time,subj_course_id,sec_code,sec_id,prof,available,waitlist,total,enrolled_ct
1668363498810,COGS 205,A00,101395,Chiba; Andrea,19,0,20,1
1668363499235,COGS 210B,001,101404,Greene; Deanna Jacquelyn,9998,0,9999,1
1668363499235,COGS 210B,002,101417,Xia; Haijun,9999,0,9999,0
1668363499235,COGS 210B,003,101422,Nitz; Douglas A.,9999,0,9999,0
1668363499235,COGS 210B,004,101423,Hollan; James D.,9998,0,9999,1
1668363499235,COGS 210B,005,101424,Deak; Gedeon O.,9998,0,9999,1
1668363499235,COGS 210B,006,101425,Rossano; Federico,9999,0,9999,0
1668363499662,COGS 211B,A00,101427,Coulson; Seana M,9996,0,9999,3
1668363500088,COGS 220,A00,101428,Hollan; James D.,0,0,25,25
1668363500513,COGS 229,A00,101429,Dow; Steven P,18,0,25,7
1668363500938,COGS 230,A00,101430,Klemmer; Scott R,11,0,17,6
1668363501362,COGS 234,A00,101431,Xia; Haijun,1,0,25,24
1668363501790,COGS 260,A00,101432,Kiyonaga; Anastasia,21,0,25,4
1668363501790,COGS 260,B00,101433,Kirsh; David Joel,15,0,25,10
1668363502217,CSE 202,A00,102371,Impagliazzo; Russell,0,0,0,0
1668363502644,CSE 203B,A01,102373,Cheng; Chung Kuan,0,0,0,0
1668363503070,CSE 208,A00,102374,Micciancio; Daniele,0,0,0,0
1668363503494,CSE 209A,A00,112895,Impagliazzo; Russell,0,0,15,15
1668363503921,CSE 209B,A00,108005,Bellare; Mihir,0,0,0,0
1668363504358,CSE 210,A00,113163,Coblenz; Michael J,0,0,0,0
1668363504782,CSE 219,A00,106111,Dow; Steven P,0,0,20,20
1668363505214,CSE 221,A00,102376,Voelker; Geoffrey M.,0,0,0,0
1668363505640,CSE 224,A01,102378,Porter; George M,0,0,0,0
1668363506082,CSE 229A,A00,102379,Savage; Stefan,0,0,0,0
1668363506509,CSE 229C,A00,102380,Munyaka; Imani N. S.,0,0,0,0
1668363506943,CSE 232B,A00,102382,Deutsch; Alin Bernard,0,0,0,0
1668363507367,CSE 234,A01,112904,Kumar; Arun Kumar,0,0,0,0
1668363507794,CSE 237A,A00,102383,Rosing; Tajana Simunic,0,0,0,0
1668363508218,CSE 239A,A00,102384,Deutsch; Alin Bernard,0,0,0,0
1668363508642,CSE 239B,A00,102385,Polikarpova; Nadezhda,0,0,0,0
1668363509070,CSE 240A,A00,102386,Pannuto; Patrick William,0,0,0,0
1668363509494,CSE 240B,A00,102387,Zhao; Jishen,0,0,0,0
1668363509918,CSE 241A,A00,106406,Kang; Mingu,0,0,0,0
1668363510347,CSE 249B,A00,102388,Kahng; Andrew Byun,0,0,8,8
1668363510771,CSE 251B,A01,102392,Cottrell; Garrison W,0,0,0,0
1668363510771,CSE 251B,A02,102393,Cottrell; Garrison W,0,0,0,0
1668363511199,CSE 252B,A00,102394,Ochoa; Benjamin Lawrence,0,0,0,0
1668363511628,CSE 257,A01,102396,Gao; Sicun,0,0,0,0
1668363512055,CSE 272,A00,102397,Li; Tzumao,0,0,0,0
1668363512490,CSE 274,A00,111323,Chern; Albert Ren-Haur,0,0,0,0
1668363512912,CSE 282,A00,102398,Pevzner; Pavel Arkadjevich,0,0,0,0
1668363513340,CSE 284,A00,114175,Gymrek; Melissa Ann,0,0,0,0
1668363513766,CSE 290,A00,102399,Chandraker; Manmohan Krishna,0,0,0,0
1668363513766,CSE 290,B00,102400,Vaccaro; Kristen Marie,0,0,25,25
1668363513766,CSE 290,C00,102414,Pannuto; Patrick William,0,0,25,25
1668363513766,CSE 290,D00,102427,Pevzner; Pavel Arkadjevich,0,0,0,0
1668363513766,CSE 290,E00,102429,Zhao; Jishen,0,0,0,0
1668363513766,CSE 290,F00,102436,Tullsen; Dean Michael,0,0,0,0
1668363513766,CSE 290,G00,102440,Christensen; Henrik I,0,0,20,20
1668363514196,CSE 291,A00,102443,Su; Hao,0,0,0,0
1668363514196,CSE 291,B00,102448,Polikarpova; Nadezhda,0,0,0,0
1668363514196,CSE 291,C00,102453,Vaccaro; Kristen Marie,0,0,0,0
1668363514196,CSE 291,D00,111343,Savage; Stefan,0,0,0,0
1668363514196,CSE 291,E00,116474,Claffy; Kimberly Claire,0,0,0,0
1668363514196,CSE 291,F00,116479,Pasquale; Joseph,0,0,0,0
1668363514650,CSE 293,001,119111,Bafna; Vineet,9999,0,9999,0
1668363514650,CSE 293,002,119118,Bellare; Mihir,9999,0,9999,0
1668363514650,CSE 293,003,119122,Berg-Kirkpatrick; Taylor D,9999,0,9999,0
1668363514650,CSE 293,004,119135,Christensen; Henrik I,9999,0,9999,0
1668363514650,CSE 293,005,119142,Cottrell; Garrison W,9999,0,9999,0
1668363514650,CSE 293,006,119146,Deutsch; Alin Bernard,9999,0,9999,0
1668363514650,CSE 293,007,119159,Esmaeilzadeh; Hadi,9999,0,9999,0
1668363514650,CSE 293,008,119166,Freund; Yoav,9999,0,9999,0
1668363514650,CSE 293,009,119170,Griswold; William G.,9999,0,9999,0
1668363514650,CSE 293,010,119183,Gymrek; Melissa Ann,9999,0,9999,0
1668363514650,CSE 293,011,119190,Heninger; Nadia A,9999,0,9999,0
1668363514650,CSE 293,012,119230,Impagliazzo; Russell,9999,0,9999,0
1668363514650,CSE 293,013,119232,Jhala; Ranjit,9999,0,9999,0
1668363514650,CSE 293,014,119233,Kahng; Andrew Byun,9999,0,9999,0
1668363514650,CSE 293,015,119298,Kane; Daniel Mertz,9999,0,9999,0
1668363514650,CSE 293,016,119299,Kriegman; David J,9999,0,9999,0
1668363514650,CSE 293,017,119300,Kumar; Arun Kumar,9999,0,9999,0
1668363514650,CSE 293,018,119301,Lerner; Sorin,9999,0,9999,0
1668363514650,CSE 293,019,119302,Lovett; Shachar,9999,0,9999,0
1668363514650,CSE 293,020,119303,McAuley; Julian John,9999,0,9999,0
1668363514650,CSE 293,021,119304,Micciancio; Daniele,9999,0,9999,0
1668363514650,CSE 293,022,119367,Orailoglu; Alex,9999,0,9999,0
1668363514650,CSE 293,023,119382,Paturi; Ramamohan,9999,0,9999,0
1668363514650,CSE 293,024,119404,Polikarpova; Nadezhda,9999,0,9999,0
1668363514650,CSE 293,025,119406,Politz; Joseph Gibbs,9999,0,9999,0
1668363514650,CSE 293,026,119411,Porter; George M,9999,0,9999,0
1668363514650,CSE 293,027,119414,Porter; Leonard Emerson,9999,0,9999,0
1668363514650,CSE 293,028,119416,Ramamoorthi; Ravi,9999,0,9999,0
1668363514650,CSE 293,029,119417,Sahoo; Debashis,9999,0,9999,0
1668363514650,CSE 293,030,119420,Saul; Lawrence,9999,0,9999,0
1668363514650,CSE 293,031,119421,Savage; Stefan,9999,0,9999,0
1668363514650,CSE 293,032,119425,Schulze; Jurgen P.,9999,0,9999,0
1668363514650,CSE 293,033,119426,Snoeren; Alex C.,9999,0,9999,0
1668363514650,CSE 293,034,119428,Shang; Jingbo,9999,0,9999,0
1668363514650,CSE 293,035,119430,Stefan; Deian,9999,0,9999,0
1668363514650,CSE 293,036,119431,Su; Hao,9999,0,9999,0
1668363514650,CSE 293,037,119433,Swanson; Steven James,9999,0,9999,0
1668363514650,CSE 293,038,119435,Tullsen; Dean Michael,9999,0,9999,0
1668363514650,CSE 293,039,119483,Voelker; Geoffrey M.,9999,0,9999,0
1668363514650,CSE 293,040,119537,Zhao; Jishen,9999,0,9999,0
1668363514650,CSE 293,041,119538,Zhou; Yuan-Yuan,9999,0,9999,0
1668363514650,CSE 293,042,119539,Gao; Sicun,9999,0,9999,0
1668363514650,CSE 293,043,119540,Weibel; Nadir,9999,0,9999,0
1668363514650,CSE 293,044,119541,Gupta; Rajesh K.,9999,0,9999,0
1668363514650,CSE 293,045,126410,Vaccaro; Kristen Marie,9999,0,9999,0
1668363514650,CSE 293,046,126411,Klemke; Richard,9999,0,9999,0
1668363515077,CSE 294,A00,102459,Voelker; Geoffrey M.,0,0,0,0
1668363515077,CSE 294,B00,111322,Orailoglu; Alex,0,0,0,0
1668363515502,DSE 201,A00,096914,Deutsch; Alin Bernard,30,0,30,0
1668363515939,DSE 210,A00,096915,Dasgupta; Sanjoy,30,0,30,0
1668363516371,DSE 260A,A00,096916,Altintas De Callaf; Ilkay,30,0,30,0
1668363516829,ECE 200,001,103586,Antipa; Nicholas A,9999,0,9999,0
1668363516829,ECE 200,002,103587,Atanasov; Nikolay A.,9999,0,9999,0
1668363516829,ECE 200,003,103588,Bharadia; Dinesh,9999,0,9999,0
1668363516829,ECE 200,004,103589,Cheng; Chung Kuan,9999,0,9999,0
1668363516829,ECE 200,005,103590,Cosman; Pamela C.,9999,0,9999,0
1668363516829,ECE 200,006,103591,Dayeh; Shadi Ahmad,9999,0,9999,0
1668363516829,ECE 200,007,103592,Fainman; Yeshaiahu,9999,0,9999,0
1668363516829,ECE 200,008,103593,Ford; Joseph Earl,9999,0,9999,0
1668363516829,ECE 200,009,103594,Franceschetti; Massimo,9999,0,9999,0
1668363516829,ECE 200,010,103595,Fullerton; Eric E,9999,0,9999,0
1668363516829,ECE 200,011,103596,Galton; Ian A,9999,0,9999,0
1668363516829,ECE 200,012,103597,Gilja; Vikash,9999,0,9999,0
1668363516829,ECE 200,013,103598,Hall; Drew A.,9999,0,9999,0
1668363516829,ECE 200,014,103599,Hsueh; Tzu-Chien,9999,0,9999,0
1668363516829,ECE 200,015,103600,Javidi; Tara,9999,0,9999,0
1668363516829,ECE 200,016,103601,Kahng; Andrew Byun,9999,0,9999,0
1668363516829,ECE 200,017,103602,Kim; Young-Han,9999,0,9999,0
1668363516829,ECE 200,018,103603,Koushanfar; Farinaz,9999,0,9999,0
1668363516829,ECE 200,019,103604,Kuzum; Duygu,9999,0,9999,0
1668363516829,ECE 200,020,103605,Le; Hanh-Phuc,9999,0,9999,0
1668363516829,ECE 200,021,103606,Lin; Bill,9999,0,9999,0
1668363516829,ECE 200,022,103607,Liu; Zhaowei,9998,0,9999,1
1668363516829,ECE 200,023,103608,Lo; Yu-Hwa,9999,0,9999,0
1668363516829,ECE 200,024,103609,Lomakin; Vitaliy,9999,0,9999,0
1668363516829,ECE 200,025,103610,Mercier; Patrick Philip,9999,0,9999,0
1668363516829,ECE 200,026,103611,Meyer; Florian,9999,0,9999,0
1668363516829,ECE 200,027,103612,Milstein; Laurence B.,9999,0,9999,0
1668363516829,ECE 200,028,103613,Mir Arabbaygi; Siavash,9999,0,9999,0
1668363516829,ECE 200,029,103614,Mookherjea; Shayan,9999,0,9999,0
1668363516829,ECE 200,030,103615,Morris; Karcher William,9999,0,9999,0
1668363516829,ECE 200,031,103616,Ng; Tse Nga,9999,0,9999,0
1668363516829,ECE 200,032,103617,Nguyen; Truong Quang,9999,0,9999,0
1668363516829,ECE 200,033,103618,Nomura; Kenji,9999,0,9999,0
1668363516829,ECE 200,034,103619,Orlitsky; Alon,9999,0,9999,0
1668363516829,ECE 200,035,103620,Pal; Piya,9999,0,9999,0
1668363516829,ECE 200,036,103621,Papen; George C.,9999,0,9999,0
1668363516829,ECE 200,037,103622,Radic; Stojan,9999,0,9999,0
1668363516829,ECE 200,038,103623,Rao; Bhaskar D.,9999,0,9999,0
1668363516829,ECE 200,039,103624,Rao; Ramesh R,9999,0,9999,0
1668363516829,ECE 200,040,103625,Rebeiz; Gabriel,9999,0,9999,0
1668363516829,ECE 200,041,103626,Sanford; John R,9999,0,9999,0
1668363516829,ECE 200,042,103627,Siegel; Paul H.,9999,0,9999,0
1668363516829,ECE 200,043,103628,Sievenpiper; Daniel F.,9999,0,9999,0
1668363516829,ECE 200,044,103629,Sworder; David D.,9999,0,9999,0
1668363516829,ECE 200,045,103630,Taur; Yuan,9999,0,9999,0
1668363516829,ECE 200,046,103631,Touri; Behrouz,9999,0,9999,0
1668363516829,ECE 200,047,103632,Trivedi; Mohan M.,9999,0,9999,0
1668363516829,ECE 200,048,103633,Vasconcelos; Nuno,9999,0,9999,0
1668363516829,ECE 200,049,103634,Wang; Xiaolong,9999,0,9999,0
1668363516829,ECE 200,050,103635,Xie; Pengtao,9999,0,9999,0
1668363516829,ECE 200,051,103636,Yip; Michael,9999,0,9999,0
1668363516829,ECE 200,052,103637,Zeger; Kenneth A.,999,0,999,0
1668363516829,ECE 200,053,103638,Zhang; Xinyu,9999,0,9999,0
1668363516829,ECE 200,054,103639,Turakhia; Yatish Girish,9999,0,9999,0
1668363516829,ECE 200,055,103640,Kang; Mingu,9999,0,9999,0
1668363516829,ECE 200,056,103641,Shi; Yuanyuan,9999,0,9999,0
1668363516829,ECE 200,057,103642,Wang; Edward Jay,9999,0,9999,0
1668363516829,ECE 200,058,103643,Zheng; Yang,9999,0,9999,0
1668363517254,ECE 202,A00,103644,Kuzum; Duygu,0,0,0,0
1668363517696,ECE 212BN,A00,103646,Ng; Tse Nga,0,0,0,0
1668363518204,ECE 221,A00,111493,Staff,0,0,0,0
1668363518628,ECE 222B,A00,103647,Lomakin; Vitaliy,0,0,0,0
1668363519058,ECE 230B,A00,103648,Taur; Yuan,0,0,0,0
1668363519487,ECE 238B,A00,103649,Garay; Javier,0,0,0,0
1668363519914,ECE 240B,A00,112900,Fainman; Yeshaiahu,0,0,0,0
1668363520340,ECE 247A,A00,103650,Jokerst; Jesse Vincent,0,0,0,0
1668363520782,ECE 247B,A00,103651,Wang; Joseph,0,0,0,0
1668363521214,ECE 250,A00,103652,Siegel; Paul H.,0,0,0,0
1668363521641,ECE 251A,A00,103654,Rao; Bhaskar D.,0,0,0,0
1668363522066,ECE 257B,A00,103655,Bharadia; Dinesh,0,0,0,0
1668363522489,ECE 258A,A00,103656,Milstein; Laurence B.,0,0,0,0
1668363522914,ECE 260B,A00,103658,Kang; Mingu,0,0,0,0
1668363523337,ECE 264A,A00,103659,Galton; Ian A,0,0,0,0
1668363523760,ECE 265A,A00,103661,Gudem; Prasad S.S.,0,0,0,0
1668363524186,ECE 265D,A00,103662,Gudem; Prasad S.S.,0,0,0,0
1668363524610,ECE 268,A00,103663,Koushanfar; Farinaz,0,0,0,0
1668363525036,ECE 269,A01,103665,Pal; Piya,0,0,0,0
1668363525459,ECE 271B,A00,103666,Vasconcelos; Manuela,0,0,0,0
1668363525898,ECE 276A,A00,103667,Atanasov; Nikolay A.,0,0,0,0
1668363526332,ECE 277,A00,103668,An; Cheolhong,0,0,0,0
1668363526766,ECE 279,A00,117947,Hall; Drew A.,0,0,0,0
1668363527624,ECE 283,A00,103670,Hsueh; Tzu-Chien,0,0,0,0
1668363528050,ECE 284,A00,103671,Turakhia; Yatish Girish,0,0,0,0
1668363528494,ECE 285,A00,103672,Zheng; Yang,0,0,0,0
1668363528494,ECE 285,B00,103673,Sworder; David D.,0,0,0,0
1668363528920,ECE 287,A00,103676,Javidi; Tara,0,0,0,0
1668363529370,MATH 200B,A00,098023,Salehi Golsefidy; Alireza,12,0,15,3
1668363529795,MATH 202B,A00,098024,Rhoades; Brendon Patrick,9,0,15,6
1668363530220,MATH 203B,A00,098025,Oprea; Dragos N.,10,0,15,5
1668363530649,MATH 204B,A00,098026,Sorensen; Claus M,13,0,15,2
1668363531073,MATH 208,A00,098027,Izadi; Elham,7,0,10,3
1668363531514,MATH 209,A00,098028,Pollack; Aaron,10,0,10,0
1668363531939,MATH 211A,A00,112919,Rogalski; Daniel,9,0,10,1
1668363532365,MATH 211B,A00,112920,Seward; Brandon M.,9,0,10,1
1668363532790,MATH 218,A00,098029,Li; Bo,10,0,10,0
1668363533219,MATH 220B,A00,098030,Novak; Jonathan I,11,0,15,4
1668363533643,MATH 221A,A00,098031,Ebenfelt; Peter F,13,0,15,2
1668363534066,MATH 231B,A00,098032,Zlatos; Andrej,12,0,15,3
1668363534495,MATH 240B,A00,098033,Ni; Lei,9,0,15,6
1668363534921,MATH 243,A00,098034,Jekel; David Andrew,10,0,10,0
1668363535346,MATH 245A,A00,098035,Nie; Jiawang,0,0,15,16
1668363535773,MATH 248,A00,098036,Bejenaru; Ioan,10,0,10,0
1668363536197,MATH 250B,A00,098037,Spolaor; Luca,14,0,15,1
1668363536622,MATH 258,A00,098038,Ni; Lei,10,0,10,0
1668363537046,MATH 264B,A00,098041,Rhoades; Brendon Patrick,9,0,15,6
1668363537473,MATH 268,A00,098042,Buss; Samuel R,10,0,10,0
1668363537900,MATH 269,A00,098043,Rhoades; Brendon Patrick,10,0,10,0
1668363538325,MATH 270B,A00,098044,Li; Bo,10,0,15,5
1668363538748,MATH 272B,A00,098045,Holst; Michael J,13,0,15,2
1668363539173,MATH 273A,A00,098046,Tian; Xiaochuan,10,0,15,5
1668363539605,MATH 275,A01,098048,Tian; Xiaochuan,6,0,10,4
1668363540044,MATH 278A,A00,098049,Holst; Michael J,8,0,10,2
1668363540479,MATH 278B,A00,098050,Cloninger; Alexander,10,0,10,0
1668363540903,MATH 278C,A00,098051,Nie; Jiawang,7,0,10,3
1668363541327,MATH 280B,A00,098052,Zheng; Tianyi,8,0,15,7
1668363541752,MATH 281B,A00,098053,Bradic; Jelena,1,0,15,14
1668363542179,MATH 282B,A00,098054,Arias-Castro; Ery,0,0,15,15
1668363542602,MATH 285,A00,098055,Fitzsimmons; Patrick J,0,0,15,17
1668363543035,MATH 287B,A00,098056,Arias-Castro; Ery,2,0,15,13
1668363543459,MATH 288,A00,098057,Agarwal; Pooja,9,0,10,1
1668363543459,MATH 288,B00,098058,Zhang; Danna,8,0,10,2
1668363543459,MATH 288,C00,098059,Williams; Ruth J,9,0,10,1
1668363543896,MATH 290B,A00,098060,Roberts; Justin Deritter,13,0,15,2
1668363544332,MATH 292,A00,098061,Belmont; Eva Kinoshita,10,0,10,0
1668363544757,MATH 295,A00,098062,Suk; Andrew Hoon,48,0,50,2
1668363545185,MATH 296,A00,098063,Novak; Jonathan I,20,0,20,0
1668363545630,MATH 297,001,098064,Gamst; Anthony Collins,9997,0,9999,2
1668364046369,COGS 205,A00,101395,Chiba; Andrea,19,0,20,1
1668364046792,COGS 210B,001,101404,Greene; Deanna Jacquelyn,9998,0,9999,1
1668364046792,COGS 210B,002,101417,Xia; Haijun,9999,0,9999,0
1668364046792,COGS 210B,003,101422,Nitz; Douglas A.,9999,0,9999,0
1668364046792,COGS 210B,004,101423,Hollan; James D.,9998,0,9999,1
1668364046792,COGS 210B,005,101424,Deak; Gedeon O.,9998,0,9999,1
1668364046792,COGS 210B,006,101425,Rossano; Federico,9999,0,9999,0
1668364047216,COGS 211B,A00,101427,Coulson; Seana M,9996,0,9999,3
1668364047642,COGS 220,A00,101428,Hollan; James D.,0,0,25,25
1668364048066,COGS 229,A00,101429,Dow; Steven P,18,0,25,7
1668364048489,COGS 230,A00,101430,Klemmer; Scott R,11,0,17,6
1668364048912,COGS 234,A00,101431,Xia; Haijun,1,0,25,24
1668364049338,COGS 260,A00,101432,Kiyonaga; Anastasia,21,0,25,4
1668364049338,COGS 260,B00,101433,Kirsh; David Joel,15,0,25,10
1668364049763,CSE 202,A00,102371,Impagliazzo; Russell,0,0,0,0
1668364050190,CSE 203B,A01,102373,Cheng; Chung Kuan,0,0,0,0
1668364050618,CSE 208,A00,102374,Micciancio; Daniele,0,0,0,0
1668364051040,CSE 209A,A00,112895,Impagliazzo; Russell,0,0,15,15
1668364051475,CSE 209B,A00,108005,Bellare; Mihir,0,0,0,0
1668364051901,CSE 210,A00,113163,Coblenz; Michael J,0,0,0,0
1668364052324,CSE 219,A00,106111,Dow; Steven P,0,0,20,20
1668364052750,CSE 221,A00,102376,Voelker; Geoffrey M.,0,0,0,0
1668364053173,CSE 224,A01,102378,Porter; George M,0,0,0,0
1668364053597,CSE 229A,A00,102379,Savage; Stefan,0,0,0,0
1668364054022,CSE 229C,A00,102380,Munyaka; Imani N. S.,0,0,0,0
1668364054446,CSE 232B,A00,102382,Deutsch; Alin Bernard,0,0,0,0
1668364054871,CSE 234,A01,112904,Kumar; Arun Kumar,0,0,0,0
1668364055294,CSE 237A,A00,102383,Rosing; Tajana Simunic,0,0,0,0
1668364055721,CSE 239A,A00,102384,Deutsch; Alin Bernard,0,0,0,0
1668364056145,CSE 239B,A00,102385,Polikarpova; Nadezhda,0,0,0,0
1668364056573,CSE 240A,A00,102386,Pannuto; Patrick William,0,0,0,0
1668364056998,CSE 240B,A00,102387,Zhao; Jishen,0,0,0,0
1668364057425,CSE 241A,A00,106406,Kang; Mingu,0,0,0,0
1668364057853,CSE 249B,A00,102388,Kahng; Andrew Byun,0,0,8,8
1668364058279,CSE 251B,A01,102392,Cottrell; Garrison W,0,0,0,0
1668364058279,CSE 251B,A02,102393,Cottrell; Garrison W,0,0,0,0
1668364058706,CSE 252B,A00,102394,Ochoa; Benjamin Lawrence,0,0,0,0
1668364059145,CSE 257,A01,102396,Gao; Sicun,0,0,0,0
1668364059575,CSE 272,A00,102397,Li; Tzumao,0,0,0,0
1668364060000,CSE 274,A00,111323,Chern; Albert Ren-Haur,0,0,0,0
1668364060424,CSE 282,A00,102398,Pevzner; Pavel Arkadjevich,0,0,0,0
1668364060850,CSE 284,A00,114175,Gymrek; Melissa Ann,0,0,0,0
1668364061273,CSE 290,A00,102399,Chandraker; Manmohan Krishna,0,0,0,0
1668364061273,CSE 290,B00,102400,Vaccaro; Kristen Marie,0,0,25,25
1668364061273,CSE 290,C00,102414,Pannuto; Patrick William,0,0,25,25
1668364061273,CSE 290,D00,102427,Pevzner; Pavel Arkadjevich,0,0,0,0
1668364061273,CSE 290,E00,102429,Zhao; Jishen,0,0,0,0
1668364061273,CSE 290,F00,102436,Tullsen; Dean Michael,0,0,0,0
1668364061273,CSE 290,G00,102440,Christensen; Henrik I,0,0,20,20
1668364061696,CSE 291,A00,102443,Su; Hao,0,0,0,0
1668364061696,CSE 291,B00,102448,Polikarpova; Nadezhda,0,0,0,0
1668364061696,CSE 291,C00,102453,Vaccaro; Kristen Marie,0,0,0,0
1668364061696,CSE 291,D00,111343,Savage; Stefan,0,0,0,0
1668364061696,CSE 291,E00,116474,Claffy; Kimberly Claire,0,0,0,0
1668364061696,CSE 291,F00,116479,Pasquale; Joseph,0,0,0,0
1668364062128,CSE 293,001,119111,Bafna; Vineet,9999,0,9999,0
1668364062128,CSE 293,002,119118,Bellare; Mihir,9999,0,9999,0
1668364062128,CSE 293,003,119122,Berg-Kirkpatrick; Taylor D,9999,0,9999,0
1668364062128,CSE 293,004,119135,Christensen; Henrik I,9999,0,9999,0
1668364062128,CSE 293,005,119142,Cottrell; Garrison W,9999,0,9999,0
1668364062128,CSE 293,006,119146,Deutsch; Alin Bernard,9999,0,9999,0
1668364062128,CSE 293,007,119159,Esmaeilzadeh; Hadi,9999,0,9999,0
1668364062128,CSE 293,008,119166,Freund; Yoav,9999,0,9999,0
1668364062128,CSE 293,009,119170,Griswold; William G.,9999,0,9999,0
1668364062128,CSE 293,010,119183,Gymrek; Melissa Ann,9999,0,9999,0
1668364062128,CSE 293,011,119190,Heninger; Nadia A,9999,0,9999,0
1668364062128,CSE 293,012,119230,Impagliazzo; Russell,9999,0,9999,0
1668364062128,CSE 293,013,119232,Jhala; Ranjit,9999,0,9999,0
1668364062128,CSE 293,014,119233,Kahng; Andrew Byun,9999,0,9999,0
1668364062128,CSE 293,015,119298,Kane; Daniel Mertz,9999,0,9999,0
1668364062128,CSE 293,016,119299,Kriegman; David J,9999,0,9999,0
1668364062128,CSE 293,017,119300,Kumar; Arun Kumar,9999,0,9999,0
1668364062128,CSE 293,018,119301,Lerner; Sorin,9999,0,9999,0
1668364062128,CSE 293,019,119302,Lovett; Shachar,9999,0,9999,0
1668364062128,CSE 293,020,119303,McAuley; Julian John,9999,0,9999,0
1668364062128,CSE 293,021,119304,Micciancio; Daniele,9999,0,9999,0
1668364062128,CSE 293,022,119367,Orailoglu; Alex,9999,0,9999,0
1668364062128,CSE 293,023,119382,Paturi; Ramamohan,9999,0,9999,0
1668364062128,CSE 293,024,119404,Polikarpova; Nadezhda,9999,0,9999,0
1668364062128,CSE 293,025,119406,Politz; Joseph Gibbs,9999,0,9999,0
1668364062128,CSE 293,026,119411,Porter; George M,9999,0,9999,0
1668364062128,CSE 293,027,119414,Porter; Leonard Emerson,9999,0,9999,0
1668364062128,CSE 293,028,119416,Ramamoorthi; Ravi,9999,0,9999,0
1668364062128,CSE 293,029,119417,Sahoo; Debashis,9999,0,9999,0
1668364062128,CSE 293,030,119420,Saul; Lawrence,9999,0,9999,0
1668364062128,CSE 293,031,119421,Savage; Stefan,9999,0,9999,0
1668364062128,CSE 293,032,119425,Schulze; Jurgen P.,9999,0,9999,0
1668364062128,CSE 293,033,119426,Snoeren; Alex C.,9999,0,9999,0
1668364062128,CSE 293,034,119428,Shang; Jingbo,9999,0,9999,0
1668364062128,CSE 293,035,119430,Stefan; Deian,9999,0,9999,0
1668364062128,CSE 293,036,119431,Su; Hao,9999,0,9999,0
1668364062128,CSE 293,037,119433,Swanson; Steven James,9999,0,9999,0
1668364062128,CSE 293,038,119435,Tullsen; Dean Michael,9999,0,9999,0
1668364062128,CSE 293,039,119483,Voelker; Geoffrey M.,9999,0,9999,0
1668364062128,CSE 293,040,119537,Zhao; Jishen,9999,0,9999,0
1668364062128,CSE 293,041,119538,Zhou; Yuan-Yuan,9999,0,9999,0
1668364062128,CSE 293,042,119539,Gao; Sicun,9999,0,9999,0
1668364062128,CSE 293,043,119540,Weibel; Nadir,9999,0,9999,0
1668364062128,CSE 293,044,119541,Gupta; Rajesh K.,9999,0,9999,0
1668364062128,CSE 293,045,126410,Vaccaro; Kristen Marie,9999,0,9999,0
1668364062128,CSE 293,046,126411,Klemke; Richard,9999,0,9999,0
1668364062550,CSE 294,A00,102459,Voelker; Geoffrey M.,0,0,0,0
1668364062550,CSE 294,B00,111322,Orailoglu; Alex,0,0,0,0
1668364062974,DSE 201,A00,096914,Deutsch; Alin Bernard,30,0,30,0
1668364063400,DSE 210,A00,096915,Dasgupta; Sanjoy,30,0,30,0
1668364063824,DSE 260A,A00,096916,Altintas De Callaf; Ilkay,30,0,30,0
1668364064251,ECE 200,001,103586,Antipa; Nicholas A,9999,0,9999,0
1668364064251,ECE 200,002,103587,Atanasov; Nikolay A.,9999,0,9999,0
1668364064251,ECE 200,003,103588,Bharadia; Dinesh,9999,0,9999,0
1668364064251,ECE 200,004,103589,Cheng; Chung Kuan,9999,0,9999,0
1668364064251,ECE 200,005,103590,Cosman; Pamela C.,9999,0,9999,0
1668364064251,ECE 200,006,103591,Dayeh; Shadi Ahmad,9999,0,9999,0
1668364064251,ECE 200,007,103592,Fainman; Yeshaiahu,9999,0,9999,0
1668364064251,ECE 200,008,103593,Ford; Joseph Earl,9999,0,9999,0
1668364064251,ECE 200,009,103594,Franceschetti; Massimo,9999,0,9999,0
1668364064251,ECE 200,010,103595,Fullerton; Eric E,9999,0,9999,0
1668364064251,ECE 200,011,103596,Galton; Ian A,9999,0,9999,0
1668364064251,ECE 200,012,103597,Gilja; Vikash,9999,0,9999,0
1668364064251,ECE 200,013,103598,Hall; Drew A.,9999,0,9999,0
1668364064251,ECE 200,014,103599,Hsueh; Tzu-Chien,9999,0,9999,0
1668364064251,ECE 200,015,103600,Javidi; Tara,9999,0,9999,0
1668364064251,ECE 200,016,103601,Kahng; Andrew Byun,9999,0,9999,0
1668364064251,ECE 200,017,103602,Kim; Young-Han,9999,0,9999,0
1668364064251,ECE 200,018,103603,Koushanfar; Farinaz,9999,0,9999,0
1668364064251,ECE 200,019,103604,Kuzum; Duygu,9999,0,9999,0
1668364064251,ECE 200,020,103605,Le; Hanh-Phuc,9999,0,9999,0
1668364064251,ECE 200,021,103606,Lin; Bill,9999,0,9999,0
1668364064251,ECE 200,022,103607,Liu; Zhaowei,9998,0,9999,1
1668364064251,ECE 200,023,103608,Lo; Yu-Hwa,9999,0,9999,0
1668364064251,ECE 200,024,103609,Lomakin; Vitaliy,9999,0,9999,0
1668364064251,ECE 200,025,103610,Mercier; Patrick Philip,9999,0,9999,0
1668364064251,ECE 200,026,103611,Meyer; Florian,9999,0,9999,0
1668364064251,ECE 200,027,103612,Milstein; Laurence B.,9999,0,9999,0
1668364064251,ECE 200,028,103613,Mir Arabbaygi; Siavash,9999,0,9999,0
1668364064251,ECE 200,029,103614,Mookherjea; Shayan,9999,0,9999,0
1668364064251,ECE 200,030,103615,Morris; Karcher William,9999,0,9999,0
1668364064251,ECE 200,031,103616,Ng; Tse Nga,9999,0,9999,0
1668364064251,ECE 200,032,103617,Nguyen; Truong Quang,9999,0,9999,0
1668364064251,ECE 200,033,103618,Nomura; Kenji,9999,0,9999,0
1668364064251,ECE 200,034,103619,Orlitsky; Alon,9999,0,9999,0
1668364064251,ECE 200,035,103620,Pal; Piya,9999,0,9999,0
1668364064251,ECE 200,036,103621,Papen; George C.,9999,0,9999,0
1668364064251,ECE 200,037,103622,Radic; Stojan,9999,0,9999,0
1668364064251,ECE 200,038,103623,Rao; Bhaskar D.,9999,0,9999,0
1668364064251,ECE 200,039,103624,Rao; Ramesh R,9999,0,9999,0
1668364064251,ECE 200,040,103625,Rebeiz; Gabriel,9999,0,9999,0
1668364064251,ECE 200,041,103626,Sanford; John R,9999,0,9999,0
1668364064251,ECE 200,042,103627,Siegel; Paul H.,9999,0,9999,0
1668364064251,ECE 200,043,103628,Sievenpiper; Daniel F.,9999,0,9999,0
1668364064251,ECE 200,044,103629,Sworder; David D.,9999,0,9999,0
1668364064251,ECE 200,045,103630,Taur; Yuan,9999,0,9999,0
1668364064251,ECE 200,046,103631,Touri; Behrouz,9999,0,9999,0
1668364064251,ECE 200,047,103632,Trivedi; Mohan M.,9999,0,9999,0
1668364064251,ECE 200,048,103633,Vasconcelos; Nuno,9999,0,9999,0
1668364064251,ECE 200,049,103634,Wang; Xiaolong,9999,0,9999,0
1668364064251,ECE 200,050,103635,Xie; Pengtao,9999,0,9999,0
1668364064251,ECE 200,051,103636,Yip; Michael,9999,0,9999,0
1668364064251,ECE 200,052,103637,Zeger; Kenneth A.,999,0,999,0
1668364064251,ECE 200,053,103638,Zhang; Xinyu,9999,0,9999,0
1668364064251,ECE 200,054,103639,Turakhia; Yatish Girish,9999,0,9999,0
1668364064251,ECE 200,055,103640,Kang; Mingu,9999,0,9999,0
1668364064251,ECE 200,056,103641,Shi; Yuanyuan,9999,0,9999,0
1668364064251,ECE 200,057,103642,Wang; Edward Jay,9999,0,9999,0
1668364064251,ECE 200,058,103643,Zheng; Yang,9999,0,9999,0
1668364064678,ECE 202,A00,103644,Kuzum; Duygu,0,0,0,0
1668364065103,ECE 212BN,A00,103646,Ng; Tse Nga,0,0,0,0
1668364065527,ECE 221,A00,111493,Staff,0,0,0,0
1668364065951,ECE 222B,A00,103647,Lomakin; Vitaliy,0,0,0,0
1668364066375,ECE 230B,A00,103648,Taur; Yuan,0,0,0,0
1668364066799,ECE 238B,A00,103649,Garay; Javier,0,0,0,0
1668364067227,ECE 240B,A00,112900,Fainman; Yeshaiahu,0,0,0,0
1668364067654,ECE 247A,A00,103650,Jokerst; Jesse Vincent,0,0,0,0
1668364068081,ECE 247B,A00,103651,Wang; Joseph,0,0,0,0
1668364068512,ECE 250,A00,103652,Siegel; Paul H.,0,0,0,0
1668364068938,ECE 251A,A00,103654,Rao; Bhaskar D.,0,0,0,0
1668364069361,ECE 257B,A00,103655,Bharadia; Dinesh,0,0,0,0
1668364069795,ECE 258A,A00,103656,Milstein; Laurence B.,0,0,0,0
1668364070221,ECE 260B,A00,103658,Kang; Mingu,0,0,0,0
1668364070644,ECE 264A,A00,103659,Galton; Ian A,0,0,0,0
1668364071071,ECE 265A,A00,103661,Gudem; Prasad S.S.,0,0,0,0
1668364071493,ECE 265D,A00,103662,Gudem; Prasad S.S.,0,0,0,0
1668364071916,ECE 268,A00,103663,Koushanfar; Farinaz,0,0,0,0
1668364072344,ECE 269,A01,103665,Pal; Piya,0,0,0,0
1668364072770,ECE 271B,A00,103666,Vasconcelos; Manuela,0,0,0,0
1668364073195,ECE 276A,A00,103667,Atanasov; Nikolay A.,0,0,0,0
1668364073622,ECE 277,A00,103668,An; Cheolhong,0,0,0,0
1668364074046,ECE 279,A00,117947,Hall; Drew A.,0,0,0,0
1668364074901,ECE 283,A00,103670,Hsueh; Tzu-Chien,0,0,0,0
1668364075339,ECE 284,A00,103671,Turakhia; Yatish Girish,0,0,0,0
1668364075779,ECE 285,A00,103672,Zheng; Yang,0,0,0,0
1668364075779,ECE 285,B00,103673,Sworder; David D.,0,0,0,0
1668364076202,ECE 287,A00,103676,Javidi; Tara,0,0,0,0
1668364076630,MATH 200B,A00,098023,Salehi Golsefidy; Alireza,12,0,15,3
1668364077053,MATH 202B,A00,098024,Rhoades; Brendon Patrick,9,0,15,6
1668364077476,MATH 203B,A00,098025,Oprea; Dragos N.,10,0,15,5
1668364077902,MATH 204B,A00,098026,Sorensen; Claus M,13,0,15,2
1668364078327,MATH 208,A00,098027,Izadi; Elham,7,0,10,3
1668364078749,MATH 209,A00,098028,Pollack; Aaron,10,0,10,0
1668364079175,MATH 211A,A00,112919,Rogalski; Daniel,9,0,10,1
1668364079598,MATH 211B,A00,112920,Seward; Brandon M.,9,0,10,1
1668364080028,MATH 218,A00,098029,Li; Bo,10,0,10,0
1668364080455,MATH 220B,A00,098030,Novak; Jonathan I,11,0,15,4
1668364080894,MATH 221A,A00,098031,Ebenfelt; Peter F,13,0,15,2
1668364081318,MATH 231B,A00,098032,Zlatos; Andrej,12,0,15,3
1668364081742,MATH 240B,A00,098033,Ni; Lei,9,0,15,6
1668364082245,MATH 243,A00,098034,Jekel; David Andrew,10,0,10,0
1668364082673,MATH 245A,A00,098035,Nie; Jiawang,0,0,15,16
1668364083097,MATH 248,A00,098036,Bejenaru; Ioan,10,0,10,0
1668364083525,MATH 250B,A00,098037,Spolaor; Luca,14,0,15,1
1668364083958,MATH 258,A00,098038,Ni; Lei,10,0,10,0
1668364084382,MATH 264B,A00,098041,Rhoades; Brendon Patrick,9,0,15,6
1668364084803,MATH 268,A00,098042,Buss; Samuel R,10,0,10,0
1668364085230,MATH 269,A00,098043,Rhoades; Brendon Patrick,10,0,10,0
1668364085653,MATH 270B,A00,098044,Li; Bo,10,0,15,5
1668364086077,MATH 272B,A00,098045,Holst; Michael J,13,0,15,2
1668364086504,MATH 273A,A00,098046,Tian; Xiaochuan,10,0,15,5
1668364086928,MATH 275,A01,098048,Tian; Xiaochuan,6,0,10,4
1668364087350,MATH 278A,A00,098049,Holst; Michael J,8,0,10,2
1668364087774,MATH 278B,A00,098050,Cloninger; Alexander,10,0,10,0
1668364088197,MATH 278C,A00,098051,Nie; Jiawang,7,0,10,3
1668364088622,MATH 280B,A00,098052,Zheng; Tianyi,8,0,15,7
1668364089050,MATH 281B,A00,098053,Bradic; Jelena,1,0,15,14
1668364089477,MATH 282B,A00,098054,Arias-Castro; Ery,0,0,15,15
1668364089901,MATH 285,A00,098055,Fitzsimmons; Patrick J,0,0,15,17
1668364090326,MATH 287B,A00,098056,Arias-Castro; Ery,2,0,15,13
1668364090751,MATH 288,A00,098057,Agarwal; Pooja,9,0,10,1
1668364090751,MATH 288,B00,098058,Zhang; Danna,8,0,10,2
1668364090751,MATH 288,C00,098059,Williams; Ruth J,9,0,10,1
1668364091189,MATH 290B,A00,098060,Roberts; Justin Deritter,13,0,15,2
1668364091613,MATH 292,A00,098061,Belmont; Eva Kinoshita,10,0,10,0
1668364092038,MATH 295,A00,098062,Suk; Andrew Hoon,48,0,50,2
1668364092461,MATH 296,A00,098063,Novak; Jonathan I,20,0,20,0
1668364092884,MATH 297,001,098064,Gamst; Anthony Collins,9997,0,9999,2
1668364593185,COGS 205,A00,101395,Chiba; Andrea,19,0,20,1
1668364593616,COGS 210B,001,101404,Greene; Deanna Jacquelyn,9998,0,9999,1
1668364593616,COGS 210B,002,101417,Xia; Haijun,9999,0,9999,0
1668364593616,COGS 210B,003,101422,Nitz; Douglas A.,9999,0,9999,0
1668364593616,COGS 210B,004,101423,Hollan; James D.,9998,0,9999,1
1668364593616,COGS 210B,005,101424,Deak; Gedeon O.,9998,0,9999,1
1668364593616,COGS 210B,006,101425,Rossano; Federico,9999,0,9999,0
1668364594043,COGS 211B,A00,101427,Coulson; Seana M,9996,0,9999,3
1668364594469,COGS 220,A00,101428,Hollan; James D.,0,0,25,25
1668364594895,COGS 229,A00,101429,Dow; Steven P,18,0,25,7
1668364595319,COGS 230,A00,101430,Klemmer; Scott R,11,0,17,6
1668364595750,COGS 234,A00,101431,Xia; Haijun,1,0,25,24
1668364596179,COGS 260,A00,101432,Kiyonaga; Anastasia,21,0,25,4
1668364596179,COGS 260,B00,101433,Kirsh; David Joel,15,0,25,10
1668364596604,CSE 202,A00,102371,Impagliazzo; Russell,0,0,0,0
1668364597044,CSE 203B,A01,102373,Cheng; Chung Kuan,0,0,0,0
1668364597485,CSE 208,A00,102374,Micciancio; Daniele,0,0,0,0
1668364597911,CSE 209A,A00,112895,Impagliazzo; Russell,0,0,15,15
1668364598335,CSE 209B,A00,108005,Bellare; Mihir,0,0,0,0
1668364598757,CSE 210,A00,113163,Coblenz; Michael J,0,0,0,0
1668364599193,CSE 219,A00,106111,Dow; Steven P,0,0,20,20
1668364599618,CSE 221,A00,102376,Voelker; Geoffrey M.,0,0,0,0
1668364600045,CSE 224,A01,102378,Porter; George M,0,0,0,0
1668364600470,CSE 229A,A00,102379,Savage; Stefan,0,0,0,0
1668364600892,CSE 229C,A00,102380,Munyaka; Imani N. S.,0,0,0,0
1668364601315,CSE 232B,A00,102382,Deutsch; Alin Bernard,0,0,0,0
1668364601742,CSE 234,A01,112904,Kumar; Arun Kumar,0,0,0,0
1668364602168,CSE 237A,A00,102383,Rosing; Tajana Simunic,0,0,0,0
1668364602678,CSE 239A,A00,102384,Deutsch; Alin Bernard,0,0,0,0
1668364603111,CSE 239B,A00,102385,Polikarpova; Nadezhda,0,0,0,0
1668364603535,CSE 240A,A00,102386,Pannuto; Patrick William,0,0,0,0
1668364603958,CSE 240B,A00,102387,Zhao; Jishen,0,0,0,0
1668364604381,CSE 241A,A00,106406,Kang; Mingu,0,0,0,0
1668364604807,CSE 249B,A00,102388,Kahng; Andrew Byun,0,0,8,8
1668364605230,CSE 251B,A01,102392,Cottrell; Garrison W,0,0,0,0
1668364605230,CSE 251B,A02,102393,Cottrell; Garrison W,0,0,0,0
1668364605654,CSE 252B,A00,102394,Ochoa; Benjamin Lawrence,0,0,0,0
1668364606080,CSE 257,A01,102396,Gao; Sicun,0,0,0,0
1668364606513,CSE 272,A00,102397,Li; Tzumao,0,0,0,0
1668364606937,CSE 274,A00,111323,Chern; Albert Ren-Haur,0,0,0,0
1668364607359,CSE 282,A00,102398,Pevzner; Pavel Arkadjevich,0,0,0,0
1668364607795,CSE 284,A00,114175,Gymrek; Melissa Ann,0,0,0,0
1668364608218,CSE 290,A00,102399,Chandraker; Manmohan Krishna,0,0,0,0
1668364608218,CSE 290,B00,102400,Vaccaro; Kristen Marie,0,0,25,25
1668364608218,CSE 290,C00,102414,Pannuto; Patrick William,0,0,25,25
1668364608218,CSE 290,D00,102427,Pevzner; Pavel Arkadjevich,0,0,0,0
1668364608218,CSE 290,E00,102429,Zhao; Jishen,0,0,0,0
1668364608218,CSE 290,F00,102436,Tullsen; Dean Michael,0,0,0,0
1668364608218,CSE 290,G00,102440,Christensen; Henrik I,0,0,20,20
1668364608643,CSE 291,A00,102443,Su; Hao,0,0,0,0
1668364608643,CSE 291,B00,102448,Polikarpova; Nadezhda,0,0,0,0
1668364608643,CSE 291,C00,102453,Vaccaro; Kristen Marie,0,0,0,0
1668364608643,CSE 291,D00,111343,Savage; Stefan,0,0,0,0
1668364608643,CSE 291,E00,116474,Claffy; Kimberly Claire,0,0,0,0
1668364608643,CSE 291,F00,116479,Pasquale; Joseph,0,0,0,0
1668364609078,CSE 293,001,119111,Bafna; Vineet,9999,0,9999,0
1668364609078,CSE 293,002,119118,Bellare; Mihir,9999,0,9999,0
1668364609078,CSE 293,003,119122,Berg-Kirkpatrick; Taylor D,9999,0,9999,0
1668364609078,CSE 293,004,119135,Christensen; Henrik I,9999,0,9999,0
1668364609078,CSE 293,005,119142,Cottrell; Garrison W,9999,0,9999,0
1668364609078,CSE 293,006,119146,Deutsch; Alin Bernard,9999,0,9999,0
1668364609078,CSE 293,007,119159,Esmaeilzadeh; Hadi,9999,0,9999,0
1668364609078,CSE 293,008,119166,Freund; Yoav,9999,0,9999,0
1668364609078,CSE 293,009,119170,Griswold; William G.,9999,0,9999,0
1668364609078,CSE 293,010,119183,Gymrek; Melissa Ann,9999,0,9999,0
1668364609078,CSE 293,011,119190,Heninger; Nadia A,9999,0,9999,0
1668364609078,CSE 293,012,119230,Impagliazzo; Russell,9999,0,9999,0
1668364609078,CSE 293,013,119232,Jhala; Ranjit,9999,0,9999,0
1668364609078,CSE 293,014,119233,Kahng; Andrew Byun,9999,0,9999,0
1668364609078,CSE 293,015,119298,Kane; Daniel Mertz,9999,0,9999,0
1668364609078,CSE 293,016,119299,Kriegman; David J,9999,0,9999,0
1668364609078,CSE 293,017,119300,Kumar; Arun Kumar,9999,0,9999,0
1668364609078,CSE 293,018,119301,Lerner; Sorin,9999,0,9999,0
1668364609078,CSE 293,019,119302,Lovett; Shachar,9999,0,9999,0
1668364609078,CSE 293,020,119303,McAuley; Julian John,9999,0,9999,0
1668364609078,CSE 293,021,119304,Micciancio; Daniele,9999,0,9999,0
1668364609078,CSE 293,022,119367,Orailoglu; Alex,9999,0,9999,0
1668364609078,CSE 293,023,119382,Paturi; Ramamohan,9999,0,9999,0
1668364609078,CSE 293,024,119404,Polikarpova; Nadezhda,9999,0,9999,0
1668364609078,CSE 293,025,119406,Politz; Joseph Gibbs,9999,0,9999,0
1668364609078,CSE 293,026,119411,Porter; George M,9999,0,9999,0
1668364609078,CSE 293,027,119414,Porter; Leonard Emerson,9999,0,9999,0
1668364609078,CSE 293,028,119416,Ramamoorthi; Ravi,9999,0,9999,0
1668364609078,CSE 293,029,119417,Sahoo; Debashis,9999,0,9999,0
1668364609078,CSE 293,030,119420,Saul; Lawrence,9999,0,9999,0
1668364609078,CSE 293,031,119421,Savage; Stefan,9999,0,9999,0
1668364609078,CSE 293,032,119425,Schulze; Jurgen P.,9999,0,9999,0
1668364609078,CSE 293,033,119426,Snoeren; Alex C.,9999,0,9999,0
1668364609078,CSE 293,034,119428,Shang; Jingbo,9999,0,9999,0
1668364609078,CSE 293,035,119430,Stefan; Deian,9999,0,9999,0
1668364609078,CSE 293,036,119431,Su; Hao,9999,0,9999,0
1668364609078,CSE 293,037,119433,Swanson; Steven James,9999,0,9999,0
1668364609078,CSE 293,038,119435,Tullsen; Dean Michael,9999,0,9999,0
1668364609078,CSE 293,039,119483,Voelker; Geoffrey M.,9999,0,9999,0
1668364609078,CSE 293,040,119537,Zhao; Jishen,9999,0,9999,0
1668364609078,CSE 293,041,119538,Zhou; Yuan-Yuan,9999,0,9999,0
1668364609078,CSE 293,042,119539,Gao; Sicun,9999,0,9999,0
1668364609078,CSE 293,043,119540,Weibel; Nadir,9999,0,9999,0
1668364609078,CSE 293,044,119541,Gupta; Rajesh K.,9999,0,9999,0
1668364609078,CSE 293,045,126410,Vaccaro; Kristen Marie,9999,0,9999,0
1668364609078,CSE 293,046,126411,Klemke; Richard,9999,0,9999,0
1668364609503,CSE 294,A00,102459,Voelker; Geoffrey M.,0,0,0,0
1668364609503,CSE 294,B00,111322,Orailoglu; Alex,0,0,0,0
1668364609927,DSE 201,A00,096914,Deutsch; Alin Bernard,30,0,30,0
1668364610351,DSE 210,A00,096915,Dasgupta; Sanjoy,30,0,30,0
1668364610773,DSE 260A,A00,096916,Altintas De Callaf; Ilkay,30,0,30,0
1668364611210,ECE 200,001,103586,Antipa; Nicholas A,9999,0,9999,0
1668364611210,ECE 200,002,103587,Atanasov; Nikolay A.,9999,0,9999,0
1668364611210,ECE 200,003,103588,Bharadia; Dinesh,9999,0,9999,0
1668364611210,ECE 200,004,103589,Cheng; Chung Kuan,9999,0,9999,0
1668364611210,ECE 200,005,103590,Cosman; Pamela C.,9999,0,9999,0
1668364611210,ECE 200,006,103591,Dayeh; Shadi Ahmad,9999,0,9999,0
1668364611210,ECE 200,007,103592,Fainman; Yeshaiahu,9999,0,9999,0
1668364611210,ECE 200,008,103593,Ford; Joseph Earl,9999,0,9999,0
1668364611210,ECE 200,009,103594,Franceschetti; Massimo,9999,0,9999,0
1668364611210,ECE 200,010,103595,Fullerton; Eric E,9999,0,9999,0
1668364611210,ECE 200,011,103596,Galton; Ian A,9999,0,9999,0
1668364611210,ECE 200,012,103597,Gilja; Vikash,9999,0,9999,0
1668364611210,ECE 200,013,103598,Hall; Drew A.,9999,0,9999,0
1668364611210,ECE 200,014,103599,Hsueh; Tzu-Chien,9999,0,9999,0
1668364611210,ECE 200,015,103600,Javidi; Tara,9999,0,9999,0
1668364611210,ECE 200,016,103601,Kahng; Andrew Byun,9999,0,9999,0
1668364611210,ECE 200,017,103602,Kim; Young-Han,9999,0,9999,0
1668364611210,ECE 200,018,103603,Koushanfar; Farinaz,9999,0,9999,0
1668364611210,ECE 200,019,103604,Kuzum; Duygu,9999,0,9999,0
1668364611210,ECE 200,020,103605,Le; Hanh-Phuc,9999,0,9999,0
1668364611210,ECE 200,021,103606,Lin; Bill,9999,0,9999,0
1668364611210,ECE 200,022,103607,Liu; Zhaowei,9998,0,9999,1
1668364611210,ECE 200,023,103608,Lo; Yu-Hwa,9999,0,9999,0
1668364611210,ECE 200,024,103609,Lomakin; Vitaliy,9999,0,9999,0
1668364611210,ECE 200,025,103610,Mercier; Patrick Philip,9999,0,9999,0
1668364611210,ECE 200,026,103611,Meyer; Florian,9999,0,9999,0
1668364611210,ECE 200,027,103612,Milstein; Laurence B.,9999,0,9999,0
1668364611210,ECE 200,028,103613,Mir Arabbaygi; Siavash,9999,0,9999,0
1668364611210,ECE 200,029,103614,Mookherjea; Shayan,9999,0,9999,0
1668364611210,ECE 200,030,103615,Morris; Karcher William,9999,0,9999,0
1668364611210,ECE 200,031,103616,Ng; Tse Nga,9999,0,9999,0
1668364611210,ECE 200,032,103617,Nguyen; Truong Quang,9999,0,9999,0
1668364611210,ECE 200,033,103618,Nomura; Kenji,9999,0,9999,0
1668364611210,ECE 200,034,103619,Orlitsky; Alon,9999,0,9999,0
1668364611210,ECE 200,035,103620,Pal; Piya,9999,0,9999,0
1668364611210,ECE 200,036,103621,Papen; George C.,9999,0,9999,0
1668364611210,ECE 200,037,103622,Radic; Stojan,9999,0,9999,0
1668364611210,ECE 200,038,103623,Rao; Bhaskar D.,9999,0,9999,0
1668364611210,ECE 200,039,103624,Rao; Ramesh R,9999,0,9999,0
1668364611210,ECE 200,040,103625,Rebeiz; Gabriel,9999,0,9999,0
1668364611210,ECE 200,041,103626,Sanford; John R,9999,0,9999,0
1668364611210,ECE 200,042,103627,Siegel; Paul H.,9999,0,9999,0
1668364611210,ECE 200,043,103628,Sievenpiper; Daniel F.,9999,0,9999,0
1668364611210,ECE 200,044,103629,Sworder; David D.,9999,0,9999,0
1668364611210,ECE 200,045,103630,Taur; Yuan,9999,0,9999,0
1668364611210,ECE 200,046,103631,Touri; Behrouz,9999,0,9999,0
1668364611210,ECE 200,047,103632,Trivedi; Mohan M.,9999,0,9999,0
1668364611210,ECE 200,048,103633,Vasconcelos; Nuno,9999,0,9999,0
1668364611210,ECE 200,049,103634,Wang; Xiaolong,9999,0,9999,0
1668364611210,ECE 200,050,103635,Xie; Pengtao,9999,0,9999,0
1668364611210,ECE 200,051,103636,Yip; Michael,9999,0,9999,0
1668364611210,ECE 200,052,103637,Zeger; Kenneth A.,999,0,999,0
1668364611210,ECE 200,053,103638,Zhang; Xinyu,9999,0,9999,0
1668364611210,ECE 200,054,103639,Turakhia; Yatish Girish,9999,0,9999,0
1668364611210,ECE 200,055,103640,Kang; Mingu,9999,0,9999,0
1668364611210,ECE 200,056,103641,Shi; Yuanyuan,9999,0,9999,0
1668364611210,ECE 200,057,103642,Wang; Edward Jay,9999,0,9999,0
1668364611210,ECE 200,058,103643,Zheng; Yang,9999,0,9999,0
1668364611635,ECE 202,A00,103644,Kuzum; Duygu,0,0,0,0
1668364612058,ECE 212BN,A00,103646,Ng; Tse Nga,0,0,0,0
1668364612489,ECE 221,A00,111493,Staff,0,0,0,0
1668364612920,ECE 222B,A00,103647,Lomakin; Vitaliy,0,0,0,0
1668364613345,ECE 230B,A00,103648,Taur; Yuan,0,0,0,0
1668364613774,ECE 238B,A00,103649,Garay; Javier,0,0,0,0
1668364614198,ECE 240B,A00,112900,Fainman; Yeshaiahu,0,0,0,0
1668364614621,ECE 247A,A00,103650,Jokerst; Jesse Vincent,0,0,0,0
1668364615048,ECE 247B,A00,103651,Wang; Joseph,0,0,0,0
1668364615485,ECE 250,A00,103652,Siegel; Paul H.,0,0,0,0
1668364615911,ECE 251A,A00,103654,Rao; Bhaskar D.,0,0,0,0
1668364616337,ECE 257B,A00,103655,Bharadia; Dinesh,0,0,0,0
1668364616760,ECE 258A,A00,103656,Milstein; Laurence B.,0,0,0,0
1668364617189,ECE 260B,A00,103658,Kang; Mingu,0,0,0,0
1668364617624,ECE 264A,A00,103659,Galton; Ian A,0,0,0,0
1668364618049,ECE 265A,A00,103661,Gudem; Prasad S.S.,0,0,0,0
1668364618475,ECE 265D,A00,103662,Gudem; Prasad S.S.,0,0,0,0
1668364618901,ECE 268,A00,103663,Koushanfar; Farinaz,0,0,0,0
1668364619335,ECE 269,A01,103665,Pal; Piya,0,0,0,0
1668364619761,ECE 271B,A00,103666,Vasconcelos; Manuela,0,0,0,0
1668364620193,ECE 276A,A00,103667,Atanasov; Nikolay A.,0,0,0,0
1668364620625,ECE 277,A00,103668,An; Cheolhong,0,0,0,0
1668364621050,ECE 279,A00,117947,Hall; Drew A.,0,0,0,0
1668364621895,ECE 283,A00,103670,Hsueh; Tzu-Chien,0,0,0,0
1668364622325,ECE 284,A00,103671,Turakhia; Yatish Girish,0,0,0,0
1668364622753,ECE 285,A00,103672,Zheng; Yang,0,0,0,0
1668364622753,ECE 285,B00,103673,Sworder; David D.,0,0,0,0
1668364623176,ECE 287,A00,103676,Javidi; Tara,0,0,0,0
1668364623603,MATH 200B,A00,098023,Salehi Golsefidy; Alireza,12,0,15,3
1668364624029,MATH 202B,A00,098024,Rhoades; Brendon Patrick,9,0,15,6
1668364624455,MATH 203B,A00,098025,Oprea; Dragos N.,10,0,15,5
1668364624879,MATH 204B,A00,098026,Sorensen; Claus M,13,0,15,2
1668364625303,MATH 208,A00,098027,Izadi; Elham,7,0,10,3
1668364625729,MATH 209,A00,098028,Pollack; Aaron,10,0,10,0
1668364626155,MATH 211A,A00,112919,Rogalski; Daniel,9,0,10,1
1668364626578,MATH 211B,A00,112920,Seward; Brandon M.,9,0,10,1
1668364627022,MATH 218,A00,098029,Li; Bo,10,0,10,0
1668364627462,MATH 220B,A00,098030,Novak; Jonathan I,11,0,15,4
1668364627887,MATH 221A,A00,098031,Ebenfelt; Peter F,13,0,15,2
1668364628315,MATH 231B,A00,098032,Zlatos; Andrej,12,0,15,3
1668364628741,MATH 240B,A00,098033,Ni; Lei,9,0,15,6
1668364629170,MATH 243,A00,098034,Jekel; David Andrew,10,0,10,0
1668364629600,MATH 245A,A00,098035,Nie; Jiawang,0,0,15,16
1668364630035,MATH 248,A00,098036,Bejenaru; Ioan,10,0,10,0
1668364630459,MATH 250B,A00,098037,Spolaor; Luca,14,0,15,1
1668364630892,MATH 258,A00,098038,Ni; Lei,10,0,10,0
1668364631315,MATH 264B,A00,098041,Rhoades; Brendon Patrick,9,0,15,6
1668364631744,MATH 268,A00,098042,Buss; Samuel R,10,0,10,0
1668364632170,MATH 269,A00,098043,Rhoades; Brendon Patrick,10,0,10,0
1668364632597,MATH 270B,A00,098044,Li; Bo,10,0,15,5
1668364633028,MATH 272B,A00,098045,Holst; Michael J,13,0,15,2
1668364633451,MATH 273A,A00,098046,Tian; Xiaochuan,10,0,15,5
1668364633874,MATH 275,A01,098048,Tian; Xiaochuan,6,0,10,4
1668364634299,MATH 278A,A00,098049,Holst; Michael J,8,0,10,2
1668364634724,MATH 278B,A00,098050,Cloninger; Alexander,10,0,10,0
1668364635150,MATH 278C,A00,098051,Nie; Jiawang,7,0,10,3
1668364635580,MATH 280B,A00,098052,Zheng; Tianyi,8,0,15,7
1668364636003,MATH 281B,A00,098053,Bradic; Jelena,1,0,15,14
1668364636426,MATH 282B,A00,098054,Arias-Castro; Ery,0,0,15,15
1668364636849,MATH 285,A00,098055,Fitzsimmons; Patrick J,0,0,15,17
1668364637271,MATH 287B,A00,098056,Arias-Castro; Ery,2,0,15,13
1668364637694,MATH 288,A00,098057,Agarwal; Pooja,9,0,10,1
1668364637694,MATH 288,B00,098058,Zhang; Danna,8,0,10,2
1668364637694,MATH 288,C00,098059,Williams; Ruth J,9,0,10,1
1668364638121,MATH 290B,A00,098060,Roberts; Justin Deritter,13,0,15,2
1668364638544,MATH 292,A00,098061,Belmont; Eva Kinoshita,10,0,10,0
1668364638969,MATH 295,A00,098062,Suk; Andrew Hoon,48,0,50,2
1668364639394,MATH 296,A00,098063,Novak; Jonathan I,20,0,20,0
1668364639821,MATH 297,001,098064,Gamst; Anthony Collins,9997,0,9999,2
1668365140577,COGS 205,A00,101395,Chiba; Andrea,19,0,20,1
1668365141012,COGS 210B,001,101404,Greene; Deanna Jacquelyn,9998,0,9999,1
1668365141012,COGS 210B,002,101417,Xia; Haijun,9999,0,9999,0
1668365141012,COGS 210B,003,101422,Nitz; Douglas A.,9999,0,9999,0
1668365141012,COGS 210B,004,101423,Hollan; James D.,9998,0,9999,1
1668365141012,COGS 210B,005,101424,Deak; Gedeon O.,9998,0,9999,1
1668365141012,COGS 210B,006,101425,Rossano; Federico,9999,0,9999,0
1668365141438,COGS 211B,A00,101427,Coulson; Seana M,9996,0,9999,3
1668365141870,COGS 220,A00,101428,Hollan; James D.,0,0,25,25
1668365142293,COGS 229,A00,101429,Dow; Steven P,18,0,25,7
1668365142717,COGS 230,A00,101430,Klemmer; Scott R,11,0,17,6
1668365143141,COGS 234,A00,101431,Xia; Haijun,1,0,25,24
1668365143564,COGS 260,A00,101432,Kiyonaga; Anastasia,21,0,25,4
1668365143564,COGS 260,B00,101433,Kirsh; David Joel,15,0,25,10
1668365143999,CSE 202,A00,102371,Impagliazzo; Russell,0,0,0,0
1668365144425,CSE 203B,A01,102373,Cheng; Chung Kuan,0,0,0,0
1668365144848,CSE 208,A00,102374,Micciancio; Daniele,0,0,0,0
1668365145279,CSE 209A,A00,112895,Impagliazzo; Russell,0,0,15,15
1668365145703,CSE 209B,A00,108005,Bellare; Mihir,0,0,0,0
1668365146131,CSE 210,A00,113163,Coblenz; Michael J,0,0,0,0
1668365146557,CSE 219,A00,106111,Dow; Steven P,0,0,20,20
1668365146985,CSE 221,A00,102376,Voelker; Geoffrey M.,0,0,0,0
1668365147425,CSE 224,A01,102378,Porter; George M,0,0,0,0
1668365147849,CSE 229A,A00,102379,Savage; Stefan,0,0,0,0
1668365148272,CSE 229C,A00,102380,Munyaka; Imani N. S.,0,0,0,0
1668365148699,CSE 232B,A00,102382,Deutsch; Alin Bernard,0,0,0,0
1668365149127,CSE 234,A01,112904,Kumar; Arun Kumar,0,0,0,0
1668365149550,CSE 237A,A00,102383,Rosing; Tajana Simunic,0,0,0,0
1668365149974,CSE 239A,A00,102384,Deutsch; Alin Bernard,0,0,0,0
1668365150401,CSE 239B,A00,102385,Polikarpova; Nadezhda,0,0,0,0
1668365150830,CSE 240A,A00,102386,Pannuto; Patrick William,0,0,0,0
1668365151265,CSE 240B,A00,102387,Zhao; Jishen,0,0,0,0
1668365151691,CSE 241A,A00,106406,Kang; Mingu,0,0,0,0
1668365152116,CSE 249B,A00,102388,Kahng; Andrew Byun,0,0,8,8
1668365152552,CSE 251B,A01,102392,Cottrell; Garrison W,0,0,0,0
1668365152552,CSE 251B,A02,102393,Cottrell; Garrison W,0,0,0,0
1668365152978,CSE 252B,A00,102394,Ochoa; Benjamin Lawrence,0,0,0,0
1668365153401,CSE 257,A01,102396,Gao; Sicun,0,0,0,0
1668365153823,CSE 272,A00,102397,Li; Tzumao,0,0,0,0
1668365154251,CSE 274,A00,111323,Chern; Albert Ren-Haur,0,0,0,0
1668365154683,CSE 282,A00,102398,Pevzner; Pavel Arkadjevich,0,0,0,0
1668365155127,CSE 284,A00,114175,Gymrek; Melissa Ann,0,0,0,0
1668365155562,CSE 290,A00,102399,Chandraker; Manmohan Krishna,0,0,0,0
1668365155562,CSE 290,B00,102400,Vaccaro; Kristen Marie,0,0,25,25
1668365155562,CSE 290,C00,102414,Pannuto; Patrick William,0,0,25,25
1668365155562,CSE 290,D00,102427,Pevzner; Pavel Arkadjevich,0,0,0,0
1668365155562,CSE 290,E00,102429,Zhao; Jishen,0,0,0,0
1668365155562,CSE 290,F00,102436,Tullsen; Dean Michael,0,0,0,0
1668365155562,CSE 290,G00,102440,Christensen; Henrik I,0,0,20,20
1668365155998,CSE 291,A00,102443,Su; Hao,0,0,0,0
1668365155998,CSE 291,B00,102448,Polikarpova; Nadezhda,0,0,0,0
1668365155998,CSE 291,C00,102453,Vaccaro; Kristen Marie,0,0,0,0
1668365155998,CSE 291,D00,111343,Savage; Stefan,0,0,0,0
1668365155998,CSE 291,E00,116474,Claffy; Kimberly Claire,0,0,0,0
1668365155998,CSE 291,F00,116479,Pasquale; Joseph,0,0,0,0
1668365156444,CSE 293,001,119111,Bafna; Vineet,9999,0,9999,0
1668365156444,CSE 293,002,119118,Bellare; Mihir,9999,0,9999,0
1668365156444,CSE 293,003,119122,Berg-Kirkpatrick; Taylor D,9999,0,9999,0
1668365156444,CSE 293,004,119135,Christensen; Henrik I,9999,0,9999,0
1668365156444,CSE 293,005,119142,Cottrell; Garrison W,9999,0,9999,0
1668365156444,CSE 293,006,119146,Deutsch; Alin Bernard,9999,0,9999,0
1668365156444,CSE 293,007,119159,Esmaeilzadeh; Hadi,9999,0,9999,0
1668365156444,CSE 293,008,119166,Freund; Yoav,9999,0,9999,0
1668365156444,CSE 293,009,119170,Griswold; William G.,9999,0,9999,0
1668365156444,CSE 293,010,119183,Gymrek; Melissa Ann,9999,0,9999,0
1668365156444,CSE 293,011,119190,Heninger; Nadia A,9999,0,9999,0
1668365156444,CSE 293,012,119230,Impagliazzo; Russell,9999,0,9999,0
1668365156444,CSE 293,013,119232,Jhala; Ranjit,9999,0,9999,0
1668365156444,CSE 293,014,119233,Kahng; Andrew Byun,9999,0,9999,0
1668365156444,CSE 293,015,119298,Kane; Daniel Mertz,9999,0,9999,0
1668365156444,CSE 293,016,119299,Kriegman; David J,9999,0,9999,0
1668365156444,CSE 293,017,119300,Kumar; Arun Kumar,9999,0,9999,0
1668365156444,CSE 293,018,119301,Lerner; Sorin,9999,0,9999,0
1668365156444,CSE 293,019,119302,Lovett; Shachar,9999,0,9999,0
1668365156444,CSE 293,020,119303,McAuley; Julian John,9999,0,9999,0
1668365156444,CSE 293,021,119304,Micciancio; Daniele,9999,0,9999,0
1668365156444,CSE 293,022,119367,Orailoglu; Alex,9999,0,9999,0
1668365156444,CSE 293,023,119382,Paturi; Ramamohan,9999,0,9999,0
1668365156444,CSE 293,024,119404,Polikarpova; Nadezhda,9999,0,9999,0
1668365156444,CSE 293,025,119406,Politz; Joseph Gibbs,9999,0,9999,0
1668365156444,CSE 293,026,119411,Porter; George M,9999,0,9999,0
1668365156444,CSE 293,027,119414,Porter; Leonard Emerson,9999,0,9999,0
1668365156444,CSE 293,028,119416,Ramamoorthi; Ravi,9999,0,9999,0
1668365156444,CSE 293,029,119417,Sahoo; Debashis,9999,0,9999,0
1668365156444,CSE 293,030,119420,Saul; Lawrence,9999,0,9999,0
1668365156444,CSE 293,031,119421,Savage; Stefan,9999,0,9999,0
1668365156444,CSE 293,032,119425,Schulze; Jurgen P.,9999,0,9999,0
1668365156444,CSE 293,033,119426,Snoeren; Alex C.,9999,0,9999,0
1668365156444,CSE 293,034,119428,Shang; Jingbo,9999,0,9999,0
1668365156444,CSE 293,035,119430,Stefan; Deian,9999,0,9999,0
1668365156444,CSE 293,036,119431,Su; Hao,9999,0,9999,0
1668365156444,CSE 293,037,119433,Swanson; Steven James,9999,0,9999,0
1668365156444,CSE 293,038,119435,Tullsen; Dean Michael,9999,0,9999,0
1668365156444,CSE 293,039,119483,Voelker; Geoffrey M.,9999,0,9999,0
1668365156444,CSE 293,040,119537,Zhao; Jishen,9999,0,9999,0
1668365156444,CSE 293,041,119538,Zhou; Yuan-Yuan,9999,0,9999,0
1668365156444,CSE 293,042,119539,Gao; Sicun,9999,0,9999,0
1668365156444,CSE 293,043,119540,Weibel; Nadir,9999,0,9999,0
1668365156444,CSE 293,044,119541,Gupta; Rajesh K.,9999,0,9999,0
1668365156444,CSE 293,045,126410,Vaccaro; Kristen Marie,9999,0,9999,0
1668365156444,CSE 293,046,126411,Klemke; Richard,9999,0,9999,0
1668365156868,CSE 294,A00,102459,Voelker; Geoffrey M.,0,0,0,0
1668365156868,CSE 294,B00,111322,Orailoglu; Alex,0,0,0,0
1668365157292,DSE 201,A00,096914,Deutsch; Alin Bernard,30,0,30,0
1668365157716,DSE 210,A00,096915,Dasgupta; Sanjoy,30,0,30,0
1668365158149,DSE 260A,A00,096916,Altintas De Callaf; Ilkay,30,0,30,0
1668365158592,ECE 200,001,103586,Antipa; Nicholas A,9999,0,9999,0
1668365158592,ECE 200,002,103587,Atanasov; Nikolay A.,9999,0,9999,0
1668365158592,ECE 200,003,103588,Bharadia; Dinesh,9999,0,9999,0
1668365158592,ECE 200,004,103589,Cheng; Chung Kuan,9999,0,9999,0
1668365158592,ECE 200,005,103590,Cosman; Pamela C.,9999,0,9999,0
1668365158592,ECE 200,006,103591,Dayeh; Shadi Ahmad,9999,0,9999,0
1668365158592,ECE 200,007,103592,Fainman; Yeshaiahu,9999,0,9999,0
1668365158592,ECE 200,008,103593,Ford; Joseph Earl,9999,0,9999,0
1668365158592,ECE 200,009,103594,Franceschetti; Massimo,9999,0,9999,0
1668365158592,ECE 200,010,103595,Fullerton; Eric E,9999,0,9999,0
1668365158592,ECE 200,011,103596,Galton; Ian A,9999,0,9999,0
1668365158592,ECE 200,012,103597,Gilja; Vikash,9999,0,9999,0
1668365158592,ECE 200,013,103598,Hall; Drew A.,9999,0,9999,0
1668365158592,ECE 200,014,103599,Hsueh; Tzu-Chien,9999,0,9999,0
1668365158592,ECE 200,015,103600,Javidi; Tara,9999,0,9999,0
1668365158592,ECE 200,016,103601,Kahng; Andrew Byun,9999,0,9999,0
1668365158592,ECE 200,017,103602,Kim; Young-Han,9999,0,9999,0
1668365158592,ECE 200,018,103603,Koushanfar; Farinaz,9999,0,9999,0
1668365158592,ECE 200,019,103604,Kuzum; Duygu,9999,0,9999,0
1668365158592,ECE 200,020,103605,Le; Hanh-Phuc,9999,0,9999,0
1668365158592,ECE 200,021,103606,Lin; Bill,9999,0,9999,0
1668365158592,ECE 200,022,103607,Liu; Zhaowei,9998,0,9999,1
1668365158592,ECE 200,023,103608,Lo; Yu-Hwa,9999,0,9999,0
1668365158592,ECE 200,024,103609,Lomakin; Vitaliy,9999,0,9999,0
1668365158592,ECE 200,025,103610,Mercier; Patrick Philip,9999,0,9999,0
1668365158592,ECE 200,026,103611,Meyer; Florian,9999,0,9999,0
1668365158592,ECE 200,027,103612,Milstein; Laurence B.,9999,0,9999,0
1668365158592,ECE 200,028,103613,Mir Arabbaygi; Siavash,9999,0,9999,0
1668365158592,ECE 200,029,103614,Mookherjea; Shayan,9999,0,9999,0
1668365158592,ECE 200,030,103615,Morris; Karcher William,9999,0,9999,0
1668365158592,ECE 200,031,103616,Ng; Tse Nga,9999,0,9999,0
1668365158592,ECE 200,032,103617,Nguyen; Truong Quang,9999,0,9999,0
1668365158592,ECE 200,033,103618,Nomura; Kenji,9999,0,9999,0
1668365158592,ECE 200,034,103619,Orlitsky; Alon,9999,0,9999,0
1668365158592,ECE 200,035,103620,Pal; Piya,9999,0,9999,0
1668365158592,ECE 200,036,103621,Papen; George C.,9999,0,9999,0
1668365158592,ECE 200,037,103622,Radic; Stojan,9999,0,9999,0
1668365158592,ECE 200,038,103623,Rao; Bhaskar D.,9999,0,9999,0
1668365158592,ECE 200,039,103624,Rao; Ramesh R,9999,0,9999,0
1668365158592,ECE 200,040,103625,Rebeiz; Gabriel,9999,0,9999,0
1668365158592,ECE 200,041,103626,Sanford; John R,9999,0,9999,0
1668365158592,ECE 200,042,103627,Siegel; Paul H.,9999,0,9999,0
1668365158592,ECE 200,043,103628,Sievenpiper; Daniel F.,9999,0,9999,0
1668365158592,ECE 200,044,103629,Sworder; David D.,9999,0,9999,0
1668365158592,ECE 200,045,103630,Taur; Yuan,9999,0,9999,0
1668365158592,ECE 200,046,103631,Touri; Behrouz,9999,0,9999,0
1668365158592,ECE 200,047,103632,Trivedi; Mohan M.,9999,0,9999,0
1668365158592,ECE 200,048,103633,Vasconcelos; Nuno,9999,0,9999,0
1668365158592,ECE 200,049,103634,Wang; Xiaolong,9999,0,9999,0
1668365158592,ECE 200,050,103635,Xie; Pengtao,9999,0,9999,0
1668365158592,ECE 200,051,103636,Yip; Michael,9999,0,9999,0
1668365158592,ECE 200,052,103637,Zeger; Kenneth A.,999,0,999,0
1668365158592,ECE 200,053,103638,Zhang; Xinyu,9999,0,9999,0
1668365158592,ECE 200,054,103639,Turakhia; Yatish Girish,9999,0,9999,0
1668365158592,ECE 200,055,103640,Kang; Mingu,9999,0,9999,0
1668365158592,ECE 200,056,103641,Shi; Yuanyuan,9999,0,9999,0
1668365158592,ECE 200,057,103642,Wang; Edward Jay,9999,0,9999,0
1668365158592,ECE 200,058,103643,Zheng; Yang,9999,0,9999,0
1668365159021,ECE 202,A00,103644,Kuzum; Duygu,0,0,0,0
1668365159445,ECE 212BN,A00,103646,Ng; Tse Nga,0,0,0,0
1668365159867,ECE 221,A00,111493,Staff,0,0,0,0
1668365160297,ECE 222B,A00,103647,Lomakin; Vitaliy,0,0,0,0
1668365160724,ECE 230B,A00,103648,Taur; Yuan,0,0,0,0
1668365161148,ECE 238B,A00,103649,Garay; Javier,0,0,0,0
1668365161573,ECE 240B,A00,112900,Fainman; Yeshaiahu,0,0,0,0
1668365162000,ECE 247A,A00,103650,Jokerst; Jesse Vincent,0,0,0,0
1668365162432,ECE 247B,A00,103651,Wang; Joseph,0,0,0,0
1668365162857,ECE 250,A00,103652,Siegel; Paul H.,0,0,0,0
1668365163287,ECE 251A,A00,103654,Rao; Bhaskar D.,0,0,0,0
1668365163717,ECE 257B,A00,103655,Bharadia; Dinesh,0,0,0,0
1668365164141,ECE 258A,A00,103656,Milstein; Laurence B.,0,0,0,0
1668365164564,ECE 260B,A00,103658,Kang; Mingu,0,0,0,0
1668365164998,ECE 264A,A00,103659,Galton; Ian A,0,0,0,0
1668365165424,ECE 265A,A00,103661,Gudem; Prasad S.S.,0,0,0,0
1668365165854,ECE 265D,A00,103662,Gudem; Prasad S.S.,0,0,0,0
1668365166277,ECE 268,A00,103663,Koushanfar; Farinaz,0,0,0,0
1668365166824,ECE 269,A01,103665,Pal; Piya,0,0,0,0
1668365167254,ECE 271B,A00,103666,Vasconcelos; Manuela,0,0,0,0
1668365167681,ECE 276A,A00,103667,Atanasov; Nikolay A.,0,0,0,0
1668365168131,ECE 277,A00,103668,An; Cheolhong,0,0,0,0
1668365168556,ECE 279,A00,117947,Hall; Drew A.,0,0,0,0
1668365169410,ECE 283,A00,103670,Hsueh; Tzu-Chien,0,0,0,0
1668365169836,ECE 284,A00,103671,Turakhia; Yatish Girish,0,0,0,0
1668365170260,ECE 285,A00,103672,Zheng; Yang,0,0,0,0
1668365170260,ECE 285,B00,103673,Sworder; David D.,0,0,0,0
1668365170687,ECE 287,A00,103676,Javidi; Tara,0,0,0,0
1668365171110,MATH 200B,A00,098023,Salehi Golsefidy; Alireza,12,0,15,3
1668365171535,MATH 202B,A00,098024,Rhoades; Brendon Patrick,9,0,15,6
1668365171969,MATH 203B,A00,098025,Oprea; Dragos N.,10,0,15,5
1668365172397,MATH 204B,A00,098026,Sorensen; Claus M,13,0,15,2
1668365172825,MATH 208,A00,098027,Izadi; Elham,7,0,10,3
1668365173249,MATH 209,A00,098028,Pollack; Aaron,10,0,10,0
1668365173675,MATH 211A,A00,112919,Rogalski; Daniel,9,0,10,1
1668365174102,MATH 211B,A00,112920,Seward; Brandon M.,9,0,10,1
1668365174525,MATH 218,A00,098029,Li; Bo,10,0,10,0
1668365174953,MATH 220B,A00,098030,Novak; Jonathan I,11,0,15,4
1668365175378,MATH 221A,A00,098031,Ebenfelt; Peter F,13,0,15,2
1668365175815,MATH 231B,A00,098032,Zlatos; Andrej,12,0,15,3
1668365176247,MATH 240B,A00,098033,Ni; Lei,9,0,15,6
1668365176681,MATH 243,A00,098034,Jekel; David Andrew,10,0,10,0
1668365177119,MATH 245A,A00,098035,Nie; Jiawang,0,0,15,16
1668365177543,MATH 248,A00,098036,Bejenaru; Ioan,10,0,10,0
1668365177976,MATH 250B,A00,098037,Spolaor; Luca,14,0,15,1
1668365178400,MATH 258,A00,098038,Ni; Lei,10,0,10,0
1668365178823,MATH 264B,A00,098041,Rhoades; Brendon Patrick,9,0,15,6
1668365179249,MATH 268,A00,098042,Buss; Samuel R,10,0,10,0
1668365179676,MATH 269,A00,098043,Rhoades; Brendon Patrick,10,0,10,0
1668365180101,MATH 270B,A00,098044,Li; Bo,10,0,15,5
1668365180531,MATH 272B,A00,098045,Holst; Michael J,13,0,15,2
1668365180957,MATH 273A,A00,098046,Tian; Xiaochuan,10,0,15,5
1668365181380,MATH 275,A01,098048,Tian; Xiaochuan,6,0,10,4
1668365181807,MATH 278A,A00,098049,Holst; Michael J,8,0,10,2
1668365182233,MATH 278B,A00,098050,Cloninger; Alexander,10,0,10,0
1668365182661,MATH 278C,A00,098051,Nie; Jiawang,7,0,10,3
1668365183087,MATH 280B,A00,098052,Zheng; Tianyi,8,0,15,7
1668365183522,MATH 281B,A00,098053,Bradic; Jelena,1,0,15,14
1668365183950,MATH 282B,A00,098054,Arias-Castro; Ery,0,0,15,15
1668365184375,MATH 285,A00,098055,Fitzsimmons; Patrick J,0,0,15,17
1668365184806,MATH 287B,A00,098056,Arias-Castro; Ery,2,0,15,13
1668365185231,MATH 288,A00,098057,Agarwal; Pooja,9,0,10,1
1668365185231,MATH 288,B00,098058,Zhang; Danna,8,0,10,2
1668365185231,MATH 288,C00,098059,Williams; Ruth J,9,0,10,1
1668365185661,MATH 290B,A00,098060,Roberts; Justin Deritter,13,0,15,2
1668365186088,MATH 292,A00,098061,Belmont; Eva Kinoshita,10,0,10,0
1668365186514,MATH 295,A00,098062,Suk; Andrew Hoon,48,0,50,2
1668365186947,MATH 296,A00,098063,Novak; Jonathan I,20,0,20,0
1668365187371,MATH 297,001,098064,Gamst; Anthony Collins,9997,0,9999,2
1668365689593,COGS 205,A00,101395,Chiba; Andrea,19,0,20,1
1668365690026,COGS 210B,001,101404,Greene; Deanna Jacquelyn,9998,0,9999,1
1668365690026,COGS 210B,002,101417,Xia; Haijun,9999,0,9999,0
1668365690026,COGS 210B,003,101422,Nitz; Douglas A.,9999,0,9999,0
1668365690026,COGS 210B,004,101423,Hollan; James D.,9998,0,9999,1
1668365690026,COGS 210B,005,101424,Deak; Gedeon O.,9998,0,9999,1
1668365690026,COGS 210B,006,101425,Rossano; Federico,9999,0,9999,0
1668365690465,COGS 211B,A00,101427,Coulson; Seana M,9996,0,9999,3
1668365690887,COGS 220,A00,101428,Hollan; James D.,0,0,25,25
1668365691311,COGS 229,A00,101429,Dow; Steven P,18,0,25,7
1668365691734,COGS 230,A00,101430,Klemmer; Scott R,11,0,17,6
1668365692158,COGS 234,A00,101431,Xia; Haijun,1,0,25,24
1668365692585,COGS 260,A00,101432,Kiyonaga; Anastasia,21,0,25,4
1668365692585,COGS 260,B00,101433,Kirsh; David Joel,15,0,25,10
1668365693008,CSE 202,A00,102371,Impagliazzo; Russell,0,0,0,0
1668365693434,CSE 203B,A01,102373,Cheng; Chung Kuan,0,0,0,0
1668365693865,CSE 208,A00,102374,Micciancio; Daniele,0,0,0,0
1668365694301,CSE 209A,A00,112895,Impagliazzo; Russell,0,0,15,15
1668365694739,CSE 209B,A00,108005,Bellare; Mihir,0,0,0,0
1668365695175,CSE 210,A00,113163,Coblenz; Michael J,0,0,0,0
1668365695611,CSE 219,A00,106111,Dow; Steven P,0,0,20,20
1668365696035,CSE 221,A00,102376,Voelker; Geoffrey M.,0,0,0,0
1668365696461,CSE 224,A01,102378,Porter; George M,0,0,0,0
1668365696885,CSE 229A,A00,102379,Savage; Stefan,0,0,0,0
1668365697309,CSE 229C,A00,102380,Munyaka; Imani N. S.,0,0,0,0
1668365697731,CSE 232B,A00,102382,Deutsch; Alin Bernard,0,0,0,0
1668365698154,CSE 234,A01,112904,Kumar; Arun Kumar,0,0,0,0
1668365698598,CSE 237A,A00,102383,Rosing; Tajana Simunic,0,0,0,0
1668365699023,CSE 239A,A00,102384,Deutsch; Alin Bernard,0,0,0,0
1668365699448,CSE 239B,A00,102385,Polikarpova; Nadezhda,0,0,0,0
1668365699872,CSE 240A,A00,102386,Pannuto; Patrick William,0,0,0,0
1668365700295,CSE 240B,A00,102387,Zhao; Jishen,0,0,0,0
1668365700720,CSE 241A,A00,106406,Kang; Mingu,0,0,0,0
1668365701143,CSE 249B,A00,102388,Kahng; Andrew Byun,0,0,8,8
1668365701566,CSE 251B,A01,102392,Cottrell; Garrison W,0,0,0,0
1668365701566,CSE 251B,A02,102393,Cottrell; Garrison W,0,0,0,0
1668365701991,CSE 252B,A00,102394,Ochoa; Benjamin Lawrence,0,0,0,0
1668365702416,CSE 257,A01,102396,Gao; Sicun,0,0,0,0
1668365702847,CSE 272,A00,102397,Li; Tzumao,0,0,0,0
1668365703273,CSE 274,A00,111323,Chern; Albert Ren-Haur,0,0,0,0
1668365703701,CSE 282,A00,102398,Pevzner; Pavel Arkadjevich,0,0,0,0
1668365704126,CSE 284,A00,114175,Gymrek; Melissa Ann,0,0,0,0
1668365704554,CSE 290,A00,102399,Chandraker; Manmohan Krishna,0,0,0,0
1668365704554,CSE 290,B00,102400,Vaccaro; Kristen Marie,0,0,25,25
1668365704554,CSE 290,C00,102414,Pannuto; Patrick William,0,0,25,25
1668365704554,CSE 290,D00,102427,Pevzner; Pavel Arkadjevich,0,0,0,0
1668365704554,CSE 290,E00,102429,Zhao; Jishen,0,0,0,0
1668365704554,CSE 290,F00,102436,Tullsen; Dean Michael,0,0,0,0
1668365704554,CSE 290,G00,102440,Christensen; Henrik I,0,0,20,20
1668365704992,CSE 291,A00,102443,Su; Hao,0,0,0,0
1668365704992,CSE 291,B00,102448,Polikarpova; Nadezhda,0,0,0,0
1668365704992,CSE 291,C00,102453,Vaccaro; Kristen Marie,0,0,0,0
1668365704992,CSE 291,D00,111343,Savage; Stefan,0,0,0,0
1668365704992,CSE 291,E00,116474,Claffy; Kimberly Claire,0,0,0,0
1668365704992,CSE 291,F00,116479,Pasquale; Joseph,0,0,0,0
1668365705446,CSE 293,001,119111,Bafna; Vineet,9999,0,9999,0
1668365705446,CSE 293,002,119118,Bellare; Mihir,9999,0,9999,0
1668365705446,CSE 293,003,119122,Berg-Kirkpatrick; Taylor D,9999,0,9999,0
1668365705446,CSE 293,004,119135,Christensen; Henrik I,9999,0,9999,0
1668365705446,CSE 293,005,119142,Cottrell; Garrison W,9999,0,9999,0
1668365705446,CSE 293,006,119146,Deutsch; Alin Bernard,9999,0,9999,0
1668365705446,CSE 293,007,119159,Esmaeilzadeh; Hadi,9999,0,9999,0
1668365705446,CSE 293,008,119166,Freund; Yoav,9999,0,9999,0
1668365705446,CSE 293,009,119170,Griswold; William G.,9999,0,9999,0
1668365705446,CSE 293,010,119183,Gymrek; Melissa Ann,9999,0,9999,0
1668365705446,CSE 293,011,119190,Heninger; Nadia A,9999,0,9999,0
1668365705446,CSE 293,012,119230,Impagliazzo; Russell,9999,0,9999,0
1668365705446,CSE 293,013,119232,Jhala; Ranjit,9999,0,9999,0
1668365705446,CSE 293,014,119233,Kahng; Andrew Byun,9999,0,9999,0
1668365705446,CSE 293,015,119298,Kane; Daniel Mertz,9999,0,9999,0
1668365705446,CSE 293,016,119299,Kriegman; David J,9999,0,9999,0
1668365705446,CSE 293,017,119300,Kumar; Arun Kumar,9999,0,9999,0
1668365705446,CSE 293,018,119301,Lerner; Sorin,9999,0,9999,0
1668365705446,CSE 293,019,119302,Lovett; Shachar,9999,0,9999,0
1668365705446,CSE 293,020,119303,McAuley; Julian John,9999,0,9999,0
1668365705446,CSE 293,021,119304,Micciancio; Daniele,9999,0,9999,0
1668365705446,CSE 293,022,119367,Orailoglu; Alex,9999,0,9999,0
1668365705446,CSE 293,023,119382,Paturi; Ramamohan,9999,0,9999,0
1668365705446,CSE 293,024,119404,Polikarpova; Nadezhda,9999,0,9999,0
1668365705446,CSE 293,025,119406,Politz; Joseph Gibbs,9999,0,9999,0
1668365705446,CSE 293,026,119411,Porter; George M,9999,0,9999,0
1668365705446,CSE 293,027,119414,Porter; Leonard Emerson,9999,0,9999,0
1668365705446,CSE 293,028,119416,Ramamoorthi; Ravi,9999,0,9999,0
1668365705446,CSE 293,029,119417,Sahoo; Debashis,9999,0,9999,0
1668365705446,CSE 293,030,119420,Saul; Lawrence,9999,0,9999,0
1668365705446,CSE 293,031,119421,Savage; Stefan,9999,0,9999,0
1668365705446,CSE 293,032,119425,Schulze; Jurgen P.,9999,0,9999,0
1668365705446,CSE 293,033,119426,Snoeren; Alex C.,9999,0,9999,0
1668365705446,CSE 293,034,119428,Shang; Jingbo,9999,0,9999,0
1668365705446,CSE 293,035,119430,Stefan; Deian,9999,0,9999,0
1668365705446,CSE 293,036,119431,Su; Hao,9999,0,9999,0
1668365705446,CSE 293,037,119433,Swanson; Steven James,9999,0,9999,0
1668365705446,CSE 293,038,119435,Tullsen; Dean Michael,9999,0,9999,0
1668365705446,CSE 293,039,119483,Voelker; Geoffrey M.,9999,0,9999,0
1668365705446,CSE 293,040,119537,Zhao; Jishen,9999,0,9999,0
1668365705446,CSE 293,041,119538,Zhou; Yuan-Yuan,9999,0,9999,0
1668365705446,CSE 293,042,119539,Gao; Sicun,9999,0,9999,0
1668365705446,CSE 293,043,119540,Weibel; Nadir,9999,0,9999,0
1668365705446,CSE 293,044,119541,Gupta; Rajesh K.,9999,0,9999,0
1668365705446,CSE 293,045,126410,Vaccaro; Kristen Marie,9999,0,9999,0
1668365705446,CSE 293,046,126411,Klemke; Richard,9999,0,9999,0
1668365705877,CSE 294,A00,102459,Voelker; Geoffrey M.,0,0,0,0
1668365705877,CSE 294,B00,111322,Orailoglu; Alex,0,0,0,0
1668365706301,DSE 201,A00,096914,Deutsch; Alin Bernard,30,0,30,0
1668365706739,DSE 210,A00,096915,Dasgupta; Sanjoy,30,0,30,0
1668365707165,DSE 260A,A00,096916,Altintas De Callaf; Ilkay,30,0,30,0
1668365707640,ECE 200,001,103586,Antipa; Nicholas A,9999,0,9999,0
1668365707640,ECE 200,002,103587,Atanasov; Nikolay A.,9999,0,9999,0
1668365707640,ECE 200,003,103588,Bharadia; Dinesh,9999,0,9999,0
1668365707640,ECE 200,004,103589,Cheng; Chung Kuan,9999,0,9999,0
1668365707640,ECE 200,005,103590,Cosman; Pamela C.,9999,0,9999,0
1668365707640,ECE 200,006,103591,Dayeh; Shadi Ahmad,9999,0,9999,0
1668365707640,ECE 200,007,103592,Fainman; Yeshaiahu,9999,0,9999,0
1668365707640,ECE 200,008,103593,Ford; Joseph Earl,9999,0,9999,0
1668365707640,ECE 200,009,103594,Franceschetti; Massimo,9999,0,9999,0
1668365707640,ECE 200,010,103595,Fullerton; Eric E,9999,0,9999,0
1668365707640,ECE 200,011,103596,Galton; Ian A,9999,0,9999,0
1668365707640,ECE 200,012,103597,Gilja; Vikash,9999,0,9999,0
1668365707640,ECE 200,013,103598,Hall; Drew A.,9999,0,9999,0
1668365707640,ECE 200,014,103599,Hsueh; Tzu-Chien,9999,0,9999,0
1668365707640,ECE 200,015,103600,Javidi; Tara,9999,0,9999,0
1668365707640,ECE 200,016,103601,Kahng; Andrew Byun,9999,0,9999,0
1668365707640,ECE 200,017,103602,Kim; Young-Han,9999,0,9999,0
1668365707640,ECE 200,018,103603,Koushanfar; Farinaz,9999,0,9999,0
1668365707640,ECE 200,019,103604,Kuzum; Duygu,9999,0,9999,0
1668365707640,ECE 200,020,103605,Le; Hanh-Phuc,9999,0,9999,0
1668365707640,ECE 200,021,103606,Lin; Bill,9999,0,9999,0
1668365707640,ECE 200,022,103607,Liu; Zhaowei,9998,0,9999,1
1668365707640,ECE 200,023,103608,Lo; Yu-Hwa,9999,0,9999,0
1668365707640,ECE 200,024,103609,Lomakin; Vitaliy,9999,0,9999,0
1668365707640,ECE 200,025,103610,Mercier; Patrick Philip,9999,0,9999,0
1668365707640,ECE 200,026,103611,Meyer; Florian,9999,0,9999,0
1668365707640,ECE 200,027,103612,Milstein; Laurence B.,9999,0,9999,0
1668365707640,ECE 200,028,103613,Mir Arabbaygi; Siavash,9999,0,9999,0
1668365707640,ECE 200,029,103614,Mookherjea; Shayan,9999,0,9999,0
1668365707640,ECE 200,030,103615,Morris; Karcher William,9999,0,9999,0
1668365707640,ECE 200,031,103616,Ng; Tse Nga,9999,0,9999,0
1668365707640,ECE 200,032,103617,Nguyen; Truong Quang,9999,0,9999,0
1668365707640,ECE 200,033,103618,Nomura; Kenji,9999,0,9999,0
1668365707640,ECE 200,034,103619,Orlitsky; Alon,9999,0,9999,0
1668365707640,ECE 200,035,103620,Pal; Piya,9999,0,9999,0
1668365707640,ECE 200,036,103621,Papen; George C.,9999,0,9999,0
1668365707640,ECE 200,037,103622,Radic; Stojan,9999,0,9999,0
1668365707640,ECE 200,038,103623,Rao; Bhaskar D.,9999,0,9999,0
1668365707640,ECE 200,039,103624,Rao; Ramesh R,9999,0,9999,0
1668365707640,ECE 200,040,103625,Rebeiz; Gabriel,9999,0,9999,0
1668365707640,ECE 200,041,103626,Sanford; John R,9999,0,9999,0
1668365707640,ECE 200,042,103627,Siegel; Paul H.,9999,0,9999,0
1668365707640,ECE 200,043,103628,Sievenpiper; Daniel F.,9999,0,9999,0
1668365707640,ECE 200,044,103629,Sworder; David D.,9999,0,9999,0
1668365707640,ECE 200,045,103630,Taur; Yuan,9999,0,9999,0
1668365707640,ECE 200,046,103631,Touri; Behrouz,9999,0,9999,0
1668365707640,ECE 200,047,103632,Trivedi; Mohan M.,9999,0,9999,0
1668365707640,ECE 200,048,103633,Vasconcelos; Nuno,9999,0,9999,0
1668365707640,ECE 200,049,103634,Wang; Xiaolong,9999,0,9999,0
1668365707640,ECE 200,050,103635,Xie; Pengtao,9999,0,9999,0
1668365707640,ECE 200,051,103636,Yip; Michael,9999,0,9999,0
1668365707640,ECE 200,052,103637,Zeger; Kenneth A.,999,0,999,0
1668365707640,ECE 200,053,103638,Zhang; Xinyu,9999,0,9999,0
1668365707640,ECE 200,054,103639,Turakhia; Yatish Girish,9999,0,9999,0
1668365707640,ECE 200,055,103640,Kang; Mingu,9999,0,9999,0
1668365707640,ECE 200,056,103641,Shi; Yuanyuan,9999,0,9999,0
1668365707640,ECE 200,057,103642,Wang; Edward Jay,9999,0,9999,0
1668365707640,ECE 200,058,103643,Zheng; Yang,9999,0,9999,0
1668365708066,ECE 202,A00,103644,Kuzum; Duygu,0,0,0,0
1668365708489,ECE 212BN,A00,103646,Ng; Tse Nga,0,0,0,0
1668365708915,ECE 221,A00,111493,Staff,0,0,0,0
1668365709338,ECE 222B,A00,103647,Lomakin; Vitaliy,0,0,0,0
1668365709768,ECE 230B,A00,103648,Taur; Yuan,0,0,0,0
1668365710191,ECE 238B,A00,103649,Garay; Javier,0,0,0,0
1668365710615,ECE 240B,A00,112900,Fainman; Yeshaiahu,0,0,0,0
1668365711048,ECE 247A,A00,103650,Jokerst; Jesse Vincent,0,0,0,0
1668365711476,ECE 247B,A00,103651,Wang; Joseph,0,0,0,0
1668365711898,ECE 250,A00,103652,Siegel; Paul H.,0,0,0,0
1668365712322,ECE 251A,A00,103654,Rao; Bhaskar D.,0,0,0,0
1668365712748,ECE 257B,A00,103655,Bharadia; Dinesh,0,0,0,0
1668365713175,ECE 258A,A00,103656,Milstein; Laurence B.,0,0,0,0
1668365713598,ECE 260B,A00,103658,Kang; Mingu,0,0,0,0
1668365714021,ECE 264A,A00,103659,Galton; Ian A,0,0,0,0
1668365714445,ECE 265A,A00,103661,Gudem; Prasad S.S.,0,0,0,0
1668365714875,ECE 265D,A00,103662,Gudem; Prasad S.S.,0,0,0,0
1668365715301,ECE 268,A00,103663,Koushanfar; Farinaz,0,0,0,0
1668365715728,ECE 269,A01,103665,Pal; Piya,0,0,0,0
1668365716150,ECE 271B,A00,103666,Vasconcelos; Manuela,0,0,0,0
1668365716584,ECE 276A,A00,103667,Atanasov; Nikolay A.,0,0,0,0
1668365717008,ECE 277,A00,103668,An; Cheolhong,0,0,0,0
1668365717441,ECE 279,A00,117947,Hall; Drew A.,0,0,0,0
1668365718288,ECE 283,A00,103670,Hsueh; Tzu-Chien,0,0,0,0
1668365718713,ECE 284,A00,103671,Turakhia; Yatish Girish,0,0,0,0
1668365719138,ECE 285,A00,103672,Zheng; Yang,0,0,0,0
1668365719138,ECE 285,B00,103673,Sworder; David D.,0,0,0,0
1668365719564,ECE 287,A00,103676,Javidi; Tara,0,0,0,0
1668365719990,MATH 200B,A00,098023,Salehi Golsefidy; Alireza,12,0,15,3
1668365720413,MATH 202B,A00,098024,Rhoades; Brendon Patrick,9,0,15,6
1668365720848,MATH 203B,A00,098025,Oprea; Dragos N.,10,0,15,5
1668365721281,MATH 204B,A00,098026,Sorensen; Claus M,13,0,15,2
1668365721711,MATH 208,A00,098027,Izadi; Elham,7,0,10,3
1668365722143,MATH 209,A00,098028,Pollack; Aaron,10,0,10,0
1668365722567,MATH 211A,A00,112919,Rogalski; Daniel,9,0,10,1
1668365723001,MATH 211B,A00,112920,Seward; Brandon M.,9,0,10,1
1668365723427,MATH 218,A00,098029,Li; Bo,10,0,10,0
1668365723857,MATH 220B,A00,098030,Novak; Jonathan I,11,0,15,4
1668365724285,MATH 221A,A00,098031,Ebenfelt; Peter F,13,0,15,2
1668365724712,MATH 231B,A00,098032,Zlatos; Andrej,12,0,15,3
1668365725137,MATH 240B,A00,098033,Ni; Lei,9,0,15,6
1668365725562,MATH 243,A00,098034,Jekel; David Andrew,10,0,10,0
1668365725987,MATH 245A,A00,098035,Nie; Jiawang,0,0,15,16
1668365726415,MATH 248,A00,098036,Bejenaru; Ioan,10,0,10,0
1668365726838,MATH 250B,A00,098037,Spolaor; Luca,14,0,15,1
1668365727261,MATH 258,A00,098038,Ni; Lei,10,0,10,0
1668365727687,MATH 264B,A00,098041,Rhoades; Brendon Patrick,9,0,15,6
1668365728113,MATH 268,A00,098042,Buss; Samuel R,10,0,10,0
1668365728538,MATH 269,A00,098043,Rhoades; Brendon Patrick,10,0,10,0
1668365728964,MATH 270B,A00,098044,Li; Bo,10,0,15,5
1668365729394,MATH 272B,A00,098045,Holst; Michael J,13,0,15,2
1668365729826,MATH 273A,A00,098046,Tian; Xiaochuan,10,0,15,5
1668365730260,MATH 275,A01,098048,Tian; Xiaochuan,6,0,10,4
1668365730697,MATH 278A,A00,098049,Holst; Michael J,8,0,10,2
1668365731133,MATH 278B,A00,098050,Cloninger; Alexander,10,0,10,0
1668365731566,MATH 278C,A00,098051,Nie; Jiawang,7,0,10,3
1668365731990,MATH 280B,A00,098052,Zheng; Tianyi,8,0,15,7
1668365732504,MATH 281B,A00,098053,Bradic; Jelena,1,0,15,14
1668365732930,MATH 282B,A00,098054,Arias-Castro; Ery,0,0,15,15
1668365733368,MATH 285,A00,098055,Fitzsimmons; Patrick J,0,0,15,17
1668365733806,MATH 287B,A00,098056,Arias-Castro; Ery,2,0,15,13
1668365734231,MATH 288,A00,098057,Agarwal; Pooja,9,0,10,1
1668365734231,MATH 288,B00,098058,Zhang; Danna,8,0,10,2
1668365734231,MATH 288,C00,098059,Williams; Ruth J,9,0,10,1
1668365734663,MATH 290B,A00,098060,Roberts; Justin Deritter,13,0,15,2
1668365735088,MATH 292,A00,098061,Belmont; Eva Kinoshita,10,0,10,0
1668365735512,MATH 295,A00,098062,Suk; Andrew Hoon,48,0,50,2
1668365735935,MATH 296,A00,098063,Novak; Jonathan I,20,0,20,0
1668365736358,MATH 297,001,098064,Gamst; Anthony Collins,9997,0,9999,2
1668366239104,COGS 205,A00,101395,Chiba; Andrea,19,0,20,1
1668366239528,COGS 210B,001,101404,Greene; Deanna Jacquelyn,9998,0,9999,1
1668366239528,COGS 210B,002,101417,Xia; Haijun,9999,0,9999,0
1668366239528,COGS 210B,003,101422,Nitz; Douglas A.,9999,0,9999,0
1668366239528,COGS 210B,004,101423,Hollan; James D.,9998,0,9999,1
1668366239528,COGS 210B,005,101424,Deak; Gedeon O.,9998,0,9999,1
1668366239528,COGS 210B,006,101425,Rossano; Federico,9999,0,9999,0
1668366239955,COGS 211B,A00,101427,Coulson; Seana M,9996,0,9999,3
1668366240379,COGS 220,A00,101428,Hollan; James D.,0,0,25,25
1668366240803,COGS 229,A00,101429,Dow; Steven P,18,0,25,7
1668366241226,COGS 230,A00,101430,Klemmer; Scott R,11,0,17,6
1668366241648,COGS 234,A00,101431,Xia; Haijun,1,0,25,24
1668366242083,COGS 260,A00,101432,Kiyonaga; Anastasia,21,0,25,4
1668366242083,COGS 260,B00,101433,Kirsh; David Joel,15,0,25,10
1668366242506,CSE 202,A00,102371,Impagliazzo; Russell,0,0,0,0
1668366242932,CSE 203B,A01,102373,Cheng; Chung Kuan,0,0,0,0
1668366243355,CSE 208,A00,102374,Micciancio; Daniele,0,0,0,0
1668366243781,CSE 209A,A00,112895,Impagliazzo; Russell,0,0,15,15
1668366244205,CSE 209B,A00,108005,Bellare; Mihir,0,0,0,0
1668366244630,CSE 210,A00,113163,Coblenz; Michael J,0,0,0,0
1668366245059,CSE 219,A00,106111,Dow; Steven P,0,0,20,20
1668366245484,CSE 221,A00,102376,Voelker; Geoffrey M.,0,0,0,0
1668366245906,CSE 224,A01,102378,Porter; George M,0,0,0,0
1668366246332,CSE 229A,A00,102379,Savage; Stefan,0,0,0,0
1668366246772,CSE 229C,A00,102380,Munyaka; Imani N. S.,0,0,0,0
1668366247196,CSE 232B,A00,102382,Deutsch; Alin Bernard,0,0,0,0
1668366247622,CSE 234,A01,112904,Kumar; Arun Kumar,0,0,0,0
1668366248045,CSE 237A,A00,102383,Rosing; Tajana Simunic,0,0,0,0
1668366248485,CSE 239A,A00,102384,Deutsch; Alin Bernard,0,0,0,0
1668366248911,CSE 239B,A00,102385,Polikarpova; Nadezhda,0,0,0,0
1668366249334,CSE 240A,A00,102386,Pannuto; Patrick William,0,0,0,0
1668366249763,CSE 240B,A00,102387,Zhao; Jishen,0,0,0,0
1668366250191,CSE 241A,A00,106406,Kang; Mingu,0,0,0,0
1668366250613,CSE 249B,A00,102388,Kahng; Andrew Byun,0,0,8,8
1668366251037,CSE 251B,A01,102392,Cottrell; Garrison W,0,0,0,0
1668366251037,CSE 251B,A02,102393,Cottrell; Garrison W,0,0,0,0
1668366251463,CSE 252B,A00,102394,Ochoa; Benjamin Lawrence,0,0,0,0
1668366251884,CSE 257,A01,102396,Gao; Sicun,0,0,0,0
1668366252322,CSE 272,A00,102397,Li; Tzumao,0,0,0,0
1668366252747,CSE 274,A00,111323,Chern; Albert Ren-Haur,0,0,0,0
1668366253170,CSE 282,A00,102398,Pevzner; Pavel Arkadjevich,0,0,0,0
1668366253594,CSE 284,A00,114175,Gymrek; Melissa Ann,0,0,0,0
1668366254028,CSE 290,A00,102399,Chandraker; Manmohan Krishna,0,0,0,0
1668366254028,CSE 290,B00,102400,Vaccaro; Kristen Marie,0,0,25,25
1668366254028,CSE 290,C00,102414,Pannuto; Patrick William,0,0,25,25
1668366254028,CSE 290,D00,102427,Pevzner; Pavel Arkadjevich,0,0,0,0
1668366254028,CSE 290,E00,102429,Zhao; Jishen,0,0,0,0
1668366254028,CSE 290,F00,102436,Tullsen; Dean Michael,0,0,0,0
1668366254028,CSE 290,G00,102440,Christensen; Henrik I,0,0,20,20
1668366254457,CSE 291,A00,102443,Su; Hao,0,0,0,0
1668366254457,CSE 291,B00,102448,Polikarpova; Nadezhda,0,0,0,0
1668366254457,CSE 291,C00,102453,Vaccaro; Kristen Marie,0,0,0,0
1668366254457,CSE 291,D00,111343,Savage; Stefan,0,0,0,0
1668366254457,CSE 291,E00,116474,Claffy; Kimberly Claire,0,0,0,0
1668366254457,CSE 291,F00,116479,Pasquale; Joseph,0,0,0,0
1668366254930,CSE 293,001,119111,Bafna; Vineet,9999,0,9999,0
1668366254930,CSE 293,002,119118,Bellare; Mihir,9999,0,9999,0
1668366254930,CSE 293,003,119122,Berg-Kirkpatrick; Taylor D,9999,0,9999,0
1668366254930,CSE 293,004,119135,Christensen; Henrik I,9999,0,9999,0
1668366254930,CSE 293,005,119142,Cottrell; Garrison W,9999,0,9999,0
1668366254930,CSE 293,006,119146,Deutsch; Alin Bernard,9999,0,9999,0
1668366254930,CSE 293,007,119159,Esmaeilzadeh; Hadi,9999,0,9999,0
1668366254930,CSE 293,008,119166,Freund; Yoav,9999,0,9999,0
1668366254930,CSE 293,009,119170,Griswold; William G.,9999,0,9999,0
1668366254930,CSE 293,010,119183,Gymrek; Melissa Ann,9999,0,9999,0
1668366254930,CSE 293,011,119190,Heninger; Nadia A,9999,0,9999,0
1668366254930,CSE 293,012,119230,Impagliazzo; Russell,9999,0,9999,0
1668366254930,CSE 293,013,119232,Jhala; Ranjit,9999,0,9999,0
1668366254930,CSE 293,014,119233,Kahng; Andrew Byun,9999,0,9999,0
1668366254930,CSE 293,015,119298,Kane; Daniel Mertz,9999,0,9999,0
1668366254930,CSE 293,016,119299,Kriegman; David J,9999,0,9999,0
1668366254930,CSE 293,017,119300,Kumar; Arun Kumar,9999,0,9999,0
1668366254930,CSE 293,018,119301,Lerner; Sorin,9999,0,9999,0
1668366254930,CSE 293,019,119302,Lovett; Shachar,9999,0,9999,0
1668366254930,CSE 293,020,119303,McAuley; Julian John,9999,0,9999,0
1668366254930,CSE 293,021,119304,Micciancio; Daniele,9999,0,9999,0
1668366254930,CSE 293,022,119367,Orailoglu; Alex,9999,0,9999,0
1668366254930,CSE 293,023,119382,Paturi; Ramamohan,9999,0,9999,0
1668366254930,CSE 293,024,119404,Polikarpova; Nadezhda,9999,0,9999,0
1668366254930,CSE 293,025,119406,Politz; Joseph Gibbs,9999,0,9999,0
1668366254930,CSE 293,026,119411,Porter; George M,9999,0,9999,0
1668366254930,CSE 293,027,119414,Porter; Leonard Emerson,9999,0,9999,0
1668366254930,CSE 293,028,119416,Ramamoorthi; Ravi,9999,0,9999,0
1668366254930,CSE 293,029,119417,Sahoo; Debashis,9999,0,9999,0
1668366254930,CSE 293,030,119420,Saul; Lawrence,9999,0,9999,0
1668366254930,CSE 293,031,119421,Savage; Stefan,9999,0,9999,0
1668366254930,CSE 293,032,119425,Schulze; Jurgen P.,9999,0,9999,0
1668366254930,CSE 293,033,119426,Snoeren; Alex C.,9999,0,9999,0
1668366254930,CSE 293,034,119428,Shang; Jingbo,9999,0,9999,0
1668366254930,CSE 293,035,119430,Stefan; Deian,9999,0,9999,0
1668366254930,CSE 293,036,119431,Su; Hao,9999,0,9999,0
1668366254930,CSE 293,037,119433,Swanson; Steven James,9999,0,9999,0
1668366254930,CSE 293,038,119435,Tullsen; Dean Michael,9999,0,9999,0
1668366254930,CSE 293,039,119483,Voelker; Geoffrey M.,9999,0,9999,0
1668366254930,CSE 293,040,119537,Zhao; Jishen,9999,0,9999,0
1668366254930,CSE 293,041,119538,Zhou; Yuan-Yuan,9999,0,9999,0
1668366254930,CSE 293,042,119539,Gao; Sicun,9999,0,9999,0
1668366254930,CSE 293,043,119540,Weibel; Nadir,9999,0,9999,0
1668366254930,CSE 293,044,119541,Gupta; Rajesh K.,9999,0,9999,0
1668366254930,CSE 293,045,126410,Vaccaro; Kristen Marie,9999,0,9999,0
1668366254930,CSE 293,046,126411,Klemke; Richard,9999,0,9999,0
1668366255437,CSE 294,A00,102459,Voelker; Geoffrey M.,0,0,0,0
1668366255437,CSE 294,B00,111322,Orailoglu; Alex,0,0,0,0
1668366255868,DSE 201,A00,096914,Deutsch; Alin Bernard,30,0,30,0
1668366256292,DSE 210,A00,096915,Dasgupta; Sanjoy,30,0,30,0
1668366256775,DSE 260A,A00,096916,Altintas De Callaf; Ilkay,30,0,30,0
1668366257245,ECE 200,001,103586,Antipa; Nicholas A,9999,0,9999,0
1668366257245,ECE 200,002,103587,Atanasov; Nikolay A.,9999,0,9999,0
1668366257245,ECE 200,003,103588,Bharadia; Dinesh,9999,0,9999,0
1668366257245,ECE 200,004,103589,Cheng; Chung Kuan,9999,0,9999,0
1668366257245,ECE 200,005,103590,Cosman; Pamela C.,9999,0,9999,0
1668366257245,ECE 200,006,103591,Dayeh; Shadi Ahmad,9999,0,9999,0
1668366257245,ECE 200,007,103592,Fainman; Yeshaiahu,9999,0,9999,0
1668366257245,ECE 200,008,103593,Ford; Joseph Earl,9999,0,9999,0
1668366257245,ECE 200,009,103594,Franceschetti; Massimo,9999,0,9999,0
1668366257245,ECE 200,010,103595,Fullerton; Eric E,9999,0,9999,0
1668366257245,ECE 200,011,103596,Galton; Ian A,9999,0,9999,0
1668366257245,ECE 200,012,103597,Gilja; Vikash,9999,0,9999,0
1668366257245,ECE 200,013,103598,Hall; Drew A.,9999,0,9999,0
1668366257245,ECE 200,014,103599,Hsueh; Tzu-Chien,9999,0,9999,0
1668366257245,ECE 200,015,103600,Javidi; Tara,9999,0,9999,0
1668366257245,ECE 200,016,103601,Kahng; Andrew Byun,9999,0,9999,0
1668366257245,ECE 200,017,103602,Kim; Young-Han,9999,0,9999,0
1668366257245,ECE 200,018,103603,Koushanfar; Farinaz,9999,0,9999,0
1668366257245,ECE 200,019,103604,Kuzum; Duygu,9999,0,9999,0
1668366257245,ECE 200,020,103605,Le; Hanh-Phuc,9999,0,9999,0
1668366257245,ECE 200,021,103606,Lin; Bill,9999,0,9999,0
1668366257245,ECE 200,022,103607,Liu; Zhaowei,9998,0,9999,1
1668366257245,ECE 200,023,103608,Lo; Yu-Hwa,9999,0,9999,0
1668366257245,ECE 200,024,103609,Lomakin; Vitaliy,9999,0,9999,0
1668366257245,ECE 200,025,103610,Mercier; Patrick Philip,9999,0,9999,0
1668366257245,ECE 200,026,103611,Meyer; Florian,9999,0,9999,0
1668366257245,ECE 200,027,103612,Milstein; Laurence B.,9999,0,9999,0
1668366257245,ECE 200,028,103613,Mir Arabbaygi; Siavash,9999,0,9999,0
1668366257245,ECE 200,029,103614,Mookherjea; Shayan,9999,0,9999,0
1668366257245,ECE 200,030,103615,Morris; Karcher William,9999,0,9999,0
1668366257245,ECE 200,031,103616,Ng; Tse Nga,9999,0,9999,0
1668366257245,ECE 200,032,103617,Nguyen; Truong Quang,9999,0,9999,0
1668366257245,ECE 200,033,103618,Nomura; Kenji,9999,0,9999,0
1668366257245,ECE 200,034,103619,Orlitsky; Alon,9999,0,9999,0
1668366257245,ECE 200,035,103620,Pal; Piya,9999,0,9999,0
1668366257245,ECE 200,036,103621,Papen; George C.,9999,0,9999,0
1668366257245,ECE 200,037,103622,Radic; Stojan,9999,0,9999,0
1668366257245,ECE 200,038,103623,Rao; Bhaskar D.,9999,0,9999,0
1668366257245,ECE 200,039,103624,Rao; Ramesh R,9999,0,9999,0
1668366257245,ECE 200,040,103625,Rebeiz; Gabriel,9999,0,9999,0
1668366257245,ECE 200,041,103626,Sanford; John R,9999,0,9999,0
1668366257245,ECE 200,042,103627,Siegel; Paul H.,9999,0,9999,0
1668366257245,ECE 200,043,103628,Sievenpiper; Daniel F.,9999,0,9999,0
1668366257245,ECE 200,044,103629,Sworder; David D.,9999,0,9999,0
1668366257245,ECE 200,045,103630,Taur; Yuan,9999,0,9999,0
1668366257245,ECE 200,046,103631,Touri; Behrouz,9999,0,9999,0
1668366257245,ECE 200,047,103632,Trivedi; Mohan M.,9999,0,9999,0
1668366257245,ECE 200,048,103633,Vasconcelos; Nuno,9999,0,9999,0
1668366257245,ECE 200,049,103634,Wang; Xiaolong,9999,0,9999,0
1668366257245,ECE 200,050,103635,Xie; Pengtao,9999,0,9999,0
1668366257245,ECE 200,051,103636,Yip; Michael,9999,0,9999,0
1668366257245,ECE 200,052,103637,Zeger; Kenneth A.,999,0,999,0
1668366257245,ECE 200,053,103638,Zhang; Xinyu,9999,0,9999,0
1668366257245,ECE 200,054,103639,Turakhia; Yatish Girish,9999,0,9999,0
1668366257245,ECE 200,055,103640,Kang; Mingu,9999,0,9999,0
1668366257245,ECE 200,056,103641,Shi; Yuanyuan,9999,0,9999,0
1668366257245,ECE 200,057,103642,Wang; Edward Jay,9999,0,9999,0
1668366257245,ECE 200,058,103643,Zheng; Yang,9999,0,9999,0
1668366257673,ECE 202,A00,103644,Kuzum; Duygu,0,0,0,0
1668366258100,ECE 212BN,A00,103646,Ng; Tse Nga,0,0,0,0
1668366258524,ECE 221,A00,111493,Staff,0,0,0,0
1668366258946,ECE 222B,A00,103647,Lomakin; Vitaliy,0,0,0,0
1668366259371,ECE 230B,A00,103648,Taur; Yuan,0,0,0,0
1668366259798,ECE 238B,A00,103649,Garay; Javier,0,0,0,0
1668366260222,ECE 240B,A00,112900,Fainman; Yeshaiahu,0,0,0,0
1668366260652,ECE 247A,A00,103650,Jokerst; Jesse Vincent,0,0,0,0
1668366261079,ECE 247B,A00,103651,Wang; Joseph,0,0,0,0
1668366261502,ECE 250,A00,103652,Siegel; Paul H.,0,0,0,0
1668366261928,ECE 251A,A00,103654,Rao; Bhaskar D.,0,0,0,0
1668366262357,ECE 257B,A00,103655,Bharadia; Dinesh,0,0,0,0
1668366262792,ECE 258A,A00,103656,Milstein; Laurence B.,0,0,0,0
1668366263217,ECE 260B,A00,103658,Kang; Mingu,0,0,0,0
1668366263644,ECE 264A,A00,103659,Galton; Ian A,0,0,0,0
1668366264068,ECE 265A,A00,103661,Gudem; Prasad S.S.,0,0,0,0
1668366264495,ECE 265D,A00,103662,Gudem; Prasad S.S.,0,0,0,0
1668366264923,ECE 268,A00,103663,Koushanfar; Farinaz,0,0,0,0
1668366265350,ECE 269,A01,103665,Pal; Piya,0,0,0,0
1668366265774,ECE 271B,A00,103666,Vasconcelos; Manuela,0,0,0,0
1668366266198,ECE 276A,A00,103667,Atanasov; Nikolay A.,0,0,0,0
1668366266634,ECE 277,A00,103668,An; Cheolhong,0,0,0,0
1668366267057,ECE 279,A00,117947,Hall; Drew A.,0,0,0,0
1668366267913,ECE 283,A00,103670,Hsueh; Tzu-Chien,0,0,0,0
1668366268339,ECE 284,A00,103671,Turakhia; Yatish Girish,0,0,0,0
1668366268767,ECE 285,A00,103672,Zheng; Yang,0,0,0,0
1668366268767,ECE 285,B00,103673,Sworder; David D.,0,0,0,0
1668366269191,ECE 287,A00,103676,Javidi; Tara,0,0,0,0
1668366269618,MATH 200B,A00,098023,Salehi Golsefidy; Alireza,12,0,15,3
1668366270055,MATH 202B,A00,098024,Rhoades; Brendon Patrick,9,0,15,6
1668366270497,MATH 203B,A00,098025,Oprea; Dragos N.,10,0,15,5
1668366270922,MATH 204B,A00,098026,Sorensen; Claus M,13,0,15,2
1668366271348,MATH 208,A00,098027,Izadi; Elham,7,0,10,3
1668366271774,MATH 209,A00,098028,Pollack; Aaron,10,0,10,0
1668366272195,MATH 211A,A00,112919,Rogalski; Daniel,9,0,10,1
1668366272618,MATH 211B,A00,112920,Seward; Brandon M.,9,0,10,1
1668366273052,MATH 218,A00,098029,Li; Bo,10,0,10,0
1668366273486,MATH 220B,A00,098030,Novak; Jonathan I,11,0,15,4
1668366273910,MATH 221A,A00,098031,Ebenfelt; Peter F,13,0,15,2
1668366274336,MATH 231B,A00,098032,Zlatos; Andrej,12,0,15,3
1668366274773,MATH 240B,A00,098033,Ni; Lei,9,0,15,6
1668366275204,MATH 243,A00,098034,Jekel; David Andrew,10,0,10,0
1668366275629,MATH 245A,A00,098035,Nie; Jiawang,0,0,15,16
1668366276052,MATH 248,A00,098036,Bejenaru; Ioan,10,0,10,0
1668366276482,MATH 250B,A00,098037,Spolaor; Luca,14,0,15,1
1668366276907,MATH 258,A00,098038,Ni; Lei,10,0,10,0
1668366277335,MATH 264B,A00,098041,Rhoades; Brendon Patrick,9,0,15,6
1668366277765,MATH 268,A00,098042,Buss; Samuel R,10,0,10,0
1668366278191,MATH 269,A00,098043,Rhoades; Brendon Patrick,10,0,10,0
1668366278621,MATH 270B,A00,098044,Li; Bo,10,0,15,5
1668366279053,MATH 272B,A00,098045,Holst; Michael J,13,0,15,2
1668366279479,MATH 273A,A00,098046,Tian; Xiaochuan,10,0,15,5
1668366279903,MATH 275,A01,098048,Tian; Xiaochuan,6,0,10,4
1668366280329,MATH 278A,A00,098049,Holst; Michael J,8,0,10,2
1668366280761,MATH 278B,A00,098050,Cloninger; Alexander,10,0,10,0
1668366281200,MATH 278C,A00,098051,Nie; Jiawang,7,0,10,3
1668366281628,MATH 280B,A00,098052,Zheng; Tianyi,8,0,15,7
1668366282050,MATH 281B,A00,098053,Bradic; Jelena,1,0,15,14
1668366282476,MATH 282B,A00,098054,Arias-Castro; Ery,0,0,15,15
1668366282899,MATH 285,A00,098055,Fitzsimmons; Patrick J,0,0,15,17
1668366283327,MATH 287B,A00,098056,Arias-Castro; Ery,2,0,15,13
1668366283752,MATH 288,A00,098057,Agarwal; Pooja,9,0,10,1
1668366283752,MATH 288,B00,098058,Zhang; Danna,8,0,10,2
1668366283752,MATH 288,C00,098059,Williams; Ruth J,9,0,10,1
1668366284174,MATH 290B,A00,098060,Roberts; Justin Deritter,13,0,15,2
1668366284601,MATH 292,A00,098061,Belmont; Eva Kinoshita,10,0,10,0
1668366285025,MATH 295,A00,098062,Suk; Andrew Hoon,48,0,50,2
1668366285455,MATH 296,A00,098063,Novak; Jonathan I,20,0,20,0
1668366285878,MATH 297,001,098064,Gamst; Anthony Collins,9997,0,9999,2
1668366786944,COGS 205,A00,101395,Chiba; Andrea,19,0,20,1
1668366787372,COGS 210B,001,101404,Greene; Deanna Jacquelyn,9998,0,9999,1
1668366787372,COGS 210B,002,101417,Xia; Haijun,9999,0,9999,0
1668366787372,COGS 210B,003,101422,Nitz; Douglas A.,9999,0,9999,0
1668366787372,COGS 210B,004,101423,Hollan; James D.,9998,0,9999,1
1668366787372,COGS 210B,005,101424,Deak; Gedeon O.,9998,0,9999,1
1668366787372,COGS 210B,006,101425,Rossano; Federico,9999,0,9999,0
1668366787799,COGS 211B,A00,101427,Coulson; Seana M,9996,0,9999,3
1668366788222,COGS 220,A00,101428,Hollan; James D.,0,0,25,25
1668366788649,COGS 229,A00,101429,Dow; Steven P,18,0,25,7
1668366789074,COGS 230,A00,101430,Klemmer; Scott R,11,0,17,6
1668366789497,COGS 234,A00,101431,Xia; Haijun,1,0,25,24
1668366789922,COGS 260,A00,101432,Kiyonaga; Anastasia,21,0,25,4
1668366789922,COGS 260,B00,101433,Kirsh; David Joel,15,0,25,10
1668366790350,CSE 202,A00,102371,Impagliazzo; Russell,0,0,0,0
1668366790776,CSE 203B,A01,102373,Cheng; Chung Kuan,0,0,0,0
1668366791201,CSE 208,A00,102374,Micciancio; Daniele,0,0,0,0
1668366791624,CSE 209A,A00,112895,Impagliazzo; Russell,0,0,15,15
1668366792047,CSE 209B,A00,108005,Bellare; Mihir,0,0,0,0
1668366792484,CSE 210,A00,113163,Coblenz; Michael J,0,0,0,0
1668366792908,CSE 219,A00,106111,Dow; Steven P,0,0,20,20
1668366793337,CSE 221,A00,102376,Voelker; Geoffrey M.,0,0,0,0
1668366793760,CSE 224,A01,102378,Porter; George M,0,0,0,0
1668366794188,CSE 229A,A00,102379,Savage; Stefan,0,0,0,0
1668366794615,CSE 229C,A00,102380,Munyaka; Imani N. S.,0,0,0,0
1668366795038,CSE 232B,A00,102382,Deutsch; Alin Bernard,0,0,0,0
1668366795466,CSE 234,A01,112904,Kumar; Arun Kumar,0,0,0,0
1668366795891,CSE 237A,A00,102383,Rosing; Tajana Simunic,0,0,0,0
1668366796314,CSE 239A,A00,102384,Deutsch; Alin Bernard,0,0,0,0
1668366796739,CSE 239B,A00,102385,Polikarpova; Nadezhda,0,0,0,0
1668366797162,CSE 240A,A00,102386,Pannuto; Patrick William,0,0,0,0
1668366797593,CSE 240B,A00,102387,Zhao; Jishen,0,0,0,0
1668366798020,CSE 241A,A00,106406,Kang; Mingu,0,0,0,0
1668366798444,CSE 249B,A00,102388,Kahng; Andrew Byun,0,0,8,8
1668366798878,CSE 251B,A01,102392,Cottrell; Garrison W,0,0,0,0
1668366798878,CSE 251B,A02,102393,Cottrell; Garrison W,0,0,0,0
1668366799314,CSE 252B,A00,102394,Ochoa; Benjamin Lawrence,0,0,0,0
1668366799744,CSE 257,A01,102396,Gao; Sicun,0,0,0,0
1668366800168,CSE 272,A00,102397,Li; Tzumao,0,0,0,0
1668366800593,CSE 274,A00,111323,Chern; Albert Ren-Haur,0,0,0,0
1668366801017,CSE 282,A00,102398,Pevzner; Pavel Arkadjevich,0,0,0,0
1668366801440,CSE 284,A00,114175,Gymrek; Melissa Ann,0,0,0,0
1668366801862,CSE 290,A00,102399,Chandraker; Manmohan Krishna,0,0,0,0
1668366801862,CSE 290,B00,102400,Vaccaro; Kristen Marie,0,0,25,25
1668366801862,CSE 290,C00,102414,Pannuto; Patrick William,0,0,25,25
1668366801862,CSE 290,D00,102427,Pevzner; Pavel Arkadjevich,0,0,0,0
1668366801862,CSE 290,E00,102429,Zhao; Jishen,0,0,0,0
1668366801862,CSE 290,F00,102436,Tullsen; Dean Michael,0,0,0,0
1668366801862,CSE 290,G00,102440,Christensen; Henrik I,0,0,20,20
1668366802291,CSE 291,A00,102443,Su; Hao,0,0,0,0
1668366802291,CSE 291,B00,102448,Polikarpova; Nadezhda,0,0,0,0
1668366802291,CSE 291,C00,102453,Vaccaro; Kristen Marie,0,0,0,0
1668366802291,CSE 291,D00,111343,Savage; Stefan,0,0,0,0
1668366802291,CSE 291,E00,116474,Claffy; Kimberly Claire,0,0,0,0
1668366802291,CSE 291,F00,116479,Pasquale; Joseph,0,0,0,0
1668366802717,CSE 293,001,119111,Bafna; Vineet,9999,0,9999,0
1668366802717,CSE 293,002,119118,Bellare; Mihir,9999,0,9999,0
1668366802717,CSE 293,003,119122,Berg-Kirkpatrick; Taylor D,9999,0,9999,0
1668366802717,CSE 293,004,119135,Christensen; Henrik I,9999,0,9999,0
1668366802717,CSE 293,005,119142,Cottrell; Garrison W,9999,0,9999,0
1668366802717,CSE 293,006,119146,Deutsch; Alin Bernard,9999,0,9999,0
1668366802717,CSE 293,007,119159,Esmaeilzadeh; Hadi,9999,0,9999,0
1668366802717,CSE 293,008,119166,Freund; Yoav,9999,0,9999,0
1668366802717,CSE 293,009,119170,Griswold; William G.,9999,0,9999,0
1668366802717,CSE 293,010,119183,Gymrek; Melissa Ann,9999,0,9999,0
1668366802717,CSE 293,011,119190,Heninger; Nadia A,9999,0,9999,0
1668366802717,CSE 293,012,119230,Impagliazzo; Russell,9999,0,9999,0
1668366802717,CSE 293,013,119232,Jhala; Ranjit,9999,0,9999,0
1668366802717,CSE 293,014,119233,Kahng; Andrew Byun,9999,0,9999,0
1668366802717,CSE 293,015,119298,Kane; Daniel Mertz,9999,0,9999,0
1668366802717,CSE 293,016,119299,Kriegman; David J,9999,0,9999,0
1668366802717,CSE 293,017,119300,Kumar; Arun Kumar,9999,0,9999,0
1668366802717,CSE 293,018,119301,Lerner; Sorin,9999,0,9999,0
1668366802717,CSE 293,019,119302,Lovett; Shachar,9999,0,9999,0
1668366802717,CSE 293,020,119303,McAuley; Julian John,9999,0,9999,0
1668366802717,CSE 293,021,119304,Micciancio; Daniele,9999,0,9999,0
1668366802717,CSE 293,022,119367,Orailoglu; Alex,9999,0,9999,0
1668366802717,CSE 293,023,119382,Paturi; Ramamohan,9999,0,9999,0
1668366802717,CSE 293,024,119404,Polikarpova; Nadezhda,9999,0,9999,0
1668366802717,CSE 293,025,119406,Politz; Joseph Gibbs,9999,0,9999,0
1668366802717,CSE 293,026,119411,Porter; George M,9999,0,9999,0
1668366802717,CSE 293,027,119414,Porter; Leonard Emerson,9999,0,9999,0
1668366802717,CSE 293,028,119416,Ramamoorthi; Ravi,9999,0,9999,0
1668366802717,CSE 293,029,119417,Sahoo; Debashis,9999,0,9999,0
1668366802717,CSE 293,030,119420,Saul; Lawrence,9999,0,9999,0
1668366802717,CSE 293,031,119421,Savage; Stefan,9999,0,9999,0
1668366802717,CSE 293,032,119425,Schulze; Jurgen P.,9999,0,9999,0
1668366802717,CSE 293,033,119426,Snoeren; Alex C.,9999,0,9999,0
1668366802717,CSE 293,034,119428,Shang; Jingbo,9999,0,9999,0
1668366802717,CSE 293,035,119430,Stefan; Deian,9999,0,9999,0
1668366802717,CSE 293,036,119431,Su; Hao,9999,0,9999,0
1668366802717,CSE 293,037,119433,Swanson; Steven James,9999,0,9999,0
1668366802717,CSE 293,038,119435,Tullsen; Dean Michael,9999,0,9999,0
1668366802717,CSE 293,039,119483,Voelker; Geoffrey M.,9999,0,9999,0
1668366802717,CSE 293,040,119537,Zhao; Jishen,9999,0,9999,0
1668366802717,CSE 293,041,119538,Zhou; Yuan-Yuan,9999,0,9999,0
1668366802717,CSE 293,042,119539,Gao; Sicun,9999,0,9999,0
1668366802717,CSE 293,043,119540,Weibel; Nadir,9999,0,9999,0
1668366802717,CSE 293,044,119541,Gupta; Rajesh K.,9999,0,9999,0
1668366802717,CSE 293,045,126410,Vaccaro; Kristen Marie,9999,0,9999,0
1668366802717,CSE 293,046,126411,Klemke; Richard,9999,0,9999,0
1668366803140,CSE 294,A00,102459,Voelker; Geoffrey M.,0,0,0,0
1668366803140,CSE 294,B00,111322,Orailoglu; Alex,0,0,0,0
1668366803570,DSE 201,A00,096914,Deutsch; Alin Bernard,30,0,30,0
1668366803999,DSE 210,A00,096915,Dasgupta; Sanjoy,30,0,30,0
1668366804431,DSE 260A,A00,096916,Altintas De Callaf; Ilkay,30,0,30,0
1668366804865,ECE 200,001,103586,Antipa; Nicholas A,9999,0,9999,0
1668366804865,ECE 200,002,103587,Atanasov; Nikolay A.,9999,0,9999,0
1668366804865,ECE 200,003,103588,Bharadia; Dinesh,9999,0,9999,0
1668366804865,ECE 200,004,103589,Cheng; Chung Kuan,9999,0,9999,0
1668366804865,ECE 200,005,103590,Cosman; Pamela C.,9999,0,9999,0
1668366804865,ECE 200,006,103591,Dayeh; Shadi Ahmad,9999,0,9999,0
1668366804865,ECE 200,007,103592,Fainman; Yeshaiahu,9999,0,9999,0
1668366804865,ECE 200,008,103593,Ford; Joseph Earl,9999,0,9999,0
1668366804865,ECE 200,009,103594,Franceschetti; Massimo,9999,0,9999,0
1668366804865,ECE 200,010,103595,Fullerton; Eric E,9999,0,9999,0
1668366804865,ECE 200,011,103596,Galton; Ian A,9999,0,9999,0
1668366804865,ECE 200,012,103597,Gilja; Vikash,9999,0,9999,0
1668366804865,ECE 200,013,103598,Hall; Drew A.,9999,0,9999,0
1668366804865,ECE 200,014,103599,Hsueh; Tzu-Chien,9999,0,9999,0
1668366804865,ECE 200,015,103600,Javidi; Tara,9999,0,9999,0
1668366804865,ECE 200,016,103601,Kahng; Andrew Byun,9999,0,9999,0
1668366804865,ECE 200,017,103602,Kim; Young-Han,9999,0,9999,0
1668366804865,ECE 200,018,103603,Koushanfar; Farinaz,9999,0,9999,0
1668366804865,ECE 200,019,103604,Kuzum; Duygu,9999,0,9999,0
1668366804865,ECE 200,020,103605,Le; Hanh-Phuc,9999,0,9999,0
1668366804865,ECE 200,021,103606,Lin; Bill,9999,0,9999,0
1668366804865,ECE 200,022,103607,Liu; Zhaowei,9998,0,9999,1
1668366804865,ECE 200,023,103608,Lo; Yu-Hwa,9999,0,9999,0
1668366804865,ECE 200,024,103609,Lomakin; Vitaliy,9999,0,9999,0
1668366804865,ECE 200,025,103610,Mercier; Patrick Philip,9999,0,9999,0
1668366804865,ECE 200,026,103611,Meyer; Florian,9999,0,9999,0
1668366804865,ECE 200,027,103612,Milstein; Laurence B.,9999,0,9999,0
1668366804865,ECE 200,028,103613,Mir Arabbaygi; Siavash,9999,0,9999,0
1668366804865,ECE 200,029,103614,Mookherjea; Shayan,9999,0,9999,0
1668366804865,ECE 200,030,103615,Morris; Karcher William,9999,0,9999,0
1668366804865,ECE 200,031,103616,Ng; Tse Nga,9999,0,9999,0
1668366804865,ECE 200,032,103617,Nguyen; Truong Quang,9999,0,9999,0
1668366804865,ECE 200,033,103618,Nomura; Kenji,9999,0,9999,0
1668366804865,ECE 200,034,103619,Orlitsky; Alon,9999,0,9999,0
1668366804865,ECE 200,035,103620,Pal; Piya,9999,0,9999,0
1668366804865,ECE 200,036,103621,Papen; George C.,9999,0,9999,0
1668366804865,ECE 200,037,103622,Radic; Stojan,9999,0,9999,0
1668366804865,ECE 200,038,103623,Rao; Bhaskar D.,9999,0,9999,0
1668366804865,ECE 200,039,103624,Rao; Ramesh R,9999,0,9999,0
1668366804865,ECE 200,040,103625,Rebeiz; Gabriel,9999,0,9999,0
1668366804865,ECE 200,041,103626,Sanford; John R,9999,0,9999,0
1668366804865,ECE 200,042,103627,Siegel; Paul H.,9999,0,9999,0
1668366804865,ECE 200,043,103628,Sievenpiper; Daniel F.,9999,0,9999,0
1668366804865,ECE 200,044,103629,Sworder; David D.,9999,0,9999,0
1668366804865,ECE 200,045,103630,Taur; Yuan,9999,0,9999,0
1668366804865,ECE 200,046,103631,Touri; Behrouz,9999,0,9999,0
1668366804865,ECE 200,047,103632,Trivedi; Mohan M.,9999,0,9999,0
1668366804865,ECE 200,048,103633,Vasconcelos; Nuno,9999,0,9999,0
1668366804865,ECE 200,049,103634,Wang; Xiaolong,9999,0,9999,0
1668366804865,ECE 200,050,103635,Xie; Pengtao,9999,0,9999,0
1668366804865,ECE 200,051,103636,Yip; Michael,9999,0,9999,0
1668366804865,ECE 200,052,103637,Zeger; Kenneth A.,999,0,999,0
1668366804865,ECE 200,053,103638,Zhang; Xinyu,9999,0,9999,0
1668366804865,ECE 200,054,103639,Turakhia; Yatish Girish,9999,0,9999,0
1668366804865,ECE 200,055,103640,Kang; Mingu,9999,0,9999,0
1668366804865,ECE 200,056,103641,Shi; Yuanyuan,9999,0,9999,0
1668366804865,ECE 200,057,103642,Wang; Edward Jay,9999,0,9999,0
1668366804865,ECE 200,058,103643,Zheng; Yang,9999,0,9999,0
1668366805289,ECE 202,A00,103644,Kuzum; Duygu,0,0,0,0
1668366805714,ECE 212BN,A00,103646,Ng; Tse Nga,0,0,0,0
1668366806139,ECE 221,A00,111493,Staff,0,0,0,0
1668366806562,ECE 222B,A00,103647,Lomakin; Vitaliy,0,0,0,0
1668366806991,ECE 230B,A00,103648,Taur; Yuan,0,0,0,0
1668366807418,ECE 238B,A00,103649,Garay; Javier,0,0,0,0
1668366807843,ECE 240B,A00,112900,Fainman; Yeshaiahu,0,0,0,0
1668366808269,ECE 247A,A00,103650,Jokerst; Jesse Vincent,0,0,0,0
1668366808694,ECE 247B,A00,103651,Wang; Joseph,0,0,0,0
1668366809119,ECE 250,A00,103652,Siegel; Paul H.,0,0,0,0
1668366809543,ECE 251A,A00,103654,Rao; Bhaskar D.,0,0,0,0
1668366809969,ECE 257B,A00,103655,Bharadia; Dinesh,0,0,0,0
1668366810397,ECE 258A,A00,103656,Milstein; Laurence B.,0,0,0,0
1668366810820,ECE 260B,A00,103658,Kang; Mingu,0,0,0,0
1668366811248,ECE 264A,A00,103659,Galton; Ian A,0,0,0,0
1668366811674,ECE 265A,A00,103661,Gudem; Prasad S.S.,0,0,0,0
1668366812098,ECE 265D,A00,103662,Gudem; Prasad S.S.,0,0,0,0
1668366812528,ECE 268,A00,103663,Koushanfar; Farinaz,0,0,0,0
1668366812957,ECE 269,A01,103665,Pal; Piya,0,0,0,0
1668366813381,ECE 271B,A00,103666,Vasconcelos; Manuela,0,0,0,0
1668366813817,ECE 276A,A00,103667,Atanasov; Nikolay A.,0,0,0,0
1668366814243,ECE 277,A00,103668,An; Cheolhong,0,0,0,0
1668366814683,ECE 279,A00,117947,Hall; Drew A.,0,0,0,0
1668366815532,ECE 283,A00,103670,Hsueh; Tzu-Chien,0,0,0,0
1668366815958,ECE 284,A00,103671,Turakhia; Yatish Girish,0,0,0,0
1668366816396,ECE 285,A00,103672,Zheng; Yang,0,0,0,0
1668366816396,ECE 285,B00,103673,Sworder; David D.,0,0,0,0
1668366816821,ECE 287,A00,103676,Javidi; Tara,0,0,0,0
1668366817249,MATH 200B,A00,098023,Salehi Golsefidy; Alireza,12,0,15,3
1668366817681,MATH 202B,A00,098024,Rhoades; Brendon Patrick,9,0,15,6
1668366818109,MATH 203B,A00,098025,Oprea; Dragos N.,10,0,15,5
1668366818533,MATH 204B,A00,098026,Sorensen; Claus M,13,0,15,2
1668366818955,MATH 208,A00,098027,Izadi; Elham,7,0,10,3
1668366819381,MATH 209,A00,098028,Pollack; Aaron,10,0,10,0
1668366819894,MATH 211A,A00,112919,Rogalski; Daniel,9,0,10,1
1668366820319,MATH 211B,A00,112920,Seward; Brandon M.,9,0,10,1
1668366820745,MATH 218,A00,098029,Li; Bo,10,0,10,0
1668366821174,MATH 220B,A00,098030,Novak; Jonathan I,11,0,15,4
1668366821599,MATH 221A,A00,098031,Ebenfelt; Peter F,13,0,15,2
1668366822033,MATH 231B,A00,098032,Zlatos; Andrej,12,0,15,3
1668366822459,MATH 240B,A00,098033,Ni; Lei,9,0,15,6
1668366822885,MATH 243,A00,098034,Jekel; David Andrew,10,0,10,0
1668366823321,MATH 245A,A00,098035,Nie; Jiawang,0,0,15,16
1668366823745,MATH 248,A00,098036,Bejenaru; Ioan,10,0,10,0
1668366824173,MATH 250B,A00,098037,Spolaor; Luca,14,0,15,1
1668366824599,MATH 258,A00,098038,Ni; Lei,10,0,10,0
1668366825024,MATH 264B,A00,098041,Rhoades; Brendon Patrick,9,0,15,6
1668366825451,MATH 268,A00,098042,Buss; Samuel R,10,0,10,0
1668366825888,MATH 269,A00,098043,Rhoades; Brendon Patrick,10,0,10,0
1668366826323,MATH 270B,A00,098044,Li; Bo,10,0,15,5
1668366826747,MATH 272B,A00,098045,Holst; Michael J,13,0,15,2
1668366827174,MATH 273A,A00,098046,Tian; Xiaochuan,10,0,15,5
1668366827604,MATH 275,A01,098048,Tian; Xiaochuan,6,0,10,4
1668366828028,MATH 278A,A00,098049,Holst; Michael J,8,0,10,2
1668366828452,MATH 278B,A00,098050,Cloninger; Alexander,10,0,10,0
1668366828876,MATH 278C,A00,098051,Nie; Jiawang,7,0,10,3
1668366829298,MATH 280B,A00,098052,Zheng; Tianyi,8,0,15,7
1668366829729,MATH 281B,A00,098053,Bradic; Jelena,1,0,15,14
1668366830152,MATH 282B,A00,098054,Arias-Castro; Ery,0,0,15,15
1668366830588,MATH 285,A00,098055,Fitzsimmons; Patrick J,0,0,15,17
1668366831015,MATH 287B,A00,098056,Arias-Castro; Ery,2,0,15,13
1668366831446,MATH 288,A00,098057,Agarwal; Pooja,9,0,10,1
1668366831446,MATH 288,B00,098058,Zhang; Danna,8,0,10,2
1668366831446,MATH 288,C00,098059,Williams; Ruth J,9,0,10,1
1668366831872,MATH 290B,A00,098060,Roberts; Justin Deritter,13,0,15,2
1668366832302,MATH 292,A00,098061,Belmont; Eva Kinoshita,10,0,10,0
1668366832738,MATH 295,A00,098062,Suk; Andrew Hoon,48,0,50,2
1668366833164,MATH 296,A00,098063,Novak; Jonathan I,20,0,20,0
1668366833587,MATH 297,001,098064,Gamst; Anthony Collins,9997,0,9999,2
1668367347031,COGS 205,A00,101395,Chiba; Andrea,19,0,20,1
1668367347463,COGS 210B,001,101404,Greene; Deanna Jacquelyn,9998,0,9999,1
1668367347463,COGS 210B,002,101417,Xia; Haijun,9999,0,9999,0
1668367347463,COGS 210B,003,101422,Nitz; Douglas A.,9999,0,9999,0
1668367347463,COGS 210B,004,101423,Hollan; James D.,9998,0,9999,1
1668367347463,COGS 210B,005,101424,Deak; Gedeon O.,9998,0,9999,1
1668367347463,COGS 210B,006,101425,Rossano; Federico,9999,0,9999,0
1668367347888,COGS 211B,A00,101427,Coulson; Seana M,9996,0,9999,3
1668367348311,COGS 220,A00,101428,Hollan; James D.,0,0,25,25
1668367348738,COGS 229,A00,101429,Dow; Steven P,18,0,25,7
1668367349161,COGS 230,A00,101430,Klemmer; Scott R,11,0,17,6
1668367349586,COGS 234,A00,101431,Xia; Haijun,1,0,25,24
1668367350014,COGS 260,A00,101432,Kiyonaga; Anastasia,21,0,25,4
1668367350014,COGS 260,B00,101433,Kirsh; David Joel,15,0,25,10
1668367350446,CSE 202,A00,102371,Impagliazzo; Russell,0,0,0,0
1668367350874,CSE 203B,A01,102373,Cheng; Chung Kuan,0,0,0,0
1668367351300,CSE 208,A00,102374,Micciancio; Daniele,0,0,0,0
1668367351726,CSE 209A,A00,112895,Impagliazzo; Russell,0,0,15,15
1668367352152,CSE 209B,A00,108005,Bellare; Mihir,0,0,0,0
1668367352584,CSE 210,A00,113163,Coblenz; Michael J,0,0,0,0
1668367353009,CSE 219,A00,106111,Dow; Steven P,0,0,20,20
1668367353533,CSE 221,A00,102376,Voelker; Geoffrey M.,0,0,0,0
1668367353957,CSE 224,A01,102378,Porter; George M,0,0,0,0
1668367354382,CSE 229A,A00,102379,Savage; Stefan,0,0,0,0
1668367354816,CSE 229C,A00,102380,Munyaka; Imani N. S.,0,0,0,0
1668367355243,CSE 232B,A00,102382,Deutsch; Alin Bernard,0,0,0,0
1668367355672,CSE 234,A01,112904,Kumar; Arun Kumar,0,0,0,0
1668367356095,CSE 237A,A00,102383,Rosing; Tajana Simunic,0,0,0,0
1668367356518,CSE 239A,A00,102384,Deutsch; Alin Bernard,0,0,0,0
1668367356950,CSE 239B,A00,102385,Polikarpova; Nadezhda,0,0,0,0
1668367357382,CSE 240A,A00,102386,Pannuto; Patrick William,0,0,0,0
1668367357808,CSE 240B,A00,102387,Zhao; Jishen,0,0,0,0
1668367358233,CSE 241A,A00,106406,Kang; Mingu,0,0,0,0
1668367358656,CSE 249B,A00,102388,Kahng; Andrew Byun,0,0,8,8
1668367359080,CSE 251B,A01,102392,Cottrell; Garrison W,0,0,0,0
1668367359080,CSE 251B,A02,102393,Cottrell; Garrison W,0,0,0,0
1668367359504,CSE 252B,A00,102394,Ochoa; Benjamin Lawrence,0,0,0,0
1668367359929,CSE 257,A01,102396,Gao; Sicun,0,0,0,0
1668367360355,CSE 272,A00,102397,Li; Tzumao,0,0,0,0
1668367360780,CSE 274,A00,111323,Chern; Albert Ren-Haur,0,0,0,0
1668367361207,CSE 282,A00,102398,Pevzner; Pavel Arkadjevich,0,0,0,0
1668367361630,CSE 284,A00,114175,Gymrek; Melissa Ann,0,0,0,0
1668367362054,CSE 290,A00,102399,Chandraker; Manmohan Krishna,0,0,0,0
1668367362054,CSE 290,B00,102400,Vaccaro; Kristen Marie,0,0,25,25
1668367362054,CSE 290,C00,102414,Pannuto; Patrick William,0,0,25,25
1668367362054,CSE 290,D00,102427,Pevzner; Pavel Arkadjevich,0,0,0,0
1668367362054,CSE 290,E00,102429,Zhao; Jishen,0,0,0,0
1668367362054,CSE 290,F00,102436,Tullsen; Dean Michael,0,0,0,0
1668367362054,CSE 290,G00,102440,Christensen; Henrik I,0,0,20,20
1668367362481,CSE 291,A00,102443,Su; Hao,0,0,0,0
1668367362481,CSE 291,B00,102448,Polikarpova; Nadezhda,0,0,0,0
1668367362481,CSE 291,C00,102453,Vaccaro; Kristen Marie,0,0,0,0
1668367362481,CSE 291,D00,111343,Savage; Stefan,0,0,0,0
1668367362481,CSE 291,E00,116474,Claffy; Kimberly Claire,0,0,0,0
1668367362481,CSE 291,F00,116479,Pasquale; Joseph,0,0,0,0
1668367362943,CSE 293,001,119111,Bafna; Vineet,9999,0,9999,0
1668367362943,CSE 293,002,119118,Bellare; Mihir,9999,0,9999,0
1668367362943,CSE 293,003,119122,Berg-Kirkpatrick; Taylor D,9999,0,9999,0
1668367362943,CSE 293,004,119135,Christensen; Henrik I,9999,0,9999,0
1668367362943,CSE 293,005,119142,Cottrell; Garrison W,9999,0,9999,0
1668367362943,CSE 293,006,119146,Deutsch; Alin Bernard,9999,0,9999,0
1668367362943,CSE 293,007,119159,Esmaeilzadeh; Hadi,9999,0,9999,0
1668367362943,CSE 293,008,119166,Freund; Yoav,9999,0,9999,0
1668367362943,CSE 293,009,119170,Griswold; William G.,9999,0,9999,0
1668367362943,CSE 293,010,119183,Gymrek; Melissa Ann,9999,0,9999,0
1668367362943,CSE 293,011,119190,Heninger; Nadia A,9999,0,9999,0
1668367362943,CSE 293,012,119230,Impagliazzo; Russell,9999,0,9999,0
1668367362943,CSE 293,013,119232,Jhala; Ranjit,9999,0,9999,0
1668367362943,CSE 293,014,119233,Kahng; Andrew Byun,9999,0,9999,0
1668367362943,CSE 293,015,119298,Kane; Daniel Mertz,9999,0,9999,0
1668367362943,CSE 293,016,119299,Kriegman; David J,9999,0,9999,0
1668367362943,CSE 293,017,119300,Kumar; Arun Kumar,9999,0,9999,0
1668367362943,CSE 293,018,119301,Lerner; Sorin,9999,0,9999,0
1668367362943,CSE 293,019,119302,Lovett; Shachar,9999,0,9999,0
1668367362943,CSE 293,020,119303,McAuley; Julian John,9999,0,9999,0
1668367362943,CSE 293,021,119304,Micciancio; Daniele,9999,0,9999,0
1668367362943,CSE 293,022,119367,Orailoglu; Alex,9999,0,9999,0
1668367362943,CSE 293,023,119382,Paturi; Ramamohan,9999,0,9999,0
1668367362943,CSE 293,024,119404,Polikarpova; Nadezhda,9999,0,9999,0
1668367362943,CSE 293,025,119406,Politz; Joseph Gibbs,9999,0,9999,0
1668367362943,CSE 293,026,119411,Porter; George M,9999,0,9999,0
1668367362943,CSE 293,027,119414,Porter; Leonard Emerson,9999,0,9999,0
1668367362943,CSE 293,028,119416,Ramamoorthi; Ravi,9999,0,9999,0
1668367362943,CSE 293,029,119417,Sahoo; Debashis,9999,0,9999,0
1668367362943,CSE 293,030,119420,Saul; Lawrence,9999,0,9999,0
1668367362943,CSE 293,031,119421,Savage; Stefan,9999,0,9999,0
1668367362943,CSE 293,032,119425,Schulze; Jurgen P.,9999,0,9999,0
1668367362943,CSE 293,033,119426,Snoeren; Alex C.,9999,0,9999,0
1668367362943,CSE 293,034,119428,Shang; Jingbo,9999,0,9999,0
1668367362943,CSE 293,035,119430,Stefan; Deian,9999,0,9999,0
1668367362943,CSE 293,036,119431,Su; Hao,9999,0,9999,0
1668367362943,CSE 293,037,119433,Swanson; Steven James,9999,0,9999,0
1668367362943,CSE 293,038,119435,Tullsen; Dean Michael,9999,0,9999,0
1668367362943,CSE 293,039,119483,Voelker; Geoffrey M.,9999,0,9999,0
1668367362943,CSE 293,040,119537,Zhao; Jishen,9999,0,9999,0
1668367362943,CSE 293,041,119538,Zhou; Yuan-Yuan,9999,0,9999,0
1668367362943,CSE 293,042,119539,Gao; Sicun,9999,0,9999,0
1668367362943,CSE 293,043,119540,Weibel; Nadir,9999,0,9999,0
1668367362943,CSE 293,044,119541,Gupta; Rajesh K.,9999,0,9999,0
1668367362943,CSE 293,045,126410,Vaccaro; Kristen Marie,9999,0,9999,0
1668367362943,CSE 293,046,126411,Klemke; Richard,9999,0,9999,0
1668367363367,CSE 294,A00,102459,Voelker; Geoffrey M.,0,0,0,0
1668367363367,CSE 294,B00,111322,Orailoglu; Alex,0,0,0,0
1668367363795,DSE 201,A00,096914,Deutsch; Alin Bernard,30,0,30,0
1668367364221,DSE 210,A00,096915,Dasgupta; Sanjoy,30,0,30,0
1668367364648,DSE 260A,A00,096916,Altintas De Callaf; Ilkay,30,0,30,0
1668367365084,ECE 200,001,103586,Antipa; Nicholas A,9999,0,9999,0
1668367365084,ECE 200,002,103587,Atanasov; Nikolay A.,9999,0,9999,0
1668367365084,ECE 200,003,103588,Bharadia; Dinesh,9999,0,9999,0
1668367365084,ECE 200,004,103589,Cheng; Chung Kuan,9999,0,9999,0
1668367365084,ECE 200,005,103590,Cosman; Pamela C.,9999,0,9999,0
1668367365084,ECE 200,006,103591,Dayeh; Shadi Ahmad,9999,0,9999,0
1668367365084,ECE 200,007,103592,Fainman; Yeshaiahu,9999,0,9999,0
1668367365084,ECE 200,008,103593,Ford; Joseph Earl,9999,0,9999,0
1668367365084,ECE 200,009,103594,Franceschetti; Massimo,9999,0,9999,0
1668367365084,ECE 200,010,103595,Fullerton; Eric E,9999,0,9999,0
1668367365084,ECE 200,011,103596,Galton; Ian A,9999,0,9999,0
1668367365084,ECE 200,012,103597,Gilja; Vikash,9999,0,9999,0
1668367365084,ECE 200,013,103598,Hall; Drew A.,9999,0,9999,0
1668367365084,ECE 200,014,103599,Hsueh; Tzu-Chien,9999,0,9999,0
1668367365084,ECE 200,015,103600,Javidi; Tara,9999,0,9999,0
1668367365084,ECE 200,016,103601,Kahng; Andrew Byun,9999,0,9999,0
1668367365084,ECE 200,017,103602,Kim; Young-Han,9999,0,9999,0
1668367365084,ECE 200,018,103603,Koushanfar; Farinaz,9999,0,9999,0
1668367365084,ECE 200,019,103604,Kuzum; Duygu,9999,0,9999,0
1668367365084,ECE 200,020,103605,Le; Hanh-Phuc,9999,0,9999,0
1668367365084,ECE 200,021,103606,Lin; Bill,9999,0,9999,0
1668367365084,ECE 200,022,103607,Liu; Zhaowei,9998,0,9999,1
1668367365084,ECE 200,023,103608,Lo; Yu-Hwa,9999,0,9999,0
1668367365084,ECE 200,024,103609,Lomakin; Vitaliy,9999,0,9999,0
1668367365084,ECE 200,025,103610,Mercier; Patrick Philip,9999,0,9999,0
1668367365084,ECE 200,026,103611,Meyer; Florian,9999,0,9999,0
1668367365084,ECE 200,027,103612,Milstein; Laurence B.,9999,0,9999,0
1668367365084,ECE 200,028,103613,Mir Arabbaygi; Siavash,9999,0,9999,0
1668367365084,ECE 200,029,103614,Mookherjea; Shayan,9999,0,9999,0
1668367365084,ECE 200,030,103615,Morris; Karcher William,9999,0,9999,0
1668367365084,ECE 200,031,103616,Ng; Tse Nga,9999,0,9999,0
1668367365084,ECE 200,032,103617,Nguyen; Truong Quang,9999,0,9999,0
1668367365084,ECE 200,033,103618,Nomura; Kenji,9999,0,9999,0
1668367365084,ECE 200,034,103619,Orlitsky; Alon,9999,0,9999,0
1668367365084,ECE 200,035,103620,Pal; Piya,9999,0,9999,0
1668367365084,ECE 200,036,103621,Papen; George C.,9999,0,9999,0
1668367365084,ECE 200,037,103622,Radic; Stojan,9999,0,9999,0
1668367365084,ECE 200,038,103623,Rao; Bhaskar D.,9999,0,9999,0
1668367365084,ECE 200,039,103624,Rao; Ramesh R,9999,0,9999,0
1668367365084,ECE 200,040,103625,Rebeiz; Gabriel,9999,0,9999,0
1668367365084,ECE 200,041,103626,Sanford; John R,9999,0,9999,0
1668367365084,ECE 200,042,103627,Siegel; Paul H.,9999,0,9999,0
1668367365084,ECE 200,043,103628,Sievenpiper; Daniel F.,9999,0,9999,0
1668367365084,ECE 200,044,103629,Sworder; David D.,9999,0,9999,0
1668367365084,ECE 200,045,103630,Taur; Yuan,9999,0,9999,0
1668367365084,ECE 200,046,103631,Touri; Behrouz,9999,0,9999,0
1668367365084,ECE 200,047,103632,Trivedi; Mohan M.,9999,0,9999,0
1668367365084,ECE 200,048,103633,Vasconcelos; Nuno,9999,0,9999,0
1668367365084,ECE 200,049,103634,Wang; Xiaolong,9999,0,9999,0
1668367365084,ECE 200,050,103635,Xie; Pengtao,9999,0,9999,0
1668367365084,ECE 200,051,103636,Yip; Michael,9999,0,9999,0
1668367365084,ECE 200,052,103637,Zeger; Kenneth A.,999,0,999,0
1668367365084,ECE 200,053,103638,Zhang; Xinyu,9999,0,9999,0
1668367365084,ECE 200,054,103639,Turakhia; Yatish Girish,9999,0,9999,0
1668367365084,ECE 200,055,103640,Kang; Mingu,9999,0,9999,0
1668367365084,ECE 200,056,103641,Shi; Yuanyuan,9999,0,9999,0
1668367365084,ECE 200,057,103642,Wang; Edward Jay,9999,0,9999,0
1668367365084,ECE 200,058,103643,Zheng; Yang,9999,0,9999,0
1668367365508,ECE 202,A00,103644,Kuzum; Duygu,0,0,0,0
1668367365931,ECE 212BN,A00,103646,Ng; Tse Nga,0,0,0,0
1668367366358,ECE 221,A00,111493,Staff,0,0,0,0
1668367366783,ECE 222B,A00,103647,Lomakin; Vitaliy,0,0,0,0
1668367367209,ECE 230B,A00,103648,Taur; Yuan,0,0,0,0
1668367367637,ECE 238B,A00,103649,Garay; Javier,0,0,0,0
1668367368060,ECE 240B,A00,112900,Fainman; Yeshaiahu,0,0,0,0
1668367368493,ECE 247A,A00,103650,Jokerst; Jesse Vincent,0,0,0,0
1668367368918,ECE 247B,A00,103651,Wang; Joseph,0,0,0,0
1668367369341,ECE 250,A00,103652,Siegel; Paul H.,0,0,0,0
1668367369768,ECE 251A,A00,103654,Rao; Bhaskar D.,0,0,0,0
1668367370194,ECE 257B,A00,103655,Bharadia; Dinesh,0,0,0,0
1668367370631,ECE 258A,A00,103656,Milstein; Laurence B.,0,0,0,0
1668367371056,ECE 260B,A00,103658,Kang; Mingu,0,0,0,0
1668367371486,ECE 264A,A00,103659,Galton; Ian A,0,0,0,0
1668367371911,ECE 265A,A00,103661,Gudem; Prasad S.S.,0,0,0,0
1668367372335,ECE 265D,A00,103662,Gudem; Prasad S.S.,0,0,0,0
1668367372760,ECE 268,A00,103663,Koushanfar; Farinaz,0,0,0,0
1668367373188,ECE 269,A01,103665,Pal; Piya,0,0,0,0
1668367373610,ECE 271B,A00,103666,Vasconcelos; Manuela,0,0,0,0
1668367374043,ECE 276A,A00,103667,Atanasov; Nikolay A.,0,0,0,0
1668367374471,ECE 277,A00,103668,An; Cheolhong,0,0,0,0
1668367374896,ECE 279,A00,117947,Hall; Drew A.,0,0,0,0
1668367375742,ECE 283,A00,103670,Hsueh; Tzu-Chien,0,0,0,0
1668367376168,ECE 284,A00,103671,Turakhia; Yatish Girish,0,0,0,0
1668367376593,ECE 285,A00,103672,Zheng; Yang,0,0,0,0
1668367376593,ECE 285,B00,103673,Sworder; David D.,0,0,0,0
1668367377020,ECE 287,A00,103676,Javidi; Tara,0,0,0,0
1668367377447,MATH 200B,A00,098023,Salehi Golsefidy; Alireza,12,0,15,3
1668367377885,MATH 202B,A00,098024,Rhoades; Brendon Patrick,9,0,15,6
1668367378313,MATH 203B,A00,098025,Oprea; Dragos N.,10,0,15,5
1668367378745,MATH 204B,A00,098026,Sorensen; Claus M,13,0,15,2
1668367379169,MATH 208,A00,098027,Izadi; Elham,7,0,10,3
1668367379593,MATH 209,A00,098028,Pollack; Aaron,10,0,10,0
1668367380020,MATH 211A,A00,112919,Rogalski; Daniel,9,0,10,1
1668367380447,MATH 211B,A00,112920,Seward; Brandon M.,9,0,10,1
1668367380871,MATH 218,A00,098029,Li; Bo,10,0,10,0
1668367381296,MATH 220B,A00,098030,Novak; Jonathan I,11,0,15,4
1668367381721,MATH 221A,A00,098031,Ebenfelt; Peter F,13,0,15,2
1668367382148,MATH 231B,A00,098032,Zlatos; Andrej,12,0,15,3
1668367382574,MATH 240B,A00,098033,Ni; Lei,9,0,15,6
1668367382998,MATH 243,A00,098034,Jekel; David Andrew,10,0,10,0
1668367383426,MATH 245A,A00,098035,Nie; Jiawang,0,0,15,16
1668367383851,MATH 248,A00,098036,Bejenaru; Ioan,10,0,10,0
1668367384274,MATH 250B,A00,098037,Spolaor; Luca,14,0,15,1
1668367384700,MATH 258,A00,098038,Ni; Lei,10,0,10,0
1668367385122,MATH 264B,A00,098041,Rhoades; Brendon Patrick,9,0,15,6
1668367385546,MATH 268,A00,098042,Buss; Samuel R,10,0,10,0
1668367385972,MATH 269,A00,098043,Rhoades; Brendon Patrick,10,0,10,0
1668367386395,MATH 270B,A00,098044,Li; Bo,10,0,15,5
1668367386819,MATH 272B,A00,098045,Holst; Michael J,13,0,15,2
1668367387245,MATH 273A,A00,098046,Tian; Xiaochuan,10,0,15,5
1668367387668,MATH 275,A01,098048,Tian; Xiaochuan,6,0,10,4
1668367388101,MATH 278A,A00,098049,Holst; Michael J,8,0,10,2
1668367388525,MATH 278B,A00,098050,Cloninger; Alexander,10,0,10,0
1668367388948,MATH 278C,A00,098051,Nie; Jiawang,7,0,10,3
1668367389370,MATH 280B,A00,098052,Zheng; Tianyi,8,0,15,7
1668367389801,MATH 281B,A00,098053,Bradic; Jelena,1,0,15,14
1668367390229,MATH 282B,A00,098054,Arias-Castro; Ery,0,0,15,15
1668367390655,MATH 285,A00,098055,Fitzsimmons; Patrick J,0,0,15,17
1668367391079,MATH 287B,A00,098056,Arias-Castro; Ery,2,0,15,13
1668367391503,MATH 288,A00,098057,Agarwal; Pooja,9,0,10,1
1668367391503,MATH 288,B00,098058,Zhang; Danna,8,0,10,2
1668367391503,MATH 288,C00,098059,Williams; Ruth J,9,0,10,1
1668367391929,MATH 290B,A00,098060,Roberts; Justin Deritter,13,0,15,2
1668367392363,MATH 292,A00,098061,Belmont; Eva Kinoshita,10,0,10,0
1668367392798,MATH 295,A00,098062,Suk; Andrew Hoon,48,0,50,2
1668367393229,MATH 296,A00,098063,Novak; Jonathan I,20,0,20,0
1668367393655,MATH 297,001,098064,Gamst; Anthony Collins,9997,0,9999,2
1668367895162,COGS 205,A00,101395,Chiba; Andrea,19,0,20,1
1668367895593,COGS 210B,001,101404,Greene; Deanna Jacquelyn,9998,0,9999,1
1668367895593,COGS 210B,002,101417,Xia; Haijun,9999,0,9999,0
1668367895593,COGS 210B,003,101422,Nitz; Douglas A.,9999,0,9999,0
1668367895593,COGS 210B,004,101423,Hollan; James D.,9998,0,9999,1
1668367895593,COGS 210B,005,101424,Deak; Gedeon O.,9998,0,9999,1
1668367895593,COGS 210B,006,101425,Rossano; Federico,9999,0,9999,0
1668367896015,COGS 211B,A00,101427,Coulson; Seana M,9996,0,9999,3
1668367896449,COGS 220,A00,101428,Hollan; James D.,0,0,25,25
1668367896872,COGS 229,A00,101429,Dow; Steven P,18,0,25,7
1668367897296,COGS 230,A00,101430,Klemmer; Scott R,11,0,17,6
1668367897732,COGS 234,A00,101431,Xia; Haijun,1,0,25,24
1668367898171,COGS 260,A00,101432,Kiyonaga; Anastasia,21,0,25,4
1668367898171,COGS 260,B00,101433,Kirsh; David Joel,15,0,25,10
1668367898593,CSE 202,A00,102371,Impagliazzo; Russell,0,0,0,0
1668367899019,CSE 203B,A01,102373,Cheng; Chung Kuan,0,0,0,0
1668367899460,CSE 208,A00,102374,Micciancio; Daniele,0,0,0,0
1668367899884,CSE 209A,A00,112895,Impagliazzo; Russell,0,0,15,15
1668367900321,CSE 209B,A00,108005,Bellare; Mihir,0,0,0,0
1668367900760,CSE 210,A00,113163,Coblenz; Michael J,0,0,0,0
1668367901185,CSE 219,A00,106111,Dow; Steven P,0,0,20,20
1668367901608,CSE 221,A00,102376,Voelker; Geoffrey M.,0,0,0,0
1668367902031,CSE 224,A01,102378,Porter; George M,0,0,0,0
1668367902455,CSE 229A,A00,102379,Savage; Stefan,0,0,0,0
1668367902877,CSE 229C,A00,102380,Munyaka; Imani N. S.,0,0,0,0
1668367903300,CSE 232B,A00,102382,Deutsch; Alin Bernard,0,0,0,0
1668367903727,CSE 234,A01,112904,Kumar; Arun Kumar,0,0,0,0
1668367904158,CSE 237A,A00,102383,Rosing; Tajana Simunic,0,0,0,0
1668367904582,CSE 239A,A00,102384,Deutsch; Alin Bernard,0,0,0,0
1668367905017,CSE 239B,A00,102385,Polikarpova; Nadezhda,0,0,0,0
1668367905450,CSE 240A,A00,102386,Pannuto; Patrick William,0,0,0,0
1668367905874,CSE 240B,A00,102387,Zhao; Jishen,0,0,0,0
1668367906299,CSE 241A,A00,106406,Kang; Mingu,0,0,0,0
1668367906722,CSE 249B,A00,102388,Kahng; Andrew Byun,0,0,8,8
1668367907146,CSE 251B,A01,102392,Cottrell; Garrison W,0,0,0,0
1668367907146,CSE 251B,A02,102393,Cottrell; Garrison W,0,0,0,0
1668367907573,CSE 252B,A00,102394,Ochoa; Benjamin Lawrence,0,0,0,0
1668367908009,CSE 257,A01,102396,Gao; Sicun,0,0,0,0
1668367908433,CSE 272,A00,102397,Li; Tzumao,0,0,0,0
1668367908857,CSE 274,A00,111323,Chern; Albert Ren-Haur,0,0,0,0
1668367909291,CSE 282,A00,102398,Pevzner; Pavel Arkadjevich,0,0,0,0
1668367909716,CSE 284,A00,114175,Gymrek; Melissa Ann,0,0,0,0
1668367910143,CSE 290,A00,102399,Chandraker; Manmohan Krishna,0,0,0,0
1668367910143,CSE 290,B00,102400,Vaccaro; Kristen Marie,0,0,25,25
1668367910143,CSE 290,C00,102414,Pannuto; Patrick William,0,0,25,25
1668367910143,CSE 290,D00,102427,Pevzner; Pavel Arkadjevich,0,0,0,0
1668367910143,CSE 290,E00,102429,Zhao; Jishen,0,0,0,0
1668367910143,CSE 290,F00,102436,Tullsen; Dean Michael,0,0,0,0
1668367910143,CSE 290,G00,102440,Christensen; Henrik I,0,0,20,20
1668367910568,CSE 291,A00,102443,Su; Hao,0,0,0,0
1668367910568,CSE 291,B00,102448,Polikarpova; Nadezhda,0,0,0,0
1668367910568,CSE 291,C00,102453,Vaccaro; Kristen Marie,0,0,0,0
1668367910568,CSE 291,D00,111343,Savage; Stefan,0,0,0,0
1668367910568,CSE 291,E00,116474,Claffy; Kimberly Claire,0,0,0,0
1668367910568,CSE 291,F00,116479,Pasquale; Joseph,0,0,0,0
1668367910993,CSE 293,001,119111,Bafna; Vineet,9999,0,9999,0
1668367910993,CSE 293,002,119118,Bellare; Mihir,9999,0,9999,0
1668367910993,CSE 293,003,119122,Berg-Kirkpatrick; Taylor D,9999,0,9999,0
1668367910993,CSE 293,004,119135,Christensen; Henrik I,9999,0,9999,0
1668367910993,CSE 293,005,119142,Cottrell; Garrison W,9999,0,9999,0
1668367910993,CSE 293,006,119146,Deutsch; Alin Bernard,9999,0,9999,0
1668367910993,CSE 293,007,119159,Esmaeilzadeh; Hadi,9999,0,9999,0
1668367910993,CSE 293,008,119166,Freund; Yoav,9999,0,9999,0
1668367910993,CSE 293,009,119170,Griswold; William G.,9999,0,9999,0
1668367910993,CSE 293,010,119183,Gymrek; Melissa Ann,9999,0,9999,0
1668367910993,CSE 293,011,119190,Heninger; Nadia A,9999,0,9999,0
1668367910993,CSE 293,012,119230,Impagliazzo; Russell,9999,0,9999,0
1668367910993,CSE 293,013,119232,Jhala; Ranjit,9999,0,9999,0
1668367910993,CSE 293,014,119233,Kahng; Andrew Byun,9999,0,9999,0
1668367910993,CSE 293,015,119298,Kane; Daniel Mertz,9999,0,9999,0
1668367910993,CSE 293,016,119299,Kriegman; David J,9999,0,9999,0
1668367910993,CSE 293,017,119300,Kumar; Arun Kumar,9999,0,9999,0
1668367910993,CSE 293,018,119301,Lerner; Sorin,9999,0,9999,0
1668367910993,CSE 293,019,119302,Lovett; Shachar,9999,0,9999,0
1668367910993,CSE 293,020,119303,McAuley; Julian John,9999,0,9999,0
1668367910993,CSE 293,021,119304,Micciancio; Daniele,9999,0,9999,0
1668367910993,CSE 293,022,119367,Orailoglu; Alex,9999,0,9999,0
1668367910993,CSE 293,023,119382,Paturi; Ramamohan,9999,0,9999,0
1668367910993,CSE 293,024,119404,Polikarpova; Nadezhda,9999,0,9999,0
1668367910993,CSE 293,025,119406,Politz; Joseph Gibbs,9999,0,9999,0
1668367910993,CSE 293,026,119411,Porter; George M,9999,0,9999,0
1668367910993,CSE 293,027,119414,Porter; Leonard Emerson,9999,0,9999,0
1668367910993,CSE 293,028,119416,Ramamoorthi; Ravi,9999,0,9999,0
1668367910993,CSE 293,029,119417,Sahoo; Debashis,9999,0,9999,0
1668367910993,CSE 293,030,119420,Saul; Lawrence,9999,0,9999,0
1668367910993,CSE 293,031,119421,Savage; Stefan,9999,0,9999,0
1668367910993,CSE 293,032,119425,Schulze; Jurgen P.,9999,0,9999,0
1668367910993,CSE 293,033,119426,Snoeren; Alex C.,9999,0,9999,0
1668367910993,CSE 293,034,119428,Shang; Jingbo,9999,0,9999,0
1668367910993,CSE 293,035,119430,Stefan; Deian,9999,0,9999,0
1668367910993,CSE 293,036,119431,Su; Hao,9999,0,9999,0
1668367910993,CSE 293,037,119433,Swanson; Steven James,9999,0,9999,0
1668367910993,CSE 293,038,119435,Tullsen; Dean Michael,9999,0,9999,0
1668367910993,CSE 293,039,119483,Voelker; Geoffrey M.,9999,0,9999,0
1668367910993,CSE 293,040,119537,Zhao; Jishen,9999,0,9999,0
1668367910993,CSE 293,041,119538,Zhou; Yuan-Yuan,9999,0,9999,0
1668367910993,CSE 293,042,119539,Gao; Sicun,9999,0,9999,0
1668367910993,CSE 293,043,119540,Weibel; Nadir,9999,0,9999,0
1668367910993,CSE 293,044,119541,Gupta; Rajesh K.,9999,0,9999,0
1668367910993,CSE 293,045,126410,Vaccaro; Kristen Marie,9999,0,9999,0
1668367910993,CSE 293,046,126411,Klemke; Richard,9999,0,9999,0
1668367911419,CSE 294,A00,102459,Voelker; Geoffrey M.,0,0,0,0
1668367911419,CSE 294,B00,111322,Orailoglu; Alex,0,0,0,0
1668367911846,DSE 201,A00,096914,Deutsch; Alin Bernard,30,0,30,0
1668367912269,DSE 210,A00,096915,Dasgupta; Sanjoy,30,0,30,0
1668367912694,DSE 260A,A00,096916,Altintas De Callaf; Ilkay,30,0,30,0
1668367913131,ECE 200,001,103586,Antipa; Nicholas A,9999,0,9999,0
1668367913131,ECE 200,002,103587,Atanasov; Nikolay A.,9999,0,9999,0
1668367913131,ECE 200,003,103588,Bharadia; Dinesh,9999,0,9999,0
1668367913131,ECE 200,004,103589,Cheng; Chung Kuan,9999,0,9999,0
1668367913131,ECE 200,005,103590,Cosman; Pamela C.,9999,0,9999,0
1668367913131,ECE 200,006,103591,Dayeh; Shadi Ahmad,9999,0,9999,0
1668367913131,ECE 200,007,103592,Fainman; Yeshaiahu,9999,0,9999,0
1668367913131,ECE 200,008,103593,Ford; Joseph Earl,9999,0,9999,0
1668367913131,ECE 200,009,103594,Franceschetti; Massimo,9999,0,9999,0
1668367913131,ECE 200,010,103595,Fullerton; Eric E,9999,0,9999,0
1668367913131,ECE 200,011,103596,Galton; Ian A,9999,0,9999,0
1668367913131,ECE 200,012,103597,Gilja; Vikash,9999,0,9999,0
1668367913131,ECE 200,013,103598,Hall; Drew A.,9999,0,9999,0
1668367913131,ECE 200,014,103599,Hsueh; Tzu-Chien,9999,0,9999,0
1668367913131,ECE 200,015,103600,Javidi; Tara,9999,0,9999,0
1668367913131,ECE 200,016,103601,Kahng; Andrew Byun,9999,0,9999,0
1668367913131,ECE 200,017,103602,Kim; Young-Han,9999,0,9999,0
1668367913131,ECE 200,018,103603,Koushanfar; Farinaz,9999,0,9999,0
1668367913131,ECE 200,019,103604,Kuzum; Duygu,9999,0,9999,0
1668367913131,ECE 200,020,103605,Le; Hanh-Phuc,9999,0,9999,0
1668367913131,ECE 200,021,103606,Lin; Bill,9999,0,9999,0
1668367913131,ECE 200,022,103607,Liu; Zhaowei,9998,0,9999,1
1668367913131,ECE 200,023,103608,Lo; Yu-Hwa,9999,0,9999,0
1668367913131,ECE 200,024,103609,Lomakin; Vitaliy,9999,0,9999,0
1668367913131,ECE 200,025,103610,Mercier; Patrick Philip,9999,0,9999,0
1668367913131,ECE 200,026,103611,Meyer; Florian,9999,0,9999,0
1668367913131,ECE 200,027,103612,Milstein; Laurence B.,9999,0,9999,0
1668367913131,ECE 200,028,103613,Mir Arabbaygi; Siavash,9999,0,9999,0
1668367913131,ECE 200,029,103614,Mookherjea; Shayan,9999,0,9999,0
1668367913131,ECE 200,030,103615,Morris; Karcher William,9999,0,9999,0
1668367913131,ECE 200,031,103616,Ng; Tse Nga,9999,0,9999,0
1668367913131,ECE 200,032,103617,Nguyen; Truong Quang,9999,0,9999,0
1668367913131,ECE 200,033,103618,Nomura; Kenji,9999,0,9999,0
1668367913131,ECE 200,034,103619,Orlitsky; Alon,9999,0,9999,0
1668367913131,ECE 200,035,103620,Pal; Piya,9999,0,9999,0
1668367913131,ECE 200,036,103621,Papen; George C.,9999,0,9999,0
1668367913131,ECE 200,037,103622,Radic; Stojan,9999,0,9999,0
1668367913131,ECE 200,038,103623,Rao; Bhaskar D.,9999,0,9999,0
1668367913131,ECE 200,039,103624,Rao; Ramesh R,9999,0,9999,0
1668367913131,ECE 200,040,103625,Rebeiz; Gabriel,9999,0,9999,0
1668367913131,ECE 200,041,103626,Sanford; John R,9999,0,9999,0
1668367913131,ECE 200,042,103627,Siegel; Paul H.,9999,0,9999,0
1668367913131,ECE 200,043,103628,Sievenpiper; Daniel F.,9999,0,9999,0
1668367913131,ECE 200,044,103629,Sworder; David D.,9999,0,9999,0
1668367913131,ECE 200,045,103630,Taur; Yuan,9999,0,9999,0
1668367913131,ECE 200,046,103631,Touri; Behrouz,9999,0,9999,0
1668367913131,ECE 200,047,103632,Trivedi; Mohan M.,9999,0,9999,0
1668367913131,ECE 200,048,103633,Vasconcelos; Nuno,9999,0,9999,0
1668367913131,ECE 200,049,103634,Wang; Xiaolong,9999,0,9999,0
1668367913131,ECE 200,050,103635,Xie; Pengtao,9999,0,9999,0
1668367913131,ECE 200,051,103636,Yip; Michael,9999,0,9999,0
1668367913131,ECE 200,052,103637,Zeger; Kenneth A.,999,0,999,0
1668367913131,ECE 200,053,103638,Zhang; Xinyu,9999,0,9999,0
1668367913131,ECE 200,054,103639,Turakhia; Yatish Girish,9999,0,9999,0
1668367913131,ECE 200,055,103640,Kang; Mingu,9999,0,9999,0
1668367913131,ECE 200,056,103641,Shi; Yuanyuan,9999,0,9999,0
1668367913131,ECE 200,057,103642,Wang; Edward Jay,9999,0,9999,0
1668367913131,ECE 200,058,103643,Zheng; Yang,9999,0,9999,0
1668367913555,ECE 202,A00,103644,Kuzum; Duygu,0,0,0,0
1668367913979,ECE 212BN,A00,103646,Ng; Tse Nga,0,0,0,0
1668367914402,ECE 221,A00,111493,Staff,0,0,0,0
1668367914832,ECE 222B,A00,103647,Lomakin; Vitaliy,0,0,0,0
1668367915257,ECE 230B,A00,103648,Taur; Yuan,0,0,0,0
1668367915686,ECE 238B,A00,103649,Garay; Javier,0,0,0,0
1668367916112,ECE 240B,A00,112900,Fainman; Yeshaiahu,0,0,0,0
1668367916549,ECE 247A,A00,103650,Jokerst; Jesse Vincent,0,0,0,0
1668367916971,ECE 247B,A00,103651,Wang; Joseph,0,0,0,0
1668367917402,ECE 250,A00,103652,Siegel; Paul H.,0,0,0,0
1668367917828,ECE 251A,A00,103654,Rao; Bhaskar D.,0,0,0,0
1668367918919,ECE 257B,A00,103655,Bharadia; Dinesh,0,0,0,0
1668367919342,ECE 258A,A00,103656,Milstein; Laurence B.,0,0,0,0
1668367919766,ECE 260B,A00,103658,Kang; Mingu,0,0,0,0
1668367920191,ECE 264A,A00,103659,Galton; Ian A,0,0,0,0
1668367920617,ECE 265A,A00,103661,Gudem; Prasad S.S.,0,0,0,0
1668367921052,ECE 265D,A00,103662,Gudem; Prasad S.S.,0,0,0,0
1668367921490,ECE 268,A00,103663,Koushanfar; Farinaz,0,0,0,0
1668367921925,ECE 269,A01,103665,Pal; Piya,0,0,0,0
1668367922359,ECE 271B,A00,103666,Vasconcelos; Manuela,0,0,0,0
1668367922786,ECE 276A,A00,103667,Atanasov; Nikolay A.,0,0,0,0
1668367923211,ECE 277,A00,103668,An; Cheolhong,0,0,0,0
1668367923634,ECE 279,A00,117947,Hall; Drew A.,0,0,0,0
1668367924485,ECE 283,A00,103670,Hsueh; Tzu-Chien,0,0,0,0
1668367924911,ECE 284,A00,103671,Turakhia; Yatish Girish,0,0,0,0
1668367925342,ECE 285,A00,103672,Zheng; Yang,0,0,0,0
1668367925342,ECE 285,B00,103673,Sworder; David D.,0,0,0,0
1668367925766,ECE 287,A00,103676,Javidi; Tara,0,0,0,0
1668367926190,MATH 200B,A00,098023,Salehi Golsefidy; Alireza,12,0,15,3
1668367926613,MATH 202B,A00,098024,Rhoades; Brendon Patrick,9,0,15,6
1668367927038,MATH 203B,A00,098025,Oprea; Dragos N.,10,0,15,5
1668367927462,MATH 204B,A00,098026,Sorensen; Claus M,13,0,15,2
1668367927886,MATH 208,A00,098027,Izadi; Elham,7,0,10,3
1668367928309,MATH 209,A00,098028,Pollack; Aaron,10,0,10,0
1668367928733,MATH 211A,A00,112919,Rogalski; Daniel,9,0,10,1
1668367929159,MATH 211B,A00,112920,Seward; Brandon M.,9,0,10,1
1668367929583,MATH 218,A00,098029,Li; Bo,10,0,10,0
1668367930015,MATH 220B,A00,098030,Novak; Jonathan I,11,0,15,4
1668367930440,MATH 221A,A00,098031,Ebenfelt; Peter F,13,0,15,2
1668367930880,MATH 231B,A00,098032,Zlatos; Andrej,12,0,15,3
1668367931302,MATH 240B,A00,098033,Ni; Lei,9,0,15,6
1668367931740,MATH 243,A00,098034,Jekel; David Andrew,10,0,10,0
1668367932166,MATH 245A,A00,098035,Nie; Jiawang,0,0,15,16
1668367932593,MATH 248,A00,098036,Bejenaru; Ioan,10,0,10,0
1668367933017,MATH 250B,A00,098037,Spolaor; Luca,14,0,15,1
1668367933443,MATH 258,A00,098038,Ni; Lei,10,0,10,0
1668367933867,MATH 264B,A00,098041,Rhoades; Brendon Patrick,9,0,15,6
1668367934292,MATH 268,A00,098042,Buss; Samuel R,10,0,10,0
1668367934720,MATH 269,A00,098043,Rhoades; Brendon Patrick,10,0,10,0
1668367935146,MATH 270B,A00,098044,Li; Bo,10,0,15,5
1668367935569,MATH 272B,A00,098045,Holst; Michael J,13,0,15,2
1668367935995,MATH 273A,A00,098046,Tian; Xiaochuan,10,0,15,5
1668367936422,MATH 275,A01,098048,Tian; Xiaochuan,6,0,10,4
1668367936846,MATH 278A,A00,098049,Holst; Michael J,8,0,10,2
1668367937270,MATH 278B,A00,098050,Cloninger; Alexander,10,0,10,0
1668367937695,MATH 278C,A00,098051,Nie; Jiawang,7,0,10,3
1668367938119,MATH 280B,A00,098052,Zheng; Tianyi,8,0,15,7
1668367938553,MATH 281B,A00,098053,Bradic; Jelena,1,0,15,14
1668367938999,MATH 282B,A00,098054,Arias-Castro; Ery,0,0,15,15
1668367939425,MATH 285,A00,098055,Fitzsimmons; Patrick J,0,0,15,17
1668367939851,MATH 287B,A00,098056,Arias-Castro; Ery,2,0,15,13
1668367940280,MATH 288,A00,098057,Agarwal; Pooja,9,0,10,1
1668367940280,MATH 288,B00,098058,Zhang; Danna,8,0,10,2
1668367940280,MATH 288,C00,098059,Williams; Ruth J,9,0,10,1
1668367940703,MATH 290B,A00,098060,Roberts; Justin Deritter,13,0,15,2
1668367941132,MATH 292,A00,098061,Belmont; Eva Kinoshita,10,0,10,0
1668367941556,MATH 295,A00,098062,Suk; Andrew Hoon,48,0,50,2
1668367941982,MATH 296,A00,098063,Novak; Jonathan I,20,0,20,0
1668367942410,MATH 297,001,098064,Gamst; Anthony Collins,9997,0,9999,2
1668368446728,COGS 205,A00,101395,Chiba; Andrea,19,0,20,1
1668368447152,COGS 210B,001,101404,Greene; Deanna Jacquelyn,9998,0,9999,1
1668368447152,COGS 210B,002,101417,Xia; Haijun,9999,0,9999,0
1668368447152,COGS 210B,003,101422,Nitz; Douglas A.,9999,0,9999,0
1668368447152,COGS 210B,004,101423,Hollan; James D.,9998,0,9999,1
1668368447152,COGS 210B,005,101424,Deak; Gedeon O.,9998,0,9999,1
1668368447152,COGS 210B,006,101425,Rossano; Federico,9999,0,9999,0
1668368447581,COGS 211B,A00,101427,Coulson; Seana M,9996,0,9999,3
1668368448015,COGS 220,A00,101428,Hollan; James D.,0,0,25,25
1668368448437,COGS 229,A00,101429,Dow; Steven P,18,0,25,7
1668368448865,COGS 230,A00,101430,Klemmer; Scott R,11,0,17,6
1668368449289,COGS 234,A00,101431,Xia; Haijun,1,0,25,24
1668368449715,COGS 260,A00,101432,Kiyonaga; Anastasia,21,0,25,4
1668368449715,COGS 260,B00,101433,Kirsh; David Joel,15,0,25,10
1668368450140,CSE 202,A00,102371,Impagliazzo; Russell,0,0,0,0
1668368450563,CSE 203B,A01,102373,Cheng; Chung Kuan,0,0,0,0
1668368450990,CSE 208,A00,102374,Micciancio; Daniele,0,0,0,0
1668368451416,CSE 209A,A00,112895,Impagliazzo; Russell,0,0,15,15
1668368451839,CSE 209B,A00,108005,Bellare; Mihir,0,0,0,0
1668368452265,CSE 210,A00,113163,Coblenz; Michael J,0,0,0,0
1668368452689,CSE 219,A00,106111,Dow; Steven P,0,0,20,20
1668368453115,CSE 221,A00,102376,Voelker; Geoffrey M.,0,0,0,0
1668368453540,CSE 224,A01,102378,Porter; George M,0,0,0,0
1668368453965,CSE 229A,A00,102379,Savage; Stefan,0,0,0,0
1668368454392,CSE 229C,A00,102380,Munyaka; Imani N. S.,0,0,0,0
1668368454815,CSE 232B,A00,102382,Deutsch; Alin Bernard,0,0,0,0
1668368455240,CSE 234,A01,112904,Kumar; Arun Kumar,0,0,0,0
1668368455665,CSE 237A,A00,102383,Rosing; Tajana Simunic,0,0,0,0
1668368456091,CSE 239A,A00,102384,Deutsch; Alin Bernard,0,0,0,0
1668368456515,CSE 239B,A00,102385,Polikarpova; Nadezhda,0,0,0,0
1668368456945,CSE 240A,A00,102386,Pannuto; Patrick William,0,0,0,0
1668368457372,CSE 240B,A00,102387,Zhao; Jishen,0,0,0,0
1668368457808,CSE 241A,A00,106406,Kang; Mingu,0,0,0,0
1668368458237,CSE 249B,A00,102388,Kahng; Andrew Byun,0,0,8,8
1668368458665,CSE 251B,A01,102392,Cottrell; Garrison W,0,0,0,0
1668368458665,CSE 251B,A02,102393,Cottrell; Garrison W,0,0,0,0
1668368459090,CSE 252B,A00,102394,Ochoa; Benjamin Lawrence,0,0,0,0
1668368459518,CSE 257,A01,102396,Gao; Sicun,0,0,0,0
1668368459940,CSE 272,A00,102397,Li; Tzumao,0,0,0,0
1668368460369,CSE 274,A00,111323,Chern; Albert Ren-Haur,0,0,0,0
1668368460827,CSE 282,A00,102398,Pevzner; Pavel Arkadjevich,0,0,0,0
1668368461259,CSE 284,A00,114175,Gymrek; Melissa Ann,0,0,0,0
1668368461687,CSE 290,A00,102399,Chandraker; Manmohan Krishna,0,0,0,0
1668368461687,CSE 290,B00,102400,Vaccaro; Kristen Marie,0,0,25,25
1668368461687,CSE 290,C00,102414,Pannuto; Patrick William,0,0,25,25
1668368461687,CSE 290,D00,102427,Pevzner; Pavel Arkadjevich,0,0,0,0
1668368461687,CSE 290,E00,102429,Zhao; Jishen,0,0,0,0
1668368461687,CSE 290,F00,102436,Tullsen; Dean Michael,0,0,0,0
1668368461687,CSE 290,G00,102440,Christensen; Henrik I,0,0,20,20
1668368462125,CSE 291,A00,102443,Su; Hao,0,0,0,0
1668368462125,CSE 291,B00,102448,Polikarpova; Nadezhda,0,0,0,0
1668368462125,CSE 291,C00,102453,Vaccaro; Kristen Marie,0,0,0,0
1668368462125,CSE 291,D00,111343,Savage; Stefan,0,0,0,0
1668368462125,CSE 291,E00,116474,Claffy; Kimberly Claire,0,0,0,0
1668368462125,CSE 291,F00,116479,Pasquale; Joseph,0,0,0,0
1668368462573,CSE 293,001,119111,Bafna; Vineet,9999,0,9999,0
1668368462573,CSE 293,002,119118,Bellare; Mihir,9999,0,9999,0
1668368462573,CSE 293,003,119122,Berg-Kirkpatrick; Taylor D,9999,0,9999,0
1668368462573,CSE 293,004,119135,Christensen; Henrik I,9999,0,9999,0
1668368462573,CSE 293,005,119142,Cottrell; Garrison W,9999,0,9999,0
1668368462573,CSE 293,006,119146,Deutsch; Alin Bernard,9999,0,9999,0
1668368462573,CSE 293,007,119159,Esmaeilzadeh; Hadi,9999,0,9999,0
1668368462573,CSE 293,008,119166,Freund; Yoav,9999,0,9999,0
1668368462573,CSE 293,009,119170,Griswold; William G.,9999,0,9999,0
1668368462573,CSE 293,010,119183,Gymrek; Melissa Ann,9999,0,9999,0
1668368462573,CSE 293,011,119190,Heninger; Nadia A,9999,0,9999,0
1668368462573,CSE 293,012,119230,Impagliazzo; Russell,9999,0,9999,0
1668368462573,CSE 293,013,119232,Jhala; Ranjit,9999,0,9999,0
1668368462573,CSE 293,014,119233,Kahng; Andrew Byun,9999,0,9999,0
1668368462573,CSE 293,015,119298,Kane; Daniel Mertz,9999,0,9999,0
1668368462573,CSE 293,016,119299,Kriegman; David J,9999,0,9999,0
1668368462573,CSE 293,017,119300,Kumar; Arun Kumar,9999,0,9999,0
1668368462573,CSE 293,018,119301,Lerner; Sorin,9999,0,9999,0
1668368462573,CSE 293,019,119302,Lovett; Shachar,9999,0,9999,0
1668368462573,CSE 293,020,119303,McAuley; Julian John,9999,0,9999,0
1668368462573,CSE 293,021,119304,Micciancio; Daniele,9999,0,9999,0
1668368462573,CSE 293,022,119367,Orailoglu; Alex,9999,0,9999,0
1668368462573,CSE 293,023,119382,Paturi; Ramamohan,9999,0,9999,0
1668368462573,CSE 293,024,119404,Polikarpova; Nadezhda,9999,0,9999,0
1668368462573,CSE 293,025,119406,Politz; Joseph Gibbs,9999,0,9999,0
1668368462573,CSE 293,026,119411,Porter; George M,9999,0,9999,0
1668368462573,CSE 293,027,119414,Porter; Leonard Emerson,9999,0,9999,0
1668368462573,CSE 293,028,119416,Ramamoorthi; Ravi,9999,0,9999,0
1668368462573,CSE 293,029,119417,Sahoo; Debashis,9999,0,9999,0
1668368462573,CSE 293,030,119420,Saul; Lawrence,9999,0,9999,0
1668368462573,CSE 293,031,119421,Savage; Stefan,9999,0,9999,0
1668368462573,CSE 293,032,119425,Schulze; Jurgen P.,9999,0,9999,0
1668368462573,CSE 293,033,119426,Snoeren; Alex C.,9999,0,9999,0
1668368462573,CSE 293,034,119428,Shang; Jingbo,9999,0,9999,0
1668368462573,CSE 293,035,119430,Stefan; Deian,9999,0,9999,0
1668368462573,CSE 293,036,119431,Su; Hao,9999,0,9999,0
1668368462573,CSE 293,037,119433,Swanson; Steven James,9999,0,9999,0
1668368462573,CSE 293,038,119435,Tullsen; Dean Michael,9999,0,9999,0
1668368462573,CSE 293,039,119483,Voelker; Geoffrey M.,9999,0,9999,0
1668368462573,CSE 293,040,119537,Zhao; Jishen,9999,0,9999,0
1668368462573,CSE 293,041,119538,Zhou; Yuan-Yuan,9999,0,9999,0
1668368462573,CSE 293,042,119539,Gao; Sicun,9999,0,9999,0
1668368462573,CSE 293,043,119540,Weibel; Nadir,9999,0,9999,0
1668368462573,CSE 293,044,119541,Gupta; Rajesh K.,9999,0,9999,0
1668368462573,CSE 293,045,126410,Vaccaro; Kristen Marie,9999,0,9999,0
1668368462573,CSE 293,046,126411,Klemke; Richard,9999,0,9999,0
1668368462997,CSE 294,A00,102459,Voelker; Geoffrey M.,0,0,0,0
1668368462997,CSE 294,B00,111322,Orailoglu; Alex,0,0,0,0
1668368463426,DSE 201,A00,096914,Deutsch; Alin Bernard,30,0,30,0
1668368463848,DSE 210,A00,096915,Dasgupta; Sanjoy,30,0,30,0
1668368464283,DSE 260A,A00,096916,Altintas De Callaf; Ilkay,30,0,30,0
1668368464731,ECE 200,001,103586,Antipa; Nicholas A,9999,0,9999,0
1668368464731,ECE 200,002,103587,Atanasov; Nikolay A.,9999,0,9999,0
1668368464731,ECE 200,003,103588,Bharadia; Dinesh,9999,0,9999,0
1668368464731,ECE 200,004,103589,Cheng; Chung Kuan,9999,0,9999,0
1668368464731,ECE 200,005,103590,Cosman; Pamela C.,9999,0,9999,0
1668368464731,ECE 200,006,103591,Dayeh; Shadi Ahmad,9999,0,9999,0
1668368464731,ECE 200,007,103592,Fainman; Yeshaiahu,9999,0,9999,0
1668368464731,ECE 200,008,103593,Ford; Joseph Earl,9999,0,9999,0
1668368464731,ECE 200,009,103594,Franceschetti; Massimo,9999,0,9999,0
1668368464731,ECE 200,010,103595,Fullerton; Eric E,9999,0,9999,0
1668368464731,ECE 200,011,103596,Galton; Ian A,9999,0,9999,0
1668368464731,ECE 200,012,103597,Gilja; Vikash,9999,0,9999,0
1668368464731,ECE 200,013,103598,Hall; Drew A.,9999,0,9999,0
1668368464731,ECE 200,014,103599,Hsueh; Tzu-Chien,9999,0,9999,0
1668368464731,ECE 200,015,103600,Javidi; Tara,9999,0,9999,0
1668368464731,ECE 200,016,103601,Kahng; Andrew Byun,9999,0,9999,0
1668368464731,ECE 200,017,103602,Kim; Young-Han,9999,0,9999,0
1668368464731,ECE 200,018,103603,Koushanfar; Farinaz,9999,0,9999,0
1668368464731,ECE 200,019,103604,Kuzum; Duygu,9999,0,9999,0
1668368464731,ECE 200,020,103605,Le; Hanh-Phuc,9999,0,9999,0
1668368464731,ECE 200,021,103606,Lin; Bill,9999,0,9999,0
1668368464731,ECE 200,022,103607,Liu; Zhaowei,9998,0,9999,1
1668368464731,ECE 200,023,103608,Lo; Yu-Hwa,9999,0,9999,0
1668368464731,ECE 200,024,103609,Lomakin; Vitaliy,9999,0,9999,0
1668368464731,ECE 200,025,103610,Mercier; Patrick Philip,9999,0,9999,0
1668368464731,ECE 200,026,103611,Meyer; Florian,9999,0,9999,0
1668368464731,ECE 200,027,103612,Milstein; Laurence B.,9999,0,9999,0
1668368464731,ECE 200,028,103613,Mir Arabbaygi; Siavash,9999,0,9999,0
1668368464731,ECE 200,029,103614,Mookherjea; Shayan,9999,0,9999,0
1668368464731,ECE 200,030,103615,Morris; Karcher William,9999,0,9999,0
1668368464731,ECE 200,031,103616,Ng; Tse Nga,9999,0,9999,0
1668368464731,ECE 200,032,103617,Nguyen; Truong Quang,9999,0,9999,0
1668368464731,ECE 200,033,103618,Nomura; Kenji,9999,0,9999,0
1668368464731,ECE 200,034,103619,Orlitsky; Alon,9999,0,9999,0
1668368464731,ECE 200,035,103620,Pal; Piya,9999,0,9999,0
1668368464731,ECE 200,036,103621,Papen; George C.,9999,0,9999,0
1668368464731,ECE 200,037,103622,Radic; Stojan,9999,0,9999,0
1668368464731,ECE 200,038,103623,Rao; Bhaskar D.,9999,0,9999,0
1668368464731,ECE 200,039,103624,Rao; Ramesh R,9999,0,9999,0
1668368464731,ECE 200,040,103625,Rebeiz; Gabriel,9999,0,9999,0
1668368464731,ECE 200,041,103626,Sanford; John R,9999,0,9999,0
1668368464731,ECE 200,042,103627,Siegel; Paul H.,9999,0,9999,0
1668368464731,ECE 200,043,103628,Sievenpiper; Daniel F.,9999,0,9999,0
1668368464731,ECE 200,044,103629,Sworder; David D.,9999,0,9999,0
1668368464731,ECE 200,045,103630,Taur; Yuan,9999,0,9999,0
1668368464731,ECE 200,046,103631,Touri; Behrouz,9999,0,9999,0
1668368464731,ECE 200,047,103632,Trivedi; Mohan M.,9999,0,9999,0
1668368464731,ECE 200,048,103633,Vasconcelos; Nuno,9999,0,9999,0
1668368464731,ECE 200,049,103634,Wang; Xiaolong,9999,0,9999,0
1668368464731,ECE 200,050,103635,Xie; Pengtao,9999,0,9999,0
1668368464731,ECE 200,051,103636,Yip; Michael,9999,0,9999,0
1668368464731,ECE 200,052,103637,Zeger; Kenneth A.,999,0,999,0
1668368464731,ECE 200,053,103638,Zhang; Xinyu,9999,0,9999,0
1668368464731,ECE 200,054,103639,Turakhia; Yatish Girish,9999,0,9999,0
1668368464731,ECE 200,055,103640,Kang; Mingu,9999,0,9999,0
1668368464731,ECE 200,056,103641,Shi; Yuanyuan,9999,0,9999,0
1668368464731,ECE 200,057,103642,Wang; Edward Jay,9999,0,9999,0
1668368464731,ECE 200,058,103643,Zheng; Yang,9999,0,9999,0
1668368465168,ECE 202,A00,103644,Kuzum; Duygu,0,0,0,0
1668368465602,ECE 212BN,A00,103646,Ng; Tse Nga,0,0,0,0
1668368466044,ECE 221,A00,111493,Staff,0,0,0,0
1668368466468,ECE 222B,A00,103647,Lomakin; Vitaliy,0,0,0,0
1668368466895,ECE 230B,A00,103648,Taur; Yuan,0,0,0,0
1668368467335,ECE 238B,A00,103649,Garay; Javier,0,0,0,0
1668368467762,ECE 240B,A00,112900,Fainman; Yeshaiahu,0,0,0,0
1668368468186,ECE 247A,A00,103650,Jokerst; Jesse Vincent,0,0,0,0
1668368468614,ECE 247B,A00,103651,Wang; Joseph,0,0,0,0
1668368469040,ECE 250,A00,103652,Siegel; Paul H.,0,0,0,0
1668368469467,ECE 251A,A00,103654,Rao; Bhaskar D.,0,0,0,0
1668368469895,ECE 257B,A00,103655,Bharadia; Dinesh,0,0,0,0
1668368470328,ECE 258A,A00,103656,Milstein; Laurence B.,0,0,0,0
1668368470754,ECE 260B,A00,103658,Kang; Mingu,0,0,0,0
1668368471177,ECE 264A,A00,103659,Galton; Ian A,0,0,0,0
1668368471602,ECE 265A,A00,103661,Gudem; Prasad S.S.,0,0,0,0
1668368472025,ECE 265D,A00,103662,Gudem; Prasad S.S.,0,0,0,0
1668368472454,ECE 268,A00,103663,Koushanfar; Farinaz,0,0,0,0
1668368472878,ECE 269,A01,103665,Pal; Piya,0,0,0,0
1668368473310,ECE 271B,A00,103666,Vasconcelos; Manuela,0,0,0,0
1668368473740,ECE 276A,A00,103667,Atanasov; Nikolay A.,0,0,0,0
1668368474165,ECE 277,A00,103668,An; Cheolhong,0,0,0,0
1668368474589,ECE 279,A00,117947,Hall; Drew A.,0,0,0,0
1668368475439,ECE 283,A00,103670,Hsueh; Tzu-Chien,0,0,0,0
1668368475861,ECE 284,A00,103671,Turakhia; Yatish Girish,0,0,0,0
1668368476285,ECE 285,A00,103672,Zheng; Yang,0,0,0,0
1668368476285,ECE 285,B00,103673,Sworder; David D.,0,0,0,0
1668368476709,ECE 287,A00,103676,Javidi; Tara,0,0,0,0
1668368477133,MATH 200B,A00,098023,Salehi Golsefidy; Alireza,12,0,15,3
1668368477563,MATH 202B,A00,098024,Rhoades; Brendon Patrick,9,0,15,6
1668368477992,MATH 203B,A00,098025,Oprea; Dragos N.,10,0,15,5
1668368478422,MATH 204B,A00,098026,Sorensen; Claus M,13,0,15,2
1668368478853,MATH 208,A00,098027,Izadi; Elham,7,0,10,3
1668368479276,MATH 209,A00,098028,Pollack; Aaron,10,0,10,0
1668368479704,MATH 211A,A00,112919,Rogalski; Daniel,9,0,10,1
1668368480127,MATH 211B,A00,112920,Seward; Brandon M.,9,0,10,1
1668368480549,MATH 218,A00,098029,Li; Bo,10,0,10,0
1668368480975,MATH 220B,A00,098030,Novak; Jonathan I,11,0,15,4
1668368481400,MATH 221A,A00,098031,Ebenfelt; Peter F,13,0,15,2
1668368481824,MATH 231B,A00,098032,Zlatos; Andrej,12,0,15,3
1668368482251,MATH 240B,A00,098033,Ni; Lei,9,0,15,6
1668368482677,MATH 243,A00,098034,Jekel; David Andrew,10,0,10,0
1668368483099,MATH 245A,A00,098035,Nie; Jiawang,0,0,15,16
1668368483526,MATH 248,A00,098036,Bejenaru; Ioan,10,0,10,0
1668368483948,MATH 250B,A00,098037,Spolaor; Luca,14,0,15,1
1668368484377,MATH 258,A00,098038,Ni; Lei,10,0,10,0
1668368484802,MATH 264B,A00,098041,Rhoades; Brendon Patrick,9,0,15,6
1668368485226,MATH 268,A00,098042,Buss; Samuel R,10,0,10,0
1668368485648,MATH 269,A00,098043,Rhoades; Brendon Patrick,10,0,10,0
1668368486080,MATH 270B,A00,098044,Li; Bo,10,0,15,5
1668368486603,MATH 272B,A00,098045,Holst; Michael J,13,0,15,2
1668368487030,MATH 273A,A00,098046,Tian; Xiaochuan,10,0,15,5
1668368487454,MATH 275,A01,098048,Tian; Xiaochuan,6,0,10,4
1668368487877,MATH 278A,A00,098049,Holst; Michael J,8,0,10,2
1668368488300,MATH 278B,A00,098050,Cloninger; Alexander,10,0,10,0
1668368488725,MATH 278C,A00,098051,Nie; Jiawang,7,0,10,3
1668368489147,MATH 280B,A00,098052,Zheng; Tianyi,8,0,15,7
1668368489581,MATH 281B,A00,098053,Bradic; Jelena,1,0,15,14
1668368490008,MATH 282B,A00,098054,Arias-Castro; Ery,0,0,15,15
1668368490446,MATH 285,A00,098055,Fitzsimmons; Patrick J,0,0,15,17
1668368490875,MATH 287B,A00,098056,Arias-Castro; Ery,2,0,15,13
1668368491300,MATH 288,A00,098057,Agarwal; Pooja,9,0,10,1
1668368491300,MATH 288,B00,098058,Zhang; Danna,8,0,10,2
1668368491300,MATH 288,C00,098059,Williams; Ruth J,9,0,10,1
1668368491735,MATH 290B,A00,098060,Roberts; Justin Deritter,13,0,15,2
1668368492170,MATH 292,A00,098061,Belmont; Eva Kinoshita,10,0,10,0
1668368492599,MATH 295,A00,098062,Suk; Andrew Hoon,48,0,50,2
1668368493024,MATH 296,A00,098063,Novak; Jonathan I,20,0,20,0
1668368493451,MATH 297,001,098064,Gamst; Anthony Collins,9997,0,9999,2
1668368994940,COGS 205,A00,101395,Chiba; Andrea,19,0,20,1
1668368995366,COGS 210B,001,101404,Greene; Deanna Jacquelyn,9998,0,9999,1
1668368995366,COGS 210B,002,101417,Xia; Haijun,9999,0,9999,0
1668368995366,COGS 210B,003,101422,Nitz; Douglas A.,9999,0,9999,0
1668368995366,COGS 210B,004,101423,Hollan; James D.,9998,0,9999,1
1668368995366,COGS 210B,005,101424,Deak; Gedeon O.,9998,0,9999,1
1668368995366,COGS 210B,006,101425,Rossano; Federico,9999,0,9999,0
1668368995789,COGS 211B,A00,101427,Coulson; Seana M,9996,0,9999,3
1668368996223,COGS 220,A00,101428,Hollan; James D.,0,0,25,25
1668368996646,COGS 229,A00,101429,Dow; Steven P,18,0,25,7
1668368997070,COGS 230,A00,101430,Klemmer; Scott R,11,0,17,6
1668368997494,COGS 234,A00,101431,Xia; Haijun,1,0,25,24
1668368997922,COGS 260,A00,101432,Kiyonaga; Anastasia,21,0,25,4
1668368997922,COGS 260,B00,101433,Kirsh; David Joel,15,0,25,10
1668368998361,CSE 202,A00,102371,Impagliazzo; Russell,0,0,0,0
1668368998785,CSE 203B,A01,102373,Cheng; Chung Kuan,0,0,0,0
1668368999218,CSE 208,A00,102374,Micciancio; Daniele,0,0,0,0
1668368999641,CSE 209A,A00,112895,Impagliazzo; Russell,0,0,15,15
1668369000066,CSE 209B,A00,108005,Bellare; Mihir,0,0,0,0
1668369000490,CSE 210,A00,113163,Coblenz; Michael J,0,0,0,0
1668369000923,CSE 219,A00,106111,Dow; Steven P,0,0,20,20
1668369001348,CSE 221,A00,102376,Voelker; Geoffrey M.,0,0,0,0
1668369001780,CSE 224,A01,102378,Porter; George M,0,0,0,0
1668369002203,CSE 229A,A00,102379,Savage; Stefan,0,0,0,0
1668369002629,CSE 229C,A00,102380,Munyaka; Imani N. S.,0,0,0,0
1668369003055,CSE 232B,A00,102382,Deutsch; Alin Bernard,0,0,0,0
1668369003482,CSE 234,A01,112904,Kumar; Arun Kumar,0,0,0,0
1668369003913,CSE 237A,A00,102383,Rosing; Tajana Simunic,0,0,0,0
1668369004345,CSE 239A,A00,102384,Deutsch; Alin Bernard,0,0,0,0
1668369004786,CSE 239B,A00,102385,Polikarpova; Nadezhda,0,0,0,0
1668369005208,CSE 240A,A00,102386,Pannuto; Patrick William,0,0,0,0
1668369005635,CSE 240B,A00,102387,Zhao; Jishen,0,0,0,0
1668369006060,CSE 241A,A00,106406,Kang; Mingu,0,0,0,0
1668369006484,CSE 249B,A00,102388,Kahng; Andrew Byun,0,0,8,8
1668369006909,CSE 251B,A01,102392,Cottrell; Garrison W,0,0,0,0
1668369006909,CSE 251B,A02,102393,Cottrell; Garrison W,0,0,0,0
1668369007334,CSE 252B,A00,102394,Ochoa; Benjamin Lawrence,0,0,0,0
1668369007759,CSE 257,A01,102396,Gao; Sicun,0,0,0,0
1668369008273,CSE 272,A00,102397,Li; Tzumao,0,0,0,0
1668369008697,CSE 274,A00,111323,Chern; Albert Ren-Haur,0,0,0,0
1668369009122,CSE 282,A00,102398,Pevzner; Pavel Arkadjevich,0,0,0,0
1668369009549,CSE 284,A00,114175,Gymrek; Melissa Ann,0,0,0,0
1668369009979,CSE 290,A00,102399,Chandraker; Manmohan Krishna,0,0,0,0
1668369009979,CSE 290,B00,102400,Vaccaro; Kristen Marie,0,0,25,25
1668369009979,CSE 290,C00,102414,Pannuto; Patrick William,0,0,25,25
1668369009979,CSE 290,D00,102427,Pevzner; Pavel Arkadjevich,0,0,0,0
1668369009979,CSE 290,E00,102429,Zhao; Jishen,0,0,0,0
1668369009979,CSE 290,F00,102436,Tullsen; Dean Michael,0,0,0,0
1668369009979,CSE 290,G00,102440,Christensen; Henrik I,0,0,20,20
1668369010404,CSE 291,A00,102443,Su; Hao,0,0,0,0
1668369010404,CSE 291,B00,102448,Polikarpova; Nadezhda,0,0,0,0
1668369010404,CSE 291,C00,102453,Vaccaro; Kristen Marie,0,0,0,0
1668369010404,CSE 291,D00,111343,Savage; Stefan,0,0,0,0
1668369010404,CSE 291,E00,116474,Claffy; Kimberly Claire,0,0,0,0
1668369010404,CSE 291,F00,116479,Pasquale; Joseph,0,0,0,0
1668369010832,CSE 293,001,119111,Bafna; Vineet,9999,0,9999,0
1668369010832,CSE 293,002,119118,Bellare; Mihir,9999,0,9999,0
1668369010832,CSE 293,003,119122,Berg-Kirkpatrick; Taylor D,9999,0,9999,0
1668369010832,CSE 293,004,119135,Christensen; Henrik I,9999,0,9999,0
1668369010832,CSE 293,005,119142,Cottrell; Garrison W,9999,0,9999,0
1668369010832,CSE 293,006,119146,Deutsch; Alin Bernard,9999,0,9999,0
1668369010832,CSE 293,007,119159,Esmaeilzadeh; Hadi,9999,0,9999,0
1668369010832,CSE 293,008,119166,Freund; Yoav,9999,0,9999,0
1668369010832,CSE 293,009,119170,Griswold; William G.,9999,0,9999,0
1668369010832,CSE 293,010,119183,Gymrek; Melissa Ann,9999,0,9999,0
1668369010832,CSE 293,011,119190,Heninger; Nadia A,9999,0,9999,0
1668369010832,CSE 293,012,119230,Impagliazzo; Russell,9999,0,9999,0
1668369010832,CSE 293,013,119232,Jhala; Ranjit,9999,0,9999,0
1668369010832,CSE 293,014,119233,Kahng; Andrew Byun,9999,0,9999,0
1668369010832,CSE 293,015,119298,Kane; Daniel Mertz,9999,0,9999,0
1668369010832,CSE 293,016,119299,Kriegman; David J,9999,0,9999,0
1668369010832,CSE 293,017,119300,Kumar; Arun Kumar,9999,0,9999,0
1668369010832,CSE 293,018,119301,Lerner; Sorin,9999,0,9999,0
1668369010832,CSE 293,019,119302,Lovett; Shachar,9999,0,9999,0
1668369010832,CSE 293,020,119303,McAuley; Julian John,9999,0,9999,0
1668369010832,CSE 293,021,119304,Micciancio; Daniele,9999,0,9999,0
1668369010832,CSE 293,022,119367,Orailoglu; Alex,9999,0,9999,0
1668369010832,CSE 293,023,119382,Paturi; Ramamohan,9999,0,9999,0
1668369010832,CSE 293,024,119404,Polikarpova; Nadezhda,9999,0,9999,0
1668369010832,CSE 293,025,119406,Politz; Joseph Gibbs,9999,0,9999,0
1668369010832,CSE 293,026,119411,Porter; George M,9999,0,9999,0
1668369010832,CSE 293,027,119414,Porter; Leonard Emerson,9999,0,9999,0
1668369010832,CSE 293,028,119416,Ramamoorthi; Ravi,9999,0,9999,0
1668369010832,CSE 293,029,119417,Sahoo; Debashis,9999,0,9999,0
1668369010832,CSE 293,030,119420,Saul; Lawrence,9999,0,9999,0
1668369010832,CSE 293,031,119421,Savage; Stefan,9999,0,9999,0
1668369010832,CSE 293,032,119425,Schulze; Jurgen P.,9999,0,9999,0
1668369010832,CSE 293,033,119426,Snoeren; Alex C.,9999,0,9999,0
1668369010832,CSE 293,034,119428,Shang; Jingbo,9999,0,9999,0
1668369010832,CSE 293,035,119430,Stefan; Deian,9999,0,9999,0
1668369010832,CSE 293,036,119431,Su; Hao,9999,0,9999,0
1668369010832,CSE 293,037,119433,Swanson; Steven James,9999,0,9999,0
1668369010832,CSE 293,038,119435,Tullsen; Dean Michael,9999,0,9999,0
1668369010832,CSE 293,039,119483,Voelker; Geoffrey M.,9999,0,9999,0
1668369010832,CSE 293,040,119537,Zhao; Jishen,9999,0,9999,0
1668369010832,CSE 293,041,119538,Zhou; Yuan-Yuan,9999,0,9999,0
1668369010832,CSE 293,042,119539,Gao; Sicun,9999,0,9999,0
1668369010832,CSE 293,043,119540,Weibel; Nadir,9999,0,9999,0
1668369010832,CSE 293,044,119541,Gupta; Rajesh K.,9999,0,9999,0
1668369010832,CSE 293,045,126410,Vaccaro; Kristen Marie,9999,0,9999,0
1668369010832,CSE 293,046,126411,Klemke; Richard,9999,0,9999,0
1668369011259,CSE 294,A00,102459,Voelker; Geoffrey M.,0,0,0,0
1668369011259,CSE 294,B00,111322,Orailoglu; Alex,0,0,0,0
1668369011684,DSE 201,A00,096914,Deutsch; Alin Bernard,30,0,30,0
1668369012109,DSE 210,A00,096915,Dasgupta; Sanjoy,30,0,30,0
1668369012547,DSE 260A,A00,096916,Altintas De Callaf; Ilkay,30,0,30,0
1668369012976,ECE 200,001,103586,Antipa; Nicholas A,9999,0,9999,0
1668369012976,ECE 200,002,103587,Atanasov; Nikolay A.,9999,0,9999,0
1668369012976,ECE 200,003,103588,Bharadia; Dinesh,9999,0,9999,0
1668369012976,ECE 200,004,103589,Cheng; Chung Kuan,9999,0,9999,0
1668369012976,ECE 200,005,103590,Cosman; Pamela C.,9999,0,9999,0
1668369012976,ECE 200,006,103591,Dayeh; Shadi Ahmad,9999,0,9999,0
1668369012976,ECE 200,007,103592,Fainman; Yeshaiahu,9999,0,9999,0
1668369012976,ECE 200,008,103593,Ford; Joseph Earl,9999,0,9999,0
1668369012976,ECE 200,009,103594,Franceschetti; Massimo,9999,0,9999,0
1668369012976,ECE 200,010,103595,Fullerton; Eric E,9999,0,9999,0
1668369012976,ECE 200,011,103596,Galton; Ian A,9999,0,9999,0
1668369012976,ECE 200,012,103597,Gilja; Vikash,9999,0,9999,0
1668369012976,ECE 200,013,103598,Hall; Drew A.,9999,0,9999,0
1668369012976,ECE 200,014,103599,Hsueh; Tzu-Chien,9999,0,9999,0
1668369012976,ECE 200,015,103600,Javidi; Tara,9999,0,9999,0
1668369012976,ECE 200,016,103601,Kahng; Andrew Byun,9999,0,9999,0
1668369012976,ECE 200,017,103602,Kim; Young-Han,9999,0,9999,0
1668369012976,ECE 200,018,103603,Koushanfar; Farinaz,9999,0,9999,0
1668369012976,ECE 200,019,103604,Kuzum; Duygu,9999,0,9999,0
1668369012976,ECE 200,020,103605,Le; Hanh-Phuc,9999,0,9999,0
1668369012976,ECE 200,021,103606,Lin; Bill,9999,0,9999,0
1668369012976,ECE 200,022,103607,Liu; Zhaowei,9998,0,9999,1
1668369012976,ECE 200,023,103608,Lo; Yu-Hwa,9999,0,9999,0
1668369012976,ECE 200,024,103609,Lomakin; Vitaliy,9999,0,9999,0
1668369012976,ECE 200,025,103610,Mercier; Patrick Philip,9999,0,9999,0
1668369012976,ECE 200,026,103611,Meyer; Florian,9999,0,9999,0
1668369012976,ECE 200,027,103612,Milstein; Laurence B.,9999,0,9999,0
1668369012976,ECE 200,028,103613,Mir Arabbaygi; Siavash,9999,0,9999,0
1668369012976,ECE 200,029,103614,Mookherjea; Shayan,9999,0,9999,0
1668369012976,ECE 200,030,103615,Morris; Karcher William,9999,0,9999,0
1668369012976,ECE 200,031,103616,Ng; Tse Nga,9999,0,9999,0
1668369012976,ECE 200,032,103617,Nguyen; Truong Quang,9999,0,9999,0
1668369012976,ECE 200,033,103618,Nomura; Kenji,9999,0,9999,0
1668369012976,ECE 200,034,103619,Orlitsky; Alon,9999,0,9999,0
1668369012976,ECE 200,035,103620,Pal; Piya,9999,0,9999,0
1668369012976,ECE 200,036,103621,Papen; George C.,9999,0,9999,0
1668369012976,ECE 200,037,103622,Radic; Stojan,9999,0,9999,0
1668369012976,ECE 200,038,103623,Rao; Bhaskar D.,9999,0,9999,0
1668369012976,ECE 200,039,103624,Rao; Ramesh R,9999,0,9999,0
1668369012976,ECE 200,040,103625,Rebeiz; Gabriel,9999,0,9999,0
1668369012976,ECE 200,041,103626,Sanford; John R,9999,0,9999,0
1668369012976,ECE 200,042,103627,Siegel; Paul H.,9999,0,9999,0
1668369012976,ECE 200,043,103628,Sievenpiper; Daniel F.,9999,0,9999,0
1668369012976,ECE 200,044,103629,Sworder; David D.,9999,0,9999,0
1668369012976,ECE 200,045,103630,Taur; Yuan,9999,0,9999,0
1668369012976,ECE 200,046,103631,Touri; Behrouz,9999,0,9999,0
1668369012976,ECE 200,047,103632,Trivedi; Mohan M.,9999,0,9999,0
1668369012976,ECE 200,048,103633,Vasconcelos; Nuno,9999,0,9999,0
1668369012976,ECE 200,049,103634,Wang; Xiaolong,9999,0,9999,0
1668369012976,ECE 200,050,103635,Xie; Pengtao,9999,0,9999,0
1668369012976,ECE 200,051,103636,Yip; Michael,9999,0,9999,0
1668369012976,ECE 200,052,103637,Zeger; Kenneth A.,999,0,999,0
1668369012976,ECE 200,053,103638,Zhang; Xinyu,9999,0,9999,0
1668369012976,ECE 200,054,103639,Turakhia; Yatish Girish,9999,0,9999,0
1668369012976,ECE 200,055,103640,Kang; Mingu,9999,0,9999,0
1668369012976,ECE 200,056,103641,Shi; Yuanyuan,9999,0,9999,0
1668369012976,ECE 200,057,103642,Wang; Edward Jay,9999,0,9999,0
1668369012976,ECE 200,058,103643,Zheng; Yang,9999,0,9999,0
1668369013409,ECE 202,A00,103644,Kuzum; Duygu,0,0,0,0
1668369013833,ECE 212BN,A00,103646,Ng; Tse Nga,0,0,0,0
1668369014258,ECE 221,A00,111493,Staff,0,0,0,0
1668369014682,ECE 222B,A00,103647,Lomakin; Vitaliy,0,0,0,0
1668369015110,ECE 230B,A00,103648,Taur; Yuan,0,0,0,0
1668369015539,ECE 238B,A00,103649,Garay; Javier,0,0,0,0
1668369015964,ECE 240B,A00,112900,Fainman; Yeshaiahu,0,0,0,0
1668369016402,ECE 247A,A00,103650,Jokerst; Jesse Vincent,0,0,0,0
1668369016827,ECE 247B,A00,103651,Wang; Joseph,0,0,0,0
1668369017251,ECE 250,A00,103652,Siegel; Paul H.,0,0,0,0
1668369017676,ECE 251A,A00,103654,Rao; Bhaskar D.,0,0,0,0
1668369018103,ECE 257B,A00,103655,Bharadia; Dinesh,0,0,0,0
1668369018533,ECE 258A,A00,103656,Milstein; Laurence B.,0,0,0,0
1668369018963,ECE 260B,A00,103658,Kang; Mingu,0,0,0,0
1668369019391,ECE 264A,A00,103659,Galton; Ian A,0,0,0,0
1668369019829,ECE 265A,A00,103661,Gudem; Prasad S.S.,0,0,0,0
1668369020256,ECE 265D,A00,103662,Gudem; Prasad S.S.,0,0,0,0
1668369020696,ECE 268,A00,103663,Koushanfar; Farinaz,0,0,0,0
1668369021122,ECE 269,A01,103665,Pal; Piya,0,0,0,0
1668369021553,ECE 271B,A00,103666,Vasconcelos; Manuela,0,0,0,0
1668369021981,ECE 276A,A00,103667,Atanasov; Nikolay A.,0,0,0,0
1668369022404,ECE 277,A00,103668,An; Cheolhong,0,0,0,0
1668369022827,ECE 279,A00,117947,Hall; Drew A.,0,0,0,0
1668369023677,ECE 283,A00,103670,Hsueh; Tzu-Chien,0,0,0,0
1668369024104,ECE 284,A00,103671,Turakhia; Yatish Girish,0,0,0,0
1668369024532,ECE 285,A00,103672,Zheng; Yang,0,0,0,0
1668369024532,ECE 285,B00,103673,Sworder; David D.,0,0,0,0
1668369024956,ECE 287,A00,103676,Javidi; Tara,0,0,0,0
1668369025381,MATH 200B,A00,098023,Salehi Golsefidy; Alireza,12,0,15,3
1668369025805,MATH 202B,A00,098024,Rhoades; Brendon Patrick,9,0,15,6
1668369026233,MATH 203B,A00,098025,Oprea; Dragos N.,10,0,15,5
1668369026669,MATH 204B,A00,098026,Sorensen; Claus M,13,0,15,2
1668369027095,MATH 208,A00,098027,Izadi; Elham,7,0,10,3
1668369027532,MATH 209,A00,098028,Pollack; Aaron,10,0,10,0
1668369027961,MATH 211A,A00,112919,Rogalski; Daniel,9,0,10,1
1668369028385,MATH 211B,A00,112920,Seward; Brandon M.,9,0,10,1
1668369028809,MATH 218,A00,098029,Li; Bo,10,0,10,0
1668369029237,MATH 220B,A00,098030,Novak; Jonathan I,11,0,15,4
1668369029673,MATH 221A,A00,098031,Ebenfelt; Peter F,13,0,15,2
1668369030100,MATH 231B,A00,098032,Zlatos; Andrej,12,0,15,3
1668369030526,MATH 240B,A00,098033,Ni; Lei,9,0,15,6
1668369030953,MATH 243,A00,098034,Jekel; David Andrew,10,0,10,0
1668369031374,MATH 245A,A00,098035,Nie; Jiawang,0,0,15,16
1668369031801,MATH 248,A00,098036,Bejenaru; Ioan,10,0,10,0
1668369032233,MATH 250B,A00,098037,Spolaor; Luca,14,0,15,1
1668369032668,MATH 258,A00,098038,Ni; Lei,10,0,10,0
1668369033092,MATH 264B,A00,098041,Rhoades; Brendon Patrick,9,0,15,6
1668369033517,MATH 268,A00,098042,Buss; Samuel R,10,0,10,0
1668369033943,MATH 269,A00,098043,Rhoades; Brendon Patrick,10,0,10,0
1668369034370,MATH 270B,A00,098044,Li; Bo,10,0,15,5
1668369034795,MATH 272B,A00,098045,Holst; Michael J,13,0,15,2
1668369035218,MATH 273A,A00,098046,Tian; Xiaochuan,10,0,15,5
1668369035648,MATH 275,A01,098048,Tian; Xiaochuan,6,0,10,4
1668369036072,MATH 278A,A00,098049,Holst; Michael J,8,0,10,2
1668369036496,MATH 278B,A00,098050,Cloninger; Alexander,10,0,10,0
1668369036921,MATH 278C,A00,098051,Nie; Jiawang,7,0,10,3
1668369037347,MATH 280B,A00,098052,Zheng; Tianyi,8,0,15,7
1668369037771,MATH 281B,A00,098053,Bradic; Jelena,1,0,15,14
1668369038201,MATH 282B,A00,098054,Arias-Castro; Ery,0,0,15,15
1668369038627,MATH 285,A00,098055,Fitzsimmons; Patrick J,0,0,15,17
1668369039058,MATH 287B,A00,098056,Arias-Castro; Ery,2,0,15,13
1668369039490,MATH 288,A00,098057,Agarwal; Pooja,9,0,10,1
1668369039490,MATH 288,B00,098058,Zhang; Danna,8,0,10,2
1668369039490,MATH 288,C00,098059,Williams; Ruth J,9,0,10,1
1668369039920,MATH 290B,A00,098060,Roberts; Justin Deritter,13,0,15,2
1668369040344,MATH 292,A00,098061,Belmont; Eva Kinoshita,10,0,10,0
1668369040770,MATH 295,A00,098062,Suk; Andrew Hoon,48,0,50,2
1668369041197,MATH 296,A00,098063,Novak; Jonathan I,20,0,20,0
1668369041631,MATH 297,001,098064,Gamst; Anthony Collins,9997,0,9999,2
1668369544561,COGS 205,A00,101395,Chiba; Andrea,19,0,20,1
1668369544984,COGS 210B,001,101404,Greene; Deanna Jacquelyn,9998,0,9999,1
1668369544984,COGS 210B,002,101417,Xia; Haijun,9999,0,9999,0
1668369544984,COGS 210B,003,101422,Nitz; Douglas A.,9999,0,9999,0
1668369544984,COGS 210B,004,101423,Hollan; James D.,9998,0,9999,1
1668369544984,COGS 210B,005,101424,Deak; Gedeon O.,9998,0,9999,1
1668369544984,COGS 210B,006,101425,Rossano; Federico,9999,0,9999,0
1668369545407,COGS 211B,A00,101427,Coulson; Seana M,9996,0,9999,3
1668369545829,COGS 220,A00,101428,Hollan; James D.,0,0,25,25
1668369546252,COGS 229,A00,101429,Dow; Steven P,18,0,25,7
1668369546675,COGS 230,A00,101430,Klemmer; Scott R,11,0,17,6
1668369547101,COGS 234,A00,101431,Xia; Haijun,1,0,25,24
1668369547527,COGS 260,A00,101432,Kiyonaga; Anastasia,21,0,25,4
1668369547527,COGS 260,B00,101433,Kirsh; David Joel,15,0,25,10
1668369547953,CSE 202,A00,102371,Impagliazzo; Russell,0,0,0,0
1668369548377,CSE 203B,A01,102373,Cheng; Chung Kuan,0,0,0,0
1668369548807,CSE 208,A00,102374,Micciancio; Daniele,0,0,0,0
1668369549231,CSE 209A,A00,112895,Impagliazzo; Russell,0,0,15,15
1668369549656,CSE 209B,A00,108005,Bellare; Mihir,0,0,0,0
1668369550083,CSE 210,A00,113163,Coblenz; Michael J,0,0,0,0
1668369550522,CSE 219,A00,106111,Dow; Steven P,0,0,20,20
1668369550955,CSE 221,A00,102376,Voelker; Geoffrey M.,0,0,0,0
1668369551378,CSE 224,A01,102378,Porter; George M,0,0,0,0
1668369551801,CSE 229A,A00,102379,Savage; Stefan,0,0,0,0
1668369552225,CSE 229C,A00,102380,Munyaka; Imani N. S.,0,0,0,0
1668369552651,CSE 232B,A00,102382,Deutsch; Alin Bernard,0,0,0,0
1668369553077,CSE 234,A01,112904,Kumar; Arun Kumar,0,0,0,0
1668369553512,CSE 237A,A00,102383,Rosing; Tajana Simunic,0,0,0,0
1668369553938,CSE 239A,A00,102384,Deutsch; Alin Bernard,0,0,0,0
1668369554363,CSE 239B,A00,102385,Polikarpova; Nadezhda,0,0,0,0
1668369554786,CSE 240A,A00,102386,Pannuto; Patrick William,0,0,0,0
1668369555220,CSE 240B,A00,102387,Zhao; Jishen,0,0,0,0
1668369555651,CSE 241A,A00,106406,Kang; Mingu,0,0,0,0
1668369556077,CSE 249B,A00,102388,Kahng; Andrew Byun,0,0,8,8
1668369556511,CSE 251B,A01,102392,Cottrell; Garrison W,0,0,0,0
1668369556511,CSE 251B,A02,102393,Cottrell; Garrison W,0,0,0,0
1668369556945,CSE 252B,A00,102394,Ochoa; Benjamin Lawrence,0,0,0,0
1668369557384,CSE 257,A01,102396,Gao; Sicun,0,0,0,0
1668369557811,CSE 272,A00,102397,Li; Tzumao,0,0,0,0
1668369558236,CSE 274,A00,111323,Chern; Albert Ren-Haur,0,0,0,0
1668369558671,CSE 282,A00,102398,Pevzner; Pavel Arkadjevich,0,0,0,0
1668369559096,CSE 284,A00,114175,Gymrek; Melissa Ann,0,0,0,0
1668369559521,CSE 290,A00,102399,Chandraker; Manmohan Krishna,0,0,0,0
1668369559521,CSE 290,B00,102400,Vaccaro; Kristen Marie,0,0,25,25
1668369559521,CSE 290,C00,102414,Pannuto; Patrick William,0,0,25,25
1668369559521,CSE 290,D00,102427,Pevzner; Pavel Arkadjevich,0,0,0,0
1668369559521,CSE 290,E00,102429,Zhao; Jishen,0,0,0,0
1668369559521,CSE 290,F00,102436,Tullsen; Dean Michael,0,0,0,0
1668369559521,CSE 290,G00,102440,Christensen; Henrik I,0,0,20,20
1668369559945,CSE 291,A00,102443,Su; Hao,0,0,0,0
1668369559945,CSE 291,B00,102448,Polikarpova; Nadezhda,0,0,0,0
1668369559945,CSE 291,C00,102453,Vaccaro; Kristen Marie,0,0,0,0
1668369559945,CSE 291,D00,111343,Savage; Stefan,0,0,0,0
1668369559945,CSE 291,E00,116474,Claffy; Kimberly Claire,0,0,0,0
1668369559945,CSE 291,F00,116479,Pasquale; Joseph,0,0,0,0
1668369560378,CSE 293,001,119111,Bafna; Vineet,9999,0,9999,0
1668369560378,CSE 293,002,119118,Bellare; Mihir,9999,0,9999,0
1668369560378,CSE 293,003,119122,Berg-Kirkpatrick; Taylor D,9999,0,9999,0
1668369560378,CSE 293,004,119135,Christensen; Henrik I,9999,0,9999,0
1668369560378,CSE 293,005,119142,Cottrell; Garrison W,9999,0,9999,0
1668369560378,CSE 293,006,119146,Deutsch; Alin Bernard,9999,0,9999,0
1668369560378,CSE 293,007,119159,Esmaeilzadeh; Hadi,9999,0,9999,0
1668369560378,CSE 293,008,119166,Freund; Yoav,9999,0,9999,0
1668369560378,CSE 293,009,119170,Griswold; William G.,9999,0,9999,0
1668369560378,CSE 293,010,119183,Gymrek; Melissa Ann,9999,0,9999,0
1668369560378,CSE 293,011,119190,Heninger; Nadia A,9999,0,9999,0
1668369560378,CSE 293,012,119230,Impagliazzo; Russell,9999,0,9999,0
1668369560378,CSE 293,013,119232,Jhala; Ranjit,9999,0,9999,0
1668369560378,CSE 293,014,119233,Kahng; Andrew Byun,9999,0,9999,0
1668369560378,CSE 293,015,119298,Kane; Daniel Mertz,9999,0,9999,0
1668369560378,CSE 293,016,119299,Kriegman; David J,9999,0,9999,0
1668369560378,CSE 293,017,119300,Kumar; Arun Kumar,9999,0,9999,0
1668369560378,CSE 293,018,119301,Lerner; Sorin,9999,0,9999,0
1668369560378,CSE 293,019,119302,Lovett; Shachar,9999,0,9999,0
1668369560378,CSE 293,020,119303,McAuley; Julian John,9999,0,9999,0
1668369560378,CSE 293,021,119304,Micciancio; Daniele,9999,0,9999,0
1668369560378,CSE 293,022,119367,Orailoglu; Alex,9999,0,9999,0
1668369560378,CSE 293,023,119382,Paturi; Ramamohan,9999,0,9999,0
1668369560378,CSE 293,024,119404,Polikarpova; Nadezhda,9999,0,9999,0
1668369560378,CSE 293,025,119406,Politz; Joseph Gibbs,9999,0,9999,0
1668369560378,CSE 293,026,119411,Porter; George M,9999,0,9999,0
1668369560378,CSE 293,027,119414,Porter; Leonard Emerson,9999,0,9999,0
1668369560378,CSE 293,028,119416,Ramamoorthi; Ravi,9999,0,9999,0
1668369560378,CSE 293,029,119417,Sahoo; Debashis,9999,0,9999,0
1668369560378,CSE 293,030,119420,Saul; Lawrence,9999,0,9999,0
1668369560378,CSE 293,031,119421,Savage; Stefan,9999,0,9999,0
1668369560378,CSE 293,032,119425,Schulze; Jurgen P.,9999,0,9999,0
1668369560378,CSE 293,033,119426,Snoeren; Alex C.,9999,0,9999,0
1668369560378,CSE 293,034,119428,Shang; Jingbo,9999,0,9999,0
1668369560378,CSE 293,035,119430,Stefan; Deian,9999,0,9999,0
1668369560378,CSE 293,036,119431,Su; Hao,9999,0,9999,0
1668369560378,CSE 293,037,119433,Swanson; Steven James,9999,0,9999,0
1668369560378,CSE 293,038,119435,Tullsen; Dean Michael,9999,0,9999,0
1668369560378,CSE 293,039,119483,Voelker; Geoffrey M.,9999,0,9999,0
1668369560378,CSE 293,040,119537,Zhao; Jishen,9999,0,9999,0
1668369560378,CSE 293,041,119538,Zhou; Yuan-Yuan,9999,0,9999,0
1668369560378,CSE 293,042,119539,Gao; Sicun,9999,0,9999,0
1668369560378,CSE 293,043,119540,Weibel; Nadir,9999,0,9999,0
1668369560378,CSE 293,044,119541,Gupta; Rajesh K.,9999,0,9999,0
1668369560378,CSE 293,045,126410,Vaccaro; Kristen Marie,9999,0,9999,0
1668369560378,CSE 293,046,126411,Klemke; Richard,9999,0,9999,0
1668369560802,CSE 294,A00,102459,Voelker; Geoffrey M.,0,0,0,0
1668369560802,CSE 294,B00,111322,Orailoglu; Alex,0,0,0,0
1668369561226,DSE 201,A00,096914,Deutsch; Alin Bernard,30,0,30,0
1668369561650,DSE 210,A00,096915,Dasgupta; Sanjoy,30,0,30,0
1668369562096,DSE 260A,A00,096916,Altintas De Callaf; Ilkay,30,0,30,0
1668369562539,ECE 200,001,103586,Antipa; Nicholas A,9999,0,9999,0
1668369562539,ECE 200,002,103587,Atanasov; Nikolay A.,9999,0,9999,0
1668369562539,ECE 200,003,103588,Bharadia; Dinesh,9999,0,9999,0
1668369562539,ECE 200,004,103589,Cheng; Chung Kuan,9999,0,9999,0
1668369562539,ECE 200,005,103590,Cosman; Pamela C.,9999,0,9999,0
1668369562539,ECE 200,006,103591,Dayeh; Shadi Ahmad,9999,0,9999,0
1668369562539,ECE 200,007,103592,Fainman; Yeshaiahu,9999,0,9999,0
1668369562539,ECE 200,008,103593,Ford; Joseph Earl,9999,0,9999,0
1668369562539,ECE 200,009,103594,Franceschetti; Massimo,9999,0,9999,0
1668369562539,ECE 200,010,103595,Fullerton; Eric E,9999,0,9999,0
1668369562539,ECE 200,011,103596,Galton; Ian A,9999,0,9999,0
1668369562539,ECE 200,012,103597,Gilja; Vikash,9999,0,9999,0
1668369562539,ECE 200,013,103598,Hall; Drew A.,9999,0,9999,0
1668369562539,ECE 200,014,103599,Hsueh; Tzu-Chien,9999,0,9999,0
1668369562539,ECE 200,015,103600,Javidi; Tara,9999,0,9999,0
1668369562539,ECE 200,016,103601,Kahng; Andrew Byun,9999,0,9999,0
1668369562539,ECE 200,017,103602,Kim; Young-Han,9999,0,9999,0
1668369562539,ECE 200,018,103603,Koushanfar; Farinaz,9999,0,9999,0
1668369562539,ECE 200,019,103604,Kuzum; Duygu,9999,0,9999,0
1668369562539,ECE 200,020,103605,Le; Hanh-Phuc,9999,0,9999,0
1668369562539,ECE 200,021,103606,Lin; Bill,9999,0,9999,0
1668369562539,ECE 200,022,103607,Liu; Zhaowei,9998,0,9999,1
1668369562539,ECE 200,023,103608,Lo; Yu-Hwa,9999,0,9999,0
1668369562539,ECE 200,024,103609,Lomakin; Vitaliy,9999,0,9999,0
1668369562539,ECE 200,025,103610,Mercier; Patrick Philip,9999,0,9999,0
1668369562539,ECE 200,026,103611,Meyer; Florian,9999,0,9999,0
1668369562539,ECE 200,027,103612,Milstein; Laurence B.,9999,0,9999,0
1668369562539,ECE 200,028,103613,Mir Arabbaygi; Siavash,9999,0,9999,0
1668369562539,ECE 200,029,103614,Mookherjea; Shayan,9999,0,9999,0
1668369562539,ECE 200,030,103615,Morris; Karcher William,9999,0,9999,0
1668369562539,ECE 200,031,103616,Ng; Tse Nga,9999,0,9999,0
1668369562539,ECE 200,032,103617,Nguyen; Truong Quang,9999,0,9999,0
1668369562539,ECE 200,033,103618,Nomura; Kenji,9999,0,9999,0
1668369562539,ECE 200,034,103619,Orlitsky; Alon,9999,0,9999,0
1668369562539,ECE 200,035,103620,Pal; Piya,9999,0,9999,0
1668369562539,ECE 200,036,103621,Papen; George C.,9999,0,9999,0
1668369562539,ECE 200,037,103622,Radic; Stojan,9999,0,9999,0
1668369562539,ECE 200,038,103623,Rao; Bhaskar D.,9999,0,9999,0
1668369562539,ECE 200,039,103624,Rao; Ramesh R,9999,0,9999,0
1668369562539,ECE 200,040,103625,Rebeiz; Gabriel,9999,0,9999,0
1668369562539,ECE 200,041,103626,Sanford; John R,9999,0,9999,0
1668369562539,ECE 200,042,103627,Siegel; Paul H.,9999,0,9999,0
1668369562539,ECE 200,043,103628,Sievenpiper; Daniel F.,9999,0,9999,0
1668369562539,ECE 200,044,103629,Sworder; David D.,9999,0,9999,0
1668369562539,ECE 200,045,103630,Taur; Yuan,9999,0,9999,0
1668369562539,ECE 200,046,103631,Touri; Behrouz,9999,0,9999,0
1668369562539,ECE 200,047,103632,Trivedi; Mohan M.,9999,0,9999,0
1668369562539,ECE 200,048,103633,Vasconcelos; Nuno,9999,0,9999,0
1668369562539,ECE 200,049,103634,Wang; Xiaolong,9999,0,9999,0
1668369562539,ECE 200,050,103635,Xie; Pengtao,9999,0,9999,0
1668369562539,ECE 200,051,103636,Yip; Michael,9999,0,9999,0
1668369562539,ECE 200,052,103637,Zeger; Kenneth A.,999,0,999,0
1668369562539,ECE 200,053,103638,Zhang; Xinyu,9999,0,9999,0
1668369562539,ECE 200,054,103639,Turakhia; Yatish Girish,9999,0,9999,0
1668369562539,ECE 200,055,103640,Kang; Mingu,9999,0,9999,0
1668369562539,ECE 200,056,103641,Shi; Yuanyuan,9999,0,9999,0
1668369562539,ECE 200,057,103642,Wang; Edward Jay,9999,0,9999,0
1668369562539,ECE 200,058,103643,Zheng; Yang,9999,0,9999,0
1668369562967,ECE 202,A00,103644,Kuzum; Duygu,0,0,0,0
1668369563394,ECE 212BN,A00,103646,Ng; Tse Nga,0,0,0,0
1668369563818,ECE 221,A00,111493,Staff,0,0,0,0
1668369564242,ECE 222B,A00,103647,Lomakin; Vitaliy,0,0,0,0
1668369564668,ECE 230B,A00,103648,Taur; Yuan,0,0,0,0
1668369565093,ECE 238B,A00,103649,Garay; Javier,0,0,0,0
1668369565519,ECE 240B,A00,112900,Fainman; Yeshaiahu,0,0,0,0
1668369565954,ECE 247A,A00,103650,Jokerst; Jesse Vincent,0,0,0,0
1668369566385,ECE 247B,A00,103651,Wang; Joseph,0,0,0,0
1668369566808,ECE 250,A00,103652,Siegel; Paul H.,0,0,0,0
1668369567232,ECE 251A,A00,103654,Rao; Bhaskar D.,0,0,0,0
1668369567657,ECE 257B,A00,103655,Bharadia; Dinesh,0,0,0,0
1668369568081,ECE 258A,A00,103656,Milstein; Laurence B.,0,0,0,0
1668369568515,ECE 260B,A00,103658,Kang; Mingu,0,0,0,0
1668369568947,ECE 264A,A00,103659,Galton; Ian A,0,0,0,0
1668369569392,ECE 265A,A00,103661,Gudem; Prasad S.S.,0,0,0,0
1668369569818,ECE 265D,A00,103662,Gudem; Prasad S.S.,0,0,0,0
1668369570241,ECE 268,A00,103663,Koushanfar; Farinaz,0,0,0,0
1668369570669,ECE 269,A01,103665,Pal; Piya,0,0,0,0
1668369571096,ECE 271B,A00,103666,Vasconcelos; Manuela,0,0,0,0
1668369571521,ECE 276A,A00,103667,Atanasov; Nikolay A.,0,0,0,0
1668369571948,ECE 277,A00,103668,An; Cheolhong,0,0,0,0
1668369572373,ECE 279,A00,117947,Hall; Drew A.,0,0,0,0
1668369573236,ECE 283,A00,103670,Hsueh; Tzu-Chien,0,0,0,0
1668369573661,ECE 284,A00,103671,Turakhia; Yatish Girish,0,0,0,0
1668369574090,ECE 285,A00,103672,Zheng; Yang,0,0,0,0
1668369574090,ECE 285,B00,103673,Sworder; David D.,0,0,0,0
1668369574633,ECE 287,A00,103676,Javidi; Tara,0,0,0,0
1668369575061,MATH 200B,A00,098023,Salehi Golsefidy; Alireza,12,0,15,3
1668369575493,MATH 202B,A00,098024,Rhoades; Brendon Patrick,9,0,15,6
1668369575919,MATH 203B,A00,098025,Oprea; Dragos N.,10,0,15,5
1668369576345,MATH 204B,A00,098026,Sorensen; Claus M,13,0,15,2
1668369576771,MATH 208,A00,098027,Izadi; Elham,7,0,10,3
1668369577195,MATH 209,A00,098028,Pollack; Aaron,10,0,10,0
1668369577621,MATH 211A,A00,112919,Rogalski; Daniel,9,0,10,1
1668369578046,MATH 211B,A00,112920,Seward; Brandon M.,9,0,10,1
1668369578478,MATH 218,A00,098029,Li; Bo,10,0,10,0
1668369578902,MATH 220B,A00,098030,Novak; Jonathan I,11,0,15,4
1668369579328,MATH 221A,A00,098031,Ebenfelt; Peter F,13,0,15,2
1668369579754,MATH 231B,A00,098032,Zlatos; Andrej,12,0,15,3
1668369580187,MATH 240B,A00,098033,Ni; Lei,9,0,15,6
1668369580609,MATH 243,A00,098034,Jekel; David Andrew,10,0,10,0
1668369581043,MATH 245A,A00,098035,Nie; Jiawang,0,0,15,16
1668369581469,MATH 248,A00,098036,Bejenaru; Ioan,10,0,10,0
1668369581902,MATH 250B,A00,098037,Spolaor; Luca,14,0,15,1
1668369582328,MATH 258,A00,098038,Ni; Lei,10,0,10,0
1668369582753,MATH 264B,A00,098041,Rhoades; Brendon Patrick,9,0,15,6
1668369583176,MATH 268,A00,098042,Buss; Samuel R,10,0,10,0
1668369583610,MATH 269,A00,098043,Rhoades; Brendon Patrick,10,0,10,0
1668369584033,MATH 270B,A00,098044,Li; Bo,10,0,15,5
1668369584457,MATH 272B,A00,098045,Holst; Michael J,13,0,15,2
1668369584884,MATH 273A,A00,098046,Tian; Xiaochuan,10,0,15,5
1668369585311,MATH 275,A01,098048,Tian; Xiaochuan,6,0,10,4
1668369585739,MATH 278A,A00,098049,Holst; Michael J,8,0,10,2
1668369586174,MATH 278B,A00,098050,Cloninger; Alexander,10,0,10,0
1668369586597,MATH 278C,A00,098051,Nie; Jiawang,7,0,10,3
1668369587022,MATH 280B,A00,098052,Zheng; Tianyi,8,0,15,7
1668369587445,MATH 281B,A00,098053,Bradic; Jelena,1,0,15,14
1668369587867,MATH 282B,A00,098054,Arias-Castro; Ery,0,0,15,15
1668369588293,MATH 285,A00,098055,Fitzsimmons; Patrick J,0,0,15,17
1668369588719,MATH 287B,A00,098056,Arias-Castro; Ery,2,0,15,13
1668369589143,MATH 288,A00,098057,Agarwal; Pooja,9,0,10,1
1668369589143,MATH 288,B00,098058,Zhang; Danna,8,0,10,2
1668369589143,MATH 288,C00,098059,Williams; Ruth J,9,0,10,1
1668369589568,MATH 290B,A00,098060,Roberts; Justin Deritter,13,0,15,2
1668369590002,MATH 292,A00,098061,Belmont; Eva Kinoshita,10,0,10,0
1668369590427,MATH 295,A00,098062,Suk; Andrew Hoon,48,0,50,2
1668369590852,MATH 296,A00,098063,Novak; Jonathan I,20,0,20,0
1668369591276,MATH 297,001,098064,Gamst; Anthony Collins,9997,0,9999,2
1668370097534,COGS 205,A00,101395,Chiba; Andrea,19,0,20,1
1668370097960,COGS 210B,001,101404,Greene; Deanna Jacquelyn,9998,0,9999,1
1668370097960,COGS 210B,002,101417,Xia; Haijun,9999,0,9999,0
1668370097960,COGS 210B,003,101422,Nitz; Douglas A.,9999,0,9999,0
1668370097960,COGS 210B,004,101423,Hollan; James D.,9998,0,9999,1
1668370097960,COGS 210B,005,101424,Deak; Gedeon O.,9998,0,9999,1
1668370097960,COGS 210B,006,101425,Rossano; Federico,9999,0,9999,0
1668370098385,COGS 211B,A00,101427,Coulson; Seana M,9996,0,9999,3
1668370098811,COGS 220,A00,101428,Hollan; James D.,0,0,25,25
1668370099236,COGS 229,A00,101429,Dow; Steven P,18,0,25,7
1668370099662,COGS 230,A00,101430,Klemmer; Scott R,11,0,17,6
1668370100084,COGS 234,A00,101431,Xia; Haijun,1,0,25,24
1668370100507,COGS 260,A00,101432,Kiyonaga; Anastasia,21,0,25,4
1668370100507,COGS 260,B00,101433,Kirsh; David Joel,15,0,25,10
1668370101028,CSE 202,A00,102371,Impagliazzo; Russell,0,0,0,0
1668370101462,CSE 203B,A01,102373,Cheng; Chung Kuan,0,0,0,0
1668370101899,CSE 208,A00,102374,Micciancio; Daniele,0,0,0,0
1668370102325,CSE 209A,A00,112895,Impagliazzo; Russell,0,0,15,15
1668370102749,CSE 209B,A00,108005,Bellare; Mihir,0,0,0,0
1668370103177,CSE 210,A00,113163,Coblenz; Michael J,0,0,0,0
1668370103601,CSE 219,A00,106111,Dow; Steven P,0,0,20,20
1668370104033,CSE 221,A00,102376,Voelker; Geoffrey M.,0,0,0,0
1668370104456,CSE 224,A01,102378,Porter; George M,0,0,0,0
1668370104888,CSE 229A,A00,102379,Savage; Stefan,0,0,0,0
1668370105311,CSE 229C,A00,102380,Munyaka; Imani N. S.,0,0,0,0
1668370105739,CSE 232B,A00,102382,Deutsch; Alin Bernard,0,0,0,0
1668370106167,CSE 234,A01,112904,Kumar; Arun Kumar,0,0,0,0
1668370106590,CSE 237A,A00,102383,Rosing; Tajana Simunic,0,0,0,0
1668370107017,CSE 239A,A00,102384,Deutsch; Alin Bernard,0,0,0,0
1668370107441,CSE 239B,A00,102385,Polikarpova; Nadezhda,0,0,0,0
1668370107865,CSE 240A,A00,102386,Pannuto; Patrick William,0,0,0,0
1668370108292,CSE 240B,A00,102387,Zhao; Jishen,0,0,0,0
1668370108723,CSE 241A,A00,106406,Kang; Mingu,0,0,0,0
1668370109156,CSE 249B,A00,102388,Kahng; Andrew Byun,0,0,8,8
1668370109593,CSE 251B,A01,102392,Cottrell; Garrison W,0,0,0,0
1668370109593,CSE 251B,A02,102393,Cottrell; Garrison W,0,0,0,0
1668370110017,CSE 252B,A00,102394,Ochoa; Benjamin Lawrence,0,0,0,0
1668370110446,CSE 257,A01,102396,Gao; Sicun,0,0,0,0
1668370110875,CSE 272,A00,102397,Li; Tzumao,0,0,0,0
1668370111300,CSE 274,A00,111323,Chern; Albert Ren-Haur,0,0,0,0
1668370111723,CSE 282,A00,102398,Pevzner; Pavel Arkadjevich,0,0,0,0
1668370112151,CSE 284,A00,114175,Gymrek; Melissa Ann,0,0,0,0
1668370112578,CSE 290,A00,102399,Chandraker; Manmohan Krishna,0,0,0,0
1668370112578,CSE 290,B00,102400,Vaccaro; Kristen Marie,0,0,25,25
1668370112578,CSE 290,C00,102414,Pannuto; Patrick William,0,0,25,25
1668370112578,CSE 290,D00,102427,Pevzner; Pavel Arkadjevich,0,0,0,0
1668370112578,CSE 290,E00,102429,Zhao; Jishen,0,0,0,0
1668370112578,CSE 290,F00,102436,Tullsen; Dean Michael,0,0,0,0
1668370112578,CSE 290,G00,102440,Christensen; Henrik I,0,0,20,20
1668370113007,CSE 291,A00,102443,Su; Hao,0,0,0,0
1668370113007,CSE 291,B00,102448,Polikarpova; Nadezhda,0,0,0,0
1668370113007,CSE 291,C00,102453,Vaccaro; Kristen Marie,0,0,0,0
1668370113007,CSE 291,D00,111343,Savage; Stefan,0,0,0,0
1668370113007,CSE 291,E00,116474,Claffy; Kimberly Claire,0,0,0,0
1668370113007,CSE 291,F00,116479,Pasquale; Joseph,0,0,0,0
1668370113441,CSE 293,001,119111,Bafna; Vineet,9999,0,9999,0
1668370113441,CSE 293,002,119118,Bellare; Mihir,9999,0,9999,0
1668370113441,CSE 293,003,119122,Berg-Kirkpatrick; Taylor D,9999,0,9999,0
1668370113441,CSE 293,004,119135,Christensen; Henrik I,9999,0,9999,0
1668370113441,CSE 293,005,119142,Cottrell; Garrison W,9999,0,9999,0
1668370113441,CSE 293,006,119146,Deutsch; Alin Bernard,9999,0,9999,0
1668370113441,CSE 293,007,119159,Esmaeilzadeh; Hadi,9999,0,9999,0
1668370113441,CSE 293,008,119166,Freund; Yoav,9999,0,9999,0
1668370113441,CSE 293,009,119170,Griswold; William G.,9999,0,9999,0
1668370113441,CSE 293,010,119183,Gymrek; Melissa Ann,9999,0,9999,0
1668370113441,CSE 293,011,119190,Heninger; Nadia A,9999,0,9999,0
1668370113441,CSE 293,012,119230,Impagliazzo; Russell,9999,0,9999,0
1668370113441,CSE 293,013,119232,Jhala; Ranjit,9999,0,9999,0
1668370113441,CSE 293,014,119233,Kahng; Andrew Byun,9999,0,9999,0
1668370113441,CSE 293,015,119298,Kane; Daniel Mertz,9999,0,9999,0
1668370113441,CSE 293,016,119299,Kriegman; David J,9999,0,9999,0
1668370113441,CSE 293,017,119300,Kumar; Arun Kumar,9999,0,9999,0
1668370113441,CSE 293,018,119301,Lerner; Sorin,9999,0,9999,0
1668370113441,CSE 293,019,119302,Lovett; Shachar,9999,0,9999,0
1668370113441,CSE 293,020,119303,McAuley; Julian John,9999,0,9999,0
1668370113441,CSE 293,021,119304,Micciancio; Daniele,9999,0,9999,0
1668370113441,CSE 293,022,119367,Orailoglu; Alex,9999,0,9999,0
1668370113441,CSE 293,023,119382,Paturi; Ramamohan,9999,0,9999,0
1668370113441,CSE 293,024,119404,Polikarpova; Nadezhda,9999,0,9999,0
1668370113441,CSE 293,025,119406,Politz; Joseph Gibbs,9999,0,9999,0
1668370113441,CSE 293,026,119411,Porter; George M,9999,0,9999,0
1668370113441,CSE 293,027,119414,Porter; Leonard Emerson,9999,0,9999,0
1668370113441,CSE 293,028,119416,Ramamoorthi; Ravi,9999,0,9999,0
1668370113441,CSE 293,029,119417,Sahoo; Debashis,9999,0,9999,0
1668370113441,CSE 293,030,119420,Saul; Lawrence,9999,0,9999,0
1668370113441,CSE 293,031,119421,Savage; Stefan,9999,0,9999,0
1668370113441,CSE 293,032,119425,Schulze; Jurgen P.,9999,0,9999,0
1668370113441,CSE 293,033,119426,Snoeren; Alex C.,9999,0,9999,0
1668370113441,CSE 293,034,119428,Shang; Jingbo,9999,0,9999,0
1668370113441,CSE 293,035,119430,Stefan; Deian,9999,0,9999,0
1668370113441,CSE 293,036,119431,Su; Hao,9999,0,9999,0
1668370113441,CSE 293,037,119433,Swanson; Steven James,9999,0,9999,0
1668370113441,CSE 293,038,119435,Tullsen; Dean Michael,9999,0,9999,0
1668370113441,CSE 293,039,119483,Voelker; Geoffrey M.,9999,0,9999,0
1668370113441,CSE 293,040,119537,Zhao; Jishen,9999,0,9999,0
1668370113441,CSE 293,041,119538,Zhou; Yuan-Yuan,9999,0,9999,0
1668370113441,CSE 293,042,119539,Gao; Sicun,9999,0,9999,0
1668370113441,CSE 293,043,119540,Weibel; Nadir,9999,0,9999,0
1668370113441,CSE 293,044,119541,Gupta; Rajesh K.,9999,0,9999,0
1668370113441,CSE 293,045,126410,Vaccaro; Kristen Marie,9999,0,9999,0
1668370113441,CSE 293,046,126411,Klemke; Richard,9999,0,9999,0
1668370113869,CSE 294,A00,102459,Voelker; Geoffrey M.,0,0,0,0
1668370113869,CSE 294,B00,111322,Orailoglu; Alex,0,0,0,0
1668370114295,DSE 201,A00,096914,Deutsch; Alin Bernard,30,0,30,0
1668370114721,DSE 210,A00,096915,Dasgupta; Sanjoy,30,0,30,0
1668370115148,DSE 260A,A00,096916,Altintas De Callaf; Ilkay,30,0,30,0
1668370115602,ECE 200,001,103586,Antipa; Nicholas A,9999,0,9999,0
1668370115602,ECE 200,002,103587,Atanasov; Nikolay A.,9999,0,9999,0
1668370115602,ECE 200,003,103588,Bharadia; Dinesh,9999,0,9999,0
1668370115602,ECE 200,004,103589,Cheng; Chung Kuan,9999,0,9999,0
1668370115602,ECE 200,005,103590,Cosman; Pamela C.,9999,0,9999,0
1668370115602,ECE 200,006,103591,Dayeh; Shadi Ahmad,9999,0,9999,0
1668370115602,ECE 200,007,103592,Fainman; Yeshaiahu,9999,0,9999,0
1668370115602,ECE 200,008,103593,Ford; Joseph Earl,9999,0,9999,0
1668370115602,ECE 200,009,103594,Franceschetti; Massimo,9999,0,9999,0
1668370115602,ECE 200,010,103595,Fullerton; Eric E,9999,0,9999,0
1668370115602,ECE 200,011,103596,Galton; Ian A,9999,0,9999,0
1668370115602,ECE 200,012,103597,Gilja; Vikash,9999,0,9999,0
1668370115602,ECE 200,013,103598,Hall; Drew A.,9999,0,9999,0
1668370115602,ECE 200,014,103599,Hsueh; Tzu-Chien,9999,0,9999,0
1668370115602,ECE 200,015,103600,Javidi; Tara,9999,0,9999,0
1668370115602,ECE 200,016,103601,Kahng; Andrew Byun,9999,0,9999,0
1668370115602,ECE 200,017,103602,Kim; Young-Han,9999,0,9999,0
1668370115602,ECE 200,018,103603,Koushanfar; Farinaz,9999,0,9999,0
1668370115602,ECE 200,019,103604,Kuzum; Duygu,9999,0,9999,0
1668370115602,ECE 200,020,103605,Le; Hanh-Phuc,9999,0,9999,0
1668370115602,ECE 200,021,103606,Lin; Bill,9999,0,9999,0
1668370115602,ECE 200,022,103607,Liu; Zhaowei,9998,0,9999,1
1668370115602,ECE 200,023,103608,Lo; Yu-Hwa,9999,0,9999,0
1668370115602,ECE 200,024,103609,Lomakin; Vitaliy,9999,0,9999,0
1668370115602,ECE 200,025,103610,Mercier; Patrick Philip,9999,0,9999,0
1668370115602,ECE 200,026,103611,Meyer; Florian,9999,0,9999,0
1668370115602,ECE 200,027,103612,Milstein; Laurence B.,9999,0,9999,0
1668370115602,ECE 200,028,103613,Mir Arabbaygi; Siavash,9999,0,9999,0
1668370115602,ECE 200,029,103614,Mookherjea; Shayan,9999,0,9999,0
1668370115602,ECE 200,030,103615,Morris; Karcher William,9999,0,9999,0
1668370115602,ECE 200,031,103616,Ng; Tse Nga,9999,0,9999,0
1668370115602,ECE 200,032,103617,Nguyen; Truong Quang,9999,0,9999,0
1668370115602,ECE 200,033,103618,Nomura; Kenji,9999,0,9999,0
1668370115602,ECE 200,034,103619,Orlitsky; Alon,9999,0,9999,0
1668370115602,ECE 200,035,103620,Pal; Piya,9999,0,9999,0
1668370115602,ECE 200,036,103621,Papen; George C.,9999,0,9999,0
1668370115602,ECE 200,037,103622,Radic; Stojan,9999,0,9999,0
1668370115602,ECE 200,038,103623,Rao; Bhaskar D.,9999,0,9999,0
1668370115602,ECE 200,039,103624,Rao; Ramesh R,9999,0,9999,0
1668370115602,ECE 200,040,103625,Rebeiz; Gabriel,9999,0,9999,0
1668370115602,ECE 200,041,103626,Sanford; John R,9999,0,9999,0
1668370115602,ECE 200,042,103627,Siegel; Paul H.,9999,0,9999,0
1668370115602,ECE 200,043,103628,Sievenpiper; Daniel F.,9999,0,9999,0
1668370115602,ECE 200,044,103629,Sworder; David D.,9999,0,9999,0
1668370115602,ECE 200,045,103630,Taur; Yuan,9999,0,9999,0
1668370115602,ECE 200,046,103631,Touri; Behrouz,9999,0,9999,0
1668370115602,ECE 200,047,103632,Trivedi; Mohan M.,9999,0,9999,0
1668370115602,ECE 200,048,103633,Vasconcelos; Nuno,9999,0,9999,0
1668370115602,ECE 200,049,103634,Wang; Xiaolong,9999,0,9999,0
1668370115602,ECE 200,050,103635,Xie; Pengtao,9999,0,9999,0
1668370115602,ECE 200,051,103636,Yip; Michael,9999,0,9999,0
1668370115602,ECE 200,052,103637,Zeger; Kenneth A.,999,0,999,0
1668370115602,ECE 200,053,103638,Zhang; Xinyu,9999,0,9999,0
1668370115602,ECE 200,054,103639,Turakhia; Yatish Girish,9999,0,9999,0
1668370115602,ECE 200,055,103640,Kang; Mingu,9999,0,9999,0
1668370115602,ECE 200,056,103641,Shi; Yuanyuan,9999,0,9999,0
1668370115602,ECE 200,057,103642,Wang; Edward Jay,9999,0,9999,0
1668370115602,ECE 200,058,103643,Zheng; Yang,9999,0,9999,0
1668370116038,ECE 202,A00,103644,Kuzum; Duygu,0,0,0,0
1668370116462,ECE 212BN,A00,103646,Ng; Tse Nga,0,0,0,0
1668370116889,ECE 221,A00,111493,Staff,0,0,0,0
1668370117314,ECE 222B,A00,103647,Lomakin; Vitaliy,0,0,0,0
1668370117741,ECE 230B,A00,103648,Taur; Yuan,0,0,0,0
1668370118164,ECE 238B,A00,103649,Garay; Javier,0,0,0,0
1668370118592,ECE 240B,A00,112900,Fainman; Yeshaiahu,0,0,0,0
1668370119017,ECE 247A,A00,103650,Jokerst; Jesse Vincent,0,0,0,0
1668370119450,ECE 247B,A00,103651,Wang; Joseph,0,0,0,0
1668370119874,ECE 250,A00,103652,Siegel; Paul H.,0,0,0,0
1668370120298,ECE 251A,A00,103654,Rao; Bhaskar D.,0,0,0,0
1668370120722,ECE 257B,A00,103655,Bharadia; Dinesh,0,0,0,0
1668370121155,ECE 258A,A00,103656,Milstein; Laurence B.,0,0,0,0
1668370121580,ECE 260B,A00,103658,Kang; Mingu,0,0,0,0
1668370122013,ECE 264A,A00,103659,Galton; Ian A,0,0,0,0
1668370122442,ECE 265A,A00,103661,Gudem; Prasad S.S.,0,0,0,0
1668370122868,ECE 265D,A00,103662,Gudem; Prasad S.S.,0,0,0,0
1668370123291,ECE 268,A00,103663,Koushanfar; Farinaz,0,0,0,0
1668370123719,ECE 269,A01,103665,Pal; Piya,0,0,0,0
1668370124143,ECE 271B,A00,103666,Vasconcelos; Manuela,0,0,0,0
1668370124566,ECE 276A,A00,103667,Atanasov; Nikolay A.,0,0,0,0
1668370124990,ECE 277,A00,103668,An; Cheolhong,0,0,0,0
1668370125416,ECE 279,A00,117947,Hall; Drew A.,0,0,0,0
1668370126267,ECE 283,A00,103670,Hsueh; Tzu-Chien,0,0,0,0
1668370126694,ECE 284,A00,103671,Turakhia; Yatish Girish,0,0,0,0
1668370127118,ECE 285,A00,103672,Zheng; Yang,0,0,0,0
1668370127118,ECE 285,B00,103673,Sworder; David D.,0,0,0,0
1668370127541,ECE 287,A00,103676,Javidi; Tara,0,0,0,0
1668370127976,MATH 200B,A00,098023,Salehi Golsefidy; Alireza,12,0,15,3
1668370128410,MATH 202B,A00,098024,Rhoades; Brendon Patrick,9,0,15,6
1668370128842,MATH 203B,A00,098025,Oprea; Dragos N.,10,0,15,5
1668370129264,MATH 204B,A00,098026,Sorensen; Claus M,13,0,15,2
1668370129696,MATH 208,A00,098027,Izadi; Elham,7,0,10,3
1668370130119,MATH 209,A00,098028,Pollack; Aaron,10,0,10,0
1668370130550,MATH 211A,A00,112919,Rogalski; Daniel,9,0,10,1
1668370130988,MATH 211B,A00,112920,Seward; Brandon M.,9,0,10,1
1668370131428,MATH 218,A00,098029,Li; Bo,10,0,10,0
1668370131855,MATH 220B,A00,098030,Novak; Jonathan I,11,0,15,4
1668370132281,MATH 221A,A00,098031,Ebenfelt; Peter F,13,0,15,2
1668370132705,MATH 231B,A00,098032,Zlatos; Andrej,12,0,15,3
1668370133129,MATH 240B,A00,098033,Ni; Lei,9,0,15,6
1668370133567,MATH 243,A00,098034,Jekel; David Andrew,10,0,10,0
1668370134006,MATH 245A,A00,098035,Nie; Jiawang,0,0,15,16
1668370134429,MATH 248,A00,098036,Bejenaru; Ioan,10,0,10,0
1668370134867,MATH 250B,A00,098037,Spolaor; Luca,14,0,15,1
1668370135289,MATH 258,A00,098038,Ni; Lei,10,0,10,0
1668370135715,MATH 264B,A00,098041,Rhoades; Brendon Patrick,9,0,15,6
1668370136142,MATH 268,A00,098042,Buss; Samuel R,10,0,10,0
1668370136564,MATH 269,A00,098043,Rhoades; Brendon Patrick,10,0,10,0
1668370136987,MATH 270B,A00,098044,Li; Bo,10,0,15,5
1668370137415,MATH 272B,A00,098045,Holst; Michael J,13,0,15,2
1668370137838,MATH 273A,A00,098046,Tian; Xiaochuan,10,0,15,5
1668370138260,MATH 275,A01,098048,Tian; Xiaochuan,6,0,10,4
1668370138684,MATH 278A,A00,098049,Holst; Michael J,8,0,10,2
1668370139108,MATH 278B,A00,098050,Cloninger; Alexander,10,0,10,0
1668370139535,MATH 278C,A00,098051,Nie; Jiawang,7,0,10,3
1668370139958,MATH 280B,A00,098052,Zheng; Tianyi,8,0,15,7
1668370140393,MATH 281B,A00,098053,Bradic; Jelena,1,0,15,14
1668370140831,MATH 282B,A00,098054,Arias-Castro; Ery,0,0,15,15
1668370141272,MATH 285,A00,098055,Fitzsimmons; Patrick J,0,0,15,17
1668370141698,MATH 287B,A00,098056,Arias-Castro; Ery,2,0,15,13
1668370142135,MATH 288,A00,098057,Agarwal; Pooja,9,0,10,1
1668370142135,MATH 288,B00,098058,Zhang; Danna,8,0,10,2
1668370142135,MATH 288,C00,098059,Williams; Ruth J,9,0,10,1
1668370142560,MATH 290B,A00,098060,Roberts; Justin Deritter,13,0,15,2
1668370142986,MATH 292,A00,098061,Belmont; Eva Kinoshita,10,0,10,0
1668370143412,MATH 295,A00,098062,Suk; Andrew Hoon,48,0,50,2
1668370143835,MATH 296,A00,098063,Novak; Jonathan I,20,0,20,0
1668370144337,MATH 297,001,098064,Gamst; Anthony Collins,9997,0,9999,2
1668370649543,COGS 205,A00,101395,Chiba; Andrea,19,0,20,1
1668370649964,COGS 210B,001,101404,Greene; Deanna Jacquelyn,9998,0,9999,1
1668370649964,COGS 210B,002,101417,Xia; Haijun,9999,0,9999,0
1668370649964,COGS 210B,003,101422,Nitz; Douglas A.,9999,0,9999,0
1668370649964,COGS 210B,004,101423,Hollan; James D.,9998,0,9999,1
1668370649964,COGS 210B,005,101424,Deak; Gedeon O.,9998,0,9999,1
1668370649964,COGS 210B,006,101425,Rossano; Federico,9999,0,9999,0
1668370650388,COGS 211B,A00,101427,Coulson; Seana M,9996,0,9999,3
1668370650812,COGS 220,A00,101428,Hollan; James D.,0,0,25,25
1668370651239,COGS 229,A00,101429,Dow; Steven P,18,0,25,7
1668370651677,COGS 230,A00,101430,Klemmer; Scott R,11,0,17,6
1668370652109,COGS 234,A00,101431,Xia; Haijun,1,0,25,24
1668370652541,COGS 260,A00,101432,Kiyonaga; Anastasia,21,0,25,4
1668370652541,COGS 260,B00,101433,Kirsh; David Joel,15,0,25,10
1668370652965,CSE 202,A00,102371,Impagliazzo; Russell,0,0,0,0
1668370653402,CSE 203B,A01,102373,Cheng; Chung Kuan,0,0,0,0
1668370653831,CSE 208,A00,102374,Micciancio; Daniele,0,0,0,0
1668370654257,CSE 209A,A00,112895,Impagliazzo; Russell,0,0,15,15
1668370654681,CSE 209B,A00,108005,Bellare; Mihir,0,0,0,0
1668370655103,CSE 210,A00,113163,Coblenz; Michael J,0,0,0,0
1668370655528,CSE 219,A00,106111,Dow; Steven P,0,0,20,20
1668370655950,CSE 221,A00,102376,Voelker; Geoffrey M.,0,0,0,0
1668370656376,CSE 224,A01,102378,Porter; George M,0,0,0,0
1668370656798,CSE 229A,A00,102379,Savage; Stefan,0,0,0,0
1668370657226,CSE 229C,A00,102380,Munyaka; Imani N. S.,0,0,0,0
1668370657659,CSE 232B,A00,102382,Deutsch; Alin Bernard,0,0,0,0
1668370658087,CSE 234,A01,112904,Kumar; Arun Kumar,0,0,0,0
1668370658526,CSE 237A,A00,102383,Rosing; Tajana Simunic,0,0,0,0
1668370658949,CSE 239A,A00,102384,Deutsch; Alin Bernard,0,0,0,0
1668370659373,CSE 239B,A00,102385,Polikarpova; Nadezhda,0,0,0,0
1668370659798,CSE 240A,A00,102386,Pannuto; Patrick William,0,0,0,0
1668370660221,CSE 240B,A00,102387,Zhao; Jishen,0,0,0,0
1668370660651,CSE 241A,A00,106406,Kang; Mingu,0,0,0,0
1668370661074,CSE 249B,A00,102388,Kahng; Andrew Byun,0,0,8,8
1668370661500,CSE 251B,A01,102392,Cottrell; Garrison W,0,0,0,0
1668370661500,CSE 251B,A02,102393,Cottrell; Garrison W,0,0,0,0
1668370661925,CSE 252B,A00,102394,Ochoa; Benjamin Lawrence,0,0,0,0
1668370662348,CSE 257,A01,102396,Gao; Sicun,0,0,0,0
1668370662777,CSE 272,A00,102397,Li; Tzumao,0,0,0,0
1668370663200,CSE 274,A00,111323,Chern; Albert Ren-Haur,0,0,0,0
1668370663627,CSE 282,A00,102398,Pevzner; Pavel Arkadjevich,0,0,0,0
1668370664061,CSE 284,A00,114175,Gymrek; Melissa Ann,0,0,0,0
1668370664486,CSE 290,A00,102399,Chandraker; Manmohan Krishna,0,0,0,0
1668370664486,CSE 290,B00,102400,Vaccaro; Kristen Marie,0,0,25,25
1668370664486,CSE 290,C00,102414,Pannuto; Patrick William,0,0,25,25
1668370664486,CSE 290,D00,102427,Pevzner; Pavel Arkadjevich,0,0,0,0
1668370664486,CSE 290,E00,102429,Zhao; Jishen,0,0,0,0
1668370664486,CSE 290,F00,102436,Tullsen; Dean Michael,0,0,0,0
1668370664486,CSE 290,G00,102440,Christensen; Henrik I,0,0,20,20
1668370664913,CSE 291,A00,102443,Su; Hao,0,0,0,0
1668370664913,CSE 291,B00,102448,Polikarpova; Nadezhda,0,0,0,0
1668370664913,CSE 291,C00,102453,Vaccaro; Kristen Marie,0,0,0,0
1668370664913,CSE 291,D00,111343,Savage; Stefan,0,0,0,0
1668370664913,CSE 291,E00,116474,Claffy; Kimberly Claire,0,0,0,0
1668370664913,CSE 291,F00,116479,Pasquale; Joseph,0,0,0,0
1668370665350,CSE 293,001,119111,Bafna; Vineet,9999,0,9999,0
1668370665350,CSE 293,002,119118,Bellare; Mihir,9999,0,9999,0
1668370665350,CSE 293,003,119122,Berg-Kirkpatrick; Taylor D,9999,0,9999,0
1668370665350,CSE 293,004,119135,Christensen; Henrik I,9999,0,9999,0
1668370665350,CSE 293,005,119142,Cottrell; Garrison W,9999,0,9999,0
1668370665350,CSE 293,006,119146,Deutsch; Alin Bernard,9999,0,9999,0
1668370665350,CSE 293,007,119159,Esmaeilzadeh; Hadi,9999,0,9999,0
1668370665350,CSE 293,008,119166,Freund; Yoav,9999,0,9999,0
1668370665350,CSE 293,009,119170,Griswold; William G.,9999,0,9999,0
1668370665350,CSE 293,010,119183,Gymrek; Melissa Ann,9999,0,9999,0
1668370665350,CSE 293,011,119190,Heninger; Nadia A,9999,0,9999,0
1668370665350,CSE 293,012,119230,Impagliazzo; Russell,9999,0,9999,0
1668370665350,CSE 293,013,119232,Jhala; Ranjit,9999,0,9999,0
1668370665350,CSE 293,014,119233,Kahng; Andrew Byun,9999,0,9999,0
1668370665350,CSE 293,015,119298,Kane; Daniel Mertz,9999,0,9999,0
1668370665350,CSE 293,016,119299,Kriegman; David J,9999,0,9999,0
1668370665350,CSE 293,017,119300,Kumar; Arun Kumar,9999,0,9999,0
1668370665350,CSE 293,018,119301,Lerner; Sorin,9999,0,9999,0
1668370665350,CSE 293,019,119302,Lovett; Shachar,9999,0,9999,0
1668370665350,CSE 293,020,119303,McAuley; Julian John,9999,0,9999,0
1668370665350,CSE 293,021,119304,Micciancio; Daniele,9999,0,9999,0
1668370665350,CSE 293,022,119367,Orailoglu; Alex,9999,0,9999,0
1668370665350,CSE 293,023,119382,Paturi; Ramamohan,9999,0,9999,0
1668370665350,CSE 293,024,119404,Polikarpova; Nadezhda,9999,0,9999,0
1668370665350,CSE 293,025,119406,Politz; Joseph Gibbs,9999,0,9999,0
1668370665350,CSE 293,026,119411,Porter; George M,9999,0,9999,0
1668370665350,CSE 293,027,119414,Porter; Leonard Emerson,9999,0,9999,0
1668370665350,CSE 293,028,119416,Ramamoorthi; Ravi,9999,0,9999,0
1668370665350,CSE 293,029,119417,Sahoo; Debashis,9999,0,9999,0
1668370665350,CSE 293,030,119420,Saul; Lawrence,9999,0,9999,0
1668370665350,CSE 293,031,119421,Savage; Stefan,9999,0,9999,0
1668370665350,CSE 293,032,119425,Schulze; Jurgen P.,9999,0,9999,0
1668370665350,CSE 293,033,119426,Snoeren; Alex C.,9999,0,9999,0
1668370665350,CSE 293,034,119428,Shang; Jingbo,9999,0,9999,0
1668370665350,CSE 293,035,119430,Stefan; Deian,9999,0,9999,0
1668370665350,CSE 293,036,119431,Su; Hao,9999,0,9999,0
1668370665350,CSE 293,037,119433,Swanson; Steven James,9999,0,9999,0
1668370665350,CSE 293,038,119435,Tullsen; Dean Michael,9999,0,9999,0
1668370665350,CSE 293,039,119483,Voelker; Geoffrey M.,9999,0,9999,0
1668370665350,CSE 293,040,119537,Zhao; Jishen,9999,0,9999,0
1668370665350,CSE 293,041,119538,Zhou; Yuan-Yuan,9999,0,9999,0
1668370665350,CSE 293,042,119539,Gao; Sicun,9999,0,9999,0
1668370665350,CSE 293,043,119540,Weibel; Nadir,9999,0,9999,0
1668370665350,CSE 293,044,119541,Gupta; Rajesh K.,9999,0,9999,0
1668370665350,CSE 293,045,126410,Vaccaro; Kristen Marie,9999,0,9999,0
1668370665350,CSE 293,046,126411,Klemke; Richard,9999,0,9999,0
1668370665774,CSE 294,A00,102459,Voelker; Geoffrey M.,0,0,0,0
1668370665774,CSE 294,B00,111322,Orailoglu; Alex,0,0,0,0
1668370666206,DSE 201,A00,096914,Deutsch; Alin Bernard,30,0,30,0
1668370666632,DSE 210,A00,096915,Dasgupta; Sanjoy,30,0,30,0
1668370667056,DSE 260A,A00,096916,Altintas De Callaf; Ilkay,30,0,30,0
1668370667547,ECE 200,001,103586,Antipa; Nicholas A,9999,0,9999,0
1668370667547,ECE 200,002,103587,Atanasov; Nikolay A.,9999,0,9999,0
1668370667547,ECE 200,003,103588,Bharadia; Dinesh,9999,0,9999,0
1668370667547,ECE 200,004,103589,Cheng; Chung Kuan,9999,0,9999,0
1668370667547,ECE 200,005,103590,Cosman; Pamela C.,9999,0,9999,0
1668370667547,ECE 200,006,103591,Dayeh; Shadi Ahmad,9999,0,9999,0
1668370667547,ECE 200,007,103592,Fainman; Yeshaiahu,9999,0,9999,0
1668370667547,ECE 200,008,103593,Ford; Joseph Earl,9999,0,9999,0
1668370667547,ECE 200,009,103594,Franceschetti; Massimo,9999,0,9999,0
1668370667547,ECE 200,010,103595,Fullerton; Eric E,9999,0,9999,0
1668370667547,ECE 200,011,103596,Galton; Ian A,9999,0,9999,0
1668370667547,ECE 200,012,103597,Gilja; Vikash,9999,0,9999,0
1668370667547,ECE 200,013,103598,Hall; Drew A.,9999,0,9999,0
1668370667547,ECE 200,014,103599,Hsueh; Tzu-Chien,9999,0,9999,0
1668370667547,ECE 200,015,103600,Javidi; Tara,9999,0,9999,0
1668370667547,ECE 200,016,103601,Kahng; Andrew Byun,9999,0,9999,0
1668370667547,ECE 200,017,103602,Kim; Young-Han,9999,0,9999,0
1668370667547,ECE 200,018,103603,Koushanfar; Farinaz,9999,0,9999,0
1668370667547,ECE 200,019,103604,Kuzum; Duygu,9999,0,9999,0
1668370667547,ECE 200,020,103605,Le; Hanh-Phuc,9999,0,9999,0
1668370667547,ECE 200,021,103606,Lin; Bill,9999,0,9999,0
1668370667547,ECE 200,022,103607,Liu; Zhaowei,9998,0,9999,1
1668370667547,ECE 200,023,103608,Lo; Yu-Hwa,9999,0,9999,0
1668370667547,ECE 200,024,103609,Lomakin; Vitaliy,9999,0,9999,0
1668370667547,ECE 200,025,103610,Mercier; Patrick Philip,9999,0,9999,0
1668370667547,ECE 200,026,103611,Meyer; Florian,9999,0,9999,0
1668370667547,ECE 200,027,103612,Milstein; Laurence B.,9999,0,9999,0
1668370667547,ECE 200,028,103613,Mir Arabbaygi; Siavash,9999,0,9999,0
1668370667547,ECE 200,029,103614,Mookherjea; Shayan,9999,0,9999,0
1668370667547,ECE 200,030,103615,Morris; Karcher William,9999,0,9999,0
1668370667547,ECE 200,031,103616,Ng; Tse Nga,9999,0,9999,0
1668370667547,ECE 200,032,103617,Nguyen; Truong Quang,9999,0,9999,0
1668370667547,ECE 200,033,103618,Nomura; Kenji,9999,0,9999,0
1668370667547,ECE 200,034,103619,Orlitsky; Alon,9999,0,9999,0
1668370667547,ECE 200,035,103620,Pal; Piya,9999,0,9999,0
1668370667547,ECE 200,036,103621,Papen; George C.,9999,0,9999,0
1668370667547,ECE 200,037,103622,Radic; Stojan,9999,0,9999,0
1668370667547,ECE 200,038,103623,Rao; Bhaskar D.,9999,0,9999,0
1668370667547,ECE 200,039,103624,Rao; Ramesh R,9999,0,9999,0
1668370667547,ECE 200,040,103625,Rebeiz; Gabriel,9999,0,9999,0
1668370667547,ECE 200,041,103626,Sanford; John R,9999,0,9999,0
1668370667547,ECE 200,042,103627,Siegel; Paul H.,9999,0,9999,0
1668370667547,ECE 200,043,103628,Sievenpiper; Daniel F.,9999,0,9999,0
1668370667547,ECE 200,044,103629,Sworder; David D.,9999,0,9999,0
1668370667547,ECE 200,045,103630,Taur; Yuan,9999,0,9999,0
1668370667547,ECE 200,046,103631,Touri; Behrouz,9999,0,9999,0
1668370667547,ECE 200,047,103632,Trivedi; Mohan M.,9999,0,9999,0
1668370667547,ECE 200,048,103633,Vasconcelos; Nuno,9999,0,9999,0
1668370667547,ECE 200,049,103634,Wang; Xiaolong,9999,0,9999,0
1668370667547,ECE 200,050,103635,Xie; Pengtao,9999,0,9999,0
1668370667547,ECE 200,051,103636,Yip; Michael,9999,0,9999,0
1668370667547,ECE 200,052,103637,Zeger; Kenneth A.,999,0,999,0
1668370667547,ECE 200,053,103638,Zhang; Xinyu,9999,0,9999,0
1668370667547,ECE 200,054,103639,Turakhia; Yatish Girish,9999,0,9999,0
1668370667547,ECE 200,055,103640,Kang; Mingu,9999,0,9999,0
1668370667547,ECE 200,056,103641,Shi; Yuanyuan,9999,0,9999,0
1668370667547,ECE 200,057,103642,Wang; Edward Jay,9999,0,9999,0
1668370667547,ECE 200,058,103643,Zheng; Yang,9999,0,9999,0
1668370667977,ECE 202,A00,103644,Kuzum; Duygu,0,0,0,0
1668370668410,ECE 212BN,A00,103646,Ng; Tse Nga,0,0,0,0
1668370668836,ECE 221,A00,111493,Staff,0,0,0,0
1668370669273,ECE 222B,A00,103647,Lomakin; Vitaliy,0,0,0,0
1668370669772,ECE 230B,A00,103648,Taur; Yuan,0,0,0,0
1668370670198,ECE 238B,A00,103649,Garay; Javier,0,0,0,0
1668370670626,ECE 240B,A00,112900,Fainman; Yeshaiahu,0,0,0,0
1668370671049,ECE 247A,A00,103650,Jokerst; Jesse Vincent,0,0,0,0
1668370671477,ECE 247B,A00,103651,Wang; Joseph,0,0,0,0
1668370671900,ECE 250,A00,103652,Siegel; Paul H.,0,0,0,0
1668370672322,ECE 251A,A00,103654,Rao; Bhaskar D.,0,0,0,0
1668370672745,ECE 257B,A00,103655,Bharadia; Dinesh,0,0,0,0
1668370673173,ECE 258A,A00,103656,Milstein; Laurence B.,0,0,0,0
1668370673600,ECE 260B,A00,103658,Kang; Mingu,0,0,0,0
1668370674025,ECE 264A,A00,103659,Galton; Ian A,0,0,0,0
1668370674451,ECE 265A,A00,103661,Gudem; Prasad S.S.,0,0,0,0
1668370674876,ECE 265D,A00,103662,Gudem; Prasad S.S.,0,0,0,0
1668370675303,ECE 268,A00,103663,Koushanfar; Farinaz,0,0,0,0
1668370675730,ECE 269,A01,103665,Pal; Piya,0,0,0,0
1668370676155,ECE 271B,A00,103666,Vasconcelos; Manuela,0,0,0,0
1668370676578,ECE 276A,A00,103667,Atanasov; Nikolay A.,0,0,0,0
1668370677001,ECE 277,A00,103668,An; Cheolhong,0,0,0,0
1668370677425,ECE 279,A00,117947,Hall; Drew A.,0,0,0,0
1668370678280,ECE 283,A00,103670,Hsueh; Tzu-Chien,0,0,0,0
1668370678714,ECE 284,A00,103671,Turakhia; Yatish Girish,0,0,0,0
1668370679156,ECE 285,A00,103672,Zheng; Yang,0,0,0,0
1668370679156,ECE 285,B00,103673,Sworder; David D.,0,0,0,0
1668370679580,ECE 287,A00,103676,Javidi; Tara,0,0,0,0
1668370680004,MATH 200B,A00,098023,Salehi Golsefidy; Alireza,12,0,15,3
1668370680431,MATH 202B,A00,098024,Rhoades; Brendon Patrick,9,0,15,6
1668370680857,MATH 203B,A00,098025,Oprea; Dragos N.,10,0,15,5
1668370681280,MATH 204B,A00,098026,Sorensen; Claus M,13,0,15,2
1668370681710,MATH 208,A00,098027,Izadi; Elham,7,0,10,3
1668370682134,MATH 209,A00,098028,Pollack; Aaron,10,0,10,0
1668370682561,MATH 211A,A00,112919,Rogalski; Daniel,9,0,10,1
1668370682986,MATH 211B,A00,112920,Seward; Brandon M.,9,0,10,1
1668370683410,MATH 218,A00,098029,Li; Bo,10,0,10,0
1668370683834,MATH 220B,A00,098030,Novak; Jonathan I,11,0,15,4
1668370684258,MATH 221A,A00,098031,Ebenfelt; Peter F,13,0,15,2
1668370684685,MATH 231B,A00,098032,Zlatos; Andrej,12,0,15,3
1668370685121,MATH 240B,A00,098033,Ni; Lei,9,0,15,6
1668370685554,MATH 243,A00,098034,Jekel; David Andrew,10,0,10,0
1668370685987,MATH 245A,A00,098035,Nie; Jiawang,0,0,15,16
1668370686411,MATH 248,A00,098036,Bejenaru; Ioan,10,0,10,0
1668370686840,MATH 250B,A00,098037,Spolaor; Luca,14,0,15,1
1668370687273,MATH 258,A00,098038,Ni; Lei,10,0,10,0
1668370687696,MATH 264B,A00,098041,Rhoades; Brendon Patrick,9,0,15,6
1668370688120,MATH 268,A00,098042,Buss; Samuel R,10,0,10,0
1668370688548,MATH 269,A00,098043,Rhoades; Brendon Patrick,10,0,10,0
1668370688970,MATH 270B,A00,098044,Li; Bo,10,0,15,5
1668370689394,MATH 272B,A00,098045,Holst; Michael J,13,0,15,2
1668370689823,MATH 273A,A00,098046,Tian; Xiaochuan,10,0,15,5
1668370690250,MATH 275,A01,098048,Tian; Xiaochuan,6,0,10,4
1668370690677,MATH 278A,A00,098049,Holst; Michael J,8,0,10,2
1668370691102,MATH 278B,A00,098050,Cloninger; Alexander,10,0,10,0
1668370691533,MATH 278C,A00,098051,Nie; Jiawang,7,0,10,3
1668370691954,MATH 280B,A00,098052,Zheng; Tianyi,8,0,15,7
1668370692388,MATH 281B,A00,098053,Bradic; Jelena,1,0,15,14
1668370692819,MATH 282B,A00,098054,Arias-Castro; Ery,0,0,15,15
1668370693243,MATH 285,A00,098055,Fitzsimmons; Patrick J,0,0,15,17
1668370693670,MATH 287B,A00,098056,Arias-Castro; Ery,2,0,15,13
1668370694098,MATH 288,A00,098057,Agarwal; Pooja,9,0,10,1
1668370694098,MATH 288,B00,098058,Zhang; Danna,8,0,10,2
1668370694098,MATH 288,C00,098059,Williams; Ruth J,9,0,10,1
1668370694523,MATH 290B,A00,098060,Roberts; Justin Deritter,13,0,15,2
1668370694946,MATH 292,A00,098061,Belmont; Eva Kinoshita,10,0,10,0
1668370695373,MATH 295,A00,098062,Suk; Andrew Hoon,48,0,50,2
1668370695806,MATH 296,A00,098063,Novak; Jonathan I,20,0,20,0
1668370696241,MATH 297,001,098064,Gamst; Anthony Collins,9997,0,9999,2
1668371200573,COGS 205,A00,101395,Chiba; Andrea,19,0,20,1
1668371200998,COGS 210B,001,101404,Greene; Deanna Jacquelyn,9998,0,9999,1
1668371200998,COGS 210B,002,101417,Xia; Haijun,9999,0,9999,0
1668371200998,COGS 210B,003,101422,Nitz; Douglas A.,9999,0,9999,0
1668371200998,COGS 210B,004,101423,Hollan; James D.,9998,0,9999,1
1668371200998,COGS 210B,005,101424,Deak; Gedeon O.,9998,0,9999,1
1668371200998,COGS 210B,006,101425,Rossano; Federico,9999,0,9999,0
1668371201423,COGS 211B,A00,101427,Coulson; Seana M,9996,0,9999,3
1668371201850,COGS 220,A00,101428,Hollan; James D.,0,0,25,25
1668371202277,COGS 229,A00,101429,Dow; Steven P,18,0,25,7
1668371202701,COGS 230,A00,101430,Klemmer; Scott R,11,0,17,6
1668371203125,COGS 234,A00,101431,Xia; Haijun,1,0,25,24
1668371203548,COGS 260,A00,101432,Kiyonaga; Anastasia,21,0,25,4
1668371203548,COGS 260,B00,101433,Kirsh; David Joel,15,0,25,10
1668371203974,CSE 202,A00,102371,Impagliazzo; Russell,0,0,0,0
1668371204398,CSE 203B,A01,102373,Cheng; Chung Kuan,0,0,0,0
1668371204822,CSE 208,A00,102374,Micciancio; Daniele,0,0,0,0
1668371205247,CSE 209A,A00,112895,Impagliazzo; Russell,0,0,15,15
1668371205672,CSE 209B,A00,108005,Bellare; Mihir,0,0,0,0
1668371206100,CSE 210,A00,113163,Coblenz; Michael J,0,0,0,0
1668371206532,CSE 219,A00,106111,Dow; Steven P,0,0,20,20
1668371206956,CSE 221,A00,102376,Voelker; Geoffrey M.,0,0,0,0
1668371207380,CSE 224,A01,102378,Porter; George M,0,0,0,0
1668371207812,CSE 229A,A00,102379,Savage; Stefan,0,0,0,0
1668371208237,CSE 229C,A00,102380,Munyaka; Imani N. S.,0,0,0,0
1668371208665,CSE 232B,A00,102382,Deutsch; Alin Bernard,0,0,0,0
1668371209090,CSE 234,A01,112904,Kumar; Arun Kumar,0,0,0,0
1668371209518,CSE 237A,A00,102383,Rosing; Tajana Simunic,0,0,0,0
1668371209951,CSE 239A,A00,102384,Deutsch; Alin Bernard,0,0,0,0
1668371210373,CSE 239B,A00,102385,Polikarpova; Nadezhda,0,0,0,0
1668371210799,CSE 240A,A00,102386,Pannuto; Patrick William,0,0,0,0
1668371211225,CSE 240B,A00,102387,Zhao; Jishen,0,0,0,0
1668371211653,CSE 241A,A00,106406,Kang; Mingu,0,0,0,0
1668371212075,CSE 249B,A00,102388,Kahng; Andrew Byun,0,0,8,8
1668371212499,CSE 251B,A01,102392,Cottrell; Garrison W,0,0,0,0
1668371212499,CSE 251B,A02,102393,Cottrell; Garrison W,0,0,0,0
1668371212925,CSE 252B,A00,102394,Ochoa; Benjamin Lawrence,0,0,0,0
1668371213357,CSE 257,A01,102396,Gao; Sicun,0,0,0,0
1668371213790,CSE 272,A00,102397,Li; Tzumao,0,0,0,0
1668371214215,CSE 274,A00,111323,Chern; Albert Ren-Haur,0,0,0,0
1668371214643,CSE 282,A00,102398,Pevzner; Pavel Arkadjevich,0,0,0,0
1668371215068,CSE 284,A00,114175,Gymrek; Melissa Ann,0,0,0,0
1668371215495,CSE 290,A00,102399,Chandraker; Manmohan Krishna,0,0,0,0
1668371215495,CSE 290,B00,102400,Vaccaro; Kristen Marie,0,0,25,25
1668371215495,CSE 290,C00,102414,Pannuto; Patrick William,0,0,25,25
1668371215495,CSE 290,D00,102427,Pevzner; Pavel Arkadjevich,0,0,0,0
1668371215495,CSE 290,E00,102429,Zhao; Jishen,0,0,0,0
1668371215495,CSE 290,F00,102436,Tullsen; Dean Michael,0,0,0,0
1668371215495,CSE 290,G00,102440,Christensen; Henrik I,0,0,20,20
1668371215923,CSE 291,A00,102443,Su; Hao,0,0,0,0
1668371215923,CSE 291,B00,102448,Polikarpova; Nadezhda,0,0,0,0
1668371215923,CSE 291,C00,102453,Vaccaro; Kristen Marie,0,0,0,0
1668371215923,CSE 291,D00,111343,Savage; Stefan,0,0,0,0
1668371215923,CSE 291,E00,116474,Claffy; Kimberly Claire,0,0,0,0
1668371215923,CSE 291,F00,116479,Pasquale; Joseph,0,0,0,0
1668371216350,CSE 293,001,119111,Bafna; Vineet,9999,0,9999,0
1668371216350,CSE 293,002,119118,Bellare; Mihir,9999,0,9999,0
1668371216350,CSE 293,003,119122,Berg-Kirkpatrick; Taylor D,9999,0,9999,0
1668371216350,CSE 293,004,119135,Christensen; Henrik I,9999,0,9999,0
1668371216350,CSE 293,005,119142,Cottrell; Garrison W,9999,0,9999,0
1668371216350,CSE 293,006,119146,Deutsch; Alin Bernard,9999,0,9999,0
1668371216350,CSE 293,007,119159,Esmaeilzadeh; Hadi,9999,0,9999,0
1668371216350,CSE 293,008,119166,Freund; Yoav,9999,0,9999,0
1668371216350,CSE 293,009,119170,Griswold; William G.,9999,0,9999,0
1668371216350,CSE 293,010,119183,Gymrek; Melissa Ann,9999,0,9999,0
1668371216350,CSE 293,011,119190,Heninger; Nadia A,9999,0,9999,0
1668371216350,CSE 293,012,119230,Impagliazzo; Russell,9999,0,9999,0
1668371216350,CSE 293,013,119232,Jhala; Ranjit,9999,0,9999,0
1668371216350,CSE 293,014,119233,Kahng; Andrew Byun,9999,0,9999,0
1668371216350,CSE 293,015,119298,Kane; Daniel Mertz,9999,0,9999,0
1668371216350,CSE 293,016,119299,Kriegman; David J,9999,0,9999,0
1668371216350,CSE 293,017,119300,Kumar; Arun Kumar,9999,0,9999,0
1668371216350,CSE 293,018,119301,Lerner; Sorin,9999,0,9999,0
1668371216350,CSE 293,019,119302,Lovett; Shachar,9999,0,9999,0
1668371216350,CSE 293,020,119303,McAuley; Julian John,9999,0,9999,0
1668371216350,CSE 293,021,119304,Micciancio; Daniele,9999,0,9999,0
1668371216350,CSE 293,022,119367,Orailoglu; Alex,9999,0,9999,0
1668371216350,CSE 293,023,119382,Paturi; Ramamohan,9999,0,9999,0
1668371216350,CSE 293,024,119404,Polikarpova; Nadezhda,9999,0,9999,0
1668371216350,CSE 293,025,119406,Politz; Joseph Gibbs,9999,0,9999,0
1668371216350,CSE 293,026,119411,Porter; George M,9999,0,9999,0
1668371216350,CSE 293,027,119414,Porter; Leonard Emerson,9999,0,9999,0
1668371216350,CSE 293,028,119416,Ramamoorthi; Ravi,9999,0,9999,0
1668371216350,CSE 293,029,119417,Sahoo; Debashis,9999,0,9999,0
1668371216350,CSE 293,030,119420,Saul; Lawrence,9999,0,9999,0
1668371216350,CSE 293,031,119421,Savage; Stefan,9999,0,9999,0
1668371216350,CSE 293,032,119425,Schulze; Jurgen P.,9999,0,9999,0
1668371216350,CSE 293,033,119426,Snoeren; Alex C.,9999,0,9999,0
1668371216350,CSE 293,034,119428,Shang; Jingbo,9999,0,9999,0
1668371216350,CSE 293,035,119430,Stefan; Deian,9999,0,9999,0
1668371216350,CSE 293,036,119431,Su; Hao,9999,0,9999,0
1668371216350,CSE 293,037,119433,Swanson; Steven James,9999,0,9999,0
1668371216350,CSE 293,038,119435,Tullsen; Dean Michael,9999,0,9999,0
1668371216350,CSE 293,039,119483,Voelker; Geoffrey M.,9999,0,9999,0
1668371216350,CSE 293,040,119537,Zhao; Jishen,9999,0,9999,0
1668371216350,CSE 293,041,119538,Zhou; Yuan-Yuan,9999,0,9999,0
1668371216350,CSE 293,042,119539,Gao; Sicun,9999,0,9999,0
1668371216350,CSE 293,043,119540,Weibel; Nadir,9999,0,9999,0
1668371216350,CSE 293,044,119541,Gupta; Rajesh K.,9999,0,9999,0
1668371216350,CSE 293,045,126410,Vaccaro; Kristen Marie,9999,0,9999,0
1668371216350,CSE 293,046,126411,Klemke; Richard,9999,0,9999,0
1668371216774,CSE 294,A00,102459,Voelker; Geoffrey M.,0,0,0,0
1668371216774,CSE 294,B00,111322,Orailoglu; Alex,0,0,0,0
1668371217197,DSE 201,A00,096914,Deutsch; Alin Bernard,30,0,30,0
1668371217624,DSE 210,A00,096915,Dasgupta; Sanjoy,30,0,30,0
1668371218050,DSE 260A,A00,096916,Altintas De Callaf; Ilkay,30,0,30,0
1668371218485,ECE 200,001,103586,Antipa; Nicholas A,9999,0,9999,0
1668371218485,ECE 200,002,103587,Atanasov; Nikolay A.,9999,0,9999,0
1668371218485,ECE 200,003,103588,Bharadia; Dinesh,9999,0,9999,0
1668371218485,ECE 200,004,103589,Cheng; Chung Kuan,9999,0,9999,0
1668371218485,ECE 200,005,103590,Cosman; Pamela C.,9999,0,9999,0
1668371218485,ECE 200,006,103591,Dayeh; Shadi Ahmad,9999,0,9999,0
1668371218485,ECE 200,007,103592,Fainman; Yeshaiahu,9999,0,9999,0
1668371218485,ECE 200,008,103593,Ford; Joseph Earl,9999,0,9999,0
1668371218485,ECE 200,009,103594,Franceschetti; Massimo,9999,0,9999,0
1668371218485,ECE 200,010,103595,Fullerton; Eric E,9999,0,9999,0
1668371218485,ECE 200,011,103596,Galton; Ian A,9999,0,9999,0
1668371218485,ECE 200,012,103597,Gilja; Vikash,9999,0,9999,0
1668371218485,ECE 200,013,103598,Hall; Drew A.,9999,0,9999,0
1668371218485,ECE 200,014,103599,Hsueh; Tzu-Chien,9999,0,9999,0
1668371218485,ECE 200,015,103600,Javidi; Tara,9999,0,9999,0
1668371218485,ECE 200,016,103601,Kahng; Andrew Byun,9999,0,9999,0
1668371218485,ECE 200,017,103602,Kim; Young-Han,9999,0,9999,0
1668371218485,ECE 200,018,103603,Koushanfar; Farinaz,9999,0,9999,0
1668371218485,ECE 200,019,103604,Kuzum; Duygu,9999,0,9999,0
1668371218485,ECE 200,020,103605,Le; Hanh-Phuc,9999,0,9999,0
1668371218485,ECE 200,021,103606,Lin; Bill,9999,0,9999,0
1668371218485,ECE 200,022,103607,Liu; Zhaowei,9998,0,9999,1
1668371218485,ECE 200,023,103608,Lo; Yu-Hwa,9999,0,9999,0
1668371218485,ECE 200,024,103609,Lomakin; Vitaliy,9999,0,9999,0
1668371218485,ECE 200,025,103610,Mercier; Patrick Philip,9999,0,9999,0
1668371218485,ECE 200,026,103611,Meyer; Florian,9999,0,9999,0
1668371218485,ECE 200,027,103612,Milstein; Laurence B.,9999,0,9999,0
1668371218485,ECE 200,028,103613,Mir Arabbaygi; Siavash,9999,0,9999,0
1668371218485,ECE 200,029,103614,Mookherjea; Shayan,9999,0,9999,0
1668371218485,ECE 200,030,103615,Morris; Karcher William,9999,0,9999,0
1668371218485,ECE 200,031,103616,Ng; Tse Nga,9999,0,9999,0
1668371218485,ECE 200,032,103617,Nguyen; Truong Quang,9999,0,9999,0
1668371218485,ECE 200,033,103618,Nomura; Kenji,9999,0,9999,0
1668371218485,ECE 200,034,103619,Orlitsky; Alon,9999,0,9999,0
1668371218485,ECE 200,035,103620,Pal; Piya,9999,0,9999,0
1668371218485,ECE 200,036,103621,Papen; George C.,9999,0,9999,0
1668371218485,ECE 200,037,103622,Radic; Stojan,9999,0,9999,0
1668371218485,ECE 200,038,103623,Rao; Bhaskar D.,9999,0,9999,0
1668371218485,ECE 200,039,103624,Rao; Ramesh R,9999,0,9999,0
1668371218485,ECE 200,040,103625,Rebeiz; Gabriel,9999,0,9999,0
1668371218485,ECE 200,041,103626,Sanford; John R,9999,0,9999,0
1668371218485,ECE 200,042,103627,Siegel; Paul H.,9999,0,9999,0
1668371218485,ECE 200,043,103628,Sievenpiper; Daniel F.,9999,0,9999,0
1668371218485,ECE 200,044,103629,Sworder; David D.,9999,0,9999,0
1668371218485,ECE 200,045,103630,Taur; Yuan,9999,0,9999,0
1668371218485,ECE 200,046,103631,Touri; Behrouz,9999,0,9999,0
1668371218485,ECE 200,047,103632,Trivedi; Mohan M.,9999,0,9999,0
1668371218485,ECE 200,048,103633,Vasconcelos; Nuno,9999,0,9999,0
1668371218485,ECE 200,049,103634,Wang; Xiaolong,9999,0,9999,0
1668371218485,ECE 200,050,103635,Xie; Pengtao,9999,0,9999,0
1668371218485,ECE 200,051,103636,Yip; Michael,9999,0,9999,0
1668371218485,ECE 200,052,103637,Zeger; Kenneth A.,999,0,999,0
1668371218485,ECE 200,053,103638,Zhang; Xinyu,9999,0,9999,0
1668371218485,ECE 200,054,103639,Turakhia; Yatish Girish,9999,0,9999,0
1668371218485,ECE 200,055,103640,Kang; Mingu,9999,0,9999,0
1668371218485,ECE 200,056,103641,Shi; Yuanyuan,9999,0,9999,0
1668371218485,ECE 200,057,103642,Wang; Edward Jay,9999,0,9999,0
1668371218485,ECE 200,058,103643,Zheng; Yang,9999,0,9999,0
1668371218909,ECE 202,A00,103644,Kuzum; Duygu,0,0,0,0
1668371219336,ECE 212BN,A00,103646,Ng; Tse Nga,0,0,0,0
1668371219762,ECE 221,A00,111493,Staff,0,0,0,0
1668371220185,ECE 222B,A00,103647,Lomakin; Vitaliy,0,0,0,0
1668371220611,ECE 230B,A00,103648,Taur; Yuan,0,0,0,0
1668371221035,ECE 238B,A00,103649,Garay; Javier,0,0,0,0
1668371221459,ECE 240B,A00,112900,Fainman; Yeshaiahu,0,0,0,0
1668371221887,ECE 247A,A00,103650,Jokerst; Jesse Vincent,0,0,0,0
1668371222312,ECE 247B,A00,103651,Wang; Joseph,0,0,0,0
1668371222734,ECE 250,A00,103652,Siegel; Paul H.,0,0,0,0
1668371223158,ECE 251A,A00,103654,Rao; Bhaskar D.,0,0,0,0
1668371223583,ECE 257B,A00,103655,Bharadia; Dinesh,0,0,0,0
1668371224013,ECE 258A,A00,103656,Milstein; Laurence B.,0,0,0,0
1668371224439,ECE 260B,A00,103658,Kang; Mingu,0,0,0,0
1668371224865,ECE 264A,A00,103659,Galton; Ian A,0,0,0,0
1668371225292,ECE 265A,A00,103661,Gudem; Prasad S.S.,0,0,0,0
1668371225716,ECE 265D,A00,103662,Gudem; Prasad S.S.,0,0,0,0
1668371226143,ECE 268,A00,103663,Koushanfar; Farinaz,0,0,0,0
1668371226571,ECE 269,A01,103665,Pal; Piya,0,0,0,0
1668371227010,ECE 271B,A00,103666,Vasconcelos; Manuela,0,0,0,0
1668371227441,ECE 276A,A00,103667,Atanasov; Nikolay A.,0,0,0,0
1668371227871,ECE 277,A00,103668,An; Cheolhong,0,0,0,0
1668371228295,ECE 279,A00,117947,Hall; Drew A.,0,0,0,0
1668371229160,ECE 283,A00,103670,Hsueh; Tzu-Chien,0,0,0,0
1668371229598,ECE 284,A00,103671,Turakhia; Yatish Girish,0,0,0,0
1668371230022,ECE 285,A00,103672,Zheng; Yang,0,0,0,0
1668371230022,ECE 285,B00,103673,Sworder; David D.,0,0,0,0
1668371230448,ECE 287,A00,103676,Javidi; Tara,0,0,0,0
1668371230873,MATH 200B,A00,098023,Salehi Golsefidy; Alireza,12,0,15,3
1668371231299,MATH 202B,A00,098024,Rhoades; Brendon Patrick,9,0,15,6
1668371231724,MATH 203B,A00,098025,Oprea; Dragos N.,10,0,15,5
1668371232147,MATH 204B,A00,098026,Sorensen; Claus M,13,0,15,2
1668371232572,MATH 208,A00,098027,Izadi; Elham,7,0,10,3
1668371232996,MATH 209,A00,098028,Pollack; Aaron,10,0,10,0
1668371233419,MATH 211A,A00,112919,Rogalski; Daniel,9,0,10,1
1668371233843,MATH 211B,A00,112920,Seward; Brandon M.,9,0,10,1
1668371234270,MATH 218,A00,098029,Li; Bo,10,0,10,0
1668371234693,MATH 220B,A00,098030,Novak; Jonathan I,11,0,15,4
1668371235122,MATH 221A,A00,098031,Ebenfelt; Peter F,13,0,15,2
1668371235545,MATH 231B,A00,098032,Zlatos; Andrej,12,0,15,3
1668371235968,MATH 240B,A00,098033,Ni; Lei,9,0,15,6
1668371236395,MATH 243,A00,098034,Jekel; David Andrew,10,0,10,0
1668371236820,MATH 245A,A00,098035,Nie; Jiawang,0,0,15,16
1668371237408,MATH 248,A00,098036,Bejenaru; Ioan,10,0,10,0
1668371237840,MATH 250B,A00,098037,Spolaor; Luca,14,0,15,1
1668371238263,MATH 258,A00,098038,Ni; Lei,10,0,10,0
1668371238687,MATH 264B,A00,098041,Rhoades; Brendon Patrick,9,0,15,6
1668371239111,MATH 268,A00,098042,Buss; Samuel R,10,0,10,0
1668371239538,MATH 269,A00,098043,Rhoades; Brendon Patrick,10,0,10,0
1668371239966,MATH 270B,A00,098044,Li; Bo,10,0,15,5
1668371240389,MATH 272B,A00,098045,Holst; Michael J,13,0,15,2
1668371240814,MATH 273A,A00,098046,Tian; Xiaochuan,10,0,15,5
1668371241241,MATH 275,A01,098048,Tian; Xiaochuan,6,0,10,4
1668371241666,MATH 278A,A00,098049,Holst; Michael J,8,0,10,2
1668371242092,MATH 278B,A00,098050,Cloninger; Alexander,10,0,10,0
1668371242518,MATH 278C,A00,098051,Nie; Jiawang,7,0,10,3
1668371242940,MATH 280B,A00,098052,Zheng; Tianyi,8,0,15,7
1668371243367,MATH 281B,A00,098053,Bradic; Jelena,1,0,15,14
1668371243802,MATH 282B,A00,098054,Arias-Castro; Ery,0,0,15,15
1668371244230,MATH 285,A00,098055,Fitzsimmons; Patrick J,0,0,15,17
1668371244654,MATH 287B,A00,098056,Arias-Castro; Ery,2,0,15,13
1668371245078,MATH 288,A00,098057,Agarwal; Pooja,9,0,10,1
1668371245078,MATH 288,B00,098058,Zhang; Danna,8,0,10,2
1668371245078,MATH 288,C00,098059,Williams; Ruth J,9,0,10,1
1668371245506,MATH 290B,A00,098060,Roberts; Justin Deritter,13,0,15,2
1668371245931,MATH 292,A00,098061,Belmont; Eva Kinoshita,10,0,10,0
1668371246357,MATH 295,A00,098062,Suk; Andrew Hoon,48,0,50,2
1668371246781,MATH 296,A00,098063,Novak; Jonathan I,20,0,20,0
1668371247207,MATH 297,001,098064,Gamst; Anthony Collins,9997,0,9999,2
1668371747641,COGS 205,A00,101395,Chiba; Andrea,19,0,20,1
1668371748108,COGS 210B,001,101404,Greene; Deanna Jacquelyn,9998,0,9999,1
1668371748108,COGS 210B,002,101417,Xia; Haijun,9999,0,9999,0
1668371748108,COGS 210B,003,101422,Nitz; Douglas A.,9999,0,9999,0
1668371748108,COGS 210B,004,101423,Hollan; James D.,9998,0,9999,1
1668371748108,COGS 210B,005,101424,Deak; Gedeon O.,9998,0,9999,1
1668371748108,COGS 210B,006,101425,Rossano; Federico,9999,0,9999,0
1668371748532,COGS 211B,A00,101427,Coulson; Seana M,9996,0,9999,3
1668371748954,COGS 220,A00,101428,Hollan; James D.,0,0,25,25
1668371749391,COGS 229,A00,101429,Dow; Steven P,18,0,25,7
1668371749815,COGS 230,A00,101430,Klemmer; Scott R,11,0,17,6
1668371750241,COGS 234,A00,101431,Xia; Haijun,1,0,25,24
1668371750664,COGS 260,A00,101432,Kiyonaga; Anastasia,21,0,25,4
1668371750664,COGS 260,B00,101433,Kirsh; David Joel,15,0,25,10
1668371751092,CSE 202,A00,102371,Impagliazzo; Russell,0,0,0,0
1668371751515,CSE 203B,A01,102373,Cheng; Chung Kuan,0,0,0,0
1668371751948,CSE 208,A00,102374,Micciancio; Daniele,0,0,0,0
1668371752371,CSE 209A,A00,112895,Impagliazzo; Russell,0,0,15,15
1668371752794,CSE 209B,A00,108005,Bellare; Mihir,0,0,0,0
1668371753217,CSE 210,A00,113163,Coblenz; Michael J,0,0,0,0
1668371753642,CSE 219,A00,106111,Dow; Steven P,0,0,20,20
1668371754067,CSE 221,A00,102376,Voelker; Geoffrey M.,0,0,0,0
1668371754494,CSE 224,A01,102378,Porter; George M,0,0,0,0
1668371754918,CSE 229A,A00,102379,Savage; Stefan,0,0,0,0
1668371755342,CSE 229C,A00,102380,Munyaka; Imani N. S.,0,0,0,0
1668371755768,CSE 232B,A00,102382,Deutsch; Alin Bernard,0,0,0,0
1668371756195,CSE 234,A01,112904,Kumar; Arun Kumar,0,0,0,0
1668371756620,CSE 237A,A00,102383,Rosing; Tajana Simunic,0,0,0,0
1668371757047,CSE 239A,A00,102384,Deutsch; Alin Bernard,0,0,0,0
1668371757472,CSE 239B,A00,102385,Polikarpova; Nadezhda,0,0,0,0
1668371757976,CSE 240A,A00,102386,Pannuto; Patrick William,0,0,0,0
1668371758401,CSE 240B,A00,102387,Zhao; Jishen,0,0,0,0
1668371758829,CSE 241A,A00,106406,Kang; Mingu,0,0,0,0
1668371759260,CSE 249B,A00,102388,Kahng; Andrew Byun,0,0,8,8
1668371759688,CSE 251B,A01,102392,Cottrell; Garrison W,0,0,0,0
1668371759688,CSE 251B,A02,102393,Cottrell; Garrison W,0,0,0,0
1668371760118,CSE 252B,A00,102394,Ochoa; Benjamin Lawrence,0,0,0,0
1668371760558,CSE 257,A01,102396,Gao; Sicun,0,0,0,0
1668371760988,CSE 272,A00,102397,Li; Tzumao,0,0,0,0
1668371761412,CSE 274,A00,111323,Chern; Albert Ren-Haur,0,0,0,0
1668371761835,CSE 282,A00,102398,Pevzner; Pavel Arkadjevich,0,0,0,0
1668371762258,CSE 284,A00,114175,Gymrek; Melissa Ann,0,0,0,0
1668371762682,CSE 290,A00,102399,Chandraker; Manmohan Krishna,0,0,0,0
1668371762682,CSE 290,B00,102400,Vaccaro; Kristen Marie,0,0,25,25
1668371762682,CSE 290,C00,102414,Pannuto; Patrick William,0,0,25,25
1668371762682,CSE 290,D00,102427,Pevzner; Pavel Arkadjevich,0,0,0,0
1668371762682,CSE 290,E00,102429,Zhao; Jishen,0,0,0,0
1668371762682,CSE 290,F00,102436,Tullsen; Dean Michael,0,0,0,0
1668371762682,CSE 290,G00,102440,Christensen; Henrik I,0,0,20,20
1668371763106,CSE 291,A00,102443,Su; Hao,0,0,0,0
1668371763106,CSE 291,B00,102448,Polikarpova; Nadezhda,0,0,0,0
1668371763106,CSE 291,C00,102453,Vaccaro; Kristen Marie,0,0,0,0
1668371763106,CSE 291,D00,111343,Savage; Stefan,0,0,0,0
1668371763106,CSE 291,E00,116474,Claffy; Kimberly Claire,0,0,0,0
1668371763106,CSE 291,F00,116479,Pasquale; Joseph,0,0,0,0
1668371763553,CSE 293,001,119111,Bafna; Vineet,9999,0,9999,0
1668371763553,CSE 293,002,119118,Bellare; Mihir,9999,0,9999,0
1668371763553,CSE 293,003,119122,Berg-Kirkpatrick; Taylor D,9999,0,9999,0
1668371763553,CSE 293,004,119135,Christensen; Henrik I,9999,0,9999,0
1668371763553,CSE 293,005,119142,Cottrell; Garrison W,9999,0,9999,0
1668371763553,CSE 293,006,119146,Deutsch; Alin Bernard,9999,0,9999,0
1668371763553,CSE 293,007,119159,Esmaeilzadeh; Hadi,9999,0,9999,0
1668371763553,CSE 293,008,119166,Freund; Yoav,9999,0,9999,0
1668371763553,CSE 293,009,119170,Griswold; William G.,9999,0,9999,0
1668371763553,CSE 293,010,119183,Gymrek; Melissa Ann,9999,0,9999,0
1668371763553,CSE 293,011,119190,Heninger; Nadia A,9999,0,9999,0
1668371763553,CSE 293,012,119230,Impagliazzo; Russell,9999,0,9999,0
1668371763553,CSE 293,013,119232,Jhala; Ranjit,9999,0,9999,0
1668371763553,CSE 293,014,119233,Kahng; Andrew Byun,9999,0,9999,0
1668371763553,CSE 293,015,119298,Kane; Daniel Mertz,9999,0,9999,0
1668371763553,CSE 293,016,119299,Kriegman; David J,9999,0,9999,0
1668371763553,CSE 293,017,119300,Kumar; Arun Kumar,9999,0,9999,0
1668371763553,CSE 293,018,119301,Lerner; Sorin,9999,0,9999,0
1668371763553,CSE 293,019,119302,Lovett; Shachar,9999,0,9999,0
1668371763553,CSE 293,020,119303,McAuley; Julian John,9999,0,9999,0
1668371763553,CSE 293,021,119304,Micciancio; Daniele,9999,0,9999,0
1668371763553,CSE 293,022,119367,Orailoglu; Alex,9999,0,9999,0
1668371763553,CSE 293,023,119382,Paturi; Ramamohan,9999,0,9999,0
1668371763553,CSE 293,024,119404,Polikarpova; Nadezhda,9999,0,9999,0
1668371763553,CSE 293,025,119406,Politz; Joseph Gibbs,9999,0,9999,0
1668371763553,CSE 293,026,119411,Porter; George M,9999,0,9999,0
1668371763553,CSE 293,027,119414,Porter; Leonard Emerson,9999,0,9999,0
1668371763553,CSE 293,028,119416,Ramamoorthi; Ravi,9999,0,9999,0
1668371763553,CSE 293,029,119417,Sahoo; Debashis,9999,0,9999,0
1668371763553,CSE 293,030,119420,Saul; Lawrence,9999,0,9999,0
1668371763553,CSE 293,031,119421,Savage; Stefan,9999,0,9999,0
1668371763553,CSE 293,032,119425,Schulze; Jurgen P.,9999,0,9999,0
1668371763553,CSE 293,033,119426,Snoeren; Alex C.,9999,0,9999,0
1668371763553,CSE 293,034,119428,Shang; Jingbo,9999,0,9999,0
1668371763553,CSE 293,035,119430,Stefan; Deian,9999,0,9999,0
1668371763553,CSE 293,036,119431,Su; Hao,9999,0,9999,0
1668371763553,CSE 293,037,119433,Swanson; Steven James,9999,0,9999,0
1668371763553,CSE 293,038,119435,Tullsen; Dean Michael,9999,0,9999,0
1668371763553,CSE 293,039,119483,Voelker; Geoffrey M.,9999,0,9999,0
1668371763553,CSE 293,040,119537,Zhao; Jishen,9999,0,9999,0
1668371763553,CSE 293,041,119538,Zhou; Yuan-Yuan,9999,0,9999,0
1668371763553,CSE 293,042,119539,Gao; Sicun,9999,0,9999,0
1668371763553,CSE 293,043,119540,Weibel; Nadir,9999,0,9999,0
1668371763553,CSE 293,044,119541,Gupta; Rajesh K.,9999,0,9999,0
1668371763553,CSE 293,045,126410,Vaccaro; Kristen Marie,9999,0,9999,0
1668371763553,CSE 293,046,126411,Klemke; Richard,9999,0,9999,0
1668371763976,CSE 294,A00,102459,Voelker; Geoffrey M.,0,0,0,0
1668371763976,CSE 294,B00,111322,Orailoglu; Alex,0,0,0,0
1668371764402,DSE 201,A00,096914,Deutsch; Alin Bernard,30,0,30,0
1668371764832,DSE 210,A00,096915,Dasgupta; Sanjoy,30,0,30,0
1668371765253,DSE 260A,A00,096916,Altintas De Callaf; Ilkay,30,0,30,0
1668371765715,ECE 200,001,103586,Antipa; Nicholas A,9999,0,9999,0
1668371765715,ECE 200,002,103587,Atanasov; Nikolay A.,9999,0,9999,0
1668371765715,ECE 200,003,103588,Bharadia; Dinesh,9999,0,9999,0
1668371765715,ECE 200,004,103589,Cheng; Chung Kuan,9999,0,9999,0
1668371765715,ECE 200,005,103590,Cosman; Pamela C.,9999,0,9999,0
1668371765715,ECE 200,006,103591,Dayeh; Shadi Ahmad,9999,0,9999,0
1668371765715,ECE 200,007,103592,Fainman; Yeshaiahu,9999,0,9999,0
1668371765715,ECE 200,008,103593,Ford; Joseph Earl,9999,0,9999,0
1668371765715,ECE 200,009,103594,Franceschetti; Massimo,9999,0,9999,0
1668371765715,ECE 200,010,103595,Fullerton; Eric E,9999,0,9999,0
1668371765715,ECE 200,011,103596,Galton; Ian A,9999,0,9999,0
1668371765715,ECE 200,012,103597,Gilja; Vikash,9999,0,9999,0
1668371765715,ECE 200,013,103598,Hall; Drew A.,9999,0,9999,0
1668371765715,ECE 200,014,103599,Hsueh; Tzu-Chien,9999,0,9999,0
1668371765715,ECE 200,015,103600,Javidi; Tara,9999,0,9999,0
1668371765715,ECE 200,016,103601,Kahng; Andrew Byun,9999,0,9999,0
1668371765715,ECE 200,017,103602,Kim; Young-Han,9999,0,9999,0
1668371765715,ECE 200,018,103603,Koushanfar; Farinaz,9999,0,9999,0
1668371765715,ECE 200,019,103604,Kuzum; Duygu,9999,0,9999,0
1668371765715,ECE 200,020,103605,Le; Hanh-Phuc,9999,0,9999,0
1668371765715,ECE 200,021,103606,Lin; Bill,9999,0,9999,0
1668371765715,ECE 200,022,103607,Liu; Zhaowei,9998,0,9999,1
1668371765715,ECE 200,023,103608,Lo; Yu-Hwa,9999,0,9999,0
1668371765715,ECE 200,024,103609,Lomakin; Vitaliy,9999,0,9999,0
1668371765715,ECE 200,025,103610,Mercier; Patrick Philip,9999,0,9999,0
1668371765715,ECE 200,026,103611,Meyer; Florian,9999,0,9999,0
1668371765715,ECE 200,027,103612,Milstein; Laurence B.,9999,0,9999,0
1668371765715,ECE 200,028,103613,Mir Arabbaygi; Siavash,9999,0,9999,0
1668371765715,ECE 200,029,103614,Mookherjea; Shayan,9999,0,9999,0
1668371765715,ECE 200,030,103615,Morris; Karcher William,9999,0,9999,0
1668371765715,ECE 200,031,103616,Ng; Tse Nga,9999,0,9999,0
1668371765715,ECE 200,032,103617,Nguyen; Truong Quang,9999,0,9999,0
1668371765715,ECE 200,033,103618,Nomura; Kenji,9999,0,9999,0
1668371765715,ECE 200,034,103619,Orlitsky; Alon,9999,0,9999,0
1668371765715,ECE 200,035,103620,Pal; Piya,9999,0,9999,0
1668371765715,ECE 200,036,103621,Papen; George C.,9999,0,9999,0
1668371765715,ECE 200,037,103622,Radic; Stojan,9999,0,9999,0
1668371765715,ECE 200,038,103623,Rao; Bhaskar D.,9999,0,9999,0
1668371765715,ECE 200,039,103624,Rao; Ramesh R,9999,0,9999,0
1668371765715,ECE 200,040,103625,Rebeiz; Gabriel,9999,0,9999,0
1668371765715,ECE 200,041,103626,Sanford; John R,9999,0,9999,0
1668371765715,ECE 200,042,103627,Siegel; Paul H.,9999,0,9999,0
1668371765715,ECE 200,043,103628,Sievenpiper; Daniel F.,9999,0,9999,0
1668371765715,ECE 200,044,103629,Sworder; David D.,9999,0,9999,0
1668371765715,ECE 200,045,103630,Taur; Yuan,9999,0,9999,0
1668371765715,ECE 200,046,103631,Touri; Behrouz,9999,0,9999,0
1668371765715,ECE 200,047,103632,Trivedi; Mohan M.,9999,0,9999,0
1668371765715,ECE 200,048,103633,Vasconcelos; Nuno,9999,0,9999,0
1668371765715,ECE 200,049,103634,Wang; Xiaolong,9999,0,9999,0
1668371765715,ECE 200,050,103635,Xie; Pengtao,9999,0,9999,0
1668371765715,ECE 200,051,103636,Yip; Michael,9999,0,9999,0
1668371765715,ECE 200,052,103637,Zeger; Kenneth A.,999,0,999,0
1668371765715,ECE 200,053,103638,Zhang; Xinyu,9999,0,9999,0
1668371765715,ECE 200,054,103639,Turakhia; Yatish Girish,9999,0,9999,0
1668371765715,ECE 200,055,103640,Kang; Mingu,9999,0,9999,0
1668371765715,ECE 200,056,103641,Shi; Yuanyuan,9999,0,9999,0
1668371765715,ECE 200,057,103642,Wang; Edward Jay,9999,0,9999,0
1668371765715,ECE 200,058,103643,Zheng; Yang,9999,0,9999,0
1668371766139,ECE 202,A00,103644,Kuzum; Duygu,0,0,0,0
1668371766564,ECE 212BN,A00,103646,Ng; Tse Nga,0,0,0,0
1668371767005,ECE 221,A00,111493,Staff,0,0,0,0
1668371767433,ECE 222B,A00,103647,Lomakin; Vitaliy,0,0,0,0
1668371767858,ECE 230B,A00,103648,Taur; Yuan,0,0,0,0
1668371768292,ECE 238B,A00,103649,Garay; Javier,0,0,0,0
1668371768723,ECE 240B,A00,112900,Fainman; Yeshaiahu,0,0,0,0
1668371769153,ECE 247A,A00,103650,Jokerst; Jesse Vincent,0,0,0,0
1668371769575,ECE 247B,A00,103651,Wang; Joseph,0,0,0,0
1668371770012,ECE 250,A00,103652,Siegel; Paul H.,0,0,0,0
1668371770436,ECE 251A,A00,103654,Rao; Bhaskar D.,0,0,0,0
1668371770861,ECE 257B,A00,103655,Bharadia; Dinesh,0,0,0,0
1668371771288,ECE 258A,A00,103656,Milstein; Laurence B.,0,0,0,0
1668371771710,ECE 260B,A00,103658,Kang; Mingu,0,0,0,0
1668371772138,ECE 264A,A00,103659,Galton; Ian A,0,0,0,0
1668371772566,ECE 265A,A00,103661,Gudem; Prasad S.S.,0,0,0,0
1668371772990,ECE 265D,A00,103662,Gudem; Prasad S.S.,0,0,0,0
1668371773416,ECE 268,A00,103663,Koushanfar; Farinaz,0,0,0,0
1668371773840,ECE 269,A01,103665,Pal; Piya,0,0,0,0
1668371774266,ECE 271B,A00,103666,Vasconcelos; Manuela,0,0,0,0
1668371774689,ECE 276A,A00,103667,Atanasov; Nikolay A.,0,0,0,0
1668371775113,ECE 277,A00,103668,An; Cheolhong,0,0,0,0
1668371775543,ECE 279,A00,117947,Hall; Drew A.,0,0,0,0
1668371776396,ECE 283,A00,103670,Hsueh; Tzu-Chien,0,0,0,0
1668371776825,ECE 284,A00,103671,Turakhia; Yatish Girish,0,0,0,0
1668371777253,ECE 285,A00,103672,Zheng; Yang,0,0,0,0
1668371777253,ECE 285,B00,103673,Sworder; David D.,0,0,0,0
1668371777679,ECE 287,A00,103676,Javidi; Tara,0,0,0,0
1668371778104,MATH 200B,A00,098023,Salehi Golsefidy; Alireza,12,0,15,3
1668371778530,MATH 202B,A00,098024,Rhoades; Brendon Patrick,9,0,15,6
1668371778954,MATH 203B,A00,098025,Oprea; Dragos N.,10,0,15,5
1668371779378,MATH 204B,A00,098026,Sorensen; Claus M,13,0,15,2
1668371779807,MATH 208,A00,098027,Izadi; Elham,7,0,10,3
1668371780230,MATH 209,A00,098028,Pollack; Aaron,10,0,10,0
1668371780657,MATH 211A,A00,112919,Rogalski; Daniel,9,0,10,1
1668371781084,MATH 211B,A00,112920,Seward; Brandon M.,9,0,10,1
1668371781509,MATH 218,A00,098029,Li; Bo,10,0,10,0
1668371781934,MATH 220B,A00,098030,Novak; Jonathan I,11,0,15,4
1668371782364,MATH 221A,A00,098031,Ebenfelt; Peter F,13,0,15,2
1668371782796,MATH 231B,A00,098032,Zlatos; Andrej,12,0,15,3
1668371783221,MATH 240B,A00,098033,Ni; Lei,9,0,15,6
1668371783645,MATH 243,A00,098034,Jekel; David Andrew,10,0,10,0
1668371784069,MATH 245A,A00,098035,Nie; Jiawang,0,0,15,16
1668371784492,MATH 248,A00,098036,Bejenaru; Ioan,10,0,10,0
1668371784916,MATH 250B,A00,098037,Spolaor; Luca,14,0,15,1
1668371785340,MATH 258,A00,098038,Ni; Lei,10,0,10,0
1668371785764,MATH 264B,A00,098041,Rhoades; Brendon Patrick,9,0,15,6
1668371786187,MATH 268,A00,098042,Buss; Samuel R,10,0,10,0
1668371786611,MATH 269,A00,098043,Rhoades; Brendon Patrick,10,0,10,0
1668371787041,MATH 270B,A00,098044,Li; Bo,10,0,15,5
1668371787471,MATH 272B,A00,098045,Holst; Michael J,13,0,15,2
1668371787896,MATH 273A,A00,098046,Tian; Xiaochuan,10,0,15,5
1668371788323,MATH 275,A01,098048,Tian; Xiaochuan,6,0,10,4
1668371788746,MATH 278A,A00,098049,Holst; Michael J,8,0,10,2
1668371789172,MATH 278B,A00,098050,Cloninger; Alexander,10,0,10,0
1668371789603,MATH 278C,A00,098051,Nie; Jiawang,7,0,10,3
1668371790029,MATH 280B,A00,098052,Zheng; Tianyi,8,0,15,7
1668371790453,MATH 281B,A00,098053,Bradic; Jelena,1,0,15,14
1668371790877,MATH 282B,A00,098054,Arias-Castro; Ery,0,0,15,15
1668371791313,MATH 285,A00,098055,Fitzsimmons; Patrick J,0,0,15,17
1668371791735,MATH 287B,A00,098056,Arias-Castro; Ery,2,0,15,13
1668371792170,MATH 288,A00,098057,Agarwal; Pooja,9,0,10,1
1668371792170,MATH 288,B00,098058,Zhang; Danna,8,0,10,2
1668371792170,MATH 288,C00,098059,Williams; Ruth J,9,0,10,1
1668371792594,MATH 290B,A00,098060,Roberts; Justin Deritter,13,0,15,2
1668371793028,MATH 292,A00,098061,Belmont; Eva Kinoshita,10,0,10,0
1668371793454,MATH 295,A00,098062,Suk; Andrew Hoon,48,0,50,2
1668371793886,MATH 296,A00,098063,Novak; Jonathan I,20,0,20,0
1668371794318,MATH 297,001,098064,Gamst; Anthony Collins,9997,0,9999,2
1668372295029,COGS 205,A00,101395,Chiba; Andrea,19,0,20,1
1668372295457,COGS 210B,001,101404,Greene; Deanna Jacquelyn,9998,0,9999,1
1668372295457,COGS 210B,002,101417,Xia; Haijun,9999,0,9999,0
1668372295457,COGS 210B,003,101422,Nitz; Douglas A.,9999,0,9999,0
1668372295457,COGS 210B,004,101423,Hollan; James D.,9998,0,9999,1
1668372295457,COGS 210B,005,101424,Deak; Gedeon O.,9998,0,9999,1
1668372295457,COGS 210B,006,101425,Rossano; Federico,9999,0,9999,0
1668372295894,COGS 211B,A00,101427,Coulson; Seana M,9996,0,9999,3
1668372296327,COGS 220,A00,101428,Hollan; James D.,0,0,25,25
1668372296751,COGS 229,A00,101429,Dow; Steven P,18,0,25,7
1668372297177,COGS 230,A00,101430,Klemmer; Scott R,11,0,17,6
1668372297603,COGS 234,A00,101431,Xia; Haijun,1,0,25,24
1668372298027,COGS 260,A00,101432,Kiyonaga; Anastasia,21,0,25,4
1668372298027,COGS 260,B00,101433,Kirsh; David Joel,15,0,25,10
1668372298453,CSE 202,A00,102371,Impagliazzo; Russell,0,0,0,0
1668372298876,CSE 203B,A01,102373,Cheng; Chung Kuan,0,0,0,0
1668372299300,CSE 208,A00,102374,Micciancio; Daniele,0,0,0,0
1668372299729,CSE 209A,A00,112895,Impagliazzo; Russell,0,0,15,15
1668372300158,CSE 209B,A00,108005,Bellare; Mihir,0,0,0,0
1668372300584,CSE 210,A00,113163,Coblenz; Michael J,0,0,0,0
1668372301008,CSE 219,A00,106111,Dow; Steven P,0,0,20,20
1668372301429,CSE 221,A00,102376,Voelker; Geoffrey M.,0,0,0,0
1668372301856,CSE 224,A01,102378,Porter; George M,0,0,0,0
1668372302278,CSE 229A,A00,102379,Savage; Stefan,0,0,0,0
1668372302716,CSE 229C,A00,102380,Munyaka; Imani N. S.,0,0,0,0
1668372303137,CSE 232B,A00,102382,Deutsch; Alin Bernard,0,0,0,0
1668372303563,CSE 234,A01,112904,Kumar; Arun Kumar,0,0,0,0
1668372304009,CSE 237A,A00,102383,Rosing; Tajana Simunic,0,0,0,0
1668372304444,CSE 239A,A00,102384,Deutsch; Alin Bernard,0,0,0,0
1668372304869,CSE 239B,A00,102385,Polikarpova; Nadezhda,0,0,0,0
1668372305294,CSE 240A,A00,102386,Pannuto; Patrick William,0,0,0,0
1668372305716,CSE 240B,A00,102387,Zhao; Jishen,0,0,0,0
1668372306141,CSE 241A,A00,106406,Kang; Mingu,0,0,0,0
1668372306566,CSE 249B,A00,102388,Kahng; Andrew Byun,0,0,8,8
1668372306990,CSE 251B,A01,102392,Cottrell; Garrison W,0,0,0,0
1668372306990,CSE 251B,A02,102393,Cottrell; Garrison W,0,0,0,0
1668372307413,CSE 252B,A00,102394,Ochoa; Benjamin Lawrence,0,0,0,0
1668372307836,CSE 257,A01,102396,Gao; Sicun,0,0,0,0
1668372308260,CSE 272,A00,102397,Li; Tzumao,0,0,0,0
1668372308701,CSE 274,A00,111323,Chern; Albert Ren-Haur,0,0,0,0
1668372309127,CSE 282,A00,102398,Pevzner; Pavel Arkadjevich,0,0,0,0
1668372309551,CSE 284,A00,114175,Gymrek; Melissa Ann,0,0,0,0
1668372309975,CSE 290,A00,102399,Chandraker; Manmohan Krishna,0,0,0,0
1668372309975,CSE 290,B00,102400,Vaccaro; Kristen Marie,0,0,25,25
1668372309975,CSE 290,C00,102414,Pannuto; Patrick William,0,0,25,25
1668372309975,CSE 290,D00,102427,Pevzner; Pavel Arkadjevich,0,0,0,0
1668372309975,CSE 290,E00,102429,Zhao; Jishen,0,0,0,0
1668372309975,CSE 290,F00,102436,Tullsen; Dean Michael,0,0,0,0
1668372309975,CSE 290,G00,102440,Christensen; Henrik I,0,0,20,20
1668372310403,CSE 291,A00,102443,Su; Hao,0,0,0,0
1668372310403,CSE 291,B00,102448,Polikarpova; Nadezhda,0,0,0,0
1668372310403,CSE 291,C00,102453,Vaccaro; Kristen Marie,0,0,0,0
1668372310403,CSE 291,D00,111343,Savage; Stefan,0,0,0,0
1668372310403,CSE 291,E00,116474,Claffy; Kimberly Claire,0,0,0,0
1668372310403,CSE 291,F00,116479,Pasquale; Joseph,0,0,0,0
1668372310862,CSE 293,001,119111,Bafna; Vineet,9999,0,9999,0
1668372310862,CSE 293,002,119118,Bellare; Mihir,9999,0,9999,0
1668372310862,CSE 293,003,119122,Berg-Kirkpatrick; Taylor D,9999,0,9999,0
1668372310862,CSE 293,004,119135,Christensen; Henrik I,9999,0,9999,0
1668372310862,CSE 293,005,119142,Cottrell; Garrison W,9999,0,9999,0
1668372310862,CSE 293,006,119146,Deutsch; Alin Bernard,9999,0,9999,0
1668372310862,CSE 293,007,119159,Esmaeilzadeh; Hadi,9999,0,9999,0
1668372310862,CSE 293,008,119166,Freund; Yoav,9999,0,9999,0
1668372310862,CSE 293,009,119170,Griswold; William G.,9999,0,9999,0
1668372310862,CSE 293,010,119183,Gymrek; Melissa Ann,9999,0,9999,0
1668372310862,CSE 293,011,119190,Heninger; Nadia A,9999,0,9999,0
1668372310862,CSE 293,012,119230,Impagliazzo; Russell,9999,0,9999,0
1668372310862,CSE 293,013,119232,Jhala; Ranjit,9999,0,9999,0
1668372310862,CSE 293,014,119233,Kahng; Andrew Byun,9999,0,9999,0
1668372310862,CSE 293,015,119298,Kane; Daniel Mertz,9999,0,9999,0
1668372310862,CSE 293,016,119299,Kriegman; David J,9999,0,9999,0
1668372310862,CSE 293,017,119300,Kumar; Arun Kumar,9999,0,9999,0
1668372310862,CSE 293,018,119301,Lerner; Sorin,9999,0,9999,0
1668372310862,CSE 293,019,119302,Lovett; Shachar,9999,0,9999,0
1668372310862,CSE 293,020,119303,McAuley; Julian John,9999,0,9999,0
1668372310862,CSE 293,021,119304,Micciancio; Daniele,9999,0,9999,0
1668372310862,CSE 293,022,119367,Orailoglu; Alex,9999,0,9999,0
1668372310862,CSE 293,023,119382,Paturi; Ramamohan,9999,0,9999,0
1668372310862,CSE 293,024,119404,Polikarpova; Nadezhda,9999,0,9999,0
1668372310862,CSE 293,025,119406,Politz; Joseph Gibbs,9999,0,9999,0
1668372310862,CSE 293,026,119411,Porter; George M,9999,0,9999,0
1668372310862,CSE 293,027,119414,Porter; Leonard Emerson,9999,0,9999,0
1668372310862,CSE 293,028,119416,Ramamoorthi; Ravi,9999,0,9999,0
1668372310862,CSE 293,029,119417,Sahoo; Debashis,9999,0,9999,0
1668372310862,CSE 293,030,119420,Saul; Lawrence,9999,0,9999,0
1668372310862,CSE 293,031,119421,Savage; Stefan,9999,0,9999,0
1668372310862,CSE 293,032,119425,Schulze; Jurgen P.,9999,0,9999,0
1668372310862,CSE 293,033,119426,Snoeren; Alex C.,9999,0,9999,0
1668372310862,CSE 293,034,119428,Shang; Jingbo,9999,0,9999,0
1668372310862,CSE 293,035,119430,Stefan; Deian,9999,0,9999,0
1668372310862,CSE 293,036,119431,Su; Hao,9999,0,9999,0
1668372310862,CSE 293,037,119433,Swanson; Steven James,9999,0,9999,0
1668372310862,CSE 293,038,119435,Tullsen; Dean Michael,9999,0,9999,0
1668372310862,CSE 293,039,119483,Voelker; Geoffrey M.,9999,0,9999,0
1668372310862,CSE 293,040,119537,Zhao; Jishen,9999,0,9999,0
1668372310862,CSE 293,041,119538,Zhou; Yuan-Yuan,9999,0,9999,0
1668372310862,CSE 293,042,119539,Gao; Sicun,9999,0,9999,0
1668372310862,CSE 293,043,119540,Weibel; Nadir,9999,0,9999,0
1668372310862,CSE 293,044,119541,Gupta; Rajesh K.,9999,0,9999,0
1668372310862,CSE 293,045,126410,Vaccaro; Kristen Marie,9999,0,9999,0
1668372310862,CSE 293,046,126411,Klemke; Richard,9999,0,9999,0
1668372311288,CSE 294,A00,102459,Voelker; Geoffrey M.,0,0,0,0
1668372311288,CSE 294,B00,111322,Orailoglu; Alex,0,0,0,0
1668372311721,DSE 201,A00,096914,Deutsch; Alin Bernard,30,0,30,0
1668372312145,DSE 210,A00,096915,Dasgupta; Sanjoy,30,0,30,0
1668372312579,DSE 260A,A00,096916,Altintas De Callaf; Ilkay,30,0,30,0
1668372313018,ECE 200,001,103586,Antipa; Nicholas A,9999,0,9999,0
1668372313018,ECE 200,002,103587,Atanasov; Nikolay A.,9999,0,9999,0
1668372313018,ECE 200,003,103588,Bharadia; Dinesh,9999,0,9999,0
1668372313018,ECE 200,004,103589,Cheng; Chung Kuan,9999,0,9999,0
1668372313018,ECE 200,005,103590,Cosman; Pamela C.,9999,0,9999,0
1668372313018,ECE 200,006,103591,Dayeh; Shadi Ahmad,9999,0,9999,0
1668372313018,ECE 200,007,103592,Fainman; Yeshaiahu,9999,0,9999,0
1668372313018,ECE 200,008,103593,Ford; Joseph Earl,9999,0,9999,0
1668372313018,ECE 200,009,103594,Franceschetti; Massimo,9999,0,9999,0
1668372313018,ECE 200,010,103595,Fullerton; Eric E,9999,0,9999,0
1668372313018,ECE 200,011,103596,Galton; Ian A,9999,0,9999,0
1668372313018,ECE 200,012,103597,Gilja; Vikash,9999,0,9999,0
1668372313018,ECE 200,013,103598,Hall; Drew A.,9999,0,9999,0
1668372313018,ECE 200,014,103599,Hsueh; Tzu-Chien,9999,0,9999,0
1668372313018,ECE 200,015,103600,Javidi; Tara,9999,0,9999,0
1668372313018,ECE 200,016,103601,Kahng; Andrew Byun,9999,0,9999,0
1668372313018,ECE 200,017,103602,Kim; Young-Han,9999,0,9999,0
1668372313018,ECE 200,018,103603,Koushanfar; Farinaz,9999,0,9999,0
1668372313018,ECE 200,019,103604,Kuzum; Duygu,9999,0,9999,0
1668372313018,ECE 200,020,103605,Le; Hanh-Phuc,9999,0,9999,0
1668372313018,ECE 200,021,103606,Lin; Bill,9999,0,9999,0
1668372313018,ECE 200,022,103607,Liu; Zhaowei,9998,0,9999,1
1668372313018,ECE 200,023,103608,Lo; Yu-Hwa,9999,0,9999,0
1668372313018,ECE 200,024,103609,Lomakin; Vitaliy,9999,0,9999,0
1668372313018,ECE 200,025,103610,Mercier; Patrick Philip,9999,0,9999,0
1668372313018,ECE 200,026,103611,Meyer; Florian,9999,0,9999,0
1668372313018,ECE 200,027,103612,Milstein; Laurence B.,9999,0,9999,0
1668372313018,ECE 200,028,103613,Mir Arabbaygi; Siavash,9999,0,9999,0
1668372313018,ECE 200,029,103614,Mookherjea; Shayan,9999,0,9999,0
1668372313018,ECE 200,030,103615,Morris; Karcher William,9999,0,9999,0
1668372313018,ECE 200,031,103616,Ng; Tse Nga,9999,0,9999,0
1668372313018,ECE 200,032,103617,Nguyen; Truong Quang,9999,0,9999,0
1668372313018,ECE 200,033,103618,Nomura; Kenji,9999,0,9999,0
1668372313018,ECE 200,034,103619,Orlitsky; Alon,9999,0,9999,0
1668372313018,ECE 200,035,103620,Pal; Piya,9999,0,9999,0
1668372313018,ECE 200,036,103621,Papen; George C.,9999,0,9999,0
1668372313018,ECE 200,037,103622,Radic; Stojan,9999,0,9999,0
1668372313018,ECE 200,038,103623,Rao; Bhaskar D.,9999,0,9999,0
1668372313018,ECE 200,039,103624,Rao; Ramesh R,9999,0,9999,0
1668372313018,ECE 200,040,103625,Rebeiz; Gabriel,9999,0,9999,0
1668372313018,ECE 200,041,103626,Sanford; John R,9999,0,9999,0
1668372313018,ECE 200,042,103627,Siegel; Paul H.,9999,0,9999,0
1668372313018,ECE 200,043,103628,Sievenpiper; Daniel F.,9999,0,9999,0
1668372313018,ECE 200,044,103629,Sworder; David D.,9999,0,9999,0
1668372313018,ECE 200,045,103630,Taur; Yuan,9999,0,9999,0
1668372313018,ECE 200,046,103631,Touri; Behrouz,9999,0,9999,0
1668372313018,ECE 200,047,103632,Trivedi; Mohan M.,9999,0,9999,0
1668372313018,ECE 200,048,103633,Vasconcelos; Nuno,9999,0,9999,0
1668372313018,ECE 200,049,103634,Wang; Xiaolong,9999,0,9999,0
1668372313018,ECE 200,050,103635,Xie; Pengtao,9999,0,9999,0
1668372313018,ECE 200,051,103636,Yip; Michael,9999,0,9999,0
1668372313018,ECE 200,052,103637,Zeger; Kenneth A.,999,0,999,0
1668372313018,ECE 200,053,103638,Zhang; Xinyu,9999,0,9999,0
1668372313018,ECE 200,054,103639,Turakhia; Yatish Girish,9999,0,9999,0
1668372313018,ECE 200,055,103640,Kang; Mingu,9999,0,9999,0
1668372313018,ECE 200,056,103641,Shi; Yuanyuan,9999,0,9999,0
1668372313018,ECE 200,057,103642,Wang; Edward Jay,9999,0,9999,0
1668372313018,ECE 200,058,103643,Zheng; Yang,9999,0,9999,0
1668372313441,ECE 202,A00,103644,Kuzum; Duygu,0,0,0,0
1668372313865,ECE 212BN,A00,103646,Ng; Tse Nga,0,0,0,0
1668372314287,ECE 221,A00,111493,Staff,0,0,0,0
1668372314711,ECE 222B,A00,103647,Lomakin; Vitaliy,0,0,0,0
1668372315133,ECE 230B,A00,103648,Taur; Yuan,0,0,0,0
1668372315560,ECE 238B,A00,103649,Garay; Javier,0,0,0,0
1668372315984,ECE 240B,A00,112900,Fainman; Yeshaiahu,0,0,0,0
1668372316411,ECE 247A,A00,103650,Jokerst; Jesse Vincent,0,0,0,0
1668372316836,ECE 247B,A00,103651,Wang; Joseph,0,0,0,0
1668372317262,ECE 250,A00,103652,Siegel; Paul H.,0,0,0,0
1668372317687,ECE 251A,A00,103654,Rao; Bhaskar D.,0,0,0,0
1668372318110,ECE 257B,A00,103655,Bharadia; Dinesh,0,0,0,0
1668372318536,ECE 258A,A00,103656,Milstein; Laurence B.,0,0,0,0
1668372318958,ECE 260B,A00,103658,Kang; Mingu,0,0,0,0
1668372319382,ECE 264A,A00,103659,Galton; Ian A,0,0,0,0
1668372319807,ECE 265A,A00,103661,Gudem; Prasad S.S.,0,0,0,0
1668372320232,ECE 265D,A00,103662,Gudem; Prasad S.S.,0,0,0,0
1668372320656,ECE 268,A00,103663,Koushanfar; Farinaz,0,0,0,0
1668372321078,ECE 269,A01,103665,Pal; Piya,0,0,0,0
1668372321507,ECE 271B,A00,103666,Vasconcelos; Manuela,0,0,0,0
1668372322122,ECE 276A,A00,103667,Atanasov; Nikolay A.,0,0,0,0
1668372322548,ECE 277,A00,103668,An; Cheolhong,0,0,0,0
1668372322972,ECE 279,A00,117947,Hall; Drew A.,0,0,0,0
1668372323820,ECE 283,A00,103670,Hsueh; Tzu-Chien,0,0,0,0
1668372324245,ECE 284,A00,103671,Turakhia; Yatish Girish,0,0,0,0
1668372324670,ECE 285,A00,103672,Zheng; Yang,0,0,0,0
1668372324670,ECE 285,B00,103673,Sworder; David D.,0,0,0,0
1668372325092,ECE 287,A00,103676,Javidi; Tara,0,0,0,0
1668372325516,MATH 200B,A00,098023,Salehi Golsefidy; Alireza,12,0,15,3
1668372325998,MATH 202B,A00,098024,Rhoades; Brendon Patrick,9,0,15,6
1668372326423,MATH 203B,A00,098025,Oprea; Dragos N.,10,0,15,5
1668372326851,MATH 204B,A00,098026,Sorensen; Claus M,13,0,15,2
1668372327276,MATH 208,A00,098027,Izadi; Elham,7,0,10,3
1668372327701,MATH 209,A00,098028,Pollack; Aaron,10,0,10,0
1668372328126,MATH 211A,A00,112919,Rogalski; Daniel,9,0,10,1
1668372328560,MATH 211B,A00,112920,Seward; Brandon M.,9,0,10,1
1668372328987,MATH 218,A00,098029,Li; Bo,10,0,10,0
1668372329412,MATH 220B,A00,098030,Novak; Jonathan I,11,0,15,4
1668372329844,MATH 221A,A00,098031,Ebenfelt; Peter F,13,0,15,2
1668372330285,MATH 231B,A00,098032,Zlatos; Andrej,12,0,15,3
1668372330708,MATH 240B,A00,098033,Ni; Lei,9,0,15,6
1668372331135,MATH 243,A00,098034,Jekel; David Andrew,10,0,10,0
1668372331558,MATH 245A,A00,098035,Nie; Jiawang,0,0,15,16
1668372331993,MATH 248,A00,098036,Bejenaru; Ioan,10,0,10,0
1668372332416,MATH 250B,A00,098037,Spolaor; Luca,14,0,15,1
1668372332840,MATH 258,A00,098038,Ni; Lei,10,0,10,0
1668372333264,MATH 264B,A00,098041,Rhoades; Brendon Patrick,9,0,15,6
1668372333689,MATH 268,A00,098042,Buss; Samuel R,10,0,10,0
1668372334114,MATH 269,A00,098043,Rhoades; Brendon Patrick,10,0,10,0
1668372334538,MATH 270B,A00,098044,Li; Bo,10,0,15,5
1668372334962,MATH 272B,A00,098045,Holst; Michael J,13,0,15,2
1668372335387,MATH 273A,A00,098046,Tian; Xiaochuan,10,0,15,5
1668372335821,MATH 275,A01,098048,Tian; Xiaochuan,6,0,10,4
1668372336246,MATH 278A,A00,098049,Holst; Michael J,8,0,10,2
1668372336672,MATH 278B,A00,098050,Cloninger; Alexander,10,0,10,0
1668372337099,MATH 278C,A00,098051,Nie; Jiawang,7,0,10,3
1668372337523,MATH 280B,A00,098052,Zheng; Tianyi,8,0,15,7
1668372337947,MATH 281B,A00,098053,Bradic; Jelena,1,0,15,14
1668372338378,MATH 282B,A00,098054,Arias-Castro; Ery,0,0,15,15
1668372338802,MATH 285,A00,098055,Fitzsimmons; Patrick J,0,0,15,17
1668372339234,MATH 287B,A00,098056,Arias-Castro; Ery,2,0,15,13
1668372339679,MATH 288,A00,098057,Agarwal; Pooja,9,0,10,1
1668372339679,MATH 288,B00,098058,Zhang; Danna,8,0,10,2
1668372339679,MATH 288,C00,098059,Williams; Ruth J,9,0,10,1
1668372340105,MATH 290B,A00,098060,Roberts; Justin Deritter,13,0,15,2
1668372340531,MATH 292,A00,098061,Belmont; Eva Kinoshita,10,0,10,0
1668372340958,MATH 295,A00,098062,Suk; Andrew Hoon,48,0,50,2
1668372341381,MATH 296,A00,098063,Novak; Jonathan I,20,0,20,0
1668372341804,MATH 297,001,098064,Gamst; Anthony Collins,9997,0,9999,2
1668372842213,COGS 205,A00,101395,Chiba; Andrea,19,0,20,1
1668372842722,COGS 210B,001,101404,Greene; Deanna Jacquelyn,9998,0,9999,1
1668372842722,COGS 210B,002,101417,Xia; Haijun,9999,0,9999,0
1668372842722,COGS 210B,003,101422,Nitz; Douglas A.,9999,0,9999,0
1668372842722,COGS 210B,004,101423,Hollan; James D.,9998,0,9999,1
1668372842722,COGS 210B,005,101424,Deak; Gedeon O.,9998,0,9999,1
1668372842722,COGS 210B,006,101425,Rossano; Federico,9999,0,9999,0
1668372843149,COGS 211B,A00,101427,Coulson; Seana M,9996,0,9999,3
1668372843576,COGS 220,A00,101428,Hollan; James D.,0,0,25,25
1668372844001,COGS 229,A00,101429,Dow; Steven P,18,0,25,7
1668372844425,COGS 230,A00,101430,Klemmer; Scott R,11,0,17,6
1668372844852,COGS 234,A00,101431,Xia; Haijun,1,0,25,24
1668372845281,COGS 260,A00,101432,Kiyonaga; Anastasia,21,0,25,4
1668372845281,COGS 260,B00,101433,Kirsh; David Joel,15,0,25,10
1668372845711,CSE 202,A00,102371,Impagliazzo; Russell,0,0,0,0
1668372846151,CSE 203B,A01,102373,Cheng; Chung Kuan,0,0,0,0
1668372846578,CSE 208,A00,102374,Micciancio; Daniele,0,0,0,0
1668372847002,CSE 209A,A00,112895,Impagliazzo; Russell,0,0,15,15
1668372847425,CSE 209B,A00,108005,Bellare; Mihir,0,0,0,0
1668372847850,CSE 210,A00,113163,Coblenz; Michael J,0,0,0,0
1668372848275,CSE 219,A00,106111,Dow; Steven P,0,0,20,20
1668372848704,CSE 221,A00,102376,Voelker; Geoffrey M.,0,0,0,0
1668372849142,CSE 224,A01,102378,Porter; George M,0,0,0,0
1668372849569,CSE 229A,A00,102379,Savage; Stefan,0,0,0,0
1668372850004,CSE 229C,A00,102380,Munyaka; Imani N. S.,0,0,0,0
1668372850427,CSE 232B,A00,102382,Deutsch; Alin Bernard,0,0,0,0
1668372850856,CSE 234,A01,112904,Kumar; Arun Kumar,0,0,0,0
1668372851287,CSE 237A,A00,102383,Rosing; Tajana Simunic,0,0,0,0
1668372851711,CSE 239A,A00,102384,Deutsch; Alin Bernard,0,0,0,0
1668372852134,CSE 239B,A00,102385,Polikarpova; Nadezhda,0,0,0,0
1668372852558,CSE 240A,A00,102386,Pannuto; Patrick William,0,0,0,0
1668372852985,CSE 240B,A00,102387,Zhao; Jishen,0,0,0,0
1668372853417,CSE 241A,A00,106406,Kang; Mingu,0,0,0,0
1668372853841,CSE 249B,A00,102388,Kahng; Andrew Byun,0,0,8,8
1668372854266,CSE 251B,A01,102392,Cottrell; Garrison W,0,0,0,0
1668372854266,CSE 251B,A02,102393,Cottrell; Garrison W,0,0,0,0
1668372854693,CSE 252B,A00,102394,Ochoa; Benjamin Lawrence,0,0,0,0
1668372855116,CSE 257,A01,102396,Gao; Sicun,0,0,0,0
1668372855550,CSE 272,A00,102397,Li; Tzumao,0,0,0,0
1668372855974,CSE 274,A00,111323,Chern; Albert Ren-Haur,0,0,0,0
1668372856398,CSE 282,A00,102398,Pevzner; Pavel Arkadjevich,0,0,0,0
1668372856821,CSE 284,A00,114175,Gymrek; Melissa Ann,0,0,0,0
1668372857245,CSE 290,A00,102399,Chandraker; Manmohan Krishna,0,0,0,0
1668372857245,CSE 290,B00,102400,Vaccaro; Kristen Marie,0,0,25,25
1668372857245,CSE 290,C00,102414,Pannuto; Patrick William,0,0,25,25
1668372857245,CSE 290,D00,102427,Pevzner; Pavel Arkadjevich,0,0,0,0
1668372857245,CSE 290,E00,102429,Zhao; Jishen,0,0,0,0
1668372857245,CSE 290,F00,102436,Tullsen; Dean Michael,0,0,0,0
1668372857245,CSE 290,G00,102440,Christensen; Henrik I,0,0,20,20
1668372857673,CSE 291,A00,102443,Su; Hao,0,0,0,0
1668372857673,CSE 291,B00,102448,Polikarpova; Nadezhda,0,0,0,0
1668372857673,CSE 291,C00,102453,Vaccaro; Kristen Marie,0,0,0,0
1668372857673,CSE 291,D00,111343,Savage; Stefan,0,0,0,0
1668372857673,CSE 291,E00,116474,Claffy; Kimberly Claire,0,0,0,0
1668372857673,CSE 291,F00,116479,Pasquale; Joseph,0,0,0,0
1668372858100,CSE 293,001,119111,Bafna; Vineet,9999,0,9999,0
1668372858100,CSE 293,002,119118,Bellare; Mihir,9999,0,9999,0
1668372858100,CSE 293,003,119122,Berg-Kirkpatrick; Taylor D,9999,0,9999,0
1668372858100,CSE 293,004,119135,Christensen; Henrik I,9999,0,9999,0
1668372858100,CSE 293,005,119142,Cottrell; Garrison W,9999,0,9999,0
1668372858100,CSE 293,006,119146,Deutsch; Alin Bernard,9999,0,9999,0
1668372858100,CSE 293,007,119159,Esmaeilzadeh; Hadi,9999,0,9999,0
1668372858100,CSE 293,008,119166,Freund; Yoav,9999,0,9999,0
1668372858100,CSE 293,009,119170,Griswold; William G.,9999,0,9999,0
1668372858100,CSE 293,010,119183,Gymrek; Melissa Ann,9999,0,9999,0
1668372858100,CSE 293,011,119190,Heninger; Nadia A,9999,0,9999,0
1668372858100,CSE 293,012,119230,Impagliazzo; Russell,9999,0,9999,0
1668372858100,CSE 293,013,119232,Jhala; Ranjit,9999,0,9999,0
1668372858100,CSE 293,014,119233,Kahng; Andrew Byun,9999,0,9999,0
1668372858100,CSE 293,015,119298,Kane; Daniel Mertz,9999,0,9999,0
1668372858100,CSE 293,016,119299,Kriegman; David J,9999,0,9999,0
1668372858100,CSE 293,017,119300,Kumar; Arun Kumar,9999,0,9999,0
1668372858100,CSE 293,018,119301,Lerner; Sorin,9999,0,9999,0
1668372858100,CSE 293,019,119302,Lovett; Shachar,9999,0,9999,0
1668372858100,CSE 293,020,119303,McAuley; Julian John,9999,0,9999,0
1668372858100,CSE 293,021,119304,Micciancio; Daniele,9999,0,9999,0
1668372858100,CSE 293,022,119367,Orailoglu; Alex,9999,0,9999,0
1668372858100,CSE 293,023,119382,Paturi; Ramamohan,9999,0,9999,0
1668372858100,CSE 293,024,119404,Polikarpova; Nadezhda,9999,0,9999,0
1668372858100,CSE 293,025,119406,Politz; Joseph Gibbs,9999,0,9999,0
1668372858100,CSE 293,026,119411,Porter; George M,9999,0,9999,0
1668372858100,CSE 293,027,119414,Porter; Leonard Emerson,9999,0,9999,0
1668372858100,CSE 293,028,119416,Ramamoorthi; Ravi,9999,0,9999,0
1668372858100,CSE 293,029,119417,Sahoo; Debashis,9999,0,9999,0
1668372858100,CSE 293,030,119420,Saul; Lawrence,9999,0,9999,0
1668372858100,CSE 293,031,119421,Savage; Stefan,9999,0,9999,0
1668372858100,CSE 293,032,119425,Schulze; Jurgen P.,9999,0,9999,0
1668372858100,CSE 293,033,119426,Snoeren; Alex C.,9999,0,9999,0
1668372858100,CSE 293,034,119428,Shang; Jingbo,9999,0,9999,0
1668372858100,CSE 293,035,119430,Stefan; Deian,9999,0,9999,0
1668372858100,CSE 293,036,119431,Su; Hao,9999,0,9999,0
1668372858100,CSE 293,037,119433,Swanson; Steven James,9999,0,9999,0
1668372858100,CSE 293,038,119435,Tullsen; Dean Michael,9999,0,9999,0
1668372858100,CSE 293,039,119483,Voelker; Geoffrey M.,9999,0,9999,0
1668372858100,CSE 293,040,119537,Zhao; Jishen,9999,0,9999,0
1668372858100,CSE 293,041,119538,Zhou; Yuan-Yuan,9999,0,9999,0
1668372858100,CSE 293,042,119539,Gao; Sicun,9999,0,9999,0
1668372858100,CSE 293,043,119540,Weibel; Nadir,9999,0,9999,0
1668372858100,CSE 293,044,119541,Gupta; Rajesh K.,9999,0,9999,0
1668372858100,CSE 293,045,126410,Vaccaro; Kristen Marie,9999,0,9999,0
1668372858100,CSE 293,046,126411,Klemke; Richard,9999,0,9999,0
1668372858524,CSE 294,A00,102459,Voelker; Geoffrey M.,0,0,0,0
1668372858524,CSE 294,B00,111322,Orailoglu; Alex,0,0,0,0
1668372858948,DSE 201,A00,096914,Deutsch; Alin Bernard,30,0,30,0
1668372859374,DSE 210,A00,096915,Dasgupta; Sanjoy,30,0,30,0
1668372859803,DSE 260A,A00,096916,Altintas De Callaf; Ilkay,30,0,30,0
1668372860246,ECE 200,001,103586,Antipa; Nicholas A,9999,0,9999,0
1668372860246,ECE 200,002,103587,Atanasov; Nikolay A.,9999,0,9999,0
1668372860246,ECE 200,003,103588,Bharadia; Dinesh,9999,0,9999,0
1668372860246,ECE 200,004,103589,Cheng; Chung Kuan,9999,0,9999,0
1668372860246,ECE 200,005,103590,Cosman; Pamela C.,9999,0,9999,0
1668372860246,ECE 200,006,103591,Dayeh; Shadi Ahmad,9999,0,9999,0
1668372860246,ECE 200,007,103592,Fainman; Yeshaiahu,9999,0,9999,0
1668372860246,ECE 200,008,103593,Ford; Joseph Earl,9999,0,9999,0
1668372860246,ECE 200,009,103594,Franceschetti; Massimo,9999,0,9999,0
1668372860246,ECE 200,010,103595,Fullerton; Eric E,9999,0,9999,0
1668372860246,ECE 200,011,103596,Galton; Ian A,9999,0,9999,0
1668372860246,ECE 200,012,103597,Gilja; Vikash,9999,0,9999,0
1668372860246,ECE 200,013,103598,Hall; Drew A.,9999,0,9999,0
1668372860246,ECE 200,014,103599,Hsueh; Tzu-Chien,9999,0,9999,0
1668372860246,ECE 200,015,103600,Javidi; Tara,9999,0,9999,0
1668372860246,ECE 200,016,103601,Kahng; Andrew Byun,9999,0,9999,0
1668372860246,ECE 200,017,103602,Kim; Young-Han,9999,0,9999,0
1668372860246,ECE 200,018,103603,Koushanfar; Farinaz,9999,0,9999,0
1668372860246,ECE 200,019,103604,Kuzum; Duygu,9999,0,9999,0
1668372860246,ECE 200,020,103605,Le; Hanh-Phuc,9999,0,9999,0
1668372860246,ECE 200,021,103606,Lin; Bill,9999,0,9999,0
1668372860246,ECE 200,022,103607,Liu; Zhaowei,9998,0,9999,1
1668372860246,ECE 200,023,103608,Lo; Yu-Hwa,9999,0,9999,0
1668372860246,ECE 200,024,103609,Lomakin; Vitaliy,9999,0,9999,0
1668372860246,ECE 200,025,103610,Mercier; Patrick Philip,9999,0,9999,0
1668372860246,ECE 200,026,103611,Meyer; Florian,9999,0,9999,0
1668372860246,ECE 200,027,103612,Milstein; Laurence B.,9999,0,9999,0
1668372860246,ECE 200,028,103613,Mir Arabbaygi; Siavash,9999,0,9999,0
1668372860246,ECE 200,029,103614,Mookherjea; Shayan,9999,0,9999,0
1668372860246,ECE 200,030,103615,Morris; Karcher William,9999,0,9999,0
1668372860246,ECE 200,031,103616,Ng; Tse Nga,9999,0,9999,0
1668372860246,ECE 200,032,103617,Nguyen; Truong Quang,9999,0,9999,0
1668372860246,ECE 200,033,103618,Nomura; Kenji,9999,0,9999,0
1668372860246,ECE 200,034,103619,Orlitsky; Alon,9999,0,9999,0
1668372860246,ECE 200,035,103620,Pal; Piya,9999,0,9999,0
1668372860246,ECE 200,036,103621,Papen; George C.,9999,0,9999,0
1668372860246,ECE 200,037,103622,Radic; Stojan,9999,0,9999,0
1668372860246,ECE 200,038,103623,Rao; Bhaskar D.,9999,0,9999,0
1668372860246,ECE 200,039,103624,Rao; Ramesh R,9999,0,9999,0
1668372860246,ECE 200,040,103625,Rebeiz; Gabriel,9999,0,9999,0
1668372860246,ECE 200,041,103626,Sanford; John R,9999,0,9999,0
1668372860246,ECE 200,042,103627,Siegel; Paul H.,9999,0,9999,0
1668372860246,ECE 200,043,103628,Sievenpiper; Daniel F.,9999,0,9999,0
1668372860246,ECE 200,044,103629,Sworder; David D.,9999,0,9999,0
1668372860246,ECE 200,045,103630,Taur; Yuan,9999,0,9999,0
1668372860246,ECE 200,046,103631,Touri; Behrouz,9999,0,9999,0
1668372860246,ECE 200,047,103632,Trivedi; Mohan M.,9999,0,9999,0
1668372860246,ECE 200,048,103633,Vasconcelos; Nuno,9999,0,9999,0
1668372860246,ECE 200,049,103634,Wang; Xiaolong,9999,0,9999,0
1668372860246,ECE 200,050,103635,Xie; Pengtao,9999,0,9999,0
1668372860246,ECE 200,051,103636,Yip; Michael,9999,0,9999,0
1668372860246,ECE 200,052,103637,Zeger; Kenneth A.,999,0,999,0
1668372860246,ECE 200,053,103638,Zhang; Xinyu,9999,0,9999,0
1668372860246,ECE 200,054,103639,Turakhia; Yatish Girish,9999,0,9999,0
1668372860246,ECE 200,055,103640,Kang; Mingu,9999,0,9999,0
1668372860246,ECE 200,056,103641,Shi; Yuanyuan,9999,0,9999,0
1668372860246,ECE 200,057,103642,Wang; Edward Jay,9999,0,9999,0
1668372860246,ECE 200,058,103643,Zheng; Yang,9999,0,9999,0
1668372860671,ECE 202,A00,103644,Kuzum; Duygu,0,0,0,0
1668372861098,ECE 212BN,A00,103646,Ng; Tse Nga,0,0,0,0
1668372861522,ECE 221,A00,111493,Staff,0,0,0,0
1668372861947,ECE 222B,A00,103647,Lomakin; Vitaliy,0,0,0,0
1668372862372,ECE 230B,A00,103648,Taur; Yuan,0,0,0,0
1668372862806,ECE 238B,A00,103649,Garay; Javier,0,0,0,0
1668372863233,ECE 240B,A00,112900,Fainman; Yeshaiahu,0,0,0,0
1668372863658,ECE 247A,A00,103650,Jokerst; Jesse Vincent,0,0,0,0
1668372864084,ECE 247B,A00,103651,Wang; Joseph,0,0,0,0
1668372864518,ECE 250,A00,103652,Siegel; Paul H.,0,0,0,0
1668372864941,ECE 251A,A00,103654,Rao; Bhaskar D.,0,0,0,0
1668372865367,ECE 257B,A00,103655,Bharadia; Dinesh,0,0,0,0
1668372865791,ECE 258A,A00,103656,Milstein; Laurence B.,0,0,0,0
1668372866216,ECE 260B,A00,103658,Kang; Mingu,0,0,0,0
1668372866644,ECE 264A,A00,103659,Galton; Ian A,0,0,0,0
1668372867067,ECE 265A,A00,103661,Gudem; Prasad S.S.,0,0,0,0
1668372867490,ECE 265D,A00,103662,Gudem; Prasad S.S.,0,0,0,0
1668372867923,ECE 268,A00,103663,Koushanfar; Farinaz,0,0,0,0
1668372868351,ECE 269,A01,103665,Pal; Piya,0,0,0,0
1668372868775,ECE 271B,A00,103666,Vasconcelos; Manuela,0,0,0,0
1668372869200,ECE 276A,A00,103667,Atanasov; Nikolay A.,0,0,0,0
1668372869623,ECE 277,A00,103668,An; Cheolhong,0,0,0,0
1668372870063,ECE 279,A00,117947,Hall; Drew A.,0,0,0,0
1668372870911,ECE 283,A00,103670,Hsueh; Tzu-Chien,0,0,0,0
1668372871343,ECE 284,A00,103671,Turakhia; Yatish Girish,0,0,0,0
1668372871769,ECE 285,A00,103672,Zheng; Yang,0,0,0,0
1668372871769,ECE 285,B00,103673,Sworder; David D.,0,0,0,0
1668372872196,ECE 287,A00,103676,Javidi; Tara,0,0,0,0
1668372872626,MATH 200B,A00,098023,Salehi Golsefidy; Alireza,12,0,15,3
1668372873057,MATH 202B,A00,098024,Rhoades; Brendon Patrick,9,0,15,6
1668372873480,MATH 203B,A00,098025,Oprea; Dragos N.,10,0,15,5
1668372873904,MATH 204B,A00,098026,Sorensen; Claus M,13,0,15,2
1668372874330,MATH 208,A00,098027,Izadi; Elham,7,0,10,3
1668372874756,MATH 209,A00,098028,Pollack; Aaron,10,0,10,0
1668372875195,MATH 211A,A00,112919,Rogalski; Daniel,9,0,10,1
1668372875620,MATH 211B,A00,112920,Seward; Brandon M.,9,0,10,1
1668372876046,MATH 218,A00,098029,Li; Bo,10,0,10,0
1668372876482,MATH 220B,A00,098030,Novak; Jonathan I,11,0,15,4
1668372876909,MATH 221A,A00,098031,Ebenfelt; Peter F,13,0,15,2
1668372877334,MATH 231B,A00,098032,Zlatos; Andrej,12,0,15,3
1668372877784,MATH 240B,A00,098033,Ni; Lei,9,0,15,6
1668372878215,MATH 243,A00,098034,Jekel; David Andrew,10,0,10,0
1668372878648,MATH 245A,A00,098035,Nie; Jiawang,0,0,15,16
1668372879080,MATH 248,A00,098036,Bejenaru; Ioan,10,0,10,0
1668372879503,MATH 250B,A00,098037,Spolaor; Luca,14,0,15,1
1668372879926,MATH 258,A00,098038,Ni; Lei,10,0,10,0
1668372880351,MATH 264B,A00,098041,Rhoades; Brendon Patrick,9,0,15,6
1668372880786,MATH 268,A00,098042,Buss; Samuel R,10,0,10,0
1668372881217,MATH 269,A00,098043,Rhoades; Brendon Patrick,10,0,10,0
1668372881649,MATH 270B,A00,098044,Li; Bo,10,0,15,5
1668372882075,MATH 272B,A00,098045,Holst; Michael J,13,0,15,2
1668372882502,MATH 273A,A00,098046,Tian; Xiaochuan,10,0,15,5
1668372882926,MATH 275,A01,098048,Tian; Xiaochuan,6,0,10,4
1668372883348,MATH 278A,A00,098049,Holst; Michael J,8,0,10,2
1668372883775,MATH 278B,A00,098050,Cloninger; Alexander,10,0,10,0
1668372884199,MATH 278C,A00,098051,Nie; Jiawang,7,0,10,3
1668372884625,MATH 280B,A00,098052,Zheng; Tianyi,8,0,15,7
1668372885050,MATH 281B,A00,098053,Bradic; Jelena,1,0,15,14
1668372885485,MATH 282B,A00,098054,Arias-Castro; Ery,0,0,15,15
1668372886047,MATH 285,A00,098055,Fitzsimmons; Patrick J,0,0,15,17
1668372886473,MATH 287B,A00,098056,Arias-Castro; Ery,2,0,15,13
1668372886897,MATH 288,A00,098057,Agarwal; Pooja,9,0,10,1
1668372886897,MATH 288,B00,098058,Zhang; Danna,8,0,10,2
1668372886897,MATH 288,C00,098059,Williams; Ruth J,9,0,10,1
1668372887323,MATH 290B,A00,098060,Roberts; Justin Deritter,13,0,15,2
1668372887746,MATH 292,A00,098061,Belmont; Eva Kinoshita,10,0,10,0
1668372888172,MATH 295,A00,098062,Suk; Andrew Hoon,48,0,50,2
1668372888598,MATH 296,A00,098063,Novak; Jonathan I,20,0,20,0
1668372889021,MATH 297,001,098064,Gamst; Anthony Collins,9997,0,9999,2
1668373390348,COGS 205,A00,101395,Chiba; Andrea,19,0,20,1
1668373390792,COGS 210B,001,101404,Greene; Deanna Jacquelyn,9998,0,9999,1
1668373390792,COGS 210B,002,101417,Xia; Haijun,9999,0,9999,0
1668373390792,COGS 210B,003,101422,Nitz; Douglas A.,9999,0,9999,0
1668373390792,COGS 210B,004,101423,Hollan; James D.,9998,0,9999,1
1668373390792,COGS 210B,005,101424,Deak; Gedeon O.,9998,0,9999,1
1668373390792,COGS 210B,006,101425,Rossano; Federico,9999,0,9999,0
1668373391222,COGS 211B,A00,101427,Coulson; Seana M,9996,0,9999,3
1668373391658,COGS 220,A00,101428,Hollan; James D.,0,0,25,25
1668373392080,COGS 229,A00,101429,Dow; Steven P,18,0,25,7
1668373392610,COGS 230,A00,101430,Klemmer; Scott R,11,0,17,6
1668373393038,COGS 234,A00,101431,Xia; Haijun,1,0,25,24
1668373393463,COGS 260,A00,101432,Kiyonaga; Anastasia,21,0,25,4
1668373393463,COGS 260,B00,101433,Kirsh; David Joel,15,0,25,10
1668373393892,CSE 202,A00,102371,Impagliazzo; Russell,0,0,0,0
1668373394320,CSE 203B,A01,102373,Cheng; Chung Kuan,0,0,0,0
1668373394743,CSE 208,A00,102374,Micciancio; Daniele,0,0,0,0
1668373395170,CSE 209A,A00,112895,Impagliazzo; Russell,0,0,15,15
1668373395594,CSE 209B,A00,108005,Bellare; Mihir,0,0,0,0
1668373396022,CSE 210,A00,113163,Coblenz; Michael J,0,0,0,0
1668373396446,CSE 219,A00,106111,Dow; Steven P,0,0,20,20
1668373396872,CSE 221,A00,102376,Voelker; Geoffrey M.,0,0,0,0
1668373397299,CSE 224,A01,102378,Porter; George M,0,0,0,0
1668373397723,CSE 229A,A00,102379,Savage; Stefan,0,0,0,0
1668373398150,CSE 229C,A00,102380,Munyaka; Imani N. S.,0,0,0,0
1668373398577,CSE 232B,A00,102382,Deutsch; Alin Bernard,0,0,0,0
1668373399001,CSE 234,A01,112904,Kumar; Arun Kumar,0,0,0,0
1668373399426,CSE 237A,A00,102383,Rosing; Tajana Simunic,0,0,0,0
1668373399853,CSE 239A,A00,102384,Deutsch; Alin Bernard,0,0,0,0
1668373400295,CSE 239B,A00,102385,Polikarpova; Nadezhda,0,0,0,0
1668373400718,CSE 240A,A00,102386,Pannuto; Patrick William,0,0,0,0
1668373401147,CSE 240B,A00,102387,Zhao; Jishen,0,0,0,0
1668373401572,CSE 241A,A00,106406,Kang; Mingu,0,0,0,0
1668373401995,CSE 249B,A00,102388,Kahng; Andrew Byun,0,0,8,8
1668373402420,CSE 251B,A01,102392,Cottrell; Garrison W,0,0,0,0
1668373402420,CSE 251B,A02,102393,Cottrell; Garrison W,0,0,0,0
1668373402854,CSE 252B,A00,102394,Ochoa; Benjamin Lawrence,0,0,0,0
1668373403280,CSE 257,A01,102396,Gao; Sicun,0,0,0,0
1668373403704,CSE 272,A00,102397,Li; Tzumao,0,0,0,0
1668373404129,CSE 274,A00,111323,Chern; Albert Ren-Haur,0,0,0,0
1668373404552,CSE 282,A00,102398,Pevzner; Pavel Arkadjevich,0,0,0,0
1668373404980,CSE 284,A00,114175,Gymrek; Melissa Ann,0,0,0,0
1668373405407,CSE 290,A00,102399,Chandraker; Manmohan Krishna,0,0,0,0
1668373405407,CSE 290,B00,102400,Vaccaro; Kristen Marie,0,0,25,25
1668373405407,CSE 290,C00,102414,Pannuto; Patrick William,0,0,25,25
1668373405407,CSE 290,D00,102427,Pevzner; Pavel Arkadjevich,0,0,0,0
1668373405407,CSE 290,E00,102429,Zhao; Jishen,0,0,0,0
1668373405407,CSE 290,F00,102436,Tullsen; Dean Michael,0,0,0,0
1668373405407,CSE 290,G00,102440,Christensen; Henrik I,0,0,20,20
1668373405836,CSE 291,A00,102443,Su; Hao,0,0,0,0
1668373405836,CSE 291,B00,102448,Polikarpova; Nadezhda,0,0,0,0
1668373405836,CSE 291,C00,102453,Vaccaro; Kristen Marie,0,0,0,0
1668373405836,CSE 291,D00,111343,Savage; Stefan,0,0,0,0
1668373405836,CSE 291,E00,116474,Claffy; Kimberly Claire,0,0,0,0
1668373405836,CSE 291,F00,116479,Pasquale; Joseph,0,0,0,0
1668373406263,CSE 293,001,119111,Bafna; Vineet,9999,0,9999,0
1668373406263,CSE 293,002,119118,Bellare; Mihir,9999,0,9999,0
1668373406263,CSE 293,003,119122,Berg-Kirkpatrick; Taylor D,9999,0,9999,0
1668373406263,CSE 293,004,119135,Christensen; Henrik I,9999,0,9999,0
1668373406263,CSE 293,005,119142,Cottrell; Garrison W,9999,0,9999,0
1668373406263,CSE 293,006,119146,Deutsch; Alin Bernard,9999,0,9999,0
1668373406263,CSE 293,007,119159,Esmaeilzadeh; Hadi,9999,0,9999,0
1668373406263,CSE 293,008,119166,Freund; Yoav,9999,0,9999,0
1668373406263,CSE 293,009,119170,Griswold; William G.,9999,0,9999,0
1668373406263,CSE 293,010,119183,Gymrek; Melissa Ann,9999,0,9999,0
1668373406263,CSE 293,011,119190,Heninger; Nadia A,9999,0,9999,0
1668373406263,CSE 293,012,119230,Impagliazzo; Russell,9999,0,9999,0
1668373406263,CSE 293,013,119232,Jhala; Ranjit,9999,0,9999,0
1668373406263,CSE 293,014,119233,Kahng; Andrew Byun,9999,0,9999,0
1668373406263,CSE 293,015,119298,Kane; Daniel Mertz,9999,0,9999,0
1668373406263,CSE 293,016,119299,Kriegman; David J,9999,0,9999,0
1668373406263,CSE 293,017,119300,Kumar; Arun Kumar,9999,0,9999,0
1668373406263,CSE 293,018,119301,Lerner; Sorin,9999,0,9999,0
1668373406263,CSE 293,019,119302,Lovett; Shachar,9999,0,9999,0
1668373406263,CSE 293,020,119303,McAuley; Julian John,9999,0,9999,0
1668373406263,CSE 293,021,119304,Micciancio; Daniele,9999,0,9999,0
1668373406263,CSE 293,022,119367,Orailoglu; Alex,9999,0,9999,0
1668373406263,CSE 293,023,119382,Paturi; Ramamohan,9999,0,9999,0
1668373406263,CSE 293,024,119404,Polikarpova; Nadezhda,9999,0,9999,0
1668373406263,CSE 293,025,119406,Politz; Joseph Gibbs,9999,0,9999,0
1668373406263,CSE 293,026,119411,Porter; George M,9999,0,9999,0
1668373406263,CSE 293,027,119414,Porter; Leonard Emerson,9999,0,9999,0
1668373406263,CSE 293,028,119416,Ramamoorthi; Ravi,9999,0,9999,0
1668373406263,CSE 293,029,119417,Sahoo; Debashis,9999,0,9999,0
1668373406263,CSE 293,030,119420,Saul; Lawrence,9999,0,9999,0
1668373406263,CSE 293,031,119421,Savage; Stefan,9999,0,9999,0
1668373406263,CSE 293,032,119425,Schulze; Jurgen P.,9999,0,9999,0
1668373406263,CSE 293,033,119426,Snoeren; Alex C.,9999,0,9999,0
1668373406263,CSE 293,034,119428,Shang; Jingbo,9999,0,9999,0
1668373406263,CSE 293,035,119430,Stefan; Deian,9999,0,9999,0
1668373406263,CSE 293,036,119431,Su; Hao,9999,0,9999,0
1668373406263,CSE 293,037,119433,Swanson; Steven James,9999,0,9999,0
1668373406263,CSE 293,038,119435,Tullsen; Dean Michael,9999,0,9999,0
1668373406263,CSE 293,039,119483,Voelker; Geoffrey M.,9999,0,9999,0
1668373406263,CSE 293,040,119537,Zhao; Jishen,9999,0,9999,0
1668373406263,CSE 293,041,119538,Zhou; Yuan-Yuan,9999,0,9999,0
1668373406263,CSE 293,042,119539,Gao; Sicun,9999,0,9999,0
1668373406263,CSE 293,043,119540,Weibel; Nadir,9999,0,9999,0
1668373406263,CSE 293,044,119541,Gupta; Rajesh K.,9999,0,9999,0
1668373406263,CSE 293,045,126410,Vaccaro; Kristen Marie,9999,0,9999,0
1668373406263,CSE 293,046,126411,Klemke; Richard,9999,0,9999,0
1668373406689,CSE 294,A00,102459,Voelker; Geoffrey M.,0,0,0,0
1668373406689,CSE 294,B00,111322,Orailoglu; Alex,0,0,0,0
1668373407124,DSE 201,A00,096914,Deutsch; Alin Bernard,30,0,30,0
1668373407652,DSE 210,A00,096915,Dasgupta; Sanjoy,30,0,30,0
1668373408077,DSE 260A,A00,096916,Altintas De Callaf; Ilkay,30,0,30,0
1668373408529,ECE 200,001,103586,Antipa; Nicholas A,9999,0,9999,0
1668373408529,ECE 200,002,103587,Atanasov; Nikolay A.,9999,0,9999,0
1668373408529,ECE 200,003,103588,Bharadia; Dinesh,9999,0,9999,0
1668373408529,ECE 200,004,103589,Cheng; Chung Kuan,9999,0,9999,0
1668373408529,ECE 200,005,103590,Cosman; Pamela C.,9999,0,9999,0
1668373408529,ECE 200,006,103591,Dayeh; Shadi Ahmad,9999,0,9999,0
1668373408529,ECE 200,007,103592,Fainman; Yeshaiahu,9999,0,9999,0
1668373408529,ECE 200,008,103593,Ford; Joseph Earl,9999,0,9999,0
1668373408529,ECE 200,009,103594,Franceschetti; Massimo,9999,0,9999,0
1668373408529,ECE 200,010,103595,Fullerton; Eric E,9999,0,9999,0
1668373408529,ECE 200,011,103596,Galton; Ian A,9999,0,9999,0
1668373408529,ECE 200,012,103597,Gilja; Vikash,9999,0,9999,0
1668373408529,ECE 200,013,103598,Hall; Drew A.,9999,0,9999,0
1668373408529,ECE 200,014,103599,Hsueh; Tzu-Chien,9999,0,9999,0
1668373408529,ECE 200,015,103600,Javidi; Tara,9999,0,9999,0
1668373408529,ECE 200,016,103601,Kahng; Andrew Byun,9999,0,9999,0
1668373408529,ECE 200,017,103602,Kim; Young-Han,9999,0,9999,0
1668373408529,ECE 200,018,103603,Koushanfar; Farinaz,9999,0,9999,0
1668373408529,ECE 200,019,103604,Kuzum; Duygu,9999,0,9999,0
1668373408529,ECE 200,020,103605,Le; Hanh-Phuc,9999,0,9999,0
1668373408529,ECE 200,021,103606,Lin; Bill,9999,0,9999,0
1668373408529,ECE 200,022,103607,Liu; Zhaowei,9998,0,9999,1
1668373408529,ECE 200,023,103608,Lo; Yu-Hwa,9999,0,9999,0
1668373408529,ECE 200,024,103609,Lomakin; Vitaliy,9999,0,9999,0
1668373408529,ECE 200,025,103610,Mercier; Patrick Philip,9999,0,9999,0
1668373408529,ECE 200,026,103611,Meyer; Florian,9999,0,9999,0
1668373408529,ECE 200,027,103612,Milstein; Laurence B.,9999,0,9999,0
1668373408529,ECE 200,028,103613,Mir Arabbaygi; Siavash,9999,0,9999,0
1668373408529,ECE 200,029,103614,Mookherjea; Shayan,9999,0,9999,0
1668373408529,ECE 200,030,103615,Morris; Karcher William,9999,0,9999,0
1668373408529,ECE 200,031,103616,Ng; Tse Nga,9999,0,9999,0
1668373408529,ECE 200,032,103617,Nguyen; Truong Quang,9999,0,9999,0
1668373408529,ECE 200,033,103618,Nomura; Kenji,9999,0,9999,0
1668373408529,ECE 200,034,103619,Orlitsky; Alon,9999,0,9999,0
1668373408529,ECE 200,035,103620,Pal; Piya,9999,0,9999,0
1668373408529,ECE 200,036,103621,Papen; George C.,9999,0,9999,0
1668373408529,ECE 200,037,103622,Radic; Stojan,9999,0,9999,0
1668373408529,ECE 200,038,103623,Rao; Bhaskar D.,9999,0,9999,0
1668373408529,ECE 200,039,103624,Rao; Ramesh R,9999,0,9999,0
1668373408529,ECE 200,040,103625,Rebeiz; Gabriel,9999,0,9999,0
1668373408529,ECE 200,041,103626,Sanford; John R,9999,0,9999,0
1668373408529,ECE 200,042,103627,Siegel; Paul H.,9999,0,9999,0
1668373408529,ECE 200,043,103628,Sievenpiper; Daniel F.,9999,0,9999,0
1668373408529,ECE 200,044,103629,Sworder; David D.,9999,0,9999,0
1668373408529,ECE 200,045,103630,Taur; Yuan,9999,0,9999,0
1668373408529,ECE 200,046,103631,Touri; Behrouz,9999,0,9999,0
1668373408529,ECE 200,047,103632,Trivedi; Mohan M.,9999,0,9999,0
1668373408529,ECE 200,048,103633,Vasconcelos; Nuno,9999,0,9999,0
1668373408529,ECE 200,049,103634,Wang; Xiaolong,9999,0,9999,0
1668373408529,ECE 200,050,103635,Xie; Pengtao,9999,0,9999,0
1668373408529,ECE 200,051,103636,Yip; Michael,9999,0,9999,0
1668373408529,ECE 200,052,103637,Zeger; Kenneth A.,999,0,999,0
1668373408529,ECE 200,053,103638,Zhang; Xinyu,9999,0,9999,0
1668373408529,ECE 200,054,103639,Turakhia; Yatish Girish,9999,0,9999,0
1668373408529,ECE 200,055,103640,Kang; Mingu,9999,0,9999,0
1668373408529,ECE 200,056,103641,Shi; Yuanyuan,9999,0,9999,0
1668373408529,ECE 200,057,103642,Wang; Edward Jay,9999,0,9999,0
1668373408529,ECE 200,058,103643,Zheng; Yang,9999,0,9999,0
1668373408952,ECE 202,A00,103644,Kuzum; Duygu,0,0,0,0
1668373409378,ECE 212BN,A00,103646,Ng; Tse Nga,0,0,0,0
1668373409800,ECE 221,A00,111493,Staff,0,0,0,0
1668373410226,ECE 222B,A00,103647,Lomakin; Vitaliy,0,0,0,0
1668373410650,ECE 230B,A00,103648,Taur; Yuan,0,0,0,0
1668373411077,ECE 238B,A00,103649,Garay; Javier,0,0,0,0
1668373411504,ECE 240B,A00,112900,Fainman; Yeshaiahu,0,0,0,0
1668373411926,ECE 247A,A00,103650,Jokerst; Jesse Vincent,0,0,0,0
1668373412352,ECE 247B,A00,103651,Wang; Joseph,0,0,0,0
1668373412773,ECE 250,A00,103652,Siegel; Paul H.,0,0,0,0
1668373413197,ECE 251A,A00,103654,Rao; Bhaskar D.,0,0,0,0
1668373413620,ECE 257B,A00,103655,Bharadia; Dinesh,0,0,0,0
1668373414048,ECE 258A,A00,103656,Milstein; Laurence B.,0,0,0,0
1668373414483,ECE 260B,A00,103658,Kang; Mingu,0,0,0,0
1668373414906,ECE 264A,A00,103659,Galton; Ian A,0,0,0,0
1668373415328,ECE 265A,A00,103661,Gudem; Prasad S.S.,0,0,0,0
1668373415752,ECE 265D,A00,103662,Gudem; Prasad S.S.,0,0,0,0
1668373416177,ECE 268,A00,103663,Koushanfar; Farinaz,0,0,0,0
1668373416601,ECE 269,A01,103665,Pal; Piya,0,0,0,0
1668373417028,ECE 271B,A00,103666,Vasconcelos; Manuela,0,0,0,0
1668373417452,ECE 276A,A00,103667,Atanasov; Nikolay A.,0,0,0,0
1668373417878,ECE 277,A00,103668,An; Cheolhong,0,0,0,0
1668373418301,ECE 279,A00,117947,Hall; Drew A.,0,0,0,0
1668373419149,ECE 283,A00,103670,Hsueh; Tzu-Chien,0,0,0,0
1668373419575,ECE 284,A00,103671,Turakhia; Yatish Girish,0,0,0,0
1668373419999,ECE 285,A00,103672,Zheng; Yang,0,0,0,0
1668373419999,ECE 285,B00,103673,Sworder; David D.,0,0,0,0
1668373420423,ECE 287,A00,103676,Javidi; Tara,0,0,0,0
1668373420847,MATH 200B,A00,098023,Salehi Golsefidy; Alireza,12,0,15,3
1668373421269,MATH 202B,A00,098024,Rhoades; Brendon Patrick,9,0,15,6
1668373421715,MATH 203B,A00,098025,Oprea; Dragos N.,10,0,15,5
1668373422138,MATH 204B,A00,098026,Sorensen; Claus M,13,0,15,2
1668373422562,MATH 208,A00,098027,Izadi; Elham,7,0,10,3
1668373422985,MATH 209,A00,098028,Pollack; Aaron,10,0,10,0
1668373423411,MATH 211A,A00,112919,Rogalski; Daniel,9,0,10,1
1668373423836,MATH 211B,A00,112920,Seward; Brandon M.,9,0,10,1
1668373424258,MATH 218,A00,098029,Li; Bo,10,0,10,0
1668373424692,MATH 220B,A00,098030,Novak; Jonathan I,11,0,15,4
1668373425115,MATH 221A,A00,098031,Ebenfelt; Peter F,13,0,15,2
1668373425541,MATH 231B,A00,098032,Zlatos; Andrej,12,0,15,3
1668373425975,MATH 240B,A00,098033,Ni; Lei,9,0,15,6
1668373426407,MATH 243,A00,098034,Jekel; David Andrew,10,0,10,0
1668373426830,MATH 245A,A00,098035,Nie; Jiawang,0,0,15,16
1668373427264,MATH 248,A00,098036,Bejenaru; Ioan,10,0,10,0
1668373427687,MATH 250B,A00,098037,Spolaor; Luca,14,0,15,1
1668373428113,MATH 258,A00,098038,Ni; Lei,10,0,10,0
1668373428538,MATH 264B,A00,098041,Rhoades; Brendon Patrick,9,0,15,6
1668373428971,MATH 268,A00,098042,Buss; Samuel R,10,0,10,0
1668373429395,MATH 269,A00,098043,Rhoades; Brendon Patrick,10,0,10,0
1668373429817,MATH 270B,A00,098044,Li; Bo,10,0,15,5
1668373430240,MATH 272B,A00,098045,Holst; Michael J,13,0,15,2
1668373430664,MATH 273A,A00,098046,Tian; Xiaochuan,10,0,15,5
1668373431090,MATH 275,A01,098048,Tian; Xiaochuan,6,0,10,4
1668373431516,MATH 278A,A00,098049,Holst; Michael J,8,0,10,2
1668373431938,MATH 278B,A00,098050,Cloninger; Alexander,10,0,10,0
1668373432362,MATH 278C,A00,098051,Nie; Jiawang,7,0,10,3
1668373432788,MATH 280B,A00,098052,Zheng; Tianyi,8,0,15,7
1668373433214,MATH 281B,A00,098053,Bradic; Jelena,1,0,15,14
1668373433636,MATH 282B,A00,098054,Arias-Castro; Ery,0,0,15,15
1668373434064,MATH 285,A00,098055,Fitzsimmons; Patrick J,0,0,15,17
1668373434488,MATH 287B,A00,098056,Arias-Castro; Ery,2,0,15,13
1668373434911,MATH 288,A00,098057,Agarwal; Pooja,9,0,10,1
1668373434911,MATH 288,B00,098058,Zhang; Danna,8,0,10,2
1668373434911,MATH 288,C00,098059,Williams; Ruth J,9,0,10,1
1668373435351,MATH 290B,A00,098060,Roberts; Justin Deritter,13,0,15,2
1668373435784,MATH 292,A00,098061,Belmont; Eva Kinoshita,10,0,10,0
1668373436221,MATH 295,A00,098062,Suk; Andrew Hoon,48,0,50,2
1668373436646,MATH 296,A00,098063,Novak; Jonathan I,20,0,20,0
1668373437072,MATH 297,001,098064,Gamst; Anthony Collins,9997,0,9999,2
1668373938616,COGS 205,A00,101395,Chiba; Andrea,19,0,20,1
1668373939042,COGS 210B,001,101404,Greene; Deanna Jacquelyn,9998,0,9999,1
1668373939042,COGS 210B,002,101417,Xia; Haijun,9999,0,9999,0
1668373939042,COGS 210B,003,101422,Nitz; Douglas A.,9999,0,9999,0
1668373939042,COGS 210B,004,101423,Hollan; James D.,9998,0,9999,1
1668373939042,COGS 210B,005,101424,Deak; Gedeon O.,9998,0,9999,1
1668373939042,COGS 210B,006,101425,Rossano; Federico,9999,0,9999,0
1668373939479,COGS 211B,A00,101427,Coulson; Seana M,9996,0,9999,3
1668373939904,COGS 220,A00,101428,Hollan; James D.,0,0,25,25
1668373940331,COGS 229,A00,101429,Dow; Steven P,18,0,25,7
1668373940755,COGS 230,A00,101430,Klemmer; Scott R,11,0,17,6
1668373941204,COGS 234,A00,101431,Xia; Haijun,1,0,25,24
1668373941630,COGS 260,A00,101432,Kiyonaga; Anastasia,21,0,25,4
1668373941630,COGS 260,B00,101433,Kirsh; David Joel,15,0,25,10
1668373942056,CSE 202,A00,102371,Impagliazzo; Russell,0,0,0,0
1668373942481,CSE 203B,A01,102373,Cheng; Chung Kuan,0,0,0,0
1668373942911,CSE 208,A00,102374,Micciancio; Daniele,0,0,0,0
1668373943335,CSE 209A,A00,112895,Impagliazzo; Russell,0,0,15,15
1668373943760,CSE 209B,A00,108005,Bellare; Mihir,0,0,0,0
1668373944184,CSE 210,A00,113163,Coblenz; Michael J,0,0,0,0
1668373944611,CSE 219,A00,106111,Dow; Steven P,0,0,20,20
1668373945034,CSE 221,A00,102376,Voelker; Geoffrey M.,0,0,0,0
1668373945458,CSE 224,A01,102378,Porter; George M,0,0,0,0
1668373945891,CSE 229A,A00,102379,Savage; Stefan,0,0,0,0
1668373946328,CSE 229C,A00,102380,Munyaka; Imani N. S.,0,0,0,0
1668373946753,CSE 232B,A00,102382,Deutsch; Alin Bernard,0,0,0,0
1668373947191,CSE 234,A01,112904,Kumar; Arun Kumar,0,0,0,0
1668373947618,CSE 237A,A00,102383,Rosing; Tajana Simunic,0,0,0,0
1668373948041,CSE 239A,A00,102384,Deutsch; Alin Bernard,0,0,0,0
1668373948463,CSE 239B,A00,102385,Polikarpova; Nadezhda,0,0,0,0
1668373948889,CSE 240A,A00,102386,Pannuto; Patrick William,0,0,0,0
1668373949313,CSE 240B,A00,102387,Zhao; Jishen,0,0,0,0
1668373949737,CSE 241A,A00,106406,Kang; Mingu,0,0,0,0
1668373950163,CSE 249B,A00,102388,Kahng; Andrew Byun,0,0,8,8
1668373950588,CSE 251B,A01,102392,Cottrell; Garrison W,0,0,0,0
1668373950588,CSE 251B,A02,102393,Cottrell; Garrison W,0,0,0,0
1668373951012,CSE 252B,A00,102394,Ochoa; Benjamin Lawrence,0,0,0,0
1668373951439,CSE 257,A01,102396,Gao; Sicun,0,0,0,0
1668373951861,CSE 272,A00,102397,Li; Tzumao,0,0,0,0
1668373952294,CSE 274,A00,111323,Chern; Albert Ren-Haur,0,0,0,0
1668373952717,CSE 282,A00,102398,Pevzner; Pavel Arkadjevich,0,0,0,0
1668373953148,CSE 284,A00,114175,Gymrek; Melissa Ann,0,0,0,0
1668373953571,CSE 290,A00,102399,Chandraker; Manmohan Krishna,0,0,0,0
1668373953571,CSE 290,B00,102400,Vaccaro; Kristen Marie,0,0,25,25
1668373953571,CSE 290,C00,102414,Pannuto; Patrick William,0,0,25,25
1668373953571,CSE 290,D00,102427,Pevzner; Pavel Arkadjevich,0,0,0,0
1668373953571,CSE 290,E00,102429,Zhao; Jishen,0,0,0,0
1668373953571,CSE 290,F00,102436,Tullsen; Dean Michael,0,0,0,0
1668373953571,CSE 290,G00,102440,Christensen; Henrik I,0,0,20,20
1668373953997,CSE 291,A00,102443,Su; Hao,0,0,0,0
1668373953997,CSE 291,B00,102448,Polikarpova; Nadezhda,0,0,0,0
1668373953997,CSE 291,C00,102453,Vaccaro; Kristen Marie,0,0,0,0
1668373953997,CSE 291,D00,111343,Savage; Stefan,0,0,0,0
1668373953997,CSE 291,E00,116474,Claffy; Kimberly Claire,0,0,0,0
1668373953997,CSE 291,F00,116479,Pasquale; Joseph,0,0,0,0
1668373954423,CSE 293,001,119111,Bafna; Vineet,9999,0,9999,0
1668373954423,CSE 293,002,119118,Bellare; Mihir,9999,0,9999,0
1668373954423,CSE 293,003,119122,Berg-Kirkpatrick; Taylor D,9999,0,9999,0
1668373954423,CSE 293,004,119135,Christensen; Henrik I,9999,0,9999,0
1668373954423,CSE 293,005,119142,Cottrell; Garrison W,9999,0,9999,0
1668373954423,CSE 293,006,119146,Deutsch; Alin Bernard,9999,0,9999,0
1668373954423,CSE 293,007,119159,Esmaeilzadeh; Hadi,9999,0,9999,0
1668373954423,CSE 293,008,119166,Freund; Yoav,9999,0,9999,0
1668373954423,CSE 293,009,119170,Griswold; William G.,9999,0,9999,0
1668373954423,CSE 293,010,119183,Gymrek; Melissa Ann,9999,0,9999,0
1668373954423,CSE 293,011,119190,Heninger; Nadia A,9999,0,9999,0
1668373954423,CSE 293,012,119230,Impagliazzo; Russell,9999,0,9999,0
1668373954423,CSE 293,013,119232,Jhala; Ranjit,9999,0,9999,0
1668373954423,CSE 293,014,119233,Kahng; Andrew Byun,9999,0,9999,0
1668373954423,CSE 293,015,119298,Kane; Daniel Mertz,9999,0,9999,0
1668373954423,CSE 293,016,119299,Kriegman; David J,9999,0,9999,0
1668373954423,CSE 293,017,119300,Kumar; Arun Kumar,9999,0,9999,0
1668373954423,CSE 293,018,119301,Lerner; Sorin,9999,0,9999,0
1668373954423,CSE 293,019,119302,Lovett; Shachar,9999,0,9999,0
1668373954423,CSE 293,020,119303,McAuley; Julian John,9999,0,9999,0
1668373954423,CSE 293,021,119304,Micciancio; Daniele,9999,0,9999,0
1668373954423,CSE 293,022,119367,Orailoglu; Alex,9999,0,9999,0
1668373954423,CSE 293,023,119382,Paturi; Ramamohan,9999,0,9999,0
1668373954423,CSE 293,024,119404,Polikarpova; Nadezhda,9999,0,9999,0
1668373954423,CSE 293,025,119406,Politz; Joseph Gibbs,9999,0,9999,0
1668373954423,CSE 293,026,119411,Porter; George M,9999,0,9999,0
1668373954423,CSE 293,027,119414,Porter; Leonard Emerson,9999,0,9999,0
1668373954423,CSE 293,028,119416,Ramamoorthi; Ravi,9999,0,9999,0
1668373954423,CSE 293,029,119417,Sahoo; Debashis,9999,0,9999,0
1668373954423,CSE 293,030,119420,Saul; Lawrence,9999,0,9999,0
1668373954423,CSE 293,031,119421,Savage; Stefan,9999,0,9999,0
1668373954423,CSE 293,032,119425,Schulze; Jurgen P.,9999,0,9999,0
1668373954423,CSE 293,033,119426,Snoeren; Alex C.,9999,0,9999,0
1668373954423,CSE 293,034,119428,Shang; Jingbo,9999,0,9999,0
1668373954423,CSE 293,035,119430,Stefan; Deian,9999,0,9999,0
1668373954423,CSE 293,036,119431,Su; Hao,9999,0,9999,0
1668373954423,CSE 293,037,119433,Swanson; Steven James,9999,0,9999,0
1668373954423,CSE 293,038,119435,Tullsen; Dean Michael,9999,0,9999,0
1668373954423,CSE 293,039,119483,Voelker; Geoffrey M.,9999,0,9999,0
1668373954423,CSE 293,040,119537,Zhao; Jishen,9999,0,9999,0
1668373954423,CSE 293,041,119538,Zhou; Yuan-Yuan,9999,0,9999,0
1668373954423,CSE 293,042,119539,Gao; Sicun,9999,0,9999,0
1668373954423,CSE 293,043,119540,Weibel; Nadir,9999,0,9999,0
1668373954423,CSE 293,044,119541,Gupta; Rajesh K.,9999,0,9999,0
1668373954423,CSE 293,045,126410,Vaccaro; Kristen Marie,9999,0,9999,0
1668373954423,CSE 293,046,126411,Klemke; Richard,9999,0,9999,0
1668373954856,CSE 294,A00,102459,Voelker; Geoffrey M.,0,0,0,0
1668373954856,CSE 294,B00,111322,Orailoglu; Alex,0,0,0,0
1668373955280,DSE 201,A00,096914,Deutsch; Alin Bernard,30,0,30,0
1668373955707,DSE 210,A00,096915,Dasgupta; Sanjoy,30,0,30,0
1668373956130,DSE 260A,A00,096916,Altintas De Callaf; Ilkay,30,0,30,0
1668373956605,ECE 200,001,103586,Antipa; Nicholas A,9999,0,9999,0
1668373956605,ECE 200,002,103587,Atanasov; Nikolay A.,9999,0,9999,0
1668373956605,ECE 200,003,103588,Bharadia; Dinesh,9999,0,9999,0
1668373956605,ECE 200,004,103589,Cheng; Chung Kuan,9999,0,9999,0
1668373956605,ECE 200,005,103590,Cosman; Pamela C.,9999,0,9999,0
1668373956605,ECE 200,006,103591,Dayeh; Shadi Ahmad,9999,0,9999,0
1668373956605,ECE 200,007,103592,Fainman; Yeshaiahu,9999,0,9999,0
1668373956605,ECE 200,008,103593,Ford; Joseph Earl,9999,0,9999,0
1668373956605,ECE 200,009,103594,Franceschetti; Massimo,9999,0,9999,0
1668373956605,ECE 200,010,103595,Fullerton; Eric E,9999,0,9999,0
1668373956605,ECE 200,011,103596,Galton; Ian A,9999,0,9999,0
1668373956605,ECE 200,012,103597,Gilja; Vikash,9999,0,9999,0
1668373956605,ECE 200,013,103598,Hall; Drew A.,9999,0,9999,0
1668373956605,ECE 200,014,103599,Hsueh; Tzu-Chien,9999,0,9999,0
1668373956605,ECE 200,015,103600,Javidi; Tara,9999,0,9999,0
1668373956605,ECE 200,016,103601,Kahng; Andrew Byun,9999,0,9999,0
1668373956605,ECE 200,017,103602,Kim; Young-Han,9999,0,9999,0
1668373956605,ECE 200,018,103603,Koushanfar; Farinaz,9999,0,9999,0
1668373956605,ECE 200,019,103604,Kuzum; Duygu,9999,0,9999,0
1668373956605,ECE 200,020,103605,Le; Hanh-Phuc,9999,0,9999,0
1668373956605,ECE 200,021,103606,Lin; Bill,9999,0,9999,0
1668373956605,ECE 200,022,103607,Liu; Zhaowei,9998,0,9999,1
1668373956605,ECE 200,023,103608,Lo; Yu-Hwa,9999,0,9999,0
1668373956605,ECE 200,024,103609,Lomakin; Vitaliy,9999,0,9999,0
1668373956605,ECE 200,025,103610,Mercier; Patrick Philip,9999,0,9999,0
1668373956605,ECE 200,026,103611,Meyer; Florian,9999,0,9999,0
1668373956605,ECE 200,027,103612,Milstein; Laurence B.,9999,0,9999,0
1668373956605,ECE 200,028,103613,Mir Arabbaygi; Siavash,9999,0,9999,0
1668373956605,ECE 200,029,103614,Mookherjea; Shayan,9999,0,9999,0
1668373956605,ECE 200,030,103615,Morris; Karcher William,9999,0,9999,0
1668373956605,ECE 200,031,103616,Ng; Tse Nga,9999,0,9999,0
1668373956605,ECE 200,032,103617,Nguyen; Truong Quang,9999,0,9999,0
1668373956605,ECE 200,033,103618,Nomura; Kenji,9999,0,9999,0
1668373956605,ECE 200,034,103619,Orlitsky; Alon,9999,0,9999,0
1668373956605,ECE 200,035,103620,Pal; Piya,9999,0,9999,0
1668373956605,ECE 200,036,103621,Papen; George C.,9999,0,9999,0
1668373956605,ECE 200,037,103622,Radic; Stojan,9999,0,9999,0
1668373956605,ECE 200,038,103623,Rao; Bhaskar D.,9999,0,9999,0
1668373956605,ECE 200,039,103624,Rao; Ramesh R,9999,0,9999,0
1668373956605,ECE 200,040,103625,Rebeiz; Gabriel,9999,0,9999,0
1668373956605,ECE 200,041,103626,Sanford; John R,9999,0,9999,0
1668373956605,ECE 200,042,103627,Siegel; Paul H.,9999,0,9999,0
1668373956605,ECE 200,043,103628,Sievenpiper; Daniel F.,9999,0,9999,0
1668373956605,ECE 200,044,103629,Sworder; David D.,9999,0,9999,0
1668373956605,ECE 200,045,103630,Taur; Yuan,9999,0,9999,0
1668373956605,ECE 200,046,103631,Touri; Behrouz,9999,0,9999,0
1668373956605,ECE 200,047,103632,Trivedi; Mohan M.,9999,0,9999,0
1668373956605,ECE 200,048,103633,Vasconcelos; Nuno,9999,0,9999,0
1668373956605,ECE 200,049,103634,Wang; Xiaolong,9999,0,9999,0
1668373956605,ECE 200,050,103635,Xie; Pengtao,9999,0,9999,0
1668373956605,ECE 200,051,103636,Yip; Michael,9999,0,9999,0
1668373956605,ECE 200,052,103637,Zeger; Kenneth A.,999,0,999,0
1668373956605,ECE 200,053,103638,Zhang; Xinyu,9999,0,9999,0
1668373956605,ECE 200,054,103639,Turakhia; Yatish Girish,9999,0,9999,0
1668373956605,ECE 200,055,103640,Kang; Mingu,9999,0,9999,0
1668373956605,ECE 200,056,103641,Shi; Yuanyuan,9999,0,9999,0
1668373956605,ECE 200,057,103642,Wang; Edward Jay,9999,0,9999,0
1668373956605,ECE 200,058,103643,Zheng; Yang,9999,0,9999,0
1668373957030,ECE 202,A00,103644,Kuzum; Duygu,0,0,0,0
1668373957459,ECE 212BN,A00,103646,Ng; Tse Nga,0,0,0,0
1668373957883,ECE 221,A00,111493,Staff,0,0,0,0
1668373958306,ECE 222B,A00,103647,Lomakin; Vitaliy,0,0,0,0
1668373958731,ECE 230B,A00,103648,Taur; Yuan,0,0,0,0
1668373959157,ECE 238B,A00,103649,Garay; Javier,0,0,0,0
1668373959581,ECE 240B,A00,112900,Fainman; Yeshaiahu,0,0,0,0
1668373960003,ECE 247A,A00,103650,Jokerst; Jesse Vincent,0,0,0,0
1668373960427,ECE 247B,A00,103651,Wang; Joseph,0,0,0,0
1668373960862,ECE 250,A00,103652,Siegel; Paul H.,0,0,0,0
1668373961288,ECE 251A,A00,103654,Rao; Bhaskar D.,0,0,0,0
1668373961715,ECE 257B,A00,103655,Bharadia; Dinesh,0,0,0,0
1668373962149,ECE 258A,A00,103656,Milstein; Laurence B.,0,0,0,0
1668373962570,ECE 260B,A00,103658,Kang; Mingu,0,0,0,0
1668373962995,ECE 264A,A00,103659,Galton; Ian A,0,0,0,0
1668373963426,ECE 265A,A00,103661,Gudem; Prasad S.S.,0,0,0,0
1668373963862,ECE 265D,A00,103662,Gudem; Prasad S.S.,0,0,0,0
1668373964290,ECE 268,A00,103663,Koushanfar; Farinaz,0,0,0,0
1668373964716,ECE 269,A01,103665,Pal; Piya,0,0,0,0
1668373965150,ECE 271B,A00,103666,Vasconcelos; Manuela,0,0,0,0
1668373965573,ECE 276A,A00,103667,Atanasov; Nikolay A.,0,0,0,0
1668373965996,ECE 277,A00,103668,An; Cheolhong,0,0,0,0
1668373966419,ECE 279,A00,117947,Hall; Drew A.,0,0,0,0
1668373967268,ECE 283,A00,103670,Hsueh; Tzu-Chien,0,0,0,0
1668373967707,ECE 284,A00,103671,Turakhia; Yatish Girish,0,0,0,0
1668373968134,ECE 285,A00,103672,Zheng; Yang,0,0,0,0
1668373968134,ECE 285,B00,103673,Sworder; David D.,0,0,0,0
1668373968559,ECE 287,A00,103676,Javidi; Tara,0,0,0,0
1668373968984,MATH 200B,A00,098023,Salehi Golsefidy; Alireza,12,0,15,3
1668373969408,MATH 202B,A00,098024,Rhoades; Brendon Patrick,9,0,15,6
1668373969832,MATH 203B,A00,098025,Oprea; Dragos N.,10,0,15,5
1668373970256,MATH 204B,A00,098026,Sorensen; Claus M,13,0,15,2
1668373970679,MATH 208,A00,098027,Izadi; Elham,7,0,10,3
1668373971103,MATH 209,A00,098028,Pollack; Aaron,10,0,10,0
1668373971530,MATH 211A,A00,112919,Rogalski; Daniel,9,0,10,1
1668373971955,MATH 211B,A00,112920,Seward; Brandon M.,9,0,10,1
1668373972461,MATH 218,A00,098029,Li; Bo,10,0,10,0
1668373972883,MATH 220B,A00,098030,Novak; Jonathan I,11,0,15,4
1668373973309,MATH 221A,A00,098031,Ebenfelt; Peter F,13,0,15,2
1668373973743,MATH 231B,A00,098032,Zlatos; Andrej,12,0,15,3
1668373974167,MATH 240B,A00,098033,Ni; Lei,9,0,15,6
1668373974591,MATH 243,A00,098034,Jekel; David Andrew,10,0,10,0
1668373975017,MATH 245A,A00,098035,Nie; Jiawang,0,0,15,16
1668373975443,MATH 248,A00,098036,Bejenaru; Ioan,10,0,10,0
1668373975866,MATH 250B,A00,098037,Spolaor; Luca,14,0,15,1
1668373976288,MATH 258,A00,098038,Ni; Lei,10,0,10,0
1668373976712,MATH 264B,A00,098041,Rhoades; Brendon Patrick,9,0,15,6
1668373977134,MATH 268,A00,098042,Buss; Samuel R,10,0,10,0
1668373977556,MATH 269,A00,098043,Rhoades; Brendon Patrick,10,0,10,0
1668373977982,MATH 270B,A00,098044,Li; Bo,10,0,15,5
1668373978405,MATH 272B,A00,098045,Holst; Michael J,13,0,15,2
1668373978831,MATH 273A,A00,098046,Tian; Xiaochuan,10,0,15,5
1668373979266,MATH 275,A01,098048,Tian; Xiaochuan,6,0,10,4
1668373979688,MATH 278A,A00,098049,Holst; Michael J,8,0,10,2
1668373980117,MATH 278B,A00,098050,Cloninger; Alexander,10,0,10,0
1668373980542,MATH 278C,A00,098051,Nie; Jiawang,7,0,10,3
1668373980965,MATH 280B,A00,098052,Zheng; Tianyi,8,0,15,7
1668373981402,MATH 281B,A00,098053,Bradic; Jelena,1,0,15,14
1668373981826,MATH 282B,A00,098054,Arias-Castro; Ery,0,0,15,15
1668373982253,MATH 285,A00,098055,Fitzsimmons; Patrick J,0,0,15,17
1668373982677,MATH 287B,A00,098056,Arias-Castro; Ery,2,0,15,13
1668373983099,MATH 288,A00,098057,Agarwal; Pooja,9,0,10,1
1668373983099,MATH 288,B00,098058,Zhang; Danna,8,0,10,2
1668373983099,MATH 288,C00,098059,Williams; Ruth J,9,0,10,1
1668373983527,MATH 290B,A00,098060,Roberts; Justin Deritter,13,0,15,2
1668373983951,MATH 292,A00,098061,Belmont; Eva Kinoshita,10,0,10,0
1668373984378,MATH 295,A00,098062,Suk; Andrew Hoon,48,0,50,2
1668373984802,MATH 296,A00,098063,Novak; Jonathan I,20,0,20,0
1668373985226,MATH 297,001,098064,Gamst; Anthony Collins,9997,0,9999,2
1668374488300,COGS 205,A00,101395,Chiba; Andrea,19,0,20,1
1668374488723,COGS 210B,001,101404,Greene; Deanna Jacquelyn,9998,0,9999,1
1668374488723,COGS 210B,002,101417,Xia; Haijun,9999,0,9999,0
1668374488723,COGS 210B,003,101422,Nitz; Douglas A.,9999,0,9999,0
1668374488723,COGS 210B,004,101423,Hollan; James D.,9998,0,9999,1
1668374488723,COGS 210B,005,101424,Deak; Gedeon O.,9998,0,9999,1
1668374488723,COGS 210B,006,101425,Rossano; Federico,9999,0,9999,0
1668374489147,COGS 211B,A00,101427,Coulson; Seana M,9996,0,9999,3
1668374489572,COGS 220,A00,101428,Hollan; James D.,0,0,25,25
1668374489994,COGS 229,A00,101429,Dow; Steven P,18,0,25,7
1668374490417,COGS 230,A00,101430,Klemmer; Scott R,11,0,17,6
1668374490841,COGS 234,A00,101431,Xia; Haijun,1,0,25,24
1668374491269,COGS 260,A00,101432,Kiyonaga; Anastasia,21,0,25,4
1668374491269,COGS 260,B00,101433,Kirsh; David Joel,15,0,25,10
1668374491713,CSE 202,A00,102371,Impagliazzo; Russell,0,0,0,0
1668374492137,CSE 203B,A01,102373,Cheng; Chung Kuan,0,0,0,0
1668374492568,CSE 208,A00,102374,Micciancio; Daniele,0,0,0,0
1668374492992,CSE 209A,A00,112895,Impagliazzo; Russell,0,0,15,15
1668374493415,CSE 209B,A00,108005,Bellare; Mihir,0,0,0,0
1668374493842,CSE 210,A00,113163,Coblenz; Michael J,0,0,0,0
1668374494280,CSE 219,A00,106111,Dow; Steven P,0,0,20,20
1668374494706,CSE 221,A00,102376,Voelker; Geoffrey M.,0,0,0,0
1668374495132,CSE 224,A01,102378,Porter; George M,0,0,0,0
1668374497550,CSE 229A,A00,102379,Savage; Stefan,0,0,0,0
1668374497972,CSE 229C,A00,102380,Munyaka; Imani N. S.,0,0,0,0
1668374498405,CSE 232B,A00,102382,Deutsch; Alin Bernard,0,0,0,0
1668374498827,CSE 234,A01,112904,Kumar; Arun Kumar,0,0,0,0
1668374499251,CSE 237A,A00,102383,Rosing; Tajana Simunic,0,0,0,0
1668374499684,CSE 239A,A00,102384,Deutsch; Alin Bernard,0,0,0,0
1668374500109,CSE 239B,A00,102385,Polikarpova; Nadezhda,0,0,0,0
1668374500535,CSE 240A,A00,102386,Pannuto; Patrick William,0,0,0,0
1668374500971,CSE 240B,A00,102387,Zhao; Jishen,0,0,0,0
1668374501397,CSE 241A,A00,106406,Kang; Mingu,0,0,0,0
1668374501821,CSE 249B,A00,102388,Kahng; Andrew Byun,0,0,8,8
1668374502244,CSE 251B,A01,102392,Cottrell; Garrison W,0,0,0,0
1668374502244,CSE 251B,A02,102393,Cottrell; Garrison W,0,0,0,0
1668374502668,CSE 252B,A00,102394,Ochoa; Benjamin Lawrence,0,0,0,0
1668374503093,CSE 257,A01,102396,Gao; Sicun,0,0,0,0
1668374503517,CSE 272,A00,102397,Li; Tzumao,0,0,0,0
1668374503943,CSE 274,A00,111323,Chern; Albert Ren-Haur,0,0,0,0
1668374504378,CSE 282,A00,102398,Pevzner; Pavel Arkadjevich,0,0,0,0
1668374504801,CSE 284,A00,114175,Gymrek; Melissa Ann,0,0,0,0
1668374505227,CSE 290,A00,102399,Chandraker; Manmohan Krishna,0,0,0,0
1668374505227,CSE 290,B00,102400,Vaccaro; Kristen Marie,0,0,25,25
1668374505227,CSE 290,C00,102414,Pannuto; Patrick William,0,0,25,25
1668374505227,CSE 290,D00,102427,Pevzner; Pavel Arkadjevich,0,0,0,0
1668374505227,CSE 290,E00,102429,Zhao; Jishen,0,0,0,0
1668374505227,CSE 290,F00,102436,Tullsen; Dean Michael,0,0,0,0
1668374505227,CSE 290,G00,102440,Christensen; Henrik I,0,0,20,20
1668374505655,CSE 291,A00,102443,Su; Hao,0,0,0,0
1668374505655,CSE 291,B00,102448,Polikarpova; Nadezhda,0,0,0,0
1668374505655,CSE 291,C00,102453,Vaccaro; Kristen Marie,0,0,0,0
1668374505655,CSE 291,D00,111343,Savage; Stefan,0,0,0,0
1668374505655,CSE 291,E00,116474,Claffy; Kimberly Claire,0,0,0,0
1668374505655,CSE 291,F00,116479,Pasquale; Joseph,0,0,0,0
1668374506088,CSE 293,001,119111,Bafna; Vineet,9999,0,9999,0
1668374506088,CSE 293,002,119118,Bellare; Mihir,9999,0,9999,0
1668374506088,CSE 293,003,119122,Berg-Kirkpatrick; Taylor D,9999,0,9999,0
1668374506088,CSE 293,004,119135,Christensen; Henrik I,9999,0,9999,0
1668374506088,CSE 293,005,119142,Cottrell; Garrison W,9999,0,9999,0
1668374506088,CSE 293,006,119146,Deutsch; Alin Bernard,9999,0,9999,0
1668374506088,CSE 293,007,119159,Esmaeilzadeh; Hadi,9999,0,9999,0
1668374506088,CSE 293,008,119166,Freund; Yoav,9999,0,9999,0
1668374506088,CSE 293,009,119170,Griswold; William G.,9999,0,9999,0
1668374506088,CSE 293,010,119183,Gymrek; Melissa Ann,9999,0,9999,0
1668374506088,CSE 293,011,119190,Heninger; Nadia A,9999,0,9999,0
1668374506088,CSE 293,012,119230,Impagliazzo; Russell,9999,0,9999,0
1668374506088,CSE 293,013,119232,Jhala; Ranjit,9999,0,9999,0
1668374506088,CSE 293,014,119233,Kahng; Andrew Byun,9999,0,9999,0
1668374506088,CSE 293,015,119298,Kane; Daniel Mertz,9999,0,9999,0
1668374506088,CSE 293,016,119299,Kriegman; David J,9999,0,9999,0
1668374506088,CSE 293,017,119300,Kumar; Arun Kumar,9999,0,9999,0
1668374506088,CSE 293,018,119301,Lerner; Sorin,9999,0,9999,0
1668374506088,CSE 293,019,119302,Lovett; Shachar,9999,0,9999,0
1668374506088,CSE 293,020,119303,McAuley; Julian John,9999,0,9999,0
1668374506088,CSE 293,021,119304,Micciancio; Daniele,9999,0,9999,0
1668374506088,CSE 293,022,119367,Orailoglu; Alex,9999,0,9999,0
1668374506088,CSE 293,023,119382,Paturi; Ramamohan,9999,0,9999,0
1668374506088,CSE 293,024,119404,Polikarpova; Nadezhda,9999,0,9999,0
1668374506088,CSE 293,025,119406,Politz; Joseph Gibbs,9999,0,9999,0
1668374506088,CSE 293,026,119411,Porter; George M,9999,0,9999,0
1668374506088,CSE 293,027,119414,Porter; Leonard Emerson,9999,0,9999,0
1668374506088,CSE 293,028,119416,Ramamoorthi; Ravi,9999,0,9999,0
1668374506088,CSE 293,029,119417,Sahoo; Debashis,9999,0,9999,0
1668374506088,CSE 293,030,119420,Saul; Lawrence,9999,0,9999,0
1668374506088,CSE 293,031,119421,Savage; Stefan,9999,0,9999,0
1668374506088,CSE 293,032,119425,Schulze; Jurgen P.,9999,0,9999,0
1668374506088,CSE 293,033,119426,Snoeren; Alex C.,9999,0,9999,0
1668374506088,CSE 293,034,119428,Shang; Jingbo,9999,0,9999,0
1668374506088,CSE 293,035,119430,Stefan; Deian,9999,0,9999,0
1668374506088,CSE 293,036,119431,Su; Hao,9999,0,9999,0
1668374506088,CSE 293,037,119433,Swanson; Steven James,9999,0,9999,0
1668374506088,CSE 293,038,119435,Tullsen; Dean Michael,9999,0,9999,0
1668374506088,CSE 293,039,119483,Voelker; Geoffrey M.,9999,0,9999,0
1668374506088,CSE 293,040,119537,Zhao; Jishen,9999,0,9999,0
1668374506088,CSE 293,041,119538,Zhou; Yuan-Yuan,9999,0,9999,0
1668374506088,CSE 293,042,119539,Gao; Sicun,9999,0,9999,0
1668374506088,CSE 293,043,119540,Weibel; Nadir,9999,0,9999,0
1668374506088,CSE 293,044,119541,Gupta; Rajesh K.,9999,0,9999,0
1668374506088,CSE 293,045,126410,Vaccaro; Kristen Marie,9999,0,9999,0
1668374506088,CSE 293,046,126411,Klemke; Richard,9999,0,9999,0
1668374506511,CSE 294,A00,102459,Voelker; Geoffrey M.,0,0,0,0
1668374506511,CSE 294,B00,111322,Orailoglu; Alex,0,0,0,0
1668374506935,DSE 201,A00,096914,Deutsch; Alin Bernard,30,0,30,0
1668374507370,DSE 210,A00,096915,Dasgupta; Sanjoy,30,0,30,0
1668374507794,DSE 260A,A00,096916,Altintas De Callaf; Ilkay,30,0,30,0
1668374508262,ECE 200,001,103586,Antipa; Nicholas A,9999,0,9999,0
1668374508262,ECE 200,002,103587,Atanasov; Nikolay A.,9999,0,9999,0
1668374508262,ECE 200,003,103588,Bharadia; Dinesh,9999,0,9999,0
1668374508262,ECE 200,004,103589,Cheng; Chung Kuan,9999,0,9999,0
1668374508262,ECE 200,005,103590,Cosman; Pamela C.,9999,0,9999,0
1668374508262,ECE 200,006,103591,Dayeh; Shadi Ahmad,9999,0,9999,0
1668374508262,ECE 200,007,103592,Fainman; Yeshaiahu,9999,0,9999,0
1668374508262,ECE 200,008,103593,Ford; Joseph Earl,9999,0,9999,0
1668374508262,ECE 200,009,103594,Franceschetti; Massimo,9999,0,9999,0
1668374508262,ECE 200,010,103595,Fullerton; Eric E,9999,0,9999,0
1668374508262,ECE 200,011,103596,Galton; Ian A,9999,0,9999,0
1668374508262,ECE 200,012,103597,Gilja; Vikash,9999,0,9999,0
1668374508262,ECE 200,013,103598,Hall; Drew A.,9999,0,9999,0
1668374508262,ECE 200,014,103599,Hsueh; Tzu-Chien,9999,0,9999,0
1668374508262,ECE 200,015,103600,Javidi; Tara,9999,0,9999,0
1668374508262,ECE 200,016,103601,Kahng; Andrew Byun,9999,0,9999,0
1668374508262,ECE 200,017,103602,Kim; Young-Han,9999,0,9999,0
1668374508262,ECE 200,018,103603,Koushanfar; Farinaz,9999,0,9999,0
1668374508262,ECE 200,019,103604,Kuzum; Duygu,9999,0,9999,0
1668374508262,ECE 200,020,103605,Le; Hanh-Phuc,9999,0,9999,0
1668374508262,ECE 200,021,103606,Lin; Bill,9999,0,9999,0
1668374508262,ECE 200,022,103607,Liu; Zhaowei,9998,0,9999,1
1668374508262,ECE 200,023,103608,Lo; Yu-Hwa,9999,0,9999,0
1668374508262,ECE 200,024,103609,Lomakin; Vitaliy,9999,0,9999,0
1668374508262,ECE 200,025,103610,Mercier; Patrick Philip,9999,0,9999,0
1668374508262,ECE 200,026,103611,Meyer; Florian,9999,0,9999,0
1668374508262,ECE 200,027,103612,Milstein; Laurence B.,9999,0,9999,0
1668374508262,ECE 200,028,103613,Mir Arabbaygi; Siavash,9999,0,9999,0
1668374508262,ECE 200,029,103614,Mookherjea; Shayan,9999,0,9999,0
1668374508262,ECE 200,030,103615,Morris; Karcher William,9999,0,9999,0
1668374508262,ECE 200,031,103616,Ng; Tse Nga,9999,0,9999,0
1668374508262,ECE 200,032,103617,Nguyen; Truong Quang,9999,0,9999,0
1668374508262,ECE 200,033,103618,Nomura; Kenji,9999,0,9999,0
1668374508262,ECE 200,034,103619,Orlitsky; Alon,9999,0,9999,0
1668374508262,ECE 200,035,103620,Pal; Piya,9999,0,9999,0
1668374508262,ECE 200,036,103621,Papen; George C.,9999,0,9999,0
1668374508262,ECE 200,037,103622,Radic; Stojan,9999,0,9999,0
1668374508262,ECE 200,038,103623,Rao; Bhaskar D.,9999,0,9999,0
1668374508262,ECE 200,039,103624,Rao; Ramesh R,9999,0,9999,0
1668374508262,ECE 200,040,103625,Rebeiz; Gabriel,9999,0,9999,0
1668374508262,ECE 200,041,103626,Sanford; John R,9999,0,9999,0
1668374508262,ECE 200,042,103627,Siegel; Paul H.,9999,0,9999,0
1668374508262,ECE 200,043,103628,Sievenpiper; Daniel F.,9999,0,9999,0
1668374508262,ECE 200,044,103629,Sworder; David D.,9999,0,9999,0
1668374508262,ECE 200,045,103630,Taur; Yuan,9999,0,9999,0
1668374508262,ECE 200,046,103631,Touri; Behrouz,9999,0,9999,0
1668374508262,ECE 200,047,103632,Trivedi; Mohan M.,9999,0,9999,0
1668374508262,ECE 200,048,103633,Vasconcelos; Nuno,9999,0,9999,0
1668374508262,ECE 200,049,103634,Wang; Xiaolong,9999,0,9999,0
1668374508262,ECE 200,050,103635,Xie; Pengtao,9999,0,9999,0
1668374508262,ECE 200,051,103636,Yip; Michael,9999,0,9999,0
1668374508262,ECE 200,052,103637,Zeger; Kenneth A.,999,0,999,0
1668374508262,ECE 200,053,103638,Zhang; Xinyu,9999,0,9999,0
1668374508262,ECE 200,054,103639,Turakhia; Yatish Girish,9999,0,9999,0
1668374508262,ECE 200,055,103640,Kang; Mingu,9999,0,9999,0
1668374508262,ECE 200,056,103641,Shi; Yuanyuan,9999,0,9999,0
1668374508262,ECE 200,057,103642,Wang; Edward Jay,9999,0,9999,0
1668374508262,ECE 200,058,103643,Zheng; Yang,9999,0,9999,0
1668374508693,ECE 202,A00,103644,Kuzum; Duygu,0,0,0,0
1668374509119,ECE 212BN,A00,103646,Ng; Tse Nga,0,0,0,0
1668374509556,ECE 221,A00,111493,Staff,0,0,0,0
1668374509979,ECE 222B,A00,103647,Lomakin; Vitaliy,0,0,0,0
1668374510403,ECE 230B,A00,103648,Taur; Yuan,0,0,0,0
1668374510829,ECE 238B,A00,103649,Garay; Javier,0,0,0,0
1668374511251,ECE 240B,A00,112900,Fainman; Yeshaiahu,0,0,0,0
1668374511674,ECE 247A,A00,103650,Jokerst; Jesse Vincent,0,0,0,0
1668374512098,ECE 247B,A00,103651,Wang; Joseph,0,0,0,0
1668374512540,ECE 250,A00,103652,Siegel; Paul H.,0,0,0,0
1668374512963,ECE 251A,A00,103654,Rao; Bhaskar D.,0,0,0,0
1668374513389,ECE 257B,A00,103655,Bharadia; Dinesh,0,0,0,0
1668374513811,ECE 258A,A00,103656,Milstein; Laurence B.,0,0,0,0
1668374514233,ECE 260B,A00,103658,Kang; Mingu,0,0,0,0
1668374514660,ECE 264A,A00,103659,Galton; Ian A,0,0,0,0
1668374515086,ECE 265A,A00,103661,Gudem; Prasad S.S.,0,0,0,0
1668374515510,ECE 265D,A00,103662,Gudem; Prasad S.S.,0,0,0,0
1668374515933,ECE 268,A00,103663,Koushanfar; Farinaz,0,0,0,0
1668374516360,ECE 269,A01,103665,Pal; Piya,0,0,0,0
1668374516784,ECE 271B,A00,103666,Vasconcelos; Manuela,0,0,0,0
1668374517211,ECE 276A,A00,103667,Atanasov; Nikolay A.,0,0,0,0
1668374517641,ECE 277,A00,103668,An; Cheolhong,0,0,0,0
1668374518064,ECE 279,A00,117947,Hall; Drew A.,0,0,0,0
1668374518918,ECE 283,A00,103670,Hsueh; Tzu-Chien,0,0,0,0
1668374519341,ECE 284,A00,103671,Turakhia; Yatish Girish,0,0,0,0
1668374519766,ECE 285,A00,103672,Zheng; Yang,0,0,0,0
1668374519766,ECE 285,B00,103673,Sworder; David D.,0,0,0,0
1668374520202,ECE 287,A00,103676,Javidi; Tara,0,0,0,0
1668374520626,MATH 200B,A00,098023,Salehi Golsefidy; Alireza,12,0,15,3
1668374521057,MATH 202B,A00,098024,Rhoades; Brendon Patrick,9,0,15,6
1668374521491,MATH 203B,A00,098025,Oprea; Dragos N.,10,0,15,5
1668374521914,MATH 204B,A00,098026,Sorensen; Claus M,13,0,15,2
1668374522337,MATH 208,A00,098027,Izadi; Elham,7,0,10,3
1668374522761,MATH 209,A00,098028,Pollack; Aaron,10,0,10,0
1668374523186,MATH 211A,A00,112919,Rogalski; Daniel,9,0,10,1
1668374523611,MATH 211B,A00,112920,Seward; Brandon M.,9,0,10,1
1668374524036,MATH 218,A00,098029,Li; Bo,10,0,10,0
1668374524474,MATH 220B,A00,098030,Novak; Jonathan I,11,0,15,4
1668374524900,MATH 221A,A00,098031,Ebenfelt; Peter F,13,0,15,2
1668374525326,MATH 231B,A00,098032,Zlatos; Andrej,12,0,15,3
1668374525752,MATH 240B,A00,098033,Ni; Lei,9,0,15,6
1668374526177,MATH 243,A00,098034,Jekel; David Andrew,10,0,10,0
1668374526602,MATH 245A,A00,098035,Nie; Jiawang,0,0,15,16
1668374527034,MATH 248,A00,098036,Bejenaru; Ioan,10,0,10,0
1668374527460,MATH 250B,A00,098037,Spolaor; Luca,14,0,15,1
1668374527882,MATH 258,A00,098038,Ni; Lei,10,0,10,0
1668374528313,MATH 264B,A00,098041,Rhoades; Brendon Patrick,9,0,15,6
1668374528740,MATH 268,A00,098042,Buss; Samuel R,10,0,10,0
1668374529171,MATH 269,A00,098043,Rhoades; Brendon Patrick,10,0,10,0
1668374529594,MATH 270B,A00,098044,Li; Bo,10,0,15,5
1668374530017,MATH 272B,A00,098045,Holst; Michael J,13,0,15,2
1668374530439,MATH 273A,A00,098046,Tian; Xiaochuan,10,0,15,5
1668374530866,MATH 275,A01,098048,Tian; Xiaochuan,6,0,10,4
1668374531291,MATH 278A,A00,098049,Holst; Michael J,8,0,10,2
1668374531714,MATH 278B,A00,098050,Cloninger; Alexander,10,0,10,0
1668374532137,MATH 278C,A00,098051,Nie; Jiawang,7,0,10,3
1668374532561,MATH 280B,A00,098052,Zheng; Tianyi,8,0,15,7
1668374532991,MATH 281B,A00,098053,Bradic; Jelena,1,0,15,14
1668374533414,MATH 282B,A00,098054,Arias-Castro; Ery,0,0,15,15
1668374533844,MATH 285,A00,098055,Fitzsimmons; Patrick J,0,0,15,17
1668374534268,MATH 287B,A00,098056,Arias-Castro; Ery,2,0,15,13
1668374534694,MATH 288,A00,098057,Agarwal; Pooja,9,0,10,1
1668374534694,MATH 288,B00,098058,Zhang; Danna,8,0,10,2
1668374534694,MATH 288,C00,098059,Williams; Ruth J,9,0,10,1
1668374535126,MATH 290B,A00,098060,Roberts; Justin Deritter,13,0,15,2
1668374535549,MATH 292,A00,098061,Belmont; Eva Kinoshita,10,0,10,0
1668374535972,MATH 295,A00,098062,Suk; Andrew Hoon,48,0,50,2
1668374536401,MATH 296,A00,098063,Novak; Jonathan I,20,0,20,0
1668374536825,MATH 297,001,098064,Gamst; Anthony Collins,9997,0,9999,2
1668375041546,COGS 205,A00,101395,Chiba; Andrea,19,0,20,1
1668375041981,COGS 210B,001,101404,Greene; Deanna Jacquelyn,9998,0,9999,1
1668375041981,COGS 210B,002,101417,Xia; Haijun,9999,0,9999,0
1668375041981,COGS 210B,003,101422,Nitz; Douglas A.,9999,0,9999,0
1668375041981,COGS 210B,004,101423,Hollan; James D.,9998,0,9999,1
1668375041981,COGS 210B,005,101424,Deak; Gedeon O.,9998,0,9999,1
1668375041981,COGS 210B,006,101425,Rossano; Federico,9999,0,9999,0
1668375042420,COGS 211B,A00,101427,Coulson; Seana M,9996,0,9999,3
1668375042846,COGS 220,A00,101428,Hollan; James D.,0,0,25,25
1668375043285,COGS 229,A00,101429,Dow; Steven P,18,0,25,7
1668375043710,COGS 230,A00,101430,Klemmer; Scott R,11,0,17,6
1668375044150,COGS 234,A00,101431,Xia; Haijun,1,0,25,24
1668375044575,COGS 260,A00,101432,Kiyonaga; Anastasia,21,0,25,4
1668375044575,COGS 260,B00,101433,Kirsh; David Joel,15,0,25,10
1668375044999,CSE 202,A00,102371,Impagliazzo; Russell,0,0,0,0
1668375045442,CSE 203B,A01,102373,Cheng; Chung Kuan,0,0,0,0
1668375045868,CSE 208,A00,102374,Micciancio; Daniele,0,0,0,0
1668375046292,CSE 209A,A00,112895,Impagliazzo; Russell,0,0,15,15
1668375046716,CSE 209B,A00,108005,Bellare; Mihir,0,0,0,0
1668375047140,CSE 210,A00,113163,Coblenz; Michael J,0,0,0,0
1668375047565,CSE 219,A00,106111,Dow; Steven P,0,0,20,20
1668375047990,CSE 221,A00,102376,Voelker; Geoffrey M.,0,0,0,0
1668375048418,CSE 224,A01,102378,Porter; George M,0,0,0,0
1668375048843,CSE 229A,A00,102379,Savage; Stefan,0,0,0,0
1668375049266,CSE 229C,A00,102380,Munyaka; Imani N. S.,0,0,0,0
1668375049690,CSE 232B,A00,102382,Deutsch; Alin Bernard,0,0,0,0
1668375050115,CSE 234,A01,112904,Kumar; Arun Kumar,0,0,0,0
1668375050539,CSE 237A,A00,102383,Rosing; Tajana Simunic,0,0,0,0
1668375050963,CSE 239A,A00,102384,Deutsch; Alin Bernard,0,0,0,0
1668375051401,CSE 239B,A00,102385,Polikarpova; Nadezhda,0,0,0,0
1668375051839,CSE 240A,A00,102386,Pannuto; Patrick William,0,0,0,0
1668375052266,CSE 240B,A00,102387,Zhao; Jishen,0,0,0,0
1668375052695,CSE 241A,A00,106406,Kang; Mingu,0,0,0,0
1668375053119,CSE 249B,A00,102388,Kahng; Andrew Byun,0,0,8,8
1668375053543,CSE 251B,A01,102392,Cottrell; Garrison W,0,0,0,0
1668375053543,CSE 251B,A02,102393,Cottrell; Garrison W,0,0,0,0
1668375053969,CSE 252B,A00,102394,Ochoa; Benjamin Lawrence,0,0,0,0
1668375054394,CSE 257,A01,102396,Gao; Sicun,0,0,0,0
1668375054818,CSE 272,A00,102397,Li; Tzumao,0,0,0,0
1668375055242,CSE 274,A00,111323,Chern; Albert Ren-Haur,0,0,0,0
1668375055670,CSE 282,A00,102398,Pevzner; Pavel Arkadjevich,0,0,0,0
1668375056101,CSE 284,A00,114175,Gymrek; Melissa Ann,0,0,0,0
1668375056534,CSE 290,A00,102399,Chandraker; Manmohan Krishna,0,0,0,0
1668375056534,CSE 290,B00,102400,Vaccaro; Kristen Marie,0,0,25,25
1668375056534,CSE 290,C00,102414,Pannuto; Patrick William,0,0,25,25
1668375056534,CSE 290,D00,102427,Pevzner; Pavel Arkadjevich,0,0,0,0
1668375056534,CSE 290,E00,102429,Zhao; Jishen,0,0,0,0
1668375056534,CSE 290,F00,102436,Tullsen; Dean Michael,0,0,0,0
1668375056534,CSE 290,G00,102440,Christensen; Henrik I,0,0,20,20
1668375056973,CSE 291,A00,102443,Su; Hao,0,0,0,0
1668375056973,CSE 291,B00,102448,Polikarpova; Nadezhda,0,0,0,0
1668375056973,CSE 291,C00,102453,Vaccaro; Kristen Marie,0,0,0,0
1668375056973,CSE 291,D00,111343,Savage; Stefan,0,0,0,0
1668375056973,CSE 291,E00,116474,Claffy; Kimberly Claire,0,0,0,0
1668375056973,CSE 291,F00,116479,Pasquale; Joseph,0,0,0,0
1668375057406,CSE 293,001,119111,Bafna; Vineet,9999,0,9999,0
1668375057406,CSE 293,002,119118,Bellare; Mihir,9999,0,9999,0
1668375057406,CSE 293,003,119122,Berg-Kirkpatrick; Taylor D,9999,0,9999,0
1668375057406,CSE 293,004,119135,Christensen; Henrik I,9999,0,9999,0
1668375057406,CSE 293,005,119142,Cottrell; Garrison W,9999,0,9999,0
1668375057406,CSE 293,006,119146,Deutsch; Alin Bernard,9999,0,9999,0
1668375057406,CSE 293,007,119159,Esmaeilzadeh; Hadi,9999,0,9999,0
1668375057406,CSE 293,008,119166,Freund; Yoav,9999,0,9999,0
1668375057406,CSE 293,009,119170,Griswold; William G.,9999,0,9999,0
1668375057406,CSE 293,010,119183,Gymrek; Melissa Ann,9999,0,9999,0
1668375057406,CSE 293,011,119190,Heninger; Nadia A,9999,0,9999,0
1668375057406,CSE 293,012,119230,Impagliazzo; Russell,9999,0,9999,0
1668375057406,CSE 293,013,119232,Jhala; Ranjit,9999,0,9999,0
1668375057406,CSE 293,014,119233,Kahng; Andrew Byun,9999,0,9999,0
1668375057406,CSE 293,015,119298,Kane; Daniel Mertz,9999,0,9999,0
1668375057406,CSE 293,016,119299,Kriegman; David J,9999,0,9999,0
1668375057406,CSE 293,017,119300,Kumar; Arun Kumar,9999,0,9999,0
1668375057406,CSE 293,018,119301,Lerner; Sorin,9999,0,9999,0
1668375057406,CSE 293,019,119302,Lovett; Shachar,9999,0,9999,0
1668375057406,CSE 293,020,119303,McAuley; Julian John,9999,0,9999,0
1668375057406,CSE 293,021,119304,Micciancio; Daniele,9999,0,9999,0
1668375057406,CSE 293,022,119367,Orailoglu; Alex,9999,0,9999,0
1668375057406,CSE 293,023,119382,Paturi; Ramamohan,9999,0,9999,0
1668375057406,CSE 293,024,119404,Polikarpova; Nadezhda,9999,0,9999,0
1668375057406,CSE 293,025,119406,Politz; Joseph Gibbs,9999,0,9999,0
1668375057406,CSE 293,026,119411,Porter; George M,9999,0,9999,0
1668375057406,CSE 293,027,119414,Porter; Leonard Emerson,9999,0,9999,0
1668375057406,CSE 293,028,119416,Ramamoorthi; Ravi,9999,0,9999,0
1668375057406,CSE 293,029,119417,Sahoo; Debashis,9999,0,9999,0
1668375057406,CSE 293,030,119420,Saul; Lawrence,9999,0,9999,0
1668375057406,CSE 293,031,119421,Savage; Stefan,9999,0,9999,0
1668375057406,CSE 293,032,119425,Schulze; Jurgen P.,9999,0,9999,0
1668375057406,CSE 293,033,119426,Snoeren; Alex C.,9999,0,9999,0
1668375057406,CSE 293,034,119428,Shang; Jingbo,9999,0,9999,0
1668375057406,CSE 293,035,119430,Stefan; Deian,9999,0,9999,0
1668375057406,CSE 293,036,119431,Su; Hao,9999,0,9999,0
1668375057406,CSE 293,037,119433,Swanson; Steven James,9999,0,9999,0
1668375057406,CSE 293,038,119435,Tullsen; Dean Michael,9999,0,9999,0
1668375057406,CSE 293,039,119483,Voelker; Geoffrey M.,9999,0,9999,0
1668375057406,CSE 293,040,119537,Zhao; Jishen,9999,0,9999,0
1668375057406,CSE 293,041,119538,Zhou; Yuan-Yuan,9999,0,9999,0
1668375057406,CSE 293,042,119539,Gao; Sicun,9999,0,9999,0
1668375057406,CSE 293,043,119540,Weibel; Nadir,9999,0,9999,0
1668375057406,CSE 293,044,119541,Gupta; Rajesh K.,9999,0,9999,0
1668375057406,CSE 293,045,126410,Vaccaro; Kristen Marie,9999,0,9999,0
1668375057406,CSE 293,046,126411,Klemke; Richard,9999,0,9999,0
1668375057843,CSE 294,A00,102459,Voelker; Geoffrey M.,0,0,0,0
1668375057843,CSE 294,B00,111322,Orailoglu; Alex,0,0,0,0
1668375058276,DSE 201,A00,096914,Deutsch; Alin Bernard,30,0,30,0
1668375058708,DSE 210,A00,096915,Dasgupta; Sanjoy,30,0,30,0
1668375059131,DSE 260A,A00,096916,Altintas De Callaf; Ilkay,30,0,30,0
1668375059592,ECE 200,001,103586,Antipa; Nicholas A,9999,0,9999,0
1668375059592,ECE 200,002,103587,Atanasov; Nikolay A.,9999,0,9999,0
1668375059592,ECE 200,003,103588,Bharadia; Dinesh,9999,0,9999,0
1668375059592,ECE 200,004,103589,Cheng; Chung Kuan,9999,0,9999,0
1668375059592,ECE 200,005,103590,Cosman; Pamela C.,9999,0,9999,0
1668375059592,ECE 200,006,103591,Dayeh; Shadi Ahmad,9999,0,9999,0
1668375059592,ECE 200,007,103592,Fainman; Yeshaiahu,9999,0,9999,0
1668375059592,ECE 200,008,103593,Ford; Joseph Earl,9999,0,9999,0
1668375059592,ECE 200,009,103594,Franceschetti; Massimo,9999,0,9999,0
1668375059592,ECE 200,010,103595,Fullerton; Eric E,9999,0,9999,0
1668375059592,ECE 200,011,103596,Galton; Ian A,9999,0,9999,0
1668375059592,ECE 200,012,103597,Gilja; Vikash,9999,0,9999,0
1668375059592,ECE 200,013,103598,Hall; Drew A.,9999,0,9999,0
1668375059592,ECE 200,014,103599,Hsueh; Tzu-Chien,9999,0,9999,0
1668375059592,ECE 200,015,103600,Javidi; Tara,9999,0,9999,0
1668375059592,ECE 200,016,103601,Kahng; Andrew Byun,9999,0,9999,0
1668375059592,ECE 200,017,103602,Kim; Young-Han,9999,0,9999,0
1668375059592,ECE 200,018,103603,Koushanfar; Farinaz,9999,0,9999,0
1668375059592,ECE 200,019,103604,Kuzum; Duygu,9999,0,9999,0
1668375059592,ECE 200,020,103605,Le; Hanh-Phuc,9999,0,9999,0
1668375059592,ECE 200,021,103606,Lin; Bill,9999,0,9999,0
1668375059592,ECE 200,022,103607,Liu; Zhaowei,9998,0,9999,1
1668375059592,ECE 200,023,103608,Lo; Yu-Hwa,9999,0,9999,0
1668375059592,ECE 200,024,103609,Lomakin; Vitaliy,9999,0,9999,0
1668375059592,ECE 200,025,103610,Mercier; Patrick Philip,9999,0,9999,0
1668375059592,ECE 200,026,103611,Meyer; Florian,9999,0,9999,0
1668375059592,ECE 200,027,103612,Milstein; Laurence B.,9999,0,9999,0
1668375059592,ECE 200,028,103613,Mir Arabbaygi; Siavash,9999,0,9999,0
1668375059592,ECE 200,029,103614,Mookherjea; Shayan,9999,0,9999,0
1668375059592,ECE 200,030,103615,Morris; Karcher William,9999,0,9999,0
1668375059592,ECE 200,031,103616,Ng; Tse Nga,9999,0,9999,0
1668375059592,ECE 200,032,103617,Nguyen; Truong Quang,9999,0,9999,0
1668375059592,ECE 200,033,103618,Nomura; Kenji,9999,0,9999,0
1668375059592,ECE 200,034,103619,Orlitsky; Alon,9999,0,9999,0
1668375059592,ECE 200,035,103620,Pal; Piya,9999,0,9999,0
1668375059592,ECE 200,036,103621,Papen; George C.,9999,0,9999,0
1668375059592,ECE 200,037,103622,Radic; Stojan,9999,0,9999,0
1668375059592,ECE 200,038,103623,Rao; Bhaskar D.,9999,0,9999,0
1668375059592,ECE 200,039,103624,Rao; Ramesh R,9999,0,9999,0
1668375059592,ECE 200,040,103625,Rebeiz; Gabriel,9999,0,9999,0
1668375059592,ECE 200,041,103626,Sanford; John R,9999,0,9999,0
1668375059592,ECE 200,042,103627,Siegel; Paul H.,9999,0,9999,0
1668375059592,ECE 200,043,103628,Sievenpiper; Daniel F.,9999,0,9999,0
1668375059592,ECE 200,044,103629,Sworder; David D.,9999,0,9999,0
1668375059592,ECE 200,045,103630,Taur; Yuan,9999,0,9999,0
1668375059592,ECE 200,046,103631,Touri; Behrouz,9999,0,9999,0
1668375059592,ECE 200,047,103632,Trivedi; Mohan M.,9999,0,9999,0
1668375059592,ECE 200,048,103633,Vasconcelos; Nuno,9999,0,9999,0
1668375059592,ECE 200,049,103634,Wang; Xiaolong,9999,0,9999,0
1668375059592,ECE 200,050,103635,Xie; Pengtao,9999,0,9999,0
1668375059592,ECE 200,051,103636,Yip; Michael,9999,0,9999,0
1668375059592,ECE 200,052,103637,Zeger; Kenneth A.,999,0,999,0
1668375059592,ECE 200,053,103638,Zhang; Xinyu,9999,0,9999,0
1668375059592,ECE 200,054,103639,Turakhia; Yatish Girish,9999,0,9999,0
1668375059592,ECE 200,055,103640,Kang; Mingu,9999,0,9999,0
1668375059592,ECE 200,056,103641,Shi; Yuanyuan,9999,0,9999,0
1668375059592,ECE 200,057,103642,Wang; Edward Jay,9999,0,9999,0
1668375059592,ECE 200,058,103643,Zheng; Yang,9999,0,9999,0
1668375060017,ECE 202,A00,103644,Kuzum; Duygu,0,0,0,0
1668375060453,ECE 212BN,A00,103646,Ng; Tse Nga,0,0,0,0
1668375060881,ECE 221,A00,111493,Staff,0,0,0,0
1668375061303,ECE 222B,A00,103647,Lomakin; Vitaliy,0,0,0,0
1668375061732,ECE 230B,A00,103648,Taur; Yuan,0,0,0,0
1668375062155,ECE 238B,A00,103649,Garay; Javier,0,0,0,0
1668375062580,ECE 240B,A00,112900,Fainman; Yeshaiahu,0,0,0,0
1668375063007,ECE 247A,A00,103650,Jokerst; Jesse Vincent,0,0,0,0
1668375063430,ECE 247B,A00,103651,Wang; Joseph,0,0,0,0
1668375063853,ECE 250,A00,103652,Siegel; Paul H.,0,0,0,0
1668375064281,ECE 251A,A00,103654,Rao; Bhaskar D.,0,0,0,0
1668375064706,ECE 257B,A00,103655,Bharadia; Dinesh,0,0,0,0
1668375065131,ECE 258A,A00,103656,Milstein; Laurence B.,0,0,0,0
1668375066175,ECE 260B,A00,103658,Kang; Mingu,0,0,0,0
1668375066602,ECE 264A,A00,103659,Galton; Ian A,0,0,0,0
1668375067025,ECE 265A,A00,103661,Gudem; Prasad S.S.,0,0,0,0
1668375067449,ECE 265D,A00,103662,Gudem; Prasad S.S.,0,0,0,0
1668375067877,ECE 268,A00,103663,Koushanfar; Farinaz,0,0,0,0
1668375068305,ECE 269,A01,103665,Pal; Piya,0,0,0,0
1668375068731,ECE 271B,A00,103666,Vasconcelos; Manuela,0,0,0,0
1668375069154,ECE 276A,A00,103667,Atanasov; Nikolay A.,0,0,0,0
1668375069581,ECE 277,A00,103668,An; Cheolhong,0,0,0,0
1668375070005,ECE 279,A00,117947,Hall; Drew A.,0,0,0,0
1668375070853,ECE 283,A00,103670,Hsueh; Tzu-Chien,0,0,0,0
1668375071281,ECE 284,A00,103671,Turakhia; Yatish Girish,0,0,0,0
1668375071707,ECE 285,A00,103672,Zheng; Yang,0,0,0,0
1668375071707,ECE 285,B00,103673,Sworder; David D.,0,0,0,0
1668375072134,ECE 287,A00,103676,Javidi; Tara,0,0,0,0
1668375072559,MATH 200B,A00,098023,Salehi Golsefidy; Alireza,12,0,15,3
1668375072993,MATH 202B,A00,098024,Rhoades; Brendon Patrick,9,0,15,6
1668375073422,MATH 203B,A00,098025,Oprea; Dragos N.,10,0,15,5
1668375073846,MATH 204B,A00,098026,Sorensen; Claus M,13,0,15,2
1668375074272,MATH 208,A00,098027,Izadi; Elham,7,0,10,3
1668375074694,MATH 209,A00,098028,Pollack; Aaron,10,0,10,0
1668375075119,MATH 211A,A00,112919,Rogalski; Daniel,9,0,10,1
1668375075542,MATH 211B,A00,112920,Seward; Brandon M.,9,0,10,1
1668375075969,MATH 218,A00,098029,Li; Bo,10,0,10,0
1668375076391,MATH 220B,A00,098030,Novak; Jonathan I,11,0,15,4
1668375076814,MATH 221A,A00,098031,Ebenfelt; Peter F,13,0,15,2
1668375077238,MATH 231B,A00,098032,Zlatos; Andrej,12,0,15,3
1668375077661,MATH 240B,A00,098033,Ni; Lei,9,0,15,6
1668375078084,MATH 243,A00,098034,Jekel; David Andrew,10,0,10,0
1668375078507,MATH 245A,A00,098035,Nie; Jiawang,0,0,15,16
1668375078932,MATH 248,A00,098036,Bejenaru; Ioan,10,0,10,0
1668375079356,MATH 250B,A00,098037,Spolaor; Luca,14,0,15,1
1668375079782,MATH 258,A00,098038,Ni; Lei,10,0,10,0
1668375080207,MATH 264B,A00,098041,Rhoades; Brendon Patrick,9,0,15,6
1668375080637,MATH 268,A00,098042,Buss; Samuel R,10,0,10,0
1668375081061,MATH 269,A00,098043,Rhoades; Brendon Patrick,10,0,10,0
1668375081485,MATH 270B,A00,098044,Li; Bo,10,0,15,5
1668375081907,MATH 272B,A00,098045,Holst; Michael J,13,0,15,2
1668375082331,MATH 273A,A00,098046,Tian; Xiaochuan,10,0,15,5
1668375082757,MATH 275,A01,098048,Tian; Xiaochuan,6,0,10,4
1668375083182,MATH 278A,A00,098049,Holst; Michael J,8,0,10,2
1668375083606,MATH 278B,A00,098050,Cloninger; Alexander,10,0,10,0
1668375084050,MATH 278C,A00,098051,Nie; Jiawang,7,0,10,3
1668375084479,MATH 280B,A00,098052,Zheng; Tianyi,8,0,15,7
1668375084906,MATH 281B,A00,098053,Bradic; Jelena,1,0,15,14
1668375085332,MATH 282B,A00,098054,Arias-Castro; Ery,0,0,15,15
1668375085757,MATH 285,A00,098055,Fitzsimmons; Patrick J,0,0,15,17
1668375086194,MATH 287B,A00,098056,Arias-Castro; Ery,2,0,15,13
1668375086618,MATH 288,A00,098057,Agarwal; Pooja,9,0,10,1
1668375086618,MATH 288,B00,098058,Zhang; Danna,8,0,10,2
1668375086618,MATH 288,C00,098059,Williams; Ruth J,9,0,10,1
1668375087045,MATH 290B,A00,098060,Roberts; Justin Deritter,13,0,15,2
1668375087467,MATH 292,A00,098061,Belmont; Eva Kinoshita,10,0,10,0
1668375087893,MATH 295,A00,098062,Suk; Andrew Hoon,48,0,50,2
1668375088319,MATH 296,A00,098063,Novak; Jonathan I,20,0,20,0
1668375088743,MATH 297,001,098064,Gamst; Anthony Collins,9997,0,9999,2
1668375589730,COGS 205,A00,101395,Chiba; Andrea,19,0,20,1
1668375590155,COGS 210B,001,101404,Greene; Deanna Jacquelyn,9998,0,9999,1
1668375590155,COGS 210B,002,101417,Xia; Haijun,9999,0,9999,0
1668375590155,COGS 210B,003,101422,Nitz; Douglas A.,9999,0,9999,0
1668375590155,COGS 210B,004,101423,Hollan; James D.,9998,0,9999,1
1668375590155,COGS 210B,005,101424,Deak; Gedeon O.,9998,0,9999,1
1668375590155,COGS 210B,006,101425,Rossano; Federico,9999,0,9999,0
1668375590580,COGS 211B,A00,101427,Coulson; Seana M,9996,0,9999,3
1668375591002,COGS 220,A00,101428,Hollan; James D.,0,0,25,25
1668375591428,COGS 229,A00,101429,Dow; Steven P,18,0,25,7
1668375591854,COGS 230,A00,101430,Klemmer; Scott R,11,0,17,6
1668375592279,COGS 234,A00,101431,Xia; Haijun,1,0,25,24
1668375592705,COGS 260,A00,101432,Kiyonaga; Anastasia,21,0,25,4
1668375592705,COGS 260,B00,101433,Kirsh; David Joel,15,0,25,10
1668375593133,CSE 202,A00,102371,Impagliazzo; Russell,0,0,0,0
1668375593556,CSE 203B,A01,102373,Cheng; Chung Kuan,0,0,0,0
1668375593989,CSE 208,A00,102374,Micciancio; Daniele,0,0,0,0
1668375594419,CSE 209A,A00,112895,Impagliazzo; Russell,0,0,15,15
1668375594851,CSE 209B,A00,108005,Bellare; Mihir,0,0,0,0
1668375595286,CSE 210,A00,113163,Coblenz; Michael J,0,0,0,0
1668375595728,CSE 219,A00,106111,Dow; Steven P,0,0,20,20
1668375596153,CSE 221,A00,102376,Voelker; Geoffrey M.,0,0,0,0
1668375596573,CSE 224,A01,102378,Porter; George M,0,0,0,0
1668375596999,CSE 229A,A00,102379,Savage; Stefan,0,0,0,0
1668375597425,CSE 229C,A00,102380,Munyaka; Imani N. S.,0,0,0,0
1668375597848,CSE 232B,A00,102382,Deutsch; Alin Bernard,0,0,0,0
1668375598271,CSE 234,A01,112904,Kumar; Arun Kumar,0,0,0,0
1668375598707,CSE 237A,A00,102383,Rosing; Tajana Simunic,0,0,0,0
1668375599141,CSE 239A,A00,102384,Deutsch; Alin Bernard,0,0,0,0
1668375599581,CSE 239B,A00,102385,Polikarpova; Nadezhda,0,0,0,0
1668375600005,CSE 240A,A00,102386,Pannuto; Patrick William,0,0,0,0
1668375600431,CSE 240B,A00,102387,Zhao; Jishen,0,0,0,0
1668375600858,CSE 241A,A00,106406,Kang; Mingu,0,0,0,0
1668375601281,CSE 249B,A00,102388,Kahng; Andrew Byun,0,0,8,8
1668375601705,CSE 251B,A01,102392,Cottrell; Garrison W,0,0,0,0
1668375601705,CSE 251B,A02,102393,Cottrell; Garrison W,0,0,0,0
1668375602145,CSE 252B,A00,102394,Ochoa; Benjamin Lawrence,0,0,0,0
1668375602571,CSE 257,A01,102396,Gao; Sicun,0,0,0,0
1668375602995,CSE 272,A00,102397,Li; Tzumao,0,0,0,0
1668375603425,CSE 274,A00,111323,Chern; Albert Ren-Haur,0,0,0,0
1668375603864,CSE 282,A00,102398,Pevzner; Pavel Arkadjevich,0,0,0,0
1668375604295,CSE 284,A00,114175,Gymrek; Melissa Ann,0,0,0,0
1668375604728,CSE 290,A00,102399,Chandraker; Manmohan Krishna,0,0,0,0
1668375604728,CSE 290,B00,102400,Vaccaro; Kristen Marie,0,0,25,25
1668375604728,CSE 290,C00,102414,Pannuto; Patrick William,0,0,25,25
1668375604728,CSE 290,D00,102427,Pevzner; Pavel Arkadjevich,0,0,0,0
1668375604728,CSE 290,E00,102429,Zhao; Jishen,0,0,0,0
1668375604728,CSE 290,F00,102436,Tullsen; Dean Michael,0,0,0,0
1668375604728,CSE 290,G00,102440,Christensen; Henrik I,0,0,20,20
1668375605163,CSE 291,A00,102443,Su; Hao,0,0,0,0
1668375605163,CSE 291,B00,102448,Polikarpova; Nadezhda,0,0,0,0
1668375605163,CSE 291,C00,102453,Vaccaro; Kristen Marie,0,0,0,0
1668375605163,CSE 291,D00,111343,Savage; Stefan,0,0,0,0
1668375605163,CSE 291,E00,116474,Claffy; Kimberly Claire,0,0,0,0
1668375605163,CSE 291,F00,116479,Pasquale; Joseph,0,0,0,0
1668375605597,CSE 293,001,119111,Bafna; Vineet,9999,0,9999,0
1668375605597,CSE 293,002,119118,Bellare; Mihir,9999,0,9999,0
1668375605597,CSE 293,003,119122,Berg-Kirkpatrick; Taylor D,9999,0,9999,0
1668375605597,CSE 293,004,119135,Christensen; Henrik I,9999,0,9999,0
1668375605597,CSE 293,005,119142,Cottrell; Garrison W,9999,0,9999,0
1668375605597,CSE 293,006,119146,Deutsch; Alin Bernard,9999,0,9999,0
1668375605597,CSE 293,007,119159,Esmaeilzadeh; Hadi,9999,0,9999,0
1668375605597,CSE 293,008,119166,Freund; Yoav,9999,0,9999,0
1668375605597,CSE 293,009,119170,Griswold; William G.,9999,0,9999,0
1668375605597,CSE 293,010,119183,Gymrek; Melissa Ann,9999,0,9999,0
1668375605597,CSE 293,011,119190,Heninger; Nadia A,9999,0,9999,0
1668375605597,CSE 293,012,119230,Impagliazzo; Russell,9999,0,9999,0
1668375605597,CSE 293,013,119232,Jhala; Ranjit,9999,0,9999,0
1668375605597,CSE 293,014,119233,Kahng; Andrew Byun,9999,0,9999,0
1668375605597,CSE 293,015,119298,Kane; Daniel Mertz,9999,0,9999,0
1668375605597,CSE 293,016,119299,Kriegman; David J,9999,0,9999,0
1668375605597,CSE 293,017,119300,Kumar; Arun Kumar,9999,0,9999,0
1668375605597,CSE 293,018,119301,Lerner; Sorin,9999,0,9999,0
1668375605597,CSE 293,019,119302,Lovett; Shachar,9999,0,9999,0
1668375605597,CSE 293,020,119303,McAuley; Julian John,9999,0,9999,0
1668375605597,CSE 293,021,119304,Micciancio; Daniele,9999,0,9999,0
1668375605597,CSE 293,022,119367,Orailoglu; Alex,9999,0,9999,0
1668375605597,CSE 293,023,119382,Paturi; Ramamohan,9999,0,9999,0
1668375605597,CSE 293,024,119404,Polikarpova; Nadezhda,9999,0,9999,0
1668375605597,CSE 293,025,119406,Politz; Joseph Gibbs,9999,0,9999,0
1668375605597,CSE 293,026,119411,Porter; George M,9999,0,9999,0
1668375605597,CSE 293,027,119414,Porter; Leonard Emerson,9999,0,9999,0
1668375605597,CSE 293,028,119416,Ramamoorthi; Ravi,9999,0,9999,0
1668375605597,CSE 293,029,119417,Sahoo; Debashis,9999,0,9999,0
1668375605597,CSE 293,030,119420,Saul; Lawrence,9999,0,9999,0
1668375605597,CSE 293,031,119421,Savage; Stefan,9999,0,9999,0
1668375605597,CSE 293,032,119425,Schulze; Jurgen P.,9999,0,9999,0
1668375605597,CSE 293,033,119426,Snoeren; Alex C.,9999,0,9999,0
1668375605597,CSE 293,034,119428,Shang; Jingbo,9999,0,9999,0
1668375605597,CSE 293,035,119430,Stefan; Deian,9999,0,9999,0
1668375605597,CSE 293,036,119431,Su; Hao,9999,0,9999,0
1668375605597,CSE 293,037,119433,Swanson; Steven James,9999,0,9999,0
1668375605597,CSE 293,038,119435,Tullsen; Dean Michael,9999,0,9999,0
1668375605597,CSE 293,039,119483,Voelker; Geoffrey M.,9999,0,9999,0
1668375605597,CSE 293,040,119537,Zhao; Jishen,9999,0,9999,0
1668375605597,CSE 293,041,119538,Zhou; Yuan-Yuan,9999,0,9999,0
1668375605597,CSE 293,042,119539,Gao; Sicun,9999,0,9999,0
1668375605597,CSE 293,043,119540,Weibel; Nadir,9999,0,9999,0
1668375605597,CSE 293,044,119541,Gupta; Rajesh K.,9999,0,9999,0
1668375605597,CSE 293,045,126410,Vaccaro; Kristen Marie,9999,0,9999,0
1668375605597,CSE 293,046,126411,Klemke; Richard,9999,0,9999,0
1668375606020,CSE 294,A00,102459,Voelker; Geoffrey M.,0,0,0,0
1668375606020,CSE 294,B00,111322,Orailoglu; Alex,0,0,0,0
1668375606447,DSE 201,A00,096914,Deutsch; Alin Bernard,30,0,30,0
1668375606870,DSE 210,A00,096915,Dasgupta; Sanjoy,30,0,30,0
1668375607294,DSE 260A,A00,096916,Altintas De Callaf; Ilkay,30,0,30,0
1668375607720,ECE 200,001,103586,Antipa; Nicholas A,9999,0,9999,0
1668375607720,ECE 200,002,103587,Atanasov; Nikolay A.,9999,0,9999,0
1668375607720,ECE 200,003,103588,Bharadia; Dinesh,9999,0,9999,0
1668375607720,ECE 200,004,103589,Cheng; Chung Kuan,9999,0,9999,0
1668375607720,ECE 200,005,103590,Cosman; Pamela C.,9999,0,9999,0
1668375607720,ECE 200,006,103591,Dayeh; Shadi Ahmad,9999,0,9999,0
1668375607720,ECE 200,007,103592,Fainman; Yeshaiahu,9999,0,9999,0
1668375607720,ECE 200,008,103593,Ford; Joseph Earl,9999,0,9999,0
1668375607720,ECE 200,009,103594,Franceschetti; Massimo,9999,0,9999,0
1668375607720,ECE 200,010,103595,Fullerton; Eric E,9999,0,9999,0
1668375607720,ECE 200,011,103596,Galton; Ian A,9999,0,9999,0
1668375607720,ECE 200,012,103597,Gilja; Vikash,9999,0,9999,0
1668375607720,ECE 200,013,103598,Hall; Drew A.,9999,0,9999,0
1668375607720,ECE 200,014,103599,Hsueh; Tzu-Chien,9999,0,9999,0
1668375607720,ECE 200,015,103600,Javidi; Tara,9999,0,9999,0
1668375607720,ECE 200,016,103601,Kahng; Andrew Byun,9999,0,9999,0
1668375607720,ECE 200,017,103602,Kim; Young-Han,9999,0,9999,0
1668375607720,ECE 200,018,103603,Koushanfar; Farinaz,9999,0,9999,0
1668375607720,ECE 200,019,103604,Kuzum; Duygu,9999,0,9999,0
1668375607720,ECE 200,020,103605,Le; Hanh-Phuc,9999,0,9999,0
1668375607720,ECE 200,021,103606,Lin; Bill,9999,0,9999,0
1668375607720,ECE 200,022,103607,Liu; Zhaowei,9998,0,9999,1
1668375607720,ECE 200,023,103608,Lo; Yu-Hwa,9999,0,9999,0
1668375607720,ECE 200,024,103609,Lomakin; Vitaliy,9999,0,9999,0
1668375607720,ECE 200,025,103610,Mercier; Patrick Philip,9999,0,9999,0
1668375607720,ECE 200,026,103611,Meyer; Florian,9999,0,9999,0
1668375607720,ECE 200,027,103612,Milstein; Laurence B.,9999,0,9999,0
1668375607720,ECE 200,028,103613,Mir Arabbaygi; Siavash,9999,0,9999,0
1668375607720,ECE 200,029,103614,Mookherjea; Shayan,9999,0,9999,0
1668375607720,ECE 200,030,103615,Morris; Karcher William,9999,0,9999,0
1668375607720,ECE 200,031,103616,Ng; Tse Nga,9999,0,9999,0
1668375607720,ECE 200,032,103617,Nguyen; Truong Quang,9999,0,9999,0
1668375607720,ECE 200,033,103618,Nomura; Kenji,9999,0,9999,0
1668375607720,ECE 200,034,103619,Orlitsky; Alon,9999,0,9999,0
1668375607720,ECE 200,035,103620,Pal; Piya,9999,0,9999,0
1668375607720,ECE 200,036,103621,Papen; George C.,9999,0,9999,0
1668375607720,ECE 200,037,103622,Radic; Stojan,9999,0,9999,0
1668375607720,ECE 200,038,103623,Rao; Bhaskar D.,9999,0,9999,0
1668375607720,ECE 200,039,103624,Rao; Ramesh R,9999,0,9999,0
1668375607720,ECE 200,040,103625,Rebeiz; Gabriel,9999,0,9999,0
1668375607720,ECE 200,041,103626,Sanford; John R,9999,0,9999,0
1668375607720,ECE 200,042,103627,Siegel; Paul H.,9999,0,9999,0
1668375607720,ECE 200,043,103628,Sievenpiper; Daniel F.,9999,0,9999,0
1668375607720,ECE 200,044,103629,Sworder; David D.,9999,0,9999,0
1668375607720,ECE 200,045,103630,Taur; Yuan,9999,0,9999,0
1668375607720,ECE 200,046,103631,Touri; Behrouz,9999,0,9999,0
1668375607720,ECE 200,047,103632,Trivedi; Mohan M.,9999,0,9999,0
1668375607720,ECE 200,048,103633,Vasconcelos; Nuno,9999,0,9999,0
1668375607720,ECE 200,049,103634,Wang; Xiaolong,9999,0,9999,0
1668375607720,ECE 200,050,103635,Xie; Pengtao,9999,0,9999,0
1668375607720,ECE 200,051,103636,Yip; Michael,9999,0,9999,0
1668375607720,ECE 200,052,103637,Zeger; Kenneth A.,999,0,999,0
1668375607720,ECE 200,053,103638,Zhang; Xinyu,9999,0,9999,0
1668375607720,ECE 200,054,103639,Turakhia; Yatish Girish,9999,0,9999,0
1668375607720,ECE 200,055,103640,Kang; Mingu,9999,0,9999,0
1668375607720,ECE 200,056,103641,Shi; Yuanyuan,9999,0,9999,0
1668375607720,ECE 200,057,103642,Wang; Edward Jay,9999,0,9999,0
1668375607720,ECE 200,058,103643,Zheng; Yang,9999,0,9999,0
1668375608147,ECE 202,A00,103644,Kuzum; Duygu,0,0,0,0
1668375608574,ECE 212BN,A00,103646,Ng; Tse Nga,0,0,0,0
1668375608998,ECE 221,A00,111493,Staff,0,0,0,0
1668375609421,ECE 222B,A00,103647,Lomakin; Vitaliy,0,0,0,0
1668375609844,ECE 230B,A00,103648,Taur; Yuan,0,0,0,0
1668375610271,ECE 238B,A00,103649,Garay; Javier,0,0,0,0
1668375610697,ECE 240B,A00,112900,Fainman; Yeshaiahu,0,0,0,0
1668375611123,ECE 247A,A00,103650,Jokerst; Jesse Vincent,0,0,0,0
1668375611557,ECE 247B,A00,103651,Wang; Joseph,0,0,0,0
1668375611981,ECE 250,A00,103652,Siegel; Paul H.,0,0,0,0
1668375612405,ECE 251A,A00,103654,Rao; Bhaskar D.,0,0,0,0
1668375612828,ECE 257B,A00,103655,Bharadia; Dinesh,0,0,0,0
1668375613256,ECE 258A,A00,103656,Milstein; Laurence B.,0,0,0,0
1668375613681,ECE 260B,A00,103658,Kang; Mingu,0,0,0,0
1668375614106,ECE 264A,A00,103659,Galton; Ian A,0,0,0,0
1668375614533,ECE 265A,A00,103661,Gudem; Prasad S.S.,0,0,0,0
1668375614957,ECE 265D,A00,103662,Gudem; Prasad S.S.,0,0,0,0
1668375615383,ECE 268,A00,103663,Koushanfar; Farinaz,0,0,0,0
1668375615808,ECE 269,A01,103665,Pal; Piya,0,0,0,0
1668375616242,ECE 271B,A00,103666,Vasconcelos; Manuela,0,0,0,0
1668375616666,ECE 276A,A00,103667,Atanasov; Nikolay A.,0,0,0,0
1668375617091,ECE 277,A00,103668,An; Cheolhong,0,0,0,0
1668375617513,ECE 279,A00,117947,Hall; Drew A.,0,0,0,0
1668375618366,ECE 283,A00,103670,Hsueh; Tzu-Chien,0,0,0,0
1668375618787,ECE 284,A00,103671,Turakhia; Yatish Girish,0,0,0,0
1668375619214,ECE 285,A00,103672,Zheng; Yang,0,0,0,0
1668375619214,ECE 285,B00,103673,Sworder; David D.,0,0,0,0
1668375619641,ECE 287,A00,103676,Javidi; Tara,0,0,0,0
1668375620075,MATH 200B,A00,098023,Salehi Golsefidy; Alireza,12,0,15,3
1668375620499,MATH 202B,A00,098024,Rhoades; Brendon Patrick,9,0,15,6
1668375620921,MATH 203B,A00,098025,Oprea; Dragos N.,10,0,15,5
1668375621343,MATH 204B,A00,098026,Sorensen; Claus M,13,0,15,2
1668375621789,MATH 208,A00,098027,Izadi; Elham,7,0,10,3
1668375622215,MATH 209,A00,098028,Pollack; Aaron,10,0,10,0
1668375622639,MATH 211A,A00,112919,Rogalski; Daniel,9,0,10,1
1668375623062,MATH 211B,A00,112920,Seward; Brandon M.,9,0,10,1
1668375623487,MATH 218,A00,098029,Li; Bo,10,0,10,0
1668375623928,MATH 220B,A00,098030,Novak; Jonathan I,11,0,15,4
1668375624357,MATH 221A,A00,098031,Ebenfelt; Peter F,13,0,15,2
1668375624779,MATH 231B,A00,098032,Zlatos; Andrej,12,0,15,3
1668375625205,MATH 240B,A00,098033,Ni; Lei,9,0,15,6
1668375625627,MATH 243,A00,098034,Jekel; David Andrew,10,0,10,0
1668375626050,MATH 245A,A00,098035,Nie; Jiawang,0,0,15,16
1668375626476,MATH 248,A00,098036,Bejenaru; Ioan,10,0,10,0
1668375626899,MATH 250B,A00,098037,Spolaor; Luca,14,0,15,1
1668375627327,MATH 258,A00,098038,Ni; Lei,10,0,10,0
1668375627749,MATH 264B,A00,098041,Rhoades; Brendon Patrick,9,0,15,6
1668375628173,MATH 268,A00,098042,Buss; Samuel R,10,0,10,0
1668375628595,MATH 269,A00,098043,Rhoades; Brendon Patrick,10,0,10,0
1668375629021,MATH 270B,A00,098044,Li; Bo,10,0,15,5
1668375629444,MATH 272B,A00,098045,Holst; Michael J,13,0,15,2
1668375629867,MATH 273A,A00,098046,Tian; Xiaochuan,10,0,15,5
1668375630368,MATH 275,A01,098048,Tian; Xiaochuan,6,0,10,4
1668375630792,MATH 278A,A00,098049,Holst; Michael J,8,0,10,2
1668375631218,MATH 278B,A00,098050,Cloninger; Alexander,10,0,10,0
1668375631649,MATH 278C,A00,098051,Nie; Jiawang,7,0,10,3
1668375632076,MATH 280B,A00,098052,Zheng; Tianyi,8,0,15,7
1668375632502,MATH 281B,A00,098053,Bradic; Jelena,1,0,15,14
1668375632924,MATH 282B,A00,098054,Arias-Castro; Ery,0,0,15,15
1668375633362,MATH 285,A00,098055,Fitzsimmons; Patrick J,0,0,15,17
1668375633797,MATH 287B,A00,098056,Arias-Castro; Ery,2,0,15,13
1668375634220,MATH 288,A00,098057,Agarwal; Pooja,9,0,10,1
1668375634220,MATH 288,B00,098058,Zhang; Danna,8,0,10,2
1668375634220,MATH 288,C00,098059,Williams; Ruth J,9,0,10,1
1668375634646,MATH 290B,A00,098060,Roberts; Justin Deritter,13,0,15,2
1668375635069,MATH 292,A00,098061,Belmont; Eva Kinoshita,10,0,10,0
1668375635497,MATH 295,A00,098062,Suk; Andrew Hoon,48,0,50,2
1668375635922,MATH 296,A00,098063,Novak; Jonathan I,20,0,20,0
1668375636346,MATH 297,001,098064,Gamst; Anthony Collins,9997,0,9999,2
1668376136578,COGS 205,A00,101395,Chiba; Andrea,19,0,20,1
1668376137001,COGS 210B,001,101404,Greene; Deanna Jacquelyn,9998,0,9999,1
1668376137001,COGS 210B,002,101417,Xia; Haijun,9999,0,9999,0
1668376137001,COGS 210B,003,101422,Nitz; Douglas A.,9999,0,9999,0
1668376137001,COGS 210B,004,101423,Hollan; James D.,9998,0,9999,1
1668376137001,COGS 210B,005,101424,Deak; Gedeon O.,9998,0,9999,1
1668376137001,COGS 210B,006,101425,Rossano; Federico,9999,0,9999,0
1668376137427,COGS 211B,A00,101427,Coulson; Seana M,9996,0,9999,3
1668376137853,COGS 220,A00,101428,Hollan; James D.,0,0,25,25
1668376138277,COGS 229,A00,101429,Dow; Steven P,18,0,25,7
1668376138699,COGS 230,A00,101430,Klemmer; Scott R,11,0,17,6
1668376139123,COGS 234,A00,101431,Xia; Haijun,1,0,25,24
1668376139555,COGS 260,A00,101432,Kiyonaga; Anastasia,21,0,25,4
1668376139555,COGS 260,B00,101433,Kirsh; David Joel,15,0,25,10
1668376139991,CSE 202,A00,102371,Impagliazzo; Russell,0,0,0,0
1668376140417,CSE 203B,A01,102373,Cheng; Chung Kuan,0,0,0,0
1668376140843,CSE 208,A00,102374,Micciancio; Daniele,0,0,0,0
1668376141268,CSE 209A,A00,112895,Impagliazzo; Russell,0,0,15,15
1668376141709,CSE 209B,A00,108005,Bellare; Mihir,0,0,0,0
1668376142137,CSE 210,A00,113163,Coblenz; Michael J,0,0,0,0
1668376142561,CSE 219,A00,106111,Dow; Steven P,0,0,20,20
1668376142986,CSE 221,A00,102376,Voelker; Geoffrey M.,0,0,0,0
1668376143409,CSE 224,A01,102378,Porter; George M,0,0,0,0
1668376143843,CSE 229A,A00,102379,Savage; Stefan,0,0,0,0
1668376144270,CSE 229C,A00,102380,Munyaka; Imani N. S.,0,0,0,0
1668376144695,CSE 232B,A00,102382,Deutsch; Alin Bernard,0,0,0,0
1668376145129,CSE 234,A01,112904,Kumar; Arun Kumar,0,0,0,0
1668376145564,CSE 237A,A00,102383,Rosing; Tajana Simunic,0,0,0,0
1668376145999,CSE 239A,A00,102384,Deutsch; Alin Bernard,0,0,0,0
1668376146422,CSE 239B,A00,102385,Polikarpova; Nadezhda,0,0,0,0
1668376146846,CSE 240A,A00,102386,Pannuto; Patrick William,0,0,0,0
1668376147270,CSE 240B,A00,102387,Zhao; Jishen,0,0,0,0
1668376147694,CSE 241A,A00,106406,Kang; Mingu,0,0,0,0
1668376148121,CSE 249B,A00,102388,Kahng; Andrew Byun,0,0,8,8
1668376148553,CSE 251B,A01,102392,Cottrell; Garrison W,0,0,0,0
1668376148553,CSE 251B,A02,102393,Cottrell; Garrison W,0,0,0,0
1668376148977,CSE 252B,A00,102394,Ochoa; Benjamin Lawrence,0,0,0,0
1668376149399,CSE 257,A01,102396,Gao; Sicun,0,0,0,0
1668376149822,CSE 272,A00,102397,Li; Tzumao,0,0,0,0
1668376150245,CSE 274,A00,111323,Chern; Albert Ren-Haur,0,0,0,0
1668376150750,CSE 282,A00,102398,Pevzner; Pavel Arkadjevich,0,0,0,0
1668376151174,CSE 284,A00,114175,Gymrek; Melissa Ann,0,0,0,0
1668376151597,CSE 290,A00,102399,Chandraker; Manmohan Krishna,0,0,0,0
1668376151597,CSE 290,B00,102400,Vaccaro; Kristen Marie,0,0,25,25
1668376151597,CSE 290,C00,102414,Pannuto; Patrick William,0,0,25,25
1668376151597,CSE 290,D00,102427,Pevzner; Pavel Arkadjevich,0,0,0,0
1668376151597,CSE 290,E00,102429,Zhao; Jishen,0,0,0,0
1668376151597,CSE 290,F00,102436,Tullsen; Dean Michael,0,0,0,0
1668376151597,CSE 290,G00,102440,Christensen; Henrik I,0,0,20,20
1668376152021,CSE 291,A00,102443,Su; Hao,0,0,0,0
1668376152021,CSE 291,B00,102448,Polikarpova; Nadezhda,0,0,0,0
1668376152021,CSE 291,C00,102453,Vaccaro; Kristen Marie,0,0,0,0
1668376152021,CSE 291,D00,111343,Savage; Stefan,0,0,0,0
1668376152021,CSE 291,E00,116474,Claffy; Kimberly Claire,0,0,0,0
1668376152021,CSE 291,F00,116479,Pasquale; Joseph,0,0,0,0
1668376152462,CSE 293,001,119111,Bafna; Vineet,9999,0,9999,0
1668376152462,CSE 293,002,119118,Bellare; Mihir,9999,0,9999,0
1668376152462,CSE 293,003,119122,Berg-Kirkpatrick; Taylor D,9999,0,9999,0
1668376152462,CSE 293,004,119135,Christensen; Henrik I,9999,0,9999,0
1668376152462,CSE 293,005,119142,Cottrell; Garrison W,9999,0,9999,0
1668376152462,CSE 293,006,119146,Deutsch; Alin Bernard,9999,0,9999,0
1668376152462,CSE 293,007,119159,Esmaeilzadeh; Hadi,9999,0,9999,0
1668376152462,CSE 293,008,119166,Freund; Yoav,9999,0,9999,0
1668376152462,CSE 293,009,119170,Griswold; William G.,9999,0,9999,0
1668376152462,CSE 293,010,119183,Gymrek; Melissa Ann,9999,0,9999,0
1668376152462,CSE 293,011,119190,Heninger; Nadia A,9999,0,9999,0
1668376152462,CSE 293,012,119230,Impagliazzo; Russell,9999,0,9999,0
1668376152462,CSE 293,013,119232,Jhala; Ranjit,9999,0,9999,0
1668376152462,CSE 293,014,119233,Kahng; Andrew Byun,9999,0,9999,0
1668376152462,CSE 293,015,119298,Kane; Daniel Mertz,9999,0,9999,0
1668376152462,CSE 293,016,119299,Kriegman; David J,9999,0,9999,0
1668376152462,CSE 293,017,119300,Kumar; Arun Kumar,9999,0,9999,0
1668376152462,CSE 293,018,119301,Lerner; Sorin,9999,0,9999,0
1668376152462,CSE 293,019,119302,Lovett; Shachar,9999,0,9999,0
1668376152462,CSE 293,020,119303,McAuley; Julian John,9999,0,9999,0
1668376152462,CSE 293,021,119304,Micciancio; Daniele,9999,0,9999,0
1668376152462,CSE 293,022,119367,Orailoglu; Alex,9999,0,9999,0
1668376152462,CSE 293,023,119382,Paturi; Ramamohan,9999,0,9999,0
1668376152462,CSE 293,024,119404,Polikarpova; Nadezhda,9999,0,9999,0
1668376152462,CSE 293,025,119406,Politz; Joseph Gibbs,9999,0,9999,0
1668376152462,CSE 293,026,119411,Porter; George M,9999,0,9999,0
1668376152462,CSE 293,027,119414,Porter; Leonard Emerson,9999,0,9999,0
1668376152462,CSE 293,028,119416,Ramamoorthi; Ravi,9999,0,9999,0
1668376152462,CSE 293,029,119417,Sahoo; Debashis,9999,0,9999,0
1668376152462,CSE 293,030,119420,Saul; Lawrence,9999,0,9999,0
1668376152462,CSE 293,031,119421,Savage; Stefan,9999,0,9999,0
1668376152462,CSE 293,032,119425,Schulze; Jurgen P.,9999,0,9999,0
1668376152462,CSE 293,033,119426,Snoeren; Alex C.,9999,0,9999,0
1668376152462,CSE 293,034,119428,Shang; Jingbo,9999,0,9999,0
1668376152462,CSE 293,035,119430,Stefan; Deian,9999,0,9999,0
1668376152462,CSE 293,036,119431,Su; Hao,9999,0,9999,0
1668376152462,CSE 293,037,119433,Swanson; Steven James,9999,0,9999,0
1668376152462,CSE 293,038,119435,Tullsen; Dean Michael,9999,0,9999,0
1668376152462,CSE 293,039,119483,Voelker; Geoffrey M.,9999,0,9999,0
1668376152462,CSE 293,040,119537,Zhao; Jishen,9999,0,9999,0
1668376152462,CSE 293,041,119538,Zhou; Yuan-Yuan,9999,0,9999,0
1668376152462,CSE 293,042,119539,Gao; Sicun,9999,0,9999,0
1668376152462,CSE 293,043,119540,Weibel; Nadir,9999,0,9999,0
1668376152462,CSE 293,044,119541,Gupta; Rajesh K.,9999,0,9999,0
1668376152462,CSE 293,045,126410,Vaccaro; Kristen Marie,9999,0,9999,0
1668376152462,CSE 293,046,126411,Klemke; Richard,9999,0,9999,0
1668376152886,CSE 294,A00,102459,Voelker; Geoffrey M.,0,0,0,0
1668376152886,CSE 294,B00,111322,Orailoglu; Alex,0,0,0,0
1668376153310,DSE 201,A00,096914,Deutsch; Alin Bernard,30,0,30,0
1668376153737,DSE 210,A00,096915,Dasgupta; Sanjoy,30,0,30,0
1668376154159,DSE 260A,A00,096916,Altintas De Callaf; Ilkay,30,0,30,0
1668376154595,ECE 200,001,103586,Antipa; Nicholas A,9999,0,9999,0
1668376154595,ECE 200,002,103587,Atanasov; Nikolay A.,9999,0,9999,0
1668376154595,ECE 200,003,103588,Bharadia; Dinesh,9999,0,9999,0
1668376154595,ECE 200,004,103589,Cheng; Chung Kuan,9999,0,9999,0
1668376154595,ECE 200,005,103590,Cosman; Pamela C.,9999,0,9999,0
1668376154595,ECE 200,006,103591,Dayeh; Shadi Ahmad,9999,0,9999,0
1668376154595,ECE 200,007,103592,Fainman; Yeshaiahu,9999,0,9999,0
1668376154595,ECE 200,008,103593,Ford; Joseph Earl,9999,0,9999,0
1668376154595,ECE 200,009,103594,Franceschetti; Massimo,9999,0,9999,0
1668376154595,ECE 200,010,103595,Fullerton; Eric E,9999,0,9999,0
1668376154595,ECE 200,011,103596,Galton; Ian A,9999,0,9999,0
1668376154595,ECE 200,012,103597,Gilja; Vikash,9999,0,9999,0
1668376154595,ECE 200,013,103598,Hall; Drew A.,9999,0,9999,0
1668376154595,ECE 200,014,103599,Hsueh; Tzu-Chien,9999,0,9999,0
1668376154595,ECE 200,015,103600,Javidi; Tara,9999,0,9999,0
1668376154595,ECE 200,016,103601,Kahng; Andrew Byun,9999,0,9999,0
1668376154595,ECE 200,017,103602,Kim; Young-Han,9999,0,9999,0
1668376154595,ECE 200,018,103603,Koushanfar; Farinaz,9999,0,9999,0
1668376154595,ECE 200,019,103604,Kuzum; Duygu,9999,0,9999,0
1668376154595,ECE 200,020,103605,Le; Hanh-Phuc,9999,0,9999,0
1668376154595,ECE 200,021,103606,Lin; Bill,9999,0,9999,0
1668376154595,ECE 200,022,103607,Liu; Zhaowei,9998,0,9999,1
1668376154595,ECE 200,023,103608,Lo; Yu-Hwa,9999,0,9999,0
1668376154595,ECE 200,024,103609,Lomakin; Vitaliy,9999,0,9999,0
1668376154595,ECE 200,025,103610,Mercier; Patrick Philip,9999,0,9999,0
1668376154595,ECE 200,026,103611,Meyer; Florian,9999,0,9999,0
1668376154595,ECE 200,027,103612,Milstein; Laurence B.,9999,0,9999,0
1668376154595,ECE 200,028,103613,Mir Arabbaygi; Siavash,9999,0,9999,0
1668376154595,ECE 200,029,103614,Mookherjea; Shayan,9999,0,9999,0
1668376154595,ECE 200,030,103615,Morris; Karcher William,9999,0,9999,0
1668376154595,ECE 200,031,103616,Ng; Tse Nga,9999,0,9999,0
1668376154595,ECE 200,032,103617,Nguyen; Truong Quang,9999,0,9999,0
1668376154595,ECE 200,033,103618,Nomura; Kenji,9999,0,9999,0
1668376154595,ECE 200,034,103619,Orlitsky; Alon,9999,0,9999,0
1668376154595,ECE 200,035,103620,Pal; Piya,9999,0,9999,0
1668376154595,ECE 200,036,103621,Papen; George C.,9999,0,9999,0
1668376154595,ECE 200,037,103622,Radic; Stojan,9999,0,9999,0
1668376154595,ECE 200,038,103623,Rao; Bhaskar D.,9999,0,9999,0
1668376154595,ECE 200,039,103624,Rao; Ramesh R,9999,0,9999,0
1668376154595,ECE 200,040,103625,Rebeiz; Gabriel,9999,0,9999,0
1668376154595,ECE 200,041,103626,Sanford; John R,9999,0,9999,0
1668376154595,ECE 200,042,103627,Siegel; Paul H.,9999,0,9999,0
1668376154595,ECE 200,043,103628,Sievenpiper; Daniel F.,9999,0,9999,0
1668376154595,ECE 200,044,103629,Sworder; David D.,9999,0,9999,0
1668376154595,ECE 200,045,103630,Taur; Yuan,9999,0,9999,0
1668376154595,ECE 200,046,103631,Touri; Behrouz,9999,0,9999,0
1668376154595,ECE 200,047,103632,Trivedi; Mohan M.,9999,0,9999,0
1668376154595,ECE 200,048,103633,Vasconcelos; Nuno,9999,0,9999,0
1668376154595,ECE 200,049,103634,Wang; Xiaolong,9999,0,9999,0
1668376154595,ECE 200,050,103635,Xie; Pengtao,9999,0,9999,0
1668376154595,ECE 200,051,103636,Yip; Michael,9999,0,9999,0
1668376154595,ECE 200,052,103637,Zeger; Kenneth A.,999,0,999,0
1668376154595,ECE 200,053,103638,Zhang; Xinyu,9999,0,9999,0
1668376154595,ECE 200,054,103639,Turakhia; Yatish Girish,9999,0,9999,0
1668376154595,ECE 200,055,103640,Kang; Mingu,9999,0,9999,0
1668376154595,ECE 200,056,103641,Shi; Yuanyuan,9999,0,9999,0
1668376154595,ECE 200,057,103642,Wang; Edward Jay,9999,0,9999,0
1668376154595,ECE 200,058,103643,Zheng; Yang,9999,0,9999,0
1668376155019,ECE 202,A00,103644,Kuzum; Duygu,0,0,0,0
1668376155442,ECE 212BN,A00,103646,Ng; Tse Nga,0,0,0,0
1668376155866,ECE 221,A00,111493,Staff,0,0,0,0
1668376156292,ECE 222B,A00,103647,Lomakin; Vitaliy,0,0,0,0
1668376156723,ECE 230B,A00,103648,Taur; Yuan,0,0,0,0
1668376157147,ECE 238B,A00,103649,Garay; Javier,0,0,0,0
1668376157573,ECE 240B,A00,112900,Fainman; Yeshaiahu,0,0,0,0
1668376157998,ECE 247A,A00,103650,Jokerst; Jesse Vincent,0,0,0,0
1668376158423,ECE 247B,A00,103651,Wang; Joseph,0,0,0,0
1668376158847,ECE 250,A00,103652,Siegel; Paul H.,0,0,0,0
1668376159270,ECE 251A,A00,103654,Rao; Bhaskar D.,0,0,0,0
1668376159693,ECE 257B,A00,103655,Bharadia; Dinesh,0,0,0,0
1668376160120,ECE 258A,A00,103656,Milstein; Laurence B.,0,0,0,0
1668376160544,ECE 260B,A00,103658,Kang; Mingu,0,0,0,0
1668376160970,ECE 264A,A00,103659,Galton; Ian A,0,0,0,0
1668376161393,ECE 265A,A00,103661,Gudem; Prasad S.S.,0,0,0,0
1668376161818,ECE 265D,A00,103662,Gudem; Prasad S.S.,0,0,0,0
1668376162244,ECE 268,A00,103663,Koushanfar; Farinaz,0,0,0,0
1668376162666,ECE 269,A01,103665,Pal; Piya,0,0,0,0
1668376163090,ECE 271B,A00,103666,Vasconcelos; Manuela,0,0,0,0
1668376163514,ECE 276A,A00,103667,Atanasov; Nikolay A.,0,0,0,0
1668376163937,ECE 277,A00,103668,An; Cheolhong,0,0,0,0
1668376164362,ECE 279,A00,117947,Hall; Drew A.,0,0,0,0
1668376165212,ECE 283,A00,103670,Hsueh; Tzu-Chien,0,0,0,0
1668376165637,ECE 284,A00,103671,Turakhia; Yatish Girish,0,0,0,0
1668376166064,ECE 285,A00,103672,Zheng; Yang,0,0,0,0
1668376166064,ECE 285,B00,103673,Sworder; David D.,0,0,0,0
1668376166489,ECE 287,A00,103676,Javidi; Tara,0,0,0,0
1668376166923,MATH 200B,A00,098023,Salehi Golsefidy; Alireza,12,0,15,3
1668376167348,MATH 202B,A00,098024,Rhoades; Brendon Patrick,9,0,15,6
1668376167772,MATH 203B,A00,098025,Oprea; Dragos N.,10,0,15,5
1668376168195,MATH 204B,A00,098026,Sorensen; Claus M,13,0,15,2
1668376168618,MATH 208,A00,098027,Izadi; Elham,7,0,10,3
1668376169046,MATH 209,A00,098028,Pollack; Aaron,10,0,10,0
1668376169471,MATH 211A,A00,112919,Rogalski; Daniel,9,0,10,1
1668376169894,MATH 211B,A00,112920,Seward; Brandon M.,9,0,10,1
1668376170319,MATH 218,A00,098029,Li; Bo,10,0,10,0
1668376170749,MATH 220B,A00,098030,Novak; Jonathan I,11,0,15,4
1668376171174,MATH 221A,A00,098031,Ebenfelt; Peter F,13,0,15,2
1668376171597,MATH 231B,A00,098032,Zlatos; Andrej,12,0,15,3
1668376172026,MATH 240B,A00,098033,Ni; Lei,9,0,15,6
1668376172458,MATH 243,A00,098034,Jekel; David Andrew,10,0,10,0
1668376172879,MATH 245A,A00,098035,Nie; Jiawang,0,0,15,16
1668376173305,MATH 248,A00,098036,Bejenaru; Ioan,10,0,10,0
1668376173729,MATH 250B,A00,098037,Spolaor; Luca,14,0,15,1
1668376174151,MATH 258,A00,098038,Ni; Lei,10,0,10,0
1668376174578,MATH 264B,A00,098041,Rhoades; Brendon Patrick,9,0,15,6
1668376175001,MATH 268,A00,098042,Buss; Samuel R,10,0,10,0
1668376175425,MATH 269,A00,098043,Rhoades; Brendon Patrick,10,0,10,0
1668376175853,MATH 270B,A00,098044,Li; Bo,10,0,15,5
1668376176277,MATH 272B,A00,098045,Holst; Michael J,13,0,15,2
1668376176700,MATH 273A,A00,098046,Tian; Xiaochuan,10,0,15,5
1668376177123,MATH 275,A01,098048,Tian; Xiaochuan,6,0,10,4
1668376177548,MATH 278A,A00,098049,Holst; Michael J,8,0,10,2
1668376177978,MATH 278B,A00,098050,Cloninger; Alexander,10,0,10,0
1668376178402,MATH 278C,A00,098051,Nie; Jiawang,7,0,10,3
1668376178829,MATH 280B,A00,098052,Zheng; Tianyi,8,0,15,7
1668376179253,MATH 281B,A00,098053,Bradic; Jelena,1,0,15,14
1668376179680,MATH 282B,A00,098054,Arias-Castro; Ery,0,0,15,15
1668376180106,MATH 285,A00,098055,Fitzsimmons; Patrick J,0,0,15,17
1668376180541,MATH 287B,A00,098056,Arias-Castro; Ery,2,0,15,13
1668376180964,MATH 288,A00,098057,Agarwal; Pooja,9,0,10,1
1668376180964,MATH 288,B00,098058,Zhang; Danna,8,0,10,2
1668376180964,MATH 288,C00,098059,Williams; Ruth J,9,0,10,1
1668376181390,MATH 290B,A00,098060,Roberts; Justin Deritter,13,0,15,2
1668376181813,MATH 292,A00,098061,Belmont; Eva Kinoshita,10,0,10,0
1668376182239,MATH 295,A00,098062,Suk; Andrew Hoon,48,0,50,2
1668376182666,MATH 296,A00,098063,Novak; Jonathan I,20,0,20,0
1668376183092,MATH 297,001,098064,Gamst; Anthony Collins,9997,0,9999,2
1668376690608,COGS 205,A00,101395,Chiba; Andrea,19,0,20,1
1668376691047,COGS 210B,001,101404,Greene; Deanna Jacquelyn,9998,0,9999,1
1668376691047,COGS 210B,002,101417,Xia; Haijun,9999,0,9999,0
1668376691047,COGS 210B,003,101422,Nitz; Douglas A.,9999,0,9999,0
1668376691047,COGS 210B,004,101423,Hollan; James D.,9998,0,9999,1
1668376691047,COGS 210B,005,101424,Deak; Gedeon O.,9998,0,9999,1
1668376691047,COGS 210B,006,101425,Rossano; Federico,9999,0,9999,0
1668376691472,COGS 211B,A00,101427,Coulson; Seana M,9996,0,9999,3
1668376691893,COGS 220,A00,101428,Hollan; James D.,0,0,25,25
1668376692317,COGS 229,A00,101429,Dow; Steven P,18,0,25,7
1668376692741,COGS 230,A00,101430,Klemmer; Scott R,11,0,17,6
1668376693169,COGS 234,A00,101431,Xia; Haijun,1,0,25,24
1668376693603,COGS 260,A00,101432,Kiyonaga; Anastasia,21,0,25,4
1668376693603,COGS 260,B00,101433,Kirsh; David Joel,15,0,25,10
1668376694029,CSE 202,A00,102371,Impagliazzo; Russell,0,0,0,0
1668376694461,CSE 203B,A01,102373,Cheng; Chung Kuan,0,0,0,0
1668376694900,CSE 208,A00,102374,Micciancio; Daniele,0,0,0,0
1668376695327,CSE 209A,A00,112895,Impagliazzo; Russell,0,0,15,15
1668376695762,CSE 209B,A00,108005,Bellare; Mihir,0,0,0,0
1668376696196,CSE 210,A00,113163,Coblenz; Michael J,0,0,0,0
1668376696633,CSE 219,A00,106111,Dow; Steven P,0,0,20,20
1668376697070,CSE 221,A00,102376,Voelker; Geoffrey M.,0,0,0,0
1668376697495,CSE 224,A01,102378,Porter; George M,0,0,0,0
1668376697923,CSE 229A,A00,102379,Savage; Stefan,0,0,0,0
1668376698349,CSE 229C,A00,102380,Munyaka; Imani N. S.,0,0,0,0
1668376698775,CSE 232B,A00,102382,Deutsch; Alin Bernard,0,0,0,0
1668376699200,CSE 234,A01,112904,Kumar; Arun Kumar,0,0,0,0
1668376699628,CSE 237A,A00,102383,Rosing; Tajana Simunic,0,0,0,0
1668376700053,CSE 239A,A00,102384,Deutsch; Alin Bernard,0,0,0,0
1668376700482,CSE 239B,A00,102385,Polikarpova; Nadezhda,0,0,0,0
1668376700906,CSE 240A,A00,102386,Pannuto; Patrick William,0,0,0,0
1668376701331,CSE 240B,A00,102387,Zhao; Jishen,0,0,0,0
1668376701755,CSE 241A,A00,106406,Kang; Mingu,0,0,0,0
1668376702179,CSE 249B,A00,102388,Kahng; Andrew Byun,0,0,8,8
1668376702605,CSE 251B,A01,102392,Cottrell; Garrison W,0,0,0,0
1668376702605,CSE 251B,A02,102393,Cottrell; Garrison W,0,0,0,0
1668376703032,CSE 252B,A00,102394,Ochoa; Benjamin Lawrence,0,0,0,0
1668376703455,CSE 257,A01,102396,Gao; Sicun,0,0,0,0
1668376703885,CSE 272,A00,102397,Li; Tzumao,0,0,0,0
1668376704309,CSE 274,A00,111323,Chern; Albert Ren-Haur,0,0,0,0
1668376704733,CSE 282,A00,102398,Pevzner; Pavel Arkadjevich,0,0,0,0
1668376705157,CSE 284,A00,114175,Gymrek; Melissa Ann,0,0,0,0
1668376705585,CSE 290,A00,102399,Chandraker; Manmohan Krishna,0,0,0,0
1668376705585,CSE 290,B00,102400,Vaccaro; Kristen Marie,0,0,25,25
1668376705585,CSE 290,C00,102414,Pannuto; Patrick William,0,0,25,25
1668376705585,CSE 290,D00,102427,Pevzner; Pavel Arkadjevich,0,0,0,0
1668376705585,CSE 290,E00,102429,Zhao; Jishen,0,0,0,0
1668376705585,CSE 290,F00,102436,Tullsen; Dean Michael,0,0,0,0
1668376705585,CSE 290,G00,102440,Christensen; Henrik I,0,0,20,20
1668376706011,CSE 291,A00,102443,Su; Hao,0,0,0,0
1668376706011,CSE 291,B00,102448,Polikarpova; Nadezhda,0,0,0,0
1668376706011,CSE 291,C00,102453,Vaccaro; Kristen Marie,0,0,0,0
1668376706011,CSE 291,D00,111343,Savage; Stefan,0,0,0,0
1668376706011,CSE 291,E00,116474,Claffy; Kimberly Claire,0,0,0,0
1668376706011,CSE 291,F00,116479,Pasquale; Joseph,0,0,0,0
1668376706445,CSE 293,001,119111,Bafna; Vineet,9999,0,9999,0
1668376706445,CSE 293,002,119118,Bellare; Mihir,9999,0,9999,0
1668376706445,CSE 293,003,119122,Berg-Kirkpatrick; Taylor D,9999,0,9999,0
1668376706445,CSE 293,004,119135,Christensen; Henrik I,9999,0,9999,0
1668376706445,CSE 293,005,119142,Cottrell; Garrison W,9999,0,9999,0
1668376706445,CSE 293,006,119146,Deutsch; Alin Bernard,9999,0,9999,0
1668376706445,CSE 293,007,119159,Esmaeilzadeh; Hadi,9999,0,9999,0
1668376706445,CSE 293,008,119166,Freund; Yoav,9999,0,9999,0
1668376706445,CSE 293,009,119170,Griswold; William G.,9999,0,9999,0
1668376706445,CSE 293,010,119183,Gymrek; Melissa Ann,9999,0,9999,0
1668376706445,CSE 293,011,119190,Heninger; Nadia A,9999,0,9999,0
1668376706445,CSE 293,012,119230,Impagliazzo; Russell,9999,0,9999,0
1668376706445,CSE 293,013,119232,Jhala; Ranjit,9999,0,9999,0
1668376706445,CSE 293,014,119233,Kahng; Andrew Byun,9999,0,9999,0
1668376706445,CSE 293,015,119298,Kane; Daniel Mertz,9999,0,9999,0
1668376706445,CSE 293,016,119299,Kriegman; David J,9999,0,9999,0
1668376706445,CSE 293,017,119300,Kumar; Arun Kumar,9999,0,9999,0
1668376706445,CSE 293,018,119301,Lerner; Sorin,9999,0,9999,0
1668376706445,CSE 293,019,119302,Lovett; Shachar,9999,0,9999,0
1668376706445,CSE 293,020,119303,McAuley; Julian John,9999,0,9999,0
1668376706445,CSE 293,021,119304,Micciancio; Daniele,9999,0,9999,0
1668376706445,CSE 293,022,119367,Orailoglu; Alex,9999,0,9999,0
1668376706445,CSE 293,023,119382,Paturi; Ramamohan,9999,0,9999,0
1668376706445,CSE 293,024,119404,Polikarpova; Nadezhda,9999,0,9999,0
1668376706445,CSE 293,025,119406,Politz; Joseph Gibbs,9999,0,9999,0
1668376706445,CSE 293,026,119411,Porter; George M,9999,0,9999,0
1668376706445,CSE 293,027,119414,Porter; Leonard Emerson,9999,0,9999,0
1668376706445,CSE 293,028,119416,Ramamoorthi; Ravi,9999,0,9999,0
1668376706445,CSE 293,029,119417,Sahoo; Debashis,9999,0,9999,0
1668376706445,CSE 293,030,119420,Saul; Lawrence,9999,0,9999,0
1668376706445,CSE 293,031,119421,Savage; Stefan,9999,0,9999,0
1668376706445,CSE 293,032,119425,Schulze; Jurgen P.,9999,0,9999,0
1668376706445,CSE 293,033,119426,Snoeren; Alex C.,9999,0,9999,0
1668376706445,CSE 293,034,119428,Shang; Jingbo,9999,0,9999,0
1668376706445,CSE 293,035,119430,Stefan; Deian,9999,0,9999,0
1668376706445,CSE 293,036,119431,Su; Hao,9999,0,9999,0
1668376706445,CSE 293,037,119433,Swanson; Steven James,9999,0,9999,0
1668376706445,CSE 293,038,119435,Tullsen; Dean Michael,9999,0,9999,0
1668376706445,CSE 293,039,119483,Voelker; Geoffrey M.,9999,0,9999,0
1668376706445,CSE 293,040,119537,Zhao; Jishen,9999,0,9999,0
1668376706445,CSE 293,041,119538,Zhou; Yuan-Yuan,9999,0,9999,0
1668376706445,CSE 293,042,119539,Gao; Sicun,9999,0,9999,0
1668376706445,CSE 293,043,119540,Weibel; Nadir,9999,0,9999,0
1668376706445,CSE 293,044,119541,Gupta; Rajesh K.,9999,0,9999,0
1668376706445,CSE 293,045,126410,Vaccaro; Kristen Marie,9999,0,9999,0
1668376706445,CSE 293,046,126411,Klemke; Richard,9999,0,9999,0
1668376706869,CSE 294,A00,102459,Voelker; Geoffrey M.,0,0,0,0
1668376706869,CSE 294,B00,111322,Orailoglu; Alex,0,0,0,0
1668376707296,DSE 201,A00,096914,Deutsch; Alin Bernard,30,0,30,0
1668376707720,DSE 210,A00,096915,Dasgupta; Sanjoy,30,0,30,0
1668376708147,DSE 260A,A00,096916,Altintas De Callaf; Ilkay,30,0,30,0
1668376708589,ECE 200,001,103586,Antipa; Nicholas A,9999,0,9999,0
1668376708589,ECE 200,002,103587,Atanasov; Nikolay A.,9999,0,9999,0
1668376708589,ECE 200,003,103588,Bharadia; Dinesh,9999,0,9999,0
1668376708589,ECE 200,004,103589,Cheng; Chung Kuan,9999,0,9999,0
1668376708589,ECE 200,005,103590,Cosman; Pamela C.,9999,0,9999,0
1668376708589,ECE 200,006,103591,Dayeh; Shadi Ahmad,9999,0,9999,0
1668376708589,ECE 200,007,103592,Fainman; Yeshaiahu,9999,0,9999,0
1668376708589,ECE 200,008,103593,Ford; Joseph Earl,9999,0,9999,0
1668376708589,ECE 200,009,103594,Franceschetti; Massimo,9999,0,9999,0
1668376708589,ECE 200,010,103595,Fullerton; Eric E,9999,0,9999,0
1668376708589,ECE 200,011,103596,Galton; Ian A,9999,0,9999,0
1668376708589,ECE 200,012,103597,Gilja; Vikash,9999,0,9999,0
1668376708589,ECE 200,013,103598,Hall; Drew A.,9999,0,9999,0
1668376708589,ECE 200,014,103599,Hsueh; Tzu-Chien,9999,0,9999,0
1668376708589,ECE 200,015,103600,Javidi; Tara,9999,0,9999,0
1668376708589,ECE 200,016,103601,Kahng; Andrew Byun,9999,0,9999,0
1668376708589,ECE 200,017,103602,Kim; Young-Han,9999,0,9999,0
1668376708589,ECE 200,018,103603,Koushanfar; Farinaz,9999,0,9999,0
1668376708589,ECE 200,019,103604,Kuzum; Duygu,9999,0,9999,0
1668376708589,ECE 200,020,103605,Le; Hanh-Phuc,9999,0,9999,0
1668376708589,ECE 200,021,103606,Lin; Bill,9999,0,9999,0
1668376708589,ECE 200,022,103607,Liu; Zhaowei,9998,0,9999,1
1668376708589,ECE 200,023,103608,Lo; Yu-Hwa,9999,0,9999,0
1668376708589,ECE 200,024,103609,Lomakin; Vitaliy,9999,0,9999,0
1668376708589,ECE 200,025,103610,Mercier; Patrick Philip,9999,0,9999,0
1668376708589,ECE 200,026,103611,Meyer; Florian,9999,0,9999,0
1668376708589,ECE 200,027,103612,Milstein; Laurence B.,9999,0,9999,0
1668376708589,ECE 200,028,103613,Mir Arabbaygi; Siavash,9999,0,9999,0
1668376708589,ECE 200,029,103614,Mookherjea; Shayan,9999,0,9999,0
1668376708589,ECE 200,030,103615,Morris; Karcher William,9999,0,9999,0
1668376708589,ECE 200,031,103616,Ng; Tse Nga,9999,0,9999,0
1668376708589,ECE 200,032,103617,Nguyen; Truong Quang,9999,0,9999,0
1668376708589,ECE 200,033,103618,Nomura; Kenji,9999,0,9999,0
1668376708589,ECE 200,034,103619,Orlitsky; Alon,9999,0,9999,0
1668376708589,ECE 200,035,103620,Pal; Piya,9999,0,9999,0
1668376708589,ECE 200,036,103621,Papen; George C.,9999,0,9999,0
1668376708589,ECE 200,037,103622,Radic; Stojan,9999,0,9999,0
1668376708589,ECE 200,038,103623,Rao; Bhaskar D.,9999,0,9999,0
1668376708589,ECE 200,039,103624,Rao; Ramesh R,9999,0,9999,0
1668376708589,ECE 200,040,103625,Rebeiz; Gabriel,9999,0,9999,0
1668376708589,ECE 200,041,103626,Sanford; John R,9999,0,9999,0
1668376708589,ECE 200,042,103627,Siegel; Paul H.,9999,0,9999,0
1668376708589,ECE 200,043,103628,Sievenpiper; Daniel F.,9999,0,9999,0
1668376708589,ECE 200,044,103629,Sworder; David D.,9999,0,9999,0
1668376708589,ECE 200,045,103630,Taur; Yuan,9999,0,9999,0
1668376708589,ECE 200,046,103631,Touri; Behrouz,9999,0,9999,0
1668376708589,ECE 200,047,103632,Trivedi; Mohan M.,9999,0,9999,0
1668376708589,ECE 200,048,103633,Vasconcelos; Nuno,9999,0,9999,0
1668376708589,ECE 200,049,103634,Wang; Xiaolong,9999,0,9999,0
1668376708589,ECE 200,050,103635,Xie; Pengtao,9999,0,9999,0
1668376708589,ECE 200,051,103636,Yip; Michael,9999,0,9999,0
1668376708589,ECE 200,052,103637,Zeger; Kenneth A.,999,0,999,0
1668376708589,ECE 200,053,103638,Zhang; Xinyu,9999,0,9999,0
1668376708589,ECE 200,054,103639,Turakhia; Yatish Girish,9999,0,9999,0
1668376708589,ECE 200,055,103640,Kang; Mingu,9999,0,9999,0
1668376708589,ECE 200,056,103641,Shi; Yuanyuan,9999,0,9999,0
1668376708589,ECE 200,057,103642,Wang; Edward Jay,9999,0,9999,0
1668376708589,ECE 200,058,103643,Zheng; Yang,9999,0,9999,0
1668376709016,ECE 202,A00,103644,Kuzum; Duygu,0,0,0,0
1668376709438,ECE 212BN,A00,103646,Ng; Tse Nga,0,0,0,0
1668376709860,ECE 221,A00,111493,Staff,0,0,0,0
1668376710285,ECE 222B,A00,103647,Lomakin; Vitaliy,0,0,0,0
1668376710723,ECE 230B,A00,103648,Taur; Yuan,0,0,0,0
1668376711148,ECE 238B,A00,103649,Garay; Javier,0,0,0,0
1668376711583,ECE 240B,A00,112900,Fainman; Yeshaiahu,0,0,0,0
1668376712010,ECE 247A,A00,103650,Jokerst; Jesse Vincent,0,0,0,0
1668376712446,ECE 247B,A00,103651,Wang; Joseph,0,0,0,0
1668376712874,ECE 250,A00,103652,Siegel; Paul H.,0,0,0,0
1668376713298,ECE 251A,A00,103654,Rao; Bhaskar D.,0,0,0,0
1668376713724,ECE 257B,A00,103655,Bharadia; Dinesh,0,0,0,0
1668376714148,ECE 258A,A00,103656,Milstein; Laurence B.,0,0,0,0
1668376714571,ECE 260B,A00,103658,Kang; Mingu,0,0,0,0
1668376714997,ECE 264A,A00,103659,Galton; Ian A,0,0,0,0
1668376715420,ECE 265A,A00,103661,Gudem; Prasad S.S.,0,0,0,0
1668376715848,ECE 265D,A00,103662,Gudem; Prasad S.S.,0,0,0,0
1668376716275,ECE 268,A00,103663,Koushanfar; Farinaz,0,0,0,0
1668376716707,ECE 269,A01,103665,Pal; Piya,0,0,0,0
1668376717135,ECE 271B,A00,103666,Vasconcelos; Manuela,0,0,0,0
1668376717560,ECE 276A,A00,103667,Atanasov; Nikolay A.,0,0,0,0
1668376717987,ECE 277,A00,103668,An; Cheolhong,0,0,0,0
1668376718410,ECE 279,A00,117947,Hall; Drew A.,0,0,0,0
1668376719263,ECE 283,A00,103670,Hsueh; Tzu-Chien,0,0,0,0
1668376719690,ECE 284,A00,103671,Turakhia; Yatish Girish,0,0,0,0
1668376720114,ECE 285,A00,103672,Zheng; Yang,0,0,0,0
1668376720114,ECE 285,B00,103673,Sworder; David D.,0,0,0,0
1668376720548,ECE 287,A00,103676,Javidi; Tara,0,0,0,0
1668376720972,MATH 200B,A00,098023,Salehi Golsefidy; Alireza,12,0,15,3
1668376721469,MATH 202B,A00,098024,Rhoades; Brendon Patrick,9,0,15,6
1668376721892,MATH 203B,A00,098025,Oprea; Dragos N.,10,0,15,5
1668376722317,MATH 204B,A00,098026,Sorensen; Claus M,13,0,15,2
1668376722741,MATH 208,A00,098027,Izadi; Elham,7,0,10,3
1668376723163,MATH 209,A00,098028,Pollack; Aaron,10,0,10,0
1668376723586,MATH 211A,A00,112919,Rogalski; Daniel,9,0,10,1
1668376724012,MATH 211B,A00,112920,Seward; Brandon M.,9,0,10,1
1668376724436,MATH 218,A00,098029,Li; Bo,10,0,10,0
1668376724859,MATH 220B,A00,098030,Novak; Jonathan I,11,0,15,4
1668376725325,MATH 221A,A00,098031,Ebenfelt; Peter F,13,0,15,2
1668376725752,MATH 231B,A00,098032,Zlatos; Andrej,12,0,15,3
1668376726175,MATH 240B,A00,098033,Ni; Lei,9,0,15,6
1668376726599,MATH 243,A00,098034,Jekel; David Andrew,10,0,10,0
1668376727022,MATH 245A,A00,098035,Nie; Jiawang,0,0,15,16
1668376727444,MATH 248,A00,098036,Bejenaru; Ioan,10,0,10,0
1668376727867,MATH 250B,A00,098037,Spolaor; Luca,14,0,15,1
1668376728289,MATH 258,A00,098038,Ni; Lei,10,0,10,0
1668376728713,MATH 264B,A00,098041,Rhoades; Brendon Patrick,9,0,15,6
1668376729137,MATH 268,A00,098042,Buss; Samuel R,10,0,10,0
1668376729560,MATH 269,A00,098043,Rhoades; Brendon Patrick,10,0,10,0
1668376729984,MATH 270B,A00,098044,Li; Bo,10,0,15,5
1668376730410,MATH 272B,A00,098045,Holst; Michael J,13,0,15,2
1668376730834,MATH 273A,A00,098046,Tian; Xiaochuan,10,0,15,5
1668376731260,MATH 275,A01,098048,Tian; Xiaochuan,6,0,10,4
1668376731683,MATH 278A,A00,098049,Holst; Michael J,8,0,10,2
1668376732105,MATH 278B,A00,098050,Cloninger; Alexander,10,0,10,0
1668376732534,MATH 278C,A00,098051,Nie; Jiawang,7,0,10,3
1668376732958,MATH 280B,A00,098052,Zheng; Tianyi,8,0,15,7
1668376733382,MATH 281B,A00,098053,Bradic; Jelena,1,0,15,14
1668376733804,MATH 282B,A00,098054,Arias-Castro; Ery,0,0,15,15
1668376734230,MATH 285,A00,098055,Fitzsimmons; Patrick J,0,0,15,17
1668376734657,MATH 287B,A00,098056,Arias-Castro; Ery,2,0,15,13
1668376735079,MATH 288,A00,098057,Agarwal; Pooja,9,0,10,1
1668376735079,MATH 288,B00,098058,Zhang; Danna,8,0,10,2
1668376735079,MATH 288,C00,098059,Williams; Ruth J,9,0,10,1
1668376735511,MATH 290B,A00,098060,Roberts; Justin Deritter,13,0,15,2
1668376735933,MATH 292,A00,098061,Belmont; Eva Kinoshita,10,0,10,0
1668376736363,MATH 295,A00,098062,Suk; Andrew Hoon,48,0,50,2
1668376736798,MATH 296,A00,098063,Novak; Jonathan I,20,0,20,0
1668376737221,MATH 297,001,098064,Gamst; Anthony Collins,9997,0,9999,2
1668377257685,COGS 205,A00,101395,Chiba; Andrea,19,0,20,1
1668377258118,COGS 210B,001,101404,Greene; Deanna Jacquelyn,9998,0,9999,1
1668377258118,COGS 210B,002,101417,Xia; Haijun,9999,0,9999,0
1668377258118,COGS 210B,003,101422,Nitz; Douglas A.,9999,0,9999,0
1668377258118,COGS 210B,004,101423,Hollan; James D.,9998,0,9999,1
1668377258118,COGS 210B,005,101424,Deak; Gedeon O.,9998,0,9999,1
1668377258118,COGS 210B,006,101425,Rossano; Federico,9999,0,9999,0
1668377258551,COGS 211B,A00,101427,Coulson; Seana M,9996,0,9999,3
1668377258981,COGS 220,A00,101428,Hollan; James D.,0,0,25,25
1668377259404,COGS 229,A00,101429,Dow; Steven P,18,0,25,7
1668377259827,COGS 230,A00,101430,Klemmer; Scott R,11,0,17,6
1668377260249,COGS 234,A00,101431,Xia; Haijun,1,0,25,24
1668377260673,COGS 260,A00,101432,Kiyonaga; Anastasia,21,0,25,4
1668377260673,COGS 260,B00,101433,Kirsh; David Joel,15,0,25,10
1668377261095,CSE 202,A00,102371,Impagliazzo; Russell,0,0,0,0
1668377261521,CSE 203B,A01,102373,Cheng; Chung Kuan,0,0,0,0
1668377262037,CSE 208,A00,102374,Micciancio; Daniele,0,0,0,0
1668377262461,CSE 209A,A00,112895,Impagliazzo; Russell,0,0,15,15
1668377262892,CSE 209B,A00,108005,Bellare; Mihir,0,0,0,0
1668377263324,CSE 210,A00,113163,Coblenz; Michael J,0,0,0,0
1668377263746,CSE 219,A00,106111,Dow; Steven P,0,0,20,20
1668377264169,CSE 221,A00,102376,Voelker; Geoffrey M.,0,0,0,0
1668377264594,CSE 224,A01,102378,Porter; George M,0,0,0,0
1668377265022,CSE 229A,A00,102379,Savage; Stefan,0,0,0,0
1668377265464,CSE 229C,A00,102380,Munyaka; Imani N. S.,0,0,0,0
1668377265890,CSE 232B,A00,102382,Deutsch; Alin Bernard,0,0,0,0
1668377266313,CSE 234,A01,112904,Kumar; Arun Kumar,0,0,0,0
1668377266738,CSE 237A,A00,102383,Rosing; Tajana Simunic,0,0,0,0
1668377267161,CSE 239A,A00,102384,Deutsch; Alin Bernard,0,0,0,0
1668377267597,CSE 239B,A00,102385,Polikarpova; Nadezhda,0,0,0,0
1668377268019,CSE 240A,A00,102386,Pannuto; Patrick William,0,0,0,0
1668377268447,CSE 240B,A00,102387,Zhao; Jishen,0,0,0,0
1668377268870,CSE 241A,A00,106406,Kang; Mingu,0,0,0,0
1668377269294,CSE 249B,A00,102388,Kahng; Andrew Byun,0,0,8,8
1668377269717,CSE 251B,A01,102392,Cottrell; Garrison W,0,0,0,0
1668377269717,CSE 251B,A02,102393,Cottrell; Garrison W,0,0,0,0
1668377270149,CSE 252B,A00,102394,Ochoa; Benjamin Lawrence,0,0,0,0
1668377270572,CSE 257,A01,102396,Gao; Sicun,0,0,0,0
1668377270995,CSE 272,A00,102397,Li; Tzumao,0,0,0,0
1668377271421,CSE 274,A00,111323,Chern; Albert Ren-Haur,0,0,0,0
1668377271845,CSE 282,A00,102398,Pevzner; Pavel Arkadjevich,0,0,0,0
1668377272269,CSE 284,A00,114175,Gymrek; Melissa Ann,0,0,0,0
1668377272694,CSE 290,A00,102399,Chandraker; Manmohan Krishna,0,0,0,0
1668377272694,CSE 290,B00,102400,Vaccaro; Kristen Marie,0,0,25,25
1668377272694,CSE 290,C00,102414,Pannuto; Patrick William,0,0,25,25
1668377272694,CSE 290,D00,102427,Pevzner; Pavel Arkadjevich,0,0,0,0
1668377272694,CSE 290,E00,102429,Zhao; Jishen,0,0,0,0
1668377272694,CSE 290,F00,102436,Tullsen; Dean Michael,0,0,0,0
1668377272694,CSE 290,G00,102440,Christensen; Henrik I,0,0,20,20
1668377273122,CSE 291,A00,102443,Su; Hao,0,0,0,0
1668377273122,CSE 291,B00,102448,Polikarpova; Nadezhda,0,0,0,0
1668377273122,CSE 291,C00,102453,Vaccaro; Kristen Marie,0,0,0,0
1668377273122,CSE 291,D00,111343,Savage; Stefan,0,0,0,0
1668377273122,CSE 291,E00,116474,Claffy; Kimberly Claire,0,0,0,0
1668377273122,CSE 291,F00,116479,Pasquale; Joseph,0,0,0,0
1668377273563,CSE 293,001,119111,Bafna; Vineet,9999,0,9999,0
1668377273563,CSE 293,002,119118,Bellare; Mihir,9999,0,9999,0
1668377273563,CSE 293,003,119122,Berg-Kirkpatrick; Taylor D,9999,0,9999,0
1668377273563,CSE 293,004,119135,Christensen; Henrik I,9999,0,9999,0
1668377273563,CSE 293,005,119142,Cottrell; Garrison W,9999,0,9999,0
1668377273563,CSE 293,006,119146,Deutsch; Alin Bernard,9999,0,9999,0
1668377273563,CSE 293,007,119159,Esmaeilzadeh; Hadi,9999,0,9999,0
1668377273563,CSE 293,008,119166,Freund; Yoav,9999,0,9999,0
1668377273563,CSE 293,009,119170,Griswold; William G.,9999,0,9999,0
1668377273563,CSE 293,010,119183,Gymrek; Melissa Ann,9999,0,9999,0
1668377273563,CSE 293,011,119190,Heninger; Nadia A,9999,0,9999,0
1668377273563,CSE 293,012,119230,Impagliazzo; Russell,9999,0,9999,0
1668377273563,CSE 293,013,119232,Jhala; Ranjit,9999,0,9999,0
1668377273563,CSE 293,014,119233,Kahng; Andrew Byun,9999,0,9999,0
1668377273563,CSE 293,015,119298,Kane; Daniel Mertz,9999,0,9999,0
1668377273563,CSE 293,016,119299,Kriegman; David J,9999,0,9999,0
1668377273563,CSE 293,017,119300,Kumar; Arun Kumar,9999,0,9999,0
1668377273563,CSE 293,018,119301,Lerner; Sorin,9999,0,9999,0
1668377273563,CSE 293,019,119302,Lovett; Shachar,9999,0,9999,0
1668377273563,CSE 293,020,119303,McAuley; Julian John,9999,0,9999,0
1668377273563,CSE 293,021,119304,Micciancio; Daniele,9999,0,9999,0
1668377273563,CSE 293,022,119367,Orailoglu; Alex,9999,0,9999,0
1668377273563,CSE 293,023,119382,Paturi; Ramamohan,9999,0,9999,0
1668377273563,CSE 293,024,119404,Polikarpova; Nadezhda,9999,0,9999,0
1668377273563,CSE 293,025,119406,Politz; Joseph Gibbs,9999,0,9999,0
1668377273563,CSE 293,026,119411,Porter; George M,9999,0,9999,0
1668377273563,CSE 293,027,119414,Porter; Leonard Emerson,9999,0,9999,0
1668377273563,CSE 293,028,119416,Ramamoorthi; Ravi,9999,0,9999,0
1668377273563,CSE 293,029,119417,Sahoo; Debashis,9999,0,9999,0
1668377273563,CSE 293,030,119420,Saul; Lawrence,9999,0,9999,0
1668377273563,CSE 293,031,119421,Savage; Stefan,9999,0,9999,0
1668377273563,CSE 293,032,119425,Schulze; Jurgen P.,9999,0,9999,0
1668377273563,CSE 293,033,119426,Snoeren; Alex C.,9999,0,9999,0
1668377273563,CSE 293,034,119428,Shang; Jingbo,9999,0,9999,0
1668377273563,CSE 293,035,119430,Stefan; Deian,9999,0,9999,0
1668377273563,CSE 293,036,119431,Su; Hao,9999,0,9999,0
1668377273563,CSE 293,037,119433,Swanson; Steven James,9999,0,9999,0
1668377273563,CSE 293,038,119435,Tullsen; Dean Michael,9999,0,9999,0
1668377273563,CSE 293,039,119483,Voelker; Geoffrey M.,9999,0,9999,0
1668377273563,CSE 293,040,119537,Zhao; Jishen,9999,0,9999,0
1668377273563,CSE 293,041,119538,Zhou; Yuan-Yuan,9999,0,9999,0
1668377273563,CSE 293,042,119539,Gao; Sicun,9999,0,9999,0
1668377273563,CSE 293,043,119540,Weibel; Nadir,9999,0,9999,0
1668377273563,CSE 293,044,119541,Gupta; Rajesh K.,9999,0,9999,0
1668377273563,CSE 293,045,126410,Vaccaro; Kristen Marie,9999,0,9999,0
1668377273563,CSE 293,046,126411,Klemke; Richard,9999,0,9999,0
1668377273988,CSE 294,A00,102459,Voelker; Geoffrey M.,0,0,0,0
1668377273988,CSE 294,B00,111322,Orailoglu; Alex,0,0,0,0
1668377274412,DSE 201,A00,096914,Deutsch; Alin Bernard,30,0,30,0
1668377274834,DSE 210,A00,096915,Dasgupta; Sanjoy,30,0,30,0
1668377275259,DSE 260A,A00,096916,Altintas De Callaf; Ilkay,30,0,30,0
1668377275717,ECE 200,001,103586,Antipa; Nicholas A,9999,0,9999,0
1668377275717,ECE 200,002,103587,Atanasov; Nikolay A.,9999,0,9999,0
1668377275717,ECE 200,003,103588,Bharadia; Dinesh,9999,0,9999,0
1668377275717,ECE 200,004,103589,Cheng; Chung Kuan,9999,0,9999,0
1668377275717,ECE 200,005,103590,Cosman; Pamela C.,9999,0,9999,0
1668377275717,ECE 200,006,103591,Dayeh; Shadi Ahmad,9999,0,9999,0
1668377275717,ECE 200,007,103592,Fainman; Yeshaiahu,9999,0,9999,0
1668377275717,ECE 200,008,103593,Ford; Joseph Earl,9999,0,9999,0
1668377275717,ECE 200,009,103594,Franceschetti; Massimo,9999,0,9999,0
1668377275717,ECE 200,010,103595,Fullerton; Eric E,9999,0,9999,0
1668377275717,ECE 200,011,103596,Galton; Ian A,9999,0,9999,0
1668377275717,ECE 200,012,103597,Gilja; Vikash,9999,0,9999,0
1668377275717,ECE 200,013,103598,Hall; Drew A.,9999,0,9999,0
1668377275717,ECE 200,014,103599,Hsueh; Tzu-Chien,9999,0,9999,0
1668377275717,ECE 200,015,103600,Javidi; Tara,9999,0,9999,0
1668377275717,ECE 200,016,103601,Kahng; Andrew Byun,9999,0,9999,0
1668377275717,ECE 200,017,103602,Kim; Young-Han,9999,0,9999,0
1668377275717,ECE 200,018,103603,Koushanfar; Farinaz,9999,0,9999,0
1668377275717,ECE 200,019,103604,Kuzum; Duygu,9999,0,9999,0
1668377275717,ECE 200,020,103605,Le; Hanh-Phuc,9999,0,9999,0
1668377275717,ECE 200,021,103606,Lin; Bill,9999,0,9999,0
1668377275717,ECE 200,022,103607,Liu; Zhaowei,9998,0,9999,1
1668377275717,ECE 200,023,103608,Lo; Yu-Hwa,9999,0,9999,0
1668377275717,ECE 200,024,103609,Lomakin; Vitaliy,9999,0,9999,0
1668377275717,ECE 200,025,103610,Mercier; Patrick Philip,9999,0,9999,0
1668377275717,ECE 200,026,103611,Meyer; Florian,9999,0,9999,0
1668377275717,ECE 200,027,103612,Milstein; Laurence B.,9999,0,9999,0
1668377275717,ECE 200,028,103613,Mir Arabbaygi; Siavash,9999,0,9999,0
1668377275717,ECE 200,029,103614,Mookherjea; Shayan,9999,0,9999,0
1668377275717,ECE 200,030,103615,Morris; Karcher William,9999,0,9999,0
1668377275717,ECE 200,031,103616,Ng; Tse Nga,9999,0,9999,0
1668377275717,ECE 200,032,103617,Nguyen; Truong Quang,9999,0,9999,0
1668377275717,ECE 200,033,103618,Nomura; Kenji,9999,0,9999,0
1668377275717,ECE 200,034,103619,Orlitsky; Alon,9999,0,9999,0
1668377275717,ECE 200,035,103620,Pal; Piya,9999,0,9999,0
1668377275717,ECE 200,036,103621,Papen; George C.,9999,0,9999,0
1668377275717,ECE 200,037,103622,Radic; Stojan,9999,0,9999,0
1668377275717,ECE 200,038,103623,Rao; Bhaskar D.,9999,0,9999,0
1668377275717,ECE 200,039,103624,Rao; Ramesh R,9999,0,9999,0
1668377275717,ECE 200,040,103625,Rebeiz; Gabriel,9999,0,9999,0
1668377275717,ECE 200,041,103626,Sanford; John R,9999,0,9999,0
1668377275717,ECE 200,042,103627,Siegel; Paul H.,9999,0,9999,0
1668377275717,ECE 200,043,103628,Sievenpiper; Daniel F.,9999,0,9999,0
1668377275717,ECE 200,044,103629,Sworder; David D.,9999,0,9999,0
1668377275717,ECE 200,045,103630,Taur; Yuan,9999,0,9999,0
1668377275717,ECE 200,046,103631,Touri; Behrouz,9999,0,9999,0
1668377275717,ECE 200,047,103632,Trivedi; Mohan M.,9999,0,9999,0
1668377275717,ECE 200,048,103633,Vasconcelos; Nuno,9999,0,9999,0
1668377275717,ECE 200,049,103634,Wang; Xiaolong,9999,0,9999,0
1668377275717,ECE 200,050,103635,Xie; Pengtao,9999,0,9999,0
1668377275717,ECE 200,051,103636,Yip; Michael,9999,0,9999,0
1668377275717,ECE 200,052,103637,Zeger; Kenneth A.,999,0,999,0
1668377275717,ECE 200,053,103638,Zhang; Xinyu,9999,0,9999,0
1668377275717,ECE 200,054,103639,Turakhia; Yatish Girish,9999,0,9999,0
1668377275717,ECE 200,055,103640,Kang; Mingu,9999,0,9999,0
1668377275717,ECE 200,056,103641,Shi; Yuanyuan,9999,0,9999,0
1668377275717,ECE 200,057,103642,Wang; Edward Jay,9999,0,9999,0
1668377275717,ECE 200,058,103643,Zheng; Yang,9999,0,9999,0
1668377276145,ECE 202,A00,103644,Kuzum; Duygu,0,0,0,0
1668377276570,ECE 212BN,A00,103646,Ng; Tse Nga,0,0,0,0
1668377276995,ECE 221,A00,111493,Staff,0,0,0,0
1668377277420,ECE 222B,A00,103647,Lomakin; Vitaliy,0,0,0,0
1668377277843,ECE 230B,A00,103648,Taur; Yuan,0,0,0,0
1668377278275,ECE 238B,A00,103649,Garay; Javier,0,0,0,0
1668377278705,ECE 240B,A00,112900,Fainman; Yeshaiahu,0,0,0,0
1668377279129,ECE 247A,A00,103650,Jokerst; Jesse Vincent,0,0,0,0
1668377279554,ECE 247B,A00,103651,Wang; Joseph,0,0,0,0
1668377279982,ECE 250,A00,103652,Siegel; Paul H.,0,0,0,0
1668377280424,ECE 251A,A00,103654,Rao; Bhaskar D.,0,0,0,0
1668377280849,ECE 257B,A00,103655,Bharadia; Dinesh,0,0,0,0
1668377281278,ECE 258A,A00,103656,Milstein; Laurence B.,0,0,0,0
1668377281700,ECE 260B,A00,103658,Kang; Mingu,0,0,0,0
1668377282147,ECE 264A,A00,103659,Galton; Ian A,0,0,0,0
1668377282586,ECE 265A,A00,103661,Gudem; Prasad S.S.,0,0,0,0
1668377283010,ECE 265D,A00,103662,Gudem; Prasad S.S.,0,0,0,0
1668377283434,ECE 268,A00,103663,Koushanfar; Farinaz,0,0,0,0
1668377283859,ECE 269,A01,103665,Pal; Piya,0,0,0,0
1668377284283,ECE 271B,A00,103666,Vasconcelos; Manuela,0,0,0,0
1668377284709,ECE 276A,A00,103667,Atanasov; Nikolay A.,0,0,0,0
1668377285133,ECE 277,A00,103668,An; Cheolhong,0,0,0,0
1668377285557,ECE 279,A00,117947,Hall; Drew A.,0,0,0,0
1668377286409,ECE 283,A00,103670,Hsueh; Tzu-Chien,0,0,0,0
1668377286835,ECE 284,A00,103671,Turakhia; Yatish Girish,0,0,0,0
1668377287264,ECE 285,A00,103672,Zheng; Yang,0,0,0,0
1668377287264,ECE 285,B00,103673,Sworder; David D.,0,0,0,0
1668377287690,ECE 287,A00,103676,Javidi; Tara,0,0,0,0
1668377288117,MATH 200B,A00,098023,Salehi Golsefidy; Alireza,12,0,15,3
1668377288541,MATH 202B,A00,098024,Rhoades; Brendon Patrick,9,0,15,6
1668377288970,MATH 203B,A00,098025,Oprea; Dragos N.,10,0,15,5
1668377289395,MATH 204B,A00,098026,Sorensen; Claus M,13,0,15,2
1668377289827,MATH 208,A00,098027,Izadi; Elham,7,0,10,3
1668377290255,MATH 209,A00,098028,Pollack; Aaron,10,0,10,0
1668377290691,MATH 211A,A00,112919,Rogalski; Daniel,9,0,10,1
1668377291131,MATH 211B,A00,112920,Seward; Brandon M.,9,0,10,1
1668377291558,MATH 218,A00,098029,Li; Bo,10,0,10,0
1668377291983,MATH 220B,A00,098030,Novak; Jonathan I,11,0,15,4
1668377292407,MATH 221A,A00,098031,Ebenfelt; Peter F,13,0,15,2
1668377292829,MATH 231B,A00,098032,Zlatos; Andrej,12,0,15,3
1668377293267,MATH 240B,A00,098033,Ni; Lei,9,0,15,6
1668377293691,MATH 243,A00,098034,Jekel; David Andrew,10,0,10,0
1668377294115,MATH 245A,A00,098035,Nie; Jiawang,0,0,15,16
1668377294538,MATH 248,A00,098036,Bejenaru; Ioan,10,0,10,0
1668377294960,MATH 250B,A00,098037,Spolaor; Luca,14,0,15,1
1668377295384,MATH 258,A00,098038,Ni; Lei,10,0,10,0
1668377295807,MATH 264B,A00,098041,Rhoades; Brendon Patrick,9,0,15,6
1668377296232,MATH 268,A00,098042,Buss; Samuel R,10,0,10,0
1668377296659,MATH 269,A00,098043,Rhoades; Brendon Patrick,10,0,10,0
1668377297084,MATH 270B,A00,098044,Li; Bo,10,0,15,5
1668377297506,MATH 272B,A00,098045,Holst; Michael J,13,0,15,2
1668377297929,MATH 273A,A00,098046,Tian; Xiaochuan,10,0,15,5
1668377298351,MATH 275,A01,098048,Tian; Xiaochuan,6,0,10,4
1668377298777,MATH 278A,A00,098049,Holst; Michael J,8,0,10,2
1668377299203,MATH 278B,A00,098050,Cloninger; Alexander,10,0,10,0
1668377299627,MATH 278C,A00,098051,Nie; Jiawang,7,0,10,3
1668377300057,MATH 280B,A00,098052,Zheng; Tianyi,8,0,15,7
1668377300481,MATH 281B,A00,098053,Bradic; Jelena,1,0,15,14
1668377300911,MATH 282B,A00,098054,Arias-Castro; Ery,0,0,15,15
1668377301341,MATH 285,A00,098055,Fitzsimmons; Patrick J,0,0,15,17
1668377301765,MATH 287B,A00,098056,Arias-Castro; Ery,2,0,15,13
1668377302212,MATH 288,A00,098057,Agarwal; Pooja,9,0,10,1
1668377302212,MATH 288,B00,098058,Zhang; Danna,8,0,10,2
1668377302212,MATH 288,C00,098059,Williams; Ruth J,9,0,10,1
1668377302638,MATH 290B,A00,098060,Roberts; Justin Deritter,13,0,15,2
1668377303062,MATH 292,A00,098061,Belmont; Eva Kinoshita,10,0,10,0
1668377303488,MATH 295,A00,098062,Suk; Andrew Hoon,48,0,50,2
1668377303911,MATH 296,A00,098063,Novak; Jonathan I,20,0,20,0
1668377304337,MATH 297,001,098064,Gamst; Anthony Collins,9997,0,9999,2
1668377804627,COGS 205,A00,101395,Chiba; Andrea,19,0,20,1
1668377805076,COGS 210B,001,101404,Greene; Deanna Jacquelyn,9998,0,9999,1
1668377805076,COGS 210B,002,101417,Xia; Haijun,9999,0,9999,0
1668377805076,COGS 210B,003,101422,Nitz; Douglas A.,9999,0,9999,0
1668377805076,COGS 210B,004,101423,Hollan; James D.,9998,0,9999,1
1668377805076,COGS 210B,005,101424,Deak; Gedeon O.,9998,0,9999,1
1668377805076,COGS 210B,006,101425,Rossano; Federico,9999,0,9999,0
1668377805501,COGS 211B,A00,101427,Coulson; Seana M,9996,0,9999,3
1668377805932,COGS 220,A00,101428,Hollan; James D.,0,0,25,25
1668377806356,COGS 229,A00,101429,Dow; Steven P,18,0,25,7
1668377806831,COGS 230,A00,101430,Klemmer; Scott R,11,0,17,6
1668377807257,COGS 234,A00,101431,Xia; Haijun,1,0,25,24
1668377807681,COGS 260,A00,101432,Kiyonaga; Anastasia,21,0,25,4
1668377807681,COGS 260,B00,101433,Kirsh; David Joel,15,0,25,10
1668377808107,CSE 202,A00,102371,Impagliazzo; Russell,0,0,0,0
1668377808534,CSE 203B,A01,102373,Cheng; Chung Kuan,0,0,0,0
1668377808959,CSE 208,A00,102374,Micciancio; Daniele,0,0,0,0
1668377809384,CSE 209A,A00,112895,Impagliazzo; Russell,0,0,15,15
1668377809821,CSE 209B,A00,108005,Bellare; Mihir,0,0,0,0
1668377810258,CSE 210,A00,113163,Coblenz; Michael J,0,0,0,0
1668377810681,CSE 219,A00,106111,Dow; Steven P,0,0,20,20
1668377811104,CSE 221,A00,102376,Voelker; Geoffrey M.,0,0,0,0
1668377811528,CSE 224,A01,102378,Porter; George M,0,0,0,0
1668377811952,CSE 229A,A00,102379,Savage; Stefan,0,0,0,0
1668377812378,CSE 229C,A00,102380,Munyaka; Imani N. S.,0,0,0,0
1668377812805,CSE 232B,A00,102382,Deutsch; Alin Bernard,0,0,0,0
1668377813231,CSE 234,A01,112904,Kumar; Arun Kumar,0,0,0,0
1668377813654,CSE 237A,A00,102383,Rosing; Tajana Simunic,0,0,0,0
1668377814086,CSE 239A,A00,102384,Deutsch; Alin Bernard,0,0,0,0
1668377814526,CSE 239B,A00,102385,Polikarpova; Nadezhda,0,0,0,0
1668377814962,CSE 240A,A00,102386,Pannuto; Patrick William,0,0,0,0
1668377815395,CSE 240B,A00,102387,Zhao; Jishen,0,0,0,0
1668377815820,CSE 241A,A00,106406,Kang; Mingu,0,0,0,0
1668377816243,CSE 249B,A00,102388,Kahng; Andrew Byun,0,0,8,8
1668377816671,CSE 251B,A01,102392,Cottrell; Garrison W,0,0,0,0
1668377816671,CSE 251B,A02,102393,Cottrell; Garrison W,0,0,0,0
1668377817107,CSE 252B,A00,102394,Ochoa; Benjamin Lawrence,0,0,0,0
1668377817532,CSE 257,A01,102396,Gao; Sicun,0,0,0,0
1668377817954,CSE 272,A00,102397,Li; Tzumao,0,0,0,0
1668377818378,CSE 274,A00,111323,Chern; Albert Ren-Haur,0,0,0,0
1668377818802,CSE 282,A00,102398,Pevzner; Pavel Arkadjevich,0,0,0,0
1668377819227,CSE 284,A00,114175,Gymrek; Melissa Ann,0,0,0,0
1668377819656,CSE 290,A00,102399,Chandraker; Manmohan Krishna,0,0,0,0
1668377819656,CSE 290,B00,102400,Vaccaro; Kristen Marie,0,0,25,25
1668377819656,CSE 290,C00,102414,Pannuto; Patrick William,0,0,25,25
1668377819656,CSE 290,D00,102427,Pevzner; Pavel Arkadjevich,0,0,0,0
1668377819656,CSE 290,E00,102429,Zhao; Jishen,0,0,0,0
1668377819656,CSE 290,F00,102436,Tullsen; Dean Michael,0,0,0,0
1668377819656,CSE 290,G00,102440,Christensen; Henrik I,0,0,20,20
1668377820086,CSE 291,A00,102443,Su; Hao,0,0,0,0
1668377820086,CSE 291,B00,102448,Polikarpova; Nadezhda,0,0,0,0
1668377820086,CSE 291,C00,102453,Vaccaro; Kristen Marie,0,0,0,0
1668377820086,CSE 291,D00,111343,Savage; Stefan,0,0,0,0
1668377820086,CSE 291,E00,116474,Claffy; Kimberly Claire,0,0,0,0
1668377820086,CSE 291,F00,116479,Pasquale; Joseph,0,0,0,0
1668377820533,CSE 293,001,119111,Bafna; Vineet,9999,0,9999,0
1668377820533,CSE 293,002,119118,Bellare; Mihir,9999,0,9999,0
1668377820533,CSE 293,003,119122,Berg-Kirkpatrick; Taylor D,9999,0,9999,0
1668377820533,CSE 293,004,119135,Christensen; Henrik I,9999,0,9999,0
1668377820533,CSE 293,005,119142,Cottrell; Garrison W,9999,0,9999,0
1668377820533,CSE 293,006,119146,Deutsch; Alin Bernard,9999,0,9999,0
1668377820533,CSE 293,007,119159,Esmaeilzadeh; Hadi,9999,0,9999,0
1668377820533,CSE 293,008,119166,Freund; Yoav,9999,0,9999,0
1668377820533,CSE 293,009,119170,Griswold; William G.,9999,0,9999,0
1668377820533,CSE 293,010,119183,Gymrek; Melissa Ann,9999,0,9999,0
1668377820533,CSE 293,011,119190,Heninger; Nadia A,9999,0,9999,0
1668377820533,CSE 293,012,119230,Impagliazzo; Russell,9999,0,9999,0
1668377820533,CSE 293,013,119232,Jhala; Ranjit,9999,0,9999,0
1668377820533,CSE 293,014,119233,Kahng; Andrew Byun,9999,0,9999,0
1668377820533,CSE 293,015,119298,Kane; Daniel Mertz,9999,0,9999,0
1668377820533,CSE 293,016,119299,Kriegman; David J,9999,0,9999,0
1668377820533,CSE 293,017,119300,Kumar; Arun Kumar,9999,0,9999,0
1668377820533,CSE 293,018,119301,Lerner; Sorin,9999,0,9999,0
1668377820533,CSE 293,019,119302,Lovett; Shachar,9999,0,9999,0
1668377820533,CSE 293,020,119303,McAuley; Julian John,9999,0,9999,0
1668377820533,CSE 293,021,119304,Micciancio; Daniele,9999,0,9999,0
1668377820533,CSE 293,022,119367,Orailoglu; Alex,9999,0,9999,0
1668377820533,CSE 293,023,119382,Paturi; Ramamohan,9999,0,9999,0
1668377820533,CSE 293,024,119404,Polikarpova; Nadezhda,9999,0,9999,0
1668377820533,CSE 293,025,119406,Politz; Joseph Gibbs,9999,0,9999,0
1668377820533,CSE 293,026,119411,Porter; George M,9999,0,9999,0
1668377820533,CSE 293,027,119414,Porter; Leonard Emerson,9999,0,9999,0
1668377820533,CSE 293,028,119416,Ramamoorthi; Ravi,9999,0,9999,0
1668377820533,CSE 293,029,119417,Sahoo; Debashis,9999,0,9999,0
1668377820533,CSE 293,030,119420,Saul; Lawrence,9999,0,9999,0
1668377820533,CSE 293,031,119421,Savage; Stefan,9999,0,9999,0
1668377820533,CSE 293,032,119425,Schulze; Jurgen P.,9999,0,9999,0
1668377820533,CSE 293,033,119426,Snoeren; Alex C.,9999,0,9999,0
1668377820533,CSE 293,034,119428,Shang; Jingbo,9999,0,9999,0
1668377820533,CSE 293,035,119430,Stefan; Deian,9999,0,9999,0
1668377820533,CSE 293,036,119431,Su; Hao,9999,0,9999,0
1668377820533,CSE 293,037,119433,Swanson; Steven James,9999,0,9999,0
1668377820533,CSE 293,038,119435,Tullsen; Dean Michael,9999,0,9999,0
1668377820533,CSE 293,039,119483,Voelker; Geoffrey M.,9999,0,9999,0
1668377820533,CSE 293,040,119537,Zhao; Jishen,9999,0,9999,0
1668377820533,CSE 293,041,119538,Zhou; Yuan-Yuan,9999,0,9999,0
1668377820533,CSE 293,042,119539,Gao; Sicun,9999,0,9999,0
1668377820533,CSE 293,043,119540,Weibel; Nadir,9999,0,9999,0
1668377820533,CSE 293,044,119541,Gupta; Rajesh K.,9999,0,9999,0
1668377820533,CSE 293,045,126410,Vaccaro; Kristen Marie,9999,0,9999,0
1668377820533,CSE 293,046,126411,Klemke; Richard,9999,0,9999,0
1668377820961,CSE 294,A00,102459,Voelker; Geoffrey M.,0,0,0,0
1668377820961,CSE 294,B00,111322,Orailoglu; Alex,0,0,0,0
1668377821384,DSE 201,A00,096914,Deutsch; Alin Bernard,30,0,30,0
1668377821811,DSE 210,A00,096915,Dasgupta; Sanjoy,30,0,30,0
1668377822235,DSE 260A,A00,096916,Altintas De Callaf; Ilkay,30,0,30,0
1668377822687,ECE 200,001,103586,Antipa; Nicholas A,9999,0,9999,0
1668377822687,ECE 200,002,103587,Atanasov; Nikolay A.,9999,0,9999,0
1668377822687,ECE 200,003,103588,Bharadia; Dinesh,9999,0,9999,0
1668377822687,ECE 200,004,103589,Cheng; Chung Kuan,9999,0,9999,0
1668377822687,ECE 200,005,103590,Cosman; Pamela C.,9999,0,9999,0
1668377822687,ECE 200,006,103591,Dayeh; Shadi Ahmad,9999,0,9999,0
1668377822687,ECE 200,007,103592,Fainman; Yeshaiahu,9999,0,9999,0
1668377822687,ECE 200,008,103593,Ford; Joseph Earl,9999,0,9999,0
1668377822687,ECE 200,009,103594,Franceschetti; Massimo,9999,0,9999,0
1668377822687,ECE 200,010,103595,Fullerton; Eric E,9999,0,9999,0
1668377822687,ECE 200,011,103596,Galton; Ian A,9999,0,9999,0
1668377822687,ECE 200,012,103597,Gilja; Vikash,9999,0,9999,0
1668377822687,ECE 200,013,103598,Hall; Drew A.,9999,0,9999,0
1668377822687,ECE 200,014,103599,Hsueh; Tzu-Chien,9999,0,9999,0
1668377822687,ECE 200,015,103600,Javidi; Tara,9999,0,9999,0
1668377822687,ECE 200,016,103601,Kahng; Andrew Byun,9999,0,9999,0
1668377822687,ECE 200,017,103602,Kim; Young-Han,9999,0,9999,0
1668377822687,ECE 200,018,103603,Koushanfar; Farinaz,9999,0,9999,0
1668377822687,ECE 200,019,103604,Kuzum; Duygu,9999,0,9999,0
1668377822687,ECE 200,020,103605,Le; Hanh-Phuc,9999,0,9999,0
1668377822687,ECE 200,021,103606,Lin; Bill,9999,0,9999,0
1668377822687,ECE 200,022,103607,Liu; Zhaowei,9998,0,9999,1
1668377822687,ECE 200,023,103608,Lo; Yu-Hwa,9999,0,9999,0
1668377822687,ECE 200,024,103609,Lomakin; Vitaliy,9999,0,9999,0
1668377822687,ECE 200,025,103610,Mercier; Patrick Philip,9999,0,9999,0
1668377822687,ECE 200,026,103611,Meyer; Florian,9999,0,9999,0
1668377822687,ECE 200,027,103612,Milstein; Laurence B.,9999,0,9999,0
1668377822687,ECE 200,028,103613,Mir Arabbaygi; Siavash,9999,0,9999,0
1668377822687,ECE 200,029,103614,Mookherjea; Shayan,9999,0,9999,0
1668377822687,ECE 200,030,103615,Morris; Karcher William,9999,0,9999,0
1668377822687,ECE 200,031,103616,Ng; Tse Nga,9999,0,9999,0
1668377822687,ECE 200,032,103617,Nguyen; Truong Quang,9999,0,9999,0
1668377822687,ECE 200,033,103618,Nomura; Kenji,9999,0,9999,0
1668377822687,ECE 200,034,103619,Orlitsky; Alon,9999,0,9999,0
1668377822687,ECE 200,035,103620,Pal; Piya,9999,0,9999,0
1668377822687,ECE 200,036,103621,Papen; George C.,9999,0,9999,0
1668377822687,ECE 200,037,103622,Radic; Stojan,9999,0,9999,0
1668377822687,ECE 200,038,103623,Rao; Bhaskar D.,9999,0,9999,0
1668377822687,ECE 200,039,103624,Rao; Ramesh R,9999,0,9999,0
1668377822687,ECE 200,040,103625,Rebeiz; Gabriel,9999,0,9999,0
1668377822687,ECE 200,041,103626,Sanford; John R,9999,0,9999,0
1668377822687,ECE 200,042,103627,Siegel; Paul H.,9999,0,9999,0
1668377822687,ECE 200,043,103628,Sievenpiper; Daniel F.,9999,0,9999,0
1668377822687,ECE 200,044,103629,Sworder; David D.,9999,0,9999,0
1668377822687,ECE 200,045,103630,Taur; Yuan,9999,0,9999,0
1668377822687,ECE 200,046,103631,Touri; Behrouz,9999,0,9999,0
1668377822687,ECE 200,047,103632,Trivedi; Mohan M.,9999,0,9999,0
1668377822687,ECE 200,048,103633,Vasconcelos; Nuno,9999,0,9999,0
1668377822687,ECE 200,049,103634,Wang; Xiaolong,9999,0,9999,0
1668377822687,ECE 200,050,103635,Xie; Pengtao,9999,0,9999,0
1668377822687,ECE 200,051,103636,Yip; Michael,9999,0,9999,0
1668377822687,ECE 200,052,103637,Zeger; Kenneth A.,999,0,999,0
1668377822687,ECE 200,053,103638,Zhang; Xinyu,9999,0,9999,0
1668377822687,ECE 200,054,103639,Turakhia; Yatish Girish,9999,0,9999,0
1668377822687,ECE 200,055,103640,Kang; Mingu,9999,0,9999,0
1668377822687,ECE 200,056,103641,Shi; Yuanyuan,9999,0,9999,0
1668377822687,ECE 200,057,103642,Wang; Edward Jay,9999,0,9999,0
1668377822687,ECE 200,058,103643,Zheng; Yang,9999,0,9999,0
1668377823119,ECE 202,A00,103644,Kuzum; Duygu,0,0,0,0
1668377823549,ECE 212BN,A00,103646,Ng; Tse Nga,0,0,0,0
1668377823975,ECE 221,A00,111493,Staff,0,0,0,0
1668377824401,ECE 222B,A00,103647,Lomakin; Vitaliy,0,0,0,0
1668377824828,ECE 230B,A00,103648,Taur; Yuan,0,0,0,0
1668377825255,ECE 238B,A00,103649,Garay; Javier,0,0,0,0
1668377825791,ECE 240B,A00,112900,Fainman; Yeshaiahu,0,0,0,0
1668377826218,ECE 247A,A00,103650,Jokerst; Jesse Vincent,0,0,0,0
1668377826645,ECE 247B,A00,103651,Wang; Joseph,0,0,0,0
1668377827072,ECE 250,A00,103652,Siegel; Paul H.,0,0,0,0
1668377827496,ECE 251A,A00,103654,Rao; Bhaskar D.,0,0,0,0
1668377827920,ECE 257B,A00,103655,Bharadia; Dinesh,0,0,0,0
1668377828343,ECE 258A,A00,103656,Milstein; Laurence B.,0,0,0,0
1668377828769,ECE 260B,A00,103658,Kang; Mingu,0,0,0,0
1668377829192,ECE 264A,A00,103659,Galton; Ian A,0,0,0,0
1668377829616,ECE 265A,A00,103661,Gudem; Prasad S.S.,0,0,0,0
1668377830042,ECE 265D,A00,103662,Gudem; Prasad S.S.,0,0,0,0
1668377830469,ECE 268,A00,103663,Koushanfar; Farinaz,0,0,0,0
1668377830892,ECE 269,A01,103665,Pal; Piya,0,0,0,0
1668377831319,ECE 271B,A00,103666,Vasconcelos; Manuela,0,0,0,0
1668377831742,ECE 276A,A00,103667,Atanasov; Nikolay A.,0,0,0,0
1668377832169,ECE 277,A00,103668,An; Cheolhong,0,0,0,0
1668377832596,ECE 279,A00,117947,Hall; Drew A.,0,0,0,0
1668377833467,ECE 283,A00,103670,Hsueh; Tzu-Chien,0,0,0,0
1668377833891,ECE 284,A00,103671,Turakhia; Yatish Girish,0,0,0,0
1668377834316,ECE 285,A00,103672,Zheng; Yang,0,0,0,0
1668377834316,ECE 285,B00,103673,Sworder; David D.,0,0,0,0
1668377834748,ECE 287,A00,103676,Javidi; Tara,0,0,0,0
1668377835174,MATH 200B,A00,098023,Salehi Golsefidy; Alireza,12,0,15,3
1668377835598,MATH 202B,A00,098024,Rhoades; Brendon Patrick,9,0,15,6
1668377836025,MATH 203B,A00,098025,Oprea; Dragos N.,10,0,15,5
1668377836449,MATH 204B,A00,098026,Sorensen; Claus M,13,0,15,2
1668377836885,MATH 208,A00,098027,Izadi; Elham,7,0,10,3
1668377837311,MATH 209,A00,098028,Pollack; Aaron,10,0,10,0
1668377837734,MATH 211A,A00,112919,Rogalski; Daniel,9,0,10,1
1668377838158,MATH 211B,A00,112920,Seward; Brandon M.,9,0,10,1
1668377838582,MATH 218,A00,098029,Li; Bo,10,0,10,0
1668377839006,MATH 220B,A00,098030,Novak; Jonathan I,11,0,15,4
1668377839431,MATH 221A,A00,098031,Ebenfelt; Peter F,13,0,15,2
1668377839855,MATH 231B,A00,098032,Zlatos; Andrej,12,0,15,3
1668377840282,MATH 240B,A00,098033,Ni; Lei,9,0,15,6
1668377840708,MATH 243,A00,098034,Jekel; David Andrew,10,0,10,0
1668377841138,MATH 245A,A00,098035,Nie; Jiawang,0,0,15,16
1668377841574,MATH 248,A00,098036,Bejenaru; Ioan,10,0,10,0
1668377842000,MATH 250B,A00,098037,Spolaor; Luca,14,0,15,1
1668377842424,MATH 258,A00,098038,Ni; Lei,10,0,10,0
1668377842850,MATH 264B,A00,098041,Rhoades; Brendon Patrick,9,0,15,6
1668377843274,MATH 268,A00,098042,Buss; Samuel R,10,0,10,0
1668377843700,MATH 269,A00,098043,Rhoades; Brendon Patrick,10,0,10,0
1668377844125,MATH 270B,A00,098044,Li; Bo,10,0,15,5
1668377844549,MATH 272B,A00,098045,Holst; Michael J,13,0,15,2
1668377844982,MATH 273A,A00,098046,Tian; Xiaochuan,10,0,15,5
1668377845409,MATH 275,A01,098048,Tian; Xiaochuan,6,0,10,4
1668377845833,MATH 278A,A00,098049,Holst; Michael J,8,0,10,2
1668377846258,MATH 278B,A00,098050,Cloninger; Alexander,10,0,10,0
1668377846681,MATH 278C,A00,098051,Nie; Jiawang,7,0,10,3
1668377847106,MATH 280B,A00,098052,Zheng; Tianyi,8,0,15,7
1668377847530,MATH 281B,A00,098053,Bradic; Jelena,1,0,15,14
1668377847953,MATH 282B,A00,098054,Arias-Castro; Ery,0,0,15,15
1668377848379,MATH 285,A00,098055,Fitzsimmons; Patrick J,0,0,15,17
1668377848812,MATH 287B,A00,098056,Arias-Castro; Ery,2,0,15,13
1668377849244,MATH 288,A00,098057,Agarwal; Pooja,9,0,10,1
1668377849244,MATH 288,B00,098058,Zhang; Danna,8,0,10,2
1668377849244,MATH 288,C00,098059,Williams; Ruth J,9,0,10,1
1668377849671,MATH 290B,A00,098060,Roberts; Justin Deritter,13,0,15,2
1668377850095,MATH 292,A00,098061,Belmont; Eva Kinoshita,10,0,10,0
1668377850525,MATH 295,A00,098062,Suk; Andrew Hoon,48,0,50,2
1668377850950,MATH 296,A00,098063,Novak; Jonathan I,20,0,20,0
1668377851373,MATH 297,001,098064,Gamst; Anthony Collins,9997,0,9999,2
1668378354605,COGS 205,A00,101395,Chiba; Andrea,19,0,20,1
1668378355029,COGS 210B,001,101404,Greene; Deanna Jacquelyn,9998,0,9999,1
1668378355029,COGS 210B,002,101417,Xia; Haijun,9999,0,9999,0
1668378355029,COGS 210B,003,101422,Nitz; Douglas A.,9999,0,9999,0
1668378355029,COGS 210B,004,101423,Hollan; James D.,9998,0,9999,1
1668378355029,COGS 210B,005,101424,Deak; Gedeon O.,9998,0,9999,1
1668378355029,COGS 210B,006,101425,Rossano; Federico,9999,0,9999,0
1668378355452,COGS 211B,A00,101427,Coulson; Seana M,9996,0,9999,3
1668378355877,COGS 220,A00,101428,Hollan; James D.,0,0,25,25
1668378356302,COGS 229,A00,101429,Dow; Steven P,18,0,25,7
1668378356728,COGS 230,A00,101430,Klemmer; Scott R,11,0,17,6
1668378357154,COGS 234,A00,101431,Xia; Haijun,1,0,25,24
1668378357578,COGS 260,A00,101432,Kiyonaga; Anastasia,21,0,25,4
1668378357578,COGS 260,B00,101433,Kirsh; David Joel,15,0,25,10
1668378358009,CSE 202,A00,102371,Impagliazzo; Russell,0,0,0,0
1668378358443,CSE 203B,A01,102373,Cheng; Chung Kuan,0,0,0,0
1668378358876,CSE 208,A00,102374,Micciancio; Daniele,0,0,0,0
1668378359320,CSE 209A,A00,112895,Impagliazzo; Russell,0,0,15,15
1668378359741,CSE 209B,A00,108005,Bellare; Mihir,0,0,0,0
1668378360165,CSE 210,A00,113163,Coblenz; Michael J,0,0,0,0
1668378360590,CSE 219,A00,106111,Dow; Steven P,0,0,20,20
1668378361016,CSE 221,A00,102376,Voelker; Geoffrey M.,0,0,0,0
1668378361438,CSE 224,A01,102378,Porter; George M,0,0,0,0
1668378361878,CSE 229A,A00,102379,Savage; Stefan,0,0,0,0
1668378362304,CSE 229C,A00,102380,Munyaka; Imani N. S.,0,0,0,0
1668378362727,CSE 232B,A00,102382,Deutsch; Alin Bernard,0,0,0,0
1668378363153,CSE 234,A01,112904,Kumar; Arun Kumar,0,0,0,0
1668378363577,CSE 237A,A00,102383,Rosing; Tajana Simunic,0,0,0,0
1668378364001,CSE 239A,A00,102384,Deutsch; Alin Bernard,0,0,0,0
1668378364425,CSE 239B,A00,102385,Polikarpova; Nadezhda,0,0,0,0
1668378364850,CSE 240A,A00,102386,Pannuto; Patrick William,0,0,0,0
1668378365283,CSE 240B,A00,102387,Zhao; Jishen,0,0,0,0
1668378365707,CSE 241A,A00,106406,Kang; Mingu,0,0,0,0
1668378366137,CSE 249B,A00,102388,Kahng; Andrew Byun,0,0,8,8
1668378366569,CSE 251B,A01,102392,Cottrell; Garrison W,0,0,0,0
1668378366569,CSE 251B,A02,102393,Cottrell; Garrison W,0,0,0,0
1668378366994,CSE 252B,A00,102394,Ochoa; Benjamin Lawrence,0,0,0,0
1668378367419,CSE 257,A01,102396,Gao; Sicun,0,0,0,0
1668378367843,CSE 272,A00,102397,Li; Tzumao,0,0,0,0
1668378368268,CSE 274,A00,111323,Chern; Albert Ren-Haur,0,0,0,0
1668378368706,CSE 282,A00,102398,Pevzner; Pavel Arkadjevich,0,0,0,0
1668378369129,CSE 284,A00,114175,Gymrek; Melissa Ann,0,0,0,0
1668378369553,CSE 290,A00,102399,Chandraker; Manmohan Krishna,0,0,0,0
1668378369553,CSE 290,B00,102400,Vaccaro; Kristen Marie,0,0,25,25
1668378369553,CSE 290,C00,102414,Pannuto; Patrick William,0,0,25,25
1668378369553,CSE 290,D00,102427,Pevzner; Pavel Arkadjevich,0,0,0,0
1668378369553,CSE 290,E00,102429,Zhao; Jishen,0,0,0,0
1668378369553,CSE 290,F00,102436,Tullsen; Dean Michael,0,0,0,0
1668378369553,CSE 290,G00,102440,Christensen; Henrik I,0,0,20,20
1668378369978,CSE 291,A00,102443,Su; Hao,0,0,0,0
1668378369978,CSE 291,B00,102448,Polikarpova; Nadezhda,0,0,0,0
1668378369978,CSE 291,C00,102453,Vaccaro; Kristen Marie,0,0,0,0
1668378369978,CSE 291,D00,111343,Savage; Stefan,0,0,0,0
1668378369978,CSE 291,E00,116474,Claffy; Kimberly Claire,0,0,0,0
1668378369978,CSE 291,F00,116479,Pasquale; Joseph,0,0,0,0
1668378370413,CSE 293,001,119111,Bafna; Vineet,9999,0,9999,0
1668378370413,CSE 293,002,119118,Bellare; Mihir,9999,0,9999,0
1668378370413,CSE 293,003,119122,Berg-Kirkpatrick; Taylor D,9999,0,9999,0
1668378370413,CSE 293,004,119135,Christensen; Henrik I,9999,0,9999,0
1668378370413,CSE 293,005,119142,Cottrell; Garrison W,9999,0,9999,0
1668378370413,CSE 293,006,119146,Deutsch; Alin Bernard,9999,0,9999,0
1668378370413,CSE 293,007,119159,Esmaeilzadeh; Hadi,9999,0,9999,0
1668378370413,CSE 293,008,119166,Freund; Yoav,9999,0,9999,0
1668378370413,CSE 293,009,119170,Griswold; William G.,9999,0,9999,0
1668378370413,CSE 293,010,119183,Gymrek; Melissa Ann,9999,0,9999,0
1668378370413,CSE 293,011,119190,Heninger; Nadia A,9999,0,9999,0
1668378370413,CSE 293,012,119230,Impagliazzo; Russell,9999,0,9999,0
1668378370413,CSE 293,013,119232,Jhala; Ranjit,9999,0,9999,0
1668378370413,CSE 293,014,119233,Kahng; Andrew Byun,9999,0,9999,0
1668378370413,CSE 293,015,119298,Kane; Daniel Mertz,9999,0,9999,0
1668378370413,CSE 293,016,119299,Kriegman; David J,9999,0,9999,0
1668378370413,CSE 293,017,119300,Kumar; Arun Kumar,9999,0,9999,0
1668378370413,CSE 293,018,119301,Lerner; Sorin,9999,0,9999,0
1668378370413,CSE 293,019,119302,Lovett; Shachar,9999,0,9999,0
1668378370413,CSE 293,020,119303,McAuley; Julian John,9999,0,9999,0
1668378370413,CSE 293,021,119304,Micciancio; Daniele,9999,0,9999,0
1668378370413,CSE 293,022,119367,Orailoglu; Alex,9999,0,9999,0
1668378370413,CSE 293,023,119382,Paturi; Ramamohan,9999,0,9999,0
1668378370413,CSE 293,024,119404,Polikarpova; Nadezhda,9999,0,9999,0
1668378370413,CSE 293,025,119406,Politz; Joseph Gibbs,9999,0,9999,0
1668378370413,CSE 293,026,119411,Porter; George M,9999,0,9999,0
1668378370413,CSE 293,027,119414,Porter; Leonard Emerson,9999,0,9999,0
1668378370413,CSE 293,028,119416,Ramamoorthi; Ravi,9999,0,9999,0
1668378370413,CSE 293,029,119417,Sahoo; Debashis,9999,0,9999,0
1668378370413,CSE 293,030,119420,Saul; Lawrence,9999,0,9999,0
1668378370413,CSE 293,031,119421,Savage; Stefan,9999,0,9999,0
1668378370413,CSE 293,032,119425,Schulze; Jurgen P.,9999,0,9999,0
1668378370413,CSE 293,033,119426,Snoeren; Alex C.,9999,0,9999,0
1668378370413,CSE 293,034,119428,Shang; Jingbo,9999,0,9999,0
1668378370413,CSE 293,035,119430,Stefan; Deian,9999,0,9999,0
1668378370413,CSE 293,036,119431,Su; Hao,9999,0,9999,0
1668378370413,CSE 293,037,119433,Swanson; Steven James,9999,0,9999,0
1668378370413,CSE 293,038,119435,Tullsen; Dean Michael,9999,0,9999,0
1668378370413,CSE 293,039,119483,Voelker; Geoffrey M.,9999,0,9999,0
1668378370413,CSE 293,040,119537,Zhao; Jishen,9999,0,9999,0
1668378370413,CSE 293,041,119538,Zhou; Yuan-Yuan,9999,0,9999,0
1668378370413,CSE 293,042,119539,Gao; Sicun,9999,0,9999,0
1668378370413,CSE 293,043,119540,Weibel; Nadir,9999,0,9999,0
1668378370413,CSE 293,044,119541,Gupta; Rajesh K.,9999,0,9999,0
1668378370413,CSE 293,045,126410,Vaccaro; Kristen Marie,9999,0,9999,0
1668378370413,CSE 293,046,126411,Klemke; Richard,9999,0,9999,0
1668378370837,CSE 294,A00,102459,Voelker; Geoffrey M.,0,0,0,0
1668378370837,CSE 294,B00,111322,Orailoglu; Alex,0,0,0,0
1668378371261,DSE 201,A00,096914,Deutsch; Alin Bernard,30,0,30,0
1668378371687,DSE 210,A00,096915,Dasgupta; Sanjoy,30,0,30,0
1668378372125,DSE 260A,A00,096916,Altintas De Callaf; Ilkay,30,0,30,0
1668378372554,ECE 200,001,103586,Antipa; Nicholas A,9999,0,9999,0
1668378372554,ECE 200,002,103587,Atanasov; Nikolay A.,9999,0,9999,0
1668378372554,ECE 200,003,103588,Bharadia; Dinesh,9999,0,9999,0
1668378372554,ECE 200,004,103589,Cheng; Chung Kuan,9999,0,9999,0
1668378372554,ECE 200,005,103590,Cosman; Pamela C.,9999,0,9999,0
1668378372554,ECE 200,006,103591,Dayeh; Shadi Ahmad,9999,0,9999,0
1668378372554,ECE 200,007,103592,Fainman; Yeshaiahu,9999,0,9999,0
1668378372554,ECE 200,008,103593,Ford; Joseph Earl,9999,0,9999,0
1668378372554,ECE 200,009,103594,Franceschetti; Massimo,9999,0,9999,0
1668378372554,ECE 200,010,103595,Fullerton; Eric E,9999,0,9999,0
1668378372554,ECE 200,011,103596,Galton; Ian A,9999,0,9999,0
1668378372554,ECE 200,012,103597,Gilja; Vikash,9999,0,9999,0
1668378372554,ECE 200,013,103598,Hall; Drew A.,9999,0,9999,0
1668378372554,ECE 200,014,103599,Hsueh; Tzu-Chien,9999,0,9999,0
1668378372554,ECE 200,015,103600,Javidi; Tara,9999,0,9999,0
1668378372554,ECE 200,016,103601,Kahng; Andrew Byun,9999,0,9999,0
1668378372554,ECE 200,017,103602,Kim; Young-Han,9999,0,9999,0
1668378372554,ECE 200,018,103603,Koushanfar; Farinaz,9999,0,9999,0
1668378372554,ECE 200,019,103604,Kuzum; Duygu,9999,0,9999,0
1668378372554,ECE 200,020,103605,Le; Hanh-Phuc,9999,0,9999,0
1668378372554,ECE 200,021,103606,Lin; Bill,9999,0,9999,0
1668378372554,ECE 200,022,103607,Liu; Zhaowei,9998,0,9999,1
1668378372554,ECE 200,023,103608,Lo; Yu-Hwa,9999,0,9999,0
1668378372554,ECE 200,024,103609,Lomakin; Vitaliy,9999,0,9999,0
1668378372554,ECE 200,025,103610,Mercier; Patrick Philip,9999,0,9999,0
1668378372554,ECE 200,026,103611,Meyer; Florian,9999,0,9999,0
1668378372554,ECE 200,027,103612,Milstein; Laurence B.,9999,0,9999,0
1668378372554,ECE 200,028,103613,Mir Arabbaygi; Siavash,9999,0,9999,0
1668378372554,ECE 200,029,103614,Mookherjea; Shayan,9999,0,9999,0
1668378372554,ECE 200,030,103615,Morris; Karcher William,9999,0,9999,0
1668378372554,ECE 200,031,103616,Ng; Tse Nga,9999,0,9999,0
1668378372554,ECE 200,032,103617,Nguyen; Truong Quang,9999,0,9999,0
1668378372554,ECE 200,033,103618,Nomura; Kenji,9999,0,9999,0
1668378372554,ECE 200,034,103619,Orlitsky; Alon,9999,0,9999,0
1668378372554,ECE 200,035,103620,Pal; Piya,9999,0,9999,0
1668378372554,ECE 200,036,103621,Papen; George C.,9999,0,9999,0
1668378372554,ECE 200,037,103622,Radic; Stojan,9999,0,9999,0
1668378372554,ECE 200,038,103623,Rao; Bhaskar D.,9999,0,9999,0
1668378372554,ECE 200,039,103624,Rao; Ramesh R,9999,0,9999,0
1668378372554,ECE 200,040,103625,Rebeiz; Gabriel,9999,0,9999,0
1668378372554,ECE 200,041,103626,Sanford; John R,9999,0,9999,0
1668378372554,ECE 200,042,103627,Siegel; Paul H.,9999,0,9999,0
1668378372554,ECE 200,043,103628,Sievenpiper; Daniel F.,9999,0,9999,0
1668378372554,ECE 200,044,103629,Sworder; David D.,9999,0,9999,0
1668378372554,ECE 200,045,103630,Taur; Yuan,9999,0,9999,0
1668378372554,ECE 200,046,103631,Touri; Behrouz,9999,0,9999,0
1668378372554,ECE 200,047,103632,Trivedi; Mohan M.,9999,0,9999,0
1668378372554,ECE 200,048,103633,Vasconcelos; Nuno,9999,0,9999,0
1668378372554,ECE 200,049,103634,Wang; Xiaolong,9999,0,9999,0
1668378372554,ECE 200,050,103635,Xie; Pengtao,9999,0,9999,0
1668378372554,ECE 200,051,103636,Yip; Michael,9999,0,9999,0
1668378372554,ECE 200,052,103637,Zeger; Kenneth A.,999,0,999,0
1668378372554,ECE 200,053,103638,Zhang; Xinyu,9999,0,9999,0
1668378372554,ECE 200,054,103639,Turakhia; Yatish Girish,9999,0,9999,0
1668378372554,ECE 200,055,103640,Kang; Mingu,9999,0,9999,0
1668378372554,ECE 200,056,103641,Shi; Yuanyuan,9999,0,9999,0
1668378372554,ECE 200,057,103642,Wang; Edward Jay,9999,0,9999,0
1668378372554,ECE 200,058,103643,Zheng; Yang,9999,0,9999,0
1668378372980,ECE 202,A00,103644,Kuzum; Duygu,0,0,0,0
1668378373404,ECE 212BN,A00,103646,Ng; Tse Nga,0,0,0,0
1668378373829,ECE 221,A00,111493,Staff,0,0,0,0
1668378374251,ECE 222B,A00,103647,Lomakin; Vitaliy,0,0,0,0
1668378374675,ECE 230B,A00,103648,Taur; Yuan,0,0,0,0
1668378375103,ECE 238B,A00,103649,Garay; Javier,0,0,0,0
1668378375530,ECE 240B,A00,112900,Fainman; Yeshaiahu,0,0,0,0
1668378375957,ECE 247A,A00,103650,Jokerst; Jesse Vincent,0,0,0,0
1668378376388,ECE 247B,A00,103651,Wang; Joseph,0,0,0,0
1668378376816,ECE 250,A00,103652,Siegel; Paul H.,0,0,0,0
1668378377250,ECE 251A,A00,103654,Rao; Bhaskar D.,0,0,0,0
1668378377684,ECE 257B,A00,103655,Bharadia; Dinesh,0,0,0,0
1668378378118,ECE 258A,A00,103656,Milstein; Laurence B.,0,0,0,0
1668378378541,ECE 260B,A00,103658,Kang; Mingu,0,0,0,0
1668378378966,ECE 264A,A00,103659,Galton; Ian A,0,0,0,0
1668378379388,ECE 265A,A00,103661,Gudem; Prasad S.S.,0,0,0,0
1668378379812,ECE 265D,A00,103662,Gudem; Prasad S.S.,0,0,0,0
1668378380246,ECE 268,A00,103663,Koushanfar; Farinaz,0,0,0,0
1668378380686,ECE 269,A01,103665,Pal; Piya,0,0,0,0
1668378381119,ECE 271B,A00,103666,Vasconcelos; Manuela,0,0,0,0
1668378381546,ECE 276A,A00,103667,Atanasov; Nikolay A.,0,0,0,0
1668378381981,ECE 277,A00,103668,An; Cheolhong,0,0,0,0
1668378382406,ECE 279,A00,117947,Hall; Drew A.,0,0,0,0
1668378383263,ECE 283,A00,103670,Hsueh; Tzu-Chien,0,0,0,0
1668378383687,ECE 284,A00,103671,Turakhia; Yatish Girish,0,0,0,0
1668378384111,ECE 285,A00,103672,Zheng; Yang,0,0,0,0
1668378384111,ECE 285,B00,103673,Sworder; David D.,0,0,0,0
1668378384535,ECE 287,A00,103676,Javidi; Tara,0,0,0,0
1668378384959,MATH 200B,A00,098023,Salehi Golsefidy; Alireza,12,0,15,3
1668378385382,MATH 202B,A00,098024,Rhoades; Brendon Patrick,9,0,15,6
1668378385807,MATH 203B,A00,098025,Oprea; Dragos N.,10,0,15,5
1668378386230,MATH 204B,A00,098026,Sorensen; Claus M,13,0,15,2
1668378386656,MATH 208,A00,098027,Izadi; Elham,7,0,10,3
1668378387082,MATH 209,A00,098028,Pollack; Aaron,10,0,10,0
1668378387508,MATH 211A,A00,112919,Rogalski; Daniel,9,0,10,1
1668378387946,MATH 211B,A00,112920,Seward; Brandon M.,9,0,10,1
1668378388370,MATH 218,A00,098029,Li; Bo,10,0,10,0
1668378388797,MATH 220B,A00,098030,Novak; Jonathan I,11,0,15,4
1668378389220,MATH 221A,A00,098031,Ebenfelt; Peter F,13,0,15,2
1668378389660,MATH 231B,A00,098032,Zlatos; Andrej,12,0,15,3
1668378390101,MATH 240B,A00,098033,Ni; Lei,9,0,15,6
1668378390529,MATH 243,A00,098034,Jekel; David Andrew,10,0,10,0
1668378390954,MATH 245A,A00,098035,Nie; Jiawang,0,0,15,16
1668378391378,MATH 248,A00,098036,Bejenaru; Ioan,10,0,10,0
1668378391804,MATH 250B,A00,098037,Spolaor; Luca,14,0,15,1
1668378392321,MATH 258,A00,098038,Ni; Lei,10,0,10,0
1668378392747,MATH 264B,A00,098041,Rhoades; Brendon Patrick,9,0,15,6
1668378393173,MATH 268,A00,098042,Buss; Samuel R,10,0,10,0
1668378393599,MATH 269,A00,098043,Rhoades; Brendon Patrick,10,0,10,0
1668378394023,MATH 270B,A00,098044,Li; Bo,10,0,15,5
1668378394448,MATH 272B,A00,098045,Holst; Michael J,13,0,15,2
1668378394878,MATH 273A,A00,098046,Tian; Xiaochuan,10,0,15,5
1668378395308,MATH 275,A01,098048,Tian; Xiaochuan,6,0,10,4
1668378395732,MATH 278A,A00,098049,Holst; Michael J,8,0,10,2
1668378396156,MATH 278B,A00,098050,Cloninger; Alexander,10,0,10,0
1668378396589,MATH 278C,A00,098051,Nie; Jiawang,7,0,10,3
1668378397012,MATH 280B,A00,098052,Zheng; Tianyi,8,0,15,7
1668378397436,MATH 281B,A00,098053,Bradic; Jelena,1,0,15,14
1668378397864,MATH 282B,A00,098054,Arias-Castro; Ery,0,0,15,15
1668378398287,MATH 285,A00,098055,Fitzsimmons; Patrick J,0,0,15,17
1668378398709,MATH 287B,A00,098056,Arias-Castro; Ery,2,0,15,13
1668378399144,MATH 288,A00,098057,Agarwal; Pooja,9,0,10,1
1668378399144,MATH 288,B00,098058,Zhang; Danna,8,0,10,2
1668378399144,MATH 288,C00,098059,Williams; Ruth J,9,0,10,1
1668378399570,MATH 290B,A00,098060,Roberts; Justin Deritter,13,0,15,2
1668378399997,MATH 292,A00,098061,Belmont; Eva Kinoshita,10,0,10,0
1668378400434,MATH 295,A00,098062,Suk; Andrew Hoon,48,0,50,2
1668378400856,MATH 296,A00,098063,Novak; Jonathan I,20,0,20,0
1668378401280,MATH 297,001,098064,Gamst; Anthony Collins,9997,0,9999,2
1668378906091,COGS 205,A00,101395,Chiba; Andrea,19,0,20,1
1668378906534,COGS 210B,001,101404,Greene; Deanna Jacquelyn,9998,0,9999,1
1668378906534,COGS 210B,002,101417,Xia; Haijun,9999,0,9999,0
1668378906534,COGS 210B,003,101422,Nitz; Douglas A.,9999,0,9999,0
1668378906534,COGS 210B,004,101423,Hollan; James D.,9998,0,9999,1
1668378906534,COGS 210B,005,101424,Deak; Gedeon O.,9998,0,9999,1
1668378906534,COGS 210B,006,101425,Rossano; Federico,9999,0,9999,0
1668378906966,COGS 211B,A00,101427,Coulson; Seana M,9996,0,9999,3
1668378907389,COGS 220,A00,101428,Hollan; James D.,0,0,25,25
1668378907815,COGS 229,A00,101429,Dow; Steven P,18,0,25,7
1668378908248,COGS 230,A00,101430,Klemmer; Scott R,11,0,17,6
1668378908678,COGS 234,A00,101431,Xia; Haijun,1,0,25,24
1668378909103,COGS 260,A00,101432,Kiyonaga; Anastasia,21,0,25,4
1668378909103,COGS 260,B00,101433,Kirsh; David Joel,15,0,25,10
1668378909528,CSE 202,A00,102371,Impagliazzo; Russell,0,0,0,0
1668378909956,CSE 203B,A01,102373,Cheng; Chung Kuan,0,0,0,0
1668378910378,CSE 208,A00,102374,Micciancio; Daniele,0,0,0,0
1668378910804,CSE 209A,A00,112895,Impagliazzo; Russell,0,0,15,15
1668378911234,CSE 209B,A00,108005,Bellare; Mihir,0,0,0,0
1668378911658,CSE 210,A00,113163,Coblenz; Michael J,0,0,0,0
1668378912092,CSE 219,A00,106111,Dow; Steven P,0,0,20,20
1668378912517,CSE 221,A00,102376,Voelker; Geoffrey M.,0,0,0,0
1668378912941,CSE 224,A01,102378,Porter; George M,0,0,0,0
1668378913363,CSE 229A,A00,102379,Savage; Stefan,0,0,0,0
1668378913790,CSE 229C,A00,102380,Munyaka; Imani N. S.,0,0,0,0
1668378914220,CSE 232B,A00,102382,Deutsch; Alin Bernard,0,0,0,0
1668378914643,CSE 234,A01,112904,Kumar; Arun Kumar,0,0,0,0
1668378915066,CSE 237A,A00,102383,Rosing; Tajana Simunic,0,0,0,0
1668378915490,CSE 239A,A00,102384,Deutsch; Alin Bernard,0,0,0,0
1668378915915,CSE 239B,A00,102385,Polikarpova; Nadezhda,0,0,0,0
1668378916339,CSE 240A,A00,102386,Pannuto; Patrick William,0,0,0,0
1668378916762,CSE 240B,A00,102387,Zhao; Jishen,0,0,0,0
1668378917505,CSE 241A,A00,106406,Kang; Mingu,0,0,0,0
1668378917941,CSE 249B,A00,102388,Kahng; Andrew Byun,0,0,8,8
1668378918364,CSE 251B,A01,102392,Cottrell; Garrison W,0,0,0,0
1668378918364,CSE 251B,A02,102393,Cottrell; Garrison W,0,0,0,0
1668378918790,CSE 252B,A00,102394,Ochoa; Benjamin Lawrence,0,0,0,0
1668378919216,CSE 257,A01,102396,Gao; Sicun,0,0,0,0
1668378919640,CSE 272,A00,102397,Li; Tzumao,0,0,0,0
1668378920066,CSE 274,A00,111323,Chern; Albert Ren-Haur,0,0,0,0
1668378920496,CSE 282,A00,102398,Pevzner; Pavel Arkadjevich,0,0,0,0
1668378920920,CSE 284,A00,114175,Gymrek; Melissa Ann,0,0,0,0
1668378921345,CSE 290,A00,102399,Chandraker; Manmohan Krishna,0,0,0,0
1668378921345,CSE 290,B00,102400,Vaccaro; Kristen Marie,0,0,25,25
1668378921345,CSE 290,C00,102414,Pannuto; Patrick William,0,0,25,25
1668378921345,CSE 290,D00,102427,Pevzner; Pavel Arkadjevich,0,0,0,0
1668378921345,CSE 290,E00,102429,Zhao; Jishen,0,0,0,0
1668378921345,CSE 290,F00,102436,Tullsen; Dean Michael,0,0,0,0
1668378921345,CSE 290,G00,102440,Christensen; Henrik I,0,0,20,20
1668378921770,CSE 291,A00,102443,Su; Hao,0,0,0,0
1668378921770,CSE 291,B00,102448,Polikarpova; Nadezhda,0,0,0,0
1668378921770,CSE 291,C00,102453,Vaccaro; Kristen Marie,0,0,0,0
1668378921770,CSE 291,D00,111343,Savage; Stefan,0,0,0,0
1668378921770,CSE 291,E00,116474,Claffy; Kimberly Claire,0,0,0,0
1668378921770,CSE 291,F00,116479,Pasquale; Joseph,0,0,0,0
1668378922196,CSE 293,001,119111,Bafna; Vineet,9999,0,9999,0
1668378922196,CSE 293,002,119118,Bellare; Mihir,9999,0,9999,0
1668378922196,CSE 293,003,119122,Berg-Kirkpatrick; Taylor D,9999,0,9999,0
1668378922196,CSE 293,004,119135,Christensen; Henrik I,9999,0,9999,0
1668378922196,CSE 293,005,119142,Cottrell; Garrison W,9999,0,9999,0
1668378922196,CSE 293,006,119146,Deutsch; Alin Bernard,9999,0,9999,0
1668378922196,CSE 293,007,119159,Esmaeilzadeh; Hadi,9999,0,9999,0
1668378922196,CSE 293,008,119166,Freund; Yoav,9999,0,9999,0
1668378922196,CSE 293,009,119170,Griswold; William G.,9999,0,9999,0
1668378922196,CSE 293,010,119183,Gymrek; Melissa Ann,9999,0,9999,0
1668378922196,CSE 293,011,119190,Heninger; Nadia A,9999,0,9999,0
1668378922196,CSE 293,012,119230,Impagliazzo; Russell,9999,0,9999,0
1668378922196,CSE 293,013,119232,Jhala; Ranjit,9999,0,9999,0
1668378922196,CSE 293,014,119233,Kahng; Andrew Byun,9999,0,9999,0
1668378922196,CSE 293,015,119298,Kane; Daniel Mertz,9999,0,9999,0
1668378922196,CSE 293,016,119299,Kriegman; David J,9999,0,9999,0
1668378922196,CSE 293,017,119300,Kumar; Arun Kumar,9999,0,9999,0
1668378922196,CSE 293,018,119301,Lerner; Sorin,9999,0,9999,0
1668378922196,CSE 293,019,119302,Lovett; Shachar,9999,0,9999,0
1668378922196,CSE 293,020,119303,McAuley; Julian John,9999,0,9999,0
1668378922196,CSE 293,021,119304,Micciancio; Daniele,9999,0,9999,0
1668378922196,CSE 293,022,119367,Orailoglu; Alex,9999,0,9999,0
1668378922196,CSE 293,023,119382,Paturi; Ramamohan,9999,0,9999,0
1668378922196,CSE 293,024,119404,Polikarpova; Nadezhda,9999,0,9999,0
1668378922196,CSE 293,025,119406,Politz; Joseph Gibbs,9999,0,9999,0
1668378922196,CSE 293,026,119411,Porter; George M,9999,0,9999,0
1668378922196,CSE 293,027,119414,Porter; Leonard Emerson,9999,0,9999,0
1668378922196,CSE 293,028,119416,Ramamoorthi; Ravi,9999,0,9999,0
1668378922196,CSE 293,029,119417,Sahoo; Debashis,9999,0,9999,0
1668378922196,CSE 293,030,119420,Saul; Lawrence,9999,0,9999,0
1668378922196,CSE 293,031,119421,Savage; Stefan,9999,0,9999,0
1668378922196,CSE 293,032,119425,Schulze; Jurgen P.,9999,0,9999,0
1668378922196,CSE 293,033,119426,Snoeren; Alex C.,9999,0,9999,0
1668378922196,CSE 293,034,119428,Shang; Jingbo,9999,0,9999,0
1668378922196,CSE 293,035,119430,Stefan; Deian,9999,0,9999,0
1668378922196,CSE 293,036,119431,Su; Hao,9999,0,9999,0
1668378922196,CSE 293,037,119433,Swanson; Steven James,9999,0,9999,0
1668378922196,CSE 293,038,119435,Tullsen; Dean Michael,9999,0,9999,0
1668378922196,CSE 293,039,119483,Voelker; Geoffrey M.,9999,0,9999,0
1668378922196,CSE 293,040,119537,Zhao; Jishen,9999,0,9999,0
1668378922196,CSE 293,041,119538,Zhou; Yuan-Yuan,9999,0,9999,0
1668378922196,CSE 293,042,119539,Gao; Sicun,9999,0,9999,0
1668378922196,CSE 293,043,119540,Weibel; Nadir,9999,0,9999,0
1668378922196,CSE 293,044,119541,Gupta; Rajesh K.,9999,0,9999,0
1668378922196,CSE 293,045,126410,Vaccaro; Kristen Marie,9999,0,9999,0
1668378922196,CSE 293,046,126411,Klemke; Richard,9999,0,9999,0
1668378922623,CSE 294,A00,102459,Voelker; Geoffrey M.,0,0,0,0
1668378922623,CSE 294,B00,111322,Orailoglu; Alex,0,0,0,0
1668378923046,DSE 201,A00,096914,Deutsch; Alin Bernard,30,0,30,0
1668378923473,DSE 210,A00,096915,Dasgupta; Sanjoy,30,0,30,0
1668378923898,DSE 260A,A00,096916,Altintas De Callaf; Ilkay,30,0,30,0
1668378924357,ECE 200,001,103586,Antipa; Nicholas A,9999,0,9999,0
1668378924357,ECE 200,002,103587,Atanasov; Nikolay A.,9999,0,9999,0
1668378924357,ECE 200,003,103588,Bharadia; Dinesh,9999,0,9999,0
1668378924357,ECE 200,004,103589,Cheng; Chung Kuan,9999,0,9999,0
1668378924357,ECE 200,005,103590,Cosman; Pamela C.,9999,0,9999,0
1668378924357,ECE 200,006,103591,Dayeh; Shadi Ahmad,9999,0,9999,0
1668378924357,ECE 200,007,103592,Fainman; Yeshaiahu,9999,0,9999,0
1668378924357,ECE 200,008,103593,Ford; Joseph Earl,9999,0,9999,0
1668378924357,ECE 200,009,103594,Franceschetti; Massimo,9999,0,9999,0
1668378924357,ECE 200,010,103595,Fullerton; Eric E,9999,0,9999,0
1668378924357,ECE 200,011,103596,Galton; Ian A,9999,0,9999,0
1668378924357,ECE 200,012,103597,Gilja; Vikash,9999,0,9999,0
1668378924357,ECE 200,013,103598,Hall; Drew A.,9999,0,9999,0
1668378924357,ECE 200,014,103599,Hsueh; Tzu-Chien,9999,0,9999,0
1668378924357,ECE 200,015,103600,Javidi; Tara,9999,0,9999,0
1668378924357,ECE 200,016,103601,Kahng; Andrew Byun,9999,0,9999,0
1668378924357,ECE 200,017,103602,Kim; Young-Han,9999,0,9999,0
1668378924357,ECE 200,018,103603,Koushanfar; Farinaz,9999,0,9999,0
1668378924357,ECE 200,019,103604,Kuzum; Duygu,9999,0,9999,0
1668378924357,ECE 200,020,103605,Le; Hanh-Phuc,9999,0,9999,0
1668378924357,ECE 200,021,103606,Lin; Bill,9999,0,9999,0
1668378924357,ECE 200,022,103607,Liu; Zhaowei,9998,0,9999,1
1668378924357,ECE 200,023,103608,Lo; Yu-Hwa,9999,0,9999,0
1668378924357,ECE 200,024,103609,Lomakin; Vitaliy,9999,0,9999,0
1668378924357,ECE 200,025,103610,Mercier; Patrick Philip,9999,0,9999,0
1668378924357,ECE 200,026,103611,Meyer; Florian,9999,0,9999,0
1668378924357,ECE 200,027,103612,Milstein; Laurence B.,9999,0,9999,0
1668378924357,ECE 200,028,103613,Mir Arabbaygi; Siavash,9999,0,9999,0
1668378924357,ECE 200,029,103614,Mookherjea; Shayan,9999,0,9999,0
1668378924357,ECE 200,030,103615,Morris; Karcher William,9999,0,9999,0
1668378924357,ECE 200,031,103616,Ng; Tse Nga,9999,0,9999,0
1668378924357,ECE 200,032,103617,Nguyen; Truong Quang,9999,0,9999,0
1668378924357,ECE 200,033,103618,Nomura; Kenji,9999,0,9999,0
1668378924357,ECE 200,034,103619,Orlitsky; Alon,9999,0,9999,0
1668378924357,ECE 200,035,103620,Pal; Piya,9999,0,9999,0
1668378924357,ECE 200,036,103621,Papen; George C.,9999,0,9999,0
1668378924357,ECE 200,037,103622,Radic; Stojan,9999,0,9999,0
1668378924357,ECE 200,038,103623,Rao; Bhaskar D.,9999,0,9999,0
1668378924357,ECE 200,039,103624,Rao; Ramesh R,9999,0,9999,0
1668378924357,ECE 200,040,103625,Rebeiz; Gabriel,9999,0,9999,0
1668378924357,ECE 200,041,103626,Sanford; John R,9999,0,9999,0
1668378924357,ECE 200,042,103627,Siegel; Paul H.,9999,0,9999,0
1668378924357,ECE 200,043,103628,Sievenpiper; Daniel F.,9999,0,9999,0
1668378924357,ECE 200,044,103629,Sworder; David D.,9999,0,9999,0
1668378924357,ECE 200,045,103630,Taur; Yuan,9999,0,9999,0
1668378924357,ECE 200,046,103631,Touri; Behrouz,9999,0,9999,0
1668378924357,ECE 200,047,103632,Trivedi; Mohan M.,9999,0,9999,0
1668378924357,ECE 200,048,103633,Vasconcelos; Nuno,9999,0,9999,0
1668378924357,ECE 200,049,103634,Wang; Xiaolong,9999,0,9999,0
1668378924357,ECE 200,050,103635,Xie; Pengtao,9999,0,9999,0
1668378924357,ECE 200,051,103636,Yip; Michael,9999,0,9999,0
1668378924357,ECE 200,052,103637,Zeger; Kenneth A.,999,0,999,0
1668378924357,ECE 200,053,103638,Zhang; Xinyu,9999,0,9999,0
1668378924357,ECE 200,054,103639,Turakhia; Yatish Girish,9999,0,9999,0
1668378924357,ECE 200,055,103640,Kang; Mingu,9999,0,9999,0
1668378924357,ECE 200,056,103641,Shi; Yuanyuan,9999,0,9999,0
1668378924357,ECE 200,057,103642,Wang; Edward Jay,9999,0,9999,0
1668378924357,ECE 200,058,103643,Zheng; Yang,9999,0,9999,0
1668378924780,ECE 202,A00,103644,Kuzum; Duygu,0,0,0,0
1668378925204,ECE 212BN,A00,103646,Ng; Tse Nga,0,0,0,0
1668378925629,ECE 221,A00,111493,Staff,0,0,0,0
1668378926052,ECE 222B,A00,103647,Lomakin; Vitaliy,0,0,0,0
1668378926475,ECE 230B,A00,103648,Taur; Yuan,0,0,0,0
1668378926911,ECE 238B,A00,103649,Garay; Javier,0,0,0,0
1668378927346,ECE 240B,A00,112900,Fainman; Yeshaiahu,0,0,0,0
1668378927783,ECE 247A,A00,103650,Jokerst; Jesse Vincent,0,0,0,0
1668378928218,ECE 247B,A00,103651,Wang; Joseph,0,0,0,0
1668378928643,ECE 250,A00,103652,Siegel; Paul H.,0,0,0,0
1668378929068,ECE 251A,A00,103654,Rao; Bhaskar D.,0,0,0,0
1668378929494,ECE 257B,A00,103655,Bharadia; Dinesh,0,0,0,0
1668378929919,ECE 258A,A00,103656,Milstein; Laurence B.,0,0,0,0
1668378930349,ECE 260B,A00,103658,Kang; Mingu,0,0,0,0
1668378930787,ECE 264A,A00,103659,Galton; Ian A,0,0,0,0
1668378931211,ECE 265A,A00,103661,Gudem; Prasad S.S.,0,0,0,0
1668378931644,ECE 265D,A00,103662,Gudem; Prasad S.S.,0,0,0,0
1668378932077,ECE 268,A00,103663,Koushanfar; Farinaz,0,0,0,0
1668378932501,ECE 269,A01,103665,Pal; Piya,0,0,0,0
1668378932922,ECE 271B,A00,103666,Vasconcelos; Manuela,0,0,0,0
1668378933349,ECE 276A,A00,103667,Atanasov; Nikolay A.,0,0,0,0
1668378933774,ECE 277,A00,103668,An; Cheolhong,0,0,0,0
1668378934197,ECE 279,A00,117947,Hall; Drew A.,0,0,0,0
1668378935046,ECE 283,A00,103670,Hsueh; Tzu-Chien,0,0,0,0
1668378935476,ECE 284,A00,103671,Turakhia; Yatish Girish,0,0,0,0
1668378935915,ECE 285,A00,103672,Zheng; Yang,0,0,0,0
1668378935915,ECE 285,B00,103673,Sworder; David D.,0,0,0,0
1668378936340,ECE 287,A00,103676,Javidi; Tara,0,0,0,0
1668378936762,MATH 200B,A00,098023,Salehi Golsefidy; Alireza,12,0,15,3
1668378937186,MATH 202B,A00,098024,Rhoades; Brendon Patrick,9,0,15,6
1668378937609,MATH 203B,A00,098025,Oprea; Dragos N.,10,0,15,5
1668378938043,MATH 204B,A00,098026,Sorensen; Claus M,13,0,15,2
1668378938491,MATH 208,A00,098027,Izadi; Elham,7,0,10,3
1668378938923,MATH 209,A00,098028,Pollack; Aaron,10,0,10,0
1668378939347,MATH 211A,A00,112919,Rogalski; Daniel,9,0,10,1
1668378939776,MATH 211B,A00,112920,Seward; Brandon M.,9,0,10,1
1668378940207,MATH 218,A00,098029,Li; Bo,10,0,10,0
1668378940630,MATH 220B,A00,098030,Novak; Jonathan I,11,0,15,4
1668378941052,MATH 221A,A00,098031,Ebenfelt; Peter F,13,0,15,2
1668378941478,MATH 231B,A00,098032,Zlatos; Andrej,12,0,15,3
1668378941903,MATH 240B,A00,098033,Ni; Lei,9,0,15,6
1668378942326,MATH 243,A00,098034,Jekel; David Andrew,10,0,10,0
1668378942762,MATH 245A,A00,098035,Nie; Jiawang,0,0,15,16
1668378943189,MATH 248,A00,098036,Bejenaru; Ioan,10,0,10,0
1668378943629,MATH 250B,A00,098037,Spolaor; Luca,14,0,15,1
1668378944056,MATH 258,A00,098038,Ni; Lei,10,0,10,0
1668378944480,MATH 264B,A00,098041,Rhoades; Brendon Patrick,9,0,15,6
1668378944901,MATH 268,A00,098042,Buss; Samuel R,10,0,10,0
1668378945324,MATH 269,A00,098043,Rhoades; Brendon Patrick,10,0,10,0
1668378945751,MATH 270B,A00,098044,Li; Bo,10,0,15,5
1668378946178,MATH 272B,A00,098045,Holst; Michael J,13,0,15,2
1668378946612,MATH 273A,A00,098046,Tian; Xiaochuan,10,0,15,5
1668378947035,MATH 275,A01,098048,Tian; Xiaochuan,6,0,10,4
1668378947458,MATH 278A,A00,098049,Holst; Michael J,8,0,10,2
1668378947880,MATH 278B,A00,098050,Cloninger; Alexander,10,0,10,0
1668378948306,MATH 278C,A00,098051,Nie; Jiawang,7,0,10,3
1668378948732,MATH 280B,A00,098052,Zheng; Tianyi,8,0,15,7
1668378949163,MATH 281B,A00,098053,Bradic; Jelena,1,0,15,14
1668378949586,MATH 282B,A00,098054,Arias-Castro; Ery,0,0,15,15
1668378950015,MATH 285,A00,098055,Fitzsimmons; Patrick J,0,0,15,17
1668378950439,MATH 287B,A00,098056,Arias-Castro; Ery,2,0,15,13
1668378950866,MATH 288,A00,098057,Agarwal; Pooja,9,0,10,1
1668378950866,MATH 288,B00,098058,Zhang; Danna,8,0,10,2
1668378950866,MATH 288,C00,098059,Williams; Ruth J,9,0,10,1
1668378951298,MATH 290B,A00,098060,Roberts; Justin Deritter,13,0,15,2
1668378951722,MATH 292,A00,098061,Belmont; Eva Kinoshita,10,0,10,0
1668378952146,MATH 295,A00,098062,Suk; Andrew Hoon,48,0,50,2
1668378952570,MATH 296,A00,098063,Novak; Jonathan I,20,0,20,0
1668378953001,MATH 297,001,098064,Gamst; Anthony Collins,9997,0,9999,2
1668379455534,COGS 205,A00,101395,Chiba; Andrea,19,0,20,1
1668379455957,COGS 210B,001,101404,Greene; Deanna Jacquelyn,9998,0,9999,1
1668379455957,COGS 210B,002,101417,Xia; Haijun,9999,0,9999,0
1668379455957,COGS 210B,003,101422,Nitz; Douglas A.,9999,0,9999,0
1668379455957,COGS 210B,004,101423,Hollan; James D.,9998,0,9999,1
1668379455957,COGS 210B,005,101424,Deak; Gedeon O.,9998,0,9999,1
1668379455957,COGS 210B,006,101425,Rossano; Federico,9999,0,9999,0
1668379456382,COGS 211B,A00,101427,Coulson; Seana M,9996,0,9999,3
1668379456807,COGS 220,A00,101428,Hollan; James D.,0,0,25,25
1668379457233,COGS 229,A00,101429,Dow; Steven P,18,0,25,7
1668379457655,COGS 230,A00,101430,Klemmer; Scott R,11,0,17,6
1668379458078,COGS 234,A00,101431,Xia; Haijun,1,0,25,24
1668379458512,COGS 260,A00,101432,Kiyonaga; Anastasia,21,0,25,4
1668379458512,COGS 260,B00,101433,Kirsh; David Joel,15,0,25,10
1668379458936,CSE 202,A00,102371,Impagliazzo; Russell,0,0,0,0
1668379459366,CSE 203B,A01,102373,Cheng; Chung Kuan,0,0,0,0
1668379459791,CSE 208,A00,102374,Micciancio; Daniele,0,0,0,0
1668379460214,CSE 209A,A00,112895,Impagliazzo; Russell,0,0,15,15
1668379460636,CSE 209B,A00,108005,Bellare; Mihir,0,0,0,0
1668379461059,CSE 210,A00,113163,Coblenz; Michael J,0,0,0,0
1668379461483,CSE 219,A00,106111,Dow; Steven P,0,0,20,20
1668379461908,CSE 221,A00,102376,Voelker; Geoffrey M.,0,0,0,0
1668379462330,CSE 224,A01,102378,Porter; George M,0,0,0,0
1668379462757,CSE 229A,A00,102379,Savage; Stefan,0,0,0,0
1668379463180,CSE 229C,A00,102380,Munyaka; Imani N. S.,0,0,0,0
1668379463604,CSE 232B,A00,102382,Deutsch; Alin Bernard,0,0,0,0
1668379464030,CSE 234,A01,112904,Kumar; Arun Kumar,0,0,0,0
1668379464456,CSE 237A,A00,102383,Rosing; Tajana Simunic,0,0,0,0
1668379464880,CSE 239A,A00,102384,Deutsch; Alin Bernard,0,0,0,0
1668379465304,CSE 239B,A00,102385,Polikarpova; Nadezhda,0,0,0,0
1668379465728,CSE 240A,A00,102386,Pannuto; Patrick William,0,0,0,0
1668379466150,CSE 240B,A00,102387,Zhao; Jishen,0,0,0,0
1668379466578,CSE 241A,A00,106406,Kang; Mingu,0,0,0,0
1668379467001,CSE 249B,A00,102388,Kahng; Andrew Byun,0,0,8,8
1668379467439,CSE 251B,A01,102392,Cottrell; Garrison W,0,0,0,0
1668379467439,CSE 251B,A02,102393,Cottrell; Garrison W,0,0,0,0
1668379467863,CSE 252B,A00,102394,Ochoa; Benjamin Lawrence,0,0,0,0
1668379468299,CSE 257,A01,102396,Gao; Sicun,0,0,0,0
1668379468724,CSE 272,A00,102397,Li; Tzumao,0,0,0,0
1668379469147,CSE 274,A00,111323,Chern; Albert Ren-Haur,0,0,0,0
1668379469573,CSE 282,A00,102398,Pevzner; Pavel Arkadjevich,0,0,0,0
1668379469997,CSE 284,A00,114175,Gymrek; Melissa Ann,0,0,0,0
1668379470422,CSE 290,A00,102399,Chandraker; Manmohan Krishna,0,0,0,0
1668379470422,CSE 290,B00,102400,Vaccaro; Kristen Marie,0,0,25,25
1668379470422,CSE 290,C00,102414,Pannuto; Patrick William,0,0,25,25
1668379470422,CSE 290,D00,102427,Pevzner; Pavel Arkadjevich,0,0,0,0
1668379470422,CSE 290,E00,102429,Zhao; Jishen,0,0,0,0
1668379470422,CSE 290,F00,102436,Tullsen; Dean Michael,0,0,0,0
1668379470422,CSE 290,G00,102440,Christensen; Henrik I,0,0,20,20
1668379470849,CSE 291,A00,102443,Su; Hao,0,0,0,0
1668379470849,CSE 291,B00,102448,Polikarpova; Nadezhda,0,0,0,0
1668379470849,CSE 291,C00,102453,Vaccaro; Kristen Marie,0,0,0,0
1668379470849,CSE 291,D00,111343,Savage; Stefan,0,0,0,0
1668379470849,CSE 291,E00,116474,Claffy; Kimberly Claire,0,0,0,0
1668379470849,CSE 291,F00,116479,Pasquale; Joseph,0,0,0,0
1668379471311,CSE 293,001,119111,Bafna; Vineet,9999,0,9999,0
1668379471311,CSE 293,002,119118,Bellare; Mihir,9999,0,9999,0
1668379471311,CSE 293,003,119122,Berg-Kirkpatrick; Taylor D,9999,0,9999,0
1668379471311,CSE 293,004,119135,Christensen; Henrik I,9999,0,9999,0
1668379471311,CSE 293,005,119142,Cottrell; Garrison W,9999,0,9999,0
1668379471311,CSE 293,006,119146,Deutsch; Alin Bernard,9999,0,9999,0
1668379471311,CSE 293,007,119159,Esmaeilzadeh; Hadi,9999,0,9999,0
1668379471311,CSE 293,008,119166,Freund; Yoav,9999,0,9999,0
1668379471311,CSE 293,009,119170,Griswold; William G.,9999,0,9999,0
1668379471311,CSE 293,010,119183,Gymrek; Melissa Ann,9999,0,9999,0
1668379471311,CSE 293,011,119190,Heninger; Nadia A,9999,0,9999,0
1668379471311,CSE 293,012,119230,Impagliazzo; Russell,9999,0,9999,0
1668379471311,CSE 293,013,119232,Jhala; Ranjit,9999,0,9999,0
1668379471311,CSE 293,014,119233,Kahng; Andrew Byun,9999,0,9999,0
1668379471311,CSE 293,015,119298,Kane; Daniel Mertz,9999,0,9999,0
1668379471311,CSE 293,016,119299,Kriegman; David J,9999,0,9999,0
1668379471311,CSE 293,017,119300,Kumar; Arun Kumar,9999,0,9999,0
1668379471311,CSE 293,018,119301,Lerner; Sorin,9999,0,9999,0
1668379471311,CSE 293,019,119302,Lovett; Shachar,9999,0,9999,0
1668379471311,CSE 293,020,119303,McAuley; Julian John,9999,0,9999,0
1668379471311,CSE 293,021,119304,Micciancio; Daniele,9999,0,9999,0
1668379471311,CSE 293,022,119367,Orailoglu; Alex,9999,0,9999,0
1668379471311,CSE 293,023,119382,Paturi; Ramamohan,9999,0,9999,0
1668379471311,CSE 293,024,119404,Polikarpova; Nadezhda,9999,0,9999,0
1668379471311,CSE 293,025,119406,Politz; Joseph Gibbs,9999,0,9999,0
1668379471311,CSE 293,026,119411,Porter; George M,9999,0,9999,0
1668379471311,CSE 293,027,119414,Porter; Leonard Emerson,9999,0,9999,0
1668379471311,CSE 293,028,119416,Ramamoorthi; Ravi,9999,0,9999,0
1668379471311,CSE 293,029,119417,Sahoo; Debashis,9999,0,9999,0
1668379471311,CSE 293,030,119420,Saul; Lawrence,9999,0,9999,0
1668379471311,CSE 293,031,119421,Savage; Stefan,9999,0,9999,0
1668379471311,CSE 293,032,119425,Schulze; Jurgen P.,9999,0,9999,0
1668379471311,CSE 293,033,119426,Snoeren; Alex C.,9999,0,9999,0
1668379471311,CSE 293,034,119428,Shang; Jingbo,9999,0,9999,0
1668379471311,CSE 293,035,119430,Stefan; Deian,9999,0,9999,0
1668379471311,CSE 293,036,119431,Su; Hao,9999,0,9999,0
1668379471311,CSE 293,037,119433,Swanson; Steven James,9999,0,9999,0
1668379471311,CSE 293,038,119435,Tullsen; Dean Michael,9999,0,9999,0
1668379471311,CSE 293,039,119483,Voelker; Geoffrey M.,9999,0,9999,0
1668379471311,CSE 293,040,119537,Zhao; Jishen,9999,0,9999,0
1668379471311,CSE 293,041,119538,Zhou; Yuan-Yuan,9999,0,9999,0
1668379471311,CSE 293,042,119539,Gao; Sicun,9999,0,9999,0
1668379471311,CSE 293,043,119540,Weibel; Nadir,9999,0,9999,0
1668379471311,CSE 293,044,119541,Gupta; Rajesh K.,9999,0,9999,0
1668379471311,CSE 293,045,126410,Vaccaro; Kristen Marie,9999,0,9999,0
1668379471311,CSE 293,046,126411,Klemke; Richard,9999,0,9999,0
1668379471738,CSE 294,A00,102459,Voelker; Geoffrey M.,0,0,0,0
1668379471738,CSE 294,B00,111322,Orailoglu; Alex,0,0,0,0
1668379472164,DSE 201,A00,096914,Deutsch; Alin Bernard,30,0,30,0
1668379472591,DSE 210,A00,096915,Dasgupta; Sanjoy,30,0,30,0
1668379473015,DSE 260A,A00,096916,Altintas De Callaf; Ilkay,30,0,30,0
1668379473442,ECE 200,001,103586,Antipa; Nicholas A,9999,0,9999,0
1668379473442,ECE 200,002,103587,Atanasov; Nikolay A.,9999,0,9999,0
1668379473442,ECE 200,003,103588,Bharadia; Dinesh,9999,0,9999,0
1668379473442,ECE 200,004,103589,Cheng; Chung Kuan,9999,0,9999,0
1668379473442,ECE 200,005,103590,Cosman; Pamela C.,9999,0,9999,0
1668379473442,ECE 200,006,103591,Dayeh; Shadi Ahmad,9999,0,9999,0
1668379473442,ECE 200,007,103592,Fainman; Yeshaiahu,9999,0,9999,0
1668379473442,ECE 200,008,103593,Ford; Joseph Earl,9999,0,9999,0
1668379473442,ECE 200,009,103594,Franceschetti; Massimo,9999,0,9999,0
1668379473442,ECE 200,010,103595,Fullerton; Eric E,9999,0,9999,0
1668379473442,ECE 200,011,103596,Galton; Ian A,9999,0,9999,0
1668379473442,ECE 200,012,103597,Gilja; Vikash,9999,0,9999,0
1668379473442,ECE 200,013,103598,Hall; Drew A.,9999,0,9999,0
1668379473442,ECE 200,014,103599,Hsueh; Tzu-Chien,9999,0,9999,0
1668379473442,ECE 200,015,103600,Javidi; Tara,9999,0,9999,0
1668379473442,ECE 200,016,103601,Kahng; Andrew Byun,9999,0,9999,0
1668379473442,ECE 200,017,103602,Kim; Young-Han,9999,0,9999,0
1668379473442,ECE 200,018,103603,Koushanfar; Farinaz,9999,0,9999,0
1668379473442,ECE 200,019,103604,Kuzum; Duygu,9999,0,9999,0
1668379473442,ECE 200,020,103605,Le; Hanh-Phuc,9999,0,9999,0
1668379473442,ECE 200,021,103606,Lin; Bill,9999,0,9999,0
1668379473442,ECE 200,022,103607,Liu; Zhaowei,9998,0,9999,1
1668379473442,ECE 200,023,103608,Lo; Yu-Hwa,9999,0,9999,0
1668379473442,ECE 200,024,103609,Lomakin; Vitaliy,9999,0,9999,0
1668379473442,ECE 200,025,103610,Mercier; Patrick Philip,9999,0,9999,0
1668379473442,ECE 200,026,103611,Meyer; Florian,9999,0,9999,0
1668379473442,ECE 200,027,103612,Milstein; Laurence B.,9999,0,9999,0
1668379473442,ECE 200,028,103613,Mir Arabbaygi; Siavash,9999,0,9999,0
1668379473442,ECE 200,029,103614,Mookherjea; Shayan,9999,0,9999,0
1668379473442,ECE 200,030,103615,Morris; Karcher William,9999,0,9999,0
1668379473442,ECE 200,031,103616,Ng; Tse Nga,9999,0,9999,0
1668379473442,ECE 200,032,103617,Nguyen; Truong Quang,9999,0,9999,0
1668379473442,ECE 200,033,103618,Nomura; Kenji,9999,0,9999,0
1668379473442,ECE 200,034,103619,Orlitsky; Alon,9999,0,9999,0
1668379473442,ECE 200,035,103620,Pal; Piya,9999,0,9999,0
1668379473442,ECE 200,036,103621,Papen; George C.,9999,0,9999,0
1668379473442,ECE 200,037,103622,Radic; Stojan,9999,0,9999,0
1668379473442,ECE 200,038,103623,Rao; Bhaskar D.,9999,0,9999,0
1668379473442,ECE 200,039,103624,Rao; Ramesh R,9999,0,9999,0
1668379473442,ECE 200,040,103625,Rebeiz; Gabriel,9999,0,9999,0
1668379473442,ECE 200,041,103626,Sanford; John R,9999,0,9999,0
1668379473442,ECE 200,042,103627,Siegel; Paul H.,9999,0,9999,0
1668379473442,ECE 200,043,103628,Sievenpiper; Daniel F.,9999,0,9999,0
1668379473442,ECE 200,044,103629,Sworder; David D.,9999,0,9999,0
1668379473442,ECE 200,045,103630,Taur; Yuan,9999,0,9999,0
1668379473442,ECE 200,046,103631,Touri; Behrouz,9999,0,9999,0
1668379473442,ECE 200,047,103632,Trivedi; Mohan M.,9999,0,9999,0
1668379473442,ECE 200,048,103633,Vasconcelos; Nuno,9999,0,9999,0
1668379473442,ECE 200,049,103634,Wang; Xiaolong,9999,0,9999,0
1668379473442,ECE 200,050,103635,Xie; Pengtao,9999,0,9999,0
1668379473442,ECE 200,051,103636,Yip; Michael,9999,0,9999,0
1668379473442,ECE 200,052,103637,Zeger; Kenneth A.,999,0,999,0
1668379473442,ECE 200,053,103638,Zhang; Xinyu,9999,0,9999,0
1668379473442,ECE 200,054,103639,Turakhia; Yatish Girish,9999,0,9999,0
1668379473442,ECE 200,055,103640,Kang; Mingu,9999,0,9999,0
1668379473442,ECE 200,056,103641,Shi; Yuanyuan,9999,0,9999,0
1668379473442,ECE 200,057,103642,Wang; Edward Jay,9999,0,9999,0
1668379473442,ECE 200,058,103643,Zheng; Yang,9999,0,9999,0
1668379473868,ECE 202,A00,103644,Kuzum; Duygu,0,0,0,0
1668379474292,ECE 212BN,A00,103646,Ng; Tse Nga,0,0,0,0
1668379474720,ECE 221,A00,111493,Staff,0,0,0,0
1668379475144,ECE 222B,A00,103647,Lomakin; Vitaliy,0,0,0,0
1668379475567,ECE 230B,A00,103648,Taur; Yuan,0,0,0,0
1668379475992,ECE 238B,A00,103649,Garay; Javier,0,0,0,0
1668379476426,ECE 240B,A00,112900,Fainman; Yeshaiahu,0,0,0,0
1668379476850,ECE 247A,A00,103650,Jokerst; Jesse Vincent,0,0,0,0
1668379477272,ECE 247B,A00,103651,Wang; Joseph,0,0,0,0
1668379477709,ECE 250,A00,103652,Siegel; Paul H.,0,0,0,0
1668379478131,ECE 251A,A00,103654,Rao; Bhaskar D.,0,0,0,0
1668379478563,ECE 257B,A00,103655,Bharadia; Dinesh,0,0,0,0
1668379478997,ECE 258A,A00,103656,Milstein; Laurence B.,0,0,0,0
1668379479423,ECE 260B,A00,103658,Kang; Mingu,0,0,0,0
1668379479847,ECE 264A,A00,103659,Galton; Ian A,0,0,0,0
1668379480271,ECE 265A,A00,103661,Gudem; Prasad S.S.,0,0,0,0
1668379480694,ECE 265D,A00,103662,Gudem; Prasad S.S.,0,0,0,0
1668379481117,ECE 268,A00,103663,Koushanfar; Farinaz,0,0,0,0
1668379481541,ECE 269,A01,103665,Pal; Piya,0,0,0,0
1668379481970,ECE 271B,A00,103666,Vasconcelos; Manuela,0,0,0,0
1668379482394,ECE 276A,A00,103667,Atanasov; Nikolay A.,0,0,0,0
1668379482819,ECE 277,A00,103668,An; Cheolhong,0,0,0,0
1668379483346,ECE 279,A00,117947,Hall; Drew A.,0,0,0,0
1668379484197,ECE 283,A00,103670,Hsueh; Tzu-Chien,0,0,0,0
1668379484620,ECE 284,A00,103671,Turakhia; Yatish Girish,0,0,0,0
1668379485042,ECE 285,A00,103672,Zheng; Yang,0,0,0,0
1668379485042,ECE 285,B00,103673,Sworder; David D.,0,0,0,0
1668379485469,ECE 287,A00,103676,Javidi; Tara,0,0,0,0
1668379485892,MATH 200B,A00,098023,Salehi Golsefidy; Alireza,12,0,15,3
1668379486319,MATH 202B,A00,098024,Rhoades; Brendon Patrick,9,0,15,6
1668379486752,MATH 203B,A00,098025,Oprea; Dragos N.,10,0,15,5
1668379487194,MATH 204B,A00,098026,Sorensen; Claus M,13,0,15,2
1668379487622,MATH 208,A00,098027,Izadi; Elham,7,0,10,3
1668379488046,MATH 209,A00,098028,Pollack; Aaron,10,0,10,0
1668379488472,MATH 211A,A00,112919,Rogalski; Daniel,9,0,10,1
1668379488897,MATH 211B,A00,112920,Seward; Brandon M.,9,0,10,1
1668379489322,MATH 218,A00,098029,Li; Bo,10,0,10,0
1668379489752,MATH 220B,A00,098030,Novak; Jonathan I,11,0,15,4
1668379490178,MATH 221A,A00,098031,Ebenfelt; Peter F,13,0,15,2
1668379490602,MATH 231B,A00,098032,Zlatos; Andrej,12,0,15,3
1668379491037,MATH 240B,A00,098033,Ni; Lei,9,0,15,6
1668379491461,MATH 243,A00,098034,Jekel; David Andrew,10,0,10,0
1668379491889,MATH 245A,A00,098035,Nie; Jiawang,0,0,15,16
1668379492311,MATH 248,A00,098036,Bejenaru; Ioan,10,0,10,0
1668379492735,MATH 250B,A00,098037,Spolaor; Luca,14,0,15,1
1668379493161,MATH 258,A00,098038,Ni; Lei,10,0,10,0
1668379493582,MATH 264B,A00,098041,Rhoades; Brendon Patrick,9,0,15,6
1668379494016,MATH 268,A00,098042,Buss; Samuel R,10,0,10,0
1668379494439,MATH 269,A00,098043,Rhoades; Brendon Patrick,10,0,10,0
1668379494871,MATH 270B,A00,098044,Li; Bo,10,0,15,5
1668379495309,MATH 272B,A00,098045,Holst; Michael J,13,0,15,2
1668379495733,MATH 273A,A00,098046,Tian; Xiaochuan,10,0,15,5
1668379496155,MATH 275,A01,098048,Tian; Xiaochuan,6,0,10,4
1668379496578,MATH 278A,A00,098049,Holst; Michael J,8,0,10,2
1668379497000,MATH 278B,A00,098050,Cloninger; Alexander,10,0,10,0
1668379497441,MATH 278C,A00,098051,Nie; Jiawang,7,0,10,3
1668379497870,MATH 280B,A00,098052,Zheng; Tianyi,8,0,15,7
1668379498296,MATH 281B,A00,098053,Bradic; Jelena,1,0,15,14
1668379498719,MATH 282B,A00,098054,Arias-Castro; Ery,0,0,15,15
1668379499147,MATH 285,A00,098055,Fitzsimmons; Patrick J,0,0,15,17
1668379499584,MATH 287B,A00,098056,Arias-Castro; Ery,2,0,15,13
1668379500008,MATH 288,A00,098057,Agarwal; Pooja,9,0,10,1
1668379500008,MATH 288,B00,098058,Zhang; Danna,8,0,10,2
1668379500008,MATH 288,C00,098059,Williams; Ruth J,9,0,10,1
1668379500431,MATH 290B,A00,098060,Roberts; Justin Deritter,13,0,15,2
1668379500853,MATH 292,A00,098061,Belmont; Eva Kinoshita,10,0,10,0
1668379501276,MATH 295,A00,098062,Suk; Andrew Hoon,48,0,50,2
1668379501703,MATH 296,A00,098063,Novak; Jonathan I,20,0,20,0
1668379502125,MATH 297,001,098064,Gamst; Anthony Collins,9997,0,9999,2
1668380002851,COGS 205,A00,101395,Chiba; Andrea,19,0,20,1
1668380003276,COGS 210B,001,101404,Greene; Deanna Jacquelyn,9998,0,9999,1
1668380003276,COGS 210B,002,101417,Xia; Haijun,9999,0,9999,0
1668380003276,COGS 210B,003,101422,Nitz; Douglas A.,9999,0,9999,0
1668380003276,COGS 210B,004,101423,Hollan; James D.,9998,0,9999,1
1668380003276,COGS 210B,005,101424,Deak; Gedeon O.,9998,0,9999,1
1668380003276,COGS 210B,006,101425,Rossano; Federico,9999,0,9999,0
1668380003702,COGS 211B,A00,101427,Coulson; Seana M,9996,0,9999,3
1668380004199,COGS 220,A00,101428,Hollan; James D.,0,0,25,25
1668380004620,COGS 229,A00,101429,Dow; Steven P,18,0,25,7
1668380005058,COGS 230,A00,101430,Klemmer; Scott R,11,0,17,6
1668380005485,COGS 234,A00,101431,Xia; Haijun,1,0,25,24
1668380005908,COGS 260,A00,101432,Kiyonaga; Anastasia,21,0,25,4
1668380005908,COGS 260,B00,101433,Kirsh; David Joel,15,0,25,10
1668380006331,CSE 202,A00,102371,Impagliazzo; Russell,0,0,0,0
1668380006757,CSE 203B,A01,102373,Cheng; Chung Kuan,0,0,0,0
1668380007183,CSE 208,A00,102374,Micciancio; Daniele,0,0,0,0
1668380007606,CSE 209A,A00,112895,Impagliazzo; Russell,0,0,15,15
1668380008033,CSE 209B,A00,108005,Bellare; Mihir,0,0,0,0
1668380008460,CSE 210,A00,113163,Coblenz; Michael J,0,0,0,0
1668380008888,CSE 219,A00,106111,Dow; Steven P,0,0,20,20
1668380009312,CSE 221,A00,102376,Voelker; Geoffrey M.,0,0,0,0
1668380009739,CSE 224,A01,102378,Porter; George M,0,0,0,0
1668380010166,CSE 229A,A00,102379,Savage; Stefan,0,0,0,0
1668380010601,CSE 229C,A00,102380,Munyaka; Imani N. S.,0,0,0,0
1668380011026,CSE 232B,A00,102382,Deutsch; Alin Bernard,0,0,0,0
1668380011449,CSE 234,A01,112904,Kumar; Arun Kumar,0,0,0,0
1668380011874,CSE 237A,A00,102383,Rosing; Tajana Simunic,0,0,0,0
1668380012298,CSE 239A,A00,102384,Deutsch; Alin Bernard,0,0,0,0
1668380012721,CSE 239B,A00,102385,Polikarpova; Nadezhda,0,0,0,0
1668380013146,CSE 240A,A00,102386,Pannuto; Patrick William,0,0,0,0
1668380013578,CSE 240B,A00,102387,Zhao; Jishen,0,0,0,0
1668380014002,CSE 241A,A00,106406,Kang; Mingu,0,0,0,0
1668380014427,CSE 249B,A00,102388,Kahng; Andrew Byun,0,0,8,8
1668380014855,CSE 251B,A01,102392,Cottrell; Garrison W,0,0,0,0
1668380014855,CSE 251B,A02,102393,Cottrell; Garrison W,0,0,0,0
1668380015282,CSE 252B,A00,102394,Ochoa; Benjamin Lawrence,0,0,0,0
1668380015709,CSE 257,A01,102396,Gao; Sicun,0,0,0,0
1668380016134,CSE 272,A00,102397,Li; Tzumao,0,0,0,0
1668380016555,CSE 274,A00,111323,Chern; Albert Ren-Haur,0,0,0,0
1668380016979,CSE 282,A00,102398,Pevzner; Pavel Arkadjevich,0,0,0,0
1668380017401,CSE 284,A00,114175,Gymrek; Melissa Ann,0,0,0,0
1668380017825,CSE 290,A00,102399,Chandraker; Manmohan Krishna,0,0,0,0
1668380017825,CSE 290,B00,102400,Vaccaro; Kristen Marie,0,0,25,25
1668380017825,CSE 290,C00,102414,Pannuto; Patrick William,0,0,25,25
1668380017825,CSE 290,D00,102427,Pevzner; Pavel Arkadjevich,0,0,0,0
1668380017825,CSE 290,E00,102429,Zhao; Jishen,0,0,0,0
1668380017825,CSE 290,F00,102436,Tullsen; Dean Michael,0,0,0,0
1668380017825,CSE 290,G00,102440,Christensen; Henrik I,0,0,20,20
1668380018250,CSE 291,A00,102443,Su; Hao,0,0,0,0
1668380018250,CSE 291,B00,102448,Polikarpova; Nadezhda,0,0,0,0
1668380018250,CSE 291,C00,102453,Vaccaro; Kristen Marie,0,0,0,0
1668380018250,CSE 291,D00,111343,Savage; Stefan,0,0,0,0
1668380018250,CSE 291,E00,116474,Claffy; Kimberly Claire,0,0,0,0
1668380018250,CSE 291,F00,116479,Pasquale; Joseph,0,0,0,0
1668380018676,CSE 293,001,119111,Bafna; Vineet,9999,0,9999,0
1668380018676,CSE 293,002,119118,Bellare; Mihir,9999,0,9999,0
1668380018676,CSE 293,003,119122,Berg-Kirkpatrick; Taylor D,9999,0,9999,0
1668380018676,CSE 293,004,119135,Christensen; Henrik I,9999,0,9999,0
1668380018676,CSE 293,005,119142,Cottrell; Garrison W,9999,0,9999,0
1668380018676,CSE 293,006,119146,Deutsch; Alin Bernard,9999,0,9999,0
1668380018676,CSE 293,007,119159,Esmaeilzadeh; Hadi,9999,0,9999,0
1668380018676,CSE 293,008,119166,Freund; Yoav,9999,0,9999,0
1668380018676,CSE 293,009,119170,Griswold; William G.,9999,0,9999,0
1668380018676,CSE 293,010,119183,Gymrek; Melissa Ann,9999,0,9999,0
1668380018676,CSE 293,011,119190,Heninger; Nadia A,9999,0,9999,0
1668380018676,CSE 293,012,119230,Impagliazzo; Russell,9999,0,9999,0
1668380018676,CSE 293,013,119232,Jhala; Ranjit,9999,0,9999,0
1668380018676,CSE 293,014,119233,Kahng; Andrew Byun,9999,0,9999,0
1668380018676,CSE 293,015,119298,Kane; Daniel Mertz,9999,0,9999,0
1668380018676,CSE 293,016,119299,Kriegman; David J,9999,0,9999,0
1668380018676,CSE 293,017,119300,Kumar; Arun Kumar,9999,0,9999,0
1668380018676,CSE 293,018,119301,Lerner; Sorin,9999,0,9999,0
1668380018676,CSE 293,019,119302,Lovett; Shachar,9999,0,9999,0
1668380018676,CSE 293,020,119303,McAuley; Julian John,9999,0,9999,0
1668380018676,CSE 293,021,119304,Micciancio; Daniele,9999,0,9999,0
1668380018676,CSE 293,022,119367,Orailoglu; Alex,9999,0,9999,0
1668380018676,CSE 293,023,119382,Paturi; Ramamohan,9999,0,9999,0
1668380018676,CSE 293,024,119404,Polikarpova; Nadezhda,9999,0,9999,0
1668380018676,CSE 293,025,119406,Politz; Joseph Gibbs,9999,0,9999,0
1668380018676,CSE 293,026,119411,Porter; George M,9999,0,9999,0
1668380018676,CSE 293,027,119414,Porter; Leonard Emerson,9999,0,9999,0
1668380018676,CSE 293,028,119416,Ramamoorthi; Ravi,9999,0,9999,0
1668380018676,CSE 293,029,119417,Sahoo; Debashis,9999,0,9999,0
1668380018676,CSE 293,030,119420,Saul; Lawrence,9999,0,9999,0
1668380018676,CSE 293,031,119421,Savage; Stefan,9999,0,9999,0
1668380018676,CSE 293,032,119425,Schulze; Jurgen P.,9999,0,9999,0
1668380018676,CSE 293,033,119426,Snoeren; Alex C.,9999,0,9999,0
1668380018676,CSE 293,034,119428,Shang; Jingbo,9999,0,9999,0
1668380018676,CSE 293,035,119430,Stefan; Deian,9999,0,9999,0
1668380018676,CSE 293,036,119431,Su; Hao,9999,0,9999,0
1668380018676,CSE 293,037,119433,Swanson; Steven James,9999,0,9999,0
1668380018676,CSE 293,038,119435,Tullsen; Dean Michael,9999,0,9999,0
1668380018676,CSE 293,039,119483,Voelker; Geoffrey M.,9999,0,9999,0
1668380018676,CSE 293,040,119537,Zhao; Jishen,9999,0,9999,0
1668380018676,CSE 293,041,119538,Zhou; Yuan-Yuan,9999,0,9999,0
1668380018676,CSE 293,042,119539,Gao; Sicun,9999,0,9999,0
1668380018676,CSE 293,043,119540,Weibel; Nadir,9999,0,9999,0
1668380018676,CSE 293,044,119541,Gupta; Rajesh K.,9999,0,9999,0
1668380018676,CSE 293,045,126410,Vaccaro; Kristen Marie,9999,0,9999,0
1668380018676,CSE 293,046,126411,Klemke; Richard,9999,0,9999,0
1668380019098,CSE 294,A00,102459,Voelker; Geoffrey M.,0,0,0,0
1668380019098,CSE 294,B00,111322,Orailoglu; Alex,0,0,0,0
1668380019524,DSE 201,A00,096914,Deutsch; Alin Bernard,30,0,30,0
1668380019950,DSE 210,A00,096915,Dasgupta; Sanjoy,30,0,30,0
1668380020374,DSE 260A,A00,096916,Altintas De Callaf; Ilkay,30,0,30,0
1668380020810,ECE 200,001,103586,Antipa; Nicholas A,9999,0,9999,0
1668380020810,ECE 200,002,103587,Atanasov; Nikolay A.,9999,0,9999,0
1668380020810,ECE 200,003,103588,Bharadia; Dinesh,9999,0,9999,0
1668380020810,ECE 200,004,103589,Cheng; Chung Kuan,9999,0,9999,0
1668380020810,ECE 200,005,103590,Cosman; Pamela C.,9999,0,9999,0
1668380020810,ECE 200,006,103591,Dayeh; Shadi Ahmad,9999,0,9999,0
1668380020810,ECE 200,007,103592,Fainman; Yeshaiahu,9999,0,9999,0
1668380020810,ECE 200,008,103593,Ford; Joseph Earl,9999,0,9999,0
1668380020810,ECE 200,009,103594,Franceschetti; Massimo,9999,0,9999,0
1668380020810,ECE 200,010,103595,Fullerton; Eric E,9999,0,9999,0
1668380020810,ECE 200,011,103596,Galton; Ian A,9999,0,9999,0
1668380020810,ECE 200,012,103597,Gilja; Vikash,9999,0,9999,0
1668380020810,ECE 200,013,103598,Hall; Drew A.,9999,0,9999,0
1668380020810,ECE 200,014,103599,Hsueh; Tzu-Chien,9999,0,9999,0
1668380020810,ECE 200,015,103600,Javidi; Tara,9999,0,9999,0
1668380020810,ECE 200,016,103601,Kahng; Andrew Byun,9999,0,9999,0
1668380020810,ECE 200,017,103602,Kim; Young-Han,9999,0,9999,0
1668380020810,ECE 200,018,103603,Koushanfar; Farinaz,9999,0,9999,0
1668380020810,ECE 200,019,103604,Kuzum; Duygu,9999,0,9999,0
1668380020810,ECE 200,020,103605,Le; Hanh-Phuc,9999,0,9999,0
1668380020810,ECE 200,021,103606,Lin; Bill,9999,0,9999,0
1668380020810,ECE 200,022,103607,Liu; Zhaowei,9998,0,9999,1
1668380020810,ECE 200,023,103608,Lo; Yu-Hwa,9999,0,9999,0
1668380020810,ECE 200,024,103609,Lomakin; Vitaliy,9999,0,9999,0
1668380020810,ECE 200,025,103610,Mercier; Patrick Philip,9999,0,9999,0
1668380020810,ECE 200,026,103611,Meyer; Florian,9999,0,9999,0
1668380020810,ECE 200,027,103612,Milstein; Laurence B.,9999,0,9999,0
1668380020810,ECE 200,028,103613,Mir Arabbaygi; Siavash,9999,0,9999,0
1668380020810,ECE 200,029,103614,Mookherjea; Shayan,9999,0,9999,0
1668380020810,ECE 200,030,103615,Morris; Karcher William,9999,0,9999,0
1668380020810,ECE 200,031,103616,Ng; Tse Nga,9999,0,9999,0
1668380020810,ECE 200,032,103617,Nguyen; Truong Quang,9999,0,9999,0
1668380020810,ECE 200,033,103618,Nomura; Kenji,9999,0,9999,0
1668380020810,ECE 200,034,103619,Orlitsky; Alon,9999,0,9999,0
1668380020810,ECE 200,035,103620,Pal; Piya,9999,0,9999,0
1668380020810,ECE 200,036,103621,Papen; George C.,9999,0,9999,0
1668380020810,ECE 200,037,103622,Radic; Stojan,9999,0,9999,0
1668380020810,ECE 200,038,103623,Rao; Bhaskar D.,9999,0,9999,0
1668380020810,ECE 200,039,103624,Rao; Ramesh R,9999,0,9999,0
1668380020810,ECE 200,040,103625,Rebeiz; Gabriel,9999,0,9999,0
1668380020810,ECE 200,041,103626,Sanford; John R,9999,0,9999,0
1668380020810,ECE 200,042,103627,Siegel; Paul H.,9999,0,9999,0
1668380020810,ECE 200,043,103628,Sievenpiper; Daniel F.,9999,0,9999,0
1668380020810,ECE 200,044,103629,Sworder; David D.,9999,0,9999,0
1668380020810,ECE 200,045,103630,Taur; Yuan,9999,0,9999,0
1668380020810,ECE 200,046,103631,Touri; Behrouz,9999,0,9999,0
1668380020810,ECE 200,047,103632,Trivedi; Mohan M.,9999,0,9999,0
1668380020810,ECE 200,048,103633,Vasconcelos; Nuno,9999,0,9999,0
1668380020810,ECE 200,049,103634,Wang; Xiaolong,9999,0,9999,0
1668380020810,ECE 200,050,103635,Xie; Pengtao,9999,0,9999,0
1668380020810,ECE 200,051,103636,Yip; Michael,9999,0,9999,0
1668380020810,ECE 200,052,103637,Zeger; Kenneth A.,999,0,999,0
1668380020810,ECE 200,053,103638,Zhang; Xinyu,9999,0,9999,0
1668380020810,ECE 200,054,103639,Turakhia; Yatish Girish,9999,0,9999,0
1668380020810,ECE 200,055,103640,Kang; Mingu,9999,0,9999,0
1668380020810,ECE 200,056,103641,Shi; Yuanyuan,9999,0,9999,0
1668380020810,ECE 200,057,103642,Wang; Edward Jay,9999,0,9999,0
1668380020810,ECE 200,058,103643,Zheng; Yang,9999,0,9999,0
1668380021233,ECE 202,A00,103644,Kuzum; Duygu,0,0,0,0
1668380021659,ECE 212BN,A00,103646,Ng; Tse Nga,0,0,0,0
1668380022083,ECE 221,A00,111493,Staff,0,0,0,0
1668380022506,ECE 222B,A00,103647,Lomakin; Vitaliy,0,0,0,0
1668380022932,ECE 230B,A00,103648,Taur; Yuan,0,0,0,0
1668380023366,ECE 238B,A00,103649,Garay; Javier,0,0,0,0
1668380023789,ECE 240B,A00,112900,Fainman; Yeshaiahu,0,0,0,0
1668380024217,ECE 247A,A00,103650,Jokerst; Jesse Vincent,0,0,0,0
1668380024643,ECE 247B,A00,103651,Wang; Joseph,0,0,0,0
1668380025066,ECE 250,A00,103652,Siegel; Paul H.,0,0,0,0
1668380025494,ECE 251A,A00,103654,Rao; Bhaskar D.,0,0,0,0
1668380025916,ECE 257B,A00,103655,Bharadia; Dinesh,0,0,0,0
1668380026340,ECE 258A,A00,103656,Milstein; Laurence B.,0,0,0,0
1668380026764,ECE 260B,A00,103658,Kang; Mingu,0,0,0,0
1668380027187,ECE 264A,A00,103659,Galton; Ian A,0,0,0,0
1668380027610,ECE 265A,A00,103661,Gudem; Prasad S.S.,0,0,0,0
1668380028037,ECE 265D,A00,103662,Gudem; Prasad S.S.,0,0,0,0
1668380028462,ECE 268,A00,103663,Koushanfar; Farinaz,0,0,0,0
1668380028883,ECE 269,A01,103665,Pal; Piya,0,0,0,0
1668380029308,ECE 271B,A00,103666,Vasconcelos; Manuela,0,0,0,0
1668380029734,ECE 276A,A00,103667,Atanasov; Nikolay A.,0,0,0,0
1668380030158,ECE 277,A00,103668,An; Cheolhong,0,0,0,0
1668380030585,ECE 279,A00,117947,Hall; Drew A.,0,0,0,0
1668380031442,ECE 283,A00,103670,Hsueh; Tzu-Chien,0,0,0,0
1668380031868,ECE 284,A00,103671,Turakhia; Yatish Girish,0,0,0,0
1668380032291,ECE 285,A00,103672,Zheng; Yang,0,0,0,0
1668380032291,ECE 285,B00,103673,Sworder; David D.,0,0,0,0
1668380032715,ECE 287,A00,103676,Javidi; Tara,0,0,0,0
1668380033150,MATH 200B,A00,098023,Salehi Golsefidy; Alireza,12,0,15,3
1668380033574,MATH 202B,A00,098024,Rhoades; Brendon Patrick,9,0,15,6
1668380033999,MATH 203B,A00,098025,Oprea; Dragos N.,10,0,15,5
1668380034423,MATH 204B,A00,098026,Sorensen; Claus M,13,0,15,2
1668380034861,MATH 208,A00,098027,Izadi; Elham,7,0,10,3
1668380035287,MATH 209,A00,098028,Pollack; Aaron,10,0,10,0
1668380035715,MATH 211A,A00,112919,Rogalski; Daniel,9,0,10,1
1668380036140,MATH 211B,A00,112920,Seward; Brandon M.,9,0,10,1
1668380036566,MATH 218,A00,098029,Li; Bo,10,0,10,0
1668380037000,MATH 220B,A00,098030,Novak; Jonathan I,11,0,15,4
1668380037426,MATH 221A,A00,098031,Ebenfelt; Peter F,13,0,15,2
1668380037853,MATH 231B,A00,098032,Zlatos; Andrej,12,0,15,3
1668380038277,MATH 240B,A00,098033,Ni; Lei,9,0,15,6
1668380038702,MATH 243,A00,098034,Jekel; David Andrew,10,0,10,0
1668380039128,MATH 245A,A00,098035,Nie; Jiawang,0,0,15,16
1668380039553,MATH 248,A00,098036,Bejenaru; Ioan,10,0,10,0
1668380039977,MATH 250B,A00,098037,Spolaor; Luca,14,0,15,1
1668380040403,MATH 258,A00,098038,Ni; Lei,10,0,10,0
1668380040828,MATH 264B,A00,098041,Rhoades; Brendon Patrick,9,0,15,6
1668380041250,MATH 268,A00,098042,Buss; Samuel R,10,0,10,0
1668380041674,MATH 269,A00,098043,Rhoades; Brendon Patrick,10,0,10,0
1668380042099,MATH 270B,A00,098044,Li; Bo,10,0,15,5
1668380042524,MATH 272B,A00,098045,Holst; Michael J,13,0,15,2
1668380042951,MATH 273A,A00,098046,Tian; Xiaochuan,10,0,15,5
1668380043374,MATH 275,A01,098048,Tian; Xiaochuan,6,0,10,4
1668380043799,MATH 278A,A00,098049,Holst; Michael J,8,0,10,2
1668380044238,MATH 278B,A00,098050,Cloninger; Alexander,10,0,10,0
1668380044662,MATH 278C,A00,098051,Nie; Jiawang,7,0,10,3
1668380045085,MATH 280B,A00,098052,Zheng; Tianyi,8,0,15,7
1668380045508,MATH 281B,A00,098053,Bradic; Jelena,1,0,15,14
1668380045934,MATH 282B,A00,098054,Arias-Castro; Ery,0,0,15,15
1668380046360,MATH 285,A00,098055,Fitzsimmons; Patrick J,0,0,15,17
1668380046783,MATH 287B,A00,098056,Arias-Castro; Ery,2,0,15,13
1668380047306,MATH 288,A00,098057,Agarwal; Pooja,9,0,10,1
1668380047306,MATH 288,B00,098058,Zhang; Danna,8,0,10,2
1668380047306,MATH 288,C00,098059,Williams; Ruth J,9,0,10,1
1668380047732,MATH 290B,A00,098060,Roberts; Justin Deritter,13,0,15,2
1668380048156,MATH 292,A00,098061,Belmont; Eva Kinoshita,10,0,10,0
1668380048588,MATH 295,A00,098062,Suk; Andrew Hoon,48,0,50,2
1668380049012,MATH 296,A00,098063,Novak; Jonathan I,20,0,20,0
1668380049446,MATH 297,001,098064,Gamst; Anthony Collins,9997,0,9999,2
1668380549634,COGS 205,A00,101395,Chiba; Andrea,19,0,20,1
1668380550064,COGS 210B,001,101404,Greene; Deanna Jacquelyn,9998,0,9999,1
1668380550064,COGS 210B,002,101417,Xia; Haijun,9999,0,9999,0
1668380550064,COGS 210B,003,101422,Nitz; Douglas A.,9999,0,9999,0
1668380550064,COGS 210B,004,101423,Hollan; James D.,9998,0,9999,1
1668380550064,COGS 210B,005,101424,Deak; Gedeon O.,9998,0,9999,1
1668380550064,COGS 210B,006,101425,Rossano; Federico,9999,0,9999,0
1668380550496,COGS 211B,A00,101427,Coulson; Seana M,9996,0,9999,3
1668380550931,COGS 220,A00,101428,Hollan; James D.,0,0,25,25
1668380551364,COGS 229,A00,101429,Dow; Steven P,18,0,25,7
1668380551787,COGS 230,A00,101430,Klemmer; Scott R,11,0,17,6
1668380552213,COGS 234,A00,101431,Xia; Haijun,1,0,25,24
1668380552638,COGS 260,A00,101432,Kiyonaga; Anastasia,21,0,25,4
1668380552638,COGS 260,B00,101433,Kirsh; David Joel,15,0,25,10
1668380553071,CSE 202,A00,102371,Impagliazzo; Russell,0,0,0,0
1668380553494,CSE 203B,A01,102373,Cheng; Chung Kuan,0,0,0,0
1668380553921,CSE 208,A00,102374,Micciancio; Daniele,0,0,0,0
1668380554347,CSE 209A,A00,112895,Impagliazzo; Russell,0,0,15,15
1668380554770,CSE 209B,A00,108005,Bellare; Mihir,0,0,0,0
1668380555204,CSE 210,A00,113163,Coblenz; Michael J,0,0,0,0
1668380555633,CSE 219,A00,106111,Dow; Steven P,0,0,20,20
1668380556059,CSE 221,A00,102376,Voelker; Geoffrey M.,0,0,0,0
1668380556487,CSE 224,A01,102378,Porter; George M,0,0,0,0
1668380556909,CSE 229A,A00,102379,Savage; Stefan,0,0,0,0
1668380557343,CSE 229C,A00,102380,Munyaka; Imani N. S.,0,0,0,0
1668380557779,CSE 232B,A00,102382,Deutsch; Alin Bernard,0,0,0,0
1668380558212,CSE 234,A01,112904,Kumar; Arun Kumar,0,0,0,0
1668380558637,CSE 237A,A00,102383,Rosing; Tajana Simunic,0,0,0,0
1668380559065,CSE 239A,A00,102384,Deutsch; Alin Bernard,0,0,0,0
1668380559491,CSE 239B,A00,102385,Polikarpova; Nadezhda,0,0,0,0
1668380559917,CSE 240A,A00,102386,Pannuto; Patrick William,0,0,0,0
1668380560341,CSE 240B,A00,102387,Zhao; Jishen,0,0,0,0
1668380560766,CSE 241A,A00,106406,Kang; Mingu,0,0,0,0
1668380561196,CSE 249B,A00,102388,Kahng; Andrew Byun,0,0,8,8
1668380561624,CSE 251B,A01,102392,Cottrell; Garrison W,0,0,0,0
1668380561624,CSE 251B,A02,102393,Cottrell; Garrison W,0,0,0,0
1668380562048,CSE 252B,A00,102394,Ochoa; Benjamin Lawrence,0,0,0,0
1668380562477,CSE 257,A01,102396,Gao; Sicun,0,0,0,0
1668380562900,CSE 272,A00,102397,Li; Tzumao,0,0,0,0
1668380563325,CSE 274,A00,111323,Chern; Albert Ren-Haur,0,0,0,0
1668380563752,CSE 282,A00,102398,Pevzner; Pavel Arkadjevich,0,0,0,0
1668380564177,CSE 284,A00,114175,Gymrek; Melissa Ann,0,0,0,0
1668380564607,CSE 290,A00,102399,Chandraker; Manmohan Krishna,0,0,0,0
1668380564607,CSE 290,B00,102400,Vaccaro; Kristen Marie,0,0,25,25
1668380564607,CSE 290,C00,102414,Pannuto; Patrick William,0,0,25,25
1668380564607,CSE 290,D00,102427,Pevzner; Pavel Arkadjevich,0,0,0,0
1668380564607,CSE 290,E00,102429,Zhao; Jishen,0,0,0,0
1668380564607,CSE 290,F00,102436,Tullsen; Dean Michael,0,0,0,0
1668380564607,CSE 290,G00,102440,Christensen; Henrik I,0,0,20,20
1668380565041,CSE 291,A00,102443,Su; Hao,0,0,0,0
1668380565041,CSE 291,B00,102448,Polikarpova; Nadezhda,0,0,0,0
1668380565041,CSE 291,C00,102453,Vaccaro; Kristen Marie,0,0,0,0
1668380565041,CSE 291,D00,111343,Savage; Stefan,0,0,0,0
1668380565041,CSE 291,E00,116474,Claffy; Kimberly Claire,0,0,0,0
1668380565041,CSE 291,F00,116479,Pasquale; Joseph,0,0,0,0
1668380565466,CSE 293,001,119111,Bafna; Vineet,9999,0,9999,0
1668380565466,CSE 293,002,119118,Bellare; Mihir,9999,0,9999,0
1668380565466,CSE 293,003,119122,Berg-Kirkpatrick; Taylor D,9999,0,9999,0
1668380565466,CSE 293,004,119135,Christensen; Henrik I,9999,0,9999,0
1668380565466,CSE 293,005,119142,Cottrell; Garrison W,9999,0,9999,0
1668380565466,CSE 293,006,119146,Deutsch; Alin Bernard,9999,0,9999,0
1668380565466,CSE 293,007,119159,Esmaeilzadeh; Hadi,9999,0,9999,0
1668380565466,CSE 293,008,119166,Freund; Yoav,9999,0,9999,0
1668380565466,CSE 293,009,119170,Griswold; William G.,9999,0,9999,0
1668380565466,CSE 293,010,119183,Gymrek; Melissa Ann,9999,0,9999,0
1668380565466,CSE 293,011,119190,Heninger; Nadia A,9999,0,9999,0
1668380565466,CSE 293,012,119230,Impagliazzo; Russell,9999,0,9999,0
1668380565466,CSE 293,013,119232,Jhala; Ranjit,9999,0,9999,0
1668380565466,CSE 293,014,119233,Kahng; Andrew Byun,9999,0,9999,0
1668380565466,CSE 293,015,119298,Kane; Daniel Mertz,9999,0,9999,0
1668380565466,CSE 293,016,119299,Kriegman; David J,9999,0,9999,0
1668380565466,CSE 293,017,119300,Kumar; Arun Kumar,9999,0,9999,0
1668380565466,CSE 293,018,119301,Lerner; Sorin,9999,0,9999,0
1668380565466,CSE 293,019,119302,Lovett; Shachar,9999,0,9999,0
1668380565466,CSE 293,020,119303,McAuley; Julian John,9999,0,9999,0
1668380565466,CSE 293,021,119304,Micciancio; Daniele,9999,0,9999,0
1668380565466,CSE 293,022,119367,Orailoglu; Alex,9999,0,9999,0
1668380565466,CSE 293,023,119382,Paturi; Ramamohan,9999,0,9999,0
1668380565466,CSE 293,024,119404,Polikarpova; Nadezhda,9999,0,9999,0
1668380565466,CSE 293,025,119406,Politz; Joseph Gibbs,9999,0,9999,0
1668380565466,CSE 293,026,119411,Porter; George M,9999,0,9999,0
1668380565466,CSE 293,027,119414,Porter; Leonard Emerson,9999,0,9999,0
1668380565466,CSE 293,028,119416,Ramamoorthi; Ravi,9999,0,9999,0
1668380565466,CSE 293,029,119417,Sahoo; Debashis,9999,0,9999,0
1668380565466,CSE 293,030,119420,Saul; Lawrence,9999,0,9999,0
1668380565466,CSE 293,031,119421,Savage; Stefan,9999,0,9999,0
1668380565466,CSE 293,032,119425,Schulze; Jurgen P.,9999,0,9999,0
1668380565466,CSE 293,033,119426,Snoeren; Alex C.,9999,0,9999,0
1668380565466,CSE 293,034,119428,Shang; Jingbo,9999,0,9999,0
1668380565466,CSE 293,035,119430,Stefan; Deian,9999,0,9999,0
1668380565466,CSE 293,036,119431,Su; Hao,9999,0,9999,0
1668380565466,CSE 293,037,119433,Swanson; Steven James,9999,0,9999,0
1668380565466,CSE 293,038,119435,Tullsen; Dean Michael,9999,0,9999,0
1668380565466,CSE 293,039,119483,Voelker; Geoffrey M.,9999,0,9999,0
1668380565466,CSE 293,040,119537,Zhao; Jishen,9999,0,9999,0
1668380565466,CSE 293,041,119538,Zhou; Yuan-Yuan,9999,0,9999,0
1668380565466,CSE 293,042,119539,Gao; Sicun,9999,0,9999,0
1668380565466,CSE 293,043,119540,Weibel; Nadir,9999,0,9999,0
1668380565466,CSE 293,044,119541,Gupta; Rajesh K.,9999,0,9999,0
1668380565466,CSE 293,045,126410,Vaccaro; Kristen Marie,9999,0,9999,0
1668380565466,CSE 293,046,126411,Klemke; Richard,9999,0,9999,0
1668380565889,CSE 294,A00,102459,Voelker; Geoffrey M.,0,0,0,0
1668380565889,CSE 294,B00,111322,Orailoglu; Alex,0,0,0,0
1668380566313,DSE 201,A00,096914,Deutsch; Alin Bernard,30,0,30,0
1668380566737,DSE 210,A00,096915,Dasgupta; Sanjoy,30,0,30,0
1668380567163,DSE 260A,A00,096916,Altintas De Callaf; Ilkay,30,0,30,0
1668380567705,ECE 200,001,103586,Antipa; Nicholas A,9999,0,9999,0
1668380567705,ECE 200,002,103587,Atanasov; Nikolay A.,9999,0,9999,0
1668380567705,ECE 200,003,103588,Bharadia; Dinesh,9999,0,9999,0
1668380567705,ECE 200,004,103589,Cheng; Chung Kuan,9999,0,9999,0
1668380567705,ECE 200,005,103590,Cosman; Pamela C.,9999,0,9999,0
1668380567705,ECE 200,006,103591,Dayeh; Shadi Ahmad,9999,0,9999,0
1668380567705,ECE 200,007,103592,Fainman; Yeshaiahu,9999,0,9999,0
1668380567705,ECE 200,008,103593,Ford; Joseph Earl,9999,0,9999,0
1668380567705,ECE 200,009,103594,Franceschetti; Massimo,9999,0,9999,0
1668380567705,ECE 200,010,103595,Fullerton; Eric E,9999,0,9999,0
1668380567705,ECE 200,011,103596,Galton; Ian A,9999,0,9999,0
1668380567705,ECE 200,012,103597,Gilja; Vikash,9999,0,9999,0
1668380567705,ECE 200,013,103598,Hall; Drew A.,9999,0,9999,0
1668380567705,ECE 200,014,103599,Hsueh; Tzu-Chien,9999,0,9999,0
1668380567705,ECE 200,015,103600,Javidi; Tara,9999,0,9999,0
1668380567705,ECE 200,016,103601,Kahng; Andrew Byun,9999,0,9999,0
1668380567705,ECE 200,017,103602,Kim; Young-Han,9999,0,9999,0
1668380567705,ECE 200,018,103603,Koushanfar; Farinaz,9999,0,9999,0
1668380567705,ECE 200,019,103604,Kuzum; Duygu,9999,0,9999,0
1668380567705,ECE 200,020,103605,Le; Hanh-Phuc,9999,0,9999,0
1668380567705,ECE 200,021,103606,Lin; Bill,9999,0,9999,0
1668380567705,ECE 200,022,103607,Liu; Zhaowei,9998,0,9999,1
1668380567705,ECE 200,023,103608,Lo; Yu-Hwa,9999,0,9999,0
1668380567705,ECE 200,024,103609,Lomakin; Vitaliy,9999,0,9999,0
1668380567705,ECE 200,025,103610,Mercier; Patrick Philip,9999,0,9999,0
1668380567705,ECE 200,026,103611,Meyer; Florian,9999,0,9999,0
1668380567705,ECE 200,027,103612,Milstein; Laurence B.,9999,0,9999,0
1668380567705,ECE 200,028,103613,Mir Arabbaygi; Siavash,9999,0,9999,0
1668380567705,ECE 200,029,103614,Mookherjea; Shayan,9999,0,9999,0
1668380567705,ECE 200,030,103615,Morris; Karcher William,9999,0,9999,0
1668380567705,ECE 200,031,103616,Ng; Tse Nga,9999,0,9999,0
1668380567705,ECE 200,032,103617,Nguyen; Truong Quang,9999,0,9999,0
1668380567705,ECE 200,033,103618,Nomura; Kenji,9999,0,9999,0
1668380567705,ECE 200,034,103619,Orlitsky; Alon,9999,0,9999,0
1668380567705,ECE 200,035,103620,Pal; Piya,9999,0,9999,0
1668380567705,ECE 200,036,103621,Papen; George C.,9999,0,9999,0
1668380567705,ECE 200,037,103622,Radic; Stojan,9999,0,9999,0
1668380567705,ECE 200,038,103623,Rao; Bhaskar D.,9999,0,9999,0
1668380567705,ECE 200,039,103624,Rao; Ramesh R,9999,0,9999,0
1668380567705,ECE 200,040,103625,Rebeiz; Gabriel,9999,0,9999,0
1668380567705,ECE 200,041,103626,Sanford; John R,9999,0,9999,0
1668380567705,ECE 200,042,103627,Siegel; Paul H.,9999,0,9999,0
1668380567705,ECE 200,043,103628,Sievenpiper; Daniel F.,9999,0,9999,0
1668380567705,ECE 200,044,103629,Sworder; David D.,9999,0,9999,0
1668380567705,ECE 200,045,103630,Taur; Yuan,9999,0,9999,0
1668380567705,ECE 200,046,103631,Touri; Behrouz,9999,0,9999,0
1668380567705,ECE 200,047,103632,Trivedi; Mohan M.,9999,0,9999,0
1668380567705,ECE 200,048,103633,Vasconcelos; Nuno,9999,0,9999,0
1668380567705,ECE 200,049,103634,Wang; Xiaolong,9999,0,9999,0
1668380567705,ECE 200,050,103635,Xie; Pengtao,9999,0,9999,0
1668380567705,ECE 200,051,103636,Yip; Michael,9999,0,9999,0
1668380567705,ECE 200,052,103637,Zeger; Kenneth A.,999,0,999,0
1668380567705,ECE 200,053,103638,Zhang; Xinyu,9999,0,9999,0
1668380567705,ECE 200,054,103639,Turakhia; Yatish Girish,9999,0,9999,0
1668380567705,ECE 200,055,103640,Kang; Mingu,9999,0,9999,0
1668380567705,ECE 200,056,103641,Shi; Yuanyuan,9999,0,9999,0
1668380567705,ECE 200,057,103642,Wang; Edward Jay,9999,0,9999,0
1668380567705,ECE 200,058,103643,Zheng; Yang,9999,0,9999,0
1668380568129,ECE 202,A00,103644,Kuzum; Duygu,0,0,0,0
1668380568551,ECE 212BN,A00,103646,Ng; Tse Nga,0,0,0,0
1668380568977,ECE 221,A00,111493,Staff,0,0,0,0
1668380569401,ECE 222B,A00,103647,Lomakin; Vitaliy,0,0,0,0
1668380569825,ECE 230B,A00,103648,Taur; Yuan,0,0,0,0
1668380570255,ECE 238B,A00,103649,Garay; Javier,0,0,0,0
1668380570679,ECE 240B,A00,112900,Fainman; Yeshaiahu,0,0,0,0
1668380571102,ECE 247A,A00,103650,Jokerst; Jesse Vincent,0,0,0,0
1668380571524,ECE 247B,A00,103651,Wang; Joseph,0,0,0,0
1668380571949,ECE 250,A00,103652,Siegel; Paul H.,0,0,0,0
1668380572372,ECE 251A,A00,103654,Rao; Bhaskar D.,0,0,0,0
1668380572796,ECE 257B,A00,103655,Bharadia; Dinesh,0,0,0,0
1668380573220,ECE 258A,A00,103656,Milstein; Laurence B.,0,0,0,0
1668380573645,ECE 260B,A00,103658,Kang; Mingu,0,0,0,0
1668380574072,ECE 264A,A00,103659,Galton; Ian A,0,0,0,0
1668380574496,ECE 265A,A00,103661,Gudem; Prasad S.S.,0,0,0,0
1668380574918,ECE 265D,A00,103662,Gudem; Prasad S.S.,0,0,0,0
1668380575342,ECE 268,A00,103663,Koushanfar; Farinaz,0,0,0,0
1668380575766,ECE 269,A01,103665,Pal; Piya,0,0,0,0
1668380576188,ECE 271B,A00,103666,Vasconcelos; Manuela,0,0,0,0
1668380576612,ECE 276A,A00,103667,Atanasov; Nikolay A.,0,0,0,0
1668380577049,ECE 277,A00,103668,An; Cheolhong,0,0,0,0
1668380577479,ECE 279,A00,117947,Hall; Drew A.,0,0,0,0
1668380578339,ECE 283,A00,103670,Hsueh; Tzu-Chien,0,0,0,0
1668380578762,ECE 284,A00,103671,Turakhia; Yatish Girish,0,0,0,0
1668380579187,ECE 285,A00,103672,Zheng; Yang,0,0,0,0
1668380579187,ECE 285,B00,103673,Sworder; David D.,0,0,0,0
1668380579611,ECE 287,A00,103676,Javidi; Tara,0,0,0,0
1668380580036,MATH 200B,A00,098023,Salehi Golsefidy; Alireza,12,0,15,3
1668380580462,MATH 202B,A00,098024,Rhoades; Brendon Patrick,9,0,15,6
1668380580889,MATH 203B,A00,098025,Oprea; Dragos N.,10,0,15,5
1668380581312,MATH 204B,A00,098026,Sorensen; Claus M,13,0,15,2
1668380581740,MATH 208,A00,098027,Izadi; Elham,7,0,10,3
1668380582172,MATH 209,A00,098028,Pollack; Aaron,10,0,10,0
1668380582595,MATH 211A,A00,112919,Rogalski; Daniel,9,0,10,1
1668380583017,MATH 211B,A00,112920,Seward; Brandon M.,9,0,10,1
1668380583449,MATH 218,A00,098029,Li; Bo,10,0,10,0
1668380583873,MATH 220B,A00,098030,Novak; Jonathan I,11,0,15,4
1668380584296,MATH 221A,A00,098031,Ebenfelt; Peter F,13,0,15,2
1668380584725,MATH 231B,A00,098032,Zlatos; Andrej,12,0,15,3
1668380585148,MATH 240B,A00,098033,Ni; Lei,9,0,15,6
1668380585586,MATH 243,A00,098034,Jekel; David Andrew,10,0,10,0
1668380586013,MATH 245A,A00,098035,Nie; Jiawang,0,0,15,16
1668380586436,MATH 248,A00,098036,Bejenaru; Ioan,10,0,10,0
1668380586863,MATH 250B,A00,098037,Spolaor; Luca,14,0,15,1
1668380587291,MATH 258,A00,098038,Ni; Lei,10,0,10,0
1668380587717,MATH 264B,A00,098041,Rhoades; Brendon Patrick,9,0,15,6
1668380588140,MATH 268,A00,098042,Buss; Samuel R,10,0,10,0
1668380588568,MATH 269,A00,098043,Rhoades; Brendon Patrick,10,0,10,0
1668380588995,MATH 270B,A00,098044,Li; Bo,10,0,15,5
1668380589418,MATH 272B,A00,098045,Holst; Michael J,13,0,15,2
1668380589841,MATH 273A,A00,098046,Tian; Xiaochuan,10,0,15,5
1668380590266,MATH 275,A01,098048,Tian; Xiaochuan,6,0,10,4
1668380590690,MATH 278A,A00,098049,Holst; Michael J,8,0,10,2
1668380591115,MATH 278B,A00,098050,Cloninger; Alexander,10,0,10,0
1668380591538,MATH 278C,A00,098051,Nie; Jiawang,7,0,10,3
1668380591962,MATH 280B,A00,098052,Zheng; Tianyi,8,0,15,7
1668380592402,MATH 281B,A00,098053,Bradic; Jelena,1,0,15,14
1668380592824,MATH 282B,A00,098054,Arias-Castro; Ery,0,0,15,15
1668380593248,MATH 285,A00,098055,Fitzsimmons; Patrick J,0,0,15,17
1668380593676,MATH 287B,A00,098056,Arias-Castro; Ery,2,0,15,13
1668380594101,MATH 288,A00,098057,Agarwal; Pooja,9,0,10,1
1668380594101,MATH 288,B00,098058,Zhang; Danna,8,0,10,2
1668380594101,MATH 288,C00,098059,Williams; Ruth J,9,0,10,1
1668380594523,MATH 290B,A00,098060,Roberts; Justin Deritter,13,0,15,2
1668380594948,MATH 292,A00,098061,Belmont; Eva Kinoshita,10,0,10,0
1668380595372,MATH 295,A00,098062,Suk; Andrew Hoon,48,0,50,2
1668380595796,MATH 296,A00,098063,Novak; Jonathan I,20,0,20,0
1668380596220,MATH 297,001,098064,Gamst; Anthony Collins,9997,0,9999,2
1668381096489,COGS 205,A00,101395,Chiba; Andrea,19,0,20,1
1668381096914,COGS 210B,001,101404,Greene; Deanna Jacquelyn,9998,0,9999,1
1668381096914,COGS 210B,002,101417,Xia; Haijun,9999,0,9999,0
1668381096914,COGS 210B,003,101422,Nitz; Douglas A.,9999,0,9999,0
1668381096914,COGS 210B,004,101423,Hollan; James D.,9998,0,9999,1
1668381096914,COGS 210B,005,101424,Deak; Gedeon O.,9998,0,9999,1
1668381096914,COGS 210B,006,101425,Rossano; Federico,9999,0,9999,0
1668381097339,COGS 211B,A00,101427,Coulson; Seana M,9996,0,9999,3
1668381097764,COGS 220,A00,101428,Hollan; James D.,0,0,25,25
1668381098189,COGS 229,A00,101429,Dow; Steven P,18,0,25,7
1668381098614,COGS 230,A00,101430,Klemmer; Scott R,11,0,17,6
1668381099037,COGS 234,A00,101431,Xia; Haijun,1,0,25,24
1668381099462,COGS 260,A00,101432,Kiyonaga; Anastasia,21,0,25,4
1668381099462,COGS 260,B00,101433,Kirsh; David Joel,15,0,25,10
1668381099887,CSE 202,A00,102371,Impagliazzo; Russell,0,0,0,0
1668381100312,CSE 203B,A01,102373,Cheng; Chung Kuan,0,0,0,0
1668381100736,CSE 208,A00,102374,Micciancio; Daniele,0,0,0,0
1668381101159,CSE 209A,A00,112895,Impagliazzo; Russell,0,0,15,15
1668381101582,CSE 209B,A00,108005,Bellare; Mihir,0,0,0,0
1668381102006,CSE 210,A00,113163,Coblenz; Michael J,0,0,0,0
1668381102430,CSE 219,A00,106111,Dow; Steven P,0,0,20,20
1668381102854,CSE 221,A00,102376,Voelker; Geoffrey M.,0,0,0,0
1668381103278,CSE 224,A01,102378,Porter; George M,0,0,0,0
1668381103700,CSE 229A,A00,102379,Savage; Stefan,0,0,0,0
1668381104125,CSE 229C,A00,102380,Munyaka; Imani N. S.,0,0,0,0
1668381104548,CSE 232B,A00,102382,Deutsch; Alin Bernard,0,0,0,0
1668381104978,CSE 234,A01,112904,Kumar; Arun Kumar,0,0,0,0
1668381105405,CSE 237A,A00,102383,Rosing; Tajana Simunic,0,0,0,0
1668381105830,CSE 239A,A00,102384,Deutsch; Alin Bernard,0,0,0,0
1668381106256,CSE 239B,A00,102385,Polikarpova; Nadezhda,0,0,0,0
1668381106680,CSE 240A,A00,102386,Pannuto; Patrick William,0,0,0,0
1668381107104,CSE 240B,A00,102387,Zhao; Jishen,0,0,0,0
1668381107528,CSE 241A,A00,106406,Kang; Mingu,0,0,0,0
1668381107953,CSE 249B,A00,102388,Kahng; Andrew Byun,0,0,8,8
1668381108376,CSE 251B,A01,102392,Cottrell; Garrison W,0,0,0,0
1668381108376,CSE 251B,A02,102393,Cottrell; Garrison W,0,0,0,0
1668381108802,CSE 252B,A00,102394,Ochoa; Benjamin Lawrence,0,0,0,0
1668381109230,CSE 257,A01,102396,Gao; Sicun,0,0,0,0
1668381109658,CSE 272,A00,102397,Li; Tzumao,0,0,0,0
1668381110083,CSE 274,A00,111323,Chern; Albert Ren-Haur,0,0,0,0
1668381110517,CSE 282,A00,102398,Pevzner; Pavel Arkadjevich,0,0,0,0
1668381110940,CSE 284,A00,114175,Gymrek; Melissa Ann,0,0,0,0
1668381111369,CSE 290,A00,102399,Chandraker; Manmohan Krishna,0,0,0,0
1668381111369,CSE 290,B00,102400,Vaccaro; Kristen Marie,0,0,25,25
1668381111369,CSE 290,C00,102414,Pannuto; Patrick William,0,0,25,25
1668381111369,CSE 290,D00,102427,Pevzner; Pavel Arkadjevich,0,0,0,0
1668381111369,CSE 290,E00,102429,Zhao; Jishen,0,0,0,0
1668381111369,CSE 290,F00,102436,Tullsen; Dean Michael,0,0,0,0
1668381111369,CSE 290,G00,102440,Christensen; Henrik I,0,0,20,20
1668381111794,CSE 291,A00,102443,Su; Hao,0,0,0,0
1668381111794,CSE 291,B00,102448,Polikarpova; Nadezhda,0,0,0,0
1668381111794,CSE 291,C00,102453,Vaccaro; Kristen Marie,0,0,0,0
1668381111794,CSE 291,D00,111343,Savage; Stefan,0,0,0,0
1668381111794,CSE 291,E00,116474,Claffy; Kimberly Claire,0,0,0,0
1668381111794,CSE 291,F00,116479,Pasquale; Joseph,0,0,0,0
1668381112263,CSE 293,001,119111,Bafna; Vineet,9999,0,9999,0
1668381112263,CSE 293,002,119118,Bellare; Mihir,9999,0,9999,0
1668381112263,CSE 293,003,119122,Berg-Kirkpatrick; Taylor D,9999,0,9999,0
1668381112263,CSE 293,004,119135,Christensen; Henrik I,9999,0,9999,0
1668381112263,CSE 293,005,119142,Cottrell; Garrison W,9999,0,9999,0
1668381112263,CSE 293,006,119146,Deutsch; Alin Bernard,9999,0,9999,0
1668381112263,CSE 293,007,119159,Esmaeilzadeh; Hadi,9999,0,9999,0
1668381112263,CSE 293,008,119166,Freund; Yoav,9999,0,9999,0
1668381112263,CSE 293,009,119170,Griswold; William G.,9999,0,9999,0
1668381112263,CSE 293,010,119183,Gymrek; Melissa Ann,9999,0,9999,0
1668381112263,CSE 293,011,119190,Heninger; Nadia A,9999,0,9999,0
1668381112263,CSE 293,012,119230,Impagliazzo; Russell,9999,0,9999,0
1668381112263,CSE 293,013,119232,Jhala; Ranjit,9999,0,9999,0
1668381112263,CSE 293,014,119233,Kahng; Andrew Byun,9999,0,9999,0
1668381112263,CSE 293,015,119298,Kane; Daniel Mertz,9999,0,9999,0
1668381112263,CSE 293,016,119299,Kriegman; David J,9999,0,9999,0
1668381112263,CSE 293,017,119300,Kumar; Arun Kumar,9999,0,9999,0
1668381112263,CSE 293,018,119301,Lerner; Sorin,9999,0,9999,0
1668381112263,CSE 293,019,119302,Lovett; Shachar,9999,0,9999,0
1668381112263,CSE 293,020,119303,McAuley; Julian John,9999,0,9999,0
1668381112263,CSE 293,021,119304,Micciancio; Daniele,9999,0,9999,0
1668381112263,CSE 293,022,119367,Orailoglu; Alex,9999,0,9999,0
1668381112263,CSE 293,023,119382,Paturi; Ramamohan,9999,0,9999,0
1668381112263,CSE 293,024,119404,Polikarpova; Nadezhda,9999,0,9999,0
1668381112263,CSE 293,025,119406,Politz; Joseph Gibbs,9999,0,9999,0
1668381112263,CSE 293,026,119411,Porter; George M,9999,0,9999,0
1668381112263,CSE 293,027,119414,Porter; Leonard Emerson,9999,0,9999,0
1668381112263,CSE 293,028,119416,Ramamoorthi; Ravi,9999,0,9999,0
1668381112263,CSE 293,029,119417,Sahoo; Debashis,9999,0,9999,0
1668381112263,CSE 293,030,119420,Saul; Lawrence,9999,0,9999,0
1668381112263,CSE 293,031,119421,Savage; Stefan,9999,0,9999,0
1668381112263,CSE 293,032,119425,Schulze; Jurgen P.,9999,0,9999,0
1668381112263,CSE 293,033,119426,Snoeren; Alex C.,9999,0,9999,0
1668381112263,CSE 293,034,119428,Shang; Jingbo,9999,0,9999,0
1668381112263,CSE 293,035,119430,Stefan; Deian,9999,0,9999,0
1668381112263,CSE 293,036,119431,Su; Hao,9999,0,9999,0
1668381112263,CSE 293,037,119433,Swanson; Steven James,9999,0,9999,0
1668381112263,CSE 293,038,119435,Tullsen; Dean Michael,9999,0,9999,0
1668381112263,CSE 293,039,119483,Voelker; Geoffrey M.,9999,0,9999,0
1668381112263,CSE 293,040,119537,Zhao; Jishen,9999,0,9999,0
1668381112263,CSE 293,041,119538,Zhou; Yuan-Yuan,9999,0,9999,0
1668381112263,CSE 293,042,119539,Gao; Sicun,9999,0,9999,0
1668381112263,CSE 293,043,119540,Weibel; Nadir,9999,0,9999,0
1668381112263,CSE 293,044,119541,Gupta; Rajesh K.,9999,0,9999,0
1668381112263,CSE 293,045,126410,Vaccaro; Kristen Marie,9999,0,9999,0
1668381112263,CSE 293,046,126411,Klemke; Richard,9999,0,9999,0
1668381112687,CSE 294,A00,102459,Voelker; Geoffrey M.,0,0,0,0
1668381112687,CSE 294,B00,111322,Orailoglu; Alex,0,0,0,0
1668381113116,DSE 201,A00,096914,Deutsch; Alin Bernard,30,0,30,0
1668381113543,DSE 210,A00,096915,Dasgupta; Sanjoy,30,0,30,0
1668381113966,DSE 260A,A00,096916,Altintas De Callaf; Ilkay,30,0,30,0
1668381114422,ECE 200,001,103586,Antipa; Nicholas A,9999,0,9999,0
1668381114422,ECE 200,002,103587,Atanasov; Nikolay A.,9999,0,9999,0
1668381114422,ECE 200,003,103588,Bharadia; Dinesh,9999,0,9999,0
1668381114422,ECE 200,004,103589,Cheng; Chung Kuan,9999,0,9999,0
1668381114422,ECE 200,005,103590,Cosman; Pamela C.,9999,0,9999,0
1668381114422,ECE 200,006,103591,Dayeh; Shadi Ahmad,9999,0,9999,0
1668381114422,ECE 200,007,103592,Fainman; Yeshaiahu,9999,0,9999,0
1668381114422,ECE 200,008,103593,Ford; Joseph Earl,9999,0,9999,0
1668381114422,ECE 200,009,103594,Franceschetti; Massimo,9999,0,9999,0
1668381114422,ECE 200,010,103595,Fullerton; Eric E,9999,0,9999,0
1668381114422,ECE 200,011,103596,Galton; Ian A,9999,0,9999,0
1668381114422,ECE 200,012,103597,Gilja; Vikash,9999,0,9999,0
1668381114422,ECE 200,013,103598,Hall; Drew A.,9999,0,9999,0
1668381114422,ECE 200,014,103599,Hsueh; Tzu-Chien,9999,0,9999,0
1668381114422,ECE 200,015,103600,Javidi; Tara,9999,0,9999,0
1668381114422,ECE 200,016,103601,Kahng; Andrew Byun,9999,0,9999,0
1668381114422,ECE 200,017,103602,Kim; Young-Han,9999,0,9999,0
1668381114422,ECE 200,018,103603,Koushanfar; Farinaz,9999,0,9999,0
1668381114422,ECE 200,019,103604,Kuzum; Duygu,9999,0,9999,0
1668381114422,ECE 200,020,103605,Le; Hanh-Phuc,9999,0,9999,0
1668381114422,ECE 200,021,103606,Lin; Bill,9999,0,9999,0
1668381114422,ECE 200,022,103607,Liu; Zhaowei,9998,0,9999,1
1668381114422,ECE 200,023,103608,Lo; Yu-Hwa,9999,0,9999,0
1668381114422,ECE 200,024,103609,Lomakin; Vitaliy,9999,0,9999,0
1668381114422,ECE 200,025,103610,Mercier; Patrick Philip,9999,0,9999,0
1668381114422,ECE 200,026,103611,Meyer; Florian,9999,0,9999,0
1668381114422,ECE 200,027,103612,Milstein; Laurence B.,9999,0,9999,0
1668381114422,ECE 200,028,103613,Mir Arabbaygi; Siavash,9999,0,9999,0
1668381114422,ECE 200,029,103614,Mookherjea; Shayan,9999,0,9999,0
1668381114422,ECE 200,030,103615,Morris; Karcher William,9999,0,9999,0
1668381114422,ECE 200,031,103616,Ng; Tse Nga,9999,0,9999,0
1668381114422,ECE 200,032,103617,Nguyen; Truong Quang,9999,0,9999,0
1668381114422,ECE 200,033,103618,Nomura; Kenji,9999,0,9999,0
1668381114422,ECE 200,034,103619,Orlitsky; Alon,9999,0,9999,0
1668381114422,ECE 200,035,103620,Pal; Piya,9999,0,9999,0
1668381114422,ECE 200,036,103621,Papen; George C.,9999,0,9999,0
1668381114422,ECE 200,037,103622,Radic; Stojan,9999,0,9999,0
1668381114422,ECE 200,038,103623,Rao; Bhaskar D.,9999,0,9999,0
1668381114422,ECE 200,039,103624,Rao; Ramesh R,9999,0,9999,0
1668381114422,ECE 200,040,103625,Rebeiz; Gabriel,9999,0,9999,0
1668381114422,ECE 200,041,103626,Sanford; John R,9999,0,9999,0
1668381114422,ECE 200,042,103627,Siegel; Paul H.,9999,0,9999,0
1668381114422,ECE 200,043,103628,Sievenpiper; Daniel F.,9999,0,9999,0
1668381114422,ECE 200,044,103629,Sworder; David D.,9999,0,9999,0
1668381114422,ECE 200,045,103630,Taur; Yuan,9999,0,9999,0
1668381114422,ECE 200,046,103631,Touri; Behrouz,9999,0,9999,0
1668381114422,ECE 200,047,103632,Trivedi; Mohan M.,9999,0,9999,0
1668381114422,ECE 200,048,103633,Vasconcelos; Nuno,9999,0,9999,0
1668381114422,ECE 200,049,103634,Wang; Xiaolong,9999,0,9999,0
1668381114422,ECE 200,050,103635,Xie; Pengtao,9999,0,9999,0
1668381114422,ECE 200,051,103636,Yip; Michael,9999,0,9999,0
1668381114422,ECE 200,052,103637,Zeger; Kenneth A.,999,0,999,0
1668381114422,ECE 200,053,103638,Zhang; Xinyu,9999,0,9999,0
1668381114422,ECE 200,054,103639,Turakhia; Yatish Girish,9999,0,9999,0
1668381114422,ECE 200,055,103640,Kang; Mingu,9999,0,9999,0
1668381114422,ECE 200,056,103641,Shi; Yuanyuan,9999,0,9999,0
1668381114422,ECE 200,057,103642,Wang; Edward Jay,9999,0,9999,0
1668381114422,ECE 200,058,103643,Zheng; Yang,9999,0,9999,0
1668381114845,ECE 202,A00,103644,Kuzum; Duygu,0,0,0,0
1668381115270,ECE 212BN,A00,103646,Ng; Tse Nga,0,0,0,0
1668381115696,ECE 221,A00,111493,Staff,0,0,0,0
1668381116130,ECE 222B,A00,103647,Lomakin; Vitaliy,0,0,0,0
1668381116554,ECE 230B,A00,103648,Taur; Yuan,0,0,0,0
1668381116981,ECE 238B,A00,103649,Garay; Javier,0,0,0,0
1668381117404,ECE 240B,A00,112900,Fainman; Yeshaiahu,0,0,0,0
1668381117830,ECE 247A,A00,103650,Jokerst; Jesse Vincent,0,0,0,0
1668381118269,ECE 247B,A00,103651,Wang; Joseph,0,0,0,0
1668381118695,ECE 250,A00,103652,Siegel; Paul H.,0,0,0,0
1668381119120,ECE 251A,A00,103654,Rao; Bhaskar D.,0,0,0,0
1668381119549,ECE 257B,A00,103655,Bharadia; Dinesh,0,0,0,0
1668381119974,ECE 258A,A00,103656,Milstein; Laurence B.,0,0,0,0
1668381120397,ECE 260B,A00,103658,Kang; Mingu,0,0,0,0
1668381120827,ECE 264A,A00,103659,Galton; Ian A,0,0,0,0
1668381121253,ECE 265A,A00,103661,Gudem; Prasad S.S.,0,0,0,0
1668381121677,ECE 265D,A00,103662,Gudem; Prasad S.S.,0,0,0,0
1668381122100,ECE 268,A00,103663,Koushanfar; Farinaz,0,0,0,0
1668381122525,ECE 269,A01,103665,Pal; Piya,0,0,0,0
1668381122950,ECE 271B,A00,103666,Vasconcelos; Manuela,0,0,0,0
1668381123382,ECE 276A,A00,103667,Atanasov; Nikolay A.,0,0,0,0
1668381123817,ECE 277,A00,103668,An; Cheolhong,0,0,0,0
1668381124238,ECE 279,A00,117947,Hall; Drew A.,0,0,0,0
1668381125089,ECE 283,A00,103670,Hsueh; Tzu-Chien,0,0,0,0
1668381125519,ECE 284,A00,103671,Turakhia; Yatish Girish,0,0,0,0
1668381125943,ECE 285,A00,103672,Zheng; Yang,0,0,0,0
1668381125943,ECE 285,B00,103673,Sworder; David D.,0,0,0,0
1668381126367,ECE 287,A00,103676,Javidi; Tara,0,0,0,0
1668381126791,MATH 200B,A00,098023,Salehi Golsefidy; Alireza,12,0,15,3
1668381127214,MATH 202B,A00,098024,Rhoades; Brendon Patrick,9,0,15,6
1668381127639,MATH 203B,A00,098025,Oprea; Dragos N.,10,0,15,5
1668381128062,MATH 204B,A00,098026,Sorensen; Claus M,13,0,15,2
1668381128488,MATH 208,A00,098027,Izadi; Elham,7,0,10,3
1668381128909,MATH 209,A00,098028,Pollack; Aaron,10,0,10,0
1668381129333,MATH 211A,A00,112919,Rogalski; Daniel,9,0,10,1
1668381129759,MATH 211B,A00,112920,Seward; Brandon M.,9,0,10,1
1668381130191,MATH 218,A00,098029,Li; Bo,10,0,10,0
1668381130621,MATH 220B,A00,098030,Novak; Jonathan I,11,0,15,4
1668381131122,MATH 221A,A00,098031,Ebenfelt; Peter F,13,0,15,2
1668381131550,MATH 231B,A00,098032,Zlatos; Andrej,12,0,15,3
1668381131977,MATH 240B,A00,098033,Ni; Lei,9,0,15,6
1668381132400,MATH 243,A00,098034,Jekel; David Andrew,10,0,10,0
1668381132824,MATH 245A,A00,098035,Nie; Jiawang,0,0,15,16
1668381133250,MATH 248,A00,098036,Bejenaru; Ioan,10,0,10,0
1668381133676,MATH 250B,A00,098037,Spolaor; Luca,14,0,15,1
1668381134103,MATH 258,A00,098038,Ni; Lei,10,0,10,0
1668381134529,MATH 264B,A00,098041,Rhoades; Brendon Patrick,9,0,15,6
1668381134950,MATH 268,A00,098042,Buss; Samuel R,10,0,10,0
1668381135379,MATH 269,A00,098043,Rhoades; Brendon Patrick,10,0,10,0
1668381135802,MATH 270B,A00,098044,Li; Bo,10,0,15,5
1668381136223,MATH 272B,A00,098045,Holst; Michael J,13,0,15,2
1668381136649,MATH 273A,A00,098046,Tian; Xiaochuan,10,0,15,5
1668381137073,MATH 275,A01,098048,Tian; Xiaochuan,6,0,10,4
1668381137497,MATH 278A,A00,098049,Holst; Michael J,8,0,10,2
1668381137918,MATH 278B,A00,098050,Cloninger; Alexander,10,0,10,0
1668381138340,MATH 278C,A00,098051,Nie; Jiawang,7,0,10,3
1668381138768,MATH 280B,A00,098052,Zheng; Tianyi,8,0,15,7
1668381139201,MATH 281B,A00,098053,Bradic; Jelena,1,0,15,14
1668381139626,MATH 282B,A00,098054,Arias-Castro; Ery,0,0,15,15
1668381140053,MATH 285,A00,098055,Fitzsimmons; Patrick J,0,0,15,17
1668381140478,MATH 287B,A00,098056,Arias-Castro; Ery,2,0,15,13
1668381140900,MATH 288,A00,098057,Agarwal; Pooja,9,0,10,1
1668381140900,MATH 288,B00,098058,Zhang; Danna,8,0,10,2
1668381140900,MATH 288,C00,098059,Williams; Ruth J,9,0,10,1
1668381141327,MATH 290B,A00,098060,Roberts; Justin Deritter,13,0,15,2
1668381141753,MATH 292,A00,098061,Belmont; Eva Kinoshita,10,0,10,0
1668381142180,MATH 295,A00,098062,Suk; Andrew Hoon,48,0,50,2
1668381142604,MATH 296,A00,098063,Novak; Jonathan I,20,0,20,0
1668381143028,MATH 297,001,098064,Gamst; Anthony Collins,9997,0,9999,2
1668381643540,COGS 205,A00,101395,Chiba; Andrea,19,0,20,1
1668381643967,COGS 210B,001,101404,Greene; Deanna Jacquelyn,9998,0,9999,1
1668381643967,COGS 210B,002,101417,Xia; Haijun,9999,0,9999,0
1668381643967,COGS 210B,003,101422,Nitz; Douglas A.,9999,0,9999,0
1668381643967,COGS 210B,004,101423,Hollan; James D.,9998,0,9999,1
1668381643967,COGS 210B,005,101424,Deak; Gedeon O.,9998,0,9999,1
1668381643967,COGS 210B,006,101425,Rossano; Federico,9999,0,9999,0
1668381644390,COGS 211B,A00,101427,Coulson; Seana M,9996,0,9999,3
1668381644814,COGS 220,A00,101428,Hollan; James D.,0,0,25,25
1668381645237,COGS 229,A00,101429,Dow; Steven P,18,0,25,7
1668381645661,COGS 230,A00,101430,Klemmer; Scott R,11,0,17,6
1668381646084,COGS 234,A00,101431,Xia; Haijun,1,0,25,24
1668381646510,COGS 260,A00,101432,Kiyonaga; Anastasia,21,0,25,4
1668381646510,COGS 260,B00,101433,Kirsh; David Joel,15,0,25,10
1668381646936,CSE 202,A00,102371,Impagliazzo; Russell,0,0,0,0
1668381647359,CSE 203B,A01,102373,Cheng; Chung Kuan,0,0,0,0
1668381647780,CSE 208,A00,102374,Micciancio; Daniele,0,0,0,0
1668381648204,CSE 209A,A00,112895,Impagliazzo; Russell,0,0,15,15
1668381648630,CSE 209B,A00,108005,Bellare; Mihir,0,0,0,0
1668381649060,CSE 210,A00,113163,Coblenz; Michael J,0,0,0,0
1668381649484,CSE 219,A00,106111,Dow; Steven P,0,0,20,20
1668381649909,CSE 221,A00,102376,Voelker; Geoffrey M.,0,0,0,0
1668381650337,CSE 224,A01,102378,Porter; George M,0,0,0,0
1668381650762,CSE 229A,A00,102379,Savage; Stefan,0,0,0,0
1668381651189,CSE 229C,A00,102380,Munyaka; Imani N. S.,0,0,0,0
1668381651693,CSE 232B,A00,102382,Deutsch; Alin Bernard,0,0,0,0
1668381652117,CSE 234,A01,112904,Kumar; Arun Kumar,0,0,0,0
1668381652540,CSE 237A,A00,102383,Rosing; Tajana Simunic,0,0,0,0
1668381652975,CSE 239A,A00,102384,Deutsch; Alin Bernard,0,0,0,0
1668381653413,CSE 239B,A00,102385,Polikarpova; Nadezhda,0,0,0,0
1668381653835,CSE 240A,A00,102386,Pannuto; Patrick William,0,0,0,0
1668381654259,CSE 240B,A00,102387,Zhao; Jishen,0,0,0,0
1668381654684,CSE 241A,A00,106406,Kang; Mingu,0,0,0,0
1668381655111,CSE 249B,A00,102388,Kahng; Andrew Byun,0,0,8,8
1668381655538,CSE 251B,A01,102392,Cottrell; Garrison W,0,0,0,0
1668381655538,CSE 251B,A02,102393,Cottrell; Garrison W,0,0,0,0
1668381655965,CSE 252B,A00,102394,Ochoa; Benjamin Lawrence,0,0,0,0
1668381656391,CSE 257,A01,102396,Gao; Sicun,0,0,0,0
1668381656821,CSE 272,A00,102397,Li; Tzumao,0,0,0,0
1668381657244,CSE 274,A00,111323,Chern; Albert Ren-Haur,0,0,0,0
1668381657676,CSE 282,A00,102398,Pevzner; Pavel Arkadjevich,0,0,0,0
1668381658101,CSE 284,A00,114175,Gymrek; Melissa Ann,0,0,0,0
1668381658530,CSE 290,A00,102399,Chandraker; Manmohan Krishna,0,0,0,0
1668381658530,CSE 290,B00,102400,Vaccaro; Kristen Marie,0,0,25,25
1668381658530,CSE 290,C00,102414,Pannuto; Patrick William,0,0,25,25
1668381658530,CSE 290,D00,102427,Pevzner; Pavel Arkadjevich,0,0,0,0
1668381658530,CSE 290,E00,102429,Zhao; Jishen,0,0,0,0
1668381658530,CSE 290,F00,102436,Tullsen; Dean Michael,0,0,0,0
1668381658530,CSE 290,G00,102440,Christensen; Henrik I,0,0,20,20
1668381658955,CSE 291,A00,102443,Su; Hao,0,0,0,0
1668381658955,CSE 291,B00,102448,Polikarpova; Nadezhda,0,0,0,0
1668381658955,CSE 291,C00,102453,Vaccaro; Kristen Marie,0,0,0,0
1668381658955,CSE 291,D00,111343,Savage; Stefan,0,0,0,0
1668381658955,CSE 291,E00,116474,Claffy; Kimberly Claire,0,0,0,0
1668381658955,CSE 291,F00,116479,Pasquale; Joseph,0,0,0,0
1668381659402,CSE 293,001,119111,Bafna; Vineet,9999,0,9999,0
1668381659402,CSE 293,002,119118,Bellare; Mihir,9999,0,9999,0
1668381659402,CSE 293,003,119122,Berg-Kirkpatrick; Taylor D,9999,0,9999,0
1668381659402,CSE 293,004,119135,Christensen; Henrik I,9999,0,9999,0
1668381659402,CSE 293,005,119142,Cottrell; Garrison W,9999,0,9999,0
1668381659402,CSE 293,006,119146,Deutsch; Alin Bernard,9999,0,9999,0
1668381659402,CSE 293,007,119159,Esmaeilzadeh; Hadi,9999,0,9999,0
1668381659402,CSE 293,008,119166,Freund; Yoav,9999,0,9999,0
1668381659402,CSE 293,009,119170,Griswold; William G.,9999,0,9999,0
1668381659402,CSE 293,010,119183,Gymrek; Melissa Ann,9999,0,9999,0
1668381659402,CSE 293,011,119190,Heninger; Nadia A,9999,0,9999,0
1668381659402,CSE 293,012,119230,Impagliazzo; Russell,9999,0,9999,0
1668381659402,CSE 293,013,119232,Jhala; Ranjit,9999,0,9999,0
1668381659402,CSE 293,014,119233,Kahng; Andrew Byun,9999,0,9999,0
1668381659402,CSE 293,015,119298,Kane; Daniel Mertz,9999,0,9999,0
1668381659402,CSE 293,016,119299,Kriegman; David J,9999,0,9999,0
1668381659402,CSE 293,017,119300,Kumar; Arun Kumar,9999,0,9999,0
1668381659402,CSE 293,018,119301,Lerner; Sorin,9999,0,9999,0
1668381659402,CSE 293,019,119302,Lovett; Shachar,9999,0,9999,0
1668381659402,CSE 293,020,119303,McAuley; Julian John,9999,0,9999,0
1668381659402,CSE 293,021,119304,Micciancio; Daniele,9999,0,9999,0
1668381659402,CSE 293,022,119367,Orailoglu; Alex,9999,0,9999,0
1668381659402,CSE 293,023,119382,Paturi; Ramamohan,9999,0,9999,0
1668381659402,CSE 293,024,119404,Polikarpova; Nadezhda,9999,0,9999,0
1668381659402,CSE 293,025,119406,Politz; Joseph Gibbs,9999,0,9999,0
1668381659402,CSE 293,026,119411,Porter; George M,9999,0,9999,0
1668381659402,CSE 293,027,119414,Porter; Leonard Emerson,9999,0,9999,0
1668381659402,CSE 293,028,119416,Ramamoorthi; Ravi,9999,0,9999,0
1668381659402,CSE 293,029,119417,Sahoo; Debashis,9999,0,9999,0
1668381659402,CSE 293,030,119420,Saul; Lawrence,9999,0,9999,0
1668381659402,CSE 293,031,119421,Savage; Stefan,9999,0,9999,0
1668381659402,CSE 293,032,119425,Schulze; Jurgen P.,9999,0,9999,0
1668381659402,CSE 293,033,119426,Snoeren; Alex C.,9999,0,9999,0
1668381659402,CSE 293,034,119428,Shang; Jingbo,9999,0,9999,0
1668381659402,CSE 293,035,119430,Stefan; Deian,9999,0,9999,0
1668381659402,CSE 293,036,119431,Su; Hao,9999,0,9999,0
1668381659402,CSE 293,037,119433,Swanson; Steven James,9999,0,9999,0
1668381659402,CSE 293,038,119435,Tullsen; Dean Michael,9999,0,9999,0
1668381659402,CSE 293,039,119483,Voelker; Geoffrey M.,9999,0,9999,0
1668381659402,CSE 293,040,119537,Zhao; Jishen,9999,0,9999,0
1668381659402,CSE 293,041,119538,Zhou; Yuan-Yuan,9999,0,9999,0
1668381659402,CSE 293,042,119539,Gao; Sicun,9999,0,9999,0
1668381659402,CSE 293,043,119540,Weibel; Nadir,9999,0,9999,0
1668381659402,CSE 293,044,119541,Gupta; Rajesh K.,9999,0,9999,0
1668381659402,CSE 293,045,126410,Vaccaro; Kristen Marie,9999,0,9999,0
1668381659402,CSE 293,046,126411,Klemke; Richard,9999,0,9999,0
1668381659826,CSE 294,A00,102459,Voelker; Geoffrey M.,0,0,0,0
1668381659826,CSE 294,B00,111322,Orailoglu; Alex,0,0,0,0
1668381660253,DSE 201,A00,096914,Deutsch; Alin Bernard,30,0,30,0
1668381660676,DSE 210,A00,096915,Dasgupta; Sanjoy,30,0,30,0
1668381661108,DSE 260A,A00,096916,Altintas De Callaf; Ilkay,30,0,30,0
1668381661543,ECE 200,001,103586,Antipa; Nicholas A,9999,0,9999,0
1668381661543,ECE 200,002,103587,Atanasov; Nikolay A.,9999,0,9999,0
1668381661543,ECE 200,003,103588,Bharadia; Dinesh,9999,0,9999,0
1668381661543,ECE 200,004,103589,Cheng; Chung Kuan,9999,0,9999,0
1668381661543,ECE 200,005,103590,Cosman; Pamela C.,9999,0,9999,0
1668381661543,ECE 200,006,103591,Dayeh; Shadi Ahmad,9999,0,9999,0
1668381661543,ECE 200,007,103592,Fainman; Yeshaiahu,9999,0,9999,0
1668381661543,ECE 200,008,103593,Ford; Joseph Earl,9999,0,9999,0
1668381661543,ECE 200,009,103594,Franceschetti; Massimo,9999,0,9999,0
1668381661543,ECE 200,010,103595,Fullerton; Eric E,9999,0,9999,0
1668381661543,ECE 200,011,103596,Galton; Ian A,9999,0,9999,0
1668381661543,ECE 200,012,103597,Gilja; Vikash,9999,0,9999,0
1668381661543,ECE 200,013,103598,Hall; Drew A.,9999,0,9999,0
1668381661543,ECE 200,014,103599,Hsueh; Tzu-Chien,9999,0,9999,0
1668381661543,ECE 200,015,103600,Javidi; Tara,9999,0,9999,0
1668381661543,ECE 200,016,103601,Kahng; Andrew Byun,9999,0,9999,0
1668381661543,ECE 200,017,103602,Kim; Young-Han,9999,0,9999,0
1668381661543,ECE 200,018,103603,Koushanfar; Farinaz,9999,0,9999,0
1668381661543,ECE 200,019,103604,Kuzum; Duygu,9999,0,9999,0
1668381661543,ECE 200,020,103605,Le; Hanh-Phuc,9999,0,9999,0
1668381661543,ECE 200,021,103606,Lin; Bill,9999,0,9999,0
1668381661543,ECE 200,022,103607,Liu; Zhaowei,9998,0,9999,1
1668381661543,ECE 200,023,103608,Lo; Yu-Hwa,9999,0,9999,0
1668381661543,ECE 200,024,103609,Lomakin; Vitaliy,9999,0,9999,0
1668381661543,ECE 200,025,103610,Mercier; Patrick Philip,9999,0,9999,0
1668381661543,ECE 200,026,103611,Meyer; Florian,9999,0,9999,0
1668381661543,ECE 200,027,103612,Milstein; Laurence B.,9999,0,9999,0
1668381661543,ECE 200,028,103613,Mir Arabbaygi; Siavash,9999,0,9999,0
1668381661543,ECE 200,029,103614,Mookherjea; Shayan,9999,0,9999,0
1668381661543,ECE 200,030,103615,Morris; Karcher William,9999,0,9999,0
1668381661543,ECE 200,031,103616,Ng; Tse Nga,9999,0,9999,0
1668381661543,ECE 200,032,103617,Nguyen; Truong Quang,9999,0,9999,0
1668381661543,ECE 200,033,103618,Nomura; Kenji,9999,0,9999,0
1668381661543,ECE 200,034,103619,Orlitsky; Alon,9999,0,9999,0
1668381661543,ECE 200,035,103620,Pal; Piya,9999,0,9999,0
1668381661543,ECE 200,036,103621,Papen; George C.,9999,0,9999,0
1668381661543,ECE 200,037,103622,Radic; Stojan,9999,0,9999,0
1668381661543,ECE 200,038,103623,Rao; Bhaskar D.,9999,0,9999,0
1668381661543,ECE 200,039,103624,Rao; Ramesh R,9999,0,9999,0
1668381661543,ECE 200,040,103625,Rebeiz; Gabriel,9999,0,9999,0
1668381661543,ECE 200,041,103626,Sanford; John R,9999,0,9999,0
1668381661543,ECE 200,042,103627,Siegel; Paul H.,9999,0,9999,0
1668381661543,ECE 200,043,103628,Sievenpiper; Daniel F.,9999,0,9999,0
1668381661543,ECE 200,044,103629,Sworder; David D.,9999,0,9999,0
1668381661543,ECE 200,045,103630,Taur; Yuan,9999,0,9999,0
1668381661543,ECE 200,046,103631,Touri; Behrouz,9999,0,9999,0
1668381661543,ECE 200,047,103632,Trivedi; Mohan M.,9999,0,9999,0
1668381661543,ECE 200,048,103633,Vasconcelos; Nuno,9999,0,9999,0
1668381661543,ECE 200,049,103634,Wang; Xiaolong,9999,0,9999,0
1668381661543,ECE 200,050,103635,Xie; Pengtao,9999,0,9999,0
1668381661543,ECE 200,051,103636,Yip; Michael,9999,0,9999,0
1668381661543,ECE 200,052,103637,Zeger; Kenneth A.,999,0,999,0
1668381661543,ECE 200,053,103638,Zhang; Xinyu,9999,0,9999,0
1668381661543,ECE 200,054,103639,Turakhia; Yatish Girish,9999,0,9999,0
1668381661543,ECE 200,055,103640,Kang; Mingu,9999,0,9999,0
1668381661543,ECE 200,056,103641,Shi; Yuanyuan,9999,0,9999,0
1668381661543,ECE 200,057,103642,Wang; Edward Jay,9999,0,9999,0
1668381661543,ECE 200,058,103643,Zheng; Yang,9999,0,9999,0
1668381661969,ECE 202,A00,103644,Kuzum; Duygu,0,0,0,0
1668381662395,ECE 212BN,A00,103646,Ng; Tse Nga,0,0,0,0
1668381662834,ECE 221,A00,111493,Staff,0,0,0,0
1668381663261,ECE 222B,A00,103647,Lomakin; Vitaliy,0,0,0,0
1668381663706,ECE 230B,A00,103648,Taur; Yuan,0,0,0,0
1668381664133,ECE 238B,A00,103649,Garay; Javier,0,0,0,0
1668381664557,ECE 240B,A00,112900,Fainman; Yeshaiahu,0,0,0,0
1668381664982,ECE 247A,A00,103650,Jokerst; Jesse Vincent,0,0,0,0
1668381665409,ECE 247B,A00,103651,Wang; Joseph,0,0,0,0
1668381665846,ECE 250,A00,103652,Siegel; Paul H.,0,0,0,0
1668381666273,ECE 251A,A00,103654,Rao; Bhaskar D.,0,0,0,0
1668381666697,ECE 257B,A00,103655,Bharadia; Dinesh,0,0,0,0
1668381667122,ECE 258A,A00,103656,Milstein; Laurence B.,0,0,0,0
1668381667546,ECE 260B,A00,103658,Kang; Mingu,0,0,0,0
1668381667971,ECE 264A,A00,103659,Galton; Ian A,0,0,0,0
1668381668394,ECE 265A,A00,103661,Gudem; Prasad S.S.,0,0,0,0
1668381668832,ECE 265D,A00,103662,Gudem; Prasad S.S.,0,0,0,0
1668381669262,ECE 268,A00,103663,Koushanfar; Farinaz,0,0,0,0
1668381669698,ECE 269,A01,103665,Pal; Piya,0,0,0,0
1668381670123,ECE 271B,A00,103666,Vasconcelos; Manuela,0,0,0,0
1668381670555,ECE 276A,A00,103667,Atanasov; Nikolay A.,0,0,0,0
1668381670979,ECE 277,A00,103668,An; Cheolhong,0,0,0,0
1668381671407,ECE 279,A00,117947,Hall; Drew A.,0,0,0,0
1668381672258,ECE 283,A00,103670,Hsueh; Tzu-Chien,0,0,0,0
1668381672686,ECE 284,A00,103671,Turakhia; Yatish Girish,0,0,0,0
1668381673122,ECE 285,A00,103672,Zheng; Yang,0,0,0,0
1668381673122,ECE 285,B00,103673,Sworder; David D.,0,0,0,0
1668381673551,ECE 287,A00,103676,Javidi; Tara,0,0,0,0
1668381673975,MATH 200B,A00,098023,Salehi Golsefidy; Alireza,12,0,15,3
1668381674399,MATH 202B,A00,098024,Rhoades; Brendon Patrick,9,0,15,6
1668381674826,MATH 203B,A00,098025,Oprea; Dragos N.,10,0,15,5
1668381675258,MATH 204B,A00,098026,Sorensen; Claus M,13,0,15,2
1668381675684,MATH 208,A00,098027,Izadi; Elham,7,0,10,3
1668381676110,MATH 209,A00,098028,Pollack; Aaron,10,0,10,0
1668381676534,MATH 211A,A00,112919,Rogalski; Daniel,9,0,10,1
1668381676958,MATH 211B,A00,112920,Seward; Brandon M.,9,0,10,1
1668381677381,MATH 218,A00,098029,Li; Bo,10,0,10,0
1668381677802,MATH 220B,A00,098030,Novak; Jonathan I,11,0,15,4
1668381678226,MATH 221A,A00,098031,Ebenfelt; Peter F,13,0,15,2
1668381678651,MATH 231B,A00,098032,Zlatos; Andrej,12,0,15,3
1668381679074,MATH 240B,A00,098033,Ni; Lei,9,0,15,6
1668381679501,MATH 243,A00,098034,Jekel; David Andrew,10,0,10,0
1668381679928,MATH 245A,A00,098035,Nie; Jiawang,0,0,15,16
1668381680362,MATH 248,A00,098036,Bejenaru; Ioan,10,0,10,0
1668381680786,MATH 250B,A00,098037,Spolaor; Luca,14,0,15,1
1668381681227,MATH 258,A00,098038,Ni; Lei,10,0,10,0
1668381681652,MATH 264B,A00,098041,Rhoades; Brendon Patrick,9,0,15,6
1668381682082,MATH 268,A00,098042,Buss; Samuel R,10,0,10,0
1668381682508,MATH 269,A00,098043,Rhoades; Brendon Patrick,10,0,10,0
1668381682933,MATH 270B,A00,098044,Li; Bo,10,0,15,5
1668381683366,MATH 272B,A00,098045,Holst; Michael J,13,0,15,2
1668381683790,MATH 273A,A00,098046,Tian; Xiaochuan,10,0,15,5
1668381684213,MATH 275,A01,098048,Tian; Xiaochuan,6,0,10,4
1668381684637,MATH 278A,A00,098049,Holst; Michael J,8,0,10,2
1668381685060,MATH 278B,A00,098050,Cloninger; Alexander,10,0,10,0
1668381685487,MATH 278C,A00,098051,Nie; Jiawang,7,0,10,3
1668381685928,MATH 280B,A00,098052,Zheng; Tianyi,8,0,15,7
1668381686354,MATH 281B,A00,098053,Bradic; Jelena,1,0,15,14
1668381686780,MATH 282B,A00,098054,Arias-Castro; Ery,0,0,15,15
1668381687205,MATH 285,A00,098055,Fitzsimmons; Patrick J,0,0,15,17
1668381687629,MATH 287B,A00,098056,Arias-Castro; Ery,2,0,15,13
1668381688058,MATH 288,A00,098057,Agarwal; Pooja,9,0,10,1
1668381688058,MATH 288,B00,098058,Zhang; Danna,8,0,10,2
1668381688058,MATH 288,C00,098059,Williams; Ruth J,9,0,10,1
1668381688485,MATH 290B,A00,098060,Roberts; Justin Deritter,13,0,15,2
1668381688908,MATH 292,A00,098061,Belmont; Eva Kinoshita,10,0,10,0
1668381689342,MATH 295,A00,098062,Suk; Andrew Hoon,48,0,50,2
1668381689763,MATH 296,A00,098063,Novak; Jonathan I,20,0,20,0
1668381690189,MATH 297,001,098064,Gamst; Anthony Collins,9997,0,9999,2
1668382190415,COGS 205,A00,101395,Chiba; Andrea,19,0,20,1
1668382190841,COGS 210B,001,101404,Greene; Deanna Jacquelyn,9998,0,9999,1
1668382190841,COGS 210B,002,101417,Xia; Haijun,9999,0,9999,0
1668382190841,COGS 210B,003,101422,Nitz; Douglas A.,9999,0,9999,0
1668382190841,COGS 210B,004,101423,Hollan; James D.,9998,0,9999,1
1668382190841,COGS 210B,005,101424,Deak; Gedeon O.,9998,0,9999,1
1668382190841,COGS 210B,006,101425,Rossano; Federico,9999,0,9999,0
1668382191280,COGS 211B,A00,101427,Coulson; Seana M,9996,0,9999,3
1668382191702,COGS 220,A00,101428,Hollan; James D.,0,0,25,25
1668382192124,COGS 229,A00,101429,Dow; Steven P,18,0,25,7
1668382192553,COGS 230,A00,101430,Klemmer; Scott R,11,0,17,6
1668382192977,COGS 234,A00,101431,Xia; Haijun,1,0,25,24
1668382193407,COGS 260,A00,101432,Kiyonaga; Anastasia,21,0,25,4
1668382193407,COGS 260,B00,101433,Kirsh; David Joel,15,0,25,10
1668382193832,CSE 202,A00,102371,Impagliazzo; Russell,0,0,0,0
1668382194255,CSE 203B,A01,102373,Cheng; Chung Kuan,0,0,0,0
1668382194678,CSE 208,A00,102374,Micciancio; Daniele,0,0,0,0
1668382195101,CSE 209A,A00,112895,Impagliazzo; Russell,0,0,15,15
1668382195530,CSE 209B,A00,108005,Bellare; Mihir,0,0,0,0
1668382195954,CSE 210,A00,113163,Coblenz; Michael J,0,0,0,0
1668382196377,CSE 219,A00,106111,Dow; Steven P,0,0,20,20
1668382196809,CSE 221,A00,102376,Voelker; Geoffrey M.,0,0,0,0
1668382197234,CSE 224,A01,102378,Porter; George M,0,0,0,0
1668382197661,CSE 229A,A00,102379,Savage; Stefan,0,0,0,0
1668382198083,CSE 229C,A00,102380,Munyaka; Imani N. S.,0,0,0,0
1668382198505,CSE 232B,A00,102382,Deutsch; Alin Bernard,0,0,0,0
1668382198945,CSE 234,A01,112904,Kumar; Arun Kumar,0,0,0,0
1668382199368,CSE 237A,A00,102383,Rosing; Tajana Simunic,0,0,0,0
1668382199789,CSE 239A,A00,102384,Deutsch; Alin Bernard,0,0,0,0
1668382200212,CSE 239B,A00,102385,Polikarpova; Nadezhda,0,0,0,0
1668382200637,CSE 240A,A00,102386,Pannuto; Patrick William,0,0,0,0
1668382201061,CSE 240B,A00,102387,Zhao; Jishen,0,0,0,0
1668382201484,CSE 241A,A00,106406,Kang; Mingu,0,0,0,0
1668382201907,CSE 249B,A00,102388,Kahng; Andrew Byun,0,0,8,8
1668382202339,CSE 251B,A01,102392,Cottrell; Garrison W,0,0,0,0
1668382202339,CSE 251B,A02,102393,Cottrell; Garrison W,0,0,0,0
1668382202762,CSE 252B,A00,102394,Ochoa; Benjamin Lawrence,0,0,0,0
1668382203188,CSE 257,A01,102396,Gao; Sicun,0,0,0,0
1668382203620,CSE 272,A00,102397,Li; Tzumao,0,0,0,0
1668382204042,CSE 274,A00,111323,Chern; Albert Ren-Haur,0,0,0,0
1668382204466,CSE 282,A00,102398,Pevzner; Pavel Arkadjevich,0,0,0,0
1668382204888,CSE 284,A00,114175,Gymrek; Melissa Ann,0,0,0,0
1668382205309,CSE 290,A00,102399,Chandraker; Manmohan Krishna,0,0,0,0
1668382205309,CSE 290,B00,102400,Vaccaro; Kristen Marie,0,0,25,25
1668382205309,CSE 290,C00,102414,Pannuto; Patrick William,0,0,25,25
1668382205309,CSE 290,D00,102427,Pevzner; Pavel Arkadjevich,0,0,0,0
1668382205309,CSE 290,E00,102429,Zhao; Jishen,0,0,0,0
1668382205309,CSE 290,F00,102436,Tullsen; Dean Michael,0,0,0,0
1668382205309,CSE 290,G00,102440,Christensen; Henrik I,0,0,20,20
1668382205733,CSE 291,A00,102443,Su; Hao,0,0,0,0
1668382205733,CSE 291,B00,102448,Polikarpova; Nadezhda,0,0,0,0
1668382205733,CSE 291,C00,102453,Vaccaro; Kristen Marie,0,0,0,0
1668382205733,CSE 291,D00,111343,Savage; Stefan,0,0,0,0
1668382205733,CSE 291,E00,116474,Claffy; Kimberly Claire,0,0,0,0
1668382205733,CSE 291,F00,116479,Pasquale; Joseph,0,0,0,0
1668382206178,CSE 293,001,119111,Bafna; Vineet,9999,0,9999,0
1668382206178,CSE 293,002,119118,Bellare; Mihir,9999,0,9999,0
1668382206178,CSE 293,003,119122,Berg-Kirkpatrick; Taylor D,9999,0,9999,0
1668382206178,CSE 293,004,119135,Christensen; Henrik I,9999,0,9999,0
1668382206178,CSE 293,005,119142,Cottrell; Garrison W,9999,0,9999,0
1668382206178,CSE 293,006,119146,Deutsch; Alin Bernard,9999,0,9999,0
1668382206178,CSE 293,007,119159,Esmaeilzadeh; Hadi,9999,0,9999,0
1668382206178,CSE 293,008,119166,Freund; Yoav,9999,0,9999,0
1668382206178,CSE 293,009,119170,Griswold; William G.,9999,0,9999,0
1668382206178,CSE 293,010,119183,Gymrek; Melissa Ann,9999,0,9999,0
1668382206178,CSE 293,011,119190,Heninger; Nadia A,9999,0,9999,0
1668382206178,CSE 293,012,119230,Impagliazzo; Russell,9999,0,9999,0
1668382206178,CSE 293,013,119232,Jhala; Ranjit,9999,0,9999,0
1668382206178,CSE 293,014,119233,Kahng; Andrew Byun,9999,0,9999,0
1668382206178,CSE 293,015,119298,Kane; Daniel Mertz,9999,0,9999,0
1668382206178,CSE 293,016,119299,Kriegman; David J,9999,0,9999,0
1668382206178,CSE 293,017,119300,Kumar; Arun Kumar,9999,0,9999,0
1668382206178,CSE 293,018,119301,Lerner; Sorin,9999,0,9999,0
1668382206178,CSE 293,019,119302,Lovett; Shachar,9999,0,9999,0
1668382206178,CSE 293,020,119303,McAuley; Julian John,9999,0,9999,0
1668382206178,CSE 293,021,119304,Micciancio; Daniele,9999,0,9999,0
1668382206178,CSE 293,022,119367,Orailoglu; Alex,9999,0,9999,0
1668382206178,CSE 293,023,119382,Paturi; Ramamohan,9999,0,9999,0
1668382206178,CSE 293,024,119404,Polikarpova; Nadezhda,9999,0,9999,0
1668382206178,CSE 293,025,119406,Politz; Joseph Gibbs,9999,0,9999,0
1668382206178,CSE 293,026,119411,Porter; George M,9999,0,9999,0
1668382206178,CSE 293,027,119414,Porter; Leonard Emerson,9999,0,9999,0
1668382206178,CSE 293,028,119416,Ramamoorthi; Ravi,9999,0,9999,0
1668382206178,CSE 293,029,119417,Sahoo; Debashis,9999,0,9999,0
1668382206178,CSE 293,030,119420,Saul; Lawrence,9999,0,9999,0
1668382206178,CSE 293,031,119421,Savage; Stefan,9999,0,9999,0
1668382206178,CSE 293,032,119425,Schulze; Jurgen P.,9999,0,9999,0
1668382206178,CSE 293,033,119426,Snoeren; Alex C.,9999,0,9999,0
1668382206178,CSE 293,034,119428,Shang; Jingbo,9999,0,9999,0
1668382206178,CSE 293,035,119430,Stefan; Deian,9999,0,9999,0
1668382206178,CSE 293,036,119431,Su; Hao,9999,0,9999,0
1668382206178,CSE 293,037,119433,Swanson; Steven James,9999,0,9999,0
1668382206178,CSE 293,038,119435,Tullsen; Dean Michael,9999,0,9999,0
1668382206178,CSE 293,039,119483,Voelker; Geoffrey M.,9999,0,9999,0
1668382206178,CSE 293,040,119537,Zhao; Jishen,9999,0,9999,0
1668382206178,CSE 293,041,119538,Zhou; Yuan-Yuan,9999,0,9999,0
1668382206178,CSE 293,042,119539,Gao; Sicun,9999,0,9999,0
1668382206178,CSE 293,043,119540,Weibel; Nadir,9999,0,9999,0
1668382206178,CSE 293,044,119541,Gupta; Rajesh K.,9999,0,9999,0
1668382206178,CSE 293,045,126410,Vaccaro; Kristen Marie,9999,0,9999,0
1668382206178,CSE 293,046,126411,Klemke; Richard,9999,0,9999,0
1668382206606,CSE 294,A00,102459,Voelker; Geoffrey M.,0,0,0,0
1668382206606,CSE 294,B00,111322,Orailoglu; Alex,0,0,0,0
1668382207040,DSE 201,A00,096914,Deutsch; Alin Bernard,30,0,30,0
1668382207476,DSE 210,A00,096915,Dasgupta; Sanjoy,30,0,30,0
1668382207898,DSE 260A,A00,096916,Altintas De Callaf; Ilkay,30,0,30,0
1668382208356,ECE 200,001,103586,Antipa; Nicholas A,9999,0,9999,0
1668382208356,ECE 200,002,103587,Atanasov; Nikolay A.,9999,0,9999,0
1668382208356,ECE 200,003,103588,Bharadia; Dinesh,9999,0,9999,0
1668382208356,ECE 200,004,103589,Cheng; Chung Kuan,9999,0,9999,0
1668382208356,ECE 200,005,103590,Cosman; Pamela C.,9999,0,9999,0
1668382208356,ECE 200,006,103591,Dayeh; Shadi Ahmad,9999,0,9999,0
1668382208356,ECE 200,007,103592,Fainman; Yeshaiahu,9999,0,9999,0
1668382208356,ECE 200,008,103593,Ford; Joseph Earl,9999,0,9999,0
1668382208356,ECE 200,009,103594,Franceschetti; Massimo,9999,0,9999,0
1668382208356,ECE 200,010,103595,Fullerton; Eric E,9999,0,9999,0
1668382208356,ECE 200,011,103596,Galton; Ian A,9999,0,9999,0
1668382208356,ECE 200,012,103597,Gilja; Vikash,9999,0,9999,0
1668382208356,ECE 200,013,103598,Hall; Drew A.,9999,0,9999,0
1668382208356,ECE 200,014,103599,Hsueh; Tzu-Chien,9999,0,9999,0
1668382208356,ECE 200,015,103600,Javidi; Tara,9999,0,9999,0
1668382208356,ECE 200,016,103601,Kahng; Andrew Byun,9999,0,9999,0
1668382208356,ECE 200,017,103602,Kim; Young-Han,9999,0,9999,0
1668382208356,ECE 200,018,103603,Koushanfar; Farinaz,9999,0,9999,0
1668382208356,ECE 200,019,103604,Kuzum; Duygu,9999,0,9999,0
1668382208356,ECE 200,020,103605,Le; Hanh-Phuc,9999,0,9999,0
1668382208356,ECE 200,021,103606,Lin; Bill,9999,0,9999,0
1668382208356,ECE 200,022,103607,Liu; Zhaowei,9998,0,9999,1
1668382208356,ECE 200,023,103608,Lo; Yu-Hwa,9999,0,9999,0
1668382208356,ECE 200,024,103609,Lomakin; Vitaliy,9999,0,9999,0
1668382208356,ECE 200,025,103610,Mercier; Patrick Philip,9999,0,9999,0
1668382208356,ECE 200,026,103611,Meyer; Florian,9999,0,9999,0
1668382208356,ECE 200,027,103612,Milstein; Laurence B.,9999,0,9999,0
1668382208356,ECE 200,028,103613,Mir Arabbaygi; Siavash,9999,0,9999,0
1668382208356,ECE 200,029,103614,Mookherjea; Shayan,9999,0,9999,0
1668382208356,ECE 200,030,103615,Morris; Karcher William,9999,0,9999,0
1668382208356,ECE 200,031,103616,Ng; Tse Nga,9999,0,9999,0
1668382208356,ECE 200,032,103617,Nguyen; Truong Quang,9999,0,9999,0
1668382208356,ECE 200,033,103618,Nomura; Kenji,9999,0,9999,0
1668382208356,ECE 200,034,103619,Orlitsky; Alon,9999,0,9999,0
1668382208356,ECE 200,035,103620,Pal; Piya,9999,0,9999,0
1668382208356,ECE 200,036,103621,Papen; George C.,9999,0,9999,0
1668382208356,ECE 200,037,103622,Radic; Stojan,9999,0,9999,0
1668382208356,ECE 200,038,103623,Rao; Bhaskar D.,9999,0,9999,0
1668382208356,ECE 200,039,103624,Rao; Ramesh R,9999,0,9999,0
1668382208356,ECE 200,040,103625,Rebeiz; Gabriel,9999,0,9999,0
1668382208356,ECE 200,041,103626,Sanford; John R,9999,0,9999,0
1668382208356,ECE 200,042,103627,Siegel; Paul H.,9999,0,9999,0
1668382208356,ECE 200,043,103628,Sievenpiper; Daniel F.,9999,0,9999,0
1668382208356,ECE 200,044,103629,Sworder; David D.,9999,0,9999,0
1668382208356,ECE 200,045,103630,Taur; Yuan,9999,0,9999,0
1668382208356,ECE 200,046,103631,Touri; Behrouz,9999,0,9999,0
1668382208356,ECE 200,047,103632,Trivedi; Mohan M.,9999,0,9999,0
1668382208356,ECE 200,048,103633,Vasconcelos; Nuno,9999,0,9999,0
1668382208356,ECE 200,049,103634,Wang; Xiaolong,9999,0,9999,0
1668382208356,ECE 200,050,103635,Xie; Pengtao,9999,0,9999,0
1668382208356,ECE 200,051,103636,Yip; Michael,9999,0,9999,0
1668382208356,ECE 200,052,103637,Zeger; Kenneth A.,999,0,999,0
1668382208356,ECE 200,053,103638,Zhang; Xinyu,9999,0,9999,0
1668382208356,ECE 200,054,103639,Turakhia; Yatish Girish,9999,0,9999,0
1668382208356,ECE 200,055,103640,Kang; Mingu,9999,0,9999,0
1668382208356,ECE 200,056,103641,Shi; Yuanyuan,9999,0,9999,0
1668382208356,ECE 200,057,103642,Wang; Edward Jay,9999,0,9999,0
1668382208356,ECE 200,058,103643,Zheng; Yang,9999,0,9999,0
1668382208778,ECE 202,A00,103644,Kuzum; Duygu,0,0,0,0
1668382209202,ECE 212BN,A00,103646,Ng; Tse Nga,0,0,0,0
1668382209626,ECE 221,A00,111493,Staff,0,0,0,0
1668382210057,ECE 222B,A00,103647,Lomakin; Vitaliy,0,0,0,0
1668382210481,ECE 230B,A00,103648,Taur; Yuan,0,0,0,0
1668382210907,ECE 238B,A00,103649,Garay; Javier,0,0,0,0
1668382211335,ECE 240B,A00,112900,Fainman; Yeshaiahu,0,0,0,0
1668382211765,ECE 247A,A00,103650,Jokerst; Jesse Vincent,0,0,0,0
1668382212187,ECE 247B,A00,103651,Wang; Joseph,0,0,0,0
1668382212629,ECE 250,A00,103652,Siegel; Paul H.,0,0,0,0
1668382213053,ECE 251A,A00,103654,Rao; Bhaskar D.,0,0,0,0
1668382213478,ECE 257B,A00,103655,Bharadia; Dinesh,0,0,0,0
1668382213902,ECE 258A,A00,103656,Milstein; Laurence B.,0,0,0,0
1668382214327,ECE 260B,A00,103658,Kang; Mingu,0,0,0,0
1668382214771,ECE 264A,A00,103659,Galton; Ian A,0,0,0,0
1668382215287,ECE 265A,A00,103661,Gudem; Prasad S.S.,0,0,0,0
1668382215723,ECE 265D,A00,103662,Gudem; Prasad S.S.,0,0,0,0
1668382216152,ECE 268,A00,103663,Koushanfar; Farinaz,0,0,0,0
1668382216580,ECE 269,A01,103665,Pal; Piya,0,0,0,0
1668382217007,ECE 271B,A00,103666,Vasconcelos; Manuela,0,0,0,0
1668382217430,ECE 276A,A00,103667,Atanasov; Nikolay A.,0,0,0,0
1668382217855,ECE 277,A00,103668,An; Cheolhong,0,0,0,0
1668382218279,ECE 279,A00,117947,Hall; Drew A.,0,0,0,0
1668382219145,ECE 283,A00,103670,Hsueh; Tzu-Chien,0,0,0,0
1668382219572,ECE 284,A00,103671,Turakhia; Yatish Girish,0,0,0,0
1668382220000,ECE 285,A00,103672,Zheng; Yang,0,0,0,0
1668382220000,ECE 285,B00,103673,Sworder; David D.,0,0,0,0
1668382220434,ECE 287,A00,103676,Javidi; Tara,0,0,0,0
1668382220875,MATH 200B,A00,098023,Salehi Golsefidy; Alireza,12,0,15,3
1668382221304,MATH 202B,A00,098024,Rhoades; Brendon Patrick,9,0,15,6
1668382221736,MATH 203B,A00,098025,Oprea; Dragos N.,10,0,15,5
1668382222161,MATH 204B,A00,098026,Sorensen; Claus M,13,0,15,2
1668382222588,MATH 208,A00,098027,Izadi; Elham,7,0,10,3
1668382223012,MATH 209,A00,098028,Pollack; Aaron,10,0,10,0
1668382223438,MATH 211A,A00,112919,Rogalski; Daniel,9,0,10,1
1668382223861,MATH 211B,A00,112920,Seward; Brandon M.,9,0,10,1
1668382224283,MATH 218,A00,098029,Li; Bo,10,0,10,0
1668382224711,MATH 220B,A00,098030,Novak; Jonathan I,11,0,15,4
1668382225137,MATH 221A,A00,098031,Ebenfelt; Peter F,13,0,15,2
1668382225561,MATH 231B,A00,098032,Zlatos; Andrej,12,0,15,3
1668382225985,MATH 240B,A00,098033,Ni; Lei,9,0,15,6
1668382226410,MATH 243,A00,098034,Jekel; David Andrew,10,0,10,0
1668382226834,MATH 245A,A00,098035,Nie; Jiawang,0,0,15,16
1668382227259,MATH 248,A00,098036,Bejenaru; Ioan,10,0,10,0
1668382227685,MATH 250B,A00,098037,Spolaor; Luca,14,0,15,1
1668382228110,MATH 258,A00,098038,Ni; Lei,10,0,10,0
1668382228534,MATH 264B,A00,098041,Rhoades; Brendon Patrick,9,0,15,6
1668382228963,MATH 268,A00,098042,Buss; Samuel R,10,0,10,0
1668382229387,MATH 269,A00,098043,Rhoades; Brendon Patrick,10,0,10,0
1668382229811,MATH 270B,A00,098044,Li; Bo,10,0,15,5
1668382230235,MATH 272B,A00,098045,Holst; Michael J,13,0,15,2
1668382230662,MATH 273A,A00,098046,Tian; Xiaochuan,10,0,15,5
1668382231086,MATH 275,A01,098048,Tian; Xiaochuan,6,0,10,4
1668382231512,MATH 278A,A00,098049,Holst; Michael J,8,0,10,2
1668382231937,MATH 278B,A00,098050,Cloninger; Alexander,10,0,10,0
1668382232367,MATH 278C,A00,098051,Nie; Jiawang,7,0,10,3
1668382232790,MATH 280B,A00,098052,Zheng; Tianyi,8,0,15,7
1668382233213,MATH 281B,A00,098053,Bradic; Jelena,1,0,15,14
1668382233639,MATH 282B,A00,098054,Arias-Castro; Ery,0,0,15,15
1668382234063,MATH 285,A00,098055,Fitzsimmons; Patrick J,0,0,15,17
1668382234488,MATH 287B,A00,098056,Arias-Castro; Ery,2,0,15,13
1668382234912,MATH 288,A00,098057,Agarwal; Pooja,9,0,10,1
1668382234912,MATH 288,B00,098058,Zhang; Danna,8,0,10,2
1668382234912,MATH 288,C00,098059,Williams; Ruth J,9,0,10,1
1668382235340,MATH 290B,A00,098060,Roberts; Justin Deritter,13,0,15,2
1668382235765,MATH 292,A00,098061,Belmont; Eva Kinoshita,10,0,10,0
1668382236187,MATH 295,A00,098062,Suk; Andrew Hoon,48,0,50,2
1668382236614,MATH 296,A00,098063,Novak; Jonathan I,20,0,20,0
1668382237047,MATH 297,001,098064,Gamst; Anthony Collins,9997,0,9999,2
1668382741740,COGS 205,A00,101395,Chiba; Andrea,19,0,20,1
1668382742176,COGS 210B,001,101404,Greene; Deanna Jacquelyn,9998,0,9999,1
1668382742176,COGS 210B,002,101417,Xia; Haijun,9999,0,9999,0
1668382742176,COGS 210B,003,101422,Nitz; Douglas A.,9999,0,9999,0
1668382742176,COGS 210B,004,101423,Hollan; James D.,9998,0,9999,1
1668382742176,COGS 210B,005,101424,Deak; Gedeon O.,9998,0,9999,1
1668382742176,COGS 210B,006,101425,Rossano; Federico,9999,0,9999,0
1668382742603,COGS 211B,A00,101427,Coulson; Seana M,9996,0,9999,3
1668382743025,COGS 220,A00,101428,Hollan; James D.,0,0,25,25
1668382743452,COGS 229,A00,101429,Dow; Steven P,18,0,25,7
1668382743876,COGS 230,A00,101430,Klemmer; Scott R,11,0,17,6
1668382744298,COGS 234,A00,101431,Xia; Haijun,1,0,25,24
1668382744726,COGS 260,A00,101432,Kiyonaga; Anastasia,21,0,25,4
1668382744726,COGS 260,B00,101433,Kirsh; David Joel,15,0,25,10
1668382745152,CSE 202,A00,102371,Impagliazzo; Russell,0,0,0,0
1668382745577,CSE 203B,A01,102373,Cheng; Chung Kuan,0,0,0,0
1668382746000,CSE 208,A00,102374,Micciancio; Daniele,0,0,0,0
1668382746437,CSE 209A,A00,112895,Impagliazzo; Russell,0,0,15,15
1668382746873,CSE 209B,A00,108005,Bellare; Mihir,0,0,0,0
1668382747299,CSE 210,A00,113163,Coblenz; Michael J,0,0,0,0
1668382747732,CSE 219,A00,106111,Dow; Steven P,0,0,20,20
1668382748165,CSE 221,A00,102376,Voelker; Geoffrey M.,0,0,0,0
1668382748589,CSE 224,A01,102378,Porter; George M,0,0,0,0
1668382749024,CSE 229A,A00,102379,Savage; Stefan,0,0,0,0
1668382749450,CSE 229C,A00,102380,Munyaka; Imani N. S.,0,0,0,0
1668382749877,CSE 232B,A00,102382,Deutsch; Alin Bernard,0,0,0,0
1668382750299,CSE 234,A01,112904,Kumar; Arun Kumar,0,0,0,0
1668382750737,CSE 237A,A00,102383,Rosing; Tajana Simunic,0,0,0,0
1668382751162,CSE 239A,A00,102384,Deutsch; Alin Bernard,0,0,0,0
1668382751599,CSE 239B,A00,102385,Polikarpova; Nadezhda,0,0,0,0
1668382752023,CSE 240A,A00,102386,Pannuto; Patrick William,0,0,0,0
1668382752448,CSE 240B,A00,102387,Zhao; Jishen,0,0,0,0
1668382752872,CSE 241A,A00,106406,Kang; Mingu,0,0,0,0
1668382753294,CSE 249B,A00,102388,Kahng; Andrew Byun,0,0,8,8
1668382753738,CSE 251B,A01,102392,Cottrell; Garrison W,0,0,0,0
1668382753738,CSE 251B,A02,102393,Cottrell; Garrison W,0,0,0,0
1668382754160,CSE 252B,A00,102394,Ochoa; Benjamin Lawrence,0,0,0,0
1668382754589,CSE 257,A01,102396,Gao; Sicun,0,0,0,0
1668382755023,CSE 272,A00,102397,Li; Tzumao,0,0,0,0
1668382755460,CSE 274,A00,111323,Chern; Albert Ren-Haur,0,0,0,0
1668382755886,CSE 282,A00,102398,Pevzner; Pavel Arkadjevich,0,0,0,0
1668382756314,CSE 284,A00,114175,Gymrek; Melissa Ann,0,0,0,0
1668382756740,CSE 290,A00,102399,Chandraker; Manmohan Krishna,0,0,0,0
1668382756740,CSE 290,B00,102400,Vaccaro; Kristen Marie,0,0,25,25
1668382756740,CSE 290,C00,102414,Pannuto; Patrick William,0,0,25,25
1668382756740,CSE 290,D00,102427,Pevzner; Pavel Arkadjevich,0,0,0,0
1668382756740,CSE 290,E00,102429,Zhao; Jishen,0,0,0,0
1668382756740,CSE 290,F00,102436,Tullsen; Dean Michael,0,0,0,0
1668382756740,CSE 290,G00,102440,Christensen; Henrik I,0,0,20,20
1668382757165,CSE 291,A00,102443,Su; Hao,0,0,0,0
1668382757165,CSE 291,B00,102448,Polikarpova; Nadezhda,0,0,0,0
1668382757165,CSE 291,C00,102453,Vaccaro; Kristen Marie,0,0,0,0
1668382757165,CSE 291,D00,111343,Savage; Stefan,0,0,0,0
1668382757165,CSE 291,E00,116474,Claffy; Kimberly Claire,0,0,0,0
1668382757165,CSE 291,F00,116479,Pasquale; Joseph,0,0,0,0
1668382757607,CSE 293,001,119111,Bafna; Vineet,9999,0,9999,0
1668382757607,CSE 293,002,119118,Bellare; Mihir,9999,0,9999,0
1668382757607,CSE 293,003,119122,Berg-Kirkpatrick; Taylor D,9999,0,9999,0
1668382757607,CSE 293,004,119135,Christensen; Henrik I,9999,0,9999,0
1668382757607,CSE 293,005,119142,Cottrell; Garrison W,9999,0,9999,0
1668382757607,CSE 293,006,119146,Deutsch; Alin Bernard,9999,0,9999,0
1668382757607,CSE 293,007,119159,Esmaeilzadeh; Hadi,9999,0,9999,0
1668382757607,CSE 293,008,119166,Freund; Yoav,9999,0,9999,0
1668382757607,CSE 293,009,119170,Griswold; William G.,9999,0,9999,0
1668382757607,CSE 293,010,119183,Gymrek; Melissa Ann,9999,0,9999,0
1668382757607,CSE 293,011,119190,Heninger; Nadia A,9999,0,9999,0
1668382757607,CSE 293,012,119230,Impagliazzo; Russell,9999,0,9999,0
1668382757607,CSE 293,013,119232,Jhala; Ranjit,9999,0,9999,0
1668382757607,CSE 293,014,119233,Kahng; Andrew Byun,9999,0,9999,0
1668382757607,CSE 293,015,119298,Kane; Daniel Mertz,9999,0,9999,0
1668382757607,CSE 293,016,119299,Kriegman; David J,9999,0,9999,0
1668382757607,CSE 293,017,119300,Kumar; Arun Kumar,9999,0,9999,0
1668382757607,CSE 293,018,119301,Lerner; Sorin,9999,0,9999,0
1668382757607,CSE 293,019,119302,Lovett; Shachar,9999,0,9999,0
1668382757607,CSE 293,020,119303,McAuley; Julian John,9999,0,9999,0
1668382757607,CSE 293,021,119304,Micciancio; Daniele,9999,0,9999,0
1668382757607,CSE 293,022,119367,Orailoglu; Alex,9999,0,9999,0
1668382757607,CSE 293,023,119382,Paturi; Ramamohan,9999,0,9999,0
1668382757607,CSE 293,024,119404,Polikarpova; Nadezhda,9999,0,9999,0
1668382757607,CSE 293,025,119406,Politz; Joseph Gibbs,9999,0,9999,0
1668382757607,CSE 293,026,119411,Porter; George M,9999,0,9999,0
1668382757607,CSE 293,027,119414,Porter; Leonard Emerson,9999,0,9999,0
1668382757607,CSE 293,028,119416,Ramamoorthi; Ravi,9999,0,9999,0
1668382757607,CSE 293,029,119417,Sahoo; Debashis,9999,0,9999,0
1668382757607,CSE 293,030,119420,Saul; Lawrence,9999,0,9999,0
1668382757607,CSE 293,031,119421,Savage; Stefan,9999,0,9999,0
1668382757607,CSE 293,032,119425,Schulze; Jurgen P.,9999,0,9999,0
1668382757607,CSE 293,033,119426,Snoeren; Alex C.,9999,0,9999,0
1668382757607,CSE 293,034,119428,Shang; Jingbo,9999,0,9999,0
1668382757607,CSE 293,035,119430,Stefan; Deian,9999,0,9999,0
1668382757607,CSE 293,036,119431,Su; Hao,9999,0,9999,0
1668382757607,CSE 293,037,119433,Swanson; Steven James,9999,0,9999,0
1668382757607,CSE 293,038,119435,Tullsen; Dean Michael,9999,0,9999,0
1668382757607,CSE 293,039,119483,Voelker; Geoffrey M.,9999,0,9999,0
1668382757607,CSE 293,040,119537,Zhao; Jishen,9999,0,9999,0
1668382757607,CSE 293,041,119538,Zhou; Yuan-Yuan,9999,0,9999,0
1668382757607,CSE 293,042,119539,Gao; Sicun,9999,0,9999,0
1668382757607,CSE 293,043,119540,Weibel; Nadir,9999,0,9999,0
1668382757607,CSE 293,044,119541,Gupta; Rajesh K.,9999,0,9999,0
1668382757607,CSE 293,045,126410,Vaccaro; Kristen Marie,9999,0,9999,0
1668382757607,CSE 293,046,126411,Klemke; Richard,9999,0,9999,0
1668382758034,CSE 294,A00,102459,Voelker; Geoffrey M.,0,0,0,0
1668382758034,CSE 294,B00,111322,Orailoglu; Alex,0,0,0,0
1668382758466,DSE 201,A00,096914,Deutsch; Alin Bernard,30,0,30,0
1668382758889,DSE 210,A00,096915,Dasgupta; Sanjoy,30,0,30,0
1668382759312,DSE 260A,A00,096916,Altintas De Callaf; Ilkay,30,0,30,0
1668382759749,ECE 200,001,103586,Antipa; Nicholas A,9999,0,9999,0
1668382759749,ECE 200,002,103587,Atanasov; Nikolay A.,9999,0,9999,0
1668382759749,ECE 200,003,103588,Bharadia; Dinesh,9999,0,9999,0
1668382759749,ECE 200,004,103589,Cheng; Chung Kuan,9999,0,9999,0
1668382759749,ECE 200,005,103590,Cosman; Pamela C.,9999,0,9999,0
1668382759749,ECE 200,006,103591,Dayeh; Shadi Ahmad,9999,0,9999,0
1668382759749,ECE 200,007,103592,Fainman; Yeshaiahu,9999,0,9999,0
1668382759749,ECE 200,008,103593,Ford; Joseph Earl,9999,0,9999,0
1668382759749,ECE 200,009,103594,Franceschetti; Massimo,9999,0,9999,0
1668382759749,ECE 200,010,103595,Fullerton; Eric E,9999,0,9999,0
1668382759749,ECE 200,011,103596,Galton; Ian A,9999,0,9999,0
1668382759749,ECE 200,012,103597,Gilja; Vikash,9999,0,9999,0
1668382759749,ECE 200,013,103598,Hall; Drew A.,9999,0,9999,0
1668382759749,ECE 200,014,103599,Hsueh; Tzu-Chien,9999,0,9999,0
1668382759749,ECE 200,015,103600,Javidi; Tara,9999,0,9999,0
1668382759749,ECE 200,016,103601,Kahng; Andrew Byun,9999,0,9999,0
1668382759749,ECE 200,017,103602,Kim; Young-Han,9999,0,9999,0
1668382759749,ECE 200,018,103603,Koushanfar; Farinaz,9999,0,9999,0
1668382759749,ECE 200,019,103604,Kuzum; Duygu,9999,0,9999,0
1668382759749,ECE 200,020,103605,Le; Hanh-Phuc,9999,0,9999,0
1668382759749,ECE 200,021,103606,Lin; Bill,9999,0,9999,0
1668382759749,ECE 200,022,103607,Liu; Zhaowei,9998,0,9999,1
1668382759749,ECE 200,023,103608,Lo; Yu-Hwa,9999,0,9999,0
1668382759749,ECE 200,024,103609,Lomakin; Vitaliy,9999,0,9999,0
1668382759749,ECE 200,025,103610,Mercier; Patrick Philip,9999,0,9999,0
1668382759749,ECE 200,026,103611,Meyer; Florian,9999,0,9999,0
1668382759749,ECE 200,027,103612,Milstein; Laurence B.,9999,0,9999,0
1668382759749,ECE 200,028,103613,Mir Arabbaygi; Siavash,9999,0,9999,0
1668382759749,ECE 200,029,103614,Mookherjea; Shayan,9999,0,9999,0
1668382759749,ECE 200,030,103615,Morris; Karcher William,9999,0,9999,0
1668382759749,ECE 200,031,103616,Ng; Tse Nga,9999,0,9999,0
1668382759749,ECE 200,032,103617,Nguyen; Truong Quang,9999,0,9999,0
1668382759749,ECE 200,033,103618,Nomura; Kenji,9999,0,9999,0
1668382759749,ECE 200,034,103619,Orlitsky; Alon,9999,0,9999,0
1668382759749,ECE 200,035,103620,Pal; Piya,9999,0,9999,0
1668382759749,ECE 200,036,103621,Papen; George C.,9999,0,9999,0
1668382759749,ECE 200,037,103622,Radic; Stojan,9999,0,9999,0
1668382759749,ECE 200,038,103623,Rao; Bhaskar D.,9999,0,9999,0
1668382759749,ECE 200,039,103624,Rao; Ramesh R,9999,0,9999,0
1668382759749,ECE 200,040,103625,Rebeiz; Gabriel,9999,0,9999,0
1668382759749,ECE 200,041,103626,Sanford; John R,9999,0,9999,0
1668382759749,ECE 200,042,103627,Siegel; Paul H.,9999,0,9999,0
1668382759749,ECE 200,043,103628,Sievenpiper; Daniel F.,9999,0,9999,0
1668382759749,ECE 200,044,103629,Sworder; David D.,9999,0,9999,0
1668382759749,ECE 200,045,103630,Taur; Yuan,9999,0,9999,0
1668382759749,ECE 200,046,103631,Touri; Behrouz,9999,0,9999,0
1668382759749,ECE 200,047,103632,Trivedi; Mohan M.,9999,0,9999,0
1668382759749,ECE 200,048,103633,Vasconcelos; Nuno,9999,0,9999,0
1668382759749,ECE 200,049,103634,Wang; Xiaolong,9999,0,9999,0
1668382759749,ECE 200,050,103635,Xie; Pengtao,9999,0,9999,0
1668382759749,ECE 200,051,103636,Yip; Michael,9999,0,9999,0
1668382759749,ECE 200,052,103637,Zeger; Kenneth A.,999,0,999,0
1668382759749,ECE 200,053,103638,Zhang; Xinyu,9999,0,9999,0
1668382759749,ECE 200,054,103639,Turakhia; Yatish Girish,9999,0,9999,0
1668382759749,ECE 200,055,103640,Kang; Mingu,9999,0,9999,0
1668382759749,ECE 200,056,103641,Shi; Yuanyuan,9999,0,9999,0
1668382759749,ECE 200,057,103642,Wang; Edward Jay,9999,0,9999,0
1668382759749,ECE 200,058,103643,Zheng; Yang,9999,0,9999,0
1668382760184,ECE 202,A00,103644,Kuzum; Duygu,0,0,0,0
1668382760609,ECE 212BN,A00,103646,Ng; Tse Nga,0,0,0,0
1668382761031,ECE 221,A00,111493,Staff,0,0,0,0
1668382761459,ECE 222B,A00,103647,Lomakin; Vitaliy,0,0,0,0
1668382761887,ECE 230B,A00,103648,Taur; Yuan,0,0,0,0
1668382762317,ECE 238B,A00,103649,Garay; Javier,0,0,0,0
1668382762743,ECE 240B,A00,112900,Fainman; Yeshaiahu,0,0,0,0
1668382763169,ECE 247A,A00,103650,Jokerst; Jesse Vincent,0,0,0,0
1668382763592,ECE 247B,A00,103651,Wang; Joseph,0,0,0,0
1668382764015,ECE 250,A00,103652,Siegel; Paul H.,0,0,0,0
1668382764439,ECE 251A,A00,103654,Rao; Bhaskar D.,0,0,0,0
1668382764874,ECE 257B,A00,103655,Bharadia; Dinesh,0,0,0,0
1668382765297,ECE 258A,A00,103656,Milstein; Laurence B.,0,0,0,0
1668382765730,ECE 260B,A00,103658,Kang; Mingu,0,0,0,0
1668382766153,ECE 264A,A00,103659,Galton; Ian A,0,0,0,0
1668382766580,ECE 265A,A00,103661,Gudem; Prasad S.S.,0,0,0,0
1668382767002,ECE 265D,A00,103662,Gudem; Prasad S.S.,0,0,0,0
1668382767427,ECE 268,A00,103663,Koushanfar; Farinaz,0,0,0,0
1668382767851,ECE 269,A01,103665,Pal; Piya,0,0,0,0
1668382768275,ECE 271B,A00,103666,Vasconcelos; Manuela,0,0,0,0
1668382768697,ECE 276A,A00,103667,Atanasov; Nikolay A.,0,0,0,0
1668382769123,ECE 277,A00,103668,An; Cheolhong,0,0,0,0
1668382769548,ECE 279,A00,117947,Hall; Drew A.,0,0,0,0
1668382770395,ECE 283,A00,103670,Hsueh; Tzu-Chien,0,0,0,0
1668382770821,ECE 284,A00,103671,Turakhia; Yatish Girish,0,0,0,0
1668382771243,ECE 285,A00,103672,Zheng; Yang,0,0,0,0
1668382771243,ECE 285,B00,103673,Sworder; David D.,0,0,0,0
1668382771665,ECE 287,A00,103676,Javidi; Tara,0,0,0,0
1668382772091,MATH 200B,A00,098023,Salehi Golsefidy; Alireza,12,0,15,3
1668382772514,MATH 202B,A00,098024,Rhoades; Brendon Patrick,9,0,15,6
1668382772940,MATH 203B,A00,098025,Oprea; Dragos N.,10,0,15,5
1668382773365,MATH 204B,A00,098026,Sorensen; Claus M,13,0,15,2
1668382773797,MATH 208,A00,098027,Izadi; Elham,7,0,10,3
1668382774221,MATH 209,A00,098028,Pollack; Aaron,10,0,10,0
1668382774643,MATH 211A,A00,112919,Rogalski; Daniel,9,0,10,1
1668382775073,MATH 211B,A00,112920,Seward; Brandon M.,9,0,10,1
1668382775495,MATH 218,A00,098029,Li; Bo,10,0,10,0
1668382775918,MATH 220B,A00,098030,Novak; Jonathan I,11,0,15,4
1668382776343,MATH 221A,A00,098031,Ebenfelt; Peter F,13,0,15,2
1668382776767,MATH 231B,A00,098032,Zlatos; Andrej,12,0,15,3
1668382777199,MATH 240B,A00,098033,Ni; Lei,9,0,15,6
1668382777624,MATH 243,A00,098034,Jekel; David Andrew,10,0,10,0
1668382778057,MATH 245A,A00,098035,Nie; Jiawang,0,0,15,16
1668382778480,MATH 248,A00,098036,Bejenaru; Ioan,10,0,10,0
1668382778915,MATH 250B,A00,098037,Spolaor; Luca,14,0,15,1
1668382779349,MATH 258,A00,098038,Ni; Lei,10,0,10,0
1668382779780,MATH 264B,A00,098041,Rhoades; Brendon Patrick,9,0,15,6
1668382780202,MATH 268,A00,098042,Buss; Samuel R,10,0,10,0
1668382780624,MATH 269,A00,098043,Rhoades; Brendon Patrick,10,0,10,0
1668382781050,MATH 270B,A00,098044,Li; Bo,10,0,15,5
1668382781478,MATH 272B,A00,098045,Holst; Michael J,13,0,15,2
1668382781915,MATH 273A,A00,098046,Tian; Xiaochuan,10,0,15,5
1668382782340,MATH 275,A01,098048,Tian; Xiaochuan,6,0,10,4
1668382782766,MATH 278A,A00,098049,Holst; Michael J,8,0,10,2
1668382783307,MATH 278B,A00,098050,Cloninger; Alexander,10,0,10,0
1668382783729,MATH 278C,A00,098051,Nie; Jiawang,7,0,10,3
1668382784152,MATH 280B,A00,098052,Zheng; Tianyi,8,0,15,7
1668382784576,MATH 281B,A00,098053,Bradic; Jelena,1,0,15,14
1668382784999,MATH 282B,A00,098054,Arias-Castro; Ery,0,0,15,15
1668382785422,MATH 285,A00,098055,Fitzsimmons; Patrick J,0,0,15,17
1668382785850,MATH 287B,A00,098056,Arias-Castro; Ery,2,0,15,13
1668382786279,MATH 288,A00,098057,Agarwal; Pooja,9,0,10,1
1668382786279,MATH 288,B00,098058,Zhang; Danna,8,0,10,2
1668382786279,MATH 288,C00,098059,Williams; Ruth J,9,0,10,1
1668382786712,MATH 290B,A00,098060,Roberts; Justin Deritter,13,0,15,2
1668382787135,MATH 292,A00,098061,Belmont; Eva Kinoshita,10,0,10,0
1668382787560,MATH 295,A00,098062,Suk; Andrew Hoon,48,0,50,2
1668382787987,MATH 296,A00,098063,Novak; Jonathan I,20,0,20,0
1668382788411,MATH 297,001,098064,Gamst; Anthony Collins,9997,0,9999,2
1668383288472,COGS 205,A00,101395,Chiba; Andrea,19,0,20,1
1668383288896,COGS 210B,001,101404,Greene; Deanna Jacquelyn,9998,0,9999,1
1668383288896,COGS 210B,002,101417,Xia; Haijun,9999,0,9999,0
1668383288896,COGS 210B,003,101422,Nitz; Douglas A.,9999,0,9999,0
1668383288896,COGS 210B,004,101423,Hollan; James D.,9998,0,9999,1
1668383288896,COGS 210B,005,101424,Deak; Gedeon O.,9998,0,9999,1
1668383288896,COGS 210B,006,101425,Rossano; Federico,9999,0,9999,0
1668383289321,COGS 211B,A00,101427,Coulson; Seana M,9996,0,9999,3
1668383289745,COGS 220,A00,101428,Hollan; James D.,0,0,25,25
1668383290181,COGS 229,A00,101429,Dow; Steven P,18,0,25,7
1668383290605,COGS 230,A00,101430,Klemmer; Scott R,11,0,17,6
1668383291038,COGS 234,A00,101431,Xia; Haijun,1,0,25,24
1668383291476,COGS 260,A00,101432,Kiyonaga; Anastasia,21,0,25,4
1668383291476,COGS 260,B00,101433,Kirsh; David Joel,15,0,25,10
1668383291899,CSE 202,A00,102371,Impagliazzo; Russell,0,0,0,0
1668383292322,CSE 203B,A01,102373,Cheng; Chung Kuan,0,0,0,0
1668383292747,CSE 208,A00,102374,Micciancio; Daniele,0,0,0,0
1668383293170,CSE 209A,A00,112895,Impagliazzo; Russell,0,0,15,15
1668383293593,CSE 209B,A00,108005,Bellare; Mihir,0,0,0,0
1668383294021,CSE 210,A00,113163,Coblenz; Michael J,0,0,0,0
1668383294456,CSE 219,A00,106111,Dow; Steven P,0,0,20,20
1668383294889,CSE 221,A00,102376,Voelker; Geoffrey M.,0,0,0,0
1668383295314,CSE 224,A01,102378,Porter; George M,0,0,0,0
1668383295742,CSE 229A,A00,102379,Savage; Stefan,0,0,0,0
1668383296177,CSE 229C,A00,102380,Munyaka; Imani N. S.,0,0,0,0
1668383296602,CSE 232B,A00,102382,Deutsch; Alin Bernard,0,0,0,0
1668383297026,CSE 234,A01,112904,Kumar; Arun Kumar,0,0,0,0
1668383297450,CSE 237A,A00,102383,Rosing; Tajana Simunic,0,0,0,0
1668383297874,CSE 239A,A00,102384,Deutsch; Alin Bernard,0,0,0,0
1668383298301,CSE 239B,A00,102385,Polikarpova; Nadezhda,0,0,0,0
1668383298726,CSE 240A,A00,102386,Pannuto; Patrick William,0,0,0,0
1668383299154,CSE 240B,A00,102387,Zhao; Jishen,0,0,0,0
1668383299591,CSE 241A,A00,106406,Kang; Mingu,0,0,0,0
1668383300022,CSE 249B,A00,102388,Kahng; Andrew Byun,0,0,8,8
1668383300449,CSE 251B,A01,102392,Cottrell; Garrison W,0,0,0,0
1668383300449,CSE 251B,A02,102393,Cottrell; Garrison W,0,0,0,0
1668383300887,CSE 252B,A00,102394,Ochoa; Benjamin Lawrence,0,0,0,0
1668383301313,CSE 257,A01,102396,Gao; Sicun,0,0,0,0
1668383301740,CSE 272,A00,102397,Li; Tzumao,0,0,0,0
1668383302165,CSE 274,A00,111323,Chern; Albert Ren-Haur,0,0,0,0
1668383302592,CSE 282,A00,102398,Pevzner; Pavel Arkadjevich,0,0,0,0
1668383303018,CSE 284,A00,114175,Gymrek; Melissa Ann,0,0,0,0
1668383303562,CSE 290,A00,102399,Chandraker; Manmohan Krishna,0,0,0,0
1668383303562,CSE 290,B00,102400,Vaccaro; Kristen Marie,0,0,25,25
1668383303562,CSE 290,C00,102414,Pannuto; Patrick William,0,0,25,25
1668383303562,CSE 290,D00,102427,Pevzner; Pavel Arkadjevich,0,0,0,0
1668383303562,CSE 290,E00,102429,Zhao; Jishen,0,0,0,0
1668383303562,CSE 290,F00,102436,Tullsen; Dean Michael,0,0,0,0
1668383303562,CSE 290,G00,102440,Christensen; Henrik I,0,0,20,20
1668383303992,CSE 291,A00,102443,Su; Hao,0,0,0,0
1668383303992,CSE 291,B00,102448,Polikarpova; Nadezhda,0,0,0,0
1668383303992,CSE 291,C00,102453,Vaccaro; Kristen Marie,0,0,0,0
1668383303992,CSE 291,D00,111343,Savage; Stefan,0,0,0,0
1668383303992,CSE 291,E00,116474,Claffy; Kimberly Claire,0,0,0,0
1668383303992,CSE 291,F00,116479,Pasquale; Joseph,0,0,0,0
1668383304449,CSE 293,001,119111,Bafna; Vineet,9999,0,9999,0
1668383304449,CSE 293,002,119118,Bellare; Mihir,9999,0,9999,0
1668383304449,CSE 293,003,119122,Berg-Kirkpatrick; Taylor D,9999,0,9999,0
1668383304449,CSE 293,004,119135,Christensen; Henrik I,9999,0,9999,0
1668383304449,CSE 293,005,119142,Cottrell; Garrison W,9999,0,9999,0
1668383304449,CSE 293,006,119146,Deutsch; Alin Bernard,9999,0,9999,0
1668383304449,CSE 293,007,119159,Esmaeilzadeh; Hadi,9999,0,9999,0
1668383304449,CSE 293,008,119166,Freund; Yoav,9999,0,9999,0
1668383304449,CSE 293,009,119170,Griswold; William G.,9999,0,9999,0
1668383304449,CSE 293,010,119183,Gymrek; Melissa Ann,9999,0,9999,0
1668383304449,CSE 293,011,119190,Heninger; Nadia A,9999,0,9999,0
1668383304449,CSE 293,012,119230,Impagliazzo; Russell,9999,0,9999,0
1668383304449,CSE 293,013,119232,Jhala; Ranjit,9999,0,9999,0
1668383304449,CSE 293,014,119233,Kahng; Andrew Byun,9999,0,9999,0
1668383304449,CSE 293,015,119298,Kane; Daniel Mertz,9999,0,9999,0
1668383304449,CSE 293,016,119299,Kriegman; David J,9999,0,9999,0
1668383304449,CSE 293,017,119300,Kumar; Arun Kumar,9999,0,9999,0
1668383304449,CSE 293,018,119301,Lerner; Sorin,9999,0,9999,0
1668383304449,CSE 293,019,119302,Lovett; Shachar,9999,0,9999,0
1668383304449,CSE 293,020,119303,McAuley; Julian John,9999,0,9999,0
1668383304449,CSE 293,021,119304,Micciancio; Daniele,9999,0,9999,0
1668383304449,CSE 293,022,119367,Orailoglu; Alex,9999,0,9999,0
1668383304449,CSE 293,023,119382,Paturi; Ramamohan,9999,0,9999,0
1668383304449,CSE 293,024,119404,Polikarpova; Nadezhda,9999,0,9999,0
1668383304449,CSE 293,025,119406,Politz; Joseph Gibbs,9999,0,9999,0
1668383304449,CSE 293,026,119411,Porter; George M,9999,0,9999,0
1668383304449,CSE 293,027,119414,Porter; Leonard Emerson,9999,0,9999,0
1668383304449,CSE 293,028,119416,Ramamoorthi; Ravi,9999,0,9999,0
1668383304449,CSE 293,029,119417,Sahoo; Debashis,9999,0,9999,0
1668383304449,CSE 293,030,119420,Saul; Lawrence,9999,0,9999,0
1668383304449,CSE 293,031,119421,Savage; Stefan,9999,0,9999,0
1668383304449,CSE 293,032,119425,Schulze; Jurgen P.,9999,0,9999,0
1668383304449,CSE 293,033,119426,Snoeren; Alex C.,9999,0,9999,0
1668383304449,CSE 293,034,119428,Shang; Jingbo,9999,0,9999,0
1668383304449,CSE 293,035,119430,Stefan; Deian,9999,0,9999,0
1668383304449,CSE 293,036,119431,Su; Hao,9999,0,9999,0
1668383304449,CSE 293,037,119433,Swanson; Steven James,9999,0,9999,0
1668383304449,CSE 293,038,119435,Tullsen; Dean Michael,9999,0,9999,0
1668383304449,CSE 293,039,119483,Voelker; Geoffrey M.,9999,0,9999,0
1668383304449,CSE 293,040,119537,Zhao; Jishen,9999,0,9999,0
1668383304449,CSE 293,041,119538,Zhou; Yuan-Yuan,9999,0,9999,0
1668383304449,CSE 293,042,119539,Gao; Sicun,9999,0,9999,0
1668383304449,CSE 293,043,119540,Weibel; Nadir,9999,0,9999,0
1668383304449,CSE 293,044,119541,Gupta; Rajesh K.,9999,0,9999,0
1668383304449,CSE 293,045,126410,Vaccaro; Kristen Marie,9999,0,9999,0
1668383304449,CSE 293,046,126411,Klemke; Richard,9999,0,9999,0
1668383304876,CSE 294,A00,102459,Voelker; Geoffrey M.,0,0,0,0
1668383304876,CSE 294,B00,111322,Orailoglu; Alex,0,0,0,0
1668383305316,DSE 201,A00,096914,Deutsch; Alin Bernard,30,0,30,0
1668383305740,DSE 210,A00,096915,Dasgupta; Sanjoy,30,0,30,0
1668383306170,DSE 260A,A00,096916,Altintas De Callaf; Ilkay,30,0,30,0
1668383306628,ECE 200,001,103586,Antipa; Nicholas A,9999,0,9999,0
1668383306628,ECE 200,002,103587,Atanasov; Nikolay A.,9999,0,9999,0
1668383306628,ECE 200,003,103588,Bharadia; Dinesh,9999,0,9999,0
1668383306628,ECE 200,004,103589,Cheng; Chung Kuan,9999,0,9999,0
1668383306628,ECE 200,005,103590,Cosman; Pamela C.,9999,0,9999,0
1668383306628,ECE 200,006,103591,Dayeh; Shadi Ahmad,9999,0,9999,0
1668383306628,ECE 200,007,103592,Fainman; Yeshaiahu,9999,0,9999,0
1668383306628,ECE 200,008,103593,Ford; Joseph Earl,9999,0,9999,0
1668383306628,ECE 200,009,103594,Franceschetti; Massimo,9999,0,9999,0
1668383306628,ECE 200,010,103595,Fullerton; Eric E,9999,0,9999,0
1668383306628,ECE 200,011,103596,Galton; Ian A,9999,0,9999,0
1668383306628,ECE 200,012,103597,Gilja; Vikash,9999,0,9999,0
1668383306628,ECE 200,013,103598,Hall; Drew A.,9999,0,9999,0
1668383306628,ECE 200,014,103599,Hsueh; Tzu-Chien,9999,0,9999,0
1668383306628,ECE 200,015,103600,Javidi; Tara,9999,0,9999,0
1668383306628,ECE 200,016,103601,Kahng; Andrew Byun,9999,0,9999,0
1668383306628,ECE 200,017,103602,Kim; Young-Han,9999,0,9999,0
1668383306628,ECE 200,018,103603,Koushanfar; Farinaz,9999,0,9999,0
1668383306628,ECE 200,019,103604,Kuzum; Duygu,9999,0,9999,0
1668383306628,ECE 200,020,103605,Le; Hanh-Phuc,9999,0,9999,0
1668383306628,ECE 200,021,103606,Lin; Bill,9999,0,9999,0
1668383306628,ECE 200,022,103607,Liu; Zhaowei,9998,0,9999,1
1668383306628,ECE 200,023,103608,Lo; Yu-Hwa,9999,0,9999,0
1668383306628,ECE 200,024,103609,Lomakin; Vitaliy,9999,0,9999,0
1668383306628,ECE 200,025,103610,Mercier; Patrick Philip,9999,0,9999,0
1668383306628,ECE 200,026,103611,Meyer; Florian,9999,0,9999,0
1668383306628,ECE 200,027,103612,Milstein; Laurence B.,9999,0,9999,0
1668383306628,ECE 200,028,103613,Mir Arabbaygi; Siavash,9999,0,9999,0
1668383306628,ECE 200,029,103614,Mookherjea; Shayan,9999,0,9999,0
1668383306628,ECE 200,030,103615,Morris; Karcher William,9999,0,9999,0
1668383306628,ECE 200,031,103616,Ng; Tse Nga,9999,0,9999,0
1668383306628,ECE 200,032,103617,Nguyen; Truong Quang,9999,0,9999,0
1668383306628,ECE 200,033,103618,Nomura; Kenji,9999,0,9999,0
1668383306628,ECE 200,034,103619,Orlitsky; Alon,9999,0,9999,0
1668383306628,ECE 200,035,103620,Pal; Piya,9999,0,9999,0
1668383306628,ECE 200,036,103621,Papen; George C.,9999,0,9999,0
1668383306628,ECE 200,037,103622,Radic; Stojan,9999,0,9999,0
1668383306628,ECE 200,038,103623,Rao; Bhaskar D.,9999,0,9999,0
1668383306628,ECE 200,039,103624,Rao; Ramesh R,9999,0,9999,0
1668383306628,ECE 200,040,103625,Rebeiz; Gabriel,9999,0,9999,0
1668383306628,ECE 200,041,103626,Sanford; John R,9999,0,9999,0
1668383306628,ECE 200,042,103627,Siegel; Paul H.,9999,0,9999,0
1668383306628,ECE 200,043,103628,Sievenpiper; Daniel F.,9999,0,9999,0
1668383306628,ECE 200,044,103629,Sworder; David D.,9999,0,9999,0
1668383306628,ECE 200,045,103630,Taur; Yuan,9999,0,9999,0
1668383306628,ECE 200,046,103631,Touri; Behrouz,9999,0,9999,0
1668383306628,ECE 200,047,103632,Trivedi; Mohan M.,9999,0,9999,0
1668383306628,ECE 200,048,103633,Vasconcelos; Nuno,9999,0,9999,0
1668383306628,ECE 200,049,103634,Wang; Xiaolong,9999,0,9999,0
1668383306628,ECE 200,050,103635,Xie; Pengtao,9999,0,9999,0
1668383306628,ECE 200,051,103636,Yip; Michael,9999,0,9999,0
1668383306628,ECE 200,052,103637,Zeger; Kenneth A.,999,0,999,0
1668383306628,ECE 200,053,103638,Zhang; Xinyu,9999,0,9999,0
1668383306628,ECE 200,054,103639,Turakhia; Yatish Girish,9999,0,9999,0
1668383306628,ECE 200,055,103640,Kang; Mingu,9999,0,9999,0
1668383306628,ECE 200,056,103641,Shi; Yuanyuan,9999,0,9999,0
1668383306628,ECE 200,057,103642,Wang; Edward Jay,9999,0,9999,0
1668383306628,ECE 200,058,103643,Zheng; Yang,9999,0,9999,0
1668383307052,ECE 202,A00,103644,Kuzum; Duygu,0,0,0,0
1668383307479,ECE 212BN,A00,103646,Ng; Tse Nga,0,0,0,0
1668383307902,ECE 221,A00,111493,Staff,0,0,0,0
1668383308334,ECE 222B,A00,103647,Lomakin; Vitaliy,0,0,0,0
1668383308760,ECE 230B,A00,103648,Taur; Yuan,0,0,0,0
1668383309191,ECE 238B,A00,103649,Garay; Javier,0,0,0,0
1668383309618,ECE 240B,A00,112900,Fainman; Yeshaiahu,0,0,0,0
1668383310043,ECE 247A,A00,103650,Jokerst; Jesse Vincent,0,0,0,0
1668383310469,ECE 247B,A00,103651,Wang; Joseph,0,0,0,0
1668383310894,ECE 250,A00,103652,Siegel; Paul H.,0,0,0,0
1668383311319,ECE 251A,A00,103654,Rao; Bhaskar D.,0,0,0,0
1668383311743,ECE 257B,A00,103655,Bharadia; Dinesh,0,0,0,0
1668383312170,ECE 258A,A00,103656,Milstein; Laurence B.,0,0,0,0
1668383312598,ECE 260B,A00,103658,Kang; Mingu,0,0,0,0
1668383313022,ECE 264A,A00,103659,Galton; Ian A,0,0,0,0
1668383313446,ECE 265A,A00,103661,Gudem; Prasad S.S.,0,0,0,0
1668383313873,ECE 265D,A00,103662,Gudem; Prasad S.S.,0,0,0,0
1668383314299,ECE 268,A00,103663,Koushanfar; Farinaz,0,0,0,0
1668383314725,ECE 269,A01,103665,Pal; Piya,0,0,0,0
1668383315147,ECE 271B,A00,103666,Vasconcelos; Manuela,0,0,0,0
1668383315574,ECE 276A,A00,103667,Atanasov; Nikolay A.,0,0,0,0
1668383315999,ECE 277,A00,103668,An; Cheolhong,0,0,0,0
1668383316422,ECE 279,A00,117947,Hall; Drew A.,0,0,0,0
1668383317269,ECE 283,A00,103670,Hsueh; Tzu-Chien,0,0,0,0
1668383317701,ECE 284,A00,103671,Turakhia; Yatish Girish,0,0,0,0
1668383318125,ECE 285,A00,103672,Zheng; Yang,0,0,0,0
1668383318125,ECE 285,B00,103673,Sworder; David D.,0,0,0,0
1668383318549,ECE 287,A00,103676,Javidi; Tara,0,0,0,0
1668383318976,MATH 200B,A00,098023,Salehi Golsefidy; Alireza,12,0,15,3
1668383319399,MATH 202B,A00,098024,Rhoades; Brendon Patrick,9,0,15,6
1668383319825,MATH 203B,A00,098025,Oprea; Dragos N.,10,0,15,5
1668383320249,MATH 204B,A00,098026,Sorensen; Claus M,13,0,15,2
1668383320676,MATH 208,A00,098027,Izadi; Elham,7,0,10,3
1668383321109,MATH 209,A00,098028,Pollack; Aaron,10,0,10,0
1668383321533,MATH 211A,A00,112919,Rogalski; Daniel,9,0,10,1
1668383321956,MATH 211B,A00,112920,Seward; Brandon M.,9,0,10,1
1668383322382,MATH 218,A00,098029,Li; Bo,10,0,10,0
1668383322805,MATH 220B,A00,098030,Novak; Jonathan I,11,0,15,4
1668383323248,MATH 221A,A00,098031,Ebenfelt; Peter F,13,0,15,2
1668383323685,MATH 231B,A00,098032,Zlatos; Andrej,12,0,15,3
1668383324107,MATH 240B,A00,098033,Ni; Lei,9,0,15,6
1668383324531,MATH 243,A00,098034,Jekel; David Andrew,10,0,10,0
1668383324957,MATH 245A,A00,098035,Nie; Jiawang,0,0,15,16
1668383325381,MATH 248,A00,098036,Bejenaru; Ioan,10,0,10,0
1668383325804,MATH 250B,A00,098037,Spolaor; Luca,14,0,15,1
1668383326229,MATH 258,A00,098038,Ni; Lei,10,0,10,0
1668383326656,MATH 264B,A00,098041,Rhoades; Brendon Patrick,9,0,15,6
1668383327081,MATH 268,A00,098042,Buss; Samuel R,10,0,10,0
1668383327507,MATH 269,A00,098043,Rhoades; Brendon Patrick,10,0,10,0
1668383327929,MATH 270B,A00,098044,Li; Bo,10,0,15,5
1668383328361,MATH 272B,A00,098045,Holst; Michael J,13,0,15,2
1668383328788,MATH 273A,A00,098046,Tian; Xiaochuan,10,0,15,5
1668383329215,MATH 275,A01,098048,Tian; Xiaochuan,6,0,10,4
1668383329642,MATH 278A,A00,098049,Holst; Michael J,8,0,10,2
1668383330072,MATH 278B,A00,098050,Cloninger; Alexander,10,0,10,0
1668383330498,MATH 278C,A00,098051,Nie; Jiawang,7,0,10,3
1668383330937,MATH 280B,A00,098052,Zheng; Tianyi,8,0,15,7
1668383331360,MATH 281B,A00,098053,Bradic; Jelena,1,0,15,14
1668383331798,MATH 282B,A00,098054,Arias-Castro; Ery,0,0,15,15
1668383332223,MATH 285,A00,098055,Fitzsimmons; Patrick J,0,0,15,17
1668383332645,MATH 287B,A00,098056,Arias-Castro; Ery,2,0,15,13
1668383333072,MATH 288,A00,098057,Agarwal; Pooja,9,0,10,1
1668383333072,MATH 288,B00,098058,Zhang; Danna,8,0,10,2
1668383333072,MATH 288,C00,098059,Williams; Ruth J,9,0,10,1
1668383333508,MATH 290B,A00,098060,Roberts; Justin Deritter,13,0,15,2
1668383333931,MATH 292,A00,098061,Belmont; Eva Kinoshita,10,0,10,0
1668383334355,MATH 295,A00,098062,Suk; Andrew Hoon,48,0,50,2
1668383334782,MATH 296,A00,098063,Novak; Jonathan I,20,0,20,0
1668383335204,MATH 297,001,098064,Gamst; Anthony Collins,9997,0,9999,2
1668383835492,COGS 205,A00,101395,Chiba; Andrea,19,0,20,1
1668383835915,COGS 210B,001,101404,Greene; Deanna Jacquelyn,9998,0,9999,1
1668383835915,COGS 210B,002,101417,Xia; Haijun,9999,0,9999,0
1668383835915,COGS 210B,003,101422,Nitz; Douglas A.,9999,0,9999,0
1668383835915,COGS 210B,004,101423,Hollan; James D.,9998,0,9999,1
1668383835915,COGS 210B,005,101424,Deak; Gedeon O.,9998,0,9999,1
1668383835915,COGS 210B,006,101425,Rossano; Federico,9999,0,9999,0
1668383836339,COGS 211B,A00,101427,Coulson; Seana M,9996,0,9999,3
1668383836767,COGS 220,A00,101428,Hollan; James D.,0,0,25,25
1668383837200,COGS 229,A00,101429,Dow; Steven P,18,0,25,7
1668383837636,COGS 230,A00,101430,Klemmer; Scott R,11,0,17,6
1668383838068,COGS 234,A00,101431,Xia; Haijun,1,0,25,24
1668383838492,COGS 260,A00,101432,Kiyonaga; Anastasia,21,0,25,4
1668383838492,COGS 260,B00,101433,Kirsh; David Joel,15,0,25,10
1668383838917,CSE 202,A00,102371,Impagliazzo; Russell,0,0,0,0
1668383839344,CSE 203B,A01,102373,Cheng; Chung Kuan,0,0,0,0
1668383839769,CSE 208,A00,102374,Micciancio; Daniele,0,0,0,0
1668383840198,CSE 209A,A00,112895,Impagliazzo; Russell,0,0,15,15
1668383840624,CSE 209B,A00,108005,Bellare; Mihir,0,0,0,0
1668383841050,CSE 210,A00,113163,Coblenz; Michael J,0,0,0,0
1668383841474,CSE 219,A00,106111,Dow; Steven P,0,0,20,20
1668383841899,CSE 221,A00,102376,Voelker; Geoffrey M.,0,0,0,0
1668383842325,CSE 224,A01,102378,Porter; George M,0,0,0,0
1668383842748,CSE 229A,A00,102379,Savage; Stefan,0,0,0,0
1668383843170,CSE 229C,A00,102380,Munyaka; Imani N. S.,0,0,0,0
1668383843596,CSE 232B,A00,102382,Deutsch; Alin Bernard,0,0,0,0
1668383844019,CSE 234,A01,112904,Kumar; Arun Kumar,0,0,0,0
1668383844443,CSE 237A,A00,102383,Rosing; Tajana Simunic,0,0,0,0
1668383844866,CSE 239A,A00,102384,Deutsch; Alin Bernard,0,0,0,0
1668383845289,CSE 239B,A00,102385,Polikarpova; Nadezhda,0,0,0,0
1668383845713,CSE 240A,A00,102386,Pannuto; Patrick William,0,0,0,0
1668383846137,CSE 240B,A00,102387,Zhao; Jishen,0,0,0,0
1668383846559,CSE 241A,A00,106406,Kang; Mingu,0,0,0,0
1668383846984,CSE 249B,A00,102388,Kahng; Andrew Byun,0,0,8,8
1668383847407,CSE 251B,A01,102392,Cottrell; Garrison W,0,0,0,0
1668383847407,CSE 251B,A02,102393,Cottrell; Garrison W,0,0,0,0
1668383847831,CSE 252B,A00,102394,Ochoa; Benjamin Lawrence,0,0,0,0
1668383848254,CSE 257,A01,102396,Gao; Sicun,0,0,0,0
1668383848690,CSE 272,A00,102397,Li; Tzumao,0,0,0,0
1668383849118,CSE 274,A00,111323,Chern; Albert Ren-Haur,0,0,0,0
1668383849544,CSE 282,A00,102398,Pevzner; Pavel Arkadjevich,0,0,0,0
1668383849969,CSE 284,A00,114175,Gymrek; Melissa Ann,0,0,0,0
1668383850393,CSE 290,A00,102399,Chandraker; Manmohan Krishna,0,0,0,0
1668383850393,CSE 290,B00,102400,Vaccaro; Kristen Marie,0,0,25,25
1668383850393,CSE 290,C00,102414,Pannuto; Patrick William,0,0,25,25
1668383850393,CSE 290,D00,102427,Pevzner; Pavel Arkadjevich,0,0,0,0
1668383850393,CSE 290,E00,102429,Zhao; Jishen,0,0,0,0
1668383850393,CSE 290,F00,102436,Tullsen; Dean Michael,0,0,0,0
1668383850393,CSE 290,G00,102440,Christensen; Henrik I,0,0,20,20
1668383850822,CSE 291,A00,102443,Su; Hao,0,0,0,0
1668383850822,CSE 291,B00,102448,Polikarpova; Nadezhda,0,0,0,0
1668383850822,CSE 291,C00,102453,Vaccaro; Kristen Marie,0,0,0,0
1668383850822,CSE 291,D00,111343,Savage; Stefan,0,0,0,0
1668383850822,CSE 291,E00,116474,Claffy; Kimberly Claire,0,0,0,0
1668383850822,CSE 291,F00,116479,Pasquale; Joseph,0,0,0,0
1668383851248,CSE 293,001,119111,Bafna; Vineet,9999,0,9999,0
1668383851248,CSE 293,002,119118,Bellare; Mihir,9999,0,9999,0
1668383851248,CSE 293,003,119122,Berg-Kirkpatrick; Taylor D,9999,0,9999,0
1668383851248,CSE 293,004,119135,Christensen; Henrik I,9999,0,9999,0
1668383851248,CSE 293,005,119142,Cottrell; Garrison W,9999,0,9999,0
1668383851248,CSE 293,006,119146,Deutsch; Alin Bernard,9999,0,9999,0
1668383851248,CSE 293,007,119159,Esmaeilzadeh; Hadi,9999,0,9999,0
1668383851248,CSE 293,008,119166,Freund; Yoav,9999,0,9999,0
1668383851248,CSE 293,009,119170,Griswold; William G.,9999,0,9999,0
1668383851248,CSE 293,010,119183,Gymrek; Melissa Ann,9999,0,9999,0
1668383851248,CSE 293,011,119190,Heninger; Nadia A,9999,0,9999,0
1668383851248,CSE 293,012,119230,Impagliazzo; Russell,9999,0,9999,0
1668383851248,CSE 293,013,119232,Jhala; Ranjit,9999,0,9999,0
1668383851248,CSE 293,014,119233,Kahng; Andrew Byun,9999,0,9999,0
1668383851248,CSE 293,015,119298,Kane; Daniel Mertz,9999,0,9999,0
1668383851248,CSE 293,016,119299,Kriegman; David J,9999,0,9999,0
1668383851248,CSE 293,017,119300,Kumar; Arun Kumar,9999,0,9999,0
1668383851248,CSE 293,018,119301,Lerner; Sorin,9999,0,9999,0
1668383851248,CSE 293,019,119302,Lovett; Shachar,9999,0,9999,0
1668383851248,CSE 293,020,119303,McAuley; Julian John,9999,0,9999,0
1668383851248,CSE 293,021,119304,Micciancio; Daniele,9999,0,9999,0
1668383851248,CSE 293,022,119367,Orailoglu; Alex,9999,0,9999,0
1668383851248,CSE 293,023,119382,Paturi; Ramamohan,9999,0,9999,0
1668383851248,CSE 293,024,119404,Polikarpova; Nadezhda,9999,0,9999,0
1668383851248,CSE 293,025,119406,Politz; Joseph Gibbs,9999,0,9999,0
1668383851248,CSE 293,026,119411,Porter; George M,9999,0,9999,0
1668383851248,CSE 293,027,119414,Porter; Leonard Emerson,9999,0,9999,0
1668383851248,CSE 293,028,119416,Ramamoorthi; Ravi,9999,0,9999,0
1668383851248,CSE 293,029,119417,Sahoo; Debashis,9999,0,9999,0
1668383851248,CSE 293,030,119420,Saul; Lawrence,9999,0,9999,0
1668383851248,CSE 293,031,119421,Savage; Stefan,9999,0,9999,0
1668383851248,CSE 293,032,119425,Schulze; Jurgen P.,9999,0,9999,0
1668383851248,CSE 293,033,119426,Snoeren; Alex C.,9999,0,9999,0
1668383851248,CSE 293,034,119428,Shang; Jingbo,9999,0,9999,0
1668383851248,CSE 293,035,119430,Stefan; Deian,9999,0,9999,0
1668383851248,CSE 293,036,119431,Su; Hao,9999,0,9999,0
1668383851248,CSE 293,037,119433,Swanson; Steven James,9999,0,9999,0
1668383851248,CSE 293,038,119435,Tullsen; Dean Michael,9999,0,9999,0
1668383851248,CSE 293,039,119483,Voelker; Geoffrey M.,9999,0,9999,0
1668383851248,CSE 293,040,119537,Zhao; Jishen,9999,0,9999,0
1668383851248,CSE 293,041,119538,Zhou; Yuan-Yuan,9999,0,9999,0
1668383851248,CSE 293,042,119539,Gao; Sicun,9999,0,9999,0
1668383851248,CSE 293,043,119540,Weibel; Nadir,9999,0,9999,0
1668383851248,CSE 293,044,119541,Gupta; Rajesh K.,9999,0,9999,0
1668383851248,CSE 293,045,126410,Vaccaro; Kristen Marie,9999,0,9999,0
1668383851248,CSE 293,046,126411,Klemke; Richard,9999,0,9999,0
1668383851670,CSE 294,A00,102459,Voelker; Geoffrey M.,0,0,0,0
1668383851670,CSE 294,B00,111322,Orailoglu; Alex,0,0,0,0
1668383852093,DSE 201,A00,096914,Deutsch; Alin Bernard,30,0,30,0
1668383852520,DSE 210,A00,096915,Dasgupta; Sanjoy,30,0,30,0
1668383852953,DSE 260A,A00,096916,Altintas De Callaf; Ilkay,30,0,30,0
1668383853433,ECE 200,001,103586,Antipa; Nicholas A,9999,0,9999,0
1668383853433,ECE 200,002,103587,Atanasov; Nikolay A.,9999,0,9999,0
1668383853433,ECE 200,003,103588,Bharadia; Dinesh,9999,0,9999,0
1668383853433,ECE 200,004,103589,Cheng; Chung Kuan,9999,0,9999,0
1668383853433,ECE 200,005,103590,Cosman; Pamela C.,9999,0,9999,0
1668383853433,ECE 200,006,103591,Dayeh; Shadi Ahmad,9999,0,9999,0
1668383853433,ECE 200,007,103592,Fainman; Yeshaiahu,9999,0,9999,0
1668383853433,ECE 200,008,103593,Ford; Joseph Earl,9999,0,9999,0
1668383853433,ECE 200,009,103594,Franceschetti; Massimo,9999,0,9999,0
1668383853433,ECE 200,010,103595,Fullerton; Eric E,9999,0,9999,0
1668383853433,ECE 200,011,103596,Galton; Ian A,9999,0,9999,0
1668383853433,ECE 200,012,103597,Gilja; Vikash,9999,0,9999,0
1668383853433,ECE 200,013,103598,Hall; Drew A.,9999,0,9999,0
1668383853433,ECE 200,014,103599,Hsueh; Tzu-Chien,9999,0,9999,0
1668383853433,ECE 200,015,103600,Javidi; Tara,9999,0,9999,0
1668383853433,ECE 200,016,103601,Kahng; Andrew Byun,9999,0,9999,0
1668383853433,ECE 200,017,103602,Kim; Young-Han,9999,0,9999,0
1668383853433,ECE 200,018,103603,Koushanfar; Farinaz,9999,0,9999,0
1668383853433,ECE 200,019,103604,Kuzum; Duygu,9999,0,9999,0
1668383853433,ECE 200,020,103605,Le; Hanh-Phuc,9999,0,9999,0
1668383853433,ECE 200,021,103606,Lin; Bill,9999,0,9999,0
1668383853433,ECE 200,022,103607,Liu; Zhaowei,9998,0,9999,1
1668383853433,ECE 200,023,103608,Lo; Yu-Hwa,9999,0,9999,0
1668383853433,ECE 200,024,103609,Lomakin; Vitaliy,9999,0,9999,0
1668383853433,ECE 200,025,103610,Mercier; Patrick Philip,9999,0,9999,0
1668383853433,ECE 200,026,103611,Meyer; Florian,9999,0,9999,0
1668383853433,ECE 200,027,103612,Milstein; Laurence B.,9999,0,9999,0
1668383853433,ECE 200,028,103613,Mir Arabbaygi; Siavash,9999,0,9999,0
1668383853433,ECE 200,029,103614,Mookherjea; Shayan,9999,0,9999,0
1668383853433,ECE 200,030,103615,Morris; Karcher William,9999,0,9999,0
1668383853433,ECE 200,031,103616,Ng; Tse Nga,9999,0,9999,0
1668383853433,ECE 200,032,103617,Nguyen; Truong Quang,9999,0,9999,0
1668383853433,ECE 200,033,103618,Nomura; Kenji,9999,0,9999,0
1668383853433,ECE 200,034,103619,Orlitsky; Alon,9999,0,9999,0
1668383853433,ECE 200,035,103620,Pal; Piya,9999,0,9999,0
1668383853433,ECE 200,036,103621,Papen; George C.,9999,0,9999,0
1668383853433,ECE 200,037,103622,Radic; Stojan,9999,0,9999,0
1668383853433,ECE 200,038,103623,Rao; Bhaskar D.,9999,0,9999,0
1668383853433,ECE 200,039,103624,Rao; Ramesh R,9999,0,9999,0
1668383853433,ECE 200,040,103625,Rebeiz; Gabriel,9999,0,9999,0
1668383853433,ECE 200,041,103626,Sanford; John R,9999,0,9999,0
1668383853433,ECE 200,042,103627,Siegel; Paul H.,9999,0,9999,0
1668383853433,ECE 200,043,103628,Sievenpiper; Daniel F.,9999,0,9999,0
1668383853433,ECE 200,044,103629,Sworder; David D.,9999,0,9999,0
1668383853433,ECE 200,045,103630,Taur; Yuan,9999,0,9999,0
1668383853433,ECE 200,046,103631,Touri; Behrouz,9999,0,9999,0
1668383853433,ECE 200,047,103632,Trivedi; Mohan M.,9999,0,9999,0
1668383853433,ECE 200,048,103633,Vasconcelos; Nuno,9999,0,9999,0
1668383853433,ECE 200,049,103634,Wang; Xiaolong,9999,0,9999,0
1668383853433,ECE 200,050,103635,Xie; Pengtao,9999,0,9999,0
1668383853433,ECE 200,051,103636,Yip; Michael,9999,0,9999,0
1668383853433,ECE 200,052,103637,Zeger; Kenneth A.,999,0,999,0
1668383853433,ECE 200,053,103638,Zhang; Xinyu,9999,0,9999,0
1668383853433,ECE 200,054,103639,Turakhia; Yatish Girish,9999,0,9999,0
1668383853433,ECE 200,055,103640,Kang; Mingu,9999,0,9999,0
1668383853433,ECE 200,056,103641,Shi; Yuanyuan,9999,0,9999,0
1668383853433,ECE 200,057,103642,Wang; Edward Jay,9999,0,9999,0
1668383853433,ECE 200,058,103643,Zheng; Yang,9999,0,9999,0
1668383853858,ECE 202,A00,103644,Kuzum; Duygu,0,0,0,0
1668383854283,ECE 212BN,A00,103646,Ng; Tse Nga,0,0,0,0
1668383854713,ECE 221,A00,111493,Staff,0,0,0,0
1668383855137,ECE 222B,A00,103647,Lomakin; Vitaliy,0,0,0,0
1668383855576,ECE 230B,A00,103648,Taur; Yuan,0,0,0,0
1668383856001,ECE 238B,A00,103649,Garay; Javier,0,0,0,0
1668383856425,ECE 240B,A00,112900,Fainman; Yeshaiahu,0,0,0,0
1668383856850,ECE 247A,A00,103650,Jokerst; Jesse Vincent,0,0,0,0
1668383857273,ECE 247B,A00,103651,Wang; Joseph,0,0,0,0
1668383857697,ECE 250,A00,103652,Siegel; Paul H.,0,0,0,0
1668383858120,ECE 251A,A00,103654,Rao; Bhaskar D.,0,0,0,0
1668383858547,ECE 257B,A00,103655,Bharadia; Dinesh,0,0,0,0
1668383858971,ECE 258A,A00,103656,Milstein; Laurence B.,0,0,0,0
1668383859397,ECE 260B,A00,103658,Kang; Mingu,0,0,0,0
1668383859825,ECE 264A,A00,103659,Galton; Ian A,0,0,0,0
1668383860247,ECE 265A,A00,103661,Gudem; Prasad S.S.,0,0,0,0
1668383860686,ECE 265D,A00,103662,Gudem; Prasad S.S.,0,0,0,0
1668383861112,ECE 268,A00,103663,Koushanfar; Farinaz,0,0,0,0
1668383861535,ECE 269,A01,103665,Pal; Piya,0,0,0,0
1668383861959,ECE 271B,A00,103666,Vasconcelos; Manuela,0,0,0,0
1668383862386,ECE 276A,A00,103667,Atanasov; Nikolay A.,0,0,0,0
1668383862807,ECE 277,A00,103668,An; Cheolhong,0,0,0,0
1668383863231,ECE 279,A00,117947,Hall; Drew A.,0,0,0,0
1668383864084,ECE 283,A00,103670,Hsueh; Tzu-Chien,0,0,0,0
1668383864511,ECE 284,A00,103671,Turakhia; Yatish Girish,0,0,0,0
1668383864933,ECE 285,A00,103672,Zheng; Yang,0,0,0,0
1668383864933,ECE 285,B00,103673,Sworder; David D.,0,0,0,0
1668383865359,ECE 287,A00,103676,Javidi; Tara,0,0,0,0
1668383865784,MATH 200B,A00,098023,Salehi Golsefidy; Alireza,12,0,15,3
1668383866210,MATH 202B,A00,098024,Rhoades; Brendon Patrick,9,0,15,6
1668383866635,MATH 203B,A00,098025,Oprea; Dragos N.,10,0,15,5
1668383867138,MATH 204B,A00,098026,Sorensen; Claus M,13,0,15,2
1668383867571,MATH 208,A00,098027,Izadi; Elham,7,0,10,3
1668383867997,MATH 209,A00,098028,Pollack; Aaron,10,0,10,0
1668383868419,MATH 211A,A00,112919,Rogalski; Daniel,9,0,10,1
1668383868842,MATH 211B,A00,112920,Seward; Brandon M.,9,0,10,1
1668383869267,MATH 218,A00,098029,Li; Bo,10,0,10,0
1668383869690,MATH 220B,A00,098030,Novak; Jonathan I,11,0,15,4
1668383870113,MATH 221A,A00,098031,Ebenfelt; Peter F,13,0,15,2
1668383870537,MATH 231B,A00,098032,Zlatos; Andrej,12,0,15,3
1668383870963,MATH 240B,A00,098033,Ni; Lei,9,0,15,6
1668383871385,MATH 243,A00,098034,Jekel; David Andrew,10,0,10,0
1668383871811,MATH 245A,A00,098035,Nie; Jiawang,0,0,15,16
1668383872235,MATH 248,A00,098036,Bejenaru; Ioan,10,0,10,0
1668383872658,MATH 250B,A00,098037,Spolaor; Luca,14,0,15,1
1668383873087,MATH 258,A00,098038,Ni; Lei,10,0,10,0
1668383873519,MATH 264B,A00,098041,Rhoades; Brendon Patrick,9,0,15,6
1668383873954,MATH 268,A00,098042,Buss; Samuel R,10,0,10,0
1668383874378,MATH 269,A00,098043,Rhoades; Brendon Patrick,10,0,10,0
1668383874801,MATH 270B,A00,098044,Li; Bo,10,0,15,5
1668383875228,MATH 272B,A00,098045,Holst; Michael J,13,0,15,2
1668383875651,MATH 273A,A00,098046,Tian; Xiaochuan,10,0,15,5
1668383876075,MATH 275,A01,098048,Tian; Xiaochuan,6,0,10,4
1668383876499,MATH 278A,A00,098049,Holst; Michael J,8,0,10,2
1668383876920,MATH 278B,A00,098050,Cloninger; Alexander,10,0,10,0
1668383877345,MATH 278C,A00,098051,Nie; Jiawang,7,0,10,3
1668383877771,MATH 280B,A00,098052,Zheng; Tianyi,8,0,15,7
1668383878195,MATH 281B,A00,098053,Bradic; Jelena,1,0,15,14
1668383878618,MATH 282B,A00,098054,Arias-Castro; Ery,0,0,15,15
1668383879044,MATH 285,A00,098055,Fitzsimmons; Patrick J,0,0,15,17
1668383879469,MATH 287B,A00,098056,Arias-Castro; Ery,2,0,15,13
1668383879891,MATH 288,A00,098057,Agarwal; Pooja,9,0,10,1
1668383879891,MATH 288,B00,098058,Zhang; Danna,8,0,10,2
1668383879891,MATH 288,C00,098059,Williams; Ruth J,9,0,10,1
1668383880330,MATH 290B,A00,098060,Roberts; Justin Deritter,13,0,15,2
1668383880754,MATH 292,A00,098061,Belmont; Eva Kinoshita,10,0,10,0
1668383881177,MATH 295,A00,098062,Suk; Andrew Hoon,48,0,50,2
1668383881601,MATH 296,A00,098063,Novak; Jonathan I,20,0,20,0
1668383882032,MATH 297,001,098064,Gamst; Anthony Collins,9997,0,9999,2
1668384383210,COGS 205,A00,101395,Chiba; Andrea,19,0,20,1
1668384383638,COGS 210B,001,101404,Greene; Deanna Jacquelyn,9998,0,9999,1
1668384383638,COGS 210B,002,101417,Xia; Haijun,9999,0,9999,0
1668384383638,COGS 210B,003,101422,Nitz; Douglas A.,9999,0,9999,0
1668384383638,COGS 210B,004,101423,Hollan; James D.,9998,0,9999,1
1668384383638,COGS 210B,005,101424,Deak; Gedeon O.,9998,0,9999,1
1668384383638,COGS 210B,006,101425,Rossano; Federico,9999,0,9999,0
1668384384078,COGS 211B,A00,101427,Coulson; Seana M,9996,0,9999,3
1668384384503,COGS 220,A00,101428,Hollan; James D.,0,0,25,25
1668384384927,COGS 229,A00,101429,Dow; Steven P,18,0,25,7
1668384385354,COGS 230,A00,101430,Klemmer; Scott R,11,0,17,6
1668384385779,COGS 234,A00,101431,Xia; Haijun,1,0,25,24
1668384386202,COGS 260,A00,101432,Kiyonaga; Anastasia,21,0,25,4
1668384386202,COGS 260,B00,101433,Kirsh; David Joel,15,0,25,10
1668384386639,CSE 202,A00,102371,Impagliazzo; Russell,0,0,0,0
1668384387066,CSE 203B,A01,102373,Cheng; Chung Kuan,0,0,0,0
1668384387495,CSE 208,A00,102374,Micciancio; Daniele,0,0,0,0
1668384387921,CSE 209A,A00,112895,Impagliazzo; Russell,0,0,15,15
1668384388425,CSE 209B,A00,108005,Bellare; Mihir,0,0,0,0
1668384388851,CSE 210,A00,113163,Coblenz; Michael J,0,0,0,0
1668384389274,CSE 219,A00,106111,Dow; Steven P,0,0,20,20
1668384389704,CSE 221,A00,102376,Voelker; Geoffrey M.,0,0,0,0
1668384390128,CSE 224,A01,102378,Porter; George M,0,0,0,0
1668384390552,CSE 229A,A00,102379,Savage; Stefan,0,0,0,0
1668384390978,CSE 229C,A00,102380,Munyaka; Imani N. S.,0,0,0,0
1668384391423,CSE 232B,A00,102382,Deutsch; Alin Bernard,0,0,0,0
1668384391855,CSE 234,A01,112904,Kumar; Arun Kumar,0,0,0,0
1668384392280,CSE 237A,A00,102383,Rosing; Tajana Simunic,0,0,0,0
1668384392705,CSE 239A,A00,102384,Deutsch; Alin Bernard,0,0,0,0
1668384393144,CSE 239B,A00,102385,Polikarpova; Nadezhda,0,0,0,0
1668384393580,CSE 240A,A00,102386,Pannuto; Patrick William,0,0,0,0
1668384394013,CSE 240B,A00,102387,Zhao; Jishen,0,0,0,0
1668384394438,CSE 241A,A00,106406,Kang; Mingu,0,0,0,0
1668384394861,CSE 249B,A00,102388,Kahng; Andrew Byun,0,0,8,8
1668384395288,CSE 251B,A01,102392,Cottrell; Garrison W,0,0,0,0
1668384395288,CSE 251B,A02,102393,Cottrell; Garrison W,0,0,0,0
1668384395715,CSE 252B,A00,102394,Ochoa; Benjamin Lawrence,0,0,0,0
1668384396138,CSE 257,A01,102396,Gao; Sicun,0,0,0,0
1668384396573,CSE 272,A00,102397,Li; Tzumao,0,0,0,0
1668384397000,CSE 274,A00,111323,Chern; Albert Ren-Haur,0,0,0,0
1668384397448,CSE 282,A00,102398,Pevzner; Pavel Arkadjevich,0,0,0,0
1668384397875,CSE 284,A00,114175,Gymrek; Melissa Ann,0,0,0,0
1668384398300,CSE 290,A00,102399,Chandraker; Manmohan Krishna,0,0,0,0
1668384398300,CSE 290,B00,102400,Vaccaro; Kristen Marie,0,0,25,25
1668384398300,CSE 290,C00,102414,Pannuto; Patrick William,0,0,25,25
1668384398300,CSE 290,D00,102427,Pevzner; Pavel Arkadjevich,0,0,0,0
1668384398300,CSE 290,E00,102429,Zhao; Jishen,0,0,0,0
1668384398300,CSE 290,F00,102436,Tullsen; Dean Michael,0,0,0,0
1668384398300,CSE 290,G00,102440,Christensen; Henrik I,0,0,20,20
1668384398730,CSE 291,A00,102443,Su; Hao,0,0,0,0
1668384398730,CSE 291,B00,102448,Polikarpova; Nadezhda,0,0,0,0
1668384398730,CSE 291,C00,102453,Vaccaro; Kristen Marie,0,0,0,0
1668384398730,CSE 291,D00,111343,Savage; Stefan,0,0,0,0
1668384398730,CSE 291,E00,116474,Claffy; Kimberly Claire,0,0,0,0
1668384398730,CSE 291,F00,116479,Pasquale; Joseph,0,0,0,0
1668384399167,CSE 293,001,119111,Bafna; Vineet,9999,0,9999,0
1668384399167,CSE 293,002,119118,Bellare; Mihir,9999,0,9999,0
1668384399167,CSE 293,003,119122,Berg-Kirkpatrick; Taylor D,9999,0,9999,0
1668384399167,CSE 293,004,119135,Christensen; Henrik I,9999,0,9999,0
1668384399167,CSE 293,005,119142,Cottrell; Garrison W,9999,0,9999,0
1668384399167,CSE 293,006,119146,Deutsch; Alin Bernard,9999,0,9999,0
1668384399167,CSE 293,007,119159,Esmaeilzadeh; Hadi,9999,0,9999,0
1668384399167,CSE 293,008,119166,Freund; Yoav,9999,0,9999,0
1668384399167,CSE 293,009,119170,Griswold; William G.,9999,0,9999,0
1668384399167,CSE 293,010,119183,Gymrek; Melissa Ann,9999,0,9999,0
1668384399167,CSE 293,011,119190,Heninger; Nadia A,9999,0,9999,0
1668384399167,CSE 293,012,119230,Impagliazzo; Russell,9999,0,9999,0
1668384399167,CSE 293,013,119232,Jhala; Ranjit,9999,0,9999,0
1668384399167,CSE 293,014,119233,Kahng; Andrew Byun,9999,0,9999,0
1668384399167,CSE 293,015,119298,Kane; Daniel Mertz,9999,0,9999,0
1668384399167,CSE 293,016,119299,Kriegman; David J,9999,0,9999,0
1668384399167,CSE 293,017,119300,Kumar; Arun Kumar,9999,0,9999,0
1668384399167,CSE 293,018,119301,Lerner; Sorin,9999,0,9999,0
1668384399167,CSE 293,019,119302,Lovett; Shachar,9999,0,9999,0
1668384399167,CSE 293,020,119303,McAuley; Julian John,9999,0,9999,0
1668384399167,CSE 293,021,119304,Micciancio; Daniele,9999,0,9999,0
1668384399167,CSE 293,022,119367,Orailoglu; Alex,9999,0,9999,0
1668384399167,CSE 293,023,119382,Paturi; Ramamohan,9999,0,9999,0
1668384399167,CSE 293,024,119404,Polikarpova; Nadezhda,9999,0,9999,0
1668384399167,CSE 293,025,119406,Politz; Joseph Gibbs,9999,0,9999,0
1668384399167,CSE 293,026,119411,Porter; George M,9999,0,9999,0
1668384399167,CSE 293,027,119414,Porter; Leonard Emerson,9999,0,9999,0
1668384399167,CSE 293,028,119416,Ramamoorthi; Ravi,9999,0,9999,0
1668384399167,CSE 293,029,119417,Sahoo; Debashis,9999,0,9999,0
1668384399167,CSE 293,030,119420,Saul; Lawrence,9999,0,9999,0
1668384399167,CSE 293,031,119421,Savage; Stefan,9999,0,9999,0
1668384399167,CSE 293,032,119425,Schulze; Jurgen P.,9999,0,9999,0
1668384399167,CSE 293,033,119426,Snoeren; Alex C.,9999,0,9999,0
1668384399167,CSE 293,034,119428,Shang; Jingbo,9999,0,9999,0
1668384399167,CSE 293,035,119430,Stefan; Deian,9999,0,9999,0
1668384399167,CSE 293,036,119431,Su; Hao,9999,0,9999,0
1668384399167,CSE 293,037,119433,Swanson; Steven James,9999,0,9999,0
1668384399167,CSE 293,038,119435,Tullsen; Dean Michael,9999,0,9999,0
1668384399167,CSE 293,039,119483,Voelker; Geoffrey M.,9999,0,9999,0
1668384399167,CSE 293,040,119537,Zhao; Jishen,9999,0,9999,0
1668384399167,CSE 293,041,119538,Zhou; Yuan-Yuan,9999,0,9999,0
1668384399167,CSE 293,042,119539,Gao; Sicun,9999,0,9999,0
1668384399167,CSE 293,043,119540,Weibel; Nadir,9999,0,9999,0
1668384399167,CSE 293,044,119541,Gupta; Rajesh K.,9999,0,9999,0
1668384399167,CSE 293,045,126410,Vaccaro; Kristen Marie,9999,0,9999,0
1668384399167,CSE 293,046,126411,Klemke; Richard,9999,0,9999,0
1668384399590,CSE 294,A00,102459,Voelker; Geoffrey M.,0,0,0,0
1668384399590,CSE 294,B00,111322,Orailoglu; Alex,0,0,0,0
1668384400017,DSE 201,A00,096914,Deutsch; Alin Bernard,30,0,30,0
1668384400448,DSE 210,A00,096915,Dasgupta; Sanjoy,30,0,30,0
1668384400873,DSE 260A,A00,096916,Altintas De Callaf; Ilkay,30,0,30,0
1668384401313,ECE 200,001,103586,Antipa; Nicholas A,9999,0,9999,0
1668384401313,ECE 200,002,103587,Atanasov; Nikolay A.,9999,0,9999,0
1668384401313,ECE 200,003,103588,Bharadia; Dinesh,9999,0,9999,0
1668384401313,ECE 200,004,103589,Cheng; Chung Kuan,9999,0,9999,0
1668384401313,ECE 200,005,103590,Cosman; Pamela C.,9999,0,9999,0
1668384401313,ECE 200,006,103591,Dayeh; Shadi Ahmad,9999,0,9999,0
1668384401313,ECE 200,007,103592,Fainman; Yeshaiahu,9999,0,9999,0
1668384401313,ECE 200,008,103593,Ford; Joseph Earl,9999,0,9999,0
1668384401313,ECE 200,009,103594,Franceschetti; Massimo,9999,0,9999,0
1668384401313,ECE 200,010,103595,Fullerton; Eric E,9999,0,9999,0
1668384401313,ECE 200,011,103596,Galton; Ian A,9999,0,9999,0
1668384401313,ECE 200,012,103597,Gilja; Vikash,9999,0,9999,0
1668384401313,ECE 200,013,103598,Hall; Drew A.,9999,0,9999,0
1668384401313,ECE 200,014,103599,Hsueh; Tzu-Chien,9999,0,9999,0
1668384401313,ECE 200,015,103600,Javidi; Tara,9999,0,9999,0
1668384401313,ECE 200,016,103601,Kahng; Andrew Byun,9999,0,9999,0
1668384401313,ECE 200,017,103602,Kim; Young-Han,9999,0,9999,0
1668384401313,ECE 200,018,103603,Koushanfar; Farinaz,9999,0,9999,0
1668384401313,ECE 200,019,103604,Kuzum; Duygu,9999,0,9999,0
1668384401313,ECE 200,020,103605,Le; Hanh-Phuc,9999,0,9999,0
1668384401313,ECE 200,021,103606,Lin; Bill,9999,0,9999,0
1668384401313,ECE 200,022,103607,Liu; Zhaowei,9998,0,9999,1
1668384401313,ECE 200,023,103608,Lo; Yu-Hwa,9999,0,9999,0
1668384401313,ECE 200,024,103609,Lomakin; Vitaliy,9999,0,9999,0
1668384401313,ECE 200,025,103610,Mercier; Patrick Philip,9999,0,9999,0
1668384401313,ECE 200,026,103611,Meyer; Florian,9999,0,9999,0
1668384401313,ECE 200,027,103612,Milstein; Laurence B.,9999,0,9999,0
1668384401313,ECE 200,028,103613,Mir Arabbaygi; Siavash,9999,0,9999,0
1668384401313,ECE 200,029,103614,Mookherjea; Shayan,9999,0,9999,0
1668384401313,ECE 200,030,103615,Morris; Karcher William,9999,0,9999,0
1668384401313,ECE 200,031,103616,Ng; Tse Nga,9999,0,9999,0
1668384401313,ECE 200,032,103617,Nguyen; Truong Quang,9999,0,9999,0
1668384401313,ECE 200,033,103618,Nomura; Kenji,9999,0,9999,0
1668384401313,ECE 200,034,103619,Orlitsky; Alon,9999,0,9999,0
1668384401313,ECE 200,035,103620,Pal; Piya,9999,0,9999,0
1668384401313,ECE 200,036,103621,Papen; George C.,9999,0,9999,0
1668384401313,ECE 200,037,103622,Radic; Stojan,9999,0,9999,0
1668384401313,ECE 200,038,103623,Rao; Bhaskar D.,9999,0,9999,0
1668384401313,ECE 200,039,103624,Rao; Ramesh R,9999,0,9999,0
1668384401313,ECE 200,040,103625,Rebeiz; Gabriel,9999,0,9999,0
1668384401313,ECE 200,041,103626,Sanford; John R,9999,0,9999,0
1668384401313,ECE 200,042,103627,Siegel; Paul H.,9999,0,9999,0
1668384401313,ECE 200,043,103628,Sievenpiper; Daniel F.,9999,0,9999,0
1668384401313,ECE 200,044,103629,Sworder; David D.,9999,0,9999,0
1668384401313,ECE 200,045,103630,Taur; Yuan,9999,0,9999,0
1668384401313,ECE 200,046,103631,Touri; Behrouz,9999,0,9999,0
1668384401313,ECE 200,047,103632,Trivedi; Mohan M.,9999,0,9999,0
1668384401313,ECE 200,048,103633,Vasconcelos; Nuno,9999,0,9999,0
1668384401313,ECE 200,049,103634,Wang; Xiaolong,9999,0,9999,0
1668384401313,ECE 200,050,103635,Xie; Pengtao,9999,0,9999,0
1668384401313,ECE 200,051,103636,Yip; Michael,9999,0,9999,0
1668384401313,ECE 200,052,103637,Zeger; Kenneth A.,999,0,999,0
1668384401313,ECE 200,053,103638,Zhang; Xinyu,9999,0,9999,0
1668384401313,ECE 200,054,103639,Turakhia; Yatish Girish,9999,0,9999,0
1668384401313,ECE 200,055,103640,Kang; Mingu,9999,0,9999,0
1668384401313,ECE 200,056,103641,Shi; Yuanyuan,9999,0,9999,0
1668384401313,ECE 200,057,103642,Wang; Edward Jay,9999,0,9999,0
1668384401313,ECE 200,058,103643,Zheng; Yang,9999,0,9999,0
1668384401738,ECE 202,A00,103644,Kuzum; Duygu,0,0,0,0
1668384402162,ECE 212BN,A00,103646,Ng; Tse Nga,0,0,0,0
1668384402586,ECE 221,A00,111493,Staff,0,0,0,0
1668384403024,ECE 222B,A00,103647,Lomakin; Vitaliy,0,0,0,0
1668384403449,ECE 230B,A00,103648,Taur; Yuan,0,0,0,0
1668384403885,ECE 238B,A00,103649,Garay; Javier,0,0,0,0
1668384404312,ECE 240B,A00,112900,Fainman; Yeshaiahu,0,0,0,0
1668384404737,ECE 247A,A00,103650,Jokerst; Jesse Vincent,0,0,0,0
1668384405159,ECE 247B,A00,103651,Wang; Joseph,0,0,0,0
1668384405600,ECE 250,A00,103652,Siegel; Paul H.,0,0,0,0
1668384406026,ECE 251A,A00,103654,Rao; Bhaskar D.,0,0,0,0
1668384406450,ECE 257B,A00,103655,Bharadia; Dinesh,0,0,0,0
1668384406898,ECE 258A,A00,103656,Milstein; Laurence B.,0,0,0,0
1668384407326,ECE 260B,A00,103658,Kang; Mingu,0,0,0,0
1668384407753,ECE 264A,A00,103659,Galton; Ian A,0,0,0,0
1668384408176,ECE 265A,A00,103661,Gudem; Prasad S.S.,0,0,0,0
1668384408608,ECE 265D,A00,103662,Gudem; Prasad S.S.,0,0,0,0
1668384409035,ECE 268,A00,103663,Koushanfar; Farinaz,0,0,0,0
1668384409458,ECE 269,A01,103665,Pal; Piya,0,0,0,0
1668384409886,ECE 271B,A00,103666,Vasconcelos; Manuela,0,0,0,0
1668384410312,ECE 276A,A00,103667,Atanasov; Nikolay A.,0,0,0,0
1668384410739,ECE 277,A00,103668,An; Cheolhong,0,0,0,0
1668384411171,ECE 279,A00,117947,Hall; Drew A.,0,0,0,0
1668384412024,ECE 283,A00,103670,Hsueh; Tzu-Chien,0,0,0,0
1668384412458,ECE 284,A00,103671,Turakhia; Yatish Girish,0,0,0,0
1668384412886,ECE 285,A00,103672,Zheng; Yang,0,0,0,0
1668384412886,ECE 285,B00,103673,Sworder; David D.,0,0,0,0
1668384413310,ECE 287,A00,103676,Javidi; Tara,0,0,0,0
1668384413731,MATH 200B,A00,098023,Salehi Golsefidy; Alireza,12,0,15,3
1668384414155,MATH 202B,A00,098024,Rhoades; Brendon Patrick,9,0,15,6
1668384414579,MATH 203B,A00,098025,Oprea; Dragos N.,10,0,15,5
1668384415011,MATH 204B,A00,098026,Sorensen; Claus M,13,0,15,2
1668384415435,MATH 208,A00,098027,Izadi; Elham,7,0,10,3
1668384415860,MATH 209,A00,098028,Pollack; Aaron,10,0,10,0
1668384416298,MATH 211A,A00,112919,Rogalski; Daniel,9,0,10,1
1668384416725,MATH 211B,A00,112920,Seward; Brandon M.,9,0,10,1
1668384417152,MATH 218,A00,098029,Li; Bo,10,0,10,0
1668384417578,MATH 220B,A00,098030,Novak; Jonathan I,11,0,15,4
1668384418002,MATH 221A,A00,098031,Ebenfelt; Peter F,13,0,15,2
1668384418426,MATH 231B,A00,098032,Zlatos; Andrej,12,0,15,3
1668384418853,MATH 240B,A00,098033,Ni; Lei,9,0,15,6
1668384419293,MATH 243,A00,098034,Jekel; David Andrew,10,0,10,0
1668384419720,MATH 245A,A00,098035,Nie; Jiawang,0,0,15,16
1668384420147,MATH 248,A00,098036,Bejenaru; Ioan,10,0,10,0
1668384420573,MATH 250B,A00,098037,Spolaor; Luca,14,0,15,1
1668384420996,MATH 258,A00,098038,Ni; Lei,10,0,10,0
1668384421423,MATH 264B,A00,098041,Rhoades; Brendon Patrick,9,0,15,6
1668384421848,MATH 268,A00,098042,Buss; Samuel R,10,0,10,0
1668384422272,MATH 269,A00,098043,Rhoades; Brendon Patrick,10,0,10,0
1668384422709,MATH 270B,A00,098044,Li; Bo,10,0,15,5
1668384423131,MATH 272B,A00,098045,Holst; Michael J,13,0,15,2
1668384423554,MATH 273A,A00,098046,Tian; Xiaochuan,10,0,15,5
1668384423978,MATH 275,A01,098048,Tian; Xiaochuan,6,0,10,4
1668384424402,MATH 278A,A00,098049,Holst; Michael J,8,0,10,2
1668384424831,MATH 278B,A00,098050,Cloninger; Alexander,10,0,10,0
1668384425259,MATH 278C,A00,098051,Nie; Jiawang,7,0,10,3
1668384425685,MATH 280B,A00,098052,Zheng; Tianyi,8,0,15,7
1668384426111,MATH 281B,A00,098053,Bradic; Jelena,1,0,15,14
1668384426539,MATH 282B,A00,098054,Arias-Castro; Ery,0,0,15,15
1668384426967,MATH 285,A00,098055,Fitzsimmons; Patrick J,0,0,15,17
1668384427391,MATH 287B,A00,098056,Arias-Castro; Ery,2,0,15,13
1668384427815,MATH 288,A00,098057,Agarwal; Pooja,9,0,10,1
1668384427815,MATH 288,B00,098058,Zhang; Danna,8,0,10,2
1668384427815,MATH 288,C00,098059,Williams; Ruth J,9,0,10,1
1668384428242,MATH 290B,A00,098060,Roberts; Justin Deritter,13,0,15,2
1668384428667,MATH 292,A00,098061,Belmont; Eva Kinoshita,10,0,10,0
1668384429093,MATH 295,A00,098062,Suk; Andrew Hoon,48,0,50,2
1668384429531,MATH 296,A00,098063,Novak; Jonathan I,20,0,20,0
1668384429960,MATH 297,001,098064,Gamst; Anthony Collins,9997,0,9999,2
1668384931347,COGS 205,A00,101395,Chiba; Andrea,19,0,20,1
1668384931783,COGS 210B,001,101404,Greene; Deanna Jacquelyn,9998,0,9999,1
1668384931783,COGS 210B,002,101417,Xia; Haijun,9999,0,9999,0
1668384931783,COGS 210B,003,101422,Nitz; Douglas A.,9999,0,9999,0
1668384931783,COGS 210B,004,101423,Hollan; James D.,9998,0,9999,1
1668384931783,COGS 210B,005,101424,Deak; Gedeon O.,9998,0,9999,1
1668384931783,COGS 210B,006,101425,Rossano; Federico,9999,0,9999,0
1668384932208,COGS 211B,A00,101427,Coulson; Seana M,9996,0,9999,3
1668384932634,COGS 220,A00,101428,Hollan; James D.,0,0,25,25
1668384933060,COGS 229,A00,101429,Dow; Steven P,18,0,25,7
1668384933485,COGS 230,A00,101430,Klemmer; Scott R,11,0,17,6
1668384933909,COGS 234,A00,101431,Xia; Haijun,1,0,25,24
1668384934333,COGS 260,A00,101432,Kiyonaga; Anastasia,21,0,25,4
1668384934333,COGS 260,B00,101433,Kirsh; David Joel,15,0,25,10
1668384934758,CSE 202,A00,102371,Impagliazzo; Russell,0,0,0,0
1668384935183,CSE 203B,A01,102373,Cheng; Chung Kuan,0,0,0,0
1668384935607,CSE 208,A00,102374,Micciancio; Daniele,0,0,0,0
1668384936045,CSE 209A,A00,112895,Impagliazzo; Russell,0,0,15,15
1668384936468,CSE 209B,A00,108005,Bellare; Mihir,0,0,0,0
1668384936895,CSE 210,A00,113163,Coblenz; Michael J,0,0,0,0
1668384937319,CSE 219,A00,106111,Dow; Steven P,0,0,20,20
1668384937745,CSE 221,A00,102376,Voelker; Geoffrey M.,0,0,0,0
1668384938172,CSE 224,A01,102378,Porter; George M,0,0,0,0
1668384938595,CSE 229A,A00,102379,Savage; Stefan,0,0,0,0
1668384939023,CSE 229C,A00,102380,Munyaka; Imani N. S.,0,0,0,0
1668384939446,CSE 232B,A00,102382,Deutsch; Alin Bernard,0,0,0,0
1668384939869,CSE 234,A01,112904,Kumar; Arun Kumar,0,0,0,0
1668384940295,CSE 237A,A00,102383,Rosing; Tajana Simunic,0,0,0,0
1668384940726,CSE 239A,A00,102384,Deutsch; Alin Bernard,0,0,0,0
1668384941150,CSE 239B,A00,102385,Polikarpova; Nadezhda,0,0,0,0
1668384941587,CSE 240A,A00,102386,Pannuto; Patrick William,0,0,0,0
1668384942010,CSE 240B,A00,102387,Zhao; Jishen,0,0,0,0
1668384942436,CSE 241A,A00,106406,Kang; Mingu,0,0,0,0
1668384942858,CSE 249B,A00,102388,Kahng; Andrew Byun,0,0,8,8
1668384943282,CSE 251B,A01,102392,Cottrell; Garrison W,0,0,0,0
1668384943282,CSE 251B,A02,102393,Cottrell; Garrison W,0,0,0,0
1668384943724,CSE 252B,A00,102394,Ochoa; Benjamin Lawrence,0,0,0,0
1668384944152,CSE 257,A01,102396,Gao; Sicun,0,0,0,0
1668384944577,CSE 272,A00,102397,Li; Tzumao,0,0,0,0
1668384945014,CSE 274,A00,111323,Chern; Albert Ren-Haur,0,0,0,0
1668384945437,CSE 282,A00,102398,Pevzner; Pavel Arkadjevich,0,0,0,0
1668384945863,CSE 284,A00,114175,Gymrek; Melissa Ann,0,0,0,0
1668384946290,CSE 290,A00,102399,Chandraker; Manmohan Krishna,0,0,0,0
1668384946290,CSE 290,B00,102400,Vaccaro; Kristen Marie,0,0,25,25
1668384946290,CSE 290,C00,102414,Pannuto; Patrick William,0,0,25,25
1668384946290,CSE 290,D00,102427,Pevzner; Pavel Arkadjevich,0,0,0,0
1668384946290,CSE 290,E00,102429,Zhao; Jishen,0,0,0,0
1668384946290,CSE 290,F00,102436,Tullsen; Dean Michael,0,0,0,0
1668384946290,CSE 290,G00,102440,Christensen; Henrik I,0,0,20,20
1668384946715,CSE 291,A00,102443,Su; Hao,0,0,0,0
1668384946715,CSE 291,B00,102448,Polikarpova; Nadezhda,0,0,0,0
1668384946715,CSE 291,C00,102453,Vaccaro; Kristen Marie,0,0,0,0
1668384946715,CSE 291,D00,111343,Savage; Stefan,0,0,0,0
1668384946715,CSE 291,E00,116474,Claffy; Kimberly Claire,0,0,0,0
1668384946715,CSE 291,F00,116479,Pasquale; Joseph,0,0,0,0
1668384947151,CSE 293,001,119111,Bafna; Vineet,9999,0,9999,0
1668384947151,CSE 293,002,119118,Bellare; Mihir,9999,0,9999,0
1668384947151,CSE 293,003,119122,Berg-Kirkpatrick; Taylor D,9999,0,9999,0
1668384947151,CSE 293,004,119135,Christensen; Henrik I,9999,0,9999,0
1668384947151,CSE 293,005,119142,Cottrell; Garrison W,9999,0,9999,0
1668384947151,CSE 293,006,119146,Deutsch; Alin Bernard,9999,0,9999,0
1668384947151,CSE 293,007,119159,Esmaeilzadeh; Hadi,9999,0,9999,0
1668384947151,CSE 293,008,119166,Freund; Yoav,9999,0,9999,0
1668384947151,CSE 293,009,119170,Griswold; William G.,9999,0,9999,0
1668384947151,CSE 293,010,119183,Gymrek; Melissa Ann,9999,0,9999,0
1668384947151,CSE 293,011,119190,Heninger; Nadia A,9999,0,9999,0
1668384947151,CSE 293,012,119230,Impagliazzo; Russell,9999,0,9999,0
1668384947151,CSE 293,013,119232,Jhala; Ranjit,9999,0,9999,0
1668384947151,CSE 293,014,119233,Kahng; Andrew Byun,9999,0,9999,0
1668384947151,CSE 293,015,119298,Kane; Daniel Mertz,9999,0,9999,0
1668384947151,CSE 293,016,119299,Kriegman; David J,9999,0,9999,0
1668384947151,CSE 293,017,119300,Kumar; Arun Kumar,9999,0,9999,0
1668384947151,CSE 293,018,119301,Lerner; Sorin,9999,0,9999,0
1668384947151,CSE 293,019,119302,Lovett; Shachar,9999,0,9999,0
1668384947151,CSE 293,020,119303,McAuley; Julian John,9999,0,9999,0
1668384947151,CSE 293,021,119304,Micciancio; Daniele,9999,0,9999,0
1668384947151,CSE 293,022,119367,Orailoglu; Alex,9999,0,9999,0
1668384947151,CSE 293,023,119382,Paturi; Ramamohan,9999,0,9999,0
1668384947151,CSE 293,024,119404,Polikarpova; Nadezhda,9999,0,9999,0
1668384947151,CSE 293,025,119406,Politz; Joseph Gibbs,9999,0,9999,0
1668384947151,CSE 293,026,119411,Porter; George M,9999,0,9999,0
1668384947151,CSE 293,027,119414,Porter; Leonard Emerson,9999,0,9999,0
1668384947151,CSE 293,028,119416,Ramamoorthi; Ravi,9999,0,9999,0
1668384947151,CSE 293,029,119417,Sahoo; Debashis,9999,0,9999,0
1668384947151,CSE 293,030,119420,Saul; Lawrence,9999,0,9999,0
1668384947151,CSE 293,031,119421,Savage; Stefan,9999,0,9999,0
1668384947151,CSE 293,032,119425,Schulze; Jurgen P.,9999,0,9999,0
1668384947151,CSE 293,033,119426,Snoeren; Alex C.,9999,0,9999,0
1668384947151,CSE 293,034,119428,Shang; Jingbo,9999,0,9999,0
1668384947151,CSE 293,035,119430,Stefan; Deian,9999,0,9999,0
1668384947151,CSE 293,036,119431,Su; Hao,9999,0,9999,0
1668384947151,CSE 293,037,119433,Swanson; Steven James,9999,0,9999,0
1668384947151,CSE 293,038,119435,Tullsen; Dean Michael,9999,0,9999,0
1668384947151,CSE 293,039,119483,Voelker; Geoffrey M.,9999,0,9999,0
1668384947151,CSE 293,040,119537,Zhao; Jishen,9999,0,9999,0
1668384947151,CSE 293,041,119538,Zhou; Yuan-Yuan,9999,0,9999,0
1668384947151,CSE 293,042,119539,Gao; Sicun,9999,0,9999,0
1668384947151,CSE 293,043,119540,Weibel; Nadir,9999,0,9999,0
1668384947151,CSE 293,044,119541,Gupta; Rajesh K.,9999,0,9999,0
1668384947151,CSE 293,045,126410,Vaccaro; Kristen Marie,9999,0,9999,0
1668384947151,CSE 293,046,126411,Klemke; Richard,9999,0,9999,0
1668384947577,CSE 294,A00,102459,Voelker; Geoffrey M.,0,0,0,0
1668384947577,CSE 294,B00,111322,Orailoglu; Alex,0,0,0,0
1668384948008,DSE 201,A00,096914,Deutsch; Alin Bernard,30,0,30,0
1668384948432,DSE 210,A00,096915,Dasgupta; Sanjoy,30,0,30,0
1668384948855,DSE 260A,A00,096916,Altintas De Callaf; Ilkay,30,0,30,0
1668384949284,ECE 200,001,103586,Antipa; Nicholas A,9999,0,9999,0
1668384949284,ECE 200,002,103587,Atanasov; Nikolay A.,9999,0,9999,0
1668384949284,ECE 200,003,103588,Bharadia; Dinesh,9999,0,9999,0
1668384949284,ECE 200,004,103589,Cheng; Chung Kuan,9999,0,9999,0
1668384949284,ECE 200,005,103590,Cosman; Pamela C.,9999,0,9999,0
1668384949284,ECE 200,006,103591,Dayeh; Shadi Ahmad,9999,0,9999,0
1668384949284,ECE 200,007,103592,Fainman; Yeshaiahu,9999,0,9999,0
1668384949284,ECE 200,008,103593,Ford; Joseph Earl,9999,0,9999,0
1668384949284,ECE 200,009,103594,Franceschetti; Massimo,9999,0,9999,0
1668384949284,ECE 200,010,103595,Fullerton; Eric E,9999,0,9999,0
1668384949284,ECE 200,011,103596,Galton; Ian A,9999,0,9999,0
1668384949284,ECE 200,012,103597,Gilja; Vikash,9999,0,9999,0
1668384949284,ECE 200,013,103598,Hall; Drew A.,9999,0,9999,0
1668384949284,ECE 200,014,103599,Hsueh; Tzu-Chien,9999,0,9999,0
1668384949284,ECE 200,015,103600,Javidi; Tara,9999,0,9999,0
1668384949284,ECE 200,016,103601,Kahng; Andrew Byun,9999,0,9999,0
1668384949284,ECE 200,017,103602,Kim; Young-Han,9999,0,9999,0
1668384949284,ECE 200,018,103603,Koushanfar; Farinaz,9999,0,9999,0
1668384949284,ECE 200,019,103604,Kuzum; Duygu,9999,0,9999,0
1668384949284,ECE 200,020,103605,Le; Hanh-Phuc,9999,0,9999,0
1668384949284,ECE 200,021,103606,Lin; Bill,9999,0,9999,0
1668384949284,ECE 200,022,103607,Liu; Zhaowei,9998,0,9999,1
1668384949284,ECE 200,023,103608,Lo; Yu-Hwa,9999,0,9999,0
1668384949284,ECE 200,024,103609,Lomakin; Vitaliy,9999,0,9999,0
1668384949284,ECE 200,025,103610,Mercier; Patrick Philip,9999,0,9999,0
1668384949284,ECE 200,026,103611,Meyer; Florian,9999,0,9999,0
1668384949284,ECE 200,027,103612,Milstein; Laurence B.,9999,0,9999,0
1668384949284,ECE 200,028,103613,Mir Arabbaygi; Siavash,9999,0,9999,0
1668384949284,ECE 200,029,103614,Mookherjea; Shayan,9999,0,9999,0
1668384949284,ECE 200,030,103615,Morris; Karcher William,9999,0,9999,0
1668384949284,ECE 200,031,103616,Ng; Tse Nga,9999,0,9999,0
1668384949284,ECE 200,032,103617,Nguyen; Truong Quang,9999,0,9999,0
1668384949284,ECE 200,033,103618,Nomura; Kenji,9999,0,9999,0
1668384949284,ECE 200,034,103619,Orlitsky; Alon,9999,0,9999,0
1668384949284,ECE 200,035,103620,Pal; Piya,9999,0,9999,0
1668384949284,ECE 200,036,103621,Papen; George C.,9999,0,9999,0
1668384949284,ECE 200,037,103622,Radic; Stojan,9999,0,9999,0
1668384949284,ECE 200,038,103623,Rao; Bhaskar D.,9999,0,9999,0
1668384949284,ECE 200,039,103624,Rao; Ramesh R,9999,0,9999,0
1668384949284,ECE 200,040,103625,Rebeiz; Gabriel,9999,0,9999,0
1668384949284,ECE 200,041,103626,Sanford; John R,9999,0,9999,0
1668384949284,ECE 200,042,103627,Siegel; Paul H.,9999,0,9999,0
1668384949284,ECE 200,043,103628,Sievenpiper; Daniel F.,9999,0,9999,0
1668384949284,ECE 200,044,103629,Sworder; David D.,9999,0,9999,0
1668384949284,ECE 200,045,103630,Taur; Yuan,9999,0,9999,0
1668384949284,ECE 200,046,103631,Touri; Behrouz,9999,0,9999,0
1668384949284,ECE 200,047,103632,Trivedi; Mohan M.,9999,0,9999,0
1668384949284,ECE 200,048,103633,Vasconcelos; Nuno,9999,0,9999,0
1668384949284,ECE 200,049,103634,Wang; Xiaolong,9999,0,9999,0
1668384949284,ECE 200,050,103635,Xie; Pengtao,9999,0,9999,0
1668384949284,ECE 200,051,103636,Yip; Michael,9999,0,9999,0
1668384949284,ECE 200,052,103637,Zeger; Kenneth A.,999,0,999,0
1668384949284,ECE 200,053,103638,Zhang; Xinyu,9999,0,9999,0
1668384949284,ECE 200,054,103639,Turakhia; Yatish Girish,9999,0,9999,0
1668384949284,ECE 200,055,103640,Kang; Mingu,9999,0,9999,0
1668384949284,ECE 200,056,103641,Shi; Yuanyuan,9999,0,9999,0
1668384949284,ECE 200,057,103642,Wang; Edward Jay,9999,0,9999,0
1668384949284,ECE 200,058,103643,Zheng; Yang,9999,0,9999,0
1668384949707,ECE 202,A00,103644,Kuzum; Duygu,0,0,0,0
1668384950141,ECE 212BN,A00,103646,Ng; Tse Nga,0,0,0,0
1668384950566,ECE 221,A00,111493,Staff,0,0,0,0
1668384950991,ECE 222B,A00,103647,Lomakin; Vitaliy,0,0,0,0
1668384951417,ECE 230B,A00,103648,Taur; Yuan,0,0,0,0
1668384951848,ECE 238B,A00,103649,Garay; Javier,0,0,0,0
1668384952275,ECE 240B,A00,112900,Fainman; Yeshaiahu,0,0,0,0
1668384952704,ECE 247A,A00,103650,Jokerst; Jesse Vincent,0,0,0,0
1668384953235,ECE 247B,A00,103651,Wang; Joseph,0,0,0,0
1668384953667,ECE 250,A00,103652,Siegel; Paul H.,0,0,0,0
1668384954089,ECE 251A,A00,103654,Rao; Bhaskar D.,0,0,0,0
1668384954513,ECE 257B,A00,103655,Bharadia; Dinesh,0,0,0,0
1668384954939,ECE 258A,A00,103656,Milstein; Laurence B.,0,0,0,0
1668384955362,ECE 260B,A00,103658,Kang; Mingu,0,0,0,0
1668384955800,ECE 264A,A00,103659,Galton; Ian A,0,0,0,0
1668384956229,ECE 265A,A00,103661,Gudem; Prasad S.S.,0,0,0,0
1668384956659,ECE 265D,A00,103662,Gudem; Prasad S.S.,0,0,0,0
1668384957083,ECE 268,A00,103663,Koushanfar; Farinaz,0,0,0,0
1668384957518,ECE 269,A01,103665,Pal; Piya,0,0,0,0
1668384957957,ECE 271B,A00,103666,Vasconcelos; Manuela,0,0,0,0
1668384958381,ECE 276A,A00,103667,Atanasov; Nikolay A.,0,0,0,0
1668384958803,ECE 277,A00,103668,An; Cheolhong,0,0,0,0
1668384959233,ECE 279,A00,117947,Hall; Drew A.,0,0,0,0
1668384960083,ECE 283,A00,103670,Hsueh; Tzu-Chien,0,0,0,0
1668384960508,ECE 284,A00,103671,Turakhia; Yatish Girish,0,0,0,0
1668384960944,ECE 285,A00,103672,Zheng; Yang,0,0,0,0
1668384960944,ECE 285,B00,103673,Sworder; David D.,0,0,0,0
1668384961375,ECE 287,A00,103676,Javidi; Tara,0,0,0,0
1668384961804,MATH 200B,A00,098023,Salehi Golsefidy; Alireza,12,0,15,3
1668384962231,MATH 202B,A00,098024,Rhoades; Brendon Patrick,9,0,15,6
1668384962660,MATH 203B,A00,098025,Oprea; Dragos N.,10,0,15,5
1668384963095,MATH 204B,A00,098026,Sorensen; Claus M,13,0,15,2
1668384963520,MATH 208,A00,098027,Izadi; Elham,7,0,10,3
1668384963945,MATH 209,A00,098028,Pollack; Aaron,10,0,10,0
1668384964369,MATH 211A,A00,112919,Rogalski; Daniel,9,0,10,1
1668384964798,MATH 211B,A00,112920,Seward; Brandon M.,9,0,10,1
1668384965221,MATH 218,A00,098029,Li; Bo,10,0,10,0
1668384965650,MATH 220B,A00,098030,Novak; Jonathan I,11,0,15,4
1668384966073,MATH 221A,A00,098031,Ebenfelt; Peter F,13,0,15,2
1668384966495,MATH 231B,A00,098032,Zlatos; Andrej,12,0,15,3
1668384966923,MATH 240B,A00,098033,Ni; Lei,9,0,15,6
1668384967362,MATH 243,A00,098034,Jekel; David Andrew,10,0,10,0
1668384967788,MATH 245A,A00,098035,Nie; Jiawang,0,0,15,16
1668384968227,MATH 248,A00,098036,Bejenaru; Ioan,10,0,10,0
1668384968650,MATH 250B,A00,098037,Spolaor; Luca,14,0,15,1
1668384969076,MATH 258,A00,098038,Ni; Lei,10,0,10,0
1668384969506,MATH 264B,A00,098041,Rhoades; Brendon Patrick,9,0,15,6
1668384969931,MATH 268,A00,098042,Buss; Samuel R,10,0,10,0
1668384970362,MATH 269,A00,098043,Rhoades; Brendon Patrick,10,0,10,0
1668384970807,MATH 270B,A00,098044,Li; Bo,10,0,15,5
1668384971230,MATH 272B,A00,098045,Holst; Michael J,13,0,15,2
1668384971653,MATH 273A,A00,098046,Tian; Xiaochuan,10,0,15,5
1668384972083,MATH 275,A01,098048,Tian; Xiaochuan,6,0,10,4
1668384972506,MATH 278A,A00,098049,Holst; Michael J,8,0,10,2
1668384972934,MATH 278B,A00,098050,Cloninger; Alexander,10,0,10,0
1668384973357,MATH 278C,A00,098051,Nie; Jiawang,7,0,10,3
1668384973793,MATH 280B,A00,098052,Zheng; Tianyi,8,0,15,7
1668384974216,MATH 281B,A00,098053,Bradic; Jelena,1,0,15,14
1668384974641,MATH 282B,A00,098054,Arias-Castro; Ery,0,0,15,15
1668384975081,MATH 285,A00,098055,Fitzsimmons; Patrick J,0,0,15,17
1668384975506,MATH 287B,A00,098056,Arias-Castro; Ery,2,0,15,13
1668384975945,MATH 288,A00,098057,Agarwal; Pooja,9,0,10,1
1668384975945,MATH 288,B00,098058,Zhang; Danna,8,0,10,2
1668384975945,MATH 288,C00,098059,Williams; Ruth J,9,0,10,1
1668384976368,MATH 290B,A00,098060,Roberts; Justin Deritter,13,0,15,2
1668384976800,MATH 292,A00,098061,Belmont; Eva Kinoshita,10,0,10,0
1668384977236,MATH 295,A00,098062,Suk; Andrew Hoon,48,0,50,2
1668384977660,MATH 296,A00,098063,Novak; Jonathan I,20,0,20,0
1668384978085,MATH 297,001,098064,Gamst; Anthony Collins,9997,0,9999,2
1668385478937,COGS 205,A00,101395,Chiba; Andrea,19,0,20,1
1668385479365,COGS 210B,001,101404,Greene; Deanna Jacquelyn,9998,0,9999,1
1668385479365,COGS 210B,002,101417,Xia; Haijun,9999,0,9999,0
1668385479365,COGS 210B,003,101422,Nitz; Douglas A.,9999,0,9999,0
1668385479365,COGS 210B,004,101423,Hollan; James D.,9998,0,9999,1
1668385479365,COGS 210B,005,101424,Deak; Gedeon O.,9998,0,9999,1
1668385479365,COGS 210B,006,101425,Rossano; Federico,9999,0,9999,0
1668385479790,COGS 211B,A00,101427,Coulson; Seana M,9996,0,9999,3
1668385480213,COGS 220,A00,101428,Hollan; James D.,0,0,25,25
1668385480640,COGS 229,A00,101429,Dow; Steven P,18,0,25,7
1668385481065,COGS 230,A00,101430,Klemmer; Scott R,11,0,17,6
1668385481493,COGS 234,A00,101431,Xia; Haijun,1,0,25,24
1668385481938,COGS 260,A00,101432,Kiyonaga; Anastasia,21,0,25,4
1668385481938,COGS 260,B00,101433,Kirsh; David Joel,15,0,25,10
1668385482367,CSE 202,A00,102371,Impagliazzo; Russell,0,0,0,0
1668385482790,CSE 203B,A01,102373,Cheng; Chung Kuan,0,0,0,0
1668385483216,CSE 208,A00,102374,Micciancio; Daniele,0,0,0,0
1668385483639,CSE 209A,A00,112895,Impagliazzo; Russell,0,0,15,15
1668385484065,CSE 209B,A00,108005,Bellare; Mihir,0,0,0,0
1668385484495,CSE 210,A00,113163,Coblenz; Michael J,0,0,0,0
1668385484919,CSE 219,A00,106111,Dow; Steven P,0,0,20,20
1668385485342,CSE 221,A00,102376,Voelker; Geoffrey M.,0,0,0,0
1668385485770,CSE 224,A01,102378,Porter; George M,0,0,0,0
1668385486202,CSE 229A,A00,102379,Savage; Stefan,0,0,0,0
1668385486627,CSE 229C,A00,102380,Munyaka; Imani N. S.,0,0,0,0
1668385487052,CSE 232B,A00,102382,Deutsch; Alin Bernard,0,0,0,0
1668385487475,CSE 234,A01,112904,Kumar; Arun Kumar,0,0,0,0
1668385487900,CSE 237A,A00,102383,Rosing; Tajana Simunic,0,0,0,0
1668385488323,CSE 239A,A00,102384,Deutsch; Alin Bernard,0,0,0,0
1668385488755,CSE 239B,A00,102385,Polikarpova; Nadezhda,0,0,0,0
1668385489185,CSE 240A,A00,102386,Pannuto; Patrick William,0,0,0,0
1668385489624,CSE 240B,A00,102387,Zhao; Jishen,0,0,0,0
1668385490066,CSE 241A,A00,106406,Kang; Mingu,0,0,0,0
1668385490504,CSE 249B,A00,102388,Kahng; Andrew Byun,0,0,8,8
1668385490940,CSE 251B,A01,102392,Cottrell; Garrison W,0,0,0,0
1668385490940,CSE 251B,A02,102393,Cottrell; Garrison W,0,0,0,0
1668385491363,CSE 252B,A00,102394,Ochoa; Benjamin Lawrence,0,0,0,0
1668385491801,CSE 257,A01,102396,Gao; Sicun,0,0,0,0
1668385492226,CSE 272,A00,102397,Li; Tzumao,0,0,0,0
1668385492651,CSE 274,A00,111323,Chern; Albert Ren-Haur,0,0,0,0
1668385493079,CSE 282,A00,102398,Pevzner; Pavel Arkadjevich,0,0,0,0
1668385493504,CSE 284,A00,114175,Gymrek; Melissa Ann,0,0,0,0
1668385493926,CSE 290,A00,102399,Chandraker; Manmohan Krishna,0,0,0,0
1668385493926,CSE 290,B00,102400,Vaccaro; Kristen Marie,0,0,25,25
1668385493926,CSE 290,C00,102414,Pannuto; Patrick William,0,0,25,25
1668385493926,CSE 290,D00,102427,Pevzner; Pavel Arkadjevich,0,0,0,0
1668385493926,CSE 290,E00,102429,Zhao; Jishen,0,0,0,0
1668385493926,CSE 290,F00,102436,Tullsen; Dean Michael,0,0,0,0
1668385493926,CSE 290,G00,102440,Christensen; Henrik I,0,0,20,20
1668385494350,CSE 291,A00,102443,Su; Hao,0,0,0,0
1668385494350,CSE 291,B00,102448,Polikarpova; Nadezhda,0,0,0,0
1668385494350,CSE 291,C00,102453,Vaccaro; Kristen Marie,0,0,0,0
1668385494350,CSE 291,D00,111343,Savage; Stefan,0,0,0,0
1668385494350,CSE 291,E00,116474,Claffy; Kimberly Claire,0,0,0,0
1668385494350,CSE 291,F00,116479,Pasquale; Joseph,0,0,0,0
1668385494780,CSE 293,001,119111,Bafna; Vineet,9999,0,9999,0
1668385494780,CSE 293,002,119118,Bellare; Mihir,9999,0,9999,0
1668385494780,CSE 293,003,119122,Berg-Kirkpatrick; Taylor D,9999,0,9999,0
1668385494780,CSE 293,004,119135,Christensen; Henrik I,9999,0,9999,0
1668385494780,CSE 293,005,119142,Cottrell; Garrison W,9999,0,9999,0
1668385494780,CSE 293,006,119146,Deutsch; Alin Bernard,9999,0,9999,0
1668385494780,CSE 293,007,119159,Esmaeilzadeh; Hadi,9999,0,9999,0
1668385494780,CSE 293,008,119166,Freund; Yoav,9999,0,9999,0
1668385494780,CSE 293,009,119170,Griswold; William G.,9999,0,9999,0
1668385494780,CSE 293,010,119183,Gymrek; Melissa Ann,9999,0,9999,0
1668385494780,CSE 293,011,119190,Heninger; Nadia A,9999,0,9999,0
1668385494780,CSE 293,012,119230,Impagliazzo; Russell,9999,0,9999,0
1668385494780,CSE 293,013,119232,Jhala; Ranjit,9999,0,9999,0
1668385494780,CSE 293,014,119233,Kahng; Andrew Byun,9999,0,9999,0
1668385494780,CSE 293,015,119298,Kane; Daniel Mertz,9999,0,9999,0
1668385494780,CSE 293,016,119299,Kriegman; David J,9999,0,9999,0
1668385494780,CSE 293,017,119300,Kumar; Arun Kumar,9999,0,9999,0
1668385494780,CSE 293,018,119301,Lerner; Sorin,9999,0,9999,0
1668385494780,CSE 293,019,119302,Lovett; Shachar,9999,0,9999,0
1668385494780,CSE 293,020,119303,McAuley; Julian John,9999,0,9999,0
1668385494780,CSE 293,021,119304,Micciancio; Daniele,9999,0,9999,0
1668385494780,CSE 293,022,119367,Orailoglu; Alex,9999,0,9999,0
1668385494780,CSE 293,023,119382,Paturi; Ramamohan,9999,0,9999,0
1668385494780,CSE 293,024,119404,Polikarpova; Nadezhda,9999,0,9999,0
1668385494780,CSE 293,025,119406,Politz; Joseph Gibbs,9999,0,9999,0
1668385494780,CSE 293,026,119411,Porter; George M,9999,0,9999,0
1668385494780,CSE 293,027,119414,Porter; Leonard Emerson,9999,0,9999,0
1668385494780,CSE 293,028,119416,Ramamoorthi; Ravi,9999,0,9999,0
1668385494780,CSE 293,029,119417,Sahoo; Debashis,9999,0,9999,0
1668385494780,CSE 293,030,119420,Saul; Lawrence,9999,0,9999,0
1668385494780,CSE 293,031,119421,Savage; Stefan,9999,0,9999,0
1668385494780,CSE 293,032,119425,Schulze; Jurgen P.,9999,0,9999,0
1668385494780,CSE 293,033,119426,Snoeren; Alex C.,9999,0,9999,0
1668385494780,CSE 293,034,119428,Shang; Jingbo,9999,0,9999,0
1668385494780,CSE 293,035,119430,Stefan; Deian,9999,0,9999,0
1668385494780,CSE 293,036,119431,Su; Hao,9999,0,9999,0
1668385494780,CSE 293,037,119433,Swanson; Steven James,9999,0,9999,0
1668385494780,CSE 293,038,119435,Tullsen; Dean Michael,9999,0,9999,0
1668385494780,CSE 293,039,119483,Voelker; Geoffrey M.,9999,0,9999,0
1668385494780,CSE 293,040,119537,Zhao; Jishen,9999,0,9999,0
1668385494780,CSE 293,041,119538,Zhou; Yuan-Yuan,9999,0,9999,0
1668385494780,CSE 293,042,119539,Gao; Sicun,9999,0,9999,0
1668385494780,CSE 293,043,119540,Weibel; Nadir,9999,0,9999,0
1668385494780,CSE 293,044,119541,Gupta; Rajesh K.,9999,0,9999,0
1668385494780,CSE 293,045,126410,Vaccaro; Kristen Marie,9999,0,9999,0
1668385494780,CSE 293,046,126411,Klemke; Richard,9999,0,9999,0
1668385495209,CSE 294,A00,102459,Voelker; Geoffrey M.,0,0,0,0
1668385495209,CSE 294,B00,111322,Orailoglu; Alex,0,0,0,0
1668385495635,DSE 201,A00,096914,Deutsch; Alin Bernard,30,0,30,0
1668385496072,DSE 210,A00,096915,Dasgupta; Sanjoy,30,0,30,0
1668385496495,DSE 260A,A00,096916,Altintas De Callaf; Ilkay,30,0,30,0
1668385496921,ECE 200,001,103586,Antipa; Nicholas A,9999,0,9999,0
1668385496921,ECE 200,002,103587,Atanasov; Nikolay A.,9999,0,9999,0
1668385496921,ECE 200,003,103588,Bharadia; Dinesh,9999,0,9999,0
1668385496921,ECE 200,004,103589,Cheng; Chung Kuan,9999,0,9999,0
1668385496921,ECE 200,005,103590,Cosman; Pamela C.,9999,0,9999,0
1668385496921,ECE 200,006,103591,Dayeh; Shadi Ahmad,9999,0,9999,0
1668385496921,ECE 200,007,103592,Fainman; Yeshaiahu,9999,0,9999,0
1668385496921,ECE 200,008,103593,Ford; Joseph Earl,9999,0,9999,0
1668385496921,ECE 200,009,103594,Franceschetti; Massimo,9999,0,9999,0
1668385496921,ECE 200,010,103595,Fullerton; Eric E,9999,0,9999,0
1668385496921,ECE 200,011,103596,Galton; Ian A,9999,0,9999,0
1668385496921,ECE 200,012,103597,Gilja; Vikash,9999,0,9999,0
1668385496921,ECE 200,013,103598,Hall; Drew A.,9999,0,9999,0
1668385496921,ECE 200,014,103599,Hsueh; Tzu-Chien,9999,0,9999,0
1668385496921,ECE 200,015,103600,Javidi; Tara,9999,0,9999,0
1668385496921,ECE 200,016,103601,Kahng; Andrew Byun,9999,0,9999,0
1668385496921,ECE 200,017,103602,Kim; Young-Han,9999,0,9999,0
1668385496921,ECE 200,018,103603,Koushanfar; Farinaz,9999,0,9999,0
1668385496921,ECE 200,019,103604,Kuzum; Duygu,9999,0,9999,0
1668385496921,ECE 200,020,103605,Le; Hanh-Phuc,9999,0,9999,0
1668385496921,ECE 200,021,103606,Lin; Bill,9999,0,9999,0
1668385496921,ECE 200,022,103607,Liu; Zhaowei,9998,0,9999,1
1668385496921,ECE 200,023,103608,Lo; Yu-Hwa,9999,0,9999,0
1668385496921,ECE 200,024,103609,Lomakin; Vitaliy,9999,0,9999,0
1668385496921,ECE 200,025,103610,Mercier; Patrick Philip,9999,0,9999,0
1668385496921,ECE 200,026,103611,Meyer; Florian,9999,0,9999,0
1668385496921,ECE 200,027,103612,Milstein; Laurence B.,9999,0,9999,0
1668385496921,ECE 200,028,103613,Mir Arabbaygi; Siavash,9999,0,9999,0
1668385496921,ECE 200,029,103614,Mookherjea; Shayan,9999,0,9999,0
1668385496921,ECE 200,030,103615,Morris; Karcher William,9999,0,9999,0
1668385496921,ECE 200,031,103616,Ng; Tse Nga,9999,0,9999,0
1668385496921,ECE 200,032,103617,Nguyen; Truong Quang,9999,0,9999,0
1668385496921,ECE 200,033,103618,Nomura; Kenji,9999,0,9999,0
1668385496921,ECE 200,034,103619,Orlitsky; Alon,9999,0,9999,0
1668385496921,ECE 200,035,103620,Pal; Piya,9999,0,9999,0
1668385496921,ECE 200,036,103621,Papen; George C.,9999,0,9999,0
1668385496921,ECE 200,037,103622,Radic; Stojan,9999,0,9999,0
1668385496921,ECE 200,038,103623,Rao; Bhaskar D.,9999,0,9999,0
1668385496921,ECE 200,039,103624,Rao; Ramesh R,9999,0,9999,0
1668385496921,ECE 200,040,103625,Rebeiz; Gabriel,9999,0,9999,0
1668385496921,ECE 200,041,103626,Sanford; John R,9999,0,9999,0
1668385496921,ECE 200,042,103627,Siegel; Paul H.,9999,0,9999,0
1668385496921,ECE 200,043,103628,Sievenpiper; Daniel F.,9999,0,9999,0
1668385496921,ECE 200,044,103629,Sworder; David D.,9999,0,9999,0
1668385496921,ECE 200,045,103630,Taur; Yuan,9999,0,9999,0
1668385496921,ECE 200,046,103631,Touri; Behrouz,9999,0,9999,0
1668385496921,ECE 200,047,103632,Trivedi; Mohan M.,9999,0,9999,0
1668385496921,ECE 200,048,103633,Vasconcelos; Nuno,9999,0,9999,0
1668385496921,ECE 200,049,103634,Wang; Xiaolong,9999,0,9999,0
1668385496921,ECE 200,050,103635,Xie; Pengtao,9999,0,9999,0
1668385496921,ECE 200,051,103636,Yip; Michael,9999,0,9999,0
1668385496921,ECE 200,052,103637,Zeger; Kenneth A.,999,0,999,0
1668385496921,ECE 200,053,103638,Zhang; Xinyu,9999,0,9999,0
1668385496921,ECE 200,054,103639,Turakhia; Yatish Girish,9999,0,9999,0
1668385496921,ECE 200,055,103640,Kang; Mingu,9999,0,9999,0
1668385496921,ECE 200,056,103641,Shi; Yuanyuan,9999,0,9999,0
1668385496921,ECE 200,057,103642,Wang; Edward Jay,9999,0,9999,0
1668385496921,ECE 200,058,103643,Zheng; Yang,9999,0,9999,0
1668385497346,ECE 202,A00,103644,Kuzum; Duygu,0,0,0,0
1668385497768,ECE 212BN,A00,103646,Ng; Tse Nga,0,0,0,0
1668385498196,ECE 221,A00,111493,Staff,0,0,0,0
1668385498619,ECE 222B,A00,103647,Lomakin; Vitaliy,0,0,0,0
1668385499041,ECE 230B,A00,103648,Taur; Yuan,0,0,0,0
1668385499466,ECE 238B,A00,103649,Garay; Javier,0,0,0,0
1668385499889,ECE 240B,A00,112900,Fainman; Yeshaiahu,0,0,0,0
1668385500313,ECE 247A,A00,103650,Jokerst; Jesse Vincent,0,0,0,0
1668385500747,ECE 247B,A00,103651,Wang; Joseph,0,0,0,0
1668385501173,ECE 250,A00,103652,Siegel; Paul H.,0,0,0,0
1668385501599,ECE 251A,A00,103654,Rao; Bhaskar D.,0,0,0,0
1668385502030,ECE 257B,A00,103655,Bharadia; Dinesh,0,0,0,0
1668385502453,ECE 258A,A00,103656,Milstein; Laurence B.,0,0,0,0
1668385502883,ECE 260B,A00,103658,Kang; Mingu,0,0,0,0
1668385503314,ECE 264A,A00,103659,Galton; Ian A,0,0,0,0
1668385503739,ECE 265A,A00,103661,Gudem; Prasad S.S.,0,0,0,0
1668385504164,ECE 265D,A00,103662,Gudem; Prasad S.S.,0,0,0,0
1668385504588,ECE 268,A00,103663,Koushanfar; Farinaz,0,0,0,0
1668385505016,ECE 269,A01,103665,Pal; Piya,0,0,0,0
1668385505443,ECE 271B,A00,103666,Vasconcelos; Manuela,0,0,0,0
1668385505867,ECE 276A,A00,103667,Atanasov; Nikolay A.,0,0,0,0
1668385506291,ECE 277,A00,103668,An; Cheolhong,0,0,0,0
1668385506713,ECE 279,A00,117947,Hall; Drew A.,0,0,0,0
1668385507566,ECE 283,A00,103670,Hsueh; Tzu-Chien,0,0,0,0
1668385507993,ECE 284,A00,103671,Turakhia; Yatish Girish,0,0,0,0
1668385508417,ECE 285,A00,103672,Zheng; Yang,0,0,0,0
1668385508417,ECE 285,B00,103673,Sworder; David D.,0,0,0,0
1668385508853,ECE 287,A00,103676,Javidi; Tara,0,0,0,0
1668385509277,MATH 200B,A00,098023,Salehi Golsefidy; Alireza,12,0,15,3
1668385509716,MATH 202B,A00,098024,Rhoades; Brendon Patrick,9,0,15,6
1668385510142,MATH 203B,A00,098025,Oprea; Dragos N.,10,0,15,5
1668385510574,MATH 204B,A00,098026,Sorensen; Claus M,13,0,15,2
1668385510998,MATH 208,A00,098027,Izadi; Elham,7,0,10,3
1668385511423,MATH 209,A00,098028,Pollack; Aaron,10,0,10,0
1668385511848,MATH 211A,A00,112919,Rogalski; Daniel,9,0,10,1
1668385512272,MATH 211B,A00,112920,Seward; Brandon M.,9,0,10,1
1668385512695,MATH 218,A00,098029,Li; Bo,10,0,10,0
1668385513123,MATH 220B,A00,098030,Novak; Jonathan I,11,0,15,4
1668385513547,MATH 221A,A00,098031,Ebenfelt; Peter F,13,0,15,2
1668385513980,MATH 231B,A00,098032,Zlatos; Andrej,12,0,15,3
1668385514405,MATH 240B,A00,098033,Ni; Lei,9,0,15,6
1668385514834,MATH 243,A00,098034,Jekel; David Andrew,10,0,10,0
1668385515275,MATH 245A,A00,098035,Nie; Jiawang,0,0,15,16
1668385515701,MATH 248,A00,098036,Bejenaru; Ioan,10,0,10,0
1668385516137,MATH 250B,A00,098037,Spolaor; Luca,14,0,15,1
1668385516560,MATH 258,A00,098038,Ni; Lei,10,0,10,0
1668385516997,MATH 264B,A00,098041,Rhoades; Brendon Patrick,9,0,15,6
1668385517512,MATH 268,A00,098042,Buss; Samuel R,10,0,10,0
1668385517936,MATH 269,A00,098043,Rhoades; Brendon Patrick,10,0,10,0
1668385518362,MATH 270B,A00,098044,Li; Bo,10,0,15,5
1668385518799,MATH 272B,A00,098045,Holst; Michael J,13,0,15,2
1668385519233,MATH 273A,A00,098046,Tian; Xiaochuan,10,0,15,5
1668385519661,MATH 275,A01,098048,Tian; Xiaochuan,6,0,10,4
1668385520087,MATH 278A,A00,098049,Holst; Michael J,8,0,10,2
1668385520513,MATH 278B,A00,098050,Cloninger; Alexander,10,0,10,0
1668385520936,MATH 278C,A00,098051,Nie; Jiawang,7,0,10,3
1668385521361,MATH 280B,A00,098052,Zheng; Tianyi,8,0,15,7
1668385521785,MATH 281B,A00,098053,Bradic; Jelena,1,0,15,14
1668385522212,MATH 282B,A00,098054,Arias-Castro; Ery,0,0,15,15
1668385522641,MATH 285,A00,098055,Fitzsimmons; Patrick J,0,0,15,17
1668385523078,MATH 287B,A00,098056,Arias-Castro; Ery,2,0,15,13
1668385523513,MATH 288,A00,098057,Agarwal; Pooja,9,0,10,1
1668385523513,MATH 288,B00,098058,Zhang; Danna,8,0,10,2
1668385523513,MATH 288,C00,098059,Williams; Ruth J,9,0,10,1
1668385523951,MATH 290B,A00,098060,Roberts; Justin Deritter,13,0,15,2
1668385524385,MATH 292,A00,098061,Belmont; Eva Kinoshita,10,0,10,0
1668385524812,MATH 295,A00,098062,Suk; Andrew Hoon,48,0,50,2
1668385525246,MATH 296,A00,098063,Novak; Jonathan I,20,0,20,0
1668385525676,MATH 297,001,098064,Gamst; Anthony Collins,9997,0,9999,2
1668386026758,COGS 205,A00,101395,Chiba; Andrea,19,0,20,1
1668386027183,COGS 210B,001,101404,Greene; Deanna Jacquelyn,9998,0,9999,1
1668386027183,COGS 210B,002,101417,Xia; Haijun,9999,0,9999,0
1668386027183,COGS 210B,003,101422,Nitz; Douglas A.,9999,0,9999,0
1668386027183,COGS 210B,004,101423,Hollan; James D.,9998,0,9999,1
1668386027183,COGS 210B,005,101424,Deak; Gedeon O.,9998,0,9999,1
1668386027183,COGS 210B,006,101425,Rossano; Federico,9999,0,9999,0
1668386027605,COGS 211B,A00,101427,Coulson; Seana M,9996,0,9999,3
1668386028030,COGS 220,A00,101428,Hollan; James D.,0,0,25,25
1668386028453,COGS 229,A00,101429,Dow; Steven P,18,0,25,7
1668386028878,COGS 230,A00,101430,Klemmer; Scott R,11,0,17,6
1668386029303,COGS 234,A00,101431,Xia; Haijun,1,0,25,24
1668386029727,COGS 260,A00,101432,Kiyonaga; Anastasia,21,0,25,4
1668386029727,COGS 260,B00,101433,Kirsh; David Joel,15,0,25,10
1668386030151,CSE 202,A00,102371,Impagliazzo; Russell,0,0,0,0
1668386030575,CSE 203B,A01,102373,Cheng; Chung Kuan,0,0,0,0
1668386031002,CSE 208,A00,102374,Micciancio; Daniele,0,0,0,0
1668386031435,CSE 209A,A00,112895,Impagliazzo; Russell,0,0,15,15
1668386031860,CSE 209B,A00,108005,Bellare; Mihir,0,0,0,0
1668386032283,CSE 210,A00,113163,Coblenz; Michael J,0,0,0,0
1668386032707,CSE 219,A00,106111,Dow; Steven P,0,0,20,20
1668386033134,CSE 221,A00,102376,Voelker; Geoffrey M.,0,0,0,0
1668386033558,CSE 224,A01,102378,Porter; George M,0,0,0,0
1668386033981,CSE 229A,A00,102379,Savage; Stefan,0,0,0,0
1668386034403,CSE 229C,A00,102380,Munyaka; Imani N. S.,0,0,0,0
1668386034833,CSE 232B,A00,102382,Deutsch; Alin Bernard,0,0,0,0
1668386035256,CSE 234,A01,112904,Kumar; Arun Kumar,0,0,0,0
1668386035683,CSE 237A,A00,102383,Rosing; Tajana Simunic,0,0,0,0
1668386036125,CSE 239A,A00,102384,Deutsch; Alin Bernard,0,0,0,0
1668386036559,CSE 239B,A00,102385,Polikarpova; Nadezhda,0,0,0,0
1668386036981,CSE 240A,A00,102386,Pannuto; Patrick William,0,0,0,0
1668386037406,CSE 240B,A00,102387,Zhao; Jishen,0,0,0,0
1668386037829,CSE 241A,A00,106406,Kang; Mingu,0,0,0,0
1668386038252,CSE 249B,A00,102388,Kahng; Andrew Byun,0,0,8,8
1668386038778,CSE 251B,A01,102392,Cottrell; Garrison W,0,0,0,0
1668386038778,CSE 251B,A02,102393,Cottrell; Garrison W,0,0,0,0
1668386039213,CSE 252B,A00,102394,Ochoa; Benjamin Lawrence,0,0,0,0
1668386039637,CSE 257,A01,102396,Gao; Sicun,0,0,0,0
1668386040060,CSE 272,A00,102397,Li; Tzumao,0,0,0,0
1668386040486,CSE 274,A00,111323,Chern; Albert Ren-Haur,0,0,0,0
1668386040913,CSE 282,A00,102398,Pevzner; Pavel Arkadjevich,0,0,0,0
1668386041337,CSE 284,A00,114175,Gymrek; Melissa Ann,0,0,0,0
1668386041769,CSE 290,A00,102399,Chandraker; Manmohan Krishna,0,0,0,0
1668386041769,CSE 290,B00,102400,Vaccaro; Kristen Marie,0,0,25,25
1668386041769,CSE 290,C00,102414,Pannuto; Patrick William,0,0,25,25
1668386041769,CSE 290,D00,102427,Pevzner; Pavel Arkadjevich,0,0,0,0
1668386041769,CSE 290,E00,102429,Zhao; Jishen,0,0,0,0
1668386041769,CSE 290,F00,102436,Tullsen; Dean Michael,0,0,0,0
1668386041769,CSE 290,G00,102440,Christensen; Henrik I,0,0,20,20
1668386042203,CSE 291,A00,102443,Su; Hao,0,0,0,0
1668386042203,CSE 291,B00,102448,Polikarpova; Nadezhda,0,0,0,0
1668386042203,CSE 291,C00,102453,Vaccaro; Kristen Marie,0,0,0,0
1668386042203,CSE 291,D00,111343,Savage; Stefan,0,0,0,0
1668386042203,CSE 291,E00,116474,Claffy; Kimberly Claire,0,0,0,0
1668386042203,CSE 291,F00,116479,Pasquale; Joseph,0,0,0,0
1668386042676,CSE 293,001,119111,Bafna; Vineet,9999,0,9999,0
1668386042676,CSE 293,002,119118,Bellare; Mihir,9999,0,9999,0
1668386042676,CSE 293,003,119122,Berg-Kirkpatrick; Taylor D,9999,0,9999,0
1668386042676,CSE 293,004,119135,Christensen; Henrik I,9999,0,9999,0
1668386042676,CSE 293,005,119142,Cottrell; Garrison W,9999,0,9999,0
1668386042676,CSE 293,006,119146,Deutsch; Alin Bernard,9999,0,9999,0
1668386042676,CSE 293,007,119159,Esmaeilzadeh; Hadi,9999,0,9999,0
1668386042676,CSE 293,008,119166,Freund; Yoav,9999,0,9999,0
1668386042676,CSE 293,009,119170,Griswold; William G.,9999,0,9999,0
1668386042676,CSE 293,010,119183,Gymrek; Melissa Ann,9999,0,9999,0
1668386042676,CSE 293,011,119190,Heninger; Nadia A,9999,0,9999,0
1668386042676,CSE 293,012,119230,Impagliazzo; Russell,9999,0,9999,0
1668386042676,CSE 293,013,119232,Jhala; Ranjit,9999,0,9999,0
1668386042676,CSE 293,014,119233,Kahng; Andrew Byun,9999,0,9999,0
1668386042676,CSE 293,015,119298,Kane; Daniel Mertz,9999,0,9999,0
1668386042676,CSE 293,016,119299,Kriegman; David J,9999,0,9999,0
1668386042676,CSE 293,017,119300,Kumar; Arun Kumar,9999,0,9999,0
1668386042676,CSE 293,018,119301,Lerner; Sorin,9999,0,9999,0
1668386042676,CSE 293,019,119302,Lovett; Shachar,9999,0,9999,0
1668386042676,CSE 293,020,119303,McAuley; Julian John,9999,0,9999,0
1668386042676,CSE 293,021,119304,Micciancio; Daniele,9999,0,9999,0
1668386042676,CSE 293,022,119367,Orailoglu; Alex,9999,0,9999,0
1668386042676,CSE 293,023,119382,Paturi; Ramamohan,9999,0,9999,0
1668386042676,CSE 293,024,119404,Polikarpova; Nadezhda,9999,0,9999,0
1668386042676,CSE 293,025,119406,Politz; Joseph Gibbs,9999,0,9999,0
1668386042676,CSE 293,026,119411,Porter; George M,9999,0,9999,0
1668386042676,CSE 293,027,119414,Porter; Leonard Emerson,9999,0,9999,0
1668386042676,CSE 293,028,119416,Ramamoorthi; Ravi,9999,0,9999,0
1668386042676,CSE 293,029,119417,Sahoo; Debashis,9999,0,9999,0
1668386042676,CSE 293,030,119420,Saul; Lawrence,9999,0,9999,0
1668386042676,CSE 293,031,119421,Savage; Stefan,9999,0,9999,0
1668386042676,CSE 293,032,119425,Schulze; Jurgen P.,9999,0,9999,0
1668386042676,CSE 293,033,119426,Snoeren; Alex C.,9999,0,9999,0
1668386042676,CSE 293,034,119428,Shang; Jingbo,9999,0,9999,0
1668386042676,CSE 293,035,119430,Stefan; Deian,9999,0,9999,0
1668386042676,CSE 293,036,119431,Su; Hao,9999,0,9999,0
1668386042676,CSE 293,037,119433,Swanson; Steven James,9999,0,9999,0
1668386042676,CSE 293,038,119435,Tullsen; Dean Michael,9999,0,9999,0
1668386042676,CSE 293,039,119483,Voelker; Geoffrey M.,9999,0,9999,0
1668386042676,CSE 293,040,119537,Zhao; Jishen,9999,0,9999,0
1668386042676,CSE 293,041,119538,Zhou; Yuan-Yuan,9999,0,9999,0
1668386042676,CSE 293,042,119539,Gao; Sicun,9999,0,9999,0
1668386042676,CSE 293,043,119540,Weibel; Nadir,9999,0,9999,0
1668386042676,CSE 293,044,119541,Gupta; Rajesh K.,9999,0,9999,0
1668386042676,CSE 293,045,126410,Vaccaro; Kristen Marie,9999,0,9999,0
1668386042676,CSE 293,046,126411,Klemke; Richard,9999,0,9999,0
1668386043099,CSE 294,A00,102459,Voelker; Geoffrey M.,0,0,0,0
1668386043099,CSE 294,B00,111322,Orailoglu; Alex,0,0,0,0
1668386043527,DSE 201,A00,096914,Deutsch; Alin Bernard,30,0,30,0
1668386043959,DSE 210,A00,096915,Dasgupta; Sanjoy,30,0,30,0
1668386044387,DSE 260A,A00,096916,Altintas De Callaf; Ilkay,30,0,30,0
1668386044844,ECE 200,001,103586,Antipa; Nicholas A,9999,0,9999,0
1668386044844,ECE 200,002,103587,Atanasov; Nikolay A.,9999,0,9999,0
1668386044844,ECE 200,003,103588,Bharadia; Dinesh,9999,0,9999,0
1668386044844,ECE 200,004,103589,Cheng; Chung Kuan,9999,0,9999,0
1668386044844,ECE 200,005,103590,Cosman; Pamela C.,9999,0,9999,0
1668386044844,ECE 200,006,103591,Dayeh; Shadi Ahmad,9999,0,9999,0
1668386044844,ECE 200,007,103592,Fainman; Yeshaiahu,9999,0,9999,0
1668386044844,ECE 200,008,103593,Ford; Joseph Earl,9999,0,9999,0
1668386044844,ECE 200,009,103594,Franceschetti; Massimo,9999,0,9999,0
1668386044844,ECE 200,010,103595,Fullerton; Eric E,9999,0,9999,0
1668386044844,ECE 200,011,103596,Galton; Ian A,9999,0,9999,0
1668386044844,ECE 200,012,103597,Gilja; Vikash,9999,0,9999,0
1668386044844,ECE 200,013,103598,Hall; Drew A.,9999,0,9999,0
1668386044844,ECE 200,014,103599,Hsueh; Tzu-Chien,9999,0,9999,0
1668386044844,ECE 200,015,103600,Javidi; Tara,9999,0,9999,0
1668386044844,ECE 200,016,103601,Kahng; Andrew Byun,9999,0,9999,0
1668386044844,ECE 200,017,103602,Kim; Young-Han,9999,0,9999,0
1668386044844,ECE 200,018,103603,Koushanfar; Farinaz,9999,0,9999,0
1668386044844,ECE 200,019,103604,Kuzum; Duygu,9999,0,9999,0
1668386044844,ECE 200,020,103605,Le; Hanh-Phuc,9999,0,9999,0
1668386044844,ECE 200,021,103606,Lin; Bill,9999,0,9999,0
1668386044844,ECE 200,022,103607,Liu; Zhaowei,9998,0,9999,1
1668386044844,ECE 200,023,103608,Lo; Yu-Hwa,9999,0,9999,0
1668386044844,ECE 200,024,103609,Lomakin; Vitaliy,9999,0,9999,0
1668386044844,ECE 200,025,103610,Mercier; Patrick Philip,9999,0,9999,0
1668386044844,ECE 200,026,103611,Meyer; Florian,9999,0,9999,0
1668386044844,ECE 200,027,103612,Milstein; Laurence B.,9999,0,9999,0
1668386044844,ECE 200,028,103613,Mir Arabbaygi; Siavash,9999,0,9999,0
1668386044844,ECE 200,029,103614,Mookherjea; Shayan,9999,0,9999,0
1668386044844,ECE 200,030,103615,Morris; Karcher William,9999,0,9999,0
1668386044844,ECE 200,031,103616,Ng; Tse Nga,9999,0,9999,0
1668386044844,ECE 200,032,103617,Nguyen; Truong Quang,9999,0,9999,0
1668386044844,ECE 200,033,103618,Nomura; Kenji,9999,0,9999,0
1668386044844,ECE 200,034,103619,Orlitsky; Alon,9999,0,9999,0
1668386044844,ECE 200,035,103620,Pal; Piya,9999,0,9999,0
1668386044844,ECE 200,036,103621,Papen; George C.,9999,0,9999,0
1668386044844,ECE 200,037,103622,Radic; Stojan,9999,0,9999,0
1668386044844,ECE 200,038,103623,Rao; Bhaskar D.,9999,0,9999,0
1668386044844,ECE 200,039,103624,Rao; Ramesh R,9999,0,9999,0
1668386044844,ECE 200,040,103625,Rebeiz; Gabriel,9999,0,9999,0
1668386044844,ECE 200,041,103626,Sanford; John R,9999,0,9999,0
1668386044844,ECE 200,042,103627,Siegel; Paul H.,9999,0,9999,0
1668386044844,ECE 200,043,103628,Sievenpiper; Daniel F.,9999,0,9999,0
1668386044844,ECE 200,044,103629,Sworder; David D.,9999,0,9999,0
1668386044844,ECE 200,045,103630,Taur; Yuan,9999,0,9999,0
1668386044844,ECE 200,046,103631,Touri; Behrouz,9999,0,9999,0
1668386044844,ECE 200,047,103632,Trivedi; Mohan M.,9999,0,9999,0
1668386044844,ECE 200,048,103633,Vasconcelos; Nuno,9999,0,9999,0
1668386044844,ECE 200,049,103634,Wang; Xiaolong,9999,0,9999,0
1668386044844,ECE 200,050,103635,Xie; Pengtao,9999,0,9999,0
1668386044844,ECE 200,051,103636,Yip; Michael,9999,0,9999,0
1668386044844,ECE 200,052,103637,Zeger; Kenneth A.,999,0,999,0
1668386044844,ECE 200,053,103638,Zhang; Xinyu,9999,0,9999,0
1668386044844,ECE 200,054,103639,Turakhia; Yatish Girish,9999,0,9999,0
1668386044844,ECE 200,055,103640,Kang; Mingu,9999,0,9999,0
1668386044844,ECE 200,056,103641,Shi; Yuanyuan,9999,0,9999,0
1668386044844,ECE 200,057,103642,Wang; Edward Jay,9999,0,9999,0
1668386044844,ECE 200,058,103643,Zheng; Yang,9999,0,9999,0
1668386045267,ECE 202,A00,103644,Kuzum; Duygu,0,0,0,0
1668386045698,ECE 212BN,A00,103646,Ng; Tse Nga,0,0,0,0
1668386046122,ECE 221,A00,111493,Staff,0,0,0,0
1668386046544,ECE 222B,A00,103647,Lomakin; Vitaliy,0,0,0,0
1668386046970,ECE 230B,A00,103648,Taur; Yuan,0,0,0,0
1668386047396,ECE 238B,A00,103649,Garay; Javier,0,0,0,0
1668386047829,ECE 240B,A00,112900,Fainman; Yeshaiahu,0,0,0,0
1668386048252,ECE 247A,A00,103650,Jokerst; Jesse Vincent,0,0,0,0
1668386048675,ECE 247B,A00,103651,Wang; Joseph,0,0,0,0
1668386049100,ECE 250,A00,103652,Siegel; Paul H.,0,0,0,0
1668386049524,ECE 251A,A00,103654,Rao; Bhaskar D.,0,0,0,0
1668386049945,ECE 257B,A00,103655,Bharadia; Dinesh,0,0,0,0
1668386050369,ECE 258A,A00,103656,Milstein; Laurence B.,0,0,0,0
1668386050794,ECE 260B,A00,103658,Kang; Mingu,0,0,0,0
1668386051220,ECE 264A,A00,103659,Galton; Ian A,0,0,0,0
1668386051647,ECE 265A,A00,103661,Gudem; Prasad S.S.,0,0,0,0
1668386052077,ECE 265D,A00,103662,Gudem; Prasad S.S.,0,0,0,0
1668386052501,ECE 268,A00,103663,Koushanfar; Farinaz,0,0,0,0
1668386052936,ECE 269,A01,103665,Pal; Piya,0,0,0,0
1668386053375,ECE 271B,A00,103666,Vasconcelos; Manuela,0,0,0,0
1668386053800,ECE 276A,A00,103667,Atanasov; Nikolay A.,0,0,0,0
1668386054233,ECE 277,A00,103668,An; Cheolhong,0,0,0,0
1668386054656,ECE 279,A00,117947,Hall; Drew A.,0,0,0,0
1668386055508,ECE 283,A00,103670,Hsueh; Tzu-Chien,0,0,0,0
1668386055931,ECE 284,A00,103671,Turakhia; Yatish Girish,0,0,0,0
1668386056356,ECE 285,A00,103672,Zheng; Yang,0,0,0,0
1668386056356,ECE 285,B00,103673,Sworder; David D.,0,0,0,0
1668386056817,ECE 287,A00,103676,Javidi; Tara,0,0,0,0
1668386057242,MATH 200B,A00,098023,Salehi Golsefidy; Alireza,12,0,15,3
1668386057675,MATH 202B,A00,098024,Rhoades; Brendon Patrick,9,0,15,6
1668386058099,MATH 203B,A00,098025,Oprea; Dragos N.,10,0,15,5
1668386058526,MATH 204B,A00,098026,Sorensen; Claus M,13,0,15,2
1668386058949,MATH 208,A00,098027,Izadi; Elham,7,0,10,3
1668386059381,MATH 209,A00,098028,Pollack; Aaron,10,0,10,0
1668386059806,MATH 211A,A00,112919,Rogalski; Daniel,9,0,10,1
1668386060237,MATH 211B,A00,112920,Seward; Brandon M.,9,0,10,1
1668386060676,MATH 218,A00,098029,Li; Bo,10,0,10,0
1668386061100,MATH 220B,A00,098030,Novak; Jonathan I,11,0,15,4
1668386061534,MATH 221A,A00,098031,Ebenfelt; Peter F,13,0,15,2
1668386061974,MATH 231B,A00,098032,Zlatos; Andrej,12,0,15,3
1668386062406,MATH 240B,A00,098033,Ni; Lei,9,0,15,6
1668386062838,MATH 243,A00,098034,Jekel; David Andrew,10,0,10,0
1668386063262,MATH 245A,A00,098035,Nie; Jiawang,0,0,15,16
1668386063686,MATH 248,A00,098036,Bejenaru; Ioan,10,0,10,0
1668386064112,MATH 250B,A00,098037,Spolaor; Luca,14,0,15,1
1668386064534,MATH 258,A00,098038,Ni; Lei,10,0,10,0
1668386064959,MATH 264B,A00,098041,Rhoades; Brendon Patrick,9,0,15,6
1668386065382,MATH 268,A00,098042,Buss; Samuel R,10,0,10,0
1668386065809,MATH 269,A00,098043,Rhoades; Brendon Patrick,10,0,10,0
1668386066233,MATH 270B,A00,098044,Li; Bo,10,0,15,5
1668386066655,MATH 272B,A00,098045,Holst; Michael J,13,0,15,2
1668386067079,MATH 273A,A00,098046,Tian; Xiaochuan,10,0,15,5
1668386067507,MATH 275,A01,098048,Tian; Xiaochuan,6,0,10,4
1668386067929,MATH 278A,A00,098049,Holst; Michael J,8,0,10,2
1668386068356,MATH 278B,A00,098050,Cloninger; Alexander,10,0,10,0
1668386068787,MATH 278C,A00,098051,Nie; Jiawang,7,0,10,3
1668386069213,MATH 280B,A00,098052,Zheng; Tianyi,8,0,15,7
1668386069647,MATH 281B,A00,098053,Bradic; Jelena,1,0,15,14
1668386070070,MATH 282B,A00,098054,Arias-Castro; Ery,0,0,15,15
1668386070493,MATH 285,A00,098055,Fitzsimmons; Patrick J,0,0,15,17
1668386070920,MATH 287B,A00,098056,Arias-Castro; Ery,2,0,15,13
1668386071353,MATH 288,A00,098057,Agarwal; Pooja,9,0,10,1
1668386071353,MATH 288,B00,098058,Zhang; Danna,8,0,10,2
1668386071353,MATH 288,C00,098059,Williams; Ruth J,9,0,10,1
1668386071776,MATH 290B,A00,098060,Roberts; Justin Deritter,13,0,15,2
1668386072199,MATH 292,A00,098061,Belmont; Eva Kinoshita,10,0,10,0
1668386072622,MATH 295,A00,098062,Suk; Andrew Hoon,48,0,50,2
1668386073053,MATH 296,A00,098063,Novak; Jonathan I,20,0,20,0
1668386073476,MATH 297,001,098064,Gamst; Anthony Collins,9997,0,9999,2
1668386590537,COGS 205,A00,101395,Chiba; Andrea,19,0,20,1
1668386590961,COGS 210B,001,101404,Greene; Deanna Jacquelyn,9998,0,9999,1
1668386590961,COGS 210B,002,101417,Xia; Haijun,9999,0,9999,0
1668386590961,COGS 210B,003,101422,Nitz; Douglas A.,9999,0,9999,0
1668386590961,COGS 210B,004,101423,Hollan; James D.,9998,0,9999,1
1668386590961,COGS 210B,005,101424,Deak; Gedeon O.,9998,0,9999,1
1668386590961,COGS 210B,006,101425,Rossano; Federico,9999,0,9999,0
1668386591389,COGS 211B,A00,101427,Coulson; Seana M,9996,0,9999,3
1668386591822,COGS 220,A00,101428,Hollan; James D.,0,0,25,25
1668386592245,COGS 229,A00,101429,Dow; Steven P,18,0,25,7
1668386592672,COGS 230,A00,101430,Klemmer; Scott R,11,0,17,6
1668386593094,COGS 234,A00,101431,Xia; Haijun,1,0,25,24
1668386593521,COGS 260,A00,101432,Kiyonaga; Anastasia,21,0,25,4
1668386593521,COGS 260,B00,101433,Kirsh; David Joel,15,0,25,10
1668386593944,CSE 202,A00,102371,Impagliazzo; Russell,0,0,0,0
1668386594370,CSE 203B,A01,102373,Cheng; Chung Kuan,0,0,0,0
1668386594799,CSE 208,A00,102374,Micciancio; Daniele,0,0,0,0
1668386595225,CSE 209A,A00,112895,Impagliazzo; Russell,0,0,15,15
1668386595655,CSE 209B,A00,108005,Bellare; Mihir,0,0,0,0
1668386596079,CSE 210,A00,113163,Coblenz; Michael J,0,0,0,0
1668386596502,CSE 219,A00,106111,Dow; Steven P,0,0,20,20
1668386596936,CSE 221,A00,102376,Voelker; Geoffrey M.,0,0,0,0
1668386597364,CSE 224,A01,102378,Porter; George M,0,0,0,0
1668386597785,CSE 229A,A00,102379,Savage; Stefan,0,0,0,0
1668386598209,CSE 229C,A00,102380,Munyaka; Imani N. S.,0,0,0,0
1668386598632,CSE 232B,A00,102382,Deutsch; Alin Bernard,0,0,0,0
1668386599066,CSE 234,A01,112904,Kumar; Arun Kumar,0,0,0,0
1668386599490,CSE 237A,A00,102383,Rosing; Tajana Simunic,0,0,0,0
1668386599916,CSE 239A,A00,102384,Deutsch; Alin Bernard,0,0,0,0
1668386600340,CSE 239B,A00,102385,Polikarpova; Nadezhda,0,0,0,0
1668386600764,CSE 240A,A00,102386,Pannuto; Patrick William,0,0,0,0
1668386601196,CSE 240B,A00,102387,Zhao; Jishen,0,0,0,0
1668386601621,CSE 241A,A00,106406,Kang; Mingu,0,0,0,0
1668386602044,CSE 249B,A00,102388,Kahng; Andrew Byun,0,0,8,8
1668386602470,CSE 251B,A01,102392,Cottrell; Garrison W,0,0,0,0
1668386602470,CSE 251B,A02,102393,Cottrell; Garrison W,0,0,0,0
1668386602905,CSE 252B,A00,102394,Ochoa; Benjamin Lawrence,0,0,0,0
1668386603329,CSE 257,A01,102396,Gao; Sicun,0,0,0,0
1668386603751,CSE 272,A00,102397,Li; Tzumao,0,0,0,0
1668386604175,CSE 274,A00,111323,Chern; Albert Ren-Haur,0,0,0,0
1668386604599,CSE 282,A00,102398,Pevzner; Pavel Arkadjevich,0,0,0,0
1668386605026,CSE 284,A00,114175,Gymrek; Melissa Ann,0,0,0,0
1668386605451,CSE 290,A00,102399,Chandraker; Manmohan Krishna,0,0,0,0
1668386605451,CSE 290,B00,102400,Vaccaro; Kristen Marie,0,0,25,25
1668386605451,CSE 290,C00,102414,Pannuto; Patrick William,0,0,25,25
1668386605451,CSE 290,D00,102427,Pevzner; Pavel Arkadjevich,0,0,0,0
1668386605451,CSE 290,E00,102429,Zhao; Jishen,0,0,0,0
1668386605451,CSE 290,F00,102436,Tullsen; Dean Michael,0,0,0,0
1668386605451,CSE 290,G00,102440,Christensen; Henrik I,0,0,20,20
1668386605877,CSE 291,A00,102443,Su; Hao,0,0,0,0
1668386605877,CSE 291,B00,102448,Polikarpova; Nadezhda,0,0,0,0
1668386605877,CSE 291,C00,102453,Vaccaro; Kristen Marie,0,0,0,0
1668386605877,CSE 291,D00,111343,Savage; Stefan,0,0,0,0
1668386605877,CSE 291,E00,116474,Claffy; Kimberly Claire,0,0,0,0
1668386605877,CSE 291,F00,116479,Pasquale; Joseph,0,0,0,0
1668386606303,CSE 293,001,119111,Bafna; Vineet,9999,0,9999,0
1668386606303,CSE 293,002,119118,Bellare; Mihir,9999,0,9999,0
1668386606303,CSE 293,003,119122,Berg-Kirkpatrick; Taylor D,9999,0,9999,0
1668386606303,CSE 293,004,119135,Christensen; Henrik I,9999,0,9999,0
1668386606303,CSE 293,005,119142,Cottrell; Garrison W,9999,0,9999,0
1668386606303,CSE 293,006,119146,Deutsch; Alin Bernard,9999,0,9999,0
1668386606303,CSE 293,007,119159,Esmaeilzadeh; Hadi,9999,0,9999,0
1668386606303,CSE 293,008,119166,Freund; Yoav,9999,0,9999,0
1668386606303,CSE 293,009,119170,Griswold; William G.,9999,0,9999,0
1668386606303,CSE 293,010,119183,Gymrek; Melissa Ann,9999,0,9999,0
1668386606303,CSE 293,011,119190,Heninger; Nadia A,9999,0,9999,0
1668386606303,CSE 293,012,119230,Impagliazzo; Russell,9999,0,9999,0
1668386606303,CSE 293,013,119232,Jhala; Ranjit,9999,0,9999,0
1668386606303,CSE 293,014,119233,Kahng; Andrew Byun,9999,0,9999,0
1668386606303,CSE 293,015,119298,Kane; Daniel Mertz,9999,0,9999,0
1668386606303,CSE 293,016,119299,Kriegman; David J,9999,0,9999,0
1668386606303,CSE 293,017,119300,Kumar; Arun Kumar,9999,0,9999,0
1668386606303,CSE 293,018,119301,Lerner; Sorin,9999,0,9999,0
1668386606303,CSE 293,019,119302,Lovett; Shachar,9999,0,9999,0
1668386606303,CSE 293,020,119303,McAuley; Julian John,9999,0,9999,0
1668386606303,CSE 293,021,119304,Micciancio; Daniele,9999,0,9999,0
1668386606303,CSE 293,022,119367,Orailoglu; Alex,9999,0,9999,0
1668386606303,CSE 293,023,119382,Paturi; Ramamohan,9999,0,9999,0
1668386606303,CSE 293,024,119404,Polikarpova; Nadezhda,9999,0,9999,0
1668386606303,CSE 293,025,119406,Politz; Joseph Gibbs,9999,0,9999,0
1668386606303,CSE 293,026,119411,Porter; George M,9999,0,9999,0
1668386606303,CSE 293,027,119414,Porter; Leonard Emerson,9999,0,9999,0
1668386606303,CSE 293,028,119416,Ramamoorthi; Ravi,9999,0,9999,0
1668386606303,CSE 293,029,119417,Sahoo; Debashis,9999,0,9999,0
1668386606303,CSE 293,030,119420,Saul; Lawrence,9999,0,9999,0
1668386606303,CSE 293,031,119421,Savage; Stefan,9999,0,9999,0
1668386606303,CSE 293,032,119425,Schulze; Jurgen P.,9999,0,9999,0
1668386606303,CSE 293,033,119426,Snoeren; Alex C.,9999,0,9999,0
1668386606303,CSE 293,034,119428,Shang; Jingbo,9999,0,9999,0
1668386606303,CSE 293,035,119430,Stefan; Deian,9999,0,9999,0
1668386606303,CSE 293,036,119431,Su; Hao,9999,0,9999,0
1668386606303,CSE 293,037,119433,Swanson; Steven James,9999,0,9999,0
1668386606303,CSE 293,038,119435,Tullsen; Dean Michael,9999,0,9999,0
1668386606303,CSE 293,039,119483,Voelker; Geoffrey M.,9999,0,9999,0
1668386606303,CSE 293,040,119537,Zhao; Jishen,9999,0,9999,0
1668386606303,CSE 293,041,119538,Zhou; Yuan-Yuan,9999,0,9999,0
1668386606303,CSE 293,042,119539,Gao; Sicun,9999,0,9999,0
1668386606303,CSE 293,043,119540,Weibel; Nadir,9999,0,9999,0
1668386606303,CSE 293,044,119541,Gupta; Rajesh K.,9999,0,9999,0
1668386606303,CSE 293,045,126410,Vaccaro; Kristen Marie,9999,0,9999,0
1668386606303,CSE 293,046,126411,Klemke; Richard,9999,0,9999,0
1668386606729,CSE 294,A00,102459,Voelker; Geoffrey M.,0,0,0,0
1668386606729,CSE 294,B00,111322,Orailoglu; Alex,0,0,0,0
1668386607155,DSE 201,A00,096914,Deutsch; Alin Bernard,30,0,30,0
1668386607599,DSE 210,A00,096915,Dasgupta; Sanjoy,30,0,30,0
1668386608023,DSE 260A,A00,096916,Altintas De Callaf; Ilkay,30,0,30,0
1668386608459,ECE 200,001,103586,Antipa; Nicholas A,9999,0,9999,0
1668386608459,ECE 200,002,103587,Atanasov; Nikolay A.,9999,0,9999,0
1668386608459,ECE 200,003,103588,Bharadia; Dinesh,9999,0,9999,0
1668386608459,ECE 200,004,103589,Cheng; Chung Kuan,9999,0,9999,0
1668386608459,ECE 200,005,103590,Cosman; Pamela C.,9999,0,9999,0
1668386608459,ECE 200,006,103591,Dayeh; Shadi Ahmad,9999,0,9999,0
1668386608459,ECE 200,007,103592,Fainman; Yeshaiahu,9999,0,9999,0
1668386608459,ECE 200,008,103593,Ford; Joseph Earl,9999,0,9999,0
1668386608459,ECE 200,009,103594,Franceschetti; Massimo,9999,0,9999,0
1668386608459,ECE 200,010,103595,Fullerton; Eric E,9999,0,9999,0
1668386608459,ECE 200,011,103596,Galton; Ian A,9999,0,9999,0
1668386608459,ECE 200,012,103597,Gilja; Vikash,9999,0,9999,0
1668386608459,ECE 200,013,103598,Hall; Drew A.,9999,0,9999,0
1668386608459,ECE 200,014,103599,Hsueh; Tzu-Chien,9999,0,9999,0
1668386608459,ECE 200,015,103600,Javidi; Tara,9999,0,9999,0
1668386608459,ECE 200,016,103601,Kahng; Andrew Byun,9999,0,9999,0
1668386608459,ECE 200,017,103602,Kim; Young-Han,9999,0,9999,0
1668386608459,ECE 200,018,103603,Koushanfar; Farinaz,9999,0,9999,0
1668386608459,ECE 200,019,103604,Kuzum; Duygu,9999,0,9999,0
1668386608459,ECE 200,020,103605,Le; Hanh-Phuc,9999,0,9999,0
1668386608459,ECE 200,021,103606,Lin; Bill,9999,0,9999,0
1668386608459,ECE 200,022,103607,Liu; Zhaowei,9998,0,9999,1
1668386608459,ECE 200,023,103608,Lo; Yu-Hwa,9999,0,9999,0
1668386608459,ECE 200,024,103609,Lomakin; Vitaliy,9999,0,9999,0
1668386608459,ECE 200,025,103610,Mercier; Patrick Philip,9999,0,9999,0
1668386608459,ECE 200,026,103611,Meyer; Florian,9999,0,9999,0
1668386608459,ECE 200,027,103612,Milstein; Laurence B.,9999,0,9999,0
1668386608459,ECE 200,028,103613,Mir Arabbaygi; Siavash,9999,0,9999,0
1668386608459,ECE 200,029,103614,Mookherjea; Shayan,9999,0,9999,0
1668386608459,ECE 200,030,103615,Morris; Karcher William,9999,0,9999,0
1668386608459,ECE 200,031,103616,Ng; Tse Nga,9999,0,9999,0
1668386608459,ECE 200,032,103617,Nguyen; Truong Quang,9999,0,9999,0
1668386608459,ECE 200,033,103618,Nomura; Kenji,9999,0,9999,0
1668386608459,ECE 200,034,103619,Orlitsky; Alon,9999,0,9999,0
1668386608459,ECE 200,035,103620,Pal; Piya,9999,0,9999,0
1668386608459,ECE 200,036,103621,Papen; George C.,9999,0,9999,0
1668386608459,ECE 200,037,103622,Radic; Stojan,9999,0,9999,0
1668386608459,ECE 200,038,103623,Rao; Bhaskar D.,9999,0,9999,0
1668386608459,ECE 200,039,103624,Rao; Ramesh R,9999,0,9999,0
1668386608459,ECE 200,040,103625,Rebeiz; Gabriel,9999,0,9999,0
1668386608459,ECE 200,041,103626,Sanford; John R,9999,0,9999,0
1668386608459,ECE 200,042,103627,Siegel; Paul H.,9999,0,9999,0
1668386608459,ECE 200,043,103628,Sievenpiper; Daniel F.,9999,0,9999,0
1668386608459,ECE 200,044,103629,Sworder; David D.,9999,0,9999,0
1668386608459,ECE 200,045,103630,Taur; Yuan,9999,0,9999,0
1668386608459,ECE 200,046,103631,Touri; Behrouz,9999,0,9999,0
1668386608459,ECE 200,047,103632,Trivedi; Mohan M.,9999,0,9999,0
1668386608459,ECE 200,048,103633,Vasconcelos; Nuno,9999,0,9999,0
1668386608459,ECE 200,049,103634,Wang; Xiaolong,9999,0,9999,0
1668386608459,ECE 200,050,103635,Xie; Pengtao,9999,0,9999,0
1668386608459,ECE 200,051,103636,Yip; Michael,9999,0,9999,0
1668386608459,ECE 200,052,103637,Zeger; Kenneth A.,999,0,999,0
1668386608459,ECE 200,053,103638,Zhang; Xinyu,9999,0,9999,0
1668386608459,ECE 200,054,103639,Turakhia; Yatish Girish,9999,0,9999,0
1668386608459,ECE 200,055,103640,Kang; Mingu,9999,0,9999,0
1668386608459,ECE 200,056,103641,Shi; Yuanyuan,9999,0,9999,0
1668386608459,ECE 200,057,103642,Wang; Edward Jay,9999,0,9999,0
1668386608459,ECE 200,058,103643,Zheng; Yang,9999,0,9999,0
1668386608883,ECE 202,A00,103644,Kuzum; Duygu,0,0,0,0
1668386609306,ECE 212BN,A00,103646,Ng; Tse Nga,0,0,0,0
1668386609729,ECE 221,A00,111493,Staff,0,0,0,0
1668386610154,ECE 222B,A00,103647,Lomakin; Vitaliy,0,0,0,0
1668386610586,ECE 230B,A00,103648,Taur; Yuan,0,0,0,0
1668386611011,ECE 238B,A00,103649,Garay; Javier,0,0,0,0
1668386611438,ECE 240B,A00,112900,Fainman; Yeshaiahu,0,0,0,0
1668386611863,ECE 247A,A00,103650,Jokerst; Jesse Vincent,0,0,0,0
1668386612289,ECE 247B,A00,103651,Wang; Joseph,0,0,0,0
1668386612725,ECE 250,A00,103652,Siegel; Paul H.,0,0,0,0
1668386613148,ECE 251A,A00,103654,Rao; Bhaskar D.,0,0,0,0
1668386613573,ECE 257B,A00,103655,Bharadia; Dinesh,0,0,0,0
1668386614000,ECE 258A,A00,103656,Milstein; Laurence B.,0,0,0,0
1668386614426,ECE 260B,A00,103658,Kang; Mingu,0,0,0,0
1668386614851,ECE 264A,A00,103659,Galton; Ian A,0,0,0,0
1668386615274,ECE 265A,A00,103661,Gudem; Prasad S.S.,0,0,0,0
1668386615697,ECE 265D,A00,103662,Gudem; Prasad S.S.,0,0,0,0
1668386616122,ECE 268,A00,103663,Koushanfar; Farinaz,0,0,0,0
1668386616547,ECE 269,A01,103665,Pal; Piya,0,0,0,0
1668386616981,ECE 271B,A00,103666,Vasconcelos; Manuela,0,0,0,0
1668386617412,ECE 276A,A00,103667,Atanasov; Nikolay A.,0,0,0,0
1668386617835,ECE 277,A00,103668,An; Cheolhong,0,0,0,0
1668386618260,ECE 279,A00,117947,Hall; Drew A.,0,0,0,0
1668386619194,ECE 283,A00,103670,Hsueh; Tzu-Chien,0,0,0,0
1668386619623,ECE 284,A00,103671,Turakhia; Yatish Girish,0,0,0,0
1668386620051,ECE 285,A00,103672,Zheng; Yang,0,0,0,0
1668386620051,ECE 285,B00,103673,Sworder; David D.,0,0,0,0
1668386620475,ECE 287,A00,103676,Javidi; Tara,0,0,0,0
1668386620908,MATH 200B,A00,098023,Salehi Golsefidy; Alireza,12,0,15,3
1668386621351,MATH 202B,A00,098024,Rhoades; Brendon Patrick,9,0,15,6
1668386621783,MATH 203B,A00,098025,Oprea; Dragos N.,10,0,15,5
1668386622209,MATH 204B,A00,098026,Sorensen; Claus M,13,0,15,2
1668386622634,MATH 208,A00,098027,Izadi; Elham,7,0,10,3
1668386623059,MATH 209,A00,098028,Pollack; Aaron,10,0,10,0
1668386623486,MATH 211A,A00,112919,Rogalski; Daniel,9,0,10,1
1668386623908,MATH 211B,A00,112920,Seward; Brandon M.,9,0,10,1
1668386624331,MATH 218,A00,098029,Li; Bo,10,0,10,0
1668386624756,MATH 220B,A00,098030,Novak; Jonathan I,11,0,15,4
1668386625179,MATH 221A,A00,098031,Ebenfelt; Peter F,13,0,15,2
1668386625609,MATH 231B,A00,098032,Zlatos; Andrej,12,0,15,3
1668386626034,MATH 240B,A00,098033,Ni; Lei,9,0,15,6
1668386626459,MATH 243,A00,098034,Jekel; David Andrew,10,0,10,0
1668386626882,MATH 245A,A00,098035,Nie; Jiawang,0,0,15,16
1668386627309,MATH 248,A00,098036,Bejenaru; Ioan,10,0,10,0
1668386627732,MATH 250B,A00,098037,Spolaor; Luca,14,0,15,1
1668386628161,MATH 258,A00,098038,Ni; Lei,10,0,10,0
1668386628584,MATH 264B,A00,098041,Rhoades; Brendon Patrick,9,0,15,6
1668386629010,MATH 268,A00,098042,Buss; Samuel R,10,0,10,0
1668386629436,MATH 269,A00,098043,Rhoades; Brendon Patrick,10,0,10,0
1668386629857,MATH 270B,A00,098044,Li; Bo,10,0,15,5
1668386630291,MATH 272B,A00,098045,Holst; Michael J,13,0,15,2
1668386630715,MATH 273A,A00,098046,Tian; Xiaochuan,10,0,15,5
1668386631144,MATH 275,A01,098048,Tian; Xiaochuan,6,0,10,4
1668386631567,MATH 278A,A00,098049,Holst; Michael J,8,0,10,2
1668386632003,MATH 278B,A00,098050,Cloninger; Alexander,10,0,10,0
1668386632424,MATH 278C,A00,098051,Nie; Jiawang,7,0,10,3
1668386632849,MATH 280B,A00,098052,Zheng; Tianyi,8,0,15,7
1668386633275,MATH 281B,A00,098053,Bradic; Jelena,0,0,15,15
1668386633702,MATH 282B,A00,098054,Arias-Castro; Ery,0,0,15,15
1668386634124,MATH 285,A00,098055,Fitzsimmons; Patrick J,0,0,15,17
1668386634548,MATH 287B,A00,098056,Arias-Castro; Ery,2,0,15,13
1668386634972,MATH 288,A00,098057,Agarwal; Pooja,9,0,10,1
1668386634972,MATH 288,B00,098058,Zhang; Danna,8,0,10,2
1668386634972,MATH 288,C00,098059,Williams; Ruth J,9,0,10,1
1668386635395,MATH 290B,A00,098060,Roberts; Justin Deritter,13,0,15,2
1668386635820,MATH 292,A00,098061,Belmont; Eva Kinoshita,10,0,10,0
1668386636245,MATH 295,A00,098062,Suk; Andrew Hoon,48,0,50,2
1668386636669,MATH 296,A00,098063,Novak; Jonathan I,20,0,20,0
1668386637095,MATH 297,001,098064,Gamst; Anthony Collins,9997,0,9999,2
1668387138092,COGS 205,A00,101395,Chiba; Andrea,19,0,20,1
1668387138528,COGS 210B,001,101404,Greene; Deanna Jacquelyn,9998,0,9999,1
1668387138528,COGS 210B,002,101417,Xia; Haijun,9999,0,9999,0
1668387138528,COGS 210B,003,101422,Nitz; Douglas A.,9999,0,9999,0
1668387138528,COGS 210B,004,101423,Hollan; James D.,9998,0,9999,1
1668387138528,COGS 210B,005,101424,Deak; Gedeon O.,9998,0,9999,1
1668387138528,COGS 210B,006,101425,Rossano; Federico,9999,0,9999,0
1668387138953,COGS 211B,A00,101427,Coulson; Seana M,9996,0,9999,3
1668387139375,COGS 220,A00,101428,Hollan; James D.,0,0,25,25
1668387139801,COGS 229,A00,101429,Dow; Steven P,18,0,25,7
1668387140333,COGS 230,A00,101430,Klemmer; Scott R,11,0,17,6
1668387140762,COGS 234,A00,101431,Xia; Haijun,1,0,25,24
1668387141195,COGS 260,A00,101432,Kiyonaga; Anastasia,21,0,25,4
1668387141195,COGS 260,B00,101433,Kirsh; David Joel,15,0,25,10
1668387141620,CSE 202,A00,102371,Impagliazzo; Russell,0,0,0,0
1668387142046,CSE 203B,A01,102373,Cheng; Chung Kuan,0,0,0,0
1668387142471,CSE 208,A00,102374,Micciancio; Daniele,0,0,0,0
1668387142899,CSE 209A,A00,112895,Impagliazzo; Russell,0,0,15,15
1668387143325,CSE 209B,A00,108005,Bellare; Mihir,0,0,0,0
1668387143748,CSE 210,A00,113163,Coblenz; Michael J,0,0,0,0
1668387144171,CSE 219,A00,106111,Dow; Steven P,0,0,20,20
1668387144598,CSE 221,A00,102376,Voelker; Geoffrey M.,0,0,0,0
1668387145022,CSE 224,A01,102378,Porter; George M,0,0,0,0
1668387145447,CSE 229A,A00,102379,Savage; Stefan,0,0,0,0
1668387145871,CSE 229C,A00,102380,Munyaka; Imani N. S.,0,0,0,0
1668387146297,CSE 232B,A00,102382,Deutsch; Alin Bernard,0,0,0,0
1668387146721,CSE 234,A01,112904,Kumar; Arun Kumar,0,0,0,0
1668387147144,CSE 237A,A00,102383,Rosing; Tajana Simunic,0,0,0,0
1668387147567,CSE 239A,A00,102384,Deutsch; Alin Bernard,0,0,0,0
1668387147991,CSE 239B,A00,102385,Polikarpova; Nadezhda,0,0,0,0
1668387148414,CSE 240A,A00,102386,Pannuto; Patrick William,0,0,0,0
1668387148841,CSE 240B,A00,102387,Zhao; Jishen,0,0,0,0
1668387149265,CSE 241A,A00,106406,Kang; Mingu,0,0,0,0
1668387149688,CSE 249B,A00,102388,Kahng; Andrew Byun,0,0,8,8
1668387150111,CSE 251B,A01,102392,Cottrell; Garrison W,0,0,0,0
1668387150111,CSE 251B,A02,102393,Cottrell; Garrison W,0,0,0,0
1668387150537,CSE 252B,A00,102394,Ochoa; Benjamin Lawrence,0,0,0,0
1668387150962,CSE 257,A01,102396,Gao; Sicun,0,0,0,0
1668387151388,CSE 272,A00,102397,Li; Tzumao,0,0,0,0
1668387151813,CSE 274,A00,111323,Chern; Albert Ren-Haur,0,0,0,0
1668387152236,CSE 282,A00,102398,Pevzner; Pavel Arkadjevich,0,0,0,0
1668387152666,CSE 284,A00,114175,Gymrek; Melissa Ann,0,0,0,0
1668387153103,CSE 290,A00,102399,Chandraker; Manmohan Krishna,0,0,0,0
1668387153103,CSE 290,B00,102400,Vaccaro; Kristen Marie,0,0,25,25
1668387153103,CSE 290,C00,102414,Pannuto; Patrick William,0,0,25,25
1668387153103,CSE 290,D00,102427,Pevzner; Pavel Arkadjevich,0,0,0,0
1668387153103,CSE 290,E00,102429,Zhao; Jishen,0,0,0,0
1668387153103,CSE 290,F00,102436,Tullsen; Dean Michael,0,0,0,0
1668387153103,CSE 290,G00,102440,Christensen; Henrik I,0,0,20,20
1668387153539,CSE 291,A00,102443,Su; Hao,0,0,0,0
1668387153539,CSE 291,B00,102448,Polikarpova; Nadezhda,0,0,0,0
1668387153539,CSE 291,C00,102453,Vaccaro; Kristen Marie,0,0,0,0
1668387153539,CSE 291,D00,111343,Savage; Stefan,0,0,0,0
1668387153539,CSE 291,E00,116474,Claffy; Kimberly Claire,0,0,0,0
1668387153539,CSE 291,F00,116479,Pasquale; Joseph,0,0,0,0
1668387153978,CSE 293,001,119111,Bafna; Vineet,9999,0,9999,0
1668387153978,CSE 293,002,119118,Bellare; Mihir,9999,0,9999,0
1668387153978,CSE 293,003,119122,Berg-Kirkpatrick; Taylor D,9999,0,9999,0
1668387153978,CSE 293,004,119135,Christensen; Henrik I,9999,0,9999,0
1668387153978,CSE 293,005,119142,Cottrell; Garrison W,9999,0,9999,0
1668387153978,CSE 293,006,119146,Deutsch; Alin Bernard,9999,0,9999,0
1668387153978,CSE 293,007,119159,Esmaeilzadeh; Hadi,9999,0,9999,0
1668387153978,CSE 293,008,119166,Freund; Yoav,9999,0,9999,0
1668387153978,CSE 293,009,119170,Griswold; William G.,9999,0,9999,0
1668387153978,CSE 293,010,119183,Gymrek; Melissa Ann,9999,0,9999,0
1668387153978,CSE 293,011,119190,Heninger; Nadia A,9999,0,9999,0
1668387153978,CSE 293,012,119230,Impagliazzo; Russell,9999,0,9999,0
1668387153978,CSE 293,013,119232,Jhala; Ranjit,9999,0,9999,0
1668387153978,CSE 293,014,119233,Kahng; Andrew Byun,9999,0,9999,0
1668387153978,CSE 293,015,119298,Kane; Daniel Mertz,9999,0,9999,0
1668387153978,CSE 293,016,119299,Kriegman; David J,9999,0,9999,0
1668387153978,CSE 293,017,119300,Kumar; Arun Kumar,9999,0,9999,0
1668387153978,CSE 293,018,119301,Lerner; Sorin,9999,0,9999,0
1668387153978,CSE 293,019,119302,Lovett; Shachar,9999,0,9999,0
1668387153978,CSE 293,020,119303,McAuley; Julian John,9999,0,9999,0
1668387153978,CSE 293,021,119304,Micciancio; Daniele,9999,0,9999,0
1668387153978,CSE 293,022,119367,Orailoglu; Alex,9999,0,9999,0
1668387153978,CSE 293,023,119382,Paturi; Ramamohan,9999,0,9999,0
1668387153978,CSE 293,024,119404,Polikarpova; Nadezhda,9999,0,9999,0
1668387153978,CSE 293,025,119406,Politz; Joseph Gibbs,9999,0,9999,0
1668387153978,CSE 293,026,119411,Porter; George M,9999,0,9999,0
1668387153978,CSE 293,027,119414,Porter; Leonard Emerson,9999,0,9999,0
1668387153978,CSE 293,028,119416,Ramamoorthi; Ravi,9999,0,9999,0
1668387153978,CSE 293,029,119417,Sahoo; Debashis,9999,0,9999,0
1668387153978,CSE 293,030,119420,Saul; Lawrence,9999,0,9999,0
1668387153978,CSE 293,031,119421,Savage; Stefan,9999,0,9999,0
1668387153978,CSE 293,032,119425,Schulze; Jurgen P.,9999,0,9999,0
1668387153978,CSE 293,033,119426,Snoeren; Alex C.,9999,0,9999,0
1668387153978,CSE 293,034,119428,Shang; Jingbo,9999,0,9999,0
1668387153978,CSE 293,035,119430,Stefan; Deian,9999,0,9999,0
1668387153978,CSE 293,036,119431,Su; Hao,9999,0,9999,0
1668387153978,CSE 293,037,119433,Swanson; Steven James,9999,0,9999,0
1668387153978,CSE 293,038,119435,Tullsen; Dean Michael,9999,0,9999,0
1668387153978,CSE 293,039,119483,Voelker; Geoffrey M.,9999,0,9999,0
1668387153978,CSE 293,040,119537,Zhao; Jishen,9999,0,9999,0
1668387153978,CSE 293,041,119538,Zhou; Yuan-Yuan,9999,0,9999,0
1668387153978,CSE 293,042,119539,Gao; Sicun,9999,0,9999,0
1668387153978,CSE 293,043,119540,Weibel; Nadir,9999,0,9999,0
1668387153978,CSE 293,044,119541,Gupta; Rajesh K.,9999,0,9999,0
1668387153978,CSE 293,045,126410,Vaccaro; Kristen Marie,9999,0,9999,0
1668387153978,CSE 293,046,126411,Klemke; Richard,9999,0,9999,0
1668387154402,CSE 294,A00,102459,Voelker; Geoffrey M.,0,0,0,0
1668387154402,CSE 294,B00,111322,Orailoglu; Alex,0,0,0,0
1668387154827,DSE 201,A00,096914,Deutsch; Alin Bernard,30,0,30,0
1668387155253,DSE 210,A00,096915,Dasgupta; Sanjoy,30,0,30,0
1668387155680,DSE 260A,A00,096916,Altintas De Callaf; Ilkay,30,0,30,0
1668387156105,ECE 200,001,103586,Antipa; Nicholas A,9999,0,9999,0
1668387156105,ECE 200,002,103587,Atanasov; Nikolay A.,9999,0,9999,0
1668387156105,ECE 200,003,103588,Bharadia; Dinesh,9999,0,9999,0
1668387156105,ECE 200,004,103589,Cheng; Chung Kuan,9999,0,9999,0
1668387156105,ECE 200,005,103590,Cosman; Pamela C.,9999,0,9999,0
1668387156105,ECE 200,006,103591,Dayeh; Shadi Ahmad,9999,0,9999,0
1668387156105,ECE 200,007,103592,Fainman; Yeshaiahu,9999,0,9999,0
1668387156105,ECE 200,008,103593,Ford; Joseph Earl,9999,0,9999,0
1668387156105,ECE 200,009,103594,Franceschetti; Massimo,9999,0,9999,0
1668387156105,ECE 200,010,103595,Fullerton; Eric E,9999,0,9999,0
1668387156105,ECE 200,011,103596,Galton; Ian A,9999,0,9999,0
1668387156105,ECE 200,012,103597,Gilja; Vikash,9999,0,9999,0
1668387156105,ECE 200,013,103598,Hall; Drew A.,9999,0,9999,0
1668387156105,ECE 200,014,103599,Hsueh; Tzu-Chien,9999,0,9999,0
1668387156105,ECE 200,015,103600,Javidi; Tara,9999,0,9999,0
1668387156105,ECE 200,016,103601,Kahng; Andrew Byun,9999,0,9999,0
1668387156105,ECE 200,017,103602,Kim; Young-Han,9999,0,9999,0
1668387156105,ECE 200,018,103603,Koushanfar; Farinaz,9999,0,9999,0
1668387156105,ECE 200,019,103604,Kuzum; Duygu,9999,0,9999,0
1668387156105,ECE 200,020,103605,Le; Hanh-Phuc,9999,0,9999,0
1668387156105,ECE 200,021,103606,Lin; Bill,9999,0,9999,0
1668387156105,ECE 200,022,103607,Liu; Zhaowei,9998,0,9999,1
1668387156105,ECE 200,023,103608,Lo; Yu-Hwa,9999,0,9999,0
1668387156105,ECE 200,024,103609,Lomakin; Vitaliy,9999,0,9999,0
1668387156105,ECE 200,025,103610,Mercier; Patrick Philip,9999,0,9999,0
1668387156105,ECE 200,026,103611,Meyer; Florian,9999,0,9999,0
1668387156105,ECE 200,027,103612,Milstein; Laurence B.,9999,0,9999,0
1668387156105,ECE 200,028,103613,Mir Arabbaygi; Siavash,9999,0,9999,0
1668387156105,ECE 200,029,103614,Mookherjea; Shayan,9999,0,9999,0
1668387156105,ECE 200,030,103615,Morris; Karcher William,9999,0,9999,0
1668387156105,ECE 200,031,103616,Ng; Tse Nga,9999,0,9999,0
1668387156105,ECE 200,032,103617,Nguyen; Truong Quang,9999,0,9999,0
1668387156105,ECE 200,033,103618,Nomura; Kenji,9999,0,9999,0
1668387156105,ECE 200,034,103619,Orlitsky; Alon,9999,0,9999,0
1668387156105,ECE 200,035,103620,Pal; Piya,9999,0,9999,0
1668387156105,ECE 200,036,103621,Papen; George C.,9999,0,9999,0
1668387156105,ECE 200,037,103622,Radic; Stojan,9999,0,9999,0
1668387156105,ECE 200,038,103623,Rao; Bhaskar D.,9999,0,9999,0
1668387156105,ECE 200,039,103624,Rao; Ramesh R,9999,0,9999,0
1668387156105,ECE 200,040,103625,Rebeiz; Gabriel,9999,0,9999,0
1668387156105,ECE 200,041,103626,Sanford; John R,9999,0,9999,0
1668387156105,ECE 200,042,103627,Siegel; Paul H.,9999,0,9999,0
1668387156105,ECE 200,043,103628,Sievenpiper; Daniel F.,9999,0,9999,0
1668387156105,ECE 200,044,103629,Sworder; David D.,9999,0,9999,0
1668387156105,ECE 200,045,103630,Taur; Yuan,9999,0,9999,0
1668387156105,ECE 200,046,103631,Touri; Behrouz,9999,0,9999,0
1668387156105,ECE 200,047,103632,Trivedi; Mohan M.,9999,0,9999,0
1668387156105,ECE 200,048,103633,Vasconcelos; Nuno,9999,0,9999,0
1668387156105,ECE 200,049,103634,Wang; Xiaolong,9999,0,9999,0
1668387156105,ECE 200,050,103635,Xie; Pengtao,9999,0,9999,0
1668387156105,ECE 200,051,103636,Yip; Michael,9999,0,9999,0
1668387156105,ECE 200,052,103637,Zeger; Kenneth A.,999,0,999,0
1668387156105,ECE 200,053,103638,Zhang; Xinyu,9999,0,9999,0
1668387156105,ECE 200,054,103639,Turakhia; Yatish Girish,9999,0,9999,0
1668387156105,ECE 200,055,103640,Kang; Mingu,9999,0,9999,0
1668387156105,ECE 200,056,103641,Shi; Yuanyuan,9999,0,9999,0
1668387156105,ECE 200,057,103642,Wang; Edward Jay,9999,0,9999,0
1668387156105,ECE 200,058,103643,Zheng; Yang,9999,0,9999,0
1668387156532,ECE 202,A00,103644,Kuzum; Duygu,0,0,0,0
1668387156965,ECE 212BN,A00,103646,Ng; Tse Nga,0,0,0,0
1668387157400,ECE 221,A00,111493,Staff,0,0,0,0
1668387157827,ECE 222B,A00,103647,Lomakin; Vitaliy,0,0,0,0
1668387158252,ECE 230B,A00,103648,Taur; Yuan,0,0,0,0
1668387158678,ECE 238B,A00,103649,Garay; Javier,0,0,0,0
1668387159104,ECE 240B,A00,112900,Fainman; Yeshaiahu,0,0,0,0
1668387159531,ECE 247A,A00,103650,Jokerst; Jesse Vincent,0,0,0,0
1668387159967,ECE 247B,A00,103651,Wang; Joseph,0,0,0,0
1668387160395,ECE 250,A00,103652,Siegel; Paul H.,0,0,0,0
1668387160819,ECE 251A,A00,103654,Rao; Bhaskar D.,0,0,0,0
1668387161246,ECE 257B,A00,103655,Bharadia; Dinesh,0,0,0,0
1668387161669,ECE 258A,A00,103656,Milstein; Laurence B.,0,0,0,0
1668387162100,ECE 260B,A00,103658,Kang; Mingu,0,0,0,0
1668387162528,ECE 264A,A00,103659,Galton; Ian A,0,0,0,0
1668387162963,ECE 265A,A00,103661,Gudem; Prasad S.S.,0,0,0,0
1668387163384,ECE 265D,A00,103662,Gudem; Prasad S.S.,0,0,0,0
1668387163807,ECE 268,A00,103663,Koushanfar; Farinaz,0,0,0,0
1668387164233,ECE 269,A01,103665,Pal; Piya,0,0,0,0
1668387164660,ECE 271B,A00,103666,Vasconcelos; Manuela,0,0,0,0
1668387165088,ECE 276A,A00,103667,Atanasov; Nikolay A.,0,0,0,0
1668387165513,ECE 277,A00,103668,An; Cheolhong,0,0,0,0
1668387165951,ECE 279,A00,117947,Hall; Drew A.,0,0,0,0
1668387166809,ECE 283,A00,103670,Hsueh; Tzu-Chien,0,0,0,0
1668387167245,ECE 284,A00,103671,Turakhia; Yatish Girish,0,0,0,0
1668387167669,ECE 285,A00,103672,Zheng; Yang,0,0,0,0
1668387167669,ECE 285,B00,103673,Sworder; David D.,0,0,0,0
1668387168092,ECE 287,A00,103676,Javidi; Tara,0,0,0,0
1668387168516,MATH 200B,A00,098023,Salehi Golsefidy; Alireza,12,0,15,3
1668387168939,MATH 202B,A00,098024,Rhoades; Brendon Patrick,9,0,15,6
1668387169365,MATH 203B,A00,098025,Oprea; Dragos N.,10,0,15,5
1668387169793,MATH 204B,A00,098026,Sorensen; Claus M,13,0,15,2
1668387170223,MATH 208,A00,098027,Izadi; Elham,7,0,10,3
1668387170647,MATH 209,A00,098028,Pollack; Aaron,10,0,10,0
1668387171077,MATH 211A,A00,112919,Rogalski; Daniel,9,0,10,1
1668387171513,MATH 211B,A00,112920,Seward; Brandon M.,9,0,10,1
1668387171941,MATH 218,A00,098029,Li; Bo,10,0,10,0
1668387172362,MATH 220B,A00,098030,Novak; Jonathan I,11,0,15,4
1668387172788,MATH 221A,A00,098031,Ebenfelt; Peter F,13,0,15,2
1668387173216,MATH 231B,A00,098032,Zlatos; Andrej,12,0,15,3
1668387173642,MATH 240B,A00,098033,Ni; Lei,9,0,15,6
1668387174067,MATH 243,A00,098034,Jekel; David Andrew,10,0,10,0
1668387174490,MATH 245A,A00,098035,Nie; Jiawang,0,0,15,16
1668387174916,MATH 248,A00,098036,Bejenaru; Ioan,10,0,10,0
1668387175341,MATH 250B,A00,098037,Spolaor; Luca,14,0,15,1
1668387175768,MATH 258,A00,098038,Ni; Lei,10,0,10,0
1668387176191,MATH 264B,A00,098041,Rhoades; Brendon Patrick,9,0,15,6
1668387176619,MATH 268,A00,098042,Buss; Samuel R,10,0,10,0
1668387177053,MATH 269,A00,098043,Rhoades; Brendon Patrick,10,0,10,0
1668387177482,MATH 270B,A00,098044,Li; Bo,10,0,15,5
1668387177906,MATH 272B,A00,098045,Holst; Michael J,13,0,15,2
1668387178331,MATH 273A,A00,098046,Tian; Xiaochuan,10,0,15,5
1668387178760,MATH 275,A01,098048,Tian; Xiaochuan,6,0,10,4
1668387179192,MATH 278A,A00,098049,Holst; Michael J,8,0,10,2
1668387179615,MATH 278B,A00,098050,Cloninger; Alexander,10,0,10,0
1668387180036,MATH 278C,A00,098051,Nie; Jiawang,7,0,10,3
1668387180463,MATH 280B,A00,098052,Zheng; Tianyi,8,0,15,7
1668387180887,MATH 281B,A00,098053,Bradic; Jelena,0,0,15,15
1668387181319,MATH 282B,A00,098054,Arias-Castro; Ery,0,0,15,15
1668387181745,MATH 285,A00,098055,Fitzsimmons; Patrick J,0,0,15,17
1668387182172,MATH 287B,A00,098056,Arias-Castro; Ery,2,0,15,13
1668387182595,MATH 288,A00,098057,Agarwal; Pooja,9,0,10,1
1668387182595,MATH 288,B00,098058,Zhang; Danna,8,0,10,2
1668387182595,MATH 288,C00,098059,Williams; Ruth J,9,0,10,1
1668387183018,MATH 290B,A00,098060,Roberts; Justin Deritter,13,0,15,2
1668387183532,MATH 292,A00,098061,Belmont; Eva Kinoshita,10,0,10,0
1668387183955,MATH 295,A00,098062,Suk; Andrew Hoon,48,0,50,2
1668387184379,MATH 296,A00,098063,Novak; Jonathan I,20,0,20,0
1668387184809,MATH 297,001,098064,Gamst; Anthony Collins,9997,0,9999,2
1668387685958,COGS 205,A00,101395,Chiba; Andrea,19,0,20,1
1668387686381,COGS 210B,001,101404,Greene; Deanna Jacquelyn,9998,0,9999,1
1668387686381,COGS 210B,002,101417,Xia; Haijun,9999,0,9999,0
1668387686381,COGS 210B,003,101422,Nitz; Douglas A.,9999,0,9999,0
1668387686381,COGS 210B,004,101423,Hollan; James D.,9998,0,9999,1
1668387686381,COGS 210B,005,101424,Deak; Gedeon O.,9998,0,9999,1
1668387686381,COGS 210B,006,101425,Rossano; Federico,9999,0,9999,0
1668387686813,COGS 211B,A00,101427,Coulson; Seana M,9996,0,9999,3
1668387687234,COGS 220,A00,101428,Hollan; James D.,0,0,25,25
1668387687671,COGS 229,A00,101429,Dow; Steven P,18,0,25,7
1668387688095,COGS 230,A00,101430,Klemmer; Scott R,11,0,17,6
1668387688519,COGS 234,A00,101431,Xia; Haijun,1,0,25,24
1668387688953,COGS 260,A00,101432,Kiyonaga; Anastasia,21,0,25,4
1668387688953,COGS 260,B00,101433,Kirsh; David Joel,15,0,25,10
1668387689387,CSE 202,A00,102371,Impagliazzo; Russell,0,0,0,0
1668387689808,CSE 203B,A01,102373,Cheng; Chung Kuan,0,0,0,0
1668387690229,CSE 208,A00,102374,Micciancio; Daniele,0,0,0,0
1668387690658,CSE 209A,A00,112895,Impagliazzo; Russell,0,0,15,15
1668387691090,CSE 209B,A00,108005,Bellare; Mihir,0,0,0,0
1668387691521,CSE 210,A00,113163,Coblenz; Michael J,0,0,0,0
1668387691953,CSE 219,A00,106111,Dow; Steven P,0,0,20,20
1668387692381,CSE 221,A00,102376,Voelker; Geoffrey M.,0,0,0,0
1668387692808,CSE 224,A01,102378,Porter; George M,0,0,0,0
1668387693234,CSE 229A,A00,102379,Savage; Stefan,0,0,0,0
1668387693656,CSE 229C,A00,102380,Munyaka; Imani N. S.,0,0,0,0
1668387694082,CSE 232B,A00,102382,Deutsch; Alin Bernard,0,0,0,0
1668387694504,CSE 234,A01,112904,Kumar; Arun Kumar,0,0,0,0
1668387694940,CSE 237A,A00,102383,Rosing; Tajana Simunic,0,0,0,0
1668387695363,CSE 239A,A00,102384,Deutsch; Alin Bernard,0,0,0,0
1668387695785,CSE 239B,A00,102385,Polikarpova; Nadezhda,0,0,0,0
1668387696208,CSE 240A,A00,102386,Pannuto; Patrick William,0,0,0,0
1668387696630,CSE 240B,A00,102387,Zhao; Jishen,0,0,0,0
1668387697055,CSE 241A,A00,106406,Kang; Mingu,0,0,0,0
1668387697476,CSE 249B,A00,102388,Kahng; Andrew Byun,0,0,8,8
1668387697907,CSE 251B,A01,102392,Cottrell; Garrison W,0,0,0,0
1668387697907,CSE 251B,A02,102393,Cottrell; Garrison W,0,0,0,0
1668387698332,CSE 252B,A00,102394,Ochoa; Benjamin Lawrence,0,0,0,0
1668387698759,CSE 257,A01,102396,Gao; Sicun,0,0,0,0
1668387699184,CSE 272,A00,102397,Li; Tzumao,0,0,0,0
1668387699610,CSE 274,A00,111323,Chern; Albert Ren-Haur,0,0,0,0
1668387700035,CSE 282,A00,102398,Pevzner; Pavel Arkadjevich,0,0,0,0
1668387700460,CSE 284,A00,114175,Gymrek; Melissa Ann,0,0,0,0
1668387700890,CSE 290,A00,102399,Chandraker; Manmohan Krishna,0,0,0,0
1668387700890,CSE 290,B00,102400,Vaccaro; Kristen Marie,0,0,25,25
1668387700890,CSE 290,C00,102414,Pannuto; Patrick William,0,0,25,25
1668387700890,CSE 290,D00,102427,Pevzner; Pavel Arkadjevich,0,0,0,0
1668387700890,CSE 290,E00,102429,Zhao; Jishen,0,0,0,0
1668387700890,CSE 290,F00,102436,Tullsen; Dean Michael,0,0,0,0
1668387700890,CSE 290,G00,102440,Christensen; Henrik I,0,0,20,20
1668387701319,CSE 291,A00,102443,Su; Hao,0,0,0,0
1668387701319,CSE 291,B00,102448,Polikarpova; Nadezhda,0,0,0,0
1668387701319,CSE 291,C00,102453,Vaccaro; Kristen Marie,0,0,0,0
1668387701319,CSE 291,D00,111343,Savage; Stefan,0,0,0,0
1668387701319,CSE 291,E00,116474,Claffy; Kimberly Claire,0,0,0,0
1668387701319,CSE 291,F00,116479,Pasquale; Joseph,0,0,0,0
1668387701751,CSE 293,001,119111,Bafna; Vineet,9999,0,9999,0
1668387701751,CSE 293,002,119118,Bellare; Mihir,9999,0,9999,0
1668387701751,CSE 293,003,119122,Berg-Kirkpatrick; Taylor D,9999,0,9999,0
1668387701751,CSE 293,004,119135,Christensen; Henrik I,9999,0,9999,0
1668387701751,CSE 293,005,119142,Cottrell; Garrison W,9999,0,9999,0
1668387701751,CSE 293,006,119146,Deutsch; Alin Bernard,9999,0,9999,0
1668387701751,CSE 293,007,119159,Esmaeilzadeh; Hadi,9999,0,9999,0
1668387701751,CSE 293,008,119166,Freund; Yoav,9999,0,9999,0
1668387701751,CSE 293,009,119170,Griswold; William G.,9999,0,9999,0
1668387701751,CSE 293,010,119183,Gymrek; Melissa Ann,9999,0,9999,0
1668387701751,CSE 293,011,119190,Heninger; Nadia A,9999,0,9999,0
1668387701751,CSE 293,012,119230,Impagliazzo; Russell,9999,0,9999,0
1668387701751,CSE 293,013,119232,Jhala; Ranjit,9999,0,9999,0
1668387701751,CSE 293,014,119233,Kahng; Andrew Byun,9999,0,9999,0
1668387701751,CSE 293,015,119298,Kane; Daniel Mertz,9999,0,9999,0
1668387701751,CSE 293,016,119299,Kriegman; David J,9999,0,9999,0
1668387701751,CSE 293,017,119300,Kumar; Arun Kumar,9999,0,9999,0
1668387701751,CSE 293,018,119301,Lerner; Sorin,9999,0,9999,0
1668387701751,CSE 293,019,119302,Lovett; Shachar,9999,0,9999,0
1668387701751,CSE 293,020,119303,McAuley; Julian John,9999,0,9999,0
1668387701751,CSE 293,021,119304,Micciancio; Daniele,9999,0,9999,0
1668387701751,CSE 293,022,119367,Orailoglu; Alex,9999,0,9999,0
1668387701751,CSE 293,023,119382,Paturi; Ramamohan,9999,0,9999,0
1668387701751,CSE 293,024,119404,Polikarpova; Nadezhda,9999,0,9999,0
1668387701751,CSE 293,025,119406,Politz; Joseph Gibbs,9999,0,9999,0
1668387701751,CSE 293,026,119411,Porter; George M,9999,0,9999,0
1668387701751,CSE 293,027,119414,Porter; Leonard Emerson,9999,0,9999,0
1668387701751,CSE 293,028,119416,Ramamoorthi; Ravi,9999,0,9999,0
1668387701751,CSE 293,029,119417,Sahoo; Debashis,9999,0,9999,0
1668387701751,CSE 293,030,119420,Saul; Lawrence,9999,0,9999,0
1668387701751,CSE 293,031,119421,Savage; Stefan,9999,0,9999,0
1668387701751,CSE 293,032,119425,Schulze; Jurgen P.,9999,0,9999,0
1668387701751,CSE 293,033,119426,Snoeren; Alex C.,9999,0,9999,0
1668387701751,CSE 293,034,119428,Shang; Jingbo,9999,0,9999,0
1668387701751,CSE 293,035,119430,Stefan; Deian,9999,0,9999,0
1668387701751,CSE 293,036,119431,Su; Hao,9999,0,9999,0
1668387701751,CSE 293,037,119433,Swanson; Steven James,9999,0,9999,0
1668387701751,CSE 293,038,119435,Tullsen; Dean Michael,9999,0,9999,0
1668387701751,CSE 293,039,119483,Voelker; Geoffrey M.,9999,0,9999,0
1668387701751,CSE 293,040,119537,Zhao; Jishen,9999,0,9999,0
1668387701751,CSE 293,041,119538,Zhou; Yuan-Yuan,9999,0,9999,0
1668387701751,CSE 293,042,119539,Gao; Sicun,9999,0,9999,0
1668387701751,CSE 293,043,119540,Weibel; Nadir,9999,0,9999,0
1668387701751,CSE 293,044,119541,Gupta; Rajesh K.,9999,0,9999,0
1668387701751,CSE 293,045,126410,Vaccaro; Kristen Marie,9999,0,9999,0
1668387701751,CSE 293,046,126411,Klemke; Richard,9999,0,9999,0
1668387702180,CSE 294,A00,102459,Voelker; Geoffrey M.,0,0,0,0
1668387702180,CSE 294,B00,111322,Orailoglu; Alex,0,0,0,0
1668387702603,DSE 201,A00,096914,Deutsch; Alin Bernard,30,0,30,0
1668387703036,DSE 210,A00,096915,Dasgupta; Sanjoy,30,0,30,0
1668387703458,DSE 260A,A00,096916,Altintas De Callaf; Ilkay,30,0,30,0
1668387703888,ECE 200,001,103586,Antipa; Nicholas A,9999,0,9999,0
1668387703888,ECE 200,002,103587,Atanasov; Nikolay A.,9999,0,9999,0
1668387703888,ECE 200,003,103588,Bharadia; Dinesh,9999,0,9999,0
1668387703888,ECE 200,004,103589,Cheng; Chung Kuan,9999,0,9999,0
1668387703888,ECE 200,005,103590,Cosman; Pamela C.,9999,0,9999,0
1668387703888,ECE 200,006,103591,Dayeh; Shadi Ahmad,9999,0,9999,0
1668387703888,ECE 200,007,103592,Fainman; Yeshaiahu,9999,0,9999,0
1668387703888,ECE 200,008,103593,Ford; Joseph Earl,9999,0,9999,0
1668387703888,ECE 200,009,103594,Franceschetti; Massimo,9999,0,9999,0
1668387703888,ECE 200,010,103595,Fullerton; Eric E,9999,0,9999,0
1668387703888,ECE 200,011,103596,Galton; Ian A,9999,0,9999,0
1668387703888,ECE 200,012,103597,Gilja; Vikash,9999,0,9999,0
1668387703888,ECE 200,013,103598,Hall; Drew A.,9999,0,9999,0
1668387703888,ECE 200,014,103599,Hsueh; Tzu-Chien,9999,0,9999,0
1668387703888,ECE 200,015,103600,Javidi; Tara,9999,0,9999,0
1668387703888,ECE 200,016,103601,Kahng; Andrew Byun,9999,0,9999,0
1668387703888,ECE 200,017,103602,Kim; Young-Han,9999,0,9999,0
1668387703888,ECE 200,018,103603,Koushanfar; Farinaz,9999,0,9999,0
1668387703888,ECE 200,019,103604,Kuzum; Duygu,9999,0,9999,0
1668387703888,ECE 200,020,103605,Le; Hanh-Phuc,9999,0,9999,0
1668387703888,ECE 200,021,103606,Lin; Bill,9999,0,9999,0
1668387703888,ECE 200,022,103607,Liu; Zhaowei,9998,0,9999,1
1668387703888,ECE 200,023,103608,Lo; Yu-Hwa,9999,0,9999,0
1668387703888,ECE 200,024,103609,Lomakin; Vitaliy,9999,0,9999,0
1668387703888,ECE 200,025,103610,Mercier; Patrick Philip,9999,0,9999,0
1668387703888,ECE 200,026,103611,Meyer; Florian,9999,0,9999,0
1668387703888,ECE 200,027,103612,Milstein; Laurence B.,9999,0,9999,0
1668387703888,ECE 200,028,103613,Mir Arabbaygi; Siavash,9999,0,9999,0
1668387703888,ECE 200,029,103614,Mookherjea; Shayan,9999,0,9999,0
1668387703888,ECE 200,030,103615,Morris; Karcher William,9999,0,9999,0
1668387703888,ECE 200,031,103616,Ng; Tse Nga,9999,0,9999,0
1668387703888,ECE 200,032,103617,Nguyen; Truong Quang,9999,0,9999,0
1668387703888,ECE 200,033,103618,Nomura; Kenji,9999,0,9999,0
1668387703888,ECE 200,034,103619,Orlitsky; Alon,9999,0,9999,0
1668387703888,ECE 200,035,103620,Pal; Piya,9999,0,9999,0
1668387703888,ECE 200,036,103621,Papen; George C.,9999,0,9999,0
1668387703888,ECE 200,037,103622,Radic; Stojan,9999,0,9999,0
1668387703888,ECE 200,038,103623,Rao; Bhaskar D.,9999,0,9999,0
1668387703888,ECE 200,039,103624,Rao; Ramesh R,9999,0,9999,0
1668387703888,ECE 200,040,103625,Rebeiz; Gabriel,9999,0,9999,0
1668387703888,ECE 200,041,103626,Sanford; John R,9999,0,9999,0
1668387703888,ECE 200,042,103627,Siegel; Paul H.,9999,0,9999,0
1668387703888,ECE 200,043,103628,Sievenpiper; Daniel F.,9999,0,9999,0
1668387703888,ECE 200,044,103629,Sworder; David D.,9999,0,9999,0
1668387703888,ECE 200,045,103630,Taur; Yuan,9999,0,9999,0
1668387703888,ECE 200,046,103631,Touri; Behrouz,9999,0,9999,0
1668387703888,ECE 200,047,103632,Trivedi; Mohan M.,9999,0,9999,0
1668387703888,ECE 200,048,103633,Vasconcelos; Nuno,9999,0,9999,0
1668387703888,ECE 200,049,103634,Wang; Xiaolong,9999,0,9999,0
1668387703888,ECE 200,050,103635,Xie; Pengtao,9999,0,9999,0
1668387703888,ECE 200,051,103636,Yip; Michael,9999,0,9999,0
1668387703888,ECE 200,052,103637,Zeger; Kenneth A.,999,0,999,0
1668387703888,ECE 200,053,103638,Zhang; Xinyu,9999,0,9999,0
1668387703888,ECE 200,054,103639,Turakhia; Yatish Girish,9999,0,9999,0
1668387703888,ECE 200,055,103640,Kang; Mingu,9999,0,9999,0
1668387703888,ECE 200,056,103641,Shi; Yuanyuan,9999,0,9999,0
1668387703888,ECE 200,057,103642,Wang; Edward Jay,9999,0,9999,0
1668387703888,ECE 200,058,103643,Zheng; Yang,9999,0,9999,0
1668387704314,ECE 202,A00,103644,Kuzum; Duygu,0,0,0,0
1668387704817,ECE 212BN,A00,103646,Ng; Tse Nga,0,0,0,0
1668387705239,ECE 221,A00,111493,Staff,0,0,0,0
1668387705679,ECE 222B,A00,103647,Lomakin; Vitaliy,0,0,0,0
1668387706104,ECE 230B,A00,103648,Taur; Yuan,0,0,0,0
1668387706527,ECE 238B,A00,103649,Garay; Javier,0,0,0,0
1668387706951,ECE 240B,A00,112900,Fainman; Yeshaiahu,0,0,0,0
1668387707375,ECE 247A,A00,103650,Jokerst; Jesse Vincent,0,0,0,0
1668387707809,ECE 247B,A00,103651,Wang; Joseph,0,0,0,0
1668387708234,ECE 250,A00,103652,Siegel; Paul H.,0,0,0,0
1668387708659,ECE 251A,A00,103654,Rao; Bhaskar D.,0,0,0,0
1668387709082,ECE 257B,A00,103655,Bharadia; Dinesh,0,0,0,0
1668387709507,ECE 258A,A00,103656,Milstein; Laurence B.,0,0,0,0
1668387709929,ECE 260B,A00,103658,Kang; Mingu,0,0,0,0
1668387710353,ECE 264A,A00,103659,Galton; Ian A,0,0,0,0
1668387710779,ECE 265A,A00,103661,Gudem; Prasad S.S.,0,0,0,0
1668387711204,ECE 265D,A00,103662,Gudem; Prasad S.S.,0,0,0,0
1668387711636,ECE 268,A00,103663,Koushanfar; Farinaz,0,0,0,0
1668387712069,ECE 269,A01,103665,Pal; Piya,0,0,0,0
1668387712495,ECE 271B,A00,103666,Vasconcelos; Manuela,0,0,0,0
1668387712919,ECE 276A,A00,103667,Atanasov; Nikolay A.,0,0,0,0
1668387713343,ECE 277,A00,103668,An; Cheolhong,0,0,0,0
1668387713769,ECE 279,A00,117947,Hall; Drew A.,0,0,0,0
1668387714619,ECE 283,A00,103670,Hsueh; Tzu-Chien,0,0,0,0
1668387715044,ECE 284,A00,103671,Turakhia; Yatish Girish,0,0,0,0
1668387715471,ECE 285,A00,103672,Zheng; Yang,0,0,0,0
1668387715471,ECE 285,B00,103673,Sworder; David D.,0,0,0,0
1668387715893,ECE 287,A00,103676,Javidi; Tara,0,0,0,0
1668387716318,MATH 200B,A00,098023,Salehi Golsefidy; Alireza,12,0,15,3
1668387716742,MATH 202B,A00,098024,Rhoades; Brendon Patrick,9,0,15,6
1668387717165,MATH 203B,A00,098025,Oprea; Dragos N.,10,0,15,5
1668387717587,MATH 204B,A00,098026,Sorensen; Claus M,13,0,15,2
1668387718012,MATH 208,A00,098027,Izadi; Elham,7,0,10,3
1668387718436,MATH 209,A00,098028,Pollack; Aaron,10,0,10,0
1668387718862,MATH 211A,A00,112919,Rogalski; Daniel,9,0,10,1
1668387719286,MATH 211B,A00,112920,Seward; Brandon M.,9,0,10,1
1668387719711,MATH 218,A00,098029,Li; Bo,10,0,10,0
1668387720133,MATH 220B,A00,098030,Novak; Jonathan I,11,0,15,4
1668387720560,MATH 221A,A00,098031,Ebenfelt; Peter F,13,0,15,2
1668387720985,MATH 231B,A00,098032,Zlatos; Andrej,12,0,15,3
1668387721410,MATH 240B,A00,098033,Ni; Lei,9,0,15,6
1668387721833,MATH 243,A00,098034,Jekel; David Andrew,10,0,10,0
1668387722258,MATH 245A,A00,098035,Nie; Jiawang,0,0,15,16
1668387722695,MATH 248,A00,098036,Bejenaru; Ioan,10,0,10,0
1668387723127,MATH 250B,A00,098037,Spolaor; Luca,14,0,15,1
1668387723553,MATH 258,A00,098038,Ni; Lei,10,0,10,0
1668387723991,MATH 264B,A00,098041,Rhoades; Brendon Patrick,9,0,15,6
1668387724418,MATH 268,A00,098042,Buss; Samuel R,10,0,10,0
1668387724840,MATH 269,A00,098043,Rhoades; Brendon Patrick,10,0,10,0
1668387725263,MATH 270B,A00,098044,Li; Bo,10,0,15,5
1668387725698,MATH 272B,A00,098045,Holst; Michael J,13,0,15,2
1668387726120,MATH 273A,A00,098046,Tian; Xiaochuan,10,0,15,5
1668387726552,MATH 275,A01,098048,Tian; Xiaochuan,6,0,10,4
1668387726975,MATH 278A,A00,098049,Holst; Michael J,8,0,10,2
1668387727403,MATH 278B,A00,098050,Cloninger; Alexander,10,0,10,0
1668387727836,MATH 278C,A00,098051,Nie; Jiawang,7,0,10,3
1668387728259,MATH 280B,A00,098052,Zheng; Tianyi,8,0,15,7
1668387728689,MATH 281B,A00,098053,Bradic; Jelena,0,0,15,15
1668387729113,MATH 282B,A00,098054,Arias-Castro; Ery,0,0,15,15
1668387729536,MATH 285,A00,098055,Fitzsimmons; Patrick J,0,0,15,17
1668387729958,MATH 287B,A00,098056,Arias-Castro; Ery,2,0,15,13
1668387730382,MATH 288,A00,098057,Agarwal; Pooja,9,0,10,1
1668387730382,MATH 288,B00,098058,Zhang; Danna,8,0,10,2
1668387730382,MATH 288,C00,098059,Williams; Ruth J,9,0,10,1
1668387730804,MATH 290B,A00,098060,Roberts; Justin Deritter,13,0,15,2
1668387731229,MATH 292,A00,098061,Belmont; Eva Kinoshita,10,0,10,0
1668387731654,MATH 295,A00,098062,Suk; Andrew Hoon,48,0,50,2
1668387732080,MATH 296,A00,098063,Novak; Jonathan I,20,0,20,0
1668387732516,MATH 297,001,098064,Gamst; Anthony Collins,9997,0,9999,2
1668388233137,COGS 205,A00,101395,Chiba; Andrea,19,0,20,1
1668388233562,COGS 210B,001,101404,Greene; Deanna Jacquelyn,9998,0,9999,1
1668388233562,COGS 210B,002,101417,Xia; Haijun,9999,0,9999,0
1668388233562,COGS 210B,003,101422,Nitz; Douglas A.,9999,0,9999,0
1668388233562,COGS 210B,004,101423,Hollan; James D.,9998,0,9999,1
1668388233562,COGS 210B,005,101424,Deak; Gedeon O.,9998,0,9999,1
1668388233562,COGS 210B,006,101425,Rossano; Federico,9999,0,9999,0
1668388233989,COGS 211B,A00,101427,Coulson; Seana M,9996,0,9999,3
1668388234420,COGS 220,A00,101428,Hollan; James D.,0,0,25,25
1668388234848,COGS 229,A00,101429,Dow; Steven P,18,0,25,7
1668388235270,COGS 230,A00,101430,Klemmer; Scott R,11,0,17,6
1668388235706,COGS 234,A00,101431,Xia; Haijun,1,0,25,24
1668388236141,COGS 260,A00,101432,Kiyonaga; Anastasia,21,0,25,4
1668388236141,COGS 260,B00,101433,Kirsh; David Joel,15,0,25,10
1668388236573,CSE 202,A00,102371,Impagliazzo; Russell,0,0,0,0
1668388236997,CSE 203B,A01,102373,Cheng; Chung Kuan,0,0,0,0
1668388237424,CSE 208,A00,102374,Micciancio; Daniele,0,0,0,0
1668388237847,CSE 209A,A00,112895,Impagliazzo; Russell,0,0,15,15
1668388238270,CSE 209B,A00,108005,Bellare; Mihir,0,0,0,0
1668388238696,CSE 210,A00,113163,Coblenz; Michael J,0,0,0,0
1668388239120,CSE 219,A00,106111,Dow; Steven P,0,0,20,20
1668388239544,CSE 221,A00,102376,Voelker; Geoffrey M.,0,0,0,0
1668388239972,CSE 224,A01,102378,Porter; George M,0,0,0,0
1668388240402,CSE 229A,A00,102379,Savage; Stefan,0,0,0,0
1668388240828,CSE 229C,A00,102380,Munyaka; Imani N. S.,0,0,0,0
1668388241253,CSE 232B,A00,102382,Deutsch; Alin Bernard,0,0,0,0
1668388241678,CSE 234,A01,112904,Kumar; Arun Kumar,0,0,0,0
1668388242102,CSE 237A,A00,102383,Rosing; Tajana Simunic,0,0,0,0
1668388242529,CSE 239A,A00,102384,Deutsch; Alin Bernard,0,0,0,0
1668388242954,CSE 239B,A00,102385,Polikarpova; Nadezhda,0,0,0,0
1668388243378,CSE 240A,A00,102386,Pannuto; Patrick William,0,0,0,0
1668388243806,CSE 240B,A00,102387,Zhao; Jishen,0,0,0,0
1668388244233,CSE 241A,A00,106406,Kang; Mingu,0,0,0,0
1668388244657,CSE 249B,A00,102388,Kahng; Andrew Byun,0,0,8,8
1668388245083,CSE 251B,A01,102392,Cottrell; Garrison W,0,0,0,0
1668388245083,CSE 251B,A02,102393,Cottrell; Garrison W,0,0,0,0
1668388245507,CSE 252B,A00,102394,Ochoa; Benjamin Lawrence,0,0,0,0
1668388245939,CSE 257,A01,102396,Gao; Sicun,0,0,0,0
1668388246376,CSE 272,A00,102397,Li; Tzumao,0,0,0,0
1668388246814,CSE 274,A00,111323,Chern; Albert Ren-Haur,0,0,0,0
1668388247250,CSE 282,A00,102398,Pevzner; Pavel Arkadjevich,0,0,0,0
1668388247691,CSE 284,A00,114175,Gymrek; Melissa Ann,0,0,0,0
1668388248114,CSE 290,A00,102399,Chandraker; Manmohan Krishna,0,0,0,0
1668388248114,CSE 290,B00,102400,Vaccaro; Kristen Marie,0,0,25,25
1668388248114,CSE 290,C00,102414,Pannuto; Patrick William,0,0,25,25
1668388248114,CSE 290,D00,102427,Pevzner; Pavel Arkadjevich,0,0,0,0
1668388248114,CSE 290,E00,102429,Zhao; Jishen,0,0,0,0
1668388248114,CSE 290,F00,102436,Tullsen; Dean Michael,0,0,0,0
1668388248114,CSE 290,G00,102440,Christensen; Henrik I,0,0,20,20
1668388248541,CSE 291,A00,102443,Su; Hao,0,0,0,0
1668388248541,CSE 291,B00,102448,Polikarpova; Nadezhda,0,0,0,0
1668388248541,CSE 291,C00,102453,Vaccaro; Kristen Marie,0,0,0,0
1668388248541,CSE 291,D00,111343,Savage; Stefan,0,0,0,0
1668388248541,CSE 291,E00,116474,Claffy; Kimberly Claire,0,0,0,0
1668388248541,CSE 291,F00,116479,Pasquale; Joseph,0,0,0,0
1668388249003,CSE 293,001,119111,Bafna; Vineet,9999,0,9999,0
1668388249003,CSE 293,002,119118,Bellare; Mihir,9999,0,9999,0
1668388249003,CSE 293,003,119122,Berg-Kirkpatrick; Taylor D,9999,0,9999,0
1668388249003,CSE 293,004,119135,Christensen; Henrik I,9999,0,9999,0
1668388249003,CSE 293,005,119142,Cottrell; Garrison W,9999,0,9999,0
1668388249003,CSE 293,006,119146,Deutsch; Alin Bernard,9999,0,9999,0
1668388249003,CSE 293,007,119159,Esmaeilzadeh; Hadi,9999,0,9999,0
1668388249003,CSE 293,008,119166,Freund; Yoav,9999,0,9999,0
1668388249003,CSE 293,009,119170,Griswold; William G.,9999,0,9999,0
1668388249003,CSE 293,010,119183,Gymrek; Melissa Ann,9999,0,9999,0
1668388249003,CSE 293,011,119190,Heninger; Nadia A,9999,0,9999,0
1668388249003,CSE 293,012,119230,Impagliazzo; Russell,9999,0,9999,0
1668388249003,CSE 293,013,119232,Jhala; Ranjit,9999,0,9999,0
1668388249003,CSE 293,014,119233,Kahng; Andrew Byun,9999,0,9999,0
1668388249003,CSE 293,015,119298,Kane; Daniel Mertz,9999,0,9999,0
1668388249003,CSE 293,016,119299,Kriegman; David J,9999,0,9999,0
1668388249003,CSE 293,017,119300,Kumar; Arun Kumar,9999,0,9999,0
1668388249003,CSE 293,018,119301,Lerner; Sorin,9999,0,9999,0
1668388249003,CSE 293,019,119302,Lovett; Shachar,9999,0,9999,0
1668388249003,CSE 293,020,119303,McAuley; Julian John,9999,0,9999,0
1668388249003,CSE 293,021,119304,Micciancio; Daniele,9999,0,9999,0
1668388249003,CSE 293,022,119367,Orailoglu; Alex,9999,0,9999,0
1668388249003,CSE 293,023,119382,Paturi; Ramamohan,9999,0,9999,0
1668388249003,CSE 293,024,119404,Polikarpova; Nadezhda,9999,0,9999,0
1668388249003,CSE 293,025,119406,Politz; Joseph Gibbs,9999,0,9999,0
1668388249003,CSE 293,026,119411,Porter; George M,9999,0,9999,0
1668388249003,CSE 293,027,119414,Porter; Leonard Emerson,9999,0,9999,0
1668388249003,CSE 293,028,119416,Ramamoorthi; Ravi,9999,0,9999,0
1668388249003,CSE 293,029,119417,Sahoo; Debashis,9999,0,9999,0
1668388249003,CSE 293,030,119420,Saul; Lawrence,9999,0,9999,0
1668388249003,CSE 293,031,119421,Savage; Stefan,9999,0,9999,0
1668388249003,CSE 293,032,119425,Schulze; Jurgen P.,9999,0,9999,0
1668388249003,CSE 293,033,119426,Snoeren; Alex C.,9999,0,9999,0
1668388249003,CSE 293,034,119428,Shang; Jingbo,9999,0,9999,0
1668388249003,CSE 293,035,119430,Stefan; Deian,9999,0,9999,0
1668388249003,CSE 293,036,119431,Su; Hao,9999,0,9999,0
1668388249003,CSE 293,037,119433,Swanson; Steven James,9999,0,9999,0
1668388249003,CSE 293,038,119435,Tullsen; Dean Michael,9999,0,9999,0
1668388249003,CSE 293,039,119483,Voelker; Geoffrey M.,9999,0,9999,0
1668388249003,CSE 293,040,119537,Zhao; Jishen,9999,0,9999,0
1668388249003,CSE 293,041,119538,Zhou; Yuan-Yuan,9999,0,9999,0
1668388249003,CSE 293,042,119539,Gao; Sicun,9999,0,9999,0
1668388249003,CSE 293,043,119540,Weibel; Nadir,9999,0,9999,0
1668388249003,CSE 293,044,119541,Gupta; Rajesh K.,9999,0,9999,0
1668388249003,CSE 293,045,126410,Vaccaro; Kristen Marie,9999,0,9999,0
1668388249003,CSE 293,046,126411,Klemke; Richard,9999,0,9999,0
1668388249431,CSE 294,A00,102459,Voelker; Geoffrey M.,0,0,0,0
1668388249431,CSE 294,B00,111322,Orailoglu; Alex,0,0,0,0
1668388249856,DSE 201,A00,096914,Deutsch; Alin Bernard,30,0,30,0
1668388250279,DSE 210,A00,096915,Dasgupta; Sanjoy,30,0,30,0
1668388250707,DSE 260A,A00,096916,Altintas De Callaf; Ilkay,30,0,30,0
1668388251145,ECE 200,001,103586,Antipa; Nicholas A,9999,0,9999,0
1668388251145,ECE 200,002,103587,Atanasov; Nikolay A.,9999,0,9999,0
1668388251145,ECE 200,003,103588,Bharadia; Dinesh,9999,0,9999,0
1668388251145,ECE 200,004,103589,Cheng; Chung Kuan,9999,0,9999,0
1668388251145,ECE 200,005,103590,Cosman; Pamela C.,9999,0,9999,0
1668388251145,ECE 200,006,103591,Dayeh; Shadi Ahmad,9999,0,9999,0
1668388251145,ECE 200,007,103592,Fainman; Yeshaiahu,9999,0,9999,0
1668388251145,ECE 200,008,103593,Ford; Joseph Earl,9999,0,9999,0
1668388251145,ECE 200,009,103594,Franceschetti; Massimo,9999,0,9999,0
1668388251145,ECE 200,010,103595,Fullerton; Eric E,9999,0,9999,0
1668388251145,ECE 200,011,103596,Galton; Ian A,9999,0,9999,0
1668388251145,ECE 200,012,103597,Gilja; Vikash,9999,0,9999,0
1668388251145,ECE 200,013,103598,Hall; Drew A.,9999,0,9999,0
1668388251145,ECE 200,014,103599,Hsueh; Tzu-Chien,9999,0,9999,0
1668388251145,ECE 200,015,103600,Javidi; Tara,9999,0,9999,0
1668388251145,ECE 200,016,103601,Kahng; Andrew Byun,9999,0,9999,0
1668388251145,ECE 200,017,103602,Kim; Young-Han,9999,0,9999,0
1668388251145,ECE 200,018,103603,Koushanfar; Farinaz,9999,0,9999,0
1668388251145,ECE 200,019,103604,Kuzum; Duygu,9999,0,9999,0
1668388251145,ECE 200,020,103605,Le; Hanh-Phuc,9999,0,9999,0
1668388251145,ECE 200,021,103606,Lin; Bill,9999,0,9999,0
1668388251145,ECE 200,022,103607,Liu; Zhaowei,9998,0,9999,1
1668388251145,ECE 200,023,103608,Lo; Yu-Hwa,9999,0,9999,0
1668388251145,ECE 200,024,103609,Lomakin; Vitaliy,9999,0,9999,0
1668388251145,ECE 200,025,103610,Mercier; Patrick Philip,9999,0,9999,0
1668388251145,ECE 200,026,103611,Meyer; Florian,9999,0,9999,0
1668388251145,ECE 200,027,103612,Milstein; Laurence B.,9999,0,9999,0
1668388251145,ECE 200,028,103613,Mir Arabbaygi; Siavash,9999,0,9999,0
1668388251145,ECE 200,029,103614,Mookherjea; Shayan,9999,0,9999,0
1668388251145,ECE 200,030,103615,Morris; Karcher William,9999,0,9999,0
1668388251145,ECE 200,031,103616,Ng; Tse Nga,9999,0,9999,0
1668388251145,ECE 200,032,103617,Nguyen; Truong Quang,9999,0,9999,0
1668388251145,ECE 200,033,103618,Nomura; Kenji,9999,0,9999,0
1668388251145,ECE 200,034,103619,Orlitsky; Alon,9999,0,9999,0
1668388251145,ECE 200,035,103620,Pal; Piya,9999,0,9999,0
1668388251145,ECE 200,036,103621,Papen; George C.,9999,0,9999,0
1668388251145,ECE 200,037,103622,Radic; Stojan,9999,0,9999,0
1668388251145,ECE 200,038,103623,Rao; Bhaskar D.,9999,0,9999,0
1668388251145,ECE 200,039,103624,Rao; Ramesh R,9999,0,9999,0
1668388251145,ECE 200,040,103625,Rebeiz; Gabriel,9999,0,9999,0
1668388251145,ECE 200,041,103626,Sanford; John R,9999,0,9999,0
1668388251145,ECE 200,042,103627,Siegel; Paul H.,9999,0,9999,0
1668388251145,ECE 200,043,103628,Sievenpiper; Daniel F.,9999,0,9999,0
1668388251145,ECE 200,044,103629,Sworder; David D.,9999,0,9999,0
1668388251145,ECE 200,045,103630,Taur; Yuan,9999,0,9999,0
1668388251145,ECE 200,046,103631,Touri; Behrouz,9999,0,9999,0
1668388251145,ECE 200,047,103632,Trivedi; Mohan M.,9999,0,9999,0
1668388251145,ECE 200,048,103633,Vasconcelos; Nuno,9999,0,9999,0
1668388251145,ECE 200,049,103634,Wang; Xiaolong,9999,0,9999,0
1668388251145,ECE 200,050,103635,Xie; Pengtao,9999,0,9999,0
1668388251145,ECE 200,051,103636,Yip; Michael,9999,0,9999,0
1668388251145,ECE 200,052,103637,Zeger; Kenneth A.,999,0,999,0
1668388251145,ECE 200,053,103638,Zhang; Xinyu,9999,0,9999,0
1668388251145,ECE 200,054,103639,Turakhia; Yatish Girish,9999,0,9999,0
1668388251145,ECE 200,055,103640,Kang; Mingu,9999,0,9999,0
1668388251145,ECE 200,056,103641,Shi; Yuanyuan,9999,0,9999,0
1668388251145,ECE 200,057,103642,Wang; Edward Jay,9999,0,9999,0
1668388251145,ECE 200,058,103643,Zheng; Yang,9999,0,9999,0
1668388251573,ECE 202,A00,103644,Kuzum; Duygu,0,0,0,0
1668388252001,ECE 212BN,A00,103646,Ng; Tse Nga,0,0,0,0
1668388252428,ECE 221,A00,111493,Staff,0,0,0,0
1668388252865,ECE 222B,A00,103647,Lomakin; Vitaliy,0,0,0,0
1668388253296,ECE 230B,A00,103648,Taur; Yuan,0,0,0,0
1668388253730,ECE 238B,A00,103649,Garay; Javier,0,0,0,0
1668388254155,ECE 240B,A00,112900,Fainman; Yeshaiahu,0,0,0,0
1668388254587,ECE 247A,A00,103650,Jokerst; Jesse Vincent,0,0,0,0
1668388255022,ECE 247B,A00,103651,Wang; Joseph,0,0,0,0
1668388255449,ECE 250,A00,103652,Siegel; Paul H.,0,0,0,0
1668388255872,ECE 251A,A00,103654,Rao; Bhaskar D.,0,0,0,0
1668388256295,ECE 257B,A00,103655,Bharadia; Dinesh,0,0,0,0
1668388256723,ECE 258A,A00,103656,Milstein; Laurence B.,0,0,0,0
1668388257146,ECE 260B,A00,103658,Kang; Mingu,0,0,0,0
1668388257574,ECE 264A,A00,103659,Galton; Ian A,0,0,0,0
1668388258003,ECE 265A,A00,103661,Gudem; Prasad S.S.,0,0,0,0
1668388258427,ECE 265D,A00,103662,Gudem; Prasad S.S.,0,0,0,0
1668388258852,ECE 268,A00,103663,Koushanfar; Farinaz,0,0,0,0
1668388259277,ECE 269,A01,103665,Pal; Piya,0,0,0,0
1668388259701,ECE 271B,A00,103666,Vasconcelos; Manuela,0,0,0,0
1668388260126,ECE 276A,A00,103667,Atanasov; Nikolay A.,0,0,0,0
1668388260560,ECE 277,A00,103668,An; Cheolhong,0,0,0,0
1668388260997,ECE 279,A00,117947,Hall; Drew A.,0,0,0,0
1668388261860,ECE 283,A00,103670,Hsueh; Tzu-Chien,0,0,0,0
1668388262287,ECE 284,A00,103671,Turakhia; Yatish Girish,0,0,0,0
1668388262715,ECE 285,A00,103672,Zheng; Yang,0,0,0,0
1668388262715,ECE 285,B00,103673,Sworder; David D.,0,0,0,0
1668388263146,ECE 287,A00,103676,Javidi; Tara,0,0,0,0
1668388263569,MATH 200B,A00,098023,Salehi Golsefidy; Alireza,12,0,15,3
1668388263997,MATH 202B,A00,098024,Rhoades; Brendon Patrick,9,0,15,6
1668388264428,MATH 203B,A00,098025,Oprea; Dragos N.,10,0,15,5
1668388264856,MATH 204B,A00,098026,Sorensen; Claus M,13,0,15,2
1668388265281,MATH 208,A00,098027,Izadi; Elham,7,0,10,3
1668388265705,MATH 209,A00,098028,Pollack; Aaron,10,0,10,0
1668388266129,MATH 211A,A00,112919,Rogalski; Daniel,9,0,10,1
1668388266555,MATH 211B,A00,112920,Seward; Brandon M.,9,0,10,1
1668388266986,MATH 218,A00,098029,Li; Bo,10,0,10,0
1668388267412,MATH 220B,A00,098030,Novak; Jonathan I,11,0,15,4
1668388267840,MATH 221A,A00,098031,Ebenfelt; Peter F,13,0,15,2
1668388268272,MATH 231B,A00,098032,Zlatos; Andrej,12,0,15,3
1668388268803,MATH 240B,A00,098033,Ni; Lei,9,0,15,6
1668388269231,MATH 243,A00,098034,Jekel; David Andrew,10,0,10,0
1668388269654,MATH 245A,A00,098035,Nie; Jiawang,0,0,15,16
1668388270077,MATH 248,A00,098036,Bejenaru; Ioan,10,0,10,0
1668388270501,MATH 250B,A00,098037,Spolaor; Luca,14,0,15,1
1668388270926,MATH 258,A00,098038,Ni; Lei,10,0,10,0
1668388271358,MATH 264B,A00,098041,Rhoades; Brendon Patrick,9,0,15,6
1668388271782,MATH 268,A00,098042,Buss; Samuel R,10,0,10,0
1668388272209,MATH 269,A00,098043,Rhoades; Brendon Patrick,10,0,10,0
1668388272633,MATH 270B,A00,098044,Li; Bo,10,0,15,5
1668388273059,MATH 272B,A00,098045,Holst; Michael J,13,0,15,2
1668388273496,MATH 273A,A00,098046,Tian; Xiaochuan,10,0,15,5
1668388273923,MATH 275,A01,098048,Tian; Xiaochuan,6,0,10,4
1668388274346,MATH 278A,A00,098049,Holst; Michael J,8,0,10,2
1668388274773,MATH 278B,A00,098050,Cloninger; Alexander,10,0,10,0
1668388275197,MATH 278C,A00,098051,Nie; Jiawang,7,0,10,3
1668388275621,MATH 280B,A00,098052,Zheng; Tianyi,8,0,15,7
1668388276043,MATH 281B,A00,098053,Bradic; Jelena,0,0,15,15
1668388276469,MATH 282B,A00,098054,Arias-Castro; Ery,0,0,15,15
1668388276896,MATH 285,A00,098055,Fitzsimmons; Patrick J,0,0,15,17
1668388277323,MATH 287B,A00,098056,Arias-Castro; Ery,2,0,15,13
1668388277749,MATH 288,A00,098057,Agarwal; Pooja,9,0,10,1
1668388277749,MATH 288,B00,098058,Zhang; Danna,8,0,10,2
1668388277749,MATH 288,C00,098059,Williams; Ruth J,9,0,10,1
1668388278172,MATH 290B,A00,098060,Roberts; Justin Deritter,13,0,15,2
1668388278600,MATH 292,A00,098061,Belmont; Eva Kinoshita,10,0,10,0
1668388279039,MATH 295,A00,098062,Suk; Andrew Hoon,48,0,50,2
1668388279464,MATH 296,A00,098063,Novak; Jonathan I,20,0,20,0
1668388279889,MATH 297,001,098064,Gamst; Anthony Collins,9997,0,9999,2
1668388781619,COGS 205,A00,101395,Chiba; Andrea,19,0,20,1
1668388782052,COGS 210B,001,101404,Greene; Deanna Jacquelyn,9998,0,9999,1
1668388782052,COGS 210B,002,101417,Xia; Haijun,9999,0,9999,0
1668388782052,COGS 210B,003,101422,Nitz; Douglas A.,9999,0,9999,0
1668388782052,COGS 210B,004,101423,Hollan; James D.,9998,0,9999,1
1668388782052,COGS 210B,005,101424,Deak; Gedeon O.,9998,0,9999,1
1668388782052,COGS 210B,006,101425,Rossano; Federico,9999,0,9999,0
1668388782477,COGS 211B,A00,101427,Coulson; Seana M,9996,0,9999,3
1668388782902,COGS 220,A00,101428,Hollan; James D.,0,0,25,25
1668388783335,COGS 229,A00,101429,Dow; Steven P,18,0,25,7
1668388783758,COGS 230,A00,101430,Klemmer; Scott R,11,0,17,6
1668388784184,COGS 234,A00,101431,Xia; Haijun,1,0,25,24
1668388784611,COGS 260,A00,101432,Kiyonaga; Anastasia,21,0,25,4
1668388784611,COGS 260,B00,101433,Kirsh; David Joel,15,0,25,10
1668388785046,CSE 202,A00,102371,Impagliazzo; Russell,0,0,0,0
1668388785471,CSE 203B,A01,102373,Cheng; Chung Kuan,0,0,0,0
1668388785895,CSE 208,A00,102374,Micciancio; Daniele,0,0,0,0
1668388786324,CSE 209A,A00,112895,Impagliazzo; Russell,0,0,15,15
1668388786760,CSE 209B,A00,108005,Bellare; Mihir,0,0,0,0
1668388787186,CSE 210,A00,113163,Coblenz; Michael J,0,0,0,0
1668388787622,CSE 219,A00,106111,Dow; Steven P,0,0,20,20
1668388788046,CSE 221,A00,102376,Voelker; Geoffrey M.,0,0,0,0
1668388788474,CSE 224,A01,102378,Porter; George M,0,0,0,0
1668388788897,CSE 229A,A00,102379,Savage; Stefan,0,0,0,0
1668388789321,CSE 229C,A00,102380,Munyaka; Imani N. S.,0,0,0,0
1668388789746,CSE 232B,A00,102382,Deutsch; Alin Bernard,0,0,0,0
1668388790174,CSE 234,A01,112904,Kumar; Arun Kumar,0,0,0,0
1668388790703,CSE 237A,A00,102383,Rosing; Tajana Simunic,0,0,0,0
1668388791127,CSE 239A,A00,102384,Deutsch; Alin Bernard,0,0,0,0
1668388791554,CSE 239B,A00,102385,Polikarpova; Nadezhda,0,0,0,0
1668388791981,CSE 240A,A00,102386,Pannuto; Patrick William,0,0,0,0
1668388792403,CSE 240B,A00,102387,Zhao; Jishen,0,0,0,0
1668388792827,CSE 241A,A00,106406,Kang; Mingu,0,0,0,0
1668388793251,CSE 249B,A00,102388,Kahng; Andrew Byun,0,0,8,8
1668388793678,CSE 251B,A01,102392,Cottrell; Garrison W,0,0,0,0
1668388793678,CSE 251B,A02,102393,Cottrell; Garrison W,0,0,0,0
1668388794102,CSE 252B,A00,102394,Ochoa; Benjamin Lawrence,0,0,0,0
1668388794533,CSE 257,A01,102396,Gao; Sicun,0,0,0,0
1668388794964,CSE 272,A00,102397,Li; Tzumao,0,0,0,0
1668388795387,CSE 274,A00,111323,Chern; Albert Ren-Haur,0,0,0,0
1668388795818,CSE 282,A00,102398,Pevzner; Pavel Arkadjevich,0,0,0,0
1668388796244,CSE 284,A00,114175,Gymrek; Melissa Ann,0,0,0,0
1668388796667,CSE 290,A00,102399,Chandraker; Manmohan Krishna,0,0,0,0
1668388796667,CSE 290,B00,102400,Vaccaro; Kristen Marie,0,0,25,25
1668388796667,CSE 290,C00,102414,Pannuto; Patrick William,0,0,25,25
1668388796667,CSE 290,D00,102427,Pevzner; Pavel Arkadjevich,0,0,0,0
1668388796667,CSE 290,E00,102429,Zhao; Jishen,0,0,0,0
1668388796667,CSE 290,F00,102436,Tullsen; Dean Michael,0,0,0,0
1668388796667,CSE 290,G00,102440,Christensen; Henrik I,0,0,20,20
1668388797104,CSE 291,A00,102443,Su; Hao,0,0,0,0
1668388797104,CSE 291,B00,102448,Polikarpova; Nadezhda,0,0,0,0
1668388797104,CSE 291,C00,102453,Vaccaro; Kristen Marie,0,0,0,0
1668388797104,CSE 291,D00,111343,Savage; Stefan,0,0,0,0
1668388797104,CSE 291,E00,116474,Claffy; Kimberly Claire,0,0,0,0
1668388797104,CSE 291,F00,116479,Pasquale; Joseph,0,0,0,0
1668388797533,CSE 293,001,119111,Bafna; Vineet,9999,0,9999,0
1668388797533,CSE 293,002,119118,Bellare; Mihir,9999,0,9999,0
1668388797533,CSE 293,003,119122,Berg-Kirkpatrick; Taylor D,9999,0,9999,0
1668388797533,CSE 293,004,119135,Christensen; Henrik I,9999,0,9999,0
1668388797533,CSE 293,005,119142,Cottrell; Garrison W,9999,0,9999,0
1668388797533,CSE 293,006,119146,Deutsch; Alin Bernard,9999,0,9999,0
1668388797533,CSE 293,007,119159,Esmaeilzadeh; Hadi,9999,0,9999,0
1668388797533,CSE 293,008,119166,Freund; Yoav,9999,0,9999,0
1668388797533,CSE 293,009,119170,Griswold; William G.,9999,0,9999,0
1668388797533,CSE 293,010,119183,Gymrek; Melissa Ann,9999,0,9999,0
1668388797533,CSE 293,011,119190,Heninger; Nadia A,9999,0,9999,0
1668388797533,CSE 293,012,119230,Impagliazzo; Russell,9999,0,9999,0
1668388797533,CSE 293,013,119232,Jhala; Ranjit,9999,0,9999,0
1668388797533,CSE 293,014,119233,Kahng; Andrew Byun,9999,0,9999,0
1668388797533,CSE 293,015,119298,Kane; Daniel Mertz,9999,0,9999,0
1668388797533,CSE 293,016,119299,Kriegman; David J,9999,0,9999,0
1668388797533,CSE 293,017,119300,Kumar; Arun Kumar,9999,0,9999,0
1668388797533,CSE 293,018,119301,Lerner; Sorin,9999,0,9999,0
1668388797533,CSE 293,019,119302,Lovett; Shachar,9999,0,9999,0
1668388797533,CSE 293,020,119303,McAuley; Julian John,9999,0,9999,0
1668388797533,CSE 293,021,119304,Micciancio; Daniele,9999,0,9999,0
1668388797533,CSE 293,022,119367,Orailoglu; Alex,9999,0,9999,0
1668388797533,CSE 293,023,119382,Paturi; Ramamohan,9999,0,9999,0
1668388797533,CSE 293,024,119404,Polikarpova; Nadezhda,9999,0,9999,0
1668388797533,CSE 293,025,119406,Politz; Joseph Gibbs,9999,0,9999,0
1668388797533,CSE 293,026,119411,Porter; George M,9999,0,9999,0
1668388797533,CSE 293,027,119414,Porter; Leonard Emerson,9999,0,9999,0
1668388797533,CSE 293,028,119416,Ramamoorthi; Ravi,9999,0,9999,0
1668388797533,CSE 293,029,119417,Sahoo; Debashis,9999,0,9999,0
1668388797533,CSE 293,030,119420,Saul; Lawrence,9999,0,9999,0
1668388797533,CSE 293,031,119421,Savage; Stefan,9999,0,9999,0
1668388797533,CSE 293,032,119425,Schulze; Jurgen P.,9999,0,9999,0
1668388797533,CSE 293,033,119426,Snoeren; Alex C.,9999,0,9999,0
1668388797533,CSE 293,034,119428,Shang; Jingbo,9999,0,9999,0
1668388797533,CSE 293,035,119430,Stefan; Deian,9999,0,9999,0
1668388797533,CSE 293,036,119431,Su; Hao,9999,0,9999,0
1668388797533,CSE 293,037,119433,Swanson; Steven James,9999,0,9999,0
1668388797533,CSE 293,038,119435,Tullsen; Dean Michael,9999,0,9999,0
1668388797533,CSE 293,039,119483,Voelker; Geoffrey M.,9999,0,9999,0
1668388797533,CSE 293,040,119537,Zhao; Jishen,9999,0,9999,0
1668388797533,CSE 293,041,119538,Zhou; Yuan-Yuan,9999,0,9999,0
1668388797533,CSE 293,042,119539,Gao; Sicun,9999,0,9999,0
1668388797533,CSE 293,043,119540,Weibel; Nadir,9999,0,9999,0
1668388797533,CSE 293,044,119541,Gupta; Rajesh K.,9999,0,9999,0
1668388797533,CSE 293,045,126410,Vaccaro; Kristen Marie,9999,0,9999,0
1668388797533,CSE 293,046,126411,Klemke; Richard,9999,0,9999,0
1668388797959,CSE 294,A00,102459,Voelker; Geoffrey M.,0,0,0,0
1668388797959,CSE 294,B00,111322,Orailoglu; Alex,0,0,0,0
1668388798385,DSE 201,A00,096914,Deutsch; Alin Bernard,30,0,30,0
1668388798815,DSE 210,A00,096915,Dasgupta; Sanjoy,30,0,30,0
1668388799240,DSE 260A,A00,096916,Altintas De Callaf; Ilkay,30,0,30,0
1668388799678,ECE 200,001,103586,Antipa; Nicholas A,9999,0,9999,0
1668388799678,ECE 200,002,103587,Atanasov; Nikolay A.,9999,0,9999,0
1668388799678,ECE 200,003,103588,Bharadia; Dinesh,9999,0,9999,0
1668388799678,ECE 200,004,103589,Cheng; Chung Kuan,9999,0,9999,0
1668388799678,ECE 200,005,103590,Cosman; Pamela C.,9999,0,9999,0
1668388799678,ECE 200,006,103591,Dayeh; Shadi Ahmad,9999,0,9999,0
1668388799678,ECE 200,007,103592,Fainman; Yeshaiahu,9999,0,9999,0
1668388799678,ECE 200,008,103593,Ford; Joseph Earl,9999,0,9999,0
1668388799678,ECE 200,009,103594,Franceschetti; Massimo,9999,0,9999,0
1668388799678,ECE 200,010,103595,Fullerton; Eric E,9999,0,9999,0
1668388799678,ECE 200,011,103596,Galton; Ian A,9999,0,9999,0
1668388799678,ECE 200,012,103597,Gilja; Vikash,9999,0,9999,0
1668388799678,ECE 200,013,103598,Hall; Drew A.,9999,0,9999,0
1668388799678,ECE 200,014,103599,Hsueh; Tzu-Chien,9999,0,9999,0
1668388799678,ECE 200,015,103600,Javidi; Tara,9999,0,9999,0
1668388799678,ECE 200,016,103601,Kahng; Andrew Byun,9999,0,9999,0
1668388799678,ECE 200,017,103602,Kim; Young-Han,9999,0,9999,0
1668388799678,ECE 200,018,103603,Koushanfar; Farinaz,9999,0,9999,0
1668388799678,ECE 200,019,103604,Kuzum; Duygu,9999,0,9999,0
1668388799678,ECE 200,020,103605,Le; Hanh-Phuc,9999,0,9999,0
1668388799678,ECE 200,021,103606,Lin; Bill,9999,0,9999,0
1668388799678,ECE 200,022,103607,Liu; Zhaowei,9998,0,9999,1
1668388799678,ECE 200,023,103608,Lo; Yu-Hwa,9999,0,9999,0
1668388799678,ECE 200,024,103609,Lomakin; Vitaliy,9999,0,9999,0
1668388799678,ECE 200,025,103610,Mercier; Patrick Philip,9999,0,9999,0
1668388799678,ECE 200,026,103611,Meyer; Florian,9999,0,9999,0
1668388799678,ECE 200,027,103612,Milstein; Laurence B.,9999,0,9999,0
1668388799678,ECE 200,028,103613,Mir Arabbaygi; Siavash,9999,0,9999,0
1668388799678,ECE 200,029,103614,Mookherjea; Shayan,9999,0,9999,0
1668388799678,ECE 200,030,103615,Morris; Karcher William,9999,0,9999,0
1668388799678,ECE 200,031,103616,Ng; Tse Nga,9999,0,9999,0
1668388799678,ECE 200,032,103617,Nguyen; Truong Quang,9999,0,9999,0
1668388799678,ECE 200,033,103618,Nomura; Kenji,9999,0,9999,0
1668388799678,ECE 200,034,103619,Orlitsky; Alon,9999,0,9999,0
1668388799678,ECE 200,035,103620,Pal; Piya,9999,0,9999,0
1668388799678,ECE 200,036,103621,Papen; George C.,9999,0,9999,0
1668388799678,ECE 200,037,103622,Radic; Stojan,9999,0,9999,0
1668388799678,ECE 200,038,103623,Rao; Bhaskar D.,9999,0,9999,0
1668388799678,ECE 200,039,103624,Rao; Ramesh R,9999,0,9999,0
1668388799678,ECE 200,040,103625,Rebeiz; Gabriel,9999,0,9999,0
1668388799678,ECE 200,041,103626,Sanford; John R,9999,0,9999,0
1668388799678,ECE 200,042,103627,Siegel; Paul H.,9999,0,9999,0
1668388799678,ECE 200,043,103628,Sievenpiper; Daniel F.,9999,0,9999,0
1668388799678,ECE 200,044,103629,Sworder; David D.,9999,0,9999,0
1668388799678,ECE 200,045,103630,Taur; Yuan,9999,0,9999,0
1668388799678,ECE 200,046,103631,Touri; Behrouz,9999,0,9999,0
1668388799678,ECE 200,047,103632,Trivedi; Mohan M.,9999,0,9999,0
1668388799678,ECE 200,048,103633,Vasconcelos; Nuno,9999,0,9999,0
1668388799678,ECE 200,049,103634,Wang; Xiaolong,9999,0,9999,0
1668388799678,ECE 200,050,103635,Xie; Pengtao,9999,0,9999,0
1668388799678,ECE 200,051,103636,Yip; Michael,9999,0,9999,0
1668388799678,ECE 200,052,103637,Zeger; Kenneth A.,999,0,999,0
1668388799678,ECE 200,053,103638,Zhang; Xinyu,9999,0,9999,0
1668388799678,ECE 200,054,103639,Turakhia; Yatish Girish,9999,0,9999,0
1668388799678,ECE 200,055,103640,Kang; Mingu,9999,0,9999,0
1668388799678,ECE 200,056,103641,Shi; Yuanyuan,9999,0,9999,0
1668388799678,ECE 200,057,103642,Wang; Edward Jay,9999,0,9999,0
1668388799678,ECE 200,058,103643,Zheng; Yang,9999,0,9999,0
1668388800101,ECE 202,A00,103644,Kuzum; Duygu,0,0,0,0
1668388800539,ECE 212BN,A00,103646,Ng; Tse Nga,0,0,0,0
1668388800972,ECE 221,A00,111493,Staff,0,0,0,0
1668388801404,ECE 222B,A00,103647,Lomakin; Vitaliy,0,0,0,0
1668388801825,ECE 230B,A00,103648,Taur; Yuan,0,0,0,0
1668388802255,ECE 238B,A00,103649,Garay; Javier,0,0,0,0
1668388802678,ECE 240B,A00,112900,Fainman; Yeshaiahu,0,0,0,0
1668388803116,ECE 247A,A00,103650,Jokerst; Jesse Vincent,0,0,0,0
1668388803545,ECE 247B,A00,103651,Wang; Joseph,0,0,0,0
1668388803970,ECE 250,A00,103652,Siegel; Paul H.,0,0,0,0
1668388804394,ECE 251A,A00,103654,Rao; Bhaskar D.,0,0,0,0
1668388804817,ECE 257B,A00,103655,Bharadia; Dinesh,0,0,0,0
1668388805253,ECE 258A,A00,103656,Milstein; Laurence B.,0,0,0,0
1668388805675,ECE 260B,A00,103658,Kang; Mingu,0,0,0,0
1668388806099,ECE 264A,A00,103659,Galton; Ian A,0,0,0,0
1668388806526,ECE 265A,A00,103661,Gudem; Prasad S.S.,0,0,0,0
1668388806949,ECE 265D,A00,103662,Gudem; Prasad S.S.,0,0,0,0
1668388807376,ECE 268,A00,103663,Koushanfar; Farinaz,0,0,0,0
1668388807802,ECE 269,A01,103665,Pal; Piya,0,0,0,0
1668388808227,ECE 271B,A00,103666,Vasconcelos; Manuela,0,0,0,0
1668388808651,ECE 276A,A00,103667,Atanasov; Nikolay A.,0,0,0,0
1668388809075,ECE 277,A00,103668,An; Cheolhong,0,0,0,0
1668388809499,ECE 279,A00,117947,Hall; Drew A.,0,0,0,0
1668388810349,ECE 283,A00,103670,Hsueh; Tzu-Chien,0,0,0,0
1668388810772,ECE 284,A00,103671,Turakhia; Yatish Girish,0,0,0,0
1668388811196,ECE 285,A00,103672,Zheng; Yang,0,0,0,0
1668388811196,ECE 285,B00,103673,Sworder; David D.,0,0,0,0
1668388811622,ECE 287,A00,103676,Javidi; Tara,0,0,0,0
1668388812047,MATH 200B,A00,098023,Salehi Golsefidy; Alireza,12,0,15,3
1668388812472,MATH 202B,A00,098024,Rhoades; Brendon Patrick,9,0,15,6
1668388812905,MATH 203B,A00,098025,Oprea; Dragos N.,10,0,15,5
1668388813333,MATH 204B,A00,098026,Sorensen; Claus M,13,0,15,2
1668388813756,MATH 208,A00,098027,Izadi; Elham,7,0,10,3
1668388814184,MATH 209,A00,098028,Pollack; Aaron,10,0,10,0
1668388814617,MATH 211A,A00,112919,Rogalski; Daniel,9,0,10,1
1668388815039,MATH 211B,A00,112920,Seward; Brandon M.,9,0,10,1
1668388815468,MATH 218,A00,098029,Li; Bo,10,0,10,0
1668388815900,MATH 220B,A00,098030,Novak; Jonathan I,11,0,15,4
1668388816328,MATH 221A,A00,098031,Ebenfelt; Peter F,13,0,15,2
1668388816751,MATH 231B,A00,098032,Zlatos; Andrej,12,0,15,3
1668388817188,MATH 240B,A00,098033,Ni; Lei,9,0,15,6
1668388817610,MATH 243,A00,098034,Jekel; David Andrew,10,0,10,0
1668388818037,MATH 245A,A00,098035,Nie; Jiawang,0,0,15,16
1668388818460,MATH 248,A00,098036,Bejenaru; Ioan,10,0,10,0
1668388818883,MATH 250B,A00,098037,Spolaor; Luca,14,0,15,1
1668388819307,MATH 258,A00,098038,Ni; Lei,10,0,10,0
1668388819731,MATH 264B,A00,098041,Rhoades; Brendon Patrick,9,0,15,6
1668388820152,MATH 268,A00,098042,Buss; Samuel R,10,0,10,0
1668388820575,MATH 269,A00,098043,Rhoades; Brendon Patrick,10,0,10,0
1668388821002,MATH 270B,A00,098044,Li; Bo,10,0,15,5
1668388821432,MATH 272B,A00,098045,Holst; Michael J,13,0,15,2
1668388821866,MATH 273A,A00,098046,Tian; Xiaochuan,10,0,15,5
1668388822303,MATH 275,A01,098048,Tian; Xiaochuan,6,0,10,4
1668388822726,MATH 278A,A00,098049,Holst; Michael J,8,0,10,2
1668388823149,MATH 278B,A00,098050,Cloninger; Alexander,10,0,10,0
1668388823580,MATH 278C,A00,098051,Nie; Jiawang,7,0,10,3
1668388824005,MATH 280B,A00,098052,Zheng; Tianyi,8,0,15,7
1668388824430,MATH 281B,A00,098053,Bradic; Jelena,0,0,15,15
1668388824856,MATH 282B,A00,098054,Arias-Castro; Ery,0,0,15,15
1668388825282,MATH 285,A00,098055,Fitzsimmons; Patrick J,0,0,15,17
1668388825709,MATH 287B,A00,098056,Arias-Castro; Ery,2,0,15,13
1668388826134,MATH 288,A00,098057,Agarwal; Pooja,9,0,10,1
1668388826134,MATH 288,B00,098058,Zhang; Danna,8,0,10,2
1668388826134,MATH 288,C00,098059,Williams; Ruth J,9,0,10,1
1668388826558,MATH 290B,A00,098060,Roberts; Justin Deritter,13,0,15,2
1668388826984,MATH 292,A00,098061,Belmont; Eva Kinoshita,10,0,10,0
1668388827409,MATH 295,A00,098062,Suk; Andrew Hoon,48,0,50,2
1668388827833,MATH 296,A00,098063,Novak; Jonathan I,20,0,20,0
1668388828274,MATH 297,001,098064,Gamst; Anthony Collins,9997,0,9999,2
1668389329155,COGS 205,A00,101395,Chiba; Andrea,19,0,20,1
1668389329594,COGS 210B,001,101404,Greene; Deanna Jacquelyn,9998,0,9999,1
1668389329594,COGS 210B,002,101417,Xia; Haijun,9999,0,9999,0
1668389329594,COGS 210B,003,101422,Nitz; Douglas A.,9999,0,9999,0
1668389329594,COGS 210B,004,101423,Hollan; James D.,9998,0,9999,1
1668389329594,COGS 210B,005,101424,Deak; Gedeon O.,9998,0,9999,1
1668389329594,COGS 210B,006,101425,Rossano; Federico,9999,0,9999,0
1668389330019,COGS 211B,A00,101427,Coulson; Seana M,9996,0,9999,3
1668389330445,COGS 220,A00,101428,Hollan; James D.,0,0,25,25
1668389330869,COGS 229,A00,101429,Dow; Steven P,18,0,25,7
1668389331292,COGS 230,A00,101430,Klemmer; Scott R,11,0,17,6
1668389331723,COGS 234,A00,101431,Xia; Haijun,1,0,25,24
1668389332148,COGS 260,A00,101432,Kiyonaga; Anastasia,21,0,25,4
1668389332148,COGS 260,B00,101433,Kirsh; David Joel,15,0,25,10
1668389332574,CSE 202,A00,102371,Impagliazzo; Russell,0,0,0,0
1668389332998,CSE 203B,A01,102373,Cheng; Chung Kuan,0,0,0,0
1668389333422,CSE 208,A00,102374,Micciancio; Daniele,0,0,0,0
1668389333854,CSE 209A,A00,112895,Impagliazzo; Russell,0,0,15,15
1668389334281,CSE 209B,A00,108005,Bellare; Mihir,0,0,0,0
1668389334713,CSE 210,A00,113163,Coblenz; Michael J,0,0,0,0
1668389335138,CSE 219,A00,106111,Dow; Steven P,0,0,20,20
1668389335569,CSE 221,A00,102376,Voelker; Geoffrey M.,0,0,0,0
1668389335994,CSE 224,A01,102378,Porter; George M,0,0,0,0
1668389336421,CSE 229A,A00,102379,Savage; Stefan,0,0,0,0
1668389336853,CSE 229C,A00,102380,Munyaka; Imani N. S.,0,0,0,0
1668389337291,CSE 232B,A00,102382,Deutsch; Alin Bernard,0,0,0,0
1668389337715,CSE 234,A01,112904,Kumar; Arun Kumar,0,0,0,0
1668389338142,CSE 237A,A00,102383,Rosing; Tajana Simunic,0,0,0,0
1668389338566,CSE 239A,A00,102384,Deutsch; Alin Bernard,0,0,0,0
1668389338990,CSE 239B,A00,102385,Polikarpova; Nadezhda,0,0,0,0
1668389339416,CSE 240A,A00,102386,Pannuto; Patrick William,0,0,0,0
1668389339843,CSE 240B,A00,102387,Zhao; Jishen,0,0,0,0
1668389340268,CSE 241A,A00,106406,Kang; Mingu,0,0,0,0
1668389340692,CSE 249B,A00,102388,Kahng; Andrew Byun,0,0,8,8
1668389341117,CSE 251B,A01,102392,Cottrell; Garrison W,0,0,0,0
1668389341117,CSE 251B,A02,102393,Cottrell; Garrison W,0,0,0,0
1668389341539,CSE 252B,A00,102394,Ochoa; Benjamin Lawrence,0,0,0,0
1668389341964,CSE 257,A01,102396,Gao; Sicun,0,0,0,0
1668389342387,CSE 272,A00,102397,Li; Tzumao,0,0,0,0
1668389342812,CSE 274,A00,111323,Chern; Albert Ren-Haur,0,0,0,0
1668389343239,CSE 282,A00,102398,Pevzner; Pavel Arkadjevich,0,0,0,0
1668389343662,CSE 284,A00,114175,Gymrek; Melissa Ann,0,0,0,0
1668389344090,CSE 290,A00,102399,Chandraker; Manmohan Krishna,0,0,0,0
1668389344090,CSE 290,B00,102400,Vaccaro; Kristen Marie,0,0,25,25
1668389344090,CSE 290,C00,102414,Pannuto; Patrick William,0,0,25,25
1668389344090,CSE 290,D00,102427,Pevzner; Pavel Arkadjevich,0,0,0,0
1668389344090,CSE 290,E00,102429,Zhao; Jishen,0,0,0,0
1668389344090,CSE 290,F00,102436,Tullsen; Dean Michael,0,0,0,0
1668389344090,CSE 290,G00,102440,Christensen; Henrik I,0,0,20,20
1668389344529,CSE 291,A00,102443,Su; Hao,0,0,0,0
1668389344529,CSE 291,B00,102448,Polikarpova; Nadezhda,0,0,0,0
1668389344529,CSE 291,C00,102453,Vaccaro; Kristen Marie,0,0,0,0
1668389344529,CSE 291,D00,111343,Savage; Stefan,0,0,0,0
1668389344529,CSE 291,E00,116474,Claffy; Kimberly Claire,0,0,0,0
1668389344529,CSE 291,F00,116479,Pasquale; Joseph,0,0,0,0
1668389344957,CSE 293,001,119111,Bafna; Vineet,9999,0,9999,0
1668389344957,CSE 293,002,119118,Bellare; Mihir,9999,0,9999,0
1668389344957,CSE 293,003,119122,Berg-Kirkpatrick; Taylor D,9999,0,9999,0
1668389344957,CSE 293,004,119135,Christensen; Henrik I,9999,0,9999,0
1668389344957,CSE 293,005,119142,Cottrell; Garrison W,9999,0,9999,0
1668389344957,CSE 293,006,119146,Deutsch; Alin Bernard,9999,0,9999,0
1668389344957,CSE 293,007,119159,Esmaeilzadeh; Hadi,9999,0,9999,0
1668389344957,CSE 293,008,119166,Freund; Yoav,9999,0,9999,0
1668389344957,CSE 293,009,119170,Griswold; William G.,9999,0,9999,0
1668389344957,CSE 293,010,119183,Gymrek; Melissa Ann,9999,0,9999,0
1668389344957,CSE 293,011,119190,Heninger; Nadia A,9999,0,9999,0
1668389344957,CSE 293,012,119230,Impagliazzo; Russell,9999,0,9999,0
1668389344957,CSE 293,013,119232,Jhala; Ranjit,9999,0,9999,0
1668389344957,CSE 293,014,119233,Kahng; Andrew Byun,9999,0,9999,0
1668389344957,CSE 293,015,119298,Kane; Daniel Mertz,9999,0,9999,0
1668389344957,CSE 293,016,119299,Kriegman; David J,9999,0,9999,0
1668389344957,CSE 293,017,119300,Kumar; Arun Kumar,9999,0,9999,0
1668389344957,CSE 293,018,119301,Lerner; Sorin,9999,0,9999,0
1668389344957,CSE 293,019,119302,Lovett; Shachar,9999,0,9999,0
1668389344957,CSE 293,020,119303,McAuley; Julian John,9999,0,9999,0
1668389344957,CSE 293,021,119304,Micciancio; Daniele,9999,0,9999,0
1668389344957,CSE 293,022,119367,Orailoglu; Alex,9999,0,9999,0
1668389344957,CSE 293,023,119382,Paturi; Ramamohan,9999,0,9999,0
1668389344957,CSE 293,024,119404,Polikarpova; Nadezhda,9999,0,9999,0
1668389344957,CSE 293,025,119406,Politz; Joseph Gibbs,9999,0,9999,0
1668389344957,CSE 293,026,119411,Porter; George M,9999,0,9999,0
1668389344957,CSE 293,027,119414,Porter; Leonard Emerson,9999,0,9999,0
1668389344957,CSE 293,028,119416,Ramamoorthi; Ravi,9999,0,9999,0
1668389344957,CSE 293,029,119417,Sahoo; Debashis,9999,0,9999,0
1668389344957,CSE 293,030,119420,Saul; Lawrence,9999,0,9999,0
1668389344957,CSE 293,031,119421,Savage; Stefan,9999,0,9999,0
1668389344957,CSE 293,032,119425,Schulze; Jurgen P.,9999,0,9999,0
1668389344957,CSE 293,033,119426,Snoeren; Alex C.,9999,0,9999,0
1668389344957,CSE 293,034,119428,Shang; Jingbo,9999,0,9999,0
1668389344957,CSE 293,035,119430,Stefan; Deian,9999,0,9999,0
1668389344957,CSE 293,036,119431,Su; Hao,9999,0,9999,0
1668389344957,CSE 293,037,119433,Swanson; Steven James,9999,0,9999,0
1668389344957,CSE 293,038,119435,Tullsen; Dean Michael,9999,0,9999,0
1668389344957,CSE 293,039,119483,Voelker; Geoffrey M.,9999,0,9999,0
1668389344957,CSE 293,040,119537,Zhao; Jishen,9999,0,9999,0
1668389344957,CSE 293,041,119538,Zhou; Yuan-Yuan,9999,0,9999,0
1668389344957,CSE 293,042,119539,Gao; Sicun,9999,0,9999,0
1668389344957,CSE 293,043,119540,Weibel; Nadir,9999,0,9999,0
1668389344957,CSE 293,044,119541,Gupta; Rajesh K.,9999,0,9999,0
1668389344957,CSE 293,045,126410,Vaccaro; Kristen Marie,9999,0,9999,0
1668389344957,CSE 293,046,126411,Klemke; Richard,9999,0,9999,0
1668389345398,CSE 294,A00,102459,Voelker; Geoffrey M.,0,0,0,0
1668389345398,CSE 294,B00,111322,Orailoglu; Alex,0,0,0,0
1668389345821,DSE 201,A00,096914,Deutsch; Alin Bernard,30,0,30,0
1668389346244,DSE 210,A00,096915,Dasgupta; Sanjoy,30,0,30,0
1668389346674,DSE 260A,A00,096916,Altintas De Callaf; Ilkay,30,0,30,0
1668389347102,ECE 200,001,103586,Antipa; Nicholas A,9999,0,9999,0
1668389347102,ECE 200,002,103587,Atanasov; Nikolay A.,9999,0,9999,0
1668389347102,ECE 200,003,103588,Bharadia; Dinesh,9999,0,9999,0
1668389347102,ECE 200,004,103589,Cheng; Chung Kuan,9999,0,9999,0
1668389347102,ECE 200,005,103590,Cosman; Pamela C.,9999,0,9999,0
1668389347102,ECE 200,006,103591,Dayeh; Shadi Ahmad,9999,0,9999,0
1668389347102,ECE 200,007,103592,Fainman; Yeshaiahu,9999,0,9999,0
1668389347102,ECE 200,008,103593,Ford; Joseph Earl,9999,0,9999,0
1668389347102,ECE 200,009,103594,Franceschetti; Massimo,9999,0,9999,0
1668389347102,ECE 200,010,103595,Fullerton; Eric E,9999,0,9999,0
1668389347102,ECE 200,011,103596,Galton; Ian A,9999,0,9999,0
1668389347102,ECE 200,012,103597,Gilja; Vikash,9999,0,9999,0
1668389347102,ECE 200,013,103598,Hall; Drew A.,9999,0,9999,0
1668389347102,ECE 200,014,103599,Hsueh; Tzu-Chien,9999,0,9999,0
1668389347102,ECE 200,015,103600,Javidi; Tara,9999,0,9999,0
1668389347102,ECE 200,016,103601,Kahng; Andrew Byun,9999,0,9999,0
1668389347102,ECE 200,017,103602,Kim; Young-Han,9999,0,9999,0
1668389347102,ECE 200,018,103603,Koushanfar; Farinaz,9999,0,9999,0
1668389347102,ECE 200,019,103604,Kuzum; Duygu,9999,0,9999,0
1668389347102,ECE 200,020,103605,Le; Hanh-Phuc,9999,0,9999,0
1668389347102,ECE 200,021,103606,Lin; Bill,9999,0,9999,0
1668389347102,ECE 200,022,103607,Liu; Zhaowei,9998,0,9999,1
1668389347102,ECE 200,023,103608,Lo; Yu-Hwa,9999,0,9999,0
1668389347102,ECE 200,024,103609,Lomakin; Vitaliy,9999,0,9999,0
1668389347102,ECE 200,025,103610,Mercier; Patrick Philip,9999,0,9999,0
1668389347102,ECE 200,026,103611,Meyer; Florian,9999,0,9999,0
1668389347102,ECE 200,027,103612,Milstein; Laurence B.,9999,0,9999,0
1668389347102,ECE 200,028,103613,Mir Arabbaygi; Siavash,9999,0,9999,0
1668389347102,ECE 200,029,103614,Mookherjea; Shayan,9999,0,9999,0
1668389347102,ECE 200,030,103615,Morris; Karcher William,9999,0,9999,0
1668389347102,ECE 200,031,103616,Ng; Tse Nga,9999,0,9999,0
1668389347102,ECE 200,032,103617,Nguyen; Truong Quang,9999,0,9999,0
1668389347102,ECE 200,033,103618,Nomura; Kenji,9999,0,9999,0
1668389347102,ECE 200,034,103619,Orlitsky; Alon,9999,0,9999,0
1668389347102,ECE 200,035,103620,Pal; Piya,9999,0,9999,0
1668389347102,ECE 200,036,103621,Papen; George C.,9999,0,9999,0
1668389347102,ECE 200,037,103622,Radic; Stojan,9999,0,9999,0
1668389347102,ECE 200,038,103623,Rao; Bhaskar D.,9999,0,9999,0
1668389347102,ECE 200,039,103624,Rao; Ramesh R,9999,0,9999,0
1668389347102,ECE 200,040,103625,Rebeiz; Gabriel,9999,0,9999,0
1668389347102,ECE 200,041,103626,Sanford; John R,9999,0,9999,0
1668389347102,ECE 200,042,103627,Siegel; Paul H.,9999,0,9999,0
1668389347102,ECE 200,043,103628,Sievenpiper; Daniel F.,9999,0,9999,0
1668389347102,ECE 200,044,103629,Sworder; David D.,9999,0,9999,0
1668389347102,ECE 200,045,103630,Taur; Yuan,9999,0,9999,0
1668389347102,ECE 200,046,103631,Touri; Behrouz,9999,0,9999,0
1668389347102,ECE 200,047,103632,Trivedi; Mohan M.,9999,0,9999,0
1668389347102,ECE 200,048,103633,Vasconcelos; Nuno,9999,0,9999,0
1668389347102,ECE 200,049,103634,Wang; Xiaolong,9999,0,9999,0
1668389347102,ECE 200,050,103635,Xie; Pengtao,9999,0,9999,0
1668389347102,ECE 200,051,103636,Yip; Michael,9999,0,9999,0
1668389347102,ECE 200,052,103637,Zeger; Kenneth A.,999,0,999,0
1668389347102,ECE 200,053,103638,Zhang; Xinyu,9999,0,9999,0
1668389347102,ECE 200,054,103639,Turakhia; Yatish Girish,9999,0,9999,0
1668389347102,ECE 200,055,103640,Kang; Mingu,9999,0,9999,0
1668389347102,ECE 200,056,103641,Shi; Yuanyuan,9999,0,9999,0
1668389347102,ECE 200,057,103642,Wang; Edward Jay,9999,0,9999,0
1668389347102,ECE 200,058,103643,Zheng; Yang,9999,0,9999,0
1668389347529,ECE 202,A00,103644,Kuzum; Duygu,0,0,0,0
1668389347956,ECE 212BN,A00,103646,Ng; Tse Nga,0,0,0,0
1668389348382,ECE 221,A00,111493,Staff,0,0,0,0
1668389348809,ECE 222B,A00,103647,Lomakin; Vitaliy,0,0,0,0
1668389349232,ECE 230B,A00,103648,Taur; Yuan,0,0,0,0
1668389349664,ECE 238B,A00,103649,Garay; Javier,0,0,0,0
1668389350100,ECE 240B,A00,112900,Fainman; Yeshaiahu,0,0,0,0
1668389350533,ECE 247A,A00,103650,Jokerst; Jesse Vincent,0,0,0,0
1668389350957,ECE 247B,A00,103651,Wang; Joseph,0,0,0,0
1668389351386,ECE 250,A00,103652,Siegel; Paul H.,0,0,0,0
1668389351811,ECE 251A,A00,103654,Rao; Bhaskar D.,0,0,0,0
1668389352233,ECE 257B,A00,103655,Bharadia; Dinesh,0,0,0,0
1668389352659,ECE 258A,A00,103656,Milstein; Laurence B.,0,0,0,0
1668389353082,ECE 260B,A00,103658,Kang; Mingu,0,0,0,0
1668389353505,ECE 264A,A00,103659,Galton; Ian A,0,0,0,0
1668389353933,ECE 265A,A00,103661,Gudem; Prasad S.S.,0,0,0,0
1668389354356,ECE 265D,A00,103662,Gudem; Prasad S.S.,0,0,0,0
1668389354896,ECE 268,A00,103663,Koushanfar; Farinaz,0,0,0,0
1668389355322,ECE 269,A01,103665,Pal; Piya,0,0,0,0
1668389355746,ECE 271B,A00,103666,Vasconcelos; Manuela,0,0,0,0
1668389356172,ECE 276A,A00,103667,Atanasov; Nikolay A.,0,0,0,0
1668389356598,ECE 277,A00,103668,An; Cheolhong,0,0,0,0
1668389357025,ECE 279,A00,117947,Hall; Drew A.,0,0,0,0
1668389357882,ECE 283,A00,103670,Hsueh; Tzu-Chien,0,0,0,0
1668389358305,ECE 284,A00,103671,Turakhia; Yatish Girish,0,0,0,0
1668389358742,ECE 285,A00,103672,Zheng; Yang,0,0,0,0
1668389358742,ECE 285,B00,103673,Sworder; David D.,0,0,0,0
1668389359165,ECE 287,A00,103676,Javidi; Tara,0,0,0,0
1668389359593,MATH 200B,A00,098023,Salehi Golsefidy; Alireza,12,0,15,3
1668389360016,MATH 202B,A00,098024,Rhoades; Brendon Patrick,9,0,15,6
1668389360440,MATH 203B,A00,098025,Oprea; Dragos N.,10,0,15,5
1668389360863,MATH 204B,A00,098026,Sorensen; Claus M,13,0,15,2
1668389361287,MATH 208,A00,098027,Izadi; Elham,7,0,10,3
1668389361713,MATH 209,A00,098028,Pollack; Aaron,10,0,10,0
1668389362144,MATH 211A,A00,112919,Rogalski; Daniel,9,0,10,1
1668389362569,MATH 211B,A00,112920,Seward; Brandon M.,9,0,10,1
1668389362993,MATH 218,A00,098029,Li; Bo,10,0,10,0
1668389363420,MATH 220B,A00,098030,Novak; Jonathan I,11,0,15,4
1668389363844,MATH 221A,A00,098031,Ebenfelt; Peter F,13,0,15,2
1668389364268,MATH 231B,A00,098032,Zlatos; Andrej,12,0,15,3
1668389364698,MATH 240B,A00,098033,Ni; Lei,9,0,15,6
1668389365126,MATH 243,A00,098034,Jekel; David Andrew,10,0,10,0
1668389365550,MATH 245A,A00,098035,Nie; Jiawang,0,0,15,16
1668389365974,MATH 248,A00,098036,Bejenaru; Ioan,10,0,10,0
1668389366396,MATH 250B,A00,098037,Spolaor; Luca,14,0,15,1
1668389366821,MATH 258,A00,098038,Ni; Lei,10,0,10,0
1668389367248,MATH 264B,A00,098041,Rhoades; Brendon Patrick,9,0,15,6
1668389367670,MATH 268,A00,098042,Buss; Samuel R,10,0,10,0
1668389368094,MATH 269,A00,098043,Rhoades; Brendon Patrick,10,0,10,0
1668389368517,MATH 270B,A00,098044,Li; Bo,10,0,15,5
1668389368947,MATH 272B,A00,098045,Holst; Michael J,13,0,15,2
1668389369373,MATH 273A,A00,098046,Tian; Xiaochuan,10,0,15,5
1668389369795,MATH 275,A01,098048,Tian; Xiaochuan,6,0,10,4
1668389370220,MATH 278A,A00,098049,Holst; Michael J,8,0,10,2
1668389370647,MATH 278B,A00,098050,Cloninger; Alexander,10,0,10,0
1668389371076,MATH 278C,A00,098051,Nie; Jiawang,7,0,10,3
1668389371502,MATH 280B,A00,098052,Zheng; Tianyi,8,0,15,7
1668389371926,MATH 281B,A00,098053,Bradic; Jelena,0,0,15,15
1668389372353,MATH 282B,A00,098054,Arias-Castro; Ery,0,0,15,15
1668389372776,MATH 285,A00,098055,Fitzsimmons; Patrick J,0,0,15,17
1668389373210,MATH 287B,A00,098056,Arias-Castro; Ery,2,0,15,13
1668389373634,MATH 288,A00,098057,Agarwal; Pooja,9,0,10,1
1668389373634,MATH 288,B00,098058,Zhang; Danna,8,0,10,2
1668389373634,MATH 288,C00,098059,Williams; Ruth J,9,0,10,1
1668389374059,MATH 290B,A00,098060,Roberts; Justin Deritter,13,0,15,2
1668389374481,MATH 292,A00,098061,Belmont; Eva Kinoshita,10,0,10,0
1668389374911,MATH 295,A00,098062,Suk; Andrew Hoon,48,0,50,2
1668389375339,MATH 296,A00,098063,Novak; Jonathan I,20,0,20,0
1668389375762,MATH 297,001,098064,Gamst; Anthony Collins,9997,0,9999,2
1668389876261,COGS 205,A00,101395,Chiba; Andrea,19,0,20,1
1668389876688,COGS 210B,001,101404,Greene; Deanna Jacquelyn,9998,0,9999,1
1668389876688,COGS 210B,002,101417,Xia; Haijun,9999,0,9999,0
1668389876688,COGS 210B,003,101422,Nitz; Douglas A.,9999,0,9999,0
1668389876688,COGS 210B,004,101423,Hollan; James D.,9998,0,9999,1
1668389876688,COGS 210B,005,101424,Deak; Gedeon O.,9998,0,9999,1
1668389876688,COGS 210B,006,101425,Rossano; Federico,9999,0,9999,0
1668389877122,COGS 211B,A00,101427,Coulson; Seana M,9996,0,9999,3
1668389877545,COGS 220,A00,101428,Hollan; James D.,0,0,25,25
1668389877968,COGS 229,A00,101429,Dow; Steven P,18,0,25,7
1668389878406,COGS 230,A00,101430,Klemmer; Scott R,11,0,17,6
1668389878829,COGS 234,A00,101431,Xia; Haijun,1,0,25,24
1668389879253,COGS 260,A00,101432,Kiyonaga; Anastasia,21,0,25,4
1668389879253,COGS 260,B00,101433,Kirsh; David Joel,15,0,25,10
1668389879679,CSE 202,A00,102371,Impagliazzo; Russell,0,0,0,0
1668389880103,CSE 203B,A01,102373,Cheng; Chung Kuan,0,0,0,0
1668389880529,CSE 208,A00,102374,Micciancio; Daniele,0,0,0,0
1668389880962,CSE 209A,A00,112895,Impagliazzo; Russell,0,0,15,15
1668389881391,CSE 209B,A00,108005,Bellare; Mihir,0,0,0,0
1668389881818,CSE 210,A00,113163,Coblenz; Michael J,0,0,0,0
1668389882243,CSE 219,A00,106111,Dow; Steven P,0,0,20,20
1668389882672,CSE 221,A00,102376,Voelker; Geoffrey M.,0,0,0,0
1668389883107,CSE 224,A01,102378,Porter; George M,0,0,0,0
1668389883534,CSE 229A,A00,102379,Savage; Stefan,0,0,0,0
1668389883956,CSE 229C,A00,102380,Munyaka; Imani N. S.,0,0,0,0
1668389884383,CSE 232B,A00,102382,Deutsch; Alin Bernard,0,0,0,0
1668389884806,CSE 234,A01,112904,Kumar; Arun Kumar,0,0,0,0
1668389885233,CSE 237A,A00,102383,Rosing; Tajana Simunic,0,0,0,0
1668389885661,CSE 239A,A00,102384,Deutsch; Alin Bernard,0,0,0,0
1668389886086,CSE 239B,A00,102385,Polikarpova; Nadezhda,0,0,0,0
1668389886511,CSE 240A,A00,102386,Pannuto; Patrick William,0,0,0,0
1668389886941,CSE 240B,A00,102387,Zhao; Jishen,0,0,0,0
1668389887370,CSE 241A,A00,106406,Kang; Mingu,0,0,0,0
1668389887809,CSE 249B,A00,102388,Kahng; Andrew Byun,0,0,8,8
1668389888232,CSE 251B,A01,102392,Cottrell; Garrison W,0,0,0,0
1668389888232,CSE 251B,A02,102393,Cottrell; Garrison W,0,0,0,0
1668389888659,CSE 252B,A00,102394,Ochoa; Benjamin Lawrence,0,0,0,0
1668389889089,CSE 257,A01,102396,Gao; Sicun,0,0,0,0
1668389889512,CSE 272,A00,102397,Li; Tzumao,0,0,0,0
1668389889937,CSE 274,A00,111323,Chern; Albert Ren-Haur,0,0,0,0
1668389890360,CSE 282,A00,102398,Pevzner; Pavel Arkadjevich,0,0,0,0
1668389890787,CSE 284,A00,114175,Gymrek; Melissa Ann,0,0,0,0
1668389891214,CSE 290,A00,102399,Chandraker; Manmohan Krishna,0,0,0,0
1668389891214,CSE 290,B00,102400,Vaccaro; Kristen Marie,0,0,25,25
1668389891214,CSE 290,C00,102414,Pannuto; Patrick William,0,0,25,25
1668389891214,CSE 290,D00,102427,Pevzner; Pavel Arkadjevich,0,0,0,0
1668389891214,CSE 290,E00,102429,Zhao; Jishen,0,0,0,0
1668389891214,CSE 290,F00,102436,Tullsen; Dean Michael,0,0,0,0
1668389891214,CSE 290,G00,102440,Christensen; Henrik I,0,0,20,20
1668389891642,CSE 291,A00,102443,Su; Hao,0,0,0,0
1668389891642,CSE 291,B00,102448,Polikarpova; Nadezhda,0,0,0,0
1668389891642,CSE 291,C00,102453,Vaccaro; Kristen Marie,0,0,0,0
1668389891642,CSE 291,D00,111343,Savage; Stefan,0,0,0,0
1668389891642,CSE 291,E00,116474,Claffy; Kimberly Claire,0,0,0,0
1668389891642,CSE 291,F00,116479,Pasquale; Joseph,0,0,0,0
1668389892075,CSE 293,001,119111,Bafna; Vineet,9999,0,9999,0
1668389892075,CSE 293,002,119118,Bellare; Mihir,9999,0,9999,0
1668389892075,CSE 293,003,119122,Berg-Kirkpatrick; Taylor D,9999,0,9999,0
1668389892075,CSE 293,004,119135,Christensen; Henrik I,9999,0,9999,0
1668389892075,CSE 293,005,119142,Cottrell; Garrison W,9999,0,9999,0
1668389892075,CSE 293,006,119146,Deutsch; Alin Bernard,9999,0,9999,0
1668389892075,CSE 293,007,119159,Esmaeilzadeh; Hadi,9999,0,9999,0
1668389892075,CSE 293,008,119166,Freund; Yoav,9999,0,9999,0
1668389892075,CSE 293,009,119170,Griswold; William G.,9999,0,9999,0
1668389892075,CSE 293,010,119183,Gymrek; Melissa Ann,9999,0,9999,0
1668389892075,CSE 293,011,119190,Heninger; Nadia A,9999,0,9999,0
1668389892075,CSE 293,012,119230,Impagliazzo; Russell,9999,0,9999,0
1668389892075,CSE 293,013,119232,Jhala; Ranjit,9999,0,9999,0
1668389892075,CSE 293,014,119233,Kahng; Andrew Byun,9999,0,9999,0
1668389892075,CSE 293,015,119298,Kane; Daniel Mertz,9999,0,9999,0
1668389892075,CSE 293,016,119299,Kriegman; David J,9999,0,9999,0
1668389892075,CSE 293,017,119300,Kumar; Arun Kumar,9999,0,9999,0
1668389892075,CSE 293,018,119301,Lerner; Sorin,9999,0,9999,0
1668389892075,CSE 293,019,119302,Lovett; Shachar,9999,0,9999,0
1668389892075,CSE 293,020,119303,McAuley; Julian John,9999,0,9999,0
1668389892075,CSE 293,021,119304,Micciancio; Daniele,9999,0,9999,0
1668389892075,CSE 293,022,119367,Orailoglu; Alex,9999,0,9999,0
1668389892075,CSE 293,023,119382,Paturi; Ramamohan,9999,0,9999,0
1668389892075,CSE 293,024,119404,Polikarpova; Nadezhda,9999,0,9999,0
1668389892075,CSE 293,025,119406,Politz; Joseph Gibbs,9999,0,9999,0
1668389892075,CSE 293,026,119411,Porter; George M,9999,0,9999,0
1668389892075,CSE 293,027,119414,Porter; Leonard Emerson,9999,0,9999,0
1668389892075,CSE 293,028,119416,Ramamoorthi; Ravi,9999,0,9999,0
1668389892075,CSE 293,029,119417,Sahoo; Debashis,9999,0,9999,0
1668389892075,CSE 293,030,119420,Saul; Lawrence,9999,0,9999,0
1668389892075,CSE 293,031,119421,Savage; Stefan,9999,0,9999,0
1668389892075,CSE 293,032,119425,Schulze; Jurgen P.,9999,0,9999,0
1668389892075,CSE 293,033,119426,Snoeren; Alex C.,9999,0,9999,0
1668389892075,CSE 293,034,119428,Shang; Jingbo,9999,0,9999,0
1668389892075,CSE 293,035,119430,Stefan; Deian,9999,0,9999,0
1668389892075,CSE 293,036,119431,Su; Hao,9999,0,9999,0
1668389892075,CSE 293,037,119433,Swanson; Steven James,9999,0,9999,0
1668389892075,CSE 293,038,119435,Tullsen; Dean Michael,9999,0,9999,0
1668389892075,CSE 293,039,119483,Voelker; Geoffrey M.,9999,0,9999,0
1668389892075,CSE 293,040,119537,Zhao; Jishen,9999,0,9999,0
1668389892075,CSE 293,041,119538,Zhou; Yuan-Yuan,9999,0,9999,0
1668389892075,CSE 293,042,119539,Gao; Sicun,9999,0,9999,0
1668389892075,CSE 293,043,119540,Weibel; Nadir,9999,0,9999,0
1668389892075,CSE 293,044,119541,Gupta; Rajesh K.,9999,0,9999,0
1668389892075,CSE 293,045,126410,Vaccaro; Kristen Marie,9999,0,9999,0
1668389892075,CSE 293,046,126411,Klemke; Richard,9999,0,9999,0
1668389892501,CSE 294,A00,102459,Voelker; Geoffrey M.,0,0,0,0
1668389892501,CSE 294,B00,111322,Orailoglu; Alex,0,0,0,0
1668389892924,DSE 201,A00,096914,Deutsch; Alin Bernard,30,0,30,0
1668389893346,DSE 210,A00,096915,Dasgupta; Sanjoy,30,0,30,0
1668389893773,DSE 260A,A00,096916,Altintas De Callaf; Ilkay,30,0,30,0
1668389894206,ECE 200,001,103586,Antipa; Nicholas A,9999,0,9999,0
1668389894206,ECE 200,002,103587,Atanasov; Nikolay A.,9999,0,9999,0
1668389894206,ECE 200,003,103588,Bharadia; Dinesh,9999,0,9999,0
1668389894206,ECE 200,004,103589,Cheng; Chung Kuan,9999,0,9999,0
1668389894206,ECE 200,005,103590,Cosman; Pamela C.,9999,0,9999,0
1668389894206,ECE 200,006,103591,Dayeh; Shadi Ahmad,9999,0,9999,0
1668389894206,ECE 200,007,103592,Fainman; Yeshaiahu,9999,0,9999,0
1668389894206,ECE 200,008,103593,Ford; Joseph Earl,9999,0,9999,0
1668389894206,ECE 200,009,103594,Franceschetti; Massimo,9999,0,9999,0
1668389894206,ECE 200,010,103595,Fullerton; Eric E,9999,0,9999,0
1668389894206,ECE 200,011,103596,Galton; Ian A,9999,0,9999,0
1668389894206,ECE 200,012,103597,Gilja; Vikash,9999,0,9999,0
1668389894206,ECE 200,013,103598,Hall; Drew A.,9999,0,9999,0
1668389894206,ECE 200,014,103599,Hsueh; Tzu-Chien,9999,0,9999,0
1668389894206,ECE 200,015,103600,Javidi; Tara,9999,0,9999,0
1668389894206,ECE 200,016,103601,Kahng; Andrew Byun,9999,0,9999,0
1668389894206,ECE 200,017,103602,Kim; Young-Han,9999,0,9999,0
1668389894206,ECE 200,018,103603,Koushanfar; Farinaz,9999,0,9999,0
1668389894206,ECE 200,019,103604,Kuzum; Duygu,9999,0,9999,0
1668389894206,ECE 200,020,103605,Le; Hanh-Phuc,9999,0,9999,0
1668389894206,ECE 200,021,103606,Lin; Bill,9999,0,9999,0
1668389894206,ECE 200,022,103607,Liu; Zhaowei,9998,0,9999,1
1668389894206,ECE 200,023,103608,Lo; Yu-Hwa,9999,0,9999,0
1668389894206,ECE 200,024,103609,Lomakin; Vitaliy,9999,0,9999,0
1668389894206,ECE 200,025,103610,Mercier; Patrick Philip,9999,0,9999,0
1668389894206,ECE 200,026,103611,Meyer; Florian,9999,0,9999,0
1668389894206,ECE 200,027,103612,Milstein; Laurence B.,9999,0,9999,0
1668389894206,ECE 200,028,103613,Mir Arabbaygi; Siavash,9999,0,9999,0
1668389894206,ECE 200,029,103614,Mookherjea; Shayan,9999,0,9999,0
1668389894206,ECE 200,030,103615,Morris; Karcher William,9999,0,9999,0
1668389894206,ECE 200,031,103616,Ng; Tse Nga,9999,0,9999,0
1668389894206,ECE 200,032,103617,Nguyen; Truong Quang,9999,0,9999,0
1668389894206,ECE 200,033,103618,Nomura; Kenji,9999,0,9999,0
1668389894206,ECE 200,034,103619,Orlitsky; Alon,9999,0,9999,0
1668389894206,ECE 200,035,103620,Pal; Piya,9999,0,9999,0
1668389894206,ECE 200,036,103621,Papen; George C.,9999,0,9999,0
1668389894206,ECE 200,037,103622,Radic; Stojan,9999,0,9999,0
1668389894206,ECE 200,038,103623,Rao; Bhaskar D.,9999,0,9999,0
1668389894206,ECE 200,039,103624,Rao; Ramesh R,9999,0,9999,0
1668389894206,ECE 200,040,103625,Rebeiz; Gabriel,9999,0,9999,0
1668389894206,ECE 200,041,103626,Sanford; John R,9999,0,9999,0
1668389894206,ECE 200,042,103627,Siegel; Paul H.,9999,0,9999,0
1668389894206,ECE 200,043,103628,Sievenpiper; Daniel F.,9999,0,9999,0
1668389894206,ECE 200,044,103629,Sworder; David D.,9999,0,9999,0
1668389894206,ECE 200,045,103630,Taur; Yuan,9999,0,9999,0
1668389894206,ECE 200,046,103631,Touri; Behrouz,9999,0,9999,0
1668389894206,ECE 200,047,103632,Trivedi; Mohan M.,9999,0,9999,0
1668389894206,ECE 200,048,103633,Vasconcelos; Nuno,9999,0,9999,0
1668389894206,ECE 200,049,103634,Wang; Xiaolong,9999,0,9999,0
1668389894206,ECE 200,050,103635,Xie; Pengtao,9999,0,9999,0
1668389894206,ECE 200,051,103636,Yip; Michael,9999,0,9999,0
1668389894206,ECE 200,052,103637,Zeger; Kenneth A.,999,0,999,0
1668389894206,ECE 200,053,103638,Zhang; Xinyu,9999,0,9999,0
1668389894206,ECE 200,054,103639,Turakhia; Yatish Girish,9999,0,9999,0
1668389894206,ECE 200,055,103640,Kang; Mingu,9999,0,9999,0
1668389894206,ECE 200,056,103641,Shi; Yuanyuan,9999,0,9999,0
1668389894206,ECE 200,057,103642,Wang; Edward Jay,9999,0,9999,0
1668389894206,ECE 200,058,103643,Zheng; Yang,9999,0,9999,0
1668389894633,ECE 202,A00,103644,Kuzum; Duygu,0,0,0,0
1668389895058,ECE 212BN,A00,103646,Ng; Tse Nga,0,0,0,0
1668389895487,ECE 221,A00,111493,Staff,0,0,0,0
1668389895917,ECE 222B,A00,103647,Lomakin; Vitaliy,0,0,0,0
1668389896342,ECE 230B,A00,103648,Taur; Yuan,0,0,0,0
1668389896766,ECE 238B,A00,103649,Garay; Javier,0,0,0,0
1668389897197,ECE 240B,A00,112900,Fainman; Yeshaiahu,0,0,0,0
1668389897630,ECE 247A,A00,103650,Jokerst; Jesse Vincent,0,0,0,0
1668389898053,ECE 247B,A00,103651,Wang; Joseph,0,0,0,0
1668389898481,ECE 250,A00,103652,Siegel; Paul H.,0,0,0,0
1668389898906,ECE 251A,A00,103654,Rao; Bhaskar D.,0,0,0,0
1668389899329,ECE 257B,A00,103655,Bharadia; Dinesh,0,0,0,0
1668389899756,ECE 258A,A00,103656,Milstein; Laurence B.,0,0,0,0
1668389900180,ECE 260B,A00,103658,Kang; Mingu,0,0,0,0
1668389900603,ECE 264A,A00,103659,Galton; Ian A,0,0,0,0
1668389901044,ECE 265A,A00,103661,Gudem; Prasad S.S.,0,0,0,0
1668389901483,ECE 265D,A00,103662,Gudem; Prasad S.S.,0,0,0,0
1668389901915,ECE 268,A00,103663,Koushanfar; Farinaz,0,0,0,0
1668389902338,ECE 269,A01,103665,Pal; Piya,0,0,0,0
1668389902765,ECE 271B,A00,103666,Vasconcelos; Manuela,0,0,0,0
1668389903188,ECE 276A,A00,103667,Atanasov; Nikolay A.,0,0,0,0
1668389903613,ECE 277,A00,103668,An; Cheolhong,0,0,0,0
1668389904035,ECE 279,A00,117947,Hall; Drew A.,0,0,0,0
1668389904884,ECE 283,A00,103670,Hsueh; Tzu-Chien,0,0,0,0
1668389905306,ECE 284,A00,103671,Turakhia; Yatish Girish,0,0,0,0
1668389905733,ECE 285,A00,103672,Zheng; Yang,0,0,0,0
1668389905733,ECE 285,B00,103673,Sworder; David D.,0,0,0,0
1668389906160,ECE 287,A00,103676,Javidi; Tara,0,0,0,0
1668389906585,MATH 200B,A00,098023,Salehi Golsefidy; Alireza,12,0,15,3
1668389907008,MATH 202B,A00,098024,Rhoades; Brendon Patrick,9,0,15,6
1668389907431,MATH 203B,A00,098025,Oprea; Dragos N.,10,0,15,5
1668389907873,MATH 204B,A00,098026,Sorensen; Claus M,13,0,15,2
1668389908297,MATH 208,A00,098027,Izadi; Elham,7,0,10,3
1668389908720,MATH 209,A00,098028,Pollack; Aaron,10,0,10,0
1668389909143,MATH 211A,A00,112919,Rogalski; Daniel,9,0,10,1
1668389909566,MATH 211B,A00,112920,Seward; Brandon M.,9,0,10,1
1668389909991,MATH 218,A00,098029,Li; Bo,10,0,10,0
1668389910417,MATH 220B,A00,098030,Novak; Jonathan I,11,0,15,4
1668389910842,MATH 221A,A00,098031,Ebenfelt; Peter F,13,0,15,2
1668389911266,MATH 231B,A00,098032,Zlatos; Andrej,12,0,15,3
1668389911690,MATH 240B,A00,098033,Ni; Lei,9,0,15,6
1668389912116,MATH 243,A00,098034,Jekel; David Andrew,10,0,10,0
1668389912546,MATH 245A,A00,098035,Nie; Jiawang,0,0,15,16
1668389912971,MATH 248,A00,098036,Bejenaru; Ioan,10,0,10,0
1668389913397,MATH 250B,A00,098037,Spolaor; Luca,14,0,15,1
1668389913828,MATH 258,A00,098038,Ni; Lei,10,0,10,0
1668389914250,MATH 264B,A00,098041,Rhoades; Brendon Patrick,9,0,15,6
1668389914687,MATH 268,A00,098042,Buss; Samuel R,10,0,10,0
1668389915123,MATH 269,A00,098043,Rhoades; Brendon Patrick,10,0,10,0
1668389915562,MATH 270B,A00,098044,Li; Bo,10,0,15,5
1668389915987,MATH 272B,A00,098045,Holst; Michael J,13,0,15,2
1668389916420,MATH 273A,A00,098046,Tian; Xiaochuan,10,0,15,5
1668389916845,MATH 275,A01,098048,Tian; Xiaochuan,6,0,10,4
1668389917271,MATH 278A,A00,098049,Holst; Michael J,8,0,10,2
1668389917705,MATH 278B,A00,098050,Cloninger; Alexander,10,0,10,0
1668389918131,MATH 278C,A00,098051,Nie; Jiawang,7,0,10,3
1668389918646,MATH 280B,A00,098052,Zheng; Tianyi,8,0,15,7
1668389919074,MATH 281B,A00,098053,Bradic; Jelena,0,0,15,15
1668389919501,MATH 282B,A00,098054,Arias-Castro; Ery,0,0,15,15
1668389919931,MATH 285,A00,098055,Fitzsimmons; Patrick J,0,0,15,17
1668389920356,MATH 287B,A00,098056,Arias-Castro; Ery,2,0,15,13
1668389920780,MATH 288,A00,098057,Agarwal; Pooja,9,0,10,1
1668389920780,MATH 288,B00,098058,Zhang; Danna,8,0,10,2
1668389920780,MATH 288,C00,098059,Williams; Ruth J,9,0,10,1
1668389921204,MATH 290B,A00,098060,Roberts; Justin Deritter,13,0,15,2
1668389921630,MATH 292,A00,098061,Belmont; Eva Kinoshita,10,0,10,0
1668389922065,MATH 295,A00,098062,Suk; Andrew Hoon,48,0,50,2
1668389922487,MATH 296,A00,098063,Novak; Jonathan I,20,0,20,0
1668389922921,MATH 297,001,098064,Gamst; Anthony Collins,9997,0,9999,2
1668390424077,COGS 205,A00,101395,Chiba; Andrea,19,0,20,1
1668390424523,COGS 210B,001,101404,Greene; Deanna Jacquelyn,9998,0,9999,1
1668390424523,COGS 210B,002,101417,Xia; Haijun,9999,0,9999,0
1668390424523,COGS 210B,003,101422,Nitz; Douglas A.,9999,0,9999,0
1668390424523,COGS 210B,004,101423,Hollan; James D.,9998,0,9999,1
1668390424523,COGS 210B,005,101424,Deak; Gedeon O.,9998,0,9999,1
1668390424523,COGS 210B,006,101425,Rossano; Federico,9999,0,9999,0
1668390424949,COGS 211B,A00,101427,Coulson; Seana M,9996,0,9999,3
1668390425379,COGS 220,A00,101428,Hollan; James D.,0,0,25,25
1668390425803,COGS 229,A00,101429,Dow; Steven P,18,0,25,7
1668390426225,COGS 230,A00,101430,Klemmer; Scott R,11,0,17,6
1668390426648,COGS 234,A00,101431,Xia; Haijun,1,0,25,24
1668390427083,COGS 260,A00,101432,Kiyonaga; Anastasia,21,0,25,4
1668390427083,COGS 260,B00,101433,Kirsh; David Joel,15,0,25,10
1668390427510,CSE 202,A00,102371,Impagliazzo; Russell,0,0,0,0
1668390427934,CSE 203B,A01,102373,Cheng; Chung Kuan,0,0,0,0
1668390428361,CSE 208,A00,102374,Micciancio; Daniele,0,0,0,0
1668390428789,CSE 209A,A00,112895,Impagliazzo; Russell,0,0,15,15
1668390429211,CSE 209B,A00,108005,Bellare; Mihir,0,0,0,0
1668390429638,CSE 210,A00,113163,Coblenz; Michael J,0,0,0,0
1668390430061,CSE 219,A00,106111,Dow; Steven P,0,0,20,20
1668390430488,CSE 221,A00,102376,Voelker; Geoffrey M.,0,0,0,0
1668390430913,CSE 224,A01,102378,Porter; George M,0,0,0,0
1668390431339,CSE 229A,A00,102379,Savage; Stefan,0,0,0,0
1668390431763,CSE 229C,A00,102380,Munyaka; Imani N. S.,0,0,0,0
1668390432193,CSE 232B,A00,102382,Deutsch; Alin Bernard,0,0,0,0
1668390432619,CSE 234,A01,112904,Kumar; Arun Kumar,0,0,0,0
1668390433042,CSE 237A,A00,102383,Rosing; Tajana Simunic,0,0,0,0
1668390433469,CSE 239A,A00,102384,Deutsch; Alin Bernard,0,0,0,0
1668390433894,CSE 239B,A00,102385,Polikarpova; Nadezhda,0,0,0,0
1668390434321,CSE 240A,A00,102386,Pannuto; Patrick William,0,0,0,0
1668390434753,CSE 240B,A00,102387,Zhao; Jishen,0,0,0,0
1668390435187,CSE 241A,A00,106406,Kang; Mingu,0,0,0,0
1668390435619,CSE 249B,A00,102388,Kahng; Andrew Byun,0,0,8,8
1668390436042,CSE 251B,A01,102392,Cottrell; Garrison W,0,0,0,0
1668390436042,CSE 251B,A02,102393,Cottrell; Garrison W,0,0,0,0
1668390436465,CSE 252B,A00,102394,Ochoa; Benjamin Lawrence,0,0,0,0
1668390436889,CSE 257,A01,102396,Gao; Sicun,0,0,0,0
1668390437312,CSE 272,A00,102397,Li; Tzumao,0,0,0,0
1668390437735,CSE 274,A00,111323,Chern; Albert Ren-Haur,0,0,0,0
1668390438158,CSE 282,A00,102398,Pevzner; Pavel Arkadjevich,0,0,0,0
1668390438596,CSE 284,A00,114175,Gymrek; Melissa Ann,0,0,0,0
1668390439023,CSE 290,A00,102399,Chandraker; Manmohan Krishna,0,0,0,0
1668390439023,CSE 290,B00,102400,Vaccaro; Kristen Marie,0,0,25,25
1668390439023,CSE 290,C00,102414,Pannuto; Patrick William,0,0,25,25
1668390439023,CSE 290,D00,102427,Pevzner; Pavel Arkadjevich,0,0,0,0
1668390439023,CSE 290,E00,102429,Zhao; Jishen,0,0,0,0
1668390439023,CSE 290,F00,102436,Tullsen; Dean Michael,0,0,0,0
1668390439023,CSE 290,G00,102440,Christensen; Henrik I,0,0,20,20
1668390439452,CSE 291,A00,102443,Su; Hao,0,0,0,0
1668390439452,CSE 291,B00,102448,Polikarpova; Nadezhda,0,0,0,0
1668390439452,CSE 291,C00,102453,Vaccaro; Kristen Marie,0,0,0,0
1668390439452,CSE 291,D00,111343,Savage; Stefan,0,0,0,0
1668390439452,CSE 291,E00,116474,Claffy; Kimberly Claire,0,0,0,0
1668390439452,CSE 291,F00,116479,Pasquale; Joseph,0,0,0,0
1668390439977,CSE 293,001,119111,Bafna; Vineet,9999,0,9999,0
1668390439977,CSE 293,002,119118,Bellare; Mihir,9999,0,9999,0
1668390439977,CSE 293,003,119122,Berg-Kirkpatrick; Taylor D,9999,0,9999,0
1668390439977,CSE 293,004,119135,Christensen; Henrik I,9999,0,9999,0
1668390439977,CSE 293,005,119142,Cottrell; Garrison W,9999,0,9999,0
1668390439977,CSE 293,006,119146,Deutsch; Alin Bernard,9999,0,9999,0
1668390439977,CSE 293,007,119159,Esmaeilzadeh; Hadi,9999,0,9999,0
1668390439977,CSE 293,008,119166,Freund; Yoav,9999,0,9999,0
1668390439977,CSE 293,009,119170,Griswold; William G.,9999,0,9999,0
1668390439977,CSE 293,010,119183,Gymrek; Melissa Ann,9999,0,9999,0
1668390439977,CSE 293,011,119190,Heninger; Nadia A,9999,0,9999,0
1668390439977,CSE 293,012,119230,Impagliazzo; Russell,9999,0,9999,0
1668390439977,CSE 293,013,119232,Jhala; Ranjit,9999,0,9999,0
1668390439977,CSE 293,014,119233,Kahng; Andrew Byun,9999,0,9999,0
1668390439977,CSE 293,015,119298,Kane; Daniel Mertz,9999,0,9999,0
1668390439977,CSE 293,016,119299,Kriegman; David J,9999,0,9999,0
1668390439977,CSE 293,017,119300,Kumar; Arun Kumar,9999,0,9999,0
1668390439977,CSE 293,018,119301,Lerner; Sorin,9999,0,9999,0
1668390439977,CSE 293,019,119302,Lovett; Shachar,9999,0,9999,0
1668390439977,CSE 293,020,119303,McAuley; Julian John,9999,0,9999,0
1668390439977,CSE 293,021,119304,Micciancio; Daniele,9999,0,9999,0
1668390439977,CSE 293,022,119367,Orailoglu; Alex,9999,0,9999,0
1668390439977,CSE 293,023,119382,Paturi; Ramamohan,9999,0,9999,0
1668390439977,CSE 293,024,119404,Polikarpova; Nadezhda,9999,0,9999,0
1668390439977,CSE 293,025,119406,Politz; Joseph Gibbs,9999,0,9999,0
1668390439977,CSE 293,026,119411,Porter; George M,9999,0,9999,0
1668390439977,CSE 293,027,119414,Porter; Leonard Emerson,9999,0,9999,0
1668390439977,CSE 293,028,119416,Ramamoorthi; Ravi,9999,0,9999,0
1668390439977,CSE 293,029,119417,Sahoo; Debashis,9999,0,9999,0
1668390439977,CSE 293,030,119420,Saul; Lawrence,9999,0,9999,0
1668390439977,CSE 293,031,119421,Savage; Stefan,9999,0,9999,0
1668390439977,CSE 293,032,119425,Schulze; Jurgen P.,9999,0,9999,0
1668390439977,CSE 293,033,119426,Snoeren; Alex C.,9999,0,9999,0
1668390439977,CSE 293,034,119428,Shang; Jingbo,9999,0,9999,0
1668390439977,CSE 293,035,119430,Stefan; Deian,9999,0,9999,0
1668390439977,CSE 293,036,119431,Su; Hao,9999,0,9999,0
1668390439977,CSE 293,037,119433,Swanson; Steven James,9999,0,9999,0
1668390439977,CSE 293,038,119435,Tullsen; Dean Michael,9999,0,9999,0
1668390439977,CSE 293,039,119483,Voelker; Geoffrey M.,9999,0,9999,0
1668390439977,CSE 293,040,119537,Zhao; Jishen,9999,0,9999,0
1668390439977,CSE 293,041,119538,Zhou; Yuan-Yuan,9999,0,9999,0
1668390439977,CSE 293,042,119539,Gao; Sicun,9999,0,9999,0
1668390439977,CSE 293,043,119540,Weibel; Nadir,9999,0,9999,0
1668390439977,CSE 293,044,119541,Gupta; Rajesh K.,9999,0,9999,0
1668390439977,CSE 293,045,126410,Vaccaro; Kristen Marie,9999,0,9999,0
1668390439977,CSE 293,046,126411,Klemke; Richard,9999,0,9999,0
1668390440402,CSE 294,A00,102459,Voelker; Geoffrey M.,0,0,0,0
1668390440402,CSE 294,B00,111322,Orailoglu; Alex,0,0,0,0
1668390440827,DSE 201,A00,096914,Deutsch; Alin Bernard,30,0,30,0
1668390441253,DSE 210,A00,096915,Dasgupta; Sanjoy,30,0,30,0
1668390441677,DSE 260A,A00,096916,Altintas De Callaf; Ilkay,30,0,30,0
1668390442104,ECE 200,001,103586,Antipa; Nicholas A,9999,0,9999,0
1668390442104,ECE 200,002,103587,Atanasov; Nikolay A.,9999,0,9999,0
1668390442104,ECE 200,003,103588,Bharadia; Dinesh,9999,0,9999,0
1668390442104,ECE 200,004,103589,Cheng; Chung Kuan,9999,0,9999,0
1668390442104,ECE 200,005,103590,Cosman; Pamela C.,9999,0,9999,0
1668390442104,ECE 200,006,103591,Dayeh; Shadi Ahmad,9999,0,9999,0
1668390442104,ECE 200,007,103592,Fainman; Yeshaiahu,9999,0,9999,0
1668390442104,ECE 200,008,103593,Ford; Joseph Earl,9999,0,9999,0
1668390442104,ECE 200,009,103594,Franceschetti; Massimo,9999,0,9999,0
1668390442104,ECE 200,010,103595,Fullerton; Eric E,9999,0,9999,0
1668390442104,ECE 200,011,103596,Galton; Ian A,9999,0,9999,0
1668390442104,ECE 200,012,103597,Gilja; Vikash,9999,0,9999,0
1668390442104,ECE 200,013,103598,Hall; Drew A.,9999,0,9999,0
1668390442104,ECE 200,014,103599,Hsueh; Tzu-Chien,9999,0,9999,0
1668390442104,ECE 200,015,103600,Javidi; Tara,9999,0,9999,0
1668390442104,ECE 200,016,103601,Kahng; Andrew Byun,9999,0,9999,0
1668390442104,ECE 200,017,103602,Kim; Young-Han,9999,0,9999,0
1668390442104,ECE 200,018,103603,Koushanfar; Farinaz,9999,0,9999,0
1668390442104,ECE 200,019,103604,Kuzum; Duygu,9999,0,9999,0
1668390442104,ECE 200,020,103605,Le; Hanh-Phuc,9999,0,9999,0
1668390442104,ECE 200,021,103606,Lin; Bill,9999,0,9999,0
1668390442104,ECE 200,022,103607,Liu; Zhaowei,9998,0,9999,1
1668390442104,ECE 200,023,103608,Lo; Yu-Hwa,9999,0,9999,0
1668390442104,ECE 200,024,103609,Lomakin; Vitaliy,9999,0,9999,0
1668390442104,ECE 200,025,103610,Mercier; Patrick Philip,9999,0,9999,0
1668390442104,ECE 200,026,103611,Meyer; Florian,9999,0,9999,0
1668390442104,ECE 200,027,103612,Milstein; Laurence B.,9999,0,9999,0
1668390442104,ECE 200,028,103613,Mir Arabbaygi; Siavash,9999,0,9999,0
1668390442104,ECE 200,029,103614,Mookherjea; Shayan,9999,0,9999,0
1668390442104,ECE 200,030,103615,Morris; Karcher William,9999,0,9999,0
1668390442104,ECE 200,031,103616,Ng; Tse Nga,9999,0,9999,0
1668390442104,ECE 200,032,103617,Nguyen; Truong Quang,9999,0,9999,0
1668390442104,ECE 200,033,103618,Nomura; Kenji,9999,0,9999,0
1668390442104,ECE 200,034,103619,Orlitsky; Alon,9999,0,9999,0
1668390442104,ECE 200,035,103620,Pal; Piya,9999,0,9999,0
1668390442104,ECE 200,036,103621,Papen; George C.,9999,0,9999,0
1668390442104,ECE 200,037,103622,Radic; Stojan,9999,0,9999,0
1668390442104,ECE 200,038,103623,Rao; Bhaskar D.,9999,0,9999,0
1668390442104,ECE 200,039,103624,Rao; Ramesh R,9999,0,9999,0
1668390442104,ECE 200,040,103625,Rebeiz; Gabriel,9999,0,9999,0
1668390442104,ECE 200,041,103626,Sanford; John R,9999,0,9999,0
1668390442104,ECE 200,042,103627,Siegel; Paul H.,9999,0,9999,0
1668390442104,ECE 200,043,103628,Sievenpiper; Daniel F.,9999,0,9999,0
1668390442104,ECE 200,044,103629,Sworder; David D.,9999,0,9999,0
1668390442104,ECE 200,045,103630,Taur; Yuan,9999,0,9999,0
1668390442104,ECE 200,046,103631,Touri; Behrouz,9999,0,9999,0
1668390442104,ECE 200,047,103632,Trivedi; Mohan M.,9999,0,9999,0
1668390442104,ECE 200,048,103633,Vasconcelos; Nuno,9999,0,9999,0
1668390442104,ECE 200,049,103634,Wang; Xiaolong,9999,0,9999,0
1668390442104,ECE 200,050,103635,Xie; Pengtao,9999,0,9999,0
1668390442104,ECE 200,051,103636,Yip; Michael,9999,0,9999,0
1668390442104,ECE 200,052,103637,Zeger; Kenneth A.,999,0,999,0
1668390442104,ECE 200,053,103638,Zhang; Xinyu,9999,0,9999,0
1668390442104,ECE 200,054,103639,Turakhia; Yatish Girish,9999,0,9999,0
1668390442104,ECE 200,055,103640,Kang; Mingu,9999,0,9999,0
1668390442104,ECE 200,056,103641,Shi; Yuanyuan,9999,0,9999,0
1668390442104,ECE 200,057,103642,Wang; Edward Jay,9999,0,9999,0
1668390442104,ECE 200,058,103643,Zheng; Yang,9999,0,9999,0
1668390442540,ECE 202,A00,103644,Kuzum; Duygu,0,0,0,0
1668390442974,ECE 212BN,A00,103646,Ng; Tse Nga,0,0,0,0
1668390443398,ECE 221,A00,111493,Staff,0,0,0,0
1668390443824,ECE 222B,A00,103647,Lomakin; Vitaliy,0,0,0,0
1668390444250,ECE 230B,A00,103648,Taur; Yuan,0,0,0,0
1668390444673,ECE 238B,A00,103649,Garay; Javier,0,0,0,0
1668390445100,ECE 240B,A00,112900,Fainman; Yeshaiahu,0,0,0,0
1668390445531,ECE 247A,A00,103650,Jokerst; Jesse Vincent,0,0,0,0
1668390445953,ECE 247B,A00,103651,Wang; Joseph,0,0,0,0
1668390446378,ECE 250,A00,103652,Siegel; Paul H.,0,0,0,0
1668390446805,ECE 251A,A00,103654,Rao; Bhaskar D.,0,0,0,0
1668390447229,ECE 257B,A00,103655,Bharadia; Dinesh,0,0,0,0
1668390447659,ECE 258A,A00,103656,Milstein; Laurence B.,0,0,0,0
1668390448084,ECE 260B,A00,103658,Kang; Mingu,0,0,0,0
1668390448525,ECE 264A,A00,103659,Galton; Ian A,0,0,0,0
1668390448960,ECE 265A,A00,103661,Gudem; Prasad S.S.,0,0,0,0
1668390449394,ECE 265D,A00,103662,Gudem; Prasad S.S.,0,0,0,0
1668390449817,ECE 268,A00,103663,Koushanfar; Farinaz,0,0,0,0
1668390450244,ECE 269,A01,103665,Pal; Piya,0,0,0,0
1668390450670,ECE 271B,A00,103666,Vasconcelos; Manuela,0,0,0,0
1668390451094,ECE 276A,A00,103667,Atanasov; Nikolay A.,0,0,0,0
1668390451517,ECE 277,A00,103668,An; Cheolhong,0,0,0,0
1668390451941,ECE 279,A00,117947,Hall; Drew A.,0,0,0,0
1668390452785,ECE 283,A00,103670,Hsueh; Tzu-Chien,0,0,0,0
1668390453211,ECE 284,A00,103671,Turakhia; Yatish Girish,0,0,0,0
1668390453648,ECE 285,A00,103672,Zheng; Yang,0,0,0,0
1668390453648,ECE 285,B00,103673,Sworder; David D.,0,0,0,0
1668390454090,ECE 287,A00,103676,Javidi; Tara,0,0,0,0
1668390454521,MATH 200B,A00,098023,Salehi Golsefidy; Alireza,12,0,15,3
1668390454947,MATH 202B,A00,098024,Rhoades; Brendon Patrick,9,0,15,6
1668390455374,MATH 203B,A00,098025,Oprea; Dragos N.,10,0,15,5
1668390455806,MATH 204B,A00,098026,Sorensen; Claus M,13,0,15,2
1668390456236,MATH 208,A00,098027,Izadi; Elham,7,0,10,3
1668390456659,MATH 209,A00,098028,Pollack; Aaron,10,0,10,0
1668390457083,MATH 211A,A00,112919,Rogalski; Daniel,9,0,10,1
1668390457507,MATH 211B,A00,112920,Seward; Brandon M.,9,0,10,1
1668390457931,MATH 218,A00,098029,Li; Bo,10,0,10,0
1668390458361,MATH 220B,A00,098030,Novak; Jonathan I,11,0,15,4
1668390458799,MATH 221A,A00,098031,Ebenfelt; Peter F,13,0,15,2
1668390459228,MATH 231B,A00,098032,Zlatos; Andrej,12,0,15,3
1668390459654,MATH 240B,A00,098033,Ni; Lei,9,0,15,6
1668390460079,MATH 243,A00,098034,Jekel; David Andrew,10,0,10,0
1668390460502,MATH 245A,A00,098035,Nie; Jiawang,0,0,15,16
1668390460927,MATH 248,A00,098036,Bejenaru; Ioan,10,0,10,0
1668390461351,MATH 250B,A00,098037,Spolaor; Luca,14,0,15,1
1668390461776,MATH 258,A00,098038,Ni; Lei,10,0,10,0
1668390462200,MATH 264B,A00,098041,Rhoades; Brendon Patrick,9,0,15,6
1668390462627,MATH 268,A00,098042,Buss; Samuel R,10,0,10,0
1668390463058,MATH 269,A00,098043,Rhoades; Brendon Patrick,10,0,10,0
1668390463491,MATH 270B,A00,098044,Li; Bo,10,0,15,5
1668390463931,MATH 272B,A00,098045,Holst; Michael J,13,0,15,2
1668390464359,MATH 273A,A00,098046,Tian; Xiaochuan,10,0,15,5
1668390464784,MATH 275,A01,098048,Tian; Xiaochuan,6,0,10,4
1668390465208,MATH 278A,A00,098049,Holst; Michael J,8,0,10,2
1668390465633,MATH 278B,A00,098050,Cloninger; Alexander,10,0,10,0
1668390466059,MATH 278C,A00,098051,Nie; Jiawang,7,0,10,3
1668390466488,MATH 280B,A00,098052,Zheng; Tianyi,8,0,15,7
1668390466920,MATH 281B,A00,098053,Bradic; Jelena,0,0,15,15
1668390467346,MATH 282B,A00,098054,Arias-Castro; Ery,0,0,15,15
1668390467767,MATH 285,A00,098055,Fitzsimmons; Patrick J,0,0,15,17
1668390468196,MATH 287B,A00,098056,Arias-Castro; Ery,2,0,15,13
1668390468620,MATH 288,A00,098057,Agarwal; Pooja,9,0,10,1
1668390468620,MATH 288,B00,098058,Zhang; Danna,8,0,10,2
1668390468620,MATH 288,C00,098059,Williams; Ruth J,9,0,10,1
1668390469051,MATH 290B,A00,098060,Roberts; Justin Deritter,13,0,15,2
1668390469474,MATH 292,A00,098061,Belmont; Eva Kinoshita,10,0,10,0
1668390469898,MATH 295,A00,098062,Suk; Andrew Hoon,48,0,50,2
1668390470320,MATH 296,A00,098063,Novak; Jonathan I,20,0,20,0
1668390470743,MATH 297,001,098064,Gamst; Anthony Collins,9997,0,9999,2
1668390972163,COGS 205,A00,101395,Chiba; Andrea,19,0,20,1
1668390972590,COGS 210B,001,101404,Greene; Deanna Jacquelyn,9998,0,9999,1
1668390972590,COGS 210B,002,101417,Xia; Haijun,9999,0,9999,0
1668390972590,COGS 210B,003,101422,Nitz; Douglas A.,9999,0,9999,0
1668390972590,COGS 210B,004,101423,Hollan; James D.,9998,0,9999,1
1668390972590,COGS 210B,005,101424,Deak; Gedeon O.,9998,0,9999,1
1668390972590,COGS 210B,006,101425,Rossano; Federico,9999,0,9999,0
1668390973013,COGS 211B,A00,101427,Coulson; Seana M,9996,0,9999,3
1668390973437,COGS 220,A00,101428,Hollan; James D.,0,0,25,25
1668390973861,COGS 229,A00,101429,Dow; Steven P,18,0,25,7
1668390974285,COGS 230,A00,101430,Klemmer; Scott R,11,0,17,6
1668390974721,COGS 234,A00,101431,Xia; Haijun,1,0,25,24
1668390975146,COGS 260,A00,101432,Kiyonaga; Anastasia,21,0,25,4
1668390975146,COGS 260,B00,101433,Kirsh; David Joel,15,0,25,10
1668390975569,CSE 202,A00,102371,Impagliazzo; Russell,0,0,0,0
1668390975994,CSE 203B,A01,102373,Cheng; Chung Kuan,0,0,0,0
1668390976416,CSE 208,A00,102374,Micciancio; Daniele,0,0,0,0
1668390976841,CSE 209A,A00,112895,Impagliazzo; Russell,0,0,15,15
1668390977266,CSE 209B,A00,108005,Bellare; Mihir,0,0,0,0
1668390977690,CSE 210,A00,113163,Coblenz; Michael J,0,0,0,0
1668390978114,CSE 219,A00,106111,Dow; Steven P,0,0,20,20
1668390978538,CSE 221,A00,102376,Voelker; Geoffrey M.,0,0,0,0
1668390978974,CSE 224,A01,102378,Porter; George M,0,0,0,0
1668390979402,CSE 229A,A00,102379,Savage; Stefan,0,0,0,0
1668390979826,CSE 229C,A00,102380,Munyaka; Imani N. S.,0,0,0,0
1668390980251,CSE 232B,A00,102382,Deutsch; Alin Bernard,0,0,0,0
1668390980677,CSE 234,A01,112904,Kumar; Arun Kumar,0,0,0,0
1668390981099,CSE 237A,A00,102383,Rosing; Tajana Simunic,0,0,0,0
1668390981524,CSE 239A,A00,102384,Deutsch; Alin Bernard,0,0,0,0
1668390981947,CSE 239B,A00,102385,Polikarpova; Nadezhda,0,0,0,0
1668390982380,CSE 240A,A00,102386,Pannuto; Patrick William,0,0,0,0
1668390982810,CSE 240B,A00,102387,Zhao; Jishen,0,0,0,0
1668390983237,CSE 241A,A00,106406,Kang; Mingu,0,0,0,0
1668390983664,CSE 249B,A00,102388,Kahng; Andrew Byun,0,0,8,8
1668390984092,CSE 251B,A01,102392,Cottrell; Garrison W,0,0,0,0
1668390984092,CSE 251B,A02,102393,Cottrell; Garrison W,0,0,0,0
1668390984516,CSE 252B,A00,102394,Ochoa; Benjamin Lawrence,0,0,0,0
1668390984939,CSE 257,A01,102396,Gao; Sicun,0,0,0,0
1668390985377,CSE 272,A00,102397,Li; Tzumao,0,0,0,0
1668390985806,CSE 274,A00,111323,Chern; Albert Ren-Haur,0,0,0,0
1668390986231,CSE 282,A00,102398,Pevzner; Pavel Arkadjevich,0,0,0,0
1668390986655,CSE 284,A00,114175,Gymrek; Melissa Ann,0,0,0,0
1668390987079,CSE 290,A00,102399,Chandraker; Manmohan Krishna,0,0,0,0
1668390987079,CSE 290,B00,102400,Vaccaro; Kristen Marie,0,0,25,25
1668390987079,CSE 290,C00,102414,Pannuto; Patrick William,0,0,25,25
1668390987079,CSE 290,D00,102427,Pevzner; Pavel Arkadjevich,0,0,0,0
1668390987079,CSE 290,E00,102429,Zhao; Jishen,0,0,0,0
1668390987079,CSE 290,F00,102436,Tullsen; Dean Michael,0,0,0,0
1668390987079,CSE 290,G00,102440,Christensen; Henrik I,0,0,20,20
1668390987508,CSE 291,A00,102443,Su; Hao,0,0,0,0
1668390987508,CSE 291,B00,102448,Polikarpova; Nadezhda,0,0,0,0
1668390987508,CSE 291,C00,102453,Vaccaro; Kristen Marie,0,0,0,0
1668390987508,CSE 291,D00,111343,Savage; Stefan,0,0,0,0
1668390987508,CSE 291,E00,116474,Claffy; Kimberly Claire,0,0,0,0
1668390987508,CSE 291,F00,116479,Pasquale; Joseph,0,0,0,0
1668390987936,CSE 293,001,119111,Bafna; Vineet,9999,0,9999,0
1668390987936,CSE 293,002,119118,Bellare; Mihir,9999,0,9999,0
1668390987936,CSE 293,003,119122,Berg-Kirkpatrick; Taylor D,9999,0,9999,0
1668390987936,CSE 293,004,119135,Christensen; Henrik I,9999,0,9999,0
1668390987936,CSE 293,005,119142,Cottrell; Garrison W,9999,0,9999,0
1668390987936,CSE 293,006,119146,Deutsch; Alin Bernard,9999,0,9999,0
1668390987936,CSE 293,007,119159,Esmaeilzadeh; Hadi,9999,0,9999,0
1668390987936,CSE 293,008,119166,Freund; Yoav,9999,0,9999,0
1668390987936,CSE 293,009,119170,Griswold; William G.,9999,0,9999,0
1668390987936,CSE 293,010,119183,Gymrek; Melissa Ann,9999,0,9999,0
1668390987936,CSE 293,011,119190,Heninger; Nadia A,9999,0,9999,0
1668390987936,CSE 293,012,119230,Impagliazzo; Russell,9999,0,9999,0
1668390987936,CSE 293,013,119232,Jhala; Ranjit,9999,0,9999,0
1668390987936,CSE 293,014,119233,Kahng; Andrew Byun,9999,0,9999,0
1668390987936,CSE 293,015,119298,Kane; Daniel Mertz,9999,0,9999,0
1668390987936,CSE 293,016,119299,Kriegman; David J,9999,0,9999,0
1668390987936,CSE 293,017,119300,Kumar; Arun Kumar,9999,0,9999,0
1668390987936,CSE 293,018,119301,Lerner; Sorin,9999,0,9999,0
1668390987936,CSE 293,019,119302,Lovett; Shachar,9999,0,9999,0
1668390987936,CSE 293,020,119303,McAuley; Julian John,9999,0,9999,0
1668390987936,CSE 293,021,119304,Micciancio; Daniele,9999,0,9999,0
1668390987936,CSE 293,022,119367,Orailoglu; Alex,9999,0,9999,0
1668390987936,CSE 293,023,119382,Paturi; Ramamohan,9999,0,9999,0
1668390987936,CSE 293,024,119404,Polikarpova; Nadezhda,9999,0,9999,0
1668390987936,CSE 293,025,119406,Politz; Joseph Gibbs,9999,0,9999,0
1668390987936,CSE 293,026,119411,Porter; George M,9999,0,9999,0
1668390987936,CSE 293,027,119414,Porter; Leonard Emerson,9999,0,9999,0
1668390987936,CSE 293,028,119416,Ramamoorthi; Ravi,9999,0,9999,0
1668390987936,CSE 293,029,119417,Sahoo; Debashis,9999,0,9999,0
1668390987936,CSE 293,030,119420,Saul; Lawrence,9999,0,9999,0
1668390987936,CSE 293,031,119421,Savage; Stefan,9999,0,9999,0
1668390987936,CSE 293,032,119425,Schulze; Jurgen P.,9999,0,9999,0
1668390987936,CSE 293,033,119426,Snoeren; Alex C.,9999,0,9999,0
1668390987936,CSE 293,034,119428,Shang; Jingbo,9999,0,9999,0
1668390987936,CSE 293,035,119430,Stefan; Deian,9999,0,9999,0
1668390987936,CSE 293,036,119431,Su; Hao,9999,0,9999,0
1668390987936,CSE 293,037,119433,Swanson; Steven James,9999,0,9999,0
1668390987936,CSE 293,038,119435,Tullsen; Dean Michael,9999,0,9999,0
1668390987936,CSE 293,039,119483,Voelker; Geoffrey M.,9999,0,9999,0
1668390987936,CSE 293,040,119537,Zhao; Jishen,9999,0,9999,0
1668390987936,CSE 293,041,119538,Zhou; Yuan-Yuan,9999,0,9999,0
1668390987936,CSE 293,042,119539,Gao; Sicun,9999,0,9999,0
1668390987936,CSE 293,043,119540,Weibel; Nadir,9999,0,9999,0
1668390987936,CSE 293,044,119541,Gupta; Rajesh K.,9999,0,9999,0
1668390987936,CSE 293,045,126410,Vaccaro; Kristen Marie,9999,0,9999,0
1668390987936,CSE 293,046,126411,Klemke; Richard,9999,0,9999,0
1668390988362,CSE 294,A00,102459,Voelker; Geoffrey M.,0,0,0,0
1668390988362,CSE 294,B00,111322,Orailoglu; Alex,0,0,0,0
1668390988791,DSE 201,A00,096914,Deutsch; Alin Bernard,30,0,30,0
1668390989226,DSE 210,A00,096915,Dasgupta; Sanjoy,30,0,30,0
1668390989653,DSE 260A,A00,096916,Altintas De Callaf; Ilkay,30,0,30,0
1668390990090,ECE 200,001,103586,Antipa; Nicholas A,9999,0,9999,0
1668390990090,ECE 200,002,103587,Atanasov; Nikolay A.,9999,0,9999,0
1668390990090,ECE 200,003,103588,Bharadia; Dinesh,9999,0,9999,0
1668390990090,ECE 200,004,103589,Cheng; Chung Kuan,9999,0,9999,0
1668390990090,ECE 200,005,103590,Cosman; Pamela C.,9999,0,9999,0
1668390990090,ECE 200,006,103591,Dayeh; Shadi Ahmad,9999,0,9999,0
1668390990090,ECE 200,007,103592,Fainman; Yeshaiahu,9999,0,9999,0
1668390990090,ECE 200,008,103593,Ford; Joseph Earl,9999,0,9999,0
1668390990090,ECE 200,009,103594,Franceschetti; Massimo,9999,0,9999,0
1668390990090,ECE 200,010,103595,Fullerton; Eric E,9999,0,9999,0
1668390990090,ECE 200,011,103596,Galton; Ian A,9999,0,9999,0
1668390990090,ECE 200,012,103597,Gilja; Vikash,9999,0,9999,0
1668390990090,ECE 200,013,103598,Hall; Drew A.,9999,0,9999,0
1668390990090,ECE 200,014,103599,Hsueh; Tzu-Chien,9999,0,9999,0
1668390990090,ECE 200,015,103600,Javidi; Tara,9999,0,9999,0
1668390990090,ECE 200,016,103601,Kahng; Andrew Byun,9999,0,9999,0
1668390990090,ECE 200,017,103602,Kim; Young-Han,9999,0,9999,0
1668390990090,ECE 200,018,103603,Koushanfar; Farinaz,9999,0,9999,0
1668390990090,ECE 200,019,103604,Kuzum; Duygu,9999,0,9999,0
1668390990090,ECE 200,020,103605,Le; Hanh-Phuc,9999,0,9999,0
1668390990090,ECE 200,021,103606,Lin; Bill,9999,0,9999,0
1668390990090,ECE 200,022,103607,Liu; Zhaowei,9998,0,9999,1
1668390990090,ECE 200,023,103608,Lo; Yu-Hwa,9999,0,9999,0
1668390990090,ECE 200,024,103609,Lomakin; Vitaliy,9999,0,9999,0
1668390990090,ECE 200,025,103610,Mercier; Patrick Philip,9999,0,9999,0
1668390990090,ECE 200,026,103611,Meyer; Florian,9999,0,9999,0
1668390990090,ECE 200,027,103612,Milstein; Laurence B.,9999,0,9999,0
1668390990090,ECE 200,028,103613,Mir Arabbaygi; Siavash,9999,0,9999,0
1668390990090,ECE 200,029,103614,Mookherjea; Shayan,9999,0,9999,0
1668390990090,ECE 200,030,103615,Morris; Karcher William,9999,0,9999,0
1668390990090,ECE 200,031,103616,Ng; Tse Nga,9999,0,9999,0
1668390990090,ECE 200,032,103617,Nguyen; Truong Quang,9999,0,9999,0
1668390990090,ECE 200,033,103618,Nomura; Kenji,9999,0,9999,0
1668390990090,ECE 200,034,103619,Orlitsky; Alon,9999,0,9999,0
1668390990090,ECE 200,035,103620,Pal; Piya,9999,0,9999,0
1668390990090,ECE 200,036,103621,Papen; George C.,9999,0,9999,0
1668390990090,ECE 200,037,103622,Radic; Stojan,9999,0,9999,0
1668390990090,ECE 200,038,103623,Rao; Bhaskar D.,9999,0,9999,0
1668390990090,ECE 200,039,103624,Rao; Ramesh R,9999,0,9999,0
1668390990090,ECE 200,040,103625,Rebeiz; Gabriel,9999,0,9999,0
1668390990090,ECE 200,041,103626,Sanford; John R,9999,0,9999,0
1668390990090,ECE 200,042,103627,Siegel; Paul H.,9999,0,9999,0
1668390990090,ECE 200,043,103628,Sievenpiper; Daniel F.,9999,0,9999,0
1668390990090,ECE 200,044,103629,Sworder; David D.,9999,0,9999,0
1668390990090,ECE 200,045,103630,Taur; Yuan,9999,0,9999,0
1668390990090,ECE 200,046,103631,Touri; Behrouz,9999,0,9999,0
1668390990090,ECE 200,047,103632,Trivedi; Mohan M.,9999,0,9999,0
1668390990090,ECE 200,048,103633,Vasconcelos; Nuno,9999,0,9999,0
1668390990090,ECE 200,049,103634,Wang; Xiaolong,9999,0,9999,0
1668390990090,ECE 200,050,103635,Xie; Pengtao,9999,0,9999,0
1668390990090,ECE 200,051,103636,Yip; Michael,9999,0,9999,0
1668390990090,ECE 200,052,103637,Zeger; Kenneth A.,999,0,999,0
1668390990090,ECE 200,053,103638,Zhang; Xinyu,9999,0,9999,0
1668390990090,ECE 200,054,103639,Turakhia; Yatish Girish,9999,0,9999,0
1668390990090,ECE 200,055,103640,Kang; Mingu,9999,0,9999,0
1668390990090,ECE 200,056,103641,Shi; Yuanyuan,9999,0,9999,0
1668390990090,ECE 200,057,103642,Wang; Edward Jay,9999,0,9999,0
1668390990090,ECE 200,058,103643,Zheng; Yang,9999,0,9999,0
1668390990513,ECE 202,A00,103644,Kuzum; Duygu,0,0,0,0
1668390990936,ECE 212BN,A00,103646,Ng; Tse Nga,0,0,0,0
1668390991358,ECE 221,A00,111493,Staff,0,0,0,0
1668390991782,ECE 222B,A00,103647,Lomakin; Vitaliy,0,0,0,0
1668390992206,ECE 230B,A00,103648,Taur; Yuan,0,0,0,0
1668390992635,ECE 238B,A00,103649,Garay; Javier,0,0,0,0
1668390993058,ECE 240B,A00,112900,Fainman; Yeshaiahu,0,0,0,0
1668390993485,ECE 247A,A00,103650,Jokerst; Jesse Vincent,0,0,0,0
1668390993907,ECE 247B,A00,103651,Wang; Joseph,0,0,0,0
1668390994330,ECE 250,A00,103652,Siegel; Paul H.,0,0,0,0
1668390994754,ECE 251A,A00,103654,Rao; Bhaskar D.,0,0,0,0
1668390995178,ECE 257B,A00,103655,Bharadia; Dinesh,0,0,0,0
1668390995605,ECE 258A,A00,103656,Milstein; Laurence B.,0,0,0,0
1668390996028,ECE 260B,A00,103658,Kang; Mingu,0,0,0,0
1668390996453,ECE 264A,A00,103659,Galton; Ian A,0,0,0,0
1668390996879,ECE 265A,A00,103661,Gudem; Prasad S.S.,0,0,0,0
1668390997304,ECE 265D,A00,103662,Gudem; Prasad S.S.,0,0,0,0
1668390997727,ECE 268,A00,103663,Koushanfar; Farinaz,0,0,0,0
1668390998151,ECE 269,A01,103665,Pal; Piya,0,0,0,0
1668390998582,ECE 271B,A00,103666,Vasconcelos; Manuela,0,0,0,0
1668390999005,ECE 276A,A00,103667,Atanasov; Nikolay A.,0,0,0,0
1668390999427,ECE 277,A00,103668,An; Cheolhong,0,0,0,0
1668390999854,ECE 279,A00,117947,Hall; Drew A.,0,0,0,0
1668391000700,ECE 283,A00,103670,Hsueh; Tzu-Chien,0,0,0,0
1668391001123,ECE 284,A00,103671,Turakhia; Yatish Girish,0,0,0,0
1668391001550,ECE 285,A00,103672,Zheng; Yang,0,0,0,0
1668391001550,ECE 285,B00,103673,Sworder; David D.,0,0,0,0
1668391001975,ECE 287,A00,103676,Javidi; Tara,0,0,0,0
1668391002400,MATH 200B,A00,098023,Salehi Golsefidy; Alireza,12,0,15,3
1668391002836,MATH 202B,A00,098024,Rhoades; Brendon Patrick,9,0,15,6
1668391003267,MATH 203B,A00,098025,Oprea; Dragos N.,10,0,15,5
1668391003694,MATH 204B,A00,098026,Sorensen; Claus M,13,0,15,2
1668391004117,MATH 208,A00,098027,Izadi; Elham,7,0,10,3
1668391004637,MATH 209,A00,098028,Pollack; Aaron,10,0,10,0
1668391005059,MATH 211A,A00,112919,Rogalski; Daniel,9,0,10,1
1668391005485,MATH 211B,A00,112920,Seward; Brandon M.,9,0,10,1
1668391005909,MATH 218,A00,098029,Li; Bo,10,0,10,0
1668391006337,MATH 220B,A00,098030,Novak; Jonathan I,11,0,15,4
1668391006766,MATH 221A,A00,098031,Ebenfelt; Peter F,13,0,15,2
1668391007198,MATH 231B,A00,098032,Zlatos; Andrej,12,0,15,3
1668391007621,MATH 240B,A00,098033,Ni; Lei,9,0,15,6
1668391008048,MATH 243,A00,098034,Jekel; David Andrew,10,0,10,0
1668391008471,MATH 245A,A00,098035,Nie; Jiawang,0,0,15,16
1668391008894,MATH 248,A00,098036,Bejenaru; Ioan,10,0,10,0
1668391009320,MATH 250B,A00,098037,Spolaor; Luca,14,0,15,1
1668391009744,MATH 258,A00,098038,Ni; Lei,10,0,10,0
1668391010166,MATH 264B,A00,098041,Rhoades; Brendon Patrick,9,0,15,6
1668391010593,MATH 268,A00,098042,Buss; Samuel R,10,0,10,0
1668391011022,MATH 269,A00,098043,Rhoades; Brendon Patrick,10,0,10,0
1668391011446,MATH 270B,A00,098044,Li; Bo,10,0,15,5
1668391011872,MATH 272B,A00,098045,Holst; Michael J,13,0,15,2
1668391012298,MATH 273A,A00,098046,Tian; Xiaochuan,10,0,15,5
1668391012735,MATH 275,A01,098048,Tian; Xiaochuan,6,0,10,4
1668391013159,MATH 278A,A00,098049,Holst; Michael J,8,0,10,2
1668391013586,MATH 278B,A00,098050,Cloninger; Alexander,10,0,10,0
1668391014009,MATH 278C,A00,098051,Nie; Jiawang,7,0,10,3
1668391014432,MATH 280B,A00,098052,Zheng; Tianyi,8,0,15,7
1668391014858,MATH 281B,A00,098053,Bradic; Jelena,0,0,15,15
1668391015282,MATH 282B,A00,098054,Arias-Castro; Ery,0,0,15,15
1668391015713,MATH 285,A00,098055,Fitzsimmons; Patrick J,0,0,15,17
1668391016141,MATH 287B,A00,098056,Arias-Castro; Ery,2,0,15,13
1668391016567,MATH 288,A00,098057,Agarwal; Pooja,9,0,10,1
1668391016567,MATH 288,B00,098058,Zhang; Danna,8,0,10,2
1668391016567,MATH 288,C00,098059,Williams; Ruth J,9,0,10,1
1668391016993,MATH 290B,A00,098060,Roberts; Justin Deritter,13,0,15,2
1668391017431,MATH 292,A00,098061,Belmont; Eva Kinoshita,10,0,10,0
1668391017854,MATH 295,A00,098062,Suk; Andrew Hoon,48,0,50,2
1668391018294,MATH 296,A00,098063,Novak; Jonathan I,20,0,20,0
1668391018729,MATH 297,001,098064,Gamst; Anthony Collins,9997,0,9999,2
1668391519046,COGS 205,A00,101395,Chiba; Andrea,19,0,20,1
1668391519470,COGS 210B,001,101404,Greene; Deanna Jacquelyn,9998,0,9999,1
1668391519470,COGS 210B,002,101417,Xia; Haijun,9999,0,9999,0
1668391519470,COGS 210B,003,101422,Nitz; Douglas A.,9999,0,9999,0
1668391519470,COGS 210B,004,101423,Hollan; James D.,9998,0,9999,1
1668391519470,COGS 210B,005,101424,Deak; Gedeon O.,9998,0,9999,1
1668391519470,COGS 210B,006,101425,Rossano; Federico,9999,0,9999,0
1668391519892,COGS 211B,A00,101427,Coulson; Seana M,9996,0,9999,3
1668391520316,COGS 220,A00,101428,Hollan; James D.,0,0,25,25
1668391520739,COGS 229,A00,101429,Dow; Steven P,18,0,25,7
1668391521169,COGS 230,A00,101430,Klemmer; Scott R,11,0,17,6
1668391521594,COGS 234,A00,101431,Xia; Haijun,1,0,25,24
1668391522016,COGS 260,A00,101432,Kiyonaga; Anastasia,21,0,25,4
1668391522016,COGS 260,B00,101433,Kirsh; David Joel,15,0,25,10
1668391522439,CSE 202,A00,102371,Impagliazzo; Russell,0,0,0,0
1668391522863,CSE 203B,A01,102373,Cheng; Chung Kuan,0,0,0,0
1668391523286,CSE 208,A00,102374,Micciancio; Daniele,0,0,0,0
1668391523710,CSE 209A,A00,112895,Impagliazzo; Russell,0,0,15,15
1668391524134,CSE 209B,A00,108005,Bellare; Mihir,0,0,0,0
1668391524567,CSE 210,A00,113163,Coblenz; Michael J,0,0,0,0
1668391525083,CSE 219,A00,106111,Dow; Steven P,0,0,20,20
1668391525510,CSE 221,A00,102376,Voelker; Geoffrey M.,0,0,0,0
1668391525946,CSE 224,A01,102378,Porter; George M,0,0,0,0
1668391526383,CSE 229A,A00,102379,Savage; Stefan,0,0,0,0
1668391526818,CSE 229C,A00,102380,Munyaka; Imani N. S.,0,0,0,0
1668391527244,CSE 232B,A00,102382,Deutsch; Alin Bernard,0,0,0,0
1668391527672,CSE 234,A01,112904,Kumar; Arun Kumar,0,0,0,0
1668391528098,CSE 237A,A00,102383,Rosing; Tajana Simunic,0,0,0,0
1668391528524,CSE 239A,A00,102384,Deutsch; Alin Bernard,0,0,0,0
1668391528952,CSE 239B,A00,102385,Polikarpova; Nadezhda,0,0,0,0
1668391529378,CSE 240A,A00,102386,Pannuto; Patrick William,0,0,0,0
1668391529802,CSE 240B,A00,102387,Zhao; Jishen,0,0,0,0
1668391530227,CSE 241A,A00,106406,Kang; Mingu,0,0,0,0
1668391530651,CSE 249B,A00,102388,Kahng; Andrew Byun,0,0,8,8
1668391531079,CSE 251B,A01,102392,Cottrell; Garrison W,0,0,0,0
1668391531079,CSE 251B,A02,102393,Cottrell; Garrison W,0,0,0,0
1668391531503,CSE 252B,A00,102394,Ochoa; Benjamin Lawrence,0,0,0,0
1668391531927,CSE 257,A01,102396,Gao; Sicun,0,0,0,0
1668391532353,CSE 272,A00,102397,Li; Tzumao,0,0,0,0
1668391532776,CSE 274,A00,111323,Chern; Albert Ren-Haur,0,0,0,0
1668391533200,CSE 282,A00,102398,Pevzner; Pavel Arkadjevich,0,0,0,0
1668391533631,CSE 284,A00,114175,Gymrek; Melissa Ann,0,0,0,0
1668391534075,CSE 290,A00,102399,Chandraker; Manmohan Krishna,0,0,0,0
1668391534075,CSE 290,B00,102400,Vaccaro; Kristen Marie,0,0,25,25
1668391534075,CSE 290,C00,102414,Pannuto; Patrick William,0,0,25,25
1668391534075,CSE 290,D00,102427,Pevzner; Pavel Arkadjevich,0,0,0,0
1668391534075,CSE 290,E00,102429,Zhao; Jishen,0,0,0,0
1668391534075,CSE 290,F00,102436,Tullsen; Dean Michael,0,0,0,0
1668391534075,CSE 290,G00,102440,Christensen; Henrik I,0,0,20,20
1668391534499,CSE 291,A00,102443,Su; Hao,0,0,0,0
1668391534499,CSE 291,B00,102448,Polikarpova; Nadezhda,0,0,0,0
1668391534499,CSE 291,C00,102453,Vaccaro; Kristen Marie,0,0,0,0
1668391534499,CSE 291,D00,111343,Savage; Stefan,0,0,0,0
1668391534499,CSE 291,E00,116474,Claffy; Kimberly Claire,0,0,0,0
1668391534499,CSE 291,F00,116479,Pasquale; Joseph,0,0,0,0
1668391534938,CSE 293,001,119111,Bafna; Vineet,9999,0,9999,0
1668391534938,CSE 293,002,119118,Bellare; Mihir,9999,0,9999,0
1668391534938,CSE 293,003,119122,Berg-Kirkpatrick; Taylor D,9999,0,9999,0
1668391534938,CSE 293,004,119135,Christensen; Henrik I,9999,0,9999,0
1668391534938,CSE 293,005,119142,Cottrell; Garrison W,9999,0,9999,0
1668391534938,CSE 293,006,119146,Deutsch; Alin Bernard,9999,0,9999,0
1668391534938,CSE 293,007,119159,Esmaeilzadeh; Hadi,9999,0,9999,0
1668391534938,CSE 293,008,119166,Freund; Yoav,9999,0,9999,0
1668391534938,CSE 293,009,119170,Griswold; William G.,9999,0,9999,0
1668391534938,CSE 293,010,119183,Gymrek; Melissa Ann,9999,0,9999,0
1668391534938,CSE 293,011,119190,Heninger; Nadia A,9999,0,9999,0
1668391534938,CSE 293,012,119230,Impagliazzo; Russell,9999,0,9999,0
1668391534938,CSE 293,013,119232,Jhala; Ranjit,9999,0,9999,0
1668391534938,CSE 293,014,119233,Kahng; Andrew Byun,9999,0,9999,0
1668391534938,CSE 293,015,119298,Kane; Daniel Mertz,9999,0,9999,0
1668391534938,CSE 293,016,119299,Kriegman; David J,9999,0,9999,0
1668391534938,CSE 293,017,119300,Kumar; Arun Kumar,9999,0,9999,0
1668391534938,CSE 293,018,119301,Lerner; Sorin,9999,0,9999,0
1668391534938,CSE 293,019,119302,Lovett; Shachar,9999,0,9999,0
1668391534938,CSE 293,020,119303,McAuley; Julian John,9999,0,9999,0
1668391534938,CSE 293,021,119304,Micciancio; Daniele,9999,0,9999,0
1668391534938,CSE 293,022,119367,Orailoglu; Alex,9999,0,9999,0
1668391534938,CSE 293,023,119382,Paturi; Ramamohan,9999,0,9999,0
1668391534938,CSE 293,024,119404,Polikarpova; Nadezhda,9999,0,9999,0
1668391534938,CSE 293,025,119406,Politz; Joseph Gibbs,9999,0,9999,0
1668391534938,CSE 293,026,119411,Porter; George M,9999,0,9999,0
1668391534938,CSE 293,027,119414,Porter; Leonard Emerson,9999,0,9999,0
1668391534938,CSE 293,028,119416,Ramamoorthi; Ravi,9999,0,9999,0
1668391534938,CSE 293,029,119417,Sahoo; Debashis,9999,0,9999,0
1668391534938,CSE 293,030,119420,Saul; Lawrence,9999,0,9999,0
1668391534938,CSE 293,031,119421,Savage; Stefan,9999,0,9999,0
1668391534938,CSE 293,032,119425,Schulze; Jurgen P.,9999,0,9999,0
1668391534938,CSE 293,033,119426,Snoeren; Alex C.,9999,0,9999,0
1668391534938,CSE 293,034,119428,Shang; Jingbo,9999,0,9999,0
1668391534938,CSE 293,035,119430,Stefan; Deian,9999,0,9999,0
1668391534938,CSE 293,036,119431,Su; Hao,9999,0,9999,0
1668391534938,CSE 293,037,119433,Swanson; Steven James,9999,0,9999,0
1668391534938,CSE 293,038,119435,Tullsen; Dean Michael,9999,0,9999,0
1668391534938,CSE 293,039,119483,Voelker; Geoffrey M.,9999,0,9999,0
1668391534938,CSE 293,040,119537,Zhao; Jishen,9999,0,9999,0
1668391534938,CSE 293,041,119538,Zhou; Yuan-Yuan,9999,0,9999,0
1668391534938,CSE 293,042,119539,Gao; Sicun,9999,0,9999,0
1668391534938,CSE 293,043,119540,Weibel; Nadir,9999,0,9999,0
1668391534938,CSE 293,044,119541,Gupta; Rajesh K.,9999,0,9999,0
1668391534938,CSE 293,045,126410,Vaccaro; Kristen Marie,9999,0,9999,0
1668391534938,CSE 293,046,126411,Klemke; Richard,9999,0,9999,0
1668391535373,CSE 294,A00,102459,Voelker; Geoffrey M.,0,0,0,0
1668391535373,CSE 294,B00,111322,Orailoglu; Alex,0,0,0,0
1668391535797,DSE 201,A00,096914,Deutsch; Alin Bernard,30,0,30,0
1668391536225,DSE 210,A00,096915,Dasgupta; Sanjoy,30,0,30,0
1668391536650,DSE 260A,A00,096916,Altintas De Callaf; Ilkay,30,0,30,0
1668391537087,ECE 200,001,103586,Antipa; Nicholas A,9999,0,9999,0
1668391537087,ECE 200,002,103587,Atanasov; Nikolay A.,9999,0,9999,0
1668391537087,ECE 200,003,103588,Bharadia; Dinesh,9999,0,9999,0
1668391537087,ECE 200,004,103589,Cheng; Chung Kuan,9999,0,9999,0
1668391537087,ECE 200,005,103590,Cosman; Pamela C.,9999,0,9999,0
1668391537087,ECE 200,006,103591,Dayeh; Shadi Ahmad,9999,0,9999,0
1668391537087,ECE 200,007,103592,Fainman; Yeshaiahu,9999,0,9999,0
1668391537087,ECE 200,008,103593,Ford; Joseph Earl,9999,0,9999,0
1668391537087,ECE 200,009,103594,Franceschetti; Massimo,9999,0,9999,0
1668391537087,ECE 200,010,103595,Fullerton; Eric E,9999,0,9999,0
1668391537087,ECE 200,011,103596,Galton; Ian A,9999,0,9999,0
1668391537087,ECE 200,012,103597,Gilja; Vikash,9999,0,9999,0
1668391537087,ECE 200,013,103598,Hall; Drew A.,9999,0,9999,0
1668391537087,ECE 200,014,103599,Hsueh; Tzu-Chien,9999,0,9999,0
1668391537087,ECE 200,015,103600,Javidi; Tara,9999,0,9999,0
1668391537087,ECE 200,016,103601,Kahng; Andrew Byun,9999,0,9999,0
1668391537087,ECE 200,017,103602,Kim; Young-Han,9999,0,9999,0
1668391537087,ECE 200,018,103603,Koushanfar; Farinaz,9999,0,9999,0
1668391537087,ECE 200,019,103604,Kuzum; Duygu,9999,0,9999,0
1668391537087,ECE 200,020,103605,Le; Hanh-Phuc,9999,0,9999,0
1668391537087,ECE 200,021,103606,Lin; Bill,9999,0,9999,0
1668391537087,ECE 200,022,103607,Liu; Zhaowei,9998,0,9999,1
1668391537087,ECE 200,023,103608,Lo; Yu-Hwa,9999,0,9999,0
1668391537087,ECE 200,024,103609,Lomakin; Vitaliy,9999,0,9999,0
1668391537087,ECE 200,025,103610,Mercier; Patrick Philip,9999,0,9999,0
1668391537087,ECE 200,026,103611,Meyer; Florian,9999,0,9999,0
1668391537087,ECE 200,027,103612,Milstein; Laurence B.,9999,0,9999,0
1668391537087,ECE 200,028,103613,Mir Arabbaygi; Siavash,9999,0,9999,0
1668391537087,ECE 200,029,103614,Mookherjea; Shayan,9999,0,9999,0
1668391537087,ECE 200,030,103615,Morris; Karcher William,9999,0,9999,0
1668391537087,ECE 200,031,103616,Ng; Tse Nga,9999,0,9999,0
1668391537087,ECE 200,032,103617,Nguyen; Truong Quang,9999,0,9999,0
1668391537087,ECE 200,033,103618,Nomura; Kenji,9999,0,9999,0
1668391537087,ECE 200,034,103619,Orlitsky; Alon,9999,0,9999,0
1668391537087,ECE 200,035,103620,Pal; Piya,9999,0,9999,0
1668391537087,ECE 200,036,103621,Papen; George C.,9999,0,9999,0
1668391537087,ECE 200,037,103622,Radic; Stojan,9999,0,9999,0
1668391537087,ECE 200,038,103623,Rao; Bhaskar D.,9999,0,9999,0
1668391537087,ECE 200,039,103624,Rao; Ramesh R,9999,0,9999,0
1668391537087,ECE 200,040,103625,Rebeiz; Gabriel,9999,0,9999,0
1668391537087,ECE 200,041,103626,Sanford; John R,9999,0,9999,0
1668391537087,ECE 200,042,103627,Siegel; Paul H.,9999,0,9999,0
1668391537087,ECE 200,043,103628,Sievenpiper; Daniel F.,9999,0,9999,0
1668391537087,ECE 200,044,103629,Sworder; David D.,9999,0,9999,0
1668391537087,ECE 200,045,103630,Taur; Yuan,9999,0,9999,0
1668391537087,ECE 200,046,103631,Touri; Behrouz,9999,0,9999,0
1668391537087,ECE 200,047,103632,Trivedi; Mohan M.,9999,0,9999,0
1668391537087,ECE 200,048,103633,Vasconcelos; Nuno,9999,0,9999,0
1668391537087,ECE 200,049,103634,Wang; Xiaolong,9999,0,9999,0
1668391537087,ECE 200,050,103635,Xie; Pengtao,9999,0,9999,0
1668391537087,ECE 200,051,103636,Yip; Michael,9999,0,9999,0
1668391537087,ECE 200,052,103637,Zeger; Kenneth A.,999,0,999,0
1668391537087,ECE 200,053,103638,Zhang; Xinyu,9999,0,9999,0
1668391537087,ECE 200,054,103639,Turakhia; Yatish Girish,9999,0,9999,0
1668391537087,ECE 200,055,103640,Kang; Mingu,9999,0,9999,0
1668391537087,ECE 200,056,103641,Shi; Yuanyuan,9999,0,9999,0
1668391537087,ECE 200,057,103642,Wang; Edward Jay,9999,0,9999,0
1668391537087,ECE 200,058,103643,Zheng; Yang,9999,0,9999,0
1668391537512,ECE 202,A00,103644,Kuzum; Duygu,0,0,0,0
1668391537935,ECE 212BN,A00,103646,Ng; Tse Nga,0,0,0,0
1668391538367,ECE 221,A00,111493,Staff,0,0,0,0
1668391538795,ECE 222B,A00,103647,Lomakin; Vitaliy,0,0,0,0
1668391539223,ECE 230B,A00,103648,Taur; Yuan,0,0,0,0
1668391539650,ECE 238B,A00,103649,Garay; Javier,0,0,0,0
1668391540082,ECE 240B,A00,112900,Fainman; Yeshaiahu,0,0,0,0
1668391540506,ECE 247A,A00,103650,Jokerst; Jesse Vincent,0,0,0,0
1668391540930,ECE 247B,A00,103651,Wang; Joseph,0,0,0,0
1668391541362,ECE 250,A00,103652,Siegel; Paul H.,0,0,0,0
1668391541789,ECE 251A,A00,103654,Rao; Bhaskar D.,0,0,0,0
1668391542211,ECE 257B,A00,103655,Bharadia; Dinesh,0,0,0,0
1668391542647,ECE 258A,A00,103656,Milstein; Laurence B.,0,0,0,0
1668391543071,ECE 260B,A00,103658,Kang; Mingu,0,0,0,0
1668391543495,ECE 264A,A00,103659,Galton; Ian A,0,0,0,0
1668391543919,ECE 265A,A00,103661,Gudem; Prasad S.S.,0,0,0,0
1668391544356,ECE 265D,A00,103662,Gudem; Prasad S.S.,0,0,0,0
1668391544780,ECE 268,A00,103663,Koushanfar; Farinaz,0,0,0,0
1668391545206,ECE 269,A01,103665,Pal; Piya,0,0,0,0
1668391545631,ECE 271B,A00,103666,Vasconcelos; Manuela,0,0,0,0
1668391546058,ECE 276A,A00,103667,Atanasov; Nikolay A.,0,0,0,0
1668391546489,ECE 277,A00,103668,An; Cheolhong,0,0,0,0
1668391546922,ECE 279,A00,117947,Hall; Drew A.,0,0,0,0
1668391547772,ECE 283,A00,103670,Hsueh; Tzu-Chien,0,0,0,0
1668391548197,ECE 284,A00,103671,Turakhia; Yatish Girish,0,0,0,0
1668391548621,ECE 285,A00,103672,Zheng; Yang,0,0,0,0
1668391548621,ECE 285,B00,103673,Sworder; David D.,0,0,0,0
1668391549045,ECE 287,A00,103676,Javidi; Tara,0,0,0,0
1668391549474,MATH 200B,A00,098023,Salehi Golsefidy; Alireza,12,0,15,3
1668391549901,MATH 202B,A00,098024,Rhoades; Brendon Patrick,9,0,15,6
1668391550329,MATH 203B,A00,098025,Oprea; Dragos N.,10,0,15,5
1668391550754,MATH 204B,A00,098026,Sorensen; Claus M,13,0,15,2
1668391551177,MATH 208,A00,098027,Izadi; Elham,7,0,10,3
1668391551603,MATH 209,A00,098028,Pollack; Aaron,10,0,10,0
1668391552028,MATH 211A,A00,112919,Rogalski; Daniel,9,0,10,1
1668391552452,MATH 211B,A00,112920,Seward; Brandon M.,9,0,10,1
1668391552875,MATH 218,A00,098029,Li; Bo,10,0,10,0
1668391553302,MATH 220B,A00,098030,Novak; Jonathan I,11,0,15,4
1668391553729,MATH 221A,A00,098031,Ebenfelt; Peter F,13,0,15,2
1668391554152,MATH 231B,A00,098032,Zlatos; Andrej,12,0,15,3
1668391554576,MATH 240B,A00,098033,Ni; Lei,9,0,15,6
1668391555002,MATH 243,A00,098034,Jekel; David Andrew,10,0,10,0
1668391555435,MATH 245A,A00,098035,Nie; Jiawang,0,0,15,16
1668391555859,MATH 248,A00,098036,Bejenaru; Ioan,10,0,10,0
1668391556282,MATH 250B,A00,098037,Spolaor; Luca,14,0,15,1
1668391556706,MATH 258,A00,098038,Ni; Lei,10,0,10,0
1668391557133,MATH 264B,A00,098041,Rhoades; Brendon Patrick,9,0,15,6
1668391557556,MATH 268,A00,098042,Buss; Samuel R,10,0,10,0
1668391557984,MATH 269,A00,098043,Rhoades; Brendon Patrick,10,0,10,0
1668391558407,MATH 270B,A00,098044,Li; Bo,10,0,15,5
1668391558832,MATH 272B,A00,098045,Holst; Michael J,13,0,15,2
1668391559257,MATH 273A,A00,098046,Tian; Xiaochuan,10,0,15,5
1668391559680,MATH 275,A01,098048,Tian; Xiaochuan,6,0,10,4
1668391560103,MATH 278A,A00,098049,Holst; Michael J,8,0,10,2
1668391560535,MATH 278B,A00,098050,Cloninger; Alexander,10,0,10,0
1668391560963,MATH 278C,A00,098051,Nie; Jiawang,7,0,10,3
1668391561396,MATH 280B,A00,098052,Zheng; Tianyi,8,0,15,7
1668391561830,MATH 281B,A00,098053,Bradic; Jelena,0,0,15,15
1668391562254,MATH 282B,A00,098054,Arias-Castro; Ery,0,0,15,15
1668391562679,MATH 285,A00,098055,Fitzsimmons; Patrick J,0,0,15,17
1668391563102,MATH 287B,A00,098056,Arias-Castro; Ery,2,0,15,13
1668391563525,MATH 288,A00,098057,Agarwal; Pooja,9,0,10,1
1668391563525,MATH 288,B00,098058,Zhang; Danna,8,0,10,2
1668391563525,MATH 288,C00,098059,Williams; Ruth J,9,0,10,1
1668391563948,MATH 290B,A00,098060,Roberts; Justin Deritter,13,0,15,2
1668391564381,MATH 292,A00,098061,Belmont; Eva Kinoshita,10,0,10,0
1668391564808,MATH 295,A00,098062,Suk; Andrew Hoon,48,0,50,2
1668391565236,MATH 296,A00,098063,Novak; Jonathan I,20,0,20,0
1668391565659,MATH 297,001,098064,Gamst; Anthony Collins,9997,0,9999,2
1668392066093,COGS 205,A00,101395,Chiba; Andrea,19,0,20,1
1668392066521,COGS 210B,001,101404,Greene; Deanna Jacquelyn,9998,0,9999,1
1668392066521,COGS 210B,002,101417,Xia; Haijun,9999,0,9999,0
1668392066521,COGS 210B,003,101422,Nitz; Douglas A.,9999,0,9999,0
1668392066521,COGS 210B,004,101423,Hollan; James D.,9998,0,9999,1
1668392066521,COGS 210B,005,101424,Deak; Gedeon O.,9998,0,9999,1
1668392066521,COGS 210B,006,101425,Rossano; Federico,9999,0,9999,0
1668392066946,COGS 211B,A00,101427,Coulson; Seana M,9996,0,9999,3
1668392067373,COGS 220,A00,101428,Hollan; James D.,0,0,25,25
1668392067795,COGS 229,A00,101429,Dow; Steven P,18,0,25,7
1668392068223,COGS 230,A00,101430,Klemmer; Scott R,11,0,17,6
1668392068647,COGS 234,A00,101431,Xia; Haijun,1,0,25,24
1668392069069,COGS 260,A00,101432,Kiyonaga; Anastasia,21,0,25,4
1668392069069,COGS 260,B00,101433,Kirsh; David Joel,15,0,25,10
1668392069495,CSE 202,A00,102371,Impagliazzo; Russell,0,0,0,0
1668392069918,CSE 203B,A01,102373,Cheng; Chung Kuan,0,0,0,0
1668392070365,CSE 208,A00,102374,Micciancio; Daniele,0,0,0,0
1668392070790,CSE 209A,A00,112895,Impagliazzo; Russell,0,0,15,15
1668392071226,CSE 209B,A00,108005,Bellare; Mihir,0,0,0,0
1668392071648,CSE 210,A00,113163,Coblenz; Michael J,0,0,0,0
1668392072080,CSE 219,A00,106111,Dow; Steven P,0,0,20,20
1668392072504,CSE 221,A00,102376,Voelker; Geoffrey M.,0,0,0,0
1668392072931,CSE 224,A01,102378,Porter; George M,0,0,0,0
1668392073353,CSE 229A,A00,102379,Savage; Stefan,0,0,0,0
1668392073777,CSE 229C,A00,102380,Munyaka; Imani N. S.,0,0,0,0
1668392074205,CSE 232B,A00,102382,Deutsch; Alin Bernard,0,0,0,0
1668392074629,CSE 234,A01,112904,Kumar; Arun Kumar,0,0,0,0
1668392075056,CSE 237A,A00,102383,Rosing; Tajana Simunic,0,0,0,0
1668392075477,CSE 239A,A00,102384,Deutsch; Alin Bernard,0,0,0,0
1668392075899,CSE 239B,A00,102385,Polikarpova; Nadezhda,0,0,0,0
1668392076327,CSE 240A,A00,102386,Pannuto; Patrick William,0,0,0,0
1668392076759,CSE 240B,A00,102387,Zhao; Jishen,0,0,0,0
1668392077186,CSE 241A,A00,106406,Kang; Mingu,0,0,0,0
1668392077611,CSE 249B,A00,102388,Kahng; Andrew Byun,0,0,8,8
1668392078040,CSE 251B,A01,102392,Cottrell; Garrison W,0,0,0,0
1668392078040,CSE 251B,A02,102393,Cottrell; Garrison W,0,0,0,0
1668392078474,CSE 252B,A00,102394,Ochoa; Benjamin Lawrence,0,0,0,0
1668392078898,CSE 257,A01,102396,Gao; Sicun,0,0,0,0
1668392079320,CSE 272,A00,102397,Li; Tzumao,0,0,0,0
1668392079745,CSE 274,A00,111323,Chern; Albert Ren-Haur,0,0,0,0
1668392080168,CSE 282,A00,102398,Pevzner; Pavel Arkadjevich,0,0,0,0
1668392080595,CSE 284,A00,114175,Gymrek; Melissa Ann,0,0,0,0
1668392081018,CSE 290,A00,102399,Chandraker; Manmohan Krishna,0,0,0,0
1668392081018,CSE 290,B00,102400,Vaccaro; Kristen Marie,0,0,25,25
1668392081018,CSE 290,C00,102414,Pannuto; Patrick William,0,0,25,25
1668392081018,CSE 290,D00,102427,Pevzner; Pavel Arkadjevich,0,0,0,0
1668392081018,CSE 290,E00,102429,Zhao; Jishen,0,0,0,0
1668392081018,CSE 290,F00,102436,Tullsen; Dean Michael,0,0,0,0
1668392081018,CSE 290,G00,102440,Christensen; Henrik I,0,0,20,20
1668392081443,CSE 291,A00,102443,Su; Hao,0,0,0,0
1668392081443,CSE 291,B00,102448,Polikarpova; Nadezhda,0,0,0,0
1668392081443,CSE 291,C00,102453,Vaccaro; Kristen Marie,0,0,0,0
1668392081443,CSE 291,D00,111343,Savage; Stefan,0,0,0,0
1668392081443,CSE 291,E00,116474,Claffy; Kimberly Claire,0,0,0,0
1668392081443,CSE 291,F00,116479,Pasquale; Joseph,0,0,0,0
1668392081870,CSE 293,001,119111,Bafna; Vineet,9999,0,9999,0
1668392081870,CSE 293,002,119118,Bellare; Mihir,9999,0,9999,0
1668392081870,CSE 293,003,119122,Berg-Kirkpatrick; Taylor D,9999,0,9999,0
1668392081870,CSE 293,004,119135,Christensen; Henrik I,9999,0,9999,0
1668392081870,CSE 293,005,119142,Cottrell; Garrison W,9999,0,9999,0
1668392081870,CSE 293,006,119146,Deutsch; Alin Bernard,9999,0,9999,0
1668392081870,CSE 293,007,119159,Esmaeilzadeh; Hadi,9999,0,9999,0
1668392081870,CSE 293,008,119166,Freund; Yoav,9999,0,9999,0
1668392081870,CSE 293,009,119170,Griswold; William G.,9999,0,9999,0
1668392081870,CSE 293,010,119183,Gymrek; Melissa Ann,9999,0,9999,0
1668392081870,CSE 293,011,119190,Heninger; Nadia A,9999,0,9999,0
1668392081870,CSE 293,012,119230,Impagliazzo; Russell,9999,0,9999,0
1668392081870,CSE 293,013,119232,Jhala; Ranjit,9999,0,9999,0
1668392081870,CSE 293,014,119233,Kahng; Andrew Byun,9999,0,9999,0
1668392081870,CSE 293,015,119298,Kane; Daniel Mertz,9999,0,9999,0
1668392081870,CSE 293,016,119299,Kriegman; David J,9999,0,9999,0
1668392081870,CSE 293,017,119300,Kumar; Arun Kumar,9999,0,9999,0
1668392081870,CSE 293,018,119301,Lerner; Sorin,9999,0,9999,0
1668392081870,CSE 293,019,119302,Lovett; Shachar,9999,0,9999,0
1668392081870,CSE 293,020,119303,McAuley; Julian John,9999,0,9999,0
1668392081870,CSE 293,021,119304,Micciancio; Daniele,9999,0,9999,0
1668392081870,CSE 293,022,119367,Orailoglu; Alex,9999,0,9999,0
1668392081870,CSE 293,023,119382,Paturi; Ramamohan,9999,0,9999,0
1668392081870,CSE 293,024,119404,Polikarpova; Nadezhda,9999,0,9999,0
1668392081870,CSE 293,025,119406,Politz; Joseph Gibbs,9999,0,9999,0
1668392081870,CSE 293,026,119411,Porter; George M,9999,0,9999,0
1668392081870,CSE 293,027,119414,Porter; Leonard Emerson,9999,0,9999,0
1668392081870,CSE 293,028,119416,Ramamoorthi; Ravi,9999,0,9999,0
1668392081870,CSE 293,029,119417,Sahoo; Debashis,9999,0,9999,0
1668392081870,CSE 293,030,119420,Saul; Lawrence,9999,0,9999,0
1668392081870,CSE 293,031,119421,Savage; Stefan,9999,0,9999,0
1668392081870,CSE 293,032,119425,Schulze; Jurgen P.,9999,0,9999,0
1668392081870,CSE 293,033,119426,Snoeren; Alex C.,9999,0,9999,0
1668392081870,CSE 293,034,119428,Shang; Jingbo,9999,0,9999,0
1668392081870,CSE 293,035,119430,Stefan; Deian,9999,0,9999,0
1668392081870,CSE 293,036,119431,Su; Hao,9999,0,9999,0
1668392081870,CSE 293,037,119433,Swanson; Steven James,9999,0,9999,0
1668392081870,CSE 293,038,119435,Tullsen; Dean Michael,9999,0,9999,0
1668392081870,CSE 293,039,119483,Voelker; Geoffrey M.,9999,0,9999,0
1668392081870,CSE 293,040,119537,Zhao; Jishen,9999,0,9999,0
1668392081870,CSE 293,041,119538,Zhou; Yuan-Yuan,9999,0,9999,0
1668392081870,CSE 293,042,119539,Gao; Sicun,9999,0,9999,0
1668392081870,CSE 293,043,119540,Weibel; Nadir,9999,0,9999,0
1668392081870,CSE 293,044,119541,Gupta; Rajesh K.,9999,0,9999,0
1668392081870,CSE 293,045,126410,Vaccaro; Kristen Marie,9999,0,9999,0
1668392081870,CSE 293,046,126411,Klemke; Richard,9999,0,9999,0
1668392082294,CSE 294,A00,102459,Voelker; Geoffrey M.,0,0,0,0
1668392082294,CSE 294,B00,111322,Orailoglu; Alex,0,0,0,0
1668392082729,DSE 201,A00,096914,Deutsch; Alin Bernard,30,0,30,0
1668392083156,DSE 210,A00,096915,Dasgupta; Sanjoy,30,0,30,0
1668392083582,DSE 260A,A00,096916,Altintas De Callaf; Ilkay,30,0,30,0
1668392084013,ECE 200,001,103586,Antipa; Nicholas A,9999,0,9999,0
1668392084013,ECE 200,002,103587,Atanasov; Nikolay A.,9999,0,9999,0
1668392084013,ECE 200,003,103588,Bharadia; Dinesh,9999,0,9999,0
1668392084013,ECE 200,004,103589,Cheng; Chung Kuan,9999,0,9999,0
1668392084013,ECE 200,005,103590,Cosman; Pamela C.,9999,0,9999,0
1668392084013,ECE 200,006,103591,Dayeh; Shadi Ahmad,9999,0,9999,0
1668392084013,ECE 200,007,103592,Fainman; Yeshaiahu,9999,0,9999,0
1668392084013,ECE 200,008,103593,Ford; Joseph Earl,9999,0,9999,0
1668392084013,ECE 200,009,103594,Franceschetti; Massimo,9999,0,9999,0
1668392084013,ECE 200,010,103595,Fullerton; Eric E,9999,0,9999,0
1668392084013,ECE 200,011,103596,Galton; Ian A,9999,0,9999,0
1668392084013,ECE 200,012,103597,Gilja; Vikash,9999,0,9999,0
1668392084013,ECE 200,013,103598,Hall; Drew A.,9999,0,9999,0
1668392084013,ECE 200,014,103599,Hsueh; Tzu-Chien,9999,0,9999,0
1668392084013,ECE 200,015,103600,Javidi; Tara,9999,0,9999,0
1668392084013,ECE 200,016,103601,Kahng; Andrew Byun,9999,0,9999,0
1668392084013,ECE 200,017,103602,Kim; Young-Han,9999,0,9999,0
1668392084013,ECE 200,018,103603,Koushanfar; Farinaz,9999,0,9999,0
1668392084013,ECE 200,019,103604,Kuzum; Duygu,9999,0,9999,0
1668392084013,ECE 200,020,103605,Le; Hanh-Phuc,9999,0,9999,0
1668392084013,ECE 200,021,103606,Lin; Bill,9999,0,9999,0
1668392084013,ECE 200,022,103607,Liu; Zhaowei,9998,0,9999,1
1668392084013,ECE 200,023,103608,Lo; Yu-Hwa,9999,0,9999,0
1668392084013,ECE 200,024,103609,Lomakin; Vitaliy,9999,0,9999,0
1668392084013,ECE 200,025,103610,Mercier; Patrick Philip,9999,0,9999,0
1668392084013,ECE 200,026,103611,Meyer; Florian,9999,0,9999,0
1668392084013,ECE 200,027,103612,Milstein; Laurence B.,9999,0,9999,0
1668392084013,ECE 200,028,103613,Mir Arabbaygi; Siavash,9999,0,9999,0
1668392084013,ECE 200,029,103614,Mookherjea; Shayan,9999,0,9999,0
1668392084013,ECE 200,030,103615,Morris; Karcher William,9999,0,9999,0
1668392084013,ECE 200,031,103616,Ng; Tse Nga,9999,0,9999,0
1668392084013,ECE 200,032,103617,Nguyen; Truong Quang,9999,0,9999,0
1668392084013,ECE 200,033,103618,Nomura; Kenji,9999,0,9999,0
1668392084013,ECE 200,034,103619,Orlitsky; Alon,9999,0,9999,0
1668392084013,ECE 200,035,103620,Pal; Piya,9999,0,9999,0
1668392084013,ECE 200,036,103621,Papen; George C.,9999,0,9999,0
1668392084013,ECE 200,037,103622,Radic; Stojan,9999,0,9999,0
1668392084013,ECE 200,038,103623,Rao; Bhaskar D.,9999,0,9999,0
1668392084013,ECE 200,039,103624,Rao; Ramesh R,9999,0,9999,0
1668392084013,ECE 200,040,103625,Rebeiz; Gabriel,9999,0,9999,0
1668392084013,ECE 200,041,103626,Sanford; John R,9999,0,9999,0
1668392084013,ECE 200,042,103627,Siegel; Paul H.,9999,0,9999,0
1668392084013,ECE 200,043,103628,Sievenpiper; Daniel F.,9999,0,9999,0
1668392084013,ECE 200,044,103629,Sworder; David D.,9999,0,9999,0
1668392084013,ECE 200,045,103630,Taur; Yuan,9999,0,9999,0
1668392084013,ECE 200,046,103631,Touri; Behrouz,9999,0,9999,0
1668392084013,ECE 200,047,103632,Trivedi; Mohan M.,9999,0,9999,0
1668392084013,ECE 200,048,103633,Vasconcelos; Nuno,9999,0,9999,0
1668392084013,ECE 200,049,103634,Wang; Xiaolong,9999,0,9999,0
1668392084013,ECE 200,050,103635,Xie; Pengtao,9999,0,9999,0
1668392084013,ECE 200,051,103636,Yip; Michael,9999,0,9999,0
1668392084013,ECE 200,052,103637,Zeger; Kenneth A.,999,0,999,0
1668392084013,ECE 200,053,103638,Zhang; Xinyu,9999,0,9999,0
1668392084013,ECE 200,054,103639,Turakhia; Yatish Girish,9999,0,9999,0
1668392084013,ECE 200,055,103640,Kang; Mingu,9999,0,9999,0
1668392084013,ECE 200,056,103641,Shi; Yuanyuan,9999,0,9999,0
1668392084013,ECE 200,057,103642,Wang; Edward Jay,9999,0,9999,0
1668392084013,ECE 200,058,103643,Zheng; Yang,9999,0,9999,0
1668392084438,ECE 202,A00,103644,Kuzum; Duygu,0,0,0,0
1668392084862,ECE 212BN,A00,103646,Ng; Tse Nga,0,0,0,0
1668392085285,ECE 221,A00,111493,Staff,0,0,0,0
1668392085713,ECE 222B,A00,103647,Lomakin; Vitaliy,0,0,0,0
1668392086136,ECE 230B,A00,103648,Taur; Yuan,0,0,0,0
1668392086562,ECE 238B,A00,103649,Garay; Javier,0,0,0,0
1668392086991,ECE 240B,A00,112900,Fainman; Yeshaiahu,0,0,0,0
1668392087415,ECE 247A,A00,103650,Jokerst; Jesse Vincent,0,0,0,0
1668392087838,ECE 247B,A00,103651,Wang; Joseph,0,0,0,0
1668392088274,ECE 250,A00,103652,Siegel; Paul H.,0,0,0,0
1668392088771,ECE 251A,A00,103654,Rao; Bhaskar D.,0,0,0,0
1668392089195,ECE 257B,A00,103655,Bharadia; Dinesh,0,0,0,0
1668392089626,ECE 258A,A00,103656,Milstein; Laurence B.,0,0,0,0
1668392090049,ECE 260B,A00,103658,Kang; Mingu,0,0,0,0
1668392090473,ECE 264A,A00,103659,Galton; Ian A,0,0,0,0
1668392090896,ECE 265A,A00,103661,Gudem; Prasad S.S.,0,0,0,0
1668392091337,ECE 265D,A00,103662,Gudem; Prasad S.S.,0,0,0,0
1668392091772,ECE 268,A00,103663,Koushanfar; Farinaz,0,0,0,0
1668392092197,ECE 269,A01,103665,Pal; Piya,0,0,0,0
1668392092624,ECE 271B,A00,103666,Vasconcelos; Manuela,0,0,0,0
1668392093050,ECE 276A,A00,103667,Atanasov; Nikolay A.,0,0,0,0
1668392093474,ECE 277,A00,103668,An; Cheolhong,0,0,0,0
1668392093898,ECE 279,A00,117947,Hall; Drew A.,0,0,0,0
1668392094755,ECE 283,A00,103670,Hsueh; Tzu-Chien,0,0,0,0
1668392095179,ECE 284,A00,103671,Turakhia; Yatish Girish,0,0,0,0
1668392095604,ECE 285,A00,103672,Zheng; Yang,0,0,0,0
1668392095604,ECE 285,B00,103673,Sworder; David D.,0,0,0,0
1668392096028,ECE 287,A00,103676,Javidi; Tara,0,0,0,0
1668392096453,MATH 200B,A00,098023,Salehi Golsefidy; Alireza,12,0,15,3
1668392096876,MATH 202B,A00,098024,Rhoades; Brendon Patrick,9,0,15,6
1668392097302,MATH 203B,A00,098025,Oprea; Dragos N.,10,0,15,5
1668392097725,MATH 204B,A00,098026,Sorensen; Claus M,13,0,15,2
1668392098149,MATH 208,A00,098027,Izadi; Elham,7,0,10,3
1668392098572,MATH 209,A00,098028,Pollack; Aaron,10,0,10,0
1668392098998,MATH 211A,A00,112919,Rogalski; Daniel,9,0,10,1
1668392099421,MATH 211B,A00,112920,Seward; Brandon M.,9,0,10,1
1668392099847,MATH 218,A00,098029,Li; Bo,10,0,10,0
1668392100269,MATH 220B,A00,098030,Novak; Jonathan I,11,0,15,4
1668392100696,MATH 221A,A00,098031,Ebenfelt; Peter F,13,0,15,2
1668392101118,MATH 231B,A00,098032,Zlatos; Andrej,12,0,15,3
1668392101541,MATH 240B,A00,098033,Ni; Lei,9,0,15,6
1668392101966,MATH 243,A00,098034,Jekel; David Andrew,10,0,10,0
1668392102389,MATH 245A,A00,098035,Nie; Jiawang,0,0,15,16
1668392102814,MATH 248,A00,098036,Bejenaru; Ioan,10,0,10,0
1668392103239,MATH 250B,A00,098037,Spolaor; Luca,14,0,15,1
1668392103663,MATH 258,A00,098038,Ni; Lei,10,0,10,0
1668392104095,MATH 264B,A00,098041,Rhoades; Brendon Patrick,9,0,15,6
1668392104516,MATH 268,A00,098042,Buss; Samuel R,10,0,10,0
1668392104942,MATH 269,A00,098043,Rhoades; Brendon Patrick,10,0,10,0
1668392105366,MATH 270B,A00,098044,Li; Bo,10,0,15,5
1668392105790,MATH 272B,A00,098045,Holst; Michael J,13,0,15,2
1668392106212,MATH 273A,A00,098046,Tian; Xiaochuan,10,0,15,5
1668392106635,MATH 275,A01,098048,Tian; Xiaochuan,6,0,10,4
1668392107061,MATH 278A,A00,098049,Holst; Michael J,8,0,10,2
1668392107485,MATH 278B,A00,098050,Cloninger; Alexander,10,0,10,0
1668392107909,MATH 278C,A00,098051,Nie; Jiawang,7,0,10,3
1668392108339,MATH 280B,A00,098052,Zheng; Tianyi,8,0,15,7
1668392108765,MATH 281B,A00,098053,Bradic; Jelena,0,0,15,15
1668392109190,MATH 282B,A00,098054,Arias-Castro; Ery,0,0,15,15
1668392109620,MATH 285,A00,098055,Fitzsimmons; Patrick J,0,0,15,17
1668392110043,MATH 287B,A00,098056,Arias-Castro; Ery,2,0,15,13
1668392110467,MATH 288,A00,098057,Agarwal; Pooja,9,0,10,1
1668392110467,MATH 288,B00,098058,Zhang; Danna,8,0,10,2
1668392110467,MATH 288,C00,098059,Williams; Ruth J,9,0,10,1
1668392110895,MATH 290B,A00,098060,Roberts; Justin Deritter,13,0,15,2
1668392111325,MATH 292,A00,098061,Belmont; Eva Kinoshita,10,0,10,0
1668392111764,MATH 295,A00,098062,Suk; Andrew Hoon,48,0,50,2
1668392112189,MATH 296,A00,098063,Novak; Jonathan I,20,0,20,0
1668392112615,MATH 297,001,098064,Gamst; Anthony Collins,9997,0,9999,2
1668392613324,COGS 205,A00,101395,Chiba; Andrea,19,0,20,1
1668392613750,COGS 210B,001,101404,Greene; Deanna Jacquelyn,9998,0,9999,1
1668392613750,COGS 210B,002,101417,Xia; Haijun,9999,0,9999,0
1668392613750,COGS 210B,003,101422,Nitz; Douglas A.,9999,0,9999,0
1668392613750,COGS 210B,004,101423,Hollan; James D.,9998,0,9999,1
1668392613750,COGS 210B,005,101424,Deak; Gedeon O.,9998,0,9999,1
1668392613750,COGS 210B,006,101425,Rossano; Federico,9999,0,9999,0
1668392614177,COGS 211B,A00,101427,Coulson; Seana M,9996,0,9999,3
1668392614628,COGS 220,A00,101428,Hollan; James D.,0,0,25,25
1668392615054,COGS 229,A00,101429,Dow; Steven P,18,0,25,7
1668392615478,COGS 230,A00,101430,Klemmer; Scott R,11,0,17,6
1668392615901,COGS 234,A00,101431,Xia; Haijun,1,0,25,24
1668392616325,COGS 260,A00,101432,Kiyonaga; Anastasia,21,0,25,4
1668392616325,COGS 260,B00,101433,Kirsh; David Joel,15,0,25,10
1668392616767,CSE 202,A00,102371,Impagliazzo; Russell,0,0,0,0
1668392617190,CSE 203B,A01,102373,Cheng; Chung Kuan,0,0,0,0
1668392617615,CSE 208,A00,102374,Micciancio; Daniele,0,0,0,0
1668392618045,CSE 209A,A00,112895,Impagliazzo; Russell,0,0,15,15
1668392618469,CSE 209B,A00,108005,Bellare; Mihir,0,0,0,0
1668392618895,CSE 210,A00,113163,Coblenz; Michael J,0,0,0,0
1668392619323,CSE 219,A00,106111,Dow; Steven P,0,0,20,20
1668392619758,CSE 221,A00,102376,Voelker; Geoffrey M.,0,0,0,0
1668392620192,CSE 224,A01,102378,Porter; George M,0,0,0,0
1668392620629,CSE 229A,A00,102379,Savage; Stefan,0,0,0,0
1668392621051,CSE 229C,A00,102380,Munyaka; Imani N. S.,0,0,0,0
1668392621481,CSE 232B,A00,102382,Deutsch; Alin Bernard,0,0,0,0
1668392621904,CSE 234,A01,112904,Kumar; Arun Kumar,0,0,0,0
1668392622331,CSE 237A,A00,102383,Rosing; Tajana Simunic,0,0,0,0
1668392622756,CSE 239A,A00,102384,Deutsch; Alin Bernard,0,0,0,0
1668392623180,CSE 239B,A00,102385,Polikarpova; Nadezhda,0,0,0,0
1668392623611,CSE 240A,A00,102386,Pannuto; Patrick William,0,0,0,0
1668392624041,CSE 240B,A00,102387,Zhao; Jishen,0,0,0,0
1668392624464,CSE 241A,A00,106406,Kang; Mingu,0,0,0,0
1668392624886,CSE 249B,A00,102388,Kahng; Andrew Byun,0,0,8,8
1668392625314,CSE 251B,A01,102392,Cottrell; Garrison W,0,0,0,0
1668392625314,CSE 251B,A02,102393,Cottrell; Garrison W,0,0,0,0
1668392625753,CSE 252B,A00,102394,Ochoa; Benjamin Lawrence,0,0,0,0
1668392626177,CSE 257,A01,102396,Gao; Sicun,0,0,0,0
1668392626601,CSE 272,A00,102397,Li; Tzumao,0,0,0,0
1668392627026,CSE 274,A00,111323,Chern; Albert Ren-Haur,0,0,0,0
1668392627449,CSE 282,A00,102398,Pevzner; Pavel Arkadjevich,0,0,0,0
1668392627872,CSE 284,A00,114175,Gymrek; Melissa Ann,0,0,0,0
1668392628298,CSE 290,A00,102399,Chandraker; Manmohan Krishna,0,0,0,0
1668392628298,CSE 290,B00,102400,Vaccaro; Kristen Marie,0,0,25,25
1668392628298,CSE 290,C00,102414,Pannuto; Patrick William,0,0,25,25
1668392628298,CSE 290,D00,102427,Pevzner; Pavel Arkadjevich,0,0,0,0
1668392628298,CSE 290,E00,102429,Zhao; Jishen,0,0,0,0
1668392628298,CSE 290,F00,102436,Tullsen; Dean Michael,0,0,0,0
1668392628298,CSE 290,G00,102440,Christensen; Henrik I,0,0,20,20
1668392628726,CSE 291,A00,102443,Su; Hao,0,0,0,0
1668392628726,CSE 291,B00,102448,Polikarpova; Nadezhda,0,0,0,0
1668392628726,CSE 291,C00,102453,Vaccaro; Kristen Marie,0,0,0,0
1668392628726,CSE 291,D00,111343,Savage; Stefan,0,0,0,0
1668392628726,CSE 291,E00,116474,Claffy; Kimberly Claire,0,0,0,0
1668392628726,CSE 291,F00,116479,Pasquale; Joseph,0,0,0,0
1668392629152,CSE 293,001,119111,Bafna; Vineet,9999,0,9999,0
1668392629152,CSE 293,002,119118,Bellare; Mihir,9999,0,9999,0
1668392629152,CSE 293,003,119122,Berg-Kirkpatrick; Taylor D,9999,0,9999,0
1668392629152,CSE 293,004,119135,Christensen; Henrik I,9999,0,9999,0
1668392629152,CSE 293,005,119142,Cottrell; Garrison W,9999,0,9999,0
1668392629152,CSE 293,006,119146,Deutsch; Alin Bernard,9999,0,9999,0
1668392629152,CSE 293,007,119159,Esmaeilzadeh; Hadi,9999,0,9999,0
1668392629152,CSE 293,008,119166,Freund; Yoav,9999,0,9999,0
1668392629152,CSE 293,009,119170,Griswold; William G.,9999,0,9999,0
1668392629152,CSE 293,010,119183,Gymrek; Melissa Ann,9999,0,9999,0
1668392629152,CSE 293,011,119190,Heninger; Nadia A,9999,0,9999,0
1668392629152,CSE 293,012,119230,Impagliazzo; Russell,9999,0,9999,0
1668392629152,CSE 293,013,119232,Jhala; Ranjit,9999,0,9999,0
1668392629152,CSE 293,014,119233,Kahng; Andrew Byun,9999,0,9999,0
1668392629152,CSE 293,015,119298,Kane; Daniel Mertz,9999,0,9999,0
1668392629152,CSE 293,016,119299,Kriegman; David J,9999,0,9999,0
1668392629152,CSE 293,017,119300,Kumar; Arun Kumar,9999,0,9999,0
1668392629152,CSE 293,018,119301,Lerner; Sorin,9999,0,9999,0
1668392629152,CSE 293,019,119302,Lovett; Shachar,9999,0,9999,0
1668392629152,CSE 293,020,119303,McAuley; Julian John,9999,0,9999,0
1668392629152,CSE 293,021,119304,Micciancio; Daniele,9999,0,9999,0
1668392629152,CSE 293,022,119367,Orailoglu; Alex,9999,0,9999,0
1668392629152,CSE 293,023,119382,Paturi; Ramamohan,9999,0,9999,0
1668392629152,CSE 293,024,119404,Polikarpova; Nadezhda,9999,0,9999,0
1668392629152,CSE 293,025,119406,Politz; Joseph Gibbs,9999,0,9999,0
1668392629152,CSE 293,026,119411,Porter; George M,9999,0,9999,0
1668392629152,CSE 293,027,119414,Porter; Leonard Emerson,9999,0,9999,0
1668392629152,CSE 293,028,119416,Ramamoorthi; Ravi,9999,0,9999,0
1668392629152,CSE 293,029,119417,Sahoo; Debashis,9999,0,9999,0
1668392629152,CSE 293,030,119420,Saul; Lawrence,9999,0,9999,0
1668392629152,CSE 293,031,119421,Savage; Stefan,9999,0,9999,0
1668392629152,CSE 293,032,119425,Schulze; Jurgen P.,9999,0,9999,0
1668392629152,CSE 293,033,119426,Snoeren; Alex C.,9999,0,9999,0
1668392629152,CSE 293,034,119428,Shang; Jingbo,9999,0,9999,0
1668392629152,CSE 293,035,119430,Stefan; Deian,9999,0,9999,0
1668392629152,CSE 293,036,119431,Su; Hao,9999,0,9999,0
1668392629152,CSE 293,037,119433,Swanson; Steven James,9999,0,9999,0
1668392629152,CSE 293,038,119435,Tullsen; Dean Michael,9999,0,9999,0
1668392629152,CSE 293,039,119483,Voelker; Geoffrey M.,9999,0,9999,0
1668392629152,CSE 293,040,119537,Zhao; Jishen,9999,0,9999,0
1668392629152,CSE 293,041,119538,Zhou; Yuan-Yuan,9999,0,9999,0
1668392629152,CSE 293,042,119539,Gao; Sicun,9999,0,9999,0
1668392629152,CSE 293,043,119540,Weibel; Nadir,9999,0,9999,0
1668392629152,CSE 293,044,119541,Gupta; Rajesh K.,9999,0,9999,0
1668392629152,CSE 293,045,126410,Vaccaro; Kristen Marie,9999,0,9999,0
1668392629152,CSE 293,046,126411,Klemke; Richard,9999,0,9999,0
1668392629575,CSE 294,A00,102459,Voelker; Geoffrey M.,0,0,0,0
1668392629575,CSE 294,B00,111322,Orailoglu; Alex,0,0,0,0
1668392629998,DSE 201,A00,096914,Deutsch; Alin Bernard,30,0,30,0
1668392630422,DSE 210,A00,096915,Dasgupta; Sanjoy,30,0,30,0
1668392630846,DSE 260A,A00,096916,Altintas De Callaf; Ilkay,30,0,30,0
1668392631302,ECE 200,001,103586,Antipa; Nicholas A,9999,0,9999,0
1668392631302,ECE 200,002,103587,Atanasov; Nikolay A.,9999,0,9999,0
1668392631302,ECE 200,003,103588,Bharadia; Dinesh,9999,0,9999,0
1668392631302,ECE 200,004,103589,Cheng; Chung Kuan,9999,0,9999,0
1668392631302,ECE 200,005,103590,Cosman; Pamela C.,9999,0,9999,0
1668392631302,ECE 200,006,103591,Dayeh; Shadi Ahmad,9999,0,9999,0
1668392631302,ECE 200,007,103592,Fainman; Yeshaiahu,9999,0,9999,0
1668392631302,ECE 200,008,103593,Ford; Joseph Earl,9999,0,9999,0
1668392631302,ECE 200,009,103594,Franceschetti; Massimo,9999,0,9999,0
1668392631302,ECE 200,010,103595,Fullerton; Eric E,9999,0,9999,0
1668392631302,ECE 200,011,103596,Galton; Ian A,9999,0,9999,0
1668392631302,ECE 200,012,103597,Gilja; Vikash,9999,0,9999,0
1668392631302,ECE 200,013,103598,Hall; Drew A.,9999,0,9999,0
1668392631302,ECE 200,014,103599,Hsueh; Tzu-Chien,9999,0,9999,0
1668392631302,ECE 200,015,103600,Javidi; Tara,9999,0,9999,0
1668392631302,ECE 200,016,103601,Kahng; Andrew Byun,9999,0,9999,0
1668392631302,ECE 200,017,103602,Kim; Young-Han,9999,0,9999,0
1668392631302,ECE 200,018,103603,Koushanfar; Farinaz,9999,0,9999,0
1668392631302,ECE 200,019,103604,Kuzum; Duygu,9999,0,9999,0
1668392631302,ECE 200,020,103605,Le; Hanh-Phuc,9999,0,9999,0
1668392631302,ECE 200,021,103606,Lin; Bill,9999,0,9999,0
1668392631302,ECE 200,022,103607,Liu; Zhaowei,9998,0,9999,1
1668392631302,ECE 200,023,103608,Lo; Yu-Hwa,9999,0,9999,0
1668392631302,ECE 200,024,103609,Lomakin; Vitaliy,9999,0,9999,0
1668392631302,ECE 200,025,103610,Mercier; Patrick Philip,9999,0,9999,0
1668392631302,ECE 200,026,103611,Meyer; Florian,9999,0,9999,0
1668392631302,ECE 200,027,103612,Milstein; Laurence B.,9999,0,9999,0
1668392631302,ECE 200,028,103613,Mir Arabbaygi; Siavash,9999,0,9999,0
1668392631302,ECE 200,029,103614,Mookherjea; Shayan,9999,0,9999,0
1668392631302,ECE 200,030,103615,Morris; Karcher William,9999,0,9999,0
1668392631302,ECE 200,031,103616,Ng; Tse Nga,9999,0,9999,0
1668392631302,ECE 200,032,103617,Nguyen; Truong Quang,9999,0,9999,0
1668392631302,ECE 200,033,103618,Nomura; Kenji,9999,0,9999,0
1668392631302,ECE 200,034,103619,Orlitsky; Alon,9999,0,9999,0
1668392631302,ECE 200,035,103620,Pal; Piya,9999,0,9999,0
1668392631302,ECE 200,036,103621,Papen; George C.,9999,0,9999,0
1668392631302,ECE 200,037,103622,Radic; Stojan,9999,0,9999,0
1668392631302,ECE 200,038,103623,Rao; Bhaskar D.,9999,0,9999,0
1668392631302,ECE 200,039,103624,Rao; Ramesh R,9999,0,9999,0
1668392631302,ECE 200,040,103625,Rebeiz; Gabriel,9999,0,9999,0
1668392631302,ECE 200,041,103626,Sanford; John R,9999,0,9999,0
1668392631302,ECE 200,042,103627,Siegel; Paul H.,9999,0,9999,0
1668392631302,ECE 200,043,103628,Sievenpiper; Daniel F.,9999,0,9999,0
1668392631302,ECE 200,044,103629,Sworder; David D.,9999,0,9999,0
1668392631302,ECE 200,045,103630,Taur; Yuan,9999,0,9999,0
1668392631302,ECE 200,046,103631,Touri; Behrouz,9999,0,9999,0
1668392631302,ECE 200,047,103632,Trivedi; Mohan M.,9999,0,9999,0
1668392631302,ECE 200,048,103633,Vasconcelos; Nuno,9999,0,9999,0
1668392631302,ECE 200,049,103634,Wang; Xiaolong,9999,0,9999,0
1668392631302,ECE 200,050,103635,Xie; Pengtao,9999,0,9999,0
1668392631302,ECE 200,051,103636,Yip; Michael,9999,0,9999,0
1668392631302,ECE 200,052,103637,Zeger; Kenneth A.,999,0,999,0
1668392631302,ECE 200,053,103638,Zhang; Xinyu,9999,0,9999,0
1668392631302,ECE 200,054,103639,Turakhia; Yatish Girish,9999,0,9999,0
1668392631302,ECE 200,055,103640,Kang; Mingu,9999,0,9999,0
1668392631302,ECE 200,056,103641,Shi; Yuanyuan,9999,0,9999,0
1668392631302,ECE 200,057,103642,Wang; Edward Jay,9999,0,9999,0
1668392631302,ECE 200,058,103643,Zheng; Yang,9999,0,9999,0
1668392631727,ECE 202,A00,103644,Kuzum; Duygu,0,0,0,0
1668392632152,ECE 212BN,A00,103646,Ng; Tse Nga,0,0,0,0
1668392632579,ECE 221,A00,111493,Staff,0,0,0,0
1668392633014,ECE 222B,A00,103647,Lomakin; Vitaliy,0,0,0,0
1668392633453,ECE 230B,A00,103648,Taur; Yuan,0,0,0,0
1668392633882,ECE 238B,A00,103649,Garay; Javier,0,0,0,0
1668392634317,ECE 240B,A00,112900,Fainman; Yeshaiahu,0,0,0,0
1668392634740,ECE 247A,A00,103650,Jokerst; Jesse Vincent,0,0,0,0
1668392635164,ECE 247B,A00,103651,Wang; Joseph,0,0,0,0
1668392635587,ECE 250,A00,103652,Siegel; Paul H.,0,0,0,0
1668392636010,ECE 251A,A00,103654,Rao; Bhaskar D.,0,0,0,0
1668392636435,ECE 257B,A00,103655,Bharadia; Dinesh,0,0,0,0
1668392636861,ECE 258A,A00,103656,Milstein; Laurence B.,0,0,0,0
1668392637285,ECE 260B,A00,103658,Kang; Mingu,0,0,0,0
1668392637715,ECE 264A,A00,103659,Galton; Ian A,0,0,0,0
1668392638140,ECE 265A,A00,103661,Gudem; Prasad S.S.,0,0,0,0
1668392638575,ECE 265D,A00,103662,Gudem; Prasad S.S.,0,0,0,0
1668392638996,ECE 268,A00,103663,Koushanfar; Farinaz,0,0,0,0
1668392639427,ECE 269,A01,103665,Pal; Piya,0,0,0,0
1668392639857,ECE 271B,A00,103666,Vasconcelos; Manuela,0,0,0,0
1668392640284,ECE 276A,A00,103667,Atanasov; Nikolay A.,0,0,0,0
1668392640708,ECE 277,A00,103668,An; Cheolhong,0,0,0,0
1668392641136,ECE 279,A00,117947,Hall; Drew A.,0,0,0,0
1668392641984,ECE 283,A00,103670,Hsueh; Tzu-Chien,0,0,0,0
1668392642423,ECE 284,A00,103671,Turakhia; Yatish Girish,0,0,0,0
1668392642846,ECE 285,A00,103672,Zheng; Yang,0,0,0,0
1668392642846,ECE 285,B00,103673,Sworder; David D.,0,0,0,0
1668392643273,ECE 287,A00,103676,Javidi; Tara,0,0,0,0
1668392643697,MATH 200B,A00,098023,Salehi Golsefidy; Alireza,12,0,15,3
1668392644121,MATH 202B,A00,098024,Rhoades; Brendon Patrick,9,0,15,6
1668392644543,MATH 203B,A00,098025,Oprea; Dragos N.,10,0,15,5
1668392644970,MATH 204B,A00,098026,Sorensen; Claus M,13,0,15,2
1668392645395,MATH 208,A00,098027,Izadi; Elham,7,0,10,3
1668392645816,MATH 209,A00,098028,Pollack; Aaron,10,0,10,0
1668392646244,MATH 211A,A00,112919,Rogalski; Daniel,9,0,10,1
1668392646666,MATH 211B,A00,112920,Seward; Brandon M.,9,0,10,1
1668392647090,MATH 218,A00,098029,Li; Bo,10,0,10,0
1668392647516,MATH 220B,A00,098030,Novak; Jonathan I,11,0,15,4
1668392647941,MATH 221A,A00,098031,Ebenfelt; Peter F,13,0,15,2
1668392648367,MATH 231B,A00,098032,Zlatos; Andrej,12,0,15,3
1668392648798,MATH 240B,A00,098033,Ni; Lei,9,0,15,6
1668392649222,MATH 243,A00,098034,Jekel; David Andrew,10,0,10,0
1668392649645,MATH 245A,A00,098035,Nie; Jiawang,0,0,15,16
1668392650072,MATH 248,A00,098036,Bejenaru; Ioan,10,0,10,0
1668392650496,MATH 250B,A00,098037,Spolaor; Luca,14,0,15,1
1668392650923,MATH 258,A00,098038,Ni; Lei,10,0,10,0
1668392651349,MATH 264B,A00,098041,Rhoades; Brendon Patrick,9,0,15,6
1668392651786,MATH 268,A00,098042,Buss; Samuel R,10,0,10,0
1668392652208,MATH 269,A00,098043,Rhoades; Brendon Patrick,10,0,10,0
1668392652722,MATH 270B,A00,098044,Li; Bo,10,0,15,5
1668392653148,MATH 272B,A00,098045,Holst; Michael J,13,0,15,2
1668392653574,MATH 273A,A00,098046,Tian; Xiaochuan,10,0,15,5
1668392653999,MATH 275,A01,098048,Tian; Xiaochuan,6,0,10,4
1668392654422,MATH 278A,A00,098049,Holst; Michael J,8,0,10,2
1668392654856,MATH 278B,A00,098050,Cloninger; Alexander,10,0,10,0
1668392655280,MATH 278C,A00,098051,Nie; Jiawang,7,0,10,3
1668392655715,MATH 280B,A00,098052,Zheng; Tianyi,8,0,15,7
1668392656137,MATH 281B,A00,098053,Bradic; Jelena,0,0,15,15
1668392656568,MATH 282B,A00,098054,Arias-Castro; Ery,0,0,15,15
1668392656991,MATH 285,A00,098055,Fitzsimmons; Patrick J,0,0,15,17
1668392657418,MATH 287B,A00,098056,Arias-Castro; Ery,2,0,15,13
1668392657844,MATH 288,A00,098057,Agarwal; Pooja,9,0,10,1
1668392657844,MATH 288,B00,098058,Zhang; Danna,8,0,10,2
1668392657844,MATH 288,C00,098059,Williams; Ruth J,9,0,10,1
1668392658268,MATH 290B,A00,098060,Roberts; Justin Deritter,13,0,15,2
1668392658691,MATH 292,A00,098061,Belmont; Eva Kinoshita,10,0,10,0
1668392659117,MATH 295,A00,098062,Suk; Andrew Hoon,48,0,50,2
1668392659544,MATH 296,A00,098063,Novak; Jonathan I,20,0,20,0
1668392659967,MATH 297,001,098064,Gamst; Anthony Collins,9997,0,9999,2
1668393160186,COGS 205,A00,101395,Chiba; Andrea,19,0,20,1
1668393160630,COGS 210B,001,101404,Greene; Deanna Jacquelyn,9998,0,9999,1
1668393160630,COGS 210B,002,101417,Xia; Haijun,9999,0,9999,0
1668393160630,COGS 210B,003,101422,Nitz; Douglas A.,9999,0,9999,0
1668393160630,COGS 210B,004,101423,Hollan; James D.,9998,0,9999,1
1668393160630,COGS 210B,005,101424,Deak; Gedeon O.,9998,0,9999,1
1668393160630,COGS 210B,006,101425,Rossano; Federico,9999,0,9999,0
1668393161054,COGS 211B,A00,101427,Coulson; Seana M,9996,0,9999,3
1668393161479,COGS 220,A00,101428,Hollan; James D.,0,0,25,25
1668393161902,COGS 229,A00,101429,Dow; Steven P,18,0,25,7
1668393162332,COGS 230,A00,101430,Klemmer; Scott R,11,0,17,6
1668393162767,COGS 234,A00,101431,Xia; Haijun,1,0,25,24
1668393163194,COGS 260,A00,101432,Kiyonaga; Anastasia,21,0,25,4
1668393163194,COGS 260,B00,101433,Kirsh; David Joel,15,0,25,10
1668393163617,CSE 202,A00,102371,Impagliazzo; Russell,0,0,0,0
1668393164043,CSE 203B,A01,102373,Cheng; Chung Kuan,0,0,0,0
1668393164469,CSE 208,A00,102374,Micciancio; Daniele,0,0,0,0
1668393164898,CSE 209A,A00,112895,Impagliazzo; Russell,0,0,15,15
1668393165337,CSE 209B,A00,108005,Bellare; Mihir,0,0,0,0
1668393165776,CSE 210,A00,113163,Coblenz; Michael J,0,0,0,0
1668393166208,CSE 219,A00,106111,Dow; Steven P,0,0,20,20
1668393166631,CSE 221,A00,102376,Voelker; Geoffrey M.,0,0,0,0
1668393167061,CSE 224,A01,102378,Porter; George M,0,0,0,0
1668393167499,CSE 229A,A00,102379,Savage; Stefan,0,0,0,0
1668393167930,CSE 229C,A00,102380,Munyaka; Imani N. S.,0,0,0,0
1668393168355,CSE 232B,A00,102382,Deutsch; Alin Bernard,0,0,0,0
1668393168781,CSE 234,A01,112904,Kumar; Arun Kumar,0,0,0,0
1668393169203,CSE 237A,A00,102383,Rosing; Tajana Simunic,0,0,0,0
1668393169626,CSE 239A,A00,102384,Deutsch; Alin Bernard,0,0,0,0
1668393170053,CSE 239B,A00,102385,Polikarpova; Nadezhda,0,0,0,0
1668393170476,CSE 240A,A00,102386,Pannuto; Patrick William,0,0,0,0
1668393170901,CSE 240B,A00,102387,Zhao; Jishen,0,0,0,0
1668393171323,CSE 241A,A00,106406,Kang; Mingu,0,0,0,0
1668393171754,CSE 249B,A00,102388,Kahng; Andrew Byun,0,0,8,8
1668393172190,CSE 251B,A01,102392,Cottrell; Garrison W,0,0,0,0
1668393172190,CSE 251B,A02,102393,Cottrell; Garrison W,0,0,0,0
1668393172615,CSE 252B,A00,102394,Ochoa; Benjamin Lawrence,0,0,0,0
1668393173134,CSE 257,A01,102396,Gao; Sicun,0,0,0,0
1668393173562,CSE 272,A00,102397,Li; Tzumao,0,0,0,0
1668393173991,CSE 274,A00,111323,Chern; Albert Ren-Haur,0,0,0,0
1668393174432,CSE 282,A00,102398,Pevzner; Pavel Arkadjevich,0,0,0,0
1668393174866,CSE 284,A00,114175,Gymrek; Melissa Ann,0,0,0,0
1668393175293,CSE 290,A00,102399,Chandraker; Manmohan Krishna,0,0,0,0
1668393175293,CSE 290,B00,102400,Vaccaro; Kristen Marie,0,0,25,25
1668393175293,CSE 290,C00,102414,Pannuto; Patrick William,0,0,25,25
1668393175293,CSE 290,D00,102427,Pevzner; Pavel Arkadjevich,0,0,0,0
1668393175293,CSE 290,E00,102429,Zhao; Jishen,0,0,0,0
1668393175293,CSE 290,F00,102436,Tullsen; Dean Michael,0,0,0,0
1668393175293,CSE 290,G00,102440,Christensen; Henrik I,0,0,20,20
1668393175719,CSE 291,A00,102443,Su; Hao,0,0,0,0
1668393175719,CSE 291,B00,102448,Polikarpova; Nadezhda,0,0,0,0
1668393175719,CSE 291,C00,102453,Vaccaro; Kristen Marie,0,0,0,0
1668393175719,CSE 291,D00,111343,Savage; Stefan,0,0,0,0
1668393175719,CSE 291,E00,116474,Claffy; Kimberly Claire,0,0,0,0
1668393175719,CSE 291,F00,116479,Pasquale; Joseph,0,0,0,0
1668393176200,CSE 293,001,119111,Bafna; Vineet,9999,0,9999,0
1668393176200,CSE 293,002,119118,Bellare; Mihir,9999,0,9999,0
1668393176200,CSE 293,003,119122,Berg-Kirkpatrick; Taylor D,9999,0,9999,0
1668393176200,CSE 293,004,119135,Christensen; Henrik I,9999,0,9999,0
1668393176200,CSE 293,005,119142,Cottrell; Garrison W,9999,0,9999,0
1668393176200,CSE 293,006,119146,Deutsch; Alin Bernard,9999,0,9999,0
1668393176200,CSE 293,007,119159,Esmaeilzadeh; Hadi,9999,0,9999,0
1668393176200,CSE 293,008,119166,Freund; Yoav,9999,0,9999,0
1668393176200,CSE 293,009,119170,Griswold; William G.,9999,0,9999,0
1668393176200,CSE 293,010,119183,Gymrek; Melissa Ann,9999,0,9999,0
1668393176200,CSE 293,011,119190,Heninger; Nadia A,9999,0,9999,0
1668393176200,CSE 293,012,119230,Impagliazzo; Russell,9999,0,9999,0
1668393176200,CSE 293,013,119232,Jhala; Ranjit,9999,0,9999,0
1668393176200,CSE 293,014,119233,Kahng; Andrew Byun,9999,0,9999,0
1668393176200,CSE 293,015,119298,Kane; Daniel Mertz,9999,0,9999,0
1668393176200,CSE 293,016,119299,Kriegman; David J,9999,0,9999,0
1668393176200,CSE 293,017,119300,Kumar; Arun Kumar,9999,0,9999,0
1668393176200,CSE 293,018,119301,Lerner; Sorin,9999,0,9999,0
1668393176200,CSE 293,019,119302,Lovett; Shachar,9999,0,9999,0
1668393176200,CSE 293,020,119303,McAuley; Julian John,9999,0,9999,0
1668393176200,CSE 293,021,119304,Micciancio; Daniele,9999,0,9999,0
1668393176200,CSE 293,022,119367,Orailoglu; Alex,9999,0,9999,0
1668393176200,CSE 293,023,119382,Paturi; Ramamohan,9999,0,9999,0
1668393176200,CSE 293,024,119404,Polikarpova; Nadezhda,9999,0,9999,0
1668393176200,CSE 293,025,119406,Politz; Joseph Gibbs,9999,0,9999,0
1668393176200,CSE 293,026,119411,Porter; George M,9999,0,9999,0
1668393176200,CSE 293,027,119414,Porter; Leonard Emerson,9999,0,9999,0
1668393176200,CSE 293,028,119416,Ramamoorthi; Ravi,9999,0,9999,0
1668393176200,CSE 293,029,119417,Sahoo; Debashis,9999,0,9999,0
1668393176200,CSE 293,030,119420,Saul; Lawrence,9999,0,9999,0
1668393176200,CSE 293,031,119421,Savage; Stefan,9999,0,9999,0
1668393176200,CSE 293,032,119425,Schulze; Jurgen P.,9999,0,9999,0
1668393176200,CSE 293,033,119426,Snoeren; Alex C.,9999,0,9999,0
1668393176200,CSE 293,034,119428,Shang; Jingbo,9999,0,9999,0
1668393176200,CSE 293,035,119430,Stefan; Deian,9999,0,9999,0
1668393176200,CSE 293,036,119431,Su; Hao,9999,0,9999,0
1668393176200,CSE 293,037,119433,Swanson; Steven James,9999,0,9999,0
1668393176200,CSE 293,038,119435,Tullsen; Dean Michael,9999,0,9999,0
1668393176200,CSE 293,039,119483,Voelker; Geoffrey M.,9999,0,9999,0
1668393176200,CSE 293,040,119537,Zhao; Jishen,9999,0,9999,0
1668393176200,CSE 293,041,119538,Zhou; Yuan-Yuan,9999,0,9999,0
1668393176200,CSE 293,042,119539,Gao; Sicun,9999,0,9999,0
1668393176200,CSE 293,043,119540,Weibel; Nadir,9999,0,9999,0
1668393176200,CSE 293,044,119541,Gupta; Rajesh K.,9999,0,9999,0
1668393176200,CSE 293,045,126410,Vaccaro; Kristen Marie,9999,0,9999,0
1668393176200,CSE 293,046,126411,Klemke; Richard,9999,0,9999,0
1668393176624,CSE 294,A00,102459,Voelker; Geoffrey M.,0,0,0,0
1668393176624,CSE 294,B00,111322,Orailoglu; Alex,0,0,0,0
1668393177048,DSE 201,A00,096914,Deutsch; Alin Bernard,30,0,30,0
1668393177474,DSE 210,A00,096915,Dasgupta; Sanjoy,30,0,30,0
1668393177898,DSE 260A,A00,096916,Altintas De Callaf; Ilkay,30,0,30,0
1668393178325,ECE 200,001,103586,Antipa; Nicholas A,9999,0,9999,0
1668393178325,ECE 200,002,103587,Atanasov; Nikolay A.,9999,0,9999,0
1668393178325,ECE 200,003,103588,Bharadia; Dinesh,9999,0,9999,0
1668393178325,ECE 200,004,103589,Cheng; Chung Kuan,9999,0,9999,0
1668393178325,ECE 200,005,103590,Cosman; Pamela C.,9999,0,9999,0
1668393178325,ECE 200,006,103591,Dayeh; Shadi Ahmad,9999,0,9999,0
1668393178325,ECE 200,007,103592,Fainman; Yeshaiahu,9999,0,9999,0
1668393178325,ECE 200,008,103593,Ford; Joseph Earl,9999,0,9999,0
1668393178325,ECE 200,009,103594,Franceschetti; Massimo,9999,0,9999,0
1668393178325,ECE 200,010,103595,Fullerton; Eric E,9999,0,9999,0
1668393178325,ECE 200,011,103596,Galton; Ian A,9999,0,9999,0
1668393178325,ECE 200,012,103597,Gilja; Vikash,9999,0,9999,0
1668393178325,ECE 200,013,103598,Hall; Drew A.,9999,0,9999,0
1668393178325,ECE 200,014,103599,Hsueh; Tzu-Chien,9999,0,9999,0
1668393178325,ECE 200,015,103600,Javidi; Tara,9999,0,9999,0
1668393178325,ECE 200,016,103601,Kahng; Andrew Byun,9999,0,9999,0
1668393178325,ECE 200,017,103602,Kim; Young-Han,9999,0,9999,0
1668393178325,ECE 200,018,103603,Koushanfar; Farinaz,9999,0,9999,0
1668393178325,ECE 200,019,103604,Kuzum; Duygu,9999,0,9999,0
1668393178325,ECE 200,020,103605,Le; Hanh-Phuc,9999,0,9999,0
1668393178325,ECE 200,021,103606,Lin; Bill,9999,0,9999,0
1668393178325,ECE 200,022,103607,Liu; Zhaowei,9998,0,9999,1
1668393178325,ECE 200,023,103608,Lo; Yu-Hwa,9999,0,9999,0
1668393178325,ECE 200,024,103609,Lomakin; Vitaliy,9999,0,9999,0
1668393178325,ECE 200,025,103610,Mercier; Patrick Philip,9999,0,9999,0
1668393178325,ECE 200,026,103611,Meyer; Florian,9999,0,9999,0
1668393178325,ECE 200,027,103612,Milstein; Laurence B.,9999,0,9999,0
1668393178325,ECE 200,028,103613,Mir Arabbaygi; Siavash,9999,0,9999,0
1668393178325,ECE 200,029,103614,Mookherjea; Shayan,9999,0,9999,0
1668393178325,ECE 200,030,103615,Morris; Karcher William,9999,0,9999,0
1668393178325,ECE 200,031,103616,Ng; Tse Nga,9999,0,9999,0
1668393178325,ECE 200,032,103617,Nguyen; Truong Quang,9999,0,9999,0
1668393178325,ECE 200,033,103618,Nomura; Kenji,9999,0,9999,0
1668393178325,ECE 200,034,103619,Orlitsky; Alon,9999,0,9999,0
1668393178325,ECE 200,035,103620,Pal; Piya,9999,0,9999,0
1668393178325,ECE 200,036,103621,Papen; George C.,9999,0,9999,0
1668393178325,ECE 200,037,103622,Radic; Stojan,9999,0,9999,0
1668393178325,ECE 200,038,103623,Rao; Bhaskar D.,9999,0,9999,0
1668393178325,ECE 200,039,103624,Rao; Ramesh R,9999,0,9999,0
1668393178325,ECE 200,040,103625,Rebeiz; Gabriel,9999,0,9999,0
1668393178325,ECE 200,041,103626,Sanford; John R,9999,0,9999,0
1668393178325,ECE 200,042,103627,Siegel; Paul H.,9999,0,9999,0
1668393178325,ECE 200,043,103628,Sievenpiper; Daniel F.,9999,0,9999,0
1668393178325,ECE 200,044,103629,Sworder; David D.,9999,0,9999,0
1668393178325,ECE 200,045,103630,Taur; Yuan,9999,0,9999,0
1668393178325,ECE 200,046,103631,Touri; Behrouz,9999,0,9999,0
1668393178325,ECE 200,047,103632,Trivedi; Mohan M.,9999,0,9999,0
1668393178325,ECE 200,048,103633,Vasconcelos; Nuno,9999,0,9999,0
1668393178325,ECE 200,049,103634,Wang; Xiaolong,9999,0,9999,0
1668393178325,ECE 200,050,103635,Xie; Pengtao,9999,0,9999,0
1668393178325,ECE 200,051,103636,Yip; Michael,9999,0,9999,0
1668393178325,ECE 200,052,103637,Zeger; Kenneth A.,999,0,999,0
1668393178325,ECE 200,053,103638,Zhang; Xinyu,9999,0,9999,0
1668393178325,ECE 200,054,103639,Turakhia; Yatish Girish,9999,0,9999,0
1668393178325,ECE 200,055,103640,Kang; Mingu,9999,0,9999,0
1668393178325,ECE 200,056,103641,Shi; Yuanyuan,9999,0,9999,0
1668393178325,ECE 200,057,103642,Wang; Edward Jay,9999,0,9999,0
1668393178325,ECE 200,058,103643,Zheng; Yang,9999,0,9999,0
1668393178752,ECE 202,A00,103644,Kuzum; Duygu,0,0,0,0
1668393179176,ECE 212BN,A00,103646,Ng; Tse Nga,0,0,0,0
1668393179599,ECE 221,A00,111493,Staff,0,0,0,0
1668393180027,ECE 222B,A00,103647,Lomakin; Vitaliy,0,0,0,0
1668393180456,ECE 230B,A00,103648,Taur; Yuan,0,0,0,0
1668393180890,ECE 238B,A00,103649,Garay; Javier,0,0,0,0
1668393181323,ECE 240B,A00,112900,Fainman; Yeshaiahu,0,0,0,0
1668393181746,ECE 247A,A00,103650,Jokerst; Jesse Vincent,0,0,0,0
1668393182171,ECE 247B,A00,103651,Wang; Joseph,0,0,0,0
1668393182603,ECE 250,A00,103652,Siegel; Paul H.,0,0,0,0
1668393183026,ECE 251A,A00,103654,Rao; Bhaskar D.,0,0,0,0
1668393183449,ECE 257B,A00,103655,Bharadia; Dinesh,0,0,0,0
1668393183871,ECE 258A,A00,103656,Milstein; Laurence B.,0,0,0,0
1668393184295,ECE 260B,A00,103658,Kang; Mingu,0,0,0,0
1668393194456,ECE 264A,A00,103659,Galton; Ian A,0,0,0,0
1668393194882,ECE 265A,A00,103661,Gudem; Prasad S.S.,0,0,0,0
1668393195304,ECE 265D,A00,103662,Gudem; Prasad S.S.,0,0,0,0
1668393195731,ECE 268,A00,103663,Koushanfar; Farinaz,0,0,0,0
1668393196156,ECE 269,A01,103665,Pal; Piya,0,0,0,0
1668393196579,ECE 271B,A00,103666,Vasconcelos; Manuela,0,0,0,0
1668393197002,ECE 276A,A00,103667,Atanasov; Nikolay A.,0,0,0,0
1668393197432,ECE 277,A00,103668,An; Cheolhong,0,0,0,0
1668393197866,ECE 279,A00,117947,Hall; Drew A.,0,0,0,0
1668393198729,ECE 283,A00,103670,Hsueh; Tzu-Chien,0,0,0,0
1668393199156,ECE 284,A00,103671,Turakhia; Yatish Girish,0,0,0,0
1668393199582,ECE 285,A00,103672,Zheng; Yang,0,0,0,0
1668393199582,ECE 285,B00,103673,Sworder; David D.,0,0,0,0
1668393200014,ECE 287,A00,103676,Javidi; Tara,0,0,0,0
1668393200446,MATH 200B,A00,098023,Salehi Golsefidy; Alireza,12,0,15,3
1668393200872,MATH 202B,A00,098024,Rhoades; Brendon Patrick,9,0,15,6
1668393201302,MATH 203B,A00,098025,Oprea; Dragos N.,10,0,15,5
1668393201729,MATH 204B,A00,098026,Sorensen; Claus M,13,0,15,2
1668393202159,MATH 208,A00,098027,Izadi; Elham,7,0,10,3
1668393202586,MATH 209,A00,098028,Pollack; Aaron,10,0,10,0
1668393203011,MATH 211A,A00,112919,Rogalski; Daniel,9,0,10,1
1668393203438,MATH 211B,A00,112920,Seward; Brandon M.,9,0,10,1
1668393203868,MATH 218,A00,098029,Li; Bo,10,0,10,0
1668393204299,MATH 220B,A00,098030,Novak; Jonathan I,11,0,15,4
1668393204728,MATH 221A,A00,098031,Ebenfelt; Peter F,13,0,15,2
1668393205154,MATH 231B,A00,098032,Zlatos; Andrej,12,0,15,3
1668393205580,MATH 240B,A00,098033,Ni; Lei,9,0,15,6
1668393206004,MATH 243,A00,098034,Jekel; David Andrew,10,0,10,0
1668393206427,MATH 245A,A00,098035,Nie; Jiawang,0,0,15,16
1668393206858,MATH 248,A00,098036,Bejenaru; Ioan,10,0,10,0
1668393207302,MATH 250B,A00,098037,Spolaor; Luca,14,0,15,1
1668393207730,MATH 258,A00,098038,Ni; Lei,10,0,10,0
1668393208154,MATH 264B,A00,098041,Rhoades; Brendon Patrick,9,0,15,6
1668393208578,MATH 268,A00,098042,Buss; Samuel R,10,0,10,0
1668393209006,MATH 269,A00,098043,Rhoades; Brendon Patrick,10,0,10,0
1668393209432,MATH 270B,A00,098044,Li; Bo,10,0,15,5
1668393209854,MATH 272B,A00,098045,Holst; Michael J,13,0,15,2
1668393210277,MATH 273A,A00,098046,Tian; Xiaochuan,10,0,15,5
1668393210701,MATH 275,A01,098048,Tian; Xiaochuan,6,0,10,4
1668393211137,MATH 278A,A00,098049,Holst; Michael J,8,0,10,2
1668393211569,MATH 278B,A00,098050,Cloninger; Alexander,10,0,10,0
1668393211996,MATH 278C,A00,098051,Nie; Jiawang,6,0,10,4
1668393212419,MATH 280B,A00,098052,Zheng; Tianyi,8,0,15,7
1668393212841,MATH 281B,A00,098053,Bradic; Jelena,0,0,15,15
1668393213269,MATH 282B,A00,098054,Arias-Castro; Ery,0,0,15,15
1668393213692,MATH 285,A00,098055,Fitzsimmons; Patrick J,0,0,15,17
1668393214127,MATH 287B,A00,098056,Arias-Castro; Ery,2,0,15,13
1668393214557,MATH 288,A00,098057,Agarwal; Pooja,9,0,10,1
1668393214557,MATH 288,B00,098058,Zhang; Danna,8,0,10,2
1668393214557,MATH 288,C00,098059,Williams; Ruth J,9,0,10,1
1668393214983,MATH 290B,A00,098060,Roberts; Justin Deritter,13,0,15,2
1668393215410,MATH 292,A00,098061,Belmont; Eva Kinoshita,10,0,10,0
1668393215833,MATH 295,A00,098062,Suk; Andrew Hoon,48,0,50,2
1668393216270,MATH 296,A00,098063,Novak; Jonathan I,20,0,20,0
1668393216702,MATH 297,001,098064,Gamst; Anthony Collins,9997,0,9999,2
1668393717195,COGS 205,A00,101395,Chiba; Andrea,19,0,20,1
1668393717619,COGS 210B,001,101404,Greene; Deanna Jacquelyn,9998,0,9999,1
1668393717619,COGS 210B,002,101417,Xia; Haijun,9999,0,9999,0
1668393717619,COGS 210B,003,101422,Nitz; Douglas A.,9999,0,9999,0
1668393717619,COGS 210B,004,101423,Hollan; James D.,9998,0,9999,1
1668393717619,COGS 210B,005,101424,Deak; Gedeon O.,9998,0,9999,1
1668393717619,COGS 210B,006,101425,Rossano; Federico,9999,0,9999,0
1668393718050,COGS 211B,A00,101427,Coulson; Seana M,9996,0,9999,3
1668393718472,COGS 220,A00,101428,Hollan; James D.,0,0,25,25
1668393718897,COGS 229,A00,101429,Dow; Steven P,18,0,25,7
1668393719322,COGS 230,A00,101430,Klemmer; Scott R,11,0,17,6
1668393719746,COGS 234,A00,101431,Xia; Haijun,1,0,25,24
1668393720168,COGS 260,A00,101432,Kiyonaga; Anastasia,21,0,25,4
1668393720168,COGS 260,B00,101433,Kirsh; David Joel,15,0,25,10
1668393720597,CSE 202,A00,102371,Impagliazzo; Russell,0,0,0,0
1668393721021,CSE 203B,A01,102373,Cheng; Chung Kuan,0,0,0,0
1668393721449,CSE 208,A00,102374,Micciancio; Daniele,0,0,0,0
1668393721878,CSE 209A,A00,112895,Impagliazzo; Russell,0,0,15,15
1668393722313,CSE 209B,A00,108005,Bellare; Mihir,0,0,0,0
1668393722739,CSE 210,A00,113163,Coblenz; Michael J,0,0,0,0
1668393723162,CSE 219,A00,106111,Dow; Steven P,0,0,20,20
1668393723592,CSE 221,A00,102376,Voelker; Geoffrey M.,0,0,0,0
1668393724016,CSE 224,A01,102378,Porter; George M,0,0,0,0
1668393724444,CSE 229A,A00,102379,Savage; Stefan,0,0,0,0
1668393724875,CSE 229C,A00,102380,Munyaka; Imani N. S.,0,0,0,0
1668393725298,CSE 232B,A00,102382,Deutsch; Alin Bernard,0,0,0,0
1668393725726,CSE 234,A01,112904,Kumar; Arun Kumar,0,0,0,0
1668393726148,CSE 237A,A00,102383,Rosing; Tajana Simunic,0,0,0,0
1668393726572,CSE 239A,A00,102384,Deutsch; Alin Bernard,0,0,0,0
1668393726995,CSE 239B,A00,102385,Polikarpova; Nadezhda,0,0,0,0
1668393727421,CSE 240A,A00,102386,Pannuto; Patrick William,0,0,0,0
1668393727844,CSE 240B,A00,102387,Zhao; Jishen,0,0,0,0
1668393728268,CSE 241A,A00,106406,Kang; Mingu,0,0,0,0
1668393728692,CSE 249B,A00,102388,Kahng; Andrew Byun,0,0,8,8
1668393729121,CSE 251B,A01,102392,Cottrell; Garrison W,0,0,0,0
1668393729121,CSE 251B,A02,102393,Cottrell; Garrison W,0,0,0,0
1668393729544,CSE 252B,A00,102394,Ochoa; Benjamin Lawrence,0,0,0,0
1668393729971,CSE 257,A01,102396,Gao; Sicun,0,0,0,0
1668393730403,CSE 272,A00,102397,Li; Tzumao,0,0,0,0
1668393730826,CSE 274,A00,111323,Chern; Albert Ren-Haur,0,0,0,0
1668393731255,CSE 282,A00,102398,Pevzner; Pavel Arkadjevich,0,0,0,0
1668393731680,CSE 284,A00,114175,Gymrek; Melissa Ann,0,0,0,0
1668393732106,CSE 290,A00,102399,Chandraker; Manmohan Krishna,0,0,0,0
1668393732106,CSE 290,B00,102400,Vaccaro; Kristen Marie,0,0,25,25
1668393732106,CSE 290,C00,102414,Pannuto; Patrick William,0,0,25,25
1668393732106,CSE 290,D00,102427,Pevzner; Pavel Arkadjevich,0,0,0,0
1668393732106,CSE 290,E00,102429,Zhao; Jishen,0,0,0,0
1668393732106,CSE 290,F00,102436,Tullsen; Dean Michael,0,0,0,0
1668393732106,CSE 290,G00,102440,Christensen; Henrik I,0,0,20,20
1668393732543,CSE 291,A00,102443,Su; Hao,0,0,0,0
1668393732543,CSE 291,B00,102448,Polikarpova; Nadezhda,0,0,0,0
1668393732543,CSE 291,C00,102453,Vaccaro; Kristen Marie,0,0,0,0
1668393732543,CSE 291,D00,111343,Savage; Stefan,0,0,0,0
1668393732543,CSE 291,E00,116474,Claffy; Kimberly Claire,0,0,0,0
1668393732543,CSE 291,F00,116479,Pasquale; Joseph,0,0,0,0
1668393732968,CSE 293,001,119111,Bafna; Vineet,9999,0,9999,0
1668393732968,CSE 293,002,119118,Bellare; Mihir,9999,0,9999,0
1668393732968,CSE 293,003,119122,Berg-Kirkpatrick; Taylor D,9999,0,9999,0
1668393732968,CSE 293,004,119135,Christensen; Henrik I,9999,0,9999,0
1668393732968,CSE 293,005,119142,Cottrell; Garrison W,9999,0,9999,0
1668393732968,CSE 293,006,119146,Deutsch; Alin Bernard,9999,0,9999,0
1668393732968,CSE 293,007,119159,Esmaeilzadeh; Hadi,9999,0,9999,0
1668393732968,CSE 293,008,119166,Freund; Yoav,9999,0,9999,0
1668393732968,CSE 293,009,119170,Griswold; William G.,9999,0,9999,0
1668393732968,CSE 293,010,119183,Gymrek; Melissa Ann,9999,0,9999,0
1668393732968,CSE 293,011,119190,Heninger; Nadia A,9999,0,9999,0
1668393732968,CSE 293,012,119230,Impagliazzo; Russell,9999,0,9999,0
1668393732968,CSE 293,013,119232,Jhala; Ranjit,9999,0,9999,0
1668393732968,CSE 293,014,119233,Kahng; Andrew Byun,9999,0,9999,0
1668393732968,CSE 293,015,119298,Kane; Daniel Mertz,9999,0,9999,0
1668393732968,CSE 293,016,119299,Kriegman; David J,9999,0,9999,0
1668393732968,CSE 293,017,119300,Kumar; Arun Kumar,9999,0,9999,0
1668393732968,CSE 293,018,119301,Lerner; Sorin,9999,0,9999,0
1668393732968,CSE 293,019,119302,Lovett; Shachar,9999,0,9999,0
1668393732968,CSE 293,020,119303,McAuley; Julian John,9999,0,9999,0
1668393732968,CSE 293,021,119304,Micciancio; Daniele,9999,0,9999,0
1668393732968,CSE 293,022,119367,Orailoglu; Alex,9999,0,9999,0
1668393732968,CSE 293,023,119382,Paturi; Ramamohan,9999,0,9999,0
1668393732968,CSE 293,024,119404,Polikarpova; Nadezhda,9999,0,9999,0
1668393732968,CSE 293,025,119406,Politz; Joseph Gibbs,9999,0,9999,0
1668393732968,CSE 293,026,119411,Porter; George M,9999,0,9999,0
1668393732968,CSE 293,027,119414,Porter; Leonard Emerson,9999,0,9999,0
1668393732968,CSE 293,028,119416,Ramamoorthi; Ravi,9999,0,9999,0
1668393732968,CSE 293,029,119417,Sahoo; Debashis,9999,0,9999,0
1668393732968,CSE 293,030,119420,Saul; Lawrence,9999,0,9999,0
1668393732968,CSE 293,031,119421,Savage; Stefan,9999,0,9999,0
1668393732968,CSE 293,032,119425,Schulze; Jurgen P.,9999,0,9999,0
1668393732968,CSE 293,033,119426,Snoeren; Alex C.,9999,0,9999,0
1668393732968,CSE 293,034,119428,Shang; Jingbo,9999,0,9999,0
1668393732968,CSE 293,035,119430,Stefan; Deian,9999,0,9999,0
1668393732968,CSE 293,036,119431,Su; Hao,9999,0,9999,0
1668393732968,CSE 293,037,119433,Swanson; Steven James,9999,0,9999,0
1668393732968,CSE 293,038,119435,Tullsen; Dean Michael,9999,0,9999,0
1668393732968,CSE 293,039,119483,Voelker; Geoffrey M.,9999,0,9999,0
1668393732968,CSE 293,040,119537,Zhao; Jishen,9999,0,9999,0
1668393732968,CSE 293,041,119538,Zhou; Yuan-Yuan,9999,0,9999,0
1668393732968,CSE 293,042,119539,Gao; Sicun,9999,0,9999,0
1668393732968,CSE 293,043,119540,Weibel; Nadir,9999,0,9999,0
1668393732968,CSE 293,044,119541,Gupta; Rajesh K.,9999,0,9999,0
1668393732968,CSE 293,045,126410,Vaccaro; Kristen Marie,9999,0,9999,0
1668393732968,CSE 293,046,126411,Klemke; Richard,9999,0,9999,0
1668393733391,CSE 294,A00,102459,Voelker; Geoffrey M.,0,0,0,0
1668393733391,CSE 294,B00,111322,Orailoglu; Alex,0,0,0,0
1668393733815,DSE 201,A00,096914,Deutsch; Alin Bernard,30,0,30,0
1668393734239,DSE 210,A00,096915,Dasgupta; Sanjoy,30,0,30,0
1668393734664,DSE 260A,A00,096916,Altintas De Callaf; Ilkay,30,0,30,0
1668393735107,ECE 200,001,103586,Antipa; Nicholas A,9999,0,9999,0
1668393735107,ECE 200,002,103587,Atanasov; Nikolay A.,9999,0,9999,0
1668393735107,ECE 200,003,103588,Bharadia; Dinesh,9999,0,9999,0
1668393735107,ECE 200,004,103589,Cheng; Chung Kuan,9999,0,9999,0
1668393735107,ECE 200,005,103590,Cosman; Pamela C.,9999,0,9999,0
1668393735107,ECE 200,006,103591,Dayeh; Shadi Ahmad,9999,0,9999,0
1668393735107,ECE 200,007,103592,Fainman; Yeshaiahu,9999,0,9999,0
1668393735107,ECE 200,008,103593,Ford; Joseph Earl,9999,0,9999,0
1668393735107,ECE 200,009,103594,Franceschetti; Massimo,9999,0,9999,0
1668393735107,ECE 200,010,103595,Fullerton; Eric E,9999,0,9999,0
1668393735107,ECE 200,011,103596,Galton; Ian A,9999,0,9999,0
1668393735107,ECE 200,012,103597,Gilja; Vikash,9999,0,9999,0
1668393735107,ECE 200,013,103598,Hall; Drew A.,9999,0,9999,0
1668393735107,ECE 200,014,103599,Hsueh; Tzu-Chien,9999,0,9999,0
1668393735107,ECE 200,015,103600,Javidi; Tara,9999,0,9999,0
1668393735107,ECE 200,016,103601,Kahng; Andrew Byun,9999,0,9999,0
1668393735107,ECE 200,017,103602,Kim; Young-Han,9999,0,9999,0
1668393735107,ECE 200,018,103603,Koushanfar; Farinaz,9999,0,9999,0
1668393735107,ECE 200,019,103604,Kuzum; Duygu,9999,0,9999,0
1668393735107,ECE 200,020,103605,Le; Hanh-Phuc,9999,0,9999,0
1668393735107,ECE 200,021,103606,Lin; Bill,9999,0,9999,0
1668393735107,ECE 200,022,103607,Liu; Zhaowei,9998,0,9999,1
1668393735107,ECE 200,023,103608,Lo; Yu-Hwa,9999,0,9999,0
1668393735107,ECE 200,024,103609,Lomakin; Vitaliy,9999,0,9999,0
1668393735107,ECE 200,025,103610,Mercier; Patrick Philip,9999,0,9999,0
1668393735107,ECE 200,026,103611,Meyer; Florian,9999,0,9999,0
1668393735107,ECE 200,027,103612,Milstein; Laurence B.,9999,0,9999,0
1668393735107,ECE 200,028,103613,Mir Arabbaygi; Siavash,9999,0,9999,0
1668393735107,ECE 200,029,103614,Mookherjea; Shayan,9999,0,9999,0
1668393735107,ECE 200,030,103615,Morris; Karcher William,9999,0,9999,0
1668393735107,ECE 200,031,103616,Ng; Tse Nga,9999,0,9999,0
1668393735107,ECE 200,032,103617,Nguyen; Truong Quang,9999,0,9999,0
1668393735107,ECE 200,033,103618,Nomura; Kenji,9999,0,9999,0
1668393735107,ECE 200,034,103619,Orlitsky; Alon,9999,0,9999,0
1668393735107,ECE 200,035,103620,Pal; Piya,9999,0,9999,0
1668393735107,ECE 200,036,103621,Papen; George C.,9999,0,9999,0
1668393735107,ECE 200,037,103622,Radic; Stojan,9999,0,9999,0
1668393735107,ECE 200,038,103623,Rao; Bhaskar D.,9999,0,9999,0
1668393735107,ECE 200,039,103624,Rao; Ramesh R,9999,0,9999,0
1668393735107,ECE 200,040,103625,Rebeiz; Gabriel,9999,0,9999,0
1668393735107,ECE 200,041,103626,Sanford; John R,9999,0,9999,0
1668393735107,ECE 200,042,103627,Siegel; Paul H.,9999,0,9999,0
1668393735107,ECE 200,043,103628,Sievenpiper; Daniel F.,9999,0,9999,0
1668393735107,ECE 200,044,103629,Sworder; David D.,9999,0,9999,0
1668393735107,ECE 200,045,103630,Taur; Yuan,9999,0,9999,0
1668393735107,ECE 200,046,103631,Touri; Behrouz,9999,0,9999,0
1668393735107,ECE 200,047,103632,Trivedi; Mohan M.,9999,0,9999,0
1668393735107,ECE 200,048,103633,Vasconcelos; Nuno,9999,0,9999,0
1668393735107,ECE 200,049,103634,Wang; Xiaolong,9999,0,9999,0
1668393735107,ECE 200,050,103635,Xie; Pengtao,9999,0,9999,0
1668393735107,ECE 200,051,103636,Yip; Michael,9999,0,9999,0
1668393735107,ECE 200,052,103637,Zeger; Kenneth A.,999,0,999,0
1668393735107,ECE 200,053,103638,Zhang; Xinyu,9999,0,9999,0
1668393735107,ECE 200,054,103639,Turakhia; Yatish Girish,9999,0,9999,0
1668393735107,ECE 200,055,103640,Kang; Mingu,9999,0,9999,0
1668393735107,ECE 200,056,103641,Shi; Yuanyuan,9999,0,9999,0
1668393735107,ECE 200,057,103642,Wang; Edward Jay,9999,0,9999,0
1668393735107,ECE 200,058,103643,Zheng; Yang,9999,0,9999,0
1668393735530,ECE 202,A00,103644,Kuzum; Duygu,0,0,0,0
1668393735981,ECE 212BN,A00,103646,Ng; Tse Nga,0,0,0,0
1668393736416,ECE 221,A00,111493,Staff,0,0,0,0
1668393736843,ECE 222B,A00,103647,Lomakin; Vitaliy,0,0,0,0
1668393737280,ECE 230B,A00,103648,Taur; Yuan,0,0,0,0
1668393737706,ECE 238B,A00,103649,Garay; Javier,0,0,0,0
1668393738143,ECE 240B,A00,112900,Fainman; Yeshaiahu,0,0,0,0
1668393738576,ECE 247A,A00,103650,Jokerst; Jesse Vincent,0,0,0,0
1668393738999,ECE 247B,A00,103651,Wang; Joseph,0,0,0,0
1668393739442,ECE 250,A00,103652,Siegel; Paul H.,0,0,0,0
1668393739870,ECE 251A,A00,103654,Rao; Bhaskar D.,0,0,0,0
1668393740296,ECE 257B,A00,103655,Bharadia; Dinesh,0,0,0,0
1668393740720,ECE 258A,A00,103656,Milstein; Laurence B.,0,0,0,0
1668393741155,ECE 260B,A00,103658,Kang; Mingu,0,0,0,0
1668393741586,ECE 264A,A00,103659,Galton; Ian A,0,0,0,0
1668393742009,ECE 265A,A00,103661,Gudem; Prasad S.S.,0,0,0,0
1668393742434,ECE 265D,A00,103662,Gudem; Prasad S.S.,0,0,0,0
1668393742860,ECE 268,A00,103663,Koushanfar; Farinaz,0,0,0,0
1668393743284,ECE 269,A01,103665,Pal; Piya,0,0,0,0
1668393743707,ECE 271B,A00,103666,Vasconcelos; Manuela,0,0,0,0
1668393744129,ECE 276A,A00,103667,Atanasov; Nikolay A.,0,0,0,0
1668393744556,ECE 277,A00,103668,An; Cheolhong,0,0,0,0
1668393744982,ECE 279,A00,117947,Hall; Drew A.,0,0,0,0
1668393745828,ECE 283,A00,103670,Hsueh; Tzu-Chien,0,0,0,0
1668393746264,ECE 284,A00,103671,Turakhia; Yatish Girish,0,0,0,0
1668393746762,ECE 285,A00,103672,Zheng; Yang,0,0,0,0
1668393746762,ECE 285,B00,103673,Sworder; David D.,0,0,0,0
1668393747188,ECE 287,A00,103676,Javidi; Tara,0,0,0,0
1668393747612,MATH 200B,A00,098023,Salehi Golsefidy; Alireza,12,0,15,3
1668393748038,MATH 202B,A00,098024,Rhoades; Brendon Patrick,9,0,15,6
1668393748460,MATH 203B,A00,098025,Oprea; Dragos N.,10,0,15,5
1668393748886,MATH 204B,A00,098026,Sorensen; Claus M,13,0,15,2
1668393749310,MATH 208,A00,098027,Izadi; Elham,7,0,10,3
1668393749733,MATH 209,A00,098028,Pollack; Aaron,10,0,10,0
1668393750165,MATH 211A,A00,112919,Rogalski; Daniel,9,0,10,1
1668393750597,MATH 211B,A00,112920,Seward; Brandon M.,9,0,10,1
1668393751031,MATH 218,A00,098029,Li; Bo,10,0,10,0
1668393751456,MATH 220B,A00,098030,Novak; Jonathan I,11,0,15,4
1668393751893,MATH 221A,A00,098031,Ebenfelt; Peter F,13,0,15,2
1668393752324,MATH 231B,A00,098032,Zlatos; Andrej,12,0,15,3
1668393752759,MATH 240B,A00,098033,Ni; Lei,9,0,15,6
1668393753188,MATH 243,A00,098034,Jekel; David Andrew,10,0,10,0
1668393753615,MATH 245A,A00,098035,Nie; Jiawang,0,0,15,16
1668393754043,MATH 248,A00,098036,Bejenaru; Ioan,10,0,10,0
1668393754466,MATH 250B,A00,098037,Spolaor; Luca,14,0,15,1
1668393754898,MATH 258,A00,098038,Ni; Lei,10,0,10,0
1668393755323,MATH 264B,A00,098041,Rhoades; Brendon Patrick,9,0,15,6
1668393755747,MATH 268,A00,098042,Buss; Samuel R,10,0,10,0
1668393756172,MATH 269,A00,098043,Rhoades; Brendon Patrick,10,0,10,0
1668393756598,MATH 270B,A00,098044,Li; Bo,10,0,15,5
1668393757022,MATH 272B,A00,098045,Holst; Michael J,13,0,15,2
1668393757463,MATH 273A,A00,098046,Tian; Xiaochuan,10,0,15,5
1668393757903,MATH 275,A01,098048,Tian; Xiaochuan,6,0,10,4
1668393758327,MATH 278A,A00,098049,Holst; Michael J,8,0,10,2
1668393758751,MATH 278B,A00,098050,Cloninger; Alexander,10,0,10,0
1668393759175,MATH 278C,A00,098051,Nie; Jiawang,6,0,10,4
1668393759598,MATH 280B,A00,098052,Zheng; Tianyi,8,0,15,7
1668393760024,MATH 281B,A00,098053,Bradic; Jelena,0,0,15,15
1668393760450,MATH 282B,A00,098054,Arias-Castro; Ery,0,0,15,15
1668393760878,MATH 285,A00,098055,Fitzsimmons; Patrick J,0,0,15,17
1668393761302,MATH 287B,A00,098056,Arias-Castro; Ery,2,0,15,13
1668393761743,MATH 288,A00,098057,Agarwal; Pooja,9,0,10,1
1668393761743,MATH 288,B00,098058,Zhang; Danna,8,0,10,2
1668393761743,MATH 288,C00,098059,Williams; Ruth J,9,0,10,1
1668393762172,MATH 290B,A00,098060,Roberts; Justin Deritter,13,0,15,2
1668393762594,MATH 292,A00,098061,Belmont; Eva Kinoshita,10,0,10,0
1668393763018,MATH 295,A00,098062,Suk; Andrew Hoon,48,0,50,2
1668393763443,MATH 296,A00,098063,Novak; Jonathan I,20,0,20,0
1668393763867,MATH 297,001,098064,Gamst; Anthony Collins,9997,0,9999,2
1668394264487,COGS 205,A00,101395,Chiba; Andrea,19,0,20,1
1668394264910,COGS 210B,001,101404,Greene; Deanna Jacquelyn,9998,0,9999,1
1668394264910,COGS 210B,002,101417,Xia; Haijun,9999,0,9999,0
1668394264910,COGS 210B,003,101422,Nitz; Douglas A.,9999,0,9999,0
1668394264910,COGS 210B,004,101423,Hollan; James D.,9998,0,9999,1
1668394264910,COGS 210B,005,101424,Deak; Gedeon O.,9998,0,9999,1
1668394264910,COGS 210B,006,101425,Rossano; Federico,9999,0,9999,0
1668394265343,COGS 211B,A00,101427,Coulson; Seana M,9996,0,9999,3
1668394265773,COGS 220,A00,101428,Hollan; James D.,0,0,25,25
1668394266198,COGS 229,A00,101429,Dow; Steven P,18,0,25,7
1668394266622,COGS 230,A00,101430,Klemmer; Scott R,11,0,17,6
1668394267045,COGS 234,A00,101431,Xia; Haijun,1,0,25,24
1668394267554,COGS 260,A00,101432,Kiyonaga; Anastasia,21,0,25,4
1668394267554,COGS 260,B00,101433,Kirsh; David Joel,15,0,25,10
1668394267978,CSE 202,A00,102371,Impagliazzo; Russell,0,0,0,0
1668394268401,CSE 203B,A01,102373,Cheng; Chung Kuan,0,0,0,0
1668394268836,CSE 208,A00,102374,Micciancio; Daniele,0,0,0,0
1668394269260,CSE 209A,A00,112895,Impagliazzo; Russell,0,0,15,15
1668394269691,CSE 209B,A00,108005,Bellare; Mihir,0,0,0,0
1668394270115,CSE 210,A00,113163,Coblenz; Michael J,0,0,0,0
1668394270548,CSE 219,A00,106111,Dow; Steven P,0,0,20,20
1668394270971,CSE 221,A00,102376,Voelker; Geoffrey M.,0,0,0,0
1668394271398,CSE 224,A01,102378,Porter; George M,0,0,0,0
1668394271821,CSE 229A,A00,102379,Savage; Stefan,0,0,0,0
1668394272250,CSE 229C,A00,102380,Munyaka; Imani N. S.,0,0,0,0
1668394272691,CSE 232B,A00,102382,Deutsch; Alin Bernard,0,0,0,0
1668394273132,CSE 234,A01,112904,Kumar; Arun Kumar,0,0,0,0
1668394273557,CSE 237A,A00,102383,Rosing; Tajana Simunic,0,0,0,0
1668394273983,CSE 239A,A00,102384,Deutsch; Alin Bernard,0,0,0,0
1668394274413,CSE 239B,A00,102385,Polikarpova; Nadezhda,0,0,0,0
1668394274835,CSE 240A,A00,102386,Pannuto; Patrick William,0,0,0,0
1668394275259,CSE 240B,A00,102387,Zhao; Jishen,0,0,0,0
1668394275682,CSE 241A,A00,106406,Kang; Mingu,0,0,0,0
1668394276106,CSE 249B,A00,102388,Kahng; Andrew Byun,0,0,8,8
1668394276529,CSE 251B,A01,102392,Cottrell; Garrison W,0,0,0,0
1668394276529,CSE 251B,A02,102393,Cottrell; Garrison W,0,0,0,0
1668394276952,CSE 252B,A00,102394,Ochoa; Benjamin Lawrence,0,0,0,0
1668394277377,CSE 257,A01,102396,Gao; Sicun,0,0,0,0
1668394277799,CSE 272,A00,102397,Li; Tzumao,0,0,0,0
1668394278227,CSE 274,A00,111323,Chern; Albert Ren-Haur,0,0,0,0
1668394278651,CSE 282,A00,102398,Pevzner; Pavel Arkadjevich,0,0,0,0
1668394279073,CSE 284,A00,114175,Gymrek; Melissa Ann,0,0,0,0
1668394279497,CSE 290,A00,102399,Chandraker; Manmohan Krishna,0,0,0,0
1668394279497,CSE 290,B00,102400,Vaccaro; Kristen Marie,0,0,25,25
1668394279497,CSE 290,C00,102414,Pannuto; Patrick William,0,0,25,25
1668394279497,CSE 290,D00,102427,Pevzner; Pavel Arkadjevich,0,0,0,0
1668394279497,CSE 290,E00,102429,Zhao; Jishen,0,0,0,0
1668394279497,CSE 290,F00,102436,Tullsen; Dean Michael,0,0,0,0
1668394279497,CSE 290,G00,102440,Christensen; Henrik I,0,0,20,20
1668394279923,CSE 291,A00,102443,Su; Hao,0,0,0,0
1668394279923,CSE 291,B00,102448,Polikarpova; Nadezhda,0,0,0,0
1668394279923,CSE 291,C00,102453,Vaccaro; Kristen Marie,0,0,0,0
1668394279923,CSE 291,D00,111343,Savage; Stefan,0,0,0,0
1668394279923,CSE 291,E00,116474,Claffy; Kimberly Claire,0,0,0,0
1668394279923,CSE 291,F00,116479,Pasquale; Joseph,0,0,0,0
1668394280391,CSE 293,001,119111,Bafna; Vineet,9999,0,9999,0
1668394280391,CSE 293,002,119118,Bellare; Mihir,9999,0,9999,0
1668394280391,CSE 293,003,119122,Berg-Kirkpatrick; Taylor D,9999,0,9999,0
1668394280391,CSE 293,004,119135,Christensen; Henrik I,9999,0,9999,0
1668394280391,CSE 293,005,119142,Cottrell; Garrison W,9999,0,9999,0
1668394280391,CSE 293,006,119146,Deutsch; Alin Bernard,9999,0,9999,0
1668394280391,CSE 293,007,119159,Esmaeilzadeh; Hadi,9999,0,9999,0
1668394280391,CSE 293,008,119166,Freund; Yoav,9999,0,9999,0
1668394280391,CSE 293,009,119170,Griswold; William G.,9999,0,9999,0
1668394280391,CSE 293,010,119183,Gymrek; Melissa Ann,9999,0,9999,0
1668394280391,CSE 293,011,119190,Heninger; Nadia A,9999,0,9999,0
1668394280391,CSE 293,012,119230,Impagliazzo; Russell,9999,0,9999,0
1668394280391,CSE 293,013,119232,Jhala; Ranjit,9999,0,9999,0
1668394280391,CSE 293,014,119233,Kahng; Andrew Byun,9999,0,9999,0
1668394280391,CSE 293,015,119298,Kane; Daniel Mertz,9999,0,9999,0
1668394280391,CSE 293,016,119299,Kriegman; David J,9999,0,9999,0
1668394280391,CSE 293,017,119300,Kumar; Arun Kumar,9999,0,9999,0
1668394280391,CSE 293,018,119301,Lerner; Sorin,9999,0,9999,0
1668394280391,CSE 293,019,119302,Lovett; Shachar,9999,0,9999,0
1668394280391,CSE 293,020,119303,McAuley; Julian John,9999,0,9999,0
1668394280391,CSE 293,021,119304,Micciancio; Daniele,9999,0,9999,0
1668394280391,CSE 293,022,119367,Orailoglu; Alex,9999,0,9999,0
1668394280391,CSE 293,023,119382,Paturi; Ramamohan,9999,0,9999,0
1668394280391,CSE 293,024,119404,Polikarpova; Nadezhda,9999,0,9999,0
1668394280391,CSE 293,025,119406,Politz; Joseph Gibbs,9999,0,9999,0
1668394280391,CSE 293,026,119411,Porter; George M,9999,0,9999,0
1668394280391,CSE 293,027,119414,Porter; Leonard Emerson,9999,0,9999,0
1668394280391,CSE 293,028,119416,Ramamoorthi; Ravi,9999,0,9999,0
1668394280391,CSE 293,029,119417,Sahoo; Debashis,9999,0,9999,0
1668394280391,CSE 293,030,119420,Saul; Lawrence,9999,0,9999,0
1668394280391,CSE 293,031,119421,Savage; Stefan,9999,0,9999,0
1668394280391,CSE 293,032,119425,Schulze; Jurgen P.,9999,0,9999,0
1668394280391,CSE 293,033,119426,Snoeren; Alex C.,9999,0,9999,0
1668394280391,CSE 293,034,119428,Shang; Jingbo,9999,0,9999,0
1668394280391,CSE 293,035,119430,Stefan; Deian,9999,0,9999,0
1668394280391,CSE 293,036,119431,Su; Hao,9999,0,9999,0
1668394280391,CSE 293,037,119433,Swanson; Steven James,9999,0,9999,0
1668394280391,CSE 293,038,119435,Tullsen; Dean Michael,9999,0,9999,0
1668394280391,CSE 293,039,119483,Voelker; Geoffrey M.,9999,0,9999,0
1668394280391,CSE 293,040,119537,Zhao; Jishen,9999,0,9999,0
1668394280391,CSE 293,041,119538,Zhou; Yuan-Yuan,9999,0,9999,0
1668394280391,CSE 293,042,119539,Gao; Sicun,9999,0,9999,0
1668394280391,CSE 293,043,119540,Weibel; Nadir,9999,0,9999,0
1668394280391,CSE 293,044,119541,Gupta; Rajesh K.,9999,0,9999,0
1668394280391,CSE 293,045,126410,Vaccaro; Kristen Marie,9999,0,9999,0
1668394280391,CSE 293,046,126411,Klemke; Richard,9999,0,9999,0
1668394280827,CSE 294,A00,102459,Voelker; Geoffrey M.,0,0,0,0
1668394280827,CSE 294,B00,111322,Orailoglu; Alex,0,0,0,0
1668394281261,DSE 201,A00,096914,Deutsch; Alin Bernard,30,0,30,0
1668394281684,DSE 210,A00,096915,Dasgupta; Sanjoy,30,0,30,0
1668394282115,DSE 260A,A00,096916,Altintas De Callaf; Ilkay,30,0,30,0
1668394282557,ECE 200,001,103586,Antipa; Nicholas A,9999,0,9999,0
1668394282557,ECE 200,002,103587,Atanasov; Nikolay A.,9999,0,9999,0
1668394282557,ECE 200,003,103588,Bharadia; Dinesh,9999,0,9999,0
1668394282557,ECE 200,004,103589,Cheng; Chung Kuan,9999,0,9999,0
1668394282557,ECE 200,005,103590,Cosman; Pamela C.,9999,0,9999,0
1668394282557,ECE 200,006,103591,Dayeh; Shadi Ahmad,9999,0,9999,0
1668394282557,ECE 200,007,103592,Fainman; Yeshaiahu,9999,0,9999,0
1668394282557,ECE 200,008,103593,Ford; Joseph Earl,9999,0,9999,0
1668394282557,ECE 200,009,103594,Franceschetti; Massimo,9999,0,9999,0
1668394282557,ECE 200,010,103595,Fullerton; Eric E,9999,0,9999,0
1668394282557,ECE 200,011,103596,Galton; Ian A,9999,0,9999,0
1668394282557,ECE 200,012,103597,Gilja; Vikash,9999,0,9999,0
1668394282557,ECE 200,013,103598,Hall; Drew A.,9999,0,9999,0
1668394282557,ECE 200,014,103599,Hsueh; Tzu-Chien,9999,0,9999,0
1668394282557,ECE 200,015,103600,Javidi; Tara,9999,0,9999,0
1668394282557,ECE 200,016,103601,Kahng; Andrew Byun,9999,0,9999,0
1668394282557,ECE 200,017,103602,Kim; Young-Han,9999,0,9999,0
1668394282557,ECE 200,018,103603,Koushanfar; Farinaz,9999,0,9999,0
1668394282557,ECE 200,019,103604,Kuzum; Duygu,9999,0,9999,0
1668394282557,ECE 200,020,103605,Le; Hanh-Phuc,9999,0,9999,0
1668394282557,ECE 200,021,103606,Lin; Bill,9999,0,9999,0
1668394282557,ECE 200,022,103607,Liu; Zhaowei,9998,0,9999,1
1668394282557,ECE 200,023,103608,Lo; Yu-Hwa,9999,0,9999,0
1668394282557,ECE 200,024,103609,Lomakin; Vitaliy,9999,0,9999,0
1668394282557,ECE 200,025,103610,Mercier; Patrick Philip,9999,0,9999,0
1668394282557,ECE 200,026,103611,Meyer; Florian,9999,0,9999,0
1668394282557,ECE 200,027,103612,Milstein; Laurence B.,9999,0,9999,0
1668394282557,ECE 200,028,103613,Mir Arabbaygi; Siavash,9999,0,9999,0
1668394282557,ECE 200,029,103614,Mookherjea; Shayan,9999,0,9999,0
1668394282557,ECE 200,030,103615,Morris; Karcher William,9999,0,9999,0
1668394282557,ECE 200,031,103616,Ng; Tse Nga,9999,0,9999,0
1668394282557,ECE 200,032,103617,Nguyen; Truong Quang,9999,0,9999,0
1668394282557,ECE 200,033,103618,Nomura; Kenji,9999,0,9999,0
1668394282557,ECE 200,034,103619,Orlitsky; Alon,9999,0,9999,0
1668394282557,ECE 200,035,103620,Pal; Piya,9999,0,9999,0
1668394282557,ECE 200,036,103621,Papen; George C.,9999,0,9999,0
1668394282557,ECE 200,037,103622,Radic; Stojan,9999,0,9999,0
1668394282557,ECE 200,038,103623,Rao; Bhaskar D.,9999,0,9999,0
1668394282557,ECE 200,039,103624,Rao; Ramesh R,9999,0,9999,0
1668394282557,ECE 200,040,103625,Rebeiz; Gabriel,9999,0,9999,0
1668394282557,ECE 200,041,103626,Sanford; John R,9999,0,9999,0
1668394282557,ECE 200,042,103627,Siegel; Paul H.,9999,0,9999,0
1668394282557,ECE 200,043,103628,Sievenpiper; Daniel F.,9999,0,9999,0
1668394282557,ECE 200,044,103629,Sworder; David D.,9999,0,9999,0
1668394282557,ECE 200,045,103630,Taur; Yuan,9999,0,9999,0
1668394282557,ECE 200,046,103631,Touri; Behrouz,9999,0,9999,0
1668394282557,ECE 200,047,103632,Trivedi; Mohan M.,9999,0,9999,0
1668394282557,ECE 200,048,103633,Vasconcelos; Nuno,9999,0,9999,0
1668394282557,ECE 200,049,103634,Wang; Xiaolong,9999,0,9999,0
1668394282557,ECE 200,050,103635,Xie; Pengtao,9999,0,9999,0
1668394282557,ECE 200,051,103636,Yip; Michael,9999,0,9999,0
1668394282557,ECE 200,052,103637,Zeger; Kenneth A.,999,0,999,0
1668394282557,ECE 200,053,103638,Zhang; Xinyu,9999,0,9999,0
1668394282557,ECE 200,054,103639,Turakhia; Yatish Girish,9999,0,9999,0
1668394282557,ECE 200,055,103640,Kang; Mingu,9999,0,9999,0
1668394282557,ECE 200,056,103641,Shi; Yuanyuan,9999,0,9999,0
1668394282557,ECE 200,057,103642,Wang; Edward Jay,9999,0,9999,0
1668394282557,ECE 200,058,103643,Zheng; Yang,9999,0,9999,0
1668394282982,ECE 202,A00,103644,Kuzum; Duygu,0,0,0,0
1668394283410,ECE 212BN,A00,103646,Ng; Tse Nga,0,0,0,0
1668394283843,ECE 221,A00,111493,Staff,0,0,0,0
1668394284269,ECE 222B,A00,103647,Lomakin; Vitaliy,0,0,0,0
1668394284692,ECE 230B,A00,103648,Taur; Yuan,0,0,0,0
1668394285119,ECE 238B,A00,103649,Garay; Javier,0,0,0,0
1668394285547,ECE 240B,A00,112900,Fainman; Yeshaiahu,0,0,0,0
1668394285972,ECE 247A,A00,103650,Jokerst; Jesse Vincent,0,0,0,0
1668394286401,ECE 247B,A00,103651,Wang; Joseph,0,0,0,0
1668394286825,ECE 250,A00,103652,Siegel; Paul H.,0,0,0,0
1668394287250,ECE 251A,A00,103654,Rao; Bhaskar D.,0,0,0,0
1668394287672,ECE 257B,A00,103655,Bharadia; Dinesh,0,0,0,0
1668394288095,ECE 258A,A00,103656,Milstein; Laurence B.,0,0,0,0
1668394288522,ECE 260B,A00,103658,Kang; Mingu,0,0,0,0
1668394288950,ECE 264A,A00,103659,Galton; Ian A,0,0,0,0
1668394289374,ECE 265A,A00,103661,Gudem; Prasad S.S.,0,0,0,0
1668394289800,ECE 265D,A00,103662,Gudem; Prasad S.S.,0,0,0,0
1668394290224,ECE 268,A00,103663,Koushanfar; Farinaz,0,0,0,0
1668394290651,ECE 269,A01,103665,Pal; Piya,0,0,0,0
1668394291077,ECE 271B,A00,103666,Vasconcelos; Manuela,0,0,0,0
1668394291503,ECE 276A,A00,103667,Atanasov; Nikolay A.,0,0,0,0
1668394291929,ECE 277,A00,103668,An; Cheolhong,0,0,0,0
1668394292351,ECE 279,A00,117947,Hall; Drew A.,0,0,0,0
1668394293202,ECE 283,A00,103670,Hsueh; Tzu-Chien,0,0,0,0
1668394293628,ECE 284,A00,103671,Turakhia; Yatish Girish,0,0,0,0
1668394294055,ECE 285,A00,103672,Zheng; Yang,0,0,0,0
1668394294055,ECE 285,B00,103673,Sworder; David D.,0,0,0,0
1668394294479,ECE 287,A00,103676,Javidi; Tara,0,0,0,0
1668394294902,MATH 200B,A00,098023,Salehi Golsefidy; Alireza,12,0,15,3
1668394295324,MATH 202B,A00,098024,Rhoades; Brendon Patrick,9,0,15,6
1668394295747,MATH 203B,A00,098025,Oprea; Dragos N.,10,0,15,5
1668394296173,MATH 204B,A00,098026,Sorensen; Claus M,13,0,15,2
1668394296597,MATH 208,A00,098027,Izadi; Elham,7,0,10,3
1668394297025,MATH 209,A00,098028,Pollack; Aaron,10,0,10,0
1668394297448,MATH 211A,A00,112919,Rogalski; Daniel,9,0,10,1
1668394297875,MATH 211B,A00,112920,Seward; Brandon M.,9,0,10,1
1668394298299,MATH 218,A00,098029,Li; Bo,10,0,10,0
1668394298728,MATH 220B,A00,098030,Novak; Jonathan I,11,0,15,4
1668394299154,MATH 221A,A00,098031,Ebenfelt; Peter F,13,0,15,2
1668394299579,MATH 231B,A00,098032,Zlatos; Andrej,12,0,15,3
1668394300003,MATH 240B,A00,098033,Ni; Lei,9,0,15,6
1668394300430,MATH 243,A00,098034,Jekel; David Andrew,10,0,10,0
1668394300853,MATH 245A,A00,098035,Nie; Jiawang,0,0,15,16
1668394301284,MATH 248,A00,098036,Bejenaru; Ioan,10,0,10,0
1668394301708,MATH 250B,A00,098037,Spolaor; Luca,14,0,15,1
1668394302133,MATH 258,A00,098038,Ni; Lei,10,0,10,0
1668394302559,MATH 264B,A00,098041,Rhoades; Brendon Patrick,9,0,15,6
1668394302985,MATH 268,A00,098042,Buss; Samuel R,10,0,10,0
1668394303408,MATH 269,A00,098043,Rhoades; Brendon Patrick,10,0,10,0
1668394303832,MATH 270B,A00,098044,Li; Bo,10,0,15,5
1668394304267,MATH 272B,A00,098045,Holst; Michael J,13,0,15,2
1668394304697,MATH 273A,A00,098046,Tian; Xiaochuan,10,0,15,5
1668394305122,MATH 275,A01,098048,Tian; Xiaochuan,6,0,10,4
1668394305544,MATH 278A,A00,098049,Holst; Michael J,8,0,10,2
1668394305968,MATH 278B,A00,098050,Cloninger; Alexander,10,0,10,0
1668394306404,MATH 278C,A00,098051,Nie; Jiawang,6,0,10,4
1668394306828,MATH 280B,A00,098052,Zheng; Tianyi,8,0,15,7
1668394307263,MATH 281B,A00,098053,Bradic; Jelena,0,0,15,15
1668394307686,MATH 282B,A00,098054,Arias-Castro; Ery,0,0,15,15
1668394308117,MATH 285,A00,098055,Fitzsimmons; Patrick J,0,0,15,17
1668394308541,MATH 287B,A00,098056,Arias-Castro; Ery,2,0,15,13
1668394308968,MATH 288,A00,098057,Agarwal; Pooja,9,0,10,1
1668394308968,MATH 288,B00,098058,Zhang; Danna,8,0,10,2
1668394308968,MATH 288,C00,098059,Williams; Ruth J,9,0,10,1
1668394309396,MATH 290B,A00,098060,Roberts; Justin Deritter,13,0,15,2
1668394309822,MATH 292,A00,098061,Belmont; Eva Kinoshita,10,0,10,0
1668394310252,MATH 295,A00,098062,Suk; Andrew Hoon,48,0,50,2
1668394310767,MATH 296,A00,098063,Novak; Jonathan I,20,0,20,0
1668394311189,MATH 297,001,098064,Gamst; Anthony Collins,9997,0,9999,2
1668394811393,COGS 205,A00,101395,Chiba; Andrea,19,0,20,1
1668394811815,COGS 210B,001,101404,Greene; Deanna Jacquelyn,9998,0,9999,1
1668394811815,COGS 210B,002,101417,Xia; Haijun,9999,0,9999,0
1668394811815,COGS 210B,003,101422,Nitz; Douglas A.,9999,0,9999,0
1668394811815,COGS 210B,004,101423,Hollan; James D.,9998,0,9999,1
1668394811815,COGS 210B,005,101424,Deak; Gedeon O.,9998,0,9999,1
1668394811815,COGS 210B,006,101425,Rossano; Federico,9999,0,9999,0
1668394812245,COGS 211B,A00,101427,Coulson; Seana M,9996,0,9999,3
1668394812666,COGS 220,A00,101428,Hollan; James D.,0,0,25,25
1668394813093,COGS 229,A00,101429,Dow; Steven P,18,0,25,7
1668394813515,COGS 230,A00,101430,Klemmer; Scott R,11,0,17,6
1668394813941,COGS 234,A00,101431,Xia; Haijun,1,0,25,24
1668394814366,COGS 260,A00,101432,Kiyonaga; Anastasia,21,0,25,4
1668394814366,COGS 260,B00,101433,Kirsh; David Joel,15,0,25,10
1668394814789,CSE 202,A00,102371,Impagliazzo; Russell,0,0,0,0
1668394815215,CSE 203B,A01,102373,Cheng; Chung Kuan,0,0,0,0
1668394815642,CSE 208,A00,102374,Micciancio; Daniele,0,0,0,0
1668394816075,CSE 209A,A00,112895,Impagliazzo; Russell,0,0,15,15
1668394816502,CSE 209B,A00,108005,Bellare; Mihir,0,0,0,0
1668394816940,CSE 210,A00,113163,Coblenz; Michael J,0,0,0,0
1668394817370,CSE 219,A00,106111,Dow; Steven P,0,0,20,20
1668394817794,CSE 221,A00,102376,Voelker; Geoffrey M.,0,0,0,0
1668394818221,CSE 224,A01,102378,Porter; George M,0,0,0,0
1668394818645,CSE 229A,A00,102379,Savage; Stefan,0,0,0,0
1668394819075,CSE 229C,A00,102380,Munyaka; Imani N. S.,0,0,0,0
1668394819499,CSE 232B,A00,102382,Deutsch; Alin Bernard,0,0,0,0
1668394819925,CSE 234,A01,112904,Kumar; Arun Kumar,0,0,0,0
1668394820350,CSE 237A,A00,102383,Rosing; Tajana Simunic,0,0,0,0
1668394820774,CSE 239A,A00,102384,Deutsch; Alin Bernard,0,0,0,0
1668394821209,CSE 239B,A00,102385,Polikarpova; Nadezhda,0,0,0,0
1668394821631,CSE 240A,A00,102386,Pannuto; Patrick William,0,0,0,0
1668394822069,CSE 240B,A00,102387,Zhao; Jishen,0,0,0,0
1668394822496,CSE 241A,A00,106406,Kang; Mingu,0,0,0,0
1668394822918,CSE 249B,A00,102388,Kahng; Andrew Byun,0,0,8,8
1668394823346,CSE 251B,A01,102392,Cottrell; Garrison W,0,0,0,0
1668394823346,CSE 251B,A02,102393,Cottrell; Garrison W,0,0,0,0
1668394823768,CSE 252B,A00,102394,Ochoa; Benjamin Lawrence,0,0,0,0
1668394824191,CSE 257,A01,102396,Gao; Sicun,0,0,0,0
1668394824613,CSE 272,A00,102397,Li; Tzumao,0,0,0,0
1668394825045,CSE 274,A00,111323,Chern; Albert Ren-Haur,0,0,0,0
1668394825469,CSE 282,A00,102398,Pevzner; Pavel Arkadjevich,0,0,0,0
1668394825897,CSE 284,A00,114175,Gymrek; Melissa Ann,0,0,0,0
1668394826335,CSE 290,A00,102399,Chandraker; Manmohan Krishna,0,0,0,0
1668394826335,CSE 290,B00,102400,Vaccaro; Kristen Marie,0,0,25,25
1668394826335,CSE 290,C00,102414,Pannuto; Patrick William,0,0,25,25
1668394826335,CSE 290,D00,102427,Pevzner; Pavel Arkadjevich,0,0,0,0
1668394826335,CSE 290,E00,102429,Zhao; Jishen,0,0,0,0
1668394826335,CSE 290,F00,102436,Tullsen; Dean Michael,0,0,0,0
1668394826335,CSE 290,G00,102440,Christensen; Henrik I,0,0,20,20
1668394826766,CSE 291,A00,102443,Su; Hao,0,0,0,0
1668394826766,CSE 291,B00,102448,Polikarpova; Nadezhda,0,0,0,0
1668394826766,CSE 291,C00,102453,Vaccaro; Kristen Marie,0,0,0,0
1668394826766,CSE 291,D00,111343,Savage; Stefan,0,0,0,0
1668394826766,CSE 291,E00,116474,Claffy; Kimberly Claire,0,0,0,0
1668394826766,CSE 291,F00,116479,Pasquale; Joseph,0,0,0,0
1668394827204,CSE 293,001,119111,Bafna; Vineet,9999,0,9999,0
1668394827204,CSE 293,002,119118,Bellare; Mihir,9999,0,9999,0
1668394827204,CSE 293,003,119122,Berg-Kirkpatrick; Taylor D,9999,0,9999,0
1668394827204,CSE 293,004,119135,Christensen; Henrik I,9999,0,9999,0
1668394827204,CSE 293,005,119142,Cottrell; Garrison W,9999,0,9999,0
1668394827204,CSE 293,006,119146,Deutsch; Alin Bernard,9999,0,9999,0
1668394827204,CSE 293,007,119159,Esmaeilzadeh; Hadi,9999,0,9999,0
1668394827204,CSE 293,008,119166,Freund; Yoav,9999,0,9999,0
1668394827204,CSE 293,009,119170,Griswold; William G.,9999,0,9999,0
1668394827204,CSE 293,010,119183,Gymrek; Melissa Ann,9999,0,9999,0
1668394827204,CSE 293,011,119190,Heninger; Nadia A,9999,0,9999,0
1668394827204,CSE 293,012,119230,Impagliazzo; Russell,9999,0,9999,0
1668394827204,CSE 293,013,119232,Jhala; Ranjit,9999,0,9999,0
1668394827204,CSE 293,014,119233,Kahng; Andrew Byun,9999,0,9999,0
1668394827204,CSE 293,015,119298,Kane; Daniel Mertz,9999,0,9999,0
1668394827204,CSE 293,016,119299,Kriegman; David J,9999,0,9999,0
1668394827204,CSE 293,017,119300,Kumar; Arun Kumar,9999,0,9999,0
1668394827204,CSE 293,018,119301,Lerner; Sorin,9999,0,9999,0
1668394827204,CSE 293,019,119302,Lovett; Shachar,9999,0,9999,0
1668394827204,CSE 293,020,119303,McAuley; Julian John,9999,0,9999,0
1668394827204,CSE 293,021,119304,Micciancio; Daniele,9999,0,9999,0
1668394827204,CSE 293,022,119367,Orailoglu; Alex,9999,0,9999,0
1668394827204,CSE 293,023,119382,Paturi; Ramamohan,9999,0,9999,0
1668394827204,CSE 293,024,119404,Polikarpova; Nadezhda,9999,0,9999,0
1668394827204,CSE 293,025,119406,Politz; Joseph Gibbs,9999,0,9999,0
1668394827204,CSE 293,026,119411,Porter; George M,9999,0,9999,0
1668394827204,CSE 293,027,119414,Porter; Leonard Emerson,9999,0,9999,0
1668394827204,CSE 293,028,119416,Ramamoorthi; Ravi,9999,0,9999,0
1668394827204,CSE 293,029,119417,Sahoo; Debashis,9999,0,9999,0
1668394827204,CSE 293,030,119420,Saul; Lawrence,9999,0,9999,0
1668394827204,CSE 293,031,119421,Savage; Stefan,9999,0,9999,0
1668394827204,CSE 293,032,119425,Schulze; Jurgen P.,9999,0,9999,0
1668394827204,CSE 293,033,119426,Snoeren; Alex C.,9999,0,9999,0
1668394827204,CSE 293,034,119428,Shang; Jingbo,9999,0,9999,0
1668394827204,CSE 293,035,119430,Stefan; Deian,9999,0,9999,0
1668394827204,CSE 293,036,119431,Su; Hao,9999,0,9999,0
1668394827204,CSE 293,037,119433,Swanson; Steven James,9999,0,9999,0
1668394827204,CSE 293,038,119435,Tullsen; Dean Michael,9999,0,9999,0
1668394827204,CSE 293,039,119483,Voelker; Geoffrey M.,9999,0,9999,0
1668394827204,CSE 293,040,119537,Zhao; Jishen,9999,0,9999,0
1668394827204,CSE 293,041,119538,Zhou; Yuan-Yuan,9999,0,9999,0
1668394827204,CSE 293,042,119539,Gao; Sicun,9999,0,9999,0
1668394827204,CSE 293,043,119540,Weibel; Nadir,9999,0,9999,0
1668394827204,CSE 293,044,119541,Gupta; Rajesh K.,9999,0,9999,0
1668394827204,CSE 293,045,126410,Vaccaro; Kristen Marie,9999,0,9999,0
1668394827204,CSE 293,046,126411,Klemke; Richard,9999,0,9999,0
1668394827627,CSE 294,A00,102459,Voelker; Geoffrey M.,0,0,0,0
1668394827627,CSE 294,B00,111322,Orailoglu; Alex,0,0,0,0
1668394828054,DSE 201,A00,096914,Deutsch; Alin Bernard,30,0,30,0
1668394828478,DSE 210,A00,096915,Dasgupta; Sanjoy,30,0,30,0
1668394828906,DSE 260A,A00,096916,Altintas De Callaf; Ilkay,30,0,30,0
1668394829334,ECE 200,001,103586,Antipa; Nicholas A,9999,0,9999,0
1668394829334,ECE 200,002,103587,Atanasov; Nikolay A.,9999,0,9999,0
1668394829334,ECE 200,003,103588,Bharadia; Dinesh,9999,0,9999,0
1668394829334,ECE 200,004,103589,Cheng; Chung Kuan,9999,0,9999,0
1668394829334,ECE 200,005,103590,Cosman; Pamela C.,9999,0,9999,0
1668394829334,ECE 200,006,103591,Dayeh; Shadi Ahmad,9999,0,9999,0
1668394829334,ECE 200,007,103592,Fainman; Yeshaiahu,9999,0,9999,0
1668394829334,ECE 200,008,103593,Ford; Joseph Earl,9999,0,9999,0
1668394829334,ECE 200,009,103594,Franceschetti; Massimo,9999,0,9999,0
1668394829334,ECE 200,010,103595,Fullerton; Eric E,9999,0,9999,0
1668394829334,ECE 200,011,103596,Galton; Ian A,9999,0,9999,0
1668394829334,ECE 200,012,103597,Gilja; Vikash,9999,0,9999,0
1668394829334,ECE 200,013,103598,Hall; Drew A.,9999,0,9999,0
1668394829334,ECE 200,014,103599,Hsueh; Tzu-Chien,9999,0,9999,0
1668394829334,ECE 200,015,103600,Javidi; Tara,9999,0,9999,0
1668394829334,ECE 200,016,103601,Kahng; Andrew Byun,9999,0,9999,0
1668394829334,ECE 200,017,103602,Kim; Young-Han,9999,0,9999,0
1668394829334,ECE 200,018,103603,Koushanfar; Farinaz,9999,0,9999,0
1668394829334,ECE 200,019,103604,Kuzum; Duygu,9999,0,9999,0
1668394829334,ECE 200,020,103605,Le; Hanh-Phuc,9999,0,9999,0
1668394829334,ECE 200,021,103606,Lin; Bill,9999,0,9999,0
1668394829334,ECE 200,022,103607,Liu; Zhaowei,9998,0,9999,1
1668394829334,ECE 200,023,103608,Lo; Yu-Hwa,9999,0,9999,0
1668394829334,ECE 200,024,103609,Lomakin; Vitaliy,9999,0,9999,0
1668394829334,ECE 200,025,103610,Mercier; Patrick Philip,9999,0,9999,0
1668394829334,ECE 200,026,103611,Meyer; Florian,9999,0,9999,0
1668394829334,ECE 200,027,103612,Milstein; Laurence B.,9999,0,9999,0
1668394829334,ECE 200,028,103613,Mir Arabbaygi; Siavash,9999,0,9999,0
1668394829334,ECE 200,029,103614,Mookherjea; Shayan,9999,0,9999,0
1668394829334,ECE 200,030,103615,Morris; Karcher William,9999,0,9999,0
1668394829334,ECE 200,031,103616,Ng; Tse Nga,9999,0,9999,0
1668394829334,ECE 200,032,103617,Nguyen; Truong Quang,9999,0,9999,0
1668394829334,ECE 200,033,103618,Nomura; Kenji,9999,0,9999,0
1668394829334,ECE 200,034,103619,Orlitsky; Alon,9999,0,9999,0
1668394829334,ECE 200,035,103620,Pal; Piya,9999,0,9999,0
1668394829334,ECE 200,036,103621,Papen; George C.,9999,0,9999,0
1668394829334,ECE 200,037,103622,Radic; Stojan,9999,0,9999,0
1668394829334,ECE 200,038,103623,Rao; Bhaskar D.,9999,0,9999,0
1668394829334,ECE 200,039,103624,Rao; Ramesh R,9999,0,9999,0
1668394829334,ECE 200,040,103625,Rebeiz; Gabriel,9999,0,9999,0
1668394829334,ECE 200,041,103626,Sanford; John R,9999,0,9999,0
1668394829334,ECE 200,042,103627,Siegel; Paul H.,9999,0,9999,0
1668394829334,ECE 200,043,103628,Sievenpiper; Daniel F.,9999,0,9999,0
1668394829334,ECE 200,044,103629,Sworder; David D.,9999,0,9999,0
1668394829334,ECE 200,045,103630,Taur; Yuan,9999,0,9999,0
1668394829334,ECE 200,046,103631,Touri; Behrouz,9999,0,9999,0
1668394829334,ECE 200,047,103632,Trivedi; Mohan M.,9999,0,9999,0
1668394829334,ECE 200,048,103633,Vasconcelos; Nuno,9999,0,9999,0
1668394829334,ECE 200,049,103634,Wang; Xiaolong,9999,0,9999,0
1668394829334,ECE 200,050,103635,Xie; Pengtao,9999,0,9999,0
1668394829334,ECE 200,051,103636,Yip; Michael,9999,0,9999,0
1668394829334,ECE 200,052,103637,Zeger; Kenneth A.,999,0,999,0
1668394829334,ECE 200,053,103638,Zhang; Xinyu,9999,0,9999,0
1668394829334,ECE 200,054,103639,Turakhia; Yatish Girish,9999,0,9999,0
1668394829334,ECE 200,055,103640,Kang; Mingu,9999,0,9999,0
1668394829334,ECE 200,056,103641,Shi; Yuanyuan,9999,0,9999,0
1668394829334,ECE 200,057,103642,Wang; Edward Jay,9999,0,9999,0
1668394829334,ECE 200,058,103643,Zheng; Yang,9999,0,9999,0
1668394829761,ECE 202,A00,103644,Kuzum; Duygu,0,0,0,0
1668394830186,ECE 212BN,A00,103646,Ng; Tse Nga,0,0,0,0
1668394830609,ECE 221,A00,111493,Staff,0,0,0,0
1668394831123,ECE 222B,A00,103647,Lomakin; Vitaliy,0,0,0,0
1668394831549,ECE 230B,A00,103648,Taur; Yuan,0,0,0,0
1668394831976,ECE 238B,A00,103649,Garay; Javier,0,0,0,0
1668394832400,ECE 240B,A00,112900,Fainman; Yeshaiahu,0,0,0,0
1668394832824,ECE 247A,A00,103650,Jokerst; Jesse Vincent,0,0,0,0
1668394833256,ECE 247B,A00,103651,Wang; Joseph,0,0,0,0
1668394833698,ECE 250,A00,103652,Siegel; Paul H.,0,0,0,0
1668394834137,ECE 251A,A00,103654,Rao; Bhaskar D.,0,0,0,0
1668394834568,ECE 257B,A00,103655,Bharadia; Dinesh,0,0,0,0
1668394835001,ECE 258A,A00,103656,Milstein; Laurence B.,0,0,0,0
1668394835433,ECE 260B,A00,103658,Kang; Mingu,0,0,0,0
1668394835855,ECE 264A,A00,103659,Galton; Ian A,0,0,0,0
1668394836282,ECE 265A,A00,103661,Gudem; Prasad S.S.,0,0,0,0
1668394836705,ECE 265D,A00,103662,Gudem; Prasad S.S.,0,0,0,0
1668394837131,ECE 268,A00,103663,Koushanfar; Farinaz,0,0,0,0
1668394837557,ECE 269,A01,103665,Pal; Piya,0,0,0,0
1668394837985,ECE 271B,A00,103666,Vasconcelos; Manuela,0,0,0,0
1668394838407,ECE 276A,A00,103667,Atanasov; Nikolay A.,0,0,0,0
1668394838830,ECE 277,A00,103668,An; Cheolhong,0,0,0,0
1668394839253,ECE 279,A00,117947,Hall; Drew A.,0,0,0,0
1668394840105,ECE 283,A00,103670,Hsueh; Tzu-Chien,0,0,0,0
1668394840547,ECE 284,A00,103671,Turakhia; Yatish Girish,0,0,0,0
1668394840974,ECE 285,A00,103672,Zheng; Yang,0,0,0,0
1668394840974,ECE 285,B00,103673,Sworder; David D.,0,0,0,0
1668394841400,ECE 287,A00,103676,Javidi; Tara,0,0,0,0
1668394841834,MATH 200B,A00,098023,Salehi Golsefidy; Alireza,12,0,15,3
1668394842273,MATH 202B,A00,098024,Rhoades; Brendon Patrick,9,0,15,6
1668394842696,MATH 203B,A00,098025,Oprea; Dragos N.,10,0,15,5
1668394843121,MATH 204B,A00,098026,Sorensen; Claus M,13,0,15,2
1668394843546,MATH 208,A00,098027,Izadi; Elham,7,0,10,3
1668394843979,MATH 209,A00,098028,Pollack; Aaron,10,0,10,0
1668394844414,MATH 211A,A00,112919,Rogalski; Daniel,9,0,10,1
1668394844840,MATH 211B,A00,112920,Seward; Brandon M.,9,0,10,1
1668394845314,MATH 218,A00,098029,Li; Bo,10,0,10,0
1668394845740,MATH 220B,A00,098030,Novak; Jonathan I,11,0,15,4
1668394846187,MATH 221A,A00,098031,Ebenfelt; Peter F,13,0,15,2
1668394846623,MATH 231B,A00,098032,Zlatos; Andrej,12,0,15,3
1668394847063,MATH 240B,A00,098033,Ni; Lei,9,0,15,6
1668394847493,MATH 243,A00,098034,Jekel; David Andrew,10,0,10,0
1668394847916,MATH 245A,A00,098035,Nie; Jiawang,0,0,15,16
1668394848346,MATH 248,A00,098036,Bejenaru; Ioan,10,0,10,0
1668394848771,MATH 250B,A00,098037,Spolaor; Luca,14,0,15,1
1668394849209,MATH 258,A00,098038,Ni; Lei,10,0,10,0
1668394849634,MATH 264B,A00,098041,Rhoades; Brendon Patrick,9,0,15,6
1668394850071,MATH 268,A00,098042,Buss; Samuel R,10,0,10,0
1668394850496,MATH 269,A00,098043,Rhoades; Brendon Patrick,10,0,10,0
1668394850920,MATH 270B,A00,098044,Li; Bo,10,0,15,5
1668394851351,MATH 272B,A00,098045,Holst; Michael J,13,0,15,2
1668394851780,MATH 273A,A00,098046,Tian; Xiaochuan,10,0,15,5
1668394852208,MATH 275,A01,098048,Tian; Xiaochuan,6,0,10,4
1668394852637,MATH 278A,A00,098049,Holst; Michael J,8,0,10,2
1668394853061,MATH 278B,A00,098050,Cloninger; Alexander,10,0,10,0
1668394853486,MATH 278C,A00,098051,Nie; Jiawang,6,0,10,4
1668394853910,MATH 280B,A00,098052,Zheng; Tianyi,8,0,15,7
1668394854334,MATH 281B,A00,098053,Bradic; Jelena,0,0,15,15
1668394854766,MATH 282B,A00,098054,Arias-Castro; Ery,0,0,15,15
1668394855189,MATH 285,A00,098055,Fitzsimmons; Patrick J,0,0,15,17
1668394855612,MATH 287B,A00,098056,Arias-Castro; Ery,2,0,15,13
1668394856038,MATH 288,A00,098057,Agarwal; Pooja,9,0,10,1
1668394856038,MATH 288,B00,098058,Zhang; Danna,8,0,10,2
1668394856038,MATH 288,C00,098059,Williams; Ruth J,9,0,10,1
1668394856479,MATH 290B,A00,098060,Roberts; Justin Deritter,13,0,15,2
1668394856909,MATH 292,A00,098061,Belmont; Eva Kinoshita,10,0,10,0
1668394857335,MATH 295,A00,098062,Suk; Andrew Hoon,48,0,50,2
1668394857767,MATH 296,A00,098063,Novak; Jonathan I,20,0,20,0
1668394858220,MATH 297,001,098064,Gamst; Anthony Collins,9997,0,9999,2
1668395360565,COGS 205,A00,101395,Chiba; Andrea,19,0,20,1
1668395360999,COGS 210B,001,101404,Greene; Deanna Jacquelyn,9998,0,9999,1
1668395360999,COGS 210B,002,101417,Xia; Haijun,9999,0,9999,0
1668395360999,COGS 210B,003,101422,Nitz; Douglas A.,9999,0,9999,0
1668395360999,COGS 210B,004,101423,Hollan; James D.,9998,0,9999,1
1668395360999,COGS 210B,005,101424,Deak; Gedeon O.,9998,0,9999,1
1668395360999,COGS 210B,006,101425,Rossano; Federico,9999,0,9999,0
1668395361428,COGS 211B,A00,101427,Coulson; Seana M,9996,0,9999,3
1668395361853,COGS 220,A00,101428,Hollan; James D.,0,0,25,25
1668395362277,COGS 229,A00,101429,Dow; Steven P,18,0,25,7
1668395362700,COGS 230,A00,101430,Klemmer; Scott R,11,0,17,6
1668395363124,COGS 234,A00,101431,Xia; Haijun,1,0,25,24
1668395363549,COGS 260,A00,101432,Kiyonaga; Anastasia,21,0,25,4
1668395363549,COGS 260,B00,101433,Kirsh; David Joel,15,0,25,10
1668395363972,CSE 202,A00,102371,Impagliazzo; Russell,0,0,0,0
1668395364399,CSE 203B,A01,102373,Cheng; Chung Kuan,0,0,0,0
1668395364824,CSE 208,A00,102374,Micciancio; Daniele,0,0,0,0
1668395365249,CSE 209A,A00,112895,Impagliazzo; Russell,0,0,15,15
1668395365673,CSE 209B,A00,108005,Bellare; Mihir,0,0,0,0
1668395366104,CSE 210,A00,113163,Coblenz; Michael J,0,0,0,0
1668395366533,CSE 219,A00,106111,Dow; Steven P,0,0,20,20
1668395366960,CSE 221,A00,102376,Voelker; Geoffrey M.,0,0,0,0
1668395367383,CSE 224,A01,102378,Porter; George M,0,0,0,0
1668395367808,CSE 229A,A00,102379,Savage; Stefan,0,0,0,0
1668395368238,CSE 229C,A00,102380,Munyaka; Imani N. S.,0,0,0,0
1668395368666,CSE 232B,A00,102382,Deutsch; Alin Bernard,0,0,0,0
1668395369097,CSE 234,A01,112904,Kumar; Arun Kumar,0,0,0,0
1668395369528,CSE 237A,A00,102383,Rosing; Tajana Simunic,0,0,0,0
1668395369952,CSE 239A,A00,102384,Deutsch; Alin Bernard,0,0,0,0
1668395370385,CSE 239B,A00,102385,Polikarpova; Nadezhda,0,0,0,0
1668395370814,CSE 240A,A00,102386,Pannuto; Patrick William,0,0,0,0
1668395371236,CSE 240B,A00,102387,Zhao; Jishen,0,0,0,0
1668395371669,CSE 241A,A00,106406,Kang; Mingu,0,0,0,0
1668395372096,CSE 249B,A00,102388,Kahng; Andrew Byun,0,0,8,8
1668395372523,CSE 251B,A01,102392,Cottrell; Garrison W,0,0,0,0
1668395372523,CSE 251B,A02,102393,Cottrell; Garrison W,0,0,0,0
1668395372948,CSE 252B,A00,102394,Ochoa; Benjamin Lawrence,0,0,0,0
1668395373381,CSE 257,A01,102396,Gao; Sicun,0,0,0,0
1668395373822,CSE 272,A00,102397,Li; Tzumao,0,0,0,0
1668395374245,CSE 274,A00,111323,Chern; Albert Ren-Haur,0,0,0,0
1668395374669,CSE 282,A00,102398,Pevzner; Pavel Arkadjevich,0,0,0,0
1668395375093,CSE 284,A00,114175,Gymrek; Melissa Ann,0,0,0,0
1668395375520,CSE 290,A00,102399,Chandraker; Manmohan Krishna,0,0,0,0
1668395375520,CSE 290,B00,102400,Vaccaro; Kristen Marie,0,0,25,25
1668395375520,CSE 290,C00,102414,Pannuto; Patrick William,0,0,25,25
1668395375520,CSE 290,D00,102427,Pevzner; Pavel Arkadjevich,0,0,0,0
1668395375520,CSE 290,E00,102429,Zhao; Jishen,0,0,0,0
1668395375520,CSE 290,F00,102436,Tullsen; Dean Michael,0,0,0,0
1668395375520,CSE 290,G00,102440,Christensen; Henrik I,0,0,20,20
1668395375964,CSE 291,A00,102443,Su; Hao,0,0,0,0
1668395375964,CSE 291,B00,102448,Polikarpova; Nadezhda,0,0,0,0
1668395375964,CSE 291,C00,102453,Vaccaro; Kristen Marie,0,0,0,0
1668395375964,CSE 291,D00,111343,Savage; Stefan,0,0,0,0
1668395375964,CSE 291,E00,116474,Claffy; Kimberly Claire,0,0,0,0
1668395375964,CSE 291,F00,116479,Pasquale; Joseph,0,0,0,0
1668395376452,CSE 293,001,119111,Bafna; Vineet,9999,0,9999,0
1668395376452,CSE 293,002,119118,Bellare; Mihir,9999,0,9999,0
1668395376452,CSE 293,003,119122,Berg-Kirkpatrick; Taylor D,9999,0,9999,0
1668395376452,CSE 293,004,119135,Christensen; Henrik I,9999,0,9999,0
1668395376452,CSE 293,005,119142,Cottrell; Garrison W,9999,0,9999,0
1668395376452,CSE 293,006,119146,Deutsch; Alin Bernard,9999,0,9999,0
1668395376452,CSE 293,007,119159,Esmaeilzadeh; Hadi,9999,0,9999,0
1668395376452,CSE 293,008,119166,Freund; Yoav,9999,0,9999,0
1668395376452,CSE 293,009,119170,Griswold; William G.,9999,0,9999,0
1668395376452,CSE 293,010,119183,Gymrek; Melissa Ann,9999,0,9999,0
1668395376452,CSE 293,011,119190,Heninger; Nadia A,9999,0,9999,0
1668395376452,CSE 293,012,119230,Impagliazzo; Russell,9999,0,9999,0
1668395376452,CSE 293,013,119232,Jhala; Ranjit,9999,0,9999,0
1668395376452,CSE 293,014,119233,Kahng; Andrew Byun,9999,0,9999,0
1668395376452,CSE 293,015,119298,Kane; Daniel Mertz,9999,0,9999,0
1668395376452,CSE 293,016,119299,Kriegman; David J,9999,0,9999,0
1668395376452,CSE 293,017,119300,Kumar; Arun Kumar,9999,0,9999,0
1668395376452,CSE 293,018,119301,Lerner; Sorin,9999,0,9999,0
1668395376452,CSE 293,019,119302,Lovett; Shachar,9999,0,9999,0
1668395376452,CSE 293,020,119303,McAuley; Julian John,9999,0,9999,0
1668395376452,CSE 293,021,119304,Micciancio; Daniele,9999,0,9999,0
1668395376452,CSE 293,022,119367,Orailoglu; Alex,9999,0,9999,0
1668395376452,CSE 293,023,119382,Paturi; Ramamohan,9999,0,9999,0
1668395376452,CSE 293,024,119404,Polikarpova; Nadezhda,9999,0,9999,0
1668395376452,CSE 293,025,119406,Politz; Joseph Gibbs,9999,0,9999,0
1668395376452,CSE 293,026,119411,Porter; George M,9999,0,9999,0
1668395376452,CSE 293,027,119414,Porter; Leonard Emerson,9999,0,9999,0
1668395376452,CSE 293,028,119416,Ramamoorthi; Ravi,9999,0,9999,0
1668395376452,CSE 293,029,119417,Sahoo; Debashis,9999,0,9999,0
1668395376452,CSE 293,030,119420,Saul; Lawrence,9999,0,9999,0
1668395376452,CSE 293,031,119421,Savage; Stefan,9999,0,9999,0
1668395376452,CSE 293,032,119425,Schulze; Jurgen P.,9999,0,9999,0
1668395376452,CSE 293,033,119426,Snoeren; Alex C.,9999,0,9999,0
1668395376452,CSE 293,034,119428,Shang; Jingbo,9999,0,9999,0
1668395376452,CSE 293,035,119430,Stefan; Deian,9999,0,9999,0
1668395376452,CSE 293,036,119431,Su; Hao,9999,0,9999,0
1668395376452,CSE 293,037,119433,Swanson; Steven James,9999,0,9999,0
1668395376452,CSE 293,038,119435,Tullsen; Dean Michael,9999,0,9999,0
1668395376452,CSE 293,039,119483,Voelker; Geoffrey M.,9999,0,9999,0
1668395376452,CSE 293,040,119537,Zhao; Jishen,9999,0,9999,0
1668395376452,CSE 293,041,119538,Zhou; Yuan-Yuan,9999,0,9999,0
1668395376452,CSE 293,042,119539,Gao; Sicun,9999,0,9999,0
1668395376452,CSE 293,043,119540,Weibel; Nadir,9999,0,9999,0
1668395376452,CSE 293,044,119541,Gupta; Rajesh K.,9999,0,9999,0
1668395376452,CSE 293,045,126410,Vaccaro; Kristen Marie,9999,0,9999,0
1668395376452,CSE 293,046,126411,Klemke; Richard,9999,0,9999,0
1668395376883,CSE 294,A00,102459,Voelker; Geoffrey M.,0,0,0,0
1668395376883,CSE 294,B00,111322,Orailoglu; Alex,0,0,0,0
1668395377306,DSE 201,A00,096914,Deutsch; Alin Bernard,30,0,30,0
1668395377730,DSE 210,A00,096915,Dasgupta; Sanjoy,30,0,30,0
1668395378157,DSE 260A,A00,096916,Altintas De Callaf; Ilkay,30,0,30,0
1668395378650,ECE 200,001,103586,Antipa; Nicholas A,9999,0,9999,0
1668395378650,ECE 200,002,103587,Atanasov; Nikolay A.,9999,0,9999,0
1668395378650,ECE 200,003,103588,Bharadia; Dinesh,9999,0,9999,0
1668395378650,ECE 200,004,103589,Cheng; Chung Kuan,9999,0,9999,0
1668395378650,ECE 200,005,103590,Cosman; Pamela C.,9999,0,9999,0
1668395378650,ECE 200,006,103591,Dayeh; Shadi Ahmad,9999,0,9999,0
1668395378650,ECE 200,007,103592,Fainman; Yeshaiahu,9999,0,9999,0
1668395378650,ECE 200,008,103593,Ford; Joseph Earl,9999,0,9999,0
1668395378650,ECE 200,009,103594,Franceschetti; Massimo,9999,0,9999,0
1668395378650,ECE 200,010,103595,Fullerton; Eric E,9999,0,9999,0
1668395378650,ECE 200,011,103596,Galton; Ian A,9999,0,9999,0
1668395378650,ECE 200,012,103597,Gilja; Vikash,9999,0,9999,0
1668395378650,ECE 200,013,103598,Hall; Drew A.,9999,0,9999,0
1668395378650,ECE 200,014,103599,Hsueh; Tzu-Chien,9999,0,9999,0
1668395378650,ECE 200,015,103600,Javidi; Tara,9999,0,9999,0
1668395378650,ECE 200,016,103601,Kahng; Andrew Byun,9999,0,9999,0
1668395378650,ECE 200,017,103602,Kim; Young-Han,9999,0,9999,0
1668395378650,ECE 200,018,103603,Koushanfar; Farinaz,9999,0,9999,0
1668395378650,ECE 200,019,103604,Kuzum; Duygu,9999,0,9999,0
1668395378650,ECE 200,020,103605,Le; Hanh-Phuc,9999,0,9999,0
1668395378650,ECE 200,021,103606,Lin; Bill,9999,0,9999,0
1668395378650,ECE 200,022,103607,Liu; Zhaowei,9998,0,9999,1
1668395378650,ECE 200,023,103608,Lo; Yu-Hwa,9999,0,9999,0
1668395378650,ECE 200,024,103609,Lomakin; Vitaliy,9999,0,9999,0
1668395378650,ECE 200,025,103610,Mercier; Patrick Philip,9999,0,9999,0
1668395378650,ECE 200,026,103611,Meyer; Florian,9999,0,9999,0
1668395378650,ECE 200,027,103612,Milstein; Laurence B.,9999,0,9999,0
1668395378650,ECE 200,028,103613,Mir Arabbaygi; Siavash,9999,0,9999,0
1668395378650,ECE 200,029,103614,Mookherjea; Shayan,9999,0,9999,0
1668395378650,ECE 200,030,103615,Morris; Karcher William,9999,0,9999,0
1668395378650,ECE 200,031,103616,Ng; Tse Nga,9999,0,9999,0
1668395378650,ECE 200,032,103617,Nguyen; Truong Quang,9999,0,9999,0
1668395378650,ECE 200,033,103618,Nomura; Kenji,9999,0,9999,0
1668395378650,ECE 200,034,103619,Orlitsky; Alon,9999,0,9999,0
1668395378650,ECE 200,035,103620,Pal; Piya,9999,0,9999,0
1668395378650,ECE 200,036,103621,Papen; George C.,9999,0,9999,0
1668395378650,ECE 200,037,103622,Radic; Stojan,9999,0,9999,0
1668395378650,ECE 200,038,103623,Rao; Bhaskar D.,9999,0,9999,0
1668395378650,ECE 200,039,103624,Rao; Ramesh R,9999,0,9999,0
1668395378650,ECE 200,040,103625,Rebeiz; Gabriel,9999,0,9999,0
1668395378650,ECE 200,041,103626,Sanford; John R,9999,0,9999,0
1668395378650,ECE 200,042,103627,Siegel; Paul H.,9999,0,9999,0
1668395378650,ECE 200,043,103628,Sievenpiper; Daniel F.,9999,0,9999,0
1668395378650,ECE 200,044,103629,Sworder; David D.,9999,0,9999,0
1668395378650,ECE 200,045,103630,Taur; Yuan,9999,0,9999,0
1668395378650,ECE 200,046,103631,Touri; Behrouz,9999,0,9999,0
1668395378650,ECE 200,047,103632,Trivedi; Mohan M.,9999,0,9999,0
1668395378650,ECE 200,048,103633,Vasconcelos; Nuno,9999,0,9999,0
1668395378650,ECE 200,049,103634,Wang; Xiaolong,9999,0,9999,0
1668395378650,ECE 200,050,103635,Xie; Pengtao,9999,0,9999,0
1668395378650,ECE 200,051,103636,Yip; Michael,9999,0,9999,0
1668395378650,ECE 200,052,103637,Zeger; Kenneth A.,999,0,999,0
1668395378650,ECE 200,053,103638,Zhang; Xinyu,9999,0,9999,0
1668395378650,ECE 200,054,103639,Turakhia; Yatish Girish,9999,0,9999,0
1668395378650,ECE 200,055,103640,Kang; Mingu,9999,0,9999,0
1668395378650,ECE 200,056,103641,Shi; Yuanyuan,9999,0,9999,0
1668395378650,ECE 200,057,103642,Wang; Edward Jay,9999,0,9999,0
1668395378650,ECE 200,058,103643,Zheng; Yang,9999,0,9999,0
1668395379071,ECE 202,A00,103644,Kuzum; Duygu,0,0,0,0
1668395379494,ECE 212BN,A00,103646,Ng; Tse Nga,0,0,0,0
1668395379921,ECE 221,A00,111493,Staff,0,0,0,0
1668395380354,ECE 222B,A00,103647,Lomakin; Vitaliy,0,0,0,0
1668395380795,ECE 230B,A00,103648,Taur; Yuan,0,0,0,0
1668395381226,ECE 238B,A00,103649,Garay; Javier,0,0,0,0
1668395381651,ECE 240B,A00,112900,Fainman; Yeshaiahu,0,0,0,0
1668395382075,ECE 247A,A00,103650,Jokerst; Jesse Vincent,0,0,0,0
1668395382499,ECE 247B,A00,103651,Wang; Joseph,0,0,0,0
1668395382926,ECE 250,A00,103652,Siegel; Paul H.,0,0,0,0
1668395383350,ECE 251A,A00,103654,Rao; Bhaskar D.,0,0,0,0
1668395383774,ECE 257B,A00,103655,Bharadia; Dinesh,0,0,0,0
1668395384199,ECE 258A,A00,103656,Milstein; Laurence B.,0,0,0,0
1668395384625,ECE 260B,A00,103658,Kang; Mingu,0,0,0,0
1668395385049,ECE 264A,A00,103659,Galton; Ian A,0,0,0,0
1668395385475,ECE 265A,A00,103661,Gudem; Prasad S.S.,0,0,0,0
1668395385913,ECE 265D,A00,103662,Gudem; Prasad S.S.,0,0,0,0
1668395386336,ECE 268,A00,103663,Koushanfar; Farinaz,0,0,0,0
1668395386762,ECE 269,A01,103665,Pal; Piya,0,0,0,0
1668395387200,ECE 271B,A00,103666,Vasconcelos; Manuela,0,0,0,0
1668395387625,ECE 276A,A00,103667,Atanasov; Nikolay A.,0,0,0,0
1668395388046,ECE 277,A00,103668,An; Cheolhong,0,0,0,0
1668395388470,ECE 279,A00,117947,Hall; Drew A.,0,0,0,0
1668395389325,ECE 283,A00,103670,Hsueh; Tzu-Chien,0,0,0,0
1668395389748,ECE 284,A00,103671,Turakhia; Yatish Girish,0,0,0,0
1668395390171,ECE 285,A00,103672,Zheng; Yang,0,0,0,0
1668395390171,ECE 285,B00,103673,Sworder; David D.,0,0,0,0
1668395390597,ECE 287,A00,103676,Javidi; Tara,0,0,0,0
1668395391022,MATH 200B,A00,098023,Salehi Golsefidy; Alireza,12,0,15,3
1668395391460,MATH 202B,A00,098024,Rhoades; Brendon Patrick,9,0,15,6
1668395391885,MATH 203B,A00,098025,Oprea; Dragos N.,10,0,15,5
1668395392318,MATH 204B,A00,098026,Sorensen; Claus M,13,0,15,2
1668395392745,MATH 208,A00,098027,Izadi; Elham,7,0,10,3
1668395393169,MATH 209,A00,098028,Pollack; Aaron,10,0,10,0
1668395393593,MATH 211A,A00,112919,Rogalski; Daniel,9,0,10,1
1668395394023,MATH 211B,A00,112920,Seward; Brandon M.,9,0,10,1
1668395394446,MATH 218,A00,098029,Li; Bo,10,0,10,0
1668395394871,MATH 220B,A00,098030,Novak; Jonathan I,11,0,15,4
1668395395295,MATH 221A,A00,098031,Ebenfelt; Peter F,13,0,15,2
1668395395721,MATH 231B,A00,098032,Zlatos; Andrej,12,0,15,3
1668395396148,MATH 240B,A00,098033,Ni; Lei,9,0,15,6
1668395396592,MATH 243,A00,098034,Jekel; David Andrew,10,0,10,0
1668395397113,MATH 245A,A00,098035,Nie; Jiawang,0,0,15,16
1668395397536,MATH 248,A00,098036,Bejenaru; Ioan,10,0,10,0
1668395397958,MATH 250B,A00,098037,Spolaor; Luca,14,0,15,1
1668395398383,MATH 258,A00,098038,Ni; Lei,10,0,10,0
1668395398807,MATH 264B,A00,098041,Rhoades; Brendon Patrick,9,0,15,6
1668395399229,MATH 268,A00,098042,Buss; Samuel R,10,0,10,0
1668395399651,MATH 269,A00,098043,Rhoades; Brendon Patrick,10,0,10,0
1668395400075,MATH 270B,A00,098044,Li; Bo,10,0,15,5
1668395400501,MATH 272B,A00,098045,Holst; Michael J,13,0,15,2
1668395400927,MATH 273A,A00,098046,Tian; Xiaochuan,10,0,15,5
1668395401352,MATH 275,A01,098048,Tian; Xiaochuan,6,0,10,4
1668395401779,MATH 278A,A00,098049,Holst; Michael J,8,0,10,2
1668395402204,MATH 278B,A00,098050,Cloninger; Alexander,10,0,10,0
1668395402630,MATH 278C,A00,098051,Nie; Jiawang,6,0,10,4
1668395403068,MATH 280B,A00,098052,Zheng; Tianyi,8,0,15,7
1668395403494,MATH 281B,A00,098053,Bradic; Jelena,0,0,15,15
1668395403918,MATH 282B,A00,098054,Arias-Castro; Ery,0,0,15,15
1668395404347,MATH 285,A00,098055,Fitzsimmons; Patrick J,0,0,15,17
1668395404771,MATH 287B,A00,098056,Arias-Castro; Ery,2,0,15,13
1668395405194,MATH 288,A00,098057,Agarwal; Pooja,9,0,10,1
1668395405194,MATH 288,B00,098058,Zhang; Danna,8,0,10,2
1668395405194,MATH 288,C00,098059,Williams; Ruth J,9,0,10,1
1668395405620,MATH 290B,A00,098060,Roberts; Justin Deritter,13,0,15,2
1668395406045,MATH 292,A00,098061,Belmont; Eva Kinoshita,10,0,10,0
1668395406468,MATH 295,A00,098062,Suk; Andrew Hoon,48,0,50,2
1668395406893,MATH 296,A00,098063,Novak; Jonathan I,20,0,20,0
1668395407318,MATH 297,001,098064,Gamst; Anthony Collins,9997,0,9999,2
1668395907783,COGS 205,A00,101395,Chiba; Andrea,19,0,20,1
1668395908211,COGS 210B,001,101404,Greene; Deanna Jacquelyn,9998,0,9999,1
1668395908211,COGS 210B,002,101417,Xia; Haijun,9999,0,9999,0
1668395908211,COGS 210B,003,101422,Nitz; Douglas A.,9999,0,9999,0
1668395908211,COGS 210B,004,101423,Hollan; James D.,9998,0,9999,1
1668395908211,COGS 210B,005,101424,Deak; Gedeon O.,9998,0,9999,1
1668395908211,COGS 210B,006,101425,Rossano; Federico,9999,0,9999,0
1668395908634,COGS 211B,A00,101427,Coulson; Seana M,9996,0,9999,3
1668395909057,COGS 220,A00,101428,Hollan; James D.,0,0,25,25
1668395909482,COGS 229,A00,101429,Dow; Steven P,18,0,25,7
1668395909913,COGS 230,A00,101430,Klemmer; Scott R,11,0,17,6
1668395910336,COGS 234,A00,101431,Xia; Haijun,1,0,25,24
1668395910763,COGS 260,A00,101432,Kiyonaga; Anastasia,21,0,25,4
1668395910763,COGS 260,B00,101433,Kirsh; David Joel,15,0,25,10
1668395911186,CSE 202,A00,102371,Impagliazzo; Russell,0,0,0,0
1668395911613,CSE 203B,A01,102373,Cheng; Chung Kuan,0,0,0,0
1668395912043,CSE 208,A00,102374,Micciancio; Daniele,0,0,0,0
1668395912469,CSE 209A,A00,112895,Impagliazzo; Russell,0,0,15,15
1668395912892,CSE 209B,A00,108005,Bellare; Mihir,0,0,0,0
1668395913314,CSE 210,A00,113163,Coblenz; Michael J,0,0,0,0
1668395913741,CSE 219,A00,106111,Dow; Steven P,0,0,20,20
1668395914174,CSE 221,A00,102376,Voelker; Geoffrey M.,0,0,0,0
1668395914607,CSE 224,A01,102378,Porter; George M,0,0,0,0
1668395915031,CSE 229A,A00,102379,Savage; Stefan,0,0,0,0
1668395915454,CSE 229C,A00,102380,Munyaka; Imani N. S.,0,0,0,0
1668395915888,CSE 232B,A00,102382,Deutsch; Alin Bernard,0,0,0,0
1668395916322,CSE 234,A01,112904,Kumar; Arun Kumar,0,0,0,0
1668395916758,CSE 237A,A00,102383,Rosing; Tajana Simunic,0,0,0,0
1668395917186,CSE 239A,A00,102384,Deutsch; Alin Bernard,0,0,0,0
1668395917705,CSE 239B,A00,102385,Polikarpova; Nadezhda,0,0,0,0
1668395918130,CSE 240A,A00,102386,Pannuto; Patrick William,0,0,0,0
1668395918564,CSE 240B,A00,102387,Zhao; Jishen,0,0,0,0
1668395918987,CSE 241A,A00,106406,Kang; Mingu,0,0,0,0
1668395919414,CSE 249B,A00,102388,Kahng; Andrew Byun,0,0,8,8
1668395919845,CSE 251B,A01,102392,Cottrell; Garrison W,0,0,0,0
1668395919845,CSE 251B,A02,102393,Cottrell; Garrison W,0,0,0,0
1668395920272,CSE 252B,A00,102394,Ochoa; Benjamin Lawrence,0,0,0,0
1668395920701,CSE 257,A01,102396,Gao; Sicun,0,0,0,0
1668395921130,CSE 272,A00,102397,Li; Tzumao,0,0,0,0
1668395921555,CSE 274,A00,111323,Chern; Albert Ren-Haur,0,0,0,0
1668395921979,CSE 282,A00,102398,Pevzner; Pavel Arkadjevich,0,0,0,0
1668395922413,CSE 284,A00,114175,Gymrek; Melissa Ann,0,0,0,0
1668395922847,CSE 290,A00,102399,Chandraker; Manmohan Krishna,0,0,0,0
1668395922847,CSE 290,B00,102400,Vaccaro; Kristen Marie,0,0,25,25
1668395922847,CSE 290,C00,102414,Pannuto; Patrick William,0,0,25,25
1668395922847,CSE 290,D00,102427,Pevzner; Pavel Arkadjevich,0,0,0,0
1668395922847,CSE 290,E00,102429,Zhao; Jishen,0,0,0,0
1668395922847,CSE 290,F00,102436,Tullsen; Dean Michael,0,0,0,0
1668395922847,CSE 290,G00,102440,Christensen; Henrik I,0,0,20,20
1668395923272,CSE 291,A00,102443,Su; Hao,0,0,0,0
1668395923272,CSE 291,B00,102448,Polikarpova; Nadezhda,0,0,0,0
1668395923272,CSE 291,C00,102453,Vaccaro; Kristen Marie,0,0,0,0
1668395923272,CSE 291,D00,111343,Savage; Stefan,0,0,0,0
1668395923272,CSE 291,E00,116474,Claffy; Kimberly Claire,0,0,0,0
1668395923272,CSE 291,F00,116479,Pasquale; Joseph,0,0,0,0
1668395923711,CSE 293,001,119111,Bafna; Vineet,9999,0,9999,0
1668395923711,CSE 293,002,119118,Bellare; Mihir,9999,0,9999,0
1668395923711,CSE 293,003,119122,Berg-Kirkpatrick; Taylor D,9999,0,9999,0
1668395923711,CSE 293,004,119135,Christensen; Henrik I,9999,0,9999,0
1668395923711,CSE 293,005,119142,Cottrell; Garrison W,9999,0,9999,0
1668395923711,CSE 293,006,119146,Deutsch; Alin Bernard,9999,0,9999,0
1668395923711,CSE 293,007,119159,Esmaeilzadeh; Hadi,9999,0,9999,0
1668395923711,CSE 293,008,119166,Freund; Yoav,9999,0,9999,0
1668395923711,CSE 293,009,119170,Griswold; William G.,9999,0,9999,0
1668395923711,CSE 293,010,119183,Gymrek; Melissa Ann,9999,0,9999,0
1668395923711,CSE 293,011,119190,Heninger; Nadia A,9999,0,9999,0
1668395923711,CSE 293,012,119230,Impagliazzo; Russell,9999,0,9999,0
1668395923711,CSE 293,013,119232,Jhala; Ranjit,9999,0,9999,0
1668395923711,CSE 293,014,119233,Kahng; Andrew Byun,9999,0,9999,0
1668395923711,CSE 293,015,119298,Kane; Daniel Mertz,9999,0,9999,0
1668395923711,CSE 293,016,119299,Kriegman; David J,9999,0,9999,0
1668395923711,CSE 293,017,119300,Kumar; Arun Kumar,9999,0,9999,0
1668395923711,CSE 293,018,119301,Lerner; Sorin,9999,0,9999,0
1668395923711,CSE 293,019,119302,Lovett; Shachar,9999,0,9999,0
1668395923711,CSE 293,020,119303,McAuley; Julian John,9999,0,9999,0
1668395923711,CSE 293,021,119304,Micciancio; Daniele,9999,0,9999,0
1668395923711,CSE 293,022,119367,Orailoglu; Alex,9999,0,9999,0
1668395923711,CSE 293,023,119382,Paturi; Ramamohan,9999,0,9999,0
1668395923711,CSE 293,024,119404,Polikarpova; Nadezhda,9999,0,9999,0
1668395923711,CSE 293,025,119406,Politz; Joseph Gibbs,9999,0,9999,0
1668395923711,CSE 293,026,119411,Porter; George M,9999,0,9999,0
1668395923711,CSE 293,027,119414,Porter; Leonard Emerson,9999,0,9999,0
1668395923711,CSE 293,028,119416,Ramamoorthi; Ravi,9999,0,9999,0
1668395923711,CSE 293,029,119417,Sahoo; Debashis,9999,0,9999,0
1668395923711,CSE 293,030,119420,Saul; Lawrence,9999,0,9999,0
1668395923711,CSE 293,031,119421,Savage; Stefan,9999,0,9999,0
1668395923711,CSE 293,032,119425,Schulze; Jurgen P.,9999,0,9999,0
1668395923711,CSE 293,033,119426,Snoeren; Alex C.,9999,0,9999,0
1668395923711,CSE 293,034,119428,Shang; Jingbo,9999,0,9999,0
1668395923711,CSE 293,035,119430,Stefan; Deian,9999,0,9999,0
1668395923711,CSE 293,036,119431,Su; Hao,9999,0,9999,0
1668395923711,CSE 293,037,119433,Swanson; Steven James,9999,0,9999,0
1668395923711,CSE 293,038,119435,Tullsen; Dean Michael,9999,0,9999,0
1668395923711,CSE 293,039,119483,Voelker; Geoffrey M.,9999,0,9999,0
1668395923711,CSE 293,040,119537,Zhao; Jishen,9999,0,9999,0
1668395923711,CSE 293,041,119538,Zhou; Yuan-Yuan,9999,0,9999,0
1668395923711,CSE 293,042,119539,Gao; Sicun,9999,0,9999,0
1668395923711,CSE 293,043,119540,Weibel; Nadir,9999,0,9999,0
1668395923711,CSE 293,044,119541,Gupta; Rajesh K.,9999,0,9999,0
1668395923711,CSE 293,045,126410,Vaccaro; Kristen Marie,9999,0,9999,0
1668395923711,CSE 293,046,126411,Klemke; Richard,9999,0,9999,0
1668395924142,CSE 294,A00,102459,Voelker; Geoffrey M.,0,0,0,0
1668395924142,CSE 294,B00,111322,Orailoglu; Alex,0,0,0,0
1668395924566,DSE 201,A00,096914,Deutsch; Alin Bernard,30,0,30,0
1668395924995,DSE 210,A00,096915,Dasgupta; Sanjoy,30,0,30,0
1668395925419,DSE 260A,A00,096916,Altintas De Callaf; Ilkay,30,0,30,0
1668395925873,ECE 200,001,103586,Antipa; Nicholas A,9999,0,9999,0
1668395925873,ECE 200,002,103587,Atanasov; Nikolay A.,9999,0,9999,0
1668395925873,ECE 200,003,103588,Bharadia; Dinesh,9999,0,9999,0
1668395925873,ECE 200,004,103589,Cheng; Chung Kuan,9999,0,9999,0
1668395925873,ECE 200,005,103590,Cosman; Pamela C.,9999,0,9999,0
1668395925873,ECE 200,006,103591,Dayeh; Shadi Ahmad,9999,0,9999,0
1668395925873,ECE 200,007,103592,Fainman; Yeshaiahu,9999,0,9999,0
1668395925873,ECE 200,008,103593,Ford; Joseph Earl,9999,0,9999,0
1668395925873,ECE 200,009,103594,Franceschetti; Massimo,9999,0,9999,0
1668395925873,ECE 200,010,103595,Fullerton; Eric E,9999,0,9999,0
1668395925873,ECE 200,011,103596,Galton; Ian A,9999,0,9999,0
1668395925873,ECE 200,012,103597,Gilja; Vikash,9999,0,9999,0
1668395925873,ECE 200,013,103598,Hall; Drew A.,9999,0,9999,0
1668395925873,ECE 200,014,103599,Hsueh; Tzu-Chien,9999,0,9999,0
1668395925873,ECE 200,015,103600,Javidi; Tara,9999,0,9999,0
1668395925873,ECE 200,016,103601,Kahng; Andrew Byun,9999,0,9999,0
1668395925873,ECE 200,017,103602,Kim; Young-Han,9999,0,9999,0
1668395925873,ECE 200,018,103603,Koushanfar; Farinaz,9999,0,9999,0
1668395925873,ECE 200,019,103604,Kuzum; Duygu,9999,0,9999,0
1668395925873,ECE 200,020,103605,Le; Hanh-Phuc,9999,0,9999,0
1668395925873,ECE 200,021,103606,Lin; Bill,9999,0,9999,0
1668395925873,ECE 200,022,103607,Liu; Zhaowei,9998,0,9999,1
1668395925873,ECE 200,023,103608,Lo; Yu-Hwa,9999,0,9999,0
1668395925873,ECE 200,024,103609,Lomakin; Vitaliy,9999,0,9999,0
1668395925873,ECE 200,025,103610,Mercier; Patrick Philip,9999,0,9999,0
1668395925873,ECE 200,026,103611,Meyer; Florian,9999,0,9999,0
1668395925873,ECE 200,027,103612,Milstein; Laurence B.,9999,0,9999,0
1668395925873,ECE 200,028,103613,Mir Arabbaygi; Siavash,9999,0,9999,0
1668395925873,ECE 200,029,103614,Mookherjea; Shayan,9999,0,9999,0
1668395925873,ECE 200,030,103615,Morris; Karcher William,9999,0,9999,0
1668395925873,ECE 200,031,103616,Ng; Tse Nga,9999,0,9999,0
1668395925873,ECE 200,032,103617,Nguyen; Truong Quang,9999,0,9999,0
1668395925873,ECE 200,033,103618,Nomura; Kenji,9999,0,9999,0
1668395925873,ECE 200,034,103619,Orlitsky; Alon,9999,0,9999,0
1668395925873,ECE 200,035,103620,Pal; Piya,9999,0,9999,0
1668395925873,ECE 200,036,103621,Papen; George C.,9999,0,9999,0
1668395925873,ECE 200,037,103622,Radic; Stojan,9999,0,9999,0
1668395925873,ECE 200,038,103623,Rao; Bhaskar D.,9999,0,9999,0
1668395925873,ECE 200,039,103624,Rao; Ramesh R,9999,0,9999,0
1668395925873,ECE 200,040,103625,Rebeiz; Gabriel,9999,0,9999,0
1668395925873,ECE 200,041,103626,Sanford; John R,9999,0,9999,0
1668395925873,ECE 200,042,103627,Siegel; Paul H.,9999,0,9999,0
1668395925873,ECE 200,043,103628,Sievenpiper; Daniel F.,9999,0,9999,0
1668395925873,ECE 200,044,103629,Sworder; David D.,9999,0,9999,0
1668395925873,ECE 200,045,103630,Taur; Yuan,9999,0,9999,0
1668395925873,ECE 200,046,103631,Touri; Behrouz,9999,0,9999,0
1668395925873,ECE 200,047,103632,Trivedi; Mohan M.,9999,0,9999,0
1668395925873,ECE 200,048,103633,Vasconcelos; Nuno,9999,0,9999,0
1668395925873,ECE 200,049,103634,Wang; Xiaolong,9999,0,9999,0
1668395925873,ECE 200,050,103635,Xie; Pengtao,9999,0,9999,0
1668395925873,ECE 200,051,103636,Yip; Michael,9999,0,9999,0
1668395925873,ECE 200,052,103637,Zeger; Kenneth A.,999,0,999,0
1668395925873,ECE 200,053,103638,Zhang; Xinyu,9999,0,9999,0
1668395925873,ECE 200,054,103639,Turakhia; Yatish Girish,9999,0,9999,0
1668395925873,ECE 200,055,103640,Kang; Mingu,9999,0,9999,0
1668395925873,ECE 200,056,103641,Shi; Yuanyuan,9999,0,9999,0
1668395925873,ECE 200,057,103642,Wang; Edward Jay,9999,0,9999,0
1668395925873,ECE 200,058,103643,Zheng; Yang,9999,0,9999,0
1668395926298,ECE 202,A00,103644,Kuzum; Duygu,0,0,0,0
1668395926725,ECE 212BN,A00,103646,Ng; Tse Nga,0,0,0,0
1668395927150,ECE 221,A00,111493,Staff,0,0,0,0
1668395927577,ECE 222B,A00,103647,Lomakin; Vitaliy,0,0,0,0
1668395928002,ECE 230B,A00,103648,Taur; Yuan,0,0,0,0
1668395928428,ECE 238B,A00,103649,Garay; Javier,0,0,0,0
1668395928851,ECE 240B,A00,112900,Fainman; Yeshaiahu,0,0,0,0
1668395929275,ECE 247A,A00,103650,Jokerst; Jesse Vincent,0,0,0,0
1668395929699,ECE 247B,A00,103651,Wang; Joseph,0,0,0,0
1668395930125,ECE 250,A00,103652,Siegel; Paul H.,0,0,0,0
1668395930548,ECE 251A,A00,103654,Rao; Bhaskar D.,0,0,0,0
1668395930974,ECE 257B,A00,103655,Bharadia; Dinesh,0,0,0,0
1668395931397,ECE 258A,A00,103656,Milstein; Laurence B.,0,0,0,0
1668395931827,ECE 260B,A00,103658,Kang; Mingu,0,0,0,0
1668395932254,ECE 264A,A00,103659,Galton; Ian A,0,0,0,0
1668395932688,ECE 265A,A00,103661,Gudem; Prasad S.S.,0,0,0,0
1668395933129,ECE 265D,A00,103662,Gudem; Prasad S.S.,0,0,0,0
1668395933552,ECE 268,A00,103663,Koushanfar; Farinaz,0,0,0,0
1668395933976,ECE 269,A01,103665,Pal; Piya,0,0,0,0
1668395934404,ECE 271B,A00,103666,Vasconcelos; Manuela,0,0,0,0
1668395934830,ECE 276A,A00,103667,Atanasov; Nikolay A.,0,0,0,0
1668395935254,ECE 277,A00,103668,An; Cheolhong,0,0,0,0
1668395935682,ECE 279,A00,117947,Hall; Drew A.,0,0,0,0
1668395936542,ECE 283,A00,103670,Hsueh; Tzu-Chien,0,0,0,0
1668395936966,ECE 284,A00,103671,Turakhia; Yatish Girish,0,0,0,0
1668395937397,ECE 285,A00,103672,Zheng; Yang,0,0,0,0
1668395937397,ECE 285,B00,103673,Sworder; David D.,0,0,0,0
1668395937822,ECE 287,A00,103676,Javidi; Tara,0,0,0,0
1668395938249,MATH 200B,A00,098023,Salehi Golsefidy; Alireza,12,0,15,3
1668395938688,MATH 202B,A00,098024,Rhoades; Brendon Patrick,9,0,15,6
1668395939124,MATH 203B,A00,098025,Oprea; Dragos N.,10,0,15,5
1668395939551,MATH 204B,A00,098026,Sorensen; Claus M,13,0,15,2
1668395939973,MATH 208,A00,098027,Izadi; Elham,7,0,10,3
1668395940396,MATH 209,A00,098028,Pollack; Aaron,10,0,10,0
1668395940825,MATH 211A,A00,112919,Rogalski; Daniel,9,0,10,1
1668395941247,MATH 211B,A00,112920,Seward; Brandon M.,9,0,10,1
1668395941674,MATH 218,A00,098029,Li; Bo,10,0,10,0
1668395942098,MATH 220B,A00,098030,Novak; Jonathan I,11,0,15,4
1668395942522,MATH 221A,A00,098031,Ebenfelt; Peter F,13,0,15,2
1668395942973,MATH 231B,A00,098032,Zlatos; Andrej,12,0,15,3
1668395943417,MATH 240B,A00,098033,Ni; Lei,9,0,15,6
1668395943842,MATH 243,A00,098034,Jekel; David Andrew,10,0,10,0
1668395944266,MATH 245A,A00,098035,Nie; Jiawang,0,0,15,16
1668395944694,MATH 248,A00,098036,Bejenaru; Ioan,10,0,10,0
1668395945121,MATH 250B,A00,098037,Spolaor; Luca,14,0,15,1
1668395945557,MATH 258,A00,098038,Ni; Lei,10,0,10,0
1668395945979,MATH 264B,A00,098041,Rhoades; Brendon Patrick,9,0,15,6
1668395946412,MATH 268,A00,098042,Buss; Samuel R,10,0,10,0
1668395946845,MATH 269,A00,098043,Rhoades; Brendon Patrick,10,0,10,0
1668395947273,MATH 270B,A00,098044,Li; Bo,10,0,15,5
1668395947700,MATH 272B,A00,098045,Holst; Michael J,13,0,15,2
1668395948133,MATH 273A,A00,098046,Tian; Xiaochuan,10,0,15,5
1668395948568,MATH 275,A01,098048,Tian; Xiaochuan,6,0,10,4
1668395948991,MATH 278A,A00,098049,Holst; Michael J,8,0,10,2
1668395949416,MATH 278B,A00,098050,Cloninger; Alexander,10,0,10,0
1668395949841,MATH 278C,A00,098051,Nie; Jiawang,6,0,10,4
1668395950266,MATH 280B,A00,098052,Zheng; Tianyi,8,0,15,7
1668395950693,MATH 281B,A00,098053,Bradic; Jelena,0,0,15,15
1668395951119,MATH 282B,A00,098054,Arias-Castro; Ery,0,0,15,15
1668395951545,MATH 285,A00,098055,Fitzsimmons; Patrick J,0,0,15,17
1668395951971,MATH 287B,A00,098056,Arias-Castro; Ery,2,0,15,13
1668395952408,MATH 288,A00,098057,Agarwal; Pooja,9,0,10,1
1668395952408,MATH 288,B00,098058,Zhang; Danna,8,0,10,2
1668395952408,MATH 288,C00,098059,Williams; Ruth J,9,0,10,1
1668395952838,MATH 290B,A00,098060,Roberts; Justin Deritter,13,0,15,2
1668395953273,MATH 292,A00,098061,Belmont; Eva Kinoshita,10,0,10,0
1668395953700,MATH 295,A00,098062,Suk; Andrew Hoon,48,0,50,2
1668395954124,MATH 296,A00,098063,Novak; Jonathan I,20,0,20,0
1668395954550,MATH 297,001,098064,Gamst; Anthony Collins,9997,0,9999,2
1668396455973,COGS 205,A00,101395,Chiba; Andrea,19,0,20,1
1668396456399,COGS 210B,001,101404,Greene; Deanna Jacquelyn,9998,0,9999,1
1668396456399,COGS 210B,002,101417,Xia; Haijun,9999,0,9999,0
1668396456399,COGS 210B,003,101422,Nitz; Douglas A.,9999,0,9999,0
1668396456399,COGS 210B,004,101423,Hollan; James D.,9998,0,9999,1
1668396456399,COGS 210B,005,101424,Deak; Gedeon O.,9998,0,9999,1
1668396456399,COGS 210B,006,101425,Rossano; Federico,9999,0,9999,0
1668396456823,COGS 211B,A00,101427,Coulson; Seana M,9996,0,9999,3
1668396457247,COGS 220,A00,101428,Hollan; James D.,0,0,25,25
1668396457670,COGS 229,A00,101429,Dow; Steven P,18,0,25,7
1668396458098,COGS 230,A00,101430,Klemmer; Scott R,11,0,17,6
1668396458522,COGS 234,A00,101431,Xia; Haijun,1,0,25,24
1668396458945,COGS 260,A00,101432,Kiyonaga; Anastasia,21,0,25,4
1668396458945,COGS 260,B00,101433,Kirsh; David Joel,15,0,25,10
1668396459371,CSE 202,A00,102371,Impagliazzo; Russell,0,0,0,0
1668396459802,CSE 203B,A01,102373,Cheng; Chung Kuan,0,0,0,0
1668396460226,CSE 208,A00,102374,Micciancio; Daniele,0,0,0,0
1668396460657,CSE 209A,A00,112895,Impagliazzo; Russell,0,0,15,15
1668396461082,CSE 209B,A00,108005,Bellare; Mihir,0,0,0,0
1668396461508,CSE 210,A00,113163,Coblenz; Michael J,0,0,0,0
1668396461931,CSE 219,A00,106111,Dow; Steven P,0,0,20,20
1668396462355,CSE 221,A00,102376,Voelker; Geoffrey M.,0,0,0,0
1668396462777,CSE 224,A01,102378,Porter; George M,0,0,0,0
1668396463201,CSE 229A,A00,102379,Savage; Stefan,0,0,0,0
1668396463627,CSE 229C,A00,102380,Munyaka; Imani N. S.,0,0,0,0
1668396464052,CSE 232B,A00,102382,Deutsch; Alin Bernard,0,0,0,0
1668396464477,CSE 234,A01,112904,Kumar; Arun Kumar,0,0,0,0
1668396464907,CSE 237A,A00,102383,Rosing; Tajana Simunic,0,0,0,0
1668396465333,CSE 239A,A00,102384,Deutsch; Alin Bernard,0,0,0,0
1668396465760,CSE 239B,A00,102385,Polikarpova; Nadezhda,0,0,0,0
1668396466183,CSE 240A,A00,102386,Pannuto; Patrick William,0,0,0,0
1668396466607,CSE 240B,A00,102387,Zhao; Jishen,0,0,0,0
1668396467031,CSE 241A,A00,106406,Kang; Mingu,0,0,0,0
1668396467459,CSE 249B,A00,102388,Kahng; Andrew Byun,0,0,8,8
1668396467890,CSE 251B,A01,102392,Cottrell; Garrison W,0,0,0,0
1668396467890,CSE 251B,A02,102393,Cottrell; Garrison W,0,0,0,0
1668396468314,CSE 252B,A00,102394,Ochoa; Benjamin Lawrence,0,0,0,0
1668396468737,CSE 257,A01,102396,Gao; Sicun,0,0,0,0
1668396469163,CSE 272,A00,102397,Li; Tzumao,0,0,0,0
1668396469586,CSE 274,A00,111323,Chern; Albert Ren-Haur,0,0,0,0
1668396470019,CSE 282,A00,102398,Pevzner; Pavel Arkadjevich,0,0,0,0
1668396470442,CSE 284,A00,114175,Gymrek; Melissa Ann,0,0,0,0
1668396470863,CSE 290,A00,102399,Chandraker; Manmohan Krishna,0,0,0,0
1668396470863,CSE 290,B00,102400,Vaccaro; Kristen Marie,0,0,25,25
1668396470863,CSE 290,C00,102414,Pannuto; Patrick William,0,0,25,25
1668396470863,CSE 290,D00,102427,Pevzner; Pavel Arkadjevich,0,0,0,0
1668396470863,CSE 290,E00,102429,Zhao; Jishen,0,0,0,0
1668396470863,CSE 290,F00,102436,Tullsen; Dean Michael,0,0,0,0
1668396470863,CSE 290,G00,102440,Christensen; Henrik I,0,0,20,20
1668396471287,CSE 291,A00,102443,Su; Hao,0,0,0,0
1668396471287,CSE 291,B00,102448,Polikarpova; Nadezhda,0,0,0,0
1668396471287,CSE 291,C00,102453,Vaccaro; Kristen Marie,0,0,0,0
1668396471287,CSE 291,D00,111343,Savage; Stefan,0,0,0,0
1668396471287,CSE 291,E00,116474,Claffy; Kimberly Claire,0,0,0,0
1668396471287,CSE 291,F00,116479,Pasquale; Joseph,0,0,0,0
1668396471725,CSE 293,001,119111,Bafna; Vineet,9999,0,9999,0
1668396471725,CSE 293,002,119118,Bellare; Mihir,9999,0,9999,0
1668396471725,CSE 293,003,119122,Berg-Kirkpatrick; Taylor D,9999,0,9999,0
1668396471725,CSE 293,004,119135,Christensen; Henrik I,9999,0,9999,0
1668396471725,CSE 293,005,119142,Cottrell; Garrison W,9999,0,9999,0
1668396471725,CSE 293,006,119146,Deutsch; Alin Bernard,9999,0,9999,0
1668396471725,CSE 293,007,119159,Esmaeilzadeh; Hadi,9999,0,9999,0
1668396471725,CSE 293,008,119166,Freund; Yoav,9999,0,9999,0
1668396471725,CSE 293,009,119170,Griswold; William G.,9999,0,9999,0
1668396471725,CSE 293,010,119183,Gymrek; Melissa Ann,9999,0,9999,0
1668396471725,CSE 293,011,119190,Heninger; Nadia A,9999,0,9999,0
1668396471725,CSE 293,012,119230,Impagliazzo; Russell,9999,0,9999,0
1668396471725,CSE 293,013,119232,Jhala; Ranjit,9999,0,9999,0
1668396471725,CSE 293,014,119233,Kahng; Andrew Byun,9999,0,9999,0
1668396471725,CSE 293,015,119298,Kane; Daniel Mertz,9999,0,9999,0
1668396471725,CSE 293,016,119299,Kriegman; David J,9999,0,9999,0
1668396471725,CSE 293,017,119300,Kumar; Arun Kumar,9999,0,9999,0
1668396471725,CSE 293,018,119301,Lerner; Sorin,9999,0,9999,0
1668396471725,CSE 293,019,119302,Lovett; Shachar,9999,0,9999,0
1668396471725,CSE 293,020,119303,McAuley; Julian John,9999,0,9999,0
1668396471725,CSE 293,021,119304,Micciancio; Daniele,9999,0,9999,0
1668396471725,CSE 293,022,119367,Orailoglu; Alex,9999,0,9999,0
1668396471725,CSE 293,023,119382,Paturi; Ramamohan,9999,0,9999,0
1668396471725,CSE 293,024,119404,Polikarpova; Nadezhda,9999,0,9999,0
1668396471725,CSE 293,025,119406,Politz; Joseph Gibbs,9999,0,9999,0
1668396471725,CSE 293,026,119411,Porter; George M,9999,0,9999,0
1668396471725,CSE 293,027,119414,Porter; Leonard Emerson,9999,0,9999,0
1668396471725,CSE 293,028,119416,Ramamoorthi; Ravi,9999,0,9999,0
1668396471725,CSE 293,029,119417,Sahoo; Debashis,9999,0,9999,0
1668396471725,CSE 293,030,119420,Saul; Lawrence,9999,0,9999,0
1668396471725,CSE 293,031,119421,Savage; Stefan,9999,0,9999,0
1668396471725,CSE 293,032,119425,Schulze; Jurgen P.,9999,0,9999,0
1668396471725,CSE 293,033,119426,Snoeren; Alex C.,9999,0,9999,0
1668396471725,CSE 293,034,119428,Shang; Jingbo,9999,0,9999,0
1668396471725,CSE 293,035,119430,Stefan; Deian,9999,0,9999,0
1668396471725,CSE 293,036,119431,Su; Hao,9999,0,9999,0
1668396471725,CSE 293,037,119433,Swanson; Steven James,9999,0,9999,0
1668396471725,CSE 293,038,119435,Tullsen; Dean Michael,9999,0,9999,0
1668396471725,CSE 293,039,119483,Voelker; Geoffrey M.,9999,0,9999,0
1668396471725,CSE 293,040,119537,Zhao; Jishen,9999,0,9999,0
1668396471725,CSE 293,041,119538,Zhou; Yuan-Yuan,9999,0,9999,0
1668396471725,CSE 293,042,119539,Gao; Sicun,9999,0,9999,0
1668396471725,CSE 293,043,119540,Weibel; Nadir,9999,0,9999,0
1668396471725,CSE 293,044,119541,Gupta; Rajesh K.,9999,0,9999,0
1668396471725,CSE 293,045,126410,Vaccaro; Kristen Marie,9999,0,9999,0
1668396471725,CSE 293,046,126411,Klemke; Richard,9999,0,9999,0
1668396472147,CSE 294,A00,102459,Voelker; Geoffrey M.,0,0,0,0
1668396472147,CSE 294,B00,111322,Orailoglu; Alex,0,0,0,0
1668396472581,DSE 201,A00,096914,Deutsch; Alin Bernard,30,0,30,0
1668396473004,DSE 210,A00,096915,Dasgupta; Sanjoy,30,0,30,0
1668396473431,DSE 260A,A00,096916,Altintas De Callaf; Ilkay,30,0,30,0
1668396473906,ECE 200,001,103586,Antipa; Nicholas A,9999,0,9999,0
1668396473906,ECE 200,002,103587,Atanasov; Nikolay A.,9999,0,9999,0
1668396473906,ECE 200,003,103588,Bharadia; Dinesh,9999,0,9999,0
1668396473906,ECE 200,004,103589,Cheng; Chung Kuan,9999,0,9999,0
1668396473906,ECE 200,005,103590,Cosman; Pamela C.,9999,0,9999,0
1668396473906,ECE 200,006,103591,Dayeh; Shadi Ahmad,9999,0,9999,0
1668396473906,ECE 200,007,103592,Fainman; Yeshaiahu,9999,0,9999,0
1668396473906,ECE 200,008,103593,Ford; Joseph Earl,9999,0,9999,0
1668396473906,ECE 200,009,103594,Franceschetti; Massimo,9999,0,9999,0
1668396473906,ECE 200,010,103595,Fullerton; Eric E,9999,0,9999,0
1668396473906,ECE 200,011,103596,Galton; Ian A,9999,0,9999,0
1668396473906,ECE 200,012,103597,Gilja; Vikash,9999,0,9999,0
1668396473906,ECE 200,013,103598,Hall; Drew A.,9999,0,9999,0
1668396473906,ECE 200,014,103599,Hsueh; Tzu-Chien,9999,0,9999,0
1668396473906,ECE 200,015,103600,Javidi; Tara,9999,0,9999,0
1668396473906,ECE 200,016,103601,Kahng; Andrew Byun,9999,0,9999,0
1668396473906,ECE 200,017,103602,Kim; Young-Han,9999,0,9999,0
1668396473906,ECE 200,018,103603,Koushanfar; Farinaz,9999,0,9999,0
1668396473906,ECE 200,019,103604,Kuzum; Duygu,9999,0,9999,0
1668396473906,ECE 200,020,103605,Le; Hanh-Phuc,9999,0,9999,0
1668396473906,ECE 200,021,103606,Lin; Bill,9999,0,9999,0
1668396473906,ECE 200,022,103607,Liu; Zhaowei,9998,0,9999,1
1668396473906,ECE 200,023,103608,Lo; Yu-Hwa,9999,0,9999,0
1668396473906,ECE 200,024,103609,Lomakin; Vitaliy,9999,0,9999,0
1668396473906,ECE 200,025,103610,Mercier; Patrick Philip,9999,0,9999,0
1668396473906,ECE 200,026,103611,Meyer; Florian,9999,0,9999,0
1668396473906,ECE 200,027,103612,Milstein; Laurence B.,9999,0,9999,0
1668396473906,ECE 200,028,103613,Mir Arabbaygi; Siavash,9999,0,9999,0
1668396473906,ECE 200,029,103614,Mookherjea; Shayan,9999,0,9999,0
1668396473906,ECE 200,030,103615,Morris; Karcher William,9999,0,9999,0
1668396473906,ECE 200,031,103616,Ng; Tse Nga,9999,0,9999,0
1668396473906,ECE 200,032,103617,Nguyen; Truong Quang,9999,0,9999,0
1668396473906,ECE 200,033,103618,Nomura; Kenji,9999,0,9999,0
1668396473906,ECE 200,034,103619,Orlitsky; Alon,9999,0,9999,0
1668396473906,ECE 200,035,103620,Pal; Piya,9999,0,9999,0
1668396473906,ECE 200,036,103621,Papen; George C.,9999,0,9999,0
1668396473906,ECE 200,037,103622,Radic; Stojan,9999,0,9999,0
1668396473906,ECE 200,038,103623,Rao; Bhaskar D.,9999,0,9999,0
1668396473906,ECE 200,039,103624,Rao; Ramesh R,9999,0,9999,0
1668396473906,ECE 200,040,103625,Rebeiz; Gabriel,9999,0,9999,0
1668396473906,ECE 200,041,103626,Sanford; John R,9999,0,9999,0
1668396473906,ECE 200,042,103627,Siegel; Paul H.,9999,0,9999,0
1668396473906,ECE 200,043,103628,Sievenpiper; Daniel F.,9999,0,9999,0
1668396473906,ECE 200,044,103629,Sworder; David D.,9999,0,9999,0
1668396473906,ECE 200,045,103630,Taur; Yuan,9999,0,9999,0
1668396473906,ECE 200,046,103631,Touri; Behrouz,9999,0,9999,0
1668396473906,ECE 200,047,103632,Trivedi; Mohan M.,9999,0,9999,0
1668396473906,ECE 200,048,103633,Vasconcelos; Nuno,9999,0,9999,0
1668396473906,ECE 200,049,103634,Wang; Xiaolong,9999,0,9999,0
1668396473906,ECE 200,050,103635,Xie; Pengtao,9999,0,9999,0
1668396473906,ECE 200,051,103636,Yip; Michael,9999,0,9999,0
1668396473906,ECE 200,052,103637,Zeger; Kenneth A.,999,0,999,0
1668396473906,ECE 200,053,103638,Zhang; Xinyu,9999,0,9999,0
1668396473906,ECE 200,054,103639,Turakhia; Yatish Girish,9999,0,9999,0
1668396473906,ECE 200,055,103640,Kang; Mingu,9999,0,9999,0
1668396473906,ECE 200,056,103641,Shi; Yuanyuan,9999,0,9999,0
1668396473906,ECE 200,057,103642,Wang; Edward Jay,9999,0,9999,0
1668396473906,ECE 200,058,103643,Zheng; Yang,9999,0,9999,0
1668396474333,ECE 202,A00,103644,Kuzum; Duygu,0,0,0,0
1668396474756,ECE 212BN,A00,103646,Ng; Tse Nga,0,0,0,0
1668396475180,ECE 221,A00,111493,Staff,0,0,0,0
1668396475607,ECE 222B,A00,103647,Lomakin; Vitaliy,0,0,0,0
1668396476032,ECE 230B,A00,103648,Taur; Yuan,0,0,0,0
1668396476459,ECE 238B,A00,103649,Garay; Javier,0,0,0,0
1668396477004,ECE 240B,A00,112900,Fainman; Yeshaiahu,0,0,0,0
1668396477431,ECE 247A,A00,103650,Jokerst; Jesse Vincent,0,0,0,0
1668396477857,ECE 247B,A00,103651,Wang; Joseph,0,0,0,0
1668396478280,ECE 250,A00,103652,Siegel; Paul H.,0,0,0,0
1668396478704,ECE 251A,A00,103654,Rao; Bhaskar D.,0,0,0,0
1668396479129,ECE 257B,A00,103655,Bharadia; Dinesh,0,0,0,0
1668396479556,ECE 258A,A00,103656,Milstein; Laurence B.,0,0,0,0
1668396479980,ECE 260B,A00,103658,Kang; Mingu,0,0,0,0
1668396480408,ECE 264A,A00,103659,Galton; Ian A,0,0,0,0
1668396480835,ECE 265A,A00,103661,Gudem; Prasad S.S.,0,0,0,0
1668396481258,ECE 265D,A00,103662,Gudem; Prasad S.S.,0,0,0,0
1668396481686,ECE 268,A00,103663,Koushanfar; Farinaz,0,0,0,0
1668396482114,ECE 269,A01,103665,Pal; Piya,0,0,0,0
1668396482629,ECE 271B,A00,103666,Vasconcelos; Manuela,0,0,0,0
1668396483055,ECE 276A,A00,103667,Atanasov; Nikolay A.,0,0,0,0
1668396483479,ECE 277,A00,103668,An; Cheolhong,0,0,0,0
1668396483904,ECE 279,A00,117947,Hall; Drew A.,0,0,0,0
1668396484758,ECE 283,A00,103670,Hsueh; Tzu-Chien,0,0,0,0
1668396485185,ECE 284,A00,103671,Turakhia; Yatish Girish,0,0,0,0
1668396485608,ECE 285,A00,103672,Zheng; Yang,0,0,0,0
1668396485608,ECE 285,B00,103673,Sworder; David D.,0,0,0,0
1668396486034,ECE 287,A00,103676,Javidi; Tara,0,0,0,0
1668396486464,MATH 200B,A00,098023,Salehi Golsefidy; Alireza,12,0,15,3
1668396486888,MATH 202B,A00,098024,Rhoades; Brendon Patrick,9,0,15,6
1668396487317,MATH 203B,A00,098025,Oprea; Dragos N.,10,0,15,5
1668396487741,MATH 204B,A00,098026,Sorensen; Claus M,13,0,15,2
1668396488173,MATH 208,A00,098027,Izadi; Elham,7,0,10,3
1668396488597,MATH 209,A00,098028,Pollack; Aaron,10,0,10,0
1668396489042,MATH 211A,A00,112919,Rogalski; Daniel,9,0,10,1
1668396489465,MATH 211B,A00,112920,Seward; Brandon M.,9,0,10,1
1668396489890,MATH 218,A00,098029,Li; Bo,10,0,10,0
1668396490317,MATH 220B,A00,098030,Novak; Jonathan I,11,0,15,4
1668396490743,MATH 221A,A00,098031,Ebenfelt; Peter F,13,0,15,2
1668396491166,MATH 231B,A00,098032,Zlatos; Andrej,12,0,15,3
1668396491591,MATH 240B,A00,098033,Ni; Lei,9,0,15,6
1668396492016,MATH 243,A00,098034,Jekel; David Andrew,10,0,10,0
1668396492442,MATH 245A,A00,098035,Nie; Jiawang,0,0,15,16
1668396492881,MATH 248,A00,098036,Bejenaru; Ioan,10,0,10,0
1668396493306,MATH 250B,A00,098037,Spolaor; Luca,14,0,15,1
1668396493731,MATH 258,A00,098038,Ni; Lei,10,0,10,0
1668396494156,MATH 264B,A00,098041,Rhoades; Brendon Patrick,9,0,15,6
1668396494581,MATH 268,A00,098042,Buss; Samuel R,10,0,10,0
1668396495013,MATH 269,A00,098043,Rhoades; Brendon Patrick,10,0,10,0
1668396495442,MATH 270B,A00,098044,Li; Bo,10,0,15,5
1668396495865,MATH 272B,A00,098045,Holst; Michael J,13,0,15,2
1668396496292,MATH 273A,A00,098046,Tian; Xiaochuan,10,0,15,5
1668396496734,MATH 275,A01,098048,Tian; Xiaochuan,6,0,10,4
1668396497169,MATH 278A,A00,098049,Holst; Michael J,8,0,10,2
1668396497594,MATH 278B,A00,098050,Cloninger; Alexander,10,0,10,0
1668396498017,MATH 278C,A00,098051,Nie; Jiawang,6,0,10,4
1668396498441,MATH 280B,A00,098052,Zheng; Tianyi,8,0,15,7
1668396498875,MATH 281B,A00,098053,Bradic; Jelena,0,0,15,15
1668396499304,MATH 282B,A00,098054,Arias-Castro; Ery,0,0,15,15
1668396499728,MATH 285,A00,098055,Fitzsimmons; Patrick J,0,0,15,17
1668396500162,MATH 287B,A00,098056,Arias-Castro; Ery,2,0,15,13
1668396500592,MATH 288,A00,098057,Agarwal; Pooja,9,0,10,1
1668396500592,MATH 288,B00,098058,Zhang; Danna,8,0,10,2
1668396500592,MATH 288,C00,098059,Williams; Ruth J,9,0,10,1
1668396501020,MATH 290B,A00,098060,Roberts; Justin Deritter,13,0,15,2
1668396501444,MATH 292,A00,098061,Belmont; Eva Kinoshita,10,0,10,0
1668396501869,MATH 295,A00,098062,Suk; Andrew Hoon,48,0,50,2
1668396502303,MATH 296,A00,098063,Novak; Jonathan I,20,0,20,0
1668396502737,MATH 297,001,098064,Gamst; Anthony Collins,9997,0,9999,2
1668397003856,COGS 205,A00,101395,Chiba; Andrea,19,0,20,1
1668397004294,COGS 210B,001,101404,Greene; Deanna Jacquelyn,9998,0,9999,1
1668397004294,COGS 210B,002,101417,Xia; Haijun,9999,0,9999,0
1668397004294,COGS 210B,003,101422,Nitz; Douglas A.,9999,0,9999,0
1668397004294,COGS 210B,004,101423,Hollan; James D.,9998,0,9999,1
1668397004294,COGS 210B,005,101424,Deak; Gedeon O.,9998,0,9999,1
1668397004294,COGS 210B,006,101425,Rossano; Federico,9999,0,9999,0
1668397004718,COGS 211B,A00,101427,Coulson; Seana M,9996,0,9999,3
1668397005145,COGS 220,A00,101428,Hollan; James D.,0,0,25,25
1668397005569,COGS 229,A00,101429,Dow; Steven P,18,0,25,7
1668397005995,COGS 230,A00,101430,Klemmer; Scott R,11,0,17,6
1668397006419,COGS 234,A00,101431,Xia; Haijun,1,0,25,24
1668397006844,COGS 260,A00,101432,Kiyonaga; Anastasia,21,0,25,4
1668397006844,COGS 260,B00,101433,Kirsh; David Joel,15,0,25,10
1668397007270,CSE 202,A00,102371,Impagliazzo; Russell,0,0,0,0
1668397007692,CSE 203B,A01,102373,Cheng; Chung Kuan,0,0,0,0
1668397008120,CSE 208,A00,102374,Micciancio; Daniele,0,0,0,0
1668397008548,CSE 209A,A00,112895,Impagliazzo; Russell,0,0,15,15
1668397008971,CSE 209B,A00,108005,Bellare; Mihir,0,0,0,0
1668397009395,CSE 210,A00,113163,Coblenz; Michael J,0,0,0,0
1668397009819,CSE 219,A00,106111,Dow; Steven P,0,0,20,20
1668397010250,CSE 221,A00,102376,Voelker; Geoffrey M.,0,0,0,0
1668397010687,CSE 224,A01,102378,Porter; George M,0,0,0,0
1668397011114,CSE 229A,A00,102379,Savage; Stefan,0,0,0,0
1668397011539,CSE 229C,A00,102380,Munyaka; Imani N. S.,0,0,0,0
1668397011970,CSE 232B,A00,102382,Deutsch; Alin Bernard,0,0,0,0
1668397012408,CSE 234,A01,112904,Kumar; Arun Kumar,0,0,0,0
1668397012846,CSE 237A,A00,102383,Rosing; Tajana Simunic,0,0,0,0
1668397013271,CSE 239A,A00,102384,Deutsch; Alin Bernard,0,0,0,0
1668397013697,CSE 239B,A00,102385,Polikarpova; Nadezhda,0,0,0,0
1668397014123,CSE 240A,A00,102386,Pannuto; Patrick William,0,0,0,0
1668397014547,CSE 240B,A00,102387,Zhao; Jishen,0,0,0,0
1668397014974,CSE 241A,A00,106406,Kang; Mingu,0,0,0,0
1668397015398,CSE 249B,A00,102388,Kahng; Andrew Byun,0,0,8,8
1668397015830,CSE 251B,A01,102392,Cottrell; Garrison W,0,0,0,0
1668397015830,CSE 251B,A02,102393,Cottrell; Garrison W,0,0,0,0
1668397016257,CSE 252B,A00,102394,Ochoa; Benjamin Lawrence,0,0,0,0
1668397016680,CSE 257,A01,102396,Gao; Sicun,0,0,0,0
1668397017104,CSE 272,A00,102397,Li; Tzumao,0,0,0,0
1668397017530,CSE 274,A00,111323,Chern; Albert Ren-Haur,0,0,0,0
1668397017955,CSE 282,A00,102398,Pevzner; Pavel Arkadjevich,0,0,0,0
1668397018379,CSE 284,A00,114175,Gymrek; Melissa Ann,0,0,0,0
1668397018804,CSE 290,A00,102399,Chandraker; Manmohan Krishna,0,0,0,0
1668397018804,CSE 290,B00,102400,Vaccaro; Kristen Marie,0,0,25,25
1668397018804,CSE 290,C00,102414,Pannuto; Patrick William,0,0,25,25
1668397018804,CSE 290,D00,102427,Pevzner; Pavel Arkadjevich,0,0,0,0
1668397018804,CSE 290,E00,102429,Zhao; Jishen,0,0,0,0
1668397018804,CSE 290,F00,102436,Tullsen; Dean Michael,0,0,0,0
1668397018804,CSE 290,G00,102440,Christensen; Henrik I,0,0,20,20
1668397019232,CSE 291,A00,102443,Su; Hao,0,0,0,0
1668397019232,CSE 291,B00,102448,Polikarpova; Nadezhda,0,0,0,0
1668397019232,CSE 291,C00,102453,Vaccaro; Kristen Marie,0,0,0,0
1668397019232,CSE 291,D00,111343,Savage; Stefan,0,0,0,0
1668397019232,CSE 291,E00,116474,Claffy; Kimberly Claire,0,0,0,0
1668397019232,CSE 291,F00,116479,Pasquale; Joseph,0,0,0,0
1668397019661,CSE 293,001,119111,Bafna; Vineet,9999,0,9999,0
1668397019661,CSE 293,002,119118,Bellare; Mihir,9999,0,9999,0
1668397019661,CSE 293,003,119122,Berg-Kirkpatrick; Taylor D,9999,0,9999,0
1668397019661,CSE 293,004,119135,Christensen; Henrik I,9999,0,9999,0
1668397019661,CSE 293,005,119142,Cottrell; Garrison W,9999,0,9999,0
1668397019661,CSE 293,006,119146,Deutsch; Alin Bernard,9999,0,9999,0
1668397019661,CSE 293,007,119159,Esmaeilzadeh; Hadi,9999,0,9999,0
1668397019661,CSE 293,008,119166,Freund; Yoav,9999,0,9999,0
1668397019661,CSE 293,009,119170,Griswold; William G.,9999,0,9999,0
1668397019661,CSE 293,010,119183,Gymrek; Melissa Ann,9999,0,9999,0
1668397019661,CSE 293,011,119190,Heninger; Nadia A,9999,0,9999,0
1668397019661,CSE 293,012,119230,Impagliazzo; Russell,9999,0,9999,0
1668397019661,CSE 293,013,119232,Jhala; Ranjit,9999,0,9999,0
1668397019661,CSE 293,014,119233,Kahng; Andrew Byun,9999,0,9999,0
1668397019661,CSE 293,015,119298,Kane; Daniel Mertz,9999,0,9999,0
1668397019661,CSE 293,016,119299,Kriegman; David J,9999,0,9999,0
1668397019661,CSE 293,017,119300,Kumar; Arun Kumar,9999,0,9999,0
1668397019661,CSE 293,018,119301,Lerner; Sorin,9999,0,9999,0
1668397019661,CSE 293,019,119302,Lovett; Shachar,9999,0,9999,0
1668397019661,CSE 293,020,119303,McAuley; Julian John,9999,0,9999,0
1668397019661,CSE 293,021,119304,Micciancio; Daniele,9999,0,9999,0
1668397019661,CSE 293,022,119367,Orailoglu; Alex,9999,0,9999,0
1668397019661,CSE 293,023,119382,Paturi; Ramamohan,9999,0,9999,0
1668397019661,CSE 293,024,119404,Polikarpova; Nadezhda,9999,0,9999,0
1668397019661,CSE 293,025,119406,Politz; Joseph Gibbs,9999,0,9999,0
1668397019661,CSE 293,026,119411,Porter; George M,9999,0,9999,0
1668397019661,CSE 293,027,119414,Porter; Leonard Emerson,9999,0,9999,0
1668397019661,CSE 293,028,119416,Ramamoorthi; Ravi,9999,0,9999,0
1668397019661,CSE 293,029,119417,Sahoo; Debashis,9999,0,9999,0
1668397019661,CSE 293,030,119420,Saul; Lawrence,9999,0,9999,0
1668397019661,CSE 293,031,119421,Savage; Stefan,9999,0,9999,0
1668397019661,CSE 293,032,119425,Schulze; Jurgen P.,9999,0,9999,0
1668397019661,CSE 293,033,119426,Snoeren; Alex C.,9999,0,9999,0
1668397019661,CSE 293,034,119428,Shang; Jingbo,9999,0,9999,0
1668397019661,CSE 293,035,119430,Stefan; Deian,9999,0,9999,0
1668397019661,CSE 293,036,119431,Su; Hao,9999,0,9999,0
1668397019661,CSE 293,037,119433,Swanson; Steven James,9999,0,9999,0
1668397019661,CSE 293,038,119435,Tullsen; Dean Michael,9999,0,9999,0
1668397019661,CSE 293,039,119483,Voelker; Geoffrey M.,9999,0,9999,0
1668397019661,CSE 293,040,119537,Zhao; Jishen,9999,0,9999,0
1668397019661,CSE 293,041,119538,Zhou; Yuan-Yuan,9999,0,9999,0
1668397019661,CSE 293,042,119539,Gao; Sicun,9999,0,9999,0
1668397019661,CSE 293,043,119540,Weibel; Nadir,9999,0,9999,0
1668397019661,CSE 293,044,119541,Gupta; Rajesh K.,9999,0,9999,0
1668397019661,CSE 293,045,126410,Vaccaro; Kristen Marie,9999,0,9999,0
1668397019661,CSE 293,046,126411,Klemke; Richard,9999,0,9999,0
1668397020083,CSE 294,A00,102459,Voelker; Geoffrey M.,0,0,0,0
1668397020083,CSE 294,B00,111322,Orailoglu; Alex,0,0,0,0
1668397020508,DSE 201,A00,096914,Deutsch; Alin Bernard,30,0,30,0
1668397020933,DSE 210,A00,096915,Dasgupta; Sanjoy,30,0,30,0
1668397021357,DSE 260A,A00,096916,Altintas De Callaf; Ilkay,30,0,30,0
1668397021799,ECE 200,001,103586,Antipa; Nicholas A,9999,0,9999,0
1668397021799,ECE 200,002,103587,Atanasov; Nikolay A.,9999,0,9999,0
1668397021799,ECE 200,003,103588,Bharadia; Dinesh,9999,0,9999,0
1668397021799,ECE 200,004,103589,Cheng; Chung Kuan,9999,0,9999,0
1668397021799,ECE 200,005,103590,Cosman; Pamela C.,9999,0,9999,0
1668397021799,ECE 200,006,103591,Dayeh; Shadi Ahmad,9999,0,9999,0
1668397021799,ECE 200,007,103592,Fainman; Yeshaiahu,9999,0,9999,0
1668397021799,ECE 200,008,103593,Ford; Joseph Earl,9999,0,9999,0
1668397021799,ECE 200,009,103594,Franceschetti; Massimo,9999,0,9999,0
1668397021799,ECE 200,010,103595,Fullerton; Eric E,9999,0,9999,0
1668397021799,ECE 200,011,103596,Galton; Ian A,9999,0,9999,0
1668397021799,ECE 200,012,103597,Gilja; Vikash,9999,0,9999,0
1668397021799,ECE 200,013,103598,Hall; Drew A.,9999,0,9999,0
1668397021799,ECE 200,014,103599,Hsueh; Tzu-Chien,9999,0,9999,0
1668397021799,ECE 200,015,103600,Javidi; Tara,9999,0,9999,0
1668397021799,ECE 200,016,103601,Kahng; Andrew Byun,9999,0,9999,0
1668397021799,ECE 200,017,103602,Kim; Young-Han,9999,0,9999,0
1668397021799,ECE 200,018,103603,Koushanfar; Farinaz,9999,0,9999,0
1668397021799,ECE 200,019,103604,Kuzum; Duygu,9999,0,9999,0
1668397021799,ECE 200,020,103605,Le; Hanh-Phuc,9999,0,9999,0
1668397021799,ECE 200,021,103606,Lin; Bill,9999,0,9999,0
1668397021799,ECE 200,022,103607,Liu; Zhaowei,9998,0,9999,1
1668397021799,ECE 200,023,103608,Lo; Yu-Hwa,9999,0,9999,0
1668397021799,ECE 200,024,103609,Lomakin; Vitaliy,9999,0,9999,0
1668397021799,ECE 200,025,103610,Mercier; Patrick Philip,9999,0,9999,0
1668397021799,ECE 200,026,103611,Meyer; Florian,9999,0,9999,0
1668397021799,ECE 200,027,103612,Milstein; Laurence B.,9999,0,9999,0
1668397021799,ECE 200,028,103613,Mir Arabbaygi; Siavash,9999,0,9999,0
1668397021799,ECE 200,029,103614,Mookherjea; Shayan,9999,0,9999,0
1668397021799,ECE 200,030,103615,Morris; Karcher William,9999,0,9999,0
1668397021799,ECE 200,031,103616,Ng; Tse Nga,9999,0,9999,0
1668397021799,ECE 200,032,103617,Nguyen; Truong Quang,9999,0,9999,0
1668397021799,ECE 200,033,103618,Nomura; Kenji,9999,0,9999,0
1668397021799,ECE 200,034,103619,Orlitsky; Alon,9999,0,9999,0
1668397021799,ECE 200,035,103620,Pal; Piya,9999,0,9999,0
1668397021799,ECE 200,036,103621,Papen; George C.,9999,0,9999,0
1668397021799,ECE 200,037,103622,Radic; Stojan,9999,0,9999,0
1668397021799,ECE 200,038,103623,Rao; Bhaskar D.,9999,0,9999,0
1668397021799,ECE 200,039,103624,Rao; Ramesh R,9999,0,9999,0
1668397021799,ECE 200,040,103625,Rebeiz; Gabriel,9999,0,9999,0
1668397021799,ECE 200,041,103626,Sanford; John R,9999,0,9999,0
1668397021799,ECE 200,042,103627,Siegel; Paul H.,9999,0,9999,0
1668397021799,ECE 200,043,103628,Sievenpiper; Daniel F.,9999,0,9999,0
1668397021799,ECE 200,044,103629,Sworder; David D.,9999,0,9999,0
1668397021799,ECE 200,045,103630,Taur; Yuan,9999,0,9999,0
1668397021799,ECE 200,046,103631,Touri; Behrouz,9999,0,9999,0
1668397021799,ECE 200,047,103632,Trivedi; Mohan M.,9999,0,9999,0
1668397021799,ECE 200,048,103633,Vasconcelos; Nuno,9999,0,9999,0
1668397021799,ECE 200,049,103634,Wang; Xiaolong,9999,0,9999,0
1668397021799,ECE 200,050,103635,Xie; Pengtao,9999,0,9999,0
1668397021799,ECE 200,051,103636,Yip; Michael,9999,0,9999,0
1668397021799,ECE 200,052,103637,Zeger; Kenneth A.,999,0,999,0
1668397021799,ECE 200,053,103638,Zhang; Xinyu,9999,0,9999,0
1668397021799,ECE 200,054,103639,Turakhia; Yatish Girish,9999,0,9999,0
1668397021799,ECE 200,055,103640,Kang; Mingu,9999,0,9999,0
1668397021799,ECE 200,056,103641,Shi; Yuanyuan,9999,0,9999,0
1668397021799,ECE 200,057,103642,Wang; Edward Jay,9999,0,9999,0
1668397021799,ECE 200,058,103643,Zheng; Yang,9999,0,9999,0
1668397022225,ECE 202,A00,103644,Kuzum; Duygu,0,0,0,0
1668397022652,ECE 212BN,A00,103646,Ng; Tse Nga,0,0,0,0
1668397023086,ECE 221,A00,111493,Staff,0,0,0,0
1668397023512,ECE 222B,A00,103647,Lomakin; Vitaliy,0,0,0,0
1668397023935,ECE 230B,A00,103648,Taur; Yuan,0,0,0,0
1668397024362,ECE 238B,A00,103649,Garay; Javier,0,0,0,0
1668397024800,ECE 240B,A00,112900,Fainman; Yeshaiahu,0,0,0,0
1668397025238,ECE 247A,A00,103650,Jokerst; Jesse Vincent,0,0,0,0
1668397025675,ECE 247B,A00,103651,Wang; Joseph,0,0,0,0
1668397026101,ECE 250,A00,103652,Siegel; Paul H.,0,0,0,0
1668397026538,ECE 251A,A00,103654,Rao; Bhaskar D.,0,0,0,0
1668397026968,ECE 257B,A00,103655,Bharadia; Dinesh,0,0,0,0
1668397027399,ECE 258A,A00,103656,Milstein; Laurence B.,0,0,0,0
1668397027823,ECE 260B,A00,103658,Kang; Mingu,0,0,0,0
1668397028251,ECE 264A,A00,103659,Galton; Ian A,0,0,0,0
1668397028674,ECE 265A,A00,103661,Gudem; Prasad S.S.,0,0,0,0
1668397029102,ECE 265D,A00,103662,Gudem; Prasad S.S.,0,0,0,0
1668397029527,ECE 268,A00,103663,Koushanfar; Farinaz,0,0,0,0
1668397029958,ECE 269,A01,103665,Pal; Piya,0,0,0,0
1668397030396,ECE 271B,A00,103666,Vasconcelos; Manuela,0,0,0,0
1668397030818,ECE 276A,A00,103667,Atanasov; Nikolay A.,0,0,0,0
1668397031252,ECE 277,A00,103668,An; Cheolhong,0,0,0,0
1668397031677,ECE 279,A00,117947,Hall; Drew A.,0,0,0,0
1668397032524,ECE 283,A00,103670,Hsueh; Tzu-Chien,0,0,0,0
1668397032952,ECE 284,A00,103671,Turakhia; Yatish Girish,0,0,0,0
1668397033379,ECE 285,A00,103672,Zheng; Yang,0,0,0,0
1668397033379,ECE 285,B00,103673,Sworder; David D.,0,0,0,0
1668397033806,ECE 287,A00,103676,Javidi; Tara,0,0,0,0
1668397034234,MATH 200B,A00,098023,Salehi Golsefidy; Alireza,12,0,15,3
1668397034661,MATH 202B,A00,098024,Rhoades; Brendon Patrick,9,0,15,6
1668397035092,MATH 203B,A00,098025,Oprea; Dragos N.,10,0,15,5
1668397035523,MATH 204B,A00,098026,Sorensen; Claus M,13,0,15,2
1668397035950,MATH 208,A00,098027,Izadi; Elham,7,0,10,3
1668397036373,MATH 209,A00,098028,Pollack; Aaron,10,0,10,0
1668397036803,MATH 211A,A00,112919,Rogalski; Daniel,9,0,10,1
1668397037228,MATH 211B,A00,112920,Seward; Brandon M.,9,0,10,1
1668397037656,MATH 218,A00,098029,Li; Bo,10,0,10,0
1668397038081,MATH 220B,A00,098030,Novak; Jonathan I,11,0,15,4
1668397038505,MATH 221A,A00,098031,Ebenfelt; Peter F,13,0,15,2
1668397038931,MATH 231B,A00,098032,Zlatos; Andrej,12,0,15,3
1668397039354,MATH 240B,A00,098033,Ni; Lei,9,0,15,6
1668397039789,MATH 243,A00,098034,Jekel; David Andrew,10,0,10,0
1668397040217,MATH 245A,A00,098035,Nie; Jiawang,0,0,15,16
1668397040643,MATH 248,A00,098036,Bejenaru; Ioan,10,0,10,0
1668397041070,MATH 250B,A00,098037,Spolaor; Luca,14,0,15,1
1668397041495,MATH 258,A00,098038,Ni; Lei,10,0,10,0
1668397041919,MATH 264B,A00,098041,Rhoades; Brendon Patrick,9,0,15,6
1668397042342,MATH 268,A00,098042,Buss; Samuel R,10,0,10,0
1668397042786,MATH 269,A00,098043,Rhoades; Brendon Patrick,10,0,10,0
1668397043213,MATH 270B,A00,098044,Li; Bo,10,0,15,5
1668397043638,MATH 272B,A00,098045,Holst; Michael J,13,0,15,2
1668397044061,MATH 273A,A00,098046,Tian; Xiaochuan,10,0,15,5
1668397044485,MATH 275,A01,098048,Tian; Xiaochuan,6,0,10,4
1668397044915,MATH 278A,A00,098049,Holst; Michael J,8,0,10,2
1668397045338,MATH 278B,A00,098050,Cloninger; Alexander,10,0,10,0
1668397045762,MATH 278C,A00,098051,Nie; Jiawang,6,0,10,4
1668397046190,MATH 280B,A00,098052,Zheng; Tianyi,8,0,15,7
1668397046618,MATH 281B,A00,098053,Bradic; Jelena,0,0,15,15
1668397047121,MATH 282B,A00,098054,Arias-Castro; Ery,0,0,15,15
1668397047560,MATH 285,A00,098055,Fitzsimmons; Patrick J,0,0,15,17
1668397047987,MATH 287B,A00,098056,Arias-Castro; Ery,2,0,15,13
1668397048411,MATH 288,A00,098057,Agarwal; Pooja,9,0,10,1
1668397048411,MATH 288,B00,098058,Zhang; Danna,8,0,10,2
1668397048411,MATH 288,C00,098059,Williams; Ruth J,9,0,10,1
1668397048834,MATH 290B,A00,098060,Roberts; Justin Deritter,13,0,15,2
1668397049260,MATH 292,A00,098061,Belmont; Eva Kinoshita,10,0,10,0
1668397049688,MATH 295,A00,098062,Suk; Andrew Hoon,48,0,50,2
1668397050115,MATH 296,A00,098063,Novak; Jonathan I,20,0,20,0
1668397050553,MATH 297,001,098064,Gamst; Anthony Collins,9997,0,9999,2
1668397552408,COGS 205,A00,101395,Chiba; Andrea,19,0,20,1
1668397552837,COGS 210B,001,101404,Greene; Deanna Jacquelyn,9998,0,9999,1
1668397552837,COGS 210B,002,101417,Xia; Haijun,9999,0,9999,0
1668397552837,COGS 210B,003,101422,Nitz; Douglas A.,9999,0,9999,0
1668397552837,COGS 210B,004,101423,Hollan; James D.,9998,0,9999,1
1668397552837,COGS 210B,005,101424,Deak; Gedeon O.,9998,0,9999,1
1668397552837,COGS 210B,006,101425,Rossano; Federico,9999,0,9999,0
1668397553262,COGS 211B,A00,101427,Coulson; Seana M,9996,0,9999,3
1668397553686,COGS 220,A00,101428,Hollan; James D.,0,0,25,25
1668397554110,COGS 229,A00,101429,Dow; Steven P,18,0,25,7
1668397554533,COGS 230,A00,101430,Klemmer; Scott R,11,0,17,6
1668397554957,COGS 234,A00,101431,Xia; Haijun,1,0,25,24
1668397555386,COGS 260,A00,101432,Kiyonaga; Anastasia,21,0,25,4
1668397555386,COGS 260,B00,101433,Kirsh; David Joel,15,0,25,10
1668397555825,CSE 202,A00,102371,Impagliazzo; Russell,0,0,0,0
1668397556257,CSE 203B,A01,102373,Cheng; Chung Kuan,0,0,0,0
1668397556685,CSE 208,A00,102374,Micciancio; Daniele,0,0,0,0
1668397557109,CSE 209A,A00,112895,Impagliazzo; Russell,0,0,15,15
1668397557532,CSE 209B,A00,108005,Bellare; Mihir,0,0,0,0
1668397557964,CSE 210,A00,113163,Coblenz; Michael J,0,0,0,0
1668397558391,CSE 219,A00,106111,Dow; Steven P,0,0,20,20
1668397558819,CSE 221,A00,102376,Voelker; Geoffrey M.,0,0,0,0
1668397559247,CSE 224,A01,102378,Porter; George M,0,0,0,0
1668397559677,CSE 229A,A00,102379,Savage; Stefan,0,0,0,0
1668397560101,CSE 229C,A00,102380,Munyaka; Imani N. S.,0,0,0,0
1668397560530,CSE 232B,A00,102382,Deutsch; Alin Bernard,0,0,0,0
1668397560960,CSE 234,A01,112904,Kumar; Arun Kumar,0,0,0,0
1668397561392,CSE 237A,A00,102383,Rosing; Tajana Simunic,0,0,0,0
1668397561814,CSE 239A,A00,102384,Deutsch; Alin Bernard,0,0,0,0
1668397562248,CSE 239B,A00,102385,Polikarpova; Nadezhda,0,0,0,0
1668397562685,CSE 240A,A00,102386,Pannuto; Patrick William,0,0,0,0
1668397563117,CSE 240B,A00,102387,Zhao; Jishen,0,0,0,0
1668397563541,CSE 241A,A00,106406,Kang; Mingu,0,0,0,0
1668397563968,CSE 249B,A00,102388,Kahng; Andrew Byun,0,0,8,8
1668397564400,CSE 251B,A01,102392,Cottrell; Garrison W,0,0,0,0
1668397564400,CSE 251B,A02,102393,Cottrell; Garrison W,0,0,0,0
1668397564826,CSE 252B,A00,102394,Ochoa; Benjamin Lawrence,0,0,0,0
1668397565253,CSE 257,A01,102396,Gao; Sicun,0,0,0,0
1668397565683,CSE 272,A00,102397,Li; Tzumao,0,0,0,0
1668397566106,CSE 274,A00,111323,Chern; Albert Ren-Haur,0,0,0,0
1668397566537,CSE 282,A00,102398,Pevzner; Pavel Arkadjevich,0,0,0,0
1668397566961,CSE 284,A00,114175,Gymrek; Melissa Ann,0,0,0,0
1668397567387,CSE 290,A00,102399,Chandraker; Manmohan Krishna,0,0,0,0
1668397567387,CSE 290,B00,102400,Vaccaro; Kristen Marie,0,0,25,25
1668397567387,CSE 290,C00,102414,Pannuto; Patrick William,0,0,25,25
1668397567387,CSE 290,D00,102427,Pevzner; Pavel Arkadjevich,0,0,0,0
1668397567387,CSE 290,E00,102429,Zhao; Jishen,0,0,0,0
1668397567387,CSE 290,F00,102436,Tullsen; Dean Michael,0,0,0,0
1668397567387,CSE 290,G00,102440,Christensen; Henrik I,0,0,20,20
1668397567825,CSE 291,A00,102443,Su; Hao,0,0,0,0
1668397567825,CSE 291,B00,102448,Polikarpova; Nadezhda,0,0,0,0
1668397567825,CSE 291,C00,102453,Vaccaro; Kristen Marie,0,0,0,0
1668397567825,CSE 291,D00,111343,Savage; Stefan,0,0,0,0
1668397567825,CSE 291,E00,116474,Claffy; Kimberly Claire,0,0,0,0
1668397567825,CSE 291,F00,116479,Pasquale; Joseph,0,0,0,0
1668397568320,CSE 293,001,119111,Bafna; Vineet,9999,0,9999,0
1668397568320,CSE 293,002,119118,Bellare; Mihir,9999,0,9999,0
1668397568320,CSE 293,003,119122,Berg-Kirkpatrick; Taylor D,9999,0,9999,0
1668397568320,CSE 293,004,119135,Christensen; Henrik I,9999,0,9999,0
1668397568320,CSE 293,005,119142,Cottrell; Garrison W,9999,0,9999,0
1668397568320,CSE 293,006,119146,Deutsch; Alin Bernard,9999,0,9999,0
1668397568320,CSE 293,007,119159,Esmaeilzadeh; Hadi,9999,0,9999,0
1668397568320,CSE 293,008,119166,Freund; Yoav,9999,0,9999,0
1668397568320,CSE 293,009,119170,Griswold; William G.,9999,0,9999,0
1668397568320,CSE 293,010,119183,Gymrek; Melissa Ann,9999,0,9999,0
1668397568320,CSE 293,011,119190,Heninger; Nadia A,9999,0,9999,0
1668397568320,CSE 293,012,119230,Impagliazzo; Russell,9999,0,9999,0
1668397568320,CSE 293,013,119232,Jhala; Ranjit,9999,0,9999,0
1668397568320,CSE 293,014,119233,Kahng; Andrew Byun,9999,0,9999,0
1668397568320,CSE 293,015,119298,Kane; Daniel Mertz,9999,0,9999,0
1668397568320,CSE 293,016,119299,Kriegman; David J,9999,0,9999,0
1668397568320,CSE 293,017,119300,Kumar; Arun Kumar,9999,0,9999,0
1668397568320,CSE 293,018,119301,Lerner; Sorin,9999,0,9999,0
1668397568320,CSE 293,019,119302,Lovett; Shachar,9999,0,9999,0
1668397568320,CSE 293,020,119303,McAuley; Julian John,9999,0,9999,0
1668397568320,CSE 293,021,119304,Micciancio; Daniele,9999,0,9999,0
1668397568320,CSE 293,022,119367,Orailoglu; Alex,9999,0,9999,0
1668397568320,CSE 293,023,119382,Paturi; Ramamohan,9999,0,9999,0
1668397568320,CSE 293,024,119404,Polikarpova; Nadezhda,9999,0,9999,0
1668397568320,CSE 293,025,119406,Politz; Joseph Gibbs,9999,0,9999,0
1668397568320,CSE 293,026,119411,Porter; George M,9999,0,9999,0
1668397568320,CSE 293,027,119414,Porter; Leonard Emerson,9999,0,9999,0
1668397568320,CSE 293,028,119416,Ramamoorthi; Ravi,9999,0,9999,0
1668397568320,CSE 293,029,119417,Sahoo; Debashis,9999,0,9999,0
1668397568320,CSE 293,030,119420,Saul; Lawrence,9999,0,9999,0
1668397568320,CSE 293,031,119421,Savage; Stefan,9999,0,9999,0
1668397568320,CSE 293,032,119425,Schulze; Jurgen P.,9999,0,9999,0
1668397568320,CSE 293,033,119426,Snoeren; Alex C.,9999,0,9999,0
1668397568320,CSE 293,034,119428,Shang; Jingbo,9999,0,9999,0
1668397568320,CSE 293,035,119430,Stefan; Deian,9999,0,9999,0
1668397568320,CSE 293,036,119431,Su; Hao,9999,0,9999,0
1668397568320,CSE 293,037,119433,Swanson; Steven James,9999,0,9999,0
1668397568320,CSE 293,038,119435,Tullsen; Dean Michael,9999,0,9999,0
1668397568320,CSE 293,039,119483,Voelker; Geoffrey M.,9999,0,9999,0
1668397568320,CSE 293,040,119537,Zhao; Jishen,9999,0,9999,0
1668397568320,CSE 293,041,119538,Zhou; Yuan-Yuan,9999,0,9999,0
1668397568320,CSE 293,042,119539,Gao; Sicun,9999,0,9999,0
1668397568320,CSE 293,043,119540,Weibel; Nadir,9999,0,9999,0
1668397568320,CSE 293,044,119541,Gupta; Rajesh K.,9999,0,9999,0
1668397568320,CSE 293,045,126410,Vaccaro; Kristen Marie,9999,0,9999,0
1668397568320,CSE 293,046,126411,Klemke; Richard,9999,0,9999,0
1668397568757,CSE 294,A00,102459,Voelker; Geoffrey M.,0,0,0,0
1668397568757,CSE 294,B00,111322,Orailoglu; Alex,0,0,0,0
1668397569267,DSE 201,A00,096914,Deutsch; Alin Bernard,30,0,30,0
1668397569700,DSE 210,A00,096915,Dasgupta; Sanjoy,30,0,30,0
1668397570133,DSE 260A,A00,096916,Altintas De Callaf; Ilkay,30,0,30,0
1668397570585,ECE 200,001,103586,Antipa; Nicholas A,9999,0,9999,0
1668397570585,ECE 200,002,103587,Atanasov; Nikolay A.,9999,0,9999,0
1668397570585,ECE 200,003,103588,Bharadia; Dinesh,9999,0,9999,0
1668397570585,ECE 200,004,103589,Cheng; Chung Kuan,9999,0,9999,0
1668397570585,ECE 200,005,103590,Cosman; Pamela C.,9999,0,9999,0
1668397570585,ECE 200,006,103591,Dayeh; Shadi Ahmad,9999,0,9999,0
1668397570585,ECE 200,007,103592,Fainman; Yeshaiahu,9999,0,9999,0
1668397570585,ECE 200,008,103593,Ford; Joseph Earl,9999,0,9999,0
1668397570585,ECE 200,009,103594,Franceschetti; Massimo,9999,0,9999,0
1668397570585,ECE 200,010,103595,Fullerton; Eric E,9999,0,9999,0
1668397570585,ECE 200,011,103596,Galton; Ian A,9999,0,9999,0
1668397570585,ECE 200,012,103597,Gilja; Vikash,9999,0,9999,0
1668397570585,ECE 200,013,103598,Hall; Drew A.,9999,0,9999,0
1668397570585,ECE 200,014,103599,Hsueh; Tzu-Chien,9999,0,9999,0
1668397570585,ECE 200,015,103600,Javidi; Tara,9999,0,9999,0
1668397570585,ECE 200,016,103601,Kahng; Andrew Byun,9999,0,9999,0
1668397570585,ECE 200,017,103602,Kim; Young-Han,9999,0,9999,0
1668397570585,ECE 200,018,103603,Koushanfar; Farinaz,9999,0,9999,0
1668397570585,ECE 200,019,103604,Kuzum; Duygu,9999,0,9999,0
1668397570585,ECE 200,020,103605,Le; Hanh-Phuc,9999,0,9999,0
1668397570585,ECE 200,021,103606,Lin; Bill,9999,0,9999,0
1668397570585,ECE 200,022,103607,Liu; Zhaowei,9998,0,9999,1
1668397570585,ECE 200,023,103608,Lo; Yu-Hwa,9999,0,9999,0
1668397570585,ECE 200,024,103609,Lomakin; Vitaliy,9999,0,9999,0
1668397570585,ECE 200,025,103610,Mercier; Patrick Philip,9999,0,9999,0
1668397570585,ECE 200,026,103611,Meyer; Florian,9999,0,9999,0
1668397570585,ECE 200,027,103612,Milstein; Laurence B.,9999,0,9999,0
1668397570585,ECE 200,028,103613,Mir Arabbaygi; Siavash,9999,0,9999,0
1668397570585,ECE 200,029,103614,Mookherjea; Shayan,9999,0,9999,0
1668397570585,ECE 200,030,103615,Morris; Karcher William,9999,0,9999,0
1668397570585,ECE 200,031,103616,Ng; Tse Nga,9999,0,9999,0
1668397570585,ECE 200,032,103617,Nguyen; Truong Quang,9999,0,9999,0
1668397570585,ECE 200,033,103618,Nomura; Kenji,9999,0,9999,0
1668397570585,ECE 200,034,103619,Orlitsky; Alon,9999,0,9999,0
1668397570585,ECE 200,035,103620,Pal; Piya,9999,0,9999,0
1668397570585,ECE 200,036,103621,Papen; George C.,9999,0,9999,0
1668397570585,ECE 200,037,103622,Radic; Stojan,9999,0,9999,0
1668397570585,ECE 200,038,103623,Rao; Bhaskar D.,9999,0,9999,0
1668397570585,ECE 200,039,103624,Rao; Ramesh R,9999,0,9999,0
1668397570585,ECE 200,040,103625,Rebeiz; Gabriel,9999,0,9999,0
1668397570585,ECE 200,041,103626,Sanford; John R,9999,0,9999,0
1668397570585,ECE 200,042,103627,Siegel; Paul H.,9999,0,9999,0
1668397570585,ECE 200,043,103628,Sievenpiper; Daniel F.,9999,0,9999,0
1668397570585,ECE 200,044,103629,Sworder; David D.,9999,0,9999,0
1668397570585,ECE 200,045,103630,Taur; Yuan,9999,0,9999,0
1668397570585,ECE 200,046,103631,Touri; Behrouz,9999,0,9999,0
1668397570585,ECE 200,047,103632,Trivedi; Mohan M.,9999,0,9999,0
1668397570585,ECE 200,048,103633,Vasconcelos; Nuno,9999,0,9999,0
1668397570585,ECE 200,049,103634,Wang; Xiaolong,9999,0,9999,0
1668397570585,ECE 200,050,103635,Xie; Pengtao,9999,0,9999,0
1668397570585,ECE 200,051,103636,Yip; Michael,9999,0,9999,0
1668397570585,ECE 200,052,103637,Zeger; Kenneth A.,999,0,999,0
1668397570585,ECE 200,053,103638,Zhang; Xinyu,9999,0,9999,0
1668397570585,ECE 200,054,103639,Turakhia; Yatish Girish,9999,0,9999,0
1668397570585,ECE 200,055,103640,Kang; Mingu,9999,0,9999,0
1668397570585,ECE 200,056,103641,Shi; Yuanyuan,9999,0,9999,0
1668397570585,ECE 200,057,103642,Wang; Edward Jay,9999,0,9999,0
1668397570585,ECE 200,058,103643,Zheng; Yang,9999,0,9999,0
1668397571009,ECE 202,A00,103644,Kuzum; Duygu,0,0,0,0
1668397571437,ECE 212BN,A00,103646,Ng; Tse Nga,0,0,0,0
1668397571862,ECE 221,A00,111493,Staff,0,0,0,0
1668397572295,ECE 222B,A00,103647,Lomakin; Vitaliy,0,0,0,0
1668397572732,ECE 230B,A00,103648,Taur; Yuan,0,0,0,0
1668397573173,ECE 238B,A00,103649,Garay; Javier,0,0,0,0
1668397573609,ECE 240B,A00,112900,Fainman; Yeshaiahu,0,0,0,0
1668397574045,ECE 247A,A00,103650,Jokerst; Jesse Vincent,0,0,0,0
1668397574471,ECE 247B,A00,103651,Wang; Joseph,0,0,0,0
1668397574895,ECE 250,A00,103652,Siegel; Paul H.,0,0,0,0
1668397575326,ECE 251A,A00,103654,Rao; Bhaskar D.,0,0,0,0
1668397575749,ECE 257B,A00,103655,Bharadia; Dinesh,0,0,0,0
1668397576190,ECE 258A,A00,103656,Milstein; Laurence B.,0,0,0,0
1668397576616,ECE 260B,A00,103658,Kang; Mingu,0,0,0,0
1668397577039,ECE 264A,A00,103659,Galton; Ian A,0,0,0,0
1668397577463,ECE 265A,A00,103661,Gudem; Prasad S.S.,0,0,0,0
1668397577886,ECE 265D,A00,103662,Gudem; Prasad S.S.,0,0,0,0
1668397578325,ECE 268,A00,103663,Koushanfar; Farinaz,0,0,0,0
1668397578750,ECE 269,A01,103665,Pal; Piya,0,0,0,0
1668397579173,ECE 271B,A00,103666,Vasconcelos; Manuela,0,0,0,0
1668397579599,ECE 276A,A00,103667,Atanasov; Nikolay A.,0,0,0,0
1668397580041,ECE 277,A00,103668,An; Cheolhong,0,0,0,0
1668397580465,ECE 279,A00,117947,Hall; Drew A.,0,0,0,0
1668397581340,ECE 283,A00,103670,Hsueh; Tzu-Chien,0,0,0,0
1668397581763,ECE 284,A00,103671,Turakhia; Yatish Girish,0,0,0,0
1668397582188,ECE 285,A00,103672,Zheng; Yang,0,0,0,0
1668397582188,ECE 285,B00,103673,Sworder; David D.,0,0,0,0
1668397582614,ECE 287,A00,103676,Javidi; Tara,0,0,0,0
1668397583039,MATH 200B,A00,098023,Salehi Golsefidy; Alireza,12,0,15,3
1668397583478,MATH 202B,A00,098024,Rhoades; Brendon Patrick,9,0,15,6
1668397583911,MATH 203B,A00,098025,Oprea; Dragos N.,10,0,15,5
1668397584344,MATH 204B,A00,098026,Sorensen; Claus M,13,0,15,2
1668397584773,MATH 208,A00,098027,Izadi; Elham,7,0,10,3
1668397585203,MATH 209,A00,098028,Pollack; Aaron,10,0,10,0
1668397585628,MATH 211A,A00,112919,Rogalski; Daniel,9,0,10,1
1668397586051,MATH 211B,A00,112920,Seward; Brandon M.,9,0,10,1
1668397586485,MATH 218,A00,098029,Li; Bo,10,0,10,0
1668397586912,MATH 220B,A00,098030,Novak; Jonathan I,11,0,15,4
1668397587335,MATH 221A,A00,098031,Ebenfelt; Peter F,13,0,15,2
1668397587769,MATH 231B,A00,098032,Zlatos; Andrej,12,0,15,3
1668397588196,MATH 240B,A00,098033,Ni; Lei,9,0,15,6
1668397588620,MATH 243,A00,098034,Jekel; David Andrew,10,0,10,0
1668397589044,MATH 245A,A00,098035,Nie; Jiawang,0,0,15,16
1668397589469,MATH 248,A00,098036,Bejenaru; Ioan,10,0,10,0
1668397589894,MATH 250B,A00,098037,Spolaor; Luca,14,0,15,1
1668397590317,MATH 258,A00,098038,Ni; Lei,10,0,10,0
1668397590746,MATH 264B,A00,098041,Rhoades; Brendon Patrick,9,0,15,6
1668397591171,MATH 268,A00,098042,Buss; Samuel R,10,0,10,0
1668397591608,MATH 269,A00,098043,Rhoades; Brendon Patrick,10,0,10,0
1668397592032,MATH 270B,A00,098044,Li; Bo,10,0,15,5
1668397592461,MATH 272B,A00,098045,Holst; Michael J,13,0,15,2
1668397592884,MATH 273A,A00,098046,Tian; Xiaochuan,10,0,15,5
1668397593312,MATH 275,A01,098048,Tian; Xiaochuan,6,0,10,4
1668397593738,MATH 278A,A00,098049,Holst; Michael J,8,0,10,2
1668397594169,MATH 278B,A00,098050,Cloninger; Alexander,10,0,10,0
1668397594593,MATH 278C,A00,098051,Nie; Jiawang,6,0,10,4
1668397595017,MATH 280B,A00,098052,Zheng; Tianyi,8,0,15,7
1668397595444,MATH 281B,A00,098053,Bradic; Jelena,0,0,15,15
1668397595866,MATH 282B,A00,098054,Arias-Castro; Ery,0,0,15,15
1668397596293,MATH 285,A00,098055,Fitzsimmons; Patrick J,0,0,15,17
1668397596717,MATH 287B,A00,098056,Arias-Castro; Ery,2,0,15,13
1668397597153,MATH 288,A00,098057,Agarwal; Pooja,9,0,10,1
1668397597153,MATH 288,B00,098058,Zhang; Danna,8,0,10,2
1668397597153,MATH 288,C00,098059,Williams; Ruth J,9,0,10,1
1668397597584,MATH 290B,A00,098060,Roberts; Justin Deritter,13,0,15,2
1668397598011,MATH 292,A00,098061,Belmont; Eva Kinoshita,10,0,10,0
1668397598434,MATH 295,A00,098062,Suk; Andrew Hoon,48,0,50,2
1668397598855,MATH 296,A00,098063,Novak; Jonathan I,20,0,20,0
1668397599278,MATH 297,001,098064,Gamst; Anthony Collins,9997,0,9999,2
1668398101282,COGS 205,A00,101395,Chiba; Andrea,19,0,20,1
1668398101712,COGS 210B,001,101404,Greene; Deanna Jacquelyn,9998,0,9999,1
1668398101712,COGS 210B,002,101417,Xia; Haijun,9999,0,9999,0
1668398101712,COGS 210B,003,101422,Nitz; Douglas A.,9999,0,9999,0
1668398101712,COGS 210B,004,101423,Hollan; James D.,9998,0,9999,1
1668398101712,COGS 210B,005,101424,Deak; Gedeon O.,9998,0,9999,1
1668398101712,COGS 210B,006,101425,Rossano; Federico,9999,0,9999,0
1668398102137,COGS 211B,A00,101427,Coulson; Seana M,9996,0,9999,3
1668398102565,COGS 220,A00,101428,Hollan; James D.,0,0,25,25
1668398102987,COGS 229,A00,101429,Dow; Steven P,18,0,25,7
1668398103413,COGS 230,A00,101430,Klemmer; Scott R,11,0,17,6
1668398103839,COGS 234,A00,101431,Xia; Haijun,1,0,25,24
1668398104272,COGS 260,A00,101432,Kiyonaga; Anastasia,21,0,25,4
1668398104272,COGS 260,B00,101433,Kirsh; David Joel,15,0,25,10
1668398104703,CSE 202,A00,102371,Impagliazzo; Russell,0,0,0,0
1668398105134,CSE 203B,A01,102373,Cheng; Chung Kuan,0,0,0,0
1668398105570,CSE 208,A00,102374,Micciancio; Daniele,0,0,0,0
1668398105999,CSE 209A,A00,112895,Impagliazzo; Russell,0,0,15,15
1668398106424,CSE 209B,A00,108005,Bellare; Mihir,0,0,0,0
1668398106856,CSE 210,A00,113163,Coblenz; Michael J,0,0,0,0
1668398107289,CSE 219,A00,106111,Dow; Steven P,0,0,20,20
1668398107717,CSE 221,A00,102376,Voelker; Geoffrey M.,0,0,0,0
1668398108150,CSE 224,A01,102378,Porter; George M,0,0,0,0
1668398108583,CSE 229A,A00,102379,Savage; Stefan,0,0,0,0
1668398109007,CSE 229C,A00,102380,Munyaka; Imani N. S.,0,0,0,0
1668398109435,CSE 232B,A00,102382,Deutsch; Alin Bernard,0,0,0,0
1668398109865,CSE 234,A01,112904,Kumar; Arun Kumar,0,0,0,0
1668398110293,CSE 237A,A00,102383,Rosing; Tajana Simunic,0,0,0,0
1668398110721,CSE 239A,A00,102384,Deutsch; Alin Bernard,0,0,0,0
1668398111147,CSE 239B,A00,102385,Polikarpova; Nadezhda,0,0,0,0
1668398111570,CSE 240A,A00,102386,Pannuto; Patrick William,0,0,0,0
1668398111992,CSE 240B,A00,102387,Zhao; Jishen,0,0,0,0
1668398112423,CSE 241A,A00,106406,Kang; Mingu,0,0,0,0
1668398112849,CSE 249B,A00,102388,Kahng; Andrew Byun,0,0,8,8
1668398113273,CSE 251B,A01,102392,Cottrell; Garrison W,0,0,0,0
1668398113273,CSE 251B,A02,102393,Cottrell; Garrison W,0,0,0,0
1668398113700,CSE 252B,A00,102394,Ochoa; Benjamin Lawrence,0,0,0,0
1668398114128,CSE 257,A01,102396,Gao; Sicun,0,0,0,0
1668398114554,CSE 272,A00,102397,Li; Tzumao,0,0,0,0
1668398114982,CSE 274,A00,111323,Chern; Albert Ren-Haur,0,0,0,0
1668398115405,CSE 282,A00,102398,Pevzner; Pavel Arkadjevich,0,0,0,0
1668398115832,CSE 284,A00,114175,Gymrek; Melissa Ann,0,0,0,0
1668398116267,CSE 290,A00,102399,Chandraker; Manmohan Krishna,0,0,0,0
1668398116267,CSE 290,B00,102400,Vaccaro; Kristen Marie,0,0,25,25
1668398116267,CSE 290,C00,102414,Pannuto; Patrick William,0,0,25,25
1668398116267,CSE 290,D00,102427,Pevzner; Pavel Arkadjevich,0,0,0,0
1668398116267,CSE 290,E00,102429,Zhao; Jishen,0,0,0,0
1668398116267,CSE 290,F00,102436,Tullsen; Dean Michael,0,0,0,0
1668398116267,CSE 290,G00,102440,Christensen; Henrik I,0,0,20,20
1668398116692,CSE 291,A00,102443,Su; Hao,0,0,0,0
1668398116692,CSE 291,B00,102448,Polikarpova; Nadezhda,0,0,0,0
1668398116692,CSE 291,C00,102453,Vaccaro; Kristen Marie,0,0,0,0
1668398116692,CSE 291,D00,111343,Savage; Stefan,0,0,0,0
1668398116692,CSE 291,E00,116474,Claffy; Kimberly Claire,0,0,0,0
1668398116692,CSE 291,F00,116479,Pasquale; Joseph,0,0,0,0
1668398117120,CSE 293,001,119111,Bafna; Vineet,9999,0,9999,0
1668398117120,CSE 293,002,119118,Bellare; Mihir,9999,0,9999,0
1668398117120,CSE 293,003,119122,Berg-Kirkpatrick; Taylor D,9999,0,9999,0
1668398117120,CSE 293,004,119135,Christensen; Henrik I,9999,0,9999,0
1668398117120,CSE 293,005,119142,Cottrell; Garrison W,9999,0,9999,0
1668398117120,CSE 293,006,119146,Deutsch; Alin Bernard,9999,0,9999,0
1668398117120,CSE 293,007,119159,Esmaeilzadeh; Hadi,9999,0,9999,0
1668398117120,CSE 293,008,119166,Freund; Yoav,9999,0,9999,0
1668398117120,CSE 293,009,119170,Griswold; William G.,9999,0,9999,0
1668398117120,CSE 293,010,119183,Gymrek; Melissa Ann,9999,0,9999,0
1668398117120,CSE 293,011,119190,Heninger; Nadia A,9999,0,9999,0
1668398117120,CSE 293,012,119230,Impagliazzo; Russell,9999,0,9999,0
1668398117120,CSE 293,013,119232,Jhala; Ranjit,9999,0,9999,0
1668398117120,CSE 293,014,119233,Kahng; Andrew Byun,9999,0,9999,0
1668398117120,CSE 293,015,119298,Kane; Daniel Mertz,9999,0,9999,0
1668398117120,CSE 293,016,119299,Kriegman; David J,9999,0,9999,0
1668398117120,CSE 293,017,119300,Kumar; Arun Kumar,9999,0,9999,0
1668398117120,CSE 293,018,119301,Lerner; Sorin,9999,0,9999,0
1668398117120,CSE 293,019,119302,Lovett; Shachar,9999,0,9999,0
1668398117120,CSE 293,020,119303,McAuley; Julian John,9999,0,9999,0
1668398117120,CSE 293,021,119304,Micciancio; Daniele,9999,0,9999,0
1668398117120,CSE 293,022,119367,Orailoglu; Alex,9999,0,9999,0
1668398117120,CSE 293,023,119382,Paturi; Ramamohan,9999,0,9999,0
1668398117120,CSE 293,024,119404,Polikarpova; Nadezhda,9999,0,9999,0
1668398117120,CSE 293,025,119406,Politz; Joseph Gibbs,9999,0,9999,0
1668398117120,CSE 293,026,119411,Porter; George M,9999,0,9999,0
1668398117120,CSE 293,027,119414,Porter; Leonard Emerson,9999,0,9999,0
1668398117120,CSE 293,028,119416,Ramamoorthi; Ravi,9999,0,9999,0
1668398117120,CSE 293,029,119417,Sahoo; Debashis,9999,0,9999,0
1668398117120,CSE 293,030,119420,Saul; Lawrence,9999,0,9999,0
1668398117120,CSE 293,031,119421,Savage; Stefan,9999,0,9999,0
1668398117120,CSE 293,032,119425,Schulze; Jurgen P.,9999,0,9999,0
1668398117120,CSE 293,033,119426,Snoeren; Alex C.,9999,0,9999,0
1668398117120,CSE 293,034,119428,Shang; Jingbo,9999,0,9999,0
1668398117120,CSE 293,035,119430,Stefan; Deian,9999,0,9999,0
1668398117120,CSE 293,036,119431,Su; Hao,9999,0,9999,0
1668398117120,CSE 293,037,119433,Swanson; Steven James,9999,0,9999,0
1668398117120,CSE 293,038,119435,Tullsen; Dean Michael,9999,0,9999,0
1668398117120,CSE 293,039,119483,Voelker; Geoffrey M.,9999,0,9999,0
1668398117120,CSE 293,040,119537,Zhao; Jishen,9999,0,9999,0
1668398117120,CSE 293,041,119538,Zhou; Yuan-Yuan,9999,0,9999,0
1668398117120,CSE 293,042,119539,Gao; Sicun,9999,0,9999,0
1668398117120,CSE 293,043,119540,Weibel; Nadir,9999,0,9999,0
1668398117120,CSE 293,044,119541,Gupta; Rajesh K.,9999,0,9999,0
1668398117120,CSE 293,045,126410,Vaccaro; Kristen Marie,9999,0,9999,0
1668398117120,CSE 293,046,126411,Klemke; Richard,9999,0,9999,0
1668398117542,CSE 294,A00,102459,Voelker; Geoffrey M.,0,0,0,0
1668398117542,CSE 294,B00,111322,Orailoglu; Alex,0,0,0,0
1668398117965,DSE 201,A00,096914,Deutsch; Alin Bernard,30,0,30,0
1668398118391,DSE 210,A00,096915,Dasgupta; Sanjoy,30,0,30,0
1668398118826,DSE 260A,A00,096916,Altintas De Callaf; Ilkay,30,0,30,0
1668398119262,ECE 200,001,103586,Antipa; Nicholas A,9999,0,9999,0
1668398119262,ECE 200,002,103587,Atanasov; Nikolay A.,9999,0,9999,0
1668398119262,ECE 200,003,103588,Bharadia; Dinesh,9999,0,9999,0
1668398119262,ECE 200,004,103589,Cheng; Chung Kuan,9999,0,9999,0
1668398119262,ECE 200,005,103590,Cosman; Pamela C.,9999,0,9999,0
1668398119262,ECE 200,006,103591,Dayeh; Shadi Ahmad,9999,0,9999,0
1668398119262,ECE 200,007,103592,Fainman; Yeshaiahu,9999,0,9999,0
1668398119262,ECE 200,008,103593,Ford; Joseph Earl,9999,0,9999,0
1668398119262,ECE 200,009,103594,Franceschetti; Massimo,9999,0,9999,0
1668398119262,ECE 200,010,103595,Fullerton; Eric E,9999,0,9999,0
1668398119262,ECE 200,011,103596,Galton; Ian A,9999,0,9999,0
1668398119262,ECE 200,012,103597,Gilja; Vikash,9999,0,9999,0
1668398119262,ECE 200,013,103598,Hall; Drew A.,9999,0,9999,0
1668398119262,ECE 200,014,103599,Hsueh; Tzu-Chien,9999,0,9999,0
1668398119262,ECE 200,015,103600,Javidi; Tara,9999,0,9999,0
1668398119262,ECE 200,016,103601,Kahng; Andrew Byun,9999,0,9999,0
1668398119262,ECE 200,017,103602,Kim; Young-Han,9999,0,9999,0
1668398119262,ECE 200,018,103603,Koushanfar; Farinaz,9999,0,9999,0
1668398119262,ECE 200,019,103604,Kuzum; Duygu,9999,0,9999,0
1668398119262,ECE 200,020,103605,Le; Hanh-Phuc,9999,0,9999,0
1668398119262,ECE 200,021,103606,Lin; Bill,9999,0,9999,0
1668398119262,ECE 200,022,103607,Liu; Zhaowei,9998,0,9999,1
1668398119262,ECE 200,023,103608,Lo; Yu-Hwa,9999,0,9999,0
1668398119262,ECE 200,024,103609,Lomakin; Vitaliy,9999,0,9999,0
1668398119262,ECE 200,025,103610,Mercier; Patrick Philip,9999,0,9999,0
1668398119262,ECE 200,026,103611,Meyer; Florian,9999,0,9999,0
1668398119262,ECE 200,027,103612,Milstein; Laurence B.,9999,0,9999,0
1668398119262,ECE 200,028,103613,Mir Arabbaygi; Siavash,9999,0,9999,0
1668398119262,ECE 200,029,103614,Mookherjea; Shayan,9999,0,9999,0
1668398119262,ECE 200,030,103615,Morris; Karcher William,9999,0,9999,0
1668398119262,ECE 200,031,103616,Ng; Tse Nga,9999,0,9999,0
1668398119262,ECE 200,032,103617,Nguyen; Truong Quang,9999,0,9999,0
1668398119262,ECE 200,033,103618,Nomura; Kenji,9999,0,9999,0
1668398119262,ECE 200,034,103619,Orlitsky; Alon,9999,0,9999,0
1668398119262,ECE 200,035,103620,Pal; Piya,9999,0,9999,0
1668398119262,ECE 200,036,103621,Papen; George C.,9999,0,9999,0
1668398119262,ECE 200,037,103622,Radic; Stojan,9999,0,9999,0
1668398119262,ECE 200,038,103623,Rao; Bhaskar D.,9999,0,9999,0
1668398119262,ECE 200,039,103624,Rao; Ramesh R,9999,0,9999,0
1668398119262,ECE 200,040,103625,Rebeiz; Gabriel,9999,0,9999,0
1668398119262,ECE 200,041,103626,Sanford; John R,9999,0,9999,0
1668398119262,ECE 200,042,103627,Siegel; Paul H.,9999,0,9999,0
1668398119262,ECE 200,043,103628,Sievenpiper; Daniel F.,9999,0,9999,0
1668398119262,ECE 200,044,103629,Sworder; David D.,9999,0,9999,0
1668398119262,ECE 200,045,103630,Taur; Yuan,9999,0,9999,0
1668398119262,ECE 200,046,103631,Touri; Behrouz,9999,0,9999,0
1668398119262,ECE 200,047,103632,Trivedi; Mohan M.,9999,0,9999,0
1668398119262,ECE 200,048,103633,Vasconcelos; Nuno,9999,0,9999,0
1668398119262,ECE 200,049,103634,Wang; Xiaolong,9999,0,9999,0
1668398119262,ECE 200,050,103635,Xie; Pengtao,9999,0,9999,0
1668398119262,ECE 200,051,103636,Yip; Michael,9999,0,9999,0
1668398119262,ECE 200,052,103637,Zeger; Kenneth A.,999,0,999,0
1668398119262,ECE 200,053,103638,Zhang; Xinyu,9999,0,9999,0
1668398119262,ECE 200,054,103639,Turakhia; Yatish Girish,9999,0,9999,0
1668398119262,ECE 200,055,103640,Kang; Mingu,9999,0,9999,0
1668398119262,ECE 200,056,103641,Shi; Yuanyuan,9999,0,9999,0
1668398119262,ECE 200,057,103642,Wang; Edward Jay,9999,0,9999,0
1668398119262,ECE 200,058,103643,Zheng; Yang,9999,0,9999,0
1668398119689,ECE 202,A00,103644,Kuzum; Duygu,0,0,0,0
1668398120121,ECE 212BN,A00,103646,Ng; Tse Nga,0,0,0,0
1668398120550,ECE 221,A00,111493,Staff,0,0,0,0
1668398120980,ECE 222B,A00,103647,Lomakin; Vitaliy,0,0,0,0
1668398121404,ECE 230B,A00,103648,Taur; Yuan,0,0,0,0
1668398121835,ECE 238B,A00,103649,Garay; Javier,0,0,0,0
1668398122258,ECE 240B,A00,112900,Fainman; Yeshaiahu,0,0,0,0
1668398122683,ECE 247A,A00,103650,Jokerst; Jesse Vincent,0,0,0,0
1668398123105,ECE 247B,A00,103651,Wang; Joseph,0,0,0,0
1668398123530,ECE 250,A00,103652,Siegel; Paul H.,0,0,0,0
1668398123957,ECE 251A,A00,103654,Rao; Bhaskar D.,0,0,0,0
1668398124382,ECE 257B,A00,103655,Bharadia; Dinesh,0,0,0,0
1668398124807,ECE 258A,A00,103656,Milstein; Laurence B.,0,0,0,0
1668398125234,ECE 260B,A00,103658,Kang; Mingu,0,0,0,0
1668398125659,ECE 264A,A00,103659,Galton; Ian A,0,0,0,0
1668398126083,ECE 265A,A00,103661,Gudem; Prasad S.S.,0,0,0,0
1668398126509,ECE 265D,A00,103662,Gudem; Prasad S.S.,0,0,0,0
1668398126934,ECE 268,A00,103663,Koushanfar; Farinaz,0,0,0,0
1668398127358,ECE 269,A01,103665,Pal; Piya,0,0,0,0
1668398127782,ECE 271B,A00,103666,Vasconcelos; Manuela,0,0,0,0
1668398128206,ECE 276A,A00,103667,Atanasov; Nikolay A.,0,0,0,0
1668398128633,ECE 277,A00,103668,An; Cheolhong,0,0,0,0
1668398129060,ECE 279,A00,117947,Hall; Drew A.,0,0,0,0
1668398129906,ECE 283,A00,103670,Hsueh; Tzu-Chien,0,0,0,0
1668398130330,ECE 284,A00,103671,Turakhia; Yatish Girish,0,0,0,0
1668398130758,ECE 285,A00,103672,Zheng; Yang,0,0,0,0
1668398130758,ECE 285,B00,103673,Sworder; David D.,0,0,0,0
1668398131185,ECE 287,A00,103676,Javidi; Tara,0,0,0,0
1668398131617,MATH 200B,A00,098023,Salehi Golsefidy; Alireza,12,0,15,3
1668398132042,MATH 202B,A00,098024,Rhoades; Brendon Patrick,9,0,15,6
1668398132468,MATH 203B,A00,098025,Oprea; Dragos N.,10,0,15,5
1668398132891,MATH 204B,A00,098026,Sorensen; Claus M,13,0,15,2
1668398133340,MATH 208,A00,098027,Izadi; Elham,7,0,10,3
1668398133765,MATH 209,A00,098028,Pollack; Aaron,10,0,10,0
1668398134196,MATH 211A,A00,112919,Rogalski; Daniel,9,0,10,1
1668398134743,MATH 211B,A00,112920,Seward; Brandon M.,9,0,10,1
1668398135177,MATH 218,A00,098029,Li; Bo,10,0,10,0
1668398135610,MATH 220B,A00,098030,Novak; Jonathan I,11,0,15,4
1668398136036,MATH 221A,A00,098031,Ebenfelt; Peter F,13,0,15,2
1668398136468,MATH 231B,A00,098032,Zlatos; Andrej,12,0,15,3
1668398136894,MATH 240B,A00,098033,Ni; Lei,9,0,15,6
1668398137320,MATH 243,A00,098034,Jekel; David Andrew,10,0,10,0
1668398137745,MATH 245A,A00,098035,Nie; Jiawang,0,0,15,16
1668398138177,MATH 248,A00,098036,Bejenaru; Ioan,10,0,10,0
1668398138602,MATH 250B,A00,098037,Spolaor; Luca,14,0,15,1
1668398139027,MATH 258,A00,098038,Ni; Lei,10,0,10,0
1668398139450,MATH 264B,A00,098041,Rhoades; Brendon Patrick,9,0,15,6
1668398139885,MATH 268,A00,098042,Buss; Samuel R,10,0,10,0
1668398140313,MATH 269,A00,098043,Rhoades; Brendon Patrick,10,0,10,0
1668398140738,MATH 270B,A00,098044,Li; Bo,10,0,15,5
1668398141163,MATH 272B,A00,098045,Holst; Michael J,13,0,15,2
1668398141601,MATH 273A,A00,098046,Tian; Xiaochuan,10,0,15,5
1668398142032,MATH 275,A01,098048,Tian; Xiaochuan,6,0,10,4
1668398142466,MATH 278A,A00,098049,Holst; Michael J,8,0,10,2
1668398142891,MATH 278B,A00,098050,Cloninger; Alexander,10,0,10,0
1668398143321,MATH 278C,A00,098051,Nie; Jiawang,6,0,10,4
1668398143744,MATH 280B,A00,098052,Zheng; Tianyi,8,0,15,7
1668398144168,MATH 281B,A00,098053,Bradic; Jelena,0,0,15,15
1668398144594,MATH 282B,A00,098054,Arias-Castro; Ery,0,0,15,15
1668398145028,MATH 285,A00,098055,Fitzsimmons; Patrick J,0,0,15,17
1668398145453,MATH 287B,A00,098056,Arias-Castro; Ery,2,0,15,13
1668398145876,MATH 288,A00,098057,Agarwal; Pooja,9,0,10,1
1668398145876,MATH 288,B00,098058,Zhang; Danna,8,0,10,2
1668398145876,MATH 288,C00,098059,Williams; Ruth J,9,0,10,1
1668398146305,MATH 290B,A00,098060,Roberts; Justin Deritter,13,0,15,2
1668398146727,MATH 292,A00,098061,Belmont; Eva Kinoshita,10,0,10,0
1668398147158,MATH 295,A00,098062,Suk; Andrew Hoon,48,0,50,2
1668398147582,MATH 296,A00,098063,Novak; Jonathan I,20,0,20,0
1668398148010,MATH 297,001,098064,Gamst; Anthony Collins,9997,0,9999,2
1668398648972,COGS 205,A00,101395,Chiba; Andrea,19,0,20,1
1668398649396,COGS 210B,001,101404,Greene; Deanna Jacquelyn,9998,0,9999,1
1668398649396,COGS 210B,002,101417,Xia; Haijun,9999,0,9999,0
1668398649396,COGS 210B,003,101422,Nitz; Douglas A.,9999,0,9999,0
1668398649396,COGS 210B,004,101423,Hollan; James D.,9998,0,9999,1
1668398649396,COGS 210B,005,101424,Deak; Gedeon O.,9998,0,9999,1
1668398649396,COGS 210B,006,101425,Rossano; Federico,9999,0,9999,0
1668398649822,COGS 211B,A00,101427,Coulson; Seana M,9996,0,9999,3
1668398650247,COGS 220,A00,101428,Hollan; James D.,0,0,25,25
1668398650672,COGS 229,A00,101429,Dow; Steven P,18,0,25,7
1668398651095,COGS 230,A00,101430,Klemmer; Scott R,11,0,17,6
1668398651519,COGS 234,A00,101431,Xia; Haijun,1,0,25,24
1668398651944,COGS 260,A00,101432,Kiyonaga; Anastasia,21,0,25,4
1668398651944,COGS 260,B00,101433,Kirsh; David Joel,15,0,25,10
1668398652368,CSE 202,A00,102371,Impagliazzo; Russell,0,0,0,0
1668398652793,CSE 203B,A01,102373,Cheng; Chung Kuan,0,0,0,0
1668398653219,CSE 208,A00,102374,Micciancio; Daniele,0,0,0,0
1668398653644,CSE 209A,A00,112895,Impagliazzo; Russell,0,0,15,15
1668398654072,CSE 209B,A00,108005,Bellare; Mihir,0,0,0,0
1668398654499,CSE 210,A00,113163,Coblenz; Michael J,0,0,0,0
1668398654924,CSE 219,A00,106111,Dow; Steven P,0,0,20,20
1668398655357,CSE 221,A00,102376,Voelker; Geoffrey M.,0,0,0,0
1668398655887,CSE 224,A01,102378,Porter; George M,0,0,0,0
1668398656313,CSE 229A,A00,102379,Savage; Stefan,0,0,0,0
1668398656736,CSE 229C,A00,102380,Munyaka; Imani N. S.,0,0,0,0
1668398657160,CSE 232B,A00,102382,Deutsch; Alin Bernard,0,0,0,0
1668398657583,CSE 234,A01,112904,Kumar; Arun Kumar,0,0,0,0
1668398658009,CSE 237A,A00,102383,Rosing; Tajana Simunic,0,0,0,0
1668398658435,CSE 239A,A00,102384,Deutsch; Alin Bernard,0,0,0,0
1668398658861,CSE 239B,A00,102385,Polikarpova; Nadezhda,0,0,0,0
1668398659286,CSE 240A,A00,102386,Pannuto; Patrick William,0,0,0,0
1668398659713,CSE 240B,A00,102387,Zhao; Jishen,0,0,0,0
1668398660137,CSE 241A,A00,106406,Kang; Mingu,0,0,0,0
1668398660561,CSE 249B,A00,102388,Kahng; Andrew Byun,0,0,8,8
1668398660992,CSE 251B,A01,102392,Cottrell; Garrison W,0,0,0,0
1668398660992,CSE 251B,A02,102393,Cottrell; Garrison W,0,0,0,0
1668398661415,CSE 252B,A00,102394,Ochoa; Benjamin Lawrence,0,0,0,0
1668398661851,CSE 257,A01,102396,Gao; Sicun,0,0,0,0
1668398662275,CSE 272,A00,102397,Li; Tzumao,0,0,0,0
1668398662697,CSE 274,A00,111323,Chern; Albert Ren-Haur,0,0,0,0
1668398663123,CSE 282,A00,102398,Pevzner; Pavel Arkadjevich,0,0,0,0
1668398663546,CSE 284,A00,114175,Gymrek; Melissa Ann,0,0,0,0
1668398663970,CSE 290,A00,102399,Chandraker; Manmohan Krishna,0,0,0,0
1668398663970,CSE 290,B00,102400,Vaccaro; Kristen Marie,0,0,25,25
1668398663970,CSE 290,C00,102414,Pannuto; Patrick William,0,0,25,25
1668398663970,CSE 290,D00,102427,Pevzner; Pavel Arkadjevich,0,0,0,0
1668398663970,CSE 290,E00,102429,Zhao; Jishen,0,0,0,0
1668398663970,CSE 290,F00,102436,Tullsen; Dean Michael,0,0,0,0
1668398663970,CSE 290,G00,102440,Christensen; Henrik I,0,0,20,20
1668398664394,CSE 291,A00,102443,Su; Hao,0,0,0,0
1668398664394,CSE 291,B00,102448,Polikarpova; Nadezhda,0,0,0,0
1668398664394,CSE 291,C00,102453,Vaccaro; Kristen Marie,0,0,0,0
1668398664394,CSE 291,D00,111343,Savage; Stefan,0,0,0,0
1668398664394,CSE 291,E00,116474,Claffy; Kimberly Claire,0,0,0,0
1668398664394,CSE 291,F00,116479,Pasquale; Joseph,0,0,0,0
1668398664821,CSE 293,001,119111,Bafna; Vineet,9999,0,9999,0
1668398664821,CSE 293,002,119118,Bellare; Mihir,9999,0,9999,0
1668398664821,CSE 293,003,119122,Berg-Kirkpatrick; Taylor D,9999,0,9999,0
1668398664821,CSE 293,004,119135,Christensen; Henrik I,9999,0,9999,0
1668398664821,CSE 293,005,119142,Cottrell; Garrison W,9999,0,9999,0
1668398664821,CSE 293,006,119146,Deutsch; Alin Bernard,9999,0,9999,0
1668398664821,CSE 293,007,119159,Esmaeilzadeh; Hadi,9999,0,9999,0
1668398664821,CSE 293,008,119166,Freund; Yoav,9999,0,9999,0
1668398664821,CSE 293,009,119170,Griswold; William G.,9999,0,9999,0
1668398664821,CSE 293,010,119183,Gymrek; Melissa Ann,9999,0,9999,0
1668398664821,CSE 293,011,119190,Heninger; Nadia A,9999,0,9999,0
1668398664821,CSE 293,012,119230,Impagliazzo; Russell,9999,0,9999,0
1668398664821,CSE 293,013,119232,Jhala; Ranjit,9999,0,9999,0
1668398664821,CSE 293,014,119233,Kahng; Andrew Byun,9999,0,9999,0
1668398664821,CSE 293,015,119298,Kane; Daniel Mertz,9999,0,9999,0
1668398664821,CSE 293,016,119299,Kriegman; David J,9999,0,9999,0
1668398664821,CSE 293,017,119300,Kumar; Arun Kumar,9999,0,9999,0
1668398664821,CSE 293,018,119301,Lerner; Sorin,9999,0,9999,0
1668398664821,CSE 293,019,119302,Lovett; Shachar,9999,0,9999,0
1668398664821,CSE 293,020,119303,McAuley; Julian John,9999,0,9999,0
1668398664821,CSE 293,021,119304,Micciancio; Daniele,9999,0,9999,0
1668398664821,CSE 293,022,119367,Orailoglu; Alex,9999,0,9999,0
1668398664821,CSE 293,023,119382,Paturi; Ramamohan,9999,0,9999,0
1668398664821,CSE 293,024,119404,Polikarpova; Nadezhda,9999,0,9999,0
1668398664821,CSE 293,025,119406,Politz; Joseph Gibbs,9999,0,9999,0
1668398664821,CSE 293,026,119411,Porter; George M,9999,0,9999,0
1668398664821,CSE 293,027,119414,Porter; Leonard Emerson,9999,0,9999,0
1668398664821,CSE 293,028,119416,Ramamoorthi; Ravi,9999,0,9999,0
1668398664821,CSE 293,029,119417,Sahoo; Debashis,9999,0,9999,0
1668398664821,CSE 293,030,119420,Saul; Lawrence,9999,0,9999,0
1668398664821,CSE 293,031,119421,Savage; Stefan,9999,0,9999,0
1668398664821,CSE 293,032,119425,Schulze; Jurgen P.,9999,0,9999,0
1668398664821,CSE 293,033,119426,Snoeren; Alex C.,9999,0,9999,0
1668398664821,CSE 293,034,119428,Shang; Jingbo,9999,0,9999,0
1668398664821,CSE 293,035,119430,Stefan; Deian,9999,0,9999,0
1668398664821,CSE 293,036,119431,Su; Hao,9999,0,9999,0
1668398664821,CSE 293,037,119433,Swanson; Steven James,9999,0,9999,0
1668398664821,CSE 293,038,119435,Tullsen; Dean Michael,9999,0,9999,0
1668398664821,CSE 293,039,119483,Voelker; Geoffrey M.,9999,0,9999,0
1668398664821,CSE 293,040,119537,Zhao; Jishen,9999,0,9999,0
1668398664821,CSE 293,041,119538,Zhou; Yuan-Yuan,9999,0,9999,0
1668398664821,CSE 293,042,119539,Gao; Sicun,9999,0,9999,0
1668398664821,CSE 293,043,119540,Weibel; Nadir,9999,0,9999,0
1668398664821,CSE 293,044,119541,Gupta; Rajesh K.,9999,0,9999,0
1668398664821,CSE 293,045,126410,Vaccaro; Kristen Marie,9999,0,9999,0
1668398664821,CSE 293,046,126411,Klemke; Richard,9999,0,9999,0
1668398665249,CSE 294,A00,102459,Voelker; Geoffrey M.,0,0,0,0
1668398665249,CSE 294,B00,111322,Orailoglu; Alex,0,0,0,0
1668398665677,DSE 201,A00,096914,Deutsch; Alin Bernard,30,0,30,0
1668398666101,DSE 210,A00,096915,Dasgupta; Sanjoy,30,0,30,0
1668398666531,DSE 260A,A00,096916,Altintas De Callaf; Ilkay,30,0,30,0
1668398666959,ECE 200,001,103586,Antipa; Nicholas A,9999,0,9999,0
1668398666959,ECE 200,002,103587,Atanasov; Nikolay A.,9999,0,9999,0
1668398666959,ECE 200,003,103588,Bharadia; Dinesh,9999,0,9999,0
1668398666959,ECE 200,004,103589,Cheng; Chung Kuan,9999,0,9999,0
1668398666959,ECE 200,005,103590,Cosman; Pamela C.,9999,0,9999,0
1668398666959,ECE 200,006,103591,Dayeh; Shadi Ahmad,9999,0,9999,0
1668398666959,ECE 200,007,103592,Fainman; Yeshaiahu,9999,0,9999,0
1668398666959,ECE 200,008,103593,Ford; Joseph Earl,9999,0,9999,0
1668398666959,ECE 200,009,103594,Franceschetti; Massimo,9999,0,9999,0
1668398666959,ECE 200,010,103595,Fullerton; Eric E,9999,0,9999,0
1668398666959,ECE 200,011,103596,Galton; Ian A,9999,0,9999,0
1668398666959,ECE 200,012,103597,Gilja; Vikash,9999,0,9999,0
1668398666959,ECE 200,013,103598,Hall; Drew A.,9999,0,9999,0
1668398666959,ECE 200,014,103599,Hsueh; Tzu-Chien,9999,0,9999,0
1668398666959,ECE 200,015,103600,Javidi; Tara,9999,0,9999,0
1668398666959,ECE 200,016,103601,Kahng; Andrew Byun,9999,0,9999,0
1668398666959,ECE 200,017,103602,Kim; Young-Han,9999,0,9999,0
1668398666959,ECE 200,018,103603,Koushanfar; Farinaz,9999,0,9999,0
1668398666959,ECE 200,019,103604,Kuzum; Duygu,9999,0,9999,0
1668398666959,ECE 200,020,103605,Le; Hanh-Phuc,9999,0,9999,0
1668398666959,ECE 200,021,103606,Lin; Bill,9999,0,9999,0
1668398666959,ECE 200,022,103607,Liu; Zhaowei,9998,0,9999,1
1668398666959,ECE 200,023,103608,Lo; Yu-Hwa,9999,0,9999,0
1668398666959,ECE 200,024,103609,Lomakin; Vitaliy,9999,0,9999,0
1668398666959,ECE 200,025,103610,Mercier; Patrick Philip,9999,0,9999,0
1668398666959,ECE 200,026,103611,Meyer; Florian,9999,0,9999,0
1668398666959,ECE 200,027,103612,Milstein; Laurence B.,9999,0,9999,0
1668398666959,ECE 200,028,103613,Mir Arabbaygi; Siavash,9999,0,9999,0
1668398666959,ECE 200,029,103614,Mookherjea; Shayan,9999,0,9999,0
1668398666959,ECE 200,030,103615,Morris; Karcher William,9999,0,9999,0
1668398666959,ECE 200,031,103616,Ng; Tse Nga,9999,0,9999,0
1668398666959,ECE 200,032,103617,Nguyen; Truong Quang,9999,0,9999,0
1668398666959,ECE 200,033,103618,Nomura; Kenji,9999,0,9999,0
1668398666959,ECE 200,034,103619,Orlitsky; Alon,9999,0,9999,0
1668398666959,ECE 200,035,103620,Pal; Piya,9999,0,9999,0
1668398666959,ECE 200,036,103621,Papen; George C.,9999,0,9999,0
1668398666959,ECE 200,037,103622,Radic; Stojan,9999,0,9999,0
1668398666959,ECE 200,038,103623,Rao; Bhaskar D.,9999,0,9999,0
1668398666959,ECE 200,039,103624,Rao; Ramesh R,9999,0,9999,0
1668398666959,ECE 200,040,103625,Rebeiz; Gabriel,9999,0,9999,0
1668398666959,ECE 200,041,103626,Sanford; John R,9999,0,9999,0
1668398666959,ECE 200,042,103627,Siegel; Paul H.,9999,0,9999,0
1668398666959,ECE 200,043,103628,Sievenpiper; Daniel F.,9999,0,9999,0
1668398666959,ECE 200,044,103629,Sworder; David D.,9999,0,9999,0
1668398666959,ECE 200,045,103630,Taur; Yuan,9999,0,9999,0
1668398666959,ECE 200,046,103631,Touri; Behrouz,9999,0,9999,0
1668398666959,ECE 200,047,103632,Trivedi; Mohan M.,9999,0,9999,0
1668398666959,ECE 200,048,103633,Vasconcelos; Nuno,9999,0,9999,0
1668398666959,ECE 200,049,103634,Wang; Xiaolong,9999,0,9999,0
1668398666959,ECE 200,050,103635,Xie; Pengtao,9999,0,9999,0
1668398666959,ECE 200,051,103636,Yip; Michael,9999,0,9999,0
1668398666959,ECE 200,052,103637,Zeger; Kenneth A.,999,0,999,0
1668398666959,ECE 200,053,103638,Zhang; Xinyu,9999,0,9999,0
1668398666959,ECE 200,054,103639,Turakhia; Yatish Girish,9999,0,9999,0
1668398666959,ECE 200,055,103640,Kang; Mingu,9999,0,9999,0
1668398666959,ECE 200,056,103641,Shi; Yuanyuan,9999,0,9999,0
1668398666959,ECE 200,057,103642,Wang; Edward Jay,9999,0,9999,0
1668398666959,ECE 200,058,103643,Zheng; Yang,9999,0,9999,0
1668398667385,ECE 202,A00,103644,Kuzum; Duygu,0,0,0,0
1668398667810,ECE 212BN,A00,103646,Ng; Tse Nga,0,0,0,0
1668398668233,ECE 221,A00,111493,Staff,0,0,0,0
1668398668659,ECE 222B,A00,103647,Lomakin; Vitaliy,0,0,0,0
1668398669085,ECE 230B,A00,103648,Taur; Yuan,0,0,0,0
1668398669513,ECE 238B,A00,103649,Garay; Javier,0,0,0,0
1668398669935,ECE 240B,A00,112900,Fainman; Yeshaiahu,0,0,0,0
1668398670358,ECE 247A,A00,103650,Jokerst; Jesse Vincent,0,0,0,0
1668398670781,ECE 247B,A00,103651,Wang; Joseph,0,0,0,0
1668398671212,ECE 250,A00,103652,Siegel; Paul H.,0,0,0,0
1668398671649,ECE 251A,A00,103654,Rao; Bhaskar D.,0,0,0,0
1668398672077,ECE 257B,A00,103655,Bharadia; Dinesh,0,0,0,0
1668398672506,ECE 258A,A00,103656,Milstein; Laurence B.,0,0,0,0
1668398672928,ECE 260B,A00,103658,Kang; Mingu,0,0,0,0
1668398673358,ECE 264A,A00,103659,Galton; Ian A,0,0,0,0
1668398673786,ECE 265A,A00,103661,Gudem; Prasad S.S.,0,0,0,0
1668398674218,ECE 265D,A00,103662,Gudem; Prasad S.S.,0,0,0,0
1668398674642,ECE 268,A00,103663,Koushanfar; Farinaz,0,0,0,0
1668398675073,ECE 269,A01,103665,Pal; Piya,0,0,0,0
1668398675497,ECE 271B,A00,103666,Vasconcelos; Manuela,0,0,0,0
1668398675922,ECE 276A,A00,103667,Atanasov; Nikolay A.,0,0,0,0
1668398676349,ECE 277,A00,103668,An; Cheolhong,0,0,0,0
1668398676772,ECE 279,A00,117947,Hall; Drew A.,0,0,0,0
1668398677628,ECE 283,A00,103670,Hsueh; Tzu-Chien,0,0,0,0
1668398678057,ECE 284,A00,103671,Turakhia; Yatish Girish,0,0,0,0
1668398678479,ECE 285,A00,103672,Zheng; Yang,0,0,0,0
1668398678479,ECE 285,B00,103673,Sworder; David D.,0,0,0,0
1668398678901,ECE 287,A00,103676,Javidi; Tara,0,0,0,0
1668398679328,MATH 200B,A00,098023,Salehi Golsefidy; Alireza,12,0,15,3
1668398679760,MATH 202B,A00,098024,Rhoades; Brendon Patrick,9,0,15,6
1668398680193,MATH 203B,A00,098025,Oprea; Dragos N.,10,0,15,5
1668398680616,MATH 204B,A00,098026,Sorensen; Claus M,13,0,15,2
1668398681040,MATH 208,A00,098027,Izadi; Elham,7,0,10,3
1668398681463,MATH 209,A00,098028,Pollack; Aaron,10,0,10,0
1668398681898,MATH 211A,A00,112919,Rogalski; Daniel,9,0,10,1
1668398682322,MATH 211B,A00,112920,Seward; Brandon M.,9,0,10,1
1668398682747,MATH 218,A00,098029,Li; Bo,10,0,10,0
1668398683174,MATH 220B,A00,098030,Novak; Jonathan I,11,0,15,4
1668398683611,MATH 221A,A00,098031,Ebenfelt; Peter F,13,0,15,2
1668398684054,MATH 231B,A00,098032,Zlatos; Andrej,12,0,15,3
1668398684479,MATH 240B,A00,098033,Ni; Lei,9,0,15,6
1668398684917,MATH 243,A00,098034,Jekel; David Andrew,10,0,10,0
1668398685341,MATH 245A,A00,098035,Nie; Jiawang,0,0,15,16
1668398685765,MATH 248,A00,098036,Bejenaru; Ioan,10,0,10,0
1668398686193,MATH 250B,A00,098037,Spolaor; Luca,14,0,15,1
1668398686617,MATH 258,A00,098038,Ni; Lei,10,0,10,0
1668398687041,MATH 264B,A00,098041,Rhoades; Brendon Patrick,9,0,15,6
1668398687464,MATH 268,A00,098042,Buss; Samuel R,10,0,10,0
1668398687887,MATH 269,A00,098043,Rhoades; Brendon Patrick,10,0,10,0
1668398688322,MATH 270B,A00,098044,Li; Bo,10,0,15,5
1668398688762,MATH 272B,A00,098045,Holst; Michael J,13,0,15,2
1668398689185,MATH 273A,A00,098046,Tian; Xiaochuan,10,0,15,5
1668398689608,MATH 275,A01,098048,Tian; Xiaochuan,6,0,10,4
1668398690032,MATH 278A,A00,098049,Holst; Michael J,8,0,10,2
1668398690455,MATH 278B,A00,098050,Cloninger; Alexander,10,0,10,0
1668398690886,MATH 278C,A00,098051,Nie; Jiawang,6,0,10,4
1668398691309,MATH 280B,A00,098052,Zheng; Tianyi,8,0,15,7
1668398691733,MATH 281B,A00,098053,Bradic; Jelena,0,0,15,15
1668398692160,MATH 282B,A00,098054,Arias-Castro; Ery,0,0,15,15
1668398692584,MATH 285,A00,098055,Fitzsimmons; Patrick J,0,0,15,17
1668398693010,MATH 287B,A00,098056,Arias-Castro; Ery,2,0,15,13
1668398693433,MATH 288,A00,098057,Agarwal; Pooja,9,0,10,1
1668398693433,MATH 288,B00,098058,Zhang; Danna,8,0,10,2
1668398693433,MATH 288,C00,098059,Williams; Ruth J,9,0,10,1
1668398693856,MATH 290B,A00,098060,Roberts; Justin Deritter,13,0,15,2
1668398694289,MATH 292,A00,098061,Belmont; Eva Kinoshita,10,0,10,0
1668398694717,MATH 295,A00,098062,Suk; Andrew Hoon,48,0,50,2
1668398695157,MATH 296,A00,098063,Novak; Jonathan I,20,0,20,0
1668398695583,MATH 297,001,098064,Gamst; Anthony Collins,9997,0,9999,2
1668399197395,COGS 205,A00,101395,Chiba; Andrea,19,0,20,1
1668399197818,COGS 210B,001,101404,Greene; Deanna Jacquelyn,9998,0,9999,1
1668399197818,COGS 210B,002,101417,Xia; Haijun,9999,0,9999,0
1668399197818,COGS 210B,003,101422,Nitz; Douglas A.,9999,0,9999,0
1668399197818,COGS 210B,004,101423,Hollan; James D.,9998,0,9999,1
1668399197818,COGS 210B,005,101424,Deak; Gedeon O.,9998,0,9999,1
1668399197818,COGS 210B,006,101425,Rossano; Federico,9999,0,9999,0
1668399198246,COGS 211B,A00,101427,Coulson; Seana M,9996,0,9999,3
1668399198677,COGS 220,A00,101428,Hollan; James D.,0,0,25,25
1668399199103,COGS 229,A00,101429,Dow; Steven P,18,0,25,7
1668399199525,COGS 230,A00,101430,Klemmer; Scott R,11,0,17,6
1668399199953,COGS 234,A00,101431,Xia; Haijun,1,0,25,24
1668399200387,COGS 260,A00,101432,Kiyonaga; Anastasia,21,0,25,4
1668399200387,COGS 260,B00,101433,Kirsh; David Joel,15,0,25,10
1668399200825,CSE 202,A00,102371,Impagliazzo; Russell,0,0,0,0
1668399201265,CSE 203B,A01,102373,Cheng; Chung Kuan,0,0,0,0
1668399201688,CSE 208,A00,102374,Micciancio; Daniele,0,0,0,0
1668399202112,CSE 209A,A00,112895,Impagliazzo; Russell,0,0,15,15
1668399202549,CSE 209B,A00,108005,Bellare; Mihir,0,0,0,0
1668399202972,CSE 210,A00,113163,Coblenz; Michael J,0,0,0,0
1668399203397,CSE 219,A00,106111,Dow; Steven P,0,0,20,20
1668399203829,CSE 221,A00,102376,Voelker; Geoffrey M.,0,0,0,0
1668399204257,CSE 224,A01,102378,Porter; George M,0,0,0,0
1668399204680,CSE 229A,A00,102379,Savage; Stefan,0,0,0,0
1668399205104,CSE 229C,A00,102380,Munyaka; Imani N. S.,0,0,0,0
1668399205531,CSE 232B,A00,102382,Deutsch; Alin Bernard,0,0,0,0
1668399205957,CSE 234,A01,112904,Kumar; Arun Kumar,0,0,0,0
1668399206382,CSE 237A,A00,102383,Rosing; Tajana Simunic,0,0,0,0
1668399206806,CSE 239A,A00,102384,Deutsch; Alin Bernard,0,0,0,0
1668399207230,CSE 239B,A00,102385,Polikarpova; Nadezhda,0,0,0,0
1668399207653,CSE 240A,A00,102386,Pannuto; Patrick William,0,0,0,0
1668399208078,CSE 240B,A00,102387,Zhao; Jishen,0,0,0,0
1668399208501,CSE 241A,A00,106406,Kang; Mingu,0,0,0,0
1668399208933,CSE 249B,A00,102388,Kahng; Andrew Byun,0,0,8,8
1668399209363,CSE 251B,A01,102392,Cottrell; Garrison W,0,0,0,0
1668399209363,CSE 251B,A02,102393,Cottrell; Garrison W,0,0,0,0
1668399209796,CSE 252B,A00,102394,Ochoa; Benjamin Lawrence,0,0,0,0
1668399210225,CSE 257,A01,102396,Gao; Sicun,0,0,0,0
1668399210648,CSE 272,A00,102397,Li; Tzumao,0,0,0,0
1668399211070,CSE 274,A00,111323,Chern; Albert Ren-Haur,0,0,0,0
1668399211508,CSE 282,A00,102398,Pevzner; Pavel Arkadjevich,0,0,0,0
1668399211933,CSE 284,A00,114175,Gymrek; Melissa Ann,0,0,0,0
1668399212357,CSE 290,A00,102399,Chandraker; Manmohan Krishna,0,0,0,0
1668399212357,CSE 290,B00,102400,Vaccaro; Kristen Marie,0,0,25,25
1668399212357,CSE 290,C00,102414,Pannuto; Patrick William,0,0,25,25
1668399212357,CSE 290,D00,102427,Pevzner; Pavel Arkadjevich,0,0,0,0
1668399212357,CSE 290,E00,102429,Zhao; Jishen,0,0,0,0
1668399212357,CSE 290,F00,102436,Tullsen; Dean Michael,0,0,0,0
1668399212357,CSE 290,G00,102440,Christensen; Henrik I,0,0,20,20
1668399212782,CSE 291,A00,102443,Su; Hao,0,0,0,0
1668399212782,CSE 291,B00,102448,Polikarpova; Nadezhda,0,0,0,0
1668399212782,CSE 291,C00,102453,Vaccaro; Kristen Marie,0,0,0,0
1668399212782,CSE 291,D00,111343,Savage; Stefan,0,0,0,0
1668399212782,CSE 291,E00,116474,Claffy; Kimberly Claire,0,0,0,0
1668399212782,CSE 291,F00,116479,Pasquale; Joseph,0,0,0,0
1668399213217,CSE 293,001,119111,Bafna; Vineet,9999,0,9999,0
1668399213217,CSE 293,002,119118,Bellare; Mihir,9999,0,9999,0
1668399213217,CSE 293,003,119122,Berg-Kirkpatrick; Taylor D,9999,0,9999,0
1668399213217,CSE 293,004,119135,Christensen; Henrik I,9999,0,9999,0
1668399213217,CSE 293,005,119142,Cottrell; Garrison W,9999,0,9999,0
1668399213217,CSE 293,006,119146,Deutsch; Alin Bernard,9999,0,9999,0
1668399213217,CSE 293,007,119159,Esmaeilzadeh; Hadi,9999,0,9999,0
1668399213217,CSE 293,008,119166,Freund; Yoav,9999,0,9999,0
1668399213217,CSE 293,009,119170,Griswold; William G.,9999,0,9999,0
1668399213217,CSE 293,010,119183,Gymrek; Melissa Ann,9999,0,9999,0
1668399213217,CSE 293,011,119190,Heninger; Nadia A,9999,0,9999,0
1668399213217,CSE 293,012,119230,Impagliazzo; Russell,9999,0,9999,0
1668399213217,CSE 293,013,119232,Jhala; Ranjit,9999,0,9999,0
1668399213217,CSE 293,014,119233,Kahng; Andrew Byun,9999,0,9999,0
1668399213217,CSE 293,015,119298,Kane; Daniel Mertz,9999,0,9999,0
1668399213217,CSE 293,016,119299,Kriegman; David J,9999,0,9999,0
1668399213217,CSE 293,017,119300,Kumar; Arun Kumar,9999,0,9999,0
1668399213217,CSE 293,018,119301,Lerner; Sorin,9999,0,9999,0
1668399213217,CSE 293,019,119302,Lovett; Shachar,9999,0,9999,0
1668399213217,CSE 293,020,119303,McAuley; Julian John,9999,0,9999,0
1668399213217,CSE 293,021,119304,Micciancio; Daniele,9999,0,9999,0
1668399213217,CSE 293,022,119367,Orailoglu; Alex,9999,0,9999,0
1668399213217,CSE 293,023,119382,Paturi; Ramamohan,9999,0,9999,0
1668399213217,CSE 293,024,119404,Polikarpova; Nadezhda,9999,0,9999,0
1668399213217,CSE 293,025,119406,Politz; Joseph Gibbs,9999,0,9999,0
1668399213217,CSE 293,026,119411,Porter; George M,9999,0,9999,0
1668399213217,CSE 293,027,119414,Porter; Leonard Emerson,9999,0,9999,0
1668399213217,CSE 293,028,119416,Ramamoorthi; Ravi,9999,0,9999,0
1668399213217,CSE 293,029,119417,Sahoo; Debashis,9999,0,9999,0
1668399213217,CSE 293,030,119420,Saul; Lawrence,9999,0,9999,0
1668399213217,CSE 293,031,119421,Savage; Stefan,9999,0,9999,0
1668399213217,CSE 293,032,119425,Schulze; Jurgen P.,9999,0,9999,0
1668399213217,CSE 293,033,119426,Snoeren; Alex C.,9999,0,9999,0
1668399213217,CSE 293,034,119428,Shang; Jingbo,9999,0,9999,0
1668399213217,CSE 293,035,119430,Stefan; Deian,9999,0,9999,0
1668399213217,CSE 293,036,119431,Su; Hao,9999,0,9999,0
1668399213217,CSE 293,037,119433,Swanson; Steven James,9999,0,9999,0
1668399213217,CSE 293,038,119435,Tullsen; Dean Michael,9999,0,9999,0
1668399213217,CSE 293,039,119483,Voelker; Geoffrey M.,9999,0,9999,0
1668399213217,CSE 293,040,119537,Zhao; Jishen,9999,0,9999,0
1668399213217,CSE 293,041,119538,Zhou; Yuan-Yuan,9999,0,9999,0
1668399213217,CSE 293,042,119539,Gao; Sicun,9999,0,9999,0
1668399213217,CSE 293,043,119540,Weibel; Nadir,9999,0,9999,0
1668399213217,CSE 293,044,119541,Gupta; Rajesh K.,9999,0,9999,0
1668399213217,CSE 293,045,126410,Vaccaro; Kristen Marie,9999,0,9999,0
1668399213217,CSE 293,046,126411,Klemke; Richard,9999,0,9999,0
1668399213643,CSE 294,A00,102459,Voelker; Geoffrey M.,0,0,0,0
1668399213643,CSE 294,B00,111322,Orailoglu; Alex,0,0,0,0
1668399214070,DSE 201,A00,096914,Deutsch; Alin Bernard,30,0,30,0
1668399214495,DSE 210,A00,096915,Dasgupta; Sanjoy,30,0,30,0
1668399214919,DSE 260A,A00,096916,Altintas De Callaf; Ilkay,30,0,30,0
1668399215356,ECE 200,001,103586,Antipa; Nicholas A,9999,0,9999,0
1668399215356,ECE 200,002,103587,Atanasov; Nikolay A.,9999,0,9999,0
1668399215356,ECE 200,003,103588,Bharadia; Dinesh,9999,0,9999,0
1668399215356,ECE 200,004,103589,Cheng; Chung Kuan,9999,0,9999,0
1668399215356,ECE 200,005,103590,Cosman; Pamela C.,9999,0,9999,0
1668399215356,ECE 200,006,103591,Dayeh; Shadi Ahmad,9999,0,9999,0
1668399215356,ECE 200,007,103592,Fainman; Yeshaiahu,9999,0,9999,0
1668399215356,ECE 200,008,103593,Ford; Joseph Earl,9999,0,9999,0
1668399215356,ECE 200,009,103594,Franceschetti; Massimo,9999,0,9999,0
1668399215356,ECE 200,010,103595,Fullerton; Eric E,9999,0,9999,0
1668399215356,ECE 200,011,103596,Galton; Ian A,9999,0,9999,0
1668399215356,ECE 200,012,103597,Gilja; Vikash,9999,0,9999,0
1668399215356,ECE 200,013,103598,Hall; Drew A.,9999,0,9999,0
1668399215356,ECE 200,014,103599,Hsueh; Tzu-Chien,9999,0,9999,0
1668399215356,ECE 200,015,103600,Javidi; Tara,9999,0,9999,0
1668399215356,ECE 200,016,103601,Kahng; Andrew Byun,9999,0,9999,0
1668399215356,ECE 200,017,103602,Kim; Young-Han,9999,0,9999,0
1668399215356,ECE 200,018,103603,Koushanfar; Farinaz,9999,0,9999,0
1668399215356,ECE 200,019,103604,Kuzum; Duygu,9999,0,9999,0
1668399215356,ECE 200,020,103605,Le; Hanh-Phuc,9999,0,9999,0
1668399215356,ECE 200,021,103606,Lin; Bill,9999,0,9999,0
1668399215356,ECE 200,022,103607,Liu; Zhaowei,9998,0,9999,1
1668399215356,ECE 200,023,103608,Lo; Yu-Hwa,9999,0,9999,0
1668399215356,ECE 200,024,103609,Lomakin; Vitaliy,9999,0,9999,0
1668399215356,ECE 200,025,103610,Mercier; Patrick Philip,9999,0,9999,0
1668399215356,ECE 200,026,103611,Meyer; Florian,9999,0,9999,0
1668399215356,ECE 200,027,103612,Milstein; Laurence B.,9999,0,9999,0
1668399215356,ECE 200,028,103613,Mir Arabbaygi; Siavash,9999,0,9999,0
1668399215356,ECE 200,029,103614,Mookherjea; Shayan,9999,0,9999,0
1668399215356,ECE 200,030,103615,Morris; Karcher William,9999,0,9999,0
1668399215356,ECE 200,031,103616,Ng; Tse Nga,9999,0,9999,0
1668399215356,ECE 200,032,103617,Nguyen; Truong Quang,9999,0,9999,0
1668399215356,ECE 200,033,103618,Nomura; Kenji,9999,0,9999,0
1668399215356,ECE 200,034,103619,Orlitsky; Alon,9999,0,9999,0
1668399215356,ECE 200,035,103620,Pal; Piya,9999,0,9999,0
1668399215356,ECE 200,036,103621,Papen; George C.,9999,0,9999,0
1668399215356,ECE 200,037,103622,Radic; Stojan,9999,0,9999,0
1668399215356,ECE 200,038,103623,Rao; Bhaskar D.,9999,0,9999,0
1668399215356,ECE 200,039,103624,Rao; Ramesh R,9999,0,9999,0
1668399215356,ECE 200,040,103625,Rebeiz; Gabriel,9999,0,9999,0
1668399215356,ECE 200,041,103626,Sanford; John R,9999,0,9999,0
1668399215356,ECE 200,042,103627,Siegel; Paul H.,9999,0,9999,0
1668399215356,ECE 200,043,103628,Sievenpiper; Daniel F.,9999,0,9999,0
1668399215356,ECE 200,044,103629,Sworder; David D.,9999,0,9999,0
1668399215356,ECE 200,045,103630,Taur; Yuan,9999,0,9999,0
1668399215356,ECE 200,046,103631,Touri; Behrouz,9999,0,9999,0
1668399215356,ECE 200,047,103632,Trivedi; Mohan M.,9999,0,9999,0
1668399215356,ECE 200,048,103633,Vasconcelos; Nuno,9999,0,9999,0
1668399215356,ECE 200,049,103634,Wang; Xiaolong,9999,0,9999,0
1668399215356,ECE 200,050,103635,Xie; Pengtao,9999,0,9999,0
1668399215356,ECE 200,051,103636,Yip; Michael,9999,0,9999,0
1668399215356,ECE 200,052,103637,Zeger; Kenneth A.,999,0,999,0
1668399215356,ECE 200,053,103638,Zhang; Xinyu,9999,0,9999,0
1668399215356,ECE 200,054,103639,Turakhia; Yatish Girish,9999,0,9999,0
1668399215356,ECE 200,055,103640,Kang; Mingu,9999,0,9999,0
1668399215356,ECE 200,056,103641,Shi; Yuanyuan,9999,0,9999,0
1668399215356,ECE 200,057,103642,Wang; Edward Jay,9999,0,9999,0
1668399215356,ECE 200,058,103643,Zheng; Yang,9999,0,9999,0
1668399215784,ECE 202,A00,103644,Kuzum; Duygu,0,0,0,0
1668399216212,ECE 212BN,A00,103646,Ng; Tse Nga,0,0,0,0
1668399216638,ECE 221,A00,111493,Staff,0,0,0,0
1668399217061,ECE 222B,A00,103647,Lomakin; Vitaliy,0,0,0,0
1668399217488,ECE 230B,A00,103648,Taur; Yuan,0,0,0,0
1668399217911,ECE 238B,A00,103649,Garay; Javier,0,0,0,0
1668399218333,ECE 240B,A00,112900,Fainman; Yeshaiahu,0,0,0,0
1668399218758,ECE 247A,A00,103650,Jokerst; Jesse Vincent,0,0,0,0
1668399219199,ECE 247B,A00,103651,Wang; Joseph,0,0,0,0
1668399219638,ECE 250,A00,103652,Siegel; Paul H.,0,0,0,0
1668399220064,ECE 251A,A00,103654,Rao; Bhaskar D.,0,0,0,0
1668399220507,ECE 257B,A00,103655,Bharadia; Dinesh,0,0,0,0
1668399221017,ECE 258A,A00,103656,Milstein; Laurence B.,0,0,0,0
1668399221441,ECE 260B,A00,103658,Kang; Mingu,0,0,0,0
1668399221865,ECE 264A,A00,103659,Galton; Ian A,0,0,0,0
1668399222289,ECE 265A,A00,103661,Gudem; Prasad S.S.,0,0,0,0
1668399222713,ECE 265D,A00,103662,Gudem; Prasad S.S.,0,0,0,0
1668399223142,ECE 268,A00,103663,Koushanfar; Farinaz,0,0,0,0
1668399223565,ECE 269,A01,103665,Pal; Piya,0,0,0,0
1668399224006,ECE 271B,A00,103666,Vasconcelos; Manuela,0,0,0,0
1668399224450,ECE 276A,A00,103667,Atanasov; Nikolay A.,0,0,0,0
1668399224882,ECE 277,A00,103668,An; Cheolhong,0,0,0,0
1668399225305,ECE 279,A00,117947,Hall; Drew A.,0,0,0,0
1668399226157,ECE 283,A00,103670,Hsueh; Tzu-Chien,0,0,0,0
1668399226579,ECE 284,A00,103671,Turakhia; Yatish Girish,0,0,0,0
1668399227003,ECE 285,A00,103672,Zheng; Yang,0,0,0,0
1668399227003,ECE 285,B00,103673,Sworder; David D.,0,0,0,0
1668399227449,ECE 287,A00,103676,Javidi; Tara,0,0,0,0
1668399227875,MATH 200B,A00,098023,Salehi Golsefidy; Alireza,12,0,15,3
1668399228302,MATH 202B,A00,098024,Rhoades; Brendon Patrick,9,0,15,6
1668399228742,MATH 203B,A00,098025,Oprea; Dragos N.,10,0,15,5
1668399229174,MATH 204B,A00,098026,Sorensen; Claus M,13,0,15,2
1668399229597,MATH 208,A00,098027,Izadi; Elham,7,0,10,3
1668399230023,MATH 209,A00,098028,Pollack; Aaron,10,0,10,0
1668399230459,MATH 211A,A00,112919,Rogalski; Daniel,9,0,10,1
1668399230882,MATH 211B,A00,112920,Seward; Brandon M.,9,0,10,1
1668399231304,MATH 218,A00,098029,Li; Bo,10,0,10,0
1668399231728,MATH 220B,A00,098030,Novak; Jonathan I,11,0,15,4
1668399232151,MATH 221A,A00,098031,Ebenfelt; Peter F,13,0,15,2
1668399232578,MATH 231B,A00,098032,Zlatos; Andrej,12,0,15,3
1668399233004,MATH 240B,A00,098033,Ni; Lei,9,0,15,6
1668399233431,MATH 243,A00,098034,Jekel; David Andrew,10,0,10,0
1668399233865,MATH 245A,A00,098035,Nie; Jiawang,0,0,15,16
1668399234302,MATH 248,A00,098036,Bejenaru; Ioan,10,0,10,0
1668399234735,MATH 250B,A00,098037,Spolaor; Luca,14,0,15,1
1668399235161,MATH 258,A00,098038,Ni; Lei,10,0,10,0
1668399235584,MATH 264B,A00,098041,Rhoades; Brendon Patrick,9,0,15,6
1668399236013,MATH 268,A00,098042,Buss; Samuel R,10,0,10,0
1668399236436,MATH 269,A00,098043,Rhoades; Brendon Patrick,10,0,10,0
1668399236862,MATH 270B,A00,098044,Li; Bo,10,0,15,5
1668399237286,MATH 272B,A00,098045,Holst; Michael J,13,0,15,2
1668399237709,MATH 273A,A00,098046,Tian; Xiaochuan,10,0,15,5
1668399238134,MATH 275,A01,098048,Tian; Xiaochuan,6,0,10,4
1668399238557,MATH 278A,A00,098049,Holst; Michael J,8,0,10,2
1668399238989,MATH 278B,A00,098050,Cloninger; Alexander,10,0,10,0
1668399239410,MATH 278C,A00,098051,Nie; Jiawang,6,0,10,4
1668399239841,MATH 280B,A00,098052,Zheng; Tianyi,8,0,15,7
1668399240269,MATH 281B,A00,098053,Bradic; Jelena,0,0,15,15
1668399240694,MATH 282B,A00,098054,Arias-Castro; Ery,0,0,15,15
1668399241129,MATH 285,A00,098055,Fitzsimmons; Patrick J,0,0,15,17
1668399241553,MATH 287B,A00,098056,Arias-Castro; Ery,2,0,15,13
1668399241977,MATH 288,A00,098057,Agarwal; Pooja,9,0,10,1
1668399241977,MATH 288,B00,098058,Zhang; Danna,8,0,10,2
1668399241977,MATH 288,C00,098059,Williams; Ruth J,9,0,10,1
1668399242405,MATH 290B,A00,098060,Roberts; Justin Deritter,13,0,15,2
1668399242835,MATH 292,A00,098061,Belmont; Eva Kinoshita,10,0,10,0
1668399243260,MATH 295,A00,098062,Suk; Andrew Hoon,48,0,50,2
1668399243685,MATH 296,A00,098063,Novak; Jonathan I,20,0,20,0
1668399244111,MATH 297,001,098064,Gamst; Anthony Collins,9997,0,9999,2
1668399744923,COGS 205,A00,101395,Chiba; Andrea,19,0,20,1
1668399745362,COGS 210B,001,101404,Greene; Deanna Jacquelyn,9998,0,9999,1
1668399745362,COGS 210B,002,101417,Xia; Haijun,9999,0,9999,0
1668399745362,COGS 210B,003,101422,Nitz; Douglas A.,9999,0,9999,0
1668399745362,COGS 210B,004,101423,Hollan; James D.,9998,0,9999,1
1668399745362,COGS 210B,005,101424,Deak; Gedeon O.,9998,0,9999,1
1668399745362,COGS 210B,006,101425,Rossano; Federico,9999,0,9999,0
1668399745787,COGS 211B,A00,101427,Coulson; Seana M,9996,0,9999,3
1668399746213,COGS 220,A00,101428,Hollan; James D.,0,0,25,25
1668399746636,COGS 229,A00,101429,Dow; Steven P,18,0,25,7
1668399747059,COGS 230,A00,101430,Klemmer; Scott R,11,0,17,6
1668399747485,COGS 234,A00,101431,Xia; Haijun,1,0,25,24
1668399747908,COGS 260,A00,101432,Kiyonaga; Anastasia,21,0,25,4
1668399747908,COGS 260,B00,101433,Kirsh; David Joel,15,0,25,10
1668399748335,CSE 202,A00,102371,Impagliazzo; Russell,0,0,0,0
1668399748759,CSE 203B,A01,102373,Cheng; Chung Kuan,0,0,0,0
1668399749189,CSE 208,A00,102374,Micciancio; Daniele,0,0,0,0
1668399749627,CSE 209A,A00,112895,Impagliazzo; Russell,0,0,15,15
1668399750053,CSE 209B,A00,108005,Bellare; Mihir,0,0,0,0
1668399750476,CSE 210,A00,113163,Coblenz; Michael J,0,0,0,0
1668399750902,CSE 219,A00,106111,Dow; Steven P,0,0,20,20
1668399751329,CSE 221,A00,102376,Voelker; Geoffrey M.,0,0,0,0
1668399751752,CSE 224,A01,102378,Porter; George M,0,0,0,0
1668399752183,CSE 229A,A00,102379,Savage; Stefan,0,0,0,0
1668399752607,CSE 229C,A00,102380,Munyaka; Imani N. S.,0,0,0,0
1668399753032,CSE 232B,A00,102382,Deutsch; Alin Bernard,0,0,0,0
1668399753458,CSE 234,A01,112904,Kumar; Arun Kumar,0,0,0,0
1668399753894,CSE 237A,A00,102383,Rosing; Tajana Simunic,0,0,0,0
1668399754323,CSE 239A,A00,102384,Deutsch; Alin Bernard,0,0,0,0
1668399754746,CSE 239B,A00,102385,Polikarpova; Nadezhda,0,0,0,0
1668399755174,CSE 240A,A00,102386,Pannuto; Patrick William,0,0,0,0
1668399755600,CSE 240B,A00,102387,Zhao; Jishen,0,0,0,0
1668399756023,CSE 241A,A00,106406,Kang; Mingu,0,0,0,0
1668399756452,CSE 249B,A00,102388,Kahng; Andrew Byun,0,0,8,8
1668399756875,CSE 251B,A01,102392,Cottrell; Garrison W,0,0,0,0
1668399756875,CSE 251B,A02,102393,Cottrell; Garrison W,0,0,0,0
1668399757302,CSE 252B,A00,102394,Ochoa; Benjamin Lawrence,0,0,0,0
1668399757730,CSE 257,A01,102396,Gao; Sicun,0,0,0,0
1668399758155,CSE 272,A00,102397,Li; Tzumao,0,0,0,0
1668399758579,CSE 274,A00,111323,Chern; Albert Ren-Haur,0,0,0,0
1668399759003,CSE 282,A00,102398,Pevzner; Pavel Arkadjevich,0,0,0,0
1668399759430,CSE 284,A00,114175,Gymrek; Melissa Ann,0,0,0,0
1668399759854,CSE 290,A00,102399,Chandraker; Manmohan Krishna,0,0,0,0
1668399759854,CSE 290,B00,102400,Vaccaro; Kristen Marie,0,0,25,25
1668399759854,CSE 290,C00,102414,Pannuto; Patrick William,0,0,25,25
1668399759854,CSE 290,D00,102427,Pevzner; Pavel Arkadjevich,0,0,0,0
1668399759854,CSE 290,E00,102429,Zhao; Jishen,0,0,0,0
1668399759854,CSE 290,F00,102436,Tullsen; Dean Michael,0,0,0,0
1668399759854,CSE 290,G00,102440,Christensen; Henrik I,0,0,20,20
1668399760283,CSE 291,A00,102443,Su; Hao,0,0,0,0
1668399760283,CSE 291,B00,102448,Polikarpova; Nadezhda,0,0,0,0
1668399760283,CSE 291,C00,102453,Vaccaro; Kristen Marie,0,0,0,0
1668399760283,CSE 291,D00,111343,Savage; Stefan,0,0,0,0
1668399760283,CSE 291,E00,116474,Claffy; Kimberly Claire,0,0,0,0
1668399760283,CSE 291,F00,116479,Pasquale; Joseph,0,0,0,0
1668399760712,CSE 293,001,119111,Bafna; Vineet,9999,0,9999,0
1668399760712,CSE 293,002,119118,Bellare; Mihir,9999,0,9999,0
1668399760712,CSE 293,003,119122,Berg-Kirkpatrick; Taylor D,9999,0,9999,0
1668399760712,CSE 293,004,119135,Christensen; Henrik I,9999,0,9999,0
1668399760712,CSE 293,005,119142,Cottrell; Garrison W,9999,0,9999,0
1668399760712,CSE 293,006,119146,Deutsch; Alin Bernard,9999,0,9999,0
1668399760712,CSE 293,007,119159,Esmaeilzadeh; Hadi,9999,0,9999,0
1668399760712,CSE 293,008,119166,Freund; Yoav,9999,0,9999,0
1668399760712,CSE 293,009,119170,Griswold; William G.,9999,0,9999,0
1668399760712,CSE 293,010,119183,Gymrek; Melissa Ann,9999,0,9999,0
1668399760712,CSE 293,011,119190,Heninger; Nadia A,9999,0,9999,0
1668399760712,CSE 293,012,119230,Impagliazzo; Russell,9999,0,9999,0
1668399760712,CSE 293,013,119232,Jhala; Ranjit,9999,0,9999,0
1668399760712,CSE 293,014,119233,Kahng; Andrew Byun,9999,0,9999,0
1668399760712,CSE 293,015,119298,Kane; Daniel Mertz,9999,0,9999,0
1668399760712,CSE 293,016,119299,Kriegman; David J,9999,0,9999,0
1668399760712,CSE 293,017,119300,Kumar; Arun Kumar,9999,0,9999,0
1668399760712,CSE 293,018,119301,Lerner; Sorin,9999,0,9999,0
1668399760712,CSE 293,019,119302,Lovett; Shachar,9999,0,9999,0
1668399760712,CSE 293,020,119303,McAuley; Julian John,9999,0,9999,0
1668399760712,CSE 293,021,119304,Micciancio; Daniele,9999,0,9999,0
1668399760712,CSE 293,022,119367,Orailoglu; Alex,9999,0,9999,0
1668399760712,CSE 293,023,119382,Paturi; Ramamohan,9999,0,9999,0
1668399760712,CSE 293,024,119404,Polikarpova; Nadezhda,9999,0,9999,0
1668399760712,CSE 293,025,119406,Politz; Joseph Gibbs,9999,0,9999,0
1668399760712,CSE 293,026,119411,Porter; George M,9999,0,9999,0
1668399760712,CSE 293,027,119414,Porter; Leonard Emerson,9999,0,9999,0
1668399760712,CSE 293,028,119416,Ramamoorthi; Ravi,9999,0,9999,0
1668399760712,CSE 293,029,119417,Sahoo; Debashis,9999,0,9999,0
1668399760712,CSE 293,030,119420,Saul; Lawrence,9999,0,9999,0
1668399760712,CSE 293,031,119421,Savage; Stefan,9999,0,9999,0
1668399760712,CSE 293,032,119425,Schulze; Jurgen P.,9999,0,9999,0
1668399760712,CSE 293,033,119426,Snoeren; Alex C.,9999,0,9999,0
1668399760712,CSE 293,034,119428,Shang; Jingbo,9999,0,9999,0
1668399760712,CSE 293,035,119430,Stefan; Deian,9999,0,9999,0
1668399760712,CSE 293,036,119431,Su; Hao,9999,0,9999,0
1668399760712,CSE 293,037,119433,Swanson; Steven James,9999,0,9999,0
1668399760712,CSE 293,038,119435,Tullsen; Dean Michael,9999,0,9999,0
1668399760712,CSE 293,039,119483,Voelker; Geoffrey M.,9999,0,9999,0
1668399760712,CSE 293,040,119537,Zhao; Jishen,9999,0,9999,0
1668399760712,CSE 293,041,119538,Zhou; Yuan-Yuan,9999,0,9999,0
1668399760712,CSE 293,042,119539,Gao; Sicun,9999,0,9999,0
1668399760712,CSE 293,043,119540,Weibel; Nadir,9999,0,9999,0
1668399760712,CSE 293,044,119541,Gupta; Rajesh K.,9999,0,9999,0
1668399760712,CSE 293,045,126410,Vaccaro; Kristen Marie,9999,0,9999,0
1668399760712,CSE 293,046,126411,Klemke; Richard,9999,0,9999,0
1668399761137,CSE 294,A00,102459,Voelker; Geoffrey M.,0,0,0,0
1668399761137,CSE 294,B00,111322,Orailoglu; Alex,0,0,0,0
1668399761561,DSE 201,A00,096914,Deutsch; Alin Bernard,30,0,30,0
1668399761985,DSE 210,A00,096915,Dasgupta; Sanjoy,30,0,30,0
1668399762410,DSE 260A,A00,096916,Altintas De Callaf; Ilkay,30,0,30,0
1668399762869,ECE 200,001,103586,Antipa; Nicholas A,9999,0,9999,0
1668399762869,ECE 200,002,103587,Atanasov; Nikolay A.,9999,0,9999,0
1668399762869,ECE 200,003,103588,Bharadia; Dinesh,9999,0,9999,0
1668399762869,ECE 200,004,103589,Cheng; Chung Kuan,9999,0,9999,0
1668399762869,ECE 200,005,103590,Cosman; Pamela C.,9999,0,9999,0
1668399762869,ECE 200,006,103591,Dayeh; Shadi Ahmad,9999,0,9999,0
1668399762869,ECE 200,007,103592,Fainman; Yeshaiahu,9999,0,9999,0
1668399762869,ECE 200,008,103593,Ford; Joseph Earl,9999,0,9999,0
1668399762869,ECE 200,009,103594,Franceschetti; Massimo,9999,0,9999,0
1668399762869,ECE 200,010,103595,Fullerton; Eric E,9999,0,9999,0
1668399762869,ECE 200,011,103596,Galton; Ian A,9999,0,9999,0
1668399762869,ECE 200,012,103597,Gilja; Vikash,9999,0,9999,0
1668399762869,ECE 200,013,103598,Hall; Drew A.,9999,0,9999,0
1668399762869,ECE 200,014,103599,Hsueh; Tzu-Chien,9999,0,9999,0
1668399762869,ECE 200,015,103600,Javidi; Tara,9999,0,9999,0
1668399762869,ECE 200,016,103601,Kahng; Andrew Byun,9999,0,9999,0
1668399762869,ECE 200,017,103602,Kim; Young-Han,9999,0,9999,0
1668399762869,ECE 200,018,103603,Koushanfar; Farinaz,9999,0,9999,0
1668399762869,ECE 200,019,103604,Kuzum; Duygu,9999,0,9999,0
1668399762869,ECE 200,020,103605,Le; Hanh-Phuc,9999,0,9999,0
1668399762869,ECE 200,021,103606,Lin; Bill,9999,0,9999,0
1668399762869,ECE 200,022,103607,Liu; Zhaowei,9998,0,9999,1
1668399762869,ECE 200,023,103608,Lo; Yu-Hwa,9999,0,9999,0
1668399762869,ECE 200,024,103609,Lomakin; Vitaliy,9999,0,9999,0
1668399762869,ECE 200,025,103610,Mercier; Patrick Philip,9999,0,9999,0
1668399762869,ECE 200,026,103611,Meyer; Florian,9999,0,9999,0
1668399762869,ECE 200,027,103612,Milstein; Laurence B.,9999,0,9999,0
1668399762869,ECE 200,028,103613,Mir Arabbaygi; Siavash,9999,0,9999,0
1668399762869,ECE 200,029,103614,Mookherjea; Shayan,9999,0,9999,0
1668399762869,ECE 200,030,103615,Morris; Karcher William,9999,0,9999,0
1668399762869,ECE 200,031,103616,Ng; Tse Nga,9999,0,9999,0
1668399762869,ECE 200,032,103617,Nguyen; Truong Quang,9999,0,9999,0
1668399762869,ECE 200,033,103618,Nomura; Kenji,9999,0,9999,0
1668399762869,ECE 200,034,103619,Orlitsky; Alon,9999,0,9999,0
1668399762869,ECE 200,035,103620,Pal; Piya,9999,0,9999,0
1668399762869,ECE 200,036,103621,Papen; George C.,9999,0,9999,0
1668399762869,ECE 200,037,103622,Radic; Stojan,9999,0,9999,0
1668399762869,ECE 200,038,103623,Rao; Bhaskar D.,9999,0,9999,0
1668399762869,ECE 200,039,103624,Rao; Ramesh R,9999,0,9999,0
1668399762869,ECE 200,040,103625,Rebeiz; Gabriel,9999,0,9999,0
1668399762869,ECE 200,041,103626,Sanford; John R,9999,0,9999,0
1668399762869,ECE 200,042,103627,Siegel; Paul H.,9999,0,9999,0
1668399762869,ECE 200,043,103628,Sievenpiper; Daniel F.,9999,0,9999,0
1668399762869,ECE 200,044,103629,Sworder; David D.,9999,0,9999,0
1668399762869,ECE 200,045,103630,Taur; Yuan,9999,0,9999,0
1668399762869,ECE 200,046,103631,Touri; Behrouz,9999,0,9999,0
1668399762869,ECE 200,047,103632,Trivedi; Mohan M.,9999,0,9999,0
1668399762869,ECE 200,048,103633,Vasconcelos; Nuno,9999,0,9999,0
1668399762869,ECE 200,049,103634,Wang; Xiaolong,9999,0,9999,0
1668399762869,ECE 200,050,103635,Xie; Pengtao,9999,0,9999,0
1668399762869,ECE 200,051,103636,Yip; Michael,9999,0,9999,0
1668399762869,ECE 200,052,103637,Zeger; Kenneth A.,999,0,999,0
1668399762869,ECE 200,053,103638,Zhang; Xinyu,9999,0,9999,0
1668399762869,ECE 200,054,103639,Turakhia; Yatish Girish,9999,0,9999,0
1668399762869,ECE 200,055,103640,Kang; Mingu,9999,0,9999,0
1668399762869,ECE 200,056,103641,Shi; Yuanyuan,9999,0,9999,0
1668399762869,ECE 200,057,103642,Wang; Edward Jay,9999,0,9999,0
1668399762869,ECE 200,058,103643,Zheng; Yang,9999,0,9999,0
1668399763293,ECE 202,A00,103644,Kuzum; Duygu,0,0,0,0
1668399763718,ECE 212BN,A00,103646,Ng; Tse Nga,0,0,0,0
1668399764142,ECE 221,A00,111493,Staff,0,0,0,0
1668399764568,ECE 222B,A00,103647,Lomakin; Vitaliy,0,0,0,0
1668399764999,ECE 230B,A00,103648,Taur; Yuan,0,0,0,0
1668399765432,ECE 238B,A00,103649,Garay; Javier,0,0,0,0
1668399765865,ECE 240B,A00,112900,Fainman; Yeshaiahu,0,0,0,0
1668399766288,ECE 247A,A00,103650,Jokerst; Jesse Vincent,0,0,0,0
1668399766714,ECE 247B,A00,103651,Wang; Joseph,0,0,0,0
1668399767140,ECE 250,A00,103652,Siegel; Paul H.,0,0,0,0
1668399767564,ECE 251A,A00,103654,Rao; Bhaskar D.,0,0,0,0
1668399767990,ECE 257B,A00,103655,Bharadia; Dinesh,0,0,0,0
1668399768415,ECE 258A,A00,103656,Milstein; Laurence B.,0,0,0,0
1668399768837,ECE 260B,A00,103658,Kang; Mingu,0,0,0,0
1668399769266,ECE 264A,A00,103659,Galton; Ian A,0,0,0,0
1668399769690,ECE 265A,A00,103661,Gudem; Prasad S.S.,0,0,0,0
1668399770114,ECE 265D,A00,103662,Gudem; Prasad S.S.,0,0,0,0
1668399770537,ECE 268,A00,103663,Koushanfar; Farinaz,0,0,0,0
1668399770962,ECE 269,A01,103665,Pal; Piya,0,0,0,0
1668399771388,ECE 271B,A00,103666,Vasconcelos; Manuela,0,0,0,0
1668399771824,ECE 276A,A00,103667,Atanasov; Nikolay A.,0,0,0,0
1668399772264,ECE 277,A00,103668,An; Cheolhong,0,0,0,0
1668399772692,ECE 279,A00,117947,Hall; Drew A.,0,0,0,0
1668399773537,ECE 283,A00,103670,Hsueh; Tzu-Chien,0,0,0,0
1668399773966,ECE 284,A00,103671,Turakhia; Yatish Girish,0,0,0,0
1668399774401,ECE 285,A00,103672,Zheng; Yang,0,0,0,0
1668399774401,ECE 285,B00,103673,Sworder; David D.,0,0,0,0
1668399774832,ECE 287,A00,103676,Javidi; Tara,0,0,0,0
1668399775264,MATH 200B,A00,098023,Salehi Golsefidy; Alireza,12,0,15,3
1668399775694,MATH 202B,A00,098024,Rhoades; Brendon Patrick,9,0,15,6
1668399776119,MATH 203B,A00,098025,Oprea; Dragos N.,10,0,15,5
1668399776542,MATH 204B,A00,098026,Sorensen; Claus M,13,0,15,2
1668399776972,MATH 208,A00,098027,Izadi; Elham,7,0,10,3
1668399777396,MATH 209,A00,098028,Pollack; Aaron,10,0,10,0
1668399777818,MATH 211A,A00,112919,Rogalski; Daniel,9,0,10,1
1668399778242,MATH 211B,A00,112920,Seward; Brandon M.,9,0,10,1
1668399778664,MATH 218,A00,098029,Li; Bo,10,0,10,0
1668399779088,MATH 220B,A00,098030,Novak; Jonathan I,11,0,15,4
1668399779512,MATH 221A,A00,098031,Ebenfelt; Peter F,13,0,15,2
1668399779936,MATH 231B,A00,098032,Zlatos; Andrej,12,0,15,3
1668399780361,MATH 240B,A00,098033,Ni; Lei,9,0,15,6
1668399780795,MATH 243,A00,098034,Jekel; David Andrew,10,0,10,0
1668399781220,MATH 245A,A00,098035,Nie; Jiawang,0,0,15,16
1668399781644,MATH 248,A00,098036,Bejenaru; Ioan,10,0,10,0
1668399782068,MATH 250B,A00,098037,Spolaor; Luca,14,0,15,1
1668399782490,MATH 258,A00,098038,Ni; Lei,10,0,10,0
1668399782916,MATH 264B,A00,098041,Rhoades; Brendon Patrick,9,0,15,6
1668399783340,MATH 268,A00,098042,Buss; Samuel R,10,0,10,0
1668399783766,MATH 269,A00,098043,Rhoades; Brendon Patrick,10,0,10,0
1668399784188,MATH 270B,A00,098044,Li; Bo,10,0,15,5
1668399784615,MATH 272B,A00,098045,Holst; Michael J,13,0,15,2
1668399785150,MATH 273A,A00,098046,Tian; Xiaochuan,10,0,15,5
1668399785576,MATH 275,A01,098048,Tian; Xiaochuan,6,0,10,4
1668399785998,MATH 278A,A00,098049,Holst; Michael J,8,0,10,2
1668399786420,MATH 278B,A00,098050,Cloninger; Alexander,10,0,10,0
1668399786844,MATH 278C,A00,098051,Nie; Jiawang,6,0,10,4
1668399787277,MATH 280B,A00,098052,Zheng; Tianyi,8,0,15,7
1668399787703,MATH 281B,A00,098053,Bradic; Jelena,0,0,15,15
1668399788125,MATH 282B,A00,098054,Arias-Castro; Ery,0,0,15,15
1668399788549,MATH 285,A00,098055,Fitzsimmons; Patrick J,0,0,15,17
1668399788972,MATH 287B,A00,098056,Arias-Castro; Ery,2,0,15,13
1668399789395,MATH 288,A00,098057,Agarwal; Pooja,9,0,10,1
1668399789395,MATH 288,B00,098058,Zhang; Danna,8,0,10,2
1668399789395,MATH 288,C00,098059,Williams; Ruth J,9,0,10,1
1668399789819,MATH 290B,A00,098060,Roberts; Justin Deritter,13,0,15,2
1668399790241,MATH 292,A00,098061,Belmont; Eva Kinoshita,10,0,10,0
1668399790667,MATH 295,A00,098062,Suk; Andrew Hoon,48,0,50,2
1668399791102,MATH 296,A00,098063,Novak; Jonathan I,20,0,20,0
1668399791542,MATH 297,001,098064,Gamst; Anthony Collins,9997,0,9999,2
1668400302928,COGS 205,A00,101395,Chiba; Andrea,19,0,20,1
1668400303367,COGS 210B,001,101404,Greene; Deanna Jacquelyn,9998,0,9999,1
1668400303367,COGS 210B,002,101417,Xia; Haijun,9999,0,9999,0
1668400303367,COGS 210B,003,101422,Nitz; Douglas A.,9999,0,9999,0
1668400303367,COGS 210B,004,101423,Hollan; James D.,9998,0,9999,1
1668400303367,COGS 210B,005,101424,Deak; Gedeon O.,9998,0,9999,1
1668400303367,COGS 210B,006,101425,Rossano; Federico,9999,0,9999,0
1668400303790,COGS 211B,A00,101427,Coulson; Seana M,9996,0,9999,3
1668400304213,COGS 220,A00,101428,Hollan; James D.,0,0,25,25
1668400304641,COGS 229,A00,101429,Dow; Steven P,18,0,25,7
1668400305067,COGS 230,A00,101430,Klemmer; Scott R,11,0,17,6
1668400305490,COGS 234,A00,101431,Xia; Haijun,1,0,25,24
1668400305917,COGS 260,A00,101432,Kiyonaga; Anastasia,21,0,25,4
1668400305917,COGS 260,B00,101433,Kirsh; David Joel,15,0,25,10
1668400306342,CSE 202,A00,102371,Impagliazzo; Russell,0,0,0,0
1668400306779,CSE 203B,A01,102373,Cheng; Chung Kuan,0,0,0,0
1668400307230,CSE 208,A00,102374,Micciancio; Daniele,0,0,0,0
1668400307655,CSE 209A,A00,112895,Impagliazzo; Russell,0,0,15,15
1668400308077,CSE 209B,A00,108005,Bellare; Mihir,0,0,0,0
1668400308502,CSE 210,A00,113163,Coblenz; Michael J,0,0,0,0
1668400308925,CSE 219,A00,106111,Dow; Steven P,0,0,20,20
1668400309350,CSE 221,A00,102376,Voelker; Geoffrey M.,0,0,0,0
1668400309782,CSE 224,A01,102378,Porter; George M,0,0,0,0
1668400310206,CSE 229A,A00,102379,Savage; Stefan,0,0,0,0
1668400310633,CSE 229C,A00,102380,Munyaka; Imani N. S.,0,0,0,0
1668400311058,CSE 232B,A00,102382,Deutsch; Alin Bernard,0,0,0,0
1668400311482,CSE 234,A01,112904,Kumar; Arun Kumar,0,0,0,0
1668400311909,CSE 237A,A00,102383,Rosing; Tajana Simunic,0,0,0,0
1668400312348,CSE 239A,A00,102384,Deutsch; Alin Bernard,0,0,0,0
1668400312775,CSE 239B,A00,102385,Polikarpova; Nadezhda,0,0,0,0
1668400313203,CSE 240A,A00,102386,Pannuto; Patrick William,0,0,0,0
1668400313639,CSE 240B,A00,102387,Zhao; Jishen,0,0,0,0
1668400314082,CSE 241A,A00,106406,Kang; Mingu,0,0,0,0
1668400314510,CSE 249B,A00,102388,Kahng; Andrew Byun,0,0,8,8
1668400314937,CSE 251B,A01,102392,Cottrell; Garrison W,0,0,0,0
1668400314937,CSE 251B,A02,102393,Cottrell; Garrison W,0,0,0,0
1668400315374,CSE 252B,A00,102394,Ochoa; Benjamin Lawrence,0,0,0,0
1668400315798,CSE 257,A01,102396,Gao; Sicun,0,0,0,0
1668400316232,CSE 272,A00,102397,Li; Tzumao,0,0,0,0
1668400316747,CSE 274,A00,111323,Chern; Albert Ren-Haur,0,0,0,0
1668400317172,CSE 282,A00,102398,Pevzner; Pavel Arkadjevich,0,0,0,0
1668400317596,CSE 284,A00,114175,Gymrek; Melissa Ann,0,0,0,0
1668400318021,CSE 290,A00,102399,Chandraker; Manmohan Krishna,0,0,0,0
1668400318021,CSE 290,B00,102400,Vaccaro; Kristen Marie,0,0,25,25
1668400318021,CSE 290,C00,102414,Pannuto; Patrick William,0,0,25,25
1668400318021,CSE 290,D00,102427,Pevzner; Pavel Arkadjevich,0,0,0,0
1668400318021,CSE 290,E00,102429,Zhao; Jishen,0,0,0,0
1668400318021,CSE 290,F00,102436,Tullsen; Dean Michael,0,0,0,0
1668400318021,CSE 290,G00,102440,Christensen; Henrik I,0,0,20,20
1668400318452,CSE 291,A00,102443,Su; Hao,0,0,0,0
1668400318452,CSE 291,B00,102448,Polikarpova; Nadezhda,0,0,0,0
1668400318452,CSE 291,C00,102453,Vaccaro; Kristen Marie,0,0,0,0
1668400318452,CSE 291,D00,111343,Savage; Stefan,0,0,0,0
1668400318452,CSE 291,E00,116474,Claffy; Kimberly Claire,0,0,0,0
1668400318452,CSE 291,F00,116479,Pasquale; Joseph,0,0,0,0
1668400318891,CSE 293,001,119111,Bafna; Vineet,9999,0,9999,0
1668400318891,CSE 293,002,119118,Bellare; Mihir,9999,0,9999,0
1668400318891,CSE 293,003,119122,Berg-Kirkpatrick; Taylor D,9999,0,9999,0
1668400318891,CSE 293,004,119135,Christensen; Henrik I,9999,0,9999,0
1668400318891,CSE 293,005,119142,Cottrell; Garrison W,9999,0,9999,0
1668400318891,CSE 293,006,119146,Deutsch; Alin Bernard,9999,0,9999,0
1668400318891,CSE 293,007,119159,Esmaeilzadeh; Hadi,9999,0,9999,0
1668400318891,CSE 293,008,119166,Freund; Yoav,9999,0,9999,0
1668400318891,CSE 293,009,119170,Griswold; William G.,9999,0,9999,0
1668400318891,CSE 293,010,119183,Gymrek; Melissa Ann,9999,0,9999,0
1668400318891,CSE 293,011,119190,Heninger; Nadia A,9999,0,9999,0
1668400318891,CSE 293,012,119230,Impagliazzo; Russell,9999,0,9999,0
1668400318891,CSE 293,013,119232,Jhala; Ranjit,9999,0,9999,0
1668400318891,CSE 293,014,119233,Kahng; Andrew Byun,9999,0,9999,0
1668400318891,CSE 293,015,119298,Kane; Daniel Mertz,9999,0,9999,0
1668400318891,CSE 293,016,119299,Kriegman; David J,9999,0,9999,0
1668400318891,CSE 293,017,119300,Kumar; Arun Kumar,9999,0,9999,0
1668400318891,CSE 293,018,119301,Lerner; Sorin,9999,0,9999,0
1668400318891,CSE 293,019,119302,Lovett; Shachar,9999,0,9999,0
1668400318891,CSE 293,020,119303,McAuley; Julian John,9999,0,9999,0
1668400318891,CSE 293,021,119304,Micciancio; Daniele,9999,0,9999,0
1668400318891,CSE 293,022,119367,Orailoglu; Alex,9999,0,9999,0
1668400318891,CSE 293,023,119382,Paturi; Ramamohan,9999,0,9999,0
1668400318891,CSE 293,024,119404,Polikarpova; Nadezhda,9999,0,9999,0
1668400318891,CSE 293,025,119406,Politz; Joseph Gibbs,9999,0,9999,0
1668400318891,CSE 293,026,119411,Porter; George M,9999,0,9999,0
1668400318891,CSE 293,027,119414,Porter; Leonard Emerson,9999,0,9999,0
1668400318891,CSE 293,028,119416,Ramamoorthi; Ravi,9999,0,9999,0
1668400318891,CSE 293,029,119417,Sahoo; Debashis,9999,0,9999,0
1668400318891,CSE 293,030,119420,Saul; Lawrence,9999,0,9999,0
1668400318891,CSE 293,031,119421,Savage; Stefan,9999,0,9999,0
1668400318891,CSE 293,032,119425,Schulze; Jurgen P.,9999,0,9999,0
1668400318891,CSE 293,033,119426,Snoeren; Alex C.,9999,0,9999,0
1668400318891,CSE 293,034,119428,Shang; Jingbo,9999,0,9999,0
1668400318891,CSE 293,035,119430,Stefan; Deian,9999,0,9999,0
1668400318891,CSE 293,036,119431,Su; Hao,9999,0,9999,0
1668400318891,CSE 293,037,119433,Swanson; Steven James,9999,0,9999,0
1668400318891,CSE 293,038,119435,Tullsen; Dean Michael,9999,0,9999,0
1668400318891,CSE 293,039,119483,Voelker; Geoffrey M.,9999,0,9999,0
1668400318891,CSE 293,040,119537,Zhao; Jishen,9999,0,9999,0
1668400318891,CSE 293,041,119538,Zhou; Yuan-Yuan,9999,0,9999,0
1668400318891,CSE 293,042,119539,Gao; Sicun,9999,0,9999,0
1668400318891,CSE 293,043,119540,Weibel; Nadir,9999,0,9999,0
1668400318891,CSE 293,044,119541,Gupta; Rajesh K.,9999,0,9999,0
1668400318891,CSE 293,045,126410,Vaccaro; Kristen Marie,9999,0,9999,0
1668400318891,CSE 293,046,126411,Klemke; Richard,9999,0,9999,0
1668400319315,CSE 294,A00,102459,Voelker; Geoffrey M.,0,0,0,0
1668400319315,CSE 294,B00,111322,Orailoglu; Alex,0,0,0,0
1668400319740,DSE 201,A00,096914,Deutsch; Alin Bernard,30,0,30,0
1668400320164,DSE 210,A00,096915,Dasgupta; Sanjoy,30,0,30,0
1668400320599,DSE 260A,A00,096916,Altintas De Callaf; Ilkay,30,0,30,0
1668400321057,ECE 200,001,103586,Antipa; Nicholas A,9999,0,9999,0
1668400321057,ECE 200,002,103587,Atanasov; Nikolay A.,9999,0,9999,0
1668400321057,ECE 200,003,103588,Bharadia; Dinesh,9999,0,9999,0
1668400321057,ECE 200,004,103589,Cheng; Chung Kuan,9999,0,9999,0
1668400321057,ECE 200,005,103590,Cosman; Pamela C.,9999,0,9999,0
1668400321057,ECE 200,006,103591,Dayeh; Shadi Ahmad,9999,0,9999,0
1668400321057,ECE 200,007,103592,Fainman; Yeshaiahu,9999,0,9999,0
1668400321057,ECE 200,008,103593,Ford; Joseph Earl,9999,0,9999,0
1668400321057,ECE 200,009,103594,Franceschetti; Massimo,9999,0,9999,0
1668400321057,ECE 200,010,103595,Fullerton; Eric E,9999,0,9999,0
1668400321057,ECE 200,011,103596,Galton; Ian A,9999,0,9999,0
1668400321057,ECE 200,012,103597,Gilja; Vikash,9999,0,9999,0
1668400321057,ECE 200,013,103598,Hall; Drew A.,9999,0,9999,0
1668400321057,ECE 200,014,103599,Hsueh; Tzu-Chien,9999,0,9999,0
1668400321057,ECE 200,015,103600,Javidi; Tara,9999,0,9999,0
1668400321057,ECE 200,016,103601,Kahng; Andrew Byun,9999,0,9999,0
1668400321057,ECE 200,017,103602,Kim; Young-Han,9999,0,9999,0
1668400321057,ECE 200,018,103603,Koushanfar; Farinaz,9999,0,9999,0
1668400321057,ECE 200,019,103604,Kuzum; Duygu,9999,0,9999,0
1668400321057,ECE 200,020,103605,Le; Hanh-Phuc,9999,0,9999,0
1668400321057,ECE 200,021,103606,Lin; Bill,9999,0,9999,0
1668400321057,ECE 200,022,103607,Liu; Zhaowei,9998,0,9999,1
1668400321057,ECE 200,023,103608,Lo; Yu-Hwa,9999,0,9999,0
1668400321057,ECE 200,024,103609,Lomakin; Vitaliy,9999,0,9999,0
1668400321057,ECE 200,025,103610,Mercier; Patrick Philip,9999,0,9999,0
1668400321057,ECE 200,026,103611,Meyer; Florian,9999,0,9999,0
1668400321057,ECE 200,027,103612,Milstein; Laurence B.,9999,0,9999,0
1668400321057,ECE 200,028,103613,Mir Arabbaygi; Siavash,9999,0,9999,0
1668400321057,ECE 200,029,103614,Mookherjea; Shayan,9999,0,9999,0
1668400321057,ECE 200,030,103615,Morris; Karcher William,9999,0,9999,0
1668400321057,ECE 200,031,103616,Ng; Tse Nga,9999,0,9999,0
1668400321057,ECE 200,032,103617,Nguyen; Truong Quang,9999,0,9999,0
1668400321057,ECE 200,033,103618,Nomura; Kenji,9999,0,9999,0
1668400321057,ECE 200,034,103619,Orlitsky; Alon,9999,0,9999,0
1668400321057,ECE 200,035,103620,Pal; Piya,9999,0,9999,0
1668400321057,ECE 200,036,103621,Papen; George C.,9999,0,9999,0
1668400321057,ECE 200,037,103622,Radic; Stojan,9999,0,9999,0
1668400321057,ECE 200,038,103623,Rao; Bhaskar D.,9999,0,9999,0
1668400321057,ECE 200,039,103624,Rao; Ramesh R,9999,0,9999,0
1668400321057,ECE 200,040,103625,Rebeiz; Gabriel,9999,0,9999,0
1668400321057,ECE 200,041,103626,Sanford; John R,9999,0,9999,0
1668400321057,ECE 200,042,103627,Siegel; Paul H.,9999,0,9999,0
1668400321057,ECE 200,043,103628,Sievenpiper; Daniel F.,9999,0,9999,0
1668400321057,ECE 200,044,103629,Sworder; David D.,9999,0,9999,0
1668400321057,ECE 200,045,103630,Taur; Yuan,9999,0,9999,0
1668400321057,ECE 200,046,103631,Touri; Behrouz,9999,0,9999,0
1668400321057,ECE 200,047,103632,Trivedi; Mohan M.,9999,0,9999,0
1668400321057,ECE 200,048,103633,Vasconcelos; Nuno,9999,0,9999,0
1668400321057,ECE 200,049,103634,Wang; Xiaolong,9999,0,9999,0
1668400321057,ECE 200,050,103635,Xie; Pengtao,9999,0,9999,0
1668400321057,ECE 200,051,103636,Yip; Michael,9999,0,9999,0
1668400321057,ECE 200,052,103637,Zeger; Kenneth A.,999,0,999,0
1668400321057,ECE 200,053,103638,Zhang; Xinyu,9999,0,9999,0
1668400321057,ECE 200,054,103639,Turakhia; Yatish Girish,9999,0,9999,0
1668400321057,ECE 200,055,103640,Kang; Mingu,9999,0,9999,0
1668400321057,ECE 200,056,103641,Shi; Yuanyuan,9999,0,9999,0
1668400321057,ECE 200,057,103642,Wang; Edward Jay,9999,0,9999,0
1668400321057,ECE 200,058,103643,Zheng; Yang,9999,0,9999,0
1668400321489,ECE 202,A00,103644,Kuzum; Duygu,0,0,0,0
1668400321931,ECE 212BN,A00,103646,Ng; Tse Nga,0,0,0,0
1668400322359,ECE 221,A00,111493,Staff,0,0,0,0
1668400322790,ECE 222B,A00,103647,Lomakin; Vitaliy,0,0,0,0
1668400323214,ECE 230B,A00,103648,Taur; Yuan,0,0,0,0
1668400323653,ECE 238B,A00,103649,Garay; Javier,0,0,0,0
1668400324094,ECE 240B,A00,112900,Fainman; Yeshaiahu,0,0,0,0
1668400324526,ECE 247A,A00,103650,Jokerst; Jesse Vincent,0,0,0,0
1668400324950,ECE 247B,A00,103651,Wang; Joseph,0,0,0,0
1668400325376,ECE 250,A00,103652,Siegel; Paul H.,0,0,0,0
1668400325802,ECE 251A,A00,103654,Rao; Bhaskar D.,0,0,0,0
1668400326239,ECE 257B,A00,103655,Bharadia; Dinesh,0,0,0,0
1668400326665,ECE 258A,A00,103656,Milstein; Laurence B.,0,0,0,0
1668400327099,ECE 260B,A00,103658,Kang; Mingu,0,0,0,0
1668400327526,ECE 264A,A00,103659,Galton; Ian A,0,0,0,0
1668400327953,ECE 265A,A00,103661,Gudem; Prasad S.S.,0,0,0,0
1668400328379,ECE 265D,A00,103662,Gudem; Prasad S.S.,0,0,0,0
1668400328804,ECE 268,A00,103663,Koushanfar; Farinaz,0,0,0,0
1668400329229,ECE 269,A01,103665,Pal; Piya,0,0,0,0
1668400329661,ECE 271B,A00,103666,Vasconcelos; Manuela,0,0,0,0
1668400330097,ECE 276A,A00,103667,Atanasov; Nikolay A.,0,0,0,0
1668400330522,ECE 277,A00,103668,An; Cheolhong,0,0,0,0
1668400330948,ECE 279,A00,117947,Hall; Drew A.,0,0,0,0
1668400331798,ECE 283,A00,103670,Hsueh; Tzu-Chien,0,0,0,0
1668400332229,ECE 284,A00,103671,Turakhia; Yatish Girish,0,0,0,0
1668400332653,ECE 285,A00,103672,Zheng; Yang,0,0,0,0
1668400332653,ECE 285,B00,103673,Sworder; David D.,0,0,0,0
1668400333076,ECE 287,A00,103676,Javidi; Tara,0,0,0,0
1668400333502,MATH 200B,A00,098023,Salehi Golsefidy; Alireza,12,0,15,3
1668400333925,MATH 202B,A00,098024,Rhoades; Brendon Patrick,9,0,15,6
1668400334356,MATH 203B,A00,098025,Oprea; Dragos N.,10,0,15,5
1668400334780,MATH 204B,A00,098026,Sorensen; Claus M,13,0,15,2
1668400335205,MATH 208,A00,098027,Izadi; Elham,7,0,10,3
1668400335630,MATH 209,A00,098028,Pollack; Aaron,10,0,10,0
1668400336061,MATH 211A,A00,112919,Rogalski; Daniel,9,0,10,1
1668400336485,MATH 211B,A00,112920,Seward; Brandon M.,9,0,10,1
1668400336909,MATH 218,A00,098029,Li; Bo,10,0,10,0
1668400337339,MATH 220B,A00,098030,Novak; Jonathan I,11,0,15,4
1668400337766,MATH 221A,A00,098031,Ebenfelt; Peter F,13,0,15,2
1668400338188,MATH 231B,A00,098032,Zlatos; Andrej,12,0,15,3
1668400338619,MATH 240B,A00,098033,Ni; Lei,9,0,15,6
1668400339044,MATH 243,A00,098034,Jekel; David Andrew,10,0,10,0
1668400339472,MATH 245A,A00,098035,Nie; Jiawang,0,0,15,16
1668400339897,MATH 248,A00,098036,Bejenaru; Ioan,10,0,10,0
1668400340323,MATH 250B,A00,098037,Spolaor; Luca,14,0,15,1
1668400340746,MATH 258,A00,098038,Ni; Lei,10,0,10,0
1668400341169,MATH 264B,A00,098041,Rhoades; Brendon Patrick,9,0,15,6
1668400341591,MATH 268,A00,098042,Buss; Samuel R,10,0,10,0
1668400342017,MATH 269,A00,098043,Rhoades; Brendon Patrick,10,0,10,0
1668400342441,MATH 270B,A00,098044,Li; Bo,10,0,15,5
1668400342869,MATH 272B,A00,098045,Holst; Michael J,13,0,15,2
1668400343293,MATH 273A,A00,098046,Tian; Xiaochuan,10,0,15,5
1668400343718,MATH 275,A01,098048,Tian; Xiaochuan,6,0,10,4
1668400344143,MATH 278A,A00,098049,Holst; Michael J,8,0,10,2
1668400344584,MATH 278B,A00,098050,Cloninger; Alexander,10,0,10,0
1668400345007,MATH 278C,A00,098051,Nie; Jiawang,6,0,10,4
1668400345429,MATH 280B,A00,098052,Zheng; Tianyi,8,0,15,7
1668400345855,MATH 281B,A00,098053,Bradic; Jelena,0,0,15,15
1668400346284,MATH 282B,A00,098054,Arias-Castro; Ery,0,0,15,15
1668400346719,MATH 285,A00,098055,Fitzsimmons; Patrick J,0,0,15,17
1668400347144,MATH 287B,A00,098056,Arias-Castro; Ery,2,0,15,13
1668400347581,MATH 288,A00,098057,Agarwal; Pooja,9,0,10,1
1668400347581,MATH 288,B00,098058,Zhang; Danna,8,0,10,2
1668400347581,MATH 288,C00,098059,Williams; Ruth J,9,0,10,1
1668400348013,MATH 290B,A00,098060,Roberts; Justin Deritter,13,0,15,2
1668400348436,MATH 292,A00,098061,Belmont; Eva Kinoshita,10,0,10,0
1668400348861,MATH 295,A00,098062,Suk; Andrew Hoon,48,0,50,2
1668400349282,MATH 296,A00,098063,Novak; Jonathan I,20,0,20,0
1668400349706,MATH 297,001,098064,Gamst; Anthony Collins,9997,0,9999,2
1668400850248,COGS 205,A00,101395,Chiba; Andrea,19,0,20,1
1668400850672,COGS 210B,001,101404,Greene; Deanna Jacquelyn,9998,0,9999,1
1668400850672,COGS 210B,002,101417,Xia; Haijun,9999,0,9999,0
1668400850672,COGS 210B,003,101422,Nitz; Douglas A.,9999,0,9999,0
1668400850672,COGS 210B,004,101423,Hollan; James D.,9998,0,9999,1
1668400850672,COGS 210B,005,101424,Deak; Gedeon O.,9998,0,9999,1
1668400850672,COGS 210B,006,101425,Rossano; Federico,9999,0,9999,0
1668400851110,COGS 211B,A00,101427,Coulson; Seana M,9996,0,9999,3
1668400851545,COGS 220,A00,101428,Hollan; James D.,0,0,25,25
1668400851969,COGS 229,A00,101429,Dow; Steven P,18,0,25,7
1668400852393,COGS 230,A00,101430,Klemmer; Scott R,11,0,17,6
1668400852819,COGS 234,A00,101431,Xia; Haijun,1,0,25,24
1668400853251,COGS 260,A00,101432,Kiyonaga; Anastasia,21,0,25,4
1668400853251,COGS 260,B00,101433,Kirsh; David Joel,15,0,25,10
1668400853677,CSE 202,A00,102371,Impagliazzo; Russell,0,0,0,0
1668400854102,CSE 203B,A01,102373,Cheng; Chung Kuan,0,0,0,0
1668400854545,CSE 208,A00,102374,Micciancio; Daniele,0,0,0,0
1668400854986,CSE 209A,A00,112895,Impagliazzo; Russell,0,0,15,15
1668400855409,CSE 209B,A00,108005,Bellare; Mihir,0,0,0,0
1668400855831,CSE 210,A00,113163,Coblenz; Michael J,0,0,0,0
1668400856256,CSE 219,A00,106111,Dow; Steven P,0,0,20,20
1668400856682,CSE 221,A00,102376,Voelker; Geoffrey M.,0,0,0,0
1668400857107,CSE 224,A01,102378,Porter; George M,0,0,0,0
1668400857537,CSE 229A,A00,102379,Savage; Stefan,0,0,0,0
1668400857961,CSE 229C,A00,102380,Munyaka; Imani N. S.,0,0,0,0
1668400858395,CSE 232B,A00,102382,Deutsch; Alin Bernard,0,0,0,0
1668400858820,CSE 234,A01,112904,Kumar; Arun Kumar,0,0,0,0
1668400859246,CSE 237A,A00,102383,Rosing; Tajana Simunic,0,0,0,0
1668400859672,CSE 239A,A00,102384,Deutsch; Alin Bernard,0,0,0,0
1668400860099,CSE 239B,A00,102385,Polikarpova; Nadezhda,0,0,0,0
1668400860525,CSE 240A,A00,102386,Pannuto; Patrick William,0,0,0,0
1668400860949,CSE 240B,A00,102387,Zhao; Jishen,0,0,0,0
1668400861387,CSE 241A,A00,106406,Kang; Mingu,0,0,0,0
1668400861809,CSE 249B,A00,102388,Kahng; Andrew Byun,0,0,8,8
1668400862233,CSE 251B,A01,102392,Cottrell; Garrison W,0,0,0,0
1668400862233,CSE 251B,A02,102393,Cottrell; Garrison W,0,0,0,0
1668400862666,CSE 252B,A00,102394,Ochoa; Benjamin Lawrence,0,0,0,0
1668400863093,CSE 257,A01,102396,Gao; Sicun,0,0,0,0
1668400863536,CSE 272,A00,102397,Li; Tzumao,0,0,0,0
1668400863960,CSE 274,A00,111323,Chern; Albert Ren-Haur,0,0,0,0
1668400864395,CSE 282,A00,102398,Pevzner; Pavel Arkadjevich,0,0,0,0
1668400864820,CSE 284,A00,114175,Gymrek; Melissa Ann,0,0,0,0
1668400865248,CSE 290,A00,102399,Chandraker; Manmohan Krishna,0,0,0,0
1668400865248,CSE 290,B00,102400,Vaccaro; Kristen Marie,0,0,25,25
1668400865248,CSE 290,C00,102414,Pannuto; Patrick William,0,0,25,25
1668400865248,CSE 290,D00,102427,Pevzner; Pavel Arkadjevich,0,0,0,0
1668400865248,CSE 290,E00,102429,Zhao; Jishen,0,0,0,0
1668400865248,CSE 290,F00,102436,Tullsen; Dean Michael,0,0,0,0
1668400865248,CSE 290,G00,102440,Christensen; Henrik I,0,0,20,20
1668400865684,CSE 291,A00,102443,Su; Hao,0,0,0,0
1668400865684,CSE 291,B00,102448,Polikarpova; Nadezhda,0,0,0,0
1668400865684,CSE 291,C00,102453,Vaccaro; Kristen Marie,0,0,0,0
1668400865684,CSE 291,D00,111343,Savage; Stefan,0,0,0,0
1668400865684,CSE 291,E00,116474,Claffy; Kimberly Claire,0,0,0,0
1668400865684,CSE 291,F00,116479,Pasquale; Joseph,0,0,0,0
1668400866122,CSE 293,001,119111,Bafna; Vineet,9999,0,9999,0
1668400866122,CSE 293,002,119118,Bellare; Mihir,9999,0,9999,0
1668400866122,CSE 293,003,119122,Berg-Kirkpatrick; Taylor D,9999,0,9999,0
1668400866122,CSE 293,004,119135,Christensen; Henrik I,9999,0,9999,0
1668400866122,CSE 293,005,119142,Cottrell; Garrison W,9999,0,9999,0
1668400866122,CSE 293,006,119146,Deutsch; Alin Bernard,9999,0,9999,0
1668400866122,CSE 293,007,119159,Esmaeilzadeh; Hadi,9999,0,9999,0
1668400866122,CSE 293,008,119166,Freund; Yoav,9999,0,9999,0
1668400866122,CSE 293,009,119170,Griswold; William G.,9999,0,9999,0
1668400866122,CSE 293,010,119183,Gymrek; Melissa Ann,9999,0,9999,0
1668400866122,CSE 293,011,119190,Heninger; Nadia A,9999,0,9999,0
1668400866122,CSE 293,012,119230,Impagliazzo; Russell,9999,0,9999,0
1668400866122,CSE 293,013,119232,Jhala; Ranjit,9999,0,9999,0
1668400866122,CSE 293,014,119233,Kahng; Andrew Byun,9999,0,9999,0
1668400866122,CSE 293,015,119298,Kane; Daniel Mertz,9999,0,9999,0
1668400866122,CSE 293,016,119299,Kriegman; David J,9999,0,9999,0
1668400866122,CSE 293,017,119300,Kumar; Arun Kumar,9999,0,9999,0
1668400866122,CSE 293,018,119301,Lerner; Sorin,9999,0,9999,0
1668400866122,CSE 293,019,119302,Lovett; Shachar,9999,0,9999,0
1668400866122,CSE 293,020,119303,McAuley; Julian John,9999,0,9999,0
1668400866122,CSE 293,021,119304,Micciancio; Daniele,9999,0,9999,0
1668400866122,CSE 293,022,119367,Orailoglu; Alex,9999,0,9999,0
1668400866122,CSE 293,023,119382,Paturi; Ramamohan,9999,0,9999,0
1668400866122,CSE 293,024,119404,Polikarpova; Nadezhda,9999,0,9999,0
1668400866122,CSE 293,025,119406,Politz; Joseph Gibbs,9999,0,9999,0
1668400866122,CSE 293,026,119411,Porter; George M,9999,0,9999,0
1668400866122,CSE 293,027,119414,Porter; Leonard Emerson,9999,0,9999,0
1668400866122,CSE 293,028,119416,Ramamoorthi; Ravi,9999,0,9999,0
1668400866122,CSE 293,029,119417,Sahoo; Debashis,9999,0,9999,0
1668400866122,CSE 293,030,119420,Saul; Lawrence,9999,0,9999,0
1668400866122,CSE 293,031,119421,Savage; Stefan,9999,0,9999,0
1668400866122,CSE 293,032,119425,Schulze; Jurgen P.,9999,0,9999,0
1668400866122,CSE 293,033,119426,Snoeren; Alex C.,9999,0,9999,0
1668400866122,CSE 293,034,119428,Shang; Jingbo,9999,0,9999,0
1668400866122,CSE 293,035,119430,Stefan; Deian,9999,0,9999,0
1668400866122,CSE 293,036,119431,Su; Hao,9999,0,9999,0
1668400866122,CSE 293,037,119433,Swanson; Steven James,9999,0,9999,0
1668400866122,CSE 293,038,119435,Tullsen; Dean Michael,9999,0,9999,0
1668400866122,CSE 293,039,119483,Voelker; Geoffrey M.,9999,0,9999,0
1668400866122,CSE 293,040,119537,Zhao; Jishen,9999,0,9999,0
1668400866122,CSE 293,041,119538,Zhou; Yuan-Yuan,9999,0,9999,0
1668400866122,CSE 293,042,119539,Gao; Sicun,9999,0,9999,0
1668400866122,CSE 293,043,119540,Weibel; Nadir,9999,0,9999,0
1668400866122,CSE 293,044,119541,Gupta; Rajesh K.,9999,0,9999,0
1668400866122,CSE 293,045,126410,Vaccaro; Kristen Marie,9999,0,9999,0
1668400866122,CSE 293,046,126411,Klemke; Richard,9999,0,9999,0
1668400866557,CSE 294,A00,102459,Voelker; Geoffrey M.,0,0,0,0
1668400866557,CSE 294,B00,111322,Orailoglu; Alex,0,0,0,0
1668400866980,DSE 201,A00,096914,Deutsch; Alin Bernard,30,0,30,0
1668400867404,DSE 210,A00,096915,Dasgupta; Sanjoy,30,0,30,0
1668400867833,DSE 260A,A00,096916,Altintas De Callaf; Ilkay,30,0,30,0
1668400868261,ECE 200,001,103586,Antipa; Nicholas A,9999,0,9999,0
1668400868261,ECE 200,002,103587,Atanasov; Nikolay A.,9999,0,9999,0
1668400868261,ECE 200,003,103588,Bharadia; Dinesh,9999,0,9999,0
1668400868261,ECE 200,004,103589,Cheng; Chung Kuan,9999,0,9999,0
1668400868261,ECE 200,005,103590,Cosman; Pamela C.,9999,0,9999,0
1668400868261,ECE 200,006,103591,Dayeh; Shadi Ahmad,9999,0,9999,0
1668400868261,ECE 200,007,103592,Fainman; Yeshaiahu,9999,0,9999,0
1668400868261,ECE 200,008,103593,Ford; Joseph Earl,9999,0,9999,0
1668400868261,ECE 200,009,103594,Franceschetti; Massimo,9999,0,9999,0
1668400868261,ECE 200,010,103595,Fullerton; Eric E,9999,0,9999,0
1668400868261,ECE 200,011,103596,Galton; Ian A,9999,0,9999,0
1668400868261,ECE 200,012,103597,Gilja; Vikash,9999,0,9999,0
1668400868261,ECE 200,013,103598,Hall; Drew A.,9999,0,9999,0
1668400868261,ECE 200,014,103599,Hsueh; Tzu-Chien,9999,0,9999,0
1668400868261,ECE 200,015,103600,Javidi; Tara,9999,0,9999,0
1668400868261,ECE 200,016,103601,Kahng; Andrew Byun,9999,0,9999,0
1668400868261,ECE 200,017,103602,Kim; Young-Han,9999,0,9999,0
1668400868261,ECE 200,018,103603,Koushanfar; Farinaz,9999,0,9999,0
1668400868261,ECE 200,019,103604,Kuzum; Duygu,9999,0,9999,0
1668400868261,ECE 200,020,103605,Le; Hanh-Phuc,9999,0,9999,0
1668400868261,ECE 200,021,103606,Lin; Bill,9999,0,9999,0
1668400868261,ECE 200,022,103607,Liu; Zhaowei,9998,0,9999,1
1668400868261,ECE 200,023,103608,Lo; Yu-Hwa,9999,0,9999,0
1668400868261,ECE 200,024,103609,Lomakin; Vitaliy,9999,0,9999,0
1668400868261,ECE 200,025,103610,Mercier; Patrick Philip,9999,0,9999,0
1668400868261,ECE 200,026,103611,Meyer; Florian,9999,0,9999,0
1668400868261,ECE 200,027,103612,Milstein; Laurence B.,9999,0,9999,0
1668400868261,ECE 200,028,103613,Mir Arabbaygi; Siavash,9999,0,9999,0
1668400868261,ECE 200,029,103614,Mookherjea; Shayan,9999,0,9999,0
1668400868261,ECE 200,030,103615,Morris; Karcher William,9999,0,9999,0
1668400868261,ECE 200,031,103616,Ng; Tse Nga,9999,0,9999,0
1668400868261,ECE 200,032,103617,Nguyen; Truong Quang,9999,0,9999,0
1668400868261,ECE 200,033,103618,Nomura; Kenji,9999,0,9999,0
1668400868261,ECE 200,034,103619,Orlitsky; Alon,9999,0,9999,0
1668400868261,ECE 200,035,103620,Pal; Piya,9999,0,9999,0
1668400868261,ECE 200,036,103621,Papen; George C.,9999,0,9999,0
1668400868261,ECE 200,037,103622,Radic; Stojan,9999,0,9999,0
1668400868261,ECE 200,038,103623,Rao; Bhaskar D.,9999,0,9999,0
1668400868261,ECE 200,039,103624,Rao; Ramesh R,9999,0,9999,0
1668400868261,ECE 200,040,103625,Rebeiz; Gabriel,9999,0,9999,0
1668400868261,ECE 200,041,103626,Sanford; John R,9999,0,9999,0
1668400868261,ECE 200,042,103627,Siegel; Paul H.,9999,0,9999,0
1668400868261,ECE 200,043,103628,Sievenpiper; Daniel F.,9999,0,9999,0
1668400868261,ECE 200,044,103629,Sworder; David D.,9999,0,9999,0
1668400868261,ECE 200,045,103630,Taur; Yuan,9999,0,9999,0
1668400868261,ECE 200,046,103631,Touri; Behrouz,9999,0,9999,0
1668400868261,ECE 200,047,103632,Trivedi; Mohan M.,9999,0,9999,0
1668400868261,ECE 200,048,103633,Vasconcelos; Nuno,9999,0,9999,0
1668400868261,ECE 200,049,103634,Wang; Xiaolong,9999,0,9999,0
1668400868261,ECE 200,050,103635,Xie; Pengtao,9999,0,9999,0
1668400868261,ECE 200,051,103636,Yip; Michael,9999,0,9999,0
1668400868261,ECE 200,052,103637,Zeger; Kenneth A.,999,0,999,0
1668400868261,ECE 200,053,103638,Zhang; Xinyu,9999,0,9999,0
1668400868261,ECE 200,054,103639,Turakhia; Yatish Girish,9999,0,9999,0
1668400868261,ECE 200,055,103640,Kang; Mingu,9999,0,9999,0
1668400868261,ECE 200,056,103641,Shi; Yuanyuan,9999,0,9999,0
1668400868261,ECE 200,057,103642,Wang; Edward Jay,9999,0,9999,0
1668400868261,ECE 200,058,103643,Zheng; Yang,9999,0,9999,0
1668400868688,ECE 202,A00,103644,Kuzum; Duygu,0,0,0,0
1668400869114,ECE 212BN,A00,103646,Ng; Tse Nga,0,0,0,0
1668400869536,ECE 221,A00,111493,Staff,0,0,0,0
1668400869959,ECE 222B,A00,103647,Lomakin; Vitaliy,0,0,0,0
1668400870384,ECE 230B,A00,103648,Taur; Yuan,0,0,0,0
1668400870809,ECE 238B,A00,103649,Garay; Javier,0,0,0,0
1668400871237,ECE 240B,A00,112900,Fainman; Yeshaiahu,0,0,0,0
1668400871660,ECE 247A,A00,103650,Jokerst; Jesse Vincent,0,0,0,0
1668400872083,ECE 247B,A00,103651,Wang; Joseph,0,0,0,0
1668400872509,ECE 250,A00,103652,Siegel; Paul H.,0,0,0,0
1668400872936,ECE 251A,A00,103654,Rao; Bhaskar D.,0,0,0,0
1668400873364,ECE 257B,A00,103655,Bharadia; Dinesh,0,0,0,0
1668400873789,ECE 258A,A00,103656,Milstein; Laurence B.,0,0,0,0
1668400874220,ECE 260B,A00,103658,Kang; Mingu,0,0,0,0
1668400874646,ECE 264A,A00,103659,Galton; Ian A,0,0,0,0
1668400875070,ECE 265A,A00,103661,Gudem; Prasad S.S.,0,0,0,0
1668400875496,ECE 265D,A00,103662,Gudem; Prasad S.S.,0,0,0,0
1668400875920,ECE 268,A00,103663,Koushanfar; Farinaz,0,0,0,0
1668400876347,ECE 269,A01,103665,Pal; Piya,0,0,0,0
1668400876771,ECE 271B,A00,103666,Vasconcelos; Manuela,0,0,0,0
1668400877198,ECE 276A,A00,103667,Atanasov; Nikolay A.,0,0,0,0
1668400877624,ECE 277,A00,103668,An; Cheolhong,0,0,0,0
1668400878047,ECE 279,A00,117947,Hall; Drew A.,0,0,0,0
1668400878900,ECE 283,A00,103670,Hsueh; Tzu-Chien,0,0,0,0
1668400879326,ECE 284,A00,103671,Turakhia; Yatish Girish,0,0,0,0
1668400879749,ECE 285,A00,103672,Zheng; Yang,0,0,0,0
1668400879749,ECE 285,B00,103673,Sworder; David D.,0,0,0,0
1668400880176,ECE 287,A00,103676,Javidi; Tara,0,0,0,0
1668400880680,MATH 200B,A00,098023,Salehi Golsefidy; Alireza,12,0,15,3
1668400881104,MATH 202B,A00,098024,Rhoades; Brendon Patrick,9,0,15,6
1668400881536,MATH 203B,A00,098025,Oprea; Dragos N.,10,0,15,5
1668400881964,MATH 204B,A00,098026,Sorensen; Claus M,13,0,15,2
1668400882395,MATH 208,A00,098027,Izadi; Elham,7,0,10,3
1668400882821,MATH 209,A00,098028,Pollack; Aaron,10,0,10,0
1668400883246,MATH 211A,A00,112919,Rogalski; Daniel,9,0,10,1
1668400883672,MATH 211B,A00,112920,Seward; Brandon M.,9,0,10,1
1668400884096,MATH 218,A00,098029,Li; Bo,10,0,10,0
1668400884521,MATH 220B,A00,098030,Novak; Jonathan I,11,0,15,4
1668400884945,MATH 221A,A00,098031,Ebenfelt; Peter F,13,0,15,2
1668400885383,MATH 231B,A00,098032,Zlatos; Andrej,12,0,15,3
1668400885808,MATH 240B,A00,098033,Ni; Lei,9,0,15,6
1668400886231,MATH 243,A00,098034,Jekel; David Andrew,10,0,10,0
1668400886655,MATH 245A,A00,098035,Nie; Jiawang,0,0,15,16
1668400887079,MATH 248,A00,098036,Bejenaru; Ioan,10,0,10,0
1668400887507,MATH 250B,A00,098037,Spolaor; Luca,14,0,15,1
1668400887943,MATH 258,A00,098038,Ni; Lei,10,0,10,0
1668400888375,MATH 264B,A00,098041,Rhoades; Brendon Patrick,9,0,15,6
1668400888799,MATH 268,A00,098042,Buss; Samuel R,10,0,10,0
1668400889220,MATH 269,A00,098043,Rhoades; Brendon Patrick,10,0,10,0
1668400889645,MATH 270B,A00,098044,Li; Bo,10,0,15,5
1668400890071,MATH 272B,A00,098045,Holst; Michael J,13,0,15,2
1668400890508,MATH 273A,A00,098046,Tian; Xiaochuan,10,0,15,5
1668400890940,MATH 275,A01,098048,Tian; Xiaochuan,6,0,10,4
1668400891369,MATH 278A,A00,098049,Holst; Michael J,8,0,10,2
1668400891805,MATH 278B,A00,098050,Cloninger; Alexander,10,0,10,0
1668400892230,MATH 278C,A00,098051,Nie; Jiawang,6,0,10,4
1668400892654,MATH 280B,A00,098052,Zheng; Tianyi,8,0,15,7
1668400893090,MATH 281B,A00,098053,Bradic; Jelena,0,0,15,15
1668400893512,MATH 282B,A00,098054,Arias-Castro; Ery,0,0,15,15
1668400893936,MATH 285,A00,098055,Fitzsimmons; Patrick J,0,0,15,17
1668400894365,MATH 287B,A00,098056,Arias-Castro; Ery,2,0,15,13
1668400894792,MATH 288,A00,098057,Agarwal; Pooja,9,0,10,1
1668400894792,MATH 288,B00,098058,Zhang; Danna,8,0,10,2
1668400894792,MATH 288,C00,098059,Williams; Ruth J,9,0,10,1
1668400895216,MATH 290B,A00,098060,Roberts; Justin Deritter,13,0,15,2
1668400895641,MATH 292,A00,098061,Belmont; Eva Kinoshita,10,0,10,0
1668400896066,MATH 295,A00,098062,Suk; Andrew Hoon,48,0,50,2
1668400896490,MATH 296,A00,098063,Novak; Jonathan I,20,0,20,0
1668400896917,MATH 297,001,098064,Gamst; Anthony Collins,9997,0,9999,2
1668401396971,COGS 205,A00,101395,Chiba; Andrea,19,0,20,1
1668401397395,COGS 210B,001,101404,Greene; Deanna Jacquelyn,9998,0,9999,1
1668401397395,COGS 210B,002,101417,Xia; Haijun,9999,0,9999,0
1668401397395,COGS 210B,003,101422,Nitz; Douglas A.,9999,0,9999,0
1668401397395,COGS 210B,004,101423,Hollan; James D.,9998,0,9999,1
1668401397395,COGS 210B,005,101424,Deak; Gedeon O.,9998,0,9999,1
1668401397395,COGS 210B,006,101425,Rossano; Federico,9999,0,9999,0
1668401397824,COGS 211B,A00,101427,Coulson; Seana M,9996,0,9999,3
1668401398245,COGS 220,A00,101428,Hollan; James D.,0,0,25,25
1668401398670,COGS 229,A00,101429,Dow; Steven P,18,0,25,7
1668401399094,COGS 230,A00,101430,Klemmer; Scott R,11,0,17,6
1668401399517,COGS 234,A00,101431,Xia; Haijun,1,0,25,24
1668401399955,COGS 260,A00,101432,Kiyonaga; Anastasia,21,0,25,4
1668401399955,COGS 260,B00,101433,Kirsh; David Joel,15,0,25,10
1668401400381,CSE 202,A00,102371,Impagliazzo; Russell,0,0,0,0
1668401400883,CSE 203B,A01,102373,Cheng; Chung Kuan,0,0,0,0
1668401401317,CSE 208,A00,102374,Micciancio; Daniele,0,0,0,0
1668401401741,CSE 209A,A00,112895,Impagliazzo; Russell,0,0,15,15
1668401402163,CSE 209B,A00,108005,Bellare; Mihir,0,0,0,0
1668401402589,CSE 210,A00,113163,Coblenz; Michael J,0,0,0,0
1668401403012,CSE 219,A00,106111,Dow; Steven P,0,0,20,20
1668401403437,CSE 221,A00,102376,Voelker; Geoffrey M.,0,0,0,0
1668401403863,CSE 224,A01,102378,Porter; George M,0,0,0,0
1668401404286,CSE 229A,A00,102379,Savage; Stefan,0,0,0,0
1668401404713,CSE 229C,A00,102380,Munyaka; Imani N. S.,0,0,0,0
1668401405139,CSE 232B,A00,102382,Deutsch; Alin Bernard,0,0,0,0
1668401405564,CSE 234,A01,112904,Kumar; Arun Kumar,0,0,0,0
1668401405998,CSE 237A,A00,102383,Rosing; Tajana Simunic,0,0,0,0
1668401406422,CSE 239A,A00,102384,Deutsch; Alin Bernard,0,0,0,0
1668401406857,CSE 239B,A00,102385,Polikarpova; Nadezhda,0,0,0,0
1668401407284,CSE 240A,A00,102386,Pannuto; Patrick William,0,0,0,0
1668401407718,CSE 240B,A00,102387,Zhao; Jishen,0,0,0,0
1668401408141,CSE 241A,A00,106406,Kang; Mingu,0,0,0,0
1668401408565,CSE 249B,A00,102388,Kahng; Andrew Byun,0,0,8,8
1668401408987,CSE 251B,A01,102392,Cottrell; Garrison W,0,0,0,0
1668401408987,CSE 251B,A02,102393,Cottrell; Garrison W,0,0,0,0
1668401409420,CSE 252B,A00,102394,Ochoa; Benjamin Lawrence,0,0,0,0
1668401409849,CSE 257,A01,102396,Gao; Sicun,0,0,0,0
1668401410274,CSE 272,A00,102397,Li; Tzumao,0,0,0,0
1668401410699,CSE 274,A00,111323,Chern; Albert Ren-Haur,0,0,0,0
1668401411122,CSE 282,A00,102398,Pevzner; Pavel Arkadjevich,0,0,0,0
1668401411557,CSE 284,A00,114175,Gymrek; Melissa Ann,0,0,0,0
1668401411996,CSE 290,A00,102399,Chandraker; Manmohan Krishna,0,0,0,0
1668401411996,CSE 290,B00,102400,Vaccaro; Kristen Marie,0,0,25,25
1668401411996,CSE 290,C00,102414,Pannuto; Patrick William,0,0,25,25
1668401411996,CSE 290,D00,102427,Pevzner; Pavel Arkadjevich,0,0,0,0
1668401411996,CSE 290,E00,102429,Zhao; Jishen,0,0,0,0
1668401411996,CSE 290,F00,102436,Tullsen; Dean Michael,0,0,0,0
1668401411996,CSE 290,G00,102440,Christensen; Henrik I,0,0,20,20
1668401412436,CSE 291,A00,102443,Su; Hao,0,0,0,0
1668401412436,CSE 291,B00,102448,Polikarpova; Nadezhda,0,0,0,0
1668401412436,CSE 291,C00,102453,Vaccaro; Kristen Marie,0,0,0,0
1668401412436,CSE 291,D00,111343,Savage; Stefan,0,0,0,0
1668401412436,CSE 291,E00,116474,Claffy; Kimberly Claire,0,0,0,0
1668401412436,CSE 291,F00,116479,Pasquale; Joseph,0,0,0,0
1668401412877,CSE 293,001,119111,Bafna; Vineet,9999,0,9999,0
1668401412877,CSE 293,002,119118,Bellare; Mihir,9999,0,9999,0
1668401412877,CSE 293,003,119122,Berg-Kirkpatrick; Taylor D,9999,0,9999,0
1668401412877,CSE 293,004,119135,Christensen; Henrik I,9999,0,9999,0
1668401412877,CSE 293,005,119142,Cottrell; Garrison W,9999,0,9999,0
1668401412877,CSE 293,006,119146,Deutsch; Alin Bernard,9999,0,9999,0
1668401412877,CSE 293,007,119159,Esmaeilzadeh; Hadi,9999,0,9999,0
1668401412877,CSE 293,008,119166,Freund; Yoav,9999,0,9999,0
1668401412877,CSE 293,009,119170,Griswold; William G.,9999,0,9999,0
1668401412877,CSE 293,010,119183,Gymrek; Melissa Ann,9999,0,9999,0
1668401412877,CSE 293,011,119190,Heninger; Nadia A,9999,0,9999,0
1668401412877,CSE 293,012,119230,Impagliazzo; Russell,9999,0,9999,0
1668401412877,CSE 293,013,119232,Jhala; Ranjit,9999,0,9999,0
1668401412877,CSE 293,014,119233,Kahng; Andrew Byun,9999,0,9999,0
1668401412877,CSE 293,015,119298,Kane; Daniel Mertz,9999,0,9999,0
1668401412877,CSE 293,016,119299,Kriegman; David J,9999,0,9999,0
1668401412877,CSE 293,017,119300,Kumar; Arun Kumar,9999,0,9999,0
1668401412877,CSE 293,018,119301,Lerner; Sorin,9999,0,9999,0
1668401412877,CSE 293,019,119302,Lovett; Shachar,9999,0,9999,0
1668401412877,CSE 293,020,119303,McAuley; Julian John,9999,0,9999,0
1668401412877,CSE 293,021,119304,Micciancio; Daniele,9999,0,9999,0
1668401412877,CSE 293,022,119367,Orailoglu; Alex,9999,0,9999,0
1668401412877,CSE 293,023,119382,Paturi; Ramamohan,9999,0,9999,0
1668401412877,CSE 293,024,119404,Polikarpova; Nadezhda,9999,0,9999,0
1668401412877,CSE 293,025,119406,Politz; Joseph Gibbs,9999,0,9999,0
1668401412877,CSE 293,026,119411,Porter; George M,9999,0,9999,0
1668401412877,CSE 293,027,119414,Porter; Leonard Emerson,9999,0,9999,0
1668401412877,CSE 293,028,119416,Ramamoorthi; Ravi,9999,0,9999,0
1668401412877,CSE 293,029,119417,Sahoo; Debashis,9999,0,9999,0
1668401412877,CSE 293,030,119420,Saul; Lawrence,9999,0,9999,0
1668401412877,CSE 293,031,119421,Savage; Stefan,9999,0,9999,0
1668401412877,CSE 293,032,119425,Schulze; Jurgen P.,9999,0,9999,0
1668401412877,CSE 293,033,119426,Snoeren; Alex C.,9999,0,9999,0
1668401412877,CSE 293,034,119428,Shang; Jingbo,9999,0,9999,0
1668401412877,CSE 293,035,119430,Stefan; Deian,9999,0,9999,0
1668401412877,CSE 293,036,119431,Su; Hao,9999,0,9999,0
1668401412877,CSE 293,037,119433,Swanson; Steven James,9999,0,9999,0
1668401412877,CSE 293,038,119435,Tullsen; Dean Michael,9999,0,9999,0
1668401412877,CSE 293,039,119483,Voelker; Geoffrey M.,9999,0,9999,0
1668401412877,CSE 293,040,119537,Zhao; Jishen,9999,0,9999,0
1668401412877,CSE 293,041,119538,Zhou; Yuan-Yuan,9999,0,9999,0
1668401412877,CSE 293,042,119539,Gao; Sicun,9999,0,9999,0
1668401412877,CSE 293,043,119540,Weibel; Nadir,9999,0,9999,0
1668401412877,CSE 293,044,119541,Gupta; Rajesh K.,9999,0,9999,0
1668401412877,CSE 293,045,126410,Vaccaro; Kristen Marie,9999,0,9999,0
1668401412877,CSE 293,046,126411,Klemke; Richard,9999,0,9999,0
1668401413303,CSE 294,A00,102459,Voelker; Geoffrey M.,0,0,0,0
1668401413303,CSE 294,B00,111322,Orailoglu; Alex,0,0,0,0
1668401413725,DSE 201,A00,096914,Deutsch; Alin Bernard,30,0,30,0
1668401414164,DSE 210,A00,096915,Dasgupta; Sanjoy,30,0,30,0
1668401414587,DSE 260A,A00,096916,Altintas De Callaf; Ilkay,30,0,30,0
1668401415021,ECE 200,001,103586,Antipa; Nicholas A,9999,0,9999,0
1668401415021,ECE 200,002,103587,Atanasov; Nikolay A.,9999,0,9999,0
1668401415021,ECE 200,003,103588,Bharadia; Dinesh,9999,0,9999,0
1668401415021,ECE 200,004,103589,Cheng; Chung Kuan,9999,0,9999,0
1668401415021,ECE 200,005,103590,Cosman; Pamela C.,9999,0,9999,0
1668401415021,ECE 200,006,103591,Dayeh; Shadi Ahmad,9999,0,9999,0
1668401415021,ECE 200,007,103592,Fainman; Yeshaiahu,9999,0,9999,0
1668401415021,ECE 200,008,103593,Ford; Joseph Earl,9999,0,9999,0
1668401415021,ECE 200,009,103594,Franceschetti; Massimo,9999,0,9999,0
1668401415021,ECE 200,010,103595,Fullerton; Eric E,9999,0,9999,0
1668401415021,ECE 200,011,103596,Galton; Ian A,9999,0,9999,0
1668401415021,ECE 200,012,103597,Gilja; Vikash,9999,0,9999,0
1668401415021,ECE 200,013,103598,Hall; Drew A.,9999,0,9999,0
1668401415021,ECE 200,014,103599,Hsueh; Tzu-Chien,9999,0,9999,0
1668401415021,ECE 200,015,103600,Javidi; Tara,9999,0,9999,0
1668401415021,ECE 200,016,103601,Kahng; Andrew Byun,9999,0,9999,0
1668401415021,ECE 200,017,103602,Kim; Young-Han,9999,0,9999,0
1668401415021,ECE 200,018,103603,Koushanfar; Farinaz,9999,0,9999,0
1668401415021,ECE 200,019,103604,Kuzum; Duygu,9999,0,9999,0
1668401415021,ECE 200,020,103605,Le; Hanh-Phuc,9999,0,9999,0
1668401415021,ECE 200,021,103606,Lin; Bill,9999,0,9999,0
1668401415021,ECE 200,022,103607,Liu; Zhaowei,9998,0,9999,1
1668401415021,ECE 200,023,103608,Lo; Yu-Hwa,9999,0,9999,0
1668401415021,ECE 200,024,103609,Lomakin; Vitaliy,9999,0,9999,0
1668401415021,ECE 200,025,103610,Mercier; Patrick Philip,9999,0,9999,0
1668401415021,ECE 200,026,103611,Meyer; Florian,9999,0,9999,0
1668401415021,ECE 200,027,103612,Milstein; Laurence B.,9999,0,9999,0
1668401415021,ECE 200,028,103613,Mir Arabbaygi; Siavash,9999,0,9999,0
1668401415021,ECE 200,029,103614,Mookherjea; Shayan,9999,0,9999,0
1668401415021,ECE 200,030,103615,Morris; Karcher William,9999,0,9999,0
1668401415021,ECE 200,031,103616,Ng; Tse Nga,9999,0,9999,0
1668401415021,ECE 200,032,103617,Nguyen; Truong Quang,9999,0,9999,0
1668401415021,ECE 200,033,103618,Nomura; Kenji,9999,0,9999,0
1668401415021,ECE 200,034,103619,Orlitsky; Alon,9999,0,9999,0
1668401415021,ECE 200,035,103620,Pal; Piya,9999,0,9999,0
1668401415021,ECE 200,036,103621,Papen; George C.,9999,0,9999,0
1668401415021,ECE 200,037,103622,Radic; Stojan,9999,0,9999,0
1668401415021,ECE 200,038,103623,Rao; Bhaskar D.,9999,0,9999,0
1668401415021,ECE 200,039,103624,Rao; Ramesh R,9999,0,9999,0
1668401415021,ECE 200,040,103625,Rebeiz; Gabriel,9999,0,9999,0
1668401415021,ECE 200,041,103626,Sanford; John R,9999,0,9999,0
1668401415021,ECE 200,042,103627,Siegel; Paul H.,9999,0,9999,0
1668401415021,ECE 200,043,103628,Sievenpiper; Daniel F.,9999,0,9999,0
1668401415021,ECE 200,044,103629,Sworder; David D.,9999,0,9999,0
1668401415021,ECE 200,045,103630,Taur; Yuan,9999,0,9999,0
1668401415021,ECE 200,046,103631,Touri; Behrouz,9999,0,9999,0
1668401415021,ECE 200,047,103632,Trivedi; Mohan M.,9999,0,9999,0
1668401415021,ECE 200,048,103633,Vasconcelos; Nuno,9999,0,9999,0
1668401415021,ECE 200,049,103634,Wang; Xiaolong,9999,0,9999,0
1668401415021,ECE 200,050,103635,Xie; Pengtao,9999,0,9999,0
1668401415021,ECE 200,051,103636,Yip; Michael,9999,0,9999,0
1668401415021,ECE 200,052,103637,Zeger; Kenneth A.,999,0,999,0
1668401415021,ECE 200,053,103638,Zhang; Xinyu,9999,0,9999,0
1668401415021,ECE 200,054,103639,Turakhia; Yatish Girish,9999,0,9999,0
1668401415021,ECE 200,055,103640,Kang; Mingu,9999,0,9999,0
1668401415021,ECE 200,056,103641,Shi; Yuanyuan,9999,0,9999,0
1668401415021,ECE 200,057,103642,Wang; Edward Jay,9999,0,9999,0
1668401415021,ECE 200,058,103643,Zheng; Yang,9999,0,9999,0
1668401415449,ECE 202,A00,103644,Kuzum; Duygu,0,0,0,0
1668401415882,ECE 212BN,A00,103646,Ng; Tse Nga,0,0,0,0
1668401416309,ECE 221,A00,111493,Staff,0,0,0,0
1668401416735,ECE 222B,A00,103647,Lomakin; Vitaliy,0,0,0,0
1668401417158,ECE 230B,A00,103648,Taur; Yuan,0,0,0,0
1668401417583,ECE 238B,A00,103649,Garay; Javier,0,0,0,0
1668401418015,ECE 240B,A00,112900,Fainman; Yeshaiahu,0,0,0,0
1668401418437,ECE 247A,A00,103650,Jokerst; Jesse Vincent,0,0,0,0
1668401418860,ECE 247B,A00,103651,Wang; Joseph,0,0,0,0
1668401419285,ECE 250,A00,103652,Siegel; Paul H.,0,0,0,0
1668401419710,ECE 251A,A00,103654,Rao; Bhaskar D.,0,0,0,0
1668401420133,ECE 257B,A00,103655,Bharadia; Dinesh,0,0,0,0
1668401420558,ECE 258A,A00,103656,Milstein; Laurence B.,0,0,0,0
1668401420983,ECE 260B,A00,103658,Kang; Mingu,0,0,0,0
1668401421408,ECE 264A,A00,103659,Galton; Ian A,0,0,0,0
1668401421830,ECE 265A,A00,103661,Gudem; Prasad S.S.,0,0,0,0
1668401422255,ECE 265D,A00,103662,Gudem; Prasad S.S.,0,0,0,0
1668401422685,ECE 268,A00,103663,Koushanfar; Farinaz,0,0,0,0
1668401423108,ECE 269,A01,103665,Pal; Piya,0,0,0,0
1668401423544,ECE 271B,A00,103666,Vasconcelos; Manuela,0,0,0,0
1668401423966,ECE 276A,A00,103667,Atanasov; Nikolay A.,0,0,0,0
1668401424390,ECE 277,A00,103668,An; Cheolhong,0,0,0,0
1668401424814,ECE 279,A00,117947,Hall; Drew A.,0,0,0,0
1668401425663,ECE 283,A00,103670,Hsueh; Tzu-Chien,0,0,0,0
1668401426101,ECE 284,A00,103671,Turakhia; Yatish Girish,0,0,0,0
1668401426528,ECE 285,A00,103672,Zheng; Yang,0,0,0,0
1668401426528,ECE 285,B00,103673,Sworder; David D.,0,0,0,0
1668401426950,ECE 287,A00,103676,Javidi; Tara,0,0,0,0
1668401427384,MATH 200B,A00,098023,Salehi Golsefidy; Alireza,12,0,15,3
1668401427808,MATH 202B,A00,098024,Rhoades; Brendon Patrick,9,0,15,6
1668401428231,MATH 203B,A00,098025,Oprea; Dragos N.,10,0,15,5
1668401428660,MATH 204B,A00,098026,Sorensen; Claus M,13,0,15,2
1668401429084,MATH 208,A00,098027,Izadi; Elham,7,0,10,3
1668401429508,MATH 209,A00,098028,Pollack; Aaron,10,0,10,0
1668401429930,MATH 211A,A00,112919,Rogalski; Daniel,9,0,10,1
1668401430353,MATH 211B,A00,112920,Seward; Brandon M.,9,0,10,1
1668401430787,MATH 218,A00,098029,Li; Bo,10,0,10,0
1668401431211,MATH 220B,A00,098030,Novak; Jonathan I,11,0,15,4
1668401431636,MATH 221A,A00,098031,Ebenfelt; Peter F,13,0,15,2
1668401432062,MATH 231B,A00,098032,Zlatos; Andrej,12,0,15,3
1668401432486,MATH 240B,A00,098033,Ni; Lei,9,0,15,6
1668401432917,MATH 243,A00,098034,Jekel; David Andrew,10,0,10,0
1668401433342,MATH 245A,A00,098035,Nie; Jiawang,0,0,15,16
1668401433765,MATH 248,A00,098036,Bejenaru; Ioan,10,0,10,0
1668401434190,MATH 250B,A00,098037,Spolaor; Luca,14,0,15,1
1668401434616,MATH 258,A00,098038,Ni; Lei,10,0,10,0
1668401435044,MATH 264B,A00,098041,Rhoades; Brendon Patrick,9,0,15,6
1668401435470,MATH 268,A00,098042,Buss; Samuel R,10,0,10,0
1668401435893,MATH 269,A00,098043,Rhoades; Brendon Patrick,10,0,10,0
1668401436321,MATH 270B,A00,098044,Li; Bo,10,0,15,5
1668401436746,MATH 272B,A00,098045,Holst; Michael J,13,0,15,2
1668401437170,MATH 273A,A00,098046,Tian; Xiaochuan,10,0,15,5
1668401437595,MATH 275,A01,098048,Tian; Xiaochuan,6,0,10,4
1668401438021,MATH 278A,A00,098049,Holst; Michael J,8,0,10,2
1668401438447,MATH 278B,A00,098050,Cloninger; Alexander,10,0,10,0
1668401438871,MATH 278C,A00,098051,Nie; Jiawang,6,0,10,4
1668401439297,MATH 280B,A00,098052,Zheng; Tianyi,8,0,15,7
1668401439722,MATH 281B,A00,098053,Bradic; Jelena,0,0,15,15
1668401440146,MATH 282B,A00,098054,Arias-Castro; Ery,0,0,15,15
1668401440569,MATH 285,A00,098055,Fitzsimmons; Patrick J,0,0,15,17
1668401440995,MATH 287B,A00,098056,Arias-Castro; Ery,2,0,15,13
1668401441420,MATH 288,A00,098057,Agarwal; Pooja,9,0,10,1
1668401441420,MATH 288,B00,098058,Zhang; Danna,8,0,10,2
1668401441420,MATH 288,C00,098059,Williams; Ruth J,9,0,10,1
1668401441846,MATH 290B,A00,098060,Roberts; Justin Deritter,13,0,15,2
1668401442271,MATH 292,A00,098061,Belmont; Eva Kinoshita,10,0,10,0
1668401442694,MATH 295,A00,098062,Suk; Andrew Hoon,48,0,50,2
1668401443123,MATH 296,A00,098063,Novak; Jonathan I,20,0,20,0
1668401443560,MATH 297,001,098064,Gamst; Anthony Collins,9997,0,9999,2
1668401944020,COGS 205,A00,101395,Chiba; Andrea,19,0,20,1
1668401944446,COGS 210B,001,101404,Greene; Deanna Jacquelyn,9998,0,9999,1
1668401944446,COGS 210B,002,101417,Xia; Haijun,9999,0,9999,0
1668401944446,COGS 210B,003,101422,Nitz; Douglas A.,9999,0,9999,0
1668401944446,COGS 210B,004,101423,Hollan; James D.,9998,0,9999,1
1668401944446,COGS 210B,005,101424,Deak; Gedeon O.,9998,0,9999,1
1668401944446,COGS 210B,006,101425,Rossano; Federico,9999,0,9999,0
1668401944869,COGS 211B,A00,101427,Coulson; Seana M,9996,0,9999,3
1668401945291,COGS 220,A00,101428,Hollan; James D.,0,0,25,25
1668401945716,COGS 229,A00,101429,Dow; Steven P,18,0,25,7
1668401946144,COGS 230,A00,101430,Klemmer; Scott R,11,0,17,6
1668401946568,COGS 234,A00,101431,Xia; Haijun,1,0,25,24
1668401946990,COGS 260,A00,101432,Kiyonaga; Anastasia,21,0,25,4
1668401946990,COGS 260,B00,101433,Kirsh; David Joel,15,0,25,10
1668401947414,CSE 202,A00,102371,Impagliazzo; Russell,0,0,0,0
1668401947841,CSE 203B,A01,102373,Cheng; Chung Kuan,0,0,0,0
1668401948270,CSE 208,A00,102374,Micciancio; Daniele,0,0,0,0
1668401948703,CSE 209A,A00,112895,Impagliazzo; Russell,0,0,15,15
1668401949136,CSE 209B,A00,108005,Bellare; Mihir,0,0,0,0
1668401949562,CSE 210,A00,113163,Coblenz; Michael J,0,0,0,0
1668401949998,CSE 219,A00,106111,Dow; Steven P,0,0,20,20
1668401950421,CSE 221,A00,102376,Voelker; Geoffrey M.,0,0,0,0
1668401950843,CSE 224,A01,102378,Porter; George M,0,0,0,0
1668401951269,CSE 229A,A00,102379,Savage; Stefan,0,0,0,0
1668401951690,CSE 229C,A00,102380,Munyaka; Imani N. S.,0,0,0,0
1668401952116,CSE 232B,A00,102382,Deutsch; Alin Bernard,0,0,0,0
1668401952547,CSE 234,A01,112904,Kumar; Arun Kumar,0,0,0,0
1668401952969,CSE 237A,A00,102383,Rosing; Tajana Simunic,0,0,0,0
1668401953395,CSE 239A,A00,102384,Deutsch; Alin Bernard,0,0,0,0
1668401953820,CSE 239B,A00,102385,Polikarpova; Nadezhda,0,0,0,0
1668401954244,CSE 240A,A00,102386,Pannuto; Patrick William,0,0,0,0
1668401954668,CSE 240B,A00,102387,Zhao; Jishen,0,0,0,0
1668401955102,CSE 241A,A00,106406,Kang; Mingu,0,0,0,0
1668401955527,CSE 249B,A00,102388,Kahng; Andrew Byun,0,0,8,8
1668401955954,CSE 251B,A01,102392,Cottrell; Garrison W,0,0,0,0
1668401955954,CSE 251B,A02,102393,Cottrell; Garrison W,0,0,0,0
1668401956380,CSE 252B,A00,102394,Ochoa; Benjamin Lawrence,0,0,0,0
1668401956808,CSE 257,A01,102396,Gao; Sicun,0,0,0,0
1668401957231,CSE 272,A00,102397,Li; Tzumao,0,0,0,0
1668401957663,CSE 274,A00,111323,Chern; Albert Ren-Haur,0,0,0,0
1668401958088,CSE 282,A00,102398,Pevzner; Pavel Arkadjevich,0,0,0,0
1668401958524,CSE 284,A00,114175,Gymrek; Melissa Ann,0,0,0,0
1668401958949,CSE 290,A00,102399,Chandraker; Manmohan Krishna,0,0,0,0
1668401958949,CSE 290,B00,102400,Vaccaro; Kristen Marie,0,0,25,25
1668401958949,CSE 290,C00,102414,Pannuto; Patrick William,0,0,25,25
1668401958949,CSE 290,D00,102427,Pevzner; Pavel Arkadjevich,0,0,0,0
1668401958949,CSE 290,E00,102429,Zhao; Jishen,0,0,0,0
1668401958949,CSE 290,F00,102436,Tullsen; Dean Michael,0,0,0,0
1668401958949,CSE 290,G00,102440,Christensen; Henrik I,0,0,20,20
1668401959374,CSE 291,A00,102443,Su; Hao,0,0,0,0
1668401959374,CSE 291,B00,102448,Polikarpova; Nadezhda,0,0,0,0
1668401959374,CSE 291,C00,102453,Vaccaro; Kristen Marie,0,0,0,0
1668401959374,CSE 291,D00,111343,Savage; Stefan,0,0,0,0
1668401959374,CSE 291,E00,116474,Claffy; Kimberly Claire,0,0,0,0
1668401959374,CSE 291,F00,116479,Pasquale; Joseph,0,0,0,0
1668401959802,CSE 293,001,119111,Bafna; Vineet,9999,0,9999,0
1668401959802,CSE 293,002,119118,Bellare; Mihir,9999,0,9999,0
1668401959802,CSE 293,003,119122,Berg-Kirkpatrick; Taylor D,9999,0,9999,0
1668401959802,CSE 293,004,119135,Christensen; Henrik I,9999,0,9999,0
1668401959802,CSE 293,005,119142,Cottrell; Garrison W,9999,0,9999,0
1668401959802,CSE 293,006,119146,Deutsch; Alin Bernard,9999,0,9999,0
1668401959802,CSE 293,007,119159,Esmaeilzadeh; Hadi,9999,0,9999,0
1668401959802,CSE 293,008,119166,Freund; Yoav,9999,0,9999,0
1668401959802,CSE 293,009,119170,Griswold; William G.,9999,0,9999,0
1668401959802,CSE 293,010,119183,Gymrek; Melissa Ann,9999,0,9999,0
1668401959802,CSE 293,011,119190,Heninger; Nadia A,9999,0,9999,0
1668401959802,CSE 293,012,119230,Impagliazzo; Russell,9999,0,9999,0
1668401959802,CSE 293,013,119232,Jhala; Ranjit,9999,0,9999,0
1668401959802,CSE 293,014,119233,Kahng; Andrew Byun,9999,0,9999,0
1668401959802,CSE 293,015,119298,Kane; Daniel Mertz,9999,0,9999,0
1668401959802,CSE 293,016,119299,Kriegman; David J,9999,0,9999,0
1668401959802,CSE 293,017,119300,Kumar; Arun Kumar,9999,0,9999,0
1668401959802,CSE 293,018,119301,Lerner; Sorin,9999,0,9999,0
1668401959802,CSE 293,019,119302,Lovett; Shachar,9999,0,9999,0
1668401959802,CSE 293,020,119303,McAuley; Julian John,9999,0,9999,0
1668401959802,CSE 293,021,119304,Micciancio; Daniele,9999,0,9999,0
1668401959802,CSE 293,022,119367,Orailoglu; Alex,9999,0,9999,0
1668401959802,CSE 293,023,119382,Paturi; Ramamohan,9999,0,9999,0
1668401959802,CSE 293,024,119404,Polikarpova; Nadezhda,9999,0,9999,0
1668401959802,CSE 293,025,119406,Politz; Joseph Gibbs,9999,0,9999,0
1668401959802,CSE 293,026,119411,Porter; George M,9999,0,9999,0
1668401959802,CSE 293,027,119414,Porter; Leonard Emerson,9999,0,9999,0
1668401959802,CSE 293,028,119416,Ramamoorthi; Ravi,9999,0,9999,0
1668401959802,CSE 293,029,119417,Sahoo; Debashis,9999,0,9999,0
1668401959802,CSE 293,030,119420,Saul; Lawrence,9999,0,9999,0
1668401959802,CSE 293,031,119421,Savage; Stefan,9999,0,9999,0
1668401959802,CSE 293,032,119425,Schulze; Jurgen P.,9999,0,9999,0
1668401959802,CSE 293,033,119426,Snoeren; Alex C.,9999,0,9999,0
1668401959802,CSE 293,034,119428,Shang; Jingbo,9999,0,9999,0
1668401959802,CSE 293,035,119430,Stefan; Deian,9999,0,9999,0
1668401959802,CSE 293,036,119431,Su; Hao,9999,0,9999,0
1668401959802,CSE 293,037,119433,Swanson; Steven James,9999,0,9999,0
1668401959802,CSE 293,038,119435,Tullsen; Dean Michael,9999,0,9999,0
1668401959802,CSE 293,039,119483,Voelker; Geoffrey M.,9999,0,9999,0
1668401959802,CSE 293,040,119537,Zhao; Jishen,9999,0,9999,0
1668401959802,CSE 293,041,119538,Zhou; Yuan-Yuan,9999,0,9999,0
1668401959802,CSE 293,042,119539,Gao; Sicun,9999,0,9999,0
1668401959802,CSE 293,043,119540,Weibel; Nadir,9999,0,9999,0
1668401959802,CSE 293,044,119541,Gupta; Rajesh K.,9999,0,9999,0
1668401959802,CSE 293,045,126410,Vaccaro; Kristen Marie,9999,0,9999,0
1668401959802,CSE 293,046,126411,Klemke; Richard,9999,0,9999,0
1668401960228,CSE 294,A00,102459,Voelker; Geoffrey M.,0,0,0,0
1668401960228,CSE 294,B00,111322,Orailoglu; Alex,0,0,0,0
1668401960650,DSE 201,A00,096914,Deutsch; Alin Bernard,30,0,30,0
1668401961075,DSE 210,A00,096915,Dasgupta; Sanjoy,30,0,30,0
1668401961498,DSE 260A,A00,096916,Altintas De Callaf; Ilkay,30,0,30,0
1668401961929,ECE 200,001,103586,Antipa; Nicholas A,9999,0,9999,0
1668401961929,ECE 200,002,103587,Atanasov; Nikolay A.,9999,0,9999,0
1668401961929,ECE 200,003,103588,Bharadia; Dinesh,9999,0,9999,0
1668401961929,ECE 200,004,103589,Cheng; Chung Kuan,9999,0,9999,0
1668401961929,ECE 200,005,103590,Cosman; Pamela C.,9999,0,9999,0
1668401961929,ECE 200,006,103591,Dayeh; Shadi Ahmad,9999,0,9999,0
1668401961929,ECE 200,007,103592,Fainman; Yeshaiahu,9999,0,9999,0
1668401961929,ECE 200,008,103593,Ford; Joseph Earl,9999,0,9999,0
1668401961929,ECE 200,009,103594,Franceschetti; Massimo,9999,0,9999,0
1668401961929,ECE 200,010,103595,Fullerton; Eric E,9999,0,9999,0
1668401961929,ECE 200,011,103596,Galton; Ian A,9999,0,9999,0
1668401961929,ECE 200,012,103597,Gilja; Vikash,9999,0,9999,0
1668401961929,ECE 200,013,103598,Hall; Drew A.,9999,0,9999,0
1668401961929,ECE 200,014,103599,Hsueh; Tzu-Chien,9999,0,9999,0
1668401961929,ECE 200,015,103600,Javidi; Tara,9999,0,9999,0
1668401961929,ECE 200,016,103601,Kahng; Andrew Byun,9999,0,9999,0
1668401961929,ECE 200,017,103602,Kim; Young-Han,9999,0,9999,0
1668401961929,ECE 200,018,103603,Koushanfar; Farinaz,9999,0,9999,0
1668401961929,ECE 200,019,103604,Kuzum; Duygu,9999,0,9999,0
1668401961929,ECE 200,020,103605,Le; Hanh-Phuc,9999,0,9999,0
1668401961929,ECE 200,021,103606,Lin; Bill,9999,0,9999,0
1668401961929,ECE 200,022,103607,Liu; Zhaowei,9998,0,9999,1
1668401961929,ECE 200,023,103608,Lo; Yu-Hwa,9999,0,9999,0
1668401961929,ECE 200,024,103609,Lomakin; Vitaliy,9999,0,9999,0
1668401961929,ECE 200,025,103610,Mercier; Patrick Philip,9999,0,9999,0
1668401961929,ECE 200,026,103611,Meyer; Florian,9999,0,9999,0
1668401961929,ECE 200,027,103612,Milstein; Laurence B.,9999,0,9999,0
1668401961929,ECE 200,028,103613,Mir Arabbaygi; Siavash,9999,0,9999,0
1668401961929,ECE 200,029,103614,Mookherjea; Shayan,9999,0,9999,0
1668401961929,ECE 200,030,103615,Morris; Karcher William,9999,0,9999,0
1668401961929,ECE 200,031,103616,Ng; Tse Nga,9999,0,9999,0
1668401961929,ECE 200,032,103617,Nguyen; Truong Quang,9999,0,9999,0
1668401961929,ECE 200,033,103618,Nomura; Kenji,9999,0,9999,0
1668401961929,ECE 200,034,103619,Orlitsky; Alon,9999,0,9999,0
1668401961929,ECE 200,035,103620,Pal; Piya,9999,0,9999,0
1668401961929,ECE 200,036,103621,Papen; George C.,9999,0,9999,0
1668401961929,ECE 200,037,103622,Radic; Stojan,9999,0,9999,0
1668401961929,ECE 200,038,103623,Rao; Bhaskar D.,9999,0,9999,0
1668401961929,ECE 200,039,103624,Rao; Ramesh R,9999,0,9999,0
1668401961929,ECE 200,040,103625,Rebeiz; Gabriel,9999,0,9999,0
1668401961929,ECE 200,041,103626,Sanford; John R,9999,0,9999,0
1668401961929,ECE 200,042,103627,Siegel; Paul H.,9999,0,9999,0
1668401961929,ECE 200,043,103628,Sievenpiper; Daniel F.,9999,0,9999,0
1668401961929,ECE 200,044,103629,Sworder; David D.,9999,0,9999,0
1668401961929,ECE 200,045,103630,Taur; Yuan,9999,0,9999,0
1668401961929,ECE 200,046,103631,Touri; Behrouz,9999,0,9999,0
1668401961929,ECE 200,047,103632,Trivedi; Mohan M.,9999,0,9999,0
1668401961929,ECE 200,048,103633,Vasconcelos; Nuno,9999,0,9999,0
1668401961929,ECE 200,049,103634,Wang; Xiaolong,9999,0,9999,0
1668401961929,ECE 200,050,103635,Xie; Pengtao,9999,0,9999,0
1668401961929,ECE 200,051,103636,Yip; Michael,9999,0,9999,0
1668401961929,ECE 200,052,103637,Zeger; Kenneth A.,999,0,999,0
1668401961929,ECE 200,053,103638,Zhang; Xinyu,9999,0,9999,0
1668401961929,ECE 200,054,103639,Turakhia; Yatish Girish,9999,0,9999,0
1668401961929,ECE 200,055,103640,Kang; Mingu,9999,0,9999,0
1668401961929,ECE 200,056,103641,Shi; Yuanyuan,9999,0,9999,0
1668401961929,ECE 200,057,103642,Wang; Edward Jay,9999,0,9999,0
1668401961929,ECE 200,058,103643,Zheng; Yang,9999,0,9999,0
1668401962355,ECE 202,A00,103644,Kuzum; Duygu,0,0,0,0
1668401962778,ECE 212BN,A00,103646,Ng; Tse Nga,0,0,0,0
1668401963201,ECE 221,A00,111493,Staff,0,0,0,0
1668401963624,ECE 222B,A00,103647,Lomakin; Vitaliy,0,0,0,0
1668401964048,ECE 230B,A00,103648,Taur; Yuan,0,0,0,0
1668401964566,ECE 238B,A00,103649,Garay; Javier,0,0,0,0
1668401964991,ECE 240B,A00,112900,Fainman; Yeshaiahu,0,0,0,0
1668401965415,ECE 247A,A00,103650,Jokerst; Jesse Vincent,0,0,0,0
1668401965855,ECE 247B,A00,103651,Wang; Joseph,0,0,0,0
1668401966277,ECE 250,A00,103652,Siegel; Paul H.,0,0,0,0
1668401966704,ECE 251A,A00,103654,Rao; Bhaskar D.,0,0,0,0
1668401967130,ECE 257B,A00,103655,Bharadia; Dinesh,0,0,0,0
1668401967562,ECE 258A,A00,103656,Milstein; Laurence B.,0,0,0,0
1668401967985,ECE 260B,A00,103658,Kang; Mingu,0,0,0,0
1668401968417,ECE 264A,A00,103659,Galton; Ian A,0,0,0,0
1668401968846,ECE 265A,A00,103661,Gudem; Prasad S.S.,0,0,0,0
1668401969273,ECE 265D,A00,103662,Gudem; Prasad S.S.,0,0,0,0
1668401969696,ECE 268,A00,103663,Koushanfar; Farinaz,0,0,0,0
1668401970127,ECE 269,A01,103665,Pal; Piya,0,0,0,0
1668401970550,ECE 271B,A00,103666,Vasconcelos; Manuela,0,0,0,0
1668401970973,ECE 276A,A00,103667,Atanasov; Nikolay A.,0,0,0,0
1668401971400,ECE 277,A00,103668,An; Cheolhong,0,0,0,0
1668401971824,ECE 279,A00,117947,Hall; Drew A.,0,0,0,0
1668401972690,ECE 283,A00,103670,Hsueh; Tzu-Chien,0,0,0,0
1668401973115,ECE 284,A00,103671,Turakhia; Yatish Girish,0,0,0,0
1668401973540,ECE 285,A00,103672,Zheng; Yang,0,0,0,0
1668401973540,ECE 285,B00,103673,Sworder; David D.,0,0,0,0
1668401973976,ECE 287,A00,103676,Javidi; Tara,0,0,0,0
1668401974400,MATH 200B,A00,098023,Salehi Golsefidy; Alireza,12,0,15,3
1668401974825,MATH 202B,A00,098024,Rhoades; Brendon Patrick,9,0,15,6
1668401975252,MATH 203B,A00,098025,Oprea; Dragos N.,10,0,15,5
1668401975676,MATH 204B,A00,098026,Sorensen; Claus M,13,0,15,2
1668401976105,MATH 208,A00,098027,Izadi; Elham,7,0,10,3
1668401976529,MATH 209,A00,098028,Pollack; Aaron,10,0,10,0
1668401976951,MATH 211A,A00,112919,Rogalski; Daniel,9,0,10,1
1668401977374,MATH 211B,A00,112920,Seward; Brandon M.,9,0,10,1
1668401977807,MATH 218,A00,098029,Li; Bo,10,0,10,0
1668401978241,MATH 220B,A00,098030,Novak; Jonathan I,11,0,15,4
1668401978678,MATH 221A,A00,098031,Ebenfelt; Peter F,13,0,15,2
1668401979112,MATH 231B,A00,098032,Zlatos; Andrej,12,0,15,3
1668401979537,MATH 240B,A00,098033,Ni; Lei,9,0,15,6
1668401979960,MATH 243,A00,098034,Jekel; David Andrew,10,0,10,0
1668401980395,MATH 245A,A00,098035,Nie; Jiawang,0,0,15,16
1668401980818,MATH 248,A00,098036,Bejenaru; Ioan,10,0,10,0
1668401981240,MATH 250B,A00,098037,Spolaor; Luca,14,0,15,1
1668401981662,MATH 258,A00,098038,Ni; Lei,10,0,10,0
1668401982084,MATH 264B,A00,098041,Rhoades; Brendon Patrick,9,0,15,6
1668401982508,MATH 268,A00,098042,Buss; Samuel R,10,0,10,0
1668401982940,MATH 269,A00,098043,Rhoades; Brendon Patrick,10,0,10,0
1668401983364,MATH 270B,A00,098044,Li; Bo,10,0,15,5
1668401983788,MATH 272B,A00,098045,Holst; Michael J,13,0,15,2
1668401984212,MATH 273A,A00,098046,Tian; Xiaochuan,10,0,15,5
1668401984637,MATH 275,A01,098048,Tian; Xiaochuan,6,0,10,4
1668401985063,MATH 278A,A00,098049,Holst; Michael J,8,0,10,2
1668401985487,MATH 278B,A00,098050,Cloninger; Alexander,10,0,10,0
1668401985913,MATH 278C,A00,098051,Nie; Jiawang,6,0,10,4
1668401986345,MATH 280B,A00,098052,Zheng; Tianyi,8,0,15,7
1668401986776,MATH 281B,A00,098053,Bradic; Jelena,0,0,15,15
1668401987207,MATH 282B,A00,098054,Arias-Castro; Ery,0,0,15,15
1668401987648,MATH 285,A00,098055,Fitzsimmons; Patrick J,0,0,15,17
1668401988085,MATH 287B,A00,098056,Arias-Castro; Ery,2,0,15,13
1668401988510,MATH 288,A00,098057,Agarwal; Pooja,9,0,10,1
1668401988510,MATH 288,B00,098058,Zhang; Danna,8,0,10,2
1668401988510,MATH 288,C00,098059,Williams; Ruth J,9,0,10,1
1668401988937,MATH 290B,A00,098060,Roberts; Justin Deritter,13,0,15,2
1668401989361,MATH 292,A00,098061,Belmont; Eva Kinoshita,10,0,10,0
1668401989784,MATH 295,A00,098062,Suk; Andrew Hoon,48,0,50,2
1668401990210,MATH 296,A00,098063,Novak; Jonathan I,20,0,20,0
1668401990632,MATH 297,001,098064,Gamst; Anthony Collins,9997,0,9999,2
1668402491071,COGS 205,A00,101395,Chiba; Andrea,19,0,20,1
1668402491498,COGS 210B,001,101404,Greene; Deanna Jacquelyn,9998,0,9999,1
1668402491498,COGS 210B,002,101417,Xia; Haijun,9999,0,9999,0
1668402491498,COGS 210B,003,101422,Nitz; Douglas A.,9999,0,9999,0
1668402491498,COGS 210B,004,101423,Hollan; James D.,9998,0,9999,1
1668402491498,COGS 210B,005,101424,Deak; Gedeon O.,9998,0,9999,1
1668402491498,COGS 210B,006,101425,Rossano; Federico,9999,0,9999,0
1668402491922,COGS 211B,A00,101427,Coulson; Seana M,9996,0,9999,3
1668402492348,COGS 220,A00,101428,Hollan; James D.,0,0,25,25
1668402492770,COGS 229,A00,101429,Dow; Steven P,18,0,25,7
1668402493194,COGS 230,A00,101430,Klemmer; Scott R,11,0,17,6
1668402493616,COGS 234,A00,101431,Xia; Haijun,1,0,25,24
1668402494039,COGS 260,A00,101432,Kiyonaga; Anastasia,21,0,25,4
1668402494039,COGS 260,B00,101433,Kirsh; David Joel,15,0,25,10
1668402494464,CSE 202,A00,102371,Impagliazzo; Russell,0,0,0,0
1668402494888,CSE 203B,A01,102373,Cheng; Chung Kuan,0,0,0,0
1668402495314,CSE 208,A00,102374,Micciancio; Daniele,0,0,0,0
1668402495737,CSE 209A,A00,112895,Impagliazzo; Russell,0,0,15,15
1668402496173,CSE 209B,A00,108005,Bellare; Mihir,0,0,0,0
1668402496606,CSE 210,A00,113163,Coblenz; Michael J,0,0,0,0
1668402497049,CSE 219,A00,106111,Dow; Steven P,0,0,20,20
1668402497485,CSE 221,A00,102376,Voelker; Geoffrey M.,0,0,0,0
1668402497910,CSE 224,A01,102378,Porter; George M,0,0,0,0
1668402498334,CSE 229A,A00,102379,Savage; Stefan,0,0,0,0
1668402498767,CSE 229C,A00,102380,Munyaka; Imani N. S.,0,0,0,0
1668402499188,CSE 232B,A00,102382,Deutsch; Alin Bernard,0,0,0,0
1668402499616,CSE 234,A01,112904,Kumar; Arun Kumar,0,0,0,0
1668402500041,CSE 237A,A00,102383,Rosing; Tajana Simunic,0,0,0,0
1668402500471,CSE 239A,A00,102384,Deutsch; Alin Bernard,0,0,0,0
1668402500909,CSE 239B,A00,102385,Polikarpova; Nadezhda,0,0,0,0
1668402501333,CSE 240A,A00,102386,Pannuto; Patrick William,0,0,0,0
1668402501756,CSE 240B,A00,102387,Zhao; Jishen,0,0,0,0
1668402502185,CSE 241A,A00,106406,Kang; Mingu,0,0,0,0
1668402502619,CSE 249B,A00,102388,Kahng; Andrew Byun,0,0,8,8
1668402503049,CSE 251B,A01,102392,Cottrell; Garrison W,0,0,0,0
1668402503049,CSE 251B,A02,102393,Cottrell; Garrison W,0,0,0,0
1668402503472,CSE 252B,A00,102394,Ochoa; Benjamin Lawrence,0,0,0,0
1668402503905,CSE 257,A01,102396,Gao; Sicun,0,0,0,0
1668402504329,CSE 272,A00,102397,Li; Tzumao,0,0,0,0
1668402504753,CSE 274,A00,111323,Chern; Albert Ren-Haur,0,0,0,0
1668402505178,CSE 282,A00,102398,Pevzner; Pavel Arkadjevich,0,0,0,0
1668402505604,CSE 284,A00,114175,Gymrek; Melissa Ann,0,0,0,0
1668402506029,CSE 290,A00,102399,Chandraker; Manmohan Krishna,0,0,0,0
1668402506029,CSE 290,B00,102400,Vaccaro; Kristen Marie,0,0,25,25
1668402506029,CSE 290,C00,102414,Pannuto; Patrick William,0,0,25,25
1668402506029,CSE 290,D00,102427,Pevzner; Pavel Arkadjevich,0,0,0,0
1668402506029,CSE 290,E00,102429,Zhao; Jishen,0,0,0,0
1668402506029,CSE 290,F00,102436,Tullsen; Dean Michael,0,0,0,0
1668402506029,CSE 290,G00,102440,Christensen; Henrik I,0,0,20,20
1668402506457,CSE 291,A00,102443,Su; Hao,0,0,0,0
1668402506457,CSE 291,B00,102448,Polikarpova; Nadezhda,0,0,0,0
1668402506457,CSE 291,C00,102453,Vaccaro; Kristen Marie,0,0,0,0
1668402506457,CSE 291,D00,111343,Savage; Stefan,0,0,0,0
1668402506457,CSE 291,E00,116474,Claffy; Kimberly Claire,0,0,0,0
1668402506457,CSE 291,F00,116479,Pasquale; Joseph,0,0,0,0
1668402506894,CSE 293,001,119111,Bafna; Vineet,9999,0,9999,0
1668402506894,CSE 293,002,119118,Bellare; Mihir,9999,0,9999,0
1668402506894,CSE 293,003,119122,Berg-Kirkpatrick; Taylor D,9999,0,9999,0
1668402506894,CSE 293,004,119135,Christensen; Henrik I,9999,0,9999,0
1668402506894,CSE 293,005,119142,Cottrell; Garrison W,9999,0,9999,0
1668402506894,CSE 293,006,119146,Deutsch; Alin Bernard,9999,0,9999,0
1668402506894,CSE 293,007,119159,Esmaeilzadeh; Hadi,9999,0,9999,0
1668402506894,CSE 293,008,119166,Freund; Yoav,9999,0,9999,0
1668402506894,CSE 293,009,119170,Griswold; William G.,9999,0,9999,0
1668402506894,CSE 293,010,119183,Gymrek; Melissa Ann,9999,0,9999,0
1668402506894,CSE 293,011,119190,Heninger; Nadia A,9999,0,9999,0
1668402506894,CSE 293,012,119230,Impagliazzo; Russell,9999,0,9999,0
1668402506894,CSE 293,013,119232,Jhala; Ranjit,9999,0,9999,0
1668402506894,CSE 293,014,119233,Kahng; Andrew Byun,9999,0,9999,0
1668402506894,CSE 293,015,119298,Kane; Daniel Mertz,9999,0,9999,0
1668402506894,CSE 293,016,119299,Kriegman; David J,9999,0,9999,0
1668402506894,CSE 293,017,119300,Kumar; Arun Kumar,9999,0,9999,0
1668402506894,CSE 293,018,119301,Lerner; Sorin,9999,0,9999,0
1668402506894,CSE 293,019,119302,Lovett; Shachar,9999,0,9999,0
1668402506894,CSE 293,020,119303,McAuley; Julian John,9999,0,9999,0
1668402506894,CSE 293,021,119304,Micciancio; Daniele,9999,0,9999,0
1668402506894,CSE 293,022,119367,Orailoglu; Alex,9999,0,9999,0
1668402506894,CSE 293,023,119382,Paturi; Ramamohan,9999,0,9999,0
1668402506894,CSE 293,024,119404,Polikarpova; Nadezhda,9999,0,9999,0
1668402506894,CSE 293,025,119406,Politz; Joseph Gibbs,9999,0,9999,0
1668402506894,CSE 293,026,119411,Porter; George M,9999,0,9999,0
1668402506894,CSE 293,027,119414,Porter; Leonard Emerson,9999,0,9999,0
1668402506894,CSE 293,028,119416,Ramamoorthi; Ravi,9999,0,9999,0
1668402506894,CSE 293,029,119417,Sahoo; Debashis,9999,0,9999,0
1668402506894,CSE 293,030,119420,Saul; Lawrence,9999,0,9999,0
1668402506894,CSE 293,031,119421,Savage; Stefan,9999,0,9999,0
1668402506894,CSE 293,032,119425,Schulze; Jurgen P.,9999,0,9999,0
1668402506894,CSE 293,033,119426,Snoeren; Alex C.,9999,0,9999,0
1668402506894,CSE 293,034,119428,Shang; Jingbo,9999,0,9999,0
1668402506894,CSE 293,035,119430,Stefan; Deian,9999,0,9999,0
1668402506894,CSE 293,036,119431,Su; Hao,9999,0,9999,0
1668402506894,CSE 293,037,119433,Swanson; Steven James,9999,0,9999,0
1668402506894,CSE 293,038,119435,Tullsen; Dean Michael,9999,0,9999,0
1668402506894,CSE 293,039,119483,Voelker; Geoffrey M.,9999,0,9999,0
1668402506894,CSE 293,040,119537,Zhao; Jishen,9999,0,9999,0
1668402506894,CSE 293,041,119538,Zhou; Yuan-Yuan,9999,0,9999,0
1668402506894,CSE 293,042,119539,Gao; Sicun,9999,0,9999,0
1668402506894,CSE 293,043,119540,Weibel; Nadir,9999,0,9999,0
1668402506894,CSE 293,044,119541,Gupta; Rajesh K.,9999,0,9999,0
1668402506894,CSE 293,045,126410,Vaccaro; Kristen Marie,9999,0,9999,0
1668402506894,CSE 293,046,126411,Klemke; Richard,9999,0,9999,0
1668402507318,CSE 294,A00,102459,Voelker; Geoffrey M.,0,0,0,0
1668402507318,CSE 294,B00,111322,Orailoglu; Alex,0,0,0,0
1668402507742,DSE 201,A00,096914,Deutsch; Alin Bernard,30,0,30,0
1668402508166,DSE 210,A00,096915,Dasgupta; Sanjoy,30,0,30,0
1668402508590,DSE 260A,A00,096916,Altintas De Callaf; Ilkay,30,0,30,0
1668402509026,ECE 200,001,103586,Antipa; Nicholas A,9999,0,9999,0
1668402509026,ECE 200,002,103587,Atanasov; Nikolay A.,9999,0,9999,0
1668402509026,ECE 200,003,103588,Bharadia; Dinesh,9999,0,9999,0
1668402509026,ECE 200,004,103589,Cheng; Chung Kuan,9999,0,9999,0
1668402509026,ECE 200,005,103590,Cosman; Pamela C.,9999,0,9999,0
1668402509026,ECE 200,006,103591,Dayeh; Shadi Ahmad,9999,0,9999,0
1668402509026,ECE 200,007,103592,Fainman; Yeshaiahu,9999,0,9999,0
1668402509026,ECE 200,008,103593,Ford; Joseph Earl,9999,0,9999,0
1668402509026,ECE 200,009,103594,Franceschetti; Massimo,9999,0,9999,0
1668402509026,ECE 200,010,103595,Fullerton; Eric E,9999,0,9999,0
1668402509026,ECE 200,011,103596,Galton; Ian A,9999,0,9999,0
1668402509026,ECE 200,012,103597,Gilja; Vikash,9999,0,9999,0
1668402509026,ECE 200,013,103598,Hall; Drew A.,9999,0,9999,0
1668402509026,ECE 200,014,103599,Hsueh; Tzu-Chien,9999,0,9999,0
1668402509026,ECE 200,015,103600,Javidi; Tara,9999,0,9999,0
1668402509026,ECE 200,016,103601,Kahng; Andrew Byun,9999,0,9999,0
1668402509026,ECE 200,017,103602,Kim; Young-Han,9999,0,9999,0
1668402509026,ECE 200,018,103603,Koushanfar; Farinaz,9999,0,9999,0
1668402509026,ECE 200,019,103604,Kuzum; Duygu,9999,0,9999,0
1668402509026,ECE 200,020,103605,Le; Hanh-Phuc,9999,0,9999,0
1668402509026,ECE 200,021,103606,Lin; Bill,9999,0,9999,0
1668402509026,ECE 200,022,103607,Liu; Zhaowei,9998,0,9999,1
1668402509026,ECE 200,023,103608,Lo; Yu-Hwa,9999,0,9999,0
1668402509026,ECE 200,024,103609,Lomakin; Vitaliy,9999,0,9999,0
1668402509026,ECE 200,025,103610,Mercier; Patrick Philip,9999,0,9999,0
1668402509026,ECE 200,026,103611,Meyer; Florian,9999,0,9999,0
1668402509026,ECE 200,027,103612,Milstein; Laurence B.,9999,0,9999,0
1668402509026,ECE 200,028,103613,Mir Arabbaygi; Siavash,9999,0,9999,0
1668402509026,ECE 200,029,103614,Mookherjea; Shayan,9999,0,9999,0
1668402509026,ECE 200,030,103615,Morris; Karcher William,9999,0,9999,0
1668402509026,ECE 200,031,103616,Ng; Tse Nga,9999,0,9999,0
1668402509026,ECE 200,032,103617,Nguyen; Truong Quang,9999,0,9999,0
1668402509026,ECE 200,033,103618,Nomura; Kenji,9999,0,9999,0
1668402509026,ECE 200,034,103619,Orlitsky; Alon,9999,0,9999,0
1668402509026,ECE 200,035,103620,Pal; Piya,9999,0,9999,0
1668402509026,ECE 200,036,103621,Papen; George C.,9999,0,9999,0
1668402509026,ECE 200,037,103622,Radic; Stojan,9999,0,9999,0
1668402509026,ECE 200,038,103623,Rao; Bhaskar D.,9999,0,9999,0
1668402509026,ECE 200,039,103624,Rao; Ramesh R,9999,0,9999,0
1668402509026,ECE 200,040,103625,Rebeiz; Gabriel,9999,0,9999,0
1668402509026,ECE 200,041,103626,Sanford; John R,9999,0,9999,0
1668402509026,ECE 200,042,103627,Siegel; Paul H.,9999,0,9999,0
1668402509026,ECE 200,043,103628,Sievenpiper; Daniel F.,9999,0,9999,0
1668402509026,ECE 200,044,103629,Sworder; David D.,9999,0,9999,0
1668402509026,ECE 200,045,103630,Taur; Yuan,9999,0,9999,0
1668402509026,ECE 200,046,103631,Touri; Behrouz,9999,0,9999,0
1668402509026,ECE 200,047,103632,Trivedi; Mohan M.,9999,0,9999,0
1668402509026,ECE 200,048,103633,Vasconcelos; Nuno,9999,0,9999,0
1668402509026,ECE 200,049,103634,Wang; Xiaolong,9999,0,9999,0
1668402509026,ECE 200,050,103635,Xie; Pengtao,9999,0,9999,0
1668402509026,ECE 200,051,103636,Yip; Michael,9999,0,9999,0
1668402509026,ECE 200,052,103637,Zeger; Kenneth A.,999,0,999,0
1668402509026,ECE 200,053,103638,Zhang; Xinyu,9999,0,9999,0
1668402509026,ECE 200,054,103639,Turakhia; Yatish Girish,9999,0,9999,0
1668402509026,ECE 200,055,103640,Kang; Mingu,9999,0,9999,0
1668402509026,ECE 200,056,103641,Shi; Yuanyuan,9999,0,9999,0
1668402509026,ECE 200,057,103642,Wang; Edward Jay,9999,0,9999,0
1668402509026,ECE 200,058,103643,Zheng; Yang,9999,0,9999,0
1668402509460,ECE 202,A00,103644,Kuzum; Duygu,0,0,0,0
1668402509889,ECE 212BN,A00,103646,Ng; Tse Nga,0,0,0,0
1668402510312,ECE 221,A00,111493,Staff,0,0,0,0
1668402510746,ECE 222B,A00,103647,Lomakin; Vitaliy,0,0,0,0
1668402511170,ECE 230B,A00,103648,Taur; Yuan,0,0,0,0
1668402511604,ECE 238B,A00,103649,Garay; Javier,0,0,0,0
1668402512030,ECE 240B,A00,112900,Fainman; Yeshaiahu,0,0,0,0
1668402512453,ECE 247A,A00,103650,Jokerst; Jesse Vincent,0,0,0,0
1668402512876,ECE 247B,A00,103651,Wang; Joseph,0,0,0,0
1668402513304,ECE 250,A00,103652,Siegel; Paul H.,0,0,0,0
1668402513727,ECE 251A,A00,103654,Rao; Bhaskar D.,0,0,0,0
1668402514151,ECE 257B,A00,103655,Bharadia; Dinesh,0,0,0,0
1668402514575,ECE 258A,A00,103656,Milstein; Laurence B.,0,0,0,0
1668402514998,ECE 260B,A00,103658,Kang; Mingu,0,0,0,0
1668402515432,ECE 264A,A00,103659,Galton; Ian A,0,0,0,0
1668402515868,ECE 265A,A00,103661,Gudem; Prasad S.S.,0,0,0,0
1668402516292,ECE 265D,A00,103662,Gudem; Prasad S.S.,0,0,0,0
1668402516715,ECE 268,A00,103663,Koushanfar; Farinaz,0,0,0,0
1668402517144,ECE 269,A01,103665,Pal; Piya,0,0,0,0
1668402517573,ECE 271B,A00,103666,Vasconcelos; Manuela,0,0,0,0
1668402517995,ECE 276A,A00,103667,Atanasov; Nikolay A.,0,0,0,0
1668402518419,ECE 277,A00,103668,An; Cheolhong,0,0,0,0
1668402518844,ECE 279,A00,117947,Hall; Drew A.,0,0,0,0
1668402519693,ECE 283,A00,103670,Hsueh; Tzu-Chien,0,0,0,0
1668402520120,ECE 284,A00,103671,Turakhia; Yatish Girish,0,0,0,0
1668402520546,ECE 285,A00,103672,Zheng; Yang,0,0,0,0
1668402520546,ECE 285,B00,103673,Sworder; David D.,0,0,0,0
1668402520968,ECE 287,A00,103676,Javidi; Tara,0,0,0,0
1668402521407,MATH 200B,A00,098023,Salehi Golsefidy; Alireza,12,0,15,3
1668402521831,MATH 202B,A00,098024,Rhoades; Brendon Patrick,9,0,15,6
1668402522254,MATH 203B,A00,098025,Oprea; Dragos N.,10,0,15,5
1668402522677,MATH 204B,A00,098026,Sorensen; Claus M,13,0,15,2
1668402523100,MATH 208,A00,098027,Izadi; Elham,7,0,10,3
1668402523524,MATH 209,A00,098028,Pollack; Aaron,10,0,10,0
1668402523946,MATH 211A,A00,112919,Rogalski; Daniel,9,0,10,1
1668402524377,MATH 211B,A00,112920,Seward; Brandon M.,9,0,10,1
1668402524803,MATH 218,A00,098029,Li; Bo,10,0,10,0
1668402525227,MATH 220B,A00,098030,Novak; Jonathan I,11,0,15,4
1668402525666,MATH 221A,A00,098031,Ebenfelt; Peter F,13,0,15,2
1668402526093,MATH 231B,A00,098032,Zlatos; Andrej,12,0,15,3
1668402526519,MATH 240B,A00,098033,Ni; Lei,9,0,15,6
1668402526944,MATH 243,A00,098034,Jekel; David Andrew,10,0,10,0
1668402527381,MATH 245A,A00,098035,Nie; Jiawang,0,0,15,16
1668402527810,MATH 248,A00,098036,Bejenaru; Ioan,10,0,10,0
1668402528332,MATH 250B,A00,098037,Spolaor; Luca,14,0,15,1
1668402528762,MATH 258,A00,098038,Ni; Lei,10,0,10,0
1668402529188,MATH 264B,A00,098041,Rhoades; Brendon Patrick,9,0,15,6
1668402529610,MATH 268,A00,098042,Buss; Samuel R,10,0,10,0
1668402530036,MATH 269,A00,098043,Rhoades; Brendon Patrick,10,0,10,0
1668402530457,MATH 270B,A00,098044,Li; Bo,10,0,15,5
1668402530881,MATH 272B,A00,098045,Holst; Michael J,13,0,15,2
1668402531305,MATH 273A,A00,098046,Tian; Xiaochuan,10,0,15,5
1668402531735,MATH 275,A01,098048,Tian; Xiaochuan,6,0,10,4
1668402532162,MATH 278A,A00,098049,Holst; Michael J,8,0,10,2
1668402532586,MATH 278B,A00,098050,Cloninger; Alexander,10,0,10,0
1668402533009,MATH 278C,A00,098051,Nie; Jiawang,6,0,10,4
1668402533434,MATH 280B,A00,098052,Zheng; Tianyi,8,0,15,7
1668402533857,MATH 281B,A00,098053,Bradic; Jelena,0,0,15,15
1668402534281,MATH 282B,A00,098054,Arias-Castro; Ery,0,0,15,15
1668402534706,MATH 285,A00,098055,Fitzsimmons; Patrick J,0,0,15,17
1668402535139,MATH 287B,A00,098056,Arias-Castro; Ery,2,0,15,13
1668402535561,MATH 288,A00,098057,Agarwal; Pooja,9,0,10,1
1668402535561,MATH 288,B00,098058,Zhang; Danna,8,0,10,2
1668402535561,MATH 288,C00,098059,Williams; Ruth J,9,0,10,1
1668402535987,MATH 290B,A00,098060,Roberts; Justin Deritter,13,0,15,2
1668402536415,MATH 292,A00,098061,Belmont; Eva Kinoshita,10,0,10,0
1668402536849,MATH 295,A00,098062,Suk; Andrew Hoon,48,0,50,2
1668402537273,MATH 296,A00,098063,Novak; Jonathan I,20,0,20,0
1668402537697,MATH 297,001,098064,Gamst; Anthony Collins,9997,0,9999,2
1668403037969,COGS 205,A00,101395,Chiba; Andrea,19,0,20,1
1668403038402,COGS 210B,001,101404,Greene; Deanna Jacquelyn,9998,0,9999,1
1668403038402,COGS 210B,002,101417,Xia; Haijun,9999,0,9999,0
1668403038402,COGS 210B,003,101422,Nitz; Douglas A.,9999,0,9999,0
1668403038402,COGS 210B,004,101423,Hollan; James D.,9998,0,9999,1
1668403038402,COGS 210B,005,101424,Deak; Gedeon O.,9998,0,9999,1
1668403038402,COGS 210B,006,101425,Rossano; Federico,9999,0,9999,0
1668403038828,COGS 211B,A00,101427,Coulson; Seana M,9996,0,9999,3
1668403039255,COGS 220,A00,101428,Hollan; James D.,0,0,25,25
1668403039685,COGS 229,A00,101429,Dow; Steven P,18,0,25,7
1668403040110,COGS 230,A00,101430,Klemmer; Scott R,11,0,17,6
1668403040532,COGS 234,A00,101431,Xia; Haijun,1,0,25,24
1668403040954,COGS 260,A00,101432,Kiyonaga; Anastasia,21,0,25,4
1668403040954,COGS 260,B00,101433,Kirsh; David Joel,15,0,25,10
1668403041380,CSE 202,A00,102371,Impagliazzo; Russell,0,0,0,0
1668403041806,CSE 203B,A01,102373,Cheng; Chung Kuan,0,0,0,0
1668403042237,CSE 208,A00,102374,Micciancio; Daniele,0,0,0,0
1668403042663,CSE 209A,A00,112895,Impagliazzo; Russell,0,0,15,15
1668403043087,CSE 209B,A00,108005,Bellare; Mihir,0,0,0,0
1668403043513,CSE 210,A00,113163,Coblenz; Michael J,0,0,0,0
1668403043934,CSE 219,A00,106111,Dow; Steven P,0,0,20,20
1668403044358,CSE 221,A00,102376,Voelker; Geoffrey M.,0,0,0,0
1668403044786,CSE 224,A01,102378,Porter; George M,0,0,0,0
1668403045214,CSE 229A,A00,102379,Savage; Stefan,0,0,0,0
1668403045638,CSE 229C,A00,102380,Munyaka; Imani N. S.,0,0,0,0
1668403046064,CSE 232B,A00,102382,Deutsch; Alin Bernard,0,0,0,0
1668403046488,CSE 234,A01,112904,Kumar; Arun Kumar,0,0,0,0
1668403046911,CSE 237A,A00,102383,Rosing; Tajana Simunic,0,0,0,0
1668403047334,CSE 239A,A00,102384,Deutsch; Alin Bernard,0,0,0,0
1668403047764,CSE 239B,A00,102385,Polikarpova; Nadezhda,0,0,0,0
1668403048193,CSE 240A,A00,102386,Pannuto; Patrick William,0,0,0,0
1668403048691,CSE 240B,A00,102387,Zhao; Jishen,0,0,0,0
1668403049117,CSE 241A,A00,106406,Kang; Mingu,0,0,0,0
1668403049540,CSE 249B,A00,102388,Kahng; Andrew Byun,0,0,8,8
1668403049961,CSE 251B,A01,102392,Cottrell; Garrison W,0,0,0,0
1668403049961,CSE 251B,A02,102393,Cottrell; Garrison W,0,0,0,0
1668403050413,CSE 252B,A00,102394,Ochoa; Benjamin Lawrence,0,0,0,0
1668403050835,CSE 257,A01,102396,Gao; Sicun,0,0,0,0
1668403051256,CSE 272,A00,102397,Li; Tzumao,0,0,0,0
1668403051682,CSE 274,A00,111323,Chern; Albert Ren-Haur,0,0,0,0
1668403052114,CSE 282,A00,102398,Pevzner; Pavel Arkadjevich,0,0,0,0
1668403052539,CSE 284,A00,114175,Gymrek; Melissa Ann,0,0,0,0
1668403052961,CSE 290,A00,102399,Chandraker; Manmohan Krishna,0,0,0,0
1668403052961,CSE 290,B00,102400,Vaccaro; Kristen Marie,0,0,25,25
1668403052961,CSE 290,C00,102414,Pannuto; Patrick William,0,0,25,25
1668403052961,CSE 290,D00,102427,Pevzner; Pavel Arkadjevich,0,0,0,0
1668403052961,CSE 290,E00,102429,Zhao; Jishen,0,0,0,0
1668403052961,CSE 290,F00,102436,Tullsen; Dean Michael,0,0,0,0
1668403052961,CSE 290,G00,102440,Christensen; Henrik I,0,0,20,20
1668403053392,CSE 291,A00,102443,Su; Hao,0,0,0,0
1668403053392,CSE 291,B00,102448,Polikarpova; Nadezhda,0,0,0,0
1668403053392,CSE 291,C00,102453,Vaccaro; Kristen Marie,0,0,0,0
1668403053392,CSE 291,D00,111343,Savage; Stefan,0,0,0,0
1668403053392,CSE 291,E00,116474,Claffy; Kimberly Claire,0,0,0,0
1668403053392,CSE 291,F00,116479,Pasquale; Joseph,0,0,0,0
1668403053840,CSE 293,001,119111,Bafna; Vineet,9999,0,9999,0
1668403053840,CSE 293,002,119118,Bellare; Mihir,9999,0,9999,0
1668403053840,CSE 293,003,119122,Berg-Kirkpatrick; Taylor D,9999,0,9999,0
1668403053840,CSE 293,004,119135,Christensen; Henrik I,9999,0,9999,0
1668403053840,CSE 293,005,119142,Cottrell; Garrison W,9999,0,9999,0
1668403053840,CSE 293,006,119146,Deutsch; Alin Bernard,9999,0,9999,0
1668403053840,CSE 293,007,119159,Esmaeilzadeh; Hadi,9999,0,9999,0
1668403053840,CSE 293,008,119166,Freund; Yoav,9999,0,9999,0
1668403053840,CSE 293,009,119170,Griswold; William G.,9999,0,9999,0
1668403053840,CSE 293,010,119183,Gymrek; Melissa Ann,9999,0,9999,0
1668403053840,CSE 293,011,119190,Heninger; Nadia A,9999,0,9999,0
1668403053840,CSE 293,012,119230,Impagliazzo; Russell,9999,0,9999,0
1668403053840,CSE 293,013,119232,Jhala; Ranjit,9999,0,9999,0
1668403053840,CSE 293,014,119233,Kahng; Andrew Byun,9999,0,9999,0
1668403053840,CSE 293,015,119298,Kane; Daniel Mertz,9999,0,9999,0
1668403053840,CSE 293,016,119299,Kriegman; David J,9999,0,9999,0
1668403053840,CSE 293,017,119300,Kumar; Arun Kumar,9999,0,9999,0
1668403053840,CSE 293,018,119301,Lerner; Sorin,9999,0,9999,0
1668403053840,CSE 293,019,119302,Lovett; Shachar,9999,0,9999,0
1668403053840,CSE 293,020,119303,McAuley; Julian John,9999,0,9999,0
1668403053840,CSE 293,021,119304,Micciancio; Daniele,9999,0,9999,0
1668403053840,CSE 293,022,119367,Orailoglu; Alex,9999,0,9999,0
1668403053840,CSE 293,023,119382,Paturi; Ramamohan,9999,0,9999,0
1668403053840,CSE 293,024,119404,Polikarpova; Nadezhda,9999,0,9999,0
1668403053840,CSE 293,025,119406,Politz; Joseph Gibbs,9999,0,9999,0
1668403053840,CSE 293,026,119411,Porter; George M,9999,0,9999,0
1668403053840,CSE 293,027,119414,Porter; Leonard Emerson,9999,0,9999,0
1668403053840,CSE 293,028,119416,Ramamoorthi; Ravi,9999,0,9999,0
1668403053840,CSE 293,029,119417,Sahoo; Debashis,9999,0,9999,0
1668403053840,CSE 293,030,119420,Saul; Lawrence,9999,0,9999,0
1668403053840,CSE 293,031,119421,Savage; Stefan,9999,0,9999,0
1668403053840,CSE 293,032,119425,Schulze; Jurgen P.,9999,0,9999,0
1668403053840,CSE 293,033,119426,Snoeren; Alex C.,9999,0,9999,0
1668403053840,CSE 293,034,119428,Shang; Jingbo,9999,0,9999,0
1668403053840,CSE 293,035,119430,Stefan; Deian,9999,0,9999,0
1668403053840,CSE 293,036,119431,Su; Hao,9999,0,9999,0
1668403053840,CSE 293,037,119433,Swanson; Steven James,9999,0,9999,0
1668403053840,CSE 293,038,119435,Tullsen; Dean Michael,9999,0,9999,0
1668403053840,CSE 293,039,119483,Voelker; Geoffrey M.,9999,0,9999,0
1668403053840,CSE 293,040,119537,Zhao; Jishen,9999,0,9999,0
1668403053840,CSE 293,041,119538,Zhou; Yuan-Yuan,9999,0,9999,0
1668403053840,CSE 293,042,119539,Gao; Sicun,9999,0,9999,0
1668403053840,CSE 293,043,119540,Weibel; Nadir,9999,0,9999,0
1668403053840,CSE 293,044,119541,Gupta; Rajesh K.,9999,0,9999,0
1668403053840,CSE 293,045,126410,Vaccaro; Kristen Marie,9999,0,9999,0
1668403053840,CSE 293,046,126411,Klemke; Richard,9999,0,9999,0
1668403054265,CSE 294,A00,102459,Voelker; Geoffrey M.,0,0,0,0
1668403054265,CSE 294,B00,111322,Orailoglu; Alex,0,0,0,0
1668403054689,DSE 201,A00,096914,Deutsch; Alin Bernard,30,0,30,0
1668403055112,DSE 210,A00,096915,Dasgupta; Sanjoy,30,0,30,0
1668403055546,DSE 260A,A00,096916,Altintas De Callaf; Ilkay,30,0,30,0
1668403055972,ECE 200,001,103586,Antipa; Nicholas A,9999,0,9999,0
1668403055972,ECE 200,002,103587,Atanasov; Nikolay A.,9999,0,9999,0
1668403055972,ECE 200,003,103588,Bharadia; Dinesh,9999,0,9999,0
1668403055972,ECE 200,004,103589,Cheng; Chung Kuan,9999,0,9999,0
1668403055972,ECE 200,005,103590,Cosman; Pamela C.,9999,0,9999,0
1668403055972,ECE 200,006,103591,Dayeh; Shadi Ahmad,9999,0,9999,0
1668403055972,ECE 200,007,103592,Fainman; Yeshaiahu,9999,0,9999,0
1668403055972,ECE 200,008,103593,Ford; Joseph Earl,9999,0,9999,0
1668403055972,ECE 200,009,103594,Franceschetti; Massimo,9999,0,9999,0
1668403055972,ECE 200,010,103595,Fullerton; Eric E,9999,0,9999,0
1668403055972,ECE 200,011,103596,Galton; Ian A,9999,0,9999,0
1668403055972,ECE 200,012,103597,Gilja; Vikash,9999,0,9999,0
1668403055972,ECE 200,013,103598,Hall; Drew A.,9999,0,9999,0
1668403055972,ECE 200,014,103599,Hsueh; Tzu-Chien,9999,0,9999,0
1668403055972,ECE 200,015,103600,Javidi; Tara,9999,0,9999,0
1668403055972,ECE 200,016,103601,Kahng; Andrew Byun,9999,0,9999,0
1668403055972,ECE 200,017,103602,Kim; Young-Han,9999,0,9999,0
1668403055972,ECE 200,018,103603,Koushanfar; Farinaz,9999,0,9999,0
1668403055972,ECE 200,019,103604,Kuzum; Duygu,9999,0,9999,0
1668403055972,ECE 200,020,103605,Le; Hanh-Phuc,9999,0,9999,0
1668403055972,ECE 200,021,103606,Lin; Bill,9999,0,9999,0
1668403055972,ECE 200,022,103607,Liu; Zhaowei,9998,0,9999,1
1668403055972,ECE 200,023,103608,Lo; Yu-Hwa,9999,0,9999,0
1668403055972,ECE 200,024,103609,Lomakin; Vitaliy,9999,0,9999,0
1668403055972,ECE 200,025,103610,Mercier; Patrick Philip,9999,0,9999,0
1668403055972,ECE 200,026,103611,Meyer; Florian,9999,0,9999,0
1668403055972,ECE 200,027,103612,Milstein; Laurence B.,9999,0,9999,0
1668403055972,ECE 200,028,103613,Mir Arabbaygi; Siavash,9999,0,9999,0
1668403055972,ECE 200,029,103614,Mookherjea; Shayan,9999,0,9999,0
1668403055972,ECE 200,030,103615,Morris; Karcher William,9999,0,9999,0
1668403055972,ECE 200,031,103616,Ng; Tse Nga,9999,0,9999,0
1668403055972,ECE 200,032,103617,Nguyen; Truong Quang,9999,0,9999,0
1668403055972,ECE 200,033,103618,Nomura; Kenji,9999,0,9999,0
1668403055972,ECE 200,034,103619,Orlitsky; Alon,9999,0,9999,0
1668403055972,ECE 200,035,103620,Pal; Piya,9999,0,9999,0
1668403055972,ECE 200,036,103621,Papen; George C.,9999,0,9999,0
1668403055972,ECE 200,037,103622,Radic; Stojan,9999,0,9999,0
1668403055972,ECE 200,038,103623,Rao; Bhaskar D.,9999,0,9999,0
1668403055972,ECE 200,039,103624,Rao; Ramesh R,9999,0,9999,0
1668403055972,ECE 200,040,103625,Rebeiz; Gabriel,9999,0,9999,0
1668403055972,ECE 200,041,103626,Sanford; John R,9999,0,9999,0
1668403055972,ECE 200,042,103627,Siegel; Paul H.,9999,0,9999,0
1668403055972,ECE 200,043,103628,Sievenpiper; Daniel F.,9999,0,9999,0
1668403055972,ECE 200,044,103629,Sworder; David D.,9999,0,9999,0
1668403055972,ECE 200,045,103630,Taur; Yuan,9999,0,9999,0
1668403055972,ECE 200,046,103631,Touri; Behrouz,9999,0,9999,0
1668403055972,ECE 200,047,103632,Trivedi; Mohan M.,9999,0,9999,0
1668403055972,ECE 200,048,103633,Vasconcelos; Nuno,9999,0,9999,0
1668403055972,ECE 200,049,103634,Wang; Xiaolong,9999,0,9999,0
1668403055972,ECE 200,050,103635,Xie; Pengtao,9999,0,9999,0
1668403055972,ECE 200,051,103636,Yip; Michael,9999,0,9999,0
1668403055972,ECE 200,052,103637,Zeger; Kenneth A.,999,0,999,0
1668403055972,ECE 200,053,103638,Zhang; Xinyu,9999,0,9999,0
1668403055972,ECE 200,054,103639,Turakhia; Yatish Girish,9999,0,9999,0
1668403055972,ECE 200,055,103640,Kang; Mingu,9999,0,9999,0
1668403055972,ECE 200,056,103641,Shi; Yuanyuan,9999,0,9999,0
1668403055972,ECE 200,057,103642,Wang; Edward Jay,9999,0,9999,0
1668403055972,ECE 200,058,103643,Zheng; Yang,9999,0,9999,0
1668403056394,ECE 202,A00,103644,Kuzum; Duygu,0,0,0,0
1668403056820,ECE 212BN,A00,103646,Ng; Tse Nga,0,0,0,0
1668403057245,ECE 221,A00,111493,Staff,0,0,0,0
1668403057667,ECE 222B,A00,103647,Lomakin; Vitaliy,0,0,0,0
1668403058102,ECE 230B,A00,103648,Taur; Yuan,0,0,0,0
1668403058525,ECE 238B,A00,103649,Garay; Javier,0,0,0,0
1668403058949,ECE 240B,A00,112900,Fainman; Yeshaiahu,0,0,0,0
1668403059387,ECE 247A,A00,103650,Jokerst; Jesse Vincent,0,0,0,0
1668403059811,ECE 247B,A00,103651,Wang; Joseph,0,0,0,0
1668403060233,ECE 250,A00,103652,Siegel; Paul H.,0,0,0,0
1668403060664,ECE 251A,A00,103654,Rao; Bhaskar D.,0,0,0,0
1668403061086,ECE 257B,A00,103655,Bharadia; Dinesh,0,0,0,0
1668403061509,ECE 258A,A00,103656,Milstein; Laurence B.,0,0,0,0
1668403061935,ECE 260B,A00,103658,Kang; Mingu,0,0,0,0
1668403062946,ECE 264A,A00,103659,Galton; Ian A,0,0,0,0
1668403063368,ECE 265A,A00,103661,Gudem; Prasad S.S.,0,0,0,0
1668403063792,ECE 265D,A00,103662,Gudem; Prasad S.S.,0,0,0,0
1668403064219,ECE 268,A00,103663,Koushanfar; Farinaz,0,0,0,0
1668403064642,ECE 269,A01,103665,Pal; Piya,0,0,0,0
1668403065067,ECE 271B,A00,103666,Vasconcelos; Manuela,0,0,0,0
1668403065492,ECE 276A,A00,103667,Atanasov; Nikolay A.,0,0,0,0
1668403065915,ECE 277,A00,103668,An; Cheolhong,0,0,0,0
1668403066337,ECE 279,A00,117947,Hall; Drew A.,0,0,0,0
1668403067184,ECE 283,A00,103670,Hsueh; Tzu-Chien,0,0,0,0
1668403067608,ECE 284,A00,103671,Turakhia; Yatish Girish,0,0,0,0
1668403068031,ECE 285,A00,103672,Zheng; Yang,0,0,0,0
1668403068031,ECE 285,B00,103673,Sworder; David D.,0,0,0,0
1668403068455,ECE 287,A00,103676,Javidi; Tara,0,0,0,0
1668403068881,MATH 200B,A00,098023,Salehi Golsefidy; Alireza,12,0,15,3
1668403069305,MATH 202B,A00,098024,Rhoades; Brendon Patrick,9,0,15,6
1668403069730,MATH 203B,A00,098025,Oprea; Dragos N.,10,0,15,5
1668403070154,MATH 204B,A00,098026,Sorensen; Claus M,13,0,15,2
1668403070577,MATH 208,A00,098027,Izadi; Elham,7,0,10,3
1668403071008,MATH 209,A00,098028,Pollack; Aaron,10,0,10,0
1668403071435,MATH 211A,A00,112919,Rogalski; Daniel,9,0,10,1
1668403071871,MATH 211B,A00,112920,Seward; Brandon M.,9,0,10,1
1668403072295,MATH 218,A00,098029,Li; Bo,10,0,10,0
1668403072737,MATH 220B,A00,098030,Novak; Jonathan I,11,0,15,4
1668403073164,MATH 221A,A00,098031,Ebenfelt; Peter F,13,0,15,2
1668403073593,MATH 231B,A00,098032,Zlatos; Andrej,12,0,15,3
1668403074021,MATH 240B,A00,098033,Ni; Lei,9,0,15,6
1668403074445,MATH 243,A00,098034,Jekel; David Andrew,10,0,10,0
1668403074872,MATH 245A,A00,098035,Nie; Jiawang,0,0,15,16
1668403075294,MATH 248,A00,098036,Bejenaru; Ioan,10,0,10,0
1668403075718,MATH 250B,A00,098037,Spolaor; Luca,14,0,15,1
1668403076150,MATH 258,A00,098038,Ni; Lei,10,0,10,0
1668403076584,MATH 264B,A00,098041,Rhoades; Brendon Patrick,9,0,15,6
1668403077011,MATH 268,A00,098042,Buss; Samuel R,10,0,10,0
1668403077445,MATH 269,A00,098043,Rhoades; Brendon Patrick,10,0,10,0
1668403077884,MATH 270B,A00,098044,Li; Bo,10,0,15,5
1668403078318,MATH 272B,A00,098045,Holst; Michael J,13,0,15,2
1668403078754,MATH 273A,A00,098046,Tian; Xiaochuan,10,0,15,5
1668403079182,MATH 275,A01,098048,Tian; Xiaochuan,6,0,10,4
1668403079609,MATH 278A,A00,098049,Holst; Michael J,8,0,10,2
1668403080031,MATH 278B,A00,098050,Cloninger; Alexander,10,0,10,0
1668403080455,MATH 278C,A00,098051,Nie; Jiawang,6,0,10,4
1668403080879,MATH 280B,A00,098052,Zheng; Tianyi,8,0,15,7
1668403081308,MATH 281B,A00,098053,Bradic; Jelena,0,0,15,15
1668403081749,MATH 282B,A00,098054,Arias-Castro; Ery,0,0,15,15
1668403082177,MATH 285,A00,098055,Fitzsimmons; Patrick J,0,0,15,17
1668403082604,MATH 287B,A00,098056,Arias-Castro; Ery,2,0,15,13
1668403083028,MATH 288,A00,098057,Agarwal; Pooja,9,0,10,1
1668403083028,MATH 288,B00,098058,Zhang; Danna,8,0,10,2
1668403083028,MATH 288,C00,098059,Williams; Ruth J,9,0,10,1
1668403083455,MATH 290B,A00,098060,Roberts; Justin Deritter,13,0,15,2
1668403083878,MATH 292,A00,098061,Belmont; Eva Kinoshita,10,0,10,0
1668403084304,MATH 295,A00,098062,Suk; Andrew Hoon,48,0,50,2
1668403084737,MATH 296,A00,098063,Novak; Jonathan I,20,0,20,0
1668403085161,MATH 297,001,098064,Gamst; Anthony Collins,9997,0,9999,2
1668403585620,COGS 205,A00,101395,Chiba; Andrea,19,0,20,1
1668403586041,COGS 210B,001,101404,Greene; Deanna Jacquelyn,9998,0,9999,1
1668403586041,COGS 210B,002,101417,Xia; Haijun,9999,0,9999,0
1668403586041,COGS 210B,003,101422,Nitz; Douglas A.,9999,0,9999,0
1668403586041,COGS 210B,004,101423,Hollan; James D.,9998,0,9999,1
1668403586041,COGS 210B,005,101424,Deak; Gedeon O.,9998,0,9999,1
1668403586041,COGS 210B,006,101425,Rossano; Federico,9999,0,9999,0
1668403586467,COGS 211B,A00,101427,Coulson; Seana M,9996,0,9999,3
1668403586892,COGS 220,A00,101428,Hollan; James D.,0,0,25,25
1668403587323,COGS 229,A00,101429,Dow; Steven P,18,0,25,7
1668403587750,COGS 230,A00,101430,Klemmer; Scott R,11,0,17,6
1668403588172,COGS 234,A00,101431,Xia; Haijun,1,0,25,24
1668403588598,COGS 260,A00,101432,Kiyonaga; Anastasia,21,0,25,4
1668403588598,COGS 260,B00,101433,Kirsh; David Joel,15,0,25,10
1668403589026,CSE 202,A00,102371,Impagliazzo; Russell,0,0,0,0
1668403589447,CSE 203B,A01,102373,Cheng; Chung Kuan,0,0,0,0
1668403589898,CSE 208,A00,102374,Micciancio; Daniele,0,0,0,0
1668403590320,CSE 209A,A00,112895,Impagliazzo; Russell,0,0,15,15
1668403590742,CSE 209B,A00,108005,Bellare; Mihir,0,0,0,0
1668403591169,CSE 210,A00,113163,Coblenz; Michael J,0,0,0,0
1668403591593,CSE 219,A00,106111,Dow; Steven P,0,0,20,20
1668403592027,CSE 221,A00,102376,Voelker; Geoffrey M.,0,0,0,0
1668403592466,CSE 224,A01,102378,Porter; George M,0,0,0,0
1668403592903,CSE 229A,A00,102379,Savage; Stefan,0,0,0,0
1668403593339,CSE 229C,A00,102380,Munyaka; Imani N. S.,0,0,0,0
1668403593765,CSE 232B,A00,102382,Deutsch; Alin Bernard,0,0,0,0
1668403594190,CSE 234,A01,112904,Kumar; Arun Kumar,0,0,0,0
1668403594617,CSE 237A,A00,102383,Rosing; Tajana Simunic,0,0,0,0
1668403595042,CSE 239A,A00,102384,Deutsch; Alin Bernard,0,0,0,0
1668403595466,CSE 239B,A00,102385,Polikarpova; Nadezhda,0,0,0,0
1668403595891,CSE 240A,A00,102386,Pannuto; Patrick William,0,0,0,0
1668403596317,CSE 240B,A00,102387,Zhao; Jishen,0,0,0,0
1668403596740,CSE 241A,A00,106406,Kang; Mingu,0,0,0,0
1668403597162,CSE 249B,A00,102388,Kahng; Andrew Byun,0,0,8,8
1668403597585,CSE 251B,A01,102392,Cottrell; Garrison W,0,0,0,0
1668403597585,CSE 251B,A02,102393,Cottrell; Garrison W,0,0,0,0
1668403598011,CSE 252B,A00,102394,Ochoa; Benjamin Lawrence,0,0,0,0
1668403598436,CSE 257,A01,102396,Gao; Sicun,0,0,0,0
1668403598857,CSE 272,A00,102397,Li; Tzumao,0,0,0,0
1668403599281,CSE 274,A00,111323,Chern; Albert Ren-Haur,0,0,0,0
1668403599718,CSE 282,A00,102398,Pevzner; Pavel Arkadjevich,0,0,0,0
1668403600144,CSE 284,A00,114175,Gymrek; Melissa Ann,0,0,0,0
1668403600568,CSE 290,A00,102399,Chandraker; Manmohan Krishna,0,0,0,0
1668403600568,CSE 290,B00,102400,Vaccaro; Kristen Marie,0,0,25,25
1668403600568,CSE 290,C00,102414,Pannuto; Patrick William,0,0,25,25
1668403600568,CSE 290,D00,102427,Pevzner; Pavel Arkadjevich,0,0,0,0
1668403600568,CSE 290,E00,102429,Zhao; Jishen,0,0,0,0
1668403600568,CSE 290,F00,102436,Tullsen; Dean Michael,0,0,0,0
1668403600568,CSE 290,G00,102440,Christensen; Henrik I,0,0,20,20
1668403600991,CSE 291,A00,102443,Su; Hao,0,0,0,0
1668403600991,CSE 291,B00,102448,Polikarpova; Nadezhda,0,0,0,0
1668403600991,CSE 291,C00,102453,Vaccaro; Kristen Marie,0,0,0,0
1668403600991,CSE 291,D00,111343,Savage; Stefan,0,0,0,0
1668403600991,CSE 291,E00,116474,Claffy; Kimberly Claire,0,0,0,0
1668403600991,CSE 291,F00,116479,Pasquale; Joseph,0,0,0,0
1668403601418,CSE 293,001,119111,Bafna; Vineet,9999,0,9999,0
1668403601418,CSE 293,002,119118,Bellare; Mihir,9999,0,9999,0
1668403601418,CSE 293,003,119122,Berg-Kirkpatrick; Taylor D,9999,0,9999,0
1668403601418,CSE 293,004,119135,Christensen; Henrik I,9999,0,9999,0
1668403601418,CSE 293,005,119142,Cottrell; Garrison W,9999,0,9999,0
1668403601418,CSE 293,006,119146,Deutsch; Alin Bernard,9999,0,9999,0
1668403601418,CSE 293,007,119159,Esmaeilzadeh; Hadi,9999,0,9999,0
1668403601418,CSE 293,008,119166,Freund; Yoav,9999,0,9999,0
1668403601418,CSE 293,009,119170,Griswold; William G.,9999,0,9999,0
1668403601418,CSE 293,010,119183,Gymrek; Melissa Ann,9999,0,9999,0
1668403601418,CSE 293,011,119190,Heninger; Nadia A,9999,0,9999,0
1668403601418,CSE 293,012,119230,Impagliazzo; Russell,9999,0,9999,0
1668403601418,CSE 293,013,119232,Jhala; Ranjit,9999,0,9999,0
1668403601418,CSE 293,014,119233,Kahng; Andrew Byun,9999,0,9999,0
1668403601418,CSE 293,015,119298,Kane; Daniel Mertz,9999,0,9999,0
1668403601418,CSE 293,016,119299,Kriegman; David J,9999,0,9999,0
1668403601418,CSE 293,017,119300,Kumar; Arun Kumar,9999,0,9999,0
1668403601418,CSE 293,018,119301,Lerner; Sorin,9999,0,9999,0
1668403601418,CSE 293,019,119302,Lovett; Shachar,9999,0,9999,0
1668403601418,CSE 293,020,119303,McAuley; Julian John,9999,0,9999,0
1668403601418,CSE 293,021,119304,Micciancio; Daniele,9999,0,9999,0
1668403601418,CSE 293,022,119367,Orailoglu; Alex,9999,0,9999,0
1668403601418,CSE 293,023,119382,Paturi; Ramamohan,9999,0,9999,0
1668403601418,CSE 293,024,119404,Polikarpova; Nadezhda,9999,0,9999,0
1668403601418,CSE 293,025,119406,Politz; Joseph Gibbs,9999,0,9999,0
1668403601418,CSE 293,026,119411,Porter; George M,9999,0,9999,0
1668403601418,CSE 293,027,119414,Porter; Leonard Emerson,9999,0,9999,0
1668403601418,CSE 293,028,119416,Ramamoorthi; Ravi,9999,0,9999,0
1668403601418,CSE 293,029,119417,Sahoo; Debashis,9999,0,9999,0
1668403601418,CSE 293,030,119420,Saul; Lawrence,9999,0,9999,0
1668403601418,CSE 293,031,119421,Savage; Stefan,9999,0,9999,0
1668403601418,CSE 293,032,119425,Schulze; Jurgen P.,9999,0,9999,0
1668403601418,CSE 293,033,119426,Snoeren; Alex C.,9999,0,9999,0
1668403601418,CSE 293,034,119428,Shang; Jingbo,9999,0,9999,0
1668403601418,CSE 293,035,119430,Stefan; Deian,9999,0,9999,0
1668403601418,CSE 293,036,119431,Su; Hao,9999,0,9999,0
1668403601418,CSE 293,037,119433,Swanson; Steven James,9999,0,9999,0
1668403601418,CSE 293,038,119435,Tullsen; Dean Michael,9999,0,9999,0
1668403601418,CSE 293,039,119483,Voelker; Geoffrey M.,9999,0,9999,0
1668403601418,CSE 293,040,119537,Zhao; Jishen,9999,0,9999,0
1668403601418,CSE 293,041,119538,Zhou; Yuan-Yuan,9999,0,9999,0
1668403601418,CSE 293,042,119539,Gao; Sicun,9999,0,9999,0
1668403601418,CSE 293,043,119540,Weibel; Nadir,9999,0,9999,0
1668403601418,CSE 293,044,119541,Gupta; Rajesh K.,9999,0,9999,0
1668403601418,CSE 293,045,126410,Vaccaro; Kristen Marie,9999,0,9999,0
1668403601418,CSE 293,046,126411,Klemke; Richard,9999,0,9999,0
1668403601850,CSE 294,A00,102459,Voelker; Geoffrey M.,0,0,0,0
1668403601850,CSE 294,B00,111322,Orailoglu; Alex,0,0,0,0
1668403602274,DSE 201,A00,096914,Deutsch; Alin Bernard,30,0,30,0
1668403602699,DSE 210,A00,096915,Dasgupta; Sanjoy,30,0,30,0
1668403603121,DSE 260A,A00,096916,Altintas De Callaf; Ilkay,30,0,30,0
1668403603549,ECE 200,001,103586,Antipa; Nicholas A,9999,0,9999,0
1668403603549,ECE 200,002,103587,Atanasov; Nikolay A.,9999,0,9999,0
1668403603549,ECE 200,003,103588,Bharadia; Dinesh,9999,0,9999,0
1668403603549,ECE 200,004,103589,Cheng; Chung Kuan,9999,0,9999,0
1668403603549,ECE 200,005,103590,Cosman; Pamela C.,9999,0,9999,0
1668403603549,ECE 200,006,103591,Dayeh; Shadi Ahmad,9999,0,9999,0
1668403603549,ECE 200,007,103592,Fainman; Yeshaiahu,9999,0,9999,0
1668403603549,ECE 200,008,103593,Ford; Joseph Earl,9999,0,9999,0
1668403603549,ECE 200,009,103594,Franceschetti; Massimo,9999,0,9999,0
1668403603549,ECE 200,010,103595,Fullerton; Eric E,9999,0,9999,0
1668403603549,ECE 200,011,103596,Galton; Ian A,9999,0,9999,0
1668403603549,ECE 200,012,103597,Gilja; Vikash,9999,0,9999,0
1668403603549,ECE 200,013,103598,Hall; Drew A.,9999,0,9999,0
1668403603549,ECE 200,014,103599,Hsueh; Tzu-Chien,9999,0,9999,0
1668403603549,ECE 200,015,103600,Javidi; Tara,9999,0,9999,0
1668403603549,ECE 200,016,103601,Kahng; Andrew Byun,9999,0,9999,0
1668403603549,ECE 200,017,103602,Kim; Young-Han,9999,0,9999,0
1668403603549,ECE 200,018,103603,Koushanfar; Farinaz,9999,0,9999,0
1668403603549,ECE 200,019,103604,Kuzum; Duygu,9999,0,9999,0
1668403603549,ECE 200,020,103605,Le; Hanh-Phuc,9999,0,9999,0
1668403603549,ECE 200,021,103606,Lin; Bill,9999,0,9999,0
1668403603549,ECE 200,022,103607,Liu; Zhaowei,9998,0,9999,1
1668403603549,ECE 200,023,103608,Lo; Yu-Hwa,9999,0,9999,0
1668403603549,ECE 200,024,103609,Lomakin; Vitaliy,9999,0,9999,0
1668403603549,ECE 200,025,103610,Mercier; Patrick Philip,9999,0,9999,0
1668403603549,ECE 200,026,103611,Meyer; Florian,9999,0,9999,0
1668403603549,ECE 200,027,103612,Milstein; Laurence B.,9999,0,9999,0
1668403603549,ECE 200,028,103613,Mir Arabbaygi; Siavash,9999,0,9999,0
1668403603549,ECE 200,029,103614,Mookherjea; Shayan,9999,0,9999,0
1668403603549,ECE 200,030,103615,Morris; Karcher William,9999,0,9999,0
1668403603549,ECE 200,031,103616,Ng; Tse Nga,9999,0,9999,0
1668403603549,ECE 200,032,103617,Nguyen; Truong Quang,9999,0,9999,0
1668403603549,ECE 200,033,103618,Nomura; Kenji,9999,0,9999,0
1668403603549,ECE 200,034,103619,Orlitsky; Alon,9999,0,9999,0
1668403603549,ECE 200,035,103620,Pal; Piya,9999,0,9999,0
1668403603549,ECE 200,036,103621,Papen; George C.,9999,0,9999,0
1668403603549,ECE 200,037,103622,Radic; Stojan,9999,0,9999,0
1668403603549,ECE 200,038,103623,Rao; Bhaskar D.,9999,0,9999,0
1668403603549,ECE 200,039,103624,Rao; Ramesh R,9999,0,9999,0
1668403603549,ECE 200,040,103625,Rebeiz; Gabriel,9999,0,9999,0
1668403603549,ECE 200,041,103626,Sanford; John R,9999,0,9999,0
1668403603549,ECE 200,042,103627,Siegel; Paul H.,9999,0,9999,0
1668403603549,ECE 200,043,103628,Sievenpiper; Daniel F.,9999,0,9999,0
1668403603549,ECE 200,044,103629,Sworder; David D.,9999,0,9999,0
1668403603549,ECE 200,045,103630,Taur; Yuan,9999,0,9999,0
1668403603549,ECE 200,046,103631,Touri; Behrouz,9999,0,9999,0
1668403603549,ECE 200,047,103632,Trivedi; Mohan M.,9999,0,9999,0
1668403603549,ECE 200,048,103633,Vasconcelos; Nuno,9999,0,9999,0
1668403603549,ECE 200,049,103634,Wang; Xiaolong,9999,0,9999,0
1668403603549,ECE 200,050,103635,Xie; Pengtao,9999,0,9999,0
1668403603549,ECE 200,051,103636,Yip; Michael,9999,0,9999,0
1668403603549,ECE 200,052,103637,Zeger; Kenneth A.,999,0,999,0
1668403603549,ECE 200,053,103638,Zhang; Xinyu,9999,0,9999,0
1668403603549,ECE 200,054,103639,Turakhia; Yatish Girish,9999,0,9999,0
1668403603549,ECE 200,055,103640,Kang; Mingu,9999,0,9999,0
1668403603549,ECE 200,056,103641,Shi; Yuanyuan,9999,0,9999,0
1668403603549,ECE 200,057,103642,Wang; Edward Jay,9999,0,9999,0
1668403603549,ECE 200,058,103643,Zheng; Yang,9999,0,9999,0
1668403603973,ECE 202,A00,103644,Kuzum; Duygu,0,0,0,0
1668403604407,ECE 212BN,A00,103646,Ng; Tse Nga,0,0,0,0
1668403604840,ECE 221,A00,111493,Staff,0,0,0,0
1668403605265,ECE 222B,A00,103647,Lomakin; Vitaliy,0,0,0,0
1668403605695,ECE 230B,A00,103648,Taur; Yuan,0,0,0,0
1668403606122,ECE 238B,A00,103649,Garay; Javier,0,0,0,0
1668403606544,ECE 240B,A00,112900,Fainman; Yeshaiahu,0,0,0,0
1668403606968,ECE 247A,A00,103650,Jokerst; Jesse Vincent,0,0,0,0
1668403607395,ECE 247B,A00,103651,Wang; Joseph,0,0,0,0
1668403607820,ECE 250,A00,103652,Siegel; Paul H.,0,0,0,0
1668403608246,ECE 251A,A00,103654,Rao; Bhaskar D.,0,0,0,0
1668403608670,ECE 257B,A00,103655,Bharadia; Dinesh,0,0,0,0
1668403609097,ECE 258A,A00,103656,Milstein; Laurence B.,0,0,0,0
1668403609528,ECE 260B,A00,103658,Kang; Mingu,0,0,0,0
1668403609956,ECE 264A,A00,103659,Galton; Ian A,0,0,0,0
1668403610379,ECE 265A,A00,103661,Gudem; Prasad S.S.,0,0,0,0
1668403610802,ECE 265D,A00,103662,Gudem; Prasad S.S.,0,0,0,0
1668403611237,ECE 268,A00,103663,Koushanfar; Farinaz,0,0,0,0
1668403611663,ECE 269,A01,103665,Pal; Piya,0,0,0,0
1668403612094,ECE 271B,A00,103666,Vasconcelos; Manuela,0,0,0,0
1668403612522,ECE 276A,A00,103667,Atanasov; Nikolay A.,0,0,0,0
1668403613048,ECE 277,A00,103668,An; Cheolhong,0,0,0,0
1668403613470,ECE 279,A00,117947,Hall; Drew A.,0,0,0,0
1668403614325,ECE 283,A00,103670,Hsueh; Tzu-Chien,0,0,0,0
1668403614751,ECE 284,A00,103671,Turakhia; Yatish Girish,0,0,0,0
1668403615174,ECE 285,A00,103672,Zheng; Yang,0,0,0,0
1668403615174,ECE 285,B00,103673,Sworder; David D.,0,0,0,0
1668403615597,ECE 287,A00,103676,Javidi; Tara,0,0,0,0
1668403616018,MATH 200B,A00,098023,Salehi Golsefidy; Alireza,12,0,15,3
1668403616445,MATH 202B,A00,098024,Rhoades; Brendon Patrick,9,0,15,6
1668403616878,MATH 203B,A00,098025,Oprea; Dragos N.,10,0,15,5
1668403617301,MATH 204B,A00,098026,Sorensen; Claus M,13,0,15,2
1668403617725,MATH 208,A00,098027,Izadi; Elham,7,0,10,3
1668403618152,MATH 209,A00,098028,Pollack; Aaron,10,0,10,0
1668403618574,MATH 211A,A00,112919,Rogalski; Daniel,9,0,10,1
1668403618999,MATH 211B,A00,112920,Seward; Brandon M.,9,0,10,1
1668403619423,MATH 218,A00,098029,Li; Bo,10,0,10,0
1668403619853,MATH 220B,A00,098030,Novak; Jonathan I,11,0,15,4
1668403620277,MATH 221A,A00,098031,Ebenfelt; Peter F,13,0,15,2
1668403620701,MATH 231B,A00,098032,Zlatos; Andrej,12,0,15,3
1668403621122,MATH 240B,A00,098033,Ni; Lei,9,0,15,6
1668403621547,MATH 243,A00,098034,Jekel; David Andrew,10,0,10,0
1668403621969,MATH 245A,A00,098035,Nie; Jiawang,0,0,15,16
1668403622394,MATH 248,A00,098036,Bejenaru; Ioan,10,0,10,0
1668403622819,MATH 250B,A00,098037,Spolaor; Luca,14,0,15,1
1668403623242,MATH 258,A00,098038,Ni; Lei,10,0,10,0
1668403623665,MATH 264B,A00,098041,Rhoades; Brendon Patrick,9,0,15,6
1668403624089,MATH 268,A00,098042,Buss; Samuel R,10,0,10,0
1668403624511,MATH 269,A00,098043,Rhoades; Brendon Patrick,10,0,10,0
1668403624935,MATH 270B,A00,098044,Li; Bo,10,0,15,5
1668403625360,MATH 272B,A00,098045,Holst; Michael J,13,0,15,2
1668403625784,MATH 273A,A00,098046,Tian; Xiaochuan,10,0,15,5
1668403626211,MATH 275,A01,098048,Tian; Xiaochuan,6,0,10,4
1668403626638,MATH 278A,A00,098049,Holst; Michael J,8,0,10,2
1668403627064,MATH 278B,A00,098050,Cloninger; Alexander,10,0,10,0
1668403627501,MATH 278C,A00,098051,Nie; Jiawang,6,0,10,4
1668403627937,MATH 280B,A00,098052,Zheng; Tianyi,8,0,15,7
1668403628359,MATH 281B,A00,098053,Bradic; Jelena,0,0,15,15
1668403628791,MATH 282B,A00,098054,Arias-Castro; Ery,0,0,15,15
1668403629248,MATH 285,A00,098055,Fitzsimmons; Patrick J,0,0,15,17
1668403629683,MATH 287B,A00,098056,Arias-Castro; Ery,2,0,15,13
1668403630119,MATH 288,A00,098057,Agarwal; Pooja,9,0,10,1
1668403630119,MATH 288,B00,098058,Zhang; Danna,8,0,10,2
1668403630119,MATH 288,C00,098059,Williams; Ruth J,9,0,10,1
1668403630558,MATH 290B,A00,098060,Roberts; Justin Deritter,13,0,15,2
1668403630992,MATH 292,A00,098061,Belmont; Eva Kinoshita,10,0,10,0
1668403631416,MATH 295,A00,098062,Suk; Andrew Hoon,48,0,50,2
1668403631852,MATH 296,A00,098063,Novak; Jonathan I,20,0,20,0
1668403632275,MATH 297,001,098064,Gamst; Anthony Collins,9997,0,9999,2
1668404132853,COGS 205,A00,101395,Chiba; Andrea,19,0,20,1
1668404133295,COGS 210B,001,101404,Greene; Deanna Jacquelyn,9998,0,9999,1
1668404133295,COGS 210B,002,101417,Xia; Haijun,9999,0,9999,0
1668404133295,COGS 210B,003,101422,Nitz; Douglas A.,9999,0,9999,0
1668404133295,COGS 210B,004,101423,Hollan; James D.,9998,0,9999,1
1668404133295,COGS 210B,005,101424,Deak; Gedeon O.,9998,0,9999,1
1668404133295,COGS 210B,006,101425,Rossano; Federico,9999,0,9999,0
1668404133812,COGS 211B,A00,101427,Coulson; Seana M,9996,0,9999,3
1668404134237,COGS 220,A00,101428,Hollan; James D.,0,0,25,25
1668404134662,COGS 229,A00,101429,Dow; Steven P,18,0,25,7
1668404135098,COGS 230,A00,101430,Klemmer; Scott R,11,0,17,6
1668404135521,COGS 234,A00,101431,Xia; Haijun,1,0,25,24
1668404135946,COGS 260,A00,101432,Kiyonaga; Anastasia,21,0,25,4
1668404135946,COGS 260,B00,101433,Kirsh; David Joel,15,0,25,10
1668404136371,CSE 202,A00,102371,Impagliazzo; Russell,0,0,0,0
1668404136804,CSE 203B,A01,102373,Cheng; Chung Kuan,0,0,0,0
1668404137234,CSE 208,A00,102374,Micciancio; Daniele,0,0,0,0
1668404137665,CSE 209A,A00,112895,Impagliazzo; Russell,0,0,15,15
1668404138089,CSE 209B,A00,108005,Bellare; Mihir,0,0,0,0
1668404138511,CSE 210,A00,113163,Coblenz; Michael J,0,0,0,0
1668404138936,CSE 219,A00,106111,Dow; Steven P,0,0,20,20
1668404139358,CSE 221,A00,102376,Voelker; Geoffrey M.,0,0,0,0
1668404139786,CSE 224,A01,102378,Porter; George M,0,0,0,0
1668404140212,CSE 229A,A00,102379,Savage; Stefan,0,0,0,0
1668404140635,CSE 229C,A00,102380,Munyaka; Imani N. S.,0,0,0,0
1668404141059,CSE 232B,A00,102382,Deutsch; Alin Bernard,0,0,0,0
1668404141491,CSE 234,A01,112904,Kumar; Arun Kumar,0,0,0,0
1668404141917,CSE 237A,A00,102383,Rosing; Tajana Simunic,0,0,0,0
1668404142339,CSE 239A,A00,102384,Deutsch; Alin Bernard,0,0,0,0
1668404142762,CSE 239B,A00,102385,Polikarpova; Nadezhda,0,0,0,0
1668404143190,CSE 240A,A00,102386,Pannuto; Patrick William,0,0,0,0
1668404143614,CSE 240B,A00,102387,Zhao; Jishen,0,0,0,0
1668404144038,CSE 241A,A00,106406,Kang; Mingu,0,0,0,0
1668404144461,CSE 249B,A00,102388,Kahng; Andrew Byun,0,0,8,8
1668404144888,CSE 251B,A01,102392,Cottrell; Garrison W,0,0,0,0
1668404144888,CSE 251B,A02,102393,Cottrell; Garrison W,0,0,0,0
1668404145316,CSE 252B,A00,102394,Ochoa; Benjamin Lawrence,0,0,0,0
1668404145741,CSE 257,A01,102396,Gao; Sicun,0,0,0,0
1668404146163,CSE 272,A00,102397,Li; Tzumao,0,0,0,0
1668404146599,CSE 274,A00,111323,Chern; Albert Ren-Haur,0,0,0,0
1668404147030,CSE 282,A00,102398,Pevzner; Pavel Arkadjevich,0,0,0,0
1668404147456,CSE 284,A00,114175,Gymrek; Melissa Ann,0,0,0,0
1668404147881,CSE 290,A00,102399,Chandraker; Manmohan Krishna,0,0,0,0
1668404147881,CSE 290,B00,102400,Vaccaro; Kristen Marie,0,0,25,25
1668404147881,CSE 290,C00,102414,Pannuto; Patrick William,0,0,25,25
1668404147881,CSE 290,D00,102427,Pevzner; Pavel Arkadjevich,0,0,0,0
1668404147881,CSE 290,E00,102429,Zhao; Jishen,0,0,0,0
1668404147881,CSE 290,F00,102436,Tullsen; Dean Michael,0,0,0,0
1668404147881,CSE 290,G00,102440,Christensen; Henrik I,0,0,20,20
1668404148311,CSE 291,A00,102443,Su; Hao,0,0,0,0
1668404148311,CSE 291,B00,102448,Polikarpova; Nadezhda,0,0,0,0
1668404148311,CSE 291,C00,102453,Vaccaro; Kristen Marie,0,0,0,0
1668404148311,CSE 291,D00,111343,Savage; Stefan,0,0,0,0
1668404148311,CSE 291,E00,116474,Claffy; Kimberly Claire,0,0,0,0
1668404148311,CSE 291,F00,116479,Pasquale; Joseph,0,0,0,0
1668404148765,CSE 293,001,119111,Bafna; Vineet,9999,0,9999,0
1668404148765,CSE 293,002,119118,Bellare; Mihir,9999,0,9999,0
1668404148765,CSE 293,003,119122,Berg-Kirkpatrick; Taylor D,9999,0,9999,0
1668404148765,CSE 293,004,119135,Christensen; Henrik I,9999,0,9999,0
1668404148765,CSE 293,005,119142,Cottrell; Garrison W,9999,0,9999,0
1668404148765,CSE 293,006,119146,Deutsch; Alin Bernard,9999,0,9999,0
1668404148765,CSE 293,007,119159,Esmaeilzadeh; Hadi,9999,0,9999,0
1668404148765,CSE 293,008,119166,Freund; Yoav,9999,0,9999,0
1668404148765,CSE 293,009,119170,Griswold; William G.,9999,0,9999,0
1668404148765,CSE 293,010,119183,Gymrek; Melissa Ann,9999,0,9999,0
1668404148765,CSE 293,011,119190,Heninger; Nadia A,9999,0,9999,0
1668404148765,CSE 293,012,119230,Impagliazzo; Russell,9999,0,9999,0
1668404148765,CSE 293,013,119232,Jhala; Ranjit,9999,0,9999,0
1668404148765,CSE 293,014,119233,Kahng; Andrew Byun,9999,0,9999,0
1668404148765,CSE 293,015,119298,Kane; Daniel Mertz,9999,0,9999,0
1668404148765,CSE 293,016,119299,Kriegman; David J,9999,0,9999,0
1668404148765,CSE 293,017,119300,Kumar; Arun Kumar,9999,0,9999,0
1668404148765,CSE 293,018,119301,Lerner; Sorin,9999,0,9999,0
1668404148765,CSE 293,019,119302,Lovett; Shachar,9999,0,9999,0
1668404148765,CSE 293,020,119303,McAuley; Julian John,9999,0,9999,0
1668404148765,CSE 293,021,119304,Micciancio; Daniele,9999,0,9999,0
1668404148765,CSE 293,022,119367,Orailoglu; Alex,9999,0,9999,0
1668404148765,CSE 293,023,119382,Paturi; Ramamohan,9999,0,9999,0
1668404148765,CSE 293,024,119404,Polikarpova; Nadezhda,9999,0,9999,0
1668404148765,CSE 293,025,119406,Politz; Joseph Gibbs,9999,0,9999,0
1668404148765,CSE 293,026,119411,Porter; George M,9999,0,9999,0
1668404148765,CSE 293,027,119414,Porter; Leonard Emerson,9999,0,9999,0
1668404148765,CSE 293,028,119416,Ramamoorthi; Ravi,9999,0,9999,0
1668404148765,CSE 293,029,119417,Sahoo; Debashis,9999,0,9999,0
1668404148765,CSE 293,030,119420,Saul; Lawrence,9999,0,9999,0
1668404148765,CSE 293,031,119421,Savage; Stefan,9999,0,9999,0
1668404148765,CSE 293,032,119425,Schulze; Jurgen P.,9999,0,9999,0
1668404148765,CSE 293,033,119426,Snoeren; Alex C.,9999,0,9999,0
1668404148765,CSE 293,034,119428,Shang; Jingbo,9999,0,9999,0
1668404148765,CSE 293,035,119430,Stefan; Deian,9999,0,9999,0
1668404148765,CSE 293,036,119431,Su; Hao,9999,0,9999,0
1668404148765,CSE 293,037,119433,Swanson; Steven James,9999,0,9999,0
1668404148765,CSE 293,038,119435,Tullsen; Dean Michael,9999,0,9999,0
1668404148765,CSE 293,039,119483,Voelker; Geoffrey M.,9999,0,9999,0
1668404148765,CSE 293,040,119537,Zhao; Jishen,9999,0,9999,0
1668404148765,CSE 293,041,119538,Zhou; Yuan-Yuan,9999,0,9999,0
1668404148765,CSE 293,042,119539,Gao; Sicun,9999,0,9999,0
1668404148765,CSE 293,043,119540,Weibel; Nadir,9999,0,9999,0
1668404148765,CSE 293,044,119541,Gupta; Rajesh K.,9999,0,9999,0
1668404148765,CSE 293,045,126410,Vaccaro; Kristen Marie,9999,0,9999,0
1668404148765,CSE 293,046,126411,Klemke; Richard,9999,0,9999,0
1668404149191,CSE 294,A00,102459,Voelker; Geoffrey M.,0,0,0,0
1668404149191,CSE 294,B00,111322,Orailoglu; Alex,0,0,0,0
1668404149615,DSE 201,A00,096914,Deutsch; Alin Bernard,30,0,30,0
1668404150038,DSE 210,A00,096915,Dasgupta; Sanjoy,30,0,30,0
1668404150465,DSE 260A,A00,096916,Altintas De Callaf; Ilkay,30,0,30,0
1668404150905,ECE 200,001,103586,Antipa; Nicholas A,9999,0,9999,0
1668404150905,ECE 200,002,103587,Atanasov; Nikolay A.,9999,0,9999,0
1668404150905,ECE 200,003,103588,Bharadia; Dinesh,9999,0,9999,0
1668404150905,ECE 200,004,103589,Cheng; Chung Kuan,9999,0,9999,0
1668404150905,ECE 200,005,103590,Cosman; Pamela C.,9999,0,9999,0
1668404150905,ECE 200,006,103591,Dayeh; Shadi Ahmad,9999,0,9999,0
1668404150905,ECE 200,007,103592,Fainman; Yeshaiahu,9999,0,9999,0
1668404150905,ECE 200,008,103593,Ford; Joseph Earl,9999,0,9999,0
1668404150905,ECE 200,009,103594,Franceschetti; Massimo,9999,0,9999,0
1668404150905,ECE 200,010,103595,Fullerton; Eric E,9999,0,9999,0
1668404150905,ECE 200,011,103596,Galton; Ian A,9999,0,9999,0
1668404150905,ECE 200,012,103597,Gilja; Vikash,9999,0,9999,0
1668404150905,ECE 200,013,103598,Hall; Drew A.,9999,0,9999,0
1668404150905,ECE 200,014,103599,Hsueh; Tzu-Chien,9999,0,9999,0
1668404150905,ECE 200,015,103600,Javidi; Tara,9999,0,9999,0
1668404150905,ECE 200,016,103601,Kahng; Andrew Byun,9999,0,9999,0
1668404150905,ECE 200,017,103602,Kim; Young-Han,9999,0,9999,0
1668404150905,ECE 200,018,103603,Koushanfar; Farinaz,9999,0,9999,0
1668404150905,ECE 200,019,103604,Kuzum; Duygu,9999,0,9999,0
1668404150905,ECE 200,020,103605,Le; Hanh-Phuc,9999,0,9999,0
1668404150905,ECE 200,021,103606,Lin; Bill,9999,0,9999,0
1668404150905,ECE 200,022,103607,Liu; Zhaowei,9998,0,9999,1
1668404150905,ECE 200,023,103608,Lo; Yu-Hwa,9999,0,9999,0
1668404150905,ECE 200,024,103609,Lomakin; Vitaliy,9999,0,9999,0
1668404150905,ECE 200,025,103610,Mercier; Patrick Philip,9999,0,9999,0
1668404150905,ECE 200,026,103611,Meyer; Florian,9999,0,9999,0
1668404150905,ECE 200,027,103612,Milstein; Laurence B.,9999,0,9999,0
1668404150905,ECE 200,028,103613,Mir Arabbaygi; Siavash,9999,0,9999,0
1668404150905,ECE 200,029,103614,Mookherjea; Shayan,9999,0,9999,0
1668404150905,ECE 200,030,103615,Morris; Karcher William,9999,0,9999,0
1668404150905,ECE 200,031,103616,Ng; Tse Nga,9999,0,9999,0
1668404150905,ECE 200,032,103617,Nguyen; Truong Quang,9999,0,9999,0
1668404150905,ECE 200,033,103618,Nomura; Kenji,9999,0,9999,0
1668404150905,ECE 200,034,103619,Orlitsky; Alon,9999,0,9999,0
1668404150905,ECE 200,035,103620,Pal; Piya,9999,0,9999,0
1668404150905,ECE 200,036,103621,Papen; George C.,9999,0,9999,0
1668404150905,ECE 200,037,103622,Radic; Stojan,9999,0,9999,0
1668404150905,ECE 200,038,103623,Rao; Bhaskar D.,9999,0,9999,0
1668404150905,ECE 200,039,103624,Rao; Ramesh R,9999,0,9999,0
1668404150905,ECE 200,040,103625,Rebeiz; Gabriel,9999,0,9999,0
1668404150905,ECE 200,041,103626,Sanford; John R,9999,0,9999,0
1668404150905,ECE 200,042,103627,Siegel; Paul H.,9999,0,9999,0
1668404150905,ECE 200,043,103628,Sievenpiper; Daniel F.,9999,0,9999,0
1668404150905,ECE 200,044,103629,Sworder; David D.,9999,0,9999,0
1668404150905,ECE 200,045,103630,Taur; Yuan,9999,0,9999,0
1668404150905,ECE 200,046,103631,Touri; Behrouz,9999,0,9999,0
1668404150905,ECE 200,047,103632,Trivedi; Mohan M.,9999,0,9999,0
1668404150905,ECE 200,048,103633,Vasconcelos; Nuno,9999,0,9999,0
1668404150905,ECE 200,049,103634,Wang; Xiaolong,9999,0,9999,0
1668404150905,ECE 200,050,103635,Xie; Pengtao,9999,0,9999,0
1668404150905,ECE 200,051,103636,Yip; Michael,9999,0,9999,0
1668404150905,ECE 200,052,103637,Zeger; Kenneth A.,999,0,999,0
1668404150905,ECE 200,053,103638,Zhang; Xinyu,9999,0,9999,0
1668404150905,ECE 200,054,103639,Turakhia; Yatish Girish,9999,0,9999,0
1668404150905,ECE 200,055,103640,Kang; Mingu,9999,0,9999,0
1668404150905,ECE 200,056,103641,Shi; Yuanyuan,9999,0,9999,0
1668404150905,ECE 200,057,103642,Wang; Edward Jay,9999,0,9999,0
1668404150905,ECE 200,058,103643,Zheng; Yang,9999,0,9999,0
1668404151329,ECE 202,A00,103644,Kuzum; Duygu,0,0,0,0
1668404151752,ECE 212BN,A00,103646,Ng; Tse Nga,0,0,0,0
1668404152177,ECE 221,A00,111493,Staff,0,0,0,0
1668404152601,ECE 222B,A00,103647,Lomakin; Vitaliy,0,0,0,0
1668404153025,ECE 230B,A00,103648,Taur; Yuan,0,0,0,0
1668404153447,ECE 238B,A00,103649,Garay; Javier,0,0,0,0
1668404153870,ECE 240B,A00,112900,Fainman; Yeshaiahu,0,0,0,0
1668404154306,ECE 247A,A00,103650,Jokerst; Jesse Vincent,0,0,0,0
1668404154740,ECE 247B,A00,103651,Wang; Joseph,0,0,0,0
1668404155162,ECE 250,A00,103652,Siegel; Paul H.,0,0,0,0
1668404155584,ECE 251A,A00,103654,Rao; Bhaskar D.,0,0,0,0
1668404156019,ECE 257B,A00,103655,Bharadia; Dinesh,0,0,0,0
1668404156441,ECE 258A,A00,103656,Milstein; Laurence B.,0,0,0,0
1668404156864,ECE 260B,A00,103658,Kang; Mingu,0,0,0,0
1668404157290,ECE 264A,A00,103659,Galton; Ian A,0,0,0,0
1668404157715,ECE 265A,A00,103661,Gudem; Prasad S.S.,0,0,0,0
1668404158140,ECE 265D,A00,103662,Gudem; Prasad S.S.,0,0,0,0
1668404158563,ECE 268,A00,103663,Koushanfar; Farinaz,0,0,0,0
1668404158987,ECE 269,A01,103665,Pal; Piya,0,0,0,0
1668404159410,ECE 271B,A00,103666,Vasconcelos; Manuela,0,0,0,0
1668404159831,ECE 276A,A00,103667,Atanasov; Nikolay A.,0,0,0,0
1668404160260,ECE 277,A00,103668,An; Cheolhong,0,0,0,0
1668404160682,ECE 279,A00,117947,Hall; Drew A.,0,0,0,0
1668404161533,ECE 283,A00,103670,Hsueh; Tzu-Chien,0,0,0,0
1668404161956,ECE 284,A00,103671,Turakhia; Yatish Girish,0,0,0,0
1668404162379,ECE 285,A00,103672,Zheng; Yang,0,0,0,0
1668404162379,ECE 285,B00,103673,Sworder; David D.,0,0,0,0
1668404162812,ECE 287,A00,103676,Javidi; Tara,0,0,0,0
1668404163235,MATH 200B,A00,098023,Salehi Golsefidy; Alireza,12,0,15,3
1668404163663,MATH 202B,A00,098024,Rhoades; Brendon Patrick,9,0,15,6
1668404164093,MATH 203B,A00,098025,Oprea; Dragos N.,10,0,15,5
1668404164515,MATH 204B,A00,098026,Sorensen; Claus M,13,0,15,2
1668404164949,MATH 208,A00,098027,Izadi; Elham,7,0,10,3
1668404165381,MATH 209,A00,098028,Pollack; Aaron,10,0,10,0
1668404165814,MATH 211A,A00,112919,Rogalski; Daniel,9,0,10,1
1668404166238,MATH 211B,A00,112920,Seward; Brandon M.,9,0,10,1
1668404166665,MATH 218,A00,098029,Li; Bo,10,0,10,0
1668404167092,MATH 220B,A00,098030,Novak; Jonathan I,11,0,15,4
1668404167520,MATH 221A,A00,098031,Ebenfelt; Peter F,13,0,15,2
1668404167943,MATH 231B,A00,098032,Zlatos; Andrej,12,0,15,3
1668404168366,MATH 240B,A00,098033,Ni; Lei,9,0,15,6
1668404168795,MATH 243,A00,098034,Jekel; David Andrew,10,0,10,0
1668404169226,MATH 245A,A00,098035,Nie; Jiawang,0,0,15,16
1668404169649,MATH 248,A00,098036,Bejenaru; Ioan,10,0,10,0
1668404170073,MATH 250B,A00,098037,Spolaor; Luca,14,0,15,1
1668404170502,MATH 258,A00,098038,Ni; Lei,10,0,10,0
1668404170925,MATH 264B,A00,098041,Rhoades; Brendon Patrick,9,0,15,6
1668404171351,MATH 268,A00,098042,Buss; Samuel R,10,0,10,0
1668404171775,MATH 269,A00,098043,Rhoades; Brendon Patrick,10,0,10,0
1668404172197,MATH 270B,A00,098044,Li; Bo,10,0,15,5
1668404172624,MATH 272B,A00,098045,Holst; Michael J,13,0,15,2
1668404173046,MATH 273A,A00,098046,Tian; Xiaochuan,10,0,15,5
1668404173470,MATH 275,A01,098048,Tian; Xiaochuan,6,0,10,4
1668404173893,MATH 278A,A00,098049,Holst; Michael J,8,0,10,2
1668404174319,MATH 278B,A00,098050,Cloninger; Alexander,10,0,10,0
1668404174741,MATH 278C,A00,098051,Nie; Jiawang,6,0,10,4
1668404175170,MATH 280B,A00,098052,Zheng; Tianyi,8,0,15,7
1668404175602,MATH 281B,A00,098053,Bradic; Jelena,0,0,15,15
1668404176024,MATH 282B,A00,098054,Arias-Castro; Ery,0,0,15,15
1668404176449,MATH 285,A00,098055,Fitzsimmons; Patrick J,0,0,15,17
1668404176949,MATH 287B,A00,098056,Arias-Castro; Ery,2,0,15,13
1668404177378,MATH 288,A00,098057,Agarwal; Pooja,9,0,10,1
1668404177378,MATH 288,B00,098058,Zhang; Danna,8,0,10,2
1668404177378,MATH 288,C00,098059,Williams; Ruth J,9,0,10,1
1668404177802,MATH 290B,A00,098060,Roberts; Justin Deritter,13,0,15,2
1668404178232,MATH 292,A00,098061,Belmont; Eva Kinoshita,10,0,10,0
1668404178665,MATH 295,A00,098062,Suk; Andrew Hoon,48,0,50,2
1668404179090,MATH 296,A00,098063,Novak; Jonathan I,20,0,20,0
1668404179511,MATH 297,001,098064,Gamst; Anthony Collins,9997,0,9999,2
1668404680083,COGS 205,A00,101395,Chiba; Andrea,19,0,20,1
1668404680518,COGS 210B,001,101404,Greene; Deanna Jacquelyn,9998,0,9999,1
1668404680518,COGS 210B,002,101417,Xia; Haijun,9999,0,9999,0
1668404680518,COGS 210B,003,101422,Nitz; Douglas A.,9999,0,9999,0
1668404680518,COGS 210B,004,101423,Hollan; James D.,9998,0,9999,1
1668404680518,COGS 210B,005,101424,Deak; Gedeon O.,9998,0,9999,1
1668404680518,COGS 210B,006,101425,Rossano; Federico,9999,0,9999,0
1668404680946,COGS 211B,A00,101427,Coulson; Seana M,9996,0,9999,3
1668404681389,COGS 220,A00,101428,Hollan; James D.,0,0,25,25
1668404681813,COGS 229,A00,101429,Dow; Steven P,18,0,25,7
1668404682239,COGS 230,A00,101430,Klemmer; Scott R,11,0,17,6
1668404682662,COGS 234,A00,101431,Xia; Haijun,1,0,25,24
1668404683091,COGS 260,A00,101432,Kiyonaga; Anastasia,21,0,25,4
1668404683091,COGS 260,B00,101433,Kirsh; David Joel,15,0,25,10
1668404683518,CSE 202,A00,102371,Impagliazzo; Russell,0,0,0,0
1668404683941,CSE 203B,A01,102373,Cheng; Chung Kuan,0,0,0,0
1668404684369,CSE 208,A00,102374,Micciancio; Daniele,0,0,0,0
1668404684793,CSE 209A,A00,112895,Impagliazzo; Russell,0,0,15,15
1668404685217,CSE 209B,A00,108005,Bellare; Mihir,0,0,0,0
1668404685641,CSE 210,A00,113163,Coblenz; Michael J,0,0,0,0
1668404686063,CSE 219,A00,106111,Dow; Steven P,0,0,20,20
1668404686497,CSE 221,A00,102376,Voelker; Geoffrey M.,0,0,0,0
1668404686936,CSE 224,A01,102378,Porter; George M,0,0,0,0
1668404687359,CSE 229A,A00,102379,Savage; Stefan,0,0,0,0
1668404687795,CSE 229C,A00,102380,Munyaka; Imani N. S.,0,0,0,0
1668404688223,CSE 232B,A00,102382,Deutsch; Alin Bernard,0,0,0,0
1668404688648,CSE 234,A01,112904,Kumar; Arun Kumar,0,0,0,0
1668404689077,CSE 237A,A00,102383,Rosing; Tajana Simunic,0,0,0,0
1668404689511,CSE 239A,A00,102384,Deutsch; Alin Bernard,0,0,0,0
1668404689934,CSE 239B,A00,102385,Polikarpova; Nadezhda,0,0,0,0
1668404690359,CSE 240A,A00,102386,Pannuto; Patrick William,0,0,0,0
1668404690793,CSE 240B,A00,102387,Zhao; Jishen,0,0,0,0
1668404691219,CSE 241A,A00,106406,Kang; Mingu,0,0,0,0
1668404691644,CSE 249B,A00,102388,Kahng; Andrew Byun,0,0,8,8
1668404692073,CSE 251B,A01,102392,Cottrell; Garrison W,0,0,0,0
1668404692073,CSE 251B,A02,102393,Cottrell; Garrison W,0,0,0,0
1668404692507,CSE 252B,A00,102394,Ochoa; Benjamin Lawrence,0,0,0,0
1668404692934,CSE 257,A01,102396,Gao; Sicun,0,0,0,0
1668404693379,CSE 272,A00,102397,Li; Tzumao,0,0,0,0
1668404693817,CSE 274,A00,111323,Chern; Albert Ren-Haur,0,0,0,0
1668404694248,CSE 282,A00,102398,Pevzner; Pavel Arkadjevich,0,0,0,0
1668404694673,CSE 284,A00,114175,Gymrek; Melissa Ann,0,0,0,0
1668404695097,CSE 290,A00,102399,Chandraker; Manmohan Krishna,0,0,0,0
1668404695097,CSE 290,B00,102400,Vaccaro; Kristen Marie,0,0,25,25
1668404695097,CSE 290,C00,102414,Pannuto; Patrick William,0,0,25,25
1668404695097,CSE 290,D00,102427,Pevzner; Pavel Arkadjevich,0,0,0,0
1668404695097,CSE 290,E00,102429,Zhao; Jishen,0,0,0,0
1668404695097,CSE 290,F00,102436,Tullsen; Dean Michael,0,0,0,0
1668404695097,CSE 290,G00,102440,Christensen; Henrik I,0,0,20,20
1668404695525,CSE 291,A00,102443,Su; Hao,0,0,0,0
1668404695525,CSE 291,B00,102448,Polikarpova; Nadezhda,0,0,0,0
1668404695525,CSE 291,C00,102453,Vaccaro; Kristen Marie,0,0,0,0
1668404695525,CSE 291,D00,111343,Savage; Stefan,0,0,0,0
1668404695525,CSE 291,E00,116474,Claffy; Kimberly Claire,0,0,0,0
1668404695525,CSE 291,F00,116479,Pasquale; Joseph,0,0,0,0
1668404695964,CSE 293,001,119111,Bafna; Vineet,9999,0,9999,0
1668404695964,CSE 293,002,119118,Bellare; Mihir,9999,0,9999,0
1668404695964,CSE 293,003,119122,Berg-Kirkpatrick; Taylor D,9999,0,9999,0
1668404695964,CSE 293,004,119135,Christensen; Henrik I,9999,0,9999,0
1668404695964,CSE 293,005,119142,Cottrell; Garrison W,9999,0,9999,0
1668404695964,CSE 293,006,119146,Deutsch; Alin Bernard,9999,0,9999,0
1668404695964,CSE 293,007,119159,Esmaeilzadeh; Hadi,9999,0,9999,0
1668404695964,CSE 293,008,119166,Freund; Yoav,9999,0,9999,0
1668404695964,CSE 293,009,119170,Griswold; William G.,9999,0,9999,0
1668404695964,CSE 293,010,119183,Gymrek; Melissa Ann,9999,0,9999,0
1668404695964,CSE 293,011,119190,Heninger; Nadia A,9999,0,9999,0
1668404695964,CSE 293,012,119230,Impagliazzo; Russell,9999,0,9999,0
1668404695964,CSE 293,013,119232,Jhala; Ranjit,9999,0,9999,0
1668404695964,CSE 293,014,119233,Kahng; Andrew Byun,9999,0,9999,0
1668404695964,CSE 293,015,119298,Kane; Daniel Mertz,9999,0,9999,0
1668404695964,CSE 293,016,119299,Kriegman; David J,9999,0,9999,0
1668404695964,CSE 293,017,119300,Kumar; Arun Kumar,9999,0,9999,0
1668404695964,CSE 293,018,119301,Lerner; Sorin,9999,0,9999,0
1668404695964,CSE 293,019,119302,Lovett; Shachar,9999,0,9999,0
1668404695964,CSE 293,020,119303,McAuley; Julian John,9999,0,9999,0
1668404695964,CSE 293,021,119304,Micciancio; Daniele,9999,0,9999,0
1668404695964,CSE 293,022,119367,Orailoglu; Alex,9999,0,9999,0
1668404695964,CSE 293,023,119382,Paturi; Ramamohan,9999,0,9999,0
1668404695964,CSE 293,024,119404,Polikarpova; Nadezhda,9999,0,9999,0
1668404695964,CSE 293,025,119406,Politz; Joseph Gibbs,9999,0,9999,0
1668404695964,CSE 293,026,119411,Porter; George M,9999,0,9999,0
1668404695964,CSE 293,027,119414,Porter; Leonard Emerson,9999,0,9999,0
1668404695964,CSE 293,028,119416,Ramamoorthi; Ravi,9999,0,9999,0
1668404695964,CSE 293,029,119417,Sahoo; Debashis,9999,0,9999,0
1668404695964,CSE 293,030,119420,Saul; Lawrence,9999,0,9999,0
1668404695964,CSE 293,031,119421,Savage; Stefan,9999,0,9999,0
1668404695964,CSE 293,032,119425,Schulze; Jurgen P.,9999,0,9999,0
1668404695964,CSE 293,033,119426,Snoeren; Alex C.,9999,0,9999,0
1668404695964,CSE 293,034,119428,Shang; Jingbo,9999,0,9999,0
1668404695964,CSE 293,035,119430,Stefan; Deian,9999,0,9999,0
1668404695964,CSE 293,036,119431,Su; Hao,9999,0,9999,0
1668404695964,CSE 293,037,119433,Swanson; Steven James,9999,0,9999,0
1668404695964,CSE 293,038,119435,Tullsen; Dean Michael,9999,0,9999,0
1668404695964,CSE 293,039,119483,Voelker; Geoffrey M.,9999,0,9999,0
1668404695964,CSE 293,040,119537,Zhao; Jishen,9999,0,9999,0
1668404695964,CSE 293,041,119538,Zhou; Yuan-Yuan,9999,0,9999,0
1668404695964,CSE 293,042,119539,Gao; Sicun,9999,0,9999,0
1668404695964,CSE 293,043,119540,Weibel; Nadir,9999,0,9999,0
1668404695964,CSE 293,044,119541,Gupta; Rajesh K.,9999,0,9999,0
1668404695964,CSE 293,045,126410,Vaccaro; Kristen Marie,9999,0,9999,0
1668404695964,CSE 293,046,126411,Klemke; Richard,9999,0,9999,0
1668404696389,CSE 294,A00,102459,Voelker; Geoffrey M.,0,0,0,0
1668404696389,CSE 294,B00,111322,Orailoglu; Alex,0,0,0,0
1668404696813,DSE 201,A00,096914,Deutsch; Alin Bernard,30,0,30,0
1668404697235,DSE 210,A00,096915,Dasgupta; Sanjoy,30,0,30,0
1668404697735,DSE 260A,A00,096916,Altintas De Callaf; Ilkay,30,0,30,0
1668404698189,ECE 200,001,103586,Antipa; Nicholas A,9999,0,9999,0
1668404698189,ECE 200,002,103587,Atanasov; Nikolay A.,9999,0,9999,0
1668404698189,ECE 200,003,103588,Bharadia; Dinesh,9999,0,9999,0
1668404698189,ECE 200,004,103589,Cheng; Chung Kuan,9999,0,9999,0
1668404698189,ECE 200,005,103590,Cosman; Pamela C.,9999,0,9999,0
1668404698189,ECE 200,006,103591,Dayeh; Shadi Ahmad,9999,0,9999,0
1668404698189,ECE 200,007,103592,Fainman; Yeshaiahu,9999,0,9999,0
1668404698189,ECE 200,008,103593,Ford; Joseph Earl,9999,0,9999,0
1668404698189,ECE 200,009,103594,Franceschetti; Massimo,9999,0,9999,0
1668404698189,ECE 200,010,103595,Fullerton; Eric E,9999,0,9999,0
1668404698189,ECE 200,011,103596,Galton; Ian A,9999,0,9999,0
1668404698189,ECE 200,012,103597,Gilja; Vikash,9999,0,9999,0
1668404698189,ECE 200,013,103598,Hall; Drew A.,9999,0,9999,0
1668404698189,ECE 200,014,103599,Hsueh; Tzu-Chien,9999,0,9999,0
1668404698189,ECE 200,015,103600,Javidi; Tara,9999,0,9999,0
1668404698189,ECE 200,016,103601,Kahng; Andrew Byun,9999,0,9999,0
1668404698189,ECE 200,017,103602,Kim; Young-Han,9999,0,9999,0
1668404698189,ECE 200,018,103603,Koushanfar; Farinaz,9999,0,9999,0
1668404698189,ECE 200,019,103604,Kuzum; Duygu,9999,0,9999,0
1668404698189,ECE 200,020,103605,Le; Hanh-Phuc,9999,0,9999,0
1668404698189,ECE 200,021,103606,Lin; Bill,9999,0,9999,0
1668404698189,ECE 200,022,103607,Liu; Zhaowei,9998,0,9999,1
1668404698189,ECE 200,023,103608,Lo; Yu-Hwa,9999,0,9999,0
1668404698189,ECE 200,024,103609,Lomakin; Vitaliy,9999,0,9999,0
1668404698189,ECE 200,025,103610,Mercier; Patrick Philip,9999,0,9999,0
1668404698189,ECE 200,026,103611,Meyer; Florian,9999,0,9999,0
1668404698189,ECE 200,027,103612,Milstein; Laurence B.,9999,0,9999,0
1668404698189,ECE 200,028,103613,Mir Arabbaygi; Siavash,9999,0,9999,0
1668404698189,ECE 200,029,103614,Mookherjea; Shayan,9999,0,9999,0
1668404698189,ECE 200,030,103615,Morris; Karcher William,9999,0,9999,0
1668404698189,ECE 200,031,103616,Ng; Tse Nga,9999,0,9999,0
1668404698189,ECE 200,032,103617,Nguyen; Truong Quang,9999,0,9999,0
1668404698189,ECE 200,033,103618,Nomura; Kenji,9999,0,9999,0
1668404698189,ECE 200,034,103619,Orlitsky; Alon,9999,0,9999,0
1668404698189,ECE 200,035,103620,Pal; Piya,9999,0,9999,0
1668404698189,ECE 200,036,103621,Papen; George C.,9999,0,9999,0
1668404698189,ECE 200,037,103622,Radic; Stojan,9999,0,9999,0
1668404698189,ECE 200,038,103623,Rao; Bhaskar D.,9999,0,9999,0
1668404698189,ECE 200,039,103624,Rao; Ramesh R,9999,0,9999,0
1668404698189,ECE 200,040,103625,Rebeiz; Gabriel,9999,0,9999,0
1668404698189,ECE 200,041,103626,Sanford; John R,9999,0,9999,0
1668404698189,ECE 200,042,103627,Siegel; Paul H.,9999,0,9999,0
1668404698189,ECE 200,043,103628,Sievenpiper; Daniel F.,9999,0,9999,0
1668404698189,ECE 200,044,103629,Sworder; David D.,9999,0,9999,0
1668404698189,ECE 200,045,103630,Taur; Yuan,9999,0,9999,0
1668404698189,ECE 200,046,103631,Touri; Behrouz,9999,0,9999,0
1668404698189,ECE 200,047,103632,Trivedi; Mohan M.,9999,0,9999,0
1668404698189,ECE 200,048,103633,Vasconcelos; Nuno,9999,0,9999,0
1668404698189,ECE 200,049,103634,Wang; Xiaolong,9999,0,9999,0
1668404698189,ECE 200,050,103635,Xie; Pengtao,9999,0,9999,0
1668404698189,ECE 200,051,103636,Yip; Michael,9999,0,9999,0
1668404698189,ECE 200,052,103637,Zeger; Kenneth A.,999,0,999,0
1668404698189,ECE 200,053,103638,Zhang; Xinyu,9999,0,9999,0
1668404698189,ECE 200,054,103639,Turakhia; Yatish Girish,9999,0,9999,0
1668404698189,ECE 200,055,103640,Kang; Mingu,9999,0,9999,0
1668404698189,ECE 200,056,103641,Shi; Yuanyuan,9999,0,9999,0
1668404698189,ECE 200,057,103642,Wang; Edward Jay,9999,0,9999,0
1668404698189,ECE 200,058,103643,Zheng; Yang,9999,0,9999,0
1668404698620,ECE 202,A00,103644,Kuzum; Duygu,0,0,0,0
1668404699043,ECE 212BN,A00,103646,Ng; Tse Nga,0,0,0,0
1668404699466,ECE 221,A00,111493,Staff,0,0,0,0
1668404699889,ECE 222B,A00,103647,Lomakin; Vitaliy,0,0,0,0
1668404700310,ECE 230B,A00,103648,Taur; Yuan,0,0,0,0
1668404700736,ECE 238B,A00,103649,Garay; Javier,0,0,0,0
1668404701162,ECE 240B,A00,112900,Fainman; Yeshaiahu,0,0,0,0
1668404701586,ECE 247A,A00,103650,Jokerst; Jesse Vincent,0,0,0,0
1668404702009,ECE 247B,A00,103651,Wang; Joseph,0,0,0,0
1668404702441,ECE 250,A00,103652,Siegel; Paul H.,0,0,0,0
1668404702863,ECE 251A,A00,103654,Rao; Bhaskar D.,0,0,0,0
1668404703288,ECE 257B,A00,103655,Bharadia; Dinesh,0,0,0,0
1668404703710,ECE 258A,A00,103656,Milstein; Laurence B.,0,0,0,0
1668404704150,ECE 260B,A00,103658,Kang; Mingu,0,0,0,0
1668404704582,ECE 264A,A00,103659,Galton; Ian A,0,0,0,0
1668404705014,ECE 265A,A00,103661,Gudem; Prasad S.S.,0,0,0,0
1668404705445,ECE 265D,A00,103662,Gudem; Prasad S.S.,0,0,0,0
1668404705872,ECE 268,A00,103663,Koushanfar; Farinaz,0,0,0,0
1668404706301,ECE 269,A01,103665,Pal; Piya,0,0,0,0
1668404706737,ECE 271B,A00,103666,Vasconcelos; Manuela,0,0,0,0
1668404707162,ECE 276A,A00,103667,Atanasov; Nikolay A.,0,0,0,0
1668404707595,ECE 277,A00,103668,An; Cheolhong,0,0,0,0
1668404708019,ECE 279,A00,117947,Hall; Drew A.,0,0,0,0
1668404708888,ECE 283,A00,103670,Hsueh; Tzu-Chien,0,0,0,0
1668404709318,ECE 284,A00,103671,Turakhia; Yatish Girish,0,0,0,0
1668404709747,ECE 285,A00,103672,Zheng; Yang,0,0,0,0
1668404709747,ECE 285,B00,103673,Sworder; David D.,0,0,0,0
1668404710173,ECE 287,A00,103676,Javidi; Tara,0,0,0,0
1668404710601,MATH 200B,A00,098023,Salehi Golsefidy; Alireza,12,0,15,3
1668404711025,MATH 202B,A00,098024,Rhoades; Brendon Patrick,9,0,15,6
1668404711450,MATH 203B,A00,098025,Oprea; Dragos N.,10,0,15,5
1668404711873,MATH 204B,A00,098026,Sorensen; Claus M,13,0,15,2
1668404712299,MATH 208,A00,098027,Izadi; Elham,7,0,10,3
1668404712723,MATH 209,A00,098028,Pollack; Aaron,10,0,10,0
1668404713148,MATH 211A,A00,112919,Rogalski; Daniel,9,0,10,1
1668404713572,MATH 211B,A00,112920,Seward; Brandon M.,9,0,10,1
1668404714000,MATH 218,A00,098029,Li; Bo,10,0,10,0
1668404714424,MATH 220B,A00,098030,Novak; Jonathan I,11,0,15,4
1668404714850,MATH 221A,A00,098031,Ebenfelt; Peter F,13,0,15,2
1668404715278,MATH 231B,A00,098032,Zlatos; Andrej,12,0,15,3
1668404715705,MATH 240B,A00,098033,Ni; Lei,9,0,15,6
1668404716129,MATH 243,A00,098034,Jekel; David Andrew,10,0,10,0
1668404716554,MATH 245A,A00,098035,Nie; Jiawang,0,0,15,16
1668404716978,MATH 248,A00,098036,Bejenaru; Ioan,10,0,10,0
1668404717407,MATH 250B,A00,098037,Spolaor; Luca,14,0,15,1
1668404717830,MATH 258,A00,098038,Ni; Lei,10,0,10,0
1668404718264,MATH 264B,A00,098041,Rhoades; Brendon Patrick,9,0,15,6
1668404718689,MATH 268,A00,098042,Buss; Samuel R,10,0,10,0
1668404719112,MATH 269,A00,098043,Rhoades; Brendon Patrick,10,0,10,0
1668404719543,MATH 270B,A00,098044,Li; Bo,10,0,15,5
1668404719976,MATH 272B,A00,098045,Holst; Michael J,13,0,15,2
1668404720409,MATH 273A,A00,098046,Tian; Xiaochuan,10,0,15,5
1668404720843,MATH 275,A01,098048,Tian; Xiaochuan,6,0,10,4
1668404721269,MATH 278A,A00,098049,Holst; Michael J,8,0,10,2
1668404721695,MATH 278B,A00,098050,Cloninger; Alexander,10,0,10,0
1668404722120,MATH 278C,A00,098051,Nie; Jiawang,6,0,10,4
1668404722545,MATH 280B,A00,098052,Zheng; Tianyi,8,0,15,7
1668404722973,MATH 281B,A00,098053,Bradic; Jelena,0,0,15,15
1668404723408,MATH 282B,A00,098054,Arias-Castro; Ery,0,0,15,15
1668404723834,MATH 285,A00,098055,Fitzsimmons; Patrick J,0,0,15,17
1668404724258,MATH 287B,A00,098056,Arias-Castro; Ery,2,0,15,13
1668404724685,MATH 288,A00,098057,Agarwal; Pooja,9,0,10,1
1668404724685,MATH 288,B00,098058,Zhang; Danna,8,0,10,2
1668404724685,MATH 288,C00,098059,Williams; Ruth J,9,0,10,1
1668404725116,MATH 290B,A00,098060,Roberts; Justin Deritter,13,0,15,2
1668404725540,MATH 292,A00,098061,Belmont; Eva Kinoshita,10,0,10,0
1668404725964,MATH 295,A00,098062,Suk; Andrew Hoon,48,0,50,2
1668404726391,MATH 296,A00,098063,Novak; Jonathan I,20,0,20,0
1668404726816,MATH 297,001,098064,Gamst; Anthony Collins,9997,0,9999,2
1668405227517,COGS 205,A00,101395,Chiba; Andrea,19,0,20,1
1668405227940,COGS 210B,001,101404,Greene; Deanna Jacquelyn,9998,0,9999,1
1668405227940,COGS 210B,002,101417,Xia; Haijun,9999,0,9999,0
1668405227940,COGS 210B,003,101422,Nitz; Douglas A.,9999,0,9999,0
1668405227940,COGS 210B,004,101423,Hollan; James D.,9998,0,9999,1
1668405227940,COGS 210B,005,101424,Deak; Gedeon O.,9998,0,9999,1
1668405227940,COGS 210B,006,101425,Rossano; Federico,9999,0,9999,0
1668405228365,COGS 211B,A00,101427,Coulson; Seana M,9996,0,9999,3
1668405228790,COGS 220,A00,101428,Hollan; James D.,0,0,25,25
1668405229216,COGS 229,A00,101429,Dow; Steven P,18,0,25,7
1668405229640,COGS 230,A00,101430,Klemmer; Scott R,11,0,17,6
1668405230063,COGS 234,A00,101431,Xia; Haijun,1,0,25,24
1668405230488,COGS 260,A00,101432,Kiyonaga; Anastasia,21,0,25,4
1668405230488,COGS 260,B00,101433,Kirsh; David Joel,15,0,25,10
1668405230910,CSE 202,A00,102371,Impagliazzo; Russell,0,0,0,0
1668405231334,CSE 203B,A01,102373,Cheng; Chung Kuan,0,0,0,0
1668405231761,CSE 208,A00,102374,Micciancio; Daniele,0,0,0,0
1668405232187,CSE 209A,A00,112895,Impagliazzo; Russell,0,0,15,15
1668405232611,CSE 209B,A00,108005,Bellare; Mihir,0,0,0,0
1668405233033,CSE 210,A00,113163,Coblenz; Michael J,0,0,0,0
1668405233457,CSE 219,A00,106111,Dow; Steven P,0,0,20,20
1668405233881,CSE 221,A00,102376,Voelker; Geoffrey M.,0,0,0,0
1668405234323,CSE 224,A01,102378,Porter; George M,0,0,0,0
1668405234749,CSE 229A,A00,102379,Savage; Stefan,0,0,0,0
1668405235171,CSE 229C,A00,102380,Munyaka; Imani N. S.,0,0,0,0
1668405235597,CSE 232B,A00,102382,Deutsch; Alin Bernard,0,0,0,0
1668405236021,CSE 234,A01,112904,Kumar; Arun Kumar,0,0,0,0
1668405236444,CSE 237A,A00,102383,Rosing; Tajana Simunic,0,0,0,0
1668405236868,CSE 239A,A00,102384,Deutsch; Alin Bernard,0,0,0,0
1668405237290,CSE 239B,A00,102385,Polikarpova; Nadezhda,0,0,0,0
1668405237717,CSE 240A,A00,102386,Pannuto; Patrick William,0,0,0,0
1668405238145,CSE 240B,A00,102387,Zhao; Jishen,0,0,0,0
1668405238573,CSE 241A,A00,106406,Kang; Mingu,0,0,0,0
1668405238999,CSE 249B,A00,102388,Kahng; Andrew Byun,0,0,8,8
1668405239424,CSE 251B,A01,102392,Cottrell; Garrison W,0,0,0,0
1668405239424,CSE 251B,A02,102393,Cottrell; Garrison W,0,0,0,0
1668405239847,CSE 252B,A00,102394,Ochoa; Benjamin Lawrence,0,0,0,0
1668405240275,CSE 257,A01,102396,Gao; Sicun,0,0,0,0
1668405240699,CSE 272,A00,102397,Li; Tzumao,0,0,0,0
1668405241126,CSE 274,A00,111323,Chern; Albert Ren-Haur,0,0,0,0
1668405241559,CSE 282,A00,102398,Pevzner; Pavel Arkadjevich,0,0,0,0
1668405241987,CSE 284,A00,114175,Gymrek; Melissa Ann,0,0,0,0
1668405242411,CSE 290,A00,102399,Chandraker; Manmohan Krishna,0,0,0,0
1668405242411,CSE 290,B00,102400,Vaccaro; Kristen Marie,0,0,25,25
1668405242411,CSE 290,C00,102414,Pannuto; Patrick William,0,0,25,25
1668405242411,CSE 290,D00,102427,Pevzner; Pavel Arkadjevich,0,0,0,0
1668405242411,CSE 290,E00,102429,Zhao; Jishen,0,0,0,0
1668405242411,CSE 290,F00,102436,Tullsen; Dean Michael,0,0,0,0
1668405242411,CSE 290,G00,102440,Christensen; Henrik I,0,0,20,20
1668405242835,CSE 291,A00,102443,Su; Hao,0,0,0,0
1668405242835,CSE 291,B00,102448,Polikarpova; Nadezhda,0,0,0,0
1668405242835,CSE 291,C00,102453,Vaccaro; Kristen Marie,0,0,0,0
1668405242835,CSE 291,D00,111343,Savage; Stefan,0,0,0,0
1668405242835,CSE 291,E00,116474,Claffy; Kimberly Claire,0,0,0,0
1668405242835,CSE 291,F00,116479,Pasquale; Joseph,0,0,0,0
1668405243260,CSE 293,001,119111,Bafna; Vineet,9999,0,9999,0
1668405243260,CSE 293,002,119118,Bellare; Mihir,9999,0,9999,0
1668405243260,CSE 293,003,119122,Berg-Kirkpatrick; Taylor D,9999,0,9999,0
1668405243260,CSE 293,004,119135,Christensen; Henrik I,9999,0,9999,0
1668405243260,CSE 293,005,119142,Cottrell; Garrison W,9999,0,9999,0
1668405243260,CSE 293,006,119146,Deutsch; Alin Bernard,9999,0,9999,0
1668405243260,CSE 293,007,119159,Esmaeilzadeh; Hadi,9999,0,9999,0
1668405243260,CSE 293,008,119166,Freund; Yoav,9999,0,9999,0
1668405243260,CSE 293,009,119170,Griswold; William G.,9999,0,9999,0
1668405243260,CSE 293,010,119183,Gymrek; Melissa Ann,9999,0,9999,0
1668405243260,CSE 293,011,119190,Heninger; Nadia A,9999,0,9999,0
1668405243260,CSE 293,012,119230,Impagliazzo; Russell,9999,0,9999,0
1668405243260,CSE 293,013,119232,Jhala; Ranjit,9999,0,9999,0
1668405243260,CSE 293,014,119233,Kahng; Andrew Byun,9999,0,9999,0
1668405243260,CSE 293,015,119298,Kane; Daniel Mertz,9999,0,9999,0
1668405243260,CSE 293,016,119299,Kriegman; David J,9999,0,9999,0
1668405243260,CSE 293,017,119300,Kumar; Arun Kumar,9999,0,9999,0
1668405243260,CSE 293,018,119301,Lerner; Sorin,9999,0,9999,0
1668405243260,CSE 293,019,119302,Lovett; Shachar,9999,0,9999,0
1668405243260,CSE 293,020,119303,McAuley; Julian John,9999,0,9999,0
1668405243260,CSE 293,021,119304,Micciancio; Daniele,9999,0,9999,0
1668405243260,CSE 293,022,119367,Orailoglu; Alex,9999,0,9999,0
1668405243260,CSE 293,023,119382,Paturi; Ramamohan,9999,0,9999,0
1668405243260,CSE 293,024,119404,Polikarpova; Nadezhda,9999,0,9999,0
1668405243260,CSE 293,025,119406,Politz; Joseph Gibbs,9999,0,9999,0
1668405243260,CSE 293,026,119411,Porter; George M,9999,0,9999,0
1668405243260,CSE 293,027,119414,Porter; Leonard Emerson,9999,0,9999,0
1668405243260,CSE 293,028,119416,Ramamoorthi; Ravi,9999,0,9999,0
1668405243260,CSE 293,029,119417,Sahoo; Debashis,9999,0,9999,0
1668405243260,CSE 293,030,119420,Saul; Lawrence,9999,0,9999,0
1668405243260,CSE 293,031,119421,Savage; Stefan,9999,0,9999,0
1668405243260,CSE 293,032,119425,Schulze; Jurgen P.,9999,0,9999,0
1668405243260,CSE 293,033,119426,Snoeren; Alex C.,9999,0,9999,0
1668405243260,CSE 293,034,119428,Shang; Jingbo,9999,0,9999,0
1668405243260,CSE 293,035,119430,Stefan; Deian,9999,0,9999,0
1668405243260,CSE 293,036,119431,Su; Hao,9999,0,9999,0
1668405243260,CSE 293,037,119433,Swanson; Steven James,9999,0,9999,0
1668405243260,CSE 293,038,119435,Tullsen; Dean Michael,9999,0,9999,0
1668405243260,CSE 293,039,119483,Voelker; Geoffrey M.,9999,0,9999,0
1668405243260,CSE 293,040,119537,Zhao; Jishen,9999,0,9999,0
1668405243260,CSE 293,041,119538,Zhou; Yuan-Yuan,9999,0,9999,0
1668405243260,CSE 293,042,119539,Gao; Sicun,9999,0,9999,0
1668405243260,CSE 293,043,119540,Weibel; Nadir,9999,0,9999,0
1668405243260,CSE 293,044,119541,Gupta; Rajesh K.,9999,0,9999,0
1668405243260,CSE 293,045,126410,Vaccaro; Kristen Marie,9999,0,9999,0
1668405243260,CSE 293,046,126411,Klemke; Richard,9999,0,9999,0
1668405243685,CSE 294,A00,102459,Voelker; Geoffrey M.,0,0,0,0
1668405243685,CSE 294,B00,111322,Orailoglu; Alex,0,0,0,0
1668405244115,DSE 201,A00,096914,Deutsch; Alin Bernard,30,0,30,0
1668405244541,DSE 210,A00,096915,Dasgupta; Sanjoy,30,0,30,0
1668405244966,DSE 260A,A00,096916,Altintas De Callaf; Ilkay,30,0,30,0
1668405245393,ECE 200,001,103586,Antipa; Nicholas A,9999,0,9999,0
1668405245393,ECE 200,002,103587,Atanasov; Nikolay A.,9999,0,9999,0
1668405245393,ECE 200,003,103588,Bharadia; Dinesh,9999,0,9999,0
1668405245393,ECE 200,004,103589,Cheng; Chung Kuan,9999,0,9999,0
1668405245393,ECE 200,005,103590,Cosman; Pamela C.,9999,0,9999,0
1668405245393,ECE 200,006,103591,Dayeh; Shadi Ahmad,9999,0,9999,0
1668405245393,ECE 200,007,103592,Fainman; Yeshaiahu,9999,0,9999,0
1668405245393,ECE 200,008,103593,Ford; Joseph Earl,9999,0,9999,0
1668405245393,ECE 200,009,103594,Franceschetti; Massimo,9999,0,9999,0
1668405245393,ECE 200,010,103595,Fullerton; Eric E,9999,0,9999,0
1668405245393,ECE 200,011,103596,Galton; Ian A,9999,0,9999,0
1668405245393,ECE 200,012,103597,Gilja; Vikash,9999,0,9999,0
1668405245393,ECE 200,013,103598,Hall; Drew A.,9999,0,9999,0
1668405245393,ECE 200,014,103599,Hsueh; Tzu-Chien,9999,0,9999,0
1668405245393,ECE 200,015,103600,Javidi; Tara,9999,0,9999,0
1668405245393,ECE 200,016,103601,Kahng; Andrew Byun,9999,0,9999,0
1668405245393,ECE 200,017,103602,Kim; Young-Han,9999,0,9999,0
1668405245393,ECE 200,018,103603,Koushanfar; Farinaz,9999,0,9999,0
1668405245393,ECE 200,019,103604,Kuzum; Duygu,9999,0,9999,0
1668405245393,ECE 200,020,103605,Le; Hanh-Phuc,9999,0,9999,0
1668405245393,ECE 200,021,103606,Lin; Bill,9999,0,9999,0
1668405245393,ECE 200,022,103607,Liu; Zhaowei,9998,0,9999,1
1668405245393,ECE 200,023,103608,Lo; Yu-Hwa,9999,0,9999,0
1668405245393,ECE 200,024,103609,Lomakin; Vitaliy,9999,0,9999,0
1668405245393,ECE 200,025,103610,Mercier; Patrick Philip,9999,0,9999,0
1668405245393,ECE 200,026,103611,Meyer; Florian,9999,0,9999,0
1668405245393,ECE 200,027,103612,Milstein; Laurence B.,9999,0,9999,0
1668405245393,ECE 200,028,103613,Mir Arabbaygi; Siavash,9999,0,9999,0
1668405245393,ECE 200,029,103614,Mookherjea; Shayan,9999,0,9999,0
1668405245393,ECE 200,030,103615,Morris; Karcher William,9999,0,9999,0
1668405245393,ECE 200,031,103616,Ng; Tse Nga,9999,0,9999,0
1668405245393,ECE 200,032,103617,Nguyen; Truong Quang,9999,0,9999,0
1668405245393,ECE 200,033,103618,Nomura; Kenji,9999,0,9999,0
1668405245393,ECE 200,034,103619,Orlitsky; Alon,9999,0,9999,0
1668405245393,ECE 200,035,103620,Pal; Piya,9999,0,9999,0
1668405245393,ECE 200,036,103621,Papen; George C.,9999,0,9999,0
1668405245393,ECE 200,037,103622,Radic; Stojan,9999,0,9999,0
1668405245393,ECE 200,038,103623,Rao; Bhaskar D.,9999,0,9999,0
1668405245393,ECE 200,039,103624,Rao; Ramesh R,9999,0,9999,0
1668405245393,ECE 200,040,103625,Rebeiz; Gabriel,9999,0,9999,0
1668405245393,ECE 200,041,103626,Sanford; John R,9999,0,9999,0
1668405245393,ECE 200,042,103627,Siegel; Paul H.,9999,0,9999,0
1668405245393,ECE 200,043,103628,Sievenpiper; Daniel F.,9999,0,9999,0
1668405245393,ECE 200,044,103629,Sworder; David D.,9999,0,9999,0
1668405245393,ECE 200,045,103630,Taur; Yuan,9999,0,9999,0
1668405245393,ECE 200,046,103631,Touri; Behrouz,9999,0,9999,0
1668405245393,ECE 200,047,103632,Trivedi; Mohan M.,9999,0,9999,0
1668405245393,ECE 200,048,103633,Vasconcelos; Nuno,9999,0,9999,0
1668405245393,ECE 200,049,103634,Wang; Xiaolong,9999,0,9999,0
1668405245393,ECE 200,050,103635,Xie; Pengtao,9999,0,9999,0
1668405245393,ECE 200,051,103636,Yip; Michael,9999,0,9999,0
1668405245393,ECE 200,052,103637,Zeger; Kenneth A.,999,0,999,0
1668405245393,ECE 200,053,103638,Zhang; Xinyu,9999,0,9999,0
1668405245393,ECE 200,054,103639,Turakhia; Yatish Girish,9999,0,9999,0
1668405245393,ECE 200,055,103640,Kang; Mingu,9999,0,9999,0
1668405245393,ECE 200,056,103641,Shi; Yuanyuan,9999,0,9999,0
1668405245393,ECE 200,057,103642,Wang; Edward Jay,9999,0,9999,0
1668405245393,ECE 200,058,103643,Zheng; Yang,9999,0,9999,0
1668405245817,ECE 202,A00,103644,Kuzum; Duygu,0,0,0,0
1668405246241,ECE 212BN,A00,103646,Ng; Tse Nga,0,0,0,0
1668405246666,ECE 221,A00,111493,Staff,0,0,0,0
1668405247089,ECE 222B,A00,103647,Lomakin; Vitaliy,0,0,0,0
1668405247513,ECE 230B,A00,103648,Taur; Yuan,0,0,0,0
1668405247938,ECE 238B,A00,103649,Garay; Javier,0,0,0,0
1668405248365,ECE 240B,A00,112900,Fainman; Yeshaiahu,0,0,0,0
1668405248794,ECE 247A,A00,103650,Jokerst; Jesse Vincent,0,0,0,0
1668405249221,ECE 247B,A00,103651,Wang; Joseph,0,0,0,0
1668405249645,ECE 250,A00,103652,Siegel; Paul H.,0,0,0,0
1668405250072,ECE 251A,A00,103654,Rao; Bhaskar D.,0,0,0,0
1668405250497,ECE 257B,A00,103655,Bharadia; Dinesh,0,0,0,0
1668405250921,ECE 258A,A00,103656,Milstein; Laurence B.,0,0,0,0
1668405251344,ECE 260B,A00,103658,Kang; Mingu,0,0,0,0
1668405251765,ECE 264A,A00,103659,Galton; Ian A,0,0,0,0
1668405252188,ECE 265A,A00,103661,Gudem; Prasad S.S.,0,0,0,0
1668405252614,ECE 265D,A00,103662,Gudem; Prasad S.S.,0,0,0,0
1668405253045,ECE 268,A00,103663,Koushanfar; Farinaz,0,0,0,0
1668405253477,ECE 269,A01,103665,Pal; Piya,0,0,0,0
1668405253901,ECE 271B,A00,103666,Vasconcelos; Manuela,0,0,0,0
1668405254322,ECE 276A,A00,103667,Atanasov; Nikolay A.,0,0,0,0
1668405254752,ECE 277,A00,103668,An; Cheolhong,0,0,0,0
1668405255178,ECE 279,A00,117947,Hall; Drew A.,0,0,0,0
1668405256028,ECE 283,A00,103670,Hsueh; Tzu-Chien,0,0,0,0
1668405256455,ECE 284,A00,103671,Turakhia; Yatish Girish,0,0,0,0
1668405256890,ECE 285,A00,103672,Zheng; Yang,0,0,0,0
1668405256890,ECE 285,B00,103673,Sworder; David D.,0,0,0,0
1668405257315,ECE 287,A00,103676,Javidi; Tara,0,0,0,0
1668405257738,MATH 200B,A00,098023,Salehi Golsefidy; Alireza,12,0,15,3
1668405258162,MATH 202B,A00,098024,Rhoades; Brendon Patrick,9,0,15,6
1668405258586,MATH 203B,A00,098025,Oprea; Dragos N.,10,0,15,5
1668405259010,MATH 204B,A00,098026,Sorensen; Claus M,13,0,15,2
1668405259435,MATH 208,A00,098027,Izadi; Elham,7,0,10,3
1668405259857,MATH 209,A00,098028,Pollack; Aaron,10,0,10,0
1668405260281,MATH 211A,A00,112919,Rogalski; Daniel,9,0,10,1
1668405260706,MATH 211B,A00,112920,Seward; Brandon M.,9,0,10,1
1668405261131,MATH 218,A00,098029,Li; Bo,10,0,10,0
1668405261633,MATH 220B,A00,098030,Novak; Jonathan I,11,0,15,4
1668405262057,MATH 221A,A00,098031,Ebenfelt; Peter F,13,0,15,2
1668405262480,MATH 231B,A00,098032,Zlatos; Andrej,12,0,15,3
1668405262904,MATH 240B,A00,098033,Ni; Lei,9,0,15,6
1668405263328,MATH 243,A00,098034,Jekel; David Andrew,10,0,10,0
1668405263750,MATH 245A,A00,098035,Nie; Jiawang,0,0,15,16
1668405264173,MATH 248,A00,098036,Bejenaru; Ioan,10,0,10,0
1668405264597,MATH 250B,A00,098037,Spolaor; Luca,14,0,15,1
1668405265021,MATH 258,A00,098038,Ni; Lei,10,0,10,0
1668405265446,MATH 264B,A00,098041,Rhoades; Brendon Patrick,9,0,15,6
1668405265868,MATH 268,A00,098042,Buss; Samuel R,10,0,10,0
1668405266292,MATH 269,A00,098043,Rhoades; Brendon Patrick,10,0,10,0
1668405266716,MATH 270B,A00,098044,Li; Bo,10,0,15,5
1668405267139,MATH 272B,A00,098045,Holst; Michael J,13,0,15,2
1668405267568,MATH 273A,A00,098046,Tian; Xiaochuan,10,0,15,5
1668405267994,MATH 275,A01,098048,Tian; Xiaochuan,6,0,10,4
1668405268424,MATH 278A,A00,098049,Holst; Michael J,8,0,10,2
1668405268848,MATH 278B,A00,098050,Cloninger; Alexander,10,0,10,0
1668405269271,MATH 278C,A00,098051,Nie; Jiawang,6,0,10,4
1668405269709,MATH 280B,A00,098052,Zheng; Tianyi,8,0,15,7
1668405270142,MATH 281B,A00,098053,Bradic; Jelena,0,0,15,15
1668405270580,MATH 282B,A00,098054,Arias-Castro; Ery,0,0,15,15
1668405271004,MATH 285,A00,098055,Fitzsimmons; Patrick J,0,0,15,17
1668405271427,MATH 287B,A00,098056,Arias-Castro; Ery,2,0,15,13
1668405271853,MATH 288,A00,098057,Agarwal; Pooja,9,0,10,1
1668405271853,MATH 288,B00,098058,Zhang; Danna,8,0,10,2
1668405271853,MATH 288,C00,098059,Williams; Ruth J,9,0,10,1
1668405272283,MATH 290B,A00,098060,Roberts; Justin Deritter,13,0,15,2
1668405272708,MATH 292,A00,098061,Belmont; Eva Kinoshita,10,0,10,0
1668405273133,MATH 295,A00,098062,Suk; Andrew Hoon,48,0,50,2
1668405273557,MATH 296,A00,098063,Novak; Jonathan I,20,0,20,0
1668405273995,MATH 297,001,098064,Gamst; Anthony Collins,9997,0,9999,2
1668405774158,COGS 205,A00,101395,Chiba; Andrea,19,0,20,1
1668405774587,COGS 210B,001,101404,Greene; Deanna Jacquelyn,9998,0,9999,1
1668405774587,COGS 210B,002,101417,Xia; Haijun,9999,0,9999,0
1668405774587,COGS 210B,003,101422,Nitz; Douglas A.,9999,0,9999,0
1668405774587,COGS 210B,004,101423,Hollan; James D.,9998,0,9999,1
1668405774587,COGS 210B,005,101424,Deak; Gedeon O.,9998,0,9999,1
1668405774587,COGS 210B,006,101425,Rossano; Federico,9999,0,9999,0
1668405775026,COGS 211B,A00,101427,Coulson; Seana M,9996,0,9999,3
1668405775450,COGS 220,A00,101428,Hollan; James D.,0,0,25,25
1668405775873,COGS 229,A00,101429,Dow; Steven P,18,0,25,7
1668405776302,COGS 230,A00,101430,Klemmer; Scott R,11,0,17,6
1668405776724,COGS 234,A00,101431,Xia; Haijun,1,0,25,24
1668405777157,COGS 260,A00,101432,Kiyonaga; Anastasia,21,0,25,4
1668405777157,COGS 260,B00,101433,Kirsh; David Joel,15,0,25,10
1668405777582,CSE 202,A00,102371,Impagliazzo; Russell,0,0,0,0
1668405778010,CSE 203B,A01,102373,Cheng; Chung Kuan,0,0,0,0
1668405778441,CSE 208,A00,102374,Micciancio; Daniele,0,0,0,0
1668405778863,CSE 209A,A00,112895,Impagliazzo; Russell,0,0,15,15
1668405779288,CSE 209B,A00,108005,Bellare; Mihir,0,0,0,0
1668405779713,CSE 210,A00,113163,Coblenz; Michael J,0,0,0,0
1668405780139,CSE 219,A00,106111,Dow; Steven P,0,0,20,20
1668405780563,CSE 221,A00,102376,Voelker; Geoffrey M.,0,0,0,0
1668405780986,CSE 224,A01,102378,Porter; George M,0,0,0,0
1668405781413,CSE 229A,A00,102379,Savage; Stefan,0,0,0,0
1668405781928,CSE 229C,A00,102380,Munyaka; Imani N. S.,0,0,0,0
1668405782356,CSE 232B,A00,102382,Deutsch; Alin Bernard,0,0,0,0
1668405782782,CSE 234,A01,112904,Kumar; Arun Kumar,0,0,0,0
1668405783207,CSE 237A,A00,102383,Rosing; Tajana Simunic,0,0,0,0
1668405783632,CSE 239A,A00,102384,Deutsch; Alin Bernard,0,0,0,0
1668405784064,CSE 239B,A00,102385,Polikarpova; Nadezhda,0,0,0,0
1668405784489,CSE 240A,A00,102386,Pannuto; Patrick William,0,0,0,0
1668405784910,CSE 240B,A00,102387,Zhao; Jishen,0,0,0,0
1668405785336,CSE 241A,A00,106406,Kang; Mingu,0,0,0,0
1668405785766,CSE 249B,A00,102388,Kahng; Andrew Byun,0,0,8,8
1668405786193,CSE 251B,A01,102392,Cottrell; Garrison W,0,0,0,0
1668405786193,CSE 251B,A02,102393,Cottrell; Garrison W,0,0,0,0
1668405786618,CSE 252B,A00,102394,Ochoa; Benjamin Lawrence,0,0,0,0
1668405787040,CSE 257,A01,102396,Gao; Sicun,0,0,0,0
1668405787464,CSE 272,A00,102397,Li; Tzumao,0,0,0,0
1668405787894,CSE 274,A00,111323,Chern; Albert Ren-Haur,0,0,0,0
1668405788322,CSE 282,A00,102398,Pevzner; Pavel Arkadjevich,0,0,0,0
1668405788744,CSE 284,A00,114175,Gymrek; Melissa Ann,0,0,0,0
1668405789168,CSE 290,A00,102399,Chandraker; Manmohan Krishna,0,0,0,0
1668405789168,CSE 290,B00,102400,Vaccaro; Kristen Marie,0,0,25,25
1668405789168,CSE 290,C00,102414,Pannuto; Patrick William,0,0,25,25
1668405789168,CSE 290,D00,102427,Pevzner; Pavel Arkadjevich,0,0,0,0
1668405789168,CSE 290,E00,102429,Zhao; Jishen,0,0,0,0
1668405789168,CSE 290,F00,102436,Tullsen; Dean Michael,0,0,0,0
1668405789168,CSE 290,G00,102440,Christensen; Henrik I,0,0,20,20
1668405789597,CSE 291,A00,102443,Su; Hao,0,0,0,0
1668405789597,CSE 291,B00,102448,Polikarpova; Nadezhda,0,0,0,0
1668405789597,CSE 291,C00,102453,Vaccaro; Kristen Marie,0,0,0,0
1668405789597,CSE 291,D00,111343,Savage; Stefan,0,0,0,0
1668405789597,CSE 291,E00,116474,Claffy; Kimberly Claire,0,0,0,0
1668405789597,CSE 291,F00,116479,Pasquale; Joseph,0,0,0,0
1668405790044,CSE 293,001,119111,Bafna; Vineet,9999,0,9999,0
1668405790044,CSE 293,002,119118,Bellare; Mihir,9999,0,9999,0
1668405790044,CSE 293,003,119122,Berg-Kirkpatrick; Taylor D,9999,0,9999,0
1668405790044,CSE 293,004,119135,Christensen; Henrik I,9999,0,9999,0
1668405790044,CSE 293,005,119142,Cottrell; Garrison W,9999,0,9999,0
1668405790044,CSE 293,006,119146,Deutsch; Alin Bernard,9999,0,9999,0
1668405790044,CSE 293,007,119159,Esmaeilzadeh; Hadi,9999,0,9999,0
1668405790044,CSE 293,008,119166,Freund; Yoav,9999,0,9999,0
1668405790044,CSE 293,009,119170,Griswold; William G.,9999,0,9999,0
1668405790044,CSE 293,010,119183,Gymrek; Melissa Ann,9999,0,9999,0
1668405790044,CSE 293,011,119190,Heninger; Nadia A,9999,0,9999,0
1668405790044,CSE 293,012,119230,Impagliazzo; Russell,9999,0,9999,0
1668405790044,CSE 293,013,119232,Jhala; Ranjit,9999,0,9999,0
1668405790044,CSE 293,014,119233,Kahng; Andrew Byun,9999,0,9999,0
1668405790044,CSE 293,015,119298,Kane; Daniel Mertz,9999,0,9999,0
1668405790044,CSE 293,016,119299,Kriegman; David J,9999,0,9999,0
1668405790044,CSE 293,017,119300,Kumar; Arun Kumar,9999,0,9999,0
1668405790044,CSE 293,018,119301,Lerner; Sorin,9999,0,9999,0
1668405790044,CSE 293,019,119302,Lovett; Shachar,9999,0,9999,0
1668405790044,CSE 293,020,119303,McAuley; Julian John,9999,0,9999,0
1668405790044,CSE 293,021,119304,Micciancio; Daniele,9999,0,9999,0
1668405790044,CSE 293,022,119367,Orailoglu; Alex,9999,0,9999,0
1668405790044,CSE 293,023,119382,Paturi; Ramamohan,9999,0,9999,0
1668405790044,CSE 293,024,119404,Polikarpova; Nadezhda,9999,0,9999,0
1668405790044,CSE 293,025,119406,Politz; Joseph Gibbs,9999,0,9999,0
1668405790044,CSE 293,026,119411,Porter; George M,9999,0,9999,0
1668405790044,CSE 293,027,119414,Porter; Leonard Emerson,9999,0,9999,0
1668405790044,CSE 293,028,119416,Ramamoorthi; Ravi,9999,0,9999,0
1668405790044,CSE 293,029,119417,Sahoo; Debashis,9999,0,9999,0
1668405790044,CSE 293,030,119420,Saul; Lawrence,9999,0,9999,0
1668405790044,CSE 293,031,119421,Savage; Stefan,9999,0,9999,0
1668405790044,CSE 293,032,119425,Schulze; Jurgen P.,9999,0,9999,0
1668405790044,CSE 293,033,119426,Snoeren; Alex C.,9999,0,9999,0
1668405790044,CSE 293,034,119428,Shang; Jingbo,9999,0,9999,0
1668405790044,CSE 293,035,119430,Stefan; Deian,9999,0,9999,0
1668405790044,CSE 293,036,119431,Su; Hao,9999,0,9999,0
1668405790044,CSE 293,037,119433,Swanson; Steven James,9999,0,9999,0
1668405790044,CSE 293,038,119435,Tullsen; Dean Michael,9999,0,9999,0
1668405790044,CSE 293,039,119483,Voelker; Geoffrey M.,9999,0,9999,0
1668405790044,CSE 293,040,119537,Zhao; Jishen,9999,0,9999,0
1668405790044,CSE 293,041,119538,Zhou; Yuan-Yuan,9999,0,9999,0
1668405790044,CSE 293,042,119539,Gao; Sicun,9999,0,9999,0
1668405790044,CSE 293,043,119540,Weibel; Nadir,9999,0,9999,0
1668405790044,CSE 293,044,119541,Gupta; Rajesh K.,9999,0,9999,0
1668405790044,CSE 293,045,126410,Vaccaro; Kristen Marie,9999,0,9999,0
1668405790044,CSE 293,046,126411,Klemke; Richard,9999,0,9999,0
1668405790468,CSE 294,A00,102459,Voelker; Geoffrey M.,0,0,0,0
1668405790468,CSE 294,B00,111322,Orailoglu; Alex,0,0,0,0
1668405790895,DSE 201,A00,096914,Deutsch; Alin Bernard,30,0,30,0
1668405791330,DSE 210,A00,096915,Dasgupta; Sanjoy,30,0,30,0
1668405791757,DSE 260A,A00,096916,Altintas De Callaf; Ilkay,30,0,30,0
1668405792265,ECE 200,001,103586,Antipa; Nicholas A,9999,0,9999,0
1668405792265,ECE 200,002,103587,Atanasov; Nikolay A.,9999,0,9999,0
1668405792265,ECE 200,003,103588,Bharadia; Dinesh,9999,0,9999,0
1668405792265,ECE 200,004,103589,Cheng; Chung Kuan,9999,0,9999,0
1668405792265,ECE 200,005,103590,Cosman; Pamela C.,9999,0,9999,0
1668405792265,ECE 200,006,103591,Dayeh; Shadi Ahmad,9999,0,9999,0
1668405792265,ECE 200,007,103592,Fainman; Yeshaiahu,9999,0,9999,0
1668405792265,ECE 200,008,103593,Ford; Joseph Earl,9999,0,9999,0
1668405792265,ECE 200,009,103594,Franceschetti; Massimo,9999,0,9999,0
1668405792265,ECE 200,010,103595,Fullerton; Eric E,9999,0,9999,0
1668405792265,ECE 200,011,103596,Galton; Ian A,9999,0,9999,0
1668405792265,ECE 200,012,103597,Gilja; Vikash,9999,0,9999,0
1668405792265,ECE 200,013,103598,Hall; Drew A.,9999,0,9999,0
1668405792265,ECE 200,014,103599,Hsueh; Tzu-Chien,9999,0,9999,0
1668405792265,ECE 200,015,103600,Javidi; Tara,9999,0,9999,0
1668405792265,ECE 200,016,103601,Kahng; Andrew Byun,9999,0,9999,0
1668405792265,ECE 200,017,103602,Kim; Young-Han,9999,0,9999,0
1668405792265,ECE 200,018,103603,Koushanfar; Farinaz,9999,0,9999,0
1668405792265,ECE 200,019,103604,Kuzum; Duygu,9999,0,9999,0
1668405792265,ECE 200,020,103605,Le; Hanh-Phuc,9999,0,9999,0
1668405792265,ECE 200,021,103606,Lin; Bill,9999,0,9999,0
1668405792265,ECE 200,022,103607,Liu; Zhaowei,9998,0,9999,1
1668405792265,ECE 200,023,103608,Lo; Yu-Hwa,9999,0,9999,0
1668405792265,ECE 200,024,103609,Lomakin; Vitaliy,9999,0,9999,0
1668405792265,ECE 200,025,103610,Mercier; Patrick Philip,9999,0,9999,0
1668405792265,ECE 200,026,103611,Meyer; Florian,9999,0,9999,0
1668405792265,ECE 200,027,103612,Milstein; Laurence B.,9999,0,9999,0
1668405792265,ECE 200,028,103613,Mir Arabbaygi; Siavash,9999,0,9999,0
1668405792265,ECE 200,029,103614,Mookherjea; Shayan,9999,0,9999,0
1668405792265,ECE 200,030,103615,Morris; Karcher William,9999,0,9999,0
1668405792265,ECE 200,031,103616,Ng; Tse Nga,9999,0,9999,0
1668405792265,ECE 200,032,103617,Nguyen; Truong Quang,9999,0,9999,0
1668405792265,ECE 200,033,103618,Nomura; Kenji,9999,0,9999,0
1668405792265,ECE 200,034,103619,Orlitsky; Alon,9999,0,9999,0
1668405792265,ECE 200,035,103620,Pal; Piya,9999,0,9999,0
1668405792265,ECE 200,036,103621,Papen; George C.,9999,0,9999,0
1668405792265,ECE 200,037,103622,Radic; Stojan,9999,0,9999,0
1668405792265,ECE 200,038,103623,Rao; Bhaskar D.,9999,0,9999,0
1668405792265,ECE 200,039,103624,Rao; Ramesh R,9999,0,9999,0
1668405792265,ECE 200,040,103625,Rebeiz; Gabriel,9999,0,9999,0
1668405792265,ECE 200,041,103626,Sanford; John R,9999,0,9999,0
1668405792265,ECE 200,042,103627,Siegel; Paul H.,9999,0,9999,0
1668405792265,ECE 200,043,103628,Sievenpiper; Daniel F.,9999,0,9999,0
1668405792265,ECE 200,044,103629,Sworder; David D.,9999,0,9999,0
1668405792265,ECE 200,045,103630,Taur; Yuan,9999,0,9999,0
1668405792265,ECE 200,046,103631,Touri; Behrouz,9999,0,9999,0
1668405792265,ECE 200,047,103632,Trivedi; Mohan M.,9999,0,9999,0
1668405792265,ECE 200,048,103633,Vasconcelos; Nuno,9999,0,9999,0
1668405792265,ECE 200,049,103634,Wang; Xiaolong,9999,0,9999,0
1668405792265,ECE 200,050,103635,Xie; Pengtao,9999,0,9999,0
1668405792265,ECE 200,051,103636,Yip; Michael,9999,0,9999,0
1668405792265,ECE 200,052,103637,Zeger; Kenneth A.,999,0,999,0
1668405792265,ECE 200,053,103638,Zhang; Xinyu,9999,0,9999,0
1668405792265,ECE 200,054,103639,Turakhia; Yatish Girish,9999,0,9999,0
1668405792265,ECE 200,055,103640,Kang; Mingu,9999,0,9999,0
1668405792265,ECE 200,056,103641,Shi; Yuanyuan,9999,0,9999,0
1668405792265,ECE 200,057,103642,Wang; Edward Jay,9999,0,9999,0
1668405792265,ECE 200,058,103643,Zheng; Yang,9999,0,9999,0
1668405792697,ECE 202,A00,103644,Kuzum; Duygu,0,0,0,0
1668405793121,ECE 212BN,A00,103646,Ng; Tse Nga,0,0,0,0
1668405793550,ECE 221,A00,111493,Staff,0,0,0,0
1668405793975,ECE 222B,A00,103647,Lomakin; Vitaliy,0,0,0,0
1668405794400,ECE 230B,A00,103648,Taur; Yuan,0,0,0,0
1668405794825,ECE 238B,A00,103649,Garay; Javier,0,0,0,0
1668405795252,ECE 240B,A00,112900,Fainman; Yeshaiahu,0,0,0,0
1668405795676,ECE 247A,A00,103650,Jokerst; Jesse Vincent,0,0,0,0
1668405796102,ECE 247B,A00,103651,Wang; Joseph,0,0,0,0
1668405796524,ECE 250,A00,103652,Siegel; Paul H.,0,0,0,0
1668405796949,ECE 251A,A00,103654,Rao; Bhaskar D.,0,0,0,0
1668405797373,ECE 257B,A00,103655,Bharadia; Dinesh,0,0,0,0
1668405797797,ECE 258A,A00,103656,Milstein; Laurence B.,0,0,0,0
1668405798219,ECE 260B,A00,103658,Kang; Mingu,0,0,0,0
1668405798647,ECE 264A,A00,103659,Galton; Ian A,0,0,0,0
1668405799069,ECE 265A,A00,103661,Gudem; Prasad S.S.,0,0,0,0
1668405799495,ECE 265D,A00,103662,Gudem; Prasad S.S.,0,0,0,0
1668405799919,ECE 268,A00,103663,Koushanfar; Farinaz,0,0,0,0
1668405800347,ECE 269,A01,103665,Pal; Piya,0,0,0,0
1668405800773,ECE 271B,A00,103666,Vasconcelos; Manuela,0,0,0,0
1668405801196,ECE 276A,A00,103667,Atanasov; Nikolay A.,0,0,0,0
1668405801625,ECE 277,A00,103668,An; Cheolhong,0,0,0,0
1668405802047,ECE 279,A00,117947,Hall; Drew A.,0,0,0,0
1668405802896,ECE 283,A00,103670,Hsueh; Tzu-Chien,0,0,0,0
1668405803322,ECE 284,A00,103671,Turakhia; Yatish Girish,0,0,0,0
1668405803747,ECE 285,A00,103672,Zheng; Yang,0,0,0,0
1668405803747,ECE 285,B00,103673,Sworder; David D.,0,0,0,0
1668405804173,ECE 287,A00,103676,Javidi; Tara,0,0,0,0
1668405804597,MATH 200B,A00,098023,Salehi Golsefidy; Alireza,12,0,15,3
1668405805021,MATH 202B,A00,098024,Rhoades; Brendon Patrick,9,0,15,6
1668405805445,MATH 203B,A00,098025,Oprea; Dragos N.,10,0,15,5
1668405805869,MATH 204B,A00,098026,Sorensen; Claus M,13,0,15,2
1668405806294,MATH 208,A00,098027,Izadi; Elham,7,0,10,3
1668405806718,MATH 209,A00,098028,Pollack; Aaron,10,0,10,0
1668405807140,MATH 211A,A00,112919,Rogalski; Daniel,9,0,10,1
1668405807564,MATH 211B,A00,112920,Seward; Brandon M.,9,0,10,1
1668405808001,MATH 218,A00,098029,Li; Bo,10,0,10,0
1668405808429,MATH 220B,A00,098030,Novak; Jonathan I,11,0,15,4
1668405808859,MATH 221A,A00,098031,Ebenfelt; Peter F,13,0,15,2
1668405809285,MATH 231B,A00,098032,Zlatos; Andrej,12,0,15,3
1668405809709,MATH 240B,A00,098033,Ni; Lei,9,0,15,6
1668405810135,MATH 243,A00,098034,Jekel; David Andrew,10,0,10,0
1668405810573,MATH 245A,A00,098035,Nie; Jiawang,0,0,15,16
1668405810996,MATH 248,A00,098036,Bejenaru; Ioan,10,0,10,0
1668405811420,MATH 250B,A00,098037,Spolaor; Luca,14,0,15,1
1668405811850,MATH 258,A00,098038,Ni; Lei,10,0,10,0
1668405812286,MATH 264B,A00,098041,Rhoades; Brendon Patrick,9,0,15,6
1668405812723,MATH 268,A00,098042,Buss; Samuel R,10,0,10,0
1668405813149,MATH 269,A00,098043,Rhoades; Brendon Patrick,10,0,10,0
1668405813572,MATH 270B,A00,098044,Li; Bo,10,0,15,5
1668405813997,MATH 272B,A00,098045,Holst; Michael J,13,0,15,2
1668405814426,MATH 273A,A00,098046,Tian; Xiaochuan,10,0,15,5
1668405814854,MATH 275,A01,098048,Tian; Xiaochuan,6,0,10,4
1668405815279,MATH 278A,A00,098049,Holst; Michael J,8,0,10,2
1668405815713,MATH 278B,A00,098050,Cloninger; Alexander,10,0,10,0
1668405816137,MATH 278C,A00,098051,Nie; Jiawang,6,0,10,4
1668405816572,MATH 280B,A00,098052,Zheng; Tianyi,8,0,15,7
1668405816997,MATH 281B,A00,098053,Bradic; Jelena,0,0,15,15
1668405817424,MATH 282B,A00,098054,Arias-Castro; Ery,0,0,15,15
1668405817849,MATH 285,A00,098055,Fitzsimmons; Patrick J,0,0,15,17
1668405818282,MATH 287B,A00,098056,Arias-Castro; Ery,2,0,15,13
1668405818708,MATH 288,A00,098057,Agarwal; Pooja,9,0,10,1
1668405818708,MATH 288,B00,098058,Zhang; Danna,8,0,10,2
1668405818708,MATH 288,C00,098059,Williams; Ruth J,9,0,10,1
1668405819135,MATH 290B,A00,098060,Roberts; Justin Deritter,13,0,15,2
1668405819558,MATH 292,A00,098061,Belmont; Eva Kinoshita,10,0,10,0
1668405819982,MATH 295,A00,098062,Suk; Andrew Hoon,48,0,50,2
1668405820404,MATH 296,A00,098063,Novak; Jonathan I,20,0,20,0
1668405820829,MATH 297,001,098064,Gamst; Anthony Collins,9997,0,9999,2
1668406321330,COGS 205,A00,101395,Chiba; Andrea,19,0,20,1
1668406321776,COGS 210B,001,101404,Greene; Deanna Jacquelyn,9998,0,9999,1
1668406321776,COGS 210B,002,101417,Xia; Haijun,9999,0,9999,0
1668406321776,COGS 210B,003,101422,Nitz; Douglas A.,9999,0,9999,0
1668406321776,COGS 210B,004,101423,Hollan; James D.,9998,0,9999,1
1668406321776,COGS 210B,005,101424,Deak; Gedeon O.,9998,0,9999,1
1668406321776,COGS 210B,006,101425,Rossano; Federico,9999,0,9999,0
1668406322200,COGS 211B,A00,101427,Coulson; Seana M,9996,0,9999,3
1668406322625,COGS 220,A00,101428,Hollan; James D.,0,0,25,25
1668406323046,COGS 229,A00,101429,Dow; Steven P,18,0,25,7
1668406323471,COGS 230,A00,101430,Klemmer; Scott R,11,0,17,6
1668406323897,COGS 234,A00,101431,Xia; Haijun,1,0,25,24
1668406324320,COGS 260,A00,101432,Kiyonaga; Anastasia,21,0,25,4
1668406324320,COGS 260,B00,101433,Kirsh; David Joel,15,0,25,10
1668406324745,CSE 202,A00,102371,Impagliazzo; Russell,0,0,0,0
1668406325172,CSE 203B,A01,102373,Cheng; Chung Kuan,0,0,0,0
1668406325596,CSE 208,A00,102374,Micciancio; Daniele,0,0,0,0
1668406326032,CSE 209A,A00,112895,Impagliazzo; Russell,0,0,15,15
1668406326458,CSE 209B,A00,108005,Bellare; Mihir,0,0,0,0
1668406326882,CSE 210,A00,113163,Coblenz; Michael J,0,0,0,0
1668406327321,CSE 219,A00,106111,Dow; Steven P,0,0,20,20
1668406327748,CSE 221,A00,102376,Voelker; Geoffrey M.,0,0,0,0
1668406328175,CSE 224,A01,102378,Porter; George M,0,0,0,0
1668406328614,CSE 229A,A00,102379,Savage; Stefan,0,0,0,0
1668406329038,CSE 229C,A00,102380,Munyaka; Imani N. S.,0,0,0,0
1668406329470,CSE 232B,A00,102382,Deutsch; Alin Bernard,0,0,0,0
1668406329893,CSE 234,A01,112904,Kumar; Arun Kumar,0,0,0,0
1668406330317,CSE 237A,A00,102383,Rosing; Tajana Simunic,0,0,0,0
1668406330745,CSE 239A,A00,102384,Deutsch; Alin Bernard,0,0,0,0
1668406331171,CSE 239B,A00,102385,Polikarpova; Nadezhda,0,0,0,0
1668406331595,CSE 240A,A00,102386,Pannuto; Patrick William,0,0,0,0
1668406332022,CSE 240B,A00,102387,Zhao; Jishen,0,0,0,0
1668406332449,CSE 241A,A00,106406,Kang; Mingu,0,0,0,0
1668406332879,CSE 249B,A00,102388,Kahng; Andrew Byun,0,0,8,8
1668406333313,CSE 251B,A01,102392,Cottrell; Garrison W,0,0,0,0
1668406333313,CSE 251B,A02,102393,Cottrell; Garrison W,0,0,0,0
1668406333738,CSE 252B,A00,102394,Ochoa; Benjamin Lawrence,0,0,0,0
1668406334168,CSE 257,A01,102396,Gao; Sicun,0,0,0,0
1668406334597,CSE 272,A00,102397,Li; Tzumao,0,0,0,0
1668406335029,CSE 274,A00,111323,Chern; Albert Ren-Haur,0,0,0,0
1668406335464,CSE 282,A00,102398,Pevzner; Pavel Arkadjevich,0,0,0,0
1668406335888,CSE 284,A00,114175,Gymrek; Melissa Ann,0,0,0,0
1668406336312,CSE 290,A00,102399,Chandraker; Manmohan Krishna,0,0,0,0
1668406336312,CSE 290,B00,102400,Vaccaro; Kristen Marie,0,0,25,25
1668406336312,CSE 290,C00,102414,Pannuto; Patrick William,0,0,25,25
1668406336312,CSE 290,D00,102427,Pevzner; Pavel Arkadjevich,0,0,0,0
1668406336312,CSE 290,E00,102429,Zhao; Jishen,0,0,0,0
1668406336312,CSE 290,F00,102436,Tullsen; Dean Michael,0,0,0,0
1668406336312,CSE 290,G00,102440,Christensen; Henrik I,0,0,20,20
1668406336735,CSE 291,A00,102443,Su; Hao,0,0,0,0
1668406336735,CSE 291,B00,102448,Polikarpova; Nadezhda,0,0,0,0
1668406336735,CSE 291,C00,102453,Vaccaro; Kristen Marie,0,0,0,0
1668406336735,CSE 291,D00,111343,Savage; Stefan,0,0,0,0
1668406336735,CSE 291,E00,116474,Claffy; Kimberly Claire,0,0,0,0
1668406336735,CSE 291,F00,116479,Pasquale; Joseph,0,0,0,0
1668406337165,CSE 293,001,119111,Bafna; Vineet,9999,0,9999,0
1668406337165,CSE 293,002,119118,Bellare; Mihir,9999,0,9999,0
1668406337165,CSE 293,003,119122,Berg-Kirkpatrick; Taylor D,9999,0,9999,0
1668406337165,CSE 293,004,119135,Christensen; Henrik I,9999,0,9999,0
1668406337165,CSE 293,005,119142,Cottrell; Garrison W,9999,0,9999,0
1668406337165,CSE 293,006,119146,Deutsch; Alin Bernard,9999,0,9999,0
1668406337165,CSE 293,007,119159,Esmaeilzadeh; Hadi,9999,0,9999,0
1668406337165,CSE 293,008,119166,Freund; Yoav,9999,0,9999,0
1668406337165,CSE 293,009,119170,Griswold; William G.,9999,0,9999,0
1668406337165,CSE 293,010,119183,Gymrek; Melissa Ann,9999,0,9999,0
1668406337165,CSE 293,011,119190,Heninger; Nadia A,9999,0,9999,0
1668406337165,CSE 293,012,119230,Impagliazzo; Russell,9999,0,9999,0
1668406337165,CSE 293,013,119232,Jhala; Ranjit,9999,0,9999,0
1668406337165,CSE 293,014,119233,Kahng; Andrew Byun,9999,0,9999,0
1668406337165,CSE 293,015,119298,Kane; Daniel Mertz,9999,0,9999,0
1668406337165,CSE 293,016,119299,Kriegman; David J,9999,0,9999,0
1668406337165,CSE 293,017,119300,Kumar; Arun Kumar,9999,0,9999,0
1668406337165,CSE 293,018,119301,Lerner; Sorin,9999,0,9999,0
1668406337165,CSE 293,019,119302,Lovett; Shachar,9999,0,9999,0
1668406337165,CSE 293,020,119303,McAuley; Julian John,9999,0,9999,0
1668406337165,CSE 293,021,119304,Micciancio; Daniele,9999,0,9999,0
1668406337165,CSE 293,022,119367,Orailoglu; Alex,9999,0,9999,0
1668406337165,CSE 293,023,119382,Paturi; Ramamohan,9999,0,9999,0
1668406337165,CSE 293,024,119404,Polikarpova; Nadezhda,9999,0,9999,0
1668406337165,CSE 293,025,119406,Politz; Joseph Gibbs,9999,0,9999,0
1668406337165,CSE 293,026,119411,Porter; George M,9999,0,9999,0
1668406337165,CSE 293,027,119414,Porter; Leonard Emerson,9999,0,9999,0
1668406337165,CSE 293,028,119416,Ramamoorthi; Ravi,9999,0,9999,0
1668406337165,CSE 293,029,119417,Sahoo; Debashis,9999,0,9999,0
1668406337165,CSE 293,030,119420,Saul; Lawrence,9999,0,9999,0
1668406337165,CSE 293,031,119421,Savage; Stefan,9999,0,9999,0
1668406337165,CSE 293,032,119425,Schulze; Jurgen P.,9999,0,9999,0
1668406337165,CSE 293,033,119426,Snoeren; Alex C.,9999,0,9999,0
1668406337165,CSE 293,034,119428,Shang; Jingbo,9999,0,9999,0
1668406337165,CSE 293,035,119430,Stefan; Deian,9999,0,9999,0
1668406337165,CSE 293,036,119431,Su; Hao,9999,0,9999,0
1668406337165,CSE 293,037,119433,Swanson; Steven James,9999,0,9999,0
1668406337165,CSE 293,038,119435,Tullsen; Dean Michael,9999,0,9999,0
1668406337165,CSE 293,039,119483,Voelker; Geoffrey M.,9999,0,9999,0
1668406337165,CSE 293,040,119537,Zhao; Jishen,9999,0,9999,0
1668406337165,CSE 293,041,119538,Zhou; Yuan-Yuan,9999,0,9999,0
1668406337165,CSE 293,042,119539,Gao; Sicun,9999,0,9999,0
1668406337165,CSE 293,043,119540,Weibel; Nadir,9999,0,9999,0
1668406337165,CSE 293,044,119541,Gupta; Rajesh K.,9999,0,9999,0
1668406337165,CSE 293,045,126410,Vaccaro; Kristen Marie,9999,0,9999,0
1668406337165,CSE 293,046,126411,Klemke; Richard,9999,0,9999,0
1668406337592,CSE 294,A00,102459,Voelker; Geoffrey M.,0,0,0,0
1668406337592,CSE 294,B00,111322,Orailoglu; Alex,0,0,0,0
1668406338021,DSE 201,A00,096914,Deutsch; Alin Bernard,30,0,30,0
1668406338448,DSE 210,A00,096915,Dasgupta; Sanjoy,30,0,30,0
1668406338881,DSE 260A,A00,096916,Altintas De Callaf; Ilkay,30,0,30,0
1668406339331,ECE 200,001,103586,Antipa; Nicholas A,9999,0,9999,0
1668406339331,ECE 200,002,103587,Atanasov; Nikolay A.,9999,0,9999,0
1668406339331,ECE 200,003,103588,Bharadia; Dinesh,9999,0,9999,0
1668406339331,ECE 200,004,103589,Cheng; Chung Kuan,9999,0,9999,0
1668406339331,ECE 200,005,103590,Cosman; Pamela C.,9999,0,9999,0
1668406339331,ECE 200,006,103591,Dayeh; Shadi Ahmad,9999,0,9999,0
1668406339331,ECE 200,007,103592,Fainman; Yeshaiahu,9999,0,9999,0
1668406339331,ECE 200,008,103593,Ford; Joseph Earl,9999,0,9999,0
1668406339331,ECE 200,009,103594,Franceschetti; Massimo,9999,0,9999,0
1668406339331,ECE 200,010,103595,Fullerton; Eric E,9999,0,9999,0
1668406339331,ECE 200,011,103596,Galton; Ian A,9999,0,9999,0
1668406339331,ECE 200,012,103597,Gilja; Vikash,9999,0,9999,0
1668406339331,ECE 200,013,103598,Hall; Drew A.,9999,0,9999,0
1668406339331,ECE 200,014,103599,Hsueh; Tzu-Chien,9999,0,9999,0
1668406339331,ECE 200,015,103600,Javidi; Tara,9999,0,9999,0
1668406339331,ECE 200,016,103601,Kahng; Andrew Byun,9999,0,9999,0
1668406339331,ECE 200,017,103602,Kim; Young-Han,9999,0,9999,0
1668406339331,ECE 200,018,103603,Koushanfar; Farinaz,9999,0,9999,0
1668406339331,ECE 200,019,103604,Kuzum; Duygu,9999,0,9999,0
1668406339331,ECE 200,020,103605,Le; Hanh-Phuc,9999,0,9999,0
1668406339331,ECE 200,021,103606,Lin; Bill,9999,0,9999,0
1668406339331,ECE 200,022,103607,Liu; Zhaowei,9998,0,9999,1
1668406339331,ECE 200,023,103608,Lo; Yu-Hwa,9999,0,9999,0
1668406339331,ECE 200,024,103609,Lomakin; Vitaliy,9999,0,9999,0
1668406339331,ECE 200,025,103610,Mercier; Patrick Philip,9999,0,9999,0
1668406339331,ECE 200,026,103611,Meyer; Florian,9999,0,9999,0
1668406339331,ECE 200,027,103612,Milstein; Laurence B.,9999,0,9999,0
1668406339331,ECE 200,028,103613,Mir Arabbaygi; Siavash,9999,0,9999,0
1668406339331,ECE 200,029,103614,Mookherjea; Shayan,9999,0,9999,0
1668406339331,ECE 200,030,103615,Morris; Karcher William,9999,0,9999,0
1668406339331,ECE 200,031,103616,Ng; Tse Nga,9999,0,9999,0
1668406339331,ECE 200,032,103617,Nguyen; Truong Quang,9999,0,9999,0
1668406339331,ECE 200,033,103618,Nomura; Kenji,9999,0,9999,0
1668406339331,ECE 200,034,103619,Orlitsky; Alon,9999,0,9999,0
1668406339331,ECE 200,035,103620,Pal; Piya,9999,0,9999,0
1668406339331,ECE 200,036,103621,Papen; George C.,9999,0,9999,0
1668406339331,ECE 200,037,103622,Radic; Stojan,9999,0,9999,0
1668406339331,ECE 200,038,103623,Rao; Bhaskar D.,9999,0,9999,0
1668406339331,ECE 200,039,103624,Rao; Ramesh R,9999,0,9999,0
1668406339331,ECE 200,040,103625,Rebeiz; Gabriel,9999,0,9999,0
1668406339331,ECE 200,041,103626,Sanford; John R,9999,0,9999,0
1668406339331,ECE 200,042,103627,Siegel; Paul H.,9999,0,9999,0
1668406339331,ECE 200,043,103628,Sievenpiper; Daniel F.,9999,0,9999,0
1668406339331,ECE 200,044,103629,Sworder; David D.,9999,0,9999,0
1668406339331,ECE 200,045,103630,Taur; Yuan,9999,0,9999,0
1668406339331,ECE 200,046,103631,Touri; Behrouz,9999,0,9999,0
1668406339331,ECE 200,047,103632,Trivedi; Mohan M.,9999,0,9999,0
1668406339331,ECE 200,048,103633,Vasconcelos; Nuno,9999,0,9999,0
1668406339331,ECE 200,049,103634,Wang; Xiaolong,9999,0,9999,0
1668406339331,ECE 200,050,103635,Xie; Pengtao,9999,0,9999,0
1668406339331,ECE 200,051,103636,Yip; Michael,9999,0,9999,0
1668406339331,ECE 200,052,103637,Zeger; Kenneth A.,999,0,999,0
1668406339331,ECE 200,053,103638,Zhang; Xinyu,9999,0,9999,0
1668406339331,ECE 200,054,103639,Turakhia; Yatish Girish,9999,0,9999,0
1668406339331,ECE 200,055,103640,Kang; Mingu,9999,0,9999,0
1668406339331,ECE 200,056,103641,Shi; Yuanyuan,9999,0,9999,0
1668406339331,ECE 200,057,103642,Wang; Edward Jay,9999,0,9999,0
1668406339331,ECE 200,058,103643,Zheng; Yang,9999,0,9999,0
1668406339756,ECE 202,A00,103644,Kuzum; Duygu,0,0,0,0
1668406340181,ECE 212BN,A00,103646,Ng; Tse Nga,0,0,0,0
1668406340607,ECE 221,A00,111493,Staff,0,0,0,0
1668406341035,ECE 222B,A00,103647,Lomakin; Vitaliy,0,0,0,0
1668406341458,ECE 230B,A00,103648,Taur; Yuan,0,0,0,0
1668406341889,ECE 238B,A00,103649,Garay; Javier,0,0,0,0
1668406342317,ECE 240B,A00,112900,Fainman; Yeshaiahu,0,0,0,0
1668406342739,ECE 247A,A00,103650,Jokerst; Jesse Vincent,0,0,0,0
1668406343163,ECE 247B,A00,103651,Wang; Joseph,0,0,0,0
1668406343590,ECE 250,A00,103652,Siegel; Paul H.,0,0,0,0
1668406344012,ECE 251A,A00,103654,Rao; Bhaskar D.,0,0,0,0
1668406344445,ECE 257B,A00,103655,Bharadia; Dinesh,0,0,0,0
1668406344885,ECE 258A,A00,103656,Milstein; Laurence B.,0,0,0,0
1668406345322,ECE 260B,A00,103658,Kang; Mingu,0,0,0,0
1668406345836,ECE 264A,A00,103659,Galton; Ian A,0,0,0,0
1668406346275,ECE 265A,A00,103661,Gudem; Prasad S.S.,0,0,0,0
1668406346711,ECE 265D,A00,103662,Gudem; Prasad S.S.,0,0,0,0
1668406347139,ECE 268,A00,103663,Koushanfar; Farinaz,0,0,0,0
1668406347573,ECE 269,A01,103665,Pal; Piya,0,0,0,0
1668406348005,ECE 271B,A00,103666,Vasconcelos; Manuela,0,0,0,0
1668406348443,ECE 276A,A00,103667,Atanasov; Nikolay A.,0,0,0,0
1668406348867,ECE 277,A00,103668,An; Cheolhong,0,0,0,0
1668406349290,ECE 279,A00,117947,Hall; Drew A.,0,0,0,0
1668406350140,ECE 283,A00,103670,Hsueh; Tzu-Chien,0,0,0,0
1668406350563,ECE 284,A00,103671,Turakhia; Yatish Girish,0,0,0,0
1668406350990,ECE 285,A00,103672,Zheng; Yang,0,0,0,0
1668406350990,ECE 285,B00,103673,Sworder; David D.,0,0,0,0
1668406351414,ECE 287,A00,103676,Javidi; Tara,0,0,0,0
1668406351851,MATH 200B,A00,098023,Salehi Golsefidy; Alireza,12,0,15,3
1668406352289,MATH 202B,A00,098024,Rhoades; Brendon Patrick,9,0,15,6
1668406352711,MATH 203B,A00,098025,Oprea; Dragos N.,10,0,15,5
1668406353136,MATH 204B,A00,098026,Sorensen; Claus M,13,0,15,2
1668406353562,MATH 208,A00,098027,Izadi; Elham,7,0,10,3
1668406353984,MATH 209,A00,098028,Pollack; Aaron,10,0,10,0
1668406354408,MATH 211A,A00,112919,Rogalski; Daniel,9,0,10,1
1668406354831,MATH 211B,A00,112920,Seward; Brandon M.,9,0,10,1
1668406355253,MATH 218,A00,098029,Li; Bo,10,0,10,0
1668406355677,MATH 220B,A00,098030,Novak; Jonathan I,11,0,15,4
1668406356100,MATH 221A,A00,098031,Ebenfelt; Peter F,13,0,15,2
1668406356523,MATH 231B,A00,098032,Zlatos; Andrej,12,0,15,3
1668406356961,MATH 240B,A00,098033,Ni; Lei,9,0,15,6
1668406357390,MATH 243,A00,098034,Jekel; David Andrew,10,0,10,0
1668406357825,MATH 245A,A00,098035,Nie; Jiawang,0,0,15,16
1668406358260,MATH 248,A00,098036,Bejenaru; Ioan,10,0,10,0
1668406358683,MATH 250B,A00,098037,Spolaor; Luca,14,0,15,1
1668406359113,MATH 258,A00,098038,Ni; Lei,10,0,10,0
1668406359536,MATH 264B,A00,098041,Rhoades; Brendon Patrick,9,0,15,6
1668406359963,MATH 268,A00,098042,Buss; Samuel R,10,0,10,0
1668406360387,MATH 269,A00,098043,Rhoades; Brendon Patrick,10,0,10,0
1668406360810,MATH 270B,A00,098044,Li; Bo,10,0,15,5
1668406361231,MATH 272B,A00,098045,Holst; Michael J,13,0,15,2
1668406361657,MATH 273A,A00,098046,Tian; Xiaochuan,10,0,15,5
1668406362078,MATH 275,A01,098048,Tian; Xiaochuan,6,0,10,4
1668406362502,MATH 278A,A00,098049,Holst; Michael J,8,0,10,2
1668406362923,MATH 278B,A00,098050,Cloninger; Alexander,10,0,10,0
1668406363347,MATH 278C,A00,098051,Nie; Jiawang,6,0,10,4
1668406363769,MATH 280B,A00,098052,Zheng; Tianyi,8,0,15,7
1668406364191,MATH 281B,A00,098053,Bradic; Jelena,0,0,15,15
1668406364617,MATH 282B,A00,098054,Arias-Castro; Ery,0,0,15,15
1668406365051,MATH 285,A00,098055,Fitzsimmons; Patrick J,0,0,15,17
1668406365474,MATH 287B,A00,098056,Arias-Castro; Ery,2,0,15,13
1668406365898,MATH 288,A00,098057,Agarwal; Pooja,9,0,10,1
1668406365898,MATH 288,B00,098058,Zhang; Danna,8,0,10,2
1668406365898,MATH 288,C00,098059,Williams; Ruth J,9,0,10,1
1668406366324,MATH 290B,A00,098060,Roberts; Justin Deritter,13,0,15,2
1668406366746,MATH 292,A00,098061,Belmont; Eva Kinoshita,10,0,10,0
1668406367169,MATH 295,A00,098062,Suk; Andrew Hoon,48,0,50,2
1668406367592,MATH 296,A00,098063,Novak; Jonathan I,20,0,20,0
1668406368017,MATH 297,001,098064,Gamst; Anthony Collins,9997,0,9999,2
1668406868670,COGS 205,A00,101395,Chiba; Andrea,19,0,20,1
1668406869092,COGS 210B,001,101404,Greene; Deanna Jacquelyn,9998,0,9999,1
1668406869092,COGS 210B,002,101417,Xia; Haijun,9999,0,9999,0
1668406869092,COGS 210B,003,101422,Nitz; Douglas A.,9999,0,9999,0
1668406869092,COGS 210B,004,101423,Hollan; James D.,9998,0,9999,1
1668406869092,COGS 210B,005,101424,Deak; Gedeon O.,9998,0,9999,1
1668406869092,COGS 210B,006,101425,Rossano; Federico,9999,0,9999,0
1668406869516,COGS 211B,A00,101427,Coulson; Seana M,9996,0,9999,3
1668406869941,COGS 220,A00,101428,Hollan; James D.,0,0,25,25
1668406870363,COGS 229,A00,101429,Dow; Steven P,18,0,25,7
1668406870791,COGS 230,A00,101430,Klemmer; Scott R,11,0,17,6
1668406871214,COGS 234,A00,101431,Xia; Haijun,1,0,25,24
1668406871637,COGS 260,A00,101432,Kiyonaga; Anastasia,21,0,25,4
1668406871637,COGS 260,B00,101433,Kirsh; David Joel,15,0,25,10
1668406872066,CSE 202,A00,102371,Impagliazzo; Russell,0,0,0,0
1668406872495,CSE 203B,A01,102373,Cheng; Chung Kuan,0,0,0,0
1668406872919,CSE 208,A00,102374,Micciancio; Daniele,0,0,0,0
1668406873355,CSE 209A,A00,112895,Impagliazzo; Russell,0,0,15,15
1668406873781,CSE 209B,A00,108005,Bellare; Mihir,0,0,0,0
1668406874208,CSE 210,A00,113163,Coblenz; Michael J,0,0,0,0
1668406874641,CSE 219,A00,106111,Dow; Steven P,0,0,20,20
1668406875069,CSE 221,A00,102376,Voelker; Geoffrey M.,0,0,0,0
1668406875492,CSE 224,A01,102378,Porter; George M,0,0,0,0
1668406875918,CSE 229A,A00,102379,Savage; Stefan,0,0,0,0
1668406876349,CSE 229C,A00,102380,Munyaka; Imani N. S.,0,0,0,0
1668406876780,CSE 232B,A00,102382,Deutsch; Alin Bernard,0,0,0,0
1668406877203,CSE 234,A01,112904,Kumar; Arun Kumar,0,0,0,0
1668406877641,CSE 237A,A00,102383,Rosing; Tajana Simunic,0,0,0,0
1668406878075,CSE 239A,A00,102384,Deutsch; Alin Bernard,0,0,0,0
1668406878518,CSE 239B,A00,102385,Polikarpova; Nadezhda,0,0,0,0
1668406878945,CSE 240A,A00,102386,Pannuto; Patrick William,0,0,0,0
1668406879368,CSE 240B,A00,102387,Zhao; Jishen,0,0,0,0
1668406879790,CSE 241A,A00,106406,Kang; Mingu,0,0,0,0
1668406880212,CSE 249B,A00,102388,Kahng; Andrew Byun,0,0,8,8
1668406880640,CSE 251B,A01,102392,Cottrell; Garrison W,0,0,0,0
1668406880640,CSE 251B,A02,102393,Cottrell; Garrison W,0,0,0,0
1668406881064,CSE 252B,A00,102394,Ochoa; Benjamin Lawrence,0,0,0,0
1668406881487,CSE 257,A01,102396,Gao; Sicun,0,0,0,0
1668406881912,CSE 272,A00,102397,Li; Tzumao,0,0,0,0
1668406882336,CSE 274,A00,111323,Chern; Albert Ren-Haur,0,0,0,0
1668406882761,CSE 282,A00,102398,Pevzner; Pavel Arkadjevich,0,0,0,0
1668406883185,CSE 284,A00,114175,Gymrek; Melissa Ann,0,0,0,0
1668406883613,CSE 290,A00,102399,Chandraker; Manmohan Krishna,0,0,0,0
1668406883613,CSE 290,B00,102400,Vaccaro; Kristen Marie,0,0,25,25
1668406883613,CSE 290,C00,102414,Pannuto; Patrick William,0,0,25,25
1668406883613,CSE 290,D00,102427,Pevzner; Pavel Arkadjevich,0,0,0,0
1668406883613,CSE 290,E00,102429,Zhao; Jishen,0,0,0,0
1668406883613,CSE 290,F00,102436,Tullsen; Dean Michael,0,0,0,0
1668406883613,CSE 290,G00,102440,Christensen; Henrik I,0,0,20,20
1668406884043,CSE 291,A00,102443,Su; Hao,0,0,0,0
1668406884043,CSE 291,B00,102448,Polikarpova; Nadezhda,0,0,0,0
1668406884043,CSE 291,C00,102453,Vaccaro; Kristen Marie,0,0,0,0
1668406884043,CSE 291,D00,111343,Savage; Stefan,0,0,0,0
1668406884043,CSE 291,E00,116474,Claffy; Kimberly Claire,0,0,0,0
1668406884043,CSE 291,F00,116479,Pasquale; Joseph,0,0,0,0
1668406884472,CSE 293,001,119111,Bafna; Vineet,9999,0,9999,0
1668406884472,CSE 293,002,119118,Bellare; Mihir,9999,0,9999,0
1668406884472,CSE 293,003,119122,Berg-Kirkpatrick; Taylor D,9999,0,9999,0
1668406884472,CSE 293,004,119135,Christensen; Henrik I,9999,0,9999,0
1668406884472,CSE 293,005,119142,Cottrell; Garrison W,9999,0,9999,0
1668406884472,CSE 293,006,119146,Deutsch; Alin Bernard,9999,0,9999,0
1668406884472,CSE 293,007,119159,Esmaeilzadeh; Hadi,9999,0,9999,0
1668406884472,CSE 293,008,119166,Freund; Yoav,9999,0,9999,0
1668406884472,CSE 293,009,119170,Griswold; William G.,9999,0,9999,0
1668406884472,CSE 293,010,119183,Gymrek; Melissa Ann,9999,0,9999,0
1668406884472,CSE 293,011,119190,Heninger; Nadia A,9999,0,9999,0
1668406884472,CSE 293,012,119230,Impagliazzo; Russell,9999,0,9999,0
1668406884472,CSE 293,013,119232,Jhala; Ranjit,9999,0,9999,0
1668406884472,CSE 293,014,119233,Kahng; Andrew Byun,9999,0,9999,0
1668406884472,CSE 293,015,119298,Kane; Daniel Mertz,9999,0,9999,0
1668406884472,CSE 293,016,119299,Kriegman; David J,9999,0,9999,0
1668406884472,CSE 293,017,119300,Kumar; Arun Kumar,9999,0,9999,0
1668406884472,CSE 293,018,119301,Lerner; Sorin,9999,0,9999,0
1668406884472,CSE 293,019,119302,Lovett; Shachar,9999,0,9999,0
1668406884472,CSE 293,020,119303,McAuley; Julian John,9999,0,9999,0
1668406884472,CSE 293,021,119304,Micciancio; Daniele,9999,0,9999,0
1668406884472,CSE 293,022,119367,Orailoglu; Alex,9999,0,9999,0
1668406884472,CSE 293,023,119382,Paturi; Ramamohan,9999,0,9999,0
1668406884472,CSE 293,024,119404,Polikarpova; Nadezhda,9999,0,9999,0
1668406884472,CSE 293,025,119406,Politz; Joseph Gibbs,9999,0,9999,0
1668406884472,CSE 293,026,119411,Porter; George M,9999,0,9999,0
1668406884472,CSE 293,027,119414,Porter; Leonard Emerson,9999,0,9999,0
1668406884472,CSE 293,028,119416,Ramamoorthi; Ravi,9999,0,9999,0
1668406884472,CSE 293,029,119417,Sahoo; Debashis,9999,0,9999,0
1668406884472,CSE 293,030,119420,Saul; Lawrence,9999,0,9999,0
1668406884472,CSE 293,031,119421,Savage; Stefan,9999,0,9999,0
1668406884472,CSE 293,032,119425,Schulze; Jurgen P.,9999,0,9999,0
1668406884472,CSE 293,033,119426,Snoeren; Alex C.,9999,0,9999,0
1668406884472,CSE 293,034,119428,Shang; Jingbo,9999,0,9999,0
1668406884472,CSE 293,035,119430,Stefan; Deian,9999,0,9999,0
1668406884472,CSE 293,036,119431,Su; Hao,9999,0,9999,0
1668406884472,CSE 293,037,119433,Swanson; Steven James,9999,0,9999,0
1668406884472,CSE 293,038,119435,Tullsen; Dean Michael,9999,0,9999,0
1668406884472,CSE 293,039,119483,Voelker; Geoffrey M.,9999,0,9999,0
1668406884472,CSE 293,040,119537,Zhao; Jishen,9999,0,9999,0
1668406884472,CSE 293,041,119538,Zhou; Yuan-Yuan,9999,0,9999,0
1668406884472,CSE 293,042,119539,Gao; Sicun,9999,0,9999,0
1668406884472,CSE 293,043,119540,Weibel; Nadir,9999,0,9999,0
1668406884472,CSE 293,044,119541,Gupta; Rajesh K.,9999,0,9999,0
1668406884472,CSE 293,045,126410,Vaccaro; Kristen Marie,9999,0,9999,0
1668406884472,CSE 293,046,126411,Klemke; Richard,9999,0,9999,0
1668406884894,CSE 294,A00,102459,Voelker; Geoffrey M.,0,0,0,0
1668406884894,CSE 294,B00,111322,Orailoglu; Alex,0,0,0,0
1668406885321,DSE 201,A00,096914,Deutsch; Alin Bernard,30,0,30,0
1668406885747,DSE 210,A00,096915,Dasgupta; Sanjoy,30,0,30,0
1668406886173,DSE 260A,A00,096916,Altintas De Callaf; Ilkay,30,0,30,0
1668406886601,ECE 200,001,103586,Antipa; Nicholas A,9999,0,9999,0
1668406886601,ECE 200,002,103587,Atanasov; Nikolay A.,9999,0,9999,0
1668406886601,ECE 200,003,103588,Bharadia; Dinesh,9999,0,9999,0
1668406886601,ECE 200,004,103589,Cheng; Chung Kuan,9999,0,9999,0
1668406886601,ECE 200,005,103590,Cosman; Pamela C.,9999,0,9999,0
1668406886601,ECE 200,006,103591,Dayeh; Shadi Ahmad,9999,0,9999,0
1668406886601,ECE 200,007,103592,Fainman; Yeshaiahu,9999,0,9999,0
1668406886601,ECE 200,008,103593,Ford; Joseph Earl,9999,0,9999,0
1668406886601,ECE 200,009,103594,Franceschetti; Massimo,9999,0,9999,0
1668406886601,ECE 200,010,103595,Fullerton; Eric E,9999,0,9999,0
1668406886601,ECE 200,011,103596,Galton; Ian A,9999,0,9999,0
1668406886601,ECE 200,012,103597,Gilja; Vikash,9999,0,9999,0
1668406886601,ECE 200,013,103598,Hall; Drew A.,9999,0,9999,0
1668406886601,ECE 200,014,103599,Hsueh; Tzu-Chien,9999,0,9999,0
1668406886601,ECE 200,015,103600,Javidi; Tara,9999,0,9999,0
1668406886601,ECE 200,016,103601,Kahng; Andrew Byun,9999,0,9999,0
1668406886601,ECE 200,017,103602,Kim; Young-Han,9999,0,9999,0
1668406886601,ECE 200,018,103603,Koushanfar; Farinaz,9999,0,9999,0
1668406886601,ECE 200,019,103604,Kuzum; Duygu,9999,0,9999,0
1668406886601,ECE 200,020,103605,Le; Hanh-Phuc,9999,0,9999,0
1668406886601,ECE 200,021,103606,Lin; Bill,9999,0,9999,0
1668406886601,ECE 200,022,103607,Liu; Zhaowei,9998,0,9999,1
1668406886601,ECE 200,023,103608,Lo; Yu-Hwa,9999,0,9999,0
1668406886601,ECE 200,024,103609,Lomakin; Vitaliy,9999,0,9999,0
1668406886601,ECE 200,025,103610,Mercier; Patrick Philip,9999,0,9999,0
1668406886601,ECE 200,026,103611,Meyer; Florian,9999,0,9999,0
1668406886601,ECE 200,027,103612,Milstein; Laurence B.,9999,0,9999,0
1668406886601,ECE 200,028,103613,Mir Arabbaygi; Siavash,9999,0,9999,0
1668406886601,ECE 200,029,103614,Mookherjea; Shayan,9999,0,9999,0
1668406886601,ECE 200,030,103615,Morris; Karcher William,9999,0,9999,0
1668406886601,ECE 200,031,103616,Ng; Tse Nga,9999,0,9999,0
1668406886601,ECE 200,032,103617,Nguyen; Truong Quang,9999,0,9999,0
1668406886601,ECE 200,033,103618,Nomura; Kenji,9999,0,9999,0
1668406886601,ECE 200,034,103619,Orlitsky; Alon,9999,0,9999,0
1668406886601,ECE 200,035,103620,Pal; Piya,9999,0,9999,0
1668406886601,ECE 200,036,103621,Papen; George C.,9999,0,9999,0
1668406886601,ECE 200,037,103622,Radic; Stojan,9999,0,9999,0
1668406886601,ECE 200,038,103623,Rao; Bhaskar D.,9999,0,9999,0
1668406886601,ECE 200,039,103624,Rao; Ramesh R,9999,0,9999,0
1668406886601,ECE 200,040,103625,Rebeiz; Gabriel,9999,0,9999,0
1668406886601,ECE 200,041,103626,Sanford; John R,9999,0,9999,0
1668406886601,ECE 200,042,103627,Siegel; Paul H.,9999,0,9999,0
1668406886601,ECE 200,043,103628,Sievenpiper; Daniel F.,9999,0,9999,0
1668406886601,ECE 200,044,103629,Sworder; David D.,9999,0,9999,0
1668406886601,ECE 200,045,103630,Taur; Yuan,9999,0,9999,0
1668406886601,ECE 200,046,103631,Touri; Behrouz,9999,0,9999,0
1668406886601,ECE 200,047,103632,Trivedi; Mohan M.,9999,0,9999,0
1668406886601,ECE 200,048,103633,Vasconcelos; Nuno,9999,0,9999,0
1668406886601,ECE 200,049,103634,Wang; Xiaolong,9999,0,9999,0
1668406886601,ECE 200,050,103635,Xie; Pengtao,9999,0,9999,0
1668406886601,ECE 200,051,103636,Yip; Michael,9999,0,9999,0
1668406886601,ECE 200,052,103637,Zeger; Kenneth A.,999,0,999,0
1668406886601,ECE 200,053,103638,Zhang; Xinyu,9999,0,9999,0
1668406886601,ECE 200,054,103639,Turakhia; Yatish Girish,9999,0,9999,0
1668406886601,ECE 200,055,103640,Kang; Mingu,9999,0,9999,0
1668406886601,ECE 200,056,103641,Shi; Yuanyuan,9999,0,9999,0
1668406886601,ECE 200,057,103642,Wang; Edward Jay,9999,0,9999,0
1668406886601,ECE 200,058,103643,Zheng; Yang,9999,0,9999,0
1668406887025,ECE 202,A00,103644,Kuzum; Duygu,0,0,0,0
1668406887452,ECE 212BN,A00,103646,Ng; Tse Nga,0,0,0,0
1668406887885,ECE 221,A00,111493,Staff,0,0,0,0
1668406888313,ECE 222B,A00,103647,Lomakin; Vitaliy,0,0,0,0
1668406888735,ECE 230B,A00,103648,Taur; Yuan,0,0,0,0
1668406889159,ECE 238B,A00,103649,Garay; Javier,0,0,0,0
1668406889587,ECE 240B,A00,112900,Fainman; Yeshaiahu,0,0,0,0
1668406890014,ECE 247A,A00,103650,Jokerst; Jesse Vincent,0,0,0,0
1668406890437,ECE 247B,A00,103651,Wang; Joseph,0,0,0,0
1668406890865,ECE 250,A00,103652,Siegel; Paul H.,0,0,0,0
1668406891289,ECE 251A,A00,103654,Rao; Bhaskar D.,0,0,0,0
1668406891713,ECE 257B,A00,103655,Bharadia; Dinesh,0,0,0,0
1668406892146,ECE 258A,A00,103656,Milstein; Laurence B.,0,0,0,0
1668406892581,ECE 260B,A00,103658,Kang; Mingu,0,0,0,0
1668406893019,ECE 264A,A00,103659,Galton; Ian A,0,0,0,0
1668406893453,ECE 265A,A00,103661,Gudem; Prasad S.S.,0,0,0,0
1668406893879,ECE 265D,A00,103662,Gudem; Prasad S.S.,0,0,0,0
1668406894301,ECE 268,A00,103663,Koushanfar; Farinaz,0,0,0,0
1668406894725,ECE 269,A01,103665,Pal; Piya,0,0,0,0
1668406895149,ECE 271B,A00,103666,Vasconcelos; Manuela,0,0,0,0
1668406895581,ECE 276A,A00,103667,Atanasov; Nikolay A.,0,0,0,0
1668406896006,ECE 277,A00,103668,An; Cheolhong,0,0,0,0
1668406896431,ECE 279,A00,117947,Hall; Drew A.,0,0,0,0
1668406897277,ECE 283,A00,103670,Hsueh; Tzu-Chien,0,0,0,0
1668406897704,ECE 284,A00,103671,Turakhia; Yatish Girish,0,0,0,0
1668406898127,ECE 285,A00,103672,Zheng; Yang,0,0,0,0
1668406898127,ECE 285,B00,103673,Sworder; David D.,0,0,0,0
1668406898550,ECE 287,A00,103676,Javidi; Tara,0,0,0,0
1668406898971,MATH 200B,A00,098023,Salehi Golsefidy; Alireza,12,0,15,3
1668406899395,MATH 202B,A00,098024,Rhoades; Brendon Patrick,9,0,15,6
1668406899820,MATH 203B,A00,098025,Oprea; Dragos N.,10,0,15,5
1668406900243,MATH 204B,A00,098026,Sorensen; Claus M,13,0,15,2
1668406900665,MATH 208,A00,098027,Izadi; Elham,7,0,10,3
1668406901087,MATH 209,A00,098028,Pollack; Aaron,10,0,10,0
1668406901510,MATH 211A,A00,112919,Rogalski; Daniel,9,0,10,1
1668406901933,MATH 211B,A00,112920,Seward; Brandon M.,9,0,10,1
1668406902362,MATH 218,A00,098029,Li; Bo,10,0,10,0
1668406902789,MATH 220B,A00,098030,Novak; Jonathan I,11,0,15,4
1668406903213,MATH 221A,A00,098031,Ebenfelt; Peter F,13,0,15,2
1668406903714,MATH 231B,A00,098032,Zlatos; Andrej,12,0,15,3
1668406904138,MATH 240B,A00,098033,Ni; Lei,9,0,15,6
1668406904561,MATH 243,A00,098034,Jekel; David Andrew,10,0,10,0
1668406904989,MATH 245A,A00,098035,Nie; Jiawang,0,0,15,16
1668406905419,MATH 248,A00,098036,Bejenaru; Ioan,10,0,10,0
1668406905856,MATH 250B,A00,098037,Spolaor; Luca,14,0,15,1
1668406906291,MATH 258,A00,098038,Ni; Lei,10,0,10,0
1668406906715,MATH 264B,A00,098041,Rhoades; Brendon Patrick,9,0,15,6
1668406907144,MATH 268,A00,098042,Buss; Samuel R,10,0,10,0
1668406907566,MATH 269,A00,098043,Rhoades; Brendon Patrick,10,0,10,0
1668406907990,MATH 270B,A00,098044,Li; Bo,10,0,15,5
1668406908422,MATH 272B,A00,098045,Holst; Michael J,13,0,15,2
1668406908855,MATH 273A,A00,098046,Tian; Xiaochuan,10,0,15,5
1668406909279,MATH 275,A01,098048,Tian; Xiaochuan,6,0,10,4
1668406909807,MATH 278A,A00,098049,Holst; Michael J,8,0,10,2
1668406910231,MATH 278B,A00,098050,Cloninger; Alexander,10,0,10,0
1668406910654,MATH 278C,A00,098051,Nie; Jiawang,6,0,10,4
1668406911077,MATH 280B,A00,098052,Zheng; Tianyi,8,0,15,7
1668406911504,MATH 281B,A00,098053,Bradic; Jelena,0,0,15,15
1668406911928,MATH 282B,A00,098054,Arias-Castro; Ery,0,0,15,15
1668406912354,MATH 285,A00,098055,Fitzsimmons; Patrick J,0,0,15,17
1668406912782,MATH 287B,A00,098056,Arias-Castro; Ery,2,0,15,13
1668406913204,MATH 288,A00,098057,Agarwal; Pooja,9,0,10,1
1668406913204,MATH 288,B00,098058,Zhang; Danna,8,0,10,2
1668406913204,MATH 288,C00,098059,Williams; Ruth J,9,0,10,1
1668406913631,MATH 290B,A00,098060,Roberts; Justin Deritter,13,0,15,2
1668406914056,MATH 292,A00,098061,Belmont; Eva Kinoshita,10,0,10,0
1668406914493,MATH 295,A00,098062,Suk; Andrew Hoon,48,0,50,2
1668406914929,MATH 296,A00,098063,Novak; Jonathan I,20,0,20,0
1668406915356,MATH 297,001,098064,Gamst; Anthony Collins,9997,0,9999,2
1668407424527,COGS 205,A00,101395,Chiba; Andrea,19,0,20,1
1668407424958,COGS 210B,001,101404,Greene; Deanna Jacquelyn,9998,0,9999,1
1668407424958,COGS 210B,002,101417,Xia; Haijun,9999,0,9999,0
1668407424958,COGS 210B,003,101422,Nitz; Douglas A.,9999,0,9999,0
1668407424958,COGS 210B,004,101423,Hollan; James D.,9998,0,9999,1
1668407424958,COGS 210B,005,101424,Deak; Gedeon O.,9998,0,9999,1
1668407424958,COGS 210B,006,101425,Rossano; Federico,9999,0,9999,0
1668407425382,COGS 211B,A00,101427,Coulson; Seana M,9996,0,9999,3
1668407425808,COGS 220,A00,101428,Hollan; James D.,0,0,25,25
1668407426237,COGS 229,A00,101429,Dow; Steven P,18,0,25,7
1668407426666,COGS 230,A00,101430,Klemmer; Scott R,11,0,17,6
1668407427089,COGS 234,A00,101431,Xia; Haijun,1,0,25,24
1668407427516,COGS 260,A00,101432,Kiyonaga; Anastasia,21,0,25,4
1668407427516,COGS 260,B00,101433,Kirsh; David Joel,15,0,25,10
1668407427959,CSE 202,A00,102371,Impagliazzo; Russell,0,0,0,0
1668407428385,CSE 203B,A01,102373,Cheng; Chung Kuan,0,0,0,0
1668407428812,CSE 208,A00,102374,Micciancio; Daniele,0,0,0,0
1668407429255,CSE 209A,A00,112895,Impagliazzo; Russell,0,0,15,15
1668407429680,CSE 209B,A00,108005,Bellare; Mihir,0,0,0,0
1668407430107,CSE 210,A00,113163,Coblenz; Michael J,0,0,0,0
1668407430529,CSE 219,A00,106111,Dow; Steven P,0,0,20,20
1668407430958,CSE 221,A00,102376,Voelker; Geoffrey M.,0,0,0,0
1668407431384,CSE 224,A01,102378,Porter; George M,0,0,0,0
1668407431806,CSE 229A,A00,102379,Savage; Stefan,0,0,0,0
1668407432233,CSE 229C,A00,102380,Munyaka; Imani N. S.,0,0,0,0
1668407432660,CSE 232B,A00,102382,Deutsch; Alin Bernard,0,0,0,0
1668407433085,CSE 234,A01,112904,Kumar; Arun Kumar,0,0,0,0
1668407433512,CSE 237A,A00,102383,Rosing; Tajana Simunic,0,0,0,0
1668407433953,CSE 239A,A00,102384,Deutsch; Alin Bernard,0,0,0,0
1668407434378,CSE 239B,A00,102385,Polikarpova; Nadezhda,0,0,0,0
1668407434801,CSE 240A,A00,102386,Pannuto; Patrick William,0,0,0,0
1668407435225,CSE 240B,A00,102387,Zhao; Jishen,0,0,0,0
1668407435649,CSE 241A,A00,106406,Kang; Mingu,0,0,0,0
1668407436073,CSE 249B,A00,102388,Kahng; Andrew Byun,0,0,8,8
1668407436496,CSE 251B,A01,102392,Cottrell; Garrison W,0,0,0,0
1668407436496,CSE 251B,A02,102393,Cottrell; Garrison W,0,0,0,0
1668407436923,CSE 252B,A00,102394,Ochoa; Benjamin Lawrence,0,0,0,0
1668407437345,CSE 257,A01,102396,Gao; Sicun,0,0,0,0
1668407437769,CSE 272,A00,102397,Li; Tzumao,0,0,0,0
1668407438196,CSE 274,A00,111323,Chern; Albert Ren-Haur,0,0,0,0
1668407438619,CSE 282,A00,102398,Pevzner; Pavel Arkadjevich,0,0,0,0
1668407439120,CSE 284,A00,114175,Gymrek; Melissa Ann,0,0,0,0
1668407439547,CSE 290,A00,102399,Chandraker; Manmohan Krishna,0,0,0,0
1668407439547,CSE 290,B00,102400,Vaccaro; Kristen Marie,0,0,25,25
1668407439547,CSE 290,C00,102414,Pannuto; Patrick William,0,0,25,25
1668407439547,CSE 290,D00,102427,Pevzner; Pavel Arkadjevich,0,0,0,0
1668407439547,CSE 290,E00,102429,Zhao; Jishen,0,0,0,0
1668407439547,CSE 290,F00,102436,Tullsen; Dean Michael,0,0,0,0
1668407439547,CSE 290,G00,102440,Christensen; Henrik I,0,0,20,20
1668407439976,CSE 291,A00,102443,Su; Hao,0,0,0,0
1668407439976,CSE 291,B00,102448,Polikarpova; Nadezhda,0,0,0,0
1668407439976,CSE 291,C00,102453,Vaccaro; Kristen Marie,0,0,0,0
1668407439976,CSE 291,D00,111343,Savage; Stefan,0,0,0,0
1668407439976,CSE 291,E00,116474,Claffy; Kimberly Claire,0,0,0,0
1668407439976,CSE 291,F00,116479,Pasquale; Joseph,0,0,0,0
1668407440404,CSE 293,001,119111,Bafna; Vineet,9999,0,9999,0
1668407440404,CSE 293,002,119118,Bellare; Mihir,9999,0,9999,0
1668407440404,CSE 293,003,119122,Berg-Kirkpatrick; Taylor D,9999,0,9999,0
1668407440404,CSE 293,004,119135,Christensen; Henrik I,9999,0,9999,0
1668407440404,CSE 293,005,119142,Cottrell; Garrison W,9999,0,9999,0
1668407440404,CSE 293,006,119146,Deutsch; Alin Bernard,9999,0,9999,0
1668407440404,CSE 293,007,119159,Esmaeilzadeh; Hadi,9999,0,9999,0
1668407440404,CSE 293,008,119166,Freund; Yoav,9999,0,9999,0
1668407440404,CSE 293,009,119170,Griswold; William G.,9999,0,9999,0
1668407440404,CSE 293,010,119183,Gymrek; Melissa Ann,9999,0,9999,0
1668407440404,CSE 293,011,119190,Heninger; Nadia A,9999,0,9999,0
1668407440404,CSE 293,012,119230,Impagliazzo; Russell,9999,0,9999,0
1668407440404,CSE 293,013,119232,Jhala; Ranjit,9999,0,9999,0
1668407440404,CSE 293,014,119233,Kahng; Andrew Byun,9999,0,9999,0
1668407440404,CSE 293,015,119298,Kane; Daniel Mertz,9999,0,9999,0
1668407440404,CSE 293,016,119299,Kriegman; David J,9999,0,9999,0
1668407440404,CSE 293,017,119300,Kumar; Arun Kumar,9999,0,9999,0
1668407440404,CSE 293,018,119301,Lerner; Sorin,9999,0,9999,0
1668407440404,CSE 293,019,119302,Lovett; Shachar,9999,0,9999,0
1668407440404,CSE 293,020,119303,McAuley; Julian John,9999,0,9999,0
1668407440404,CSE 293,021,119304,Micciancio; Daniele,9999,0,9999,0
1668407440404,CSE 293,022,119367,Orailoglu; Alex,9999,0,9999,0
1668407440404,CSE 293,023,119382,Paturi; Ramamohan,9999,0,9999,0
1668407440404,CSE 293,024,119404,Polikarpova; Nadezhda,9999,0,9999,0
1668407440404,CSE 293,025,119406,Politz; Joseph Gibbs,9999,0,9999,0
1668407440404,CSE 293,026,119411,Porter; George M,9999,0,9999,0
1668407440404,CSE 293,027,119414,Porter; Leonard Emerson,9999,0,9999,0
1668407440404,CSE 293,028,119416,Ramamoorthi; Ravi,9999,0,9999,0
1668407440404,CSE 293,029,119417,Sahoo; Debashis,9999,0,9999,0
1668407440404,CSE 293,030,119420,Saul; Lawrence,9999,0,9999,0
1668407440404,CSE 293,031,119421,Savage; Stefan,9999,0,9999,0
1668407440404,CSE 293,032,119425,Schulze; Jurgen P.,9999,0,9999,0
1668407440404,CSE 293,033,119426,Snoeren; Alex C.,9999,0,9999,0
1668407440404,CSE 293,034,119428,Shang; Jingbo,9999,0,9999,0
1668407440404,CSE 293,035,119430,Stefan; Deian,9999,0,9999,0
1668407440404,CSE 293,036,119431,Su; Hao,9999,0,9999,0
1668407440404,CSE 293,037,119433,Swanson; Steven James,9999,0,9999,0
1668407440404,CSE 293,038,119435,Tullsen; Dean Michael,9999,0,9999,0
1668407440404,CSE 293,039,119483,Voelker; Geoffrey M.,9999,0,9999,0
1668407440404,CSE 293,040,119537,Zhao; Jishen,9999,0,9999,0
1668407440404,CSE 293,041,119538,Zhou; Yuan-Yuan,9999,0,9999,0
1668407440404,CSE 293,042,119539,Gao; Sicun,9999,0,9999,0
1668407440404,CSE 293,043,119540,Weibel; Nadir,9999,0,9999,0
1668407440404,CSE 293,044,119541,Gupta; Rajesh K.,9999,0,9999,0
1668407440404,CSE 293,045,126410,Vaccaro; Kristen Marie,9999,0,9999,0
1668407440404,CSE 293,046,126411,Klemke; Richard,9999,0,9999,0
1668407440827,CSE 294,A00,102459,Voelker; Geoffrey M.,0,0,0,0
1668407440827,CSE 294,B00,111322,Orailoglu; Alex,0,0,0,0
1668407441253,DSE 201,A00,096914,Deutsch; Alin Bernard,30,0,30,0
1668407441687,DSE 210,A00,096915,Dasgupta; Sanjoy,30,0,30,0
1668407442118,DSE 260A,A00,096916,Altintas De Callaf; Ilkay,30,0,30,0
1668407442553,ECE 200,001,103586,Antipa; Nicholas A,9999,0,9999,0
1668407442553,ECE 200,002,103587,Atanasov; Nikolay A.,9999,0,9999,0
1668407442553,ECE 200,003,103588,Bharadia; Dinesh,9999,0,9999,0
1668407442553,ECE 200,004,103589,Cheng; Chung Kuan,9999,0,9999,0
1668407442553,ECE 200,005,103590,Cosman; Pamela C.,9999,0,9999,0
1668407442553,ECE 200,006,103591,Dayeh; Shadi Ahmad,9999,0,9999,0
1668407442553,ECE 200,007,103592,Fainman; Yeshaiahu,9999,0,9999,0
1668407442553,ECE 200,008,103593,Ford; Joseph Earl,9999,0,9999,0
1668407442553,ECE 200,009,103594,Franceschetti; Massimo,9999,0,9999,0
1668407442553,ECE 200,010,103595,Fullerton; Eric E,9999,0,9999,0
1668407442553,ECE 200,011,103596,Galton; Ian A,9999,0,9999,0
1668407442553,ECE 200,012,103597,Gilja; Vikash,9999,0,9999,0
1668407442553,ECE 200,013,103598,Hall; Drew A.,9999,0,9999,0
1668407442553,ECE 200,014,103599,Hsueh; Tzu-Chien,9999,0,9999,0
1668407442553,ECE 200,015,103600,Javidi; Tara,9999,0,9999,0
1668407442553,ECE 200,016,103601,Kahng; Andrew Byun,9999,0,9999,0
1668407442553,ECE 200,017,103602,Kim; Young-Han,9999,0,9999,0
1668407442553,ECE 200,018,103603,Koushanfar; Farinaz,9999,0,9999,0
1668407442553,ECE 200,019,103604,Kuzum; Duygu,9999,0,9999,0
1668407442553,ECE 200,020,103605,Le; Hanh-Phuc,9999,0,9999,0
1668407442553,ECE 200,021,103606,Lin; Bill,9999,0,9999,0
1668407442553,ECE 200,022,103607,Liu; Zhaowei,9998,0,9999,1
1668407442553,ECE 200,023,103608,Lo; Yu-Hwa,9999,0,9999,0
1668407442553,ECE 200,024,103609,Lomakin; Vitaliy,9999,0,9999,0
1668407442553,ECE 200,025,103610,Mercier; Patrick Philip,9999,0,9999,0
1668407442553,ECE 200,026,103611,Meyer; Florian,9999,0,9999,0
1668407442553,ECE 200,027,103612,Milstein; Laurence B.,9999,0,9999,0
1668407442553,ECE 200,028,103613,Mir Arabbaygi; Siavash,9999,0,9999,0
1668407442553,ECE 200,029,103614,Mookherjea; Shayan,9999,0,9999,0
1668407442553,ECE 200,030,103615,Morris; Karcher William,9999,0,9999,0
1668407442553,ECE 200,031,103616,Ng; Tse Nga,9999,0,9999,0
1668407442553,ECE 200,032,103617,Nguyen; Truong Quang,9999,0,9999,0
1668407442553,ECE 200,033,103618,Nomura; Kenji,9999,0,9999,0
1668407442553,ECE 200,034,103619,Orlitsky; Alon,9999,0,9999,0
1668407442553,ECE 200,035,103620,Pal; Piya,9999,0,9999,0
1668407442553,ECE 200,036,103621,Papen; George C.,9999,0,9999,0
1668407442553,ECE 200,037,103622,Radic; Stojan,9999,0,9999,0
1668407442553,ECE 200,038,103623,Rao; Bhaskar D.,9999,0,9999,0
1668407442553,ECE 200,039,103624,Rao; Ramesh R,9999,0,9999,0
1668407442553,ECE 200,040,103625,Rebeiz; Gabriel,9999,0,9999,0
1668407442553,ECE 200,041,103626,Sanford; John R,9999,0,9999,0
1668407442553,ECE 200,042,103627,Siegel; Paul H.,9999,0,9999,0
1668407442553,ECE 200,043,103628,Sievenpiper; Daniel F.,9999,0,9999,0
1668407442553,ECE 200,044,103629,Sworder; David D.,9999,0,9999,0
1668407442553,ECE 200,045,103630,Taur; Yuan,9999,0,9999,0
1668407442553,ECE 200,046,103631,Touri; Behrouz,9999,0,9999,0
1668407442553,ECE 200,047,103632,Trivedi; Mohan M.,9999,0,9999,0
1668407442553,ECE 200,048,103633,Vasconcelos; Nuno,9999,0,9999,0
1668407442553,ECE 200,049,103634,Wang; Xiaolong,9999,0,9999,0
1668407442553,ECE 200,050,103635,Xie; Pengtao,9999,0,9999,0
1668407442553,ECE 200,051,103636,Yip; Michael,9999,0,9999,0
1668407442553,ECE 200,052,103637,Zeger; Kenneth A.,999,0,999,0
1668407442553,ECE 200,053,103638,Zhang; Xinyu,9999,0,9999,0
1668407442553,ECE 200,054,103639,Turakhia; Yatish Girish,9999,0,9999,0
1668407442553,ECE 200,055,103640,Kang; Mingu,9999,0,9999,0
1668407442553,ECE 200,056,103641,Shi; Yuanyuan,9999,0,9999,0
1668407442553,ECE 200,057,103642,Wang; Edward Jay,9999,0,9999,0
1668407442553,ECE 200,058,103643,Zheng; Yang,9999,0,9999,0
1668407442980,ECE 202,A00,103644,Kuzum; Duygu,0,0,0,0
1668407443405,ECE 212BN,A00,103646,Ng; Tse Nga,0,0,0,0
1668407443830,ECE 221,A00,111493,Staff,0,0,0,0
1668407444258,ECE 222B,A00,103647,Lomakin; Vitaliy,0,0,0,0
1668407444681,ECE 230B,A00,103648,Taur; Yuan,0,0,0,0
1668407445103,ECE 238B,A00,103649,Garay; Javier,0,0,0,0
1668407445527,ECE 240B,A00,112900,Fainman; Yeshaiahu,0,0,0,0
1668407445949,ECE 247A,A00,103650,Jokerst; Jesse Vincent,0,0,0,0
1668407446376,ECE 247B,A00,103651,Wang; Joseph,0,0,0,0
1668407446907,ECE 250,A00,103652,Siegel; Paul H.,0,0,0,0
1668407447332,ECE 251A,A00,103654,Rao; Bhaskar D.,0,0,0,0
1668407447758,ECE 257B,A00,103655,Bharadia; Dinesh,0,0,0,0
1668407448181,ECE 258A,A00,103656,Milstein; Laurence B.,0,0,0,0
1668407448603,ECE 260B,A00,103658,Kang; Mingu,0,0,0,0
1668407449027,ECE 264A,A00,103659,Galton; Ian A,0,0,0,0
1668407449461,ECE 265A,A00,103661,Gudem; Prasad S.S.,0,0,0,0
1668407449884,ECE 265D,A00,103662,Gudem; Prasad S.S.,0,0,0,0
1668407450310,ECE 268,A00,103663,Koushanfar; Farinaz,0,0,0,0
1668407450734,ECE 269,A01,103665,Pal; Piya,0,0,0,0
1668407451158,ECE 271B,A00,103666,Vasconcelos; Manuela,0,0,0,0
1668407451585,ECE 276A,A00,103667,Atanasov; Nikolay A.,0,0,0,0
1668407452010,ECE 277,A00,103668,An; Cheolhong,0,0,0,0
1668407452436,ECE 279,A00,117947,Hall; Drew A.,0,0,0,0
1668407453291,ECE 283,A00,103670,Hsueh; Tzu-Chien,0,0,0,0
1668407453717,ECE 284,A00,103671,Turakhia; Yatish Girish,0,0,0,0
1668407454141,ECE 285,A00,103672,Zheng; Yang,0,0,0,0
1668407454141,ECE 285,B00,103673,Sworder; David D.,0,0,0,0
1668407454565,ECE 287,A00,103676,Javidi; Tara,0,0,0,0
1668407454990,MATH 200B,A00,098023,Salehi Golsefidy; Alireza,12,0,15,3
1668407455415,MATH 202B,A00,098024,Rhoades; Brendon Patrick,9,0,15,6
1668407455842,MATH 203B,A00,098025,Oprea; Dragos N.,10,0,15,5
1668407456268,MATH 204B,A00,098026,Sorensen; Claus M,13,0,15,2
1668407456693,MATH 208,A00,098027,Izadi; Elham,7,0,10,3
1668407457115,MATH 209,A00,098028,Pollack; Aaron,10,0,10,0
1668407457539,MATH 211A,A00,112919,Rogalski; Daniel,9,0,10,1
1668407457964,MATH 211B,A00,112920,Seward; Brandon M.,9,0,10,1
1668407458388,MATH 218,A00,098029,Li; Bo,10,0,10,0
1668407458815,MATH 220B,A00,098030,Novak; Jonathan I,11,0,15,4
1668407459247,MATH 221A,A00,098031,Ebenfelt; Peter F,13,0,15,2
1668407459670,MATH 231B,A00,098032,Zlatos; Andrej,12,0,15,3
1668407460094,MATH 240B,A00,098033,Ni; Lei,9,0,15,6
1668407460526,MATH 243,A00,098034,Jekel; David Andrew,10,0,10,0
1668407460950,MATH 245A,A00,098035,Nie; Jiawang,0,0,15,16
1668407461375,MATH 248,A00,098036,Bejenaru; Ioan,10,0,10,0
1668407461806,MATH 250B,A00,098037,Spolaor; Luca,14,0,15,1
1668407462232,MATH 258,A00,098038,Ni; Lei,10,0,10,0
1668407462656,MATH 264B,A00,098041,Rhoades; Brendon Patrick,9,0,15,6
1668407463080,MATH 268,A00,098042,Buss; Samuel R,10,0,10,0
1668407463504,MATH 269,A00,098043,Rhoades; Brendon Patrick,10,0,10,0
1668407463932,MATH 270B,A00,098044,Li; Bo,10,0,15,5
1668407464360,MATH 272B,A00,098045,Holst; Michael J,13,0,15,2
1668407464781,MATH 273A,A00,098046,Tian; Xiaochuan,10,0,15,5
1668407465206,MATH 275,A01,098048,Tian; Xiaochuan,6,0,10,4
1668407465632,MATH 278A,A00,098049,Holst; Michael J,8,0,10,2
1668407466056,MATH 278B,A00,098050,Cloninger; Alexander,10,0,10,0
1668407466482,MATH 278C,A00,098051,Nie; Jiawang,6,0,10,4
1668407466903,MATH 280B,A00,098052,Zheng; Tianyi,8,0,15,7
1668407467327,MATH 281B,A00,098053,Bradic; Jelena,0,0,15,15
1668407467760,MATH 282B,A00,098054,Arias-Castro; Ery,0,0,15,15
1668407468188,MATH 285,A00,098055,Fitzsimmons; Patrick J,0,0,15,17
1668407468610,MATH 287B,A00,098056,Arias-Castro; Ery,2,0,15,13
1668407469036,MATH 288,A00,098057,Agarwal; Pooja,9,0,10,1
1668407469036,MATH 288,B00,098058,Zhang; Danna,8,0,10,2
1668407469036,MATH 288,C00,098059,Williams; Ruth J,9,0,10,1
1668407469460,MATH 290B,A00,098060,Roberts; Justin Deritter,13,0,15,2
1668407469885,MATH 292,A00,098061,Belmont; Eva Kinoshita,10,0,10,0
1668407470309,MATH 295,A00,098062,Suk; Andrew Hoon,48,0,50,2
1668407470732,MATH 296,A00,098063,Novak; Jonathan I,20,0,20,0
1668407471165,MATH 297,001,098064,Gamst; Anthony Collins,9997,0,9999,2
1668407971334,COGS 205,A00,101395,Chiba; Andrea,19,0,20,1
1668407971770,COGS 210B,001,101404,Greene; Deanna Jacquelyn,9998,0,9999,1
1668407971770,COGS 210B,002,101417,Xia; Haijun,9999,0,9999,0
1668407971770,COGS 210B,003,101422,Nitz; Douglas A.,9999,0,9999,0
1668407971770,COGS 210B,004,101423,Hollan; James D.,9998,0,9999,1
1668407971770,COGS 210B,005,101424,Deak; Gedeon O.,9998,0,9999,1
1668407971770,COGS 210B,006,101425,Rossano; Federico,9999,0,9999,0
1668407972194,COGS 211B,A00,101427,Coulson; Seana M,9996,0,9999,3
1668407972616,COGS 220,A00,101428,Hollan; James D.,0,0,25,25
1668407973052,COGS 229,A00,101429,Dow; Steven P,18,0,25,7
1668407973477,COGS 230,A00,101430,Klemmer; Scott R,11,0,17,6
1668407973900,COGS 234,A00,101431,Xia; Haijun,1,0,25,24
1668407974326,COGS 260,A00,101432,Kiyonaga; Anastasia,21,0,25,4
1668407974326,COGS 260,B00,101433,Kirsh; David Joel,15,0,25,10
1668407974755,CSE 202,A00,102371,Impagliazzo; Russell,0,0,0,0
1668407975179,CSE 203B,A01,102373,Cheng; Chung Kuan,0,0,0,0
1668407975602,CSE 208,A00,102374,Micciancio; Daniele,0,0,0,0
1668407976028,CSE 209A,A00,112895,Impagliazzo; Russell,0,0,15,15
1668407976462,CSE 209B,A00,108005,Bellare; Mihir,0,0,0,0
1668407976885,CSE 210,A00,113163,Coblenz; Michael J,0,0,0,0
1668407977308,CSE 219,A00,106111,Dow; Steven P,0,0,20,20
1668407977732,CSE 221,A00,102376,Voelker; Geoffrey M.,0,0,0,0
1668407978165,CSE 224,A01,102378,Porter; George M,0,0,0,0
1668407978591,CSE 229A,A00,102379,Savage; Stefan,0,0,0,0
1668407979015,CSE 229C,A00,102380,Munyaka; Imani N. S.,0,0,0,0
1668407979453,CSE 232B,A00,102382,Deutsch; Alin Bernard,0,0,0,0
1668407979889,CSE 234,A01,112904,Kumar; Arun Kumar,0,0,0,0
1668407980326,CSE 237A,A00,102383,Rosing; Tajana Simunic,0,0,0,0
1668407980758,CSE 239A,A00,102384,Deutsch; Alin Bernard,0,0,0,0
1668407981190,CSE 239B,A00,102385,Polikarpova; Nadezhda,0,0,0,0
1668407981615,CSE 240A,A00,102386,Pannuto; Patrick William,0,0,0,0
1668407982042,CSE 240B,A00,102387,Zhao; Jishen,0,0,0,0
1668407982476,CSE 241A,A00,106406,Kang; Mingu,0,0,0,0
1668407982900,CSE 249B,A00,102388,Kahng; Andrew Byun,0,0,8,8
1668407983322,CSE 251B,A01,102392,Cottrell; Garrison W,0,0,0,0
1668407983322,CSE 251B,A02,102393,Cottrell; Garrison W,0,0,0,0
1668407983748,CSE 252B,A00,102394,Ochoa; Benjamin Lawrence,0,0,0,0
1668407984172,CSE 257,A01,102396,Gao; Sicun,0,0,0,0
1668407984596,CSE 272,A00,102397,Li; Tzumao,0,0,0,0
1668407985019,CSE 274,A00,111323,Chern; Albert Ren-Haur,0,0,0,0
1668407985442,CSE 282,A00,102398,Pevzner; Pavel Arkadjevich,0,0,0,0
1668407985868,CSE 284,A00,114175,Gymrek; Melissa Ann,0,0,0,0
1668407986293,CSE 290,A00,102399,Chandraker; Manmohan Krishna,0,0,0,0
1668407986293,CSE 290,B00,102400,Vaccaro; Kristen Marie,0,0,25,25
1668407986293,CSE 290,C00,102414,Pannuto; Patrick William,0,0,25,25
1668407986293,CSE 290,D00,102427,Pevzner; Pavel Arkadjevich,0,0,0,0
1668407986293,CSE 290,E00,102429,Zhao; Jishen,0,0,0,0
1668407986293,CSE 290,F00,102436,Tullsen; Dean Michael,0,0,0,0
1668407986293,CSE 290,G00,102440,Christensen; Henrik I,0,0,20,20
1668407986718,CSE 291,A00,102443,Su; Hao,0,0,0,0
1668407986718,CSE 291,B00,102448,Polikarpova; Nadezhda,0,0,0,0
1668407986718,CSE 291,C00,102453,Vaccaro; Kristen Marie,0,0,0,0
1668407986718,CSE 291,D00,111343,Savage; Stefan,0,0,0,0
1668407986718,CSE 291,E00,116474,Claffy; Kimberly Claire,0,0,0,0
1668407986718,CSE 291,F00,116479,Pasquale; Joseph,0,0,0,0
1668407987144,CSE 293,001,119111,Bafna; Vineet,9999,0,9999,0
1668407987144,CSE 293,002,119118,Bellare; Mihir,9999,0,9999,0
1668407987144,CSE 293,003,119122,Berg-Kirkpatrick; Taylor D,9999,0,9999,0
1668407987144,CSE 293,004,119135,Christensen; Henrik I,9999,0,9999,0
1668407987144,CSE 293,005,119142,Cottrell; Garrison W,9999,0,9999,0
1668407987144,CSE 293,006,119146,Deutsch; Alin Bernard,9999,0,9999,0
1668407987144,CSE 293,007,119159,Esmaeilzadeh; Hadi,9999,0,9999,0
1668407987144,CSE 293,008,119166,Freund; Yoav,9999,0,9999,0
1668407987144,CSE 293,009,119170,Griswold; William G.,9999,0,9999,0
1668407987144,CSE 293,010,119183,Gymrek; Melissa Ann,9999,0,9999,0
1668407987144,CSE 293,011,119190,Heninger; Nadia A,9999,0,9999,0
1668407987144,CSE 293,012,119230,Impagliazzo; Russell,9999,0,9999,0
1668407987144,CSE 293,013,119232,Jhala; Ranjit,9999,0,9999,0
1668407987144,CSE 293,014,119233,Kahng; Andrew Byun,9999,0,9999,0
1668407987144,CSE 293,015,119298,Kane; Daniel Mertz,9999,0,9999,0
1668407987144,CSE 293,016,119299,Kriegman; David J,9999,0,9999,0
1668407987144,CSE 293,017,119300,Kumar; Arun Kumar,9999,0,9999,0
1668407987144,CSE 293,018,119301,Lerner; Sorin,9999,0,9999,0
1668407987144,CSE 293,019,119302,Lovett; Shachar,9999,0,9999,0
1668407987144,CSE 293,020,119303,McAuley; Julian John,9999,0,9999,0
1668407987144,CSE 293,021,119304,Micciancio; Daniele,9999,0,9999,0
1668407987144,CSE 293,022,119367,Orailoglu; Alex,9999,0,9999,0
1668407987144,CSE 293,023,119382,Paturi; Ramamohan,9999,0,9999,0
1668407987144,CSE 293,024,119404,Polikarpova; Nadezhda,9999,0,9999,0
1668407987144,CSE 293,025,119406,Politz; Joseph Gibbs,9999,0,9999,0
1668407987144,CSE 293,026,119411,Porter; George M,9999,0,9999,0
1668407987144,CSE 293,027,119414,Porter; Leonard Emerson,9999,0,9999,0
1668407987144,CSE 293,028,119416,Ramamoorthi; Ravi,9999,0,9999,0
1668407987144,CSE 293,029,119417,Sahoo; Debashis,9999,0,9999,0
1668407987144,CSE 293,030,119420,Saul; Lawrence,9999,0,9999,0
1668407987144,CSE 293,031,119421,Savage; Stefan,9999,0,9999,0
1668407987144,CSE 293,032,119425,Schulze; Jurgen P.,9999,0,9999,0
1668407987144,CSE 293,033,119426,Snoeren; Alex C.,9999,0,9999,0
1668407987144,CSE 293,034,119428,Shang; Jingbo,9999,0,9999,0
1668407987144,CSE 293,035,119430,Stefan; Deian,9999,0,9999,0
1668407987144,CSE 293,036,119431,Su; Hao,9999,0,9999,0
1668407987144,CSE 293,037,119433,Swanson; Steven James,9999,0,9999,0
1668407987144,CSE 293,038,119435,Tullsen; Dean Michael,9999,0,9999,0
1668407987144,CSE 293,039,119483,Voelker; Geoffrey M.,9999,0,9999,0
1668407987144,CSE 293,040,119537,Zhao; Jishen,9999,0,9999,0
1668407987144,CSE 293,041,119538,Zhou; Yuan-Yuan,9999,0,9999,0
1668407987144,CSE 293,042,119539,Gao; Sicun,9999,0,9999,0
1668407987144,CSE 293,043,119540,Weibel; Nadir,9999,0,9999,0
1668407987144,CSE 293,044,119541,Gupta; Rajesh K.,9999,0,9999,0
1668407987144,CSE 293,045,126410,Vaccaro; Kristen Marie,9999,0,9999,0
1668407987144,CSE 293,046,126411,Klemke; Richard,9999,0,9999,0
1668407987566,CSE 294,A00,102459,Voelker; Geoffrey M.,0,0,0,0
1668407987566,CSE 294,B00,111322,Orailoglu; Alex,0,0,0,0
1668407987992,DSE 201,A00,096914,Deutsch; Alin Bernard,30,0,30,0
1668407988416,DSE 210,A00,096915,Dasgupta; Sanjoy,30,0,30,0
1668407988840,DSE 260A,A00,096916,Altintas De Callaf; Ilkay,30,0,30,0
1668407989304,ECE 200,001,103586,Antipa; Nicholas A,9999,0,9999,0
1668407989304,ECE 200,002,103587,Atanasov; Nikolay A.,9999,0,9999,0
1668407989304,ECE 200,003,103588,Bharadia; Dinesh,9999,0,9999,0
1668407989304,ECE 200,004,103589,Cheng; Chung Kuan,9999,0,9999,0
1668407989304,ECE 200,005,103590,Cosman; Pamela C.,9999,0,9999,0
1668407989304,ECE 200,006,103591,Dayeh; Shadi Ahmad,9999,0,9999,0
1668407989304,ECE 200,007,103592,Fainman; Yeshaiahu,9999,0,9999,0
1668407989304,ECE 200,008,103593,Ford; Joseph Earl,9999,0,9999,0
1668407989304,ECE 200,009,103594,Franceschetti; Massimo,9999,0,9999,0
1668407989304,ECE 200,010,103595,Fullerton; Eric E,9999,0,9999,0
1668407989304,ECE 200,011,103596,Galton; Ian A,9999,0,9999,0
1668407989304,ECE 200,012,103597,Gilja; Vikash,9999,0,9999,0
1668407989304,ECE 200,013,103598,Hall; Drew A.,9999,0,9999,0
1668407989304,ECE 200,014,103599,Hsueh; Tzu-Chien,9999,0,9999,0
1668407989304,ECE 200,015,103600,Javidi; Tara,9999,0,9999,0
1668407989304,ECE 200,016,103601,Kahng; Andrew Byun,9999,0,9999,0
1668407989304,ECE 200,017,103602,Kim; Young-Han,9999,0,9999,0
1668407989304,ECE 200,018,103603,Koushanfar; Farinaz,9999,0,9999,0
1668407989304,ECE 200,019,103604,Kuzum; Duygu,9999,0,9999,0
1668407989304,ECE 200,020,103605,Le; Hanh-Phuc,9999,0,9999,0
1668407989304,ECE 200,021,103606,Lin; Bill,9999,0,9999,0
1668407989304,ECE 200,022,103607,Liu; Zhaowei,9998,0,9999,1
1668407989304,ECE 200,023,103608,Lo; Yu-Hwa,9999,0,9999,0
1668407989304,ECE 200,024,103609,Lomakin; Vitaliy,9999,0,9999,0
1668407989304,ECE 200,025,103610,Mercier; Patrick Philip,9999,0,9999,0
1668407989304,ECE 200,026,103611,Meyer; Florian,9999,0,9999,0
1668407989304,ECE 200,027,103612,Milstein; Laurence B.,9999,0,9999,0
1668407989304,ECE 200,028,103613,Mir Arabbaygi; Siavash,9999,0,9999,0
1668407989304,ECE 200,029,103614,Mookherjea; Shayan,9999,0,9999,0
1668407989304,ECE 200,030,103615,Morris; Karcher William,9999,0,9999,0
1668407989304,ECE 200,031,103616,Ng; Tse Nga,9999,0,9999,0
1668407989304,ECE 200,032,103617,Nguyen; Truong Quang,9999,0,9999,0
1668407989304,ECE 200,033,103618,Nomura; Kenji,9999,0,9999,0
1668407989304,ECE 200,034,103619,Orlitsky; Alon,9999,0,9999,0
1668407989304,ECE 200,035,103620,Pal; Piya,9999,0,9999,0
1668407989304,ECE 200,036,103621,Papen; George C.,9999,0,9999,0
1668407989304,ECE 200,037,103622,Radic; Stojan,9999,0,9999,0
1668407989304,ECE 200,038,103623,Rao; Bhaskar D.,9999,0,9999,0
1668407989304,ECE 200,039,103624,Rao; Ramesh R,9999,0,9999,0
1668407989304,ECE 200,040,103625,Rebeiz; Gabriel,9999,0,9999,0
1668407989304,ECE 200,041,103626,Sanford; John R,9999,0,9999,0
1668407989304,ECE 200,042,103627,Siegel; Paul H.,9999,0,9999,0
1668407989304,ECE 200,043,103628,Sievenpiper; Daniel F.,9999,0,9999,0
1668407989304,ECE 200,044,103629,Sworder; David D.,9999,0,9999,0
1668407989304,ECE 200,045,103630,Taur; Yuan,9999,0,9999,0
1668407989304,ECE 200,046,103631,Touri; Behrouz,9999,0,9999,0
1668407989304,ECE 200,047,103632,Trivedi; Mohan M.,9999,0,9999,0
1668407989304,ECE 200,048,103633,Vasconcelos; Nuno,9999,0,9999,0
1668407989304,ECE 200,049,103634,Wang; Xiaolong,9999,0,9999,0
1668407989304,ECE 200,050,103635,Xie; Pengtao,9999,0,9999,0
1668407989304,ECE 200,051,103636,Yip; Michael,9999,0,9999,0
1668407989304,ECE 200,052,103637,Zeger; Kenneth A.,999,0,999,0
1668407989304,ECE 200,053,103638,Zhang; Xinyu,9999,0,9999,0
1668407989304,ECE 200,054,103639,Turakhia; Yatish Girish,9999,0,9999,0
1668407989304,ECE 200,055,103640,Kang; Mingu,9999,0,9999,0
1668407989304,ECE 200,056,103641,Shi; Yuanyuan,9999,0,9999,0
1668407989304,ECE 200,057,103642,Wang; Edward Jay,9999,0,9999,0
1668407989304,ECE 200,058,103643,Zheng; Yang,9999,0,9999,0
1668407989733,ECE 202,A00,103644,Kuzum; Duygu,0,0,0,0
1668407990161,ECE 212BN,A00,103646,Ng; Tse Nga,0,0,0,0
1668407990584,ECE 221,A00,111493,Staff,0,0,0,0
1668407991006,ECE 222B,A00,103647,Lomakin; Vitaliy,0,0,0,0
1668407991431,ECE 230B,A00,103648,Taur; Yuan,0,0,0,0
1668407991867,ECE 238B,A00,103649,Garay; Javier,0,0,0,0
1668407992290,ECE 240B,A00,112900,Fainman; Yeshaiahu,0,0,0,0
1668407992717,ECE 247A,A00,103650,Jokerst; Jesse Vincent,0,0,0,0
1668407993147,ECE 247B,A00,103651,Wang; Joseph,0,0,0,0
1668407993571,ECE 250,A00,103652,Siegel; Paul H.,0,0,0,0
1668407993999,ECE 251A,A00,103654,Rao; Bhaskar D.,0,0,0,0
1668407994421,ECE 257B,A00,103655,Bharadia; Dinesh,0,0,0,0
1668407994847,ECE 258A,A00,103656,Milstein; Laurence B.,0,0,0,0
1668407995273,ECE 260B,A00,103658,Kang; Mingu,0,0,0,0
1668407995698,ECE 264A,A00,103659,Galton; Ian A,0,0,0,0
1668407996122,ECE 265A,A00,103661,Gudem; Prasad S.S.,0,0,0,0
1668407996546,ECE 265D,A00,103662,Gudem; Prasad S.S.,0,0,0,0
1668407996973,ECE 268,A00,103663,Koushanfar; Farinaz,0,0,0,0
1668407997395,ECE 269,A01,103665,Pal; Piya,0,0,0,0
1668407997828,ECE 271B,A00,103666,Vasconcelos; Manuela,0,0,0,0
1668407998267,ECE 276A,A00,103667,Atanasov; Nikolay A.,0,0,0,0
1668407998691,ECE 277,A00,103668,An; Cheolhong,0,0,0,0
1668407999120,ECE 279,A00,117947,Hall; Drew A.,0,0,0,0
1668407999981,ECE 283,A00,103670,Hsueh; Tzu-Chien,0,0,0,0
1668408000419,ECE 284,A00,103671,Turakhia; Yatish Girish,0,0,0,0
1668408000841,ECE 285,A00,103672,Zheng; Yang,0,0,0,0
1668408000841,ECE 285,B00,103673,Sworder; David D.,0,0,0,0
1668408001266,ECE 287,A00,103676,Javidi; Tara,0,0,0,0
1668408001705,MATH 200B,A00,098023,Salehi Golsefidy; Alireza,12,0,15,3
1668408002145,MATH 202B,A00,098024,Rhoades; Brendon Patrick,9,0,15,6
1668408002665,MATH 203B,A00,098025,Oprea; Dragos N.,10,0,15,5
1668408003087,MATH 204B,A00,098026,Sorensen; Claus M,13,0,15,2
1668408003509,MATH 208,A00,098027,Izadi; Elham,7,0,10,3
1668408003933,MATH 209,A00,098028,Pollack; Aaron,10,0,10,0
1668408004365,MATH 211A,A00,112919,Rogalski; Daniel,9,0,10,1
1668408004789,MATH 211B,A00,112920,Seward; Brandon M.,9,0,10,1
1668408005214,MATH 218,A00,098029,Li; Bo,10,0,10,0
1668408005644,MATH 220B,A00,098030,Novak; Jonathan I,11,0,15,4
1668408006071,MATH 221A,A00,098031,Ebenfelt; Peter F,13,0,15,2
1668408006495,MATH 231B,A00,098032,Zlatos; Andrej,12,0,15,3
1668408006919,MATH 240B,A00,098033,Ni; Lei,9,0,15,6
1668408007340,MATH 243,A00,098034,Jekel; David Andrew,10,0,10,0
1668408007767,MATH 245A,A00,098035,Nie; Jiawang,0,0,15,16
1668408008190,MATH 248,A00,098036,Bejenaru; Ioan,10,0,10,0
1668408008616,MATH 250B,A00,098037,Spolaor; Luca,14,0,15,1
1668408009047,MATH 258,A00,098038,Ni; Lei,10,0,10,0
1668408009474,MATH 264B,A00,098041,Rhoades; Brendon Patrick,9,0,15,6
1668408009897,MATH 268,A00,098042,Buss; Samuel R,10,0,10,0
1668408010320,MATH 269,A00,098043,Rhoades; Brendon Patrick,10,0,10,0
1668408010745,MATH 270B,A00,098044,Li; Bo,10,0,15,5
1668408011175,MATH 272B,A00,098045,Holst; Michael J,13,0,15,2
1668408011599,MATH 273A,A00,098046,Tian; Xiaochuan,10,0,15,5
1668408012027,MATH 275,A01,098048,Tian; Xiaochuan,6,0,10,4
1668408012459,MATH 278A,A00,098049,Holst; Michael J,8,0,10,2
1668408012893,MATH 278B,A00,098050,Cloninger; Alexander,10,0,10,0
1668408013320,MATH 278C,A00,098051,Nie; Jiawang,6,0,10,4
1668408013742,MATH 280B,A00,098052,Zheng; Tianyi,8,0,15,7
1668408014165,MATH 281B,A00,098053,Bradic; Jelena,0,0,15,15
1668408014588,MATH 282B,A00,098054,Arias-Castro; Ery,0,0,15,15
1668408015014,MATH 285,A00,098055,Fitzsimmons; Patrick J,0,0,15,17
1668408015438,MATH 287B,A00,098056,Arias-Castro; Ery,2,0,15,13
1668408015863,MATH 288,A00,098057,Agarwal; Pooja,9,0,10,1
1668408015863,MATH 288,B00,098058,Zhang; Danna,8,0,10,2
1668408015863,MATH 288,C00,098059,Williams; Ruth J,9,0,10,1
1668408016287,MATH 290B,A00,098060,Roberts; Justin Deritter,13,0,15,2
1668408016714,MATH 292,A00,098061,Belmont; Eva Kinoshita,10,0,10,0
1668408017139,MATH 295,A00,098062,Suk; Andrew Hoon,48,0,50,2
1668408017563,MATH 296,A00,098063,Novak; Jonathan I,20,0,20,0
1668408017989,MATH 297,001,098064,Gamst; Anthony Collins,9997,0,9999,2
1668408517852,COGS 205,A00,101395,Chiba; Andrea,19,0,20,1
1668408518280,COGS 210B,001,101404,Greene; Deanna Jacquelyn,9998,0,9999,1
1668408518280,COGS 210B,002,101417,Xia; Haijun,9999,0,9999,0
1668408518280,COGS 210B,003,101422,Nitz; Douglas A.,9999,0,9999,0
1668408518280,COGS 210B,004,101423,Hollan; James D.,9998,0,9999,1
1668408518280,COGS 210B,005,101424,Deak; Gedeon O.,9998,0,9999,1
1668408518280,COGS 210B,006,101425,Rossano; Federico,9999,0,9999,0
1668408518707,COGS 211B,A00,101427,Coulson; Seana M,9996,0,9999,3
1668408519143,COGS 220,A00,101428,Hollan; James D.,0,0,25,25
1668408519580,COGS 229,A00,101429,Dow; Steven P,18,0,25,7
1668408520011,COGS 230,A00,101430,Klemmer; Scott R,11,0,17,6
1668408520447,COGS 234,A00,101431,Xia; Haijun,1,0,25,24
1668408520873,COGS 260,A00,101432,Kiyonaga; Anastasia,21,0,25,4
1668408520873,COGS 260,B00,101433,Kirsh; David Joel,15,0,25,10
1668408521298,CSE 202,A00,102371,Impagliazzo; Russell,0,0,0,0
1668408521727,CSE 203B,A01,102373,Cheng; Chung Kuan,0,0,0,0
1668408522153,CSE 208,A00,102374,Micciancio; Daniele,0,0,0,0
1668408522678,CSE 209A,A00,112895,Impagliazzo; Russell,0,0,15,15
1668408523105,CSE 209B,A00,108005,Bellare; Mihir,0,0,0,0
1668408523528,CSE 210,A00,113163,Coblenz; Michael J,0,0,0,0
1668408523951,CSE 219,A00,106111,Dow; Steven P,0,0,20,20
1668408524375,CSE 221,A00,102376,Voelker; Geoffrey M.,0,0,0,0
1668408524801,CSE 224,A01,102378,Porter; George M,0,0,0,0
1668408525224,CSE 229A,A00,102379,Savage; Stefan,0,0,0,0
1668408525649,CSE 229C,A00,102380,Munyaka; Imani N. S.,0,0,0,0
1668408526075,CSE 232B,A00,102382,Deutsch; Alin Bernard,0,0,0,0
1668408526502,CSE 234,A01,112904,Kumar; Arun Kumar,0,0,0,0
1668408526925,CSE 237A,A00,102383,Rosing; Tajana Simunic,0,0,0,0
1668408527352,CSE 239A,A00,102384,Deutsch; Alin Bernard,0,0,0,0
1668408527775,CSE 239B,A00,102385,Polikarpova; Nadezhda,0,0,0,0
1668408528201,CSE 240A,A00,102386,Pannuto; Patrick William,0,0,0,0
1668408528625,CSE 240B,A00,102387,Zhao; Jishen,0,0,0,0
1668408529049,CSE 241A,A00,106406,Kang; Mingu,0,0,0,0
1668408529475,CSE 249B,A00,102388,Kahng; Andrew Byun,0,0,8,8
1668408529899,CSE 251B,A01,102392,Cottrell; Garrison W,0,0,0,0
1668408529899,CSE 251B,A02,102393,Cottrell; Garrison W,0,0,0,0
1668408530322,CSE 252B,A00,102394,Ochoa; Benjamin Lawrence,0,0,0,0
1668408530748,CSE 257,A01,102396,Gao; Sicun,0,0,0,0
1668408531178,CSE 272,A00,102397,Li; Tzumao,0,0,0,0
1668408531601,CSE 274,A00,111323,Chern; Albert Ren-Haur,0,0,0,0
1668408532029,CSE 282,A00,102398,Pevzner; Pavel Arkadjevich,0,0,0,0
1668408532455,CSE 284,A00,114175,Gymrek; Melissa Ann,0,0,0,0
1668408532878,CSE 290,A00,102399,Chandraker; Manmohan Krishna,0,0,0,0
1668408532878,CSE 290,B00,102400,Vaccaro; Kristen Marie,0,0,25,25
1668408532878,CSE 290,C00,102414,Pannuto; Patrick William,0,0,25,25
1668408532878,CSE 290,D00,102427,Pevzner; Pavel Arkadjevich,0,0,0,0
1668408532878,CSE 290,E00,102429,Zhao; Jishen,0,0,0,0
1668408532878,CSE 290,F00,102436,Tullsen; Dean Michael,0,0,0,0
1668408532878,CSE 290,G00,102440,Christensen; Henrik I,0,0,20,20
1668408533303,CSE 291,A00,102443,Su; Hao,0,0,0,0
1668408533303,CSE 291,B00,102448,Polikarpova; Nadezhda,0,0,0,0
1668408533303,CSE 291,C00,102453,Vaccaro; Kristen Marie,0,0,0,0
1668408533303,CSE 291,D00,111343,Savage; Stefan,0,0,0,0
1668408533303,CSE 291,E00,116474,Claffy; Kimberly Claire,0,0,0,0
1668408533303,CSE 291,F00,116479,Pasquale; Joseph,0,0,0,0
1668408533736,CSE 293,001,119111,Bafna; Vineet,9999,0,9999,0
1668408533736,CSE 293,002,119118,Bellare; Mihir,9999,0,9999,0
1668408533736,CSE 293,003,119122,Berg-Kirkpatrick; Taylor D,9999,0,9999,0
1668408533736,CSE 293,004,119135,Christensen; Henrik I,9999,0,9999,0
1668408533736,CSE 293,005,119142,Cottrell; Garrison W,9999,0,9999,0
1668408533736,CSE 293,006,119146,Deutsch; Alin Bernard,9999,0,9999,0
1668408533736,CSE 293,007,119159,Esmaeilzadeh; Hadi,9999,0,9999,0
1668408533736,CSE 293,008,119166,Freund; Yoav,9999,0,9999,0
1668408533736,CSE 293,009,119170,Griswold; William G.,9999,0,9999,0
1668408533736,CSE 293,010,119183,Gymrek; Melissa Ann,9999,0,9999,0
1668408533736,CSE 293,011,119190,Heninger; Nadia A,9999,0,9999,0
1668408533736,CSE 293,012,119230,Impagliazzo; Russell,9999,0,9999,0
1668408533736,CSE 293,013,119232,Jhala; Ranjit,9999,0,9999,0
1668408533736,CSE 293,014,119233,Kahng; Andrew Byun,9999,0,9999,0
1668408533736,CSE 293,015,119298,Kane; Daniel Mertz,9999,0,9999,0
1668408533736,CSE 293,016,119299,Kriegman; David J,9999,0,9999,0
1668408533736,CSE 293,017,119300,Kumar; Arun Kumar,9999,0,9999,0
1668408533736,CSE 293,018,119301,Lerner; Sorin,9999,0,9999,0
1668408533736,CSE 293,019,119302,Lovett; Shachar,9999,0,9999,0
1668408533736,CSE 293,020,119303,McAuley; Julian John,9999,0,9999,0
1668408533736,CSE 293,021,119304,Micciancio; Daniele,9999,0,9999,0
1668408533736,CSE 293,022,119367,Orailoglu; Alex,9999,0,9999,0
1668408533736,CSE 293,023,119382,Paturi; Ramamohan,9999,0,9999,0
1668408533736,CSE 293,024,119404,Polikarpova; Nadezhda,9999,0,9999,0
1668408533736,CSE 293,025,119406,Politz; Joseph Gibbs,9999,0,9999,0
1668408533736,CSE 293,026,119411,Porter; George M,9999,0,9999,0
1668408533736,CSE 293,027,119414,Porter; Leonard Emerson,9999,0,9999,0
1668408533736,CSE 293,028,119416,Ramamoorthi; Ravi,9999,0,9999,0
1668408533736,CSE 293,029,119417,Sahoo; Debashis,9999,0,9999,0
1668408533736,CSE 293,030,119420,Saul; Lawrence,9999,0,9999,0
1668408533736,CSE 293,031,119421,Savage; Stefan,9999,0,9999,0
1668408533736,CSE 293,032,119425,Schulze; Jurgen P.,9999,0,9999,0
1668408533736,CSE 293,033,119426,Snoeren; Alex C.,9999,0,9999,0
1668408533736,CSE 293,034,119428,Shang; Jingbo,9999,0,9999,0
1668408533736,CSE 293,035,119430,Stefan; Deian,9999,0,9999,0
1668408533736,CSE 293,036,119431,Su; Hao,9999,0,9999,0
1668408533736,CSE 293,037,119433,Swanson; Steven James,9999,0,9999,0
1668408533736,CSE 293,038,119435,Tullsen; Dean Michael,9999,0,9999,0
1668408533736,CSE 293,039,119483,Voelker; Geoffrey M.,9999,0,9999,0
1668408533736,CSE 293,040,119537,Zhao; Jishen,9999,0,9999,0
1668408533736,CSE 293,041,119538,Zhou; Yuan-Yuan,9999,0,9999,0
1668408533736,CSE 293,042,119539,Gao; Sicun,9999,0,9999,0
1668408533736,CSE 293,043,119540,Weibel; Nadir,9999,0,9999,0
1668408533736,CSE 293,044,119541,Gupta; Rajesh K.,9999,0,9999,0
1668408533736,CSE 293,045,126410,Vaccaro; Kristen Marie,9999,0,9999,0
1668408533736,CSE 293,046,126411,Klemke; Richard,9999,0,9999,0
1668408534161,CSE 294,A00,102459,Voelker; Geoffrey M.,0,0,0,0
1668408534161,CSE 294,B00,111322,Orailoglu; Alex,0,0,0,0
1668408534584,DSE 201,A00,096914,Deutsch; Alin Bernard,30,0,30,0
1668408535013,DSE 210,A00,096915,Dasgupta; Sanjoy,30,0,30,0
1668408535436,DSE 260A,A00,096916,Altintas De Callaf; Ilkay,30,0,30,0
1668408535866,ECE 200,001,103586,Antipa; Nicholas A,9999,0,9999,0
1668408535866,ECE 200,002,103587,Atanasov; Nikolay A.,9999,0,9999,0
1668408535866,ECE 200,003,103588,Bharadia; Dinesh,9999,0,9999,0
1668408535866,ECE 200,004,103589,Cheng; Chung Kuan,9999,0,9999,0
1668408535866,ECE 200,005,103590,Cosman; Pamela C.,9999,0,9999,0
1668408535866,ECE 200,006,103591,Dayeh; Shadi Ahmad,9999,0,9999,0
1668408535866,ECE 200,007,103592,Fainman; Yeshaiahu,9999,0,9999,0
1668408535866,ECE 200,008,103593,Ford; Joseph Earl,9999,0,9999,0
1668408535866,ECE 200,009,103594,Franceschetti; Massimo,9999,0,9999,0
1668408535866,ECE 200,010,103595,Fullerton; Eric E,9999,0,9999,0
1668408535866,ECE 200,011,103596,Galton; Ian A,9999,0,9999,0
1668408535866,ECE 200,012,103597,Gilja; Vikash,9999,0,9999,0
1668408535866,ECE 200,013,103598,Hall; Drew A.,9999,0,9999,0
1668408535866,ECE 200,014,103599,Hsueh; Tzu-Chien,9999,0,9999,0
1668408535866,ECE 200,015,103600,Javidi; Tara,9999,0,9999,0
1668408535866,ECE 200,016,103601,Kahng; Andrew Byun,9999,0,9999,0
1668408535866,ECE 200,017,103602,Kim; Young-Han,9999,0,9999,0
1668408535866,ECE 200,018,103603,Koushanfar; Farinaz,9999,0,9999,0
1668408535866,ECE 200,019,103604,Kuzum; Duygu,9999,0,9999,0
1668408535866,ECE 200,020,103605,Le; Hanh-Phuc,9999,0,9999,0
1668408535866,ECE 200,021,103606,Lin; Bill,9999,0,9999,0
1668408535866,ECE 200,022,103607,Liu; Zhaowei,9998,0,9999,1
1668408535866,ECE 200,023,103608,Lo; Yu-Hwa,9999,0,9999,0
1668408535866,ECE 200,024,103609,Lomakin; Vitaliy,9999,0,9999,0
1668408535866,ECE 200,025,103610,Mercier; Patrick Philip,9999,0,9999,0
1668408535866,ECE 200,026,103611,Meyer; Florian,9999,0,9999,0
1668408535866,ECE 200,027,103612,Milstein; Laurence B.,9999,0,9999,0
1668408535866,ECE 200,028,103613,Mir Arabbaygi; Siavash,9999,0,9999,0
1668408535866,ECE 200,029,103614,Mookherjea; Shayan,9999,0,9999,0
1668408535866,ECE 200,030,103615,Morris; Karcher William,9999,0,9999,0
1668408535866,ECE 200,031,103616,Ng; Tse Nga,9999,0,9999,0
1668408535866,ECE 200,032,103617,Nguyen; Truong Quang,9999,0,9999,0
1668408535866,ECE 200,033,103618,Nomura; Kenji,9999,0,9999,0
1668408535866,ECE 200,034,103619,Orlitsky; Alon,9999,0,9999,0
1668408535866,ECE 200,035,103620,Pal; Piya,9999,0,9999,0
1668408535866,ECE 200,036,103621,Papen; George C.,9999,0,9999,0
1668408535866,ECE 200,037,103622,Radic; Stojan,9999,0,9999,0
1668408535866,ECE 200,038,103623,Rao; Bhaskar D.,9999,0,9999,0
1668408535866,ECE 200,039,103624,Rao; Ramesh R,9999,0,9999,0
1668408535866,ECE 200,040,103625,Rebeiz; Gabriel,9999,0,9999,0
1668408535866,ECE 200,041,103626,Sanford; John R,9999,0,9999,0
1668408535866,ECE 200,042,103627,Siegel; Paul H.,9999,0,9999,0
1668408535866,ECE 200,043,103628,Sievenpiper; Daniel F.,9999,0,9999,0
1668408535866,ECE 200,044,103629,Sworder; David D.,9999,0,9999,0
1668408535866,ECE 200,045,103630,Taur; Yuan,9999,0,9999,0
1668408535866,ECE 200,046,103631,Touri; Behrouz,9999,0,9999,0
1668408535866,ECE 200,047,103632,Trivedi; Mohan M.,9999,0,9999,0
1668408535866,ECE 200,048,103633,Vasconcelos; Nuno,9999,0,9999,0
1668408535866,ECE 200,049,103634,Wang; Xiaolong,9999,0,9999,0
1668408535866,ECE 200,050,103635,Xie; Pengtao,9999,0,9999,0
1668408535866,ECE 200,051,103636,Yip; Michael,9999,0,9999,0
1668408535866,ECE 200,052,103637,Zeger; Kenneth A.,999,0,999,0
1668408535866,ECE 200,053,103638,Zhang; Xinyu,9999,0,9999,0
1668408535866,ECE 200,054,103639,Turakhia; Yatish Girish,9999,0,9999,0
1668408535866,ECE 200,055,103640,Kang; Mingu,9999,0,9999,0
1668408535866,ECE 200,056,103641,Shi; Yuanyuan,9999,0,9999,0
1668408535866,ECE 200,057,103642,Wang; Edward Jay,9999,0,9999,0
1668408535866,ECE 200,058,103643,Zheng; Yang,9999,0,9999,0
1668408536294,ECE 202,A00,103644,Kuzum; Duygu,0,0,0,0
1668408536719,ECE 212BN,A00,103646,Ng; Tse Nga,0,0,0,0
1668408537146,ECE 221,A00,111493,Staff,0,0,0,0
1668408537573,ECE 222B,A00,103647,Lomakin; Vitaliy,0,0,0,0
1668408537997,ECE 230B,A00,103648,Taur; Yuan,0,0,0,0
1668408538419,ECE 238B,A00,103649,Garay; Javier,0,0,0,0
1668408538844,ECE 240B,A00,112900,Fainman; Yeshaiahu,0,0,0,0
1668408539270,ECE 247A,A00,103650,Jokerst; Jesse Vincent,0,0,0,0
1668408539713,ECE 247B,A00,103651,Wang; Joseph,0,0,0,0
1668408540146,ECE 250,A00,103652,Siegel; Paul H.,0,0,0,0
1668408540572,ECE 251A,A00,103654,Rao; Bhaskar D.,0,0,0,0
1668408541004,ECE 257B,A00,103655,Bharadia; Dinesh,0,0,0,0
1668408541430,ECE 258A,A00,103656,Milstein; Laurence B.,0,0,0,0
1668408541854,ECE 260B,A00,103658,Kang; Mingu,0,0,0,0
1668408542281,ECE 264A,A00,103659,Galton; Ian A,0,0,0,0
1668408542705,ECE 265A,A00,103661,Gudem; Prasad S.S.,0,0,0,0
1668408543128,ECE 265D,A00,103662,Gudem; Prasad S.S.,0,0,0,0
1668408543552,ECE 268,A00,103663,Koushanfar; Farinaz,0,0,0,0
1668408543978,ECE 269,A01,103665,Pal; Piya,0,0,0,0
1668408544411,ECE 271B,A00,103666,Vasconcelos; Manuela,0,0,0,0
1668408544837,ECE 276A,A00,103667,Atanasov; Nikolay A.,0,0,0,0
1668408545259,ECE 277,A00,103668,An; Cheolhong,0,0,0,0
1668408545683,ECE 279,A00,117947,Hall; Drew A.,0,0,0,0
1668408546529,ECE 283,A00,103670,Hsueh; Tzu-Chien,0,0,0,0
1668408546957,ECE 284,A00,103671,Turakhia; Yatish Girish,0,0,0,0
1668408547381,ECE 285,A00,103672,Zheng; Yang,0,0,0,0
1668408547381,ECE 285,B00,103673,Sworder; David D.,0,0,0,0
1668408547809,ECE 287,A00,103676,Javidi; Tara,0,0,0,0
1668408548233,MATH 200B,A00,098023,Salehi Golsefidy; Alireza,12,0,15,3
1668408548660,MATH 202B,A00,098024,Rhoades; Brendon Patrick,9,0,15,6
1668408549086,MATH 203B,A00,098025,Oprea; Dragos N.,10,0,15,5
1668408549512,MATH 204B,A00,098026,Sorensen; Claus M,13,0,15,2
1668408549938,MATH 208,A00,098027,Izadi; Elham,7,0,10,3
1668408550369,MATH 209,A00,098028,Pollack; Aaron,10,0,10,0
1668408550791,MATH 211A,A00,112919,Rogalski; Daniel,9,0,10,1
1668408551227,MATH 211B,A00,112920,Seward; Brandon M.,9,0,10,1
1668408551651,MATH 218,A00,098029,Li; Bo,10,0,10,0
1668408552074,MATH 220B,A00,098030,Novak; Jonathan I,11,0,15,4
1668408552499,MATH 221A,A00,098031,Ebenfelt; Peter F,13,0,15,2
1668408552928,MATH 231B,A00,098032,Zlatos; Andrej,12,0,15,3
1668408553359,MATH 240B,A00,098033,Ni; Lei,9,0,15,6
1668408553789,MATH 243,A00,098034,Jekel; David Andrew,10,0,10,0
1668408554217,MATH 245A,A00,098035,Nie; Jiawang,0,0,15,16
1668408554647,MATH 248,A00,098036,Bejenaru; Ioan,10,0,10,0
1668408555073,MATH 250B,A00,098037,Spolaor; Luca,14,0,15,1
1668408555498,MATH 258,A00,098038,Ni; Lei,10,0,10,0
1668408555928,MATH 264B,A00,098041,Rhoades; Brendon Patrick,9,0,15,6
1668408556351,MATH 268,A00,098042,Buss; Samuel R,10,0,10,0
1668408556782,MATH 269,A00,098043,Rhoades; Brendon Patrick,10,0,10,0
1668408557206,MATH 270B,A00,098044,Li; Bo,10,0,15,5
1668408557629,MATH 272B,A00,098045,Holst; Michael J,13,0,15,2
1668408558056,MATH 273A,A00,098046,Tian; Xiaochuan,10,0,15,5
1668408558483,MATH 275,A01,098048,Tian; Xiaochuan,6,0,10,4
1668408558905,MATH 278A,A00,098049,Holst; Michael J,8,0,10,2
1668408559331,MATH 278B,A00,098050,Cloninger; Alexander,10,0,10,0
1668408559755,MATH 278C,A00,098051,Nie; Jiawang,6,0,10,4
1668408560178,MATH 280B,A00,098052,Zheng; Tianyi,8,0,15,7
1668408560599,MATH 281B,A00,098053,Bradic; Jelena,0,0,15,15
1668408561022,MATH 282B,A00,098054,Arias-Castro; Ery,0,0,15,15
1668408561453,MATH 285,A00,098055,Fitzsimmons; Patrick J,0,0,15,17
1668408561878,MATH 287B,A00,098056,Arias-Castro; Ery,2,0,15,13
1668408562302,MATH 288,A00,098057,Agarwal; Pooja,9,0,10,1
1668408562302,MATH 288,B00,098058,Zhang; Danna,8,0,10,2
1668408562302,MATH 288,C00,098059,Williams; Ruth J,9,0,10,1
1668408562726,MATH 290B,A00,098060,Roberts; Justin Deritter,13,0,15,2
1668408563153,MATH 292,A00,098061,Belmont; Eva Kinoshita,10,0,10,0
1668408563577,MATH 295,A00,098062,Suk; Andrew Hoon,48,0,50,2
1668408564001,MATH 296,A00,098063,Novak; Jonathan I,20,0,20,0
1668408564424,MATH 297,001,098064,Gamst; Anthony Collins,9997,0,9999,2
1668409064646,COGS 205,A00,101395,Chiba; Andrea,19,0,20,1
1668409065070,COGS 210B,001,101404,Greene; Deanna Jacquelyn,9998,0,9999,1
1668409065070,COGS 210B,002,101417,Xia; Haijun,9999,0,9999,0
1668409065070,COGS 210B,003,101422,Nitz; Douglas A.,9999,0,9999,0
1668409065070,COGS 210B,004,101423,Hollan; James D.,9998,0,9999,1
1668409065070,COGS 210B,005,101424,Deak; Gedeon O.,9998,0,9999,1
1668409065070,COGS 210B,006,101425,Rossano; Federico,9999,0,9999,0
1668409065495,COGS 211B,A00,101427,Coulson; Seana M,9996,0,9999,3
1668409065926,COGS 220,A00,101428,Hollan; James D.,0,0,25,25
1668409066353,COGS 229,A00,101429,Dow; Steven P,18,0,25,7
1668409066777,COGS 230,A00,101430,Klemmer; Scott R,11,0,17,6
1668409067203,COGS 234,A00,101431,Xia; Haijun,1,0,25,24
1668409067625,COGS 260,A00,101432,Kiyonaga; Anastasia,21,0,25,4
1668409067625,COGS 260,B00,101433,Kirsh; David Joel,15,0,25,10
1668409068048,CSE 202,A00,102371,Impagliazzo; Russell,0,0,0,0
1668409068472,CSE 203B,A01,102373,Cheng; Chung Kuan,0,0,0,0
1668409068901,CSE 208,A00,102374,Micciancio; Daniele,0,0,0,0
1668409069325,CSE 209A,A00,112895,Impagliazzo; Russell,0,0,15,15
1668409069749,CSE 209B,A00,108005,Bellare; Mihir,0,0,0,0
1668409070172,CSE 210,A00,113163,Coblenz; Michael J,0,0,0,0
1668409070597,CSE 219,A00,106111,Dow; Steven P,0,0,20,20
1668409071021,CSE 221,A00,102376,Voelker; Geoffrey M.,0,0,0,0
1668409071460,CSE 224,A01,102378,Porter; George M,0,0,0,0
1668409071889,CSE 229A,A00,102379,Savage; Stefan,0,0,0,0
1668409072316,CSE 229C,A00,102380,Munyaka; Imani N. S.,0,0,0,0
1668409072743,CSE 232B,A00,102382,Deutsch; Alin Bernard,0,0,0,0
1668409073169,CSE 234,A01,112904,Kumar; Arun Kumar,0,0,0,0
1668409073592,CSE 237A,A00,102383,Rosing; Tajana Simunic,0,0,0,0
1668409074019,CSE 239A,A00,102384,Deutsch; Alin Bernard,0,0,0,0
1668409074449,CSE 239B,A00,102385,Polikarpova; Nadezhda,0,0,0,0
1668409074883,CSE 240A,A00,102386,Pannuto; Patrick William,0,0,0,0
1668409075306,CSE 240B,A00,102387,Zhao; Jishen,0,0,0,0
1668409075743,CSE 241A,A00,106406,Kang; Mingu,0,0,0,0
1668409076167,CSE 249B,A00,102388,Kahng; Andrew Byun,0,0,8,8
1668409076590,CSE 251B,A01,102392,Cottrell; Garrison W,0,0,0,0
1668409076590,CSE 251B,A02,102393,Cottrell; Garrison W,0,0,0,0
1668409077016,CSE 252B,A00,102394,Ochoa; Benjamin Lawrence,0,0,0,0
1668409077439,CSE 257,A01,102396,Gao; Sicun,0,0,0,0
1668409077863,CSE 272,A00,102397,Li; Tzumao,0,0,0,0
1668409078289,CSE 274,A00,111323,Chern; Albert Ren-Haur,0,0,0,0
1668409078712,CSE 282,A00,102398,Pevzner; Pavel Arkadjevich,0,0,0,0
1668409079139,CSE 284,A00,114175,Gymrek; Melissa Ann,0,0,0,0
1668409079562,CSE 290,A00,102399,Chandraker; Manmohan Krishna,0,0,0,0
1668409079562,CSE 290,B00,102400,Vaccaro; Kristen Marie,0,0,25,25
1668409079562,CSE 290,C00,102414,Pannuto; Patrick William,0,0,25,25
1668409079562,CSE 290,D00,102427,Pevzner; Pavel Arkadjevich,0,0,0,0
1668409079562,CSE 290,E00,102429,Zhao; Jishen,0,0,0,0
1668409079562,CSE 290,F00,102436,Tullsen; Dean Michael,0,0,0,0
1668409079562,CSE 290,G00,102440,Christensen; Henrik I,0,0,20,20
1668409079990,CSE 291,A00,102443,Su; Hao,0,0,0,0
1668409079990,CSE 291,B00,102448,Polikarpova; Nadezhda,0,0,0,0
1668409079990,CSE 291,C00,102453,Vaccaro; Kristen Marie,0,0,0,0
1668409079990,CSE 291,D00,111343,Savage; Stefan,0,0,0,0
1668409079990,CSE 291,E00,116474,Claffy; Kimberly Claire,0,0,0,0
1668409079990,CSE 291,F00,116479,Pasquale; Joseph,0,0,0,0
1668409080419,CSE 293,001,119111,Bafna; Vineet,9999,0,9999,0
1668409080419,CSE 293,002,119118,Bellare; Mihir,9999,0,9999,0
1668409080419,CSE 293,003,119122,Berg-Kirkpatrick; Taylor D,9999,0,9999,0
1668409080419,CSE 293,004,119135,Christensen; Henrik I,9999,0,9999,0
1668409080419,CSE 293,005,119142,Cottrell; Garrison W,9999,0,9999,0
1668409080419,CSE 293,006,119146,Deutsch; Alin Bernard,9999,0,9999,0
1668409080419,CSE 293,007,119159,Esmaeilzadeh; Hadi,9999,0,9999,0
1668409080419,CSE 293,008,119166,Freund; Yoav,9999,0,9999,0
1668409080419,CSE 293,009,119170,Griswold; William G.,9999,0,9999,0
1668409080419,CSE 293,010,119183,Gymrek; Melissa Ann,9999,0,9999,0
1668409080419,CSE 293,011,119190,Heninger; Nadia A,9999,0,9999,0
1668409080419,CSE 293,012,119230,Impagliazzo; Russell,9999,0,9999,0
1668409080419,CSE 293,013,119232,Jhala; Ranjit,9999,0,9999,0
1668409080419,CSE 293,014,119233,Kahng; Andrew Byun,9999,0,9999,0
1668409080419,CSE 293,015,119298,Kane; Daniel Mertz,9999,0,9999,0
1668409080419,CSE 293,016,119299,Kriegman; David J,9999,0,9999,0
1668409080419,CSE 293,017,119300,Kumar; Arun Kumar,9999,0,9999,0
1668409080419,CSE 293,018,119301,Lerner; Sorin,9999,0,9999,0
1668409080419,CSE 293,019,119302,Lovett; Shachar,9999,0,9999,0
1668409080419,CSE 293,020,119303,McAuley; Julian John,9999,0,9999,0
1668409080419,CSE 293,021,119304,Micciancio; Daniele,9999,0,9999,0
1668409080419,CSE 293,022,119367,Orailoglu; Alex,9999,0,9999,0
1668409080419,CSE 293,023,119382,Paturi; Ramamohan,9999,0,9999,0
1668409080419,CSE 293,024,119404,Polikarpova; Nadezhda,9999,0,9999,0
1668409080419,CSE 293,025,119406,Politz; Joseph Gibbs,9999,0,9999,0
1668409080419,CSE 293,026,119411,Porter; George M,9999,0,9999,0
1668409080419,CSE 293,027,119414,Porter; Leonard Emerson,9999,0,9999,0
1668409080419,CSE 293,028,119416,Ramamoorthi; Ravi,9999,0,9999,0
1668409080419,CSE 293,029,119417,Sahoo; Debashis,9999,0,9999,0
1668409080419,CSE 293,030,119420,Saul; Lawrence,9999,0,9999,0
1668409080419,CSE 293,031,119421,Savage; Stefan,9999,0,9999,0
1668409080419,CSE 293,032,119425,Schulze; Jurgen P.,9999,0,9999,0
1668409080419,CSE 293,033,119426,Snoeren; Alex C.,9999,0,9999,0
1668409080419,CSE 293,034,119428,Shang; Jingbo,9999,0,9999,0
1668409080419,CSE 293,035,119430,Stefan; Deian,9999,0,9999,0
1668409080419,CSE 293,036,119431,Su; Hao,9999,0,9999,0
1668409080419,CSE 293,037,119433,Swanson; Steven James,9999,0,9999,0
1668409080419,CSE 293,038,119435,Tullsen; Dean Michael,9999,0,9999,0
1668409080419,CSE 293,039,119483,Voelker; Geoffrey M.,9999,0,9999,0
1668409080419,CSE 293,040,119537,Zhao; Jishen,9999,0,9999,0
1668409080419,CSE 293,041,119538,Zhou; Yuan-Yuan,9999,0,9999,0
1668409080419,CSE 293,042,119539,Gao; Sicun,9999,0,9999,0
1668409080419,CSE 293,043,119540,Weibel; Nadir,9999,0,9999,0
1668409080419,CSE 293,044,119541,Gupta; Rajesh K.,9999,0,9999,0
1668409080419,CSE 293,045,126410,Vaccaro; Kristen Marie,9999,0,9999,0
1668409080419,CSE 293,046,126411,Klemke; Richard,9999,0,9999,0
1668409080845,CSE 294,A00,102459,Voelker; Geoffrey M.,0,0,0,0
1668409080845,CSE 294,B00,111322,Orailoglu; Alex,0,0,0,0
1668409081267,DSE 201,A00,096914,Deutsch; Alin Bernard,30,0,30,0
1668409081690,DSE 210,A00,096915,Dasgupta; Sanjoy,30,0,30,0
1668409082114,DSE 260A,A00,096916,Altintas De Callaf; Ilkay,30,0,30,0
1668409082556,ECE 200,001,103586,Antipa; Nicholas A,9999,0,9999,0
1668409082556,ECE 200,002,103587,Atanasov; Nikolay A.,9999,0,9999,0
1668409082556,ECE 200,003,103588,Bharadia; Dinesh,9999,0,9999,0
1668409082556,ECE 200,004,103589,Cheng; Chung Kuan,9999,0,9999,0
1668409082556,ECE 200,005,103590,Cosman; Pamela C.,9999,0,9999,0
1668409082556,ECE 200,006,103591,Dayeh; Shadi Ahmad,9999,0,9999,0
1668409082556,ECE 200,007,103592,Fainman; Yeshaiahu,9999,0,9999,0
1668409082556,ECE 200,008,103593,Ford; Joseph Earl,9999,0,9999,0
1668409082556,ECE 200,009,103594,Franceschetti; Massimo,9999,0,9999,0
1668409082556,ECE 200,010,103595,Fullerton; Eric E,9999,0,9999,0
1668409082556,ECE 200,011,103596,Galton; Ian A,9999,0,9999,0
1668409082556,ECE 200,012,103597,Gilja; Vikash,9999,0,9999,0
1668409082556,ECE 200,013,103598,Hall; Drew A.,9999,0,9999,0
1668409082556,ECE 200,014,103599,Hsueh; Tzu-Chien,9999,0,9999,0
1668409082556,ECE 200,015,103600,Javidi; Tara,9999,0,9999,0
1668409082556,ECE 200,016,103601,Kahng; Andrew Byun,9999,0,9999,0
1668409082556,ECE 200,017,103602,Kim; Young-Han,9999,0,9999,0
1668409082556,ECE 200,018,103603,Koushanfar; Farinaz,9999,0,9999,0
1668409082556,ECE 200,019,103604,Kuzum; Duygu,9999,0,9999,0
1668409082556,ECE 200,020,103605,Le; Hanh-Phuc,9999,0,9999,0
1668409082556,ECE 200,021,103606,Lin; Bill,9999,0,9999,0
1668409082556,ECE 200,022,103607,Liu; Zhaowei,9998,0,9999,1
1668409082556,ECE 200,023,103608,Lo; Yu-Hwa,9999,0,9999,0
1668409082556,ECE 200,024,103609,Lomakin; Vitaliy,9999,0,9999,0
1668409082556,ECE 200,025,103610,Mercier; Patrick Philip,9999,0,9999,0
1668409082556,ECE 200,026,103611,Meyer; Florian,9999,0,9999,0
1668409082556,ECE 200,027,103612,Milstein; Laurence B.,9999,0,9999,0
1668409082556,ECE 200,028,103613,Mir Arabbaygi; Siavash,9999,0,9999,0
1668409082556,ECE 200,029,103614,Mookherjea; Shayan,9999,0,9999,0
1668409082556,ECE 200,030,103615,Morris; Karcher William,9999,0,9999,0
1668409082556,ECE 200,031,103616,Ng; Tse Nga,9999,0,9999,0
1668409082556,ECE 200,032,103617,Nguyen; Truong Quang,9999,0,9999,0
1668409082556,ECE 200,033,103618,Nomura; Kenji,9999,0,9999,0
1668409082556,ECE 200,034,103619,Orlitsky; Alon,9999,0,9999,0
1668409082556,ECE 200,035,103620,Pal; Piya,9999,0,9999,0
1668409082556,ECE 200,036,103621,Papen; George C.,9999,0,9999,0
1668409082556,ECE 200,037,103622,Radic; Stojan,9999,0,9999,0
1668409082556,ECE 200,038,103623,Rao; Bhaskar D.,9999,0,9999,0
1668409082556,ECE 200,039,103624,Rao; Ramesh R,9999,0,9999,0
1668409082556,ECE 200,040,103625,Rebeiz; Gabriel,9999,0,9999,0
1668409082556,ECE 200,041,103626,Sanford; John R,9999,0,9999,0
1668409082556,ECE 200,042,103627,Siegel; Paul H.,9999,0,9999,0
1668409082556,ECE 200,043,103628,Sievenpiper; Daniel F.,9999,0,9999,0
1668409082556,ECE 200,044,103629,Sworder; David D.,9999,0,9999,0
1668409082556,ECE 200,045,103630,Taur; Yuan,9999,0,9999,0
1668409082556,ECE 200,046,103631,Touri; Behrouz,9999,0,9999,0
1668409082556,ECE 200,047,103632,Trivedi; Mohan M.,9999,0,9999,0
1668409082556,ECE 200,048,103633,Vasconcelos; Nuno,9999,0,9999,0
1668409082556,ECE 200,049,103634,Wang; Xiaolong,9999,0,9999,0
1668409082556,ECE 200,050,103635,Xie; Pengtao,9999,0,9999,0
1668409082556,ECE 200,051,103636,Yip; Michael,9999,0,9999,0
1668409082556,ECE 200,052,103637,Zeger; Kenneth A.,999,0,999,0
1668409082556,ECE 200,053,103638,Zhang; Xinyu,9999,0,9999,0
1668409082556,ECE 200,054,103639,Turakhia; Yatish Girish,9999,0,9999,0
1668409082556,ECE 200,055,103640,Kang; Mingu,9999,0,9999,0
1668409082556,ECE 200,056,103641,Shi; Yuanyuan,9999,0,9999,0
1668409082556,ECE 200,057,103642,Wang; Edward Jay,9999,0,9999,0
1668409082556,ECE 200,058,103643,Zheng; Yang,9999,0,9999,0
1668409082978,ECE 202,A00,103644,Kuzum; Duygu,0,0,0,0
1668409083404,ECE 212BN,A00,103646,Ng; Tse Nga,0,0,0,0
1668409083831,ECE 221,A00,111493,Staff,0,0,0,0
1668409084256,ECE 222B,A00,103647,Lomakin; Vitaliy,0,0,0,0
1668409084684,ECE 230B,A00,103648,Taur; Yuan,0,0,0,0
1668409085107,ECE 238B,A00,103649,Garay; Javier,0,0,0,0
1668409085537,ECE 240B,A00,112900,Fainman; Yeshaiahu,0,0,0,0
1668409086034,ECE 247A,A00,103650,Jokerst; Jesse Vincent,0,0,0,0
1668409086461,ECE 247B,A00,103651,Wang; Joseph,0,0,0,0
1668409086890,ECE 250,A00,103652,Siegel; Paul H.,0,0,0,0
1668409087315,ECE 251A,A00,103654,Rao; Bhaskar D.,0,0,0,0
1668409087738,ECE 257B,A00,103655,Bharadia; Dinesh,0,0,0,0
1668409088170,ECE 258A,A00,103656,Milstein; Laurence B.,0,0,0,0
1668409088609,ECE 260B,A00,103658,Kang; Mingu,0,0,0,0
1668409089041,ECE 264A,A00,103659,Galton; Ian A,0,0,0,0
1668409089471,ECE 265A,A00,103661,Gudem; Prasad S.S.,0,0,0,0
1668409089898,ECE 265D,A00,103662,Gudem; Prasad S.S.,0,0,0,0
1668409090321,ECE 268,A00,103663,Koushanfar; Farinaz,0,0,0,0
1668409090755,ECE 269,A01,103665,Pal; Piya,0,0,0,0
1668409091187,ECE 271B,A00,103666,Vasconcelos; Manuela,0,0,0,0
1668409091625,ECE 276A,A00,103667,Atanasov; Nikolay A.,0,0,0,0
1668409092065,ECE 277,A00,103668,An; Cheolhong,0,0,0,0
1668409092501,ECE 279,A00,117947,Hall; Drew A.,0,0,0,0
1668409093351,ECE 283,A00,103670,Hsueh; Tzu-Chien,0,0,0,0
1668409093779,ECE 284,A00,103671,Turakhia; Yatish Girish,0,0,0,0
1668409094204,ECE 285,A00,103672,Zheng; Yang,0,0,0,0
1668409094204,ECE 285,B00,103673,Sworder; David D.,0,0,0,0
1668409094627,ECE 287,A00,103676,Javidi; Tara,0,0,0,0
1668409095062,MATH 200B,A00,098023,Salehi Golsefidy; Alireza,12,0,15,3
1668409095486,MATH 202B,A00,098024,Rhoades; Brendon Patrick,9,0,15,6
1668409095915,MATH 203B,A00,098025,Oprea; Dragos N.,10,0,15,5
1668409096339,MATH 204B,A00,098026,Sorensen; Claus M,13,0,15,2
1668409096765,MATH 208,A00,098027,Izadi; Elham,7,0,10,3
1668409097190,MATH 209,A00,098028,Pollack; Aaron,10,0,10,0
1668409097613,MATH 211A,A00,112919,Rogalski; Daniel,9,0,10,1
1668409098036,MATH 211B,A00,112920,Seward; Brandon M.,9,0,10,1
1668409098463,MATH 218,A00,098029,Li; Bo,10,0,10,0
1668409098886,MATH 220B,A00,098030,Novak; Jonathan I,11,0,15,4
1668409099312,MATH 221A,A00,098031,Ebenfelt; Peter F,13,0,15,2
1668409099745,MATH 231B,A00,098032,Zlatos; Andrej,12,0,15,3
1668409100169,MATH 240B,A00,098033,Ni; Lei,9,0,15,6
1668409100593,MATH 243,A00,098034,Jekel; David Andrew,10,0,10,0
1668409101017,MATH 245A,A00,098035,Nie; Jiawang,0,0,15,16
1668409101439,MATH 248,A00,098036,Bejenaru; Ioan,10,0,10,0
1668409101867,MATH 250B,A00,098037,Spolaor; Luca,14,0,15,1
1668409102292,MATH 258,A00,098038,Ni; Lei,10,0,10,0
1668409102716,MATH 264B,A00,098041,Rhoades; Brendon Patrick,9,0,15,6
1668409103139,MATH 268,A00,098042,Buss; Samuel R,10,0,10,0
1668409103566,MATH 269,A00,098043,Rhoades; Brendon Patrick,10,0,10,0
1668409103990,MATH 270B,A00,098044,Li; Bo,10,0,15,5
1668409104414,MATH 272B,A00,098045,Holst; Michael J,13,0,15,2
1668409104838,MATH 273A,A00,098046,Tian; Xiaochuan,10,0,15,5
1668409105286,MATH 275,A01,098048,Tian; Xiaochuan,6,0,10,4
1668409105710,MATH 278A,A00,098049,Holst; Michael J,8,0,10,2
1668409106143,MATH 278B,A00,098050,Cloninger; Alexander,10,0,10,0
1668409106579,MATH 278C,A00,098051,Nie; Jiawang,6,0,10,4
1668409107006,MATH 280B,A00,098052,Zheng; Tianyi,8,0,15,7
1668409107435,MATH 281B,A00,098053,Bradic; Jelena,0,0,15,15
1668409107861,MATH 282B,A00,098054,Arias-Castro; Ery,0,0,15,15
1668409108284,MATH 285,A00,098055,Fitzsimmons; Patrick J,0,0,15,17
1668409108706,MATH 287B,A00,098056,Arias-Castro; Ery,2,0,15,13
1668409109133,MATH 288,A00,098057,Agarwal; Pooja,9,0,10,1
1668409109133,MATH 288,B00,098058,Zhang; Danna,8,0,10,2
1668409109133,MATH 288,C00,098059,Williams; Ruth J,9,0,10,1
1668409109558,MATH 290B,A00,098060,Roberts; Justin Deritter,13,0,15,2
1668409109988,MATH 292,A00,098061,Belmont; Eva Kinoshita,10,0,10,0
1668409110422,MATH 295,A00,098062,Suk; Andrew Hoon,48,0,50,2
1668409110863,MATH 296,A00,098063,Novak; Jonathan I,20,0,20,0
1668409111289,MATH 297,001,098064,Gamst; Anthony Collins,9997,0,9999,2
1668409612756,COGS 205,A00,101395,Chiba; Andrea,19,0,20,1
1668409613180,COGS 210B,001,101404,Greene; Deanna Jacquelyn,9998,0,9999,1
1668409613180,COGS 210B,002,101417,Xia; Haijun,9999,0,9999,0
1668409613180,COGS 210B,003,101422,Nitz; Douglas A.,9999,0,9999,0
1668409613180,COGS 210B,004,101423,Hollan; James D.,9998,0,9999,1
1668409613180,COGS 210B,005,101424,Deak; Gedeon O.,9998,0,9999,1
1668409613180,COGS 210B,006,101425,Rossano; Federico,9999,0,9999,0
1668409613605,COGS 211B,A00,101427,Coulson; Seana M,9996,0,9999,3
1668409614029,COGS 220,A00,101428,Hollan; James D.,0,0,25,25
1668409614464,COGS 229,A00,101429,Dow; Steven P,18,0,25,7
1668409614888,COGS 230,A00,101430,Klemmer; Scott R,11,0,17,6
1668409615313,COGS 234,A00,101431,Xia; Haijun,1,0,25,24
1668409615753,COGS 260,A00,101432,Kiyonaga; Anastasia,21,0,25,4
1668409615753,COGS 260,B00,101433,Kirsh; David Joel,15,0,25,10
1668409616186,CSE 202,A00,102371,Impagliazzo; Russell,0,0,0,0
1668409616614,CSE 203B,A01,102373,Cheng; Chung Kuan,0,0,0,0
1668409617050,CSE 208,A00,102374,Micciancio; Daniele,0,0,0,0
1668409617473,CSE 209A,A00,112895,Impagliazzo; Russell,0,0,15,15
1668409617898,CSE 209B,A00,108005,Bellare; Mihir,0,0,0,0
1668409618321,CSE 210,A00,113163,Coblenz; Michael J,0,0,0,0
1668409618745,CSE 219,A00,106111,Dow; Steven P,0,0,20,20
1668409619172,CSE 221,A00,102376,Voelker; Geoffrey M.,0,0,0,0
1668409619596,CSE 224,A01,102378,Porter; George M,0,0,0,0
1668409620021,CSE 229A,A00,102379,Savage; Stefan,0,0,0,0
1668409620449,CSE 229C,A00,102380,Munyaka; Imani N. S.,0,0,0,0
1668409620873,CSE 232B,A00,102382,Deutsch; Alin Bernard,0,0,0,0
1668409621299,CSE 234,A01,112904,Kumar; Arun Kumar,0,0,0,0
1668409621726,CSE 237A,A00,102383,Rosing; Tajana Simunic,0,0,0,0
1668409622148,CSE 239A,A00,102384,Deutsch; Alin Bernard,0,0,0,0
1668409622575,CSE 239B,A00,102385,Polikarpova; Nadezhda,0,0,0,0
1668409623008,CSE 240A,A00,102386,Pannuto; Patrick William,0,0,0,0
1668409623432,CSE 240B,A00,102387,Zhao; Jishen,0,0,0,0
1668409623866,CSE 241A,A00,106406,Kang; Mingu,0,0,0,0
1668409624306,CSE 249B,A00,102388,Kahng; Andrew Byun,0,0,8,8
1668409624735,CSE 251B,A01,102392,Cottrell; Garrison W,0,0,0,0
1668409624735,CSE 251B,A02,102393,Cottrell; Garrison W,0,0,0,0
1668409625163,CSE 252B,A00,102394,Ochoa; Benjamin Lawrence,0,0,0,0
1668409625588,CSE 257,A01,102396,Gao; Sicun,0,0,0,0
1668409626013,CSE 272,A00,102397,Li; Tzumao,0,0,0,0
1668409626440,CSE 274,A00,111323,Chern; Albert Ren-Haur,0,0,0,0
1668409626865,CSE 282,A00,102398,Pevzner; Pavel Arkadjevich,0,0,0,0
1668409627291,CSE 284,A00,114175,Gymrek; Melissa Ann,0,0,0,0
1668409627718,CSE 290,A00,102399,Chandraker; Manmohan Krishna,0,0,0,0
1668409627718,CSE 290,B00,102400,Vaccaro; Kristen Marie,0,0,25,25
1668409627718,CSE 290,C00,102414,Pannuto; Patrick William,0,0,25,25
1668409627718,CSE 290,D00,102427,Pevzner; Pavel Arkadjevich,0,0,0,0
1668409627718,CSE 290,E00,102429,Zhao; Jishen,0,0,0,0
1668409627718,CSE 290,F00,102436,Tullsen; Dean Michael,0,0,0,0
1668409627718,CSE 290,G00,102440,Christensen; Henrik I,0,0,20,20
1668409628143,CSE 291,A00,102443,Su; Hao,0,0,0,0
1668409628143,CSE 291,B00,102448,Polikarpova; Nadezhda,0,0,0,0
1668409628143,CSE 291,C00,102453,Vaccaro; Kristen Marie,0,0,0,0
1668409628143,CSE 291,D00,111343,Savage; Stefan,0,0,0,0
1668409628143,CSE 291,E00,116474,Claffy; Kimberly Claire,0,0,0,0
1668409628143,CSE 291,F00,116479,Pasquale; Joseph,0,0,0,0
1668409628572,CSE 293,001,119111,Bafna; Vineet,9999,0,9999,0
1668409628572,CSE 293,002,119118,Bellare; Mihir,9999,0,9999,0
1668409628572,CSE 293,003,119122,Berg-Kirkpatrick; Taylor D,9999,0,9999,0
1668409628572,CSE 293,004,119135,Christensen; Henrik I,9999,0,9999,0
1668409628572,CSE 293,005,119142,Cottrell; Garrison W,9999,0,9999,0
1668409628572,CSE 293,006,119146,Deutsch; Alin Bernard,9999,0,9999,0
1668409628572,CSE 293,007,119159,Esmaeilzadeh; Hadi,9999,0,9999,0
1668409628572,CSE 293,008,119166,Freund; Yoav,9999,0,9999,0
1668409628572,CSE 293,009,119170,Griswold; William G.,9999,0,9999,0
1668409628572,CSE 293,010,119183,Gymrek; Melissa Ann,9999,0,9999,0
1668409628572,CSE 293,011,119190,Heninger; Nadia A,9999,0,9999,0
1668409628572,CSE 293,012,119230,Impagliazzo; Russell,9999,0,9999,0
1668409628572,CSE 293,013,119232,Jhala; Ranjit,9999,0,9999,0
1668409628572,CSE 293,014,119233,Kahng; Andrew Byun,9999,0,9999,0
1668409628572,CSE 293,015,119298,Kane; Daniel Mertz,9999,0,9999,0
1668409628572,CSE 293,016,119299,Kriegman; David J,9999,0,9999,0
1668409628572,CSE 293,017,119300,Kumar; Arun Kumar,9999,0,9999,0
1668409628572,CSE 293,018,119301,Lerner; Sorin,9999,0,9999,0
1668409628572,CSE 293,019,119302,Lovett; Shachar,9999,0,9999,0
1668409628572,CSE 293,020,119303,McAuley; Julian John,9999,0,9999,0
1668409628572,CSE 293,021,119304,Micciancio; Daniele,9999,0,9999,0
1668409628572,CSE 293,022,119367,Orailoglu; Alex,9999,0,9999,0
1668409628572,CSE 293,023,119382,Paturi; Ramamohan,9999,0,9999,0
1668409628572,CSE 293,024,119404,Polikarpova; Nadezhda,9999,0,9999,0
1668409628572,CSE 293,025,119406,Politz; Joseph Gibbs,9999,0,9999,0
1668409628572,CSE 293,026,119411,Porter; George M,9999,0,9999,0
1668409628572,CSE 293,027,119414,Porter; Leonard Emerson,9999,0,9999,0
1668409628572,CSE 293,028,119416,Ramamoorthi; Ravi,9999,0,9999,0
1668409628572,CSE 293,029,119417,Sahoo; Debashis,9999,0,9999,0
1668409628572,CSE 293,030,119420,Saul; Lawrence,9999,0,9999,0
1668409628572,CSE 293,031,119421,Savage; Stefan,9999,0,9999,0
1668409628572,CSE 293,032,119425,Schulze; Jurgen P.,9999,0,9999,0
1668409628572,CSE 293,033,119426,Snoeren; Alex C.,9999,0,9999,0
1668409628572,CSE 293,034,119428,Shang; Jingbo,9999,0,9999,0
1668409628572,CSE 293,035,119430,Stefan; Deian,9999,0,9999,0
1668409628572,CSE 293,036,119431,Su; Hao,9999,0,9999,0
1668409628572,CSE 293,037,119433,Swanson; Steven James,9999,0,9999,0
1668409628572,CSE 293,038,119435,Tullsen; Dean Michael,9999,0,9999,0
1668409628572,CSE 293,039,119483,Voelker; Geoffrey M.,9999,0,9999,0
1668409628572,CSE 293,040,119537,Zhao; Jishen,9999,0,9999,0
1668409628572,CSE 293,041,119538,Zhou; Yuan-Yuan,9999,0,9999,0
1668409628572,CSE 293,042,119539,Gao; Sicun,9999,0,9999,0
1668409628572,CSE 293,043,119540,Weibel; Nadir,9999,0,9999,0
1668409628572,CSE 293,044,119541,Gupta; Rajesh K.,9999,0,9999,0
1668409628572,CSE 293,045,126410,Vaccaro; Kristen Marie,9999,0,9999,0
1668409628572,CSE 293,046,126411,Klemke; Richard,9999,0,9999,0
1668409628998,CSE 294,A00,102459,Voelker; Geoffrey M.,0,0,0,0
1668409628998,CSE 294,B00,111322,Orailoglu; Alex,0,0,0,0
1668409629424,DSE 201,A00,096914,Deutsch; Alin Bernard,30,0,30,0
1668409629854,DSE 210,A00,096915,Dasgupta; Sanjoy,30,0,30,0
1668409630278,DSE 260A,A00,096916,Altintas De Callaf; Ilkay,30,0,30,0
1668409630713,ECE 200,001,103586,Antipa; Nicholas A,9999,0,9999,0
1668409630713,ECE 200,002,103587,Atanasov; Nikolay A.,9999,0,9999,0
1668409630713,ECE 200,003,103588,Bharadia; Dinesh,9999,0,9999,0
1668409630713,ECE 200,004,103589,Cheng; Chung Kuan,9999,0,9999,0
1668409630713,ECE 200,005,103590,Cosman; Pamela C.,9999,0,9999,0
1668409630713,ECE 200,006,103591,Dayeh; Shadi Ahmad,9999,0,9999,0
1668409630713,ECE 200,007,103592,Fainman; Yeshaiahu,9999,0,9999,0
1668409630713,ECE 200,008,103593,Ford; Joseph Earl,9999,0,9999,0
1668409630713,ECE 200,009,103594,Franceschetti; Massimo,9999,0,9999,0
1668409630713,ECE 200,010,103595,Fullerton; Eric E,9999,0,9999,0
1668409630713,ECE 200,011,103596,Galton; Ian A,9999,0,9999,0
1668409630713,ECE 200,012,103597,Gilja; Vikash,9999,0,9999,0
1668409630713,ECE 200,013,103598,Hall; Drew A.,9999,0,9999,0
1668409630713,ECE 200,014,103599,Hsueh; Tzu-Chien,9999,0,9999,0
1668409630713,ECE 200,015,103600,Javidi; Tara,9999,0,9999,0
1668409630713,ECE 200,016,103601,Kahng; Andrew Byun,9999,0,9999,0
1668409630713,ECE 200,017,103602,Kim; Young-Han,9999,0,9999,0
1668409630713,ECE 200,018,103603,Koushanfar; Farinaz,9999,0,9999,0
1668409630713,ECE 200,019,103604,Kuzum; Duygu,9999,0,9999,0
1668409630713,ECE 200,020,103605,Le; Hanh-Phuc,9999,0,9999,0
1668409630713,ECE 200,021,103606,Lin; Bill,9999,0,9999,0
1668409630713,ECE 200,022,103607,Liu; Zhaowei,9998,0,9999,1
1668409630713,ECE 200,023,103608,Lo; Yu-Hwa,9999,0,9999,0
1668409630713,ECE 200,024,103609,Lomakin; Vitaliy,9999,0,9999,0
1668409630713,ECE 200,025,103610,Mercier; Patrick Philip,9999,0,9999,0
1668409630713,ECE 200,026,103611,Meyer; Florian,9999,0,9999,0
1668409630713,ECE 200,027,103612,Milstein; Laurence B.,9999,0,9999,0
1668409630713,ECE 200,028,103613,Mir Arabbaygi; Siavash,9999,0,9999,0
1668409630713,ECE 200,029,103614,Mookherjea; Shayan,9999,0,9999,0
1668409630713,ECE 200,030,103615,Morris; Karcher William,9999,0,9999,0
1668409630713,ECE 200,031,103616,Ng; Tse Nga,9999,0,9999,0
1668409630713,ECE 200,032,103617,Nguyen; Truong Quang,9999,0,9999,0
1668409630713,ECE 200,033,103618,Nomura; Kenji,9999,0,9999,0
1668409630713,ECE 200,034,103619,Orlitsky; Alon,9999,0,9999,0
1668409630713,ECE 200,035,103620,Pal; Piya,9999,0,9999,0
1668409630713,ECE 200,036,103621,Papen; George C.,9999,0,9999,0
1668409630713,ECE 200,037,103622,Radic; Stojan,9999,0,9999,0
1668409630713,ECE 200,038,103623,Rao; Bhaskar D.,9999,0,9999,0
1668409630713,ECE 200,039,103624,Rao; Ramesh R,9999,0,9999,0
1668409630713,ECE 200,040,103625,Rebeiz; Gabriel,9999,0,9999,0
1668409630713,ECE 200,041,103626,Sanford; John R,9999,0,9999,0
1668409630713,ECE 200,042,103627,Siegel; Paul H.,9999,0,9999,0
1668409630713,ECE 200,043,103628,Sievenpiper; Daniel F.,9999,0,9999,0
1668409630713,ECE 200,044,103629,Sworder; David D.,9999,0,9999,0
1668409630713,ECE 200,045,103630,Taur; Yuan,9999,0,9999,0
1668409630713,ECE 200,046,103631,Touri; Behrouz,9999,0,9999,0
1668409630713,ECE 200,047,103632,Trivedi; Mohan M.,9999,0,9999,0
1668409630713,ECE 200,048,103633,Vasconcelos; Nuno,9999,0,9999,0
1668409630713,ECE 200,049,103634,Wang; Xiaolong,9999,0,9999,0
1668409630713,ECE 200,050,103635,Xie; Pengtao,9999,0,9999,0
1668409630713,ECE 200,051,103636,Yip; Michael,9999,0,9999,0
1668409630713,ECE 200,052,103637,Zeger; Kenneth A.,999,0,999,0
1668409630713,ECE 200,053,103638,Zhang; Xinyu,9999,0,9999,0
1668409630713,ECE 200,054,103639,Turakhia; Yatish Girish,9999,0,9999,0
1668409630713,ECE 200,055,103640,Kang; Mingu,9999,0,9999,0
1668409630713,ECE 200,056,103641,Shi; Yuanyuan,9999,0,9999,0
1668409630713,ECE 200,057,103642,Wang; Edward Jay,9999,0,9999,0
1668409630713,ECE 200,058,103643,Zheng; Yang,9999,0,9999,0
1668409631140,ECE 202,A00,103644,Kuzum; Duygu,0,0,0,0
1668409631566,ECE 212BN,A00,103646,Ng; Tse Nga,0,0,0,0
1668409631994,ECE 221,A00,111493,Staff,0,0,0,0
1668409632421,ECE 222B,A00,103647,Lomakin; Vitaliy,0,0,0,0
1668409632854,ECE 230B,A00,103648,Taur; Yuan,0,0,0,0
1668409633284,ECE 238B,A00,103649,Garay; Javier,0,0,0,0
1668409633716,ECE 240B,A00,112900,Fainman; Yeshaiahu,0,0,0,0
1668409634143,ECE 247A,A00,103650,Jokerst; Jesse Vincent,0,0,0,0
1668409634568,ECE 247B,A00,103651,Wang; Joseph,0,0,0,0
1668409634995,ECE 250,A00,103652,Siegel; Paul H.,0,0,0,0
1668409635429,ECE 251A,A00,103654,Rao; Bhaskar D.,0,0,0,0
1668409635861,ECE 257B,A00,103655,Bharadia; Dinesh,0,0,0,0
1668409636283,ECE 258A,A00,103656,Milstein; Laurence B.,0,0,0,0
1668409636712,ECE 260B,A00,103658,Kang; Mingu,0,0,0,0
1668409637136,ECE 264A,A00,103659,Galton; Ian A,0,0,0,0
1668409637563,ECE 265A,A00,103661,Gudem; Prasad S.S.,0,0,0,0
1668409637986,ECE 265D,A00,103662,Gudem; Prasad S.S.,0,0,0,0
1668409638412,ECE 268,A00,103663,Koushanfar; Farinaz,0,0,0,0
1668409638839,ECE 269,A01,103665,Pal; Piya,0,0,0,0
1668409639266,ECE 271B,A00,103666,Vasconcelos; Manuela,0,0,0,0
1668409639691,ECE 276A,A00,103667,Atanasov; Nikolay A.,0,0,0,0
1668409640117,ECE 277,A00,103668,An; Cheolhong,0,0,0,0
1668409640544,ECE 279,A00,117947,Hall; Drew A.,0,0,0,0
1668409641394,ECE 283,A00,103670,Hsueh; Tzu-Chien,0,0,0,0
1668409641818,ECE 284,A00,103671,Turakhia; Yatish Girish,0,0,0,0
1668409642246,ECE 285,A00,103672,Zheng; Yang,0,0,0,0
1668409642246,ECE 285,B00,103673,Sworder; David D.,0,0,0,0
1668409642682,ECE 287,A00,103676,Javidi; Tara,0,0,0,0
1668409643110,MATH 200B,A00,098023,Salehi Golsefidy; Alireza,12,0,15,3
1668409643542,MATH 202B,A00,098024,Rhoades; Brendon Patrick,9,0,15,6
1668409643980,MATH 203B,A00,098025,Oprea; Dragos N.,10,0,15,5
1668409644419,MATH 204B,A00,098026,Sorensen; Claus M,13,0,15,2
1668409644844,MATH 208,A00,098027,Izadi; Elham,7,0,10,3
1668409645275,MATH 209,A00,098028,Pollack; Aaron,10,0,10,0
1668409645708,MATH 211A,A00,112919,Rogalski; Daniel,9,0,10,1
1668409646133,MATH 211B,A00,112920,Seward; Brandon M.,9,0,10,1
1668409646555,MATH 218,A00,098029,Li; Bo,10,0,10,0
1668409646993,MATH 220B,A00,098030,Novak; Jonathan I,11,0,15,4
1668409647415,MATH 221A,A00,098031,Ebenfelt; Peter F,13,0,15,2
1668409647841,MATH 231B,A00,098032,Zlatos; Andrej,12,0,15,3
1668409648277,MATH 240B,A00,098033,Ni; Lei,9,0,15,6
1668409648699,MATH 243,A00,098034,Jekel; David Andrew,10,0,10,0
1668409649124,MATH 245A,A00,098035,Nie; Jiawang,0,0,15,16
1668409649547,MATH 248,A00,098036,Bejenaru; Ioan,10,0,10,0
1668409649972,MATH 250B,A00,098037,Spolaor; Luca,14,0,15,1
1668409650398,MATH 258,A00,098038,Ni; Lei,10,0,10,0
1668409650926,MATH 264B,A00,098041,Rhoades; Brendon Patrick,9,0,15,6
1668409651349,MATH 268,A00,098042,Buss; Samuel R,10,0,10,0
1668409651772,MATH 269,A00,098043,Rhoades; Brendon Patrick,10,0,10,0
1668409652199,MATH 270B,A00,098044,Li; Bo,10,0,15,5
1668409652624,MATH 272B,A00,098045,Holst; Michael J,13,0,15,2
1668409653049,MATH 273A,A00,098046,Tian; Xiaochuan,10,0,15,5
1668409653474,MATH 275,A01,098048,Tian; Xiaochuan,6,0,10,4
1668409653897,MATH 278A,A00,098049,Holst; Michael J,8,0,10,2
1668409654324,MATH 278B,A00,098050,Cloninger; Alexander,10,0,10,0
1668409654758,MATH 278C,A00,098051,Nie; Jiawang,6,0,10,4
1668409655183,MATH 280B,A00,098052,Zheng; Tianyi,8,0,15,7
1668409655627,MATH 281B,A00,098053,Bradic; Jelena,0,0,15,15
1668409656052,MATH 282B,A00,098054,Arias-Castro; Ery,0,0,15,15
1668409656480,MATH 285,A00,098055,Fitzsimmons; Patrick J,0,0,15,17
1668409656907,MATH 287B,A00,098056,Arias-Castro; Ery,2,0,15,13
1668409657330,MATH 288,A00,098057,Agarwal; Pooja,9,0,10,1
1668409657330,MATH 288,B00,098058,Zhang; Danna,8,0,10,2
1668409657330,MATH 288,C00,098059,Williams; Ruth J,9,0,10,1
1668409657756,MATH 290B,A00,098060,Roberts; Justin Deritter,13,0,15,2
1668409658191,MATH 292,A00,098061,Belmont; Eva Kinoshita,10,0,10,0
1668409658614,MATH 295,A00,098062,Suk; Andrew Hoon,48,0,50,2
1668409659039,MATH 296,A00,098063,Novak; Jonathan I,20,0,20,0
1668409659465,MATH 297,001,098064,Gamst; Anthony Collins,9997,0,9999,2
1668410160105,COGS 205,A00,101395,Chiba; Andrea,19,0,20,1
1668410160530,COGS 210B,001,101404,Greene; Deanna Jacquelyn,9998,0,9999,1
1668410160530,COGS 210B,002,101417,Xia; Haijun,9999,0,9999,0
1668410160530,COGS 210B,003,101422,Nitz; Douglas A.,9999,0,9999,0
1668410160530,COGS 210B,004,101423,Hollan; James D.,9998,0,9999,1
1668410160530,COGS 210B,005,101424,Deak; Gedeon O.,9998,0,9999,1
1668410160530,COGS 210B,006,101425,Rossano; Federico,9999,0,9999,0
1668410160957,COGS 211B,A00,101427,Coulson; Seana M,9996,0,9999,3
1668410161391,COGS 220,A00,101428,Hollan; James D.,0,0,25,25
1668410161814,COGS 229,A00,101429,Dow; Steven P,18,0,25,7
1668410162242,COGS 230,A00,101430,Klemmer; Scott R,11,0,17,6
1668410162666,COGS 234,A00,101431,Xia; Haijun,1,0,25,24
1668410163090,COGS 260,A00,101432,Kiyonaga; Anastasia,21,0,25,4
1668410163090,COGS 260,B00,101433,Kirsh; David Joel,15,0,25,10
1668410163517,CSE 202,A00,102371,Impagliazzo; Russell,0,0,0,0
1668410163945,CSE 203B,A01,102373,Cheng; Chung Kuan,0,0,0,0
1668410164372,CSE 208,A00,102374,Micciancio; Daniele,0,0,0,0
1668410164796,CSE 209A,A00,112895,Impagliazzo; Russell,0,0,15,15
1668410165221,CSE 209B,A00,108005,Bellare; Mihir,0,0,0,0
1668410165649,CSE 210,A00,113163,Coblenz; Michael J,0,0,0,0
1668410166072,CSE 219,A00,106111,Dow; Steven P,0,0,20,20
1668410166497,CSE 221,A00,102376,Voelker; Geoffrey M.,0,0,0,0
1668410166924,CSE 224,A01,102378,Porter; George M,0,0,0,0
1668410167348,CSE 229A,A00,102379,Savage; Stefan,0,0,0,0
1668410167771,CSE 229C,A00,102380,Munyaka; Imani N. S.,0,0,0,0
1668410168195,CSE 232B,A00,102382,Deutsch; Alin Bernard,0,0,0,0
1668410168620,CSE 234,A01,112904,Kumar; Arun Kumar,0,0,0,0
1668410169043,CSE 237A,A00,102383,Rosing; Tajana Simunic,0,0,0,0
1668410169465,CSE 239A,A00,102384,Deutsch; Alin Bernard,0,0,0,0
1668410169891,CSE 239B,A00,102385,Polikarpova; Nadezhda,0,0,0,0
1668410170317,CSE 240A,A00,102386,Pannuto; Patrick William,0,0,0,0
1668410170743,CSE 240B,A00,102387,Zhao; Jishen,0,0,0,0
1668410171171,CSE 241A,A00,106406,Kang; Mingu,0,0,0,0
1668410171690,CSE 249B,A00,102388,Kahng; Andrew Byun,0,0,8,8
1668410172115,CSE 251B,A01,102392,Cottrell; Garrison W,0,0,0,0
1668410172115,CSE 251B,A02,102393,Cottrell; Garrison W,0,0,0,0
1668410172537,CSE 252B,A00,102394,Ochoa; Benjamin Lawrence,0,0,0,0
1668410172961,CSE 257,A01,102396,Gao; Sicun,0,0,0,0
1668410173399,CSE 272,A00,102397,Li; Tzumao,0,0,0,0
1668410173834,CSE 274,A00,111323,Chern; Albert Ren-Haur,0,0,0,0
1668410174271,CSE 282,A00,102398,Pevzner; Pavel Arkadjevich,0,0,0,0
1668410174698,CSE 284,A00,114175,Gymrek; Melissa Ann,0,0,0,0
1668410175122,CSE 290,A00,102399,Chandraker; Manmohan Krishna,0,0,0,0
1668410175122,CSE 290,B00,102400,Vaccaro; Kristen Marie,0,0,25,25
1668410175122,CSE 290,C00,102414,Pannuto; Patrick William,0,0,25,25
1668410175122,CSE 290,D00,102427,Pevzner; Pavel Arkadjevich,0,0,0,0
1668410175122,CSE 290,E00,102429,Zhao; Jishen,0,0,0,0
1668410175122,CSE 290,F00,102436,Tullsen; Dean Michael,0,0,0,0
1668410175122,CSE 290,G00,102440,Christensen; Henrik I,0,0,20,20
1668410175551,CSE 291,A00,102443,Su; Hao,0,0,0,0
1668410175551,CSE 291,B00,102448,Polikarpova; Nadezhda,0,0,0,0
1668410175551,CSE 291,C00,102453,Vaccaro; Kristen Marie,0,0,0,0
1668410175551,CSE 291,D00,111343,Savage; Stefan,0,0,0,0
1668410175551,CSE 291,E00,116474,Claffy; Kimberly Claire,0,0,0,0
1668410175551,CSE 291,F00,116479,Pasquale; Joseph,0,0,0,0
1668410175986,CSE 293,001,119111,Bafna; Vineet,9999,0,9999,0
1668410175986,CSE 293,002,119118,Bellare; Mihir,9999,0,9999,0
1668410175986,CSE 293,003,119122,Berg-Kirkpatrick; Taylor D,9999,0,9999,0
1668410175986,CSE 293,004,119135,Christensen; Henrik I,9999,0,9999,0
1668410175986,CSE 293,005,119142,Cottrell; Garrison W,9999,0,9999,0
1668410175986,CSE 293,006,119146,Deutsch; Alin Bernard,9999,0,9999,0
1668410175986,CSE 293,007,119159,Esmaeilzadeh; Hadi,9999,0,9999,0
1668410175986,CSE 293,008,119166,Freund; Yoav,9999,0,9999,0
1668410175986,CSE 293,009,119170,Griswold; William G.,9999,0,9999,0
1668410175986,CSE 293,010,119183,Gymrek; Melissa Ann,9999,0,9999,0
1668410175986,CSE 293,011,119190,Heninger; Nadia A,9999,0,9999,0
1668410175986,CSE 293,012,119230,Impagliazzo; Russell,9999,0,9999,0
1668410175986,CSE 293,013,119232,Jhala; Ranjit,9999,0,9999,0
1668410175986,CSE 293,014,119233,Kahng; Andrew Byun,9999,0,9999,0
1668410175986,CSE 293,015,119298,Kane; Daniel Mertz,9999,0,9999,0
1668410175986,CSE 293,016,119299,Kriegman; David J,9999,0,9999,0
1668410175986,CSE 293,017,119300,Kumar; Arun Kumar,9999,0,9999,0
1668410175986,CSE 293,018,119301,Lerner; Sorin,9999,0,9999,0
1668410175986,CSE 293,019,119302,Lovett; Shachar,9999,0,9999,0
1668410175986,CSE 293,020,119303,McAuley; Julian John,9999,0,9999,0
1668410175986,CSE 293,021,119304,Micciancio; Daniele,9999,0,9999,0
1668410175986,CSE 293,022,119367,Orailoglu; Alex,9999,0,9999,0
1668410175986,CSE 293,023,119382,Paturi; Ramamohan,9999,0,9999,0
1668410175986,CSE 293,024,119404,Polikarpova; Nadezhda,9999,0,9999,0
1668410175986,CSE 293,025,119406,Politz; Joseph Gibbs,9999,0,9999,0
1668410175986,CSE 293,026,119411,Porter; George M,9999,0,9999,0
1668410175986,CSE 293,027,119414,Porter; Leonard Emerson,9999,0,9999,0
1668410175986,CSE 293,028,119416,Ramamoorthi; Ravi,9999,0,9999,0
1668410175986,CSE 293,029,119417,Sahoo; Debashis,9999,0,9999,0
1668410175986,CSE 293,030,119420,Saul; Lawrence,9999,0,9999,0
1668410175986,CSE 293,031,119421,Savage; Stefan,9999,0,9999,0
1668410175986,CSE 293,032,119425,Schulze; Jurgen P.,9999,0,9999,0
1668410175986,CSE 293,033,119426,Snoeren; Alex C.,9999,0,9999,0
1668410175986,CSE 293,034,119428,Shang; Jingbo,9999,0,9999,0
1668410175986,CSE 293,035,119430,Stefan; Deian,9999,0,9999,0
1668410175986,CSE 293,036,119431,Su; Hao,9999,0,9999,0
1668410175986,CSE 293,037,119433,Swanson; Steven James,9999,0,9999,0
1668410175986,CSE 293,038,119435,Tullsen; Dean Michael,9999,0,9999,0
1668410175986,CSE 293,039,119483,Voelker; Geoffrey M.,9999,0,9999,0
1668410175986,CSE 293,040,119537,Zhao; Jishen,9999,0,9999,0
1668410175986,CSE 293,041,119538,Zhou; Yuan-Yuan,9999,0,9999,0
1668410175986,CSE 293,042,119539,Gao; Sicun,9999,0,9999,0
1668410175986,CSE 293,043,119540,Weibel; Nadir,9999,0,9999,0
1668410175986,CSE 293,044,119541,Gupta; Rajesh K.,9999,0,9999,0
1668410175986,CSE 293,045,126410,Vaccaro; Kristen Marie,9999,0,9999,0
1668410175986,CSE 293,046,126411,Klemke; Richard,9999,0,9999,0
1668410176411,CSE 294,A00,102459,Voelker; Geoffrey M.,0,0,0,0
1668410176411,CSE 294,B00,111322,Orailoglu; Alex,0,0,0,0
1668410176835,DSE 201,A00,096914,Deutsch; Alin Bernard,30,0,30,0
1668410177257,DSE 210,A00,096915,Dasgupta; Sanjoy,30,0,30,0
1668410177690,DSE 260A,A00,096916,Altintas De Callaf; Ilkay,30,0,30,0
1668410178116,ECE 200,001,103586,Antipa; Nicholas A,9999,0,9999,0
1668410178116,ECE 200,002,103587,Atanasov; Nikolay A.,9999,0,9999,0
1668410178116,ECE 200,003,103588,Bharadia; Dinesh,9999,0,9999,0
1668410178116,ECE 200,004,103589,Cheng; Chung Kuan,9999,0,9999,0
1668410178116,ECE 200,005,103590,Cosman; Pamela C.,9999,0,9999,0
1668410178116,ECE 200,006,103591,Dayeh; Shadi Ahmad,9999,0,9999,0
1668410178116,ECE 200,007,103592,Fainman; Yeshaiahu,9999,0,9999,0
1668410178116,ECE 200,008,103593,Ford; Joseph Earl,9999,0,9999,0
1668410178116,ECE 200,009,103594,Franceschetti; Massimo,9999,0,9999,0
1668410178116,ECE 200,010,103595,Fullerton; Eric E,9999,0,9999,0
1668410178116,ECE 200,011,103596,Galton; Ian A,9999,0,9999,0
1668410178116,ECE 200,012,103597,Gilja; Vikash,9999,0,9999,0
1668410178116,ECE 200,013,103598,Hall; Drew A.,9999,0,9999,0
1668410178116,ECE 200,014,103599,Hsueh; Tzu-Chien,9999,0,9999,0
1668410178116,ECE 200,015,103600,Javidi; Tara,9999,0,9999,0
1668410178116,ECE 200,016,103601,Kahng; Andrew Byun,9999,0,9999,0
1668410178116,ECE 200,017,103602,Kim; Young-Han,9999,0,9999,0
1668410178116,ECE 200,018,103603,Koushanfar; Farinaz,9999,0,9999,0
1668410178116,ECE 200,019,103604,Kuzum; Duygu,9999,0,9999,0
1668410178116,ECE 200,020,103605,Le; Hanh-Phuc,9999,0,9999,0
1668410178116,ECE 200,021,103606,Lin; Bill,9999,0,9999,0
1668410178116,ECE 200,022,103607,Liu; Zhaowei,9998,0,9999,1
1668410178116,ECE 200,023,103608,Lo; Yu-Hwa,9999,0,9999,0
1668410178116,ECE 200,024,103609,Lomakin; Vitaliy,9999,0,9999,0
1668410178116,ECE 200,025,103610,Mercier; Patrick Philip,9999,0,9999,0
1668410178116,ECE 200,026,103611,Meyer; Florian,9999,0,9999,0
1668410178116,ECE 200,027,103612,Milstein; Laurence B.,9999,0,9999,0
1668410178116,ECE 200,028,103613,Mir Arabbaygi; Siavash,9999,0,9999,0
1668410178116,ECE 200,029,103614,Mookherjea; Shayan,9999,0,9999,0
1668410178116,ECE 200,030,103615,Morris; Karcher William,9999,0,9999,0
1668410178116,ECE 200,031,103616,Ng; Tse Nga,9999,0,9999,0
1668410178116,ECE 200,032,103617,Nguyen; Truong Quang,9999,0,9999,0
1668410178116,ECE 200,033,103618,Nomura; Kenji,9999,0,9999,0
1668410178116,ECE 200,034,103619,Orlitsky; Alon,9999,0,9999,0
1668410178116,ECE 200,035,103620,Pal; Piya,9999,0,9999,0
1668410178116,ECE 200,036,103621,Papen; George C.,9999,0,9999,0
1668410178116,ECE 200,037,103622,Radic; Stojan,9999,0,9999,0
1668410178116,ECE 200,038,103623,Rao; Bhaskar D.,9999,0,9999,0
1668410178116,ECE 200,039,103624,Rao; Ramesh R,9999,0,9999,0
1668410178116,ECE 200,040,103625,Rebeiz; Gabriel,9999,0,9999,0
1668410178116,ECE 200,041,103626,Sanford; John R,9999,0,9999,0
1668410178116,ECE 200,042,103627,Siegel; Paul H.,9999,0,9999,0
1668410178116,ECE 200,043,103628,Sievenpiper; Daniel F.,9999,0,9999,0
1668410178116,ECE 200,044,103629,Sworder; David D.,9999,0,9999,0
1668410178116,ECE 200,045,103630,Taur; Yuan,9999,0,9999,0
1668410178116,ECE 200,046,103631,Touri; Behrouz,9999,0,9999,0
1668410178116,ECE 200,047,103632,Trivedi; Mohan M.,9999,0,9999,0
1668410178116,ECE 200,048,103633,Vasconcelos; Nuno,9999,0,9999,0
1668410178116,ECE 200,049,103634,Wang; Xiaolong,9999,0,9999,0
1668410178116,ECE 200,050,103635,Xie; Pengtao,9999,0,9999,0
1668410178116,ECE 200,051,103636,Yip; Michael,9999,0,9999,0
1668410178116,ECE 200,052,103637,Zeger; Kenneth A.,999,0,999,0
1668410178116,ECE 200,053,103638,Zhang; Xinyu,9999,0,9999,0
1668410178116,ECE 200,054,103639,Turakhia; Yatish Girish,9999,0,9999,0
1668410178116,ECE 200,055,103640,Kang; Mingu,9999,0,9999,0
1668410178116,ECE 200,056,103641,Shi; Yuanyuan,9999,0,9999,0
1668410178116,ECE 200,057,103642,Wang; Edward Jay,9999,0,9999,0
1668410178116,ECE 200,058,103643,Zheng; Yang,9999,0,9999,0
1668410178542,ECE 202,A00,103644,Kuzum; Duygu,0,0,0,0
1668410178966,ECE 212BN,A00,103646,Ng; Tse Nga,0,0,0,0
1668410179390,ECE 221,A00,111493,Staff,0,0,0,0
1668410179816,ECE 222B,A00,103647,Lomakin; Vitaliy,0,0,0,0
1668410180239,ECE 230B,A00,103648,Taur; Yuan,0,0,0,0
1668410180662,ECE 238B,A00,103649,Garay; Javier,0,0,0,0
1668410181112,ECE 240B,A00,112900,Fainman; Yeshaiahu,0,0,0,0
1668410181537,ECE 247A,A00,103650,Jokerst; Jesse Vincent,0,0,0,0
1668410181959,ECE 247B,A00,103651,Wang; Joseph,0,0,0,0
1668410182387,ECE 250,A00,103652,Siegel; Paul H.,0,0,0,0
1668410182814,ECE 251A,A00,103654,Rao; Bhaskar D.,0,0,0,0
1668410183236,ECE 257B,A00,103655,Bharadia; Dinesh,0,0,0,0
1668410183660,ECE 258A,A00,103656,Milstein; Laurence B.,0,0,0,0
1668410184083,ECE 260B,A00,103658,Kang; Mingu,0,0,0,0
1668410184510,ECE 264A,A00,103659,Galton; Ian A,0,0,0,0
1668410184936,ECE 265A,A00,103661,Gudem; Prasad S.S.,0,0,0,0
1668410185362,ECE 265D,A00,103662,Gudem; Prasad S.S.,0,0,0,0
1668410185784,ECE 268,A00,103663,Koushanfar; Farinaz,0,0,0,0
1668410186211,ECE 269,A01,103665,Pal; Piya,0,0,0,0
1668410186634,ECE 271B,A00,103666,Vasconcelos; Manuela,0,0,0,0
1668410187058,ECE 276A,A00,103667,Atanasov; Nikolay A.,0,0,0,0
1668410187480,ECE 277,A00,103668,An; Cheolhong,0,0,0,0
1668410187903,ECE 279,A00,117947,Hall; Drew A.,0,0,0,0
1668410188753,ECE 283,A00,103670,Hsueh; Tzu-Chien,0,0,0,0
1668410189177,ECE 284,A00,103671,Turakhia; Yatish Girish,0,0,0,0
1668410189604,ECE 285,A00,103672,Zheng; Yang,0,0,0,0
1668410189604,ECE 285,B00,103673,Sworder; David D.,0,0,0,0
1668410190027,ECE 287,A00,103676,Javidi; Tara,0,0,0,0
1668410190470,MATH 200B,A00,098023,Salehi Golsefidy; Alireza,12,0,15,3
1668410190907,MATH 202B,A00,098024,Rhoades; Brendon Patrick,9,0,15,6
1668410191331,MATH 203B,A00,098025,Oprea; Dragos N.,10,0,15,5
1668410191756,MATH 204B,A00,098026,Sorensen; Claus M,13,0,15,2
1668410192178,MATH 208,A00,098027,Izadi; Elham,7,0,10,3
1668410192600,MATH 209,A00,098028,Pollack; Aaron,10,0,10,0
1668410193023,MATH 211A,A00,112919,Rogalski; Daniel,9,0,10,1
1668410193449,MATH 211B,A00,112920,Seward; Brandon M.,9,0,10,1
1668410193872,MATH 218,A00,098029,Li; Bo,10,0,10,0
1668410194294,MATH 220B,A00,098030,Novak; Jonathan I,11,0,15,4
1668410194719,MATH 221A,A00,098031,Ebenfelt; Peter F,13,0,15,2
1668410195151,MATH 231B,A00,098032,Zlatos; Andrej,12,0,15,3
1668410195575,MATH 240B,A00,098033,Ni; Lei,9,0,15,6
1668410196001,MATH 243,A00,098034,Jekel; David Andrew,10,0,10,0
1668410196426,MATH 245A,A00,098035,Nie; Jiawang,0,0,15,16
1668410196849,MATH 248,A00,098036,Bejenaru; Ioan,10,0,10,0
1668410197272,MATH 250B,A00,098037,Spolaor; Luca,14,0,15,1
1668410197698,MATH 258,A00,098038,Ni; Lei,10,0,10,0
1668410198123,MATH 264B,A00,098041,Rhoades; Brendon Patrick,9,0,15,6
1668410198550,MATH 268,A00,098042,Buss; Samuel R,10,0,10,0
1668410198973,MATH 269,A00,098043,Rhoades; Brendon Patrick,10,0,10,0
1668410199400,MATH 270B,A00,098044,Li; Bo,10,0,15,5
1668410199828,MATH 272B,A00,098045,Holst; Michael J,13,0,15,2
1668410200252,MATH 273A,A00,098046,Tian; Xiaochuan,10,0,15,5
1668410200678,MATH 275,A01,098048,Tian; Xiaochuan,6,0,10,4
1668410201107,MATH 278A,A00,098049,Holst; Michael J,8,0,10,2
1668410201529,MATH 278B,A00,098050,Cloninger; Alexander,10,0,10,0
1668410201953,MATH 278C,A00,098051,Nie; Jiawang,6,0,10,4
1668410202381,MATH 280B,A00,098052,Zheng; Tianyi,8,0,15,7
1668410202805,MATH 281B,A00,098053,Bradic; Jelena,0,0,15,15
1668410203231,MATH 282B,A00,098054,Arias-Castro; Ery,0,0,15,15
1668410203657,MATH 285,A00,098055,Fitzsimmons; Patrick J,0,0,15,17
1668410204094,MATH 287B,A00,098056,Arias-Castro; Ery,2,0,15,13
1668410204515,MATH 288,A00,098057,Agarwal; Pooja,9,0,10,1
1668410204515,MATH 288,B00,098058,Zhang; Danna,8,0,10,2
1668410204515,MATH 288,C00,098059,Williams; Ruth J,9,0,10,1
1668410204938,MATH 290B,A00,098060,Roberts; Justin Deritter,13,0,15,2
1668410205364,MATH 292,A00,098061,Belmont; Eva Kinoshita,10,0,10,0
1668410205792,MATH 295,A00,098062,Suk; Andrew Hoon,48,0,50,2
1668410206214,MATH 296,A00,098063,Novak; Jonathan I,20,0,20,0
1668410206646,MATH 297,001,098064,Gamst; Anthony Collins,9997,0,9999,2
1668410707957,COGS 205,A00,101395,Chiba; Andrea,19,0,20,1
1668410708393,COGS 210B,001,101404,Greene; Deanna Jacquelyn,9998,0,9999,1
1668410708393,COGS 210B,002,101417,Xia; Haijun,9999,0,9999,0
1668410708393,COGS 210B,003,101422,Nitz; Douglas A.,9999,0,9999,0
1668410708393,COGS 210B,004,101423,Hollan; James D.,9998,0,9999,1
1668410708393,COGS 210B,005,101424,Deak; Gedeon O.,9998,0,9999,1
1668410708393,COGS 210B,006,101425,Rossano; Federico,9999,0,9999,0
1668410708821,COGS 211B,A00,101427,Coulson; Seana M,9996,0,9999,3
1668410709244,COGS 220,A00,101428,Hollan; James D.,0,0,25,25
1668410709677,COGS 229,A00,101429,Dow; Steven P,18,0,25,7
1668410710103,COGS 230,A00,101430,Klemmer; Scott R,11,0,17,6
1668410710536,COGS 234,A00,101431,Xia; Haijun,1,0,25,24
1668410710961,COGS 260,A00,101432,Kiyonaga; Anastasia,21,0,25,4
1668410710961,COGS 260,B00,101433,Kirsh; David Joel,15,0,25,10
1668410711388,CSE 202,A00,102371,Impagliazzo; Russell,0,0,0,0
1668410711817,CSE 203B,A01,102373,Cheng; Chung Kuan,0,0,0,0
1668410712240,CSE 208,A00,102374,Micciancio; Daniele,0,0,0,0
1668410712665,CSE 209A,A00,112895,Impagliazzo; Russell,0,0,15,15
1668410713105,CSE 209B,A00,108005,Bellare; Mihir,0,0,0,0
1668410713529,CSE 210,A00,113163,Coblenz; Michael J,0,0,0,0
1668410713951,CSE 219,A00,106111,Dow; Steven P,0,0,20,20
1668410714375,CSE 221,A00,102376,Voelker; Geoffrey M.,0,0,0,0
1668410714799,CSE 224,A01,102378,Porter; George M,0,0,0,0
1668410715228,CSE 229A,A00,102379,Savage; Stefan,0,0,0,0
1668410715656,CSE 229C,A00,102380,Munyaka; Imani N. S.,0,0,0,0
1668410716079,CSE 232B,A00,102382,Deutsch; Alin Bernard,0,0,0,0
1668410716512,CSE 234,A01,112904,Kumar; Arun Kumar,0,0,0,0
1668410716937,CSE 237A,A00,102383,Rosing; Tajana Simunic,0,0,0,0
1668410717365,CSE 239A,A00,102384,Deutsch; Alin Bernard,0,0,0,0
1668410717789,CSE 239B,A00,102385,Polikarpova; Nadezhda,0,0,0,0
1668410718225,CSE 240A,A00,102386,Pannuto; Patrick William,0,0,0,0
1668410718658,CSE 240B,A00,102387,Zhao; Jishen,0,0,0,0
1668410719085,CSE 241A,A00,106406,Kang; Mingu,0,0,0,0
1668410719513,CSE 249B,A00,102388,Kahng; Andrew Byun,0,0,8,8
1668410719938,CSE 251B,A01,102392,Cottrell; Garrison W,0,0,0,0
1668410719938,CSE 251B,A02,102393,Cottrell; Garrison W,0,0,0,0
1668410720365,CSE 252B,A00,102394,Ochoa; Benjamin Lawrence,0,0,0,0
1668410720797,CSE 257,A01,102396,Gao; Sicun,0,0,0,0
1668410721219,CSE 272,A00,102397,Li; Tzumao,0,0,0,0
1668410721643,CSE 274,A00,111323,Chern; Albert Ren-Haur,0,0,0,0
1668410722076,CSE 282,A00,102398,Pevzner; Pavel Arkadjevich,0,0,0,0
1668410722506,CSE 284,A00,114175,Gymrek; Melissa Ann,0,0,0,0
1668410722931,CSE 290,A00,102399,Chandraker; Manmohan Krishna,0,0,0,0
1668410722931,CSE 290,B00,102400,Vaccaro; Kristen Marie,0,0,25,25
1668410722931,CSE 290,C00,102414,Pannuto; Patrick William,0,0,25,25
1668410722931,CSE 290,D00,102427,Pevzner; Pavel Arkadjevich,0,0,0,0
1668410722931,CSE 290,E00,102429,Zhao; Jishen,0,0,0,0
1668410722931,CSE 290,F00,102436,Tullsen; Dean Michael,0,0,0,0
1668410722931,CSE 290,G00,102440,Christensen; Henrik I,0,0,20,20
1668410723366,CSE 291,A00,102443,Su; Hao,0,0,0,0
1668410723366,CSE 291,B00,102448,Polikarpova; Nadezhda,0,0,0,0
1668410723366,CSE 291,C00,102453,Vaccaro; Kristen Marie,0,0,0,0
1668410723366,CSE 291,D00,111343,Savage; Stefan,0,0,0,0
1668410723366,CSE 291,E00,116474,Claffy; Kimberly Claire,0,0,0,0
1668410723366,CSE 291,F00,116479,Pasquale; Joseph,0,0,0,0
1668410723801,CSE 293,001,119111,Bafna; Vineet,9999,0,9999,0
1668410723801,CSE 293,002,119118,Bellare; Mihir,9999,0,9999,0
1668410723801,CSE 293,003,119122,Berg-Kirkpatrick; Taylor D,9999,0,9999,0
1668410723801,CSE 293,004,119135,Christensen; Henrik I,9999,0,9999,0
1668410723801,CSE 293,005,119142,Cottrell; Garrison W,9999,0,9999,0
1668410723801,CSE 293,006,119146,Deutsch; Alin Bernard,9999,0,9999,0
1668410723801,CSE 293,007,119159,Esmaeilzadeh; Hadi,9999,0,9999,0
1668410723801,CSE 293,008,119166,Freund; Yoav,9999,0,9999,0
1668410723801,CSE 293,009,119170,Griswold; William G.,9999,0,9999,0
1668410723801,CSE 293,010,119183,Gymrek; Melissa Ann,9999,0,9999,0
1668410723801,CSE 293,011,119190,Heninger; Nadia A,9999,0,9999,0
1668410723801,CSE 293,012,119230,Impagliazzo; Russell,9999,0,9999,0
1668410723801,CSE 293,013,119232,Jhala; Ranjit,9999,0,9999,0
1668410723801,CSE 293,014,119233,Kahng; Andrew Byun,9999,0,9999,0
1668410723801,CSE 293,015,119298,Kane; Daniel Mertz,9999,0,9999,0
1668410723801,CSE 293,016,119299,Kriegman; David J,9999,0,9999,0
1668410723801,CSE 293,017,119300,Kumar; Arun Kumar,9999,0,9999,0
1668410723801,CSE 293,018,119301,Lerner; Sorin,9999,0,9999,0
1668410723801,CSE 293,019,119302,Lovett; Shachar,9999,0,9999,0
1668410723801,CSE 293,020,119303,McAuley; Julian John,9999,0,9999,0
1668410723801,CSE 293,021,119304,Micciancio; Daniele,9999,0,9999,0
1668410723801,CSE 293,022,119367,Orailoglu; Alex,9999,0,9999,0
1668410723801,CSE 293,023,119382,Paturi; Ramamohan,9999,0,9999,0
1668410723801,CSE 293,024,119404,Polikarpova; Nadezhda,9999,0,9999,0
1668410723801,CSE 293,025,119406,Politz; Joseph Gibbs,9999,0,9999,0
1668410723801,CSE 293,026,119411,Porter; George M,9999,0,9999,0
1668410723801,CSE 293,027,119414,Porter; Leonard Emerson,9999,0,9999,0
1668410723801,CSE 293,028,119416,Ramamoorthi; Ravi,9999,0,9999,0
1668410723801,CSE 293,029,119417,Sahoo; Debashis,9999,0,9999,0
1668410723801,CSE 293,030,119420,Saul; Lawrence,9999,0,9999,0
1668410723801,CSE 293,031,119421,Savage; Stefan,9999,0,9999,0
1668410723801,CSE 293,032,119425,Schulze; Jurgen P.,9999,0,9999,0
1668410723801,CSE 293,033,119426,Snoeren; Alex C.,9999,0,9999,0
1668410723801,CSE 293,034,119428,Shang; Jingbo,9999,0,9999,0
1668410723801,CSE 293,035,119430,Stefan; Deian,9999,0,9999,0
1668410723801,CSE 293,036,119431,Su; Hao,9999,0,9999,0
1668410723801,CSE 293,037,119433,Swanson; Steven James,9999,0,9999,0
1668410723801,CSE 293,038,119435,Tullsen; Dean Michael,9999,0,9999,0
1668410723801,CSE 293,039,119483,Voelker; Geoffrey M.,9999,0,9999,0
1668410723801,CSE 293,040,119537,Zhao; Jishen,9999,0,9999,0
1668410723801,CSE 293,041,119538,Zhou; Yuan-Yuan,9999,0,9999,0
1668410723801,CSE 293,042,119539,Gao; Sicun,9999,0,9999,0
1668410723801,CSE 293,043,119540,Weibel; Nadir,9999,0,9999,0
1668410723801,CSE 293,044,119541,Gupta; Rajesh K.,9999,0,9999,0
1668410723801,CSE 293,045,126410,Vaccaro; Kristen Marie,9999,0,9999,0
1668410723801,CSE 293,046,126411,Klemke; Richard,9999,0,9999,0
1668410724237,CSE 294,A00,102459,Voelker; Geoffrey M.,0,0,0,0
1668410724237,CSE 294,B00,111322,Orailoglu; Alex,0,0,0,0
1668410724665,DSE 201,A00,096914,Deutsch; Alin Bernard,30,0,30,0
1668410725091,DSE 210,A00,096915,Dasgupta; Sanjoy,30,0,30,0
1668410725514,DSE 260A,A00,096916,Altintas De Callaf; Ilkay,30,0,30,0
1668410725944,ECE 200,001,103586,Antipa; Nicholas A,9999,0,9999,0
1668410725944,ECE 200,002,103587,Atanasov; Nikolay A.,9999,0,9999,0
1668410725944,ECE 200,003,103588,Bharadia; Dinesh,9999,0,9999,0
1668410725944,ECE 200,004,103589,Cheng; Chung Kuan,9999,0,9999,0
1668410725944,ECE 200,005,103590,Cosman; Pamela C.,9999,0,9999,0
1668410725944,ECE 200,006,103591,Dayeh; Shadi Ahmad,9999,0,9999,0
1668410725944,ECE 200,007,103592,Fainman; Yeshaiahu,9999,0,9999,0
1668410725944,ECE 200,008,103593,Ford; Joseph Earl,9999,0,9999,0
1668410725944,ECE 200,009,103594,Franceschetti; Massimo,9999,0,9999,0
1668410725944,ECE 200,010,103595,Fullerton; Eric E,9999,0,9999,0
1668410725944,ECE 200,011,103596,Galton; Ian A,9999,0,9999,0
1668410725944,ECE 200,012,103597,Gilja; Vikash,9999,0,9999,0
1668410725944,ECE 200,013,103598,Hall; Drew A.,9999,0,9999,0
1668410725944,ECE 200,014,103599,Hsueh; Tzu-Chien,9999,0,9999,0
1668410725944,ECE 200,015,103600,Javidi; Tara,9999,0,9999,0
1668410725944,ECE 200,016,103601,Kahng; Andrew Byun,9999,0,9999,0
1668410725944,ECE 200,017,103602,Kim; Young-Han,9999,0,9999,0
1668410725944,ECE 200,018,103603,Koushanfar; Farinaz,9999,0,9999,0
1668410725944,ECE 200,019,103604,Kuzum; Duygu,9999,0,9999,0
1668410725944,ECE 200,020,103605,Le; Hanh-Phuc,9999,0,9999,0
1668410725944,ECE 200,021,103606,Lin; Bill,9999,0,9999,0
1668410725944,ECE 200,022,103607,Liu; Zhaowei,9998,0,9999,1
1668410725944,ECE 200,023,103608,Lo; Yu-Hwa,9999,0,9999,0
1668410725944,ECE 200,024,103609,Lomakin; Vitaliy,9999,0,9999,0
1668410725944,ECE 200,025,103610,Mercier; Patrick Philip,9999,0,9999,0
1668410725944,ECE 200,026,103611,Meyer; Florian,9999,0,9999,0
1668410725944,ECE 200,027,103612,Milstein; Laurence B.,9999,0,9999,0
1668410725944,ECE 200,028,103613,Mir Arabbaygi; Siavash,9999,0,9999,0
1668410725944,ECE 200,029,103614,Mookherjea; Shayan,9999,0,9999,0
1668410725944,ECE 200,030,103615,Morris; Karcher William,9999,0,9999,0
1668410725944,ECE 200,031,103616,Ng; Tse Nga,9999,0,9999,0
1668410725944,ECE 200,032,103617,Nguyen; Truong Quang,9999,0,9999,0
1668410725944,ECE 200,033,103618,Nomura; Kenji,9999,0,9999,0
1668410725944,ECE 200,034,103619,Orlitsky; Alon,9999,0,9999,0
1668410725944,ECE 200,035,103620,Pal; Piya,9999,0,9999,0
1668410725944,ECE 200,036,103621,Papen; George C.,9999,0,9999,0
1668410725944,ECE 200,037,103622,Radic; Stojan,9999,0,9999,0
1668410725944,ECE 200,038,103623,Rao; Bhaskar D.,9999,0,9999,0
1668410725944,ECE 200,039,103624,Rao; Ramesh R,9999,0,9999,0
1668410725944,ECE 200,040,103625,Rebeiz; Gabriel,9999,0,9999,0
1668410725944,ECE 200,041,103626,Sanford; John R,9999,0,9999,0
1668410725944,ECE 200,042,103627,Siegel; Paul H.,9999,0,9999,0
1668410725944,ECE 200,043,103628,Sievenpiper; Daniel F.,9999,0,9999,0
1668410725944,ECE 200,044,103629,Sworder; David D.,9999,0,9999,0
1668410725944,ECE 200,045,103630,Taur; Yuan,9999,0,9999,0
1668410725944,ECE 200,046,103631,Touri; Behrouz,9999,0,9999,0
1668410725944,ECE 200,047,103632,Trivedi; Mohan M.,9999,0,9999,0
1668410725944,ECE 200,048,103633,Vasconcelos; Nuno,9999,0,9999,0
1668410725944,ECE 200,049,103634,Wang; Xiaolong,9999,0,9999,0
1668410725944,ECE 200,050,103635,Xie; Pengtao,9999,0,9999,0
1668410725944,ECE 200,051,103636,Yip; Michael,9999,0,9999,0
1668410725944,ECE 200,052,103637,Zeger; Kenneth A.,999,0,999,0
1668410725944,ECE 200,053,103638,Zhang; Xinyu,9999,0,9999,0
1668410725944,ECE 200,054,103639,Turakhia; Yatish Girish,9999,0,9999,0
1668410725944,ECE 200,055,103640,Kang; Mingu,9999,0,9999,0
1668410725944,ECE 200,056,103641,Shi; Yuanyuan,9999,0,9999,0
1668410725944,ECE 200,057,103642,Wang; Edward Jay,9999,0,9999,0
1668410725944,ECE 200,058,103643,Zheng; Yang,9999,0,9999,0
1668410726368,ECE 202,A00,103644,Kuzum; Duygu,0,0,0,0
1668410726796,ECE 212BN,A00,103646,Ng; Tse Nga,0,0,0,0
1668410727234,ECE 221,A00,111493,Staff,0,0,0,0
1668410727656,ECE 222B,A00,103647,Lomakin; Vitaliy,0,0,0,0
1668410728100,ECE 230B,A00,103648,Taur; Yuan,0,0,0,0
1668410728535,ECE 238B,A00,103649,Garay; Javier,0,0,0,0
1668410728965,ECE 240B,A00,112900,Fainman; Yeshaiahu,0,0,0,0
1668410729399,ECE 247A,A00,103650,Jokerst; Jesse Vincent,0,0,0,0
1668410729824,ECE 247B,A00,103651,Wang; Joseph,0,0,0,0
1668410730249,ECE 250,A00,103652,Siegel; Paul H.,0,0,0,0
1668410730674,ECE 251A,A00,103654,Rao; Bhaskar D.,0,0,0,0
1668410731098,ECE 257B,A00,103655,Bharadia; Dinesh,0,0,0,0
1668410731525,ECE 258A,A00,103656,Milstein; Laurence B.,0,0,0,0
1668410731950,ECE 260B,A00,103658,Kang; Mingu,0,0,0,0
1668410732374,ECE 264A,A00,103659,Galton; Ian A,0,0,0,0
1668410732811,ECE 265A,A00,103661,Gudem; Prasad S.S.,0,0,0,0
1668410733247,ECE 265D,A00,103662,Gudem; Prasad S.S.,0,0,0,0
1668410733682,ECE 268,A00,103663,Koushanfar; Farinaz,0,0,0,0
1668410734109,ECE 269,A01,103665,Pal; Piya,0,0,0,0
1668410734535,ECE 271B,A00,103666,Vasconcelos; Manuela,0,0,0,0
1668410734959,ECE 276A,A00,103667,Atanasov; Nikolay A.,0,0,0,0
1668410735383,ECE 277,A00,103668,An; Cheolhong,0,0,0,0
1668410735807,ECE 279,A00,117947,Hall; Drew A.,0,0,0,0
1668410736747,ECE 283,A00,103670,Hsueh; Tzu-Chien,0,0,0,0
1668410737175,ECE 284,A00,103671,Turakhia; Yatish Girish,0,0,0,0
1668410737603,ECE 285,A00,103672,Zheng; Yang,0,0,0,0
1668410737603,ECE 285,B00,103673,Sworder; David D.,0,0,0,0
1668410738026,ECE 287,A00,103676,Javidi; Tara,0,0,0,0
1668410738455,MATH 200B,A00,098023,Salehi Golsefidy; Alireza,12,0,15,3
1668410738879,MATH 202B,A00,098024,Rhoades; Brendon Patrick,9,0,15,6
1668410739311,MATH 203B,A00,098025,Oprea; Dragos N.,10,0,15,5
1668410739734,MATH 204B,A00,098026,Sorensen; Claus M,13,0,15,2
1668410740162,MATH 208,A00,098027,Izadi; Elham,7,0,10,3
1668410740601,MATH 209,A00,098028,Pollack; Aaron,10,0,10,0
1668410741026,MATH 211A,A00,112919,Rogalski; Daniel,9,0,10,1
1668410741448,MATH 211B,A00,112920,Seward; Brandon M.,9,0,10,1
1668410741870,MATH 218,A00,098029,Li; Bo,10,0,10,0
1668410742303,MATH 220B,A00,098030,Novak; Jonathan I,11,0,15,4
1668410742726,MATH 221A,A00,098031,Ebenfelt; Peter F,13,0,15,2
1668410743154,MATH 231B,A00,098032,Zlatos; Andrej,12,0,15,3
1668410743579,MATH 240B,A00,098033,Ni; Lei,9,0,15,6
1668410744006,MATH 243,A00,098034,Jekel; David Andrew,10,0,10,0
1668410744435,MATH 245A,A00,098035,Nie; Jiawang,0,0,15,16
1668410744861,MATH 248,A00,098036,Bejenaru; Ioan,10,0,10,0
1668410745289,MATH 250B,A00,098037,Spolaor; Luca,14,0,15,1
1668410745722,MATH 258,A00,098038,Ni; Lei,10,0,10,0
1668410746149,MATH 264B,A00,098041,Rhoades; Brendon Patrick,9,0,15,6
1668410746574,MATH 268,A00,098042,Buss; Samuel R,10,0,10,0
1668410747009,MATH 269,A00,098043,Rhoades; Brendon Patrick,10,0,10,0
1668410747450,MATH 270B,A00,098044,Li; Bo,10,0,15,5
1668410747877,MATH 272B,A00,098045,Holst; Michael J,13,0,15,2
1668410748301,MATH 273A,A00,098046,Tian; Xiaochuan,10,0,15,5
1668410748734,MATH 275,A01,098048,Tian; Xiaochuan,6,0,10,4
1668410749162,MATH 278A,A00,098049,Holst; Michael J,8,0,10,2
1668410749585,MATH 278B,A00,098050,Cloninger; Alexander,10,0,10,0
1668410750009,MATH 278C,A00,098051,Nie; Jiawang,6,0,10,4
1668410750452,MATH 280B,A00,098052,Zheng; Tianyi,8,0,15,7
1668410750887,MATH 281B,A00,098053,Bradic; Jelena,0,0,15,15
1668410751329,MATH 282B,A00,098054,Arias-Castro; Ery,0,0,15,15
1668410751752,MATH 285,A00,098055,Fitzsimmons; Patrick J,0,0,15,17
1668410752182,MATH 287B,A00,098056,Arias-Castro; Ery,2,0,15,13
1668410752607,MATH 288,A00,098057,Agarwal; Pooja,9,0,10,1
1668410752607,MATH 288,B00,098058,Zhang; Danna,8,0,10,2
1668410752607,MATH 288,C00,098059,Williams; Ruth J,9,0,10,1
1668410753048,MATH 290B,A00,098060,Roberts; Justin Deritter,13,0,15,2
1668410753473,MATH 292,A00,098061,Belmont; Eva Kinoshita,10,0,10,0
1668410753896,MATH 295,A00,098062,Suk; Andrew Hoon,48,0,50,2
1668410754320,MATH 296,A00,098063,Novak; Jonathan I,20,0,20,0
1668410754745,MATH 297,001,098064,Gamst; Anthony Collins,9997,0,9999,2
1668411255212,COGS 205,A00,101395,Chiba; Andrea,19,0,20,1
1668411255646,COGS 210B,001,101404,Greene; Deanna Jacquelyn,9998,0,9999,1
1668411255646,COGS 210B,002,101417,Xia; Haijun,9999,0,9999,0
1668411255646,COGS 210B,003,101422,Nitz; Douglas A.,9999,0,9999,0
1668411255646,COGS 210B,004,101423,Hollan; James D.,9998,0,9999,1
1668411255646,COGS 210B,005,101424,Deak; Gedeon O.,9998,0,9999,1
1668411255646,COGS 210B,006,101425,Rossano; Federico,9999,0,9999,0
1668411256071,COGS 211B,A00,101427,Coulson; Seana M,9996,0,9999,3
1668411256505,COGS 220,A00,101428,Hollan; James D.,0,0,25,25
1668411257019,COGS 229,A00,101429,Dow; Steven P,18,0,25,7
1668411257445,COGS 230,A00,101430,Klemmer; Scott R,11,0,17,6
1668411257882,COGS 234,A00,101431,Xia; Haijun,1,0,25,24
1668411258306,COGS 260,A00,101432,Kiyonaga; Anastasia,21,0,25,4
1668411258306,COGS 260,B00,101433,Kirsh; David Joel,15,0,25,10
1668411258729,CSE 202,A00,102371,Impagliazzo; Russell,0,0,0,0
1668411259151,CSE 203B,A01,102373,Cheng; Chung Kuan,0,0,0,0
1668411259577,CSE 208,A00,102374,Micciancio; Daniele,0,0,0,0
1668411260002,CSE 209A,A00,112895,Impagliazzo; Russell,0,0,15,15
1668411260425,CSE 209B,A00,108005,Bellare; Mihir,0,0,0,0
1668411260857,CSE 210,A00,113163,Coblenz; Michael J,0,0,0,0
1668411261280,CSE 219,A00,106111,Dow; Steven P,0,0,20,20
1668411261702,CSE 221,A00,102376,Voelker; Geoffrey M.,0,0,0,0
1668411262127,CSE 224,A01,102378,Porter; George M,0,0,0,0
1668411262556,CSE 229A,A00,102379,Savage; Stefan,0,0,0,0
1668411262980,CSE 229C,A00,102380,Munyaka; Imani N. S.,0,0,0,0
1668411263406,CSE 232B,A00,102382,Deutsch; Alin Bernard,0,0,0,0
1668411263829,CSE 234,A01,112904,Kumar; Arun Kumar,0,0,0,0
1668411264253,CSE 237A,A00,102383,Rosing; Tajana Simunic,0,0,0,0
1668411264678,CSE 239A,A00,102384,Deutsch; Alin Bernard,0,0,0,0
1668411265105,CSE 239B,A00,102385,Polikarpova; Nadezhda,0,0,0,0
1668411265528,CSE 240A,A00,102386,Pannuto; Patrick William,0,0,0,0
1668411265967,CSE 240B,A00,102387,Zhao; Jishen,0,0,0,0
1668411266390,CSE 241A,A00,106406,Kang; Mingu,0,0,0,0
1668411266813,CSE 249B,A00,102388,Kahng; Andrew Byun,0,0,8,8
1668411267247,CSE 251B,A01,102392,Cottrell; Garrison W,0,0,0,0
1668411267247,CSE 251B,A02,102393,Cottrell; Garrison W,0,0,0,0
1668411267685,CSE 252B,A00,102394,Ochoa; Benjamin Lawrence,0,0,0,0
1668411268107,CSE 257,A01,102396,Gao; Sicun,0,0,0,0
1668411268531,CSE 272,A00,102397,Li; Tzumao,0,0,0,0
1668411268953,CSE 274,A00,111323,Chern; Albert Ren-Haur,0,0,0,0
1668411269380,CSE 282,A00,102398,Pevzner; Pavel Arkadjevich,0,0,0,0
1668411269803,CSE 284,A00,114175,Gymrek; Melissa Ann,0,0,0,0
1668411270230,CSE 290,A00,102399,Chandraker; Manmohan Krishna,0,0,0,0
1668411270230,CSE 290,B00,102400,Vaccaro; Kristen Marie,0,0,25,25
1668411270230,CSE 290,C00,102414,Pannuto; Patrick William,0,0,25,25
1668411270230,CSE 290,D00,102427,Pevzner; Pavel Arkadjevich,0,0,0,0
1668411270230,CSE 290,E00,102429,Zhao; Jishen,0,0,0,0
1668411270230,CSE 290,F00,102436,Tullsen; Dean Michael,0,0,0,0
1668411270230,CSE 290,G00,102440,Christensen; Henrik I,0,0,20,20
1668411270654,CSE 291,A00,102443,Su; Hao,0,0,0,0
1668411270654,CSE 291,B00,102448,Polikarpova; Nadezhda,0,0,0,0
1668411270654,CSE 291,C00,102453,Vaccaro; Kristen Marie,0,0,0,0
1668411270654,CSE 291,D00,111343,Savage; Stefan,0,0,0,0
1668411270654,CSE 291,E00,116474,Claffy; Kimberly Claire,0,0,0,0
1668411270654,CSE 291,F00,116479,Pasquale; Joseph,0,0,0,0
1668411271082,CSE 293,001,119111,Bafna; Vineet,9999,0,9999,0
1668411271082,CSE 293,002,119118,Bellare; Mihir,9999,0,9999,0
1668411271082,CSE 293,003,119122,Berg-Kirkpatrick; Taylor D,9999,0,9999,0
1668411271082,CSE 293,004,119135,Christensen; Henrik I,9999,0,9999,0
1668411271082,CSE 293,005,119142,Cottrell; Garrison W,9999,0,9999,0
1668411271082,CSE 293,006,119146,Deutsch; Alin Bernard,9999,0,9999,0
1668411271082,CSE 293,007,119159,Esmaeilzadeh; Hadi,9999,0,9999,0
1668411271082,CSE 293,008,119166,Freund; Yoav,9999,0,9999,0
1668411271082,CSE 293,009,119170,Griswold; William G.,9999,0,9999,0
1668411271082,CSE 293,010,119183,Gymrek; Melissa Ann,9999,0,9999,0
1668411271082,CSE 293,011,119190,Heninger; Nadia A,9999,0,9999,0
1668411271082,CSE 293,012,119230,Impagliazzo; Russell,9999,0,9999,0
1668411271082,CSE 293,013,119232,Jhala; Ranjit,9999,0,9999,0
1668411271082,CSE 293,014,119233,Kahng; Andrew Byun,9999,0,9999,0
1668411271082,CSE 293,015,119298,Kane; Daniel Mertz,9999,0,9999,0
1668411271082,CSE 293,016,119299,Kriegman; David J,9999,0,9999,0
1668411271082,CSE 293,017,119300,Kumar; Arun Kumar,9999,0,9999,0
1668411271082,CSE 293,018,119301,Lerner; Sorin,9999,0,9999,0
1668411271082,CSE 293,019,119302,Lovett; Shachar,9999,0,9999,0
1668411271082,CSE 293,020,119303,McAuley; Julian John,9999,0,9999,0
1668411271082,CSE 293,021,119304,Micciancio; Daniele,9999,0,9999,0
1668411271082,CSE 293,022,119367,Orailoglu; Alex,9999,0,9999,0
1668411271082,CSE 293,023,119382,Paturi; Ramamohan,9999,0,9999,0
1668411271082,CSE 293,024,119404,Polikarpova; Nadezhda,9999,0,9999,0
1668411271082,CSE 293,025,119406,Politz; Joseph Gibbs,9999,0,9999,0
1668411271082,CSE 293,026,119411,Porter; George M,9999,0,9999,0
1668411271082,CSE 293,027,119414,Porter; Leonard Emerson,9999,0,9999,0
1668411271082,CSE 293,028,119416,Ramamoorthi; Ravi,9999,0,9999,0
1668411271082,CSE 293,029,119417,Sahoo; Debashis,9999,0,9999,0
1668411271082,CSE 293,030,119420,Saul; Lawrence,9999,0,9999,0
1668411271082,CSE 293,031,119421,Savage; Stefan,9999,0,9999,0
1668411271082,CSE 293,032,119425,Schulze; Jurgen P.,9999,0,9999,0
1668411271082,CSE 293,033,119426,Snoeren; Alex C.,9999,0,9999,0
1668411271082,CSE 293,034,119428,Shang; Jingbo,9999,0,9999,0
1668411271082,CSE 293,035,119430,Stefan; Deian,9999,0,9999,0
1668411271082,CSE 293,036,119431,Su; Hao,9999,0,9999,0
1668411271082,CSE 293,037,119433,Swanson; Steven James,9999,0,9999,0
1668411271082,CSE 293,038,119435,Tullsen; Dean Michael,9999,0,9999,0
1668411271082,CSE 293,039,119483,Voelker; Geoffrey M.,9999,0,9999,0
1668411271082,CSE 293,040,119537,Zhao; Jishen,9999,0,9999,0
1668411271082,CSE 293,041,119538,Zhou; Yuan-Yuan,9999,0,9999,0
1668411271082,CSE 293,042,119539,Gao; Sicun,9999,0,9999,0
1668411271082,CSE 293,043,119540,Weibel; Nadir,9999,0,9999,0
1668411271082,CSE 293,044,119541,Gupta; Rajesh K.,9999,0,9999,0
1668411271082,CSE 293,045,126410,Vaccaro; Kristen Marie,9999,0,9999,0
1668411271082,CSE 293,046,126411,Klemke; Richard,9999,0,9999,0
1668411271506,CSE 294,A00,102459,Voelker; Geoffrey M.,0,0,0,0
1668411271506,CSE 294,B00,111322,Orailoglu; Alex,0,0,0,0
1668411271934,DSE 201,A00,096914,Deutsch; Alin Bernard,30,0,30,0
1668411272356,DSE 210,A00,096915,Dasgupta; Sanjoy,30,0,30,0
1668411272779,DSE 260A,A00,096916,Altintas De Callaf; Ilkay,30,0,30,0
1668411273248,ECE 200,001,103586,Antipa; Nicholas A,9999,0,9999,0
1668411273248,ECE 200,002,103587,Atanasov; Nikolay A.,9999,0,9999,0
1668411273248,ECE 200,003,103588,Bharadia; Dinesh,9999,0,9999,0
1668411273248,ECE 200,004,103589,Cheng; Chung Kuan,9999,0,9999,0
1668411273248,ECE 200,005,103590,Cosman; Pamela C.,9999,0,9999,0
1668411273248,ECE 200,006,103591,Dayeh; Shadi Ahmad,9999,0,9999,0
1668411273248,ECE 200,007,103592,Fainman; Yeshaiahu,9999,0,9999,0
1668411273248,ECE 200,008,103593,Ford; Joseph Earl,9999,0,9999,0
1668411273248,ECE 200,009,103594,Franceschetti; Massimo,9999,0,9999,0
1668411273248,ECE 200,010,103595,Fullerton; Eric E,9999,0,9999,0
1668411273248,ECE 200,011,103596,Galton; Ian A,9999,0,9999,0
1668411273248,ECE 200,012,103597,Gilja; Vikash,9999,0,9999,0
1668411273248,ECE 200,013,103598,Hall; Drew A.,9999,0,9999,0
1668411273248,ECE 200,014,103599,Hsueh; Tzu-Chien,9999,0,9999,0
1668411273248,ECE 200,015,103600,Javidi; Tara,9999,0,9999,0
1668411273248,ECE 200,016,103601,Kahng; Andrew Byun,9999,0,9999,0
1668411273248,ECE 200,017,103602,Kim; Young-Han,9999,0,9999,0
1668411273248,ECE 200,018,103603,Koushanfar; Farinaz,9999,0,9999,0
1668411273248,ECE 200,019,103604,Kuzum; Duygu,9999,0,9999,0
1668411273248,ECE 200,020,103605,Le; Hanh-Phuc,9999,0,9999,0
1668411273248,ECE 200,021,103606,Lin; Bill,9999,0,9999,0
1668411273248,ECE 200,022,103607,Liu; Zhaowei,9998,0,9999,1
1668411273248,ECE 200,023,103608,Lo; Yu-Hwa,9999,0,9999,0
1668411273248,ECE 200,024,103609,Lomakin; Vitaliy,9999,0,9999,0
1668411273248,ECE 200,025,103610,Mercier; Patrick Philip,9999,0,9999,0
1668411273248,ECE 200,026,103611,Meyer; Florian,9999,0,9999,0
1668411273248,ECE 200,027,103612,Milstein; Laurence B.,9999,0,9999,0
1668411273248,ECE 200,028,103613,Mir Arabbaygi; Siavash,9999,0,9999,0
1668411273248,ECE 200,029,103614,Mookherjea; Shayan,9999,0,9999,0
1668411273248,ECE 200,030,103615,Morris; Karcher William,9999,0,9999,0
1668411273248,ECE 200,031,103616,Ng; Tse Nga,9999,0,9999,0
1668411273248,ECE 200,032,103617,Nguyen; Truong Quang,9999,0,9999,0
1668411273248,ECE 200,033,103618,Nomura; Kenji,9999,0,9999,0
1668411273248,ECE 200,034,103619,Orlitsky; Alon,9999,0,9999,0
1668411273248,ECE 200,035,103620,Pal; Piya,9999,0,9999,0
1668411273248,ECE 200,036,103621,Papen; George C.,9999,0,9999,0
1668411273248,ECE 200,037,103622,Radic; Stojan,9999,0,9999,0
1668411273248,ECE 200,038,103623,Rao; Bhaskar D.,9999,0,9999,0
1668411273248,ECE 200,039,103624,Rao; Ramesh R,9999,0,9999,0
1668411273248,ECE 200,040,103625,Rebeiz; Gabriel,9999,0,9999,0
1668411273248,ECE 200,041,103626,Sanford; John R,9999,0,9999,0
1668411273248,ECE 200,042,103627,Siegel; Paul H.,9999,0,9999,0
1668411273248,ECE 200,043,103628,Sievenpiper; Daniel F.,9999,0,9999,0
1668411273248,ECE 200,044,103629,Sworder; David D.,9999,0,9999,0
1668411273248,ECE 200,045,103630,Taur; Yuan,9999,0,9999,0
1668411273248,ECE 200,046,103631,Touri; Behrouz,9999,0,9999,0
1668411273248,ECE 200,047,103632,Trivedi; Mohan M.,9999,0,9999,0
1668411273248,ECE 200,048,103633,Vasconcelos; Nuno,9999,0,9999,0
1668411273248,ECE 200,049,103634,Wang; Xiaolong,9999,0,9999,0
1668411273248,ECE 200,050,103635,Xie; Pengtao,9999,0,9999,0
1668411273248,ECE 200,051,103636,Yip; Michael,9999,0,9999,0
1668411273248,ECE 200,052,103637,Zeger; Kenneth A.,999,0,999,0
1668411273248,ECE 200,053,103638,Zhang; Xinyu,9999,0,9999,0
1668411273248,ECE 200,054,103639,Turakhia; Yatish Girish,9999,0,9999,0
1668411273248,ECE 200,055,103640,Kang; Mingu,9999,0,9999,0
1668411273248,ECE 200,056,103641,Shi; Yuanyuan,9999,0,9999,0
1668411273248,ECE 200,057,103642,Wang; Edward Jay,9999,0,9999,0
1668411273248,ECE 200,058,103643,Zheng; Yang,9999,0,9999,0
1668411273674,ECE 202,A00,103644,Kuzum; Duygu,0,0,0,0
1668411274098,ECE 212BN,A00,103646,Ng; Tse Nga,0,0,0,0
1668411274523,ECE 221,A00,111493,Staff,0,0,0,0
1668411274945,ECE 222B,A00,103647,Lomakin; Vitaliy,0,0,0,0
1668411275369,ECE 230B,A00,103648,Taur; Yuan,0,0,0,0
1668411275791,ECE 238B,A00,103649,Garay; Javier,0,0,0,0
1668411276218,ECE 240B,A00,112900,Fainman; Yeshaiahu,0,0,0,0
1668411276642,ECE 247A,A00,103650,Jokerst; Jesse Vincent,0,0,0,0
1668411277064,ECE 247B,A00,103651,Wang; Joseph,0,0,0,0
1668411277487,ECE 250,A00,103652,Siegel; Paul H.,0,0,0,0
1668411277911,ECE 251A,A00,103654,Rao; Bhaskar D.,0,0,0,0
1668411278334,ECE 257B,A00,103655,Bharadia; Dinesh,0,0,0,0
1668411278758,ECE 258A,A00,103656,Milstein; Laurence B.,0,0,0,0
1668411279180,ECE 260B,A00,103658,Kang; Mingu,0,0,0,0
1668411279606,ECE 264A,A00,103659,Galton; Ian A,0,0,0,0
1668411280028,ECE 265A,A00,103661,Gudem; Prasad S.S.,0,0,0,0
1668411280453,ECE 265D,A00,103662,Gudem; Prasad S.S.,0,0,0,0
1668411280876,ECE 268,A00,103663,Koushanfar; Farinaz,0,0,0,0
1668411281304,ECE 269,A01,103665,Pal; Piya,0,0,0,0
1668411281731,ECE 271B,A00,103666,Vasconcelos; Manuela,0,0,0,0
1668411282154,ECE 276A,A00,103667,Atanasov; Nikolay A.,0,0,0,0
1668411282581,ECE 277,A00,103668,An; Cheolhong,0,0,0,0
1668411283005,ECE 279,A00,117947,Hall; Drew A.,0,0,0,0
1668411283871,ECE 283,A00,103670,Hsueh; Tzu-Chien,0,0,0,0
1668411284298,ECE 284,A00,103671,Turakhia; Yatish Girish,0,0,0,0
1668411284732,ECE 285,A00,103672,Zheng; Yang,0,0,0,0
1668411284732,ECE 285,B00,103673,Sworder; David D.,0,0,0,0
1668411285162,ECE 287,A00,103676,Javidi; Tara,0,0,0,0
1668411285598,MATH 200B,A00,098023,Salehi Golsefidy; Alireza,12,0,15,3
1668411286031,MATH 202B,A00,098024,Rhoades; Brendon Patrick,9,0,15,6
1668411286455,MATH 203B,A00,098025,Oprea; Dragos N.,10,0,15,5
1668411286879,MATH 204B,A00,098026,Sorensen; Claus M,13,0,15,2
1668411287306,MATH 208,A00,098027,Izadi; Elham,7,0,10,3
1668411287729,MATH 209,A00,098028,Pollack; Aaron,10,0,10,0
1668411288170,MATH 211A,A00,112919,Rogalski; Daniel,9,0,10,1
1668411288594,MATH 211B,A00,112920,Seward; Brandon M.,9,0,10,1
1668411289017,MATH 218,A00,098029,Li; Bo,10,0,10,0
1668411289443,MATH 220B,A00,098030,Novak; Jonathan I,11,0,15,4
1668411289884,MATH 221A,A00,098031,Ebenfelt; Peter F,13,0,15,2
1668411290307,MATH 231B,A00,098032,Zlatos; Andrej,12,0,15,3
1668411290731,MATH 240B,A00,098033,Ni; Lei,9,0,15,6
1668411291167,MATH 243,A00,098034,Jekel; David Andrew,10,0,10,0
1668411291595,MATH 245A,A00,098035,Nie; Jiawang,0,0,15,16
1668411292021,MATH 248,A00,098036,Bejenaru; Ioan,10,0,10,0
1668411292445,MATH 250B,A00,098037,Spolaor; Luca,14,0,15,1
1668411292870,MATH 258,A00,098038,Ni; Lei,10,0,10,0
1668411293293,MATH 264B,A00,098041,Rhoades; Brendon Patrick,9,0,15,6
1668411293716,MATH 268,A00,098042,Buss; Samuel R,10,0,10,0
1668411294142,MATH 269,A00,098043,Rhoades; Brendon Patrick,10,0,10,0
1668411294569,MATH 270B,A00,098044,Li; Bo,10,0,15,5
1668411294995,MATH 272B,A00,098045,Holst; Michael J,13,0,15,2
1668411295418,MATH 273A,A00,098046,Tian; Xiaochuan,10,0,15,5
1668411295843,MATH 275,A01,098048,Tian; Xiaochuan,6,0,10,4
1668411296266,MATH 278A,A00,098049,Holst; Michael J,8,0,10,2
1668411296693,MATH 278B,A00,098050,Cloninger; Alexander,10,0,10,0
1668411297117,MATH 278C,A00,098051,Nie; Jiawang,6,0,10,4
1668411297553,MATH 280B,A00,098052,Zheng; Tianyi,8,0,15,7
1668411297977,MATH 281B,A00,098053,Bradic; Jelena,0,0,15,15
1668411298404,MATH 282B,A00,098054,Arias-Castro; Ery,0,0,15,15
1668411298829,MATH 285,A00,098055,Fitzsimmons; Patrick J,0,0,15,17
1668411299256,MATH 287B,A00,098056,Arias-Castro; Ery,2,0,15,13
1668411299690,MATH 288,A00,098057,Agarwal; Pooja,9,0,10,1
1668411299690,MATH 288,B00,098058,Zhang; Danna,8,0,10,2
1668411299690,MATH 288,C00,098059,Williams; Ruth J,9,0,10,1
1668411300193,MATH 290B,A00,098060,Roberts; Justin Deritter,13,0,15,2
1668411300615,MATH 292,A00,098061,Belmont; Eva Kinoshita,10,0,10,0
1668411301039,MATH 295,A00,098062,Suk; Andrew Hoon,48,0,50,2
1668411301472,MATH 296,A00,098063,Novak; Jonathan I,20,0,20,0
1668411301897,MATH 297,001,098064,Gamst; Anthony Collins,9997,0,9999,2
1668411802115,COGS 205,A00,101395,Chiba; Andrea,19,0,20,1
1668411802541,COGS 210B,001,101404,Greene; Deanna Jacquelyn,9998,0,9999,1
1668411802541,COGS 210B,002,101417,Xia; Haijun,9999,0,9999,0
1668411802541,COGS 210B,003,101422,Nitz; Douglas A.,9999,0,9999,0
1668411802541,COGS 210B,004,101423,Hollan; James D.,9998,0,9999,1
1668411802541,COGS 210B,005,101424,Deak; Gedeon O.,9998,0,9999,1
1668411802541,COGS 210B,006,101425,Rossano; Federico,9999,0,9999,0
1668411802976,COGS 211B,A00,101427,Coulson; Seana M,9996,0,9999,3
1668411803401,COGS 220,A00,101428,Hollan; James D.,0,0,25,25
1668411803827,COGS 229,A00,101429,Dow; Steven P,18,0,25,7
1668411804249,COGS 230,A00,101430,Klemmer; Scott R,11,0,17,6
1668411804675,COGS 234,A00,101431,Xia; Haijun,1,0,25,24
1668411805113,COGS 260,A00,101432,Kiyonaga; Anastasia,21,0,25,4
1668411805113,COGS 260,B00,101433,Kirsh; David Joel,15,0,25,10
1668411805536,CSE 202,A00,102371,Impagliazzo; Russell,0,0,0,0
1668411805962,CSE 203B,A01,102373,Cheng; Chung Kuan,0,0,0,0
1668411806387,CSE 208,A00,102374,Micciancio; Daniele,0,0,0,0
1668411806810,CSE 209A,A00,112895,Impagliazzo; Russell,0,0,15,15
1668411807238,CSE 209B,A00,108005,Bellare; Mihir,0,0,0,0
1668411807661,CSE 210,A00,113163,Coblenz; Michael J,0,0,0,0
1668411808083,CSE 219,A00,106111,Dow; Steven P,0,0,20,20
1668411808511,CSE 221,A00,102376,Voelker; Geoffrey M.,0,0,0,0
1668411808938,CSE 224,A01,102378,Porter; George M,0,0,0,0
1668411809370,CSE 229A,A00,102379,Savage; Stefan,0,0,0,0
1668411809794,CSE 229C,A00,102380,Munyaka; Imani N. S.,0,0,0,0
1668411810218,CSE 232B,A00,102382,Deutsch; Alin Bernard,0,0,0,0
1668411810647,CSE 234,A01,112904,Kumar; Arun Kumar,0,0,0,0
1668411811069,CSE 237A,A00,102383,Rosing; Tajana Simunic,0,0,0,0
1668411811495,CSE 239A,A00,102384,Deutsch; Alin Bernard,0,0,0,0
1668411811920,CSE 239B,A00,102385,Polikarpova; Nadezhda,0,0,0,0
1668411812355,CSE 240A,A00,102386,Pannuto; Patrick William,0,0,0,0
1668411812782,CSE 240B,A00,102387,Zhao; Jishen,0,0,0,0
1668411813228,CSE 241A,A00,106406,Kang; Mingu,0,0,0,0
1668411813656,CSE 249B,A00,102388,Kahng; Andrew Byun,0,0,8,8
1668411814081,CSE 251B,A01,102392,Cottrell; Garrison W,0,0,0,0
1668411814081,CSE 251B,A02,102393,Cottrell; Garrison W,0,0,0,0
1668411814505,CSE 252B,A00,102394,Ochoa; Benjamin Lawrence,0,0,0,0
1668411814932,CSE 257,A01,102396,Gao; Sicun,0,0,0,0
1668411815359,CSE 272,A00,102397,Li; Tzumao,0,0,0,0
1668411815784,CSE 274,A00,111323,Chern; Albert Ren-Haur,0,0,0,0
1668411816209,CSE 282,A00,102398,Pevzner; Pavel Arkadjevich,0,0,0,0
1668411816636,CSE 284,A00,114175,Gymrek; Melissa Ann,0,0,0,0
1668411817061,CSE 290,A00,102399,Chandraker; Manmohan Krishna,0,0,0,0
1668411817061,CSE 290,B00,102400,Vaccaro; Kristen Marie,0,0,25,25
1668411817061,CSE 290,C00,102414,Pannuto; Patrick William,0,0,25,25
1668411817061,CSE 290,D00,102427,Pevzner; Pavel Arkadjevich,0,0,0,0
1668411817061,CSE 290,E00,102429,Zhao; Jishen,0,0,0,0
1668411817061,CSE 290,F00,102436,Tullsen; Dean Michael,0,0,0,0
1668411817061,CSE 290,G00,102440,Christensen; Henrik I,0,0,20,20
1668411817484,CSE 291,A00,102443,Su; Hao,0,0,0,0
1668411817484,CSE 291,B00,102448,Polikarpova; Nadezhda,0,0,0,0
1668411817484,CSE 291,C00,102453,Vaccaro; Kristen Marie,0,0,0,0
1668411817484,CSE 291,D00,111343,Savage; Stefan,0,0,0,0
1668411817484,CSE 291,E00,116474,Claffy; Kimberly Claire,0,0,0,0
1668411817484,CSE 291,F00,116479,Pasquale; Joseph,0,0,0,0
1668411817919,CSE 293,001,119111,Bafna; Vineet,9999,0,9999,0
1668411817919,CSE 293,002,119118,Bellare; Mihir,9999,0,9999,0
1668411817919,CSE 293,003,119122,Berg-Kirkpatrick; Taylor D,9999,0,9999,0
1668411817919,CSE 293,004,119135,Christensen; Henrik I,9999,0,9999,0
1668411817919,CSE 293,005,119142,Cottrell; Garrison W,9999,0,9999,0
1668411817919,CSE 293,006,119146,Deutsch; Alin Bernard,9999,0,9999,0
1668411817919,CSE 293,007,119159,Esmaeilzadeh; Hadi,9999,0,9999,0
1668411817919,CSE 293,008,119166,Freund; Yoav,9999,0,9999,0
1668411817919,CSE 293,009,119170,Griswold; William G.,9999,0,9999,0
1668411817919,CSE 293,010,119183,Gymrek; Melissa Ann,9999,0,9999,0
1668411817919,CSE 293,011,119190,Heninger; Nadia A,9999,0,9999,0
1668411817919,CSE 293,012,119230,Impagliazzo; Russell,9999,0,9999,0
1668411817919,CSE 293,013,119232,Jhala; Ranjit,9999,0,9999,0
1668411817919,CSE 293,014,119233,Kahng; Andrew Byun,9999,0,9999,0
1668411817919,CSE 293,015,119298,Kane; Daniel Mertz,9999,0,9999,0
1668411817919,CSE 293,016,119299,Kriegman; David J,9999,0,9999,0
1668411817919,CSE 293,017,119300,Kumar; Arun Kumar,9999,0,9999,0
1668411817919,CSE 293,018,119301,Lerner; Sorin,9999,0,9999,0
1668411817919,CSE 293,019,119302,Lovett; Shachar,9999,0,9999,0
1668411817919,CSE 293,020,119303,McAuley; Julian John,9999,0,9999,0
1668411817919,CSE 293,021,119304,Micciancio; Daniele,9999,0,9999,0
1668411817919,CSE 293,022,119367,Orailoglu; Alex,9999,0,9999,0
1668411817919,CSE 293,023,119382,Paturi; Ramamohan,9999,0,9999,0
1668411817919,CSE 293,024,119404,Polikarpova; Nadezhda,9999,0,9999,0
1668411817919,CSE 293,025,119406,Politz; Joseph Gibbs,9999,0,9999,0
1668411817919,CSE 293,026,119411,Porter; George M,9999,0,9999,0
1668411817919,CSE 293,027,119414,Porter; Leonard Emerson,9999,0,9999,0
1668411817919,CSE 293,028,119416,Ramamoorthi; Ravi,9999,0,9999,0
1668411817919,CSE 293,029,119417,Sahoo; Debashis,9999,0,9999,0
1668411817919,CSE 293,030,119420,Saul; Lawrence,9999,0,9999,0
1668411817919,CSE 293,031,119421,Savage; Stefan,9999,0,9999,0
1668411817919,CSE 293,032,119425,Schulze; Jurgen P.,9999,0,9999,0
1668411817919,CSE 293,033,119426,Snoeren; Alex C.,9999,0,9999,0
1668411817919,CSE 293,034,119428,Shang; Jingbo,9999,0,9999,0
1668411817919,CSE 293,035,119430,Stefan; Deian,9999,0,9999,0
1668411817919,CSE 293,036,119431,Su; Hao,9999,0,9999,0
1668411817919,CSE 293,037,119433,Swanson; Steven James,9999,0,9999,0
1668411817919,CSE 293,038,119435,Tullsen; Dean Michael,9999,0,9999,0
1668411817919,CSE 293,039,119483,Voelker; Geoffrey M.,9999,0,9999,0
1668411817919,CSE 293,040,119537,Zhao; Jishen,9999,0,9999,0
1668411817919,CSE 293,041,119538,Zhou; Yuan-Yuan,9999,0,9999,0
1668411817919,CSE 293,042,119539,Gao; Sicun,9999,0,9999,0
1668411817919,CSE 293,043,119540,Weibel; Nadir,9999,0,9999,0
1668411817919,CSE 293,044,119541,Gupta; Rajesh K.,9999,0,9999,0
1668411817919,CSE 293,045,126410,Vaccaro; Kristen Marie,9999,0,9999,0
1668411817919,CSE 293,046,126411,Klemke; Richard,9999,0,9999,0
1668411818352,CSE 294,A00,102459,Voelker; Geoffrey M.,0,0,0,0
1668411818352,CSE 294,B00,111322,Orailoglu; Alex,0,0,0,0
1668411818774,DSE 201,A00,096914,Deutsch; Alin Bernard,30,0,30,0
1668411819200,DSE 210,A00,096915,Dasgupta; Sanjoy,30,0,30,0
1668411819627,DSE 260A,A00,096916,Altintas De Callaf; Ilkay,30,0,30,0
1668411820063,ECE 200,001,103586,Antipa; Nicholas A,9999,0,9999,0
1668411820063,ECE 200,002,103587,Atanasov; Nikolay A.,9999,0,9999,0
1668411820063,ECE 200,003,103588,Bharadia; Dinesh,9999,0,9999,0
1668411820063,ECE 200,004,103589,Cheng; Chung Kuan,9999,0,9999,0
1668411820063,ECE 200,005,103590,Cosman; Pamela C.,9999,0,9999,0
1668411820063,ECE 200,006,103591,Dayeh; Shadi Ahmad,9999,0,9999,0
1668411820063,ECE 200,007,103592,Fainman; Yeshaiahu,9999,0,9999,0
1668411820063,ECE 200,008,103593,Ford; Joseph Earl,9999,0,9999,0
1668411820063,ECE 200,009,103594,Franceschetti; Massimo,9999,0,9999,0
1668411820063,ECE 200,010,103595,Fullerton; Eric E,9999,0,9999,0
1668411820063,ECE 200,011,103596,Galton; Ian A,9999,0,9999,0
1668411820063,ECE 200,012,103597,Gilja; Vikash,9999,0,9999,0
1668411820063,ECE 200,013,103598,Hall; Drew A.,9999,0,9999,0
1668411820063,ECE 200,014,103599,Hsueh; Tzu-Chien,9999,0,9999,0
1668411820063,ECE 200,015,103600,Javidi; Tara,9999,0,9999,0
1668411820063,ECE 200,016,103601,Kahng; Andrew Byun,9999,0,9999,0
1668411820063,ECE 200,017,103602,Kim; Young-Han,9999,0,9999,0
1668411820063,ECE 200,018,103603,Koushanfar; Farinaz,9999,0,9999,0
1668411820063,ECE 200,019,103604,Kuzum; Duygu,9999,0,9999,0
1668411820063,ECE 200,020,103605,Le; Hanh-Phuc,9999,0,9999,0
1668411820063,ECE 200,021,103606,Lin; Bill,9999,0,9999,0
1668411820063,ECE 200,022,103607,Liu; Zhaowei,9998,0,9999,1
1668411820063,ECE 200,023,103608,Lo; Yu-Hwa,9999,0,9999,0
1668411820063,ECE 200,024,103609,Lomakin; Vitaliy,9999,0,9999,0
1668411820063,ECE 200,025,103610,Mercier; Patrick Philip,9999,0,9999,0
1668411820063,ECE 200,026,103611,Meyer; Florian,9999,0,9999,0
1668411820063,ECE 200,027,103612,Milstein; Laurence B.,9999,0,9999,0
1668411820063,ECE 200,028,103613,Mir Arabbaygi; Siavash,9999,0,9999,0
1668411820063,ECE 200,029,103614,Mookherjea; Shayan,9999,0,9999,0
1668411820063,ECE 200,030,103615,Morris; Karcher William,9999,0,9999,0
1668411820063,ECE 200,031,103616,Ng; Tse Nga,9999,0,9999,0
1668411820063,ECE 200,032,103617,Nguyen; Truong Quang,9999,0,9999,0
1668411820063,ECE 200,033,103618,Nomura; Kenji,9999,0,9999,0
1668411820063,ECE 200,034,103619,Orlitsky; Alon,9999,0,9999,0
1668411820063,ECE 200,035,103620,Pal; Piya,9999,0,9999,0
1668411820063,ECE 200,036,103621,Papen; George C.,9999,0,9999,0
1668411820063,ECE 200,037,103622,Radic; Stojan,9999,0,9999,0
1668411820063,ECE 200,038,103623,Rao; Bhaskar D.,9999,0,9999,0
1668411820063,ECE 200,039,103624,Rao; Ramesh R,9999,0,9999,0
1668411820063,ECE 200,040,103625,Rebeiz; Gabriel,9999,0,9999,0
1668411820063,ECE 200,041,103626,Sanford; John R,9999,0,9999,0
1668411820063,ECE 200,042,103627,Siegel; Paul H.,9999,0,9999,0
1668411820063,ECE 200,043,103628,Sievenpiper; Daniel F.,9999,0,9999,0
1668411820063,ECE 200,044,103629,Sworder; David D.,9999,0,9999,0
1668411820063,ECE 200,045,103630,Taur; Yuan,9999,0,9999,0
1668411820063,ECE 200,046,103631,Touri; Behrouz,9999,0,9999,0
1668411820063,ECE 200,047,103632,Trivedi; Mohan M.,9999,0,9999,0
1668411820063,ECE 200,048,103633,Vasconcelos; Nuno,9999,0,9999,0
1668411820063,ECE 200,049,103634,Wang; Xiaolong,9999,0,9999,0
1668411820063,ECE 200,050,103635,Xie; Pengtao,9999,0,9999,0
1668411820063,ECE 200,051,103636,Yip; Michael,9999,0,9999,0
1668411820063,ECE 200,052,103637,Zeger; Kenneth A.,999,0,999,0
1668411820063,ECE 200,053,103638,Zhang; Xinyu,9999,0,9999,0
1668411820063,ECE 200,054,103639,Turakhia; Yatish Girish,9999,0,9999,0
1668411820063,ECE 200,055,103640,Kang; Mingu,9999,0,9999,0
1668411820063,ECE 200,056,103641,Shi; Yuanyuan,9999,0,9999,0
1668411820063,ECE 200,057,103642,Wang; Edward Jay,9999,0,9999,0
1668411820063,ECE 200,058,103643,Zheng; Yang,9999,0,9999,0
1668411820563,ECE 202,A00,103644,Kuzum; Duygu,0,0,0,0
1668411820988,ECE 212BN,A00,103646,Ng; Tse Nga,0,0,0,0
1668411821420,ECE 221,A00,111493,Staff,0,0,0,0
1668411821846,ECE 222B,A00,103647,Lomakin; Vitaliy,0,0,0,0
1668411822272,ECE 230B,A00,103648,Taur; Yuan,0,0,0,0
1668411822697,ECE 238B,A00,103649,Garay; Javier,0,0,0,0
1668411823122,ECE 240B,A00,112900,Fainman; Yeshaiahu,0,0,0,0
1668411823547,ECE 247A,A00,103650,Jokerst; Jesse Vincent,0,0,0,0
1668411823970,ECE 247B,A00,103651,Wang; Joseph,0,0,0,0
1668411824394,ECE 250,A00,103652,Siegel; Paul H.,0,0,0,0
1668411824821,ECE 251A,A00,103654,Rao; Bhaskar D.,0,0,0,0
1668411825245,ECE 257B,A00,103655,Bharadia; Dinesh,0,0,0,0
1668411825673,ECE 258A,A00,103656,Milstein; Laurence B.,0,0,0,0
1668411826106,ECE 260B,A00,103658,Kang; Mingu,0,0,0,0
1668411826536,ECE 264A,A00,103659,Galton; Ian A,0,0,0,0
1668411826958,ECE 265A,A00,103661,Gudem; Prasad S.S.,0,0,0,0
1668411827385,ECE 265D,A00,103662,Gudem; Prasad S.S.,0,0,0,0
1668411827810,ECE 268,A00,103663,Koushanfar; Farinaz,0,0,0,0
1668411828233,ECE 269,A01,103665,Pal; Piya,0,0,0,0
1668411828656,ECE 271B,A00,103666,Vasconcelos; Manuela,0,0,0,0
1668411829079,ECE 276A,A00,103667,Atanasov; Nikolay A.,0,0,0,0
1668411829505,ECE 277,A00,103668,An; Cheolhong,0,0,0,0
1668411829934,ECE 279,A00,117947,Hall; Drew A.,0,0,0,0
1668411830793,ECE 283,A00,103670,Hsueh; Tzu-Chien,0,0,0,0
1668411831229,ECE 284,A00,103671,Turakhia; Yatish Girish,0,0,0,0
1668411831655,ECE 285,A00,103672,Zheng; Yang,0,0,0,0
1668411831655,ECE 285,B00,103673,Sworder; David D.,0,0,0,0
1668411832076,ECE 287,A00,103676,Javidi; Tara,0,0,0,0
1668411832499,MATH 200B,A00,098023,Salehi Golsefidy; Alireza,12,0,15,3
1668411832926,MATH 202B,A00,098024,Rhoades; Brendon Patrick,9,0,15,6
1668411833358,MATH 203B,A00,098025,Oprea; Dragos N.,10,0,15,5
1668411833795,MATH 204B,A00,098026,Sorensen; Claus M,13,0,15,2
1668411834230,MATH 208,A00,098027,Izadi; Elham,7,0,10,3
1668411834655,MATH 209,A00,098028,Pollack; Aaron,10,0,10,0
1668411835091,MATH 211A,A00,112919,Rogalski; Daniel,9,0,10,1
1668411835517,MATH 211B,A00,112920,Seward; Brandon M.,9,0,10,1
1668411835938,MATH 218,A00,098029,Li; Bo,10,0,10,0
1668411836362,MATH 220B,A00,098030,Novak; Jonathan I,11,0,15,4
1668411836796,MATH 221A,A00,098031,Ebenfelt; Peter F,13,0,15,2
1668411837221,MATH 231B,A00,098032,Zlatos; Andrej,12,0,15,3
1668411837657,MATH 240B,A00,098033,Ni; Lei,9,0,15,6
1668411838085,MATH 243,A00,098034,Jekel; David Andrew,10,0,10,0
1668411838511,MATH 245A,A00,098035,Nie; Jiawang,0,0,15,16
1668411838948,MATH 248,A00,098036,Bejenaru; Ioan,10,0,10,0
1668411839370,MATH 250B,A00,098037,Spolaor; Luca,14,0,15,1
1668411839807,MATH 258,A00,098038,Ni; Lei,10,0,10,0
1668411840236,MATH 264B,A00,098041,Rhoades; Brendon Patrick,9,0,15,6
1668411840658,MATH 268,A00,098042,Buss; Samuel R,10,0,10,0
1668411841084,MATH 269,A00,098043,Rhoades; Brendon Patrick,10,0,10,0
1668411841520,MATH 270B,A00,098044,Li; Bo,10,0,15,5
1668411841945,MATH 272B,A00,098045,Holst; Michael J,13,0,15,2
1668411842377,MATH 273A,A00,098046,Tian; Xiaochuan,10,0,15,5
1668411842807,MATH 275,A01,098048,Tian; Xiaochuan,6,0,10,4
1668411843229,MATH 278A,A00,098049,Holst; Michael J,8,0,10,2
1668411843652,MATH 278B,A00,098050,Cloninger; Alexander,10,0,10,0
1668411844077,MATH 278C,A00,098051,Nie; Jiawang,6,0,10,4
1668411844512,MATH 280B,A00,098052,Zheng; Tianyi,8,0,15,7
1668411844941,MATH 281B,A00,098053,Bradic; Jelena,0,0,15,15
1668411845366,MATH 282B,A00,098054,Arias-Castro; Ery,0,0,15,15
1668411845789,MATH 285,A00,098055,Fitzsimmons; Patrick J,0,0,15,17
1668411846224,MATH 287B,A00,098056,Arias-Castro; Ery,2,0,15,13
1668411846662,MATH 288,A00,098057,Agarwal; Pooja,9,0,10,1
1668411846662,MATH 288,B00,098058,Zhang; Danna,8,0,10,2
1668411846662,MATH 288,C00,098059,Williams; Ruth J,9,0,10,1
1668411847098,MATH 290B,A00,098060,Roberts; Justin Deritter,13,0,15,2
1668411847524,MATH 292,A00,098061,Belmont; Eva Kinoshita,10,0,10,0
1668411847950,MATH 295,A00,098062,Suk; Andrew Hoon,48,0,50,2
1668411848374,MATH 296,A00,098063,Novak; Jonathan I,20,0,20,0
1668411848797,MATH 297,001,098064,Gamst; Anthony Collins,9997,0,9999,2
1668412348614,COGS 205,A00,101395,Chiba; Andrea,19,0,20,1
1668412349039,COGS 210B,001,101404,Greene; Deanna Jacquelyn,9998,0,9999,1
1668412349039,COGS 210B,002,101417,Xia; Haijun,9999,0,9999,0
1668412349039,COGS 210B,003,101422,Nitz; Douglas A.,9999,0,9999,0
1668412349039,COGS 210B,004,101423,Hollan; James D.,9998,0,9999,1
1668412349039,COGS 210B,005,101424,Deak; Gedeon O.,9998,0,9999,1
1668412349039,COGS 210B,006,101425,Rossano; Federico,9999,0,9999,0
1668412349463,COGS 211B,A00,101427,Coulson; Seana M,9996,0,9999,3
1668412349887,COGS 220,A00,101428,Hollan; James D.,0,0,25,25
1668412350311,COGS 229,A00,101429,Dow; Steven P,18,0,25,7
1668412350735,COGS 230,A00,101430,Klemmer; Scott R,11,0,17,6
1668412351158,COGS 234,A00,101431,Xia; Haijun,1,0,25,24
1668412351590,COGS 260,A00,101432,Kiyonaga; Anastasia,21,0,25,4
1668412351590,COGS 260,B00,101433,Kirsh; David Joel,15,0,25,10
1668412352012,CSE 202,A00,102371,Impagliazzo; Russell,0,0,0,0
1668412352438,CSE 203B,A01,102373,Cheng; Chung Kuan,0,0,0,0
1668412352865,CSE 208,A00,102374,Micciancio; Daniele,0,0,0,0
1668412353301,CSE 209A,A00,112895,Impagliazzo; Russell,0,0,15,15
1668412353735,CSE 209B,A00,108005,Bellare; Mihir,0,0,0,0
1668412354162,CSE 210,A00,113163,Coblenz; Michael J,0,0,0,0
1668412354590,CSE 219,A00,106111,Dow; Steven P,0,0,20,20
1668412355013,CSE 221,A00,102376,Voelker; Geoffrey M.,0,0,0,0
1668412355446,CSE 224,A01,102378,Porter; George M,0,0,0,0
1668412355869,CSE 229A,A00,102379,Savage; Stefan,0,0,0,0
1668412356297,CSE 229C,A00,102380,Munyaka; Imani N. S.,0,0,0,0
1668412356724,CSE 232B,A00,102382,Deutsch; Alin Bernard,0,0,0,0
1668412357148,CSE 234,A01,112904,Kumar; Arun Kumar,0,0,0,0
1668412357573,CSE 237A,A00,102383,Rosing; Tajana Simunic,0,0,0,0
1668412357998,CSE 239A,A00,102384,Deutsch; Alin Bernard,0,0,0,0
1668412358421,CSE 239B,A00,102385,Polikarpova; Nadezhda,0,0,0,0
1668412358844,CSE 240A,A00,102386,Pannuto; Patrick William,0,0,0,0
1668412359268,CSE 240B,A00,102387,Zhao; Jishen,0,0,0,0
1668412359694,CSE 241A,A00,106406,Kang; Mingu,0,0,0,0
1668412360116,CSE 249B,A00,102388,Kahng; Andrew Byun,0,0,8,8
1668412360543,CSE 251B,A01,102392,Cottrell; Garrison W,0,0,0,0
1668412360543,CSE 251B,A02,102393,Cottrell; Garrison W,0,0,0,0
1668412360965,CSE 252B,A00,102394,Ochoa; Benjamin Lawrence,0,0,0,0
1668412361389,CSE 257,A01,102396,Gao; Sicun,0,0,0,0
1668412361811,CSE 272,A00,102397,Li; Tzumao,0,0,0,0
1668412362238,CSE 274,A00,111323,Chern; Albert Ren-Haur,0,0,0,0
1668412362660,CSE 282,A00,102398,Pevzner; Pavel Arkadjevich,0,0,0,0
1668412363086,CSE 284,A00,114175,Gymrek; Melissa Ann,0,0,0,0
1668412363513,CSE 290,A00,102399,Chandraker; Manmohan Krishna,0,0,0,0
1668412363513,CSE 290,B00,102400,Vaccaro; Kristen Marie,0,0,25,25
1668412363513,CSE 290,C00,102414,Pannuto; Patrick William,0,0,25,25
1668412363513,CSE 290,D00,102427,Pevzner; Pavel Arkadjevich,0,0,0,0
1668412363513,CSE 290,E00,102429,Zhao; Jishen,0,0,0,0
1668412363513,CSE 290,F00,102436,Tullsen; Dean Michael,0,0,0,0
1668412363513,CSE 290,G00,102440,Christensen; Henrik I,0,0,20,20
1668412363943,CSE 291,A00,102443,Su; Hao,0,0,0,0
1668412363943,CSE 291,B00,102448,Polikarpova; Nadezhda,0,0,0,0
1668412363943,CSE 291,C00,102453,Vaccaro; Kristen Marie,0,0,0,0
1668412363943,CSE 291,D00,111343,Savage; Stefan,0,0,0,0
1668412363943,CSE 291,E00,116474,Claffy; Kimberly Claire,0,0,0,0
1668412363943,CSE 291,F00,116479,Pasquale; Joseph,0,0,0,0
1668412364385,CSE 293,001,119111,Bafna; Vineet,9999,0,9999,0
1668412364385,CSE 293,002,119118,Bellare; Mihir,9999,0,9999,0
1668412364385,CSE 293,003,119122,Berg-Kirkpatrick; Taylor D,9999,0,9999,0
1668412364385,CSE 293,004,119135,Christensen; Henrik I,9999,0,9999,0
1668412364385,CSE 293,005,119142,Cottrell; Garrison W,9999,0,9999,0
1668412364385,CSE 293,006,119146,Deutsch; Alin Bernard,9999,0,9999,0
1668412364385,CSE 293,007,119159,Esmaeilzadeh; Hadi,9999,0,9999,0
1668412364385,CSE 293,008,119166,Freund; Yoav,9999,0,9999,0
1668412364385,CSE 293,009,119170,Griswold; William G.,9999,0,9999,0
1668412364385,CSE 293,010,119183,Gymrek; Melissa Ann,9999,0,9999,0
1668412364385,CSE 293,011,119190,Heninger; Nadia A,9999,0,9999,0
1668412364385,CSE 293,012,119230,Impagliazzo; Russell,9999,0,9999,0
1668412364385,CSE 293,013,119232,Jhala; Ranjit,9999,0,9999,0
1668412364385,CSE 293,014,119233,Kahng; Andrew Byun,9999,0,9999,0
1668412364385,CSE 293,015,119298,Kane; Daniel Mertz,9999,0,9999,0
1668412364385,CSE 293,016,119299,Kriegman; David J,9999,0,9999,0
1668412364385,CSE 293,017,119300,Kumar; Arun Kumar,9999,0,9999,0
1668412364385,CSE 293,018,119301,Lerner; Sorin,9999,0,9999,0
1668412364385,CSE 293,019,119302,Lovett; Shachar,9999,0,9999,0
1668412364385,CSE 293,020,119303,McAuley; Julian John,9999,0,9999,0
1668412364385,CSE 293,021,119304,Micciancio; Daniele,9999,0,9999,0
1668412364385,CSE 293,022,119367,Orailoglu; Alex,9999,0,9999,0
1668412364385,CSE 293,023,119382,Paturi; Ramamohan,9999,0,9999,0
1668412364385,CSE 293,024,119404,Polikarpova; Nadezhda,9999,0,9999,0
1668412364385,CSE 293,025,119406,Politz; Joseph Gibbs,9999,0,9999,0
1668412364385,CSE 293,026,119411,Porter; George M,9999,0,9999,0
1668412364385,CSE 293,027,119414,Porter; Leonard Emerson,9999,0,9999,0
1668412364385,CSE 293,028,119416,Ramamoorthi; Ravi,9999,0,9999,0
1668412364385,CSE 293,029,119417,Sahoo; Debashis,9999,0,9999,0
1668412364385,CSE 293,030,119420,Saul; Lawrence,9999,0,9999,0
1668412364385,CSE 293,031,119421,Savage; Stefan,9999,0,9999,0
1668412364385,CSE 293,032,119425,Schulze; Jurgen P.,9999,0,9999,0
1668412364385,CSE 293,033,119426,Snoeren; Alex C.,9999,0,9999,0
1668412364385,CSE 293,034,119428,Shang; Jingbo,9999,0,9999,0
1668412364385,CSE 293,035,119430,Stefan; Deian,9999,0,9999,0
1668412364385,CSE 293,036,119431,Su; Hao,9999,0,9999,0
1668412364385,CSE 293,037,119433,Swanson; Steven James,9999,0,9999,0
1668412364385,CSE 293,038,119435,Tullsen; Dean Michael,9999,0,9999,0
1668412364385,CSE 293,039,119483,Voelker; Geoffrey M.,9999,0,9999,0
1668412364385,CSE 293,040,119537,Zhao; Jishen,9999,0,9999,0
1668412364385,CSE 293,041,119538,Zhou; Yuan-Yuan,9999,0,9999,0
1668412364385,CSE 293,042,119539,Gao; Sicun,9999,0,9999,0
1668412364385,CSE 293,043,119540,Weibel; Nadir,9999,0,9999,0
1668412364385,CSE 293,044,119541,Gupta; Rajesh K.,9999,0,9999,0
1668412364385,CSE 293,045,126410,Vaccaro; Kristen Marie,9999,0,9999,0
1668412364385,CSE 293,046,126411,Klemke; Richard,9999,0,9999,0
1668412364809,CSE 294,A00,102459,Voelker; Geoffrey M.,0,0,0,0
1668412364809,CSE 294,B00,111322,Orailoglu; Alex,0,0,0,0
1668412365241,DSE 201,A00,096914,Deutsch; Alin Bernard,30,0,30,0
1668412365674,DSE 210,A00,096915,Dasgupta; Sanjoy,30,0,30,0
1668412366098,DSE 260A,A00,096916,Altintas De Callaf; Ilkay,30,0,30,0
1668412366532,ECE 200,001,103586,Antipa; Nicholas A,9999,0,9999,0
1668412366532,ECE 200,002,103587,Atanasov; Nikolay A.,9999,0,9999,0
1668412366532,ECE 200,003,103588,Bharadia; Dinesh,9999,0,9999,0
1668412366532,ECE 200,004,103589,Cheng; Chung Kuan,9999,0,9999,0
1668412366532,ECE 200,005,103590,Cosman; Pamela C.,9999,0,9999,0
1668412366532,ECE 200,006,103591,Dayeh; Shadi Ahmad,9999,0,9999,0
1668412366532,ECE 200,007,103592,Fainman; Yeshaiahu,9999,0,9999,0
1668412366532,ECE 200,008,103593,Ford; Joseph Earl,9999,0,9999,0
1668412366532,ECE 200,009,103594,Franceschetti; Massimo,9999,0,9999,0
1668412366532,ECE 200,010,103595,Fullerton; Eric E,9999,0,9999,0
1668412366532,ECE 200,011,103596,Galton; Ian A,9999,0,9999,0
1668412366532,ECE 200,012,103597,Gilja; Vikash,9999,0,9999,0
1668412366532,ECE 200,013,103598,Hall; Drew A.,9999,0,9999,0
1668412366532,ECE 200,014,103599,Hsueh; Tzu-Chien,9999,0,9999,0
1668412366532,ECE 200,015,103600,Javidi; Tara,9999,0,9999,0
1668412366532,ECE 200,016,103601,Kahng; Andrew Byun,9999,0,9999,0
1668412366532,ECE 200,017,103602,Kim; Young-Han,9999,0,9999,0
1668412366532,ECE 200,018,103603,Koushanfar; Farinaz,9999,0,9999,0
1668412366532,ECE 200,019,103604,Kuzum; Duygu,9999,0,9999,0
1668412366532,ECE 200,020,103605,Le; Hanh-Phuc,9999,0,9999,0
1668412366532,ECE 200,021,103606,Lin; Bill,9999,0,9999,0
1668412366532,ECE 200,022,103607,Liu; Zhaowei,9998,0,9999,1
1668412366532,ECE 200,023,103608,Lo; Yu-Hwa,9999,0,9999,0
1668412366532,ECE 200,024,103609,Lomakin; Vitaliy,9999,0,9999,0
1668412366532,ECE 200,025,103610,Mercier; Patrick Philip,9999,0,9999,0
1668412366532,ECE 200,026,103611,Meyer; Florian,9999,0,9999,0
1668412366532,ECE 200,027,103612,Milstein; Laurence B.,9999,0,9999,0
1668412366532,ECE 200,028,103613,Mir Arabbaygi; Siavash,9999,0,9999,0
1668412366532,ECE 200,029,103614,Mookherjea; Shayan,9999,0,9999,0
1668412366532,ECE 200,030,103615,Morris; Karcher William,9999,0,9999,0
1668412366532,ECE 200,031,103616,Ng; Tse Nga,9999,0,9999,0
1668412366532,ECE 200,032,103617,Nguyen; Truong Quang,9999,0,9999,0
1668412366532,ECE 200,033,103618,Nomura; Kenji,9999,0,9999,0
1668412366532,ECE 200,034,103619,Orlitsky; Alon,9999,0,9999,0
1668412366532,ECE 200,035,103620,Pal; Piya,9999,0,9999,0
1668412366532,ECE 200,036,103621,Papen; George C.,9999,0,9999,0
1668412366532,ECE 200,037,103622,Radic; Stojan,9999,0,9999,0
1668412366532,ECE 200,038,103623,Rao; Bhaskar D.,9999,0,9999,0
1668412366532,ECE 200,039,103624,Rao; Ramesh R,9999,0,9999,0
1668412366532,ECE 200,040,103625,Rebeiz; Gabriel,9999,0,9999,0
1668412366532,ECE 200,041,103626,Sanford; John R,9999,0,9999,0
1668412366532,ECE 200,042,103627,Siegel; Paul H.,9999,0,9999,0
1668412366532,ECE 200,043,103628,Sievenpiper; Daniel F.,9999,0,9999,0
1668412366532,ECE 200,044,103629,Sworder; David D.,9999,0,9999,0
1668412366532,ECE 200,045,103630,Taur; Yuan,9999,0,9999,0
1668412366532,ECE 200,046,103631,Touri; Behrouz,9999,0,9999,0
1668412366532,ECE 200,047,103632,Trivedi; Mohan M.,9999,0,9999,0
1668412366532,ECE 200,048,103633,Vasconcelos; Nuno,9999,0,9999,0
1668412366532,ECE 200,049,103634,Wang; Xiaolong,9999,0,9999,0
1668412366532,ECE 200,050,103635,Xie; Pengtao,9999,0,9999,0
1668412366532,ECE 200,051,103636,Yip; Michael,9999,0,9999,0
1668412366532,ECE 200,052,103637,Zeger; Kenneth A.,999,0,999,0
1668412366532,ECE 200,053,103638,Zhang; Xinyu,9999,0,9999,0
1668412366532,ECE 200,054,103639,Turakhia; Yatish Girish,9999,0,9999,0
1668412366532,ECE 200,055,103640,Kang; Mingu,9999,0,9999,0
1668412366532,ECE 200,056,103641,Shi; Yuanyuan,9999,0,9999,0
1668412366532,ECE 200,057,103642,Wang; Edward Jay,9999,0,9999,0
1668412366532,ECE 200,058,103643,Zheng; Yang,9999,0,9999,0
1668412366955,ECE 202,A00,103644,Kuzum; Duygu,0,0,0,0
1668412367379,ECE 212BN,A00,103646,Ng; Tse Nga,0,0,0,0
1668412367805,ECE 221,A00,111493,Staff,0,0,0,0
1668412368229,ECE 222B,A00,103647,Lomakin; Vitaliy,0,0,0,0
1668412368655,ECE 230B,A00,103648,Taur; Yuan,0,0,0,0
1668412369079,ECE 238B,A00,103649,Garay; Javier,0,0,0,0
1668412369501,ECE 240B,A00,112900,Fainman; Yeshaiahu,0,0,0,0
1668412369925,ECE 247A,A00,103650,Jokerst; Jesse Vincent,0,0,0,0
1668412370347,ECE 247B,A00,103651,Wang; Joseph,0,0,0,0
1668412370771,ECE 250,A00,103652,Siegel; Paul H.,0,0,0,0
1668412371201,ECE 251A,A00,103654,Rao; Bhaskar D.,0,0,0,0
1668412371625,ECE 257B,A00,103655,Bharadia; Dinesh,0,0,0,0
1668412372047,ECE 258A,A00,103656,Milstein; Laurence B.,0,0,0,0
1668412372484,ECE 260B,A00,103658,Kang; Mingu,0,0,0,0
1668412372921,ECE 264A,A00,103659,Galton; Ian A,0,0,0,0
1668412373346,ECE 265A,A00,103661,Gudem; Prasad S.S.,0,0,0,0
1668412373775,ECE 265D,A00,103662,Gudem; Prasad S.S.,0,0,0,0
1668412374202,ECE 268,A00,103663,Koushanfar; Farinaz,0,0,0,0
1668412374625,ECE 269,A01,103665,Pal; Piya,0,0,0,0
1668412375052,ECE 271B,A00,103666,Vasconcelos; Manuela,0,0,0,0
1668412375477,ECE 276A,A00,103667,Atanasov; Nikolay A.,0,0,0,0
1668412375905,ECE 277,A00,103668,An; Cheolhong,0,0,0,0
1668412376329,ECE 279,A00,117947,Hall; Drew A.,0,0,0,0
1668412377175,ECE 283,A00,103670,Hsueh; Tzu-Chien,0,0,0,0
1668412377600,ECE 284,A00,103671,Turakhia; Yatish Girish,0,0,0,0
1668412378027,ECE 285,A00,103672,Zheng; Yang,0,0,0,0
1668412378027,ECE 285,B00,103673,Sworder; David D.,0,0,0,0
1668412378454,ECE 287,A00,103676,Javidi; Tara,0,0,0,0
1668412378877,MATH 200B,A00,098023,Salehi Golsefidy; Alireza,12,0,15,3
1668412379301,MATH 202B,A00,098024,Rhoades; Brendon Patrick,9,0,15,6
1668412379727,MATH 203B,A00,098025,Oprea; Dragos N.,10,0,15,5
1668412380152,MATH 204B,A00,098026,Sorensen; Claus M,13,0,15,2
1668412380581,MATH 208,A00,098027,Izadi; Elham,7,0,10,3
1668412381005,MATH 209,A00,098028,Pollack; Aaron,10,0,10,0
1668412381432,MATH 211A,A00,112919,Rogalski; Daniel,9,0,10,1
1668412381858,MATH 211B,A00,112920,Seward; Brandon M.,9,0,10,1
1668412382284,MATH 218,A00,098029,Li; Bo,10,0,10,0
1668412382711,MATH 220B,A00,098030,Novak; Jonathan I,11,0,15,4
1668412383134,MATH 221A,A00,098031,Ebenfelt; Peter F,13,0,15,2
1668412383650,MATH 231B,A00,098032,Zlatos; Andrej,12,0,15,3
1668412384084,MATH 240B,A00,098033,Ni; Lei,9,0,15,6
1668412384507,MATH 243,A00,098034,Jekel; David Andrew,10,0,10,0
1668412384931,MATH 245A,A00,098035,Nie; Jiawang,0,0,15,16
1668412385356,MATH 248,A00,098036,Bejenaru; Ioan,10,0,10,0
1668412385780,MATH 250B,A00,098037,Spolaor; Luca,14,0,15,1
1668412386204,MATH 258,A00,098038,Ni; Lei,10,0,10,0
1668412386628,MATH 264B,A00,098041,Rhoades; Brendon Patrick,9,0,15,6
1668412387060,MATH 268,A00,098042,Buss; Samuel R,10,0,10,0
1668412387494,MATH 269,A00,098043,Rhoades; Brendon Patrick,10,0,10,0
1668412387922,MATH 270B,A00,098044,Li; Bo,10,0,15,5
1668412388346,MATH 272B,A00,098045,Holst; Michael J,13,0,15,2
1668412388771,MATH 273A,A00,098046,Tian; Xiaochuan,10,0,15,5
1668412389196,MATH 275,A01,098048,Tian; Xiaochuan,6,0,10,4
1668412389624,MATH 278A,A00,098049,Holst; Michael J,8,0,10,2
1668412390048,MATH 278B,A00,098050,Cloninger; Alexander,10,0,10,0
1668412390473,MATH 278C,A00,098051,Nie; Jiawang,6,0,10,4
1668412390896,MATH 280B,A00,098052,Zheng; Tianyi,8,0,15,7
1668412391326,MATH 281B,A00,098053,Bradic; Jelena,0,0,15,15
1668412391762,MATH 282B,A00,098054,Arias-Castro; Ery,0,0,15,15
1668412392201,MATH 285,A00,098055,Fitzsimmons; Patrick J,0,0,15,17
1668412392625,MATH 287B,A00,098056,Arias-Castro; Ery,2,0,15,13
1668412393052,MATH 288,A00,098057,Agarwal; Pooja,9,0,10,1
1668412393052,MATH 288,B00,098058,Zhang; Danna,8,0,10,2
1668412393052,MATH 288,C00,098059,Williams; Ruth J,9,0,10,1
1668412393475,MATH 290B,A00,098060,Roberts; Justin Deritter,13,0,15,2
1668412393902,MATH 292,A00,098061,Belmont; Eva Kinoshita,10,0,10,0
1668412394330,MATH 295,A00,098062,Suk; Andrew Hoon,48,0,50,2
1668412394764,MATH 296,A00,098063,Novak; Jonathan I,20,0,20,0
1668412395194,MATH 297,001,098064,Gamst; Anthony Collins,9997,0,9999,2
1668412914039,COGS 205,A00,101395,Chiba; Andrea,19,0,20,1
1668412914463,COGS 210B,001,101404,Greene; Deanna Jacquelyn,9998,0,9999,1
1668412914463,COGS 210B,002,101417,Xia; Haijun,9999,0,9999,0
1668412914463,COGS 210B,003,101422,Nitz; Douglas A.,9999,0,9999,0
1668412914463,COGS 210B,004,101423,Hollan; James D.,9998,0,9999,1
1668412914463,COGS 210B,005,101424,Deak; Gedeon O.,9998,0,9999,1
1668412914463,COGS 210B,006,101425,Rossano; Federico,9999,0,9999,0
1668412914890,COGS 211B,A00,101427,Coulson; Seana M,9996,0,9999,3
1668412915315,COGS 220,A00,101428,Hollan; James D.,0,0,25,25
1668412915745,COGS 229,A00,101429,Dow; Steven P,18,0,25,7
1668412916169,COGS 230,A00,101430,Klemmer; Scott R,11,0,17,6
1668412916593,COGS 234,A00,101431,Xia; Haijun,1,0,25,24
1668412917017,COGS 260,A00,101432,Kiyonaga; Anastasia,21,0,25,4
1668412917017,COGS 260,B00,101433,Kirsh; David Joel,15,0,25,10
1668412917443,CSE 202,A00,102371,Impagliazzo; Russell,0,11,0,0
1668412917866,CSE 203B,A01,102373,Cheng; Chung Kuan,0,9,0,0
1668412918294,CSE 208,A00,102374,Micciancio; Daniele,0,1,0,0
1668412918718,CSE 209A,A00,112895,Impagliazzo; Russell,0,1,15,15
1668412919147,CSE 209B,A00,108005,Bellare; Mihir,0,1,0,0
1668412919583,CSE 210,A00,113163,Coblenz; Michael J,0,15,0,0
1668412920006,CSE 219,A00,106111,Dow; Steven P,0,0,20,20
1668412920446,CSE 221,A00,102376,Voelker; Geoffrey M.,0,10,0,0
1668412920870,CSE 224,A01,102378,Porter; George M,0,39,0,0
1668412921293,CSE 229A,A00,102379,Savage; Stefan,0,1,0,0
1668412921716,CSE 229C,A00,102380,Munyaka; Imani N. S.,0,0,0,0
1668412922139,CSE 232B,A00,102382,Deutsch; Alin Bernard,0,4,0,0
1668412922663,CSE 234,A01,112904,Kumar; Arun Kumar,0,0,0,0
1668412923105,CSE 237A,A00,102383,Rosing; Tajana Simunic,0,10,0,0
1668412923544,CSE 239A,A00,102384,Deutsch; Alin Bernard,0,0,0,0
1668412923976,CSE 239B,A00,102385,Polikarpova; Nadezhda,0,0,0,0
1668412924407,CSE 240A,A00,102386,Pannuto; Patrick William,0,7,0,0
1668412924850,CSE 240B,A00,102387,Zhao; Jishen,0,12,0,0
1668412925279,CSE 241A,A00,106406,Kang; Mingu,0,0,0,0
1668412925726,CSE 249B,A00,102388,Kahng; Andrew Byun,0,0,8,8
1668412926179,CSE 251B,A01,102392,Cottrell; Garrison W,0,11,0,0
1668412926179,CSE 251B,A02,102393,Cottrell; Garrison W,0,9,0,0
1668412926605,CSE 252B,A00,102394,Ochoa; Benjamin Lawrence,0,17,0,0
1668412927031,CSE 257,A01,102396,Gao; Sicun,0,33,0,0
1668412927459,CSE 272,A00,102397,Li; Tzumao,0,3,0,0
1668412927905,CSE 274,A00,111323,Chern; Albert Ren-Haur,0,2,0,0
1668412928340,CSE 282,A00,102398,Pevzner; Pavel Arkadjevich,0,0,0,0
1668412928765,CSE 284,A00,114175,Gymrek; Melissa Ann,0,3,0,0
1668412929196,CSE 290,A00,102399,Chandraker; Manmohan Krishna,0,1,0,0
1668412929196,CSE 290,B00,102400,Vaccaro; Kristen Marie,0,0,25,25
1668412929196,CSE 290,C00,102414,Pannuto; Patrick William,0,1,25,25
1668412929196,CSE 290,D00,102427,Pevzner; Pavel Arkadjevich,0,0,0,0
1668412929196,CSE 290,E00,102429,Zhao; Jishen,0,0,0,0
1668412929196,CSE 290,F00,102436,Tullsen; Dean Michael,0,0,0,0
1668412929196,CSE 290,G00,102440,Christensen; Henrik I,0,1,20,20
1668412929643,CSE 291,A00,102443,Su; Hao,0,0,0,0
1668412929643,CSE 291,B00,102448,Polikarpova; Nadezhda,0,0,0,0
1668412929643,CSE 291,C00,102453,Vaccaro; Kristen Marie,0,0,0,0
1668412929643,CSE 291,D00,111343,Savage; Stefan,0,0,0,0
1668412929643,CSE 291,E00,116474,Claffy; Kimberly Claire,0,0,0,0
1668412929643,CSE 291,F00,116479,Pasquale; Joseph,0,0,0,0
1668412930078,CSE 293,001,119111,Bafna; Vineet,9999,0,9999,0
1668412930078,CSE 293,002,119118,Bellare; Mihir,9999,0,9999,0
1668412930078,CSE 293,003,119122,Berg-Kirkpatrick; Taylor D,9999,0,9999,0
1668412930078,CSE 293,004,119135,Christensen; Henrik I,9999,0,9999,0
1668412930078,CSE 293,005,119142,Cottrell; Garrison W,9999,0,9999,0
1668412930078,CSE 293,006,119146,Deutsch; Alin Bernard,9999,0,9999,0
1668412930078,CSE 293,007,119159,Esmaeilzadeh; Hadi,9999,0,9999,0
1668412930078,CSE 293,008,119166,Freund; Yoav,9999,0,9999,0
1668412930078,CSE 293,009,119170,Griswold; William G.,9999,0,9999,0
1668412930078,CSE 293,010,119183,Gymrek; Melissa Ann,9999,0,9999,0
1668412930078,CSE 293,011,119190,Heninger; Nadia A,9999,0,9999,0
1668412930078,CSE 293,012,119230,Impagliazzo; Russell,9999,0,9999,0
1668412930078,CSE 293,013,119232,Jhala; Ranjit,9999,0,9999,0
1668412930078,CSE 293,014,119233,Kahng; Andrew Byun,9999,0,9999,0
1668412930078,CSE 293,015,119298,Kane; Daniel Mertz,9999,0,9999,0
1668412930078,CSE 293,016,119299,Kriegman; David J,9999,0,9999,0
1668412930078,CSE 293,017,119300,Kumar; Arun Kumar,9999,0,9999,0
1668412930078,CSE 293,018,119301,Lerner; Sorin,9999,0,9999,0
1668412930078,CSE 293,019,119302,Lovett; Shachar,9999,0,9999,0
1668412930078,CSE 293,020,119303,McAuley; Julian John,9999,0,9999,0
1668412930078,CSE 293,021,119304,Micciancio; Daniele,9999,0,9999,0
1668412930078,CSE 293,022,119367,Orailoglu; Alex,9999,0,9999,0
1668412930078,CSE 293,023,119382,Paturi; Ramamohan,9999,0,9999,0
1668412930078,CSE 293,024,119404,Polikarpova; Nadezhda,9999,0,9999,0
1668412930078,CSE 293,025,119406,Politz; Joseph Gibbs,9999,0,9999,0
1668412930078,CSE 293,026,119411,Porter; George M,9999,0,9999,0
1668412930078,CSE 293,027,119414,Porter; Leonard Emerson,9999,0,9999,0
1668412930078,CSE 293,028,119416,Ramamoorthi; Ravi,9999,0,9999,0
1668412930078,CSE 293,029,119417,Sahoo; Debashis,9999,0,9999,0
1668412930078,CSE 293,030,119420,Saul; Lawrence,9999,0,9999,0
1668412930078,CSE 293,031,119421,Savage; Stefan,9999,0,9999,0
1668412930078,CSE 293,032,119425,Schulze; Jurgen P.,9999,0,9999,0
1668412930078,CSE 293,033,119426,Snoeren; Alex C.,9999,0,9999,0
1668412930078,CSE 293,034,119428,Shang; Jingbo,9999,0,9999,0
1668412930078,CSE 293,035,119430,Stefan; Deian,9999,0,9999,0
1668412930078,CSE 293,036,119431,Su; Hao,9999,0,9999,0
1668412930078,CSE 293,037,119433,Swanson; Steven James,9999,0,9999,0
1668412930078,CSE 293,038,119435,Tullsen; Dean Michael,9999,0,9999,0
1668412930078,CSE 293,039,119483,Voelker; Geoffrey M.,9999,0,9999,0
1668412930078,CSE 293,040,119537,Zhao; Jishen,9999,0,9999,0
1668412930078,CSE 293,041,119538,Zhou; Yuan-Yuan,9999,0,9999,0
1668412930078,CSE 293,042,119539,Gao; Sicun,9999,0,9999,0
1668412930078,CSE 293,043,119540,Weibel; Nadir,9999,0,9999,0
1668412930078,CSE 293,044,119541,Gupta; Rajesh K.,9999,0,9999,0
1668412930078,CSE 293,045,126410,Vaccaro; Kristen Marie,9999,0,9999,0
1668412930078,CSE 293,046,126411,Klemke; Richard,9999,0,9999,0
1668412930506,CSE 294,A00,102459,Voelker; Geoffrey M.,0,0,0,0
1668412930506,CSE 294,B00,111322,Orailoglu; Alex,0,0,0,0
1668412930944,DSE 201,A00,096914,Deutsch; Alin Bernard,30,0,30,0
1668412931382,DSE 210,A00,096915,Dasgupta; Sanjoy,30,0,30,0
1668412931807,DSE 260A,A00,096916,Altintas De Callaf; Ilkay,30,0,30,0
1668412932241,ECE 200,001,103586,Antipa; Nicholas A,9999,0,9999,0
1668412932241,ECE 200,002,103587,Atanasov; Nikolay A.,9999,0,9999,0
1668412932241,ECE 200,003,103588,Bharadia; Dinesh,9999,0,9999,0
1668412932241,ECE 200,004,103589,Cheng; Chung Kuan,9999,0,9999,0
1668412932241,ECE 200,005,103590,Cosman; Pamela C.,9999,0,9999,0
1668412932241,ECE 200,006,103591,Dayeh; Shadi Ahmad,9999,0,9999,0
1668412932241,ECE 200,007,103592,Fainman; Yeshaiahu,9999,0,9999,0
1668412932241,ECE 200,008,103593,Ford; Joseph Earl,9999,0,9999,0
1668412932241,ECE 200,009,103594,Franceschetti; Massimo,9999,0,9999,0
1668412932241,ECE 200,010,103595,Fullerton; Eric E,9999,0,9999,0
1668412932241,ECE 200,011,103596,Galton; Ian A,9999,0,9999,0
1668412932241,ECE 200,012,103597,Gilja; Vikash,9999,0,9999,0
1668412932241,ECE 200,013,103598,Hall; Drew A.,9999,0,9999,0
1668412932241,ECE 200,014,103599,Hsueh; Tzu-Chien,9999,0,9999,0
1668412932241,ECE 200,015,103600,Javidi; Tara,9999,0,9999,0
1668412932241,ECE 200,016,103601,Kahng; Andrew Byun,9999,0,9999,0
1668412932241,ECE 200,017,103602,Kim; Young-Han,9999,0,9999,0
1668412932241,ECE 200,018,103603,Koushanfar; Farinaz,9999,0,9999,0
1668412932241,ECE 200,019,103604,Kuzum; Duygu,9999,0,9999,0
1668412932241,ECE 200,020,103605,Le; Hanh-Phuc,9999,0,9999,0
1668412932241,ECE 200,021,103606,Lin; Bill,9999,0,9999,0
1668412932241,ECE 200,022,103607,Liu; Zhaowei,9998,0,9999,1
1668412932241,ECE 200,023,103608,Lo; Yu-Hwa,9999,0,9999,0
1668412932241,ECE 200,024,103609,Lomakin; Vitaliy,9999,0,9999,0
1668412932241,ECE 200,025,103610,Mercier; Patrick Philip,9999,0,9999,0
1668412932241,ECE 200,026,103611,Meyer; Florian,9999,0,9999,0
1668412932241,ECE 200,027,103612,Milstein; Laurence B.,9999,0,9999,0
1668412932241,ECE 200,028,103613,Mir Arabbaygi; Siavash,9999,0,9999,0
1668412932241,ECE 200,029,103614,Mookherjea; Shayan,9999,0,9999,0
1668412932241,ECE 200,030,103615,Morris; Karcher William,9999,0,9999,0
1668412932241,ECE 200,031,103616,Ng; Tse Nga,9999,0,9999,0
1668412932241,ECE 200,032,103617,Nguyen; Truong Quang,9999,0,9999,0
1668412932241,ECE 200,033,103618,Nomura; Kenji,9999,0,9999,0
1668412932241,ECE 200,034,103619,Orlitsky; Alon,9999,0,9999,0
1668412932241,ECE 200,035,103620,Pal; Piya,9999,0,9999,0
1668412932241,ECE 200,036,103621,Papen; George C.,9999,0,9999,0
1668412932241,ECE 200,037,103622,Radic; Stojan,9999,0,9999,0
1668412932241,ECE 200,038,103623,Rao; Bhaskar D.,9999,0,9999,0
1668412932241,ECE 200,039,103624,Rao; Ramesh R,9999,0,9999,0
1668412932241,ECE 200,040,103625,Rebeiz; Gabriel,9999,0,9999,0
1668412932241,ECE 200,041,103626,Sanford; John R,9999,0,9999,0
1668412932241,ECE 200,042,103627,Siegel; Paul H.,9999,0,9999,0
1668412932241,ECE 200,043,103628,Sievenpiper; Daniel F.,9999,0,9999,0
1668412932241,ECE 200,044,103629,Sworder; David D.,9999,0,9999,0
1668412932241,ECE 200,045,103630,Taur; Yuan,9999,0,9999,0
1668412932241,ECE 200,046,103631,Touri; Behrouz,9999,0,9999,0
1668412932241,ECE 200,047,103632,Trivedi; Mohan M.,9999,0,9999,0
1668412932241,ECE 200,048,103633,Vasconcelos; Nuno,9999,0,9999,0
1668412932241,ECE 200,049,103634,Wang; Xiaolong,9999,0,9999,0
1668412932241,ECE 200,050,103635,Xie; Pengtao,9999,0,9999,0
1668412932241,ECE 200,051,103636,Yip; Michael,9999,0,9999,0
1668412932241,ECE 200,052,103637,Zeger; Kenneth A.,999,0,999,0
1668412932241,ECE 200,053,103638,Zhang; Xinyu,9999,0,9999,0
1668412932241,ECE 200,054,103639,Turakhia; Yatish Girish,9999,0,9999,0
1668412932241,ECE 200,055,103640,Kang; Mingu,9999,0,9999,0
1668412932241,ECE 200,056,103641,Shi; Yuanyuan,9999,0,9999,0
1668412932241,ECE 200,057,103642,Wang; Edward Jay,9999,0,9999,0
1668412932241,ECE 200,058,103643,Zheng; Yang,9999,0,9999,0
1668412932669,ECE 202,A00,103644,Kuzum; Duygu,0,3,0,0
1668412933107,ECE 212BN,A00,103646,Ng; Tse Nga,0,0,0,0
1668412933536,ECE 221,A00,111493,Staff,0,0,0,0
1668412933993,ECE 222B,A00,103647,Lomakin; Vitaliy,0,0,0,0
1668412934433,ECE 230B,A00,103648,Taur; Yuan,0,0,0,0
1668412934857,ECE 238B,A00,103649,Garay; Javier,0,0,0,0
1668412935282,ECE 240B,A00,112900,Fainman; Yeshaiahu,0,0,0,0
1668412935738,ECE 247A,A00,103650,Jokerst; Jesse Vincent,0,0,0,0
1668412936172,ECE 247B,A00,103651,Wang; Joseph,0,1,0,0
1668412936604,ECE 250,A00,103652,Siegel; Paul H.,0,17,0,0
1668412937034,ECE 251A,A00,103654,Rao; Bhaskar D.,0,14,0,0
1668412937458,ECE 257B,A00,103655,Bharadia; Dinesh,0,7,0,0
1668412937881,ECE 258A,A00,103656,Milstein; Laurence B.,0,5,0,0
1668412938306,ECE 260B,A00,103658,Kang; Mingu,0,24,0,0
1668412938736,ECE 264A,A00,103659,Galton; Ian A,0,6,0,0
1668412939159,ECE 265A,A00,103661,Gudem; Prasad S.S.,0,2,0,0
1668412939582,ECE 265D,A00,103662,Gudem; Prasad S.S.,0,5,0,0
1668412940011,ECE 268,A00,103663,Koushanfar; Farinaz,0,9,0,0
1668412940441,ECE 269,A01,103665,Pal; Piya,0,56,0,0
1668412940869,ECE 271B,A00,103666,Vasconcelos; Manuela,0,25,0,0
1668412941297,ECE 276A,A00,103667,Atanasov; Nikolay A.,0,20,0,0
1668412941721,ECE 277,A00,103668,An; Cheolhong,0,40,0,0
1668412942169,ECE 279,A00,117947,Hall; Drew A.,0,5,0,0
1668412943045,ECE 283,A00,103670,Hsueh; Tzu-Chien,0,7,0,0
1668412943473,ECE 284,A00,103671,Turakhia; Yatish Girish,0,10,0,0
1668412943900,ECE 285,A00,103672,Zheng; Yang,0,7,0,0
1668412943900,ECE 285,B00,103673,Sworder; David D.,0,16,0,0
1668412944327,ECE 287,A00,103676,Javidi; Tara,0,1,0,0
1668412944757,MATH 200B,A00,098023,Salehi Golsefidy; Alireza,12,0,15,3
1668412945189,MATH 202B,A00,098024,Rhoades; Brendon Patrick,9,0,15,6
1668412945619,MATH 203B,A00,098025,Oprea; Dragos N.,10,0,15,5
1668412946052,MATH 204B,A00,098026,Sorensen; Claus M,13,0,15,2
1668412946488,MATH 208,A00,098027,Izadi; Elham,7,0,10,3
1668412946921,MATH 209,A00,098028,Pollack; Aaron,10,0,10,0
1668412947351,MATH 211A,A00,112919,Rogalski; Daniel,9,0,10,1
1668412947788,MATH 211B,A00,112920,Seward; Brandon M.,9,0,10,1
1668412948216,MATH 218,A00,098029,Li; Bo,10,0,10,0
1668412948709,MATH 220B,A00,098030,Novak; Jonathan I,11,0,15,4
1668412949143,MATH 221A,A00,098031,Ebenfelt; Peter F,13,0,15,2
1668412949574,MATH 231B,A00,098032,Zlatos; Andrej,12,0,15,3
1668412950005,MATH 240B,A00,098033,Ni; Lei,9,0,15,6
1668412950432,MATH 243,A00,098034,Jekel; David Andrew,10,0,10,0
1668412950866,MATH 245A,A00,098035,Nie; Jiawang,0,0,15,16
1668412951303,MATH 248,A00,098036,Bejenaru; Ioan,10,0,10,0
1668412951736,MATH 250B,A00,098037,Spolaor; Luca,14,0,15,1
1668412952168,MATH 258,A00,098038,Ni; Lei,10,0,10,0
1668412952594,MATH 264B,A00,098041,Rhoades; Brendon Patrick,9,0,15,6
1668412953026,MATH 268,A00,098042,Buss; Samuel R,10,0,10,0
1668412953458,MATH 269,A00,098043,Rhoades; Brendon Patrick,10,0,10,0
1668412953884,MATH 270B,A00,098044,Li; Bo,10,0,15,5
1668412954313,MATH 272B,A00,098045,Holst; Michael J,13,0,15,2
1668412954749,MATH 273A,A00,098046,Tian; Xiaochuan,10,0,15,5
1668412955189,MATH 275,A01,098048,Tian; Xiaochuan,6,0,10,4
1668412955617,MATH 278A,A00,098049,Holst; Michael J,8,0,10,2
1668412956052,MATH 278B,A00,098050,Cloninger; Alexander,10,0,10,0
1668412956481,MATH 278C,A00,098051,Nie; Jiawang,6,0,10,4
1668412956910,MATH 280B,A00,098052,Zheng; Tianyi,8,0,15,7
1668412957356,MATH 281B,A00,098053,Bradic; Jelena,0,0,15,15
1668412957780,MATH 282B,A00,098054,Arias-Castro; Ery,0,0,15,15
1668412958209,MATH 285,A00,098055,Fitzsimmons; Patrick J,0,0,15,17
1668412958649,MATH 287B,A00,098056,Arias-Castro; Ery,2,0,15,13
1668412959080,MATH 288,A00,098057,Agarwal; Pooja,9,0,10,1
1668412959080,MATH 288,B00,098058,Zhang; Danna,8,0,10,2
1668412959080,MATH 288,C00,098059,Williams; Ruth J,9,0,10,1
1668412959518,MATH 290B,A00,098060,Roberts; Justin Deritter,13,0,15,2
1668412959944,MATH 292,A00,098061,Belmont; Eva Kinoshita,10,0,10,0
1668412960369,MATH 295,A00,098062,Suk; Andrew Hoon,48,0,50,2
1668412960804,MATH 296,A00,098063,Novak; Jonathan I,20,0,20,0
1668412961232,MATH 297,001,098064,Gamst; Anthony Collins,9997,0,9999,2
1668413464495,COGS 205,A00,101395,Chiba; Andrea,19,0,20,1
1668413464926,COGS 210B,001,101404,Greene; Deanna Jacquelyn,9998,0,9999,1
1668413464926,COGS 210B,002,101417,Xia; Haijun,9999,0,9999,0
1668413464926,COGS 210B,003,101422,Nitz; Douglas A.,9999,0,9999,0
1668413464926,COGS 210B,004,101423,Hollan; James D.,9998,0,9999,1
1668413464926,COGS 210B,005,101424,Deak; Gedeon O.,9998,0,9999,1
1668413464926,COGS 210B,006,101425,Rossano; Federico,9999,0,9999,0
1668413465362,COGS 211B,A00,101427,Coulson; Seana M,9996,0,9999,3
1668413465787,COGS 220,A00,101428,Hollan; James D.,0,1,25,25
1668413466212,COGS 229,A00,101429,Dow; Steven P,18,0,25,7
1668413466645,COGS 230,A00,101430,Klemmer; Scott R,11,0,17,6
1668413467069,COGS 234,A00,101431,Xia; Haijun,1,0,25,24
1668413467495,COGS 260,A00,101432,Kiyonaga; Anastasia,21,0,25,4
1668413467495,COGS 260,B00,101433,Kirsh; David Joel,15,0,25,10
1668413467919,CSE 202,A00,102371,Impagliazzo; Russell,0,21,0,0
1668413468346,CSE 203B,A01,102373,Cheng; Chung Kuan,0,17,0,0
1668413468788,CSE 208,A00,102374,Micciancio; Daniele,0,1,0,0
1668413469213,CSE 209A,A00,112895,Impagliazzo; Russell,0,3,15,15
1668413469637,CSE 209B,A00,108005,Bellare; Mihir,0,1,0,0
1668413470062,CSE 210,A00,113163,Coblenz; Michael J,0,32,0,0
1668413470489,CSE 219,A00,106111,Dow; Steven P,0,0,20,20
1668413470923,CSE 221,A00,102376,Voelker; Geoffrey M.,0,21,0,0
1668413471350,CSE 224,A01,102378,Porter; George M,0,66,0,0
1668413471777,CSE 229A,A00,102379,Savage; Stefan,0,2,0,0
1668413472207,CSE 229C,A00,102380,Munyaka; Imani N. S.,0,0,0,0
1668413472632,CSE 232B,A00,102382,Deutsch; Alin Bernard,0,9,0,0
1668413473087,CSE 234,A01,112904,Kumar; Arun Kumar,0,0,0,0
1668413473511,CSE 237A,A00,102383,Rosing; Tajana Simunic,0,15,0,0
1668413473935,CSE 239A,A00,102384,Deutsch; Alin Bernard,0,3,0,0
1668413474366,CSE 239B,A00,102385,Polikarpova; Nadezhda,0,0,0,0
1668413474790,CSE 240A,A00,102386,Pannuto; Patrick William,0,14,0,0
1668413475220,CSE 240B,A00,102387,Zhao; Jishen,0,17,0,0
1668413475652,CSE 241A,A00,106406,Kang; Mingu,0,1,0,0
1668413476079,CSE 249B,A00,102388,Kahng; Andrew Byun,0,1,8,8
1668413476508,CSE 251B,A01,102392,Cottrell; Garrison W,0,16,0,0
1668413476508,CSE 251B,A02,102393,Cottrell; Garrison W,0,15,0,0
1668413476938,CSE 252B,A00,102394,Ochoa; Benjamin Lawrence,0,25,0,0
1668413477379,CSE 257,A01,102396,Gao; Sicun,0,60,0,0
1668413477807,CSE 272,A00,102397,Li; Tzumao,0,3,0,0
1668413478230,CSE 274,A00,111323,Chern; Albert Ren-Haur,0,6,0,0
1668413478659,CSE 282,A00,102398,Pevzner; Pavel Arkadjevich,0,0,0,0
1668413479084,CSE 284,A00,114175,Gymrek; Melissa Ann,0,4,0,0
1668413479507,CSE 290,A00,102399,Chandraker; Manmohan Krishna,0,4,0,0
1668413479507,CSE 290,B00,102400,Vaccaro; Kristen Marie,0,0,25,25
1668413479507,CSE 290,C00,102414,Pannuto; Patrick William,0,1,25,25
1668413479507,CSE 290,D00,102427,Pevzner; Pavel Arkadjevich,0,0,0,0
1668413479507,CSE 290,E00,102429,Zhao; Jishen,0,1,0,0
1668413479507,CSE 290,F00,102436,Tullsen; Dean Michael,0,2,0,0
1668413479507,CSE 290,G00,102440,Christensen; Henrik I,0,2,20,20
1668413479944,CSE 291,A00,102443,Su; Hao,0,0,0,0
1668413479944,CSE 291,B00,102448,Polikarpova; Nadezhda,0,0,0,0
1668413479944,CSE 291,C00,102453,Vaccaro; Kristen Marie,0,0,0,0
1668413479944,CSE 291,D00,111343,Savage; Stefan,0,0,0,0
1668413479944,CSE 291,E00,116474,Claffy; Kimberly Claire,0,0,0,0
1668413479944,CSE 291,F00,116479,Pasquale; Joseph,0,0,0,0
1668413480386,CSE 293,001,119111,Bafna; Vineet,9999,0,9999,0
1668413480386,CSE 293,002,119118,Bellare; Mihir,9999,0,9999,0
1668413480386,CSE 293,003,119122,Berg-Kirkpatrick; Taylor D,9999,0,9999,0
1668413480386,CSE 293,004,119135,Christensen; Henrik I,9999,0,9999,0
1668413480386,CSE 293,005,119142,Cottrell; Garrison W,9999,0,9999,0
1668413480386,CSE 293,006,119146,Deutsch; Alin Bernard,9999,0,9999,0
1668413480386,CSE 293,007,119159,Esmaeilzadeh; Hadi,9999,0,9999,0
1668413480386,CSE 293,008,119166,Freund; Yoav,9999,0,9999,0
1668413480386,CSE 293,009,119170,Griswold; William G.,9999,0,9999,0
1668413480386,CSE 293,010,119183,Gymrek; Melissa Ann,9999,0,9999,0
1668413480386,CSE 293,011,119190,Heninger; Nadia A,9999,0,9999,0
1668413480386,CSE 293,012,119230,Impagliazzo; Russell,9999,0,9999,0
1668413480386,CSE 293,013,119232,Jhala; Ranjit,9999,0,9999,0
1668413480386,CSE 293,014,119233,Kahng; Andrew Byun,9999,0,9999,0
1668413480386,CSE 293,015,119298,Kane; Daniel Mertz,9999,0,9999,0
1668413480386,CSE 293,016,119299,Kriegman; David J,9999,0,9999,0
1668413480386,CSE 293,017,119300,Kumar; Arun Kumar,9999,0,9999,0
1668413480386,CSE 293,018,119301,Lerner; Sorin,9999,0,9999,0
1668413480386,CSE 293,019,119302,Lovett; Shachar,9999,0,9999,0
1668413480386,CSE 293,020,119303,McAuley; Julian John,9999,0,9999,0
1668413480386,CSE 293,021,119304,Micciancio; Daniele,9999,0,9999,0
1668413480386,CSE 293,022,119367,Orailoglu; Alex,9999,0,9999,0
1668413480386,CSE 293,023,119382,Paturi; Ramamohan,9999,0,9999,0
1668413480386,CSE 293,024,119404,Polikarpova; Nadezhda,9999,0,9999,0
1668413480386,CSE 293,025,119406,Politz; Joseph Gibbs,9999,0,9999,0
1668413480386,CSE 293,026,119411,Porter; George M,9999,0,9999,0
1668413480386,CSE 293,027,119414,Porter; Leonard Emerson,9999,0,9999,0
1668413480386,CSE 293,028,119416,Ramamoorthi; Ravi,9999,0,9999,0
1668413480386,CSE 293,029,119417,Sahoo; Debashis,9999,0,9999,0
1668413480386,CSE 293,030,119420,Saul; Lawrence,9999,0,9999,0
1668413480386,CSE 293,031,119421,Savage; Stefan,9999,0,9999,0
1668413480386,CSE 293,032,119425,Schulze; Jurgen P.,9999,0,9999,0
1668413480386,CSE 293,033,119426,Snoeren; Alex C.,9999,0,9999,0
1668413480386,CSE 293,034,119428,Shang; Jingbo,9999,0,9999,0
1668413480386,CSE 293,035,119430,Stefan; Deian,9999,0,9999,0
1668413480386,CSE 293,036,119431,Su; Hao,9999,0,9999,0
1668413480386,CSE 293,037,119433,Swanson; Steven James,9999,0,9999,0
1668413480386,CSE 293,038,119435,Tullsen; Dean Michael,9999,0,9999,0
1668413480386,CSE 293,039,119483,Voelker; Geoffrey M.,9999,0,9999,0
1668413480386,CSE 293,040,119537,Zhao; Jishen,9999,0,9999,0
1668413480386,CSE 293,041,119538,Zhou; Yuan-Yuan,9999,0,9999,0
1668413480386,CSE 293,042,119539,Gao; Sicun,9999,0,9999,0
1668413480386,CSE 293,043,119540,Weibel; Nadir,9999,0,9999,0
1668413480386,CSE 293,044,119541,Gupta; Rajesh K.,9999,0,9999,0
1668413480386,CSE 293,045,126410,Vaccaro; Kristen Marie,9999,0,9999,0
1668413480386,CSE 293,046,126411,Klemke; Richard,9999,0,9999,0
1668413480813,CSE 294,A00,102459,Voelker; Geoffrey M.,0,0,0,0
1668413480813,CSE 294,B00,111322,Orailoglu; Alex,0,0,0,0
1668413481243,DSE 201,A00,096914,Deutsch; Alin Bernard,30,0,30,0
1668413481667,DSE 210,A00,096915,Dasgupta; Sanjoy,30,0,30,0
1668413482115,DSE 260A,A00,096916,Altintas De Callaf; Ilkay,30,0,30,0
1668413482544,ECE 200,001,103586,Antipa; Nicholas A,9999,0,9999,0
1668413482544,ECE 200,002,103587,Atanasov; Nikolay A.,9999,0,9999,0
1668413482544,ECE 200,003,103588,Bharadia; Dinesh,9999,0,9999,0
1668413482544,ECE 200,004,103589,Cheng; Chung Kuan,9999,0,9999,0
1668413482544,ECE 200,005,103590,Cosman; Pamela C.,9999,0,9999,0
1668413482544,ECE 200,006,103591,Dayeh; Shadi Ahmad,9999,0,9999,0
1668413482544,ECE 200,007,103592,Fainman; Yeshaiahu,9999,0,9999,0
1668413482544,ECE 200,008,103593,Ford; Joseph Earl,9999,0,9999,0
1668413482544,ECE 200,009,103594,Franceschetti; Massimo,9999,0,9999,0
1668413482544,ECE 200,010,103595,Fullerton; Eric E,9999,0,9999,0
1668413482544,ECE 200,011,103596,Galton; Ian A,9999,0,9999,0
1668413482544,ECE 200,012,103597,Gilja; Vikash,9999,0,9999,0
1668413482544,ECE 200,013,103598,Hall; Drew A.,9999,0,9999,0
1668413482544,ECE 200,014,103599,Hsueh; Tzu-Chien,9999,0,9999,0
1668413482544,ECE 200,015,103600,Javidi; Tara,9999,0,9999,0
1668413482544,ECE 200,016,103601,Kahng; Andrew Byun,9999,0,9999,0
1668413482544,ECE 200,017,103602,Kim; Young-Han,9999,0,9999,0
1668413482544,ECE 200,018,103603,Koushanfar; Farinaz,9999,0,9999,0
1668413482544,ECE 200,019,103604,Kuzum; Duygu,9999,0,9999,0
1668413482544,ECE 200,020,103605,Le; Hanh-Phuc,9999,0,9999,0
1668413482544,ECE 200,021,103606,Lin; Bill,9999,0,9999,0
1668413482544,ECE 200,022,103607,Liu; Zhaowei,9998,0,9999,1
1668413482544,ECE 200,023,103608,Lo; Yu-Hwa,9999,0,9999,0
1668413482544,ECE 200,024,103609,Lomakin; Vitaliy,9999,0,9999,0
1668413482544,ECE 200,025,103610,Mercier; Patrick Philip,9999,0,9999,0
1668413482544,ECE 200,026,103611,Meyer; Florian,9999,0,9999,0
1668413482544,ECE 200,027,103612,Milstein; Laurence B.,9999,0,9999,0
1668413482544,ECE 200,028,103613,Mir Arabbaygi; Siavash,9999,0,9999,0
1668413482544,ECE 200,029,103614,Mookherjea; Shayan,9999,0,9999,0
1668413482544,ECE 200,030,103615,Morris; Karcher William,9999,0,9999,0
1668413482544,ECE 200,031,103616,Ng; Tse Nga,9999,0,9999,0
1668413482544,ECE 200,032,103617,Nguyen; Truong Quang,9999,0,9999,0
1668413482544,ECE 200,033,103618,Nomura; Kenji,9999,0,9999,0
1668413482544,ECE 200,034,103619,Orlitsky; Alon,9999,0,9999,0
1668413482544,ECE 200,035,103620,Pal; Piya,9999,0,9999,0
1668413482544,ECE 200,036,103621,Papen; George C.,9999,0,9999,0
1668413482544,ECE 200,037,103622,Radic; Stojan,9999,0,9999,0
1668413482544,ECE 200,038,103623,Rao; Bhaskar D.,9999,0,9999,0
1668413482544,ECE 200,039,103624,Rao; Ramesh R,9999,0,9999,0
1668413482544,ECE 200,040,103625,Rebeiz; Gabriel,9999,0,9999,0
1668413482544,ECE 200,041,103626,Sanford; John R,9999,0,9999,0
1668413482544,ECE 200,042,103627,Siegel; Paul H.,9999,0,9999,0
1668413482544,ECE 200,043,103628,Sievenpiper; Daniel F.,9999,0,9999,0
1668413482544,ECE 200,044,103629,Sworder; David D.,9999,0,9999,0
1668413482544,ECE 200,045,103630,Taur; Yuan,9999,0,9999,0
1668413482544,ECE 200,046,103631,Touri; Behrouz,9999,0,9999,0
1668413482544,ECE 200,047,103632,Trivedi; Mohan M.,9999,0,9999,0
1668413482544,ECE 200,048,103633,Vasconcelos; Nuno,9999,0,9999,0
1668413482544,ECE 200,049,103634,Wang; Xiaolong,9999,0,9999,0
1668413482544,ECE 200,050,103635,Xie; Pengtao,9999,0,9999,0
1668413482544,ECE 200,051,103636,Yip; Michael,9999,0,9999,0
1668413482544,ECE 200,052,103637,Zeger; Kenneth A.,999,0,999,0
1668413482544,ECE 200,053,103638,Zhang; Xinyu,9999,0,9999,0
1668413482544,ECE 200,054,103639,Turakhia; Yatish Girish,9999,0,9999,0
1668413482544,ECE 200,055,103640,Kang; Mingu,9999,0,9999,0
1668413482544,ECE 200,056,103641,Shi; Yuanyuan,9999,0,9999,0
1668413482544,ECE 200,057,103642,Wang; Edward Jay,9999,0,9999,0
1668413482544,ECE 200,058,103643,Zheng; Yang,9999,0,9999,0
1668413482970,ECE 202,A00,103644,Kuzum; Duygu,0,11,0,0
1668413483396,ECE 212BN,A00,103646,Ng; Tse Nga,0,0,0,0
1668413483819,ECE 221,A00,111493,Staff,0,0,0,0
1668413484244,ECE 222B,A00,103647,Lomakin; Vitaliy,0,2,0,0
1668413484668,ECE 230B,A00,103648,Taur; Yuan,0,0,0,0
1668413485095,ECE 238B,A00,103649,Garay; Javier,0,0,0,0
1668413485518,ECE 240B,A00,112900,Fainman; Yeshaiahu,0,0,0,0
1668413485948,ECE 247A,A00,103650,Jokerst; Jesse Vincent,0,1,0,0
1668413486384,ECE 247B,A00,103651,Wang; Joseph,0,2,0,0
1668413486808,ECE 250,A00,103652,Siegel; Paul H.,0,29,0,0
1668413487238,ECE 251A,A00,103654,Rao; Bhaskar D.,0,21,0,0
1668413487664,ECE 257B,A00,103655,Bharadia; Dinesh,0,11,0,0
1668413488087,ECE 258A,A00,103656,Milstein; Laurence B.,0,8,0,0
1668413488511,ECE 260B,A00,103658,Kang; Mingu,0,47,0,0
1668413488933,ECE 264A,A00,103659,Galton; Ian A,0,18,0,0
1668413489360,ECE 265A,A00,103661,Gudem; Prasad S.S.,0,6,0,0
1668413489855,ECE 265D,A00,103662,Gudem; Prasad S.S.,0,6,0,0
1668413490291,ECE 268,A00,103663,Koushanfar; Farinaz,0,14,0,0
1668413490723,ECE 269,A01,103665,Pal; Piya,0,89,0,0
1668413491163,ECE 271B,A00,103666,Vasconcelos; Manuela,0,37,0,0
1668413491599,ECE 276A,A00,103667,Atanasov; Nikolay A.,0,36,0,0
1668413492028,ECE 277,A00,103668,An; Cheolhong,0,52,0,0
1668413492455,ECE 279,A00,117947,Hall; Drew A.,0,9,0,0
1668413493310,ECE 283,A00,103670,Hsueh; Tzu-Chien,0,11,0,0
1668413493744,ECE 284,A00,103671,Turakhia; Yatish Girish,0,20,0,0
1668413494169,ECE 285,A00,103672,Zheng; Yang,0,14,0,0
1668413494169,ECE 285,B00,103673,Sworder; David D.,0,28,0,0
1668413494596,ECE 287,A00,103676,Javidi; Tara,0,4,0,0
1668413495026,MATH 200B,A00,098023,Salehi Golsefidy; Alireza,12,0,15,3
1668413495455,MATH 202B,A00,098024,Rhoades; Brendon Patrick,9,0,15,6
1668413495881,MATH 203B,A00,098025,Oprea; Dragos N.,10,0,15,5
1668413496307,MATH 204B,A00,098026,Sorensen; Claus M,13,0,15,2
1668413496739,MATH 208,A00,098027,Izadi; Elham,7,0,10,3
1668413497170,MATH 209,A00,098028,Pollack; Aaron,10,0,10,0
1668413497599,MATH 211A,A00,112919,Rogalski; Daniel,9,0,10,1
1668413498029,MATH 211B,A00,112920,Seward; Brandon M.,9,0,10,1
1668413498455,MATH 218,A00,098029,Li; Bo,10,0,10,0
1668413498976,MATH 220B,A00,098030,Novak; Jonathan I,11,0,15,4
1668413499407,MATH 221A,A00,098031,Ebenfelt; Peter F,13,0,15,2
1668413499841,MATH 231B,A00,098032,Zlatos; Andrej,12,0,15,3
1668413500264,MATH 240B,A00,098033,Ni; Lei,9,0,15,6
1668413500689,MATH 243,A00,098034,Jekel; David Andrew,10,0,10,0
1668413501113,MATH 245A,A00,098035,Nie; Jiawang,0,0,15,16
1668413501535,MATH 248,A00,098036,Bejenaru; Ioan,10,0,10,0
1668413501958,MATH 250B,A00,098037,Spolaor; Luca,14,0,15,1
1668413502385,MATH 258,A00,098038,Ni; Lei,10,0,10,0
1668413502815,MATH 264B,A00,098041,Rhoades; Brendon Patrick,9,0,15,6
1668413503248,MATH 268,A00,098042,Buss; Samuel R,10,0,10,0
1668413503690,MATH 269,A00,098043,Rhoades; Brendon Patrick,10,0,10,0
1668413504117,MATH 270B,A00,098044,Li; Bo,10,0,15,5
1668413504545,MATH 272B,A00,098045,Holst; Michael J,13,0,15,2
1668413504971,MATH 273A,A00,098046,Tian; Xiaochuan,10,0,15,5
1668413505406,MATH 275,A01,098048,Tian; Xiaochuan,6,0,10,4
1668413505837,MATH 278A,A00,098049,Holst; Michael J,8,0,10,2
1668413506269,MATH 278B,A00,098050,Cloninger; Alexander,10,0,10,0
1668413506694,MATH 278C,A00,098051,Nie; Jiawang,6,0,10,4
1668413507119,MATH 280B,A00,098052,Zheng; Tianyi,8,0,15,7
1668413507547,MATH 281B,A00,098053,Bradic; Jelena,0,1,15,15
1668413507973,MATH 282B,A00,098054,Arias-Castro; Ery,0,0,15,15
1668413508400,MATH 285,A00,098055,Fitzsimmons; Patrick J,0,0,15,17
1668413508825,MATH 287B,A00,098056,Arias-Castro; Ery,2,0,15,13
1668413509251,MATH 288,A00,098057,Agarwal; Pooja,9,0,10,1
1668413509251,MATH 288,B00,098058,Zhang; Danna,8,0,10,2
1668413509251,MATH 288,C00,098059,Williams; Ruth J,9,0,10,1
1668413509682,MATH 290B,A00,098060,Roberts; Justin Deritter,13,0,15,2
1668413510108,MATH 292,A00,098061,Belmont; Eva Kinoshita,10,0,10,0
1668413510538,MATH 295,A00,098062,Suk; Andrew Hoon,48,0,50,2
1668413510966,MATH 296,A00,098063,Novak; Jonathan I,20,0,20,0
1668413511395,MATH 297,001,098064,Gamst; Anthony Collins,9997,0,9999,2
1668414020193,COGS 205,A00,101395,Chiba; Andrea,19,0,20,1
1668414020646,COGS 210B,001,101404,Greene; Deanna Jacquelyn,9998,0,9999,1
1668414020646,COGS 210B,002,101417,Xia; Haijun,9999,0,9999,0
1668414020646,COGS 210B,003,101422,Nitz; Douglas A.,9999,0,9999,0
1668414020646,COGS 210B,004,101423,Hollan; James D.,9998,0,9999,1
1668414020646,COGS 210B,005,101424,Deak; Gedeon O.,9998,0,9999,1
1668414020646,COGS 210B,006,101425,Rossano; Federico,9999,0,9999,0
1668414021090,COGS 211B,A00,101427,Coulson; Seana M,9996,0,9999,3
1668414021513,COGS 220,A00,101428,Hollan; James D.,0,1,25,25
1668414021948,COGS 229,A00,101429,Dow; Steven P,18,0,25,7
1668414022381,COGS 230,A00,101430,Klemmer; Scott R,11,0,17,6
1668414022807,COGS 234,A00,101431,Xia; Haijun,1,0,25,24
1668414023242,COGS 260,A00,101432,Kiyonaga; Anastasia,21,0,25,4
1668414023242,COGS 260,B00,101433,Kirsh; David Joel,15,0,25,10
1668414023678,CSE 202,A00,102371,Impagliazzo; Russell,0,23,0,0
1668414024114,CSE 203B,A01,102373,Cheng; Chung Kuan,0,16,0,0
1668414024539,CSE 208,A00,102374,Micciancio; Daniele,0,1,0,0
1668414024971,CSE 209A,A00,112895,Impagliazzo; Russell,0,3,15,15
1668414025398,CSE 209B,A00,108005,Bellare; Mihir,0,2,0,0
1668414025830,CSE 210,A00,113163,Coblenz; Michael J,0,34,0,0
1668414026253,CSE 219,A00,106111,Dow; Steven P,0,0,20,20
1668414026682,CSE 221,A00,102376,Voelker; Geoffrey M.,0,22,0,0
1668414027105,CSE 224,A01,102378,Porter; George M,0,80,0,0
1668414027528,CSE 229A,A00,102379,Savage; Stefan,0,4,0,0
1668414027954,CSE 229C,A00,102380,Munyaka; Imani N. S.,0,3,0,0
1668414028377,CSE 232B,A00,102382,Deutsch; Alin Bernard,0,9,0,0
1668414028805,CSE 234,A01,112904,Kumar; Arun Kumar,0,0,0,0
1668414029227,CSE 237A,A00,102383,Rosing; Tajana Simunic,0,19,0,0
1668414029653,CSE 239A,A00,102384,Deutsch; Alin Bernard,0,4,0,0
1668414030076,CSE 239B,A00,102385,Polikarpova; Nadezhda,0,1,0,0
1668414030508,CSE 240A,A00,102386,Pannuto; Patrick William,0,18,0,0
1668414030939,CSE 240B,A00,102387,Zhao; Jishen,0,17,0,0
1668414031362,CSE 241A,A00,106406,Kang; Mingu,0,0,0,0
1668414031791,CSE 249B,A00,102388,Kahng; Andrew Byun,0,1,8,8
1668414032217,CSE 251B,A01,102392,Cottrell; Garrison W,0,17,0,0
1668414032217,CSE 251B,A02,102393,Cottrell; Garrison W,0,17,0,0
1668414032651,CSE 252B,A00,102394,Ochoa; Benjamin Lawrence,0,29,0,0
1668414033075,CSE 257,A01,102396,Gao; Sicun,0,65,0,0
1668414033502,CSE 272,A00,102397,Li; Tzumao,0,3,0,0
1668414033929,CSE 274,A00,111323,Chern; Albert Ren-Haur,0,6,0,0
1668414034356,CSE 282,A00,102398,Pevzner; Pavel Arkadjevich,0,0,0,0
1668414034781,CSE 284,A00,114175,Gymrek; Melissa Ann,0,5,0,0
1668414035216,CSE 290,A00,102399,Chandraker; Manmohan Krishna,0,3,0,0
1668414035216,CSE 290,B00,102400,Vaccaro; Kristen Marie,0,1,25,25
1668414035216,CSE 290,C00,102414,Pannuto; Patrick William,0,1,25,25
1668414035216,CSE 290,D00,102427,Pevzner; Pavel Arkadjevich,0,0,0,0
1668414035216,CSE 290,E00,102429,Zhao; Jishen,0,1,0,0
1668414035216,CSE 290,F00,102436,Tullsen; Dean Michael,0,2,0,0
1668414035216,CSE 290,G00,102440,Christensen; Henrik I,0,3,20,20
1668414035653,CSE 291,A00,102443,Su; Hao,0,0,0,0
1668414035653,CSE 291,B00,102448,Polikarpova; Nadezhda,0,0,0,0
1668414035653,CSE 291,C00,102453,Vaccaro; Kristen Marie,0,0,0,0
1668414035653,CSE 291,D00,111343,Savage; Stefan,0,0,0,0
1668414035653,CSE 291,E00,116474,Claffy; Kimberly Claire,0,0,0,0
1668414035653,CSE 291,F00,116479,Pasquale; Joseph,0,0,0,0
1668414036095,CSE 293,001,119111,Bafna; Vineet,9999,0,9999,0
1668414036095,CSE 293,002,119118,Bellare; Mihir,9999,0,9999,0
1668414036095,CSE 293,003,119122,Berg-Kirkpatrick; Taylor D,9999,0,9999,0
1668414036095,CSE 293,004,119135,Christensen; Henrik I,9999,0,9999,0
1668414036095,CSE 293,005,119142,Cottrell; Garrison W,9999,0,9999,0
1668414036095,CSE 293,006,119146,Deutsch; Alin Bernard,9999,0,9999,0
1668414036095,CSE 293,007,119159,Esmaeilzadeh; Hadi,9999,0,9999,0
1668414036095,CSE 293,008,119166,Freund; Yoav,9999,0,9999,0
1668414036095,CSE 293,009,119170,Griswold; William G.,9999,0,9999,0
1668414036095,CSE 293,010,119183,Gymrek; Melissa Ann,9999,0,9999,0
1668414036095,CSE 293,011,119190,Heninger; Nadia A,9999,0,9999,0
1668414036095,CSE 293,012,119230,Impagliazzo; Russell,9999,0,9999,0
1668414036095,CSE 293,013,119232,Jhala; Ranjit,9999,0,9999,0
1668414036095,CSE 293,014,119233,Kahng; Andrew Byun,9999,0,9999,0
1668414036095,CSE 293,015,119298,Kane; Daniel Mertz,9999,0,9999,0
1668414036095,CSE 293,016,119299,Kriegman; David J,9999,0,9999,0
1668414036095,CSE 293,017,119300,Kumar; Arun Kumar,9999,0,9999,0
1668414036095,CSE 293,018,119301,Lerner; Sorin,9999,0,9999,0
1668414036095,CSE 293,019,119302,Lovett; Shachar,9999,0,9999,0
1668414036095,CSE 293,020,119303,McAuley; Julian John,9999,0,9999,0
1668414036095,CSE 293,021,119304,Micciancio; Daniele,9999,0,9999,0
1668414036095,CSE 293,022,119367,Orailoglu; Alex,9999,0,9999,0
1668414036095,CSE 293,023,119382,Paturi; Ramamohan,9999,0,9999,0
1668414036095,CSE 293,024,119404,Polikarpova; Nadezhda,9999,0,9999,0
1668414036095,CSE 293,025,119406,Politz; Joseph Gibbs,9999,0,9999,0
1668414036095,CSE 293,026,119411,Porter; George M,9999,0,9999,0
1668414036095,CSE 293,027,119414,Porter; Leonard Emerson,9999,0,9999,0
1668414036095,CSE 293,028,119416,Ramamoorthi; Ravi,9999,0,9999,0
1668414036095,CSE 293,029,119417,Sahoo; Debashis,9999,0,9999,0
1668414036095,CSE 293,030,119420,Saul; Lawrence,9999,0,9999,0
1668414036095,CSE 293,031,119421,Savage; Stefan,9999,0,9999,0
1668414036095,CSE 293,032,119425,Schulze; Jurgen P.,9999,0,9999,0
1668414036095,CSE 293,033,119426,Snoeren; Alex C.,9999,0,9999,0
1668414036095,CSE 293,034,119428,Shang; Jingbo,9999,0,9999,0
1668414036095,CSE 293,035,119430,Stefan; Deian,9999,0,9999,0
1668414036095,CSE 293,036,119431,Su; Hao,9999,0,9999,0
1668414036095,CSE 293,037,119433,Swanson; Steven James,9999,0,9999,0
1668414036095,CSE 293,038,119435,Tullsen; Dean Michael,9999,0,9999,0
1668414036095,CSE 293,039,119483,Voelker; Geoffrey M.,9999,0,9999,0
1668414036095,CSE 293,040,119537,Zhao; Jishen,9999,0,9999,0
1668414036095,CSE 293,041,119538,Zhou; Yuan-Yuan,9999,0,9999,0
1668414036095,CSE 293,042,119539,Gao; Sicun,9999,0,9999,0
1668414036095,CSE 293,043,119540,Weibel; Nadir,9999,0,9999,0
1668414036095,CSE 293,044,119541,Gupta; Rajesh K.,9999,0,9999,0
1668414036095,CSE 293,045,126410,Vaccaro; Kristen Marie,9999,0,9999,0
1668414036095,CSE 293,046,126411,Klemke; Richard,9999,0,9999,0
1668414036526,CSE 294,A00,102459,Voelker; Geoffrey M.,0,1,0,0
1668414036526,CSE 294,B00,111322,Orailoglu; Alex,0,0,0,0
1668414036952,DSE 201,A00,096914,Deutsch; Alin Bernard,30,0,30,0
1668414037385,DSE 210,A00,096915,Dasgupta; Sanjoy,30,0,30,0
1668414037812,DSE 260A,A00,096916,Altintas De Callaf; Ilkay,30,0,30,0
1668414038292,ECE 200,001,103586,Antipa; Nicholas A,9999,0,9999,0
1668414038292,ECE 200,002,103587,Atanasov; Nikolay A.,9999,0,9999,0
1668414038292,ECE 200,003,103588,Bharadia; Dinesh,9999,0,9999,0
1668414038292,ECE 200,004,103589,Cheng; Chung Kuan,9999,0,9999,0
1668414038292,ECE 200,005,103590,Cosman; Pamela C.,9999,0,9999,0
1668414038292,ECE 200,006,103591,Dayeh; Shadi Ahmad,9999,0,9999,0
1668414038292,ECE 200,007,103592,Fainman; Yeshaiahu,9999,0,9999,0
1668414038292,ECE 200,008,103593,Ford; Joseph Earl,9999,0,9999,0
1668414038292,ECE 200,009,103594,Franceschetti; Massimo,9999,0,9999,0
1668414038292,ECE 200,010,103595,Fullerton; Eric E,9999,0,9999,0
1668414038292,ECE 200,011,103596,Galton; Ian A,9999,0,9999,0
1668414038292,ECE 200,012,103597,Gilja; Vikash,9999,0,9999,0
1668414038292,ECE 200,013,103598,Hall; Drew A.,9999,0,9999,0
1668414038292,ECE 200,014,103599,Hsueh; Tzu-Chien,9999,0,9999,0
1668414038292,ECE 200,015,103600,Javidi; Tara,9999,0,9999,0
1668414038292,ECE 200,016,103601,Kahng; Andrew Byun,9999,0,9999,0
1668414038292,ECE 200,017,103602,Kim; Young-Han,9999,0,9999,0
1668414038292,ECE 200,018,103603,Koushanfar; Farinaz,9999,0,9999,0
1668414038292,ECE 200,019,103604,Kuzum; Duygu,9999,0,9999,0
1668414038292,ECE 200,020,103605,Le; Hanh-Phuc,9999,0,9999,0
1668414038292,ECE 200,021,103606,Lin; Bill,9999,0,9999,0
1668414038292,ECE 200,022,103607,Liu; Zhaowei,9998,0,9999,1
1668414038292,ECE 200,023,103608,Lo; Yu-Hwa,9999,0,9999,0
1668414038292,ECE 200,024,103609,Lomakin; Vitaliy,9999,0,9999,0
1668414038292,ECE 200,025,103610,Mercier; Patrick Philip,9999,0,9999,0
1668414038292,ECE 200,026,103611,Meyer; Florian,9999,0,9999,0
1668414038292,ECE 200,027,103612,Milstein; Laurence B.,9999,0,9999,0
1668414038292,ECE 200,028,103613,Mir Arabbaygi; Siavash,9999,0,9999,0
1668414038292,ECE 200,029,103614,Mookherjea; Shayan,9999,0,9999,0
1668414038292,ECE 200,030,103615,Morris; Karcher William,9999,0,9999,0
1668414038292,ECE 200,031,103616,Ng; Tse Nga,9999,0,9999,0
1668414038292,ECE 200,032,103617,Nguyen; Truong Quang,9999,0,9999,0
1668414038292,ECE 200,033,103618,Nomura; Kenji,9999,0,9999,0
1668414038292,ECE 200,034,103619,Orlitsky; Alon,9999,0,9999,0
1668414038292,ECE 200,035,103620,Pal; Piya,9999,0,9999,0
1668414038292,ECE 200,036,103621,Papen; George C.,9999,0,9999,0
1668414038292,ECE 200,037,103622,Radic; Stojan,9999,0,9999,0
1668414038292,ECE 200,038,103623,Rao; Bhaskar D.,9999,0,9999,0
1668414038292,ECE 200,039,103624,Rao; Ramesh R,9999,0,9999,0
1668414038292,ECE 200,040,103625,Rebeiz; Gabriel,9999,0,9999,0
1668414038292,ECE 200,041,103626,Sanford; John R,9999,0,9999,0
1668414038292,ECE 200,042,103627,Siegel; Paul H.,9999,0,9999,0
1668414038292,ECE 200,043,103628,Sievenpiper; Daniel F.,9999,0,9999,0
1668414038292,ECE 200,044,103629,Sworder; David D.,9999,0,9999,0
1668414038292,ECE 200,045,103630,Taur; Yuan,9999,0,9999,0
1668414038292,ECE 200,046,103631,Touri; Behrouz,9999,0,9999,0
1668414038292,ECE 200,047,103632,Trivedi; Mohan M.,9999,0,9999,0
1668414038292,ECE 200,048,103633,Vasconcelos; Nuno,9999,0,9999,0
1668414038292,ECE 200,049,103634,Wang; Xiaolong,9999,0,9999,0
1668414038292,ECE 200,050,103635,Xie; Pengtao,9999,0,9999,0
1668414038292,ECE 200,051,103636,Yip; Michael,9999,0,9999,0
1668414038292,ECE 200,052,103637,Zeger; Kenneth A.,999,0,999,0
1668414038292,ECE 200,053,103638,Zhang; Xinyu,9999,0,9999,0
1668414038292,ECE 200,054,103639,Turakhia; Yatish Girish,9999,0,9999,0
1668414038292,ECE 200,055,103640,Kang; Mingu,9999,0,9999,0
1668414038292,ECE 200,056,103641,Shi; Yuanyuan,9999,0,9999,0
1668414038292,ECE 200,057,103642,Wang; Edward Jay,9999,0,9999,0
1668414038292,ECE 200,058,103643,Zheng; Yang,9999,0,9999,0
1668414038716,ECE 202,A00,103644,Kuzum; Duygu,0,14,0,0
1668414039142,ECE 212BN,A00,103646,Ng; Tse Nga,0,0,0,0
1668414039566,ECE 221,A00,111493,Staff,0,0,0,0
1668414039990,ECE 222B,A00,103647,Lomakin; Vitaliy,0,3,0,0
1668414040415,ECE 230B,A00,103648,Taur; Yuan,0,0,0,0
1668414040843,ECE 238B,A00,103649,Garay; Javier,0,0,0,0
1668414041274,ECE 240B,A00,112900,Fainman; Yeshaiahu,0,1,0,0
1668414041695,ECE 247A,A00,103650,Jokerst; Jesse Vincent,0,1,0,0
1668414042118,ECE 247B,A00,103651,Wang; Joseph,0,2,0,0
1668414042543,ECE 250,A00,103652,Siegel; Paul H.,0,31,0,0
1668414042970,ECE 251A,A00,103654,Rao; Bhaskar D.,0,26,0,0
1668414043399,ECE 257B,A00,103655,Bharadia; Dinesh,0,11,0,0
1668414043822,ECE 258A,A00,103656,Milstein; Laurence B.,0,8,0,0
1668414044246,ECE 260B,A00,103658,Kang; Mingu,0,54,0,0
1668414044670,ECE 264A,A00,103659,Galton; Ian A,0,19,0,0
1668414045094,ECE 265A,A00,103661,Gudem; Prasad S.S.,0,6,0,0
1668414045517,ECE 265D,A00,103662,Gudem; Prasad S.S.,0,8,0,0
1668414045941,ECE 268,A00,103663,Koushanfar; Farinaz,0,18,0,0
1668414046368,ECE 269,A01,103665,Pal; Piya,0,94,0,0
1668414046794,ECE 271B,A00,103666,Vasconcelos; Manuela,0,37,0,0
1668414047226,ECE 276A,A00,103667,Atanasov; Nikolay A.,0,42,0,0
1668414047658,ECE 277,A00,103668,An; Cheolhong,0,60,0,0
1668414048096,ECE 279,A00,117947,Hall; Drew A.,0,9,0,0
1668414048946,ECE 283,A00,103670,Hsueh; Tzu-Chien,0,13,0,0
1668414049372,ECE 284,A00,103671,Turakhia; Yatish Girish,0,22,0,0
1668414049798,ECE 285,A00,103672,Zheng; Yang,0,14,0,0
1668414049798,ECE 285,B00,103673,Sworder; David D.,0,31,0,0
1668414050222,ECE 287,A00,103676,Javidi; Tara,0,4,0,0
1668414050651,MATH 200B,A00,098023,Salehi Golsefidy; Alireza,12,0,15,3
1668414051079,MATH 202B,A00,098024,Rhoades; Brendon Patrick,9,0,15,6
1668414051524,MATH 203B,A00,098025,Oprea; Dragos N.,10,0,15,5
1668414051951,MATH 204B,A00,098026,Sorensen; Claus M,13,0,15,2
1668414052376,MATH 208,A00,098027,Izadi; Elham,7,0,10,3
1668414052803,MATH 209,A00,098028,Pollack; Aaron,10,0,10,0
1668414053230,MATH 211A,A00,112919,Rogalski; Daniel,9,0,10,1
1668414053656,MATH 211B,A00,112920,Seward; Brandon M.,9,0,10,1
1668414054079,MATH 218,A00,098029,Li; Bo,10,0,10,0
1668414054505,MATH 220B,A00,098030,Novak; Jonathan I,11,0,15,4
1668414054930,MATH 221A,A00,098031,Ebenfelt; Peter F,13,0,15,2
1668414055357,MATH 231B,A00,098032,Zlatos; Andrej,12,0,15,3
1668414055785,MATH 240B,A00,098033,Ni; Lei,9,0,15,6
1668414056209,MATH 243,A00,098034,Jekel; David Andrew,10,0,10,0
1668414056634,MATH 245A,A00,098035,Nie; Jiawang,0,0,15,16
1668414057058,MATH 248,A00,098036,Bejenaru; Ioan,10,0,10,0
1668414057487,MATH 250B,A00,098037,Spolaor; Luca,14,0,15,1
1668414057913,MATH 258,A00,098038,Ni; Lei,10,0,10,0
1668414058339,MATH 264B,A00,098041,Rhoades; Brendon Patrick,9,0,15,6
1668414058764,MATH 268,A00,098042,Buss; Samuel R,10,0,10,0
1668414059196,MATH 269,A00,098043,Rhoades; Brendon Patrick,10,0,10,0
1668414059621,MATH 270B,A00,098044,Li; Bo,10,0,15,5
1668414060042,MATH 272B,A00,098045,Holst; Michael J,13,0,15,2
1668414060468,MATH 273A,A00,098046,Tian; Xiaochuan,10,0,15,5
1668414060900,MATH 275,A01,098048,Tian; Xiaochuan,6,0,10,4
1668414061323,MATH 278A,A00,098049,Holst; Michael J,8,0,10,2
1668414061755,MATH 278B,A00,098050,Cloninger; Alexander,10,0,10,0
1668414062277,MATH 278C,A00,098051,Nie; Jiawang,6,0,10,4
1668414062702,MATH 280B,A00,098052,Zheng; Tianyi,8,0,15,7
1668414063125,MATH 281B,A00,098053,Bradic; Jelena,0,1,15,15
1668414063557,MATH 282B,A00,098054,Arias-Castro; Ery,0,0,15,15
1668414063988,MATH 285,A00,098055,Fitzsimmons; Patrick J,0,0,15,17
1668414064420,MATH 287B,A00,098056,Arias-Castro; Ery,2,0,15,13
1668414064843,MATH 288,A00,098057,Agarwal; Pooja,9,0,10,1
1668414064843,MATH 288,B00,098058,Zhang; Danna,8,0,10,2
1668414064843,MATH 288,C00,098059,Williams; Ruth J,9,0,10,1
1668414065275,MATH 290B,A00,098060,Roberts; Justin Deritter,13,0,15,2
1668414065701,MATH 292,A00,098061,Belmont; Eva Kinoshita,10,0,10,0
1668414066125,MATH 295,A00,098062,Suk; Andrew Hoon,48,0,50,2
1668414066551,MATH 296,A00,098063,Novak; Jonathan I,20,0,20,0
1668414066993,MATH 297,001,098064,Gamst; Anthony Collins,9997,0,9999,2
1668414570154,COGS 205,A00,101395,Chiba; Andrea,19,0,20,1
1668414570601,COGS 210B,001,101404,Greene; Deanna Jacquelyn,9998,0,9999,1
1668414570601,COGS 210B,002,101417,Xia; Haijun,9999,0,9999,0
1668414570601,COGS 210B,003,101422,Nitz; Douglas A.,9999,0,9999,0
1668414570601,COGS 210B,004,101423,Hollan; James D.,9998,0,9999,1
1668414570601,COGS 210B,005,101424,Deak; Gedeon O.,9998,0,9999,1
1668414570601,COGS 210B,006,101425,Rossano; Federico,9999,0,9999,0
1668414571031,COGS 211B,A00,101427,Coulson; Seana M,9996,0,9999,3
1668414571457,COGS 220,A00,101428,Hollan; James D.,0,1,25,25
1668414571894,COGS 229,A00,101429,Dow; Steven P,18,0,25,7
1668414572326,COGS 230,A00,101430,Klemmer; Scott R,11,0,17,6
1668414572758,COGS 234,A00,101431,Xia; Haijun,1,0,25,24
1668414573184,COGS 260,A00,101432,Kiyonaga; Anastasia,21,0,25,4
1668414573184,COGS 260,B00,101433,Kirsh; David Joel,15,0,25,10
1668414573608,CSE 202,A00,102371,Impagliazzo; Russell,0,27,0,0
1668414574038,CSE 203B,A01,102373,Cheng; Chung Kuan,0,18,0,0
1668414574470,CSE 208,A00,102374,Micciancio; Daniele,0,1,0,0
1668414574900,CSE 209A,A00,112895,Impagliazzo; Russell,0,3,15,15
1668414575328,CSE 209B,A00,108005,Bellare; Mihir,0,2,0,0
1668414575753,CSE 210,A00,113163,Coblenz; Michael J,0,35,0,0
1668414576182,CSE 219,A00,106111,Dow; Steven P,0,0,20,20
1668414576610,CSE 221,A00,102376,Voelker; Geoffrey M.,0,23,0,0
1668414577047,CSE 224,A01,102378,Porter; George M,0,85,0,0
1668414577491,CSE 229A,A00,102379,Savage; Stefan,0,4,0,0
1668414577917,CSE 229C,A00,102380,Munyaka; Imani N. S.,0,3,0,0
1668414578342,CSE 232B,A00,102382,Deutsch; Alin Bernard,0,9,0,0
1668414578767,CSE 234,A01,112904,Kumar; Arun Kumar,0,0,0,0
1668414579198,CSE 237A,A00,102383,Rosing; Tajana Simunic,0,22,0,0
1668414579624,CSE 239A,A00,102384,Deutsch; Alin Bernard,0,4,0,0
1668414580050,CSE 239B,A00,102385,Polikarpova; Nadezhda,0,1,0,0
1668414580474,CSE 240A,A00,102386,Pannuto; Patrick William,0,19,0,0
1668414580901,CSE 240B,A00,102387,Zhao; Jishen,0,18,0,0
1668414581328,CSE 241A,A00,106406,Kang; Mingu,0,0,0,0
1668414581752,CSE 249B,A00,102388,Kahng; Andrew Byun,0,1,8,8
1668414582180,CSE 251B,A01,102392,Cottrell; Garrison W,0,18,0,0
1668414582180,CSE 251B,A02,102393,Cottrell; Garrison W,0,19,0,0
1668414582605,CSE 252B,A00,102394,Ochoa; Benjamin Lawrence,0,31,0,0
1668414583031,CSE 257,A01,102396,Gao; Sicun,0,72,0,0
1668414583457,CSE 272,A00,102397,Li; Tzumao,0,4,0,0
1668414583881,CSE 274,A00,111323,Chern; Albert Ren-Haur,0,6,0,0
1668414584308,CSE 282,A00,102398,Pevzner; Pavel Arkadjevich,0,0,0,0
1668414584732,CSE 284,A00,114175,Gymrek; Melissa Ann,0,6,0,0
1668414585157,CSE 290,A00,102399,Chandraker; Manmohan Krishna,0,3,0,0
1668414585157,CSE 290,B00,102400,Vaccaro; Kristen Marie,0,1,25,25
1668414585157,CSE 290,C00,102414,Pannuto; Patrick William,0,1,25,25
1668414585157,CSE 290,D00,102427,Pevzner; Pavel Arkadjevich,0,0,0,0
1668414585157,CSE 290,E00,102429,Zhao; Jishen,0,1,0,0
1668414585157,CSE 290,F00,102436,Tullsen; Dean Michael,0,2,0,0
1668414585157,CSE 290,G00,102440,Christensen; Henrik I,0,2,20,20
1668414585672,CSE 291,A00,102443,Su; Hao,0,0,0,0
1668414585672,CSE 291,B00,102448,Polikarpova; Nadezhda,0,0,0,0
1668414585672,CSE 291,C00,102453,Vaccaro; Kristen Marie,0,0,0,0
1668414585672,CSE 291,D00,111343,Savage; Stefan,0,0,0,0
1668414585672,CSE 291,E00,116474,Claffy; Kimberly Claire,0,0,0,0
1668414585672,CSE 291,F00,116479,Pasquale; Joseph,0,0,0,0
1668414586119,CSE 293,001,119111,Bafna; Vineet,9999,0,9999,0
1668414586119,CSE 293,002,119118,Bellare; Mihir,9999,0,9999,0
1668414586119,CSE 293,003,119122,Berg-Kirkpatrick; Taylor D,9999,0,9999,0
1668414586119,CSE 293,004,119135,Christensen; Henrik I,9999,0,9999,0
1668414586119,CSE 293,005,119142,Cottrell; Garrison W,9999,0,9999,0
1668414586119,CSE 293,006,119146,Deutsch; Alin Bernard,9999,0,9999,0
1668414586119,CSE 293,007,119159,Esmaeilzadeh; Hadi,9999,0,9999,0
1668414586119,CSE 293,008,119166,Freund; Yoav,9999,0,9999,0
1668414586119,CSE 293,009,119170,Griswold; William G.,9999,0,9999,0
1668414586119,CSE 293,010,119183,Gymrek; Melissa Ann,9999,0,9999,0
1668414586119,CSE 293,011,119190,Heninger; Nadia A,9999,0,9999,0
1668414586119,CSE 293,012,119230,Impagliazzo; Russell,9999,0,9999,0
1668414586119,CSE 293,013,119232,Jhala; Ranjit,9999,0,9999,0
1668414586119,CSE 293,014,119233,Kahng; Andrew Byun,9999,0,9999,0
1668414586119,CSE 293,015,119298,Kane; Daniel Mertz,9999,0,9999,0
1668414586119,CSE 293,016,119299,Kriegman; David J,9999,0,9999,0
1668414586119,CSE 293,017,119300,Kumar; Arun Kumar,9999,0,9999,0
1668414586119,CSE 293,018,119301,Lerner; Sorin,9999,0,9999,0
1668414586119,CSE 293,019,119302,Lovett; Shachar,9999,0,9999,0
1668414586119,CSE 293,020,119303,McAuley; Julian John,9999,0,9999,0
1668414586119,CSE 293,021,119304,Micciancio; Daniele,9999,0,9999,0
1668414586119,CSE 293,022,119367,Orailoglu; Alex,9999,0,9999,0
1668414586119,CSE 293,023,119382,Paturi; Ramamohan,9999,0,9999,0
1668414586119,CSE 293,024,119404,Polikarpova; Nadezhda,9999,0,9999,0
1668414586119,CSE 293,025,119406,Politz; Joseph Gibbs,9999,0,9999,0
1668414586119,CSE 293,026,119411,Porter; George M,9999,0,9999,0
1668414586119,CSE 293,027,119414,Porter; Leonard Emerson,9999,0,9999,0
1668414586119,CSE 293,028,119416,Ramamoorthi; Ravi,9999,0,9999,0
1668414586119,CSE 293,029,119417,Sahoo; Debashis,9999,0,9999,0
1668414586119,CSE 293,030,119420,Saul; Lawrence,9999,0,9999,0
1668414586119,CSE 293,031,119421,Savage; Stefan,9999,0,9999,0
1668414586119,CSE 293,032,119425,Schulze; Jurgen P.,9999,0,9999,0
1668414586119,CSE 293,033,119426,Snoeren; Alex C.,9999,0,9999,0
1668414586119,CSE 293,034,119428,Shang; Jingbo,9999,0,9999,0
1668414586119,CSE 293,035,119430,Stefan; Deian,9999,0,9999,0
1668414586119,CSE 293,036,119431,Su; Hao,9999,0,9999,0
1668414586119,CSE 293,037,119433,Swanson; Steven James,9999,0,9999,0
1668414586119,CSE 293,038,119435,Tullsen; Dean Michael,9999,0,9999,0
1668414586119,CSE 293,039,119483,Voelker; Geoffrey M.,9999,0,9999,0
1668414586119,CSE 293,040,119537,Zhao; Jishen,9999,0,9999,0
1668414586119,CSE 293,041,119538,Zhou; Yuan-Yuan,9999,0,9999,0
1668414586119,CSE 293,042,119539,Gao; Sicun,9999,0,9999,0
1668414586119,CSE 293,043,119540,Weibel; Nadir,9999,0,9999,0
1668414586119,CSE 293,044,119541,Gupta; Rajesh K.,9999,0,9999,0
1668414586119,CSE 293,045,126410,Vaccaro; Kristen Marie,9999,0,9999,0
1668414586119,CSE 293,046,126411,Klemke; Richard,9999,0,9999,0
1668414586542,CSE 294,A00,102459,Voelker; Geoffrey M.,0,1,0,0
1668414586542,CSE 294,B00,111322,Orailoglu; Alex,0,0,0,0
1668414586968,DSE 201,A00,096914,Deutsch; Alin Bernard,30,0,30,0
1668414587403,DSE 210,A00,096915,Dasgupta; Sanjoy,30,0,30,0
1668414587838,DSE 260A,A00,096916,Altintas De Callaf; Ilkay,30,0,30,0
1668414588271,ECE 200,001,103586,Antipa; Nicholas A,9999,0,9999,0
1668414588271,ECE 200,002,103587,Atanasov; Nikolay A.,9999,0,9999,0
1668414588271,ECE 200,003,103588,Bharadia; Dinesh,9999,0,9999,0
1668414588271,ECE 200,004,103589,Cheng; Chung Kuan,9999,0,9999,0
1668414588271,ECE 200,005,103590,Cosman; Pamela C.,9999,0,9999,0
1668414588271,ECE 200,006,103591,Dayeh; Shadi Ahmad,9999,0,9999,0
1668414588271,ECE 200,007,103592,Fainman; Yeshaiahu,9999,0,9999,0
1668414588271,ECE 200,008,103593,Ford; Joseph Earl,9999,0,9999,0
1668414588271,ECE 200,009,103594,Franceschetti; Massimo,9999,0,9999,0
1668414588271,ECE 200,010,103595,Fullerton; Eric E,9999,0,9999,0
1668414588271,ECE 200,011,103596,Galton; Ian A,9999,0,9999,0
1668414588271,ECE 200,012,103597,Gilja; Vikash,9999,0,9999,0
1668414588271,ECE 200,013,103598,Hall; Drew A.,9999,0,9999,0
1668414588271,ECE 200,014,103599,Hsueh; Tzu-Chien,9999,0,9999,0
1668414588271,ECE 200,015,103600,Javidi; Tara,9999,0,9999,0
1668414588271,ECE 200,016,103601,Kahng; Andrew Byun,9999,0,9999,0
1668414588271,ECE 200,017,103602,Kim; Young-Han,9999,0,9999,0
1668414588271,ECE 200,018,103603,Koushanfar; Farinaz,9999,0,9999,0
1668414588271,ECE 200,019,103604,Kuzum; Duygu,9999,0,9999,0
1668414588271,ECE 200,020,103605,Le; Hanh-Phuc,9999,0,9999,0
1668414588271,ECE 200,021,103606,Lin; Bill,9999,0,9999,0
1668414588271,ECE 200,022,103607,Liu; Zhaowei,9998,0,9999,1
1668414588271,ECE 200,023,103608,Lo; Yu-Hwa,9999,0,9999,0
1668414588271,ECE 200,024,103609,Lomakin; Vitaliy,9999,0,9999,0
1668414588271,ECE 200,025,103610,Mercier; Patrick Philip,9999,0,9999,0
1668414588271,ECE 200,026,103611,Meyer; Florian,9999,0,9999,0
1668414588271,ECE 200,027,103612,Milstein; Laurence B.,9999,0,9999,0
1668414588271,ECE 200,028,103613,Mir Arabbaygi; Siavash,9999,0,9999,0
1668414588271,ECE 200,029,103614,Mookherjea; Shayan,9999,0,9999,0
1668414588271,ECE 200,030,103615,Morris; Karcher William,9999,0,9999,0
1668414588271,ECE 200,031,103616,Ng; Tse Nga,9999,0,9999,0
1668414588271,ECE 200,032,103617,Nguyen; Truong Quang,9999,0,9999,0
1668414588271,ECE 200,033,103618,Nomura; Kenji,9999,0,9999,0
1668414588271,ECE 200,034,103619,Orlitsky; Alon,9999,0,9999,0
1668414588271,ECE 200,035,103620,Pal; Piya,9999,0,9999,0
1668414588271,ECE 200,036,103621,Papen; George C.,9999,0,9999,0
1668414588271,ECE 200,037,103622,Radic; Stojan,9999,0,9999,0
1668414588271,ECE 200,038,103623,Rao; Bhaskar D.,9999,0,9999,0
1668414588271,ECE 200,039,103624,Rao; Ramesh R,9999,0,9999,0
1668414588271,ECE 200,040,103625,Rebeiz; Gabriel,9999,0,9999,0
1668414588271,ECE 200,041,103626,Sanford; John R,9999,0,9999,0
1668414588271,ECE 200,042,103627,Siegel; Paul H.,9999,0,9999,0
1668414588271,ECE 200,043,103628,Sievenpiper; Daniel F.,9999,0,9999,0
1668414588271,ECE 200,044,103629,Sworder; David D.,9999,0,9999,0
1668414588271,ECE 200,045,103630,Taur; Yuan,9999,0,9999,0
1668414588271,ECE 200,046,103631,Touri; Behrouz,9999,0,9999,0
1668414588271,ECE 200,047,103632,Trivedi; Mohan M.,9999,0,9999,0
1668414588271,ECE 200,048,103633,Vasconcelos; Nuno,9999,0,9999,0
1668414588271,ECE 200,049,103634,Wang; Xiaolong,9999,0,9999,0
1668414588271,ECE 200,050,103635,Xie; Pengtao,9999,0,9999,0
1668414588271,ECE 200,051,103636,Yip; Michael,9999,0,9999,0
1668414588271,ECE 200,052,103637,Zeger; Kenneth A.,999,0,999,0
1668414588271,ECE 200,053,103638,Zhang; Xinyu,9999,0,9999,0
1668414588271,ECE 200,054,103639,Turakhia; Yatish Girish,9999,0,9999,0
1668414588271,ECE 200,055,103640,Kang; Mingu,9999,0,9999,0
1668414588271,ECE 200,056,103641,Shi; Yuanyuan,9999,0,9999,0
1668414588271,ECE 200,057,103642,Wang; Edward Jay,9999,0,9999,0
1668414588271,ECE 200,058,103643,Zheng; Yang,9999,0,9999,0
1668414588695,ECE 202,A00,103644,Kuzum; Duygu,0,16,0,0
1668414589121,ECE 212BN,A00,103646,Ng; Tse Nga,0,0,0,0
1668414589552,ECE 221,A00,111493,Staff,0,0,0,0
1668414589979,ECE 222B,A00,103647,Lomakin; Vitaliy,0,3,0,0
1668414590406,ECE 230B,A00,103648,Taur; Yuan,0,0,0,0
1668414590842,ECE 238B,A00,103649,Garay; Javier,0,0,0,0
1668414591269,ECE 240B,A00,112900,Fainman; Yeshaiahu,0,1,0,0
1668414591701,ECE 247A,A00,103650,Jokerst; Jesse Vincent,0,1,0,0
1668414592128,ECE 247B,A00,103651,Wang; Joseph,0,2,0,0
1668414592553,ECE 250,A00,103652,Siegel; Paul H.,0,34,0,0
1668414592983,ECE 251A,A00,103654,Rao; Bhaskar D.,0,27,0,0
1668414593412,ECE 257B,A00,103655,Bharadia; Dinesh,0,11,0,0
1668414593835,ECE 258A,A00,103656,Milstein; Laurence B.,0,8,0,0
1668414594276,ECE 260B,A00,103658,Kang; Mingu,0,57,0,0
1668414594714,ECE 264A,A00,103659,Galton; Ian A,0,21,0,0
1668414595139,ECE 265A,A00,103661,Gudem; Prasad S.S.,0,6,0,0
1668414595562,ECE 265D,A00,103662,Gudem; Prasad S.S.,0,8,0,0
1668414595989,ECE 268,A00,103663,Koushanfar; Farinaz,0,16,0,0
1668414596442,ECE 269,A01,103665,Pal; Piya,0,108,0,0
1668414596874,ECE 271B,A00,103666,Vasconcelos; Manuela,0,40,0,0
1668414597301,ECE 276A,A00,103667,Atanasov; Nikolay A.,0,46,0,0
1668414597727,ECE 277,A00,103668,An; Cheolhong,0,70,0,0
1668414598161,ECE 279,A00,117947,Hall; Drew A.,0,9,0,0
1668414599009,ECE 283,A00,103670,Hsueh; Tzu-Chien,0,15,0,0
1668414599436,ECE 284,A00,103671,Turakhia; Yatish Girish,0,23,0,0
1668414599859,ECE 285,A00,103672,Zheng; Yang,0,17,0,0
1668414599859,ECE 285,B00,103673,Sworder; David D.,0,33,0,0
1668414600285,ECE 287,A00,103676,Javidi; Tara,0,4,0,0
1668414600708,MATH 200B,A00,098023,Salehi Golsefidy; Alireza,12,0,15,3
1668414601134,MATH 202B,A00,098024,Rhoades; Brendon Patrick,9,0,15,6
1668414601564,MATH 203B,A00,098025,Oprea; Dragos N.,10,0,15,5
1668414601994,MATH 204B,A00,098026,Sorensen; Claus M,13,0,15,2
1668414602430,MATH 208,A00,098027,Izadi; Elham,7,0,10,3
1668414602864,MATH 209,A00,098028,Pollack; Aaron,10,0,10,0
1668414603287,MATH 211A,A00,112919,Rogalski; Daniel,9,0,10,1
1668414603714,MATH 211B,A00,112920,Seward; Brandon M.,9,0,10,1
1668414604139,MATH 218,A00,098029,Li; Bo,10,0,10,0
1668414604566,MATH 220B,A00,098030,Novak; Jonathan I,11,0,15,4
1668414604992,MATH 221A,A00,098031,Ebenfelt; Peter F,13,0,15,2
1668414605420,MATH 231B,A00,098032,Zlatos; Andrej,12,0,15,3
1668414605844,MATH 240B,A00,098033,Ni; Lei,9,0,15,6
1668414606268,MATH 243,A00,098034,Jekel; David Andrew,10,0,10,0
1668414606691,MATH 245A,A00,098035,Nie; Jiawang,0,0,15,16
1668414607120,MATH 248,A00,098036,Bejenaru; Ioan,10,0,10,0
1668414607547,MATH 250B,A00,098037,Spolaor; Luca,14,0,15,1
1668414607969,MATH 258,A00,098038,Ni; Lei,10,0,10,0
1668414608397,MATH 264B,A00,098041,Rhoades; Brendon Patrick,9,0,15,6
1668414608823,MATH 268,A00,098042,Buss; Samuel R,10,0,10,0
1668414609249,MATH 269,A00,098043,Rhoades; Brendon Patrick,10,0,10,0
1668414609682,MATH 270B,A00,098044,Li; Bo,10,0,15,5
1668414610126,MATH 272B,A00,098045,Holst; Michael J,13,0,15,2
1668414610551,MATH 273A,A00,098046,Tian; Xiaochuan,10,0,15,5
1668414610978,MATH 275,A01,098048,Tian; Xiaochuan,6,0,10,4
1668414611416,MATH 278A,A00,098049,Holst; Michael J,8,0,10,2
1668414611840,MATH 278B,A00,098050,Cloninger; Alexander,10,0,10,0
1668414612275,MATH 278C,A00,098051,Nie; Jiawang,6,0,10,4
1668414612709,MATH 280B,A00,098052,Zheng; Tianyi,8,0,15,7
1668414613133,MATH 281B,A00,098053,Bradic; Jelena,0,1,15,15
1668414613556,MATH 282B,A00,098054,Arias-Castro; Ery,0,0,15,15
1668414613983,MATH 285,A00,098055,Fitzsimmons; Patrick J,0,0,15,17
1668414614418,MATH 287B,A00,098056,Arias-Castro; Ery,2,0,15,13
1668414614847,MATH 288,A00,098057,Agarwal; Pooja,9,0,10,1
1668414614847,MATH 288,B00,098058,Zhang; Danna,8,0,10,2
1668414614847,MATH 288,C00,098059,Williams; Ruth J,9,0,10,1
1668414615285,MATH 290B,A00,098060,Roberts; Justin Deritter,13,0,15,2
1668414615726,MATH 292,A00,098061,Belmont; Eva Kinoshita,10,0,10,0
1668414616163,MATH 295,A00,098062,Suk; Andrew Hoon,48,0,50,2
1668414616604,MATH 296,A00,098063,Novak; Jonathan I,20,0,20,0
1668414617038,MATH 297,001,098064,Gamst; Anthony Collins,9997,0,9999,2
1668415134653,COGS 205,A00,101395,Chiba; Andrea,19,0,20,1
1668415135101,COGS 210B,001,101404,Greene; Deanna Jacquelyn,9998,0,9999,1
1668415135101,COGS 210B,002,101417,Xia; Haijun,9999,0,9999,0
1668415135101,COGS 210B,003,101422,Nitz; Douglas A.,9999,0,9999,0
1668415135101,COGS 210B,004,101423,Hollan; James D.,9998,0,9999,1
1668415135101,COGS 210B,005,101424,Deak; Gedeon O.,9998,0,9999,1
1668415135101,COGS 210B,006,101425,Rossano; Federico,9999,0,9999,0
1668415135530,COGS 211B,A00,101427,Coulson; Seana M,9996,0,9999,3
1668415135956,COGS 220,A00,101428,Hollan; James D.,0,1,25,25
1668415136384,COGS 229,A00,101429,Dow; Steven P,18,0,25,7
1668415136808,COGS 230,A00,101430,Klemmer; Scott R,11,0,17,6
1668415137230,COGS 234,A00,101431,Xia; Haijun,1,0,25,24
1668415137654,COGS 260,A00,101432,Kiyonaga; Anastasia,21,0,25,4
1668415137654,COGS 260,B00,101433,Kirsh; David Joel,15,0,25,10
1668415138082,CSE 202,A00,102371,Impagliazzo; Russell,0,26,0,0
1668415138505,CSE 203B,A01,102373,Cheng; Chung Kuan,0,19,0,0
1668415138929,CSE 208,A00,102374,Micciancio; Daniele,0,1,0,0
1668415139356,CSE 209A,A00,112895,Impagliazzo; Russell,0,3,15,15
1668415139786,CSE 209B,A00,108005,Bellare; Mihir,0,2,0,0
1668415140209,CSE 210,A00,113163,Coblenz; Michael J,0,35,0,0
1668415140632,CSE 219,A00,106111,Dow; Steven P,0,0,20,20
1668415141056,CSE 221,A00,102376,Voelker; Geoffrey M.,0,23,0,0
1668415141482,CSE 224,A01,102378,Porter; George M,0,88,0,0
1668415141924,CSE 229A,A00,102379,Savage; Stefan,0,4,0,0
1668415142351,CSE 229C,A00,102380,Munyaka; Imani N. S.,0,3,0,0
1668415142777,CSE 232B,A00,102382,Deutsch; Alin Bernard,0,9,0,0
1668415143206,CSE 234,A01,112904,Kumar; Arun Kumar,0,0,0,0
1668415143629,CSE 237A,A00,102383,Rosing; Tajana Simunic,0,22,0,0
1668415144053,CSE 239A,A00,102384,Deutsch; Alin Bernard,0,4,0,0
1668415144479,CSE 239B,A00,102385,Polikarpova; Nadezhda,0,2,0,0
1668415144906,CSE 240A,A00,102386,Pannuto; Patrick William,0,19,0,0
1668415145333,CSE 240B,A00,102387,Zhao; Jishen,0,19,0,0
1668415145757,CSE 241A,A00,106406,Kang; Mingu,0,0,0,0
1668415146180,CSE 249B,A00,102388,Kahng; Andrew Byun,0,1,8,8
1668415146602,CSE 251B,A01,102392,Cottrell; Garrison W,0,20,0,0
1668415146602,CSE 251B,A02,102393,Cottrell; Garrison W,0,20,0,0
1668415147026,CSE 252B,A00,102394,Ochoa; Benjamin Lawrence,0,32,0,0
1668415147465,CSE 257,A01,102396,Gao; Sicun,0,76,0,0
1668415147892,CSE 272,A00,102397,Li; Tzumao,0,5,0,0
1668415148316,CSE 274,A00,111323,Chern; Albert Ren-Haur,0,6,0,0
1668415148739,CSE 282,A00,102398,Pevzner; Pavel Arkadjevich,0,0,0,0
1668415149164,CSE 284,A00,114175,Gymrek; Melissa Ann,0,7,0,0
1668415149587,CSE 290,A00,102399,Chandraker; Manmohan Krishna,0,3,0,0
1668415149587,CSE 290,B00,102400,Vaccaro; Kristen Marie,0,1,25,25
1668415149587,CSE 290,C00,102414,Pannuto; Patrick William,0,1,25,25
1668415149587,CSE 290,D00,102427,Pevzner; Pavel Arkadjevich,0,0,0,0
1668415149587,CSE 290,E00,102429,Zhao; Jishen,0,1,0,0
1668415149587,CSE 290,F00,102436,Tullsen; Dean Michael,0,2,0,0
1668415149587,CSE 290,G00,102440,Christensen; Henrik I,0,3,20,20
1668415150017,CSE 291,A00,102443,Su; Hao,0,0,0,0
1668415150017,CSE 291,B00,102448,Polikarpova; Nadezhda,0,0,0,0
1668415150017,CSE 291,C00,102453,Vaccaro; Kristen Marie,0,0,0,0
1668415150017,CSE 291,D00,111343,Savage; Stefan,0,0,0,0
1668415150017,CSE 291,E00,116474,Claffy; Kimberly Claire,0,0,0,0
1668415150017,CSE 291,F00,116479,Pasquale; Joseph,0,0,0,0
1668415150453,CSE 293,001,119111,Bafna; Vineet,9999,0,9999,0
1668415150453,CSE 293,002,119118,Bellare; Mihir,9999,0,9999,0
1668415150453,CSE 293,003,119122,Berg-Kirkpatrick; Taylor D,9999,0,9999,0
1668415150453,CSE 293,004,119135,Christensen; Henrik I,9999,0,9999,0
1668415150453,CSE 293,005,119142,Cottrell; Garrison W,9999,0,9999,0
1668415150453,CSE 293,006,119146,Deutsch; Alin Bernard,9999,0,9999,0
1668415150453,CSE 293,007,119159,Esmaeilzadeh; Hadi,9999,0,9999,0
1668415150453,CSE 293,008,119166,Freund; Yoav,9999,0,9999,0
1668415150453,CSE 293,009,119170,Griswold; William G.,9999,0,9999,0
1668415150453,CSE 293,010,119183,Gymrek; Melissa Ann,9999,0,9999,0
1668415150453,CSE 293,011,119190,Heninger; Nadia A,9999,0,9999,0
1668415150453,CSE 293,012,119230,Impagliazzo; Russell,9999,0,9999,0
1668415150453,CSE 293,013,119232,Jhala; Ranjit,9999,0,9999,0
1668415150453,CSE 293,014,119233,Kahng; Andrew Byun,9999,0,9999,0
1668415150453,CSE 293,015,119298,Kane; Daniel Mertz,9999,0,9999,0
1668415150453,CSE 293,016,119299,Kriegman; David J,9999,0,9999,0
1668415150453,CSE 293,017,119300,Kumar; Arun Kumar,9999,0,9999,0
1668415150453,CSE 293,018,119301,Lerner; Sorin,9999,0,9999,0
1668415150453,CSE 293,019,119302,Lovett; Shachar,9999,0,9999,0
1668415150453,CSE 293,020,119303,McAuley; Julian John,9999,0,9999,0
1668415150453,CSE 293,021,119304,Micciancio; Daniele,9999,0,9999,0
1668415150453,CSE 293,022,119367,Orailoglu; Alex,9999,0,9999,0
1668415150453,CSE 293,023,119382,Paturi; Ramamohan,9999,0,9999,0
1668415150453,CSE 293,024,119404,Polikarpova; Nadezhda,9999,0,9999,0
1668415150453,CSE 293,025,119406,Politz; Joseph Gibbs,9999,0,9999,0
1668415150453,CSE 293,026,119411,Porter; George M,9999,0,9999,0
1668415150453,CSE 293,027,119414,Porter; Leonard Emerson,9999,0,9999,0
1668415150453,CSE 293,028,119416,Ramamoorthi; Ravi,9999,0,9999,0
1668415150453,CSE 293,029,119417,Sahoo; Debashis,9999,0,9999,0
1668415150453,CSE 293,030,119420,Saul; Lawrence,9999,0,9999,0
1668415150453,CSE 293,031,119421,Savage; Stefan,9999,0,9999,0
1668415150453,CSE 293,032,119425,Schulze; Jurgen P.,9999,0,9999,0
1668415150453,CSE 293,033,119426,Snoeren; Alex C.,9999,0,9999,0
1668415150453,CSE 293,034,119428,Shang; Jingbo,9999,0,9999,0
1668415150453,CSE 293,035,119430,Stefan; Deian,9999,0,9999,0
1668415150453,CSE 293,036,119431,Su; Hao,9999,0,9999,0
1668415150453,CSE 293,037,119433,Swanson; Steven James,9999,0,9999,0
1668415150453,CSE 293,038,119435,Tullsen; Dean Michael,9999,0,9999,0
1668415150453,CSE 293,039,119483,Voelker; Geoffrey M.,9999,0,9999,0
1668415150453,CSE 293,040,119537,Zhao; Jishen,9999,0,9999,0
1668415150453,CSE 293,041,119538,Zhou; Yuan-Yuan,9999,0,9999,0
1668415150453,CSE 293,042,119539,Gao; Sicun,9999,0,9999,0
1668415150453,CSE 293,043,119540,Weibel; Nadir,9999,0,9999,0
1668415150453,CSE 293,044,119541,Gupta; Rajesh K.,9999,0,9999,0
1668415150453,CSE 293,045,126410,Vaccaro; Kristen Marie,9999,0,9999,0
1668415150453,CSE 293,046,126411,Klemke; Richard,9999,0,9999,0
1668415150881,CSE 294,A00,102459,Voelker; Geoffrey M.,0,1,0,0
1668415150881,CSE 294,B00,111322,Orailoglu; Alex,0,0,0,0
1668415151307,DSE 201,A00,096914,Deutsch; Alin Bernard,30,0,30,0
1668415151730,DSE 210,A00,096915,Dasgupta; Sanjoy,30,0,30,0
1668415152153,DSE 260A,A00,096916,Altintas De Callaf; Ilkay,30,0,30,0
1668415152580,ECE 200,001,103586,Antipa; Nicholas A,9999,0,9999,0
1668415152580,ECE 200,002,103587,Atanasov; Nikolay A.,9999,0,9999,0
1668415152580,ECE 200,003,103588,Bharadia; Dinesh,9999,0,9999,0
1668415152580,ECE 200,004,103589,Cheng; Chung Kuan,9999,0,9999,0
1668415152580,ECE 200,005,103590,Cosman; Pamela C.,9999,0,9999,0
1668415152580,ECE 200,006,103591,Dayeh; Shadi Ahmad,9999,0,9999,0
1668415152580,ECE 200,007,103592,Fainman; Yeshaiahu,9999,0,9999,0
1668415152580,ECE 200,008,103593,Ford; Joseph Earl,9999,0,9999,0
1668415152580,ECE 200,009,103594,Franceschetti; Massimo,9999,0,9999,0
1668415152580,ECE 200,010,103595,Fullerton; Eric E,9999,0,9999,0
1668415152580,ECE 200,011,103596,Galton; Ian A,9999,0,9999,0
1668415152580,ECE 200,012,103597,Gilja; Vikash,9999,0,9999,0
1668415152580,ECE 200,013,103598,Hall; Drew A.,9999,0,9999,0
1668415152580,ECE 200,014,103599,Hsueh; Tzu-Chien,9999,0,9999,0
1668415152580,ECE 200,015,103600,Javidi; Tara,9999,0,9999,0
1668415152580,ECE 200,016,103601,Kahng; Andrew Byun,9999,0,9999,0
1668415152580,ECE 200,017,103602,Kim; Young-Han,9999,0,9999,0
1668415152580,ECE 200,018,103603,Koushanfar; Farinaz,9999,0,9999,0
1668415152580,ECE 200,019,103604,Kuzum; Duygu,9999,0,9999,0
1668415152580,ECE 200,020,103605,Le; Hanh-Phuc,9999,0,9999,0
1668415152580,ECE 200,021,103606,Lin; Bill,9999,0,9999,0
1668415152580,ECE 200,022,103607,Liu; Zhaowei,9998,0,9999,1
1668415152580,ECE 200,023,103608,Lo; Yu-Hwa,9999,0,9999,0
1668415152580,ECE 200,024,103609,Lomakin; Vitaliy,9999,0,9999,0
1668415152580,ECE 200,025,103610,Mercier; Patrick Philip,9999,0,9999,0
1668415152580,ECE 200,026,103611,Meyer; Florian,9999,0,9999,0
1668415152580,ECE 200,027,103612,Milstein; Laurence B.,9999,0,9999,0
1668415152580,ECE 200,028,103613,Mir Arabbaygi; Siavash,9999,0,9999,0
1668415152580,ECE 200,029,103614,Mookherjea; Shayan,9999,0,9999,0
1668415152580,ECE 200,030,103615,Morris; Karcher William,9999,0,9999,0
1668415152580,ECE 200,031,103616,Ng; Tse Nga,9999,0,9999,0
1668415152580,ECE 200,032,103617,Nguyen; Truong Quang,9999,0,9999,0
1668415152580,ECE 200,033,103618,Nomura; Kenji,9999,0,9999,0
1668415152580,ECE 200,034,103619,Orlitsky; Alon,9999,0,9999,0
1668415152580,ECE 200,035,103620,Pal; Piya,9999,0,9999,0
1668415152580,ECE 200,036,103621,Papen; George C.,9999,0,9999,0
1668415152580,ECE 200,037,103622,Radic; Stojan,9999,0,9999,0
1668415152580,ECE 200,038,103623,Rao; Bhaskar D.,9999,0,9999,0
1668415152580,ECE 200,039,103624,Rao; Ramesh R,9999,0,9999,0
1668415152580,ECE 200,040,103625,Rebeiz; Gabriel,9999,0,9999,0
1668415152580,ECE 200,041,103626,Sanford; John R,9999,0,9999,0
1668415152580,ECE 200,042,103627,Siegel; Paul H.,9999,0,9999,0
1668415152580,ECE 200,043,103628,Sievenpiper; Daniel F.,9999,0,9999,0
1668415152580,ECE 200,044,103629,Sworder; David D.,9999,0,9999,0
1668415152580,ECE 200,045,103630,Taur; Yuan,9999,0,9999,0
1668415152580,ECE 200,046,103631,Touri; Behrouz,9999,0,9999,0
1668415152580,ECE 200,047,103632,Trivedi; Mohan M.,9999,0,9999,0
1668415152580,ECE 200,048,103633,Vasconcelos; Nuno,9999,0,9999,0
1668415152580,ECE 200,049,103634,Wang; Xiaolong,9999,0,9999,0
1668415152580,ECE 200,050,103635,Xie; Pengtao,9999,0,9999,0
1668415152580,ECE 200,051,103636,Yip; Michael,9999,0,9999,0
1668415152580,ECE 200,052,103637,Zeger; Kenneth A.,999,0,999,0
1668415152580,ECE 200,053,103638,Zhang; Xinyu,9999,0,9999,0
1668415152580,ECE 200,054,103639,Turakhia; Yatish Girish,9999,0,9999,0
1668415152580,ECE 200,055,103640,Kang; Mingu,9999,0,9999,0
1668415152580,ECE 200,056,103641,Shi; Yuanyuan,9999,0,9999,0
1668415152580,ECE 200,057,103642,Wang; Edward Jay,9999,0,9999,0
1668415152580,ECE 200,058,103643,Zheng; Yang,9999,0,9999,0
1668415153012,ECE 202,A00,103644,Kuzum; Duygu,0,17,0,0
1668415153436,ECE 212BN,A00,103646,Ng; Tse Nga,0,0,0,0
1668415153862,ECE 221,A00,111493,Staff,0,0,0,0
1668415154288,ECE 222B,A00,103647,Lomakin; Vitaliy,0,4,0,0
1668415154712,ECE 230B,A00,103648,Taur; Yuan,0,0,0,0
1668415155144,ECE 238B,A00,103649,Garay; Javier,0,0,0,0
1668415155572,ECE 240B,A00,112900,Fainman; Yeshaiahu,0,1,0,0
1668415156000,ECE 247A,A00,103650,Jokerst; Jesse Vincent,0,1,0,0
1668415156424,ECE 247B,A00,103651,Wang; Joseph,0,2,0,0
1668415156857,ECE 250,A00,103652,Siegel; Paul H.,0,36,0,0
1668415157287,ECE 251A,A00,103654,Rao; Bhaskar D.,0,28,0,0
1668415157712,ECE 257B,A00,103655,Bharadia; Dinesh,0,10,0,0
1668415158145,ECE 258A,A00,103656,Milstein; Laurence B.,0,9,0,0
1668415158577,ECE 260B,A00,103658,Kang; Mingu,0,57,0,0
1668415159002,ECE 264A,A00,103659,Galton; Ian A,0,26,0,0
1668415159428,ECE 265A,A00,103661,Gudem; Prasad S.S.,0,10,0,0
1668415159854,ECE 265D,A00,103662,Gudem; Prasad S.S.,0,8,0,0
1668415160278,ECE 268,A00,103663,Koushanfar; Farinaz,0,17,0,0
1668415160705,ECE 269,A01,103665,Pal; Piya,0,113,0,0
1668415161132,ECE 271B,A00,103666,Vasconcelos; Manuela,0,43,0,0
1668415161558,ECE 276A,A00,103667,Atanasov; Nikolay A.,0,53,0,0
1668415161983,ECE 277,A00,103668,An; Cheolhong,0,80,0,0
1668415162408,ECE 279,A00,117947,Hall; Drew A.,0,10,0,0
1668415163258,ECE 283,A00,103670,Hsueh; Tzu-Chien,0,16,0,0
1668415163684,ECE 284,A00,103671,Turakhia; Yatish Girish,0,21,0,0
1668415164112,ECE 285,A00,103672,Zheng; Yang,0,18,0,0
1668415164112,ECE 285,B00,103673,Sworder; David D.,0,35,0,0
1668415164540,ECE 287,A00,103676,Javidi; Tara,0,4,0,0
1668415165095,MATH 200B,A00,098023,Salehi Golsefidy; Alireza,12,0,15,3
1668415165530,MATH 202B,A00,098024,Rhoades; Brendon Patrick,9,0,15,6
1668415165955,MATH 203B,A00,098025,Oprea; Dragos N.,10,0,15,5
1668415166380,MATH 204B,A00,098026,Sorensen; Claus M,13,0,15,2
1668415166881,MATH 208,A00,098027,Izadi; Elham,7,0,10,3
1668415167305,MATH 209,A00,098028,Pollack; Aaron,10,0,10,0
1668415167728,MATH 211A,A00,112919,Rogalski; Daniel,9,0,10,1
1668415168157,MATH 211B,A00,112920,Seward; Brandon M.,9,0,10,1
1668415168580,MATH 218,A00,098029,Li; Bo,10,0,10,0
1668415169005,MATH 220B,A00,098030,Novak; Jonathan I,11,0,15,4
1668415169429,MATH 221A,A00,098031,Ebenfelt; Peter F,13,0,15,2
1668415169851,MATH 231B,A00,098032,Zlatos; Andrej,12,0,15,3
1668415170274,MATH 240B,A00,098033,Ni; Lei,9,0,15,6
1668415170699,MATH 243,A00,098034,Jekel; David Andrew,10,0,10,0
1668415171146,MATH 245A,A00,098035,Nie; Jiawang,0,0,15,16
1668415171572,MATH 248,A00,098036,Bejenaru; Ioan,10,0,10,0
1668415172024,MATH 250B,A00,098037,Spolaor; Luca,14,0,15,1
1668415172450,MATH 258,A00,098038,Ni; Lei,10,0,10,0
1668415172876,MATH 264B,A00,098041,Rhoades; Brendon Patrick,9,0,15,6
1668415173302,MATH 268,A00,098042,Buss; Samuel R,10,0,10,0
1668415173728,MATH 269,A00,098043,Rhoades; Brendon Patrick,10,0,10,0
1668415174153,MATH 270B,A00,098044,Li; Bo,10,0,15,5
1668415174586,MATH 272B,A00,098045,Holst; Michael J,13,0,15,2
1668415175008,MATH 273A,A00,098046,Tian; Xiaochuan,10,0,15,5
1668415175437,MATH 275,A01,098048,Tian; Xiaochuan,6,0,10,4
1668415175860,MATH 278A,A00,098049,Holst; Michael J,8,0,10,2
1668415176288,MATH 278B,A00,098050,Cloninger; Alexander,10,0,10,0
1668415176711,MATH 278C,A00,098051,Nie; Jiawang,6,0,10,4
1668415177133,MATH 280B,A00,098052,Zheng; Tianyi,8,0,15,7
1668415177559,MATH 281B,A00,098053,Bradic; Jelena,0,1,15,15
1668415177980,MATH 282B,A00,098054,Arias-Castro; Ery,0,0,15,15
1668415178405,MATH 285,A00,098055,Fitzsimmons; Patrick J,0,0,15,17
1668415178836,MATH 287B,A00,098056,Arias-Castro; Ery,2,0,15,13
1668415179258,MATH 288,A00,098057,Agarwal; Pooja,9,0,10,1
1668415179258,MATH 288,B00,098058,Zhang; Danna,8,0,10,2
1668415179258,MATH 288,C00,098059,Williams; Ruth J,9,0,10,1
1668415179688,MATH 290B,A00,098060,Roberts; Justin Deritter,13,0,15,2
1668415180110,MATH 292,A00,098061,Belmont; Eva Kinoshita,10,0,10,0
1668415180534,MATH 295,A00,098062,Suk; Andrew Hoon,48,0,50,2
1668415180963,MATH 296,A00,098063,Novak; Jonathan I,20,0,20,0
1668415181397,MATH 297,001,098064,Gamst; Anthony Collins,9997,0,9999,2
1668415683088,COGS 205,A00,101395,Chiba; Andrea,19,0,20,1
1668415683535,COGS 210B,001,101404,Greene; Deanna Jacquelyn,9998,0,9999,1
1668415683535,COGS 210B,002,101417,Xia; Haijun,9999,0,9999,0
1668415683535,COGS 210B,003,101422,Nitz; Douglas A.,9999,0,9999,0
1668415683535,COGS 210B,004,101423,Hollan; James D.,9998,0,9999,1
1668415683535,COGS 210B,005,101424,Deak; Gedeon O.,9998,0,9999,1
1668415683535,COGS 210B,006,101425,Rossano; Federico,9999,0,9999,0
1668415683961,COGS 211B,A00,101427,Coulson; Seana M,9996,0,9999,3
1668415684382,COGS 220,A00,101428,Hollan; James D.,0,1,25,25
1668415684807,COGS 229,A00,101429,Dow; Steven P,18,0,25,7
1668415685229,COGS 230,A00,101430,Klemmer; Scott R,11,0,17,6
1668415685655,COGS 234,A00,101431,Xia; Haijun,1,0,25,24
1668415686079,COGS 260,A00,101432,Kiyonaga; Anastasia,21,0,25,4
1668415686079,COGS 260,B00,101433,Kirsh; David Joel,15,0,25,10
1668415686502,CSE 202,A00,102371,Impagliazzo; Russell,0,26,0,0
1668415686924,CSE 203B,A01,102373,Cheng; Chung Kuan,0,22,0,0
1668415687348,CSE 208,A00,102374,Micciancio; Daniele,0,1,0,0
1668415687784,CSE 209A,A00,112895,Impagliazzo; Russell,0,3,15,15
1668415688223,CSE 209B,A00,108005,Bellare; Mihir,0,2,0,0
1668415688743,CSE 210,A00,113163,Coblenz; Michael J,0,39,0,0
1668415689167,CSE 219,A00,106111,Dow; Steven P,0,0,20,20
1668415689594,CSE 221,A00,102376,Voelker; Geoffrey M.,0,24,0,0
1668415690022,CSE 224,A01,102378,Porter; George M,0,92,0,0
1668415690448,CSE 229A,A00,102379,Savage; Stefan,0,4,0,0
1668415690872,CSE 229C,A00,102380,Munyaka; Imani N. S.,0,3,0,0
1668415691295,CSE 232B,A00,102382,Deutsch; Alin Bernard,0,10,0,0
1668415691723,CSE 234,A01,112904,Kumar; Arun Kumar,0,0,0,0
1668415692148,CSE 237A,A00,102383,Rosing; Tajana Simunic,0,22,0,0
1668415692577,CSE 239A,A00,102384,Deutsch; Alin Bernard,0,4,0,0
1668415692999,CSE 239B,A00,102385,Polikarpova; Nadezhda,0,2,0,0
1668415693432,CSE 240A,A00,102386,Pannuto; Patrick William,0,20,0,0
1668415693860,CSE 240B,A00,102387,Zhao; Jishen,0,20,0,0
1668415694296,CSE 241A,A00,106406,Kang; Mingu,0,1,0,0
1668415694720,CSE 249B,A00,102388,Kahng; Andrew Byun,0,1,8,8
1668415695152,CSE 251B,A01,102392,Cottrell; Garrison W,0,19,0,0
1668415695152,CSE 251B,A02,102393,Cottrell; Garrison W,0,21,0,0
1668415695578,CSE 252B,A00,102394,Ochoa; Benjamin Lawrence,0,34,0,0
1668415696007,CSE 257,A01,102396,Gao; Sicun,0,78,0,0
1668415696432,CSE 272,A00,102397,Li; Tzumao,0,6,0,0
1668415696857,CSE 274,A00,111323,Chern; Albert Ren-Haur,0,6,0,0
1668415697281,CSE 282,A00,102398,Pevzner; Pavel Arkadjevich,0,0,0,0
1668415697709,CSE 284,A00,114175,Gymrek; Melissa Ann,0,8,0,0
1668415698132,CSE 290,A00,102399,Chandraker; Manmohan Krishna,0,3,0,0
1668415698132,CSE 290,B00,102400,Vaccaro; Kristen Marie,0,1,25,25
1668415698132,CSE 290,C00,102414,Pannuto; Patrick William,0,1,25,25
1668415698132,CSE 290,D00,102427,Pevzner; Pavel Arkadjevich,0,0,0,0
1668415698132,CSE 290,E00,102429,Zhao; Jishen,0,1,0,0
1668415698132,CSE 290,F00,102436,Tullsen; Dean Michael,0,2,0,0
1668415698132,CSE 290,G00,102440,Christensen; Henrik I,0,3,20,20
1668415698568,CSE 291,A00,102443,Su; Hao,0,0,0,0
1668415698568,CSE 291,B00,102448,Polikarpova; Nadezhda,0,0,0,0
1668415698568,CSE 291,C00,102453,Vaccaro; Kristen Marie,0,0,0,0
1668415698568,CSE 291,D00,111343,Savage; Stefan,0,0,0,0
1668415698568,CSE 291,E00,116474,Claffy; Kimberly Claire,0,0,0,0
1668415698568,CSE 291,F00,116479,Pasquale; Joseph,0,0,0,0
1668415699011,CSE 293,001,119111,Bafna; Vineet,9999,0,9999,0
1668415699011,CSE 293,002,119118,Bellare; Mihir,9999,0,9999,0
1668415699011,CSE 293,003,119122,Berg-Kirkpatrick; Taylor D,9999,0,9999,0
1668415699011,CSE 293,004,119135,Christensen; Henrik I,9999,0,9999,0
1668415699011,CSE 293,005,119142,Cottrell; Garrison W,9999,0,9999,0
1668415699011,CSE 293,006,119146,Deutsch; Alin Bernard,9999,0,9999,0
1668415699011,CSE 293,007,119159,Esmaeilzadeh; Hadi,9999,0,9999,0
1668415699011,CSE 293,008,119166,Freund; Yoav,9999,0,9999,0
1668415699011,CSE 293,009,119170,Griswold; William G.,9999,0,9999,0
1668415699011,CSE 293,010,119183,Gymrek; Melissa Ann,9999,0,9999,0
1668415699011,CSE 293,011,119190,Heninger; Nadia A,9999,0,9999,0
1668415699011,CSE 293,012,119230,Impagliazzo; Russell,9999,0,9999,0
1668415699011,CSE 293,013,119232,Jhala; Ranjit,9999,0,9999,0
1668415699011,CSE 293,014,119233,Kahng; Andrew Byun,9999,0,9999,0
1668415699011,CSE 293,015,119298,Kane; Daniel Mertz,9999,0,9999,0
1668415699011,CSE 293,016,119299,Kriegman; David J,9999,0,9999,0
1668415699011,CSE 293,017,119300,Kumar; Arun Kumar,9999,0,9999,0
1668415699011,CSE 293,018,119301,Lerner; Sorin,9999,0,9999,0
1668415699011,CSE 293,019,119302,Lovett; Shachar,9999,0,9999,0
1668415699011,CSE 293,020,119303,McAuley; Julian John,9999,0,9999,0
1668415699011,CSE 293,021,119304,Micciancio; Daniele,9999,0,9999,0
1668415699011,CSE 293,022,119367,Orailoglu; Alex,9999,0,9999,0
1668415699011,CSE 293,023,119382,Paturi; Ramamohan,9999,0,9999,0
1668415699011,CSE 293,024,119404,Polikarpova; Nadezhda,9999,0,9999,0
1668415699011,CSE 293,025,119406,Politz; Joseph Gibbs,9999,0,9999,0
1668415699011,CSE 293,026,119411,Porter; George M,9999,0,9999,0
1668415699011,CSE 293,027,119414,Porter; Leonard Emerson,9999,0,9999,0
1668415699011,CSE 293,028,119416,Ramamoorthi; Ravi,9999,0,9999,0
1668415699011,CSE 293,029,119417,Sahoo; Debashis,9999,0,9999,0
1668415699011,CSE 293,030,119420,Saul; Lawrence,9999,0,9999,0
1668415699011,CSE 293,031,119421,Savage; Stefan,9999,0,9999,0
1668415699011,CSE 293,032,119425,Schulze; Jurgen P.,9999,0,9999,0
1668415699011,CSE 293,033,119426,Snoeren; Alex C.,9999,0,9999,0
1668415699011,CSE 293,034,119428,Shang; Jingbo,9999,0,9999,0
1668415699011,CSE 293,035,119430,Stefan; Deian,9999,0,9999,0
1668415699011,CSE 293,036,119431,Su; Hao,9999,0,9999,0
1668415699011,CSE 293,037,119433,Swanson; Steven James,9999,0,9999,0
1668415699011,CSE 293,038,119435,Tullsen; Dean Michael,9999,0,9999,0
1668415699011,CSE 293,039,119483,Voelker; Geoffrey M.,9999,0,9999,0
1668415699011,CSE 293,040,119537,Zhao; Jishen,9999,0,9999,0
1668415699011,CSE 293,041,119538,Zhou; Yuan-Yuan,9999,0,9999,0
1668415699011,CSE 293,042,119539,Gao; Sicun,9999,0,9999,0
1668415699011,CSE 293,043,119540,Weibel; Nadir,9999,0,9999,0
1668415699011,CSE 293,044,119541,Gupta; Rajesh K.,9999,0,9999,0
1668415699011,CSE 293,045,126410,Vaccaro; Kristen Marie,9999,0,9999,0
1668415699011,CSE 293,046,126411,Klemke; Richard,9999,0,9999,0
1668415699433,CSE 294,A00,102459,Voelker; Geoffrey M.,0,1,0,0
1668415699433,CSE 294,B00,111322,Orailoglu; Alex,0,0,0,0
1668415699862,DSE 201,A00,096914,Deutsch; Alin Bernard,30,0,30,0
1668415700286,DSE 210,A00,096915,Dasgupta; Sanjoy,30,0,30,0
1668415700709,DSE 260A,A00,096916,Altintas De Callaf; Ilkay,30,0,30,0
1668415701162,ECE 200,001,103586,Antipa; Nicholas A,9999,0,9999,0
1668415701162,ECE 200,002,103587,Atanasov; Nikolay A.,9999,0,9999,0
1668415701162,ECE 200,003,103588,Bharadia; Dinesh,9999,0,9999,0
1668415701162,ECE 200,004,103589,Cheng; Chung Kuan,9999,0,9999,0
1668415701162,ECE 200,005,103590,Cosman; Pamela C.,9999,0,9999,0
1668415701162,ECE 200,006,103591,Dayeh; Shadi Ahmad,9999,0,9999,0
1668415701162,ECE 200,007,103592,Fainman; Yeshaiahu,9999,0,9999,0
1668415701162,ECE 200,008,103593,Ford; Joseph Earl,9999,0,9999,0
1668415701162,ECE 200,009,103594,Franceschetti; Massimo,9999,0,9999,0
1668415701162,ECE 200,010,103595,Fullerton; Eric E,9999,0,9999,0
1668415701162,ECE 200,011,103596,Galton; Ian A,9999,0,9999,0
1668415701162,ECE 200,012,103597,Gilja; Vikash,9999,0,9999,0
1668415701162,ECE 200,013,103598,Hall; Drew A.,9999,0,9999,0
1668415701162,ECE 200,014,103599,Hsueh; Tzu-Chien,9999,0,9999,0
1668415701162,ECE 200,015,103600,Javidi; Tara,9999,0,9999,0
1668415701162,ECE 200,016,103601,Kahng; Andrew Byun,9999,0,9999,0
1668415701162,ECE 200,017,103602,Kim; Young-Han,9999,0,9999,0
1668415701162,ECE 200,018,103603,Koushanfar; Farinaz,9999,0,9999,0
1668415701162,ECE 200,019,103604,Kuzum; Duygu,9999,0,9999,0
1668415701162,ECE 200,020,103605,Le; Hanh-Phuc,9999,0,9999,0
1668415701162,ECE 200,021,103606,Lin; Bill,9999,0,9999,0
1668415701162,ECE 200,022,103607,Liu; Zhaowei,9998,0,9999,1
1668415701162,ECE 200,023,103608,Lo; Yu-Hwa,9999,0,9999,0
1668415701162,ECE 200,024,103609,Lomakin; Vitaliy,9999,0,9999,0
1668415701162,ECE 200,025,103610,Mercier; Patrick Philip,9999,0,9999,0
1668415701162,ECE 200,026,103611,Meyer; Florian,9999,0,9999,0
1668415701162,ECE 200,027,103612,Milstein; Laurence B.,9999,0,9999,0
1668415701162,ECE 200,028,103613,Mir Arabbaygi; Siavash,9999,0,9999,0
1668415701162,ECE 200,029,103614,Mookherjea; Shayan,9999,0,9999,0
1668415701162,ECE 200,030,103615,Morris; Karcher William,9999,0,9999,0
1668415701162,ECE 200,031,103616,Ng; Tse Nga,9999,0,9999,0
1668415701162,ECE 200,032,103617,Nguyen; Truong Quang,9999,0,9999,0
1668415701162,ECE 200,033,103618,Nomura; Kenji,9999,0,9999,0
1668415701162,ECE 200,034,103619,Orlitsky; Alon,9999,0,9999,0
1668415701162,ECE 200,035,103620,Pal; Piya,9999,0,9999,0
1668415701162,ECE 200,036,103621,Papen; George C.,9999,0,9999,0
1668415701162,ECE 200,037,103622,Radic; Stojan,9999,0,9999,0
1668415701162,ECE 200,038,103623,Rao; Bhaskar D.,9999,0,9999,0
1668415701162,ECE 200,039,103624,Rao; Ramesh R,9999,0,9999,0
1668415701162,ECE 200,040,103625,Rebeiz; Gabriel,9999,0,9999,0
1668415701162,ECE 200,041,103626,Sanford; John R,9999,0,9999,0
1668415701162,ECE 200,042,103627,Siegel; Paul H.,9999,0,9999,0
1668415701162,ECE 200,043,103628,Sievenpiper; Daniel F.,9999,0,9999,0
1668415701162,ECE 200,044,103629,Sworder; David D.,9999,0,9999,0
1668415701162,ECE 200,045,103630,Taur; Yuan,9999,0,9999,0
1668415701162,ECE 200,046,103631,Touri; Behrouz,9999,0,9999,0
1668415701162,ECE 200,047,103632,Trivedi; Mohan M.,9999,0,9999,0
1668415701162,ECE 200,048,103633,Vasconcelos; Nuno,9999,0,9999,0
1668415701162,ECE 200,049,103634,Wang; Xiaolong,9999,0,9999,0
1668415701162,ECE 200,050,103635,Xie; Pengtao,9999,0,9999,0
1668415701162,ECE 200,051,103636,Yip; Michael,9999,0,9999,0
1668415701162,ECE 200,052,103637,Zeger; Kenneth A.,999,0,999,0
1668415701162,ECE 200,053,103638,Zhang; Xinyu,9999,0,9999,0
1668415701162,ECE 200,054,103639,Turakhia; Yatish Girish,9999,0,9999,0
1668415701162,ECE 200,055,103640,Kang; Mingu,9999,0,9999,0
1668415701162,ECE 200,056,103641,Shi; Yuanyuan,9999,0,9999,0
1668415701162,ECE 200,057,103642,Wang; Edward Jay,9999,0,9999,0
1668415701162,ECE 200,058,103643,Zheng; Yang,9999,0,9999,0
1668415701588,ECE 202,A00,103644,Kuzum; Duygu,0,19,0,0
1668415702026,ECE 212BN,A00,103646,Ng; Tse Nga,0,0,0,0
1668415702453,ECE 221,A00,111493,Staff,0,0,0,0
1668415702878,ECE 222B,A00,103647,Lomakin; Vitaliy,0,4,0,0
1668415703302,ECE 230B,A00,103648,Taur; Yuan,0,0,0,0
1668415703729,ECE 238B,A00,103649,Garay; Javier,0,0,0,0
1668415704154,ECE 240B,A00,112900,Fainman; Yeshaiahu,0,3,0,0
1668415704578,ECE 247A,A00,103650,Jokerst; Jesse Vincent,0,1,0,0
1668415705003,ECE 247B,A00,103651,Wang; Joseph,0,3,0,0
1668415705441,ECE 250,A00,103652,Siegel; Paul H.,0,40,0,0
1668415705867,ECE 251A,A00,103654,Rao; Bhaskar D.,0,28,0,0
1668415706292,ECE 257B,A00,103655,Bharadia; Dinesh,0,11,0,0
1668415706718,ECE 258A,A00,103656,Milstein; Laurence B.,0,10,0,0
1668415707145,ECE 260B,A00,103658,Kang; Mingu,0,60,0,0
1668415707568,ECE 264A,A00,103659,Galton; Ian A,0,27,0,0
1668415707993,ECE 265A,A00,103661,Gudem; Prasad S.S.,0,12,0,0
1668415708420,ECE 265D,A00,103662,Gudem; Prasad S.S.,0,8,0,0
1668415708849,ECE 268,A00,103663,Koushanfar; Farinaz,0,18,0,0
1668415709276,ECE 269,A01,103665,Pal; Piya,0,116,0,0
1668415709704,ECE 271B,A00,103666,Vasconcelos; Manuela,0,44,0,0
1668415710129,ECE 276A,A00,103667,Atanasov; Nikolay A.,0,59,0,0
1668415710559,ECE 277,A00,103668,An; Cheolhong,0,81,0,0
1668415710991,ECE 279,A00,117947,Hall; Drew A.,0,10,0,0
1668415711849,ECE 283,A00,103670,Hsueh; Tzu-Chien,0,17,0,0
1668415712284,ECE 284,A00,103671,Turakhia; Yatish Girish,0,22,0,0
1668415712725,ECE 285,A00,103672,Zheng; Yang,0,20,0,0
1668415712725,ECE 285,B00,103673,Sworder; David D.,0,36,0,0
1668415713155,ECE 287,A00,103676,Javidi; Tara,0,4,0,0
1668415713617,MATH 200B,A00,098023,Salehi Golsefidy; Alireza,12,0,15,3
1668415714057,MATH 202B,A00,098024,Rhoades; Brendon Patrick,9,0,15,6
1668415714493,MATH 203B,A00,098025,Oprea; Dragos N.,10,0,15,5
1668415714919,MATH 204B,A00,098026,Sorensen; Claus M,13,0,15,2
1668415715344,MATH 208,A00,098027,Izadi; Elham,7,0,10,3
1668415715771,MATH 209,A00,098028,Pollack; Aaron,10,0,10,0
1668415716196,MATH 211A,A00,112919,Rogalski; Daniel,9,0,10,1
1668415716625,MATH 211B,A00,112920,Seward; Brandon M.,9,0,10,1
1668415717049,MATH 218,A00,098029,Li; Bo,10,0,10,0
1668415717473,MATH 220B,A00,098030,Novak; Jonathan I,11,0,15,4
1668415717898,MATH 221A,A00,098031,Ebenfelt; Peter F,13,0,15,2
1668415718323,MATH 231B,A00,098032,Zlatos; Andrej,12,0,15,3
1668415718749,MATH 240B,A00,098033,Ni; Lei,9,0,15,6
1668415719171,MATH 243,A00,098034,Jekel; David Andrew,10,0,10,0
1668415719597,MATH 245A,A00,098035,Nie; Jiawang,0,0,15,16
1668415720022,MATH 248,A00,098036,Bejenaru; Ioan,10,0,10,0
1668415720445,MATH 250B,A00,098037,Spolaor; Luca,14,0,15,1
1668415720881,MATH 258,A00,098038,Ni; Lei,10,0,10,0
1668415721308,MATH 264B,A00,098041,Rhoades; Brendon Patrick,9,0,15,6
1668415721734,MATH 268,A00,098042,Buss; Samuel R,10,0,10,0
1668415722160,MATH 269,A00,098043,Rhoades; Brendon Patrick,10,0,10,0
1668415722585,MATH 270B,A00,098044,Li; Bo,10,0,15,5
1668415723010,MATH 272B,A00,098045,Holst; Michael J,13,0,15,2
1668415723441,MATH 273A,A00,098046,Tian; Xiaochuan,10,0,15,5
1668415723873,MATH 275,A01,098048,Tian; Xiaochuan,6,0,10,4
1668415724297,MATH 278A,A00,098049,Holst; Michael J,8,0,10,2
1668415724724,MATH 278B,A00,098050,Cloninger; Alexander,10,0,10,0
1668415725150,MATH 278C,A00,098051,Nie; Jiawang,6,0,10,4
1668415725576,MATH 280B,A00,098052,Zheng; Tianyi,8,0,15,7
1668415726004,MATH 281B,A00,098053,Bradic; Jelena,0,1,15,15
1668415726428,MATH 282B,A00,098054,Arias-Castro; Ery,0,0,15,15
1668415726852,MATH 285,A00,098055,Fitzsimmons; Patrick J,0,0,15,17
1668415727278,MATH 287B,A00,098056,Arias-Castro; Ery,2,0,15,13
1668415727706,MATH 288,A00,098057,Agarwal; Pooja,9,0,10,1
1668415727706,MATH 288,B00,098058,Zhang; Danna,8,0,10,2
1668415727706,MATH 288,C00,098059,Williams; Ruth J,9,0,10,1
1668415728132,MATH 290B,A00,098060,Roberts; Justin Deritter,13,0,15,2
1668415728555,MATH 292,A00,098061,Belmont; Eva Kinoshita,10,0,10,0
1668415728982,MATH 295,A00,098062,Suk; Andrew Hoon,48,0,50,2
1668415729409,MATH 296,A00,098063,Novak; Jonathan I,20,0,20,0
1668415729835,MATH 297,001,098064,Gamst; Anthony Collins,9997,0,9999,2
1668416231961,COGS 205,A00,101395,Chiba; Andrea,19,0,20,1
1668416232384,COGS 210B,001,101404,Greene; Deanna Jacquelyn,9998,0,9999,1
1668416232384,COGS 210B,002,101417,Xia; Haijun,9999,0,9999,0
1668416232384,COGS 210B,003,101422,Nitz; Douglas A.,9999,0,9999,0
1668416232384,COGS 210B,004,101423,Hollan; James D.,9998,0,9999,1
1668416232384,COGS 210B,005,101424,Deak; Gedeon O.,9998,0,9999,1
1668416232384,COGS 210B,006,101425,Rossano; Federico,9999,0,9999,0
1668416232808,COGS 211B,A00,101427,Coulson; Seana M,9996,0,9999,3
1668416233231,COGS 220,A00,101428,Hollan; James D.,1,2,25,24
1668416233655,COGS 229,A00,101429,Dow; Steven P,18,0,25,7
1668416234080,COGS 230,A00,101430,Klemmer; Scott R,11,0,17,6
1668416234502,COGS 234,A00,101431,Xia; Haijun,2,0,25,23
1668416234926,COGS 260,A00,101432,Kiyonaga; Anastasia,21,0,25,4
1668416234926,COGS 260,B00,101433,Kirsh; David Joel,15,0,25,10
1668416235352,CSE 202,A00,102371,Impagliazzo; Russell,0,27,0,0
1668416235779,CSE 203B,A01,102373,Cheng; Chung Kuan,0,22,0,0
1668416236206,CSE 208,A00,102374,Micciancio; Daniele,0,1,0,0
1668416236638,CSE 209A,A00,112895,Impagliazzo; Russell,0,3,15,15
1668416237063,CSE 209B,A00,108005,Bellare; Mihir,0,2,0,0
1668416237487,CSE 210,A00,113163,Coblenz; Michael J,0,39,0,0
1668416237915,CSE 219,A00,106111,Dow; Steven P,0,0,20,20
1668416238340,CSE 221,A00,102376,Voelker; Geoffrey M.,0,24,0,0
1668416238766,CSE 224,A01,102378,Porter; George M,0,96,0,0
1668416239189,CSE 229A,A00,102379,Savage; Stefan,0,4,0,0
1668416239611,CSE 229C,A00,102380,Munyaka; Imani N. S.,0,4,0,0
1668416240047,CSE 232B,A00,102382,Deutsch; Alin Bernard,0,10,0,0
1668416240473,CSE 234,A01,112904,Kumar; Arun Kumar,0,0,0,0
1668416240895,CSE 237A,A00,102383,Rosing; Tajana Simunic,0,22,0,0
1668416241318,CSE 239A,A00,102384,Deutsch; Alin Bernard,0,5,0,0
1668416241741,CSE 239B,A00,102385,Polikarpova; Nadezhda,0,3,0,0
1668416242168,CSE 240A,A00,102386,Pannuto; Patrick William,0,21,0,0
1668416242593,CSE 240B,A00,102387,Zhao; Jishen,0,20,0,0
1668416243024,CSE 241A,A00,106406,Kang; Mingu,0,1,0,0
1668416243451,CSE 249B,A00,102388,Kahng; Andrew Byun,0,1,8,8
1668416243877,CSE 251B,A01,102392,Cottrell; Garrison W,0,19,0,0
1668416243877,CSE 251B,A02,102393,Cottrell; Garrison W,0,21,0,0
1668416244302,CSE 252B,A00,102394,Ochoa; Benjamin Lawrence,0,34,0,0
1668416244729,CSE 257,A01,102396,Gao; Sicun,0,79,0,0
1668416245152,CSE 272,A00,102397,Li; Tzumao,0,6,0,0
1668416245578,CSE 274,A00,111323,Chern; Albert Ren-Haur,0,6,0,0
1668416246002,CSE 282,A00,102398,Pevzner; Pavel Arkadjevich,0,0,0,0
1668416246429,CSE 284,A00,114175,Gymrek; Melissa Ann,0,9,0,0
1668416246852,CSE 290,A00,102399,Chandraker; Manmohan Krishna,0,3,0,0
1668416246852,CSE 290,B00,102400,Vaccaro; Kristen Marie,0,1,25,25
1668416246852,CSE 290,C00,102414,Pannuto; Patrick William,0,1,25,25
1668416246852,CSE 290,D00,102427,Pevzner; Pavel Arkadjevich,0,0,0,0
1668416246852,CSE 290,E00,102429,Zhao; Jishen,0,1,0,0
1668416246852,CSE 290,F00,102436,Tullsen; Dean Michael,0,2,0,0
1668416246852,CSE 290,G00,102440,Christensen; Henrik I,0,3,20,20
1668416247287,CSE 291,A00,102443,Su; Hao,0,0,0,0
1668416247287,CSE 291,B00,102448,Polikarpova; Nadezhda,0,0,0,0
1668416247287,CSE 291,C00,102453,Vaccaro; Kristen Marie,0,0,0,0
1668416247287,CSE 291,D00,111343,Savage; Stefan,0,0,0,0
1668416247287,CSE 291,E00,116474,Claffy; Kimberly Claire,0,0,0,0
1668416247287,CSE 291,F00,116479,Pasquale; Joseph,0,0,0,0
1668416247722,CSE 293,001,119111,Bafna; Vineet,9999,0,9999,0
1668416247722,CSE 293,002,119118,Bellare; Mihir,9999,0,9999,0
1668416247722,CSE 293,003,119122,Berg-Kirkpatrick; Taylor D,9999,0,9999,0
1668416247722,CSE 293,004,119135,Christensen; Henrik I,9999,0,9999,0
1668416247722,CSE 293,005,119142,Cottrell; Garrison W,9999,0,9999,0
1668416247722,CSE 293,006,119146,Deutsch; Alin Bernard,9999,0,9999,0
1668416247722,CSE 293,007,119159,Esmaeilzadeh; Hadi,9999,0,9999,0
1668416247722,CSE 293,008,119166,Freund; Yoav,9999,0,9999,0
1668416247722,CSE 293,009,119170,Griswold; William G.,9999,0,9999,0
1668416247722,CSE 293,010,119183,Gymrek; Melissa Ann,9999,0,9999,0
1668416247722,CSE 293,011,119190,Heninger; Nadia A,9999,0,9999,0
1668416247722,CSE 293,012,119230,Impagliazzo; Russell,9999,0,9999,0
1668416247722,CSE 293,013,119232,Jhala; Ranjit,9999,0,9999,0
1668416247722,CSE 293,014,119233,Kahng; Andrew Byun,9999,0,9999,0
1668416247722,CSE 293,015,119298,Kane; Daniel Mertz,9999,0,9999,0
1668416247722,CSE 293,016,119299,Kriegman; David J,9999,0,9999,0
1668416247722,CSE 293,017,119300,Kumar; Arun Kumar,9999,0,9999,0
1668416247722,CSE 293,018,119301,Lerner; Sorin,9999,0,9999,0
1668416247722,CSE 293,019,119302,Lovett; Shachar,9999,0,9999,0
1668416247722,CSE 293,020,119303,McAuley; Julian John,9999,0,9999,0
1668416247722,CSE 293,021,119304,Micciancio; Daniele,9999,0,9999,0
1668416247722,CSE 293,022,119367,Orailoglu; Alex,9999,0,9999,0
1668416247722,CSE 293,023,119382,Paturi; Ramamohan,9999,0,9999,0
1668416247722,CSE 293,024,119404,Polikarpova; Nadezhda,9999,0,9999,0
1668416247722,CSE 293,025,119406,Politz; Joseph Gibbs,9999,0,9999,0
1668416247722,CSE 293,026,119411,Porter; George M,9999,0,9999,0
1668416247722,CSE 293,027,119414,Porter; Leonard Emerson,9999,0,9999,0
1668416247722,CSE 293,028,119416,Ramamoorthi; Ravi,9999,0,9999,0
1668416247722,CSE 293,029,119417,Sahoo; Debashis,9999,0,9999,0
1668416247722,CSE 293,030,119420,Saul; Lawrence,9999,0,9999,0
1668416247722,CSE 293,031,119421,Savage; Stefan,9999,0,9999,0
1668416247722,CSE 293,032,119425,Schulze; Jurgen P.,9999,0,9999,0
1668416247722,CSE 293,033,119426,Snoeren; Alex C.,9999,0,9999,0
1668416247722,CSE 293,034,119428,Shang; Jingbo,9999,0,9999,0
1668416247722,CSE 293,035,119430,Stefan; Deian,9999,0,9999,0
1668416247722,CSE 293,036,119431,Su; Hao,9999,0,9999,0
1668416247722,CSE 293,037,119433,Swanson; Steven James,9999,0,9999,0
1668416247722,CSE 293,038,119435,Tullsen; Dean Michael,9999,0,9999,0
1668416247722,CSE 293,039,119483,Voelker; Geoffrey M.,9999,0,9999,0
1668416247722,CSE 293,040,119537,Zhao; Jishen,9999,0,9999,0
1668416247722,CSE 293,041,119538,Zhou; Yuan-Yuan,9999,0,9999,0
1668416247722,CSE 293,042,119539,Gao; Sicun,9999,0,9999,0
1668416247722,CSE 293,043,119540,Weibel; Nadir,9999,0,9999,0
1668416247722,CSE 293,044,119541,Gupta; Rajesh K.,9999,0,9999,0
1668416247722,CSE 293,045,126410,Vaccaro; Kristen Marie,9999,0,9999,0
1668416247722,CSE 293,046,126411,Klemke; Richard,9999,0,9999,0
1668416248148,CSE 294,A00,102459,Voelker; Geoffrey M.,0,1,0,0
1668416248148,CSE 294,B00,111322,Orailoglu; Alex,0,0,0,0
1668416248570,DSE 201,A00,096914,Deutsch; Alin Bernard,30,0,30,0
1668416249000,DSE 210,A00,096915,Dasgupta; Sanjoy,30,0,30,0
1668416249426,DSE 260A,A00,096916,Altintas De Callaf; Ilkay,30,0,30,0
1668416249851,ECE 200,001,103586,Antipa; Nicholas A,9999,0,9999,0
1668416249851,ECE 200,002,103587,Atanasov; Nikolay A.,9999,0,9999,0
1668416249851,ECE 200,003,103588,Bharadia; Dinesh,9999,0,9999,0
1668416249851,ECE 200,004,103589,Cheng; Chung Kuan,9999,0,9999,0
1668416249851,ECE 200,005,103590,Cosman; Pamela C.,9999,0,9999,0
1668416249851,ECE 200,006,103591,Dayeh; Shadi Ahmad,9999,0,9999,0
1668416249851,ECE 200,007,103592,Fainman; Yeshaiahu,9999,0,9999,0
1668416249851,ECE 200,008,103593,Ford; Joseph Earl,9999,0,9999,0
1668416249851,ECE 200,009,103594,Franceschetti; Massimo,9999,0,9999,0
1668416249851,ECE 200,010,103595,Fullerton; Eric E,9999,0,9999,0
1668416249851,ECE 200,011,103596,Galton; Ian A,9999,0,9999,0
1668416249851,ECE 200,012,103597,Gilja; Vikash,9999,0,9999,0
1668416249851,ECE 200,013,103598,Hall; Drew A.,9999,0,9999,0
1668416249851,ECE 200,014,103599,Hsueh; Tzu-Chien,9999,0,9999,0
1668416249851,ECE 200,015,103600,Javidi; Tara,9999,0,9999,0
1668416249851,ECE 200,016,103601,Kahng; Andrew Byun,9999,0,9999,0
1668416249851,ECE 200,017,103602,Kim; Young-Han,9999,0,9999,0
1668416249851,ECE 200,018,103603,Koushanfar; Farinaz,9999,0,9999,0
1668416249851,ECE 200,019,103604,Kuzum; Duygu,9999,0,9999,0
1668416249851,ECE 200,020,103605,Le; Hanh-Phuc,9999,0,9999,0
1668416249851,ECE 200,021,103606,Lin; Bill,9999,0,9999,0
1668416249851,ECE 200,022,103607,Liu; Zhaowei,9998,0,9999,1
1668416249851,ECE 200,023,103608,Lo; Yu-Hwa,9999,0,9999,0
1668416249851,ECE 200,024,103609,Lomakin; Vitaliy,9999,0,9999,0
1668416249851,ECE 200,025,103610,Mercier; Patrick Philip,9999,0,9999,0
1668416249851,ECE 200,026,103611,Meyer; Florian,9999,0,9999,0
1668416249851,ECE 200,027,103612,Milstein; Laurence B.,9999,0,9999,0
1668416249851,ECE 200,028,103613,Mir Arabbaygi; Siavash,9999,0,9999,0
1668416249851,ECE 200,029,103614,Mookherjea; Shayan,9999,0,9999,0
1668416249851,ECE 200,030,103615,Morris; Karcher William,9999,0,9999,0
1668416249851,ECE 200,031,103616,Ng; Tse Nga,9999,0,9999,0
1668416249851,ECE 200,032,103617,Nguyen; Truong Quang,9999,0,9999,0
1668416249851,ECE 200,033,103618,Nomura; Kenji,9999,0,9999,0
1668416249851,ECE 200,034,103619,Orlitsky; Alon,9999,0,9999,0
1668416249851,ECE 200,035,103620,Pal; Piya,9999,0,9999,0
1668416249851,ECE 200,036,103621,Papen; George C.,9999,0,9999,0
1668416249851,ECE 200,037,103622,Radic; Stojan,9999,0,9999,0
1668416249851,ECE 200,038,103623,Rao; Bhaskar D.,9999,0,9999,0
1668416249851,ECE 200,039,103624,Rao; Ramesh R,9999,0,9999,0
1668416249851,ECE 200,040,103625,Rebeiz; Gabriel,9999,0,9999,0
1668416249851,ECE 200,041,103626,Sanford; John R,9999,0,9999,0
1668416249851,ECE 200,042,103627,Siegel; Paul H.,9999,0,9999,0
1668416249851,ECE 200,043,103628,Sievenpiper; Daniel F.,9999,0,9999,0
1668416249851,ECE 200,044,103629,Sworder; David D.,9999,0,9999,0
1668416249851,ECE 200,045,103630,Taur; Yuan,9999,0,9999,0
1668416249851,ECE 200,046,103631,Touri; Behrouz,9999,0,9999,0
1668416249851,ECE 200,047,103632,Trivedi; Mohan M.,9999,0,9999,0
1668416249851,ECE 200,048,103633,Vasconcelos; Nuno,9999,0,9999,0
1668416249851,ECE 200,049,103634,Wang; Xiaolong,9999,0,9999,0
1668416249851,ECE 200,050,103635,Xie; Pengtao,9999,0,9999,0
1668416249851,ECE 200,051,103636,Yip; Michael,9999,0,9999,0
1668416249851,ECE 200,052,103637,Zeger; Kenneth A.,999,0,999,0
1668416249851,ECE 200,053,103638,Zhang; Xinyu,9999,0,9999,0
1668416249851,ECE 200,054,103639,Turakhia; Yatish Girish,9999,0,9999,0
1668416249851,ECE 200,055,103640,Kang; Mingu,9999,0,9999,0
1668416249851,ECE 200,056,103641,Shi; Yuanyuan,9999,0,9999,0
1668416249851,ECE 200,057,103642,Wang; Edward Jay,9999,0,9999,0
1668416249851,ECE 200,058,103643,Zheng; Yang,9999,0,9999,0
1668416250276,ECE 202,A00,103644,Kuzum; Duygu,0,19,0,0
1668416250700,ECE 212BN,A00,103646,Ng; Tse Nga,0,0,0,0
1668416251123,ECE 221,A00,111493,Staff,0,0,0,0
1668416251555,ECE 222B,A00,103647,Lomakin; Vitaliy,0,4,0,0
1668416251999,ECE 230B,A00,103648,Taur; Yuan,0,0,0,0
1668416252440,ECE 238B,A00,103649,Garay; Javier,0,0,0,0
1668416252876,ECE 240B,A00,112900,Fainman; Yeshaiahu,0,3,0,0
1668416253302,ECE 247A,A00,103650,Jokerst; Jesse Vincent,0,1,0,0
1668416253729,ECE 247B,A00,103651,Wang; Joseph,0,3,0,0
1668416254247,ECE 250,A00,103652,Siegel; Paul H.,0,40,0,0
1668416254672,ECE 251A,A00,103654,Rao; Bhaskar D.,0,28,0,0
1668416255098,ECE 257B,A00,103655,Bharadia; Dinesh,0,11,0,0
1668416255521,ECE 258A,A00,103656,Milstein; Laurence B.,0,10,0,0
1668416255947,ECE 260B,A00,103658,Kang; Mingu,0,62,0,0
1668416256382,ECE 264A,A00,103659,Galton; Ian A,0,29,0,0
1668416256806,ECE 265A,A00,103661,Gudem; Prasad S.S.,0,14,0,0
1668416257234,ECE 265D,A00,103662,Gudem; Prasad S.S.,0,9,0,0
1668416257658,ECE 268,A00,103663,Koushanfar; Farinaz,0,18,0,0
1668416258081,ECE 269,A01,103665,Pal; Piya,0,118,0,0
1668416258505,ECE 271B,A00,103666,Vasconcelos; Manuela,0,44,0,0
1668416258928,ECE 276A,A00,103667,Atanasov; Nikolay A.,0,58,0,0
1668416259352,ECE 277,A00,103668,An; Cheolhong,0,82,0,0
1668416259780,ECE 279,A00,117947,Hall; Drew A.,0,10,0,0
1668416260631,ECE 283,A00,103670,Hsueh; Tzu-Chien,0,20,0,0
1668416261057,ECE 284,A00,103671,Turakhia; Yatish Girish,0,22,0,0
1668416261481,ECE 285,A00,103672,Zheng; Yang,0,20,0,0
1668416261481,ECE 285,B00,103673,Sworder; David D.,0,36,0,0
1668416261907,ECE 287,A00,103676,Javidi; Tara,0,4,0,0
1668416262331,MATH 200B,A00,098023,Salehi Golsefidy; Alireza,12,0,15,3
1668416262755,MATH 202B,A00,098024,Rhoades; Brendon Patrick,9,0,15,6
1668416263178,MATH 203B,A00,098025,Oprea; Dragos N.,10,0,15,5
1668416263604,MATH 204B,A00,098026,Sorensen; Claus M,13,0,15,2
1668416264030,MATH 208,A00,098027,Izadi; Elham,7,0,10,3
1668416264460,MATH 209,A00,098028,Pollack; Aaron,10,0,10,0
1668416264886,MATH 211A,A00,112919,Rogalski; Daniel,9,0,10,1
1668416265312,MATH 211B,A00,112920,Seward; Brandon M.,9,0,10,1
1668416265736,MATH 218,A00,098029,Li; Bo,10,0,10,0
1668416266164,MATH 220B,A00,098030,Novak; Jonathan I,11,0,15,4
1668416266591,MATH 221A,A00,098031,Ebenfelt; Peter F,13,0,15,2
1668416267018,MATH 231B,A00,098032,Zlatos; Andrej,12,0,15,3
1668416267444,MATH 240B,A00,098033,Ni; Lei,9,0,15,6
1668416267876,MATH 243,A00,098034,Jekel; David Andrew,10,0,10,0
1668416268317,MATH 245A,A00,098035,Nie; Jiawang,0,0,15,16
1668416268740,MATH 248,A00,098036,Bejenaru; Ioan,10,0,10,0
1668416269164,MATH 250B,A00,098037,Spolaor; Luca,14,0,15,1
1668416269603,MATH 258,A00,098038,Ni; Lei,10,0,10,0
1668416270025,MATH 264B,A00,098041,Rhoades; Brendon Patrick,9,0,15,6
1668416270454,MATH 268,A00,098042,Buss; Samuel R,10,0,10,0
1668416270879,MATH 269,A00,098043,Rhoades; Brendon Patrick,10,0,10,0
1668416271313,MATH 270B,A00,098044,Li; Bo,10,0,15,5
1668416271739,MATH 272B,A00,098045,Holst; Michael J,13,0,15,2
1668416272164,MATH 273A,A00,098046,Tian; Xiaochuan,10,0,15,5
1668416272588,MATH 275,A01,098048,Tian; Xiaochuan,6,0,10,4
1668416273013,MATH 278A,A00,098049,Holst; Michael J,8,0,10,2
1668416273440,MATH 278B,A00,098050,Cloninger; Alexander,10,0,10,0
1668416273866,MATH 278C,A00,098051,Nie; Jiawang,6,0,10,4
1668416274296,MATH 280B,A00,098052,Zheng; Tianyi,8,0,15,7
1668416274724,MATH 281B,A00,098053,Bradic; Jelena,0,1,15,15
1668416275147,MATH 282B,A00,098054,Arias-Castro; Ery,0,0,15,15
1668416275575,MATH 285,A00,098055,Fitzsimmons; Patrick J,0,0,15,17
1668416276002,MATH 287B,A00,098056,Arias-Castro; Ery,2,0,15,13
1668416276448,MATH 288,A00,098057,Agarwal; Pooja,9,0,10,1
1668416276448,MATH 288,B00,098058,Zhang; Danna,8,0,10,2
1668416276448,MATH 288,C00,098059,Williams; Ruth J,9,0,10,1
1668416276879,MATH 290B,A00,098060,Roberts; Justin Deritter,13,0,15,2
1668416277317,MATH 292,A00,098061,Belmont; Eva Kinoshita,10,0,10,0
1668416277746,MATH 295,A00,098062,Suk; Andrew Hoon,48,0,50,2
1668416278176,MATH 296,A00,098063,Novak; Jonathan I,20,0,20,0
1668416278609,MATH 297,001,098064,Gamst; Anthony Collins,9997,0,9999,2
1668416779617,COGS 205,A00,101395,Chiba; Andrea,19,0,20,1
1668416780061,COGS 210B,001,101404,Greene; Deanna Jacquelyn,9998,0,9999,1
1668416780061,COGS 210B,002,101417,Xia; Haijun,9999,0,9999,0
1668416780061,COGS 210B,003,101422,Nitz; Douglas A.,9999,0,9999,0
1668416780061,COGS 210B,004,101423,Hollan; James D.,9998,0,9999,1
1668416780061,COGS 210B,005,101424,Deak; Gedeon O.,9998,0,9999,1
1668416780061,COGS 210B,006,101425,Rossano; Federico,9999,0,9999,0
1668416780486,COGS 211B,A00,101427,Coulson; Seana M,9996,0,9999,3
1668416780909,COGS 220,A00,101428,Hollan; James D.,1,2,25,24
1668416781333,COGS 229,A00,101429,Dow; Steven P,18,0,25,7
1668416781764,COGS 230,A00,101430,Klemmer; Scott R,11,0,17,6
1668416782197,COGS 234,A00,101431,Xia; Haijun,2,0,25,23
1668416782629,COGS 260,A00,101432,Kiyonaga; Anastasia,21,0,25,4
1668416782629,COGS 260,B00,101433,Kirsh; David Joel,15,0,25,10
1668416783053,CSE 202,A00,102371,Impagliazzo; Russell,0,28,0,0
1668416783482,CSE 203B,A01,102373,Cheng; Chung Kuan,0,23,0,0
1668416783908,CSE 208,A00,102374,Micciancio; Daniele,0,1,0,0
1668416784336,CSE 209A,A00,112895,Impagliazzo; Russell,0,3,15,15
1668416784759,CSE 209B,A00,108005,Bellare; Mihir,0,2,0,0
1668416785185,CSE 210,A00,113163,Coblenz; Michael J,0,39,0,0
1668416785624,CSE 219,A00,106111,Dow; Steven P,0,0,20,20
1668416786052,CSE 221,A00,102376,Voelker; Geoffrey M.,0,25,0,0
1668416786476,CSE 224,A01,102378,Porter; George M,0,96,0,0
1668416786900,CSE 229A,A00,102379,Savage; Stefan,0,4,0,0
1668416787327,CSE 229C,A00,102380,Munyaka; Imani N. S.,0,4,0,0
1668416787750,CSE 232B,A00,102382,Deutsch; Alin Bernard,0,11,0,0
1668416788184,CSE 234,A01,112904,Kumar; Arun Kumar,0,0,0,0
1668416788611,CSE 237A,A00,102383,Rosing; Tajana Simunic,0,22,0,0
1668416789036,CSE 239A,A00,102384,Deutsch; Alin Bernard,0,5,0,0
1668416789470,CSE 239B,A00,102385,Polikarpova; Nadezhda,0,3,0,0
1668416789904,CSE 240A,A00,102386,Pannuto; Patrick William,0,21,0,0
1668416790334,CSE 240B,A00,102387,Zhao; Jishen,0,20,0,0
1668416790774,CSE 241A,A00,106406,Kang; Mingu,0,1,0,0
1668416791202,CSE 249B,A00,102388,Kahng; Andrew Byun,0,1,8,8
1668416791626,CSE 251B,A01,102392,Cottrell; Garrison W,0,20,0,0
1668416791626,CSE 251B,A02,102393,Cottrell; Garrison W,0,21,0,0
1668416792054,CSE 252B,A00,102394,Ochoa; Benjamin Lawrence,0,33,0,0
1668416792477,CSE 257,A01,102396,Gao; Sicun,0,79,0,0
1668416792909,CSE 272,A00,102397,Li; Tzumao,0,6,0,0
1668416793346,CSE 274,A00,111323,Chern; Albert Ren-Haur,0,7,0,0
1668416793774,CSE 282,A00,102398,Pevzner; Pavel Arkadjevich,0,0,0,0
1668416794197,CSE 284,A00,114175,Gymrek; Melissa Ann,0,9,0,0
1668416794622,CSE 290,A00,102399,Chandraker; Manmohan Krishna,0,3,0,0
1668416794622,CSE 290,B00,102400,Vaccaro; Kristen Marie,0,1,25,25
1668416794622,CSE 290,C00,102414,Pannuto; Patrick William,0,1,25,25
1668416794622,CSE 290,D00,102427,Pevzner; Pavel Arkadjevich,0,0,0,0
1668416794622,CSE 290,E00,102429,Zhao; Jishen,0,1,0,0
1668416794622,CSE 290,F00,102436,Tullsen; Dean Michael,0,2,0,0
1668416794622,CSE 290,G00,102440,Christensen; Henrik I,0,3,20,20
1668416795047,CSE 291,A00,102443,Su; Hao,0,0,0,0
1668416795047,CSE 291,B00,102448,Polikarpova; Nadezhda,0,0,0,0
1668416795047,CSE 291,C00,102453,Vaccaro; Kristen Marie,0,0,0,0
1668416795047,CSE 291,D00,111343,Savage; Stefan,0,0,0,0
1668416795047,CSE 291,E00,116474,Claffy; Kimberly Claire,0,0,0,0
1668416795047,CSE 291,F00,116479,Pasquale; Joseph,0,0,0,0
1668416795475,CSE 293,001,119111,Bafna; Vineet,9999,0,9999,0
1668416795475,CSE 293,002,119118,Bellare; Mihir,9999,0,9999,0
1668416795475,CSE 293,003,119122,Berg-Kirkpatrick; Taylor D,9999,0,9999,0
1668416795475,CSE 293,004,119135,Christensen; Henrik I,9999,0,9999,0
1668416795475,CSE 293,005,119142,Cottrell; Garrison W,9999,0,9999,0
1668416795475,CSE 293,006,119146,Deutsch; Alin Bernard,9999,0,9999,0
1668416795475,CSE 293,007,119159,Esmaeilzadeh; Hadi,9999,0,9999,0
1668416795475,CSE 293,008,119166,Freund; Yoav,9999,0,9999,0
1668416795475,CSE 293,009,119170,Griswold; William G.,9999,0,9999,0
1668416795475,CSE 293,010,119183,Gymrek; Melissa Ann,9999,0,9999,0
1668416795475,CSE 293,011,119190,Heninger; Nadia A,9999,0,9999,0
1668416795475,CSE 293,012,119230,Impagliazzo; Russell,9999,0,9999,0
1668416795475,CSE 293,013,119232,Jhala; Ranjit,9999,0,9999,0
1668416795475,CSE 293,014,119233,Kahng; Andrew Byun,9999,0,9999,0
1668416795475,CSE 293,015,119298,Kane; Daniel Mertz,9999,0,9999,0
1668416795475,CSE 293,016,119299,Kriegman; David J,9999,0,9999,0
1668416795475,CSE 293,017,119300,Kumar; Arun Kumar,9999,0,9999,0
1668416795475,CSE 293,018,119301,Lerner; Sorin,9999,0,9999,0
1668416795475,CSE 293,019,119302,Lovett; Shachar,9999,0,9999,0
1668416795475,CSE 293,020,119303,McAuley; Julian John,9999,0,9999,0
1668416795475,CSE 293,021,119304,Micciancio; Daniele,9999,0,9999,0
1668416795475,CSE 293,022,119367,Orailoglu; Alex,9999,0,9999,0
1668416795475,CSE 293,023,119382,Paturi; Ramamohan,9999,0,9999,0
1668416795475,CSE 293,024,119404,Polikarpova; Nadezhda,9999,0,9999,0
1668416795475,CSE 293,025,119406,Politz; Joseph Gibbs,9999,0,9999,0
1668416795475,CSE 293,026,119411,Porter; George M,9999,0,9999,0
1668416795475,CSE 293,027,119414,Porter; Leonard Emerson,9999,0,9999,0
1668416795475,CSE 293,028,119416,Ramamoorthi; Ravi,9999,0,9999,0
1668416795475,CSE 293,029,119417,Sahoo; Debashis,9999,0,9999,0
1668416795475,CSE 293,030,119420,Saul; Lawrence,9999,0,9999,0
1668416795475,CSE 293,031,119421,Savage; Stefan,9999,0,9999,0
1668416795475,CSE 293,032,119425,Schulze; Jurgen P.,9999,0,9999,0
1668416795475,CSE 293,033,119426,Snoeren; Alex C.,9999,0,9999,0
1668416795475,CSE 293,034,119428,Shang; Jingbo,9999,0,9999,0
1668416795475,CSE 293,035,119430,Stefan; Deian,9999,0,9999,0
1668416795475,CSE 293,036,119431,Su; Hao,9999,0,9999,0
1668416795475,CSE 293,037,119433,Swanson; Steven James,9999,0,9999,0
1668416795475,CSE 293,038,119435,Tullsen; Dean Michael,9999,0,9999,0
1668416795475,CSE 293,039,119483,Voelker; Geoffrey M.,9999,0,9999,0
1668416795475,CSE 293,040,119537,Zhao; Jishen,9999,0,9999,0
1668416795475,CSE 293,041,119538,Zhou; Yuan-Yuan,9999,0,9999,0
1668416795475,CSE 293,042,119539,Gao; Sicun,9999,0,9999,0
1668416795475,CSE 293,043,119540,Weibel; Nadir,9999,0,9999,0
1668416795475,CSE 293,044,119541,Gupta; Rajesh K.,9999,0,9999,0
1668416795475,CSE 293,045,126410,Vaccaro; Kristen Marie,9999,0,9999,0
1668416795475,CSE 293,046,126411,Klemke; Richard,9999,0,9999,0
1668416795900,CSE 294,A00,102459,Voelker; Geoffrey M.,0,1,0,0
1668416795900,CSE 294,B00,111322,Orailoglu; Alex,0,0,0,0
1668416796324,DSE 201,A00,096914,Deutsch; Alin Bernard,30,0,30,0
1668416796750,DSE 210,A00,096915,Dasgupta; Sanjoy,30,0,30,0
1668416797174,DSE 260A,A00,096916,Altintas De Callaf; Ilkay,30,0,30,0
1668416797629,ECE 200,001,103586,Antipa; Nicholas A,9999,0,9999,0
1668416797629,ECE 200,002,103587,Atanasov; Nikolay A.,9999,0,9999,0
1668416797629,ECE 200,003,103588,Bharadia; Dinesh,9999,0,9999,0
1668416797629,ECE 200,004,103589,Cheng; Chung Kuan,9999,0,9999,0
1668416797629,ECE 200,005,103590,Cosman; Pamela C.,9999,0,9999,0
1668416797629,ECE 200,006,103591,Dayeh; Shadi Ahmad,9999,0,9999,0
1668416797629,ECE 200,007,103592,Fainman; Yeshaiahu,9999,0,9999,0
1668416797629,ECE 200,008,103593,Ford; Joseph Earl,9999,0,9999,0
1668416797629,ECE 200,009,103594,Franceschetti; Massimo,9999,0,9999,0
1668416797629,ECE 200,010,103595,Fullerton; Eric E,9999,0,9999,0
1668416797629,ECE 200,011,103596,Galton; Ian A,9999,0,9999,0
1668416797629,ECE 200,012,103597,Gilja; Vikash,9999,0,9999,0
1668416797629,ECE 200,013,103598,Hall; Drew A.,9999,0,9999,0
1668416797629,ECE 200,014,103599,Hsueh; Tzu-Chien,9999,0,9999,0
1668416797629,ECE 200,015,103600,Javidi; Tara,9999,0,9999,0
1668416797629,ECE 200,016,103601,Kahng; Andrew Byun,9999,0,9999,0
1668416797629,ECE 200,017,103602,Kim; Young-Han,9999,0,9999,0
1668416797629,ECE 200,018,103603,Koushanfar; Farinaz,9999,0,9999,0
1668416797629,ECE 200,019,103604,Kuzum; Duygu,9999,0,9999,0
1668416797629,ECE 200,020,103605,Le; Hanh-Phuc,9999,0,9999,0
1668416797629,ECE 200,021,103606,Lin; Bill,9999,0,9999,0
1668416797629,ECE 200,022,103607,Liu; Zhaowei,9998,0,9999,1
1668416797629,ECE 200,023,103608,Lo; Yu-Hwa,9999,0,9999,0
1668416797629,ECE 200,024,103609,Lomakin; Vitaliy,9999,0,9999,0
1668416797629,ECE 200,025,103610,Mercier; Patrick Philip,9999,0,9999,0
1668416797629,ECE 200,026,103611,Meyer; Florian,9999,0,9999,0
1668416797629,ECE 200,027,103612,Milstein; Laurence B.,9999,0,9999,0
1668416797629,ECE 200,028,103613,Mir Arabbaygi; Siavash,9999,0,9999,0
1668416797629,ECE 200,029,103614,Mookherjea; Shayan,9999,0,9999,0
1668416797629,ECE 200,030,103615,Morris; Karcher William,9999,0,9999,0
1668416797629,ECE 200,031,103616,Ng; Tse Nga,9999,0,9999,0
1668416797629,ECE 200,032,103617,Nguyen; Truong Quang,9999,0,9999,0
1668416797629,ECE 200,033,103618,Nomura; Kenji,9999,0,9999,0
1668416797629,ECE 200,034,103619,Orlitsky; Alon,9999,0,9999,0
1668416797629,ECE 200,035,103620,Pal; Piya,9999,0,9999,0
1668416797629,ECE 200,036,103621,Papen; George C.,9999,0,9999,0
1668416797629,ECE 200,037,103622,Radic; Stojan,9999,0,9999,0
1668416797629,ECE 200,038,103623,Rao; Bhaskar D.,9999,0,9999,0
1668416797629,ECE 200,039,103624,Rao; Ramesh R,9999,0,9999,0
1668416797629,ECE 200,040,103625,Rebeiz; Gabriel,9999,0,9999,0
1668416797629,ECE 200,041,103626,Sanford; John R,9999,0,9999,0
1668416797629,ECE 200,042,103627,Siegel; Paul H.,9999,0,9999,0
1668416797629,ECE 200,043,103628,Sievenpiper; Daniel F.,9999,0,9999,0
1668416797629,ECE 200,044,103629,Sworder; David D.,9999,0,9999,0
1668416797629,ECE 200,045,103630,Taur; Yuan,9999,0,9999,0
1668416797629,ECE 200,046,103631,Touri; Behrouz,9999,0,9999,0
1668416797629,ECE 200,047,103632,Trivedi; Mohan M.,9999,0,9999,0
1668416797629,ECE 200,048,103633,Vasconcelos; Nuno,9999,0,9999,0
1668416797629,ECE 200,049,103634,Wang; Xiaolong,9999,0,9999,0
1668416797629,ECE 200,050,103635,Xie; Pengtao,9999,0,9999,0
1668416797629,ECE 200,051,103636,Yip; Michael,9999,0,9999,0
1668416797629,ECE 200,052,103637,Zeger; Kenneth A.,999,0,999,0
1668416797629,ECE 200,053,103638,Zhang; Xinyu,9999,0,9999,0
1668416797629,ECE 200,054,103639,Turakhia; Yatish Girish,9999,0,9999,0
1668416797629,ECE 200,055,103640,Kang; Mingu,9999,0,9999,0
1668416797629,ECE 200,056,103641,Shi; Yuanyuan,9999,0,9999,0
1668416797629,ECE 200,057,103642,Wang; Edward Jay,9999,0,9999,0
1668416797629,ECE 200,058,103643,Zheng; Yang,9999,0,9999,0
1668416798053,ECE 202,A00,103644,Kuzum; Duygu,0,20,0,0
1668416798480,ECE 212BN,A00,103646,Ng; Tse Nga,0,1,0,0
1668416798908,ECE 221,A00,111493,Staff,0,0,0,0
1668416799333,ECE 222B,A00,103647,Lomakin; Vitaliy,0,4,0,0
1668416799757,ECE 230B,A00,103648,Taur; Yuan,0,0,0,0
1668416800183,ECE 238B,A00,103649,Garay; Javier,0,0,0,0
1668416800606,ECE 240B,A00,112900,Fainman; Yeshaiahu,0,4,0,0
1668416801030,ECE 247A,A00,103650,Jokerst; Jesse Vincent,0,1,0,0
1668416801464,ECE 247B,A00,103651,Wang; Joseph,0,3,0,0
1668416801887,ECE 250,A00,103652,Siegel; Paul H.,0,41,0,0
1668416802318,ECE 251A,A00,103654,Rao; Bhaskar D.,0,28,0,0
1668416802744,ECE 257B,A00,103655,Bharadia; Dinesh,0,11,0,0
1668416803169,ECE 258A,A00,103656,Milstein; Laurence B.,0,10,0,0
1668416803593,ECE 260B,A00,103658,Kang; Mingu,0,63,0,0
1668416804017,ECE 264A,A00,103659,Galton; Ian A,0,30,0,0
1668416804441,ECE 265A,A00,103661,Gudem; Prasad S.S.,0,14,0,0
1668416804874,ECE 265D,A00,103662,Gudem; Prasad S.S.,0,9,0,0
1668416805300,ECE 268,A00,103663,Koushanfar; Farinaz,0,18,0,0
1668416805727,ECE 269,A01,103665,Pal; Piya,0,118,0,0
1668416806151,ECE 271B,A00,103666,Vasconcelos; Manuela,0,44,0,0
1668416806576,ECE 276A,A00,103667,Atanasov; Nikolay A.,0,59,0,0
1668416806999,ECE 277,A00,103668,An; Cheolhong,0,82,0,0
1668416807428,ECE 279,A00,117947,Hall; Drew A.,0,10,0,0
1668416808277,ECE 283,A00,103670,Hsueh; Tzu-Chien,0,20,0,0
1668416808711,ECE 284,A00,103671,Turakhia; Yatish Girish,0,22,0,0
1668416809135,ECE 285,A00,103672,Zheng; Yang,0,21,0,0
1668416809135,ECE 285,B00,103673,Sworder; David D.,0,36,0,0
1668416809559,ECE 287,A00,103676,Javidi; Tara,0,4,0,0
1668416809988,MATH 200B,A00,098023,Salehi Golsefidy; Alireza,12,0,15,3
1668416810414,MATH 202B,A00,098024,Rhoades; Brendon Patrick,9,0,15,6
1668416810837,MATH 203B,A00,098025,Oprea; Dragos N.,10,0,15,5
1668416811262,MATH 204B,A00,098026,Sorensen; Claus M,13,0,15,2
1668416811686,MATH 208,A00,098027,Izadi; Elham,7,0,10,3
1668416812120,MATH 209,A00,098028,Pollack; Aaron,10,0,10,0
1668416812550,MATH 211A,A00,112919,Rogalski; Daniel,9,0,10,1
1668416812974,MATH 211B,A00,112920,Seward; Brandon M.,9,0,10,1
1668416813399,MATH 218,A00,098029,Li; Bo,10,0,10,0
1668416813824,MATH 220B,A00,098030,Novak; Jonathan I,11,0,15,4
1668416814247,MATH 221A,A00,098031,Ebenfelt; Peter F,13,0,15,2
1668416814674,MATH 231B,A00,098032,Zlatos; Andrej,12,0,15,3
1668416815099,MATH 240B,A00,098033,Ni; Lei,9,0,15,6
1668416815527,MATH 243,A00,098034,Jekel; David Andrew,10,0,10,0
1668416815952,MATH 245A,A00,098035,Nie; Jiawang,0,1,15,16
1668416816377,MATH 248,A00,098036,Bejenaru; Ioan,10,0,10,0
1668416816799,MATH 250B,A00,098037,Spolaor; Luca,14,0,15,1
1668416817227,MATH 258,A00,098038,Ni; Lei,10,0,10,0
1668416817651,MATH 264B,A00,098041,Rhoades; Brendon Patrick,9,0,15,6
1668416818076,MATH 268,A00,098042,Buss; Samuel R,10,0,10,0
1668416818579,MATH 269,A00,098043,Rhoades; Brendon Patrick,10,0,10,0
1668416819008,MATH 270B,A00,098044,Li; Bo,10,0,15,5
1668416819439,MATH 272B,A00,098045,Holst; Michael J,13,0,15,2
1668416819864,MATH 273A,A00,098046,Tian; Xiaochuan,10,0,15,5
1668416820318,MATH 275,A01,098048,Tian; Xiaochuan,6,0,10,4
1668416820741,MATH 278A,A00,098049,Holst; Michael J,8,0,10,2
1668416821164,MATH 278B,A00,098050,Cloninger; Alexander,10,0,10,0
1668416821599,MATH 278C,A00,098051,Nie; Jiawang,6,0,10,4
1668416822023,MATH 280B,A00,098052,Zheng; Tianyi,8,0,15,7
1668416822452,MATH 281B,A00,098053,Bradic; Jelena,0,1,15,15
1668416822878,MATH 282B,A00,098054,Arias-Castro; Ery,0,0,15,15
1668416823304,MATH 285,A00,098055,Fitzsimmons; Patrick J,0,0,15,17
1668416823731,MATH 287B,A00,098056,Arias-Castro; Ery,2,0,15,13
1668416824162,MATH 288,A00,098057,Agarwal; Pooja,9,0,10,1
1668416824162,MATH 288,B00,098058,Zhang; Danna,8,0,10,2
1668416824162,MATH 288,C00,098059,Williams; Ruth J,9,0,10,1
1668416824587,MATH 290B,A00,098060,Roberts; Justin Deritter,13,0,15,2
1668416825010,MATH 292,A00,098061,Belmont; Eva Kinoshita,10,0,10,0
1668416825436,MATH 295,A00,098062,Suk; Andrew Hoon,48,0,50,2
1668416825867,MATH 296,A00,098063,Novak; Jonathan I,20,0,20,0
1668416826292,MATH 297,001,098064,Gamst; Anthony Collins,9997,0,9999,2
1668417332777,COGS 205,A00,101395,Chiba; Andrea,19,0,20,1
1668417333208,COGS 210B,001,101404,Greene; Deanna Jacquelyn,9998,0,9999,1
1668417333208,COGS 210B,002,101417,Xia; Haijun,9999,0,9999,0
1668417333208,COGS 210B,003,101422,Nitz; Douglas A.,9999,0,9999,0
1668417333208,COGS 210B,004,101423,Hollan; James D.,9998,0,9999,1
1668417333208,COGS 210B,005,101424,Deak; Gedeon O.,9998,0,9999,1
1668417333208,COGS 210B,006,101425,Rossano; Federico,9999,0,9999,0
1668417333633,COGS 211B,A00,101427,Coulson; Seana M,9996,0,9999,3
1668417334061,COGS 220,A00,101428,Hollan; James D.,1,2,25,24
1668417334499,COGS 229,A00,101429,Dow; Steven P,18,0,25,7
1668417334928,COGS 230,A00,101430,Klemmer; Scott R,11,0,17,6
1668417335365,COGS 234,A00,101431,Xia; Haijun,2,0,25,23
1668417335796,COGS 260,A00,101432,Kiyonaga; Anastasia,21,0,25,4
1668417335796,COGS 260,B00,101433,Kirsh; David Joel,15,0,25,10
1668417336222,CSE 202,A00,102371,Impagliazzo; Russell,0,28,0,0
1668417336647,CSE 203B,A01,102373,Cheng; Chung Kuan,0,23,0,0
1668417337073,CSE 208,A00,102374,Micciancio; Daniele,0,1,0,0
1668417337499,CSE 209A,A00,112895,Impagliazzo; Russell,0,3,15,15
1668417337932,CSE 209B,A00,108005,Bellare; Mihir,0,2,0,0
1668417338361,CSE 210,A00,113163,Coblenz; Michael J,0,40,0,0
1668417338788,CSE 219,A00,106111,Dow; Steven P,0,0,20,20
1668417339214,CSE 221,A00,102376,Voelker; Geoffrey M.,0,27,0,0
1668417339639,CSE 224,A01,102378,Porter; George M,0,98,0,0
1668417340069,CSE 229A,A00,102379,Savage; Stefan,0,4,0,0
1668417340496,CSE 229C,A00,102380,Munyaka; Imani N. S.,0,4,0,0
1668417340922,CSE 232B,A00,102382,Deutsch; Alin Bernard,0,12,0,0
1668417341346,CSE 234,A01,112904,Kumar; Arun Kumar,0,0,0,0
1668417341770,CSE 237A,A00,102383,Rosing; Tajana Simunic,0,24,0,0
1668417342196,CSE 239A,A00,102384,Deutsch; Alin Bernard,0,5,0,0
1668417342620,CSE 239B,A00,102385,Polikarpova; Nadezhda,0,3,0,0
1668417343053,CSE 240A,A00,102386,Pannuto; Patrick William,0,22,0,0
1668417343477,CSE 240B,A00,102387,Zhao; Jishen,0,21,0,0
1668417343907,CSE 241A,A00,106406,Kang; Mingu,0,1,0,0
1668417344335,CSE 249B,A00,102388,Kahng; Andrew Byun,0,1,8,8
1668417344767,CSE 251B,A01,102392,Cottrell; Garrison W,0,21,0,0
1668417344767,CSE 251B,A02,102393,Cottrell; Garrison W,0,21,0,0
1668417345281,CSE 252B,A00,102394,Ochoa; Benjamin Lawrence,0,33,0,0
1668417345717,CSE 257,A01,102396,Gao; Sicun,0,82,0,0
1668417346147,CSE 272,A00,102397,Li; Tzumao,0,6,0,0
1668417346577,CSE 274,A00,111323,Chern; Albert Ren-Haur,0,7,0,0
1668417347002,CSE 282,A00,102398,Pevzner; Pavel Arkadjevich,0,0,0,0
1668417347427,CSE 284,A00,114175,Gymrek; Melissa Ann,0,9,0,0
1668417347882,CSE 290,A00,102399,Chandraker; Manmohan Krishna,0,3,0,0
1668417347882,CSE 290,B00,102400,Vaccaro; Kristen Marie,0,1,25,25
1668417347882,CSE 290,C00,102414,Pannuto; Patrick William,0,1,25,25
1668417347882,CSE 290,D00,102427,Pevzner; Pavel Arkadjevich,0,0,0,0
1668417347882,CSE 290,E00,102429,Zhao; Jishen,0,1,0,0
1668417347882,CSE 290,F00,102436,Tullsen; Dean Michael,0,2,0,0
1668417347882,CSE 290,G00,102440,Christensen; Henrik I,0,3,20,20
1668417348309,CSE 291,A00,102443,Su; Hao,0,0,0,0
1668417348309,CSE 291,B00,102448,Polikarpova; Nadezhda,0,0,0,0
1668417348309,CSE 291,C00,102453,Vaccaro; Kristen Marie,0,0,0,0
1668417348309,CSE 291,D00,111343,Savage; Stefan,0,0,0,0
1668417348309,CSE 291,E00,116474,Claffy; Kimberly Claire,0,0,0,0
1668417348309,CSE 291,F00,116479,Pasquale; Joseph,0,0,0,0
1668417348780,CSE 293,001,119111,Bafna; Vineet,9999,0,9999,0
1668417348780,CSE 293,002,119118,Bellare; Mihir,9999,0,9999,0
1668417348780,CSE 293,003,119122,Berg-Kirkpatrick; Taylor D,9999,0,9999,0
1668417348780,CSE 293,004,119135,Christensen; Henrik I,9999,0,9999,0
1668417348780,CSE 293,005,119142,Cottrell; Garrison W,9999,0,9999,0
1668417348780,CSE 293,006,119146,Deutsch; Alin Bernard,9999,0,9999,0
1668417348780,CSE 293,007,119159,Esmaeilzadeh; Hadi,9999,0,9999,0
1668417348780,CSE 293,008,119166,Freund; Yoav,9999,0,9999,0
1668417348780,CSE 293,009,119170,Griswold; William G.,9999,0,9999,0
1668417348780,CSE 293,010,119183,Gymrek; Melissa Ann,9999,0,9999,0
1668417348780,CSE 293,011,119190,Heninger; Nadia A,9999,0,9999,0
1668417348780,CSE 293,012,119230,Impagliazzo; Russell,9999,0,9999,0
1668417348780,CSE 293,013,119232,Jhala; Ranjit,9999,0,9999,0
1668417348780,CSE 293,014,119233,Kahng; Andrew Byun,9999,0,9999,0
1668417348780,CSE 293,015,119298,Kane; Daniel Mertz,9999,0,9999,0
1668417348780,CSE 293,016,119299,Kriegman; David J,9999,0,9999,0
1668417348780,CSE 293,017,119300,Kumar; Arun Kumar,9999,0,9999,0
1668417348780,CSE 293,018,119301,Lerner; Sorin,9999,0,9999,0
1668417348780,CSE 293,019,119302,Lovett; Shachar,9999,0,9999,0
1668417348780,CSE 293,020,119303,McAuley; Julian John,9999,0,9999,0
1668417348780,CSE 293,021,119304,Micciancio; Daniele,9999,0,9999,0
1668417348780,CSE 293,022,119367,Orailoglu; Alex,9999,0,9999,0
1668417348780,CSE 293,023,119382,Paturi; Ramamohan,9999,0,9999,0
1668417348780,CSE 293,024,119404,Polikarpova; Nadezhda,9999,0,9999,0
1668417348780,CSE 293,025,119406,Politz; Joseph Gibbs,9999,0,9999,0
1668417348780,CSE 293,026,119411,Porter; George M,9999,0,9999,0
1668417348780,CSE 293,027,119414,Porter; Leonard Emerson,9999,0,9999,0
1668417348780,CSE 293,028,119416,Ramamoorthi; Ravi,9999,0,9999,0
1668417348780,CSE 293,029,119417,Sahoo; Debashis,9999,0,9999,0
1668417348780,CSE 293,030,119420,Saul; Lawrence,9999,0,9999,0
1668417348780,CSE 293,031,119421,Savage; Stefan,9999,0,9999,0
1668417348780,CSE 293,032,119425,Schulze; Jurgen P.,9999,0,9999,0
1668417348780,CSE 293,033,119426,Snoeren; Alex C.,9999,0,9999,0
1668417348780,CSE 293,034,119428,Shang; Jingbo,9999,0,9999,0
1668417348780,CSE 293,035,119430,Stefan; Deian,9999,0,9999,0
1668417348780,CSE 293,036,119431,Su; Hao,9999,0,9999,0
1668417348780,CSE 293,037,119433,Swanson; Steven James,9999,0,9999,0
1668417348780,CSE 293,038,119435,Tullsen; Dean Michael,9999,0,9999,0
1668417348780,CSE 293,039,119483,Voelker; Geoffrey M.,9999,0,9999,0
1668417348780,CSE 293,040,119537,Zhao; Jishen,9999,0,9999,0
1668417348780,CSE 293,041,119538,Zhou; Yuan-Yuan,9999,0,9999,0
1668417348780,CSE 293,042,119539,Gao; Sicun,9999,0,9999,0
1668417348780,CSE 293,043,119540,Weibel; Nadir,9999,0,9999,0
1668417348780,CSE 293,044,119541,Gupta; Rajesh K.,9999,0,9999,0
1668417348780,CSE 293,045,126410,Vaccaro; Kristen Marie,9999,0,9999,0
1668417348780,CSE 293,046,126411,Klemke; Richard,9999,0,9999,0
1668417349211,CSE 294,A00,102459,Voelker; Geoffrey M.,0,1,0,0
1668417349211,CSE 294,B00,111322,Orailoglu; Alex,0,0,0,0
1668417349643,DSE 201,A00,096914,Deutsch; Alin Bernard,30,0,30,0
1668417350068,DSE 210,A00,096915,Dasgupta; Sanjoy,30,0,30,0
1668417350497,DSE 260A,A00,096916,Altintas De Callaf; Ilkay,30,0,30,0
1668417350950,ECE 200,001,103586,Antipa; Nicholas A,9999,0,9999,0
1668417350950,ECE 200,002,103587,Atanasov; Nikolay A.,9999,0,9999,0
1668417350950,ECE 200,003,103588,Bharadia; Dinesh,9999,0,9999,0
1668417350950,ECE 200,004,103589,Cheng; Chung Kuan,9999,0,9999,0
1668417350950,ECE 200,005,103590,Cosman; Pamela C.,9999,0,9999,0
1668417350950,ECE 200,006,103591,Dayeh; Shadi Ahmad,9999,0,9999,0
1668417350950,ECE 200,007,103592,Fainman; Yeshaiahu,9999,0,9999,0
1668417350950,ECE 200,008,103593,Ford; Joseph Earl,9999,0,9999,0
1668417350950,ECE 200,009,103594,Franceschetti; Massimo,9999,0,9999,0
1668417350950,ECE 200,010,103595,Fullerton; Eric E,9999,0,9999,0
1668417350950,ECE 200,011,103596,Galton; Ian A,9999,0,9999,0
1668417350950,ECE 200,012,103597,Gilja; Vikash,9999,0,9999,0
1668417350950,ECE 200,013,103598,Hall; Drew A.,9999,0,9999,0
1668417350950,ECE 200,014,103599,Hsueh; Tzu-Chien,9999,0,9999,0
1668417350950,ECE 200,015,103600,Javidi; Tara,9999,0,9999,0
1668417350950,ECE 200,016,103601,Kahng; Andrew Byun,9999,0,9999,0
1668417350950,ECE 200,017,103602,Kim; Young-Han,9999,0,9999,0
1668417350950,ECE 200,018,103603,Koushanfar; Farinaz,9999,0,9999,0
1668417350950,ECE 200,019,103604,Kuzum; Duygu,9999,0,9999,0
1668417350950,ECE 200,020,103605,Le; Hanh-Phuc,9999,0,9999,0
1668417350950,ECE 200,021,103606,Lin; Bill,9999,0,9999,0
1668417350950,ECE 200,022,103607,Liu; Zhaowei,9998,0,9999,1
1668417350950,ECE 200,023,103608,Lo; Yu-Hwa,9999,0,9999,0
1668417350950,ECE 200,024,103609,Lomakin; Vitaliy,9999,0,9999,0
1668417350950,ECE 200,025,103610,Mercier; Patrick Philip,9999,0,9999,0
1668417350950,ECE 200,026,103611,Meyer; Florian,9999,0,9999,0
1668417350950,ECE 200,027,103612,Milstein; Laurence B.,9999,0,9999,0
1668417350950,ECE 200,028,103613,Mir Arabbaygi; Siavash,9999,0,9999,0
1668417350950,ECE 200,029,103614,Mookherjea; Shayan,9999,0,9999,0
1668417350950,ECE 200,030,103615,Morris; Karcher William,9999,0,9999,0
1668417350950,ECE 200,031,103616,Ng; Tse Nga,9999,0,9999,0
1668417350950,ECE 200,032,103617,Nguyen; Truong Quang,9999,0,9999,0
1668417350950,ECE 200,033,103618,Nomura; Kenji,9999,0,9999,0
1668417350950,ECE 200,034,103619,Orlitsky; Alon,9999,0,9999,0
1668417350950,ECE 200,035,103620,Pal; Piya,9999,0,9999,0
1668417350950,ECE 200,036,103621,Papen; George C.,9999,0,9999,0
1668417350950,ECE 200,037,103622,Radic; Stojan,9999,0,9999,0
1668417350950,ECE 200,038,103623,Rao; Bhaskar D.,9999,0,9999,0
1668417350950,ECE 200,039,103624,Rao; Ramesh R,9999,0,9999,0
1668417350950,ECE 200,040,103625,Rebeiz; Gabriel,9999,0,9999,0
1668417350950,ECE 200,041,103626,Sanford; John R,9999,0,9999,0
1668417350950,ECE 200,042,103627,Siegel; Paul H.,9999,0,9999,0
1668417350950,ECE 200,043,103628,Sievenpiper; Daniel F.,9999,0,9999,0
1668417350950,ECE 200,044,103629,Sworder; David D.,9999,0,9999,0
1668417350950,ECE 200,045,103630,Taur; Yuan,9999,0,9999,0
1668417350950,ECE 200,046,103631,Touri; Behrouz,9999,0,9999,0
1668417350950,ECE 200,047,103632,Trivedi; Mohan M.,9999,0,9999,0
1668417350950,ECE 200,048,103633,Vasconcelos; Nuno,9999,0,9999,0
1668417350950,ECE 200,049,103634,Wang; Xiaolong,9999,0,9999,0
1668417350950,ECE 200,050,103635,Xie; Pengtao,9999,0,9999,0
1668417350950,ECE 200,051,103636,Yip; Michael,9999,0,9999,0
1668417350950,ECE 200,052,103637,Zeger; Kenneth A.,999,0,999,0
1668417350950,ECE 200,053,103638,Zhang; Xinyu,9999,0,9999,0
1668417350950,ECE 200,054,103639,Turakhia; Yatish Girish,9999,0,9999,0
1668417350950,ECE 200,055,103640,Kang; Mingu,9999,0,9999,0
1668417350950,ECE 200,056,103641,Shi; Yuanyuan,9999,0,9999,0
1668417350950,ECE 200,057,103642,Wang; Edward Jay,9999,0,9999,0
1668417350950,ECE 200,058,103643,Zheng; Yang,9999,0,9999,0
1668417351383,ECE 202,A00,103644,Kuzum; Duygu,0,20,0,0
1668417351807,ECE 212BN,A00,103646,Ng; Tse Nga,0,1,0,0
1668417352239,ECE 221,A00,111493,Staff,0,0,0,0
1668417352664,ECE 222B,A00,103647,Lomakin; Vitaliy,0,5,0,0
1668417353099,ECE 230B,A00,103648,Taur; Yuan,0,0,0,0
1668417353526,ECE 238B,A00,103649,Garay; Javier,0,0,0,0
1668417353952,ECE 240B,A00,112900,Fainman; Yeshaiahu,0,4,0,0
1668417354380,ECE 247A,A00,103650,Jokerst; Jesse Vincent,0,1,0,0
1668417354805,ECE 247B,A00,103651,Wang; Joseph,0,3,0,0
1668417355236,ECE 250,A00,103652,Siegel; Paul H.,0,41,0,0
1668417355665,ECE 251A,A00,103654,Rao; Bhaskar D.,0,28,0,0
1668417356091,ECE 257B,A00,103655,Bharadia; Dinesh,0,11,0,0
1668417356527,ECE 258A,A00,103656,Milstein; Laurence B.,0,10,0,0
1668417356951,ECE 260B,A00,103658,Kang; Mingu,0,63,0,0
1668417357387,ECE 264A,A00,103659,Galton; Ian A,0,30,0,0
1668417357822,ECE 265A,A00,103661,Gudem; Prasad S.S.,0,15,0,0
1668417358246,ECE 265D,A00,103662,Gudem; Prasad S.S.,0,9,0,0
1668417358683,ECE 268,A00,103663,Koushanfar; Farinaz,0,18,0,0
1668417359125,ECE 269,A01,103665,Pal; Piya,0,118,0,0
1668417359555,ECE 271B,A00,103666,Vasconcelos; Manuela,0,44,0,0
1668417359978,ECE 276A,A00,103667,Atanasov; Nikolay A.,0,60,0,0
1668417360407,ECE 277,A00,103668,An; Cheolhong,0,84,0,0
1668417360841,ECE 279,A00,117947,Hall; Drew A.,0,10,0,0
1668417361714,ECE 283,A00,103670,Hsueh; Tzu-Chien,0,20,0,0
1668417362140,ECE 284,A00,103671,Turakhia; Yatish Girish,0,22,0,0
1668417362565,ECE 285,A00,103672,Zheng; Yang,0,21,0,0
1668417362565,ECE 285,B00,103673,Sworder; David D.,0,36,0,0
1668417362992,ECE 287,A00,103676,Javidi; Tara,0,4,0,0
1668417363432,MATH 200B,A00,098023,Salehi Golsefidy; Alireza,12,0,15,3
1668417363866,MATH 202B,A00,098024,Rhoades; Brendon Patrick,9,0,15,6
1668417364295,MATH 203B,A00,098025,Oprea; Dragos N.,10,0,15,5
1668417364724,MATH 204B,A00,098026,Sorensen; Claus M,13,0,15,2
1668417365154,MATH 208,A00,098027,Izadi; Elham,7,0,10,3
1668417365582,MATH 209,A00,098028,Pollack; Aaron,10,0,10,0
1668417366010,MATH 211A,A00,112919,Rogalski; Daniel,9,0,10,1
1668417366434,MATH 211B,A00,112920,Seward; Brandon M.,9,0,10,1
1668417366859,MATH 218,A00,098029,Li; Bo,10,0,10,0
1668417367283,MATH 220B,A00,098030,Novak; Jonathan I,11,0,15,4
1668417367719,MATH 221A,A00,098031,Ebenfelt; Peter F,13,0,15,2
1668417368144,MATH 231B,A00,098032,Zlatos; Andrej,12,0,15,3
1668417368570,MATH 240B,A00,098033,Ni; Lei,9,0,15,6
1668417368995,MATH 243,A00,098034,Jekel; David Andrew,10,0,10,0
1668417369421,MATH 245A,A00,098035,Nie; Jiawang,0,1,15,16
1668417369846,MATH 248,A00,098036,Bejenaru; Ioan,10,0,10,0
1668417370271,MATH 250B,A00,098037,Spolaor; Luca,14,0,15,1
1668417370695,MATH 258,A00,098038,Ni; Lei,10,0,10,0
1668417371123,MATH 264B,A00,098041,Rhoades; Brendon Patrick,9,0,15,6
1668417371548,MATH 268,A00,098042,Buss; Samuel R,10,0,10,0
1668417371978,MATH 269,A00,098043,Rhoades; Brendon Patrick,10,0,10,0
1668417372404,MATH 270B,A00,098044,Li; Bo,10,0,15,5
1668417372834,MATH 272B,A00,098045,Holst; Michael J,13,0,15,2
1668417373258,MATH 273A,A00,098046,Tian; Xiaochuan,10,0,15,5
1668417373684,MATH 275,A01,098048,Tian; Xiaochuan,6,0,10,4
1668417374108,MATH 278A,A00,098049,Holst; Michael J,8,0,10,2
1668417374534,MATH 278B,A00,098050,Cloninger; Alexander,10,0,10,0
1668417374958,MATH 278C,A00,098051,Nie; Jiawang,6,0,10,4
1668417375383,MATH 280B,A00,098052,Zheng; Tianyi,8,0,15,7
1668417375812,MATH 281B,A00,098053,Bradic; Jelena,0,1,15,15
1668417376235,MATH 282B,A00,098054,Arias-Castro; Ery,0,0,15,15
1668417376666,MATH 285,A00,098055,Fitzsimmons; Patrick J,0,0,15,17
1668417377090,MATH 287B,A00,098056,Arias-Castro; Ery,2,0,15,13
1668417377514,MATH 288,A00,098057,Agarwal; Pooja,9,0,10,1
1668417377514,MATH 288,B00,098058,Zhang; Danna,8,0,10,2
1668417377514,MATH 288,C00,098059,Williams; Ruth J,9,0,10,1
1668417377943,MATH 290B,A00,098060,Roberts; Justin Deritter,13,0,15,2
1668417378374,MATH 292,A00,098061,Belmont; Eva Kinoshita,10,0,10,0
1668417378798,MATH 295,A00,098062,Suk; Andrew Hoon,48,0,50,2
1668417379223,MATH 296,A00,098063,Novak; Jonathan I,20,0,20,0
1668417379649,MATH 297,001,098064,Gamst; Anthony Collins,9997,0,9999,2
1668417883827,COGS 205,A00,101395,Chiba; Andrea,19,0,20,1
1668417884259,COGS 210B,001,101404,Greene; Deanna Jacquelyn,9998,0,9999,1
1668417884259,COGS 210B,002,101417,Xia; Haijun,9999,0,9999,0
1668417884259,COGS 210B,003,101422,Nitz; Douglas A.,9999,0,9999,0
1668417884259,COGS 210B,004,101423,Hollan; James D.,9998,0,9999,1
1668417884259,COGS 210B,005,101424,Deak; Gedeon O.,9998,0,9999,1
1668417884259,COGS 210B,006,101425,Rossano; Federico,9999,0,9999,0
1668417884684,COGS 211B,A00,101427,Coulson; Seana M,9996,0,9999,3
1668417885110,COGS 220,A00,101428,Hollan; James D.,1,2,25,24
1668417885534,COGS 229,A00,101429,Dow; Steven P,18,0,25,7
1668417885965,COGS 230,A00,101430,Klemmer; Scott R,11,0,17,6
1668417886391,COGS 234,A00,101431,Xia; Haijun,2,0,25,23
1668417886829,COGS 260,A00,101432,Kiyonaga; Anastasia,21,0,25,4
1668417886829,COGS 260,B00,101433,Kirsh; David Joel,15,0,25,10
1668417887257,CSE 202,A00,102371,Impagliazzo; Russell,0,30,0,0
1668417887684,CSE 203B,A01,102373,Cheng; Chung Kuan,0,23,0,0
1668417888112,CSE 208,A00,102374,Micciancio; Daniele,0,1,0,0
1668417888540,CSE 209A,A00,112895,Impagliazzo; Russell,0,3,15,15
1668417888977,CSE 209B,A00,108005,Bellare; Mihir,0,2,0,0
1668417889405,CSE 210,A00,113163,Coblenz; Michael J,0,42,0,0
1668417889835,CSE 219,A00,106111,Dow; Steven P,0,0,20,20
1668417890264,CSE 221,A00,102376,Voelker; Geoffrey M.,0,27,0,0
1668417890698,CSE 224,A01,102378,Porter; George M,0,100,0,0
1668417891122,CSE 229A,A00,102379,Savage; Stefan,0,4,0,0
1668417891563,CSE 229C,A00,102380,Munyaka; Imani N. S.,0,4,0,0
1668417891989,CSE 232B,A00,102382,Deutsch; Alin Bernard,0,12,0,0
1668417892424,CSE 234,A01,112904,Kumar; Arun Kumar,0,0,0,0
1668417892859,CSE 237A,A00,102383,Rosing; Tajana Simunic,0,24,0,0
1668417893283,CSE 239A,A00,102384,Deutsch; Alin Bernard,0,5,0,0
1668417893710,CSE 239B,A00,102385,Polikarpova; Nadezhda,0,3,0,0
1668417894135,CSE 240A,A00,102386,Pannuto; Patrick William,0,22,0,0
1668417894581,CSE 240B,A00,102387,Zhao; Jishen,0,22,0,0
1668417895013,CSE 241A,A00,106406,Kang; Mingu,0,2,0,0
1668417895441,CSE 249B,A00,102388,Kahng; Andrew Byun,0,1,8,8
1668417895873,CSE 251B,A01,102392,Cottrell; Garrison W,0,21,0,0
1668417895873,CSE 251B,A02,102393,Cottrell; Garrison W,0,21,0,0
1668417896297,CSE 252B,A00,102394,Ochoa; Benjamin Lawrence,0,33,0,0
1668417896724,CSE 257,A01,102396,Gao; Sicun,0,82,0,0
1668417897150,CSE 272,A00,102397,Li; Tzumao,0,6,0,0
1668417897575,CSE 274,A00,111323,Chern; Albert Ren-Haur,0,7,0,0
1668417897999,CSE 282,A00,102398,Pevzner; Pavel Arkadjevich,0,0,0,0
1668417898425,CSE 284,A00,114175,Gymrek; Melissa Ann,0,9,0,0
1668417898853,CSE 290,A00,102399,Chandraker; Manmohan Krishna,0,3,0,0
1668417898853,CSE 290,B00,102400,Vaccaro; Kristen Marie,0,1,25,25
1668417898853,CSE 290,C00,102414,Pannuto; Patrick William,0,1,25,25
1668417898853,CSE 290,D00,102427,Pevzner; Pavel Arkadjevich,0,0,0,0
1668417898853,CSE 290,E00,102429,Zhao; Jishen,0,1,0,0
1668417898853,CSE 290,F00,102436,Tullsen; Dean Michael,0,2,0,0
1668417898853,CSE 290,G00,102440,Christensen; Henrik I,0,3,20,20
1668417899288,CSE 291,A00,102443,Su; Hao,0,0,0,0
1668417899288,CSE 291,B00,102448,Polikarpova; Nadezhda,0,0,0,0
1668417899288,CSE 291,C00,102453,Vaccaro; Kristen Marie,0,0,0,0
1668417899288,CSE 291,D00,111343,Savage; Stefan,0,0,0,0
1668417899288,CSE 291,E00,116474,Claffy; Kimberly Claire,0,0,0,0
1668417899288,CSE 291,F00,116479,Pasquale; Joseph,0,0,0,0
1668417899746,CSE 293,001,119111,Bafna; Vineet,9999,0,9999,0
1668417899746,CSE 293,002,119118,Bellare; Mihir,9999,0,9999,0
1668417899746,CSE 293,003,119122,Berg-Kirkpatrick; Taylor D,9999,0,9999,0
1668417899746,CSE 293,004,119135,Christensen; Henrik I,9999,0,9999,0
1668417899746,CSE 293,005,119142,Cottrell; Garrison W,9999,0,9999,0
1668417899746,CSE 293,006,119146,Deutsch; Alin Bernard,9999,0,9999,0
1668417899746,CSE 293,007,119159,Esmaeilzadeh; Hadi,9999,0,9999,0
1668417899746,CSE 293,008,119166,Freund; Yoav,9999,0,9999,0
1668417899746,CSE 293,009,119170,Griswold; William G.,9999,0,9999,0
1668417899746,CSE 293,010,119183,Gymrek; Melissa Ann,9999,0,9999,0
1668417899746,CSE 293,011,119190,Heninger; Nadia A,9999,0,9999,0
1668417899746,CSE 293,012,119230,Impagliazzo; Russell,9999,0,9999,0
1668417899746,CSE 293,013,119232,Jhala; Ranjit,9999,0,9999,0
1668417899746,CSE 293,014,119233,Kahng; Andrew Byun,9999,0,9999,0
1668417899746,CSE 293,015,119298,Kane; Daniel Mertz,9999,0,9999,0
1668417899746,CSE 293,016,119299,Kriegman; David J,9999,0,9999,0
1668417899746,CSE 293,017,119300,Kumar; Arun Kumar,9999,0,9999,0
1668417899746,CSE 293,018,119301,Lerner; Sorin,9999,0,9999,0
1668417899746,CSE 293,019,119302,Lovett; Shachar,9999,0,9999,0
1668417899746,CSE 293,020,119303,McAuley; Julian John,9999,0,9999,0
1668417899746,CSE 293,021,119304,Micciancio; Daniele,9999,0,9999,0
1668417899746,CSE 293,022,119367,Orailoglu; Alex,9999,0,9999,0
1668417899746,CSE 293,023,119382,Paturi; Ramamohan,9999,0,9999,0
1668417899746,CSE 293,024,119404,Polikarpova; Nadezhda,9999,0,9999,0
1668417899746,CSE 293,025,119406,Politz; Joseph Gibbs,9999,0,9999,0
1668417899746,CSE 293,026,119411,Porter; George M,9999,0,9999,0
1668417899746,CSE 293,027,119414,Porter; Leonard Emerson,9999,0,9999,0
1668417899746,CSE 293,028,119416,Ramamoorthi; Ravi,9999,0,9999,0
1668417899746,CSE 293,029,119417,Sahoo; Debashis,9999,0,9999,0
1668417899746,CSE 293,030,119420,Saul; Lawrence,9999,0,9999,0
1668417899746,CSE 293,031,119421,Savage; Stefan,9999,0,9999,0
1668417899746,CSE 293,032,119425,Schulze; Jurgen P.,9999,0,9999,0
1668417899746,CSE 293,033,119426,Snoeren; Alex C.,9999,0,9999,0
1668417899746,CSE 293,034,119428,Shang; Jingbo,9999,0,9999,0
1668417899746,CSE 293,035,119430,Stefan; Deian,9999,0,9999,0
1668417899746,CSE 293,036,119431,Su; Hao,9999,0,9999,0
1668417899746,CSE 293,037,119433,Swanson; Steven James,9999,0,9999,0
1668417899746,CSE 293,038,119435,Tullsen; Dean Michael,9999,0,9999,0
1668417899746,CSE 293,039,119483,Voelker; Geoffrey M.,9999,0,9999,0
1668417899746,CSE 293,040,119537,Zhao; Jishen,9999,0,9999,0
1668417899746,CSE 293,041,119538,Zhou; Yuan-Yuan,9999,0,9999,0
1668417899746,CSE 293,042,119539,Gao; Sicun,9999,0,9999,0
1668417899746,CSE 293,043,119540,Weibel; Nadir,9999,0,9999,0
1668417899746,CSE 293,044,119541,Gupta; Rajesh K.,9999,0,9999,0
1668417899746,CSE 293,045,126410,Vaccaro; Kristen Marie,9999,0,9999,0
1668417899746,CSE 293,046,126411,Klemke; Richard,9999,0,9999,0
1668417900175,CSE 294,A00,102459,Voelker; Geoffrey M.,0,1,0,0
1668417900175,CSE 294,B00,111322,Orailoglu; Alex,0,0,0,0
1668417900616,DSE 201,A00,096914,Deutsch; Alin Bernard,30,0,30,0
1668417901048,DSE 210,A00,096915,Dasgupta; Sanjoy,30,0,30,0
1668417901478,DSE 260A,A00,096916,Altintas De Callaf; Ilkay,30,0,30,0
1668417901929,ECE 200,001,103586,Antipa; Nicholas A,9999,0,9999,0
1668417901929,ECE 200,002,103587,Atanasov; Nikolay A.,9999,0,9999,0
1668417901929,ECE 200,003,103588,Bharadia; Dinesh,9999,0,9999,0
1668417901929,ECE 200,004,103589,Cheng; Chung Kuan,9999,0,9999,0
1668417901929,ECE 200,005,103590,Cosman; Pamela C.,9999,0,9999,0
1668417901929,ECE 200,006,103591,Dayeh; Shadi Ahmad,9999,0,9999,0
1668417901929,ECE 200,007,103592,Fainman; Yeshaiahu,9999,0,9999,0
1668417901929,ECE 200,008,103593,Ford; Joseph Earl,9999,0,9999,0
1668417901929,ECE 200,009,103594,Franceschetti; Massimo,9999,0,9999,0
1668417901929,ECE 200,010,103595,Fullerton; Eric E,9999,0,9999,0
1668417901929,ECE 200,011,103596,Galton; Ian A,9999,0,9999,0
1668417901929,ECE 200,012,103597,Gilja; Vikash,9999,0,9999,0
1668417901929,ECE 200,013,103598,Hall; Drew A.,9999,0,9999,0
1668417901929,ECE 200,014,103599,Hsueh; Tzu-Chien,9999,0,9999,0
1668417901929,ECE 200,015,103600,Javidi; Tara,9999,0,9999,0
1668417901929,ECE 200,016,103601,Kahng; Andrew Byun,9999,0,9999,0
1668417901929,ECE 200,017,103602,Kim; Young-Han,9999,0,9999,0
1668417901929,ECE 200,018,103603,Koushanfar; Farinaz,9999,0,9999,0
1668417901929,ECE 200,019,103604,Kuzum; Duygu,9999,0,9999,0
1668417901929,ECE 200,020,103605,Le; Hanh-Phuc,9999,0,9999,0
1668417901929,ECE 200,021,103606,Lin; Bill,9999,0,9999,0
1668417901929,ECE 200,022,103607,Liu; Zhaowei,9998,0,9999,1
1668417901929,ECE 200,023,103608,Lo; Yu-Hwa,9999,0,9999,0
1668417901929,ECE 200,024,103609,Lomakin; Vitaliy,9999,0,9999,0
1668417901929,ECE 200,025,103610,Mercier; Patrick Philip,9999,0,9999,0
1668417901929,ECE 200,026,103611,Meyer; Florian,9999,0,9999,0
1668417901929,ECE 200,027,103612,Milstein; Laurence B.,9999,0,9999,0
1668417901929,ECE 200,028,103613,Mir Arabbaygi; Siavash,9999,0,9999,0
1668417901929,ECE 200,029,103614,Mookherjea; Shayan,9999,0,9999,0
1668417901929,ECE 200,030,103615,Morris; Karcher William,9999,0,9999,0
1668417901929,ECE 200,031,103616,Ng; Tse Nga,9999,0,9999,0
1668417901929,ECE 200,032,103617,Nguyen; Truong Quang,9999,0,9999,0
1668417901929,ECE 200,033,103618,Nomura; Kenji,9999,0,9999,0
1668417901929,ECE 200,034,103619,Orlitsky; Alon,9999,0,9999,0
1668417901929,ECE 200,035,103620,Pal; Piya,9999,0,9999,0
1668417901929,ECE 200,036,103621,Papen; George C.,9999,0,9999,0
1668417901929,ECE 200,037,103622,Radic; Stojan,9999,0,9999,0
1668417901929,ECE 200,038,103623,Rao; Bhaskar D.,9999,0,9999,0
1668417901929,ECE 200,039,103624,Rao; Ramesh R,9999,0,9999,0
1668417901929,ECE 200,040,103625,Rebeiz; Gabriel,9999,0,9999,0
1668417901929,ECE 200,041,103626,Sanford; John R,9999,0,9999,0
1668417901929,ECE 200,042,103627,Siegel; Paul H.,9999,0,9999,0
1668417901929,ECE 200,043,103628,Sievenpiper; Daniel F.,9999,0,9999,0
1668417901929,ECE 200,044,103629,Sworder; David D.,9999,0,9999,0
1668417901929,ECE 200,045,103630,Taur; Yuan,9999,0,9999,0
1668417901929,ECE 200,046,103631,Touri; Behrouz,9999,0,9999,0
1668417901929,ECE 200,047,103632,Trivedi; Mohan M.,9999,0,9999,0
1668417901929,ECE 200,048,103633,Vasconcelos; Nuno,9999,0,9999,0
1668417901929,ECE 200,049,103634,Wang; Xiaolong,9999,0,9999,0
1668417901929,ECE 200,050,103635,Xie; Pengtao,9999,0,9999,0
1668417901929,ECE 200,051,103636,Yip; Michael,9999,0,9999,0
1668417901929,ECE 200,052,103637,Zeger; Kenneth A.,999,0,999,0
1668417901929,ECE 200,053,103638,Zhang; Xinyu,9999,0,9999,0
1668417901929,ECE 200,054,103639,Turakhia; Yatish Girish,9999,0,9999,0
1668417901929,ECE 200,055,103640,Kang; Mingu,9999,0,9999,0
1668417901929,ECE 200,056,103641,Shi; Yuanyuan,9999,0,9999,0
1668417901929,ECE 200,057,103642,Wang; Edward Jay,9999,0,9999,0
1668417901929,ECE 200,058,103643,Zheng; Yang,9999,0,9999,0
1668417902361,ECE 202,A00,103644,Kuzum; Duygu,0,20,0,0
1668417902790,ECE 212BN,A00,103646,Ng; Tse Nga,0,1,0,0
1668417903219,ECE 221,A00,111493,Staff,0,0,0,0
1668417903647,ECE 222B,A00,103647,Lomakin; Vitaliy,0,5,0,0
1668417904077,ECE 230B,A00,103648,Taur; Yuan,0,0,0,0
1668417904513,ECE 238B,A00,103649,Garay; Javier,0,0,0,0
1668417904940,ECE 240B,A00,112900,Fainman; Yeshaiahu,0,4,0,0
1668417905366,ECE 247A,A00,103650,Jokerst; Jesse Vincent,0,1,0,0
1668417905789,ECE 247B,A00,103651,Wang; Joseph,0,3,0,0
1668417906214,ECE 250,A00,103652,Siegel; Paul H.,0,42,0,0
1668417906638,ECE 251A,A00,103654,Rao; Bhaskar D.,0,28,0,0
1668417907063,ECE 257B,A00,103655,Bharadia; Dinesh,0,11,0,0
1668417907487,ECE 258A,A00,103656,Milstein; Laurence B.,0,10,0,0
1668417907913,ECE 260B,A00,103658,Kang; Mingu,0,64,0,0
1668417908337,ECE 264A,A00,103659,Galton; Ian A,0,30,0,0
1668417908766,ECE 265A,A00,103661,Gudem; Prasad S.S.,0,15,0,0
1668417909192,ECE 265D,A00,103662,Gudem; Prasad S.S.,0,9,0,0
1668417909618,ECE 268,A00,103663,Koushanfar; Farinaz,0,18,0,0
1668417910050,ECE 269,A01,103665,Pal; Piya,0,120,0,0
1668417910479,ECE 271B,A00,103666,Vasconcelos; Manuela,0,44,0,0
1668417910910,ECE 276A,A00,103667,Atanasov; Nikolay A.,0,62,0,0
1668417911335,ECE 277,A00,103668,An; Cheolhong,0,85,0,0
1668417911765,ECE 279,A00,117947,Hall; Drew A.,0,10,0,0
1668417912621,ECE 283,A00,103670,Hsueh; Tzu-Chien,0,20,0,0
1668417913155,ECE 284,A00,103671,Turakhia; Yatish Girish,0,22,0,0
1668417913583,ECE 285,A00,103672,Zheng; Yang,0,21,0,0
1668417913583,ECE 285,B00,103673,Sworder; David D.,0,36,0,0
1668417914008,ECE 287,A00,103676,Javidi; Tara,0,4,0,0
1668417914438,MATH 200B,A00,098023,Salehi Golsefidy; Alireza,12,0,15,3
1668417914863,MATH 202B,A00,098024,Rhoades; Brendon Patrick,9,0,15,6
1668417915289,MATH 203B,A00,098025,Oprea; Dragos N.,10,0,15,5
1668417915713,MATH 204B,A00,098026,Sorensen; Claus M,13,0,15,2
1668417916171,MATH 208,A00,098027,Izadi; Elham,7,0,10,3
1668417916599,MATH 209,A00,098028,Pollack; Aaron,10,0,10,0
1668417917036,MATH 211A,A00,112919,Rogalski; Daniel,9,0,10,1
1668417917472,MATH 211B,A00,112920,Seward; Brandon M.,9,0,10,1
1668417917901,MATH 218,A00,098029,Li; Bo,10,0,10,0
1668417918325,MATH 220B,A00,098030,Novak; Jonathan I,11,0,15,4
1668417918763,MATH 221A,A00,098031,Ebenfelt; Peter F,13,0,15,2
1668417919198,MATH 231B,A00,098032,Zlatos; Andrej,12,0,15,3
1668417919624,MATH 240B,A00,098033,Ni; Lei,9,0,15,6
1668417920057,MATH 243,A00,098034,Jekel; David Andrew,10,0,10,0
1668417920511,MATH 245A,A00,098035,Nie; Jiawang,0,1,15,16
1668417920940,MATH 248,A00,098036,Bejenaru; Ioan,10,0,10,0
1668417921367,MATH 250B,A00,098037,Spolaor; Luca,14,0,15,1
1668417921791,MATH 258,A00,098038,Ni; Lei,10,0,10,0
1668417922215,MATH 264B,A00,098041,Rhoades; Brendon Patrick,9,0,15,6
1668417922640,MATH 268,A00,098042,Buss; Samuel R,10,0,10,0
1668417923066,MATH 269,A00,098043,Rhoades; Brendon Patrick,10,0,10,0
1668417923498,MATH 270B,A00,098044,Li; Bo,10,0,15,5
1668417923936,MATH 272B,A00,098045,Holst; Michael J,13,0,15,2
1668417924387,MATH 273A,A00,098046,Tian; Xiaochuan,10,0,15,5
1668417924816,MATH 275,A01,098048,Tian; Xiaochuan,6,0,10,4
1668417925243,MATH 278A,A00,098049,Holst; Michael J,8,0,10,2
1668417925672,MATH 278B,A00,098050,Cloninger; Alexander,10,0,10,0
1668417926095,MATH 278C,A00,098051,Nie; Jiawang,6,0,10,4
1668417926520,MATH 280B,A00,098052,Zheng; Tianyi,8,0,15,7
1668417926946,MATH 281B,A00,098053,Bradic; Jelena,0,1,15,15
1668417927373,MATH 282B,A00,098054,Arias-Castro; Ery,0,0,15,15
1668417927803,MATH 285,A00,098055,Fitzsimmons; Patrick J,0,0,15,17
1668417928228,MATH 287B,A00,098056,Arias-Castro; Ery,2,0,15,13
1668417928660,MATH 288,A00,098057,Agarwal; Pooja,9,0,10,1
1668417928660,MATH 288,B00,098058,Zhang; Danna,8,0,10,2
1668417928660,MATH 288,C00,098059,Williams; Ruth J,9,0,10,1
1668417929094,MATH 290B,A00,098060,Roberts; Justin Deritter,13,0,15,2
1668417929518,MATH 292,A00,098061,Belmont; Eva Kinoshita,10,0,10,0
1668417929953,MATH 295,A00,098062,Suk; Andrew Hoon,48,0,50,2
1668417930388,MATH 296,A00,098063,Novak; Jonathan I,20,0,20,0
1668417930819,MATH 297,001,098064,Gamst; Anthony Collins,9997,0,9999,2
1668418433777,COGS 205,A00,101395,Chiba; Andrea,19,0,20,1
1668418434221,COGS 210B,001,101404,Greene; Deanna Jacquelyn,9998,0,9999,1
1668418434221,COGS 210B,002,101417,Xia; Haijun,9999,0,9999,0
1668418434221,COGS 210B,003,101422,Nitz; Douglas A.,9999,0,9999,0
1668418434221,COGS 210B,004,101423,Hollan; James D.,9998,0,9999,1
1668418434221,COGS 210B,005,101424,Deak; Gedeon O.,9998,0,9999,1
1668418434221,COGS 210B,006,101425,Rossano; Federico,9999,0,9999,0
1668418434645,COGS 211B,A00,101427,Coulson; Seana M,9996,0,9999,3
1668418435069,COGS 220,A00,101428,Hollan; James D.,1,2,25,24
1668418435498,COGS 229,A00,101429,Dow; Steven P,18,0,25,7
1668418435924,COGS 230,A00,101430,Klemmer; Scott R,11,0,17,6
1668418436448,COGS 234,A00,101431,Xia; Haijun,2,0,25,23
1668418436879,COGS 260,A00,101432,Kiyonaga; Anastasia,21,0,25,4
1668418436879,COGS 260,B00,101433,Kirsh; David Joel,15,0,25,10
1668418437306,CSE 202,A00,102371,Impagliazzo; Russell,0,30,0,0
1668418437737,CSE 203B,A01,102373,Cheng; Chung Kuan,0,24,0,0
1668418438160,CSE 208,A00,102374,Micciancio; Daniele,0,1,0,0
1668418438585,CSE 209A,A00,112895,Impagliazzo; Russell,0,3,15,15
1668418439012,CSE 209B,A00,108005,Bellare; Mihir,0,2,0,0
1668418439438,CSE 210,A00,113163,Coblenz; Michael J,0,41,0,0
1668418439861,CSE 219,A00,106111,Dow; Steven P,0,0,20,20
1668418440286,CSE 221,A00,102376,Voelker; Geoffrey M.,0,27,0,0
1668418440710,CSE 224,A01,102378,Porter; George M,0,101,0,0
1668418441140,CSE 229A,A00,102379,Savage; Stefan,0,4,0,0
1668418441568,CSE 229C,A00,102380,Munyaka; Imani N. S.,0,4,0,0
1668418441994,CSE 232B,A00,102382,Deutsch; Alin Bernard,0,12,0,0
1668418442420,CSE 234,A01,112904,Kumar; Arun Kumar,0,0,0,0
1668418442841,CSE 237A,A00,102383,Rosing; Tajana Simunic,0,24,0,0
1668418443281,CSE 239A,A00,102384,Deutsch; Alin Bernard,0,5,0,0
1668418443713,CSE 239B,A00,102385,Polikarpova; Nadezhda,0,3,0,0
1668418444148,CSE 240A,A00,102386,Pannuto; Patrick William,0,23,0,0
1668418444584,CSE 240B,A00,102387,Zhao; Jishen,0,23,0,0
1668418445017,CSE 241A,A00,106406,Kang; Mingu,0,2,0,0
1668418445443,CSE 249B,A00,102388,Kahng; Andrew Byun,0,1,8,8
1668418445876,CSE 251B,A01,102392,Cottrell; Garrison W,0,21,0,0
1668418445876,CSE 251B,A02,102393,Cottrell; Garrison W,0,21,0,0
1668418446309,CSE 252B,A00,102394,Ochoa; Benjamin Lawrence,0,34,0,0
1668418446737,CSE 257,A01,102396,Gao; Sicun,0,82,0,0
1668418447174,CSE 272,A00,102397,Li; Tzumao,0,6,0,0
1668418447604,CSE 274,A00,111323,Chern; Albert Ren-Haur,0,7,0,0
1668418448029,CSE 282,A00,102398,Pevzner; Pavel Arkadjevich,0,0,0,0
1668418448455,CSE 284,A00,114175,Gymrek; Melissa Ann,0,9,0,0
1668418448881,CSE 290,A00,102399,Chandraker; Manmohan Krishna,0,3,0,0
1668418448881,CSE 290,B00,102400,Vaccaro; Kristen Marie,0,1,25,25
1668418448881,CSE 290,C00,102414,Pannuto; Patrick William,0,1,25,25
1668418448881,CSE 290,D00,102427,Pevzner; Pavel Arkadjevich,0,0,0,0
1668418448881,CSE 290,E00,102429,Zhao; Jishen,0,1,0,0
1668418448881,CSE 290,F00,102436,Tullsen; Dean Michael,0,2,0,0
1668418448881,CSE 290,G00,102440,Christensen; Henrik I,0,3,20,20
1668418449316,CSE 291,A00,102443,Su; Hao,0,0,0,0
1668418449316,CSE 291,B00,102448,Polikarpova; Nadezhda,0,0,0,0
1668418449316,CSE 291,C00,102453,Vaccaro; Kristen Marie,0,0,0,0
1668418449316,CSE 291,D00,111343,Savage; Stefan,0,0,0,0
1668418449316,CSE 291,E00,116474,Claffy; Kimberly Claire,0,0,0,0
1668418449316,CSE 291,F00,116479,Pasquale; Joseph,0,0,0,0
1668418449778,CSE 293,001,119111,Bafna; Vineet,9999,0,9999,0
1668418449778,CSE 293,002,119118,Bellare; Mihir,9999,0,9999,0
1668418449778,CSE 293,003,119122,Berg-Kirkpatrick; Taylor D,9999,0,9999,0
1668418449778,CSE 293,004,119135,Christensen; Henrik I,9999,0,9999,0
1668418449778,CSE 293,005,119142,Cottrell; Garrison W,9999,0,9999,0
1668418449778,CSE 293,006,119146,Deutsch; Alin Bernard,9999,0,9999,0
1668418449778,CSE 293,007,119159,Esmaeilzadeh; Hadi,9999,0,9999,0
1668418449778,CSE 293,008,119166,Freund; Yoav,9999,0,9999,0
1668418449778,CSE 293,009,119170,Griswold; William G.,9999,0,9999,0
1668418449778,CSE 293,010,119183,Gymrek; Melissa Ann,9999,0,9999,0
1668418449778,CSE 293,011,119190,Heninger; Nadia A,9999,0,9999,0
1668418449778,CSE 293,012,119230,Impagliazzo; Russell,9999,0,9999,0
1668418449778,CSE 293,013,119232,Jhala; Ranjit,9999,0,9999,0
1668418449778,CSE 293,014,119233,Kahng; Andrew Byun,9999,0,9999,0
1668418449778,CSE 293,015,119298,Kane; Daniel Mertz,9999,0,9999,0
1668418449778,CSE 293,016,119299,Kriegman; David J,9999,0,9999,0
1668418449778,CSE 293,017,119300,Kumar; Arun Kumar,9999,0,9999,0
1668418449778,CSE 293,018,119301,Lerner; Sorin,9999,0,9999,0
1668418449778,CSE 293,019,119302,Lovett; Shachar,9999,0,9999,0
1668418449778,CSE 293,020,119303,McAuley; Julian John,9999,0,9999,0
1668418449778,CSE 293,021,119304,Micciancio; Daniele,9999,0,9999,0
1668418449778,CSE 293,022,119367,Orailoglu; Alex,9999,0,9999,0
1668418449778,CSE 293,023,119382,Paturi; Ramamohan,9999,0,9999,0
1668418449778,CSE 293,024,119404,Polikarpova; Nadezhda,9999,0,9999,0
1668418449778,CSE 293,025,119406,Politz; Joseph Gibbs,9999,0,9999,0
1668418449778,CSE 293,026,119411,Porter; George M,9999,0,9999,0
1668418449778,CSE 293,027,119414,Porter; Leonard Emerson,9999,0,9999,0
1668418449778,CSE 293,028,119416,Ramamoorthi; Ravi,9999,0,9999,0
1668418449778,CSE 293,029,119417,Sahoo; Debashis,9999,0,9999,0
1668418449778,CSE 293,030,119420,Saul; Lawrence,9999,0,9999,0
1668418449778,CSE 293,031,119421,Savage; Stefan,9999,0,9999,0
1668418449778,CSE 293,032,119425,Schulze; Jurgen P.,9999,0,9999,0
1668418449778,CSE 293,033,119426,Snoeren; Alex C.,9999,0,9999,0
1668418449778,CSE 293,034,119428,Shang; Jingbo,9999,0,9999,0
1668418449778,CSE 293,035,119430,Stefan; Deian,9999,0,9999,0
1668418449778,CSE 293,036,119431,Su; Hao,9999,0,9999,0
1668418449778,CSE 293,037,119433,Swanson; Steven James,9999,0,9999,0
1668418449778,CSE 293,038,119435,Tullsen; Dean Michael,9999,0,9999,0
1668418449778,CSE 293,039,119483,Voelker; Geoffrey M.,9999,0,9999,0
1668418449778,CSE 293,040,119537,Zhao; Jishen,9999,0,9999,0
1668418449778,CSE 293,041,119538,Zhou; Yuan-Yuan,9999,0,9999,0
1668418449778,CSE 293,042,119539,Gao; Sicun,9999,0,9999,0
1668418449778,CSE 293,043,119540,Weibel; Nadir,9999,0,9999,0
1668418449778,CSE 293,044,119541,Gupta; Rajesh K.,9999,0,9999,0
1668418449778,CSE 293,045,126410,Vaccaro; Kristen Marie,9999,0,9999,0
1668418449778,CSE 293,046,126411,Klemke; Richard,9999,0,9999,0
1668418450205,CSE 294,A00,102459,Voelker; Geoffrey M.,0,1,0,0
1668418450205,CSE 294,B00,111322,Orailoglu; Alex,0,0,0,0
1668418450630,DSE 201,A00,096914,Deutsch; Alin Bernard,30,0,30,0
1668418451058,DSE 210,A00,096915,Dasgupta; Sanjoy,30,0,30,0
1668418451491,DSE 260A,A00,096916,Altintas De Callaf; Ilkay,30,0,30,0
1668418452009,ECE 200,001,103586,Antipa; Nicholas A,9999,0,9999,0
1668418452009,ECE 200,002,103587,Atanasov; Nikolay A.,9999,0,9999,0
1668418452009,ECE 200,003,103588,Bharadia; Dinesh,9999,0,9999,0
1668418452009,ECE 200,004,103589,Cheng; Chung Kuan,9999,0,9999,0
1668418452009,ECE 200,005,103590,Cosman; Pamela C.,9999,0,9999,0
1668418452009,ECE 200,006,103591,Dayeh; Shadi Ahmad,9999,0,9999,0
1668418452009,ECE 200,007,103592,Fainman; Yeshaiahu,9999,0,9999,0
1668418452009,ECE 200,008,103593,Ford; Joseph Earl,9999,0,9999,0
1668418452009,ECE 200,009,103594,Franceschetti; Massimo,9999,0,9999,0
1668418452009,ECE 200,010,103595,Fullerton; Eric E,9999,0,9999,0
1668418452009,ECE 200,011,103596,Galton; Ian A,9999,0,9999,0
1668418452009,ECE 200,012,103597,Gilja; Vikash,9999,0,9999,0
1668418452009,ECE 200,013,103598,Hall; Drew A.,9999,0,9999,0
1668418452009,ECE 200,014,103599,Hsueh; Tzu-Chien,9999,0,9999,0
1668418452009,ECE 200,015,103600,Javidi; Tara,9999,0,9999,0
1668418452009,ECE 200,016,103601,Kahng; Andrew Byun,9999,0,9999,0
1668418452009,ECE 200,017,103602,Kim; Young-Han,9999,0,9999,0
1668418452009,ECE 200,018,103603,Koushanfar; Farinaz,9999,0,9999,0
1668418452009,ECE 200,019,103604,Kuzum; Duygu,9999,0,9999,0
1668418452009,ECE 200,020,103605,Le; Hanh-Phuc,9999,0,9999,0
1668418452009,ECE 200,021,103606,Lin; Bill,9999,0,9999,0
1668418452009,ECE 200,022,103607,Liu; Zhaowei,9998,0,9999,1
1668418452009,ECE 200,023,103608,Lo; Yu-Hwa,9999,0,9999,0
1668418452009,ECE 200,024,103609,Lomakin; Vitaliy,9999,0,9999,0
1668418452009,ECE 200,025,103610,Mercier; Patrick Philip,9999,0,9999,0
1668418452009,ECE 200,026,103611,Meyer; Florian,9999,0,9999,0
1668418452009,ECE 200,027,103612,Milstein; Laurence B.,9999,0,9999,0
1668418452009,ECE 200,028,103613,Mir Arabbaygi; Siavash,9999,0,9999,0
1668418452009,ECE 200,029,103614,Mookherjea; Shayan,9999,0,9999,0
1668418452009,ECE 200,030,103615,Morris; Karcher William,9999,0,9999,0
1668418452009,ECE 200,031,103616,Ng; Tse Nga,9999,0,9999,0
1668418452009,ECE 200,032,103617,Nguyen; Truong Quang,9999,0,9999,0
1668418452009,ECE 200,033,103618,Nomura; Kenji,9999,0,9999,0
1668418452009,ECE 200,034,103619,Orlitsky; Alon,9999,0,9999,0
1668418452009,ECE 200,035,103620,Pal; Piya,9999,0,9999,0
1668418452009,ECE 200,036,103621,Papen; George C.,9999,0,9999,0
1668418452009,ECE 200,037,103622,Radic; Stojan,9999,0,9999,0
1668418452009,ECE 200,038,103623,Rao; Bhaskar D.,9999,0,9999,0
1668418452009,ECE 200,039,103624,Rao; Ramesh R,9999,0,9999,0
1668418452009,ECE 200,040,103625,Rebeiz; Gabriel,9999,0,9999,0
1668418452009,ECE 200,041,103626,Sanford; John R,9999,0,9999,0
1668418452009,ECE 200,042,103627,Siegel; Paul H.,9999,0,9999,0
1668418452009,ECE 200,043,103628,Sievenpiper; Daniel F.,9999,0,9999,0
1668418452009,ECE 200,044,103629,Sworder; David D.,9999,0,9999,0
1668418452009,ECE 200,045,103630,Taur; Yuan,9999,0,9999,0
1668418452009,ECE 200,046,103631,Touri; Behrouz,9999,0,9999,0
1668418452009,ECE 200,047,103632,Trivedi; Mohan M.,9999,0,9999,0
1668418452009,ECE 200,048,103633,Vasconcelos; Nuno,9999,0,9999,0
1668418452009,ECE 200,049,103634,Wang; Xiaolong,9999,0,9999,0
1668418452009,ECE 200,050,103635,Xie; Pengtao,9999,0,9999,0
1668418452009,ECE 200,051,103636,Yip; Michael,9999,0,9999,0
1668418452009,ECE 200,052,103637,Zeger; Kenneth A.,999,0,999,0
1668418452009,ECE 200,053,103638,Zhang; Xinyu,9999,0,9999,0
1668418452009,ECE 200,054,103639,Turakhia; Yatish Girish,9999,0,9999,0
1668418452009,ECE 200,055,103640,Kang; Mingu,9999,0,9999,0
1668418452009,ECE 200,056,103641,Shi; Yuanyuan,9999,0,9999,0
1668418452009,ECE 200,057,103642,Wang; Edward Jay,9999,0,9999,0
1668418452009,ECE 200,058,103643,Zheng; Yang,9999,0,9999,0
1668418452446,ECE 202,A00,103644,Kuzum; Duygu,0,20,0,0
1668418452872,ECE 212BN,A00,103646,Ng; Tse Nga,0,1,0,0
1668418453301,ECE 221,A00,111493,Staff,0,0,0,0
1668418453725,ECE 222B,A00,103647,Lomakin; Vitaliy,0,5,0,0
1668418454154,ECE 230B,A00,103648,Taur; Yuan,0,0,0,0
1668418454580,ECE 238B,A00,103649,Garay; Javier,0,0,0,0
1668418455006,ECE 240B,A00,112900,Fainman; Yeshaiahu,0,4,0,0
1668418455431,ECE 247A,A00,103650,Jokerst; Jesse Vincent,0,1,0,0
1668418455864,ECE 247B,A00,103651,Wang; Joseph,0,3,0,0
1668418456297,ECE 250,A00,103652,Siegel; Paul H.,0,42,0,0
1668418456724,ECE 251A,A00,103654,Rao; Bhaskar D.,0,28,0,0
1668418457151,ECE 257B,A00,103655,Bharadia; Dinesh,0,11,0,0
1668418457577,ECE 258A,A00,103656,Milstein; Laurence B.,0,10,0,0
1668418458005,ECE 260B,A00,103658,Kang; Mingu,0,64,0,0
1668418458433,ECE 264A,A00,103659,Galton; Ian A,0,30,0,0
1668418458858,ECE 265A,A00,103661,Gudem; Prasad S.S.,0,15,0,0
1668418459283,ECE 265D,A00,103662,Gudem; Prasad S.S.,0,9,0,0
1668418459707,ECE 268,A00,103663,Koushanfar; Farinaz,0,18,0,0
1668418460135,ECE 269,A01,103665,Pal; Piya,0,120,0,0
1668418460559,ECE 271B,A00,103666,Vasconcelos; Manuela,0,44,0,0
1668418461007,ECE 276A,A00,103667,Atanasov; Nikolay A.,0,62,0,0
1668418461537,ECE 277,A00,103668,An; Cheolhong,0,85,0,0
1668418461964,ECE 279,A00,117947,Hall; Drew A.,0,10,0,0
1668418462813,ECE 283,A00,103670,Hsueh; Tzu-Chien,0,20,0,0
1668418463241,ECE 284,A00,103671,Turakhia; Yatish Girish,0,22,0,0
1668418463664,ECE 285,A00,103672,Zheng; Yang,0,21,0,0
1668418463664,ECE 285,B00,103673,Sworder; David D.,0,36,0,0
1668418464092,ECE 287,A00,103676,Javidi; Tara,0,4,0,0
1668418464521,MATH 200B,A00,098023,Salehi Golsefidy; Alireza,12,0,15,3
1668418464949,MATH 202B,A00,098024,Rhoades; Brendon Patrick,9,0,15,6
1668418465381,MATH 203B,A00,098025,Oprea; Dragos N.,10,0,15,5
1668418465813,MATH 204B,A00,098026,Sorensen; Claus M,13,0,15,2
1668418466239,MATH 208,A00,098027,Izadi; Elham,7,0,10,3
1668418466668,MATH 209,A00,098028,Pollack; Aaron,10,0,10,0
1668418467096,MATH 211A,A00,112919,Rogalski; Daniel,9,0,10,1
1668418467521,MATH 211B,A00,112920,Seward; Brandon M.,9,0,10,1
1668418467950,MATH 218,A00,098029,Li; Bo,10,0,10,0
1668418468375,MATH 220B,A00,098030,Novak; Jonathan I,11,0,15,4
1668418468804,MATH 221A,A00,098031,Ebenfelt; Peter F,13,0,15,2
1668418469229,MATH 231B,A00,098032,Zlatos; Andrej,12,0,15,3
1668418469659,MATH 240B,A00,098033,Ni; Lei,9,0,15,6
1668418470093,MATH 243,A00,098034,Jekel; David Andrew,10,0,10,0
1668418470517,MATH 245A,A00,098035,Nie; Jiawang,0,1,15,16
1668418470942,MATH 248,A00,098036,Bejenaru; Ioan,10,0,10,0
1668418471372,MATH 250B,A00,098037,Spolaor; Luca,14,0,15,1
1668418471796,MATH 258,A00,098038,Ni; Lei,10,0,10,0
1668418472221,MATH 264B,A00,098041,Rhoades; Brendon Patrick,9,0,15,6
1668418472652,MATH 268,A00,098042,Buss; Samuel R,10,0,10,0
1668418473077,MATH 269,A00,098043,Rhoades; Brendon Patrick,10,0,10,0
1668418473505,MATH 270B,A00,098044,Li; Bo,10,0,15,5
1668418473933,MATH 272B,A00,098045,Holst; Michael J,13,0,15,2
1668418474375,MATH 273A,A00,098046,Tian; Xiaochuan,10,0,15,5
1668418474809,MATH 275,A01,098048,Tian; Xiaochuan,6,0,10,4
1668418475233,MATH 278A,A00,098049,Holst; Michael J,8,0,10,2
1668418475658,MATH 278B,A00,098050,Cloninger; Alexander,10,0,10,0
1668418476094,MATH 278C,A00,098051,Nie; Jiawang,6,0,10,4
1668418476544,MATH 280B,A00,098052,Zheng; Tianyi,8,0,15,7
1668418476968,MATH 281B,A00,098053,Bradic; Jelena,0,1,15,15
1668418477392,MATH 282B,A00,098054,Arias-Castro; Ery,0,0,15,15
1668418477818,MATH 285,A00,098055,Fitzsimmons; Patrick J,0,0,15,17
1668418478249,MATH 287B,A00,098056,Arias-Castro; Ery,2,0,15,13
1668418478693,MATH 288,A00,098057,Agarwal; Pooja,9,0,10,1
1668418478693,MATH 288,B00,098058,Zhang; Danna,8,0,10,2
1668418478693,MATH 288,C00,098059,Williams; Ruth J,9,0,10,1
1668418479118,MATH 290B,A00,098060,Roberts; Justin Deritter,13,0,15,2
1668418479544,MATH 292,A00,098061,Belmont; Eva Kinoshita,10,0,10,0
1668418480047,MATH 295,A00,098062,Suk; Andrew Hoon,48,0,50,2
1668418480473,MATH 296,A00,098063,Novak; Jonathan I,20,0,20,0
1668418480901,MATH 297,001,098064,Gamst; Anthony Collins,9997,0,9999,2
1668418984076,COGS 205,A00,101395,Chiba; Andrea,19,0,20,1
1668418984504,COGS 210B,001,101404,Greene; Deanna Jacquelyn,9998,0,9999,1
1668418984504,COGS 210B,002,101417,Xia; Haijun,9999,0,9999,0
1668418984504,COGS 210B,003,101422,Nitz; Douglas A.,9999,0,9999,0
1668418984504,COGS 210B,004,101423,Hollan; James D.,9998,0,9999,1
1668418984504,COGS 210B,005,101424,Deak; Gedeon O.,9998,0,9999,1
1668418984504,COGS 210B,006,101425,Rossano; Federico,9999,0,9999,0
1668418984930,COGS 211B,A00,101427,Coulson; Seana M,9996,0,9999,3
1668418985354,COGS 220,A00,101428,Hollan; James D.,1,2,25,24
1668418985778,COGS 229,A00,101429,Dow; Steven P,18,0,25,7
1668418986207,COGS 230,A00,101430,Klemmer; Scott R,11,0,17,6
1668418986630,COGS 234,A00,101431,Xia; Haijun,2,0,25,23
1668418987055,COGS 260,A00,101432,Kiyonaga; Anastasia,21,0,25,4
1668418987055,COGS 260,B00,101433,Kirsh; David Joel,15,0,25,10
1668418987485,CSE 202,A00,102371,Impagliazzo; Russell,0,30,0,0
1668418987914,CSE 203B,A01,102373,Cheng; Chung Kuan,0,24,0,0
1668418988346,CSE 208,A00,102374,Micciancio; Daniele,0,1,0,0
1668418988773,CSE 209A,A00,112895,Impagliazzo; Russell,0,3,15,15
1668418989199,CSE 209B,A00,108005,Bellare; Mihir,0,2,0,0
1668418989635,CSE 210,A00,113163,Coblenz; Michael J,0,41,0,0
1668418990064,CSE 219,A00,106111,Dow; Steven P,0,0,20,20
1668418990495,CSE 221,A00,102376,Voelker; Geoffrey M.,0,27,0,0
1668418990941,CSE 224,A01,102378,Porter; George M,0,101,0,0
1668418991382,CSE 229A,A00,102379,Savage; Stefan,0,4,0,0
1668418991812,CSE 229C,A00,102380,Munyaka; Imani N. S.,0,4,0,0
1668418992240,CSE 232B,A00,102382,Deutsch; Alin Bernard,0,12,0,0
1668418992669,CSE 234,A01,112904,Kumar; Arun Kumar,0,0,0,0
1668418993098,CSE 237A,A00,102383,Rosing; Tajana Simunic,0,24,0,0
1668418993524,CSE 239A,A00,102384,Deutsch; Alin Bernard,0,5,0,0
1668418993952,CSE 239B,A00,102385,Polikarpova; Nadezhda,0,3,0,0
1668418994376,CSE 240A,A00,102386,Pannuto; Patrick William,0,23,0,0
1668418994802,CSE 240B,A00,102387,Zhao; Jishen,0,23,0,0
1668418995232,CSE 241A,A00,106406,Kang; Mingu,0,2,0,0
1668418995660,CSE 249B,A00,102388,Kahng; Andrew Byun,0,1,8,8
1668418996087,CSE 251B,A01,102392,Cottrell; Garrison W,0,21,0,0
1668418996087,CSE 251B,A02,102393,Cottrell; Garrison W,0,21,0,0
1668418996515,CSE 252B,A00,102394,Ochoa; Benjamin Lawrence,0,34,0,0
1668418996938,CSE 257,A01,102396,Gao; Sicun,0,82,0,0
1668418997364,CSE 272,A00,102397,Li; Tzumao,0,6,0,0
1668418997787,CSE 274,A00,111323,Chern; Albert Ren-Haur,0,7,0,0
1668418998218,CSE 282,A00,102398,Pevzner; Pavel Arkadjevich,0,0,0,0
1668418998645,CSE 284,A00,114175,Gymrek; Melissa Ann,0,9,0,0
1668418999071,CSE 290,A00,102399,Chandraker; Manmohan Krishna,0,3,0,0
1668418999071,CSE 290,B00,102400,Vaccaro; Kristen Marie,0,1,25,25
1668418999071,CSE 290,C00,102414,Pannuto; Patrick William,0,1,25,25
1668418999071,CSE 290,D00,102427,Pevzner; Pavel Arkadjevich,0,0,0,0
1668418999071,CSE 290,E00,102429,Zhao; Jishen,0,1,0,0
1668418999071,CSE 290,F00,102436,Tullsen; Dean Michael,0,2,0,0
1668418999071,CSE 290,G00,102440,Christensen; Henrik I,0,3,20,20
1668418999499,CSE 291,A00,102443,Su; Hao,0,0,0,0
1668418999499,CSE 291,B00,102448,Polikarpova; Nadezhda,0,0,0,0
1668418999499,CSE 291,C00,102453,Vaccaro; Kristen Marie,0,0,0,0
1668418999499,CSE 291,D00,111343,Savage; Stefan,0,0,0,0
1668418999499,CSE 291,E00,116474,Claffy; Kimberly Claire,0,0,0,0
1668418999499,CSE 291,F00,116479,Pasquale; Joseph,0,0,0,0
1668418999942,CSE 293,001,119111,Bafna; Vineet,9999,0,9999,0
1668418999942,CSE 293,002,119118,Bellare; Mihir,9999,0,9999,0
1668418999942,CSE 293,003,119122,Berg-Kirkpatrick; Taylor D,9999,0,9999,0
1668418999942,CSE 293,004,119135,Christensen; Henrik I,9999,0,9999,0
1668418999942,CSE 293,005,119142,Cottrell; Garrison W,9999,0,9999,0
1668418999942,CSE 293,006,119146,Deutsch; Alin Bernard,9999,0,9999,0
1668418999942,CSE 293,007,119159,Esmaeilzadeh; Hadi,9999,0,9999,0
1668418999942,CSE 293,008,119166,Freund; Yoav,9999,0,9999,0
1668418999942,CSE 293,009,119170,Griswold; William G.,9999,0,9999,0
1668418999942,CSE 293,010,119183,Gymrek; Melissa Ann,9999,0,9999,0
1668418999942,CSE 293,011,119190,Heninger; Nadia A,9999,0,9999,0
1668418999942,CSE 293,012,119230,Impagliazzo; Russell,9999,0,9999,0
1668418999942,CSE 293,013,119232,Jhala; Ranjit,9999,0,9999,0
1668418999942,CSE 293,014,119233,Kahng; Andrew Byun,9999,0,9999,0
1668418999942,CSE 293,015,119298,Kane; Daniel Mertz,9999,0,9999,0
1668418999942,CSE 293,016,119299,Kriegman; David J,9999,0,9999,0
1668418999942,CSE 293,017,119300,Kumar; Arun Kumar,9999,0,9999,0
1668418999942,CSE 293,018,119301,Lerner; Sorin,9999,0,9999,0
1668418999942,CSE 293,019,119302,Lovett; Shachar,9999,0,9999,0
1668418999942,CSE 293,020,119303,McAuley; Julian John,9999,0,9999,0
1668418999942,CSE 293,021,119304,Micciancio; Daniele,9999,0,9999,0
1668418999942,CSE 293,022,119367,Orailoglu; Alex,9999,0,9999,0
1668418999942,CSE 293,023,119382,Paturi; Ramamohan,9999,0,9999,0
1668418999942,CSE 293,024,119404,Polikarpova; Nadezhda,9999,0,9999,0
1668418999942,CSE 293,025,119406,Politz; Joseph Gibbs,9999,0,9999,0
1668418999942,CSE 293,026,119411,Porter; George M,9999,0,9999,0
1668418999942,CSE 293,027,119414,Porter; Leonard Emerson,9999,0,9999,0
1668418999942,CSE 293,028,119416,Ramamoorthi; Ravi,9999,0,9999,0
1668418999942,CSE 293,029,119417,Sahoo; Debashis,9999,0,9999,0
1668418999942,CSE 293,030,119420,Saul; Lawrence,9999,0,9999,0
1668418999942,CSE 293,031,119421,Savage; Stefan,9999,0,9999,0
1668418999942,CSE 293,032,119425,Schulze; Jurgen P.,9999,0,9999,0
1668418999942,CSE 293,033,119426,Snoeren; Alex C.,9999,0,9999,0
1668418999942,CSE 293,034,119428,Shang; Jingbo,9999,0,9999,0
1668418999942,CSE 293,035,119430,Stefan; Deian,9999,0,9999,0
1668418999942,CSE 293,036,119431,Su; Hao,9999,0,9999,0
1668418999942,CSE 293,037,119433,Swanson; Steven James,9999,0,9999,0
1668418999942,CSE 293,038,119435,Tullsen; Dean Michael,9999,0,9999,0
1668418999942,CSE 293,039,119483,Voelker; Geoffrey M.,9999,0,9999,0
1668418999942,CSE 293,040,119537,Zhao; Jishen,9999,0,9999,0
1668418999942,CSE 293,041,119538,Zhou; Yuan-Yuan,9999,0,9999,0
1668418999942,CSE 293,042,119539,Gao; Sicun,9999,0,9999,0
1668418999942,CSE 293,043,119540,Weibel; Nadir,9999,0,9999,0
1668418999942,CSE 293,044,119541,Gupta; Rajesh K.,9999,0,9999,0
1668418999942,CSE 293,045,126410,Vaccaro; Kristen Marie,9999,0,9999,0
1668418999942,CSE 293,046,126411,Klemke; Richard,9999,0,9999,0
1668419000366,CSE 294,A00,102459,Voelker; Geoffrey M.,0,1,0,0
1668419000366,CSE 294,B00,111322,Orailoglu; Alex,0,0,0,0
1668419000795,DSE 201,A00,096914,Deutsch; Alin Bernard,30,0,30,0
1668419001224,DSE 210,A00,096915,Dasgupta; Sanjoy,30,0,30,0
1668419001651,DSE 260A,A00,096916,Altintas De Callaf; Ilkay,30,0,30,0
1668419002100,ECE 200,001,103586,Antipa; Nicholas A,9999,0,9999,0
1668419002100,ECE 200,002,103587,Atanasov; Nikolay A.,9999,0,9999,0
1668419002100,ECE 200,003,103588,Bharadia; Dinesh,9999,0,9999,0
1668419002100,ECE 200,004,103589,Cheng; Chung Kuan,9999,0,9999,0
1668419002100,ECE 200,005,103590,Cosman; Pamela C.,9999,0,9999,0
1668419002100,ECE 200,006,103591,Dayeh; Shadi Ahmad,9999,0,9999,0
1668419002100,ECE 200,007,103592,Fainman; Yeshaiahu,9999,0,9999,0
1668419002100,ECE 200,008,103593,Ford; Joseph Earl,9999,0,9999,0
1668419002100,ECE 200,009,103594,Franceschetti; Massimo,9999,0,9999,0
1668419002100,ECE 200,010,103595,Fullerton; Eric E,9999,0,9999,0
1668419002100,ECE 200,011,103596,Galton; Ian A,9999,0,9999,0
1668419002100,ECE 200,012,103597,Gilja; Vikash,9999,0,9999,0
1668419002100,ECE 200,013,103598,Hall; Drew A.,9999,0,9999,0
1668419002100,ECE 200,014,103599,Hsueh; Tzu-Chien,9999,0,9999,0
1668419002100,ECE 200,015,103600,Javidi; Tara,9999,0,9999,0
1668419002100,ECE 200,016,103601,Kahng; Andrew Byun,9999,0,9999,0
1668419002100,ECE 200,017,103602,Kim; Young-Han,9999,0,9999,0
1668419002100,ECE 200,018,103603,Koushanfar; Farinaz,9999,0,9999,0
1668419002100,ECE 200,019,103604,Kuzum; Duygu,9999,0,9999,0
1668419002100,ECE 200,020,103605,Le; Hanh-Phuc,9999,0,9999,0
1668419002100,ECE 200,021,103606,Lin; Bill,9999,0,9999,0
1668419002100,ECE 200,022,103607,Liu; Zhaowei,9998,0,9999,1
1668419002100,ECE 200,023,103608,Lo; Yu-Hwa,9999,0,9999,0
1668419002100,ECE 200,024,103609,Lomakin; Vitaliy,9999,0,9999,0
1668419002100,ECE 200,025,103610,Mercier; Patrick Philip,9999,0,9999,0
1668419002100,ECE 200,026,103611,Meyer; Florian,9999,0,9999,0
1668419002100,ECE 200,027,103612,Milstein; Laurence B.,9999,0,9999,0
1668419002100,ECE 200,028,103613,Mir Arabbaygi; Siavash,9999,0,9999,0
1668419002100,ECE 200,029,103614,Mookherjea; Shayan,9999,0,9999,0
1668419002100,ECE 200,030,103615,Morris; Karcher William,9999,0,9999,0
1668419002100,ECE 200,031,103616,Ng; Tse Nga,9999,0,9999,0
1668419002100,ECE 200,032,103617,Nguyen; Truong Quang,9999,0,9999,0
1668419002100,ECE 200,033,103618,Nomura; Kenji,9999,0,9999,0
1668419002100,ECE 200,034,103619,Orlitsky; Alon,9999,0,9999,0
1668419002100,ECE 200,035,103620,Pal; Piya,9999,0,9999,0
1668419002100,ECE 200,036,103621,Papen; George C.,9999,0,9999,0
1668419002100,ECE 200,037,103622,Radic; Stojan,9999,0,9999,0
1668419002100,ECE 200,038,103623,Rao; Bhaskar D.,9999,0,9999,0
1668419002100,ECE 200,039,103624,Rao; Ramesh R,9999,0,9999,0
1668419002100,ECE 200,040,103625,Rebeiz; Gabriel,9999,0,9999,0
1668419002100,ECE 200,041,103626,Sanford; John R,9999,0,9999,0
1668419002100,ECE 200,042,103627,Siegel; Paul H.,9999,0,9999,0
1668419002100,ECE 200,043,103628,Sievenpiper; Daniel F.,9999,0,9999,0
1668419002100,ECE 200,044,103629,Sworder; David D.,9999,0,9999,0
1668419002100,ECE 200,045,103630,Taur; Yuan,9999,0,9999,0
1668419002100,ECE 200,046,103631,Touri; Behrouz,9999,0,9999,0
1668419002100,ECE 200,047,103632,Trivedi; Mohan M.,9999,0,9999,0
1668419002100,ECE 200,048,103633,Vasconcelos; Nuno,9999,0,9999,0
1668419002100,ECE 200,049,103634,Wang; Xiaolong,9999,0,9999,0
1668419002100,ECE 200,050,103635,Xie; Pengtao,9999,0,9999,0
1668419002100,ECE 200,051,103636,Yip; Michael,9999,0,9999,0
1668419002100,ECE 200,052,103637,Zeger; Kenneth A.,999,0,999,0
1668419002100,ECE 200,053,103638,Zhang; Xinyu,9999,0,9999,0
1668419002100,ECE 200,054,103639,Turakhia; Yatish Girish,9999,0,9999,0
1668419002100,ECE 200,055,103640,Kang; Mingu,9999,0,9999,0
1668419002100,ECE 200,056,103641,Shi; Yuanyuan,9999,0,9999,0
1668419002100,ECE 200,057,103642,Wang; Edward Jay,9999,0,9999,0
1668419002100,ECE 200,058,103643,Zheng; Yang,9999,0,9999,0
1668419002529,ECE 202,A00,103644,Kuzum; Duygu,0,20,0,0
1668419002958,ECE 212BN,A00,103646,Ng; Tse Nga,0,1,0,0
1668419003461,ECE 221,A00,111493,Staff,0,0,0,0
1668419003885,ECE 222B,A00,103647,Lomakin; Vitaliy,0,5,0,0
1668419004308,ECE 230B,A00,103648,Taur; Yuan,0,0,0,0
1668419004737,ECE 238B,A00,103649,Garay; Javier,0,0,0,0
1668419005161,ECE 240B,A00,112900,Fainman; Yeshaiahu,0,4,0,0
1668419005586,ECE 247A,A00,103650,Jokerst; Jesse Vincent,0,1,0,0
1668419006014,ECE 247B,A00,103651,Wang; Joseph,0,3,0,0
1668419006439,ECE 250,A00,103652,Siegel; Paul H.,0,42,0,0
1668419006871,ECE 251A,A00,103654,Rao; Bhaskar D.,0,28,0,0
1668419007296,ECE 257B,A00,103655,Bharadia; Dinesh,0,11,0,0
1668419007721,ECE 258A,A00,103656,Milstein; Laurence B.,0,10,0,0
1668419008146,ECE 260B,A00,103658,Kang; Mingu,0,64,0,0
1668419008570,ECE 264A,A00,103659,Galton; Ian A,0,30,0,0
1668419008993,ECE 265A,A00,103661,Gudem; Prasad S.S.,0,15,0,0
1668419009417,ECE 265D,A00,103662,Gudem; Prasad S.S.,0,9,0,0
1668419009843,ECE 268,A00,103663,Koushanfar; Farinaz,0,18,0,0
1668419010271,ECE 269,A01,103665,Pal; Piya,0,121,0,0
1668419010697,ECE 271B,A00,103666,Vasconcelos; Manuela,0,45,0,0
1668419011131,ECE 276A,A00,103667,Atanasov; Nikolay A.,0,64,0,0
1668419011556,ECE 277,A00,103668,An; Cheolhong,0,85,0,0
1668419011985,ECE 279,A00,117947,Hall; Drew A.,0,10,0,0
1668419012835,ECE 283,A00,103670,Hsueh; Tzu-Chien,0,20,0,0
1668419013260,ECE 284,A00,103671,Turakhia; Yatish Girish,0,22,0,0
1668419013684,ECE 285,A00,103672,Zheng; Yang,0,21,0,0
1668419013684,ECE 285,B00,103673,Sworder; David D.,0,36,0,0
1668419014109,ECE 287,A00,103676,Javidi; Tara,0,4,0,0
1668419014542,MATH 200B,A00,098023,Salehi Golsefidy; Alireza,12,0,15,3
1668419014971,MATH 202B,A00,098024,Rhoades; Brendon Patrick,9,0,15,6
1668419015396,MATH 203B,A00,098025,Oprea; Dragos N.,10,0,15,5
1668419015819,MATH 204B,A00,098026,Sorensen; Claus M,13,0,15,2
1668419016244,MATH 208,A00,098027,Izadi; Elham,7,0,10,3
1668419016671,MATH 209,A00,098028,Pollack; Aaron,10,0,10,0
1668419017097,MATH 211A,A00,112919,Rogalski; Daniel,9,0,10,1
1668419017521,MATH 211B,A00,112920,Seward; Brandon M.,9,0,10,1
1668419017946,MATH 218,A00,098029,Li; Bo,10,0,10,0
1668419018372,MATH 220B,A00,098030,Novak; Jonathan I,11,0,15,4
1668419018796,MATH 221A,A00,098031,Ebenfelt; Peter F,13,0,15,2
1668419019220,MATH 231B,A00,098032,Zlatos; Andrej,12,0,15,3
1668419019649,MATH 240B,A00,098033,Ni; Lei,9,0,15,6
1668419020073,MATH 243,A00,098034,Jekel; David Andrew,10,0,10,0
1668419020496,MATH 245A,A00,098035,Nie; Jiawang,0,1,15,16
1668419020921,MATH 248,A00,098036,Bejenaru; Ioan,10,0,10,0
1668419021351,MATH 250B,A00,098037,Spolaor; Luca,14,0,15,1
1668419021777,MATH 258,A00,098038,Ni; Lei,10,0,10,0
1668419022217,MATH 264B,A00,098041,Rhoades; Brendon Patrick,9,0,15,6
1668419022641,MATH 268,A00,098042,Buss; Samuel R,10,0,10,0
1668419023075,MATH 269,A00,098043,Rhoades; Brendon Patrick,10,0,10,0
1668419023513,MATH 270B,A00,098044,Li; Bo,10,0,15,5
1668419023937,MATH 272B,A00,098045,Holst; Michael J,13,0,15,2
1668419024366,MATH 273A,A00,098046,Tian; Xiaochuan,10,0,15,5
1668419024794,MATH 275,A01,098048,Tian; Xiaochuan,6,0,10,4
1668419025220,MATH 278A,A00,098049,Holst; Michael J,8,0,10,2
1668419025647,MATH 278B,A00,098050,Cloninger; Alexander,10,0,10,0
1668419026076,MATH 278C,A00,098051,Nie; Jiawang,6,0,10,4
1668419026498,MATH 280B,A00,098052,Zheng; Tianyi,8,0,15,7
1668419026928,MATH 281B,A00,098053,Bradic; Jelena,0,1,15,15
1668419027354,MATH 282B,A00,098054,Arias-Castro; Ery,0,0,15,15
1668419027798,MATH 285,A00,098055,Fitzsimmons; Patrick J,0,0,15,17
1668419028222,MATH 287B,A00,098056,Arias-Castro; Ery,2,0,15,13
1668419028647,MATH 288,A00,098057,Agarwal; Pooja,9,0,10,1
1668419028647,MATH 288,B00,098058,Zhang; Danna,8,0,10,2
1668419028647,MATH 288,C00,098059,Williams; Ruth J,9,0,10,1
1668419029072,MATH 290B,A00,098060,Roberts; Justin Deritter,13,0,15,2
1668419029505,MATH 292,A00,098061,Belmont; Eva Kinoshita,10,0,10,0
1668419029931,MATH 295,A00,098062,Suk; Andrew Hoon,48,0,50,2
1668419030354,MATH 296,A00,098063,Novak; Jonathan I,20,0,20,0
1668419030778,MATH 297,001,098064,Gamst; Anthony Collins,9997,0,9999,2
1668419533993,COGS 205,A00,101395,Chiba; Andrea,19,0,20,1
1668419534418,COGS 210B,001,101404,Greene; Deanna Jacquelyn,9998,0,9999,1
1668419534418,COGS 210B,002,101417,Xia; Haijun,9999,0,9999,0
1668419534418,COGS 210B,003,101422,Nitz; Douglas A.,9999,0,9999,0
1668419534418,COGS 210B,004,101423,Hollan; James D.,9998,0,9999,1
1668419534418,COGS 210B,005,101424,Deak; Gedeon O.,9998,0,9999,1
1668419534418,COGS 210B,006,101425,Rossano; Federico,9999,0,9999,0
1668419534853,COGS 211B,A00,101427,Coulson; Seana M,9996,0,9999,3
1668419535280,COGS 220,A00,101428,Hollan; James D.,1,2,25,24
1668419535705,COGS 229,A00,101429,Dow; Steven P,18,0,25,7
1668419536133,COGS 230,A00,101430,Klemmer; Scott R,11,0,17,6
1668419536562,COGS 234,A00,101431,Xia; Haijun,2,0,25,23
1668419536987,COGS 260,A00,101432,Kiyonaga; Anastasia,21,0,25,4
1668419536987,COGS 260,B00,101433,Kirsh; David Joel,15,0,25,10
1668419537412,CSE 202,A00,102371,Impagliazzo; Russell,0,30,0,0
1668419537840,CSE 203B,A01,102373,Cheng; Chung Kuan,0,24,0,0
1668419538271,CSE 208,A00,102374,Micciancio; Daniele,0,1,0,0
1668419538695,CSE 209A,A00,112895,Impagliazzo; Russell,0,3,15,15
1668419539123,CSE 209B,A00,108005,Bellare; Mihir,0,2,0,0
1668419539548,CSE 210,A00,113163,Coblenz; Michael J,0,41,0,0
1668419539976,CSE 219,A00,106111,Dow; Steven P,0,0,20,20
1668419540406,CSE 221,A00,102376,Voelker; Geoffrey M.,0,27,0,0
1668419540831,CSE 224,A01,102378,Porter; George M,0,101,0,0
1668419541259,CSE 229A,A00,102379,Savage; Stefan,0,4,0,0
1668419541682,CSE 229C,A00,102380,Munyaka; Imani N. S.,0,4,0,0
1668419542107,CSE 232B,A00,102382,Deutsch; Alin Bernard,0,12,0,0
1668419542531,CSE 234,A01,112904,Kumar; Arun Kumar,0,0,0,0
1668419542961,CSE 237A,A00,102383,Rosing; Tajana Simunic,0,24,0,0
1668419543386,CSE 239A,A00,102384,Deutsch; Alin Bernard,0,5,0,0
1668419543810,CSE 239B,A00,102385,Polikarpova; Nadezhda,0,3,0,0
1668419544239,CSE 240A,A00,102386,Pannuto; Patrick William,0,23,0,0
1668419544665,CSE 240B,A00,102387,Zhao; Jishen,0,23,0,0
1668419545092,CSE 241A,A00,106406,Kang; Mingu,0,2,0,0
1668419545520,CSE 249B,A00,102388,Kahng; Andrew Byun,0,1,8,8
1668419545945,CSE 251B,A01,102392,Cottrell; Garrison W,0,20,0,0
1668419545945,CSE 251B,A02,102393,Cottrell; Garrison W,0,21,0,0
1668419546385,CSE 252B,A00,102394,Ochoa; Benjamin Lawrence,0,34,0,0
1668419546816,CSE 257,A01,102396,Gao; Sicun,0,83,0,0
1668419547244,CSE 272,A00,102397,Li; Tzumao,0,6,0,0
1668419547672,CSE 274,A00,111323,Chern; Albert Ren-Haur,0,7,0,0
1668419548097,CSE 282,A00,102398,Pevzner; Pavel Arkadjevich,0,0,0,0
1668419548526,CSE 284,A00,114175,Gymrek; Melissa Ann,0,9,0,0
1668419548959,CSE 290,A00,102399,Chandraker; Manmohan Krishna,0,3,0,0
1668419548959,CSE 290,B00,102400,Vaccaro; Kristen Marie,0,1,25,25
1668419548959,CSE 290,C00,102414,Pannuto; Patrick William,0,1,25,25
1668419548959,CSE 290,D00,102427,Pevzner; Pavel Arkadjevich,0,0,0,0
1668419548959,CSE 290,E00,102429,Zhao; Jishen,0,1,0,0
1668419548959,CSE 290,F00,102436,Tullsen; Dean Michael,0,2,0,0
1668419548959,CSE 290,G00,102440,Christensen; Henrik I,0,3,20,20
1668419549392,CSE 291,A00,102443,Su; Hao,0,0,0,0
1668419549392,CSE 291,B00,102448,Polikarpova; Nadezhda,0,0,0,0
1668419549392,CSE 291,C00,102453,Vaccaro; Kristen Marie,0,0,0,0
1668419549392,CSE 291,D00,111343,Savage; Stefan,0,0,0,0
1668419549392,CSE 291,E00,116474,Claffy; Kimberly Claire,0,0,0,0
1668419549392,CSE 291,F00,116479,Pasquale; Joseph,0,0,0,0
1668419549879,CSE 293,001,119111,Bafna; Vineet,9999,0,9999,0
1668419549879,CSE 293,002,119118,Bellare; Mihir,9999,0,9999,0
1668419549879,CSE 293,003,119122,Berg-Kirkpatrick; Taylor D,9999,0,9999,0
1668419549879,CSE 293,004,119135,Christensen; Henrik I,9999,0,9999,0
1668419549879,CSE 293,005,119142,Cottrell; Garrison W,9999,0,9999,0
1668419549879,CSE 293,006,119146,Deutsch; Alin Bernard,9999,0,9999,0
1668419549879,CSE 293,007,119159,Esmaeilzadeh; Hadi,9999,0,9999,0
1668419549879,CSE 293,008,119166,Freund; Yoav,9999,0,9999,0
1668419549879,CSE 293,009,119170,Griswold; William G.,9999,0,9999,0
1668419549879,CSE 293,010,119183,Gymrek; Melissa Ann,9999,0,9999,0
1668419549879,CSE 293,011,119190,Heninger; Nadia A,9999,0,9999,0
1668419549879,CSE 293,012,119230,Impagliazzo; Russell,9999,0,9999,0
1668419549879,CSE 293,013,119232,Jhala; Ranjit,9999,0,9999,0
1668419549879,CSE 293,014,119233,Kahng; Andrew Byun,9999,0,9999,0
1668419549879,CSE 293,015,119298,Kane; Daniel Mertz,9999,0,9999,0
1668419549879,CSE 293,016,119299,Kriegman; David J,9999,0,9999,0
1668419549879,CSE 293,017,119300,Kumar; Arun Kumar,9999,0,9999,0
1668419549879,CSE 293,018,119301,Lerner; Sorin,9999,0,9999,0
1668419549879,CSE 293,019,119302,Lovett; Shachar,9999,0,9999,0
1668419549879,CSE 293,020,119303,McAuley; Julian John,9999,0,9999,0
1668419549879,CSE 293,021,119304,Micciancio; Daniele,9999,0,9999,0
1668419549879,CSE 293,022,119367,Orailoglu; Alex,9999,0,9999,0
1668419549879,CSE 293,023,119382,Paturi; Ramamohan,9999,0,9999,0
1668419549879,CSE 293,024,119404,Polikarpova; Nadezhda,9999,0,9999,0
1668419549879,CSE 293,025,119406,Politz; Joseph Gibbs,9999,0,9999,0
1668419549879,CSE 293,026,119411,Porter; George M,9999,0,9999,0
1668419549879,CSE 293,027,119414,Porter; Leonard Emerson,9999,0,9999,0
1668419549879,CSE 293,028,119416,Ramamoorthi; Ravi,9999,0,9999,0
1668419549879,CSE 293,029,119417,Sahoo; Debashis,9999,0,9999,0
1668419549879,CSE 293,030,119420,Saul; Lawrence,9999,0,9999,0
1668419549879,CSE 293,031,119421,Savage; Stefan,9999,0,9999,0
1668419549879,CSE 293,032,119425,Schulze; Jurgen P.,9999,0,9999,0
1668419549879,CSE 293,033,119426,Snoeren; Alex C.,9999,0,9999,0
1668419549879,CSE 293,034,119428,Shang; Jingbo,9999,0,9999,0
1668419549879,CSE 293,035,119430,Stefan; Deian,9999,0,9999,0
1668419549879,CSE 293,036,119431,Su; Hao,9999,0,9999,0
1668419549879,CSE 293,037,119433,Swanson; Steven James,9999,0,9999,0
1668419549879,CSE 293,038,119435,Tullsen; Dean Michael,9999,0,9999,0
1668419549879,CSE 293,039,119483,Voelker; Geoffrey M.,9999,0,9999,0
1668419549879,CSE 293,040,119537,Zhao; Jishen,9999,0,9999,0
1668419549879,CSE 293,041,119538,Zhou; Yuan-Yuan,9999,0,9999,0
1668419549879,CSE 293,042,119539,Gao; Sicun,9999,0,9999,0
1668419549879,CSE 293,043,119540,Weibel; Nadir,9999,0,9999,0
1668419549879,CSE 293,044,119541,Gupta; Rajesh K.,9999,0,9999,0
1668419549879,CSE 293,045,126410,Vaccaro; Kristen Marie,9999,0,9999,0
1668419549879,CSE 293,046,126411,Klemke; Richard,9999,0,9999,0
1668419550312,CSE 294,A00,102459,Voelker; Geoffrey M.,0,1,0,0
1668419550312,CSE 294,B00,111322,Orailoglu; Alex,0,0,0,0
1668419550751,DSE 201,A00,096914,Deutsch; Alin Bernard,30,0,30,0
1668419551175,DSE 210,A00,096915,Dasgupta; Sanjoy,30,0,30,0
1668419551614,DSE 260A,A00,096916,Altintas De Callaf; Ilkay,30,0,30,0
1668419552073,ECE 200,001,103586,Antipa; Nicholas A,9999,0,9999,0
1668419552073,ECE 200,002,103587,Atanasov; Nikolay A.,9999,0,9999,0
1668419552073,ECE 200,003,103588,Bharadia; Dinesh,9999,0,9999,0
1668419552073,ECE 200,004,103589,Cheng; Chung Kuan,9999,0,9999,0
1668419552073,ECE 200,005,103590,Cosman; Pamela C.,9999,0,9999,0
1668419552073,ECE 200,006,103591,Dayeh; Shadi Ahmad,9999,0,9999,0
1668419552073,ECE 200,007,103592,Fainman; Yeshaiahu,9999,0,9999,0
1668419552073,ECE 200,008,103593,Ford; Joseph Earl,9999,0,9999,0
1668419552073,ECE 200,009,103594,Franceschetti; Massimo,9999,0,9999,0
1668419552073,ECE 200,010,103595,Fullerton; Eric E,9999,0,9999,0
1668419552073,ECE 200,011,103596,Galton; Ian A,9999,0,9999,0
1668419552073,ECE 200,012,103597,Gilja; Vikash,9999,0,9999,0
1668419552073,ECE 200,013,103598,Hall; Drew A.,9999,0,9999,0
1668419552073,ECE 200,014,103599,Hsueh; Tzu-Chien,9999,0,9999,0
1668419552073,ECE 200,015,103600,Javidi; Tara,9999,0,9999,0
1668419552073,ECE 200,016,103601,Kahng; Andrew Byun,9999,0,9999,0
1668419552073,ECE 200,017,103602,Kim; Young-Han,9999,0,9999,0
1668419552073,ECE 200,018,103603,Koushanfar; Farinaz,9999,0,9999,0
1668419552073,ECE 200,019,103604,Kuzum; Duygu,9999,0,9999,0
1668419552073,ECE 200,020,103605,Le; Hanh-Phuc,9999,0,9999,0
1668419552073,ECE 200,021,103606,Lin; Bill,9999,0,9999,0
1668419552073,ECE 200,022,103607,Liu; Zhaowei,9998,0,9999,1
1668419552073,ECE 200,023,103608,Lo; Yu-Hwa,9999,0,9999,0
1668419552073,ECE 200,024,103609,Lomakin; Vitaliy,9999,0,9999,0
1668419552073,ECE 200,025,103610,Mercier; Patrick Philip,9999,0,9999,0
1668419552073,ECE 200,026,103611,Meyer; Florian,9999,0,9999,0
1668419552073,ECE 200,027,103612,Milstein; Laurence B.,9999,0,9999,0
1668419552073,ECE 200,028,103613,Mir Arabbaygi; Siavash,9999,0,9999,0
1668419552073,ECE 200,029,103614,Mookherjea; Shayan,9999,0,9999,0
1668419552073,ECE 200,030,103615,Morris; Karcher William,9999,0,9999,0
1668419552073,ECE 200,031,103616,Ng; Tse Nga,9999,0,9999,0
1668419552073,ECE 200,032,103617,Nguyen; Truong Quang,9999,0,9999,0
1668419552073,ECE 200,033,103618,Nomura; Kenji,9999,0,9999,0
1668419552073,ECE 200,034,103619,Orlitsky; Alon,9999,0,9999,0
1668419552073,ECE 200,035,103620,Pal; Piya,9999,0,9999,0
1668419552073,ECE 200,036,103621,Papen; George C.,9999,0,9999,0
1668419552073,ECE 200,037,103622,Radic; Stojan,9999,0,9999,0
1668419552073,ECE 200,038,103623,Rao; Bhaskar D.,9999,0,9999,0
1668419552073,ECE 200,039,103624,Rao; Ramesh R,9999,0,9999,0
1668419552073,ECE 200,040,103625,Rebeiz; Gabriel,9999,0,9999,0
1668419552073,ECE 200,041,103626,Sanford; John R,9999,0,9999,0
1668419552073,ECE 200,042,103627,Siegel; Paul H.,9999,0,9999,0
1668419552073,ECE 200,043,103628,Sievenpiper; Daniel F.,9999,0,9999,0
1668419552073,ECE 200,044,103629,Sworder; David D.,9999,0,9999,0
1668419552073,ECE 200,045,103630,Taur; Yuan,9999,0,9999,0
1668419552073,ECE 200,046,103631,Touri; Behrouz,9999,0,9999,0
1668419552073,ECE 200,047,103632,Trivedi; Mohan M.,9999,0,9999,0
1668419552073,ECE 200,048,103633,Vasconcelos; Nuno,9999,0,9999,0
1668419552073,ECE 200,049,103634,Wang; Xiaolong,9999,0,9999,0
1668419552073,ECE 200,050,103635,Xie; Pengtao,9999,0,9999,0
1668419552073,ECE 200,051,103636,Yip; Michael,9999,0,9999,0
1668419552073,ECE 200,052,103637,Zeger; Kenneth A.,999,0,999,0
1668419552073,ECE 200,053,103638,Zhang; Xinyu,9999,0,9999,0
1668419552073,ECE 200,054,103639,Turakhia; Yatish Girish,9999,0,9999,0
1668419552073,ECE 200,055,103640,Kang; Mingu,9999,0,9999,0
1668419552073,ECE 200,056,103641,Shi; Yuanyuan,9999,0,9999,0
1668419552073,ECE 200,057,103642,Wang; Edward Jay,9999,0,9999,0
1668419552073,ECE 200,058,103643,Zheng; Yang,9999,0,9999,0
1668419552499,ECE 202,A00,103644,Kuzum; Duygu,0,20,0,0
1668419552929,ECE 212BN,A00,103646,Ng; Tse Nga,0,1,0,0
1668419553354,ECE 221,A00,111493,Staff,0,0,0,0
1668419553785,ECE 222B,A00,103647,Lomakin; Vitaliy,0,5,0,0
1668419554210,ECE 230B,A00,103648,Taur; Yuan,0,0,0,0
1668419554635,ECE 238B,A00,103649,Garay; Javier,0,0,0,0
1668419555061,ECE 240B,A00,112900,Fainman; Yeshaiahu,0,4,0,0
1668419555486,ECE 247A,A00,103650,Jokerst; Jesse Vincent,0,1,0,0
1668419555912,ECE 247B,A00,103651,Wang; Joseph,0,3,0,0
1668419556336,ECE 250,A00,103652,Siegel; Paul H.,0,42,0,0
1668419556760,ECE 251A,A00,103654,Rao; Bhaskar D.,0,28,0,0
1668419557184,ECE 257B,A00,103655,Bharadia; Dinesh,0,11,0,0
1668419557612,ECE 258A,A00,103656,Milstein; Laurence B.,0,10,0,0
1668419558037,ECE 260B,A00,103658,Kang; Mingu,0,64,0,0
1668419558468,ECE 264A,A00,103659,Galton; Ian A,0,31,0,0
1668419558897,ECE 265A,A00,103661,Gudem; Prasad S.S.,0,16,0,0
1668419559322,ECE 265D,A00,103662,Gudem; Prasad S.S.,0,9,0,0
1668419559745,ECE 268,A00,103663,Koushanfar; Farinaz,0,18,0,0
1668419560175,ECE 269,A01,103665,Pal; Piya,0,121,0,0
1668419560599,ECE 271B,A00,103666,Vasconcelos; Manuela,0,45,0,0
1668419561025,ECE 276A,A00,103667,Atanasov; Nikolay A.,0,65,0,0
1668419561454,ECE 277,A00,103668,An; Cheolhong,0,85,0,0
1668419561885,ECE 279,A00,117947,Hall; Drew A.,0,10,0,0
1668419562733,ECE 283,A00,103670,Hsueh; Tzu-Chien,0,20,0,0
1668419563158,ECE 284,A00,103671,Turakhia; Yatish Girish,0,22,0,0
1668419563582,ECE 285,A00,103672,Zheng; Yang,0,21,0,0
1668419563582,ECE 285,B00,103673,Sworder; David D.,0,36,0,0
1668419564014,ECE 287,A00,103676,Javidi; Tara,0,4,0,0
1668419564454,MATH 200B,A00,098023,Salehi Golsefidy; Alireza,12,0,15,3
1668419564882,MATH 202B,A00,098024,Rhoades; Brendon Patrick,9,0,15,6
1668419565308,MATH 203B,A00,098025,Oprea; Dragos N.,10,0,15,5
1668419565732,MATH 204B,A00,098026,Sorensen; Claus M,13,0,15,2
1668419566156,MATH 208,A00,098027,Izadi; Elham,7,0,10,3
1668419566582,MATH 209,A00,098028,Pollack; Aaron,10,0,10,0
1668419567008,MATH 211A,A00,112919,Rogalski; Daniel,9,0,10,1
1668419567435,MATH 211B,A00,112920,Seward; Brandon M.,9,0,10,1
1668419567863,MATH 218,A00,098029,Li; Bo,10,0,10,0
1668419568299,MATH 220B,A00,098030,Novak; Jonathan I,11,0,15,4
1668419568727,MATH 221A,A00,098031,Ebenfelt; Peter F,13,0,15,2
1668419569152,MATH 231B,A00,098032,Zlatos; Andrej,12,0,15,3
1668419569582,MATH 240B,A00,098033,Ni; Lei,9,0,15,6
1668419570096,MATH 243,A00,098034,Jekel; David Andrew,10,0,10,0
1668419570528,MATH 245A,A00,098035,Nie; Jiawang,0,1,15,16
1668419570953,MATH 248,A00,098036,Bejenaru; Ioan,10,0,10,0
1668419571379,MATH 250B,A00,098037,Spolaor; Luca,14,0,15,1
1668419571804,MATH 258,A00,098038,Ni; Lei,10,0,10,0
1668419572236,MATH 264B,A00,098041,Rhoades; Brendon Patrick,9,0,15,6
1668419572662,MATH 268,A00,098042,Buss; Samuel R,10,0,10,0
1668419573088,MATH 269,A00,098043,Rhoades; Brendon Patrick,10,0,10,0
1668419573513,MATH 270B,A00,098044,Li; Bo,10,0,15,5
1668419573938,MATH 272B,A00,098045,Holst; Michael J,13,0,15,2
1668419574363,MATH 273A,A00,098046,Tian; Xiaochuan,10,0,15,5
1668419574789,MATH 275,A01,098048,Tian; Xiaochuan,6,0,10,4
1668419575213,MATH 278A,A00,098049,Holst; Michael J,8,0,10,2
1668419575638,MATH 278B,A00,098050,Cloninger; Alexander,10,0,10,0
1668419576065,MATH 278C,A00,098051,Nie; Jiawang,6,0,10,4
1668419576490,MATH 280B,A00,098052,Zheng; Tianyi,8,0,15,7
1668419576917,MATH 281B,A00,098053,Bradic; Jelena,0,1,15,15
1668419577341,MATH 282B,A00,098054,Arias-Castro; Ery,0,0,15,15
1668419577767,MATH 285,A00,098055,Fitzsimmons; Patrick J,0,0,15,17
1668419578195,MATH 287B,A00,098056,Arias-Castro; Ery,2,0,15,13
1668419578636,MATH 288,A00,098057,Agarwal; Pooja,9,0,10,1
1668419578636,MATH 288,B00,098058,Zhang; Danna,8,0,10,2
1668419578636,MATH 288,C00,098059,Williams; Ruth J,9,0,10,1
1668419579063,MATH 290B,A00,098060,Roberts; Justin Deritter,13,0,15,2
1668419579488,MATH 292,A00,098061,Belmont; Eva Kinoshita,10,0,10,0
1668419579912,MATH 295,A00,098062,Suk; Andrew Hoon,48,0,50,2
1668419580335,MATH 296,A00,098063,Novak; Jonathan I,20,0,20,0
1668419580764,MATH 297,001,098064,Gamst; Anthony Collins,9997,0,9999,2
1668420083775,COGS 205,A00,101395,Chiba; Andrea,19,0,20,1
1668420084199,COGS 210B,001,101404,Greene; Deanna Jacquelyn,9998,0,9999,1
1668420084199,COGS 210B,002,101417,Xia; Haijun,9999,0,9999,0
1668420084199,COGS 210B,003,101422,Nitz; Douglas A.,9999,0,9999,0
1668420084199,COGS 210B,004,101423,Hollan; James D.,9998,0,9999,1
1668420084199,COGS 210B,005,101424,Deak; Gedeon O.,9998,0,9999,1
1668420084199,COGS 210B,006,101425,Rossano; Federico,9999,0,9999,0
1668420084623,COGS 211B,A00,101427,Coulson; Seana M,9996,0,9999,3
1668420085047,COGS 220,A00,101428,Hollan; James D.,1,2,25,24
1668420085472,COGS 229,A00,101429,Dow; Steven P,18,0,25,7
1668420085898,COGS 230,A00,101430,Klemmer; Scott R,11,0,17,6
1668420086322,COGS 234,A00,101431,Xia; Haijun,2,0,25,23
1668420086747,COGS 260,A00,101432,Kiyonaga; Anastasia,21,0,25,4
1668420086747,COGS 260,B00,101433,Kirsh; David Joel,15,0,25,10
1668420087180,CSE 202,A00,102371,Impagliazzo; Russell,0,30,0,0
1668420087618,CSE 203B,A01,102373,Cheng; Chung Kuan,0,24,0,0
1668420088048,CSE 208,A00,102374,Micciancio; Daniele,0,1,0,0
1668420088481,CSE 209A,A00,112895,Impagliazzo; Russell,0,3,15,15
1668420088924,CSE 209B,A00,108005,Bellare; Mihir,0,2,0,0
1668420089356,CSE 210,A00,113163,Coblenz; Michael J,0,41,0,0
1668420089779,CSE 219,A00,106111,Dow; Steven P,0,0,20,20
1668420090205,CSE 221,A00,102376,Voelker; Geoffrey M.,0,27,0,0
1668420090628,CSE 224,A01,102378,Porter; George M,0,101,0,0
1668420091055,CSE 229A,A00,102379,Savage; Stefan,0,4,0,0
1668420091479,CSE 229C,A00,102380,Munyaka; Imani N. S.,0,4,0,0
1668420091904,CSE 232B,A00,102382,Deutsch; Alin Bernard,0,12,0,0
1668420092331,CSE 234,A01,112904,Kumar; Arun Kumar,0,0,0,0
1668420092758,CSE 237A,A00,102383,Rosing; Tajana Simunic,0,24,0,0
1668420093293,CSE 239A,A00,102384,Deutsch; Alin Bernard,0,5,0,0
1668420093718,CSE 239B,A00,102385,Polikarpova; Nadezhda,0,3,0,0
1668420094146,CSE 240A,A00,102386,Pannuto; Patrick William,0,23,0,0
1668420094569,CSE 240B,A00,102387,Zhao; Jishen,0,23,0,0
1668420094994,CSE 241A,A00,106406,Kang; Mingu,0,2,0,0
1668420095420,CSE 249B,A00,102388,Kahng; Andrew Byun,0,1,8,8
1668420095842,CSE 251B,A01,102392,Cottrell; Garrison W,0,21,0,0
1668420095842,CSE 251B,A02,102393,Cottrell; Garrison W,0,21,0,0
1668420096266,CSE 252B,A00,102394,Ochoa; Benjamin Lawrence,0,35,0,0
1668420096693,CSE 257,A01,102396,Gao; Sicun,0,84,0,0
1668420097120,CSE 272,A00,102397,Li; Tzumao,0,7,0,0
1668420097548,CSE 274,A00,111323,Chern; Albert Ren-Haur,0,7,0,0
1668420097975,CSE 282,A00,102398,Pevzner; Pavel Arkadjevich,0,0,0,0
1668420098400,CSE 284,A00,114175,Gymrek; Melissa Ann,0,9,0,0
1668420098826,CSE 290,A00,102399,Chandraker; Manmohan Krishna,0,4,0,0
1668420098826,CSE 290,B00,102400,Vaccaro; Kristen Marie,0,1,25,25
1668420098826,CSE 290,C00,102414,Pannuto; Patrick William,0,1,25,25
1668420098826,CSE 290,D00,102427,Pevzner; Pavel Arkadjevich,0,0,0,0
1668420098826,CSE 290,E00,102429,Zhao; Jishen,0,1,0,0
1668420098826,CSE 290,F00,102436,Tullsen; Dean Michael,0,2,0,0
1668420098826,CSE 290,G00,102440,Christensen; Henrik I,0,3,20,20
1668420099257,CSE 291,A00,102443,Su; Hao,0,0,0,0
1668420099257,CSE 291,B00,102448,Polikarpova; Nadezhda,0,0,0,0
1668420099257,CSE 291,C00,102453,Vaccaro; Kristen Marie,0,0,0,0
1668420099257,CSE 291,D00,111343,Savage; Stefan,0,0,0,0
1668420099257,CSE 291,E00,116474,Claffy; Kimberly Claire,0,0,0,0
1668420099257,CSE 291,F00,116479,Pasquale; Joseph,0,0,0,0
1668420099685,CSE 293,001,119111,Bafna; Vineet,9999,0,9999,0
1668420099685,CSE 293,002,119118,Bellare; Mihir,9999,0,9999,0
1668420099685,CSE 293,003,119122,Berg-Kirkpatrick; Taylor D,9999,0,9999,0
1668420099685,CSE 293,004,119135,Christensen; Henrik I,9999,0,9999,0
1668420099685,CSE 293,005,119142,Cottrell; Garrison W,9999,0,9999,0
1668420099685,CSE 293,006,119146,Deutsch; Alin Bernard,9999,0,9999,0
1668420099685,CSE 293,007,119159,Esmaeilzadeh; Hadi,9999,0,9999,0
1668420099685,CSE 293,008,119166,Freund; Yoav,9999,0,9999,0
1668420099685,CSE 293,009,119170,Griswold; William G.,9999,0,9999,0
1668420099685,CSE 293,010,119183,Gymrek; Melissa Ann,9999,0,9999,0
1668420099685,CSE 293,011,119190,Heninger; Nadia A,9999,0,9999,0
1668420099685,CSE 293,012,119230,Impagliazzo; Russell,9999,0,9999,0
1668420099685,CSE 293,013,119232,Jhala; Ranjit,9999,0,9999,0
1668420099685,CSE 293,014,119233,Kahng; Andrew Byun,9999,0,9999,0
1668420099685,CSE 293,015,119298,Kane; Daniel Mertz,9999,0,9999,0
1668420099685,CSE 293,016,119299,Kriegman; David J,9999,0,9999,0
1668420099685,CSE 293,017,119300,Kumar; Arun Kumar,9999,0,9999,0
1668420099685,CSE 293,018,119301,Lerner; Sorin,9999,0,9999,0
1668420099685,CSE 293,019,119302,Lovett; Shachar,9999,0,9999,0
1668420099685,CSE 293,020,119303,McAuley; Julian John,9999,0,9999,0
1668420099685,CSE 293,021,119304,Micciancio; Daniele,9999,0,9999,0
1668420099685,CSE 293,022,119367,Orailoglu; Alex,9999,0,9999,0
1668420099685,CSE 293,023,119382,Paturi; Ramamohan,9999,0,9999,0
1668420099685,CSE 293,024,119404,Polikarpova; Nadezhda,9999,0,9999,0
1668420099685,CSE 293,025,119406,Politz; Joseph Gibbs,9999,0,9999,0
1668420099685,CSE 293,026,119411,Porter; George M,9999,0,9999,0
1668420099685,CSE 293,027,119414,Porter; Leonard Emerson,9999,0,9999,0
1668420099685,CSE 293,028,119416,Ramamoorthi; Ravi,9999,0,9999,0
1668420099685,CSE 293,029,119417,Sahoo; Debashis,9999,0,9999,0
1668420099685,CSE 293,030,119420,Saul; Lawrence,9999,0,9999,0
1668420099685,CSE 293,031,119421,Savage; Stefan,9999,0,9999,0
1668420099685,CSE 293,032,119425,Schulze; Jurgen P.,9999,0,9999,0
1668420099685,CSE 293,033,119426,Snoeren; Alex C.,9999,0,9999,0
1668420099685,CSE 293,034,119428,Shang; Jingbo,9999,0,9999,0
1668420099685,CSE 293,035,119430,Stefan; Deian,9999,0,9999,0
1668420099685,CSE 293,036,119431,Su; Hao,9999,0,9999,0
1668420099685,CSE 293,037,119433,Swanson; Steven James,9999,0,9999,0
1668420099685,CSE 293,038,119435,Tullsen; Dean Michael,9999,0,9999,0
1668420099685,CSE 293,039,119483,Voelker; Geoffrey M.,9999,0,9999,0
1668420099685,CSE 293,040,119537,Zhao; Jishen,9999,0,9999,0
1668420099685,CSE 293,041,119538,Zhou; Yuan-Yuan,9999,0,9999,0
1668420099685,CSE 293,042,119539,Gao; Sicun,9999,0,9999,0
1668420099685,CSE 293,043,119540,Weibel; Nadir,9999,0,9999,0
1668420099685,CSE 293,044,119541,Gupta; Rajesh K.,9999,0,9999,0
1668420099685,CSE 293,045,126410,Vaccaro; Kristen Marie,9999,0,9999,0
1668420099685,CSE 293,046,126411,Klemke; Richard,9999,0,9999,0
1668420100110,CSE 294,A00,102459,Voelker; Geoffrey M.,0,1,0,0
1668420100110,CSE 294,B00,111322,Orailoglu; Alex,0,0,0,0
1668420100536,DSE 201,A00,096914,Deutsch; Alin Bernard,30,0,30,0
1668420100960,DSE 210,A00,096915,Dasgupta; Sanjoy,30,0,30,0
1668420101384,DSE 260A,A00,096916,Altintas De Callaf; Ilkay,30,0,30,0
1668420101826,ECE 200,001,103586,Antipa; Nicholas A,9999,0,9999,0
1668420101826,ECE 200,002,103587,Atanasov; Nikolay A.,9999,0,9999,0
1668420101826,ECE 200,003,103588,Bharadia; Dinesh,9999,0,9999,0
1668420101826,ECE 200,004,103589,Cheng; Chung Kuan,9999,0,9999,0
1668420101826,ECE 200,005,103590,Cosman; Pamela C.,9999,0,9999,0
1668420101826,ECE 200,006,103591,Dayeh; Shadi Ahmad,9999,0,9999,0
1668420101826,ECE 200,007,103592,Fainman; Yeshaiahu,9999,0,9999,0
1668420101826,ECE 200,008,103593,Ford; Joseph Earl,9999,0,9999,0
1668420101826,ECE 200,009,103594,Franceschetti; Massimo,9999,0,9999,0
1668420101826,ECE 200,010,103595,Fullerton; Eric E,9999,0,9999,0
1668420101826,ECE 200,011,103596,Galton; Ian A,9999,0,9999,0
1668420101826,ECE 200,012,103597,Gilja; Vikash,9999,0,9999,0
1668420101826,ECE 200,013,103598,Hall; Drew A.,9999,0,9999,0
1668420101826,ECE 200,014,103599,Hsueh; Tzu-Chien,9999,0,9999,0
1668420101826,ECE 200,015,103600,Javidi; Tara,9999,0,9999,0
1668420101826,ECE 200,016,103601,Kahng; Andrew Byun,9999,0,9999,0
1668420101826,ECE 200,017,103602,Kim; Young-Han,9999,0,9999,0
1668420101826,ECE 200,018,103603,Koushanfar; Farinaz,9999,0,9999,0
1668420101826,ECE 200,019,103604,Kuzum; Duygu,9999,0,9999,0
1668420101826,ECE 200,020,103605,Le; Hanh-Phuc,9999,0,9999,0
1668420101826,ECE 200,021,103606,Lin; Bill,9999,0,9999,0
1668420101826,ECE 200,022,103607,Liu; Zhaowei,9998,0,9999,1
1668420101826,ECE 200,023,103608,Lo; Yu-Hwa,9999,0,9999,0
1668420101826,ECE 200,024,103609,Lomakin; Vitaliy,9999,0,9999,0
1668420101826,ECE 200,025,103610,Mercier; Patrick Philip,9999,0,9999,0
1668420101826,ECE 200,026,103611,Meyer; Florian,9999,0,9999,0
1668420101826,ECE 200,027,103612,Milstein; Laurence B.,9999,0,9999,0
1668420101826,ECE 200,028,103613,Mir Arabbaygi; Siavash,9999,0,9999,0
1668420101826,ECE 200,029,103614,Mookherjea; Shayan,9999,0,9999,0
1668420101826,ECE 200,030,103615,Morris; Karcher William,9999,0,9999,0
1668420101826,ECE 200,031,103616,Ng; Tse Nga,9999,0,9999,0
1668420101826,ECE 200,032,103617,Nguyen; Truong Quang,9999,0,9999,0
1668420101826,ECE 200,033,103618,Nomura; Kenji,9999,0,9999,0
1668420101826,ECE 200,034,103619,Orlitsky; Alon,9999,0,9999,0
1668420101826,ECE 200,035,103620,Pal; Piya,9999,0,9999,0
1668420101826,ECE 200,036,103621,Papen; George C.,9999,0,9999,0
1668420101826,ECE 200,037,103622,Radic; Stojan,9999,0,9999,0
1668420101826,ECE 200,038,103623,Rao; Bhaskar D.,9999,0,9999,0
1668420101826,ECE 200,039,103624,Rao; Ramesh R,9999,0,9999,0
1668420101826,ECE 200,040,103625,Rebeiz; Gabriel,9999,0,9999,0
1668420101826,ECE 200,041,103626,Sanford; John R,9999,0,9999,0
1668420101826,ECE 200,042,103627,Siegel; Paul H.,9999,0,9999,0
1668420101826,ECE 200,043,103628,Sievenpiper; Daniel F.,9999,0,9999,0
1668420101826,ECE 200,044,103629,Sworder; David D.,9999,0,9999,0
1668420101826,ECE 200,045,103630,Taur; Yuan,9999,0,9999,0
1668420101826,ECE 200,046,103631,Touri; Behrouz,9999,0,9999,0
1668420101826,ECE 200,047,103632,Trivedi; Mohan M.,9999,0,9999,0
1668420101826,ECE 200,048,103633,Vasconcelos; Nuno,9999,0,9999,0
1668420101826,ECE 200,049,103634,Wang; Xiaolong,9999,0,9999,0
1668420101826,ECE 200,050,103635,Xie; Pengtao,9999,0,9999,0
1668420101826,ECE 200,051,103636,Yip; Michael,9999,0,9999,0
1668420101826,ECE 200,052,103637,Zeger; Kenneth A.,999,0,999,0
1668420101826,ECE 200,053,103638,Zhang; Xinyu,9999,0,9999,0
1668420101826,ECE 200,054,103639,Turakhia; Yatish Girish,9999,0,9999,0
1668420101826,ECE 200,055,103640,Kang; Mingu,9999,0,9999,0
1668420101826,ECE 200,056,103641,Shi; Yuanyuan,9999,0,9999,0
1668420101826,ECE 200,057,103642,Wang; Edward Jay,9999,0,9999,0
1668420101826,ECE 200,058,103643,Zheng; Yang,9999,0,9999,0
1668420102254,ECE 202,A00,103644,Kuzum; Duygu,0,20,0,0
1668420102678,ECE 212BN,A00,103646,Ng; Tse Nga,0,1,0,0
1668420103105,ECE 221,A00,111493,Staff,0,0,0,0
1668420103530,ECE 222B,A00,103647,Lomakin; Vitaliy,0,5,0,0
1668420103959,ECE 230B,A00,103648,Taur; Yuan,0,0,0,0
1668420104383,ECE 238B,A00,103649,Garay; Javier,0,0,0,0
1668420104810,ECE 240B,A00,112900,Fainman; Yeshaiahu,0,4,0,0
1668420105237,ECE 247A,A00,103650,Jokerst; Jesse Vincent,0,1,0,0
1668420105663,ECE 247B,A00,103651,Wang; Joseph,0,3,0,0
1668420106088,ECE 250,A00,103652,Siegel; Paul H.,0,42,0,0
1668420106518,ECE 251A,A00,103654,Rao; Bhaskar D.,0,28,0,0
1668420106943,ECE 257B,A00,103655,Bharadia; Dinesh,0,11,0,0
1668420107371,ECE 258A,A00,103656,Milstein; Laurence B.,0,10,0,0
1668420107804,ECE 260B,A00,103658,Kang; Mingu,0,64,0,0
1668420108233,ECE 264A,A00,103659,Galton; Ian A,0,31,0,0
1668420108659,ECE 265A,A00,103661,Gudem; Prasad S.S.,0,16,0,0
1668420109087,ECE 265D,A00,103662,Gudem; Prasad S.S.,0,9,0,0
1668420109513,ECE 268,A00,103663,Koushanfar; Farinaz,0,18,0,0
1668420109936,ECE 269,A01,103665,Pal; Piya,0,122,0,0
1668420110373,ECE 271B,A00,103666,Vasconcelos; Manuela,0,45,0,0
1668420110796,ECE 276A,A00,103667,Atanasov; Nikolay A.,0,65,0,0
1668420111238,ECE 277,A00,103668,An; Cheolhong,0,85,0,0
1668420111661,ECE 279,A00,117947,Hall; Drew A.,0,11,0,0
1668420112512,ECE 283,A00,103670,Hsueh; Tzu-Chien,0,20,0,0
1668420112941,ECE 284,A00,103671,Turakhia; Yatish Girish,0,22,0,0
1668420113364,ECE 285,A00,103672,Zheng; Yang,0,22,0,0
1668420113364,ECE 285,B00,103673,Sworder; David D.,0,36,0,0
1668420113795,ECE 287,A00,103676,Javidi; Tara,0,4,0,0
1668420114227,MATH 200B,A00,098023,Salehi Golsefidy; Alireza,12,0,15,3
1668420114650,MATH 202B,A00,098024,Rhoades; Brendon Patrick,9,0,15,6
1668420115080,MATH 203B,A00,098025,Oprea; Dragos N.,10,0,15,5
1668420115503,MATH 204B,A00,098026,Sorensen; Claus M,13,0,15,2
1668420115928,MATH 208,A00,098027,Izadi; Elham,7,0,10,3
1668420116353,MATH 209,A00,098028,Pollack; Aaron,10,0,10,0
1668420116780,MATH 211A,A00,112919,Rogalski; Daniel,9,0,10,1
1668420117207,MATH 211B,A00,112920,Seward; Brandon M.,9,0,10,1
1668420117645,MATH 218,A00,098029,Li; Bo,10,0,10,0
1668420118072,MATH 220B,A00,098030,Novak; Jonathan I,11,0,15,4
1668420118496,MATH 221A,A00,098031,Ebenfelt; Peter F,13,0,15,2
1668420118921,MATH 231B,A00,098032,Zlatos; Andrej,12,0,15,3
1668420119357,MATH 240B,A00,098033,Ni; Lei,9,0,15,6
1668420119782,MATH 243,A00,098034,Jekel; David Andrew,10,0,10,0
1668420120209,MATH 245A,A00,098035,Nie; Jiawang,0,1,15,16
1668420120635,MATH 248,A00,098036,Bejenaru; Ioan,10,0,10,0
1668420121061,MATH 250B,A00,098037,Spolaor; Luca,14,0,15,1
1668420121484,MATH 258,A00,098038,Ni; Lei,10,0,10,0
1668420121911,MATH 264B,A00,098041,Rhoades; Brendon Patrick,9,0,15,6
1668420122336,MATH 268,A00,098042,Buss; Samuel R,10,0,10,0
1668420122760,MATH 269,A00,098043,Rhoades; Brendon Patrick,10,0,10,0
1668420123185,MATH 270B,A00,098044,Li; Bo,10,0,15,5
1668420123620,MATH 272B,A00,098045,Holst; Michael J,13,0,15,2
1668420124044,MATH 273A,A00,098046,Tian; Xiaochuan,10,0,15,5
1668420124469,MATH 275,A01,098048,Tian; Xiaochuan,6,0,10,4
1668420124896,MATH 278A,A00,098049,Holst; Michael J,8,0,10,2
1668420125320,MATH 278B,A00,098050,Cloninger; Alexander,10,0,10,0
1668420125747,MATH 278C,A00,098051,Nie; Jiawang,6,0,10,4
1668420126171,MATH 280B,A00,098052,Zheng; Tianyi,8,0,15,7
1668420126594,MATH 281B,A00,098053,Bradic; Jelena,0,1,15,15
1668420127019,MATH 282B,A00,098054,Arias-Castro; Ery,0,0,15,15
1668420127444,MATH 285,A00,098055,Fitzsimmons; Patrick J,0,0,15,17
1668420127868,MATH 287B,A00,098056,Arias-Castro; Ery,2,0,15,13
1668420128294,MATH 288,A00,098057,Agarwal; Pooja,9,0,10,1
1668420128294,MATH 288,B00,098058,Zhang; Danna,8,0,10,2
1668420128294,MATH 288,C00,098059,Williams; Ruth J,9,0,10,1
1668420128720,MATH 290B,A00,098060,Roberts; Justin Deritter,13,0,15,2
1668420129144,MATH 292,A00,098061,Belmont; Eva Kinoshita,10,0,10,0
1668420129570,MATH 295,A00,098062,Suk; Andrew Hoon,48,0,50,2
1668420129994,MATH 296,A00,098063,Novak; Jonathan I,20,0,20,0
1668420130419,MATH 297,001,098064,Gamst; Anthony Collins,9997,0,9999,2
1668420632920,COGS 205,A00,101395,Chiba; Andrea,19,0,20,1
1668420633365,COGS 210B,001,101404,Greene; Deanna Jacquelyn,9998,0,9999,1
1668420633365,COGS 210B,002,101417,Xia; Haijun,9999,0,9999,0
1668420633365,COGS 210B,003,101422,Nitz; Douglas A.,9999,0,9999,0
1668420633365,COGS 210B,004,101423,Hollan; James D.,9998,0,9999,1
1668420633365,COGS 210B,005,101424,Deak; Gedeon O.,9998,0,9999,1
1668420633365,COGS 210B,006,101425,Rossano; Federico,9999,0,9999,0
1668420633793,COGS 211B,A00,101427,Coulson; Seana M,9996,0,9999,3
1668420634231,COGS 220,A00,101428,Hollan; James D.,1,2,25,24
1668420634676,COGS 229,A00,101429,Dow; Steven P,18,0,25,7
1668420635103,COGS 230,A00,101430,Klemmer; Scott R,11,0,17,6
1668420635534,COGS 234,A00,101431,Xia; Haijun,2,0,25,23
1668420635957,COGS 260,A00,101432,Kiyonaga; Anastasia,21,0,25,4
1668420635957,COGS 260,B00,101433,Kirsh; David Joel,15,0,25,10
1668420636398,CSE 202,A00,102371,Impagliazzo; Russell,0,30,0,0
1668420636832,CSE 203B,A01,102373,Cheng; Chung Kuan,0,24,0,0
1668420637261,CSE 208,A00,102374,Micciancio; Daniele,0,1,0,0
1668420637685,CSE 209A,A00,112895,Impagliazzo; Russell,0,3,15,15
1668420638112,CSE 209B,A00,108005,Bellare; Mihir,0,3,0,0
1668420638538,CSE 210,A00,113163,Coblenz; Michael J,0,41,0,0
1668420638966,CSE 219,A00,106111,Dow; Steven P,0,0,20,20
1668420639394,CSE 221,A00,102376,Voelker; Geoffrey M.,0,28,0,0
1668420639828,CSE 224,A01,102378,Porter; George M,0,102,0,0
1668420640255,CSE 229A,A00,102379,Savage; Stefan,0,4,0,0
1668420640684,CSE 229C,A00,102380,Munyaka; Imani N. S.,0,4,0,0
1668420641119,CSE 232B,A00,102382,Deutsch; Alin Bernard,0,13,0,0
1668420641548,CSE 234,A01,112904,Kumar; Arun Kumar,0,0,0,0
1668420641985,CSE 237A,A00,102383,Rosing; Tajana Simunic,0,24,0,0
1668420642413,CSE 239A,A00,102384,Deutsch; Alin Bernard,0,5,0,0
1668420642842,CSE 239B,A00,102385,Polikarpova; Nadezhda,0,3,0,0
1668420643267,CSE 240A,A00,102386,Pannuto; Patrick William,0,23,0,0
1668420643697,CSE 240B,A00,102387,Zhao; Jishen,0,23,0,0
1668420644122,CSE 241A,A00,106406,Kang; Mingu,0,2,0,0
1668420644556,CSE 249B,A00,102388,Kahng; Andrew Byun,0,1,8,8
1668420644990,CSE 251B,A01,102392,Cottrell; Garrison W,0,21,0,0
1668420644990,CSE 251B,A02,102393,Cottrell; Garrison W,0,21,0,0
1668420645417,CSE 252B,A00,102394,Ochoa; Benjamin Lawrence,0,35,0,0
1668420645845,CSE 257,A01,102396,Gao; Sicun,0,84,0,0
1668420646273,CSE 272,A00,102397,Li; Tzumao,0,7,0,0
1668420646698,CSE 274,A00,111323,Chern; Albert Ren-Haur,0,7,0,0
1668420647122,CSE 282,A00,102398,Pevzner; Pavel Arkadjevich,0,0,0,0
1668420647551,CSE 284,A00,114175,Gymrek; Melissa Ann,0,9,0,0
1668420647983,CSE 290,A00,102399,Chandraker; Manmohan Krishna,0,4,0,0
1668420647983,CSE 290,B00,102400,Vaccaro; Kristen Marie,0,1,25,25
1668420647983,CSE 290,C00,102414,Pannuto; Patrick William,0,1,25,25
1668420647983,CSE 290,D00,102427,Pevzner; Pavel Arkadjevich,0,0,0,0
1668420647983,CSE 290,E00,102429,Zhao; Jishen,0,1,0,0
1668420647983,CSE 290,F00,102436,Tullsen; Dean Michael,0,2,0,0
1668420647983,CSE 290,G00,102440,Christensen; Henrik I,0,3,20,20
1668420648436,CSE 291,A00,102443,Su; Hao,0,0,0,0
1668420648436,CSE 291,B00,102448,Polikarpova; Nadezhda,0,0,0,0
1668420648436,CSE 291,C00,102453,Vaccaro; Kristen Marie,0,0,0,0
1668420648436,CSE 291,D00,111343,Savage; Stefan,0,0,0,0
1668420648436,CSE 291,E00,116474,Claffy; Kimberly Claire,0,0,0,0
1668420648436,CSE 291,F00,116479,Pasquale; Joseph,0,0,0,0
1668420648903,CSE 293,001,119111,Bafna; Vineet,9999,0,9999,0
1668420648903,CSE 293,002,119118,Bellare; Mihir,9999,0,9999,0
1668420648903,CSE 293,003,119122,Berg-Kirkpatrick; Taylor D,9999,0,9999,0
1668420648903,CSE 293,004,119135,Christensen; Henrik I,9999,0,9999,0
1668420648903,CSE 293,005,119142,Cottrell; Garrison W,9999,0,9999,0
1668420648903,CSE 293,006,119146,Deutsch; Alin Bernard,9999,0,9999,0
1668420648903,CSE 293,007,119159,Esmaeilzadeh; Hadi,9999,0,9999,0
1668420648903,CSE 293,008,119166,Freund; Yoav,9999,0,9999,0
1668420648903,CSE 293,009,119170,Griswold; William G.,9999,0,9999,0
1668420648903,CSE 293,010,119183,Gymrek; Melissa Ann,9999,0,9999,0
1668420648903,CSE 293,011,119190,Heninger; Nadia A,9999,0,9999,0
1668420648903,CSE 293,012,119230,Impagliazzo; Russell,9999,0,9999,0
1668420648903,CSE 293,013,119232,Jhala; Ranjit,9999,0,9999,0
1668420648903,CSE 293,014,119233,Kahng; Andrew Byun,9999,0,9999,0
1668420648903,CSE 293,015,119298,Kane; Daniel Mertz,9999,0,9999,0
1668420648903,CSE 293,016,119299,Kriegman; David J,9999,0,9999,0
1668420648903,CSE 293,017,119300,Kumar; Arun Kumar,9999,0,9999,0
1668420648903,CSE 293,018,119301,Lerner; Sorin,9999,0,9999,0
1668420648903,CSE 293,019,119302,Lovett; Shachar,9999,0,9999,0
1668420648903,CSE 293,020,119303,McAuley; Julian John,9999,0,9999,0
1668420648903,CSE 293,021,119304,Micciancio; Daniele,9999,0,9999,0
1668420648903,CSE 293,022,119367,Orailoglu; Alex,9999,0,9999,0
1668420648903,CSE 293,023,119382,Paturi; Ramamohan,9999,0,9999,0
1668420648903,CSE 293,024,119404,Polikarpova; Nadezhda,9999,0,9999,0
1668420648903,CSE 293,025,119406,Politz; Joseph Gibbs,9999,0,9999,0
1668420648903,CSE 293,026,119411,Porter; George M,9999,0,9999,0
1668420648903,CSE 293,027,119414,Porter; Leonard Emerson,9999,0,9999,0
1668420648903,CSE 293,028,119416,Ramamoorthi; Ravi,9999,0,9999,0
1668420648903,CSE 293,029,119417,Sahoo; Debashis,9999,0,9999,0
1668420648903,CSE 293,030,119420,Saul; Lawrence,9999,0,9999,0
1668420648903,CSE 293,031,119421,Savage; Stefan,9999,0,9999,0
1668420648903,CSE 293,032,119425,Schulze; Jurgen P.,9999,0,9999,0
1668420648903,CSE 293,033,119426,Snoeren; Alex C.,9999,0,9999,0
1668420648903,CSE 293,034,119428,Shang; Jingbo,9999,0,9999,0
1668420648903,CSE 293,035,119430,Stefan; Deian,9999,0,9999,0
1668420648903,CSE 293,036,119431,Su; Hao,9999,0,9999,0
1668420648903,CSE 293,037,119433,Swanson; Steven James,9999,0,9999,0
1668420648903,CSE 293,038,119435,Tullsen; Dean Michael,9999,0,9999,0
1668420648903,CSE 293,039,119483,Voelker; Geoffrey M.,9999,0,9999,0
1668420648903,CSE 293,040,119537,Zhao; Jishen,9999,0,9999,0
1668420648903,CSE 293,041,119538,Zhou; Yuan-Yuan,9999,0,9999,0
1668420648903,CSE 293,042,119539,Gao; Sicun,9999,0,9999,0
1668420648903,CSE 293,043,119540,Weibel; Nadir,9999,0,9999,0
1668420648903,CSE 293,044,119541,Gupta; Rajesh K.,9999,0,9999,0
1668420648903,CSE 293,045,126410,Vaccaro; Kristen Marie,9999,0,9999,0
1668420648903,CSE 293,046,126411,Klemke; Richard,9999,0,9999,0
1668420649327,CSE 294,A00,102459,Voelker; Geoffrey M.,0,1,0,0
1668420649327,CSE 294,B00,111322,Orailoglu; Alex,0,0,0,0
1668420649753,DSE 201,A00,096914,Deutsch; Alin Bernard,30,0,30,0
1668420650179,DSE 210,A00,096915,Dasgupta; Sanjoy,30,0,30,0
1668420650607,DSE 260A,A00,096916,Altintas De Callaf; Ilkay,30,0,30,0
1668420651126,ECE 200,001,103586,Antipa; Nicholas A,9999,0,9999,0
1668420651126,ECE 200,002,103587,Atanasov; Nikolay A.,9999,0,9999,0
1668420651126,ECE 200,003,103588,Bharadia; Dinesh,9999,0,9999,0
1668420651126,ECE 200,004,103589,Cheng; Chung Kuan,9999,0,9999,0
1668420651126,ECE 200,005,103590,Cosman; Pamela C.,9999,0,9999,0
1668420651126,ECE 200,006,103591,Dayeh; Shadi Ahmad,9999,0,9999,0
1668420651126,ECE 200,007,103592,Fainman; Yeshaiahu,9999,0,9999,0
1668420651126,ECE 200,008,103593,Ford; Joseph Earl,9999,0,9999,0
1668420651126,ECE 200,009,103594,Franceschetti; Massimo,9999,0,9999,0
1668420651126,ECE 200,010,103595,Fullerton; Eric E,9999,0,9999,0
1668420651126,ECE 200,011,103596,Galton; Ian A,9999,0,9999,0
1668420651126,ECE 200,012,103597,Gilja; Vikash,9999,0,9999,0
1668420651126,ECE 200,013,103598,Hall; Drew A.,9999,0,9999,0
1668420651126,ECE 200,014,103599,Hsueh; Tzu-Chien,9999,0,9999,0
1668420651126,ECE 200,015,103600,Javidi; Tara,9999,0,9999,0
1668420651126,ECE 200,016,103601,Kahng; Andrew Byun,9999,0,9999,0
1668420651126,ECE 200,017,103602,Kim; Young-Han,9999,0,9999,0
1668420651126,ECE 200,018,103603,Koushanfar; Farinaz,9999,0,9999,0
1668420651126,ECE 200,019,103604,Kuzum; Duygu,9999,0,9999,0
1668420651126,ECE 200,020,103605,Le; Hanh-Phuc,9999,0,9999,0
1668420651126,ECE 200,021,103606,Lin; Bill,9999,0,9999,0
1668420651126,ECE 200,022,103607,Liu; Zhaowei,9998,0,9999,1
1668420651126,ECE 200,023,103608,Lo; Yu-Hwa,9999,0,9999,0
1668420651126,ECE 200,024,103609,Lomakin; Vitaliy,9999,0,9999,0
1668420651126,ECE 200,025,103610,Mercier; Patrick Philip,9999,0,9999,0
1668420651126,ECE 200,026,103611,Meyer; Florian,9999,0,9999,0
1668420651126,ECE 200,027,103612,Milstein; Laurence B.,9999,0,9999,0
1668420651126,ECE 200,028,103613,Mir Arabbaygi; Siavash,9999,0,9999,0
1668420651126,ECE 200,029,103614,Mookherjea; Shayan,9999,0,9999,0
1668420651126,ECE 200,030,103615,Morris; Karcher William,9999,0,9999,0
1668420651126,ECE 200,031,103616,Ng; Tse Nga,9999,0,9999,0
1668420651126,ECE 200,032,103617,Nguyen; Truong Quang,9999,0,9999,0
1668420651126,ECE 200,033,103618,Nomura; Kenji,9999,0,9999,0
1668420651126,ECE 200,034,103619,Orlitsky; Alon,9999,0,9999,0
1668420651126,ECE 200,035,103620,Pal; Piya,9999,0,9999,0
1668420651126,ECE 200,036,103621,Papen; George C.,9999,0,9999,0
1668420651126,ECE 200,037,103622,Radic; Stojan,9999,0,9999,0
1668420651126,ECE 200,038,103623,Rao; Bhaskar D.,9999,0,9999,0
1668420651126,ECE 200,039,103624,Rao; Ramesh R,9999,0,9999,0
1668420651126,ECE 200,040,103625,Rebeiz; Gabriel,9999,0,9999,0
1668420651126,ECE 200,041,103626,Sanford; John R,9999,0,9999,0
1668420651126,ECE 200,042,103627,Siegel; Paul H.,9999,0,9999,0
1668420651126,ECE 200,043,103628,Sievenpiper; Daniel F.,9999,0,9999,0
1668420651126,ECE 200,044,103629,Sworder; David D.,9999,0,9999,0
1668420651126,ECE 200,045,103630,Taur; Yuan,9999,0,9999,0
1668420651126,ECE 200,046,103631,Touri; Behrouz,9999,0,9999,0
1668420651126,ECE 200,047,103632,Trivedi; Mohan M.,9999,0,9999,0
1668420651126,ECE 200,048,103633,Vasconcelos; Nuno,9999,0,9999,0
1668420651126,ECE 200,049,103634,Wang; Xiaolong,9999,0,9999,0
1668420651126,ECE 200,050,103635,Xie; Pengtao,9999,0,9999,0
1668420651126,ECE 200,051,103636,Yip; Michael,9999,0,9999,0
1668420651126,ECE 200,052,103637,Zeger; Kenneth A.,999,0,999,0
1668420651126,ECE 200,053,103638,Zhang; Xinyu,9999,0,9999,0
1668420651126,ECE 200,054,103639,Turakhia; Yatish Girish,9999,0,9999,0
1668420651126,ECE 200,055,103640,Kang; Mingu,9999,0,9999,0
1668420651126,ECE 200,056,103641,Shi; Yuanyuan,9999,0,9999,0
1668420651126,ECE 200,057,103642,Wang; Edward Jay,9999,0,9999,0
1668420651126,ECE 200,058,103643,Zheng; Yang,9999,0,9999,0
1668420651556,ECE 202,A00,103644,Kuzum; Duygu,0,21,0,0
1668420651983,ECE 212BN,A00,103646,Ng; Tse Nga,0,1,0,0
1668420652417,ECE 221,A00,111493,Staff,0,0,0,0
1668420652844,ECE 222B,A00,103647,Lomakin; Vitaliy,0,5,0,0
1668420653273,ECE 230B,A00,103648,Taur; Yuan,0,0,0,0
1668420653700,ECE 238B,A00,103649,Garay; Javier,0,0,0,0
1668420654126,ECE 240B,A00,112900,Fainman; Yeshaiahu,0,4,0,0
1668420654552,ECE 247A,A00,103650,Jokerst; Jesse Vincent,0,1,0,0
1668420654979,ECE 247B,A00,103651,Wang; Joseph,0,4,0,0
1668420655412,ECE 250,A00,103652,Siegel; Paul H.,0,42,0,0
1668420655842,ECE 251A,A00,103654,Rao; Bhaskar D.,0,28,0,0
1668420656269,ECE 257B,A00,103655,Bharadia; Dinesh,0,11,0,0
1668420656695,ECE 258A,A00,103656,Milstein; Laurence B.,0,10,0,0
1668420657129,ECE 260B,A00,103658,Kang; Mingu,0,64,0,0
1668420657557,ECE 264A,A00,103659,Galton; Ian A,0,31,0,0
1668420657990,ECE 265A,A00,103661,Gudem; Prasad S.S.,0,16,0,0
1668420658418,ECE 265D,A00,103662,Gudem; Prasad S.S.,0,10,0,0
1668420658842,ECE 268,A00,103663,Koushanfar; Farinaz,0,18,0,0
1668420659348,ECE 269,A01,103665,Pal; Piya,0,122,0,0
1668420659778,ECE 271B,A00,103666,Vasconcelos; Manuela,0,45,0,0
1668420660201,ECE 276A,A00,103667,Atanasov; Nikolay A.,0,65,0,0
1668420660625,ECE 277,A00,103668,An; Cheolhong,0,86,0,0
1668420661049,ECE 279,A00,117947,Hall; Drew A.,0,11,0,0
1668420661905,ECE 283,A00,103670,Hsueh; Tzu-Chien,0,21,0,0
1668420662338,ECE 284,A00,103671,Turakhia; Yatish Girish,0,22,0,0
1668420662763,ECE 285,A00,103672,Zheng; Yang,0,22,0,0
1668420662763,ECE 285,B00,103673,Sworder; David D.,0,36,0,0
1668420663187,ECE 287,A00,103676,Javidi; Tara,0,4,0,0
1668420663612,MATH 200B,A00,098023,Salehi Golsefidy; Alireza,12,0,15,3
1668420664038,MATH 202B,A00,098024,Rhoades; Brendon Patrick,9,0,15,6
1668420664475,MATH 203B,A00,098025,Oprea; Dragos N.,10,0,15,5
1668420664908,MATH 204B,A00,098026,Sorensen; Claus M,13,0,15,2
1668420665333,MATH 208,A00,098027,Izadi; Elham,7,0,10,3
1668420665761,MATH 209,A00,098028,Pollack; Aaron,10,0,10,0
1668420666203,MATH 211A,A00,112919,Rogalski; Daniel,9,0,10,1
1668420666627,MATH 211B,A00,112920,Seward; Brandon M.,9,0,10,1
1668420667051,MATH 218,A00,098029,Li; Bo,10,0,10,0
1668420667476,MATH 220B,A00,098030,Novak; Jonathan I,11,0,15,4
1668420667900,MATH 221A,A00,098031,Ebenfelt; Peter F,13,0,15,2
1668420668325,MATH 231B,A00,098032,Zlatos; Andrej,12,0,15,3
1668420668751,MATH 240B,A00,098033,Ni; Lei,9,0,15,6
1668420669176,MATH 243,A00,098034,Jekel; David Andrew,10,0,10,0
1668420669601,MATH 245A,A00,098035,Nie; Jiawang,0,1,15,16
1668420670026,MATH 248,A00,098036,Bejenaru; Ioan,10,0,10,0
1668420670460,MATH 250B,A00,098037,Spolaor; Luca,14,0,15,1
1668420670884,MATH 258,A00,098038,Ni; Lei,10,0,10,0
1668420671308,MATH 264B,A00,098041,Rhoades; Brendon Patrick,9,0,15,6
1668420671733,MATH 268,A00,098042,Buss; Samuel R,10,0,10,0
1668420672161,MATH 269,A00,098043,Rhoades; Brendon Patrick,10,0,10,0
1668420672588,MATH 270B,A00,098044,Li; Bo,10,0,15,5
1668420673013,MATH 272B,A00,098045,Holst; Michael J,13,0,15,2
1668420673446,MATH 273A,A00,098046,Tian; Xiaochuan,10,0,15,5
1668420673875,MATH 275,A01,098048,Tian; Xiaochuan,6,0,10,4
1668420674303,MATH 278A,A00,098049,Holst; Michael J,8,0,10,2
1668420674738,MATH 278B,A00,098050,Cloninger; Alexander,10,0,10,0
1668420675161,MATH 278C,A00,098051,Nie; Jiawang,6,0,10,4
1668420675587,MATH 280B,A00,098052,Zheng; Tianyi,8,0,15,7
1668420676015,MATH 281B,A00,098053,Bradic; Jelena,0,1,15,15
1668420676441,MATH 282B,A00,098054,Arias-Castro; Ery,0,0,15,15
1668420676870,MATH 285,A00,098055,Fitzsimmons; Patrick J,0,0,15,17
1668420677308,MATH 287B,A00,098056,Arias-Castro; Ery,2,0,15,13
1668420677733,MATH 288,A00,098057,Agarwal; Pooja,9,0,10,1
1668420677733,MATH 288,B00,098058,Zhang; Danna,8,0,10,2
1668420677733,MATH 288,C00,098059,Williams; Ruth J,9,0,10,1
1668420678161,MATH 290B,A00,098060,Roberts; Justin Deritter,13,0,15,2
1668420678584,MATH 292,A00,098061,Belmont; Eva Kinoshita,10,0,10,0
1668420679008,MATH 295,A00,098062,Suk; Andrew Hoon,48,0,50,2
1668420679432,MATH 296,A00,098063,Novak; Jonathan I,20,0,20,0
1668420679856,MATH 297,001,098064,Gamst; Anthony Collins,9997,0,9999,2
1668421184261,COGS 205,A00,101395,Chiba; Andrea,19,0,20,1
1668421184717,COGS 210B,001,101404,Greene; Deanna Jacquelyn,9998,0,9999,1
1668421184717,COGS 210B,002,101417,Xia; Haijun,9999,0,9999,0
1668421184717,COGS 210B,003,101422,Nitz; Douglas A.,9999,0,9999,0
1668421184717,COGS 210B,004,101423,Hollan; James D.,9998,0,9999,1
1668421184717,COGS 210B,005,101424,Deak; Gedeon O.,9998,0,9999,1
1668421184717,COGS 210B,006,101425,Rossano; Federico,9999,0,9999,0
1668421185161,COGS 211B,A00,101427,Coulson; Seana M,9996,0,9999,3
1668421185586,COGS 220,A00,101428,Hollan; James D.,1,2,25,24
1668421186014,COGS 229,A00,101429,Dow; Steven P,18,0,25,7
1668421186438,COGS 230,A00,101430,Klemmer; Scott R,11,0,17,6
1668421186864,COGS 234,A00,101431,Xia; Haijun,2,0,25,23
1668421187289,COGS 260,A00,101432,Kiyonaga; Anastasia,21,0,25,4
1668421187289,COGS 260,B00,101433,Kirsh; David Joel,15,0,25,10
1668421187714,CSE 202,A00,102371,Impagliazzo; Russell,0,30,0,0
1668421188144,CSE 203B,A01,102373,Cheng; Chung Kuan,0,24,0,0
1668421188567,CSE 208,A00,102374,Micciancio; Daniele,0,1,0,0
1668421188993,CSE 209A,A00,112895,Impagliazzo; Russell,0,3,15,15
1668421189419,CSE 209B,A00,108005,Bellare; Mihir,0,3,0,0
1668421189849,CSE 210,A00,113163,Coblenz; Michael J,0,41,0,0
1668421190273,CSE 219,A00,106111,Dow; Steven P,0,0,20,20
1668421190701,CSE 221,A00,102376,Voelker; Geoffrey M.,0,28,0,0
1668421191139,CSE 224,A01,102378,Porter; George M,0,102,0,0
1668421191566,CSE 229A,A00,102379,Savage; Stefan,0,4,0,0
1668421191998,CSE 229C,A00,102380,Munyaka; Imani N. S.,0,4,0,0
1668421192427,CSE 232B,A00,102382,Deutsch; Alin Bernard,0,13,0,0
1668421192854,CSE 234,A01,112904,Kumar; Arun Kumar,0,0,0,0
1668421193279,CSE 237A,A00,102383,Rosing; Tajana Simunic,0,24,0,0
1668421193714,CSE 239A,A00,102384,Deutsch; Alin Bernard,0,5,0,0
1668421194142,CSE 239B,A00,102385,Polikarpova; Nadezhda,0,3,0,0
1668421194567,CSE 240A,A00,102386,Pannuto; Patrick William,0,23,0,0
1668421194990,CSE 240B,A00,102387,Zhao; Jishen,0,23,0,0
1668421195417,CSE 241A,A00,106406,Kang; Mingu,0,2,0,0
1668421195847,CSE 249B,A00,102388,Kahng; Andrew Byun,0,1,8,8
1668421196272,CSE 251B,A01,102392,Cottrell; Garrison W,0,21,0,0
1668421196272,CSE 251B,A02,102393,Cottrell; Garrison W,0,21,0,0
1668421196697,CSE 252B,A00,102394,Ochoa; Benjamin Lawrence,0,35,0,0
1668421197123,CSE 257,A01,102396,Gao; Sicun,0,84,0,0
1668421197569,CSE 272,A00,102397,Li; Tzumao,0,7,0,0
1668421198004,CSE 274,A00,111323,Chern; Albert Ren-Haur,0,7,0,0
1668421198435,CSE 282,A00,102398,Pevzner; Pavel Arkadjevich,0,0,0,0
1668421198872,CSE 284,A00,114175,Gymrek; Melissa Ann,0,9,0,0
1668421199320,CSE 290,A00,102399,Chandraker; Manmohan Krishna,0,4,0,0
1668421199320,CSE 290,B00,102400,Vaccaro; Kristen Marie,0,1,25,25
1668421199320,CSE 290,C00,102414,Pannuto; Patrick William,0,1,25,25
1668421199320,CSE 290,D00,102427,Pevzner; Pavel Arkadjevich,0,0,0,0
1668421199320,CSE 290,E00,102429,Zhao; Jishen,0,1,0,0
1668421199320,CSE 290,F00,102436,Tullsen; Dean Michael,0,2,0,0
1668421199320,CSE 290,G00,102440,Christensen; Henrik I,0,3,20,20
1668421199753,CSE 291,A00,102443,Su; Hao,0,0,0,0
1668421199753,CSE 291,B00,102448,Polikarpova; Nadezhda,0,0,0,0
1668421199753,CSE 291,C00,102453,Vaccaro; Kristen Marie,0,0,0,0
1668421199753,CSE 291,D00,111343,Savage; Stefan,0,0,0,0
1668421199753,CSE 291,E00,116474,Claffy; Kimberly Claire,0,0,0,0
1668421199753,CSE 291,F00,116479,Pasquale; Joseph,0,0,0,0
1668421200199,CSE 293,001,119111,Bafna; Vineet,9999,0,9999,0
1668421200199,CSE 293,002,119118,Bellare; Mihir,9999,0,9999,0
1668421200199,CSE 293,003,119122,Berg-Kirkpatrick; Taylor D,9999,0,9999,0
1668421200199,CSE 293,004,119135,Christensen; Henrik I,9999,0,9999,0
1668421200199,CSE 293,005,119142,Cottrell; Garrison W,9999,0,9999,0
1668421200199,CSE 293,006,119146,Deutsch; Alin Bernard,9999,0,9999,0
1668421200199,CSE 293,007,119159,Esmaeilzadeh; Hadi,9999,0,9999,0
1668421200199,CSE 293,008,119166,Freund; Yoav,9999,0,9999,0
1668421200199,CSE 293,009,119170,Griswold; William G.,9999,0,9999,0
1668421200199,CSE 293,010,119183,Gymrek; Melissa Ann,9999,0,9999,0
1668421200199,CSE 293,011,119190,Heninger; Nadia A,9999,0,9999,0
1668421200199,CSE 293,012,119230,Impagliazzo; Russell,9999,0,9999,0
1668421200199,CSE 293,013,119232,Jhala; Ranjit,9999,0,9999,0
1668421200199,CSE 293,014,119233,Kahng; Andrew Byun,9999,0,9999,0
1668421200199,CSE 293,015,119298,Kane; Daniel Mertz,9999,0,9999,0
1668421200199,CSE 293,016,119299,Kriegman; David J,9999,0,9999,0
1668421200199,CSE 293,017,119300,Kumar; Arun Kumar,9999,0,9999,0
1668421200199,CSE 293,018,119301,Lerner; Sorin,9999,0,9999,0
1668421200199,CSE 293,019,119302,Lovett; Shachar,9999,0,9999,0
1668421200199,CSE 293,020,119303,McAuley; Julian John,9999,0,9999,0
1668421200199,CSE 293,021,119304,Micciancio; Daniele,9999,0,9999,0
1668421200199,CSE 293,022,119367,Orailoglu; Alex,9999,0,9999,0
1668421200199,CSE 293,023,119382,Paturi; Ramamohan,9999,0,9999,0
1668421200199,CSE 293,024,119404,Polikarpova; Nadezhda,9999,0,9999,0
1668421200199,CSE 293,025,119406,Politz; Joseph Gibbs,9999,0,9999,0
1668421200199,CSE 293,026,119411,Porter; George M,9999,0,9999,0
1668421200199,CSE 293,027,119414,Porter; Leonard Emerson,9999,0,9999,0
1668421200199,CSE 293,028,119416,Ramamoorthi; Ravi,9999,0,9999,0
1668421200199,CSE 293,029,119417,Sahoo; Debashis,9999,0,9999,0
1668421200199,CSE 293,030,119420,Saul; Lawrence,9999,0,9999,0
1668421200199,CSE 293,031,119421,Savage; Stefan,9999,0,9999,0
1668421200199,CSE 293,032,119425,Schulze; Jurgen P.,9999,0,9999,0
1668421200199,CSE 293,033,119426,Snoeren; Alex C.,9999,0,9999,0
1668421200199,CSE 293,034,119428,Shang; Jingbo,9999,0,9999,0
1668421200199,CSE 293,035,119430,Stefan; Deian,9999,0,9999,0
1668421200199,CSE 293,036,119431,Su; Hao,9999,0,9999,0
1668421200199,CSE 293,037,119433,Swanson; Steven James,9999,0,9999,0
1668421200199,CSE 293,038,119435,Tullsen; Dean Michael,9999,0,9999,0
1668421200199,CSE 293,039,119483,Voelker; Geoffrey M.,9999,0,9999,0
1668421200199,CSE 293,040,119537,Zhao; Jishen,9999,0,9999,0
1668421200199,CSE 293,041,119538,Zhou; Yuan-Yuan,9999,0,9999,0
1668421200199,CSE 293,042,119539,Gao; Sicun,9999,0,9999,0
1668421200199,CSE 293,043,119540,Weibel; Nadir,9999,0,9999,0
1668421200199,CSE 293,044,119541,Gupta; Rajesh K.,9999,0,9999,0
1668421200199,CSE 293,045,126410,Vaccaro; Kristen Marie,9999,0,9999,0
1668421200199,CSE 293,046,126411,Klemke; Richard,9999,0,9999,0
1668421200635,CSE 294,A00,102459,Voelker; Geoffrey M.,0,1,0,0
1668421200635,CSE 294,B00,111322,Orailoglu; Alex,0,0,0,0
1668421201065,DSE 201,A00,096914,Deutsch; Alin Bernard,30,0,30,0
1668421201502,DSE 210,A00,096915,Dasgupta; Sanjoy,30,0,30,0
1668421201933,DSE 260A,A00,096916,Altintas De Callaf; Ilkay,30,0,30,0
1668421202381,ECE 200,001,103586,Antipa; Nicholas A,9999,0,9999,0
1668421202381,ECE 200,002,103587,Atanasov; Nikolay A.,9999,0,9999,0
1668421202381,ECE 200,003,103588,Bharadia; Dinesh,9999,0,9999,0
1668421202381,ECE 200,004,103589,Cheng; Chung Kuan,9999,0,9999,0
1668421202381,ECE 200,005,103590,Cosman; Pamela C.,9999,0,9999,0
1668421202381,ECE 200,006,103591,Dayeh; Shadi Ahmad,9999,0,9999,0
1668421202381,ECE 200,007,103592,Fainman; Yeshaiahu,9999,0,9999,0
1668421202381,ECE 200,008,103593,Ford; Joseph Earl,9999,0,9999,0
1668421202381,ECE 200,009,103594,Franceschetti; Massimo,9999,0,9999,0
1668421202381,ECE 200,010,103595,Fullerton; Eric E,9999,0,9999,0
1668421202381,ECE 200,011,103596,Galton; Ian A,9999,0,9999,0
1668421202381,ECE 200,012,103597,Gilja; Vikash,9999,0,9999,0
1668421202381,ECE 200,013,103598,Hall; Drew A.,9999,0,9999,0
1668421202381,ECE 200,014,103599,Hsueh; Tzu-Chien,9999,0,9999,0
1668421202381,ECE 200,015,103600,Javidi; Tara,9999,0,9999,0
1668421202381,ECE 200,016,103601,Kahng; Andrew Byun,9999,0,9999,0
1668421202381,ECE 200,017,103602,Kim; Young-Han,9999,0,9999,0
1668421202381,ECE 200,018,103603,Koushanfar; Farinaz,9999,0,9999,0
1668421202381,ECE 200,019,103604,Kuzum; Duygu,9999,0,9999,0
1668421202381,ECE 200,020,103605,Le; Hanh-Phuc,9999,0,9999,0
1668421202381,ECE 200,021,103606,Lin; Bill,9999,0,9999,0
1668421202381,ECE 200,022,103607,Liu; Zhaowei,9998,0,9999,1
1668421202381,ECE 200,023,103608,Lo; Yu-Hwa,9999,0,9999,0
1668421202381,ECE 200,024,103609,Lomakin; Vitaliy,9999,0,9999,0
1668421202381,ECE 200,025,103610,Mercier; Patrick Philip,9999,0,9999,0
1668421202381,ECE 200,026,103611,Meyer; Florian,9999,0,9999,0
1668421202381,ECE 200,027,103612,Milstein; Laurence B.,9999,0,9999,0
1668421202381,ECE 200,028,103613,Mir Arabbaygi; Siavash,9999,0,9999,0
1668421202381,ECE 200,029,103614,Mookherjea; Shayan,9999,0,9999,0
1668421202381,ECE 200,030,103615,Morris; Karcher William,9999,0,9999,0
1668421202381,ECE 200,031,103616,Ng; Tse Nga,9999,0,9999,0
1668421202381,ECE 200,032,103617,Nguyen; Truong Quang,9999,0,9999,0
1668421202381,ECE 200,033,103618,Nomura; Kenji,9999,0,9999,0
1668421202381,ECE 200,034,103619,Orlitsky; Alon,9999,0,9999,0
1668421202381,ECE 200,035,103620,Pal; Piya,9999,0,9999,0
1668421202381,ECE 200,036,103621,Papen; George C.,9999,0,9999,0
1668421202381,ECE 200,037,103622,Radic; Stojan,9999,0,9999,0
1668421202381,ECE 200,038,103623,Rao; Bhaskar D.,9999,0,9999,0
1668421202381,ECE 200,039,103624,Rao; Ramesh R,9999,0,9999,0
1668421202381,ECE 200,040,103625,Rebeiz; Gabriel,9999,0,9999,0
1668421202381,ECE 200,041,103626,Sanford; John R,9999,0,9999,0
1668421202381,ECE 200,042,103627,Siegel; Paul H.,9999,0,9999,0
1668421202381,ECE 200,043,103628,Sievenpiper; Daniel F.,9999,0,9999,0
1668421202381,ECE 200,044,103629,Sworder; David D.,9999,0,9999,0
1668421202381,ECE 200,045,103630,Taur; Yuan,9999,0,9999,0
1668421202381,ECE 200,046,103631,Touri; Behrouz,9999,0,9999,0
1668421202381,ECE 200,047,103632,Trivedi; Mohan M.,9999,0,9999,0
1668421202381,ECE 200,048,103633,Vasconcelos; Nuno,9999,0,9999,0
1668421202381,ECE 200,049,103634,Wang; Xiaolong,9999,0,9999,0
1668421202381,ECE 200,050,103635,Xie; Pengtao,9999,0,9999,0
1668421202381,ECE 200,051,103636,Yip; Michael,9999,0,9999,0
1668421202381,ECE 200,052,103637,Zeger; Kenneth A.,999,0,999,0
1668421202381,ECE 200,053,103638,Zhang; Xinyu,9999,0,9999,0
1668421202381,ECE 200,054,103639,Turakhia; Yatish Girish,9999,0,9999,0
1668421202381,ECE 200,055,103640,Kang; Mingu,9999,0,9999,0
1668421202381,ECE 200,056,103641,Shi; Yuanyuan,9999,0,9999,0
1668421202381,ECE 200,057,103642,Wang; Edward Jay,9999,0,9999,0
1668421202381,ECE 200,058,103643,Zheng; Yang,9999,0,9999,0
1668421202807,ECE 202,A00,103644,Kuzum; Duygu,0,21,0,0
1668421203232,ECE 212BN,A00,103646,Ng; Tse Nga,0,1,0,0
1668421203661,ECE 221,A00,111493,Staff,0,0,0,0
1668421204085,ECE 222B,A00,103647,Lomakin; Vitaliy,0,5,0,0
1668421204513,ECE 230B,A00,103648,Taur; Yuan,0,0,0,0
1668421204946,ECE 238B,A00,103649,Garay; Javier,0,0,0,0
1668421205374,ECE 240B,A00,112900,Fainman; Yeshaiahu,0,4,0,0
1668421205798,ECE 247A,A00,103650,Jokerst; Jesse Vincent,0,1,0,0
1668421206228,ECE 247B,A00,103651,Wang; Joseph,0,4,0,0
1668421206654,ECE 250,A00,103652,Siegel; Paul H.,0,42,0,0
1668421207079,ECE 251A,A00,103654,Rao; Bhaskar D.,0,28,0,0
1668421207503,ECE 257B,A00,103655,Bharadia; Dinesh,0,11,0,0
1668421207930,ECE 258A,A00,103656,Milstein; Laurence B.,0,10,0,0
1668421208363,ECE 260B,A00,103658,Kang; Mingu,0,64,0,0
1668421208795,ECE 264A,A00,103659,Galton; Ian A,0,31,0,0
1668421209221,ECE 265A,A00,103661,Gudem; Prasad S.S.,0,16,0,0
1668421209645,ECE 265D,A00,103662,Gudem; Prasad S.S.,0,10,0,0
1668421210086,ECE 268,A00,103663,Koushanfar; Farinaz,0,18,0,0
1668421210510,ECE 269,A01,103665,Pal; Piya,0,123,0,0
1668421210952,ECE 271B,A00,103666,Vasconcelos; Manuela,0,46,0,0
1668421211397,ECE 276A,A00,103667,Atanasov; Nikolay A.,0,66,0,0
1668421211838,ECE 277,A00,103668,An; Cheolhong,0,86,0,0
1668421212275,ECE 279,A00,117947,Hall; Drew A.,0,11,0,0
1668421213136,ECE 283,A00,103670,Hsueh; Tzu-Chien,0,21,0,0
1668421213559,ECE 284,A00,103671,Turakhia; Yatish Girish,0,22,0,0
1668421213984,ECE 285,A00,103672,Zheng; Yang,0,22,0,0
1668421213984,ECE 285,B00,103673,Sworder; David D.,0,36,0,0
1668421214412,ECE 287,A00,103676,Javidi; Tara,0,4,0,0
1668421214841,MATH 200B,A00,098023,Salehi Golsefidy; Alireza,12,0,15,3
1668421215267,MATH 202B,A00,098024,Rhoades; Brendon Patrick,9,0,15,6
1668421215694,MATH 203B,A00,098025,Oprea; Dragos N.,10,0,15,5
1668421216123,MATH 204B,A00,098026,Sorensen; Claus M,13,0,15,2
1668421216551,MATH 208,A00,098027,Izadi; Elham,7,0,10,3
1668421216979,MATH 209,A00,098028,Pollack; Aaron,10,0,10,0
1668421217417,MATH 211A,A00,112919,Rogalski; Daniel,9,0,10,1
1668421217844,MATH 211B,A00,112920,Seward; Brandon M.,9,0,10,1
1668421218278,MATH 218,A00,098029,Li; Bo,10,0,10,0
1668421218716,MATH 220B,A00,098030,Novak; Jonathan I,11,0,15,4
1668421219140,MATH 221A,A00,098031,Ebenfelt; Peter F,13,0,15,2
1668421219565,MATH 231B,A00,098032,Zlatos; Andrej,12,0,15,3
1668421219998,MATH 240B,A00,098033,Ni; Lei,9,0,15,6
1668421220424,MATH 243,A00,098034,Jekel; David Andrew,10,0,10,0
1668421220852,MATH 245A,A00,098035,Nie; Jiawang,0,1,15,16
1668421221278,MATH 248,A00,098036,Bejenaru; Ioan,10,0,10,0
1668421221702,MATH 250B,A00,098037,Spolaor; Luca,14,0,15,1
1668421222132,MATH 258,A00,098038,Ni; Lei,10,0,10,0
1668421222567,MATH 264B,A00,098041,Rhoades; Brendon Patrick,9,0,15,6
1668421222997,MATH 268,A00,098042,Buss; Samuel R,10,0,10,0
1668421223424,MATH 269,A00,098043,Rhoades; Brendon Patrick,10,0,10,0
1668421223847,MATH 270B,A00,098044,Li; Bo,10,0,15,5
1668421224289,MATH 272B,A00,098045,Holst; Michael J,13,0,15,2
1668421224713,MATH 273A,A00,098046,Tian; Xiaochuan,10,0,15,5
1668421225149,MATH 275,A01,098048,Tian; Xiaochuan,6,0,10,4
1668421225577,MATH 278A,A00,098049,Holst; Michael J,8,0,10,2
1668421226000,MATH 278B,A00,098050,Cloninger; Alexander,10,0,10,0
1668421226436,MATH 278C,A00,098051,Nie; Jiawang,6,0,10,4
1668421226861,MATH 280B,A00,098052,Zheng; Tianyi,8,0,15,7
1668421227375,MATH 281B,A00,098053,Bradic; Jelena,0,1,15,15
1668421227802,MATH 282B,A00,098054,Arias-Castro; Ery,0,0,15,15
1668421228231,MATH 285,A00,098055,Fitzsimmons; Patrick J,0,0,15,17
1668421228656,MATH 287B,A00,098056,Arias-Castro; Ery,2,0,15,13
1668421229081,MATH 288,A00,098057,Agarwal; Pooja,9,0,10,1
1668421229081,MATH 288,B00,098058,Zhang; Danna,8,0,10,2
1668421229081,MATH 288,C00,098059,Williams; Ruth J,9,0,10,1
1668421229507,MATH 290B,A00,098060,Roberts; Justin Deritter,13,0,15,2
1668421229932,MATH 292,A00,098061,Belmont; Eva Kinoshita,10,0,10,0
1668421230359,MATH 295,A00,098062,Suk; Andrew Hoon,48,0,50,2
1668421230784,MATH 296,A00,098063,Novak; Jonathan I,20,0,20,0
1668421231207,MATH 297,001,098064,Gamst; Anthony Collins,9997,0,9999,2
1668421733974,COGS 205,A00,101395,Chiba; Andrea,19,0,20,1
1668421734398,COGS 210B,001,101404,Greene; Deanna Jacquelyn,9998,0,9999,1
1668421734398,COGS 210B,002,101417,Xia; Haijun,9999,0,9999,0
1668421734398,COGS 210B,003,101422,Nitz; Douglas A.,9999,0,9999,0
1668421734398,COGS 210B,004,101423,Hollan; James D.,9998,0,9999,1
1668421734398,COGS 210B,005,101424,Deak; Gedeon O.,9998,0,9999,1
1668421734398,COGS 210B,006,101425,Rossano; Federico,9999,0,9999,0
1668421734822,COGS 211B,A00,101427,Coulson; Seana M,9996,0,9999,3
1668421735252,COGS 220,A00,101428,Hollan; James D.,1,2,25,24
1668421735681,COGS 229,A00,101429,Dow; Steven P,18,0,25,7
1668421736113,COGS 230,A00,101430,Klemmer; Scott R,11,0,17,6
1668421736538,COGS 234,A00,101431,Xia; Haijun,2,0,25,23
1668421736966,COGS 260,A00,101432,Kiyonaga; Anastasia,21,0,25,4
1668421736966,COGS 260,B00,101433,Kirsh; David Joel,15,0,25,10
1668421737390,CSE 202,A00,102371,Impagliazzo; Russell,0,30,0,0
1668421737816,CSE 203B,A01,102373,Cheng; Chung Kuan,0,24,0,0
1668421738239,CSE 208,A00,102374,Micciancio; Daniele,0,1,0,0
1668421738666,CSE 209A,A00,112895,Impagliazzo; Russell,0,3,15,15
1668421739094,CSE 209B,A00,108005,Bellare; Mihir,0,3,0,0
1668421739518,CSE 210,A00,113163,Coblenz; Michael J,0,40,0,0
1668421739943,CSE 219,A00,106111,Dow; Steven P,0,0,20,20
1668421740368,CSE 221,A00,102376,Voelker; Geoffrey M.,0,28,0,0
1668421740797,CSE 224,A01,102378,Porter; George M,0,102,0,0
1668421741221,CSE 229A,A00,102379,Savage; Stefan,0,4,0,0
1668421741645,CSE 229C,A00,102380,Munyaka; Imani N. S.,0,4,0,0
1668421742070,CSE 232B,A00,102382,Deutsch; Alin Bernard,0,13,0,0
1668421742497,CSE 234,A01,112904,Kumar; Arun Kumar,0,0,0,0
1668421742921,CSE 237A,A00,102383,Rosing; Tajana Simunic,0,24,0,0
1668421743346,CSE 239A,A00,102384,Deutsch; Alin Bernard,0,5,0,0
1668421743780,CSE 239B,A00,102385,Polikarpova; Nadezhda,0,3,0,0
1668421744207,CSE 240A,A00,102386,Pannuto; Patrick William,0,23,0,0
1668421744641,CSE 240B,A00,102387,Zhao; Jishen,0,23,0,0
1668421745064,CSE 241A,A00,106406,Kang; Mingu,0,2,0,0
1668421745498,CSE 249B,A00,102388,Kahng; Andrew Byun,0,1,8,8
1668421745920,CSE 251B,A01,102392,Cottrell; Garrison W,0,21,0,0
1668421745920,CSE 251B,A02,102393,Cottrell; Garrison W,0,21,0,0
1668421746344,CSE 252B,A00,102394,Ochoa; Benjamin Lawrence,0,35,0,0
1668421746770,CSE 257,A01,102396,Gao; Sicun,0,84,0,0
1668421747197,CSE 272,A00,102397,Li; Tzumao,0,7,0,0
1668421747620,CSE 274,A00,111323,Chern; Albert Ren-Haur,0,7,0,0
1668421748047,CSE 282,A00,102398,Pevzner; Pavel Arkadjevich,0,0,0,0
1668421748477,CSE 284,A00,114175,Gymrek; Melissa Ann,0,9,0,0
1668421748905,CSE 290,A00,102399,Chandraker; Manmohan Krishna,0,4,0,0
1668421748905,CSE 290,B00,102400,Vaccaro; Kristen Marie,0,1,25,25
1668421748905,CSE 290,C00,102414,Pannuto; Patrick William,0,1,25,25
1668421748905,CSE 290,D00,102427,Pevzner; Pavel Arkadjevich,0,0,0,0
1668421748905,CSE 290,E00,102429,Zhao; Jishen,0,1,0,0
1668421748905,CSE 290,F00,102436,Tullsen; Dean Michael,0,2,0,0
1668421748905,CSE 290,G00,102440,Christensen; Henrik I,0,3,20,20
1668421749333,CSE 291,A00,102443,Su; Hao,0,0,0,0
1668421749333,CSE 291,B00,102448,Polikarpova; Nadezhda,0,0,0,0
1668421749333,CSE 291,C00,102453,Vaccaro; Kristen Marie,0,0,0,0
1668421749333,CSE 291,D00,111343,Savage; Stefan,0,0,0,0
1668421749333,CSE 291,E00,116474,Claffy; Kimberly Claire,0,0,0,0
1668421749333,CSE 291,F00,116479,Pasquale; Joseph,0,0,0,0
1668421749789,CSE 293,001,119111,Bafna; Vineet,9999,0,9999,0
1668421749789,CSE 293,002,119118,Bellare; Mihir,9999,0,9999,0
1668421749789,CSE 293,003,119122,Berg-Kirkpatrick; Taylor D,9999,0,9999,0
1668421749789,CSE 293,004,119135,Christensen; Henrik I,9999,0,9999,0
1668421749789,CSE 293,005,119142,Cottrell; Garrison W,9999,0,9999,0
1668421749789,CSE 293,006,119146,Deutsch; Alin Bernard,9999,0,9999,0
1668421749789,CSE 293,007,119159,Esmaeilzadeh; Hadi,9999,0,9999,0
1668421749789,CSE 293,008,119166,Freund; Yoav,9999,0,9999,0
1668421749789,CSE 293,009,119170,Griswold; William G.,9999,0,9999,0
1668421749789,CSE 293,010,119183,Gymrek; Melissa Ann,9999,0,9999,0
1668421749789,CSE 293,011,119190,Heninger; Nadia A,9999,0,9999,0
1668421749789,CSE 293,012,119230,Impagliazzo; Russell,9999,0,9999,0
1668421749789,CSE 293,013,119232,Jhala; Ranjit,9999,0,9999,0
1668421749789,CSE 293,014,119233,Kahng; Andrew Byun,9999,0,9999,0
1668421749789,CSE 293,015,119298,Kane; Daniel Mertz,9999,0,9999,0
1668421749789,CSE 293,016,119299,Kriegman; David J,9999,0,9999,0
1668421749789,CSE 293,017,119300,Kumar; Arun Kumar,9999,0,9999,0
1668421749789,CSE 293,018,119301,Lerner; Sorin,9999,0,9999,0
1668421749789,CSE 293,019,119302,Lovett; Shachar,9999,0,9999,0
1668421749789,CSE 293,020,119303,McAuley; Julian John,9999,0,9999,0
1668421749789,CSE 293,021,119304,Micciancio; Daniele,9999,0,9999,0
1668421749789,CSE 293,022,119367,Orailoglu; Alex,9999,0,9999,0
1668421749789,CSE 293,023,119382,Paturi; Ramamohan,9999,0,9999,0
1668421749789,CSE 293,024,119404,Polikarpova; Nadezhda,9999,0,9999,0
1668421749789,CSE 293,025,119406,Politz; Joseph Gibbs,9999,0,9999,0
1668421749789,CSE 293,026,119411,Porter; George M,9999,0,9999,0
1668421749789,CSE 293,027,119414,Porter; Leonard Emerson,9999,0,9999,0
1668421749789,CSE 293,028,119416,Ramamoorthi; Ravi,9999,0,9999,0
1668421749789,CSE 293,029,119417,Sahoo; Debashis,9999,0,9999,0
1668421749789,CSE 293,030,119420,Saul; Lawrence,9999,0,9999,0
1668421749789,CSE 293,031,119421,Savage; Stefan,9999,0,9999,0
1668421749789,CSE 293,032,119425,Schulze; Jurgen P.,9999,0,9999,0
1668421749789,CSE 293,033,119426,Snoeren; Alex C.,9999,0,9999,0
1668421749789,CSE 293,034,119428,Shang; Jingbo,9999,0,9999,0
1668421749789,CSE 293,035,119430,Stefan; Deian,9999,0,9999,0
1668421749789,CSE 293,036,119431,Su; Hao,9999,0,9999,0
1668421749789,CSE 293,037,119433,Swanson; Steven James,9999,0,9999,0
1668421749789,CSE 293,038,119435,Tullsen; Dean Michael,9999,0,9999,0
1668421749789,CSE 293,039,119483,Voelker; Geoffrey M.,9999,0,9999,0
1668421749789,CSE 293,040,119537,Zhao; Jishen,9999,0,9999,0
1668421749789,CSE 293,041,119538,Zhou; Yuan-Yuan,9999,0,9999,0
1668421749789,CSE 293,042,119539,Gao; Sicun,9999,0,9999,0
1668421749789,CSE 293,043,119540,Weibel; Nadir,9999,0,9999,0
1668421749789,CSE 293,044,119541,Gupta; Rajesh K.,9999,0,9999,0
1668421749789,CSE 293,045,126410,Vaccaro; Kristen Marie,9999,0,9999,0
1668421749789,CSE 293,046,126411,Klemke; Richard,9999,0,9999,0
1668421750295,CSE 294,A00,102459,Voelker; Geoffrey M.,0,1,0,0
1668421750295,CSE 294,B00,111322,Orailoglu; Alex,0,0,0,0
1668421750720,DSE 201,A00,096914,Deutsch; Alin Bernard,30,0,30,0
1668421751144,DSE 210,A00,096915,Dasgupta; Sanjoy,30,0,30,0
1668421751577,DSE 260A,A00,096916,Altintas De Callaf; Ilkay,30,0,30,0
1668421752031,ECE 200,001,103586,Antipa; Nicholas A,9999,0,9999,0
1668421752031,ECE 200,002,103587,Atanasov; Nikolay A.,9999,0,9999,0
1668421752031,ECE 200,003,103588,Bharadia; Dinesh,9999,0,9999,0
1668421752031,ECE 200,004,103589,Cheng; Chung Kuan,9999,0,9999,0
1668421752031,ECE 200,005,103590,Cosman; Pamela C.,9999,0,9999,0
1668421752031,ECE 200,006,103591,Dayeh; Shadi Ahmad,9999,0,9999,0
1668421752031,ECE 200,007,103592,Fainman; Yeshaiahu,9999,0,9999,0
1668421752031,ECE 200,008,103593,Ford; Joseph Earl,9999,0,9999,0
1668421752031,ECE 200,009,103594,Franceschetti; Massimo,9999,0,9999,0
1668421752031,ECE 200,010,103595,Fullerton; Eric E,9999,0,9999,0
1668421752031,ECE 200,011,103596,Galton; Ian A,9999,0,9999,0
1668421752031,ECE 200,012,103597,Gilja; Vikash,9999,0,9999,0
1668421752031,ECE 200,013,103598,Hall; Drew A.,9999,0,9999,0
1668421752031,ECE 200,014,103599,Hsueh; Tzu-Chien,9999,0,9999,0
1668421752031,ECE 200,015,103600,Javidi; Tara,9999,0,9999,0
1668421752031,ECE 200,016,103601,Kahng; Andrew Byun,9999,0,9999,0
1668421752031,ECE 200,017,103602,Kim; Young-Han,9999,0,9999,0
1668421752031,ECE 200,018,103603,Koushanfar; Farinaz,9999,0,9999,0
1668421752031,ECE 200,019,103604,Kuzum; Duygu,9999,0,9999,0
1668421752031,ECE 200,020,103605,Le; Hanh-Phuc,9999,0,9999,0
1668421752031,ECE 200,021,103606,Lin; Bill,9999,0,9999,0
1668421752031,ECE 200,022,103607,Liu; Zhaowei,9998,0,9999,1
1668421752031,ECE 200,023,103608,Lo; Yu-Hwa,9999,0,9999,0
1668421752031,ECE 200,024,103609,Lomakin; Vitaliy,9999,0,9999,0
1668421752031,ECE 200,025,103610,Mercier; Patrick Philip,9999,0,9999,0
1668421752031,ECE 200,026,103611,Meyer; Florian,9999,0,9999,0
1668421752031,ECE 200,027,103612,Milstein; Laurence B.,9999,0,9999,0
1668421752031,ECE 200,028,103613,Mir Arabbaygi; Siavash,9999,0,9999,0
1668421752031,ECE 200,029,103614,Mookherjea; Shayan,9999,0,9999,0
1668421752031,ECE 200,030,103615,Morris; Karcher William,9999,0,9999,0
1668421752031,ECE 200,031,103616,Ng; Tse Nga,9999,0,9999,0
1668421752031,ECE 200,032,103617,Nguyen; Truong Quang,9999,0,9999,0
1668421752031,ECE 200,033,103618,Nomura; Kenji,9999,0,9999,0
1668421752031,ECE 200,034,103619,Orlitsky; Alon,9999,0,9999,0
1668421752031,ECE 200,035,103620,Pal; Piya,9999,0,9999,0
1668421752031,ECE 200,036,103621,Papen; George C.,9999,0,9999,0
1668421752031,ECE 200,037,103622,Radic; Stojan,9999,0,9999,0
1668421752031,ECE 200,038,103623,Rao; Bhaskar D.,9999,0,9999,0
1668421752031,ECE 200,039,103624,Rao; Ramesh R,9999,0,9999,0
1668421752031,ECE 200,040,103625,Rebeiz; Gabriel,9999,0,9999,0
1668421752031,ECE 200,041,103626,Sanford; John R,9999,0,9999,0
1668421752031,ECE 200,042,103627,Siegel; Paul H.,9999,0,9999,0
1668421752031,ECE 200,043,103628,Sievenpiper; Daniel F.,9999,0,9999,0
1668421752031,ECE 200,044,103629,Sworder; David D.,9999,0,9999,0
1668421752031,ECE 200,045,103630,Taur; Yuan,9999,0,9999,0
1668421752031,ECE 200,046,103631,Touri; Behrouz,9999,0,9999,0
1668421752031,ECE 200,047,103632,Trivedi; Mohan M.,9999,0,9999,0
1668421752031,ECE 200,048,103633,Vasconcelos; Nuno,9999,0,9999,0
1668421752031,ECE 200,049,103634,Wang; Xiaolong,9999,0,9999,0
1668421752031,ECE 200,050,103635,Xie; Pengtao,9999,0,9999,0
1668421752031,ECE 200,051,103636,Yip; Michael,9999,0,9999,0
1668421752031,ECE 200,052,103637,Zeger; Kenneth A.,999,0,999,0
1668421752031,ECE 200,053,103638,Zhang; Xinyu,9999,0,9999,0
1668421752031,ECE 200,054,103639,Turakhia; Yatish Girish,9999,0,9999,0
1668421752031,ECE 200,055,103640,Kang; Mingu,9999,0,9999,0
1668421752031,ECE 200,056,103641,Shi; Yuanyuan,9999,0,9999,0
1668421752031,ECE 200,057,103642,Wang; Edward Jay,9999,0,9999,0
1668421752031,ECE 200,058,103643,Zheng; Yang,9999,0,9999,0
1668421752460,ECE 202,A00,103644,Kuzum; Duygu,0,21,0,0
1668421752897,ECE 212BN,A00,103646,Ng; Tse Nga,0,1,0,0
1668421753330,ECE 221,A00,111493,Staff,0,0,0,0
1668421753761,ECE 222B,A00,103647,Lomakin; Vitaliy,0,5,0,0
1668421754186,ECE 230B,A00,103648,Taur; Yuan,0,0,0,0
1668421754620,ECE 238B,A00,103649,Garay; Javier,0,0,0,0
1668421755043,ECE 240B,A00,112900,Fainman; Yeshaiahu,0,4,0,0
1668421755466,ECE 247A,A00,103650,Jokerst; Jesse Vincent,0,1,0,0
1668421755890,ECE 247B,A00,103651,Wang; Joseph,0,4,0,0
1668421756313,ECE 250,A00,103652,Siegel; Paul H.,0,42,0,0
1668421756734,ECE 251A,A00,103654,Rao; Bhaskar D.,0,28,0,0
1668421757157,ECE 257B,A00,103655,Bharadia; Dinesh,0,11,0,0
1668421757583,ECE 258A,A00,103656,Milstein; Laurence B.,0,10,0,0
1668421758010,ECE 260B,A00,103658,Kang; Mingu,0,64,0,0
1668421758435,ECE 264A,A00,103659,Galton; Ian A,0,31,0,0
1668421758859,ECE 265A,A00,103661,Gudem; Prasad S.S.,0,16,0,0
1668421759282,ECE 265D,A00,103662,Gudem; Prasad S.S.,0,10,0,0
1668421759706,ECE 268,A00,103663,Koushanfar; Farinaz,0,18,0,0
1668421760138,ECE 269,A01,103665,Pal; Piya,0,123,0,0
1668421760566,ECE 271B,A00,103666,Vasconcelos; Manuela,0,46,0,0
1668421760990,ECE 276A,A00,103667,Atanasov; Nikolay A.,0,66,0,0
1668421761414,ECE 277,A00,103668,An; Cheolhong,0,86,0,0
1668421761837,ECE 279,A00,117947,Hall; Drew A.,0,11,0,0
1668421762690,ECE 283,A00,103670,Hsueh; Tzu-Chien,0,21,0,0
1668421763117,ECE 284,A00,103671,Turakhia; Yatish Girish,0,22,0,0
1668421763539,ECE 285,A00,103672,Zheng; Yang,0,22,0,0
1668421763539,ECE 285,B00,103673,Sworder; David D.,0,36,0,0
1668421763964,ECE 287,A00,103676,Javidi; Tara,0,4,0,0
1668421764395,MATH 200B,A00,098023,Salehi Golsefidy; Alireza,12,0,15,3
1668421764820,MATH 202B,A00,098024,Rhoades; Brendon Patrick,9,0,15,6
1668421765245,MATH 203B,A00,098025,Oprea; Dragos N.,10,0,15,5
1668421765673,MATH 204B,A00,098026,Sorensen; Claus M,13,0,15,2
1668421766100,MATH 208,A00,098027,Izadi; Elham,7,0,10,3
1668421766525,MATH 209,A00,098028,Pollack; Aaron,10,0,10,0
1668421766947,MATH 211A,A00,112919,Rogalski; Daniel,9,0,10,1
1668421767398,MATH 211B,A00,112920,Seward; Brandon M.,9,0,10,1
1668421767821,MATH 218,A00,098029,Li; Bo,10,0,10,0
1668421768246,MATH 220B,A00,098030,Novak; Jonathan I,11,0,15,4
1668421768671,MATH 221A,A00,098031,Ebenfelt; Peter F,13,0,15,2
1668421769098,MATH 231B,A00,098032,Zlatos; Andrej,12,0,15,3
1668421769521,MATH 240B,A00,098033,Ni; Lei,9,0,15,6
1668421769946,MATH 243,A00,098034,Jekel; David Andrew,10,0,10,0
1668421770372,MATH 245A,A00,098035,Nie; Jiawang,0,1,15,16
1668421770796,MATH 248,A00,098036,Bejenaru; Ioan,10,0,10,0
1668421771219,MATH 250B,A00,098037,Spolaor; Luca,14,0,15,1
1668421771648,MATH 258,A00,098038,Ni; Lei,10,0,10,0
1668421772078,MATH 264B,A00,098041,Rhoades; Brendon Patrick,9,0,15,6
1668421772505,MATH 268,A00,098042,Buss; Samuel R,10,0,10,0
1668421772932,MATH 269,A00,098043,Rhoades; Brendon Patrick,10,0,10,0
1668421773357,MATH 270B,A00,098044,Li; Bo,10,0,15,5
1668421773789,MATH 272B,A00,098045,Holst; Michael J,13,0,15,2
1668421774225,MATH 273A,A00,098046,Tian; Xiaochuan,10,0,15,5
1668421774661,MATH 275,A01,098048,Tian; Xiaochuan,6,0,10,4
1668421775088,MATH 278A,A00,098049,Holst; Michael J,8,0,10,2
1668421775516,MATH 278B,A00,098050,Cloninger; Alexander,10,0,10,0
1668421775938,MATH 278C,A00,098051,Nie; Jiawang,6,0,10,4
1668421776362,MATH 280B,A00,098052,Zheng; Tianyi,8,0,15,7
1668421776791,MATH 281B,A00,098053,Bradic; Jelena,0,1,15,15
1668421777222,MATH 282B,A00,098054,Arias-Castro; Ery,0,0,15,15
1668421777650,MATH 285,A00,098055,Fitzsimmons; Patrick J,0,0,15,17
1668421778081,MATH 287B,A00,098056,Arias-Castro; Ery,2,0,15,13
1668421778504,MATH 288,A00,098057,Agarwal; Pooja,9,0,10,1
1668421778504,MATH 288,B00,098058,Zhang; Danna,8,0,10,2
1668421778504,MATH 288,C00,098059,Williams; Ruth J,9,0,10,1
1668421778936,MATH 290B,A00,098060,Roberts; Justin Deritter,13,0,15,2
1668421779359,MATH 292,A00,098061,Belmont; Eva Kinoshita,10,0,10,0
1668421779783,MATH 295,A00,098062,Suk; Andrew Hoon,48,0,50,2
1668421780206,MATH 296,A00,098063,Novak; Jonathan I,20,0,20,0
1668421780628,MATH 297,001,098064,Gamst; Anthony Collins,9997,0,9999,2
1668422300502,COGS 205,A00,101395,Chiba; Andrea,19,0,20,1
1668422300936,COGS 210B,001,101404,Greene; Deanna Jacquelyn,9998,0,9999,1
1668422300936,COGS 210B,002,101417,Xia; Haijun,9999,0,9999,0
1668422300936,COGS 210B,003,101422,Nitz; Douglas A.,9999,0,9999,0
1668422300936,COGS 210B,004,101423,Hollan; James D.,9998,0,9999,1
1668422300936,COGS 210B,005,101424,Deak; Gedeon O.,9998,0,9999,1
1668422300936,COGS 210B,006,101425,Rossano; Federico,9999,0,9999,0
1668422301362,COGS 211B,A00,101427,Coulson; Seana M,9996,0,9999,3
1668422301789,COGS 220,A00,101428,Hollan; James D.,1,2,25,24
1668422302215,COGS 229,A00,101429,Dow; Steven P,18,0,25,7
1668422302643,COGS 230,A00,101430,Klemmer; Scott R,11,0,17,6
1668422303067,COGS 234,A00,101431,Xia; Haijun,2,0,25,23
1668422303494,COGS 260,A00,101432,Kiyonaga; Anastasia,21,0,25,4
1668422303494,COGS 260,B00,101433,Kirsh; David Joel,15,0,25,10
1668422303921,CSE 202,A00,102371,Impagliazzo; Russell,0,30,0,0
1668422304344,CSE 203B,A01,102373,Cheng; Chung Kuan,0,24,0,0
1668422304770,CSE 208,A00,102374,Micciancio; Daniele,0,1,0,0
1668422305195,CSE 209A,A00,112895,Impagliazzo; Russell,0,3,15,15
1668422305623,CSE 209B,A00,108005,Bellare; Mihir,0,3,0,0
1668422306048,CSE 210,A00,113163,Coblenz; Michael J,0,41,0,0
1668422306481,CSE 219,A00,106111,Dow; Steven P,0,0,20,20
1668422306907,CSE 221,A00,102376,Voelker; Geoffrey M.,0,28,0,0
1668422307338,CSE 224,A01,102378,Porter; George M,0,102,0,0
1668422307764,CSE 229A,A00,102379,Savage; Stefan,0,4,0,0
1668422308187,CSE 229C,A00,102380,Munyaka; Imani N. S.,0,4,0,0
1668422308612,CSE 232B,A00,102382,Deutsch; Alin Bernard,0,13,0,0
1668422309041,CSE 234,A01,112904,Kumar; Arun Kumar,0,0,0,0
1668422309464,CSE 237A,A00,102383,Rosing; Tajana Simunic,0,24,0,0
1668422309895,CSE 239A,A00,102384,Deutsch; Alin Bernard,0,5,0,0
1668422310323,CSE 239B,A00,102385,Polikarpova; Nadezhda,0,3,0,0
1668422310746,CSE 240A,A00,102386,Pannuto; Patrick William,0,23,0,0
1668422311170,CSE 240B,A00,102387,Zhao; Jishen,0,23,0,0
1668422311598,CSE 241A,A00,106406,Kang; Mingu,0,2,0,0
1668422312025,CSE 249B,A00,102388,Kahng; Andrew Byun,0,1,8,8
1668422312453,CSE 251B,A01,102392,Cottrell; Garrison W,0,21,0,0
1668422312453,CSE 251B,A02,102393,Cottrell; Garrison W,0,21,0,0
1668422312878,CSE 252B,A00,102394,Ochoa; Benjamin Lawrence,0,35,0,0
1668422313306,CSE 257,A01,102396,Gao; Sicun,0,84,0,0
1668422313730,CSE 272,A00,102397,Li; Tzumao,0,7,0,0
1668422314153,CSE 274,A00,111323,Chern; Albert Ren-Haur,0,7,0,0
1668422314576,CSE 282,A00,102398,Pevzner; Pavel Arkadjevich,0,0,0,0
1668422315001,CSE 284,A00,114175,Gymrek; Melissa Ann,0,9,0,0
1668422315434,CSE 290,A00,102399,Chandraker; Manmohan Krishna,0,4,0,0
1668422315434,CSE 290,B00,102400,Vaccaro; Kristen Marie,0,1,25,25
1668422315434,CSE 290,C00,102414,Pannuto; Patrick William,0,1,25,25
1668422315434,CSE 290,D00,102427,Pevzner; Pavel Arkadjevich,0,0,0,0
1668422315434,CSE 290,E00,102429,Zhao; Jishen,0,1,0,0
1668422315434,CSE 290,F00,102436,Tullsen; Dean Michael,0,2,0,0
1668422315434,CSE 290,G00,102440,Christensen; Henrik I,0,3,20,20
1668422315866,CSE 291,A00,102443,Su; Hao,0,0,0,0
1668422315866,CSE 291,B00,102448,Polikarpova; Nadezhda,0,0,0,0
1668422315866,CSE 291,C00,102453,Vaccaro; Kristen Marie,0,0,0,0
1668422315866,CSE 291,D00,111343,Savage; Stefan,0,0,0,0
1668422315866,CSE 291,E00,116474,Claffy; Kimberly Claire,0,0,0,0
1668422315866,CSE 291,F00,116479,Pasquale; Joseph,0,0,0,0
1668422316330,CSE 293,001,119111,Bafna; Vineet,9999,0,9999,0
1668422316330,CSE 293,002,119118,Bellare; Mihir,9999,0,9999,0
1668422316330,CSE 293,003,119122,Berg-Kirkpatrick; Taylor D,9999,0,9999,0
1668422316330,CSE 293,004,119135,Christensen; Henrik I,9999,0,9999,0
1668422316330,CSE 293,005,119142,Cottrell; Garrison W,9999,0,9999,0
1668422316330,CSE 293,006,119146,Deutsch; Alin Bernard,9999,0,9999,0
1668422316330,CSE 293,007,119159,Esmaeilzadeh; Hadi,9999,0,9999,0
1668422316330,CSE 293,008,119166,Freund; Yoav,9999,0,9999,0
1668422316330,CSE 293,009,119170,Griswold; William G.,9999,0,9999,0
1668422316330,CSE 293,010,119183,Gymrek; Melissa Ann,9999,0,9999,0
1668422316330,CSE 293,011,119190,Heninger; Nadia A,9999,0,9999,0
1668422316330,CSE 293,012,119230,Impagliazzo; Russell,9999,0,9999,0
1668422316330,CSE 293,013,119232,Jhala; Ranjit,9999,0,9999,0
1668422316330,CSE 293,014,119233,Kahng; Andrew Byun,9999,0,9999,0
1668422316330,CSE 293,015,119298,Kane; Daniel Mertz,9999,0,9999,0
1668422316330,CSE 293,016,119299,Kriegman; David J,9999,0,9999,0
1668422316330,CSE 293,017,119300,Kumar; Arun Kumar,9999,0,9999,0
1668422316330,CSE 293,018,119301,Lerner; Sorin,9999,0,9999,0
1668422316330,CSE 293,019,119302,Lovett; Shachar,9999,0,9999,0
1668422316330,CSE 293,020,119303,McAuley; Julian John,9999,0,9999,0
1668422316330,CSE 293,021,119304,Micciancio; Daniele,9999,0,9999,0
1668422316330,CSE 293,022,119367,Orailoglu; Alex,9999,0,9999,0
1668422316330,CSE 293,023,119382,Paturi; Ramamohan,9999,0,9999,0
1668422316330,CSE 293,024,119404,Polikarpova; Nadezhda,9999,0,9999,0
1668422316330,CSE 293,025,119406,Politz; Joseph Gibbs,9999,0,9999,0
1668422316330,CSE 293,026,119411,Porter; George M,9999,0,9999,0
1668422316330,CSE 293,027,119414,Porter; Leonard Emerson,9999,0,9999,0
1668422316330,CSE 293,028,119416,Ramamoorthi; Ravi,9999,0,9999,0
1668422316330,CSE 293,029,119417,Sahoo; Debashis,9999,0,9999,0
1668422316330,CSE 293,030,119420,Saul; Lawrence,9999,0,9999,0
1668422316330,CSE 293,031,119421,Savage; Stefan,9999,0,9999,0
1668422316330,CSE 293,032,119425,Schulze; Jurgen P.,9999,0,9999,0
1668422316330,CSE 293,033,119426,Snoeren; Alex C.,9999,0,9999,0
1668422316330,CSE 293,034,119428,Shang; Jingbo,9999,0,9999,0
1668422316330,CSE 293,035,119430,Stefan; Deian,9999,0,9999,0
1668422316330,CSE 293,036,119431,Su; Hao,9999,0,9999,0
1668422316330,CSE 293,037,119433,Swanson; Steven James,9999,0,9999,0
1668422316330,CSE 293,038,119435,Tullsen; Dean Michael,9999,0,9999,0
1668422316330,CSE 293,039,119483,Voelker; Geoffrey M.,9999,0,9999,0
1668422316330,CSE 293,040,119537,Zhao; Jishen,9999,0,9999,0
1668422316330,CSE 293,041,119538,Zhou; Yuan-Yuan,9999,0,9999,0
1668422316330,CSE 293,042,119539,Gao; Sicun,9999,0,9999,0
1668422316330,CSE 293,043,119540,Weibel; Nadir,9999,0,9999,0
1668422316330,CSE 293,044,119541,Gupta; Rajesh K.,9999,0,9999,0
1668422316330,CSE 293,045,126410,Vaccaro; Kristen Marie,9999,0,9999,0
1668422316330,CSE 293,046,126411,Klemke; Richard,9999,0,9999,0
1668422316755,CSE 294,A00,102459,Voelker; Geoffrey M.,0,1,0,0
1668422316755,CSE 294,B00,111322,Orailoglu; Alex,0,0,0,0
1668422317178,DSE 201,A00,096914,Deutsch; Alin Bernard,30,0,30,0
1668422317603,DSE 210,A00,096915,Dasgupta; Sanjoy,30,0,30,0
1668422318028,DSE 260A,A00,096916,Altintas De Callaf; Ilkay,30,0,30,0
1668422318535,ECE 200,001,103586,Antipa; Nicholas A,9999,0,9999,0
1668422318535,ECE 200,002,103587,Atanasov; Nikolay A.,9999,0,9999,0
1668422318535,ECE 200,003,103588,Bharadia; Dinesh,9999,0,9999,0
1668422318535,ECE 200,004,103589,Cheng; Chung Kuan,9999,0,9999,0
1668422318535,ECE 200,005,103590,Cosman; Pamela C.,9999,0,9999,0
1668422318535,ECE 200,006,103591,Dayeh; Shadi Ahmad,9999,0,9999,0
1668422318535,ECE 200,007,103592,Fainman; Yeshaiahu,9999,0,9999,0
1668422318535,ECE 200,008,103593,Ford; Joseph Earl,9999,0,9999,0
1668422318535,ECE 200,009,103594,Franceschetti; Massimo,9999,0,9999,0
1668422318535,ECE 200,010,103595,Fullerton; Eric E,9999,0,9999,0
1668422318535,ECE 200,011,103596,Galton; Ian A,9999,0,9999,0
1668422318535,ECE 200,012,103597,Gilja; Vikash,9999,0,9999,0
1668422318535,ECE 200,013,103598,Hall; Drew A.,9999,0,9999,0
1668422318535,ECE 200,014,103599,Hsueh; Tzu-Chien,9999,0,9999,0
1668422318535,ECE 200,015,103600,Javidi; Tara,9999,0,9999,0
1668422318535,ECE 200,016,103601,Kahng; Andrew Byun,9999,0,9999,0
1668422318535,ECE 200,017,103602,Kim; Young-Han,9999,0,9999,0
1668422318535,ECE 200,018,103603,Koushanfar; Farinaz,9999,0,9999,0
1668422318535,ECE 200,019,103604,Kuzum; Duygu,9999,0,9999,0
1668422318535,ECE 200,020,103605,Le; Hanh-Phuc,9999,0,9999,0
1668422318535,ECE 200,021,103606,Lin; Bill,9999,0,9999,0
1668422318535,ECE 200,022,103607,Liu; Zhaowei,9998,0,9999,1
1668422318535,ECE 200,023,103608,Lo; Yu-Hwa,9999,0,9999,0
1668422318535,ECE 200,024,103609,Lomakin; Vitaliy,9999,0,9999,0
1668422318535,ECE 200,025,103610,Mercier; Patrick Philip,9999,0,9999,0
1668422318535,ECE 200,026,103611,Meyer; Florian,9999,0,9999,0
1668422318535,ECE 200,027,103612,Milstein; Laurence B.,9999,0,9999,0
1668422318535,ECE 200,028,103613,Mir Arabbaygi; Siavash,9999,0,9999,0
1668422318535,ECE 200,029,103614,Mookherjea; Shayan,9999,0,9999,0
1668422318535,ECE 200,030,103615,Morris; Karcher William,9999,0,9999,0
1668422318535,ECE 200,031,103616,Ng; Tse Nga,9999,0,9999,0
1668422318535,ECE 200,032,103617,Nguyen; Truong Quang,9999,0,9999,0
1668422318535,ECE 200,033,103618,Nomura; Kenji,9999,0,9999,0
1668422318535,ECE 200,034,103619,Orlitsky; Alon,9999,0,9999,0
1668422318535,ECE 200,035,103620,Pal; Piya,9999,0,9999,0
1668422318535,ECE 200,036,103621,Papen; George C.,9999,0,9999,0
1668422318535,ECE 200,037,103622,Radic; Stojan,9999,0,9999,0
1668422318535,ECE 200,038,103623,Rao; Bhaskar D.,9999,0,9999,0
1668422318535,ECE 200,039,103624,Rao; Ramesh R,9999,0,9999,0
1668422318535,ECE 200,040,103625,Rebeiz; Gabriel,9999,0,9999,0
1668422318535,ECE 200,041,103626,Sanford; John R,9999,0,9999,0
1668422318535,ECE 200,042,103627,Siegel; Paul H.,9999,0,9999,0
1668422318535,ECE 200,043,103628,Sievenpiper; Daniel F.,9999,0,9999,0
1668422318535,ECE 200,044,103629,Sworder; David D.,9999,0,9999,0
1668422318535,ECE 200,045,103630,Taur; Yuan,9999,0,9999,0
1668422318535,ECE 200,046,103631,Touri; Behrouz,9999,0,9999,0
1668422318535,ECE 200,047,103632,Trivedi; Mohan M.,9999,0,9999,0
1668422318535,ECE 200,048,103633,Vasconcelos; Nuno,9999,0,9999,0
1668422318535,ECE 200,049,103634,Wang; Xiaolong,9999,0,9999,0
1668422318535,ECE 200,050,103635,Xie; Pengtao,9999,0,9999,0
1668422318535,ECE 200,051,103636,Yip; Michael,9999,0,9999,0
1668422318535,ECE 200,052,103637,Zeger; Kenneth A.,999,0,999,0
1668422318535,ECE 200,053,103638,Zhang; Xinyu,9999,0,9999,0
1668422318535,ECE 200,054,103639,Turakhia; Yatish Girish,9999,0,9999,0
1668422318535,ECE 200,055,103640,Kang; Mingu,9999,0,9999,0
1668422318535,ECE 200,056,103641,Shi; Yuanyuan,9999,0,9999,0
1668422318535,ECE 200,057,103642,Wang; Edward Jay,9999,0,9999,0
1668422318535,ECE 200,058,103643,Zheng; Yang,9999,0,9999,0
1668422318959,ECE 202,A00,103644,Kuzum; Duygu,0,21,0,0
1668422319383,ECE 212BN,A00,103646,Ng; Tse Nga,0,1,0,0
1668422319806,ECE 221,A00,111493,Staff,0,0,0,0
1668422320230,ECE 222B,A00,103647,Lomakin; Vitaliy,0,5,0,0
1668422320654,ECE 230B,A00,103648,Taur; Yuan,0,0,0,0
1668422321084,ECE 238B,A00,103649,Garay; Javier,0,0,0,0
1668422321506,ECE 240B,A00,112900,Fainman; Yeshaiahu,0,4,0,0
1668422321928,ECE 247A,A00,103650,Jokerst; Jesse Vincent,0,1,0,0
1668422322353,ECE 247B,A00,103651,Wang; Joseph,0,4,0,0
1668422322778,ECE 250,A00,103652,Siegel; Paul H.,0,42,0,0
1668422323202,ECE 251A,A00,103654,Rao; Bhaskar D.,0,28,0,0
1668422323631,ECE 257B,A00,103655,Bharadia; Dinesh,0,12,0,0
1668422324056,ECE 258A,A00,103656,Milstein; Laurence B.,0,10,0,0
1668422324485,ECE 260B,A00,103658,Kang; Mingu,0,64,0,0
1668422324912,ECE 264A,A00,103659,Galton; Ian A,0,31,0,0
1668422325338,ECE 265A,A00,103661,Gudem; Prasad S.S.,0,16,0,0
1668422325764,ECE 265D,A00,103662,Gudem; Prasad S.S.,0,10,0,0
1668422326188,ECE 268,A00,103663,Koushanfar; Farinaz,0,18,0,0
1668422326611,ECE 269,A01,103665,Pal; Piya,0,123,0,0
1668422327045,ECE 271B,A00,103666,Vasconcelos; Manuela,0,46,0,0
1668422327473,ECE 276A,A00,103667,Atanasov; Nikolay A.,0,66,0,0
1668422327898,ECE 277,A00,103668,An; Cheolhong,0,86,0,0
1668422328323,ECE 279,A00,117947,Hall; Drew A.,0,11,0,0
1668422329172,ECE 283,A00,103670,Hsueh; Tzu-Chien,0,21,0,0
1668422329600,ECE 284,A00,103671,Turakhia; Yatish Girish,0,22,0,0
1668422330034,ECE 285,A00,103672,Zheng; Yang,0,22,0,0
1668422330034,ECE 285,B00,103673,Sworder; David D.,0,36,0,0
1668422330465,ECE 287,A00,103676,Javidi; Tara,0,4,0,0
1668422330892,MATH 200B,A00,098023,Salehi Golsefidy; Alireza,12,0,15,3
1668422331315,MATH 202B,A00,098024,Rhoades; Brendon Patrick,9,0,15,6
1668422331739,MATH 203B,A00,098025,Oprea; Dragos N.,10,0,15,5
1668422332163,MATH 204B,A00,098026,Sorensen; Claus M,13,0,15,2
1668422332589,MATH 208,A00,098027,Izadi; Elham,7,0,10,3
1668422333014,MATH 209,A00,098028,Pollack; Aaron,10,0,10,0
1668422333535,MATH 211A,A00,112919,Rogalski; Daniel,9,0,10,1
1668422333959,MATH 211B,A00,112920,Seward; Brandon M.,9,0,10,1
1668422334382,MATH 218,A00,098029,Li; Bo,10,0,10,0
1668422334805,MATH 220B,A00,098030,Novak; Jonathan I,11,0,15,4
1668422335230,MATH 221A,A00,098031,Ebenfelt; Peter F,13,0,15,2
1668422335659,MATH 231B,A00,098032,Zlatos; Andrej,12,0,15,3
1668422336084,MATH 240B,A00,098033,Ni; Lei,9,0,15,6
1668422336510,MATH 243,A00,098034,Jekel; David Andrew,10,0,10,0
1668422336948,MATH 245A,A00,098035,Nie; Jiawang,0,1,15,16
1668422337372,MATH 248,A00,098036,Bejenaru; Ioan,10,0,10,0
1668422337796,MATH 250B,A00,098037,Spolaor; Luca,14,0,15,1
1668422338219,MATH 258,A00,098038,Ni; Lei,10,0,10,0
1668422338648,MATH 264B,A00,098041,Rhoades; Brendon Patrick,9,0,15,6
1668422339071,MATH 268,A00,098042,Buss; Samuel R,10,0,10,0
1668422339494,MATH 269,A00,098043,Rhoades; Brendon Patrick,10,0,10,0
1668422339917,MATH 270B,A00,098044,Li; Bo,10,0,15,5
1668422340351,MATH 272B,A00,098045,Holst; Michael J,13,0,15,2
1668422340782,MATH 273A,A00,098046,Tian; Xiaochuan,10,0,15,5
1668422341213,MATH 275,A01,098048,Tian; Xiaochuan,6,0,10,4
1668422341640,MATH 278A,A00,098049,Holst; Michael J,8,0,10,2
1668422342063,MATH 278B,A00,098050,Cloninger; Alexander,10,0,10,0
1668422342489,MATH 278C,A00,098051,Nie; Jiawang,6,0,10,4
1668422342910,MATH 280B,A00,098052,Zheng; Tianyi,8,0,15,7
1668422343335,MATH 281B,A00,098053,Bradic; Jelena,0,1,15,15
1668422343759,MATH 282B,A00,098054,Arias-Castro; Ery,0,0,15,15
1668422344186,MATH 285,A00,098055,Fitzsimmons; Patrick J,0,0,15,17
1668422344610,MATH 287B,A00,098056,Arias-Castro; Ery,2,0,15,13
1668422345037,MATH 288,A00,098057,Agarwal; Pooja,9,0,10,1
1668422345037,MATH 288,B00,098058,Zhang; Danna,8,0,10,2
1668422345037,MATH 288,C00,098059,Williams; Ruth J,9,0,10,1
1668422345466,MATH 290B,A00,098060,Roberts; Justin Deritter,13,0,15,2
1668422345892,MATH 292,A00,098061,Belmont; Eva Kinoshita,10,0,10,0
1668422346315,MATH 295,A00,098062,Suk; Andrew Hoon,48,0,50,2
1668422346740,MATH 296,A00,098063,Novak; Jonathan I,20,0,20,0
1668422347165,MATH 297,001,098064,Gamst; Anthony Collins,9997,0,9999,2
1668422850272,COGS 205,A00,101395,Chiba; Andrea,19,0,20,1
1668422850715,COGS 210B,001,101404,Greene; Deanna Jacquelyn,9998,0,9999,1
1668422850715,COGS 210B,002,101417,Xia; Haijun,9999,0,9999,0
1668422850715,COGS 210B,003,101422,Nitz; Douglas A.,9999,0,9999,0
1668422850715,COGS 210B,004,101423,Hollan; James D.,9998,0,9999,1
1668422850715,COGS 210B,005,101424,Deak; Gedeon O.,9998,0,9999,1
1668422850715,COGS 210B,006,101425,Rossano; Federico,9999,0,9999,0
1668422851156,COGS 211B,A00,101427,Coulson; Seana M,9996,0,9999,3
1668422851613,COGS 220,A00,101428,Hollan; James D.,1,2,25,24
1668422852041,COGS 229,A00,101429,Dow; Steven P,18,0,25,7
1668422852464,COGS 230,A00,101430,Klemmer; Scott R,11,0,17,6
1668422852889,COGS 234,A00,101431,Xia; Haijun,2,0,25,23
1668422853314,COGS 260,A00,101432,Kiyonaga; Anastasia,21,0,25,4
1668422853314,COGS 260,B00,101433,Kirsh; David Joel,15,0,25,10
1668422853742,CSE 202,A00,102371,Impagliazzo; Russell,0,30,0,0
1668422854167,CSE 203B,A01,102373,Cheng; Chung Kuan,0,24,0,0
1668422854595,CSE 208,A00,102374,Micciancio; Daniele,0,1,0,0
1668422855053,CSE 209A,A00,112895,Impagliazzo; Russell,0,3,15,15
1668422855476,CSE 209B,A00,108005,Bellare; Mihir,0,3,0,0
1668422855901,CSE 210,A00,113163,Coblenz; Michael J,0,41,0,0
1668422856338,CSE 219,A00,106111,Dow; Steven P,0,0,20,20
1668422856875,CSE 221,A00,102376,Voelker; Geoffrey M.,0,28,0,0
1668422857303,CSE 224,A01,102378,Porter; George M,0,102,0,0
1668422857756,CSE 229A,A00,102379,Savage; Stefan,0,4,0,0
1668422858200,CSE 229C,A00,102380,Munyaka; Imani N. S.,0,4,0,0
1668422858633,CSE 232B,A00,102382,Deutsch; Alin Bernard,0,13,0,0
1668422859060,CSE 234,A01,112904,Kumar; Arun Kumar,0,0,0,0
1668422859492,CSE 237A,A00,102383,Rosing; Tajana Simunic,0,24,0,0
1668422859920,CSE 239A,A00,102384,Deutsch; Alin Bernard,0,5,0,0
1668422860348,CSE 239B,A00,102385,Polikarpova; Nadezhda,0,3,0,0
1668422860777,CSE 240A,A00,102386,Pannuto; Patrick William,0,23,0,0
1668422861206,CSE 240B,A00,102387,Zhao; Jishen,0,23,0,0
1668422861650,CSE 241A,A00,106406,Kang; Mingu,0,2,0,0
1668422862078,CSE 249B,A00,102388,Kahng; Andrew Byun,0,1,8,8
1668422862505,CSE 251B,A01,102392,Cottrell; Garrison W,0,21,0,0
1668422862505,CSE 251B,A02,102393,Cottrell; Garrison W,0,21,0,0
1668422862933,CSE 252B,A00,102394,Ochoa; Benjamin Lawrence,0,35,0,0
1668422863362,CSE 257,A01,102396,Gao; Sicun,0,85,0,0
1668422863787,CSE 272,A00,102397,Li; Tzumao,0,7,0,0
1668422864216,CSE 274,A00,111323,Chern; Albert Ren-Haur,0,7,0,0
1668422864646,CSE 282,A00,102398,Pevzner; Pavel Arkadjevich,0,0,0,0
1668422865074,CSE 284,A00,114175,Gymrek; Melissa Ann,0,9,0,0
1668422865504,CSE 290,A00,102399,Chandraker; Manmohan Krishna,0,4,0,0
1668422865504,CSE 290,B00,102400,Vaccaro; Kristen Marie,0,1,25,25
1668422865504,CSE 290,C00,102414,Pannuto; Patrick William,0,1,25,25
1668422865504,CSE 290,D00,102427,Pevzner; Pavel Arkadjevich,0,0,0,0
1668422865504,CSE 290,E00,102429,Zhao; Jishen,0,1,0,0
1668422865504,CSE 290,F00,102436,Tullsen; Dean Michael,0,2,0,0
1668422865504,CSE 290,G00,102440,Christensen; Henrik I,0,3,20,20
1668422865938,CSE 291,A00,102443,Su; Hao,0,0,0,0
1668422865938,CSE 291,B00,102448,Polikarpova; Nadezhda,0,0,0,0
1668422865938,CSE 291,C00,102453,Vaccaro; Kristen Marie,0,0,0,0
1668422865938,CSE 291,D00,111343,Savage; Stefan,0,0,0,0
1668422865938,CSE 291,E00,116474,Claffy; Kimberly Claire,0,0,0,0
1668422865938,CSE 291,F00,116479,Pasquale; Joseph,0,0,0,0
1668422866424,CSE 293,001,119111,Bafna; Vineet,9999,0,9999,0
1668422866424,CSE 293,002,119118,Bellare; Mihir,9999,0,9999,0
1668422866424,CSE 293,003,119122,Berg-Kirkpatrick; Taylor D,9999,0,9999,0
1668422866424,CSE 293,004,119135,Christensen; Henrik I,9999,0,9999,0
1668422866424,CSE 293,005,119142,Cottrell; Garrison W,9999,0,9999,0
1668422866424,CSE 293,006,119146,Deutsch; Alin Bernard,9999,0,9999,0
1668422866424,CSE 293,007,119159,Esmaeilzadeh; Hadi,9999,0,9999,0
1668422866424,CSE 293,008,119166,Freund; Yoav,9999,0,9999,0
1668422866424,CSE 293,009,119170,Griswold; William G.,9999,0,9999,0
1668422866424,CSE 293,010,119183,Gymrek; Melissa Ann,9999,0,9999,0
1668422866424,CSE 293,011,119190,Heninger; Nadia A,9999,0,9999,0
1668422866424,CSE 293,012,119230,Impagliazzo; Russell,9999,0,9999,0
1668422866424,CSE 293,013,119232,Jhala; Ranjit,9999,0,9999,0
1668422866424,CSE 293,014,119233,Kahng; Andrew Byun,9999,0,9999,0
1668422866424,CSE 293,015,119298,Kane; Daniel Mertz,9999,0,9999,0
1668422866424,CSE 293,016,119299,Kriegman; David J,9999,0,9999,0
1668422866424,CSE 293,017,119300,Kumar; Arun Kumar,9999,0,9999,0
1668422866424,CSE 293,018,119301,Lerner; Sorin,9999,0,9999,0
1668422866424,CSE 293,019,119302,Lovett; Shachar,9999,0,9999,0
1668422866424,CSE 293,020,119303,McAuley; Julian John,9999,0,9999,0
1668422866424,CSE 293,021,119304,Micciancio; Daniele,9999,0,9999,0
1668422866424,CSE 293,022,119367,Orailoglu; Alex,9999,0,9999,0
1668422866424,CSE 293,023,119382,Paturi; Ramamohan,9999,0,9999,0
1668422866424,CSE 293,024,119404,Polikarpova; Nadezhda,9999,0,9999,0
1668422866424,CSE 293,025,119406,Politz; Joseph Gibbs,9999,0,9999,0
1668422866424,CSE 293,026,119411,Porter; George M,9999,0,9999,0
1668422866424,CSE 293,027,119414,Porter; Leonard Emerson,9999,0,9999,0
1668422866424,CSE 293,028,119416,Ramamoorthi; Ravi,9999,0,9999,0
1668422866424,CSE 293,029,119417,Sahoo; Debashis,9999,0,9999,0
1668422866424,CSE 293,030,119420,Saul; Lawrence,9999,0,9999,0
1668422866424,CSE 293,031,119421,Savage; Stefan,9999,0,9999,0
1668422866424,CSE 293,032,119425,Schulze; Jurgen P.,9999,0,9999,0
1668422866424,CSE 293,033,119426,Snoeren; Alex C.,9999,0,9999,0
1668422866424,CSE 293,034,119428,Shang; Jingbo,9999,0,9999,0
1668422866424,CSE 293,035,119430,Stefan; Deian,9999,0,9999,0
1668422866424,CSE 293,036,119431,Su; Hao,9999,0,9999,0
1668422866424,CSE 293,037,119433,Swanson; Steven James,9999,0,9999,0
1668422866424,CSE 293,038,119435,Tullsen; Dean Michael,9999,0,9999,0
1668422866424,CSE 293,039,119483,Voelker; Geoffrey M.,9999,0,9999,0
1668422866424,CSE 293,040,119537,Zhao; Jishen,9999,0,9999,0
1668422866424,CSE 293,041,119538,Zhou; Yuan-Yuan,9999,0,9999,0
1668422866424,CSE 293,042,119539,Gao; Sicun,9999,0,9999,0
1668422866424,CSE 293,043,119540,Weibel; Nadir,9999,0,9999,0
1668422866424,CSE 293,044,119541,Gupta; Rajesh K.,9999,0,9999,0
1668422866424,CSE 293,045,126410,Vaccaro; Kristen Marie,9999,0,9999,0
1668422866424,CSE 293,046,126411,Klemke; Richard,9999,0,9999,0
1668422866852,CSE 294,A00,102459,Voelker; Geoffrey M.,0,1,0,0
1668422866852,CSE 294,B00,111322,Orailoglu; Alex,0,0,0,0
1668422867288,DSE 201,A00,096914,Deutsch; Alin Bernard,30,0,30,0
1668422867727,DSE 210,A00,096915,Dasgupta; Sanjoy,30,0,30,0
1668422868156,DSE 260A,A00,096916,Altintas De Callaf; Ilkay,30,0,30,0
1668422868672,ECE 200,001,103586,Antipa; Nicholas A,9999,0,9999,0
1668422868672,ECE 200,002,103587,Atanasov; Nikolay A.,9999,0,9999,0
1668422868672,ECE 200,003,103588,Bharadia; Dinesh,9999,0,9999,0
1668422868672,ECE 200,004,103589,Cheng; Chung Kuan,9999,0,9999,0
1668422868672,ECE 200,005,103590,Cosman; Pamela C.,9999,0,9999,0
1668422868672,ECE 200,006,103591,Dayeh; Shadi Ahmad,9999,0,9999,0
1668422868672,ECE 200,007,103592,Fainman; Yeshaiahu,9999,0,9999,0
1668422868672,ECE 200,008,103593,Ford; Joseph Earl,9999,0,9999,0
1668422868672,ECE 200,009,103594,Franceschetti; Massimo,9999,0,9999,0
1668422868672,ECE 200,010,103595,Fullerton; Eric E,9999,0,9999,0
1668422868672,ECE 200,011,103596,Galton; Ian A,9999,0,9999,0
1668422868672,ECE 200,012,103597,Gilja; Vikash,9999,0,9999,0
1668422868672,ECE 200,013,103598,Hall; Drew A.,9999,0,9999,0
1668422868672,ECE 200,014,103599,Hsueh; Tzu-Chien,9999,0,9999,0
1668422868672,ECE 200,015,103600,Javidi; Tara,9999,0,9999,0
1668422868672,ECE 200,016,103601,Kahng; Andrew Byun,9999,0,9999,0
1668422868672,ECE 200,017,103602,Kim; Young-Han,9999,0,9999,0
1668422868672,ECE 200,018,103603,Koushanfar; Farinaz,9999,0,9999,0
1668422868672,ECE 200,019,103604,Kuzum; Duygu,9999,0,9999,0
1668422868672,ECE 200,020,103605,Le; Hanh-Phuc,9999,0,9999,0
1668422868672,ECE 200,021,103606,Lin; Bill,9999,0,9999,0
1668422868672,ECE 200,022,103607,Liu; Zhaowei,9998,0,9999,1
1668422868672,ECE 200,023,103608,Lo; Yu-Hwa,9999,0,9999,0
1668422868672,ECE 200,024,103609,Lomakin; Vitaliy,9999,0,9999,0
1668422868672,ECE 200,025,103610,Mercier; Patrick Philip,9999,0,9999,0
1668422868672,ECE 200,026,103611,Meyer; Florian,9999,0,9999,0
1668422868672,ECE 200,027,103612,Milstein; Laurence B.,9999,0,9999,0
1668422868672,ECE 200,028,103613,Mir Arabbaygi; Siavash,9999,0,9999,0
1668422868672,ECE 200,029,103614,Mookherjea; Shayan,9999,0,9999,0
1668422868672,ECE 200,030,103615,Morris; Karcher William,9999,0,9999,0
1668422868672,ECE 200,031,103616,Ng; Tse Nga,9999,0,9999,0
1668422868672,ECE 200,032,103617,Nguyen; Truong Quang,9999,0,9999,0
1668422868672,ECE 200,033,103618,Nomura; Kenji,9999,0,9999,0
1668422868672,ECE 200,034,103619,Orlitsky; Alon,9999,0,9999,0
1668422868672,ECE 200,035,103620,Pal; Piya,9999,0,9999,0
1668422868672,ECE 200,036,103621,Papen; George C.,9999,0,9999,0
1668422868672,ECE 200,037,103622,Radic; Stojan,9999,0,9999,0
1668422868672,ECE 200,038,103623,Rao; Bhaskar D.,9999,0,9999,0
1668422868672,ECE 200,039,103624,Rao; Ramesh R,9999,0,9999,0
1668422868672,ECE 200,040,103625,Rebeiz; Gabriel,9999,0,9999,0
1668422868672,ECE 200,041,103626,Sanford; John R,9999,0,9999,0
1668422868672,ECE 200,042,103627,Siegel; Paul H.,9999,0,9999,0
1668422868672,ECE 200,043,103628,Sievenpiper; Daniel F.,9999,0,9999,0
1668422868672,ECE 200,044,103629,Sworder; David D.,9999,0,9999,0
1668422868672,ECE 200,045,103630,Taur; Yuan,9999,0,9999,0
1668422868672,ECE 200,046,103631,Touri; Behrouz,9999,0,9999,0
1668422868672,ECE 200,047,103632,Trivedi; Mohan M.,9999,0,9999,0
1668422868672,ECE 200,048,103633,Vasconcelos; Nuno,9999,0,9999,0
1668422868672,ECE 200,049,103634,Wang; Xiaolong,9999,0,9999,0
1668422868672,ECE 200,050,103635,Xie; Pengtao,9999,0,9999,0
1668422868672,ECE 200,051,103636,Yip; Michael,9999,0,9999,0
1668422868672,ECE 200,052,103637,Zeger; Kenneth A.,999,0,999,0
1668422868672,ECE 200,053,103638,Zhang; Xinyu,9999,0,9999,0
1668422868672,ECE 200,054,103639,Turakhia; Yatish Girish,9999,0,9999,0
1668422868672,ECE 200,055,103640,Kang; Mingu,9999,0,9999,0
1668422868672,ECE 200,056,103641,Shi; Yuanyuan,9999,0,9999,0
1668422868672,ECE 200,057,103642,Wang; Edward Jay,9999,0,9999,0
1668422868672,ECE 200,058,103643,Zheng; Yang,9999,0,9999,0
1668422869106,ECE 202,A00,103644,Kuzum; Duygu,0,21,0,0
1668422869531,ECE 212BN,A00,103646,Ng; Tse Nga,0,1,0,0
1668422869954,ECE 221,A00,111493,Staff,0,0,0,0
1668422870382,ECE 222B,A00,103647,Lomakin; Vitaliy,0,5,0,0
1668422870806,ECE 230B,A00,103648,Taur; Yuan,0,0,0,0
1668422871236,ECE 238B,A00,103649,Garay; Javier,0,0,0,0
1668422871661,ECE 240B,A00,112900,Fainman; Yeshaiahu,0,4,0,0
1668422872085,ECE 247A,A00,103650,Jokerst; Jesse Vincent,0,1,0,0
1668422872513,ECE 247B,A00,103651,Wang; Joseph,0,4,0,0
1668422872946,ECE 250,A00,103652,Siegel; Paul H.,0,42,0,0
1668422873373,ECE 251A,A00,103654,Rao; Bhaskar D.,0,28,0,0
1668422873810,ECE 257B,A00,103655,Bharadia; Dinesh,0,12,0,0
1668422874237,ECE 258A,A00,103656,Milstein; Laurence B.,0,10,0,0
1668422874677,ECE 260B,A00,103658,Kang; Mingu,0,64,0,0
1668422875112,ECE 264A,A00,103659,Galton; Ian A,0,31,0,0
1668422875537,ECE 265A,A00,103661,Gudem; Prasad S.S.,0,16,0,0
1668422875961,ECE 265D,A00,103662,Gudem; Prasad S.S.,0,10,0,0
1668422876393,ECE 268,A00,103663,Koushanfar; Farinaz,0,18,0,0
1668422876829,ECE 269,A01,103665,Pal; Piya,0,123,0,0
1668422877262,ECE 271B,A00,103666,Vasconcelos; Manuela,0,46,0,0
1668422877686,ECE 276A,A00,103667,Atanasov; Nikolay A.,0,66,0,0
1668422878127,ECE 277,A00,103668,An; Cheolhong,0,87,0,0
1668422878553,ECE 279,A00,117947,Hall; Drew A.,0,11,0,0
1668422879436,ECE 283,A00,103670,Hsueh; Tzu-Chien,0,21,0,0
1668422879862,ECE 284,A00,103671,Turakhia; Yatish Girish,0,22,0,0
1668422880295,ECE 285,A00,103672,Zheng; Yang,0,22,0,0
1668422880295,ECE 285,B00,103673,Sworder; David D.,0,36,0,0
1668422880734,ECE 287,A00,103676,Javidi; Tara,0,4,0,0
1668422881179,MATH 200B,A00,098023,Salehi Golsefidy; Alireza,12,0,15,3
1668422881626,MATH 202B,A00,098024,Rhoades; Brendon Patrick,9,0,15,6
1668422882054,MATH 203B,A00,098025,Oprea; Dragos N.,10,0,15,5
1668422882483,MATH 204B,A00,098026,Sorensen; Claus M,13,0,15,2
1668422882907,MATH 208,A00,098027,Izadi; Elham,7,0,10,3
1668422883331,MATH 209,A00,098028,Pollack; Aaron,10,0,10,0
1668422883756,MATH 211A,A00,112919,Rogalski; Daniel,9,0,10,1
1668422884185,MATH 211B,A00,112920,Seward; Brandon M.,9,0,10,1
1668422884608,MATH 218,A00,098029,Li; Bo,10,0,10,0
1668422885042,MATH 220B,A00,098030,Novak; Jonathan I,11,0,15,4
1668422885499,MATH 221A,A00,098031,Ebenfelt; Peter F,13,0,15,2
1668422885932,MATH 231B,A00,098032,Zlatos; Andrej,12,0,15,3
1668422886357,MATH 240B,A00,098033,Ni; Lei,9,0,15,6
1668422886783,MATH 243,A00,098034,Jekel; David Andrew,10,0,10,0
1668422887212,MATH 245A,A00,098035,Nie; Jiawang,0,1,15,16
1668422887636,MATH 248,A00,098036,Bejenaru; Ioan,10,0,10,0
1668422888062,MATH 250B,A00,098037,Spolaor; Luca,14,0,15,1
1668422888488,MATH 258,A00,098038,Ni; Lei,10,0,10,0
1668422888926,MATH 264B,A00,098041,Rhoades; Brendon Patrick,9,0,15,6
1668422889374,MATH 268,A00,098042,Buss; Samuel R,10,0,10,0
1668422889808,MATH 269,A00,098043,Rhoades; Brendon Patrick,10,0,10,0
1668422890251,MATH 270B,A00,098044,Li; Bo,10,0,15,5
1668422890680,MATH 272B,A00,098045,Holst; Michael J,13,0,15,2
1668422891105,MATH 273A,A00,098046,Tian; Xiaochuan,10,0,15,5
1668422891534,MATH 275,A01,098048,Tian; Xiaochuan,6,0,10,4
1668422891958,MATH 278A,A00,098049,Holst; Michael J,8,0,10,2
1668422892394,MATH 278B,A00,098050,Cloninger; Alexander,10,0,10,0
1668422892819,MATH 278C,A00,098051,Nie; Jiawang,6,0,10,4
1668422893274,MATH 280B,A00,098052,Zheng; Tianyi,8,0,15,7
1668422893707,MATH 281B,A00,098053,Bradic; Jelena,0,1,15,15
1668422894137,MATH 282B,A00,098054,Arias-Castro; Ery,0,0,15,15
1668422894563,MATH 285,A00,098055,Fitzsimmons; Patrick J,0,0,15,17
1668422895007,MATH 287B,A00,098056,Arias-Castro; Ery,2,0,15,13
1668422895442,MATH 288,A00,098057,Agarwal; Pooja,9,0,10,1
1668422895442,MATH 288,B00,098058,Zhang; Danna,8,0,10,2
1668422895442,MATH 288,C00,098059,Williams; Ruth J,9,0,10,1
1668422895878,MATH 290B,A00,098060,Roberts; Justin Deritter,13,0,15,2
1668422896303,MATH 292,A00,098061,Belmont; Eva Kinoshita,10,0,10,0
1668422896729,MATH 295,A00,098062,Suk; Andrew Hoon,48,0,50,2
1668422897155,MATH 296,A00,098063,Novak; Jonathan I,20,0,20,0
1668422897597,MATH 297,001,098064,Gamst; Anthony Collins,9997,0,9999,2
1668423404790,COGS 205,A00,101395,Chiba; Andrea,19,0,20,1
1668423405233,COGS 210B,001,101404,Greene; Deanna Jacquelyn,9998,0,9999,1
1668423405233,COGS 210B,002,101417,Xia; Haijun,9999,0,9999,0
1668423405233,COGS 210B,003,101422,Nitz; Douglas A.,9999,0,9999,0
1668423405233,COGS 210B,004,101423,Hollan; James D.,9998,0,9999,1
1668423405233,COGS 210B,005,101424,Deak; Gedeon O.,9998,0,9999,1
1668423405233,COGS 210B,006,101425,Rossano; Federico,9999,0,9999,0
1668423405663,COGS 211B,A00,101427,Coulson; Seana M,9996,0,9999,3
1668423406107,COGS 220,A00,101428,Hollan; James D.,1,2,25,24
1668423406530,COGS 229,A00,101429,Dow; Steven P,18,0,25,7
1668423406971,COGS 230,A00,101430,Klemmer; Scott R,11,0,17,6
1668423407397,COGS 234,A00,101431,Xia; Haijun,2,0,25,23
1668423407823,COGS 260,A00,101432,Kiyonaga; Anastasia,21,0,25,4
1668423407823,COGS 260,B00,101433,Kirsh; David Joel,15,0,25,10
1668423408250,CSE 202,A00,102371,Impagliazzo; Russell,0,31,0,0
1668423408686,CSE 203B,A01,102373,Cheng; Chung Kuan,0,24,0,0
1668423409111,CSE 208,A00,102374,Micciancio; Daniele,0,1,0,0
1668423409536,CSE 209A,A00,112895,Impagliazzo; Russell,0,3,15,15
1668423409961,CSE 209B,A00,108005,Bellare; Mihir,0,3,0,0
1668423410387,CSE 210,A00,113163,Coblenz; Michael J,0,41,0,0
1668423410809,CSE 219,A00,106111,Dow; Steven P,0,0,20,20
1668423411248,CSE 221,A00,102376,Voelker; Geoffrey M.,0,29,0,0
1668423411678,CSE 224,A01,102378,Porter; George M,0,102,0,0
1668423412102,CSE 229A,A00,102379,Savage; Stefan,0,4,0,0
1668423412527,CSE 229C,A00,102380,Munyaka; Imani N. S.,0,4,0,0
1668423412979,CSE 232B,A00,102382,Deutsch; Alin Bernard,0,13,0,0
1668423413405,CSE 234,A01,112904,Kumar; Arun Kumar,0,0,0,0
1668423413827,CSE 237A,A00,102383,Rosing; Tajana Simunic,0,25,0,0
1668423414255,CSE 239A,A00,102384,Deutsch; Alin Bernard,0,5,0,0
1668423414683,CSE 239B,A00,102385,Polikarpova; Nadezhda,0,3,0,0
1668423415116,CSE 240A,A00,102386,Pannuto; Patrick William,0,24,0,0
1668423415549,CSE 240B,A00,102387,Zhao; Jishen,0,23,0,0
1668423415973,CSE 241A,A00,106406,Kang; Mingu,0,2,0,0
1668423416408,CSE 249B,A00,102388,Kahng; Andrew Byun,0,1,8,8
1668423416833,CSE 251B,A01,102392,Cottrell; Garrison W,0,22,0,0
1668423416833,CSE 251B,A02,102393,Cottrell; Garrison W,0,21,0,0
1668423417273,CSE 252B,A00,102394,Ochoa; Benjamin Lawrence,0,35,0,0
1668423417710,CSE 257,A01,102396,Gao; Sicun,0,86,0,0
1668423418138,CSE 272,A00,102397,Li; Tzumao,0,7,0,0
1668423418564,CSE 274,A00,111323,Chern; Albert Ren-Haur,0,7,0,0
1668423418989,CSE 282,A00,102398,Pevzner; Pavel Arkadjevich,0,0,0,0
1668423419438,CSE 284,A00,114175,Gymrek; Melissa Ann,0,9,0,0
1668423419878,CSE 290,A00,102399,Chandraker; Manmohan Krishna,0,4,0,0
1668423419878,CSE 290,B00,102400,Vaccaro; Kristen Marie,0,1,25,25
1668423419878,CSE 290,C00,102414,Pannuto; Patrick William,0,1,25,25
1668423419878,CSE 290,D00,102427,Pevzner; Pavel Arkadjevich,0,0,0,0
1668423419878,CSE 290,E00,102429,Zhao; Jishen,0,1,0,0
1668423419878,CSE 290,F00,102436,Tullsen; Dean Michael,0,2,0,0
1668423419878,CSE 290,G00,102440,Christensen; Henrik I,0,3,20,20
1668423420303,CSE 291,A00,102443,Su; Hao,0,0,0,0
1668423420303,CSE 291,B00,102448,Polikarpova; Nadezhda,0,0,0,0
1668423420303,CSE 291,C00,102453,Vaccaro; Kristen Marie,0,0,0,0
1668423420303,CSE 291,D00,111343,Savage; Stefan,0,0,0,0
1668423420303,CSE 291,E00,116474,Claffy; Kimberly Claire,0,0,0,0
1668423420303,CSE 291,F00,116479,Pasquale; Joseph,0,0,0,0
1668423420739,CSE 293,001,119111,Bafna; Vineet,9999,0,9999,0
1668423420739,CSE 293,002,119118,Bellare; Mihir,9999,0,9999,0
1668423420739,CSE 293,003,119122,Berg-Kirkpatrick; Taylor D,9999,0,9999,0
1668423420739,CSE 293,004,119135,Christensen; Henrik I,9999,0,9999,0
1668423420739,CSE 293,005,119142,Cottrell; Garrison W,9999,0,9999,0
1668423420739,CSE 293,006,119146,Deutsch; Alin Bernard,9999,0,9999,0
1668423420739,CSE 293,007,119159,Esmaeilzadeh; Hadi,9999,0,9999,0
1668423420739,CSE 293,008,119166,Freund; Yoav,9999,0,9999,0
1668423420739,CSE 293,009,119170,Griswold; William G.,9999,0,9999,0
1668423420739,CSE 293,010,119183,Gymrek; Melissa Ann,9999,0,9999,0
1668423420739,CSE 293,011,119190,Heninger; Nadia A,9999,0,9999,0
1668423420739,CSE 293,012,119230,Impagliazzo; Russell,9999,0,9999,0
1668423420739,CSE 293,013,119232,Jhala; Ranjit,9999,0,9999,0
1668423420739,CSE 293,014,119233,Kahng; Andrew Byun,9999,0,9999,0
1668423420739,CSE 293,015,119298,Kane; Daniel Mertz,9999,0,9999,0
1668423420739,CSE 293,016,119299,Kriegman; David J,9999,0,9999,0
1668423420739,CSE 293,017,119300,Kumar; Arun Kumar,9999,0,9999,0
1668423420739,CSE 293,018,119301,Lerner; Sorin,9999,0,9999,0
1668423420739,CSE 293,019,119302,Lovett; Shachar,9999,0,9999,0
1668423420739,CSE 293,020,119303,McAuley; Julian John,9999,0,9999,0
1668423420739,CSE 293,021,119304,Micciancio; Daniele,9999,0,9999,0
1668423420739,CSE 293,022,119367,Orailoglu; Alex,9999,0,9999,0
1668423420739,CSE 293,023,119382,Paturi; Ramamohan,9999,0,9999,0
1668423420739,CSE 293,024,119404,Polikarpova; Nadezhda,9999,0,9999,0
1668423420739,CSE 293,025,119406,Politz; Joseph Gibbs,9999,0,9999,0
1668423420739,CSE 293,026,119411,Porter; George M,9999,0,9999,0
1668423420739,CSE 293,027,119414,Porter; Leonard Emerson,9999,0,9999,0
1668423420739,CSE 293,028,119416,Ramamoorthi; Ravi,9999,0,9999,0
1668423420739,CSE 293,029,119417,Sahoo; Debashis,9999,0,9999,0
1668423420739,CSE 293,030,119420,Saul; Lawrence,9999,0,9999,0
1668423420739,CSE 293,031,119421,Savage; Stefan,9999,0,9999,0
1668423420739,CSE 293,032,119425,Schulze; Jurgen P.,9999,0,9999,0
1668423420739,CSE 293,033,119426,Snoeren; Alex C.,9999,0,9999,0
1668423420739,CSE 293,034,119428,Shang; Jingbo,9999,0,9999,0
1668423420739,CSE 293,035,119430,Stefan; Deian,9999,0,9999,0
1668423420739,CSE 293,036,119431,Su; Hao,9999,0,9999,0
1668423420739,CSE 293,037,119433,Swanson; Steven James,9999,0,9999,0
1668423420739,CSE 293,038,119435,Tullsen; Dean Michael,9999,0,9999,0
1668423420739,CSE 293,039,119483,Voelker; Geoffrey M.,9999,0,9999,0
1668423420739,CSE 293,040,119537,Zhao; Jishen,9999,0,9999,0
1668423420739,CSE 293,041,119538,Zhou; Yuan-Yuan,9999,0,9999,0
1668423420739,CSE 293,042,119539,Gao; Sicun,9999,0,9999,0
1668423420739,CSE 293,043,119540,Weibel; Nadir,9999,0,9999,0
1668423420739,CSE 293,044,119541,Gupta; Rajesh K.,9999,0,9999,0
1668423420739,CSE 293,045,126410,Vaccaro; Kristen Marie,9999,0,9999,0
1668423420739,CSE 293,046,126411,Klemke; Richard,9999,0,9999,0
1668423421189,CSE 294,A00,102459,Voelker; Geoffrey M.,0,1,0,0
1668423421189,CSE 294,B00,111322,Orailoglu; Alex,0,0,0,0
1668423421613,DSE 201,A00,096914,Deutsch; Alin Bernard,30,0,30,0
1668423422038,DSE 210,A00,096915,Dasgupta; Sanjoy,30,0,30,0
1668423422465,DSE 260A,A00,096916,Altintas De Callaf; Ilkay,30,0,30,0
1668423422933,ECE 200,001,103586,Antipa; Nicholas A,9999,0,9999,0
1668423422933,ECE 200,002,103587,Atanasov; Nikolay A.,9999,0,9999,0
1668423422933,ECE 200,003,103588,Bharadia; Dinesh,9999,0,9999,0
1668423422933,ECE 200,004,103589,Cheng; Chung Kuan,9999,0,9999,0
1668423422933,ECE 200,005,103590,Cosman; Pamela C.,9999,0,9999,0
1668423422933,ECE 200,006,103591,Dayeh; Shadi Ahmad,9999,0,9999,0
1668423422933,ECE 200,007,103592,Fainman; Yeshaiahu,9999,0,9999,0
1668423422933,ECE 200,008,103593,Ford; Joseph Earl,9999,0,9999,0
1668423422933,ECE 200,009,103594,Franceschetti; Massimo,9999,0,9999,0
1668423422933,ECE 200,010,103595,Fullerton; Eric E,9999,0,9999,0
1668423422933,ECE 200,011,103596,Galton; Ian A,9999,0,9999,0
1668423422933,ECE 200,012,103597,Gilja; Vikash,9999,0,9999,0
1668423422933,ECE 200,013,103598,Hall; Drew A.,9999,0,9999,0
1668423422933,ECE 200,014,103599,Hsueh; Tzu-Chien,9999,0,9999,0
1668423422933,ECE 200,015,103600,Javidi; Tara,9999,0,9999,0
1668423422933,ECE 200,016,103601,Kahng; Andrew Byun,9999,0,9999,0
1668423422933,ECE 200,017,103602,Kim; Young-Han,9999,0,9999,0
1668423422933,ECE 200,018,103603,Koushanfar; Farinaz,9999,0,9999,0
1668423422933,ECE 200,019,103604,Kuzum; Duygu,9999,0,9999,0
1668423422933,ECE 200,020,103605,Le; Hanh-Phuc,9999,0,9999,0
1668423422933,ECE 200,021,103606,Lin; Bill,9999,0,9999,0
1668423422933,ECE 200,022,103607,Liu; Zhaowei,9998,0,9999,1
1668423422933,ECE 200,023,103608,Lo; Yu-Hwa,9999,0,9999,0
1668423422933,ECE 200,024,103609,Lomakin; Vitaliy,9999,0,9999,0
1668423422933,ECE 200,025,103610,Mercier; Patrick Philip,9999,0,9999,0
1668423422933,ECE 200,026,103611,Meyer; Florian,9999,0,9999,0
1668423422933,ECE 200,027,103612,Milstein; Laurence B.,9999,0,9999,0
1668423422933,ECE 200,028,103613,Mir Arabbaygi; Siavash,9999,0,9999,0
1668423422933,ECE 200,029,103614,Mookherjea; Shayan,9999,0,9999,0
1668423422933,ECE 200,030,103615,Morris; Karcher William,9999,0,9999,0
1668423422933,ECE 200,031,103616,Ng; Tse Nga,9999,0,9999,0
1668423422933,ECE 200,032,103617,Nguyen; Truong Quang,9999,0,9999,0
1668423422933,ECE 200,033,103618,Nomura; Kenji,9999,0,9999,0
1668423422933,ECE 200,034,103619,Orlitsky; Alon,9999,0,9999,0
1668423422933,ECE 200,035,103620,Pal; Piya,9999,0,9999,0
1668423422933,ECE 200,036,103621,Papen; George C.,9999,0,9999,0
1668423422933,ECE 200,037,103622,Radic; Stojan,9999,0,9999,0
1668423422933,ECE 200,038,103623,Rao; Bhaskar D.,9999,0,9999,0
1668423422933,ECE 200,039,103624,Rao; Ramesh R,9999,0,9999,0
1668423422933,ECE 200,040,103625,Rebeiz; Gabriel,9999,0,9999,0
1668423422933,ECE 200,041,103626,Sanford; John R,9999,0,9999,0
1668423422933,ECE 200,042,103627,Siegel; Paul H.,9999,0,9999,0
1668423422933,ECE 200,043,103628,Sievenpiper; Daniel F.,9999,0,9999,0
1668423422933,ECE 200,044,103629,Sworder; David D.,9999,0,9999,0
1668423422933,ECE 200,045,103630,Taur; Yuan,9999,0,9999,0
1668423422933,ECE 200,046,103631,Touri; Behrouz,9999,0,9999,0
1668423422933,ECE 200,047,103632,Trivedi; Mohan M.,9999,0,9999,0
1668423422933,ECE 200,048,103633,Vasconcelos; Nuno,9999,0,9999,0
1668423422933,ECE 200,049,103634,Wang; Xiaolong,9999,0,9999,0
1668423422933,ECE 200,050,103635,Xie; Pengtao,9999,0,9999,0
1668423422933,ECE 200,051,103636,Yip; Michael,9999,0,9999,0
1668423422933,ECE 200,052,103637,Zeger; Kenneth A.,999,0,999,0
1668423422933,ECE 200,053,103638,Zhang; Xinyu,9999,0,9999,0
1668423422933,ECE 200,054,103639,Turakhia; Yatish Girish,9999,0,9999,0
1668423422933,ECE 200,055,103640,Kang; Mingu,9999,0,9999,0
1668423422933,ECE 200,056,103641,Shi; Yuanyuan,9999,0,9999,0
1668423422933,ECE 200,057,103642,Wang; Edward Jay,9999,0,9999,0
1668423422933,ECE 200,058,103643,Zheng; Yang,9999,0,9999,0
1668423423362,ECE 202,A00,103644,Kuzum; Duygu,0,21,0,0
1668423423798,ECE 212BN,A00,103646,Ng; Tse Nga,0,1,0,0
1668423424222,ECE 221,A00,111493,Staff,0,0,0,0
1668423424646,ECE 222B,A00,103647,Lomakin; Vitaliy,0,5,0,0
1668423425070,ECE 230B,A00,103648,Taur; Yuan,0,0,0,0
1668423425523,ECE 238B,A00,103649,Garay; Javier,0,0,0,0
1668423425956,ECE 240B,A00,112900,Fainman; Yeshaiahu,0,4,0,0
1668423426393,ECE 247A,A00,103650,Jokerst; Jesse Vincent,0,1,0,0
1668423426827,ECE 247B,A00,103651,Wang; Joseph,0,4,0,0
1668423427272,ECE 250,A00,103652,Siegel; Paul H.,0,42,0,0
1668423427696,ECE 251A,A00,103654,Rao; Bhaskar D.,0,28,0,0
1668423428222,ECE 257B,A00,103655,Bharadia; Dinesh,0,12,0,0
1668423428662,ECE 258A,A00,103656,Milstein; Laurence B.,0,10,0,0
1668423429086,ECE 260B,A00,103658,Kang; Mingu,0,64,0,0
1668423429521,ECE 264A,A00,103659,Galton; Ian A,0,31,0,0
1668423429972,ECE 265A,A00,103661,Gudem; Prasad S.S.,0,16,0,0
1668423430410,ECE 265D,A00,103662,Gudem; Prasad S.S.,0,10,0,0
1668423430834,ECE 268,A00,103663,Koushanfar; Farinaz,0,18,0,0
1668423431261,ECE 269,A01,103665,Pal; Piya,0,124,0,0
1668423431709,ECE 271B,A00,103666,Vasconcelos; Manuela,0,46,0,0
1668423432135,ECE 276A,A00,103667,Atanasov; Nikolay A.,0,66,0,0
1668423432559,ECE 277,A00,103668,An; Cheolhong,0,87,0,0
1668423432999,ECE 279,A00,117947,Hall; Drew A.,0,11,0,0
1668423433885,ECE 283,A00,103670,Hsueh; Tzu-Chien,0,21,0,0
1668423434308,ECE 284,A00,103671,Turakhia; Yatish Girish,0,22,0,0
1668423434734,ECE 285,A00,103672,Zheng; Yang,0,22,0,0
1668423434734,ECE 285,B00,103673,Sworder; David D.,0,36,0,0
1668423435167,ECE 287,A00,103676,Javidi; Tara,0,4,0,0
1668423435615,MATH 200B,A00,098023,Salehi Golsefidy; Alireza,12,0,15,3
1668423436072,MATH 202B,A00,098024,Rhoades; Brendon Patrick,9,0,15,6
1668423436511,MATH 203B,A00,098025,Oprea; Dragos N.,10,0,15,5
1668423436939,MATH 204B,A00,098026,Sorensen; Claus M,13,0,15,2
1668423437380,MATH 208,A00,098027,Izadi; Elham,7,0,10,3
1668423437816,MATH 209,A00,098028,Pollack; Aaron,10,0,10,0
1668423438254,MATH 211A,A00,112919,Rogalski; Daniel,9,0,10,1
1668423438679,MATH 211B,A00,112920,Seward; Brandon M.,9,0,10,1
1668423439106,MATH 218,A00,098029,Li; Bo,10,0,10,0
1668423439534,MATH 220B,A00,098030,Novak; Jonathan I,11,0,15,4
1668423439962,MATH 221A,A00,098031,Ebenfelt; Peter F,13,0,15,2
1668423440403,MATH 231B,A00,098032,Zlatos; Andrej,12,0,15,3
1668423440832,MATH 240B,A00,098033,Ni; Lei,9,0,15,6
1668423441257,MATH 243,A00,098034,Jekel; David Andrew,10,0,10,0
1668423441688,MATH 245A,A00,098035,Nie; Jiawang,0,1,15,16
1668423442123,MATH 248,A00,098036,Bejenaru; Ioan,10,0,10,0
1668423442548,MATH 250B,A00,098037,Spolaor; Luca,14,0,15,1
1668423442976,MATH 258,A00,098038,Ni; Lei,10,0,10,0
1668423443400,MATH 264B,A00,098041,Rhoades; Brendon Patrick,9,0,15,6
1668423443856,MATH 268,A00,098042,Buss; Samuel R,10,0,10,0
1668423444281,MATH 269,A00,098043,Rhoades; Brendon Patrick,10,0,10,0
1668423444718,MATH 270B,A00,098044,Li; Bo,10,0,15,5
1668423445141,MATH 272B,A00,098045,Holst; Michael J,13,0,15,2
1668423445607,MATH 273A,A00,098046,Tian; Xiaochuan,10,0,15,5
1668423446039,MATH 275,A01,098048,Tian; Xiaochuan,6,0,10,4
1668423446465,MATH 278A,A00,098049,Holst; Michael J,8,0,10,2
1668423446890,MATH 278B,A00,098050,Cloninger; Alexander,10,0,10,0
1668423447315,MATH 278C,A00,098051,Nie; Jiawang,6,0,10,4
1668423447761,MATH 280B,A00,098052,Zheng; Tianyi,8,0,15,7
1668423448190,MATH 281B,A00,098053,Bradic; Jelena,0,1,15,15
1668423448613,MATH 282B,A00,098054,Arias-Castro; Ery,0,0,15,15
1668423449048,MATH 285,A00,098055,Fitzsimmons; Patrick J,0,0,15,17
1668423449488,MATH 287B,A00,098056,Arias-Castro; Ery,2,0,15,13
1668423449932,MATH 288,A00,098057,Agarwal; Pooja,9,0,10,1
1668423449932,MATH 288,B00,098058,Zhang; Danna,8,0,10,2
1668423449932,MATH 288,C00,098059,Williams; Ruth J,9,0,10,1
1668423450359,MATH 290B,A00,098060,Roberts; Justin Deritter,13,0,15,2
1668423450783,MATH 292,A00,098061,Belmont; Eva Kinoshita,10,0,10,0
1668423451208,MATH 295,A00,098062,Suk; Andrew Hoon,48,0,50,2
1668423451632,MATH 296,A00,098063,Novak; Jonathan I,20,0,20,0
1668423452061,MATH 297,001,098064,Gamst; Anthony Collins,9997,0,9999,2
1668423959075,COGS 205,A00,101395,Chiba; Andrea,19,0,20,1
1668423959528,COGS 210B,001,101404,Greene; Deanna Jacquelyn,9998,0,9999,1
1668423959528,COGS 210B,002,101417,Xia; Haijun,9999,0,9999,0
1668423959528,COGS 210B,003,101422,Nitz; Douglas A.,9999,0,9999,0
1668423959528,COGS 210B,004,101423,Hollan; James D.,9998,0,9999,1
1668423959528,COGS 210B,005,101424,Deak; Gedeon O.,9998,0,9999,1
1668423959528,COGS 210B,006,101425,Rossano; Federico,9999,0,9999,0
1668423959953,COGS 211B,A00,101427,Coulson; Seana M,9996,0,9999,3
1668423960399,COGS 220,A00,101428,Hollan; James D.,1,2,25,24
1668423960851,COGS 229,A00,101429,Dow; Steven P,18,0,25,7
1668423961276,COGS 230,A00,101430,Klemmer; Scott R,11,0,17,6
1668423961706,COGS 234,A00,101431,Xia; Haijun,2,0,25,23
1668423962133,COGS 260,A00,101432,Kiyonaga; Anastasia,21,0,25,4
1668423962133,COGS 260,B00,101433,Kirsh; David Joel,15,0,25,10
1668423962556,CSE 202,A00,102371,Impagliazzo; Russell,0,31,0,0
1668423962985,CSE 203B,A01,102373,Cheng; Chung Kuan,0,25,0,0
1668423963413,CSE 208,A00,102374,Micciancio; Daniele,0,1,0,0
1668423963852,CSE 209A,A00,112895,Impagliazzo; Russell,0,3,15,15
1668423964287,CSE 209B,A00,108005,Bellare; Mihir,0,3,0,0
1668423964712,CSE 210,A00,113163,Coblenz; Michael J,0,41,0,0
1668423965137,CSE 219,A00,106111,Dow; Steven P,0,0,20,20
1668423965573,CSE 221,A00,102376,Voelker; Geoffrey M.,0,29,0,0
1668423965997,CSE 224,A01,102378,Porter; George M,0,102,0,0
1668423966436,CSE 229A,A00,102379,Savage; Stefan,0,4,0,0
1668423966858,CSE 229C,A00,102380,Munyaka; Imani N. S.,0,4,0,0
1668423967305,CSE 232B,A00,102382,Deutsch; Alin Bernard,0,13,0,0
1668423967729,CSE 234,A01,112904,Kumar; Arun Kumar,0,0,0,0
1668423968157,CSE 237A,A00,102383,Rosing; Tajana Simunic,0,25,0,0
1668423968598,CSE 239A,A00,102384,Deutsch; Alin Bernard,0,5,0,0
1668423969042,CSE 239B,A00,102385,Polikarpova; Nadezhda,0,3,0,0
1668423969481,CSE 240A,A00,102386,Pannuto; Patrick William,0,24,0,0
1668423969910,CSE 240B,A00,102387,Zhao; Jishen,0,23,0,0
1668423970340,CSE 241A,A00,106406,Kang; Mingu,0,2,0,0
1668423970766,CSE 249B,A00,102388,Kahng; Andrew Byun,0,1,8,8
1668423971209,CSE 251B,A01,102392,Cottrell; Garrison W,0,21,0,0
1668423971209,CSE 251B,A02,102393,Cottrell; Garrison W,0,21,0,0
1668423971634,CSE 252B,A00,102394,Ochoa; Benjamin Lawrence,0,35,0,0
1668423972061,CSE 257,A01,102396,Gao; Sicun,0,86,0,0
1668423972487,CSE 272,A00,102397,Li; Tzumao,0,7,0,0
1668423972916,CSE 274,A00,111323,Chern; Albert Ren-Haur,0,7,0,0
1668423973349,CSE 282,A00,102398,Pevzner; Pavel Arkadjevich,0,0,0,0
1668423973777,CSE 284,A00,114175,Gymrek; Melissa Ann,0,9,0,0
1668423974212,CSE 290,A00,102399,Chandraker; Manmohan Krishna,0,4,0,0
1668423974212,CSE 290,B00,102400,Vaccaro; Kristen Marie,0,1,25,25
1668423974212,CSE 290,C00,102414,Pannuto; Patrick William,0,1,25,25
1668423974212,CSE 290,D00,102427,Pevzner; Pavel Arkadjevich,0,0,0,0
1668423974212,CSE 290,E00,102429,Zhao; Jishen,0,1,0,0
1668423974212,CSE 290,F00,102436,Tullsen; Dean Michael,0,2,0,0
1668423974212,CSE 290,G00,102440,Christensen; Henrik I,0,3,20,20
1668423974658,CSE 291,A00,102443,Su; Hao,0,0,0,0
1668423974658,CSE 291,B00,102448,Polikarpova; Nadezhda,0,0,0,0
1668423974658,CSE 291,C00,102453,Vaccaro; Kristen Marie,0,0,0,0
1668423974658,CSE 291,D00,111343,Savage; Stefan,0,0,0,0
1668423974658,CSE 291,E00,116474,Claffy; Kimberly Claire,0,0,0,0
1668423974658,CSE 291,F00,116479,Pasquale; Joseph,0,0,0,0
1668423975102,CSE 293,001,119111,Bafna; Vineet,9999,0,9999,0
1668423975102,CSE 293,002,119118,Bellare; Mihir,9999,0,9999,0
1668423975102,CSE 293,003,119122,Berg-Kirkpatrick; Taylor D,9999,0,9999,0
1668423975102,CSE 293,004,119135,Christensen; Henrik I,9999,0,9999,0
1668423975102,CSE 293,005,119142,Cottrell; Garrison W,9999,0,9999,0
1668423975102,CSE 293,006,119146,Deutsch; Alin Bernard,9999,0,9999,0
1668423975102,CSE 293,007,119159,Esmaeilzadeh; Hadi,9999,0,9999,0
1668423975102,CSE 293,008,119166,Freund; Yoav,9999,0,9999,0
1668423975102,CSE 293,009,119170,Griswold; William G.,9999,0,9999,0
1668423975102,CSE 293,010,119183,Gymrek; Melissa Ann,9999,0,9999,0
1668423975102,CSE 293,011,119190,Heninger; Nadia A,9999,0,9999,0
1668423975102,CSE 293,012,119230,Impagliazzo; Russell,9999,0,9999,0
1668423975102,CSE 293,013,119232,Jhala; Ranjit,9999,0,9999,0
1668423975102,CSE 293,014,119233,Kahng; Andrew Byun,9999,0,9999,0
1668423975102,CSE 293,015,119298,Kane; Daniel Mertz,9999,0,9999,0
1668423975102,CSE 293,016,119299,Kriegman; David J,9999,0,9999,0
1668423975102,CSE 293,017,119300,Kumar; Arun Kumar,9999,0,9999,0
1668423975102,CSE 293,018,119301,Lerner; Sorin,9999,0,9999,0
1668423975102,CSE 293,019,119302,Lovett; Shachar,9999,0,9999,0
1668423975102,CSE 293,020,119303,McAuley; Julian John,9999,0,9999,0
1668423975102,CSE 293,021,119304,Micciancio; Daniele,9999,0,9999,0
1668423975102,CSE 293,022,119367,Orailoglu; Alex,9999,0,9999,0
1668423975102,CSE 293,023,119382,Paturi; Ramamohan,9999,0,9999,0
1668423975102,CSE 293,024,119404,Polikarpova; Nadezhda,9999,0,9999,0
1668423975102,CSE 293,025,119406,Politz; Joseph Gibbs,9999,0,9999,0
1668423975102,CSE 293,026,119411,Porter; George M,9999,0,9999,0
1668423975102,CSE 293,027,119414,Porter; Leonard Emerson,9999,0,9999,0
1668423975102,CSE 293,028,119416,Ramamoorthi; Ravi,9999,0,9999,0
1668423975102,CSE 293,029,119417,Sahoo; Debashis,9999,0,9999,0
1668423975102,CSE 293,030,119420,Saul; Lawrence,9999,0,9999,0
1668423975102,CSE 293,031,119421,Savage; Stefan,9999,0,9999,0
1668423975102,CSE 293,032,119425,Schulze; Jurgen P.,9999,0,9999,0
1668423975102,CSE 293,033,119426,Snoeren; Alex C.,9999,0,9999,0
1668423975102,CSE 293,034,119428,Shang; Jingbo,9999,0,9999,0
1668423975102,CSE 293,035,119430,Stefan; Deian,9999,0,9999,0
1668423975102,CSE 293,036,119431,Su; Hao,9999,0,9999,0
1668423975102,CSE 293,037,119433,Swanson; Steven James,9999,0,9999,0
1668423975102,CSE 293,038,119435,Tullsen; Dean Michael,9999,0,9999,0
1668423975102,CSE 293,039,119483,Voelker; Geoffrey M.,9999,0,9999,0
1668423975102,CSE 293,040,119537,Zhao; Jishen,9999,0,9999,0
1668423975102,CSE 293,041,119538,Zhou; Yuan-Yuan,9999,0,9999,0
1668423975102,CSE 293,042,119539,Gao; Sicun,9999,0,9999,0
1668423975102,CSE 293,043,119540,Weibel; Nadir,9999,0,9999,0
1668423975102,CSE 293,044,119541,Gupta; Rajesh K.,9999,0,9999,0
1668423975102,CSE 293,045,126410,Vaccaro; Kristen Marie,9999,0,9999,0
1668423975102,CSE 293,046,126411,Klemke; Richard,9999,0,9999,0
1668423975526,CSE 294,A00,102459,Voelker; Geoffrey M.,0,1,0,0
1668423975526,CSE 294,B00,111322,Orailoglu; Alex,0,0,0,0
1668423975952,DSE 201,A00,096914,Deutsch; Alin Bernard,30,0,30,0
1668423976391,DSE 210,A00,096915,Dasgupta; Sanjoy,30,0,30,0
1668423976829,DSE 260A,A00,096916,Altintas De Callaf; Ilkay,30,0,30,0
1668423977309,ECE 200,001,103586,Antipa; Nicholas A,9999,0,9999,0
1668423977309,ECE 200,002,103587,Atanasov; Nikolay A.,9999,0,9999,0
1668423977309,ECE 200,003,103588,Bharadia; Dinesh,9999,0,9999,0
1668423977309,ECE 200,004,103589,Cheng; Chung Kuan,9999,0,9999,0
1668423977309,ECE 200,005,103590,Cosman; Pamela C.,9999,0,9999,0
1668423977309,ECE 200,006,103591,Dayeh; Shadi Ahmad,9999,0,9999,0
1668423977309,ECE 200,007,103592,Fainman; Yeshaiahu,9999,0,9999,0
1668423977309,ECE 200,008,103593,Ford; Joseph Earl,9999,0,9999,0
1668423977309,ECE 200,009,103594,Franceschetti; Massimo,9999,0,9999,0
1668423977309,ECE 200,010,103595,Fullerton; Eric E,9999,0,9999,0
1668423977309,ECE 200,011,103596,Galton; Ian A,9999,0,9999,0
1668423977309,ECE 200,012,103597,Gilja; Vikash,9999,0,9999,0
1668423977309,ECE 200,013,103598,Hall; Drew A.,9999,0,9999,0
1668423977309,ECE 200,014,103599,Hsueh; Tzu-Chien,9999,0,9999,0
1668423977309,ECE 200,015,103600,Javidi; Tara,9999,0,9999,0
1668423977309,ECE 200,016,103601,Kahng; Andrew Byun,9999,0,9999,0
1668423977309,ECE 200,017,103602,Kim; Young-Han,9999,0,9999,0
1668423977309,ECE 200,018,103603,Koushanfar; Farinaz,9999,0,9999,0
1668423977309,ECE 200,019,103604,Kuzum; Duygu,9999,0,9999,0
1668423977309,ECE 200,020,103605,Le; Hanh-Phuc,9999,0,9999,0
1668423977309,ECE 200,021,103606,Lin; Bill,9999,0,9999,0
1668423977309,ECE 200,022,103607,Liu; Zhaowei,9998,0,9999,1
1668423977309,ECE 200,023,103608,Lo; Yu-Hwa,9999,0,9999,0
1668423977309,ECE 200,024,103609,Lomakin; Vitaliy,9999,0,9999,0
1668423977309,ECE 200,025,103610,Mercier; Patrick Philip,9999,0,9999,0
1668423977309,ECE 200,026,103611,Meyer; Florian,9999,0,9999,0
1668423977309,ECE 200,027,103612,Milstein; Laurence B.,9999,0,9999,0
1668423977309,ECE 200,028,103613,Mir Arabbaygi; Siavash,9999,0,9999,0
1668423977309,ECE 200,029,103614,Mookherjea; Shayan,9999,0,9999,0
1668423977309,ECE 200,030,103615,Morris; Karcher William,9999,0,9999,0
1668423977309,ECE 200,031,103616,Ng; Tse Nga,9999,0,9999,0
1668423977309,ECE 200,032,103617,Nguyen; Truong Quang,9999,0,9999,0
1668423977309,ECE 200,033,103618,Nomura; Kenji,9999,0,9999,0
1668423977309,ECE 200,034,103619,Orlitsky; Alon,9999,0,9999,0
1668423977309,ECE 200,035,103620,Pal; Piya,9999,0,9999,0
1668423977309,ECE 200,036,103621,Papen; George C.,9999,0,9999,0
1668423977309,ECE 200,037,103622,Radic; Stojan,9999,0,9999,0
1668423977309,ECE 200,038,103623,Rao; Bhaskar D.,9999,0,9999,0
1668423977309,ECE 200,039,103624,Rao; Ramesh R,9999,0,9999,0
1668423977309,ECE 200,040,103625,Rebeiz; Gabriel,9999,0,9999,0
1668423977309,ECE 200,041,103626,Sanford; John R,9999,0,9999,0
1668423977309,ECE 200,042,103627,Siegel; Paul H.,9999,0,9999,0
1668423977309,ECE 200,043,103628,Sievenpiper; Daniel F.,9999,0,9999,0
1668423977309,ECE 200,044,103629,Sworder; David D.,9999,0,9999,0
1668423977309,ECE 200,045,103630,Taur; Yuan,9999,0,9999,0
1668423977309,ECE 200,046,103631,Touri; Behrouz,9999,0,9999,0
1668423977309,ECE 200,047,103632,Trivedi; Mohan M.,9999,0,9999,0
1668423977309,ECE 200,048,103633,Vasconcelos; Nuno,9999,0,9999,0
1668423977309,ECE 200,049,103634,Wang; Xiaolong,9999,0,9999,0
1668423977309,ECE 200,050,103635,Xie; Pengtao,9999,0,9999,0
1668423977309,ECE 200,051,103636,Yip; Michael,9999,0,9999,0
1668423977309,ECE 200,052,103637,Zeger; Kenneth A.,999,0,999,0
1668423977309,ECE 200,053,103638,Zhang; Xinyu,9999,0,9999,0
1668423977309,ECE 200,054,103639,Turakhia; Yatish Girish,9999,0,9999,0
1668423977309,ECE 200,055,103640,Kang; Mingu,9999,0,9999,0
1668423977309,ECE 200,056,103641,Shi; Yuanyuan,9999,0,9999,0
1668423977309,ECE 200,057,103642,Wang; Edward Jay,9999,0,9999,0
1668423977309,ECE 200,058,103643,Zheng; Yang,9999,0,9999,0
1668423977732,ECE 202,A00,103644,Kuzum; Duygu,0,21,0,0
1668423978157,ECE 212BN,A00,103646,Ng; Tse Nga,0,1,0,0
1668423978580,ECE 221,A00,111493,Staff,0,0,0,0
1668423979003,ECE 222B,A00,103647,Lomakin; Vitaliy,0,5,0,0
1668423979434,ECE 230B,A00,103648,Taur; Yuan,0,0,0,0
1668423979879,ECE 238B,A00,103649,Garay; Javier,0,0,0,0
1668423980310,ECE 240B,A00,112900,Fainman; Yeshaiahu,0,4,0,0
1668423980746,ECE 247A,A00,103650,Jokerst; Jesse Vincent,0,1,0,0
1668423981171,ECE 247B,A00,103651,Wang; Joseph,0,4,0,0
1668423981595,ECE 250,A00,103652,Siegel; Paul H.,0,42,0,0
1668423982030,ECE 251A,A00,103654,Rao; Bhaskar D.,0,28,0,0
1668423982454,ECE 257B,A00,103655,Bharadia; Dinesh,0,12,0,0
1668423982880,ECE 258A,A00,103656,Milstein; Laurence B.,0,10,0,0
1668423983310,ECE 260B,A00,103658,Kang; Mingu,0,64,0,0
1668423983768,ECE 264A,A00,103659,Galton; Ian A,0,31,0,0
1668423984199,ECE 265A,A00,103661,Gudem; Prasad S.S.,0,16,0,0
1668423984633,ECE 265D,A00,103662,Gudem; Prasad S.S.,0,10,0,0
1668423985056,ECE 268,A00,103663,Koushanfar; Farinaz,0,18,0,0
1668423985488,ECE 269,A01,103665,Pal; Piya,0,124,0,0
1668423985936,ECE 271B,A00,103666,Vasconcelos; Manuela,0,46,0,0
1668423986377,ECE 276A,A00,103667,Atanasov; Nikolay A.,0,66,0,0
1668423986813,ECE 277,A00,103668,An; Cheolhong,0,87,0,0
1668423987238,ECE 279,A00,117947,Hall; Drew A.,0,11,0,0
1668423988125,ECE 283,A00,103670,Hsueh; Tzu-Chien,0,21,0,0
1668423988565,ECE 284,A00,103671,Turakhia; Yatish Girish,0,22,0,0
1668423989012,ECE 285,A00,103672,Zheng; Yang,0,22,0,0
1668423989012,ECE 285,B00,103673,Sworder; David D.,0,36,0,0
1668423989448,ECE 287,A00,103676,Javidi; Tara,0,4,0,0
1668423989884,MATH 200B,A00,098023,Salehi Golsefidy; Alireza,12,0,15,3
1668423990310,MATH 202B,A00,098024,Rhoades; Brendon Patrick,9,0,15,6
1668423990760,MATH 203B,A00,098025,Oprea; Dragos N.,10,0,15,5
1668423991192,MATH 204B,A00,098026,Sorensen; Claus M,13,0,15,2
1668423991621,MATH 208,A00,098027,Izadi; Elham,7,0,10,3
1668423992044,MATH 209,A00,098028,Pollack; Aaron,10,0,10,0
1668423992472,MATH 211A,A00,112919,Rogalski; Daniel,9,0,10,1
1668423992926,MATH 211B,A00,112920,Seward; Brandon M.,9,0,10,1
1668423993350,MATH 218,A00,098029,Li; Bo,10,0,10,0
1668423993779,MATH 220B,A00,098030,Novak; Jonathan I,11,0,15,4
1668423994202,MATH 221A,A00,098031,Ebenfelt; Peter F,13,0,15,2
1668423994652,MATH 231B,A00,098032,Zlatos; Andrej,12,0,15,3
1668423995088,MATH 240B,A00,098033,Ni; Lei,9,0,15,6
1668423995512,MATH 243,A00,098034,Jekel; David Andrew,10,0,10,0
1668423995939,MATH 245A,A00,098035,Nie; Jiawang,0,1,15,16
1668423996363,MATH 248,A00,098036,Bejenaru; Ioan,10,0,10,0
1668423996800,MATH 250B,A00,098037,Spolaor; Luca,14,0,15,1
1668423997226,MATH 258,A00,098038,Ni; Lei,10,0,10,0
1668423997651,MATH 264B,A00,098041,Rhoades; Brendon Patrick,9,0,15,6
1668423998076,MATH 268,A00,098042,Buss; Samuel R,10,0,10,0
1668423998532,MATH 269,A00,098043,Rhoades; Brendon Patrick,10,0,10,0
1668423998977,MATH 270B,A00,098044,Li; Bo,10,0,15,5
1668423999482,MATH 272B,A00,098045,Holst; Michael J,13,0,15,2
1668423999960,MATH 273A,A00,098046,Tian; Xiaochuan,10,0,15,5
1668424000411,MATH 275,A01,098048,Tian; Xiaochuan,6,0,10,4
1668424000836,MATH 278A,A00,098049,Holst; Michael J,8,0,10,2
1668424001277,MATH 278B,A00,098050,Cloninger; Alexander,10,0,10,0
1668424001704,MATH 278C,A00,098051,Nie; Jiawang,6,0,10,4
1668424002148,MATH 280B,A00,098052,Zheng; Tianyi,8,0,15,7
1668424002590,MATH 281B,A00,098053,Bradic; Jelena,0,1,15,15
1668424003015,MATH 282B,A00,098054,Arias-Castro; Ery,0,0,15,15
1668424003455,MATH 285,A00,098055,Fitzsimmons; Patrick J,0,0,15,17
1668424003882,MATH 287B,A00,098056,Arias-Castro; Ery,2,0,15,13
1668424004319,MATH 288,A00,098057,Agarwal; Pooja,9,0,10,1
1668424004319,MATH 288,B00,098058,Zhang; Danna,8,0,10,2
1668424004319,MATH 288,C00,098059,Williams; Ruth J,9,0,10,1
1668424004741,MATH 290B,A00,098060,Roberts; Justin Deritter,13,0,15,2
1668424005168,MATH 292,A00,098061,Belmont; Eva Kinoshita,10,0,10,0
1668424005602,MATH 295,A00,098062,Suk; Andrew Hoon,48,0,50,2
1668424006043,MATH 296,A00,098063,Novak; Jonathan I,20,0,20,0
1668424006493,MATH 297,001,098064,Gamst; Anthony Collins,9997,0,9999,2
1668424514729,COGS 205,A00,101395,Chiba; Andrea,19,0,20,1
1668424515156,COGS 210B,001,101404,Greene; Deanna Jacquelyn,9998,0,9999,1
1668424515156,COGS 210B,002,101417,Xia; Haijun,9999,0,9999,0
1668424515156,COGS 210B,003,101422,Nitz; Douglas A.,9999,0,9999,0
1668424515156,COGS 210B,004,101423,Hollan; James D.,9998,0,9999,1
1668424515156,COGS 210B,005,101424,Deak; Gedeon O.,9998,0,9999,1
1668424515156,COGS 210B,006,101425,Rossano; Federico,9999,0,9999,0
1668424515580,COGS 211B,A00,101427,Coulson; Seana M,9996,0,9999,3
1668424516004,COGS 220,A00,101428,Hollan; James D.,1,2,25,24
1668424516428,COGS 229,A00,101429,Dow; Steven P,18,0,25,7
1668424516854,COGS 230,A00,101430,Klemmer; Scott R,11,0,17,6
1668424517289,COGS 234,A00,101431,Xia; Haijun,2,0,25,23
1668424517736,COGS 260,A00,101432,Kiyonaga; Anastasia,21,0,25,4
1668424517736,COGS 260,B00,101433,Kirsh; David Joel,15,0,25,10
1668424518179,CSE 202,A00,102371,Impagliazzo; Russell,0,31,0,0
1668424518615,CSE 203B,A01,102373,Cheng; Chung Kuan,0,25,0,0
1668424519039,CSE 208,A00,102374,Micciancio; Daniele,0,1,0,0
1668424519464,CSE 209A,A00,112895,Impagliazzo; Russell,0,3,15,15
1668424519911,CSE 209B,A00,108005,Bellare; Mihir,0,3,0,0
1668424520346,CSE 210,A00,113163,Coblenz; Michael J,0,41,0,0
1668424520796,CSE 219,A00,106111,Dow; Steven P,0,0,20,20
1668424521241,CSE 221,A00,102376,Voelker; Geoffrey M.,0,29,0,0
1668424521678,CSE 224,A01,102378,Porter; George M,0,102,0,0
1668424522103,CSE 229A,A00,102379,Savage; Stefan,0,4,0,0
1668424522526,CSE 229C,A00,102380,Munyaka; Imani N. S.,0,4,0,0
1668424522961,CSE 232B,A00,102382,Deutsch; Alin Bernard,0,13,0,0
1668424523399,CSE 234,A01,112904,Kumar; Arun Kumar,0,0,0,0
1668424523832,CSE 237A,A00,102383,Rosing; Tajana Simunic,0,25,0,0
1668424524262,CSE 239A,A00,102384,Deutsch; Alin Bernard,0,5,0,0
1668424524689,CSE 239B,A00,102385,Polikarpova; Nadezhda,0,3,0,0
1668424525116,CSE 240A,A00,102386,Pannuto; Patrick William,0,24,0,0
1668424525562,CSE 240B,A00,102387,Zhao; Jishen,0,23,0,0
1668424526000,CSE 241A,A00,106406,Kang; Mingu,0,2,0,0
1668424526431,CSE 249B,A00,102388,Kahng; Andrew Byun,0,1,8,8
1668424526857,CSE 251B,A01,102392,Cottrell; Garrison W,0,22,0,0
1668424526857,CSE 251B,A02,102393,Cottrell; Garrison W,0,21,0,0
1668424527281,CSE 252B,A00,102394,Ochoa; Benjamin Lawrence,0,35,0,0
1668424527726,CSE 257,A01,102396,Gao; Sicun,0,86,0,0
1668424528242,CSE 272,A00,102397,Li; Tzumao,0,7,0,0
1668424528682,CSE 274,A00,111323,Chern; Albert Ren-Haur,0,7,0,0
1668424529111,CSE 282,A00,102398,Pevzner; Pavel Arkadjevich,0,0,0,0
1668424529535,CSE 284,A00,114175,Gymrek; Melissa Ann,0,9,0,0
1668424529962,CSE 290,A00,102399,Chandraker; Manmohan Krishna,0,4,0,0
1668424529962,CSE 290,B00,102400,Vaccaro; Kristen Marie,0,1,25,25
1668424529962,CSE 290,C00,102414,Pannuto; Patrick William,0,1,25,25
1668424529962,CSE 290,D00,102427,Pevzner; Pavel Arkadjevich,0,0,0,0
1668424529962,CSE 290,E00,102429,Zhao; Jishen,0,1,0,0
1668424529962,CSE 290,F00,102436,Tullsen; Dean Michael,0,2,0,0
1668424529962,CSE 290,G00,102440,Christensen; Henrik I,0,3,20,20
1668424530406,CSE 291,A00,102443,Su; Hao,0,0,0,0
1668424530406,CSE 291,B00,102448,Polikarpova; Nadezhda,0,0,0,0
1668424530406,CSE 291,C00,102453,Vaccaro; Kristen Marie,0,0,0,0
1668424530406,CSE 291,D00,111343,Savage; Stefan,0,0,0,0
1668424530406,CSE 291,E00,116474,Claffy; Kimberly Claire,0,0,0,0
1668424530406,CSE 291,F00,116479,Pasquale; Joseph,0,0,0,0
1668424530851,CSE 293,001,119111,Bafna; Vineet,9999,0,9999,0
1668424530851,CSE 293,002,119118,Bellare; Mihir,9999,0,9999,0
1668424530851,CSE 293,003,119122,Berg-Kirkpatrick; Taylor D,9999,0,9999,0
1668424530851,CSE 293,004,119135,Christensen; Henrik I,9999,0,9999,0
1668424530851,CSE 293,005,119142,Cottrell; Garrison W,9999,0,9999,0
1668424530851,CSE 293,006,119146,Deutsch; Alin Bernard,9999,0,9999,0
1668424530851,CSE 293,007,119159,Esmaeilzadeh; Hadi,9999,0,9999,0
1668424530851,CSE 293,008,119166,Freund; Yoav,9999,0,9999,0
1668424530851,CSE 293,009,119170,Griswold; William G.,9999,0,9999,0
1668424530851,CSE 293,010,119183,Gymrek; Melissa Ann,9999,0,9999,0
1668424530851,CSE 293,011,119190,Heninger; Nadia A,9999,0,9999,0
1668424530851,CSE 293,012,119230,Impagliazzo; Russell,9999,0,9999,0
1668424530851,CSE 293,013,119232,Jhala; Ranjit,9999,0,9999,0
1668424530851,CSE 293,014,119233,Kahng; Andrew Byun,9999,0,9999,0
1668424530851,CSE 293,015,119298,Kane; Daniel Mertz,9999,0,9999,0
1668424530851,CSE 293,016,119299,Kriegman; David J,9999,0,9999,0
1668424530851,CSE 293,017,119300,Kumar; Arun Kumar,9999,0,9999,0
1668424530851,CSE 293,018,119301,Lerner; Sorin,9999,0,9999,0
1668424530851,CSE 293,019,119302,Lovett; Shachar,9999,0,9999,0
1668424530851,CSE 293,020,119303,McAuley; Julian John,9999,0,9999,0
1668424530851,CSE 293,021,119304,Micciancio; Daniele,9999,0,9999,0
1668424530851,CSE 293,022,119367,Orailoglu; Alex,9999,0,9999,0
1668424530851,CSE 293,023,119382,Paturi; Ramamohan,9999,0,9999,0
1668424530851,CSE 293,024,119404,Polikarpova; Nadezhda,9999,0,9999,0
1668424530851,CSE 293,025,119406,Politz; Joseph Gibbs,9999,0,9999,0
1668424530851,CSE 293,026,119411,Porter; George M,9999,0,9999,0
1668424530851,CSE 293,027,119414,Porter; Leonard Emerson,9999,0,9999,0
1668424530851,CSE 293,028,119416,Ramamoorthi; Ravi,9999,0,9999,0
1668424530851,CSE 293,029,119417,Sahoo; Debashis,9999,0,9999,0
1668424530851,CSE 293,030,119420,Saul; Lawrence,9999,0,9999,0
1668424530851,CSE 293,031,119421,Savage; Stefan,9999,0,9999,0
1668424530851,CSE 293,032,119425,Schulze; Jurgen P.,9999,0,9999,0
1668424530851,CSE 293,033,119426,Snoeren; Alex C.,9999,0,9999,0
1668424530851,CSE 293,034,119428,Shang; Jingbo,9999,0,9999,0
1668424530851,CSE 293,035,119430,Stefan; Deian,9999,0,9999,0
1668424530851,CSE 293,036,119431,Su; Hao,9999,0,9999,0
1668424530851,CSE 293,037,119433,Swanson; Steven James,9999,0,9999,0
1668424530851,CSE 293,038,119435,Tullsen; Dean Michael,9999,0,9999,0
1668424530851,CSE 293,039,119483,Voelker; Geoffrey M.,9999,0,9999,0
1668424530851,CSE 293,040,119537,Zhao; Jishen,9999,0,9999,0
1668424530851,CSE 293,041,119538,Zhou; Yuan-Yuan,9999,0,9999,0
1668424530851,CSE 293,042,119539,Gao; Sicun,9999,0,9999,0
1668424530851,CSE 293,043,119540,Weibel; Nadir,9999,0,9999,0
1668424530851,CSE 293,044,119541,Gupta; Rajesh K.,9999,0,9999,0
1668424530851,CSE 293,045,126410,Vaccaro; Kristen Marie,9999,0,9999,0
1668424530851,CSE 293,046,126411,Klemke; Richard,9999,0,9999,0
1668424531279,CSE 294,A00,102459,Voelker; Geoffrey M.,0,1,0,0
1668424531279,CSE 294,B00,111322,Orailoglu; Alex,0,0,0,0
1668424531715,DSE 201,A00,096914,Deutsch; Alin Bernard,30,0,30,0
1668424532151,DSE 210,A00,096915,Dasgupta; Sanjoy,30,0,30,0
1668424532584,DSE 260A,A00,096916,Altintas De Callaf; Ilkay,30,0,30,0
1668424533072,ECE 200,001,103586,Antipa; Nicholas A,9999,0,9999,0
1668424533072,ECE 200,002,103587,Atanasov; Nikolay A.,9999,0,9999,0
1668424533072,ECE 200,003,103588,Bharadia; Dinesh,9999,0,9999,0
1668424533072,ECE 200,004,103589,Cheng; Chung Kuan,9999,0,9999,0
1668424533072,ECE 200,005,103590,Cosman; Pamela C.,9999,0,9999,0
1668424533072,ECE 200,006,103591,Dayeh; Shadi Ahmad,9999,0,9999,0
1668424533072,ECE 200,007,103592,Fainman; Yeshaiahu,9999,0,9999,0
1668424533072,ECE 200,008,103593,Ford; Joseph Earl,9999,0,9999,0
1668424533072,ECE 200,009,103594,Franceschetti; Massimo,9999,0,9999,0
1668424533072,ECE 200,010,103595,Fullerton; Eric E,9999,0,9999,0
1668424533072,ECE 200,011,103596,Galton; Ian A,9999,0,9999,0
1668424533072,ECE 200,012,103597,Gilja; Vikash,9999,0,9999,0
1668424533072,ECE 200,013,103598,Hall; Drew A.,9999,0,9999,0
1668424533072,ECE 200,014,103599,Hsueh; Tzu-Chien,9999,0,9999,0
1668424533072,ECE 200,015,103600,Javidi; Tara,9999,0,9999,0
1668424533072,ECE 200,016,103601,Kahng; Andrew Byun,9999,0,9999,0
1668424533072,ECE 200,017,103602,Kim; Young-Han,9999,0,9999,0
1668424533072,ECE 200,018,103603,Koushanfar; Farinaz,9999,0,9999,0
1668424533072,ECE 200,019,103604,Kuzum; Duygu,9999,0,9999,0
1668424533072,ECE 200,020,103605,Le; Hanh-Phuc,9999,0,9999,0
1668424533072,ECE 200,021,103606,Lin; Bill,9999,0,9999,0
1668424533072,ECE 200,022,103607,Liu; Zhaowei,9998,0,9999,1
1668424533072,ECE 200,023,103608,Lo; Yu-Hwa,9999,0,9999,0
1668424533072,ECE 200,024,103609,Lomakin; Vitaliy,9999,0,9999,0
1668424533072,ECE 200,025,103610,Mercier; Patrick Philip,9999,0,9999,0
1668424533072,ECE 200,026,103611,Meyer; Florian,9999,0,9999,0
1668424533072,ECE 200,027,103612,Milstein; Laurence B.,9999,0,9999,0
1668424533072,ECE 200,028,103613,Mir Arabbaygi; Siavash,9999,0,9999,0
1668424533072,ECE 200,029,103614,Mookherjea; Shayan,9999,0,9999,0
1668424533072,ECE 200,030,103615,Morris; Karcher William,9999,0,9999,0
1668424533072,ECE 200,031,103616,Ng; Tse Nga,9999,0,9999,0
1668424533072,ECE 200,032,103617,Nguyen; Truong Quang,9999,0,9999,0
1668424533072,ECE 200,033,103618,Nomura; Kenji,9999,0,9999,0
1668424533072,ECE 200,034,103619,Orlitsky; Alon,9999,0,9999,0
1668424533072,ECE 200,035,103620,Pal; Piya,9999,0,9999,0
1668424533072,ECE 200,036,103621,Papen; George C.,9999,0,9999,0
1668424533072,ECE 200,037,103622,Radic; Stojan,9999,0,9999,0
1668424533072,ECE 200,038,103623,Rao; Bhaskar D.,9999,0,9999,0
1668424533072,ECE 200,039,103624,Rao; Ramesh R,9999,0,9999,0
1668424533072,ECE 200,040,103625,Rebeiz; Gabriel,9999,0,9999,0
1668424533072,ECE 200,041,103626,Sanford; John R,9999,0,9999,0
1668424533072,ECE 200,042,103627,Siegel; Paul H.,9999,0,9999,0
1668424533072,ECE 200,043,103628,Sievenpiper; Daniel F.,9999,0,9999,0
1668424533072,ECE 200,044,103629,Sworder; David D.,9999,0,9999,0
1668424533072,ECE 200,045,103630,Taur; Yuan,9999,0,9999,0
1668424533072,ECE 200,046,103631,Touri; Behrouz,9999,0,9999,0
1668424533072,ECE 200,047,103632,Trivedi; Mohan M.,9999,0,9999,0
1668424533072,ECE 200,048,103633,Vasconcelos; Nuno,9999,0,9999,0
1668424533072,ECE 200,049,103634,Wang; Xiaolong,9999,0,9999,0
1668424533072,ECE 200,050,103635,Xie; Pengtao,9999,0,9999,0
1668424533072,ECE 200,051,103636,Yip; Michael,9999,0,9999,0
1668424533072,ECE 200,052,103637,Zeger; Kenneth A.,999,0,999,0
1668424533072,ECE 200,053,103638,Zhang; Xinyu,9999,0,9999,0
1668424533072,ECE 200,054,103639,Turakhia; Yatish Girish,9999,0,9999,0
1668424533072,ECE 200,055,103640,Kang; Mingu,9999,0,9999,0
1668424533072,ECE 200,056,103641,Shi; Yuanyuan,9999,0,9999,0
1668424533072,ECE 200,057,103642,Wang; Edward Jay,9999,0,9999,0
1668424533072,ECE 200,058,103643,Zheng; Yang,9999,0,9999,0
1668424533499,ECE 202,A00,103644,Kuzum; Duygu,0,21,0,0
1668424533933,ECE 212BN,A00,103646,Ng; Tse Nga,0,1,0,0
1668424534372,ECE 221,A00,111493,Staff,0,0,0,0
1668424534811,ECE 222B,A00,103647,Lomakin; Vitaliy,0,5,0,0
1668424535235,ECE 230B,A00,103648,Taur; Yuan,0,0,0,0
1668424535665,ECE 238B,A00,103649,Garay; Javier,0,0,0,0
1668424536089,ECE 240B,A00,112900,Fainman; Yeshaiahu,0,4,0,0
1668424536520,ECE 247A,A00,103650,Jokerst; Jesse Vincent,0,1,0,0
1668424536945,ECE 247B,A00,103651,Wang; Joseph,0,4,0,0
1668424537394,ECE 250,A00,103652,Siegel; Paul H.,0,42,0,0
1668424537823,ECE 251A,A00,103654,Rao; Bhaskar D.,0,28,0,0
1668424538265,ECE 257B,A00,103655,Bharadia; Dinesh,0,12,0,0
1668424538691,ECE 258A,A00,103656,Milstein; Laurence B.,0,10,0,0
1668424539115,ECE 260B,A00,103658,Kang; Mingu,0,64,0,0
1668424539570,ECE 264A,A00,103659,Galton; Ian A,0,31,0,0
1668424539994,ECE 265A,A00,103661,Gudem; Prasad S.S.,0,16,0,0
1668424540417,ECE 265D,A00,103662,Gudem; Prasad S.S.,0,10,0,0
1668424540851,ECE 268,A00,103663,Koushanfar; Farinaz,0,18,0,0
1668424541283,ECE 269,A01,103665,Pal; Piya,0,125,0,0
1668424541712,ECE 271B,A00,103666,Vasconcelos; Manuela,0,46,0,0
1668424542140,ECE 276A,A00,103667,Atanasov; Nikolay A.,0,66,0,0
1668424542576,ECE 277,A00,103668,An; Cheolhong,0,87,0,0
1668424543000,ECE 279,A00,117947,Hall; Drew A.,0,11,0,0
1668424543874,ECE 283,A00,103670,Hsueh; Tzu-Chien,0,21,0,0
1668424544322,ECE 284,A00,103671,Turakhia; Yatish Girish,0,22,0,0
1668424544759,ECE 285,A00,103672,Zheng; Yang,0,22,0,0
1668424544759,ECE 285,B00,103673,Sworder; David D.,0,36,0,0
1668424545185,ECE 287,A00,103676,Javidi; Tara,0,4,0,0
1668424545642,MATH 200B,A00,098023,Salehi Golsefidy; Alireza,12,0,15,3
1668424546078,MATH 202B,A00,098024,Rhoades; Brendon Patrick,9,0,15,6
1668424546507,MATH 203B,A00,098025,Oprea; Dragos N.,10,0,15,5
1668424546944,MATH 204B,A00,098026,Sorensen; Claus M,13,0,15,2
1668424547389,MATH 208,A00,098027,Izadi; Elham,7,0,10,3
1668424547842,MATH 209,A00,098028,Pollack; Aaron,10,0,10,0
1668424548274,MATH 211A,A00,112919,Rogalski; Daniel,9,0,10,1
1668424548698,MATH 211B,A00,112920,Seward; Brandon M.,9,0,10,1
1668424549127,MATH 218,A00,098029,Li; Bo,10,0,10,0
1668424549555,MATH 220B,A00,098030,Novak; Jonathan I,11,0,15,4
1668424549992,MATH 221A,A00,098031,Ebenfelt; Peter F,13,0,15,2
1668424550417,MATH 231B,A00,098032,Zlatos; Andrej,12,0,15,3
1668424550842,MATH 240B,A00,098033,Ni; Lei,9,0,15,6
1668424551270,MATH 243,A00,098034,Jekel; David Andrew,10,0,10,0
1668424551704,MATH 245A,A00,098035,Nie; Jiawang,0,1,15,16
1668424552143,MATH 248,A00,098036,Bejenaru; Ioan,10,0,10,0
1668424552582,MATH 250B,A00,098037,Spolaor; Luca,14,0,15,1
1668424553020,MATH 258,A00,098038,Ni; Lei,10,0,10,0
1668424553459,MATH 264B,A00,098041,Rhoades; Brendon Patrick,9,0,15,6
1668424553884,MATH 268,A00,098042,Buss; Samuel R,10,0,10,0
1668424554328,MATH 269,A00,098043,Rhoades; Brendon Patrick,10,0,10,0
1668424554754,MATH 270B,A00,098044,Li; Bo,10,0,15,5
1668424555180,MATH 272B,A00,098045,Holst; Michael J,13,0,15,2
1668424555614,MATH 273A,A00,098046,Tian; Xiaochuan,10,0,15,5
1668424556044,MATH 275,A01,098048,Tian; Xiaochuan,6,0,10,4
1668424556494,MATH 278A,A00,098049,Holst; Michael J,8,0,10,2
1668424556936,MATH 278B,A00,098050,Cloninger; Alexander,10,0,10,0
1668424557397,MATH 278C,A00,098051,Nie; Jiawang,6,0,10,4
1668424557836,MATH 280B,A00,098052,Zheng; Tianyi,8,0,15,7
1668424558265,MATH 281B,A00,098053,Bradic; Jelena,0,1,15,15
1668424558690,MATH 282B,A00,098054,Arias-Castro; Ery,0,0,15,15
1668424559134,MATH 285,A00,098055,Fitzsimmons; Patrick J,0,0,15,17
1668424559559,MATH 287B,A00,098056,Arias-Castro; Ery,2,0,15,13
1668424559984,MATH 288,A00,098057,Agarwal; Pooja,9,0,10,1
1668424559984,MATH 288,B00,098058,Zhang; Danna,8,0,10,2
1668424559984,MATH 288,C00,098059,Williams; Ruth J,9,0,10,1
1668424560422,MATH 290B,A00,098060,Roberts; Justin Deritter,13,0,15,2
1668424560846,MATH 292,A00,098061,Belmont; Eva Kinoshita,10,0,10,0
1668424561291,MATH 295,A00,098062,Suk; Andrew Hoon,48,0,50,2
1668424561718,MATH 296,A00,098063,Novak; Jonathan I,20,0,20,0
1668424562149,MATH 297,001,098064,Gamst; Anthony Collins,9997,0,9999,2
1668425070844,COGS 205,A00,101395,Chiba; Andrea,19,0,20,1
1668425071284,COGS 210B,001,101404,Greene; Deanna Jacquelyn,9998,0,9999,1
1668425071284,COGS 210B,002,101417,Xia; Haijun,9999,0,9999,0
1668425071284,COGS 210B,003,101422,Nitz; Douglas A.,9999,0,9999,0
1668425071284,COGS 210B,004,101423,Hollan; James D.,9998,0,9999,1
1668425071284,COGS 210B,005,101424,Deak; Gedeon O.,9998,0,9999,1
1668425071284,COGS 210B,006,101425,Rossano; Federico,9999,0,9999,0
1668425071716,COGS 211B,A00,101427,Coulson; Seana M,9996,0,9999,3
1668425072152,COGS 220,A00,101428,Hollan; James D.,1,2,25,24
1668425072578,COGS 229,A00,101429,Dow; Steven P,18,0,25,7
1668425073015,COGS 230,A00,101430,Klemmer; Scott R,11,0,17,6
1668425073455,COGS 234,A00,101431,Xia; Haijun,2,0,25,23
1668425073882,COGS 260,A00,101432,Kiyonaga; Anastasia,21,0,25,4
1668425073882,COGS 260,B00,101433,Kirsh; David Joel,15,0,25,10
1668425074306,CSE 202,A00,102371,Impagliazzo; Russell,0,31,0,0
1668425074764,CSE 203B,A01,102373,Cheng; Chung Kuan,0,25,0,0
1668425075191,CSE 208,A00,102374,Micciancio; Daniele,0,1,0,0
1668425075638,CSE 209A,A00,112895,Impagliazzo; Russell,0,3,15,15
1668425076064,CSE 209B,A00,108005,Bellare; Mihir,0,3,0,0
1668425076490,CSE 210,A00,113163,Coblenz; Michael J,0,41,0,0
1668425076914,CSE 219,A00,106111,Dow; Steven P,0,0,20,20
1668425077355,CSE 221,A00,102376,Voelker; Geoffrey M.,0,29,0,0
1668425077785,CSE 224,A01,102378,Porter; George M,0,102,0,0
1668425078220,CSE 229A,A00,102379,Savage; Stefan,0,4,0,0
1668425078653,CSE 229C,A00,102380,Munyaka; Imani N. S.,0,4,0,0
1668425079079,CSE 232B,A00,102382,Deutsch; Alin Bernard,0,13,0,0
1668425079518,CSE 234,A01,112904,Kumar; Arun Kumar,0,0,0,0
1668425079954,CSE 237A,A00,102383,Rosing; Tajana Simunic,0,25,0,0
1668425080380,CSE 239A,A00,102384,Deutsch; Alin Bernard,0,5,0,0
1668425080812,CSE 239B,A00,102385,Polikarpova; Nadezhda,0,3,0,0
1668425081250,CSE 240A,A00,102386,Pannuto; Patrick William,0,24,0,0
1668425081694,CSE 240B,A00,102387,Zhao; Jishen,0,23,0,0
1668425082148,CSE 241A,A00,106406,Kang; Mingu,0,2,0,0
1668425082587,CSE 249B,A00,102388,Kahng; Andrew Byun,0,1,8,8
1668425083019,CSE 251B,A01,102392,Cottrell; Garrison W,0,22,0,0
1668425083019,CSE 251B,A02,102393,Cottrell; Garrison W,0,21,0,0
1668425083445,CSE 252B,A00,102394,Ochoa; Benjamin Lawrence,0,36,0,0
1668425083872,CSE 257,A01,102396,Gao; Sicun,0,86,0,0
1668425084298,CSE 272,A00,102397,Li; Tzumao,0,7,0,0
1668425084739,CSE 274,A00,111323,Chern; Albert Ren-Haur,0,7,0,0
1668425085173,CSE 282,A00,102398,Pevzner; Pavel Arkadjevich,0,0,0,0
1668425085612,CSE 284,A00,114175,Gymrek; Melissa Ann,0,9,0,0
1668425086067,CSE 290,A00,102399,Chandraker; Manmohan Krishna,0,4,0,0
1668425086067,CSE 290,B00,102400,Vaccaro; Kristen Marie,0,1,25,25
1668425086067,CSE 290,C00,102414,Pannuto; Patrick William,0,1,25,25
1668425086067,CSE 290,D00,102427,Pevzner; Pavel Arkadjevich,0,0,0,0
1668425086067,CSE 290,E00,102429,Zhao; Jishen,0,1,0,0
1668425086067,CSE 290,F00,102436,Tullsen; Dean Michael,0,2,0,0
1668425086067,CSE 290,G00,102440,Christensen; Henrik I,0,3,20,20
1668425086493,CSE 291,A00,102443,Su; Hao,0,0,0,0
1668425086493,CSE 291,B00,102448,Polikarpova; Nadezhda,0,0,0,0
1668425086493,CSE 291,C00,102453,Vaccaro; Kristen Marie,0,0,0,0
1668425086493,CSE 291,D00,111343,Savage; Stefan,0,0,0,0
1668425086493,CSE 291,E00,116474,Claffy; Kimberly Claire,0,0,0,0
1668425086493,CSE 291,F00,116479,Pasquale; Joseph,0,0,0,0
1668425086940,CSE 293,001,119111,Bafna; Vineet,9999,0,9999,0
1668425086940,CSE 293,002,119118,Bellare; Mihir,9999,0,9999,0
1668425086940,CSE 293,003,119122,Berg-Kirkpatrick; Taylor D,9999,0,9999,0
1668425086940,CSE 293,004,119135,Christensen; Henrik I,9999,0,9999,0
1668425086940,CSE 293,005,119142,Cottrell; Garrison W,9999,0,9999,0
1668425086940,CSE 293,006,119146,Deutsch; Alin Bernard,9999,0,9999,0
1668425086940,CSE 293,007,119159,Esmaeilzadeh; Hadi,9999,0,9999,0
1668425086940,CSE 293,008,119166,Freund; Yoav,9999,0,9999,0
1668425086940,CSE 293,009,119170,Griswold; William G.,9999,0,9999,0
1668425086940,CSE 293,010,119183,Gymrek; Melissa Ann,9999,0,9999,0
1668425086940,CSE 293,011,119190,Heninger; Nadia A,9999,0,9999,0
1668425086940,CSE 293,012,119230,Impagliazzo; Russell,9999,0,9999,0
1668425086940,CSE 293,013,119232,Jhala; Ranjit,9999,0,9999,0
1668425086940,CSE 293,014,119233,Kahng; Andrew Byun,9999,0,9999,0
1668425086940,CSE 293,015,119298,Kane; Daniel Mertz,9999,0,9999,0
1668425086940,CSE 293,016,119299,Kriegman; David J,9999,0,9999,0
1668425086940,CSE 293,017,119300,Kumar; Arun Kumar,9999,0,9999,0
1668425086940,CSE 293,018,119301,Lerner; Sorin,9999,0,9999,0
1668425086940,CSE 293,019,119302,Lovett; Shachar,9999,0,9999,0
1668425086940,CSE 293,020,119303,McAuley; Julian John,9999,0,9999,0
1668425086940,CSE 293,021,119304,Micciancio; Daniele,9999,0,9999,0
1668425086940,CSE 293,022,119367,Orailoglu; Alex,9999,0,9999,0
1668425086940,CSE 293,023,119382,Paturi; Ramamohan,9999,0,9999,0
1668425086940,CSE 293,024,119404,Polikarpova; Nadezhda,9999,0,9999,0
1668425086940,CSE 293,025,119406,Politz; Joseph Gibbs,9999,0,9999,0
1668425086940,CSE 293,026,119411,Porter; George M,9999,0,9999,0
1668425086940,CSE 293,027,119414,Porter; Leonard Emerson,9999,0,9999,0
1668425086940,CSE 293,028,119416,Ramamoorthi; Ravi,9999,0,9999,0
1668425086940,CSE 293,029,119417,Sahoo; Debashis,9999,0,9999,0
1668425086940,CSE 293,030,119420,Saul; Lawrence,9999,0,9999,0
1668425086940,CSE 293,031,119421,Savage; Stefan,9999,0,9999,0
1668425086940,CSE 293,032,119425,Schulze; Jurgen P.,9999,0,9999,0
1668425086940,CSE 293,033,119426,Snoeren; Alex C.,9999,0,9999,0
1668425086940,CSE 293,034,119428,Shang; Jingbo,9999,0,9999,0
1668425086940,CSE 293,035,119430,Stefan; Deian,9999,0,9999,0
1668425086940,CSE 293,036,119431,Su; Hao,9999,0,9999,0
1668425086940,CSE 293,037,119433,Swanson; Steven James,9999,0,9999,0
1668425086940,CSE 293,038,119435,Tullsen; Dean Michael,9999,0,9999,0
1668425086940,CSE 293,039,119483,Voelker; Geoffrey M.,9999,0,9999,0
1668425086940,CSE 293,040,119537,Zhao; Jishen,9999,0,9999,0
1668425086940,CSE 293,041,119538,Zhou; Yuan-Yuan,9999,0,9999,0
1668425086940,CSE 293,042,119539,Gao; Sicun,9999,0,9999,0
1668425086940,CSE 293,043,119540,Weibel; Nadir,9999,0,9999,0
1668425086940,CSE 293,044,119541,Gupta; Rajesh K.,9999,0,9999,0
1668425086940,CSE 293,045,126410,Vaccaro; Kristen Marie,9999,0,9999,0
1668425086940,CSE 293,046,126411,Klemke; Richard,9999,0,9999,0
1668425087365,CSE 294,A00,102459,Voelker; Geoffrey M.,0,1,0,0
1668425087365,CSE 294,B00,111322,Orailoglu; Alex,0,0,0,0
1668425087788,DSE 201,A00,096914,Deutsch; Alin Bernard,30,0,30,0
1668425088217,DSE 210,A00,096915,Dasgupta; Sanjoy,30,0,30,0
1668425088660,DSE 260A,A00,096916,Altintas De Callaf; Ilkay,30,0,30,0
1668425089113,ECE 200,001,103586,Antipa; Nicholas A,9999,0,9999,0
1668425089113,ECE 200,002,103587,Atanasov; Nikolay A.,9999,0,9999,0
1668425089113,ECE 200,003,103588,Bharadia; Dinesh,9999,0,9999,0
1668425089113,ECE 200,004,103589,Cheng; Chung Kuan,9999,0,9999,0
1668425089113,ECE 200,005,103590,Cosman; Pamela C.,9999,0,9999,0
1668425089113,ECE 200,006,103591,Dayeh; Shadi Ahmad,9999,0,9999,0
1668425089113,ECE 200,007,103592,Fainman; Yeshaiahu,9999,0,9999,0
1668425089113,ECE 200,008,103593,Ford; Joseph Earl,9999,0,9999,0
1668425089113,ECE 200,009,103594,Franceschetti; Massimo,9999,0,9999,0
1668425089113,ECE 200,010,103595,Fullerton; Eric E,9999,0,9999,0
1668425089113,ECE 200,011,103596,Galton; Ian A,9999,0,9999,0
1668425089113,ECE 200,012,103597,Gilja; Vikash,9999,0,9999,0
1668425089113,ECE 200,013,103598,Hall; Drew A.,9999,0,9999,0
1668425089113,ECE 200,014,103599,Hsueh; Tzu-Chien,9999,0,9999,0
1668425089113,ECE 200,015,103600,Javidi; Tara,9999,0,9999,0
1668425089113,ECE 200,016,103601,Kahng; Andrew Byun,9999,0,9999,0
1668425089113,ECE 200,017,103602,Kim; Young-Han,9999,0,9999,0
1668425089113,ECE 200,018,103603,Koushanfar; Farinaz,9999,0,9999,0
1668425089113,ECE 200,019,103604,Kuzum; Duygu,9999,0,9999,0
1668425089113,ECE 200,020,103605,Le; Hanh-Phuc,9999,0,9999,0
1668425089113,ECE 200,021,103606,Lin; Bill,9999,0,9999,0
1668425089113,ECE 200,022,103607,Liu; Zhaowei,9998,0,9999,1
1668425089113,ECE 200,023,103608,Lo; Yu-Hwa,9999,0,9999,0
1668425089113,ECE 200,024,103609,Lomakin; Vitaliy,9999,0,9999,0
1668425089113,ECE 200,025,103610,Mercier; Patrick Philip,9999,0,9999,0
1668425089113,ECE 200,026,103611,Meyer; Florian,9999,0,9999,0
1668425089113,ECE 200,027,103612,Milstein; Laurence B.,9999,0,9999,0
1668425089113,ECE 200,028,103613,Mir Arabbaygi; Siavash,9999,0,9999,0
1668425089113,ECE 200,029,103614,Mookherjea; Shayan,9999,0,9999,0
1668425089113,ECE 200,030,103615,Morris; Karcher William,9999,0,9999,0
1668425089113,ECE 200,031,103616,Ng; Tse Nga,9999,0,9999,0
1668425089113,ECE 200,032,103617,Nguyen; Truong Quang,9999,0,9999,0
1668425089113,ECE 200,033,103618,Nomura; Kenji,9999,0,9999,0
1668425089113,ECE 200,034,103619,Orlitsky; Alon,9999,0,9999,0
1668425089113,ECE 200,035,103620,Pal; Piya,9999,0,9999,0
1668425089113,ECE 200,036,103621,Papen; George C.,9999,0,9999,0
1668425089113,ECE 200,037,103622,Radic; Stojan,9999,0,9999,0
1668425089113,ECE 200,038,103623,Rao; Bhaskar D.,9999,0,9999,0
1668425089113,ECE 200,039,103624,Rao; Ramesh R,9999,0,9999,0
1668425089113,ECE 200,040,103625,Rebeiz; Gabriel,9999,0,9999,0
1668425089113,ECE 200,041,103626,Sanford; John R,9999,0,9999,0
1668425089113,ECE 200,042,103627,Siegel; Paul H.,9999,0,9999,0
1668425089113,ECE 200,043,103628,Sievenpiper; Daniel F.,9999,0,9999,0
1668425089113,ECE 200,044,103629,Sworder; David D.,9999,0,9999,0
1668425089113,ECE 200,045,103630,Taur; Yuan,9999,0,9999,0
1668425089113,ECE 200,046,103631,Touri; Behrouz,9999,0,9999,0
1668425089113,ECE 200,047,103632,Trivedi; Mohan M.,9999,0,9999,0
1668425089113,ECE 200,048,103633,Vasconcelos; Nuno,9999,0,9999,0
1668425089113,ECE 200,049,103634,Wang; Xiaolong,9999,0,9999,0
1668425089113,ECE 200,050,103635,Xie; Pengtao,9999,0,9999,0
1668425089113,ECE 200,051,103636,Yip; Michael,9999,0,9999,0
1668425089113,ECE 200,052,103637,Zeger; Kenneth A.,999,0,999,0
1668425089113,ECE 200,053,103638,Zhang; Xinyu,9999,0,9999,0
1668425089113,ECE 200,054,103639,Turakhia; Yatish Girish,9999,0,9999,0
1668425089113,ECE 200,055,103640,Kang; Mingu,9999,0,9999,0
1668425089113,ECE 200,056,103641,Shi; Yuanyuan,9999,0,9999,0
1668425089113,ECE 200,057,103642,Wang; Edward Jay,9999,0,9999,0
1668425089113,ECE 200,058,103643,Zheng; Yang,9999,0,9999,0
1668425089546,ECE 202,A00,103644,Kuzum; Duygu,0,21,0,0
1668425089970,ECE 212BN,A00,103646,Ng; Tse Nga,0,1,0,0
1668425090394,ECE 221,A00,111493,Staff,0,0,0,0
1668425090832,ECE 222B,A00,103647,Lomakin; Vitaliy,0,5,0,0
1668425091260,ECE 230B,A00,103648,Taur; Yuan,0,0,0,0
1668425091688,ECE 238B,A00,103649,Garay; Javier,0,0,0,0
1668425092113,ECE 240B,A00,112900,Fainman; Yeshaiahu,0,4,0,0
1668425092567,ECE 247A,A00,103650,Jokerst; Jesse Vincent,0,1,0,0
1668425093006,ECE 247B,A00,103651,Wang; Joseph,0,4,0,0
1668425093434,ECE 250,A00,103652,Siegel; Paul H.,0,42,0,0
1668425093860,ECE 251A,A00,103654,Rao; Bhaskar D.,0,28,0,0
1668425094288,ECE 257B,A00,103655,Bharadia; Dinesh,0,12,0,0
1668425094726,ECE 258A,A00,103656,Milstein; Laurence B.,0,10,0,0
1668425095153,ECE 260B,A00,103658,Kang; Mingu,0,64,0,0
1668425095598,ECE 264A,A00,103659,Galton; Ian A,0,31,0,0
1668425096023,ECE 265A,A00,103661,Gudem; Prasad S.S.,0,16,0,0
1668425096454,ECE 265D,A00,103662,Gudem; Prasad S.S.,0,10,0,0
1668425096895,ECE 268,A00,103663,Koushanfar; Farinaz,0,18,0,0
1668425097337,ECE 269,A01,103665,Pal; Piya,0,125,0,0
1668425097765,ECE 271B,A00,103666,Vasconcelos; Manuela,0,46,0,0
1668425098202,ECE 276A,A00,103667,Atanasov; Nikolay A.,0,66,0,0
1668425098634,ECE 277,A00,103668,An; Cheolhong,0,87,0,0
1668425099069,ECE 279,A00,117947,Hall; Drew A.,0,11,0,0
1668425099923,ECE 283,A00,103670,Hsueh; Tzu-Chien,0,21,0,0
1668425100352,ECE 284,A00,103671,Turakhia; Yatish Girish,0,22,0,0
1668425100799,ECE 285,A00,103672,Zheng; Yang,0,22,0,0
1668425100799,ECE 285,B00,103673,Sworder; David D.,0,36,0,0
1668425101340,ECE 287,A00,103676,Javidi; Tara,0,4,0,0
1668425101779,MATH 200B,A00,098023,Salehi Golsefidy; Alireza,12,0,15,3
1668425102215,MATH 202B,A00,098024,Rhoades; Brendon Patrick,9,0,15,6
1668425102643,MATH 203B,A00,098025,Oprea; Dragos N.,10,0,15,5
1668425103068,MATH 204B,A00,098026,Sorensen; Claus M,13,0,15,2
1668425103509,MATH 208,A00,098027,Izadi; Elham,7,0,10,3
1668425103932,MATH 209,A00,098028,Pollack; Aaron,10,0,10,0
1668425104361,MATH 211A,A00,112919,Rogalski; Daniel,9,0,10,1
1668425104785,MATH 211B,A00,112920,Seward; Brandon M.,9,0,10,1
1668425105214,MATH 218,A00,098029,Li; Bo,10,0,10,0
1668425105654,MATH 220B,A00,098030,Novak; Jonathan I,11,0,15,4
1668425106083,MATH 221A,A00,098031,Ebenfelt; Peter F,13,0,15,2
1668425106510,MATH 231B,A00,098032,Zlatos; Andrej,12,0,15,3
1668425106936,MATH 240B,A00,098033,Ni; Lei,9,0,15,6
1668425107363,MATH 243,A00,098034,Jekel; David Andrew,10,0,10,0
1668425107804,MATH 245A,A00,098035,Nie; Jiawang,0,1,15,16
1668425108229,MATH 248,A00,098036,Bejenaru; Ioan,10,0,10,0
1668425108652,MATH 250B,A00,098037,Spolaor; Luca,14,0,15,1
1668425109077,MATH 258,A00,098038,Ni; Lei,10,0,10,0
1668425109534,MATH 264B,A00,098041,Rhoades; Brendon Patrick,9,0,15,6
1668425109970,MATH 268,A00,098042,Buss; Samuel R,10,0,10,0
1668425110402,MATH 269,A00,098043,Rhoades; Brendon Patrick,10,0,10,0
1668425110829,MATH 270B,A00,098044,Li; Bo,10,0,15,5
1668425111267,MATH 272B,A00,098045,Holst; Michael J,13,0,15,2
1668425111690,MATH 273A,A00,098046,Tian; Xiaochuan,10,0,15,5
1668425112125,MATH 275,A01,098048,Tian; Xiaochuan,6,0,10,4
1668425112552,MATH 278A,A00,098049,Holst; Michael J,8,0,10,2
1668425112981,MATH 278B,A00,098050,Cloninger; Alexander,10,0,10,0
1668425113439,MATH 278C,A00,098051,Nie; Jiawang,6,0,10,4
1668425113864,MATH 280B,A00,098052,Zheng; Tianyi,8,0,15,7
1668425114288,MATH 281B,A00,098053,Bradic; Jelena,0,1,15,15
1668425114710,MATH 282B,A00,098054,Arias-Castro; Ery,0,0,15,15
1668425115135,MATH 285,A00,098055,Fitzsimmons; Patrick J,0,0,15,17
1668425115575,MATH 287B,A00,098056,Arias-Castro; Ery,2,0,15,13
1668425116029,MATH 288,A00,098057,Agarwal; Pooja,9,0,10,1
1668425116029,MATH 288,B00,098058,Zhang; Danna,8,0,10,2
1668425116029,MATH 288,C00,098059,Williams; Ruth J,9,0,10,1
1668425116456,MATH 290B,A00,098060,Roberts; Justin Deritter,13,0,15,2
1668425116880,MATH 292,A00,098061,Belmont; Eva Kinoshita,10,0,10,0
1668425117303,MATH 295,A00,098062,Suk; Andrew Hoon,48,0,50,2
1668425117730,MATH 296,A00,098063,Novak; Jonathan I,20,0,20,0
1668425118177,MATH 297,001,098064,Gamst; Anthony Collins,9997,0,9999,2
1668425626749,COGS 205,A00,101395,Chiba; Andrea,19,0,20,1
1668425627188,COGS 210B,001,101404,Greene; Deanna Jacquelyn,9998,0,9999,1
1668425627188,COGS 210B,002,101417,Xia; Haijun,9999,0,9999,0
1668425627188,COGS 210B,003,101422,Nitz; Douglas A.,9999,0,9999,0
1668425627188,COGS 210B,004,101423,Hollan; James D.,9998,0,9999,1
1668425627188,COGS 210B,005,101424,Deak; Gedeon O.,9998,0,9999,1
1668425627188,COGS 210B,006,101425,Rossano; Federico,9999,0,9999,0
1668425627613,COGS 211B,A00,101427,Coulson; Seana M,9996,0,9999,3
1668425628037,COGS 220,A00,101428,Hollan; James D.,1,2,25,24
1668425628462,COGS 229,A00,101429,Dow; Steven P,18,0,25,7
1668425628894,COGS 230,A00,101430,Klemmer; Scott R,11,0,17,6
1668425629322,COGS 234,A00,101431,Xia; Haijun,2,0,25,23
1668425629774,COGS 260,A00,101432,Kiyonaga; Anastasia,21,0,25,4
1668425629774,COGS 260,B00,101433,Kirsh; David Joel,15,0,25,10
1668425630290,CSE 202,A00,102371,Impagliazzo; Russell,0,31,0,0
1668425630727,CSE 203B,A01,102373,Cheng; Chung Kuan,0,25,0,0
1668425631163,CSE 208,A00,102374,Micciancio; Daniele,0,1,0,0
1668425631605,CSE 209A,A00,112895,Impagliazzo; Russell,0,3,15,15
1668425632032,CSE 209B,A00,108005,Bellare; Mihir,0,3,0,0
1668425632464,CSE 210,A00,113163,Coblenz; Michael J,0,41,0,0
1668425632903,CSE 219,A00,106111,Dow; Steven P,0,0,20,20
1668425633351,CSE 221,A00,102376,Voelker; Geoffrey M.,0,29,0,0
1668425633780,CSE 224,A01,102378,Porter; George M,0,102,0,0
1668425634206,CSE 229A,A00,102379,Savage; Stefan,0,4,0,0
1668425634635,CSE 229C,A00,102380,Munyaka; Imani N. S.,0,4,0,0
1668425635058,CSE 232B,A00,102382,Deutsch; Alin Bernard,0,13,0,0
1668425635487,CSE 234,A01,112904,Kumar; Arun Kumar,0,0,0,0
1668425635916,CSE 237A,A00,102383,Rosing; Tajana Simunic,0,25,0,0
1668425636342,CSE 239A,A00,102384,Deutsch; Alin Bernard,0,5,0,0
1668425636778,CSE 239B,A00,102385,Polikarpova; Nadezhda,0,3,0,0
1668425637204,CSE 240A,A00,102386,Pannuto; Patrick William,0,24,0,0
1668425637641,CSE 240B,A00,102387,Zhao; Jishen,0,23,0,0
1668425638067,CSE 241A,A00,106406,Kang; Mingu,0,2,0,0
1668425638490,CSE 249B,A00,102388,Kahng; Andrew Byun,0,1,8,8
1668425638927,CSE 251B,A01,102392,Cottrell; Garrison W,0,22,0,0
1668425638927,CSE 251B,A02,102393,Cottrell; Garrison W,0,21,0,0
1668425639377,CSE 252B,A00,102394,Ochoa; Benjamin Lawrence,0,36,0,0
1668425639801,CSE 257,A01,102396,Gao; Sicun,0,86,0,0
1668425640236,CSE 272,A00,102397,Li; Tzumao,0,7,0,0
1668425640674,CSE 274,A00,111323,Chern; Albert Ren-Haur,0,7,0,0
1668425641114,CSE 282,A00,102398,Pevzner; Pavel Arkadjevich,0,0,0,0
1668425641539,CSE 284,A00,114175,Gymrek; Melissa Ann,0,9,0,0
1668425641965,CSE 290,A00,102399,Chandraker; Manmohan Krishna,0,4,0,0
1668425641965,CSE 290,B00,102400,Vaccaro; Kristen Marie,0,1,25,25
1668425641965,CSE 290,C00,102414,Pannuto; Patrick William,0,1,25,25
1668425641965,CSE 290,D00,102427,Pevzner; Pavel Arkadjevich,0,0,0,0
1668425641965,CSE 290,E00,102429,Zhao; Jishen,0,1,0,0
1668425641965,CSE 290,F00,102436,Tullsen; Dean Michael,0,2,0,0
1668425641965,CSE 290,G00,102440,Christensen; Henrik I,0,3,20,20
1668425642391,CSE 291,A00,102443,Su; Hao,0,0,0,0
1668425642391,CSE 291,B00,102448,Polikarpova; Nadezhda,0,0,0,0
1668425642391,CSE 291,C00,102453,Vaccaro; Kristen Marie,0,0,0,0
1668425642391,CSE 291,D00,111343,Savage; Stefan,0,0,0,0
1668425642391,CSE 291,E00,116474,Claffy; Kimberly Claire,0,0,0,0
1668425642391,CSE 291,F00,116479,Pasquale; Joseph,0,0,0,0
1668425642865,CSE 293,001,119111,Bafna; Vineet,9999,0,9999,0
1668425642865,CSE 293,002,119118,Bellare; Mihir,9999,0,9999,0
1668425642865,CSE 293,003,119122,Berg-Kirkpatrick; Taylor D,9999,0,9999,0
1668425642865,CSE 293,004,119135,Christensen; Henrik I,9999,0,9999,0
1668425642865,CSE 293,005,119142,Cottrell; Garrison W,9999,0,9999,0
1668425642865,CSE 293,006,119146,Deutsch; Alin Bernard,9999,0,9999,0
1668425642865,CSE 293,007,119159,Esmaeilzadeh; Hadi,9999,0,9999,0
1668425642865,CSE 293,008,119166,Freund; Yoav,9999,0,9999,0
1668425642865,CSE 293,009,119170,Griswold; William G.,9999,0,9999,0
1668425642865,CSE 293,010,119183,Gymrek; Melissa Ann,9999,0,9999,0
1668425642865,CSE 293,011,119190,Heninger; Nadia A,9999,0,9999,0
1668425642865,CSE 293,012,119230,Impagliazzo; Russell,9999,0,9999,0
1668425642865,CSE 293,013,119232,Jhala; Ranjit,9999,0,9999,0
1668425642865,CSE 293,014,119233,Kahng; Andrew Byun,9999,0,9999,0
1668425642865,CSE 293,015,119298,Kane; Daniel Mertz,9999,0,9999,0
1668425642865,CSE 293,016,119299,Kriegman; David J,9999,0,9999,0
1668425642865,CSE 293,017,119300,Kumar; Arun Kumar,9999,0,9999,0
1668425642865,CSE 293,018,119301,Lerner; Sorin,9999,0,9999,0
1668425642865,CSE 293,019,119302,Lovett; Shachar,9999,0,9999,0
1668425642865,CSE 293,020,119303,McAuley; Julian John,9999,0,9999,0
1668425642865,CSE 293,021,119304,Micciancio; Daniele,9999,0,9999,0
1668425642865,CSE 293,022,119367,Orailoglu; Alex,9999,0,9999,0
1668425642865,CSE 293,023,119382,Paturi; Ramamohan,9999,0,9999,0
1668425642865,CSE 293,024,119404,Polikarpova; Nadezhda,9999,0,9999,0
1668425642865,CSE 293,025,119406,Politz; Joseph Gibbs,9999,0,9999,0
1668425642865,CSE 293,026,119411,Porter; George M,9999,0,9999,0
1668425642865,CSE 293,027,119414,Porter; Leonard Emerson,9999,0,9999,0
1668425642865,CSE 293,028,119416,Ramamoorthi; Ravi,9999,0,9999,0
1668425642865,CSE 293,029,119417,Sahoo; Debashis,9999,0,9999,0
1668425642865,CSE 293,030,119420,Saul; Lawrence,9999,0,9999,0
1668425642865,CSE 293,031,119421,Savage; Stefan,9999,0,9999,0
1668425642865,CSE 293,032,119425,Schulze; Jurgen P.,9999,0,9999,0
1668425642865,CSE 293,033,119426,Snoeren; Alex C.,9999,0,9999,0
1668425642865,CSE 293,034,119428,Shang; Jingbo,9999,0,9999,0
1668425642865,CSE 293,035,119430,Stefan; Deian,9999,0,9999,0
1668425642865,CSE 293,036,119431,Su; Hao,9999,0,9999,0
1668425642865,CSE 293,037,119433,Swanson; Steven James,9999,0,9999,0
1668425642865,CSE 293,038,119435,Tullsen; Dean Michael,9999,0,9999,0
1668425642865,CSE 293,039,119483,Voelker; Geoffrey M.,9999,0,9999,0
1668425642865,CSE 293,040,119537,Zhao; Jishen,9999,0,9999,0
1668425642865,CSE 293,041,119538,Zhou; Yuan-Yuan,9999,0,9999,0
1668425642865,CSE 293,042,119539,Gao; Sicun,9999,0,9999,0
1668425642865,CSE 293,043,119540,Weibel; Nadir,9999,0,9999,0
1668425642865,CSE 293,044,119541,Gupta; Rajesh K.,9999,0,9999,0
1668425642865,CSE 293,045,126410,Vaccaro; Kristen Marie,9999,0,9999,0
1668425642865,CSE 293,046,126411,Klemke; Richard,9999,0,9999,0
1668425643292,CSE 294,A00,102459,Voelker; Geoffrey M.,0,1,0,0
1668425643292,CSE 294,B00,111322,Orailoglu; Alex,0,0,0,0
1668425643727,DSE 201,A00,096914,Deutsch; Alin Bernard,30,0,30,0
1668425644153,DSE 210,A00,096915,Dasgupta; Sanjoy,30,0,30,0
1668425644580,DSE 260A,A00,096916,Altintas De Callaf; Ilkay,30,0,30,0
1668425645060,ECE 200,001,103586,Antipa; Nicholas A,9999,0,9999,0
1668425645060,ECE 200,002,103587,Atanasov; Nikolay A.,9999,0,9999,0
1668425645060,ECE 200,003,103588,Bharadia; Dinesh,9999,0,9999,0
1668425645060,ECE 200,004,103589,Cheng; Chung Kuan,9999,0,9999,0
1668425645060,ECE 200,005,103590,Cosman; Pamela C.,9999,0,9999,0
1668425645060,ECE 200,006,103591,Dayeh; Shadi Ahmad,9999,0,9999,0
1668425645060,ECE 200,007,103592,Fainman; Yeshaiahu,9999,0,9999,0
1668425645060,ECE 200,008,103593,Ford; Joseph Earl,9999,0,9999,0
1668425645060,ECE 200,009,103594,Franceschetti; Massimo,9999,0,9999,0
1668425645060,ECE 200,010,103595,Fullerton; Eric E,9999,0,9999,0
1668425645060,ECE 200,011,103596,Galton; Ian A,9999,0,9999,0
1668425645060,ECE 200,012,103597,Gilja; Vikash,9999,0,9999,0
1668425645060,ECE 200,013,103598,Hall; Drew A.,9999,0,9999,0
1668425645060,ECE 200,014,103599,Hsueh; Tzu-Chien,9999,0,9999,0
1668425645060,ECE 200,015,103600,Javidi; Tara,9999,0,9999,0
1668425645060,ECE 200,016,103601,Kahng; Andrew Byun,9999,0,9999,0
1668425645060,ECE 200,017,103602,Kim; Young-Han,9999,0,9999,0
1668425645060,ECE 200,018,103603,Koushanfar; Farinaz,9999,0,9999,0
1668425645060,ECE 200,019,103604,Kuzum; Duygu,9999,0,9999,0
1668425645060,ECE 200,020,103605,Le; Hanh-Phuc,9999,0,9999,0
1668425645060,ECE 200,021,103606,Lin; Bill,9999,0,9999,0
1668425645060,ECE 200,022,103607,Liu; Zhaowei,9998,0,9999,1
1668425645060,ECE 200,023,103608,Lo; Yu-Hwa,9999,0,9999,0
1668425645060,ECE 200,024,103609,Lomakin; Vitaliy,9999,0,9999,0
1668425645060,ECE 200,025,103610,Mercier; Patrick Philip,9999,0,9999,0
1668425645060,ECE 200,026,103611,Meyer; Florian,9999,0,9999,0
1668425645060,ECE 200,027,103612,Milstein; Laurence B.,9999,0,9999,0
1668425645060,ECE 200,028,103613,Mir Arabbaygi; Siavash,9999,0,9999,0
1668425645060,ECE 200,029,103614,Mookherjea; Shayan,9999,0,9999,0
1668425645060,ECE 200,030,103615,Morris; Karcher William,9999,0,9999,0
1668425645060,ECE 200,031,103616,Ng; Tse Nga,9999,0,9999,0
1668425645060,ECE 200,032,103617,Nguyen; Truong Quang,9999,0,9999,0
1668425645060,ECE 200,033,103618,Nomura; Kenji,9999,0,9999,0
1668425645060,ECE 200,034,103619,Orlitsky; Alon,9999,0,9999,0
1668425645060,ECE 200,035,103620,Pal; Piya,9999,0,9999,0
1668425645060,ECE 200,036,103621,Papen; George C.,9999,0,9999,0
1668425645060,ECE 200,037,103622,Radic; Stojan,9999,0,9999,0
1668425645060,ECE 200,038,103623,Rao; Bhaskar D.,9999,0,9999,0
1668425645060,ECE 200,039,103624,Rao; Ramesh R,9999,0,9999,0
1668425645060,ECE 200,040,103625,Rebeiz; Gabriel,9999,0,9999,0
1668425645060,ECE 200,041,103626,Sanford; John R,9999,0,9999,0
1668425645060,ECE 200,042,103627,Siegel; Paul H.,9999,0,9999,0
1668425645060,ECE 200,043,103628,Sievenpiper; Daniel F.,9999,0,9999,0
1668425645060,ECE 200,044,103629,Sworder; David D.,9999,0,9999,0
1668425645060,ECE 200,045,103630,Taur; Yuan,9999,0,9999,0
1668425645060,ECE 200,046,103631,Touri; Behrouz,9999,0,9999,0
1668425645060,ECE 200,047,103632,Trivedi; Mohan M.,9999,0,9999,0
1668425645060,ECE 200,048,103633,Vasconcelos; Nuno,9999,0,9999,0
1668425645060,ECE 200,049,103634,Wang; Xiaolong,9999,0,9999,0
1668425645060,ECE 200,050,103635,Xie; Pengtao,9999,0,9999,0
1668425645060,ECE 200,051,103636,Yip; Michael,9999,0,9999,0
1668425645060,ECE 200,052,103637,Zeger; Kenneth A.,999,0,999,0
1668425645060,ECE 200,053,103638,Zhang; Xinyu,9999,0,9999,0
1668425645060,ECE 200,054,103639,Turakhia; Yatish Girish,9999,0,9999,0
1668425645060,ECE 200,055,103640,Kang; Mingu,9999,0,9999,0
1668425645060,ECE 200,056,103641,Shi; Yuanyuan,9999,0,9999,0
1668425645060,ECE 200,057,103642,Wang; Edward Jay,9999,0,9999,0
1668425645060,ECE 200,058,103643,Zheng; Yang,9999,0,9999,0
1668425645498,ECE 202,A00,103644,Kuzum; Duygu,0,21,0,0
1668425645926,ECE 212BN,A00,103646,Ng; Tse Nga,0,1,0,0
1668425646354,ECE 221,A00,111493,Staff,0,0,0,0
1668425646778,ECE 222B,A00,103647,Lomakin; Vitaliy,0,5,0,0
1668425647214,ECE 230B,A00,103648,Taur; Yuan,0,0,0,0
1668425647663,ECE 238B,A00,103649,Garay; Javier,0,0,0,0
1668425648088,ECE 240B,A00,112900,Fainman; Yeshaiahu,0,4,0,0
1668425648519,ECE 247A,A00,103650,Jokerst; Jesse Vincent,0,1,0,0
1668425648955,ECE 247B,A00,103651,Wang; Joseph,0,4,0,0
1668425649405,ECE 250,A00,103652,Siegel; Paul H.,0,42,0,0
1668425649857,ECE 251A,A00,103654,Rao; Bhaskar D.,0,28,0,0
1668425650304,ECE 257B,A00,103655,Bharadia; Dinesh,0,12,0,0
1668425650747,ECE 258A,A00,103656,Milstein; Laurence B.,0,10,0,0
1668425651183,ECE 260B,A00,103658,Kang; Mingu,0,64,0,0
1668425651610,ECE 264A,A00,103659,Galton; Ian A,0,31,0,0
1668425652051,ECE 265A,A00,103661,Gudem; Prasad S.S.,0,16,0,0
1668425652480,ECE 265D,A00,103662,Gudem; Prasad S.S.,0,11,0,0
1668425652910,ECE 268,A00,103663,Koushanfar; Farinaz,0,18,0,0
1668425653338,ECE 269,A01,103665,Pal; Piya,0,125,0,0
1668425653762,ECE 271B,A00,103666,Vasconcelos; Manuela,0,46,0,0
1668425654187,ECE 276A,A00,103667,Atanasov; Nikolay A.,0,66,0,0
1668425654615,ECE 277,A00,103668,An; Cheolhong,0,87,0,0
1668425655039,ECE 279,A00,117947,Hall; Drew A.,0,12,0,0
1668425655914,ECE 283,A00,103670,Hsueh; Tzu-Chien,0,22,0,0
1668425656344,ECE 284,A00,103671,Turakhia; Yatish Girish,0,22,0,0
1668425656768,ECE 285,A00,103672,Zheng; Yang,0,22,0,0
1668425656768,ECE 285,B00,103673,Sworder; David D.,0,36,0,0
1668425657206,ECE 287,A00,103676,Javidi; Tara,0,4,0,0
1668425657649,MATH 200B,A00,098023,Salehi Golsefidy; Alireza,12,0,15,3
1668425658082,MATH 202B,A00,098024,Rhoades; Brendon Patrick,9,0,15,6
1668425658508,MATH 203B,A00,098025,Oprea; Dragos N.,10,0,15,5
1668425658940,MATH 204B,A00,098026,Sorensen; Claus M,13,0,15,2
1668425659367,MATH 208,A00,098027,Izadi; Elham,7,0,10,3
1668425659803,MATH 209,A00,098028,Pollack; Aaron,10,0,10,0
1668425660236,MATH 211A,A00,112919,Rogalski; Daniel,9,0,10,1
1668425660663,MATH 211B,A00,112920,Seward; Brandon M.,9,0,10,1
1668425661091,MATH 218,A00,098029,Li; Bo,10,0,10,0
1668425661528,MATH 220B,A00,098030,Novak; Jonathan I,11,0,15,4
1668425661967,MATH 221A,A00,098031,Ebenfelt; Peter F,13,0,15,2
1668425662427,MATH 231B,A00,098032,Zlatos; Andrej,12,0,15,3
1668425662854,MATH 240B,A00,098033,Ni; Lei,9,0,15,6
1668425663283,MATH 243,A00,098034,Jekel; David Andrew,10,0,10,0
1668425663711,MATH 245A,A00,098035,Nie; Jiawang,0,1,15,16
1668425664147,MATH 248,A00,098036,Bejenaru; Ioan,10,0,10,0
1668425664601,MATH 250B,A00,098037,Spolaor; Luca,14,0,15,1
1668425665026,MATH 258,A00,098038,Ni; Lei,10,0,10,0
1668425665457,MATH 264B,A00,098041,Rhoades; Brendon Patrick,9,0,15,6
1668425665881,MATH 268,A00,098042,Buss; Samuel R,10,0,10,0
1668425666310,MATH 269,A00,098043,Rhoades; Brendon Patrick,10,0,10,0
1668425666739,MATH 270B,A00,098044,Li; Bo,10,0,15,5
1668425667169,MATH 272B,A00,098045,Holst; Michael J,13,0,15,2
1668425667595,MATH 273A,A00,098046,Tian; Xiaochuan,10,0,15,5
1668425668047,MATH 275,A01,098048,Tian; Xiaochuan,6,0,10,4
1668425668481,MATH 278A,A00,098049,Holst; Michael J,8,0,10,2
1668425668904,MATH 278B,A00,098050,Cloninger; Alexander,10,0,10,0
1668425669331,MATH 278C,A00,098051,Nie; Jiawang,6,0,10,4
1668425669755,MATH 280B,A00,098052,Zheng; Tianyi,8,0,15,7
1668425670208,MATH 281B,A00,098053,Bradic; Jelena,0,1,15,15
1668425670654,MATH 282B,A00,098054,Arias-Castro; Ery,0,0,15,15
1668425671079,MATH 285,A00,098055,Fitzsimmons; Patrick J,0,0,15,17
1668425671503,MATH 287B,A00,098056,Arias-Castro; Ery,2,0,15,13
1668425671946,MATH 288,A00,098057,Agarwal; Pooja,9,0,10,1
1668425671946,MATH 288,B00,098058,Zhang; Danna,8,0,10,2
1668425671946,MATH 288,C00,098059,Williams; Ruth J,9,0,10,1
1668425672372,MATH 290B,A00,098060,Roberts; Justin Deritter,13,0,15,2
1668425672814,MATH 292,A00,098061,Belmont; Eva Kinoshita,10,0,10,0
1668425673242,MATH 295,A00,098062,Suk; Andrew Hoon,48,0,50,2
1668425673665,MATH 296,A00,098063,Novak; Jonathan I,20,0,20,0
1668425674194,MATH 297,001,098064,Gamst; Anthony Collins,9997,0,9999,2
1668426184458,COGS 205,A00,101395,Chiba; Andrea,19,0,20,1
1668426184893,COGS 210B,001,101404,Greene; Deanna Jacquelyn,9998,0,9999,1
1668426184893,COGS 210B,002,101417,Xia; Haijun,9999,0,9999,0
1668426184893,COGS 210B,003,101422,Nitz; Douglas A.,9999,0,9999,0
1668426184893,COGS 210B,004,101423,Hollan; James D.,9998,0,9999,1
1668426184893,COGS 210B,005,101424,Deak; Gedeon O.,9998,0,9999,1
1668426184893,COGS 210B,006,101425,Rossano; Federico,9999,0,9999,0
1668426185319,COGS 211B,A00,101427,Coulson; Seana M,9996,0,9999,3
1668426185751,COGS 220,A00,101428,Hollan; James D.,1,2,25,24
1668426186174,COGS 229,A00,101429,Dow; Steven P,18,0,25,7
1668426186603,COGS 230,A00,101430,Klemmer; Scott R,11,0,17,6
1668426187050,COGS 234,A00,101431,Xia; Haijun,2,0,25,23
1668426187483,COGS 260,A00,101432,Kiyonaga; Anastasia,21,0,25,4
1668426187483,COGS 260,B00,101433,Kirsh; David Joel,15,0,25,10
1668426187926,CSE 202,A00,102371,Impagliazzo; Russell,0,31,0,0
1668426188352,CSE 203B,A01,102373,Cheng; Chung Kuan,0,25,0,0
1668426188780,CSE 208,A00,102374,Micciancio; Daniele,0,1,0,0
1668426189222,CSE 209A,A00,112895,Impagliazzo; Russell,0,3,15,15
1668426189656,CSE 209B,A00,108005,Bellare; Mihir,0,3,0,0
1668426190108,CSE 210,A00,113163,Coblenz; Michael J,0,41,0,0
1668426190546,CSE 219,A00,106111,Dow; Steven P,0,0,20,20
1668426190986,CSE 221,A00,102376,Voelker; Geoffrey M.,0,29,0,0
1668426191411,CSE 224,A01,102378,Porter; George M,0,102,0,0
1668426191870,CSE 229A,A00,102379,Savage; Stefan,0,4,0,0
1668426192309,CSE 229C,A00,102380,Munyaka; Imani N. S.,0,4,0,0
1668426192738,CSE 232B,A00,102382,Deutsch; Alin Bernard,0,13,0,0
1668426193170,CSE 234,A01,112904,Kumar; Arun Kumar,0,0,0,0
1668426193595,CSE 237A,A00,102383,Rosing; Tajana Simunic,0,25,0,0
1668426194036,CSE 239A,A00,102384,Deutsch; Alin Bernard,0,5,0,0
1668426194466,CSE 239B,A00,102385,Polikarpova; Nadezhda,0,3,0,0
1668426194894,CSE 240A,A00,102386,Pannuto; Patrick William,0,24,0,0
1668426195323,CSE 240B,A00,102387,Zhao; Jishen,0,23,0,0
1668426195760,CSE 241A,A00,106406,Kang; Mingu,0,2,0,0
1668426196188,CSE 249B,A00,102388,Kahng; Andrew Byun,0,1,8,8
1668426196628,CSE 251B,A01,102392,Cottrell; Garrison W,0,22,0,0
1668426196628,CSE 251B,A02,102393,Cottrell; Garrison W,0,21,0,0
1668426197054,CSE 252B,A00,102394,Ochoa; Benjamin Lawrence,0,36,0,0
1668426197477,CSE 257,A01,102396,Gao; Sicun,0,86,0,0
1668426197913,CSE 272,A00,102397,Li; Tzumao,0,7,0,0
1668426198342,CSE 274,A00,111323,Chern; Albert Ren-Haur,0,7,0,0
1668426198772,CSE 282,A00,102398,Pevzner; Pavel Arkadjevich,0,0,0,0
1668426199225,CSE 284,A00,114175,Gymrek; Melissa Ann,0,9,0,0
1668426199664,CSE 290,A00,102399,Chandraker; Manmohan Krishna,0,4,0,0
1668426199664,CSE 290,B00,102400,Vaccaro; Kristen Marie,0,1,25,25
1668426199664,CSE 290,C00,102414,Pannuto; Patrick William,0,1,25,25
1668426199664,CSE 290,D00,102427,Pevzner; Pavel Arkadjevich,0,0,0,0
1668426199664,CSE 290,E00,102429,Zhao; Jishen,0,1,0,0
1668426199664,CSE 290,F00,102436,Tullsen; Dean Michael,0,2,0,0
1668426199664,CSE 290,G00,102440,Christensen; Henrik I,0,3,20,20
1668426200092,CSE 291,A00,102443,Su; Hao,0,0,0,0
1668426200092,CSE 291,B00,102448,Polikarpova; Nadezhda,0,0,0,0
1668426200092,CSE 291,C00,102453,Vaccaro; Kristen Marie,0,0,0,0
1668426200092,CSE 291,D00,111343,Savage; Stefan,0,0,0,0
1668426200092,CSE 291,E00,116474,Claffy; Kimberly Claire,0,0,0,0
1668426200092,CSE 291,F00,116479,Pasquale; Joseph,0,0,0,0
1668426200542,CSE 293,001,119111,Bafna; Vineet,9999,0,9999,0
1668426200542,CSE 293,002,119118,Bellare; Mihir,9999,0,9999,0
1668426200542,CSE 293,003,119122,Berg-Kirkpatrick; Taylor D,9999,0,9999,0
1668426200542,CSE 293,004,119135,Christensen; Henrik I,9999,0,9999,0
1668426200542,CSE 293,005,119142,Cottrell; Garrison W,9999,0,9999,0
1668426200542,CSE 293,006,119146,Deutsch; Alin Bernard,9999,0,9999,0
1668426200542,CSE 293,007,119159,Esmaeilzadeh; Hadi,9999,0,9999,0
1668426200542,CSE 293,008,119166,Freund; Yoav,9999,0,9999,0
1668426200542,CSE 293,009,119170,Griswold; William G.,9999,0,9999,0
1668426200542,CSE 293,010,119183,Gymrek; Melissa Ann,9999,0,9999,0
1668426200542,CSE 293,011,119190,Heninger; Nadia A,9999,0,9999,0
1668426200542,CSE 293,012,119230,Impagliazzo; Russell,9999,0,9999,0
1668426200542,CSE 293,013,119232,Jhala; Ranjit,9999,0,9999,0
1668426200542,CSE 293,014,119233,Kahng; Andrew Byun,9999,0,9999,0
1668426200542,CSE 293,015,119298,Kane; Daniel Mertz,9999,0,9999,0
1668426200542,CSE 293,016,119299,Kriegman; David J,9999,0,9999,0
1668426200542,CSE 293,017,119300,Kumar; Arun Kumar,9999,0,9999,0
1668426200542,CSE 293,018,119301,Lerner; Sorin,9999,0,9999,0
1668426200542,CSE 293,019,119302,Lovett; Shachar,9999,0,9999,0
1668426200542,CSE 293,020,119303,McAuley; Julian John,9999,0,9999,0
1668426200542,CSE 293,021,119304,Micciancio; Daniele,9999,0,9999,0
1668426200542,CSE 293,022,119367,Orailoglu; Alex,9999,0,9999,0
1668426200542,CSE 293,023,119382,Paturi; Ramamohan,9999,0,9999,0
1668426200542,CSE 293,024,119404,Polikarpova; Nadezhda,9999,0,9999,0
1668426200542,CSE 293,025,119406,Politz; Joseph Gibbs,9999,0,9999,0
1668426200542,CSE 293,026,119411,Porter; George M,9999,0,9999,0
1668426200542,CSE 293,027,119414,Porter; Leonard Emerson,9999,0,9999,0
1668426200542,CSE 293,028,119416,Ramamoorthi; Ravi,9999,0,9999,0
1668426200542,CSE 293,029,119417,Sahoo; Debashis,9999,0,9999,0
1668426200542,CSE 293,030,119420,Saul; Lawrence,9999,0,9999,0
1668426200542,CSE 293,031,119421,Savage; Stefan,9999,0,9999,0
1668426200542,CSE 293,032,119425,Schulze; Jurgen P.,9999,0,9999,0
1668426200542,CSE 293,033,119426,Snoeren; Alex C.,9999,0,9999,0
1668426200542,CSE 293,034,119428,Shang; Jingbo,9999,0,9999,0
1668426200542,CSE 293,035,119430,Stefan; Deian,9999,0,9999,0
1668426200542,CSE 293,036,119431,Su; Hao,9999,0,9999,0
1668426200542,CSE 293,037,119433,Swanson; Steven James,9999,0,9999,0
1668426200542,CSE 293,038,119435,Tullsen; Dean Michael,9999,0,9999,0
1668426200542,CSE 293,039,119483,Voelker; Geoffrey M.,9999,0,9999,0
1668426200542,CSE 293,040,119537,Zhao; Jishen,9999,0,9999,0
1668426200542,CSE 293,041,119538,Zhou; Yuan-Yuan,9999,0,9999,0
1668426200542,CSE 293,042,119539,Gao; Sicun,9999,0,9999,0
1668426200542,CSE 293,043,119540,Weibel; Nadir,9999,0,9999,0
1668426200542,CSE 293,044,119541,Gupta; Rajesh K.,9999,0,9999,0
1668426200542,CSE 293,045,126410,Vaccaro; Kristen Marie,9999,0,9999,0
1668426200542,CSE 293,046,126411,Klemke; Richard,9999,0,9999,0
1668426200974,CSE 294,A00,102459,Voelker; Geoffrey M.,0,1,0,0
1668426200974,CSE 294,B00,111322,Orailoglu; Alex,0,0,0,0
1668426201449,DSE 201,A00,096914,Deutsch; Alin Bernard,30,0,30,0
1668426201878,DSE 210,A00,096915,Dasgupta; Sanjoy,30,0,30,0
1668426202313,DSE 260A,A00,096916,Altintas De Callaf; Ilkay,30,0,30,0
1668426202774,ECE 200,001,103586,Antipa; Nicholas A,9999,0,9999,0
1668426202774,ECE 200,002,103587,Atanasov; Nikolay A.,9999,0,9999,0
1668426202774,ECE 200,003,103588,Bharadia; Dinesh,9999,0,9999,0
1668426202774,ECE 200,004,103589,Cheng; Chung Kuan,9999,0,9999,0
1668426202774,ECE 200,005,103590,Cosman; Pamela C.,9999,0,9999,0
1668426202774,ECE 200,006,103591,Dayeh; Shadi Ahmad,9999,0,9999,0
1668426202774,ECE 200,007,103592,Fainman; Yeshaiahu,9999,0,9999,0
1668426202774,ECE 200,008,103593,Ford; Joseph Earl,9999,0,9999,0
1668426202774,ECE 200,009,103594,Franceschetti; Massimo,9999,0,9999,0
1668426202774,ECE 200,010,103595,Fullerton; Eric E,9999,0,9999,0
1668426202774,ECE 200,011,103596,Galton; Ian A,9999,0,9999,0
1668426202774,ECE 200,012,103597,Gilja; Vikash,9999,0,9999,0
1668426202774,ECE 200,013,103598,Hall; Drew A.,9999,0,9999,0
1668426202774,ECE 200,014,103599,Hsueh; Tzu-Chien,9999,0,9999,0
1668426202774,ECE 200,015,103600,Javidi; Tara,9999,0,9999,0
1668426202774,ECE 200,016,103601,Kahng; Andrew Byun,9999,0,9999,0
1668426202774,ECE 200,017,103602,Kim; Young-Han,9999,0,9999,0
1668426202774,ECE 200,018,103603,Koushanfar; Farinaz,9999,0,9999,0
1668426202774,ECE 200,019,103604,Kuzum; Duygu,9999,0,9999,0
1668426202774,ECE 200,020,103605,Le; Hanh-Phuc,9999,0,9999,0
1668426202774,ECE 200,021,103606,Lin; Bill,9999,0,9999,0
1668426202774,ECE 200,022,103607,Liu; Zhaowei,9998,0,9999,1
1668426202774,ECE 200,023,103608,Lo; Yu-Hwa,9999,0,9999,0
1668426202774,ECE 200,024,103609,Lomakin; Vitaliy,9999,0,9999,0
1668426202774,ECE 200,025,103610,Mercier; Patrick Philip,9999,0,9999,0
1668426202774,ECE 200,026,103611,Meyer; Florian,9999,0,9999,0
1668426202774,ECE 200,027,103612,Milstein; Laurence B.,9999,0,9999,0
1668426202774,ECE 200,028,103613,Mir Arabbaygi; Siavash,9999,0,9999,0
1668426202774,ECE 200,029,103614,Mookherjea; Shayan,9999,0,9999,0
1668426202774,ECE 200,030,103615,Morris; Karcher William,9999,0,9999,0
1668426202774,ECE 200,031,103616,Ng; Tse Nga,9999,0,9999,0
1668426202774,ECE 200,032,103617,Nguyen; Truong Quang,9999,0,9999,0
1668426202774,ECE 200,033,103618,Nomura; Kenji,9999,0,9999,0
1668426202774,ECE 200,034,103619,Orlitsky; Alon,9999,0,9999,0
1668426202774,ECE 200,035,103620,Pal; Piya,9999,0,9999,0
1668426202774,ECE 200,036,103621,Papen; George C.,9999,0,9999,0
1668426202774,ECE 200,037,103622,Radic; Stojan,9999,0,9999,0
1668426202774,ECE 200,038,103623,Rao; Bhaskar D.,9999,0,9999,0
1668426202774,ECE 200,039,103624,Rao; Ramesh R,9999,0,9999,0
1668426202774,ECE 200,040,103625,Rebeiz; Gabriel,9999,0,9999,0
1668426202774,ECE 200,041,103626,Sanford; John R,9999,0,9999,0
1668426202774,ECE 200,042,103627,Siegel; Paul H.,9999,0,9999,0
1668426202774,ECE 200,043,103628,Sievenpiper; Daniel F.,9999,0,9999,0
1668426202774,ECE 200,044,103629,Sworder; David D.,9999,0,9999,0
1668426202774,ECE 200,045,103630,Taur; Yuan,9999,0,9999,0
1668426202774,ECE 200,046,103631,Touri; Behrouz,9999,0,9999,0
1668426202774,ECE 200,047,103632,Trivedi; Mohan M.,9999,0,9999,0
1668426202774,ECE 200,048,103633,Vasconcelos; Nuno,9999,0,9999,0
1668426202774,ECE 200,049,103634,Wang; Xiaolong,9999,0,9999,0
1668426202774,ECE 200,050,103635,Xie; Pengtao,9999,0,9999,0
1668426202774,ECE 200,051,103636,Yip; Michael,9999,0,9999,0
1668426202774,ECE 200,052,103637,Zeger; Kenneth A.,999,0,999,0
1668426202774,ECE 200,053,103638,Zhang; Xinyu,9999,0,9999,0
1668426202774,ECE 200,054,103639,Turakhia; Yatish Girish,9999,0,9999,0
1668426202774,ECE 200,055,103640,Kang; Mingu,9999,0,9999,0
1668426202774,ECE 200,056,103641,Shi; Yuanyuan,9999,0,9999,0
1668426202774,ECE 200,057,103642,Wang; Edward Jay,9999,0,9999,0
1668426202774,ECE 200,058,103643,Zheng; Yang,9999,0,9999,0
1668426203200,ECE 202,A00,103644,Kuzum; Duygu,0,21,0,0
1668426203634,ECE 212BN,A00,103646,Ng; Tse Nga,0,1,0,0
1668426204076,ECE 221,A00,111493,Staff,0,0,0,0
1668426204508,ECE 222B,A00,103647,Lomakin; Vitaliy,0,5,0,0
1668426205043,ECE 230B,A00,103648,Taur; Yuan,0,0,0,0
1668426205473,ECE 238B,A00,103649,Garay; Javier,0,0,0,0
1668426205900,ECE 240B,A00,112900,Fainman; Yeshaiahu,0,4,0,0
1668426206332,ECE 247A,A00,103650,Jokerst; Jesse Vincent,0,1,0,0
1668426206759,ECE 247B,A00,103651,Wang; Joseph,0,4,0,0
1668426207207,ECE 250,A00,103652,Siegel; Paul H.,0,42,0,0
1668426207642,ECE 251A,A00,103654,Rao; Bhaskar D.,0,28,0,0
1668426208085,ECE 257B,A00,103655,Bharadia; Dinesh,0,12,0,0
1668426208519,ECE 258A,A00,103656,Milstein; Laurence B.,0,10,0,0
1668426208944,ECE 260B,A00,103658,Kang; Mingu,0,64,0,0
1668426209373,ECE 264A,A00,103659,Galton; Ian A,0,31,0,0
1668426209804,ECE 265A,A00,103661,Gudem; Prasad S.S.,0,16,0,0
1668426210238,ECE 265D,A00,103662,Gudem; Prasad S.S.,0,11,0,0
1668426210666,ECE 268,A00,103663,Koushanfar; Farinaz,0,18,0,0
1668426211089,ECE 269,A01,103665,Pal; Piya,0,125,0,0
1668426211541,ECE 271B,A00,103666,Vasconcelos; Manuela,0,46,0,0
1668426211981,ECE 276A,A00,103667,Atanasov; Nikolay A.,0,66,0,0
1668426212406,ECE 277,A00,103668,An; Cheolhong,0,87,0,0
1668426212830,ECE 279,A00,117947,Hall; Drew A.,0,12,0,0
1668426213711,ECE 283,A00,103670,Hsueh; Tzu-Chien,0,22,0,0
1668426214135,ECE 284,A00,103671,Turakhia; Yatish Girish,0,22,0,0
1668426214585,ECE 285,A00,103672,Zheng; Yang,0,22,0,0
1668426214585,ECE 285,B00,103673,Sworder; David D.,0,36,0,0
1668426215008,ECE 287,A00,103676,Javidi; Tara,0,4,0,0
1668426215442,MATH 200B,A00,098023,Salehi Golsefidy; Alireza,12,0,15,3
1668426215881,MATH 202B,A00,098024,Rhoades; Brendon Patrick,9,0,15,6
1668426216336,MATH 203B,A00,098025,Oprea; Dragos N.,10,0,15,5
1668426216761,MATH 204B,A00,098026,Sorensen; Claus M,13,0,15,2
1668426217191,MATH 208,A00,098027,Izadi; Elham,7,0,10,3
1668426217625,MATH 209,A00,098028,Pollack; Aaron,10,0,10,0
1668426218067,MATH 211A,A00,112919,Rogalski; Daniel,9,0,10,1
1668426218498,MATH 211B,A00,112920,Seward; Brandon M.,9,0,10,1
1668426218924,MATH 218,A00,098029,Li; Bo,10,0,10,0
1668426219351,MATH 220B,A00,098030,Novak; Jonathan I,11,0,15,4
1668426219791,MATH 221A,A00,098031,Ebenfelt; Peter F,13,0,15,2
1668426220215,MATH 231B,A00,098032,Zlatos; Andrej,12,0,15,3
1668426220644,MATH 240B,A00,098033,Ni; Lei,9,0,15,6
1668426221073,MATH 243,A00,098034,Jekel; David Andrew,10,0,10,0
1668426221504,MATH 245A,A00,098035,Nie; Jiawang,0,1,15,16
1668426221927,MATH 248,A00,098036,Bejenaru; Ioan,10,0,10,0
1668426222353,MATH 250B,A00,098037,Spolaor; Luca,14,0,15,1
1668426222795,MATH 258,A00,098038,Ni; Lei,10,0,10,0
1668426223223,MATH 264B,A00,098041,Rhoades; Brendon Patrick,9,0,15,6
1668426223654,MATH 268,A00,098042,Buss; Samuel R,10,0,10,0
1668426224081,MATH 269,A00,098043,Rhoades; Brendon Patrick,10,0,10,0
1668426224510,MATH 270B,A00,098044,Li; Bo,10,0,15,5
1668426224938,MATH 272B,A00,098045,Holst; Michael J,13,0,15,2
1668426225371,MATH 273A,A00,098046,Tian; Xiaochuan,10,0,15,5
1668426225797,MATH 275,A01,098048,Tian; Xiaochuan,6,0,10,4
1668426226233,MATH 278A,A00,098049,Holst; Michael J,8,0,10,2
1668426226680,MATH 278B,A00,098050,Cloninger; Alexander,10,0,10,0
1668426227104,MATH 278C,A00,098051,Nie; Jiawang,6,0,10,4
1668426227528,MATH 280B,A00,098052,Zheng; Tianyi,8,0,15,7
1668426227967,MATH 281B,A00,098053,Bradic; Jelena,0,1,15,15
1668426228403,MATH 282B,A00,098054,Arias-Castro; Ery,0,0,15,15
1668426228831,MATH 285,A00,098055,Fitzsimmons; Patrick J,0,0,15,17
1668426229256,MATH 287B,A00,098056,Arias-Castro; Ery,2,0,15,13
1668426229694,MATH 288,A00,098057,Agarwal; Pooja,9,0,10,1
1668426229694,MATH 288,B00,098058,Zhang; Danna,8,0,10,2
1668426229694,MATH 288,C00,098059,Williams; Ruth J,9,0,10,1
1668426230127,MATH 290B,A00,098060,Roberts; Justin Deritter,13,0,15,2
1668426230576,MATH 292,A00,098061,Belmont; Eva Kinoshita,10,0,10,0
1668426231021,MATH 295,A00,098062,Suk; Andrew Hoon,48,0,50,2
1668426231451,MATH 296,A00,098063,Novak; Jonathan I,20,0,20,0
1668426231884,MATH 297,001,098064,Gamst; Anthony Collins,9997,0,9999,2
1668426741086,COGS 205,A00,101395,Chiba; Andrea,19,0,20,1
1668426741522,COGS 210B,001,101404,Greene; Deanna Jacquelyn,9998,0,9999,1
1668426741522,COGS 210B,002,101417,Xia; Haijun,9999,0,9999,0
1668426741522,COGS 210B,003,101422,Nitz; Douglas A.,9999,0,9999,0
1668426741522,COGS 210B,004,101423,Hollan; James D.,9998,0,9999,1
1668426741522,COGS 210B,005,101424,Deak; Gedeon O.,9998,0,9999,1
1668426741522,COGS 210B,006,101425,Rossano; Federico,9999,0,9999,0
1668426741972,COGS 211B,A00,101427,Coulson; Seana M,9996,0,9999,3
1668426742407,COGS 220,A00,101428,Hollan; James D.,1,2,25,24
1668426742844,COGS 229,A00,101429,Dow; Steven P,18,0,25,7
1668426743273,COGS 230,A00,101430,Klemmer; Scott R,11,0,17,6
1668426743705,COGS 234,A00,101431,Xia; Haijun,2,0,25,23
1668426744136,COGS 260,A00,101432,Kiyonaga; Anastasia,21,0,25,4
1668426744136,COGS 260,B00,101433,Kirsh; David Joel,15,0,25,10
1668426744567,CSE 202,A00,102371,Impagliazzo; Russell,0,31,0,0
1668426745012,CSE 203B,A01,102373,Cheng; Chung Kuan,0,25,0,0
1668426745454,CSE 208,A00,102374,Micciancio; Daniele,0,1,0,0
1668426745880,CSE 209A,A00,112895,Impagliazzo; Russell,0,3,15,15
1668426746322,CSE 209B,A00,108005,Bellare; Mihir,0,3,0,0
1668426746767,CSE 210,A00,113163,Coblenz; Michael J,0,41,0,0
1668426747203,CSE 219,A00,106111,Dow; Steven P,0,0,20,20
1668426747629,CSE 221,A00,102376,Voelker; Geoffrey M.,0,29,0,0
1668426748053,CSE 224,A01,102378,Porter; George M,0,102,0,0
1668426748498,CSE 229A,A00,102379,Savage; Stefan,0,4,0,0
1668426748936,CSE 229C,A00,102380,Munyaka; Imani N. S.,0,4,0,0
1668426749373,CSE 232B,A00,102382,Deutsch; Alin Bernard,0,13,0,0
1668426749803,CSE 234,A01,112904,Kumar; Arun Kumar,0,0,0,0
1668426750244,CSE 237A,A00,102383,Rosing; Tajana Simunic,0,25,0,0
1668426750689,CSE 239A,A00,102384,Deutsch; Alin Bernard,0,5,0,0
1668426751116,CSE 239B,A00,102385,Polikarpova; Nadezhda,0,3,0,0
1668426751547,CSE 240A,A00,102386,Pannuto; Patrick William,0,24,0,0
1668426751978,CSE 240B,A00,102387,Zhao; Jishen,0,23,0,0
1668426752406,CSE 241A,A00,106406,Kang; Mingu,0,2,0,0
1668426752831,CSE 249B,A00,102388,Kahng; Andrew Byun,0,1,8,8
1668426753277,CSE 251B,A01,102392,Cottrell; Garrison W,0,22,0,0
1668426753277,CSE 251B,A02,102393,Cottrell; Garrison W,0,21,0,0
1668426753706,CSE 252B,A00,102394,Ochoa; Benjamin Lawrence,0,36,0,0
1668426754131,CSE 257,A01,102396,Gao; Sicun,0,86,0,0
1668426754575,CSE 272,A00,102397,Li; Tzumao,0,7,0,0
1668426755003,CSE 274,A00,111323,Chern; Albert Ren-Haur,0,7,0,0
1668426755459,CSE 282,A00,102398,Pevzner; Pavel Arkadjevich,0,0,0,0
1668426755884,CSE 284,A00,114175,Gymrek; Melissa Ann,0,9,0,0
1668426756310,CSE 290,A00,102399,Chandraker; Manmohan Krishna,0,4,0,0
1668426756310,CSE 290,B00,102400,Vaccaro; Kristen Marie,0,1,25,25
1668426756310,CSE 290,C00,102414,Pannuto; Patrick William,0,1,25,25
1668426756310,CSE 290,D00,102427,Pevzner; Pavel Arkadjevich,0,0,0,0
1668426756310,CSE 290,E00,102429,Zhao; Jishen,0,1,0,0
1668426756310,CSE 290,F00,102436,Tullsen; Dean Michael,0,2,0,0
1668426756310,CSE 290,G00,102440,Christensen; Henrik I,0,3,20,20
1668426756755,CSE 291,A00,102443,Su; Hao,0,0,0,0
1668426756755,CSE 291,B00,102448,Polikarpova; Nadezhda,0,0,0,0
1668426756755,CSE 291,C00,102453,Vaccaro; Kristen Marie,0,0,0,0
1668426756755,CSE 291,D00,111343,Savage; Stefan,0,0,0,0
1668426756755,CSE 291,E00,116474,Claffy; Kimberly Claire,0,0,0,0
1668426756755,CSE 291,F00,116479,Pasquale; Joseph,0,0,0,0
1668426757233,CSE 293,001,119111,Bafna; Vineet,9999,0,9999,0
1668426757233,CSE 293,002,119118,Bellare; Mihir,9999,0,9999,0
1668426757233,CSE 293,003,119122,Berg-Kirkpatrick; Taylor D,9999,0,9999,0
1668426757233,CSE 293,004,119135,Christensen; Henrik I,9999,0,9999,0
1668426757233,CSE 293,005,119142,Cottrell; Garrison W,9999,0,9999,0
1668426757233,CSE 293,006,119146,Deutsch; Alin Bernard,9999,0,9999,0
1668426757233,CSE 293,007,119159,Esmaeilzadeh; Hadi,9999,0,9999,0
1668426757233,CSE 293,008,119166,Freund; Yoav,9999,0,9999,0
1668426757233,CSE 293,009,119170,Griswold; William G.,9999,0,9999,0
1668426757233,CSE 293,010,119183,Gymrek; Melissa Ann,9999,0,9999,0
1668426757233,CSE 293,011,119190,Heninger; Nadia A,9999,0,9999,0
1668426757233,CSE 293,012,119230,Impagliazzo; Russell,9999,0,9999,0
1668426757233,CSE 293,013,119232,Jhala; Ranjit,9999,0,9999,0
1668426757233,CSE 293,014,119233,Kahng; Andrew Byun,9999,0,9999,0
1668426757233,CSE 293,015,119298,Kane; Daniel Mertz,9999,0,9999,0
1668426757233,CSE 293,016,119299,Kriegman; David J,9999,0,9999,0
1668426757233,CSE 293,017,119300,Kumar; Arun Kumar,9999,0,9999,0
1668426757233,CSE 293,018,119301,Lerner; Sorin,9999,0,9999,0
1668426757233,CSE 293,019,119302,Lovett; Shachar,9999,0,9999,0
1668426757233,CSE 293,020,119303,McAuley; Julian John,9999,0,9999,0
1668426757233,CSE 293,021,119304,Micciancio; Daniele,9999,0,9999,0
1668426757233,CSE 293,022,119367,Orailoglu; Alex,9999,0,9999,0
1668426757233,CSE 293,023,119382,Paturi; Ramamohan,9999,0,9999,0
1668426757233,CSE 293,024,119404,Polikarpova; Nadezhda,9999,0,9999,0
1668426757233,CSE 293,025,119406,Politz; Joseph Gibbs,9999,0,9999,0
1668426757233,CSE 293,026,119411,Porter; George M,9999,0,9999,0
1668426757233,CSE 293,027,119414,Porter; Leonard Emerson,9999,0,9999,0
1668426757233,CSE 293,028,119416,Ramamoorthi; Ravi,9999,0,9999,0
1668426757233,CSE 293,029,119417,Sahoo; Debashis,9999,0,9999,0
1668426757233,CSE 293,030,119420,Saul; Lawrence,9999,0,9999,0
1668426757233,CSE 293,031,119421,Savage; Stefan,9999,0,9999,0
1668426757233,CSE 293,032,119425,Schulze; Jurgen P.,9999,0,9999,0
1668426757233,CSE 293,033,119426,Snoeren; Alex C.,9999,0,9999,0
1668426757233,CSE 293,034,119428,Shang; Jingbo,9999,0,9999,0
1668426757233,CSE 293,035,119430,Stefan; Deian,9999,0,9999,0
1668426757233,CSE 293,036,119431,Su; Hao,9999,0,9999,0
1668426757233,CSE 293,037,119433,Swanson; Steven James,9999,0,9999,0
1668426757233,CSE 293,038,119435,Tullsen; Dean Michael,9999,0,9999,0
1668426757233,CSE 293,039,119483,Voelker; Geoffrey M.,9999,0,9999,0
1668426757233,CSE 293,040,119537,Zhao; Jishen,9999,0,9999,0
1668426757233,CSE 293,041,119538,Zhou; Yuan-Yuan,9999,0,9999,0
1668426757233,CSE 293,042,119539,Gao; Sicun,9999,0,9999,0
1668426757233,CSE 293,043,119540,Weibel; Nadir,9999,0,9999,0
1668426757233,CSE 293,044,119541,Gupta; Rajesh K.,9999,0,9999,0
1668426757233,CSE 293,045,126410,Vaccaro; Kristen Marie,9999,0,9999,0
1668426757233,CSE 293,046,126411,Klemke; Richard,9999,0,9999,0
1668426757669,CSE 294,A00,102459,Voelker; Geoffrey M.,0,1,0,0
1668426757669,CSE 294,B00,111322,Orailoglu; Alex,0,0,0,0
1668426758095,DSE 201,A00,096914,Deutsch; Alin Bernard,30,0,30,0
1668426758538,DSE 210,A00,096915,Dasgupta; Sanjoy,30,0,30,0
1668426758964,DSE 260A,A00,096916,Altintas De Callaf; Ilkay,30,0,30,0
1668426759519,ECE 200,001,103586,Antipa; Nicholas A,9999,0,9999,0
1668426759519,ECE 200,002,103587,Atanasov; Nikolay A.,9999,0,9999,0
1668426759519,ECE 200,003,103588,Bharadia; Dinesh,9999,0,9999,0
1668426759519,ECE 200,004,103589,Cheng; Chung Kuan,9999,0,9999,0
1668426759519,ECE 200,005,103590,Cosman; Pamela C.,9999,0,9999,0
1668426759519,ECE 200,006,103591,Dayeh; Shadi Ahmad,9999,0,9999,0
1668426759519,ECE 200,007,103592,Fainman; Yeshaiahu,9999,0,9999,0
1668426759519,ECE 200,008,103593,Ford; Joseph Earl,9999,0,9999,0
1668426759519,ECE 200,009,103594,Franceschetti; Massimo,9999,0,9999,0
1668426759519,ECE 200,010,103595,Fullerton; Eric E,9999,0,9999,0
1668426759519,ECE 200,011,103596,Galton; Ian A,9999,0,9999,0
1668426759519,ECE 200,012,103597,Gilja; Vikash,9999,0,9999,0
1668426759519,ECE 200,013,103598,Hall; Drew A.,9999,0,9999,0
1668426759519,ECE 200,014,103599,Hsueh; Tzu-Chien,9999,0,9999,0
1668426759519,ECE 200,015,103600,Javidi; Tara,9999,0,9999,0
1668426759519,ECE 200,016,103601,Kahng; Andrew Byun,9999,0,9999,0
1668426759519,ECE 200,017,103602,Kim; Young-Han,9999,0,9999,0
1668426759519,ECE 200,018,103603,Koushanfar; Farinaz,9999,0,9999,0
1668426759519,ECE 200,019,103604,Kuzum; Duygu,9999,0,9999,0
1668426759519,ECE 200,020,103605,Le; Hanh-Phuc,9999,0,9999,0
1668426759519,ECE 200,021,103606,Lin; Bill,9999,0,9999,0
1668426759519,ECE 200,022,103607,Liu; Zhaowei,9998,0,9999,1
1668426759519,ECE 200,023,103608,Lo; Yu-Hwa,9999,0,9999,0
1668426759519,ECE 200,024,103609,Lomakin; Vitaliy,9999,0,9999,0
1668426759519,ECE 200,025,103610,Mercier; Patrick Philip,9999,0,9999,0
1668426759519,ECE 200,026,103611,Meyer; Florian,9999,0,9999,0
1668426759519,ECE 200,027,103612,Milstein; Laurence B.,9999,0,9999,0
1668426759519,ECE 200,028,103613,Mir Arabbaygi; Siavash,9999,0,9999,0
1668426759519,ECE 200,029,103614,Mookherjea; Shayan,9999,0,9999,0
1668426759519,ECE 200,030,103615,Morris; Karcher William,9999,0,9999,0
1668426759519,ECE 200,031,103616,Ng; Tse Nga,9999,0,9999,0
1668426759519,ECE 200,032,103617,Nguyen; Truong Quang,9999,0,9999,0
1668426759519,ECE 200,033,103618,Nomura; Kenji,9999,0,9999,0
1668426759519,ECE 200,034,103619,Orlitsky; Alon,9999,0,9999,0
1668426759519,ECE 200,035,103620,Pal; Piya,9999,0,9999,0
1668426759519,ECE 200,036,103621,Papen; George C.,9999,0,9999,0
1668426759519,ECE 200,037,103622,Radic; Stojan,9999,0,9999,0
1668426759519,ECE 200,038,103623,Rao; Bhaskar D.,9999,0,9999,0
1668426759519,ECE 200,039,103624,Rao; Ramesh R,9999,0,9999,0
1668426759519,ECE 200,040,103625,Rebeiz; Gabriel,9999,0,9999,0
1668426759519,ECE 200,041,103626,Sanford; John R,9999,0,9999,0
1668426759519,ECE 200,042,103627,Siegel; Paul H.,9999,0,9999,0
1668426759519,ECE 200,043,103628,Sievenpiper; Daniel F.,9999,0,9999,0
1668426759519,ECE 200,044,103629,Sworder; David D.,9999,0,9999,0
1668426759519,ECE 200,045,103630,Taur; Yuan,9999,0,9999,0
1668426759519,ECE 200,046,103631,Touri; Behrouz,9999,0,9999,0
1668426759519,ECE 200,047,103632,Trivedi; Mohan M.,9999,0,9999,0
1668426759519,ECE 200,048,103633,Vasconcelos; Nuno,9999,0,9999,0
1668426759519,ECE 200,049,103634,Wang; Xiaolong,9999,0,9999,0
1668426759519,ECE 200,050,103635,Xie; Pengtao,9999,0,9999,0
1668426759519,ECE 200,051,103636,Yip; Michael,9999,0,9999,0
1668426759519,ECE 200,052,103637,Zeger; Kenneth A.,999,0,999,0
1668426759519,ECE 200,053,103638,Zhang; Xinyu,9999,0,9999,0
1668426759519,ECE 200,054,103639,Turakhia; Yatish Girish,9999,0,9999,0
1668426759519,ECE 200,055,103640,Kang; Mingu,9999,0,9999,0
1668426759519,ECE 200,056,103641,Shi; Yuanyuan,9999,0,9999,0
1668426759519,ECE 200,057,103642,Wang; Edward Jay,9999,0,9999,0
1668426759519,ECE 200,058,103643,Zheng; Yang,9999,0,9999,0
1668426759945,ECE 202,A00,103644,Kuzum; Duygu,0,21,0,0
1668426760373,ECE 212BN,A00,103646,Ng; Tse Nga,0,1,0,0
1668426760800,ECE 221,A00,111493,Staff,0,0,0,0
1668426761224,ECE 222B,A00,103647,Lomakin; Vitaliy,0,5,0,0
1668426761658,ECE 230B,A00,103648,Taur; Yuan,0,0,0,0
1668426762105,ECE 238B,A00,103649,Garay; Javier,0,0,0,0
1668426762533,ECE 240B,A00,112900,Fainman; Yeshaiahu,0,4,0,0
1668426762958,ECE 247A,A00,103650,Jokerst; Jesse Vincent,0,1,0,0
1668426763394,ECE 247B,A00,103651,Wang; Joseph,0,4,0,0
1668426763832,ECE 250,A00,103652,Siegel; Paul H.,0,42,0,0
1668426764270,ECE 251A,A00,103654,Rao; Bhaskar D.,0,28,0,0
1668426764694,ECE 257B,A00,103655,Bharadia; Dinesh,0,12,0,0
1668426765126,ECE 258A,A00,103656,Milstein; Laurence B.,0,10,0,0
1668426765562,ECE 260B,A00,103658,Kang; Mingu,0,64,0,0
1668426765987,ECE 264A,A00,103659,Galton; Ian A,0,31,0,0
1668426766411,ECE 265A,A00,103661,Gudem; Prasad S.S.,0,16,0,0
1668426766849,ECE 265D,A00,103662,Gudem; Prasad S.S.,0,11,0,0
1668426767277,ECE 268,A00,103663,Koushanfar; Farinaz,0,18,0,0
1668426767710,ECE 269,A01,103665,Pal; Piya,0,125,0,0
1668426768144,ECE 271B,A00,103666,Vasconcelos; Manuela,0,46,0,0
1668426768574,ECE 276A,A00,103667,Atanasov; Nikolay A.,0,66,0,0
1668426768999,ECE 277,A00,103668,An; Cheolhong,0,87,0,0
1668426769427,ECE 279,A00,117947,Hall; Drew A.,0,12,0,0
1668426770316,ECE 283,A00,103670,Hsueh; Tzu-Chien,0,22,0,0
1668426770767,ECE 284,A00,103671,Turakhia; Yatish Girish,0,22,0,0
1668426771198,ECE 285,A00,103672,Zheng; Yang,0,22,0,0
1668426771198,ECE 285,B00,103673,Sworder; David D.,0,36,0,0
1668426771636,ECE 287,A00,103676,Javidi; Tara,0,4,0,0
1668426772063,MATH 200B,A00,098023,Salehi Golsefidy; Alireza,12,0,15,3
1668426772507,MATH 202B,A00,098024,Rhoades; Brendon Patrick,9,0,15,6
1668426772938,MATH 203B,A00,098025,Oprea; Dragos N.,10,0,15,5
1668426773366,MATH 204B,A00,098026,Sorensen; Claus M,13,0,15,2
1668426773799,MATH 208,A00,098027,Izadi; Elham,7,0,10,3
1668426774231,MATH 209,A00,098028,Pollack; Aaron,10,0,10,0
1668426774662,MATH 211A,A00,112919,Rogalski; Daniel,9,0,10,1
1668426775087,MATH 211B,A00,112920,Seward; Brandon M.,9,0,10,1
1668426775518,MATH 218,A00,098029,Li; Bo,10,0,10,0
1668426775948,MATH 220B,A00,098030,Novak; Jonathan I,11,0,15,4
1668426776404,MATH 221A,A00,098031,Ebenfelt; Peter F,13,0,15,2
1668426776851,MATH 231B,A00,098032,Zlatos; Andrej,12,0,15,3
1668426777277,MATH 240B,A00,098033,Ni; Lei,9,0,15,6
1668426777701,MATH 243,A00,098034,Jekel; David Andrew,10,0,10,0
1668426778132,MATH 245A,A00,098035,Nie; Jiawang,0,1,15,16
1668426778638,MATH 248,A00,098036,Bejenaru; Ioan,10,0,10,0
1668426779073,MATH 250B,A00,098037,Spolaor; Luca,14,0,15,1
1668426779519,MATH 258,A00,098038,Ni; Lei,10,0,10,0
1668426779954,MATH 264B,A00,098041,Rhoades; Brendon Patrick,9,0,15,6
1668426780386,MATH 268,A00,098042,Buss; Samuel R,10,0,10,0
1668426780821,MATH 269,A00,098043,Rhoades; Brendon Patrick,10,0,10,0
1668426781263,MATH 270B,A00,098044,Li; Bo,10,0,15,5
1668426781699,MATH 272B,A00,098045,Holst; Michael J,13,0,15,2
1668426782125,MATH 273A,A00,098046,Tian; Xiaochuan,10,0,15,5
1668426782553,MATH 275,A01,098048,Tian; Xiaochuan,6,0,10,4
1668426782976,MATH 278A,A00,098049,Holst; Michael J,8,0,10,2
1668426783420,MATH 278B,A00,098050,Cloninger; Alexander,10,0,10,0
1668426783849,MATH 278C,A00,098051,Nie; Jiawang,6,0,10,4
1668426784299,MATH 280B,A00,098052,Zheng; Tianyi,8,0,15,7
1668426784730,MATH 281B,A00,098053,Bradic; Jelena,0,1,15,15
1668426785163,MATH 282B,A00,098054,Arias-Castro; Ery,0,0,15,15
1668426785612,MATH 285,A00,098055,Fitzsimmons; Patrick J,0,0,15,17
1668426786054,MATH 287B,A00,098056,Arias-Castro; Ery,2,0,15,13
1668426786481,MATH 288,A00,098057,Agarwal; Pooja,9,0,10,1
1668426786481,MATH 288,B00,098058,Zhang; Danna,8,0,10,2
1668426786481,MATH 288,C00,098059,Williams; Ruth J,9,0,10,1
1668426786923,MATH 290B,A00,098060,Roberts; Justin Deritter,13,0,15,2
1668426787347,MATH 292,A00,098061,Belmont; Eva Kinoshita,10,0,10,0
1668426787791,MATH 295,A00,098062,Suk; Andrew Hoon,48,0,50,2
1668426788219,MATH 296,A00,098063,Novak; Jonathan I,20,0,20,0
1668426788643,MATH 297,001,098064,Gamst; Anthony Collins,9997,0,9999,2
1668427297527,COGS 205,A00,101395,Chiba; Andrea,19,0,20,1
1668427297973,COGS 210B,001,101404,Greene; Deanna Jacquelyn,9998,0,9999,1
1668427297973,COGS 210B,002,101417,Xia; Haijun,9999,0,9999,0
1668427297973,COGS 210B,003,101422,Nitz; Douglas A.,9999,0,9999,0
1668427297973,COGS 210B,004,101423,Hollan; James D.,9998,0,9999,1
1668427297973,COGS 210B,005,101424,Deak; Gedeon O.,9998,0,9999,1
1668427297973,COGS 210B,006,101425,Rossano; Federico,9999,0,9999,0
1668427298436,COGS 211B,A00,101427,Coulson; Seana M,9996,0,9999,3
1668427298861,COGS 220,A00,101428,Hollan; James D.,1,2,25,24
1668427299289,COGS 229,A00,101429,Dow; Steven P,18,0,25,7
1668427299723,COGS 230,A00,101430,Klemmer; Scott R,11,0,17,6
1668427300150,COGS 234,A00,101431,Xia; Haijun,2,0,25,23
1668427300587,COGS 260,A00,101432,Kiyonaga; Anastasia,21,0,25,4
1668427300587,COGS 260,B00,101433,Kirsh; David Joel,15,0,25,10
1668427301018,CSE 202,A00,102371,Impagliazzo; Russell,0,31,0,0
1668427301445,CSE 203B,A01,102373,Cheng; Chung Kuan,0,25,0,0
1668427301894,CSE 208,A00,102374,Micciancio; Daniele,0,1,0,0
1668427302327,CSE 209A,A00,112895,Impagliazzo; Russell,0,3,15,15
1668427302762,CSE 209B,A00,108005,Bellare; Mihir,0,3,0,0
1668427303191,CSE 210,A00,113163,Coblenz; Michael J,0,41,0,0
1668427303618,CSE 219,A00,106111,Dow; Steven P,0,0,20,20
1668427304053,CSE 221,A00,102376,Voelker; Geoffrey M.,0,29,0,0
1668427304494,CSE 224,A01,102378,Porter; George M,0,102,0,0
1668427304943,CSE 229A,A00,102379,Savage; Stefan,0,4,0,0
1668427305367,CSE 229C,A00,102380,Munyaka; Imani N. S.,0,4,0,0
1668427305793,CSE 232B,A00,102382,Deutsch; Alin Bernard,0,13,0,0
1668427306229,CSE 234,A01,112904,Kumar; Arun Kumar,0,0,0,0
1668427306683,CSE 237A,A00,102383,Rosing; Tajana Simunic,0,25,0,0
1668427307117,CSE 239A,A00,102384,Deutsch; Alin Bernard,0,5,0,0
1668427307544,CSE 239B,A00,102385,Polikarpova; Nadezhda,0,3,0,0
1668427308066,CSE 240A,A00,102386,Pannuto; Patrick William,0,24,0,0
1668427308506,CSE 240B,A00,102387,Zhao; Jishen,0,23,0,0
1668427308961,CSE 241A,A00,106406,Kang; Mingu,0,2,0,0
1668427309418,CSE 249B,A00,102388,Kahng; Andrew Byun,0,1,8,8
1668427309849,CSE 251B,A01,102392,Cottrell; Garrison W,0,22,0,0
1668427309849,CSE 251B,A02,102393,Cottrell; Garrison W,0,21,0,0
1668427310274,CSE 252B,A00,102394,Ochoa; Benjamin Lawrence,0,36,0,0
1668427310698,CSE 257,A01,102396,Gao; Sicun,0,86,0,0
1668427311122,CSE 272,A00,102397,Li; Tzumao,0,7,0,0
1668427311560,CSE 274,A00,111323,Chern; Albert Ren-Haur,0,7,0,0
1668427311983,CSE 282,A00,102398,Pevzner; Pavel Arkadjevich,0,0,0,0
1668427312424,CSE 284,A00,114175,Gymrek; Melissa Ann,0,9,0,0
1668427312887,CSE 290,A00,102399,Chandraker; Manmohan Krishna,0,4,0,0
1668427312887,CSE 290,B00,102400,Vaccaro; Kristen Marie,0,1,25,25
1668427312887,CSE 290,C00,102414,Pannuto; Patrick William,0,1,25,25
1668427312887,CSE 290,D00,102427,Pevzner; Pavel Arkadjevich,0,0,0,0
1668427312887,CSE 290,E00,102429,Zhao; Jishen,0,1,0,0
1668427312887,CSE 290,F00,102436,Tullsen; Dean Michael,0,2,0,0
1668427312887,CSE 290,G00,102440,Christensen; Henrik I,0,3,20,20
1668427313340,CSE 291,A00,102443,Su; Hao,0,0,0,0
1668427313340,CSE 291,B00,102448,Polikarpova; Nadezhda,0,0,0,0
1668427313340,CSE 291,C00,102453,Vaccaro; Kristen Marie,0,0,0,0
1668427313340,CSE 291,D00,111343,Savage; Stefan,0,0,0,0
1668427313340,CSE 291,E00,116474,Claffy; Kimberly Claire,0,0,0,0
1668427313340,CSE 291,F00,116479,Pasquale; Joseph,0,0,0,0
1668427313822,CSE 293,001,119111,Bafna; Vineet,9999,0,9999,0
1668427313822,CSE 293,002,119118,Bellare; Mihir,9999,0,9999,0
1668427313822,CSE 293,003,119122,Berg-Kirkpatrick; Taylor D,9999,0,9999,0
1668427313822,CSE 293,004,119135,Christensen; Henrik I,9999,0,9999,0
1668427313822,CSE 293,005,119142,Cottrell; Garrison W,9999,0,9999,0
1668427313822,CSE 293,006,119146,Deutsch; Alin Bernard,9999,0,9999,0
1668427313822,CSE 293,007,119159,Esmaeilzadeh; Hadi,9999,0,9999,0
1668427313822,CSE 293,008,119166,Freund; Yoav,9999,0,9999,0
1668427313822,CSE 293,009,119170,Griswold; William G.,9999,0,9999,0
1668427313822,CSE 293,010,119183,Gymrek; Melissa Ann,9999,0,9999,0
1668427313822,CSE 293,011,119190,Heninger; Nadia A,9999,0,9999,0
1668427313822,CSE 293,012,119230,Impagliazzo; Russell,9999,0,9999,0
1668427313822,CSE 293,013,119232,Jhala; Ranjit,9999,0,9999,0
1668427313822,CSE 293,014,119233,Kahng; Andrew Byun,9999,0,9999,0
1668427313822,CSE 293,015,119298,Kane; Daniel Mertz,9999,0,9999,0
1668427313822,CSE 293,016,119299,Kriegman; David J,9999,0,9999,0
1668427313822,CSE 293,017,119300,Kumar; Arun Kumar,9999,0,9999,0
1668427313822,CSE 293,018,119301,Lerner; Sorin,9999,0,9999,0
1668427313822,CSE 293,019,119302,Lovett; Shachar,9999,0,9999,0
1668427313822,CSE 293,020,119303,McAuley; Julian John,9999,0,9999,0
1668427313822,CSE 293,021,119304,Micciancio; Daniele,9999,0,9999,0
1668427313822,CSE 293,022,119367,Orailoglu; Alex,9999,0,9999,0
1668427313822,CSE 293,023,119382,Paturi; Ramamohan,9999,0,9999,0
1668427313822,CSE 293,024,119404,Polikarpova; Nadezhda,9999,0,9999,0
1668427313822,CSE 293,025,119406,Politz; Joseph Gibbs,9999,0,9999,0
1668427313822,CSE 293,026,119411,Porter; George M,9999,0,9999,0
1668427313822,CSE 293,027,119414,Porter; Leonard Emerson,9999,0,9999,0
1668427313822,CSE 293,028,119416,Ramamoorthi; Ravi,9999,0,9999,0
1668427313822,CSE 293,029,119417,Sahoo; Debashis,9999,0,9999,0
1668427313822,CSE 293,030,119420,Saul; Lawrence,9999,0,9999,0
1668427313822,CSE 293,031,119421,Savage; Stefan,9999,0,9999,0
1668427313822,CSE 293,032,119425,Schulze; Jurgen P.,9999,0,9999,0
1668427313822,CSE 293,033,119426,Snoeren; Alex C.,9999,0,9999,0
1668427313822,CSE 293,034,119428,Shang; Jingbo,9999,0,9999,0
1668427313822,CSE 293,035,119430,Stefan; Deian,9999,0,9999,0
1668427313822,CSE 293,036,119431,Su; Hao,9999,0,9999,0
1668427313822,CSE 293,037,119433,Swanson; Steven James,9999,0,9999,0
1668427313822,CSE 293,038,119435,Tullsen; Dean Michael,9999,0,9999,0
1668427313822,CSE 293,039,119483,Voelker; Geoffrey M.,9999,0,9999,0
1668427313822,CSE 293,040,119537,Zhao; Jishen,9999,0,9999,0
1668427313822,CSE 293,041,119538,Zhou; Yuan-Yuan,9999,0,9999,0
1668427313822,CSE 293,042,119539,Gao; Sicun,9999,0,9999,0
1668427313822,CSE 293,043,119540,Weibel; Nadir,9999,0,9999,0
1668427313822,CSE 293,044,119541,Gupta; Rajesh K.,9999,0,9999,0
1668427313822,CSE 293,045,126410,Vaccaro; Kristen Marie,9999,0,9999,0
1668427313822,CSE 293,046,126411,Klemke; Richard,9999,0,9999,0
1668427314247,CSE 294,A00,102459,Voelker; Geoffrey M.,0,1,0,0
1668427314247,CSE 294,B00,111322,Orailoglu; Alex,0,0,0,0
1668427314679,DSE 201,A00,096914,Deutsch; Alin Bernard,30,0,30,0
1668427315102,DSE 210,A00,096915,Dasgupta; Sanjoy,30,0,30,0
1668427315530,DSE 260A,A00,096916,Altintas De Callaf; Ilkay,30,0,30,0
1668427316017,ECE 200,001,103586,Antipa; Nicholas A,9999,0,9999,0
1668427316017,ECE 200,002,103587,Atanasov; Nikolay A.,9999,0,9999,0
1668427316017,ECE 200,003,103588,Bharadia; Dinesh,9999,0,9999,0
1668427316017,ECE 200,004,103589,Cheng; Chung Kuan,9999,0,9999,0
1668427316017,ECE 200,005,103590,Cosman; Pamela C.,9999,0,9999,0
1668427316017,ECE 200,006,103591,Dayeh; Shadi Ahmad,9999,0,9999,0
1668427316017,ECE 200,007,103592,Fainman; Yeshaiahu,9999,0,9999,0
1668427316017,ECE 200,008,103593,Ford; Joseph Earl,9999,0,9999,0
1668427316017,ECE 200,009,103594,Franceschetti; Massimo,9999,0,9999,0
1668427316017,ECE 200,010,103595,Fullerton; Eric E,9999,0,9999,0
1668427316017,ECE 200,011,103596,Galton; Ian A,9999,0,9999,0
1668427316017,ECE 200,012,103597,Gilja; Vikash,9999,0,9999,0
1668427316017,ECE 200,013,103598,Hall; Drew A.,9999,0,9999,0
1668427316017,ECE 200,014,103599,Hsueh; Tzu-Chien,9999,0,9999,0
1668427316017,ECE 200,015,103600,Javidi; Tara,9999,0,9999,0
1668427316017,ECE 200,016,103601,Kahng; Andrew Byun,9999,0,9999,0
1668427316017,ECE 200,017,103602,Kim; Young-Han,9999,0,9999,0
1668427316017,ECE 200,018,103603,Koushanfar; Farinaz,9999,0,9999,0
1668427316017,ECE 200,019,103604,Kuzum; Duygu,9999,0,9999,0
1668427316017,ECE 200,020,103605,Le; Hanh-Phuc,9999,0,9999,0
1668427316017,ECE 200,021,103606,Lin; Bill,9999,0,9999,0
1668427316017,ECE 200,022,103607,Liu; Zhaowei,9998,0,9999,1
1668427316017,ECE 200,023,103608,Lo; Yu-Hwa,9999,0,9999,0
1668427316017,ECE 200,024,103609,Lomakin; Vitaliy,9999,0,9999,0
1668427316017,ECE 200,025,103610,Mercier; Patrick Philip,9999,0,9999,0
1668427316017,ECE 200,026,103611,Meyer; Florian,9999,0,9999,0
1668427316017,ECE 200,027,103612,Milstein; Laurence B.,9999,0,9999,0
1668427316017,ECE 200,028,103613,Mir Arabbaygi; Siavash,9999,0,9999,0
1668427316017,ECE 200,029,103614,Mookherjea; Shayan,9999,0,9999,0
1668427316017,ECE 200,030,103615,Morris; Karcher William,9999,0,9999,0
1668427316017,ECE 200,031,103616,Ng; Tse Nga,9999,0,9999,0
1668427316017,ECE 200,032,103617,Nguyen; Truong Quang,9999,0,9999,0
1668427316017,ECE 200,033,103618,Nomura; Kenji,9999,0,9999,0
1668427316017,ECE 200,034,103619,Orlitsky; Alon,9999,0,9999,0
1668427316017,ECE 200,035,103620,Pal; Piya,9999,0,9999,0
1668427316017,ECE 200,036,103621,Papen; George C.,9999,0,9999,0
1668427316017,ECE 200,037,103622,Radic; Stojan,9999,0,9999,0
1668427316017,ECE 200,038,103623,Rao; Bhaskar D.,9999,0,9999,0
1668427316017,ECE 200,039,103624,Rao; Ramesh R,9999,0,9999,0
1668427316017,ECE 200,040,103625,Rebeiz; Gabriel,9999,0,9999,0
1668427316017,ECE 200,041,103626,Sanford; John R,9999,0,9999,0
1668427316017,ECE 200,042,103627,Siegel; Paul H.,9999,0,9999,0
1668427316017,ECE 200,043,103628,Sievenpiper; Daniel F.,9999,0,9999,0
1668427316017,ECE 200,044,103629,Sworder; David D.,9999,0,9999,0
1668427316017,ECE 200,045,103630,Taur; Yuan,9999,0,9999,0
1668427316017,ECE 200,046,103631,Touri; Behrouz,9999,0,9999,0
1668427316017,ECE 200,047,103632,Trivedi; Mohan M.,9999,0,9999,0
1668427316017,ECE 200,048,103633,Vasconcelos; Nuno,9999,0,9999,0
1668427316017,ECE 200,049,103634,Wang; Xiaolong,9999,0,9999,0
1668427316017,ECE 200,050,103635,Xie; Pengtao,9999,0,9999,0
1668427316017,ECE 200,051,103636,Yip; Michael,9999,0,9999,0
1668427316017,ECE 200,052,103637,Zeger; Kenneth A.,999,0,999,0
1668427316017,ECE 200,053,103638,Zhang; Xinyu,9999,0,9999,0
1668427316017,ECE 200,054,103639,Turakhia; Yatish Girish,9999,0,9999,0
1668427316017,ECE 200,055,103640,Kang; Mingu,9999,0,9999,0
1668427316017,ECE 200,056,103641,Shi; Yuanyuan,9999,0,9999,0
1668427316017,ECE 200,057,103642,Wang; Edward Jay,9999,0,9999,0
1668427316017,ECE 200,058,103643,Zheng; Yang,9999,0,9999,0
1668427316447,ECE 202,A00,103644,Kuzum; Duygu,0,21,0,0
1668427316873,ECE 212BN,A00,103646,Ng; Tse Nga,0,1,0,0
1668427317300,ECE 221,A00,111493,Staff,0,0,0,0
1668427317739,ECE 222B,A00,103647,Lomakin; Vitaliy,0,5,0,0
1668427318163,ECE 230B,A00,103648,Taur; Yuan,0,0,0,0
1668427318588,ECE 238B,A00,103649,Garay; Javier,0,0,0,0
1668427319020,ECE 240B,A00,112900,Fainman; Yeshaiahu,0,4,0,0
1668427319462,ECE 247A,A00,103650,Jokerst; Jesse Vincent,0,1,0,0
1668427319902,ECE 247B,A00,103651,Wang; Joseph,0,4,0,0
1668427320327,ECE 250,A00,103652,Siegel; Paul H.,0,42,0,0
1668427320751,ECE 251A,A00,103654,Rao; Bhaskar D.,0,28,0,0
1668427321178,ECE 257B,A00,103655,Bharadia; Dinesh,0,12,0,0
1668427321600,ECE 258A,A00,103656,Milstein; Laurence B.,0,10,0,0
1668427322026,ECE 260B,A00,103658,Kang; Mingu,0,64,0,0
1668427322450,ECE 264A,A00,103659,Galton; Ian A,0,31,0,0
1668427322893,ECE 265A,A00,103661,Gudem; Prasad S.S.,0,16,0,0
1668427323319,ECE 265D,A00,103662,Gudem; Prasad S.S.,0,11,0,0
1668427323757,ECE 268,A00,103663,Koushanfar; Farinaz,0,18,0,0
1668427324207,ECE 269,A01,103665,Pal; Piya,0,125,0,0
1668427324646,ECE 271B,A00,103666,Vasconcelos; Manuela,0,46,0,0
1668427325069,ECE 276A,A00,103667,Atanasov; Nikolay A.,0,66,0,0
1668427325501,ECE 277,A00,103668,An; Cheolhong,0,87,0,0
1668427325923,ECE 279,A00,117947,Hall; Drew A.,0,12,0,0
1668427326804,ECE 283,A00,103670,Hsueh; Tzu-Chien,0,22,0,0
1668427327238,ECE 284,A00,103671,Turakhia; Yatish Girish,0,22,0,0
1668427327660,ECE 285,A00,103672,Zheng; Yang,0,22,0,0
1668427327660,ECE 285,B00,103673,Sworder; David D.,0,36,0,0
1668427328086,ECE 287,A00,103676,Javidi; Tara,0,4,0,0
1668427328526,MATH 200B,A00,098023,Salehi Golsefidy; Alireza,12,0,15,3
1668427328950,MATH 202B,A00,098024,Rhoades; Brendon Patrick,9,0,15,6
1668427329384,MATH 203B,A00,098025,Oprea; Dragos N.,10,0,15,5
1668427329816,MATH 204B,A00,098026,Sorensen; Claus M,13,0,15,2
1668427330252,MATH 208,A00,098027,Izadi; Elham,7,0,10,3
1668427330687,MATH 209,A00,098028,Pollack; Aaron,10,0,10,0
1668427331110,MATH 211A,A00,112919,Rogalski; Daniel,9,0,10,1
1668427331553,MATH 211B,A00,112920,Seward; Brandon M.,9,0,10,1
1668427331978,MATH 218,A00,098029,Li; Bo,10,0,10,0
1668427332405,MATH 220B,A00,098030,Novak; Jonathan I,11,0,15,4
1668427332832,MATH 221A,A00,098031,Ebenfelt; Peter F,13,0,15,2
1668427333270,MATH 231B,A00,098032,Zlatos; Andrej,12,0,15,3
1668427333727,MATH 240B,A00,098033,Ni; Lei,9,0,15,6
1668427334174,MATH 243,A00,098034,Jekel; David Andrew,10,0,10,0
1668427334622,MATH 245A,A00,098035,Nie; Jiawang,0,1,15,16
1668427335047,MATH 248,A00,098036,Bejenaru; Ioan,10,0,10,0
1668427335482,MATH 250B,A00,098037,Spolaor; Luca,14,0,15,1
1668427335945,MATH 258,A00,098038,Ni; Lei,10,0,10,0
1668427336379,MATH 264B,A00,098041,Rhoades; Brendon Patrick,9,0,15,6
1668427336814,MATH 268,A00,098042,Buss; Samuel R,10,0,10,0
1668427337238,MATH 269,A00,098043,Rhoades; Brendon Patrick,10,0,10,0
1668427337661,MATH 270B,A00,098044,Li; Bo,10,0,15,5
1668427338097,MATH 272B,A00,098045,Holst; Michael J,13,0,15,2
1668427338529,MATH 273A,A00,098046,Tian; Xiaochuan,10,0,15,5
1668427338957,MATH 275,A01,098048,Tian; Xiaochuan,6,0,10,4
1668427339384,MATH 278A,A00,098049,Holst; Michael J,8,0,10,2
1668427339809,MATH 278B,A00,098050,Cloninger; Alexander,10,0,10,0
1668427340260,MATH 278C,A00,098051,Nie; Jiawang,6,0,10,4
1668427340689,MATH 280B,A00,098052,Zheng; Tianyi,8,0,15,7
1668427341128,MATH 281B,A00,098053,Bradic; Jelena,0,1,15,15
1668427341557,MATH 282B,A00,098054,Arias-Castro; Ery,0,0,15,15
1668427341992,MATH 285,A00,098055,Fitzsimmons; Patrick J,0,0,15,17
1668427342435,MATH 287B,A00,098056,Arias-Castro; Ery,2,0,15,13
1668427342886,MATH 288,A00,098057,Agarwal; Pooja,9,0,10,1
1668427342886,MATH 288,B00,098058,Zhang; Danna,8,0,10,2
1668427342886,MATH 288,C00,098059,Williams; Ruth J,9,0,10,1
1668427343318,MATH 290B,A00,098060,Roberts; Justin Deritter,13,0,15,2
1668427343742,MATH 292,A00,098061,Belmont; Eva Kinoshita,10,0,10,0
1668427344178,MATH 295,A00,098062,Suk; Andrew Hoon,48,0,50,2
1668427344615,MATH 296,A00,098063,Novak; Jonathan I,20,0,20,0
1668427345045,MATH 297,001,098064,Gamst; Anthony Collins,9997,0,9999,2
1668427854803,COGS 205,A00,101395,Chiba; Andrea,19,0,20,1
1668427855253,COGS 210B,001,101404,Greene; Deanna Jacquelyn,9998,0,9999,1
1668427855253,COGS 210B,002,101417,Xia; Haijun,9999,0,9999,0
1668427855253,COGS 210B,003,101422,Nitz; Douglas A.,9999,0,9999,0
1668427855253,COGS 210B,004,101423,Hollan; James D.,9998,0,9999,1
1668427855253,COGS 210B,005,101424,Deak; Gedeon O.,9998,0,9999,1
1668427855253,COGS 210B,006,101425,Rossano; Federico,9999,0,9999,0
1668427855679,COGS 211B,A00,101427,Coulson; Seana M,9996,0,9999,3
1668427856111,COGS 220,A00,101428,Hollan; James D.,1,2,25,24
1668427856546,COGS 229,A00,101429,Dow; Steven P,18,0,25,7
1668427856970,COGS 230,A00,101430,Klemmer; Scott R,11,0,17,6
1668427857395,COGS 234,A00,101431,Xia; Haijun,2,0,25,23
1668427857822,COGS 260,A00,101432,Kiyonaga; Anastasia,21,0,25,4
1668427857822,COGS 260,B00,101433,Kirsh; David Joel,15,0,25,10
1668427858255,CSE 202,A00,102371,Impagliazzo; Russell,0,31,0,0
1668427858687,CSE 203B,A01,102373,Cheng; Chung Kuan,0,25,0,0
1668427859112,CSE 208,A00,102374,Micciancio; Daniele,0,1,0,0
1668427859536,CSE 209A,A00,112895,Impagliazzo; Russell,0,3,15,15
1668427859963,CSE 209B,A00,108005,Bellare; Mihir,0,3,0,0
1668427860388,CSE 210,A00,113163,Coblenz; Michael J,0,41,0,0
1668427860813,CSE 219,A00,106111,Dow; Steven P,0,0,20,20
1668427861253,CSE 221,A00,102376,Voelker; Geoffrey M.,0,29,0,0
1668427861693,CSE 224,A01,102378,Porter; George M,0,102,0,0
1668427862122,CSE 229A,A00,102379,Savage; Stefan,0,4,0,0
1668427862550,CSE 229C,A00,102380,Munyaka; Imani N. S.,0,4,0,0
1668427862977,CSE 232B,A00,102382,Deutsch; Alin Bernard,0,13,0,0
1668427863406,CSE 234,A01,112904,Kumar; Arun Kumar,0,0,0,0
1668427863842,CSE 237A,A00,102383,Rosing; Tajana Simunic,0,25,0,0
1668427864290,CSE 239A,A00,102384,Deutsch; Alin Bernard,0,5,0,0
1668427864730,CSE 239B,A00,102385,Polikarpova; Nadezhda,0,3,0,0
1668427865155,CSE 240A,A00,102386,Pannuto; Patrick William,0,24,0,0
1668427865579,CSE 240B,A00,102387,Zhao; Jishen,0,23,0,0
1668427866003,CSE 241A,A00,106406,Kang; Mingu,0,2,0,0
1668427866430,CSE 249B,A00,102388,Kahng; Andrew Byun,0,1,8,8
1668427866872,CSE 251B,A01,102392,Cottrell; Garrison W,0,22,0,0
1668427866872,CSE 251B,A02,102393,Cottrell; Garrison W,0,21,0,0
1668427867308,CSE 252B,A00,102394,Ochoa; Benjamin Lawrence,0,36,0,0
1668427867746,CSE 257,A01,102396,Gao; Sicun,0,86,0,0
1668427868174,CSE 272,A00,102397,Li; Tzumao,0,7,0,0
1668427868628,CSE 274,A00,111323,Chern; Albert Ren-Haur,0,7,0,0
1668427869053,CSE 282,A00,102398,Pevzner; Pavel Arkadjevich,0,0,0,0
1668427869480,CSE 284,A00,114175,Gymrek; Melissa Ann,0,9,0,0
1668427869929,CSE 290,A00,102399,Chandraker; Manmohan Krishna,0,4,0,0
1668427869929,CSE 290,B00,102400,Vaccaro; Kristen Marie,0,1,25,25
1668427869929,CSE 290,C00,102414,Pannuto; Patrick William,0,1,25,25
1668427869929,CSE 290,D00,102427,Pevzner; Pavel Arkadjevich,0,0,0,0
1668427869929,CSE 290,E00,102429,Zhao; Jishen,0,1,0,0
1668427869929,CSE 290,F00,102436,Tullsen; Dean Michael,0,2,0,0
1668427869929,CSE 290,G00,102440,Christensen; Henrik I,0,3,20,20
1668427870374,CSE 291,A00,102443,Su; Hao,0,0,0,0
1668427870374,CSE 291,B00,102448,Polikarpova; Nadezhda,0,0,0,0
1668427870374,CSE 291,C00,102453,Vaccaro; Kristen Marie,0,0,0,0
1668427870374,CSE 291,D00,111343,Savage; Stefan,0,0,0,0
1668427870374,CSE 291,E00,116474,Claffy; Kimberly Claire,0,0,0,0
1668427870374,CSE 291,F00,116479,Pasquale; Joseph,0,0,0,0
1668427870851,CSE 293,001,119111,Bafna; Vineet,9999,0,9999,0
1668427870851,CSE 293,002,119118,Bellare; Mihir,9999,0,9999,0
1668427870851,CSE 293,003,119122,Berg-Kirkpatrick; Taylor D,9999,0,9999,0
1668427870851,CSE 293,004,119135,Christensen; Henrik I,9999,0,9999,0
1668427870851,CSE 293,005,119142,Cottrell; Garrison W,9999,0,9999,0
1668427870851,CSE 293,006,119146,Deutsch; Alin Bernard,9999,0,9999,0
1668427870851,CSE 293,007,119159,Esmaeilzadeh; Hadi,9999,0,9999,0
1668427870851,CSE 293,008,119166,Freund; Yoav,9999,0,9999,0
1668427870851,CSE 293,009,119170,Griswold; William G.,9999,0,9999,0
1668427870851,CSE 293,010,119183,Gymrek; Melissa Ann,9999,0,9999,0
1668427870851,CSE 293,011,119190,Heninger; Nadia A,9999,0,9999,0
1668427870851,CSE 293,012,119230,Impagliazzo; Russell,9999,0,9999,0
1668427870851,CSE 293,013,119232,Jhala; Ranjit,9999,0,9999,0
1668427870851,CSE 293,014,119233,Kahng; Andrew Byun,9999,0,9999,0
1668427870851,CSE 293,015,119298,Kane; Daniel Mertz,9999,0,9999,0
1668427870851,CSE 293,016,119299,Kriegman; David J,9999,0,9999,0
1668427870851,CSE 293,017,119300,Kumar; Arun Kumar,9999,0,9999,0
1668427870851,CSE 293,018,119301,Lerner; Sorin,9999,0,9999,0
1668427870851,CSE 293,019,119302,Lovett; Shachar,9999,0,9999,0
1668427870851,CSE 293,020,119303,McAuley; Julian John,9999,0,9999,0
1668427870851,CSE 293,021,119304,Micciancio; Daniele,9999,0,9999,0
1668427870851,CSE 293,022,119367,Orailoglu; Alex,9999,0,9999,0
1668427870851,CSE 293,023,119382,Paturi; Ramamohan,9999,0,9999,0
1668427870851,CSE 293,024,119404,Polikarpova; Nadezhda,9999,0,9999,0
1668427870851,CSE 293,025,119406,Politz; Joseph Gibbs,9999,0,9999,0
1668427870851,CSE 293,026,119411,Porter; George M,9999,0,9999,0
1668427870851,CSE 293,027,119414,Porter; Leonard Emerson,9999,0,9999,0
1668427870851,CSE 293,028,119416,Ramamoorthi; Ravi,9999,0,9999,0
1668427870851,CSE 293,029,119417,Sahoo; Debashis,9999,0,9999,0
1668427870851,CSE 293,030,119420,Saul; Lawrence,9999,0,9999,0
1668427870851,CSE 293,031,119421,Savage; Stefan,9999,0,9999,0
1668427870851,CSE 293,032,119425,Schulze; Jurgen P.,9999,0,9999,0
1668427870851,CSE 293,033,119426,Snoeren; Alex C.,9999,0,9999,0
1668427870851,CSE 293,034,119428,Shang; Jingbo,9999,0,9999,0
1668427870851,CSE 293,035,119430,Stefan; Deian,9999,0,9999,0
1668427870851,CSE 293,036,119431,Su; Hao,9999,0,9999,0
1668427870851,CSE 293,037,119433,Swanson; Steven James,9999,0,9999,0
1668427870851,CSE 293,038,119435,Tullsen; Dean Michael,9999,0,9999,0
1668427870851,CSE 293,039,119483,Voelker; Geoffrey M.,9999,0,9999,0
1668427870851,CSE 293,040,119537,Zhao; Jishen,9999,0,9999,0
1668427870851,CSE 293,041,119538,Zhou; Yuan-Yuan,9999,0,9999,0
1668427870851,CSE 293,042,119539,Gao; Sicun,9999,0,9999,0
1668427870851,CSE 293,043,119540,Weibel; Nadir,9999,0,9999,0
1668427870851,CSE 293,044,119541,Gupta; Rajesh K.,9999,0,9999,0
1668427870851,CSE 293,045,126410,Vaccaro; Kristen Marie,9999,0,9999,0
1668427870851,CSE 293,046,126411,Klemke; Richard,9999,0,9999,0
1668427871278,CSE 294,A00,102459,Voelker; Geoffrey M.,0,1,0,0
1668427871278,CSE 294,B00,111322,Orailoglu; Alex,0,0,0,0
1668427871703,DSE 201,A00,096914,Deutsch; Alin Bernard,30,0,30,0
1668427872143,DSE 210,A00,096915,Dasgupta; Sanjoy,30,0,30,0
1668427872596,DSE 260A,A00,096916,Altintas De Callaf; Ilkay,30,0,30,0
1668427873098,ECE 200,001,103586,Antipa; Nicholas A,9999,0,9999,0
1668427873098,ECE 200,002,103587,Atanasov; Nikolay A.,9999,0,9999,0
1668427873098,ECE 200,003,103588,Bharadia; Dinesh,9999,0,9999,0
1668427873098,ECE 200,004,103589,Cheng; Chung Kuan,9999,0,9999,0
1668427873098,ECE 200,005,103590,Cosman; Pamela C.,9999,0,9999,0
1668427873098,ECE 200,006,103591,Dayeh; Shadi Ahmad,9999,0,9999,0
1668427873098,ECE 200,007,103592,Fainman; Yeshaiahu,9999,0,9999,0
1668427873098,ECE 200,008,103593,Ford; Joseph Earl,9999,0,9999,0
1668427873098,ECE 200,009,103594,Franceschetti; Massimo,9999,0,9999,0
1668427873098,ECE 200,010,103595,Fullerton; Eric E,9999,0,9999,0
1668427873098,ECE 200,011,103596,Galton; Ian A,9999,0,9999,0
1668427873098,ECE 200,012,103597,Gilja; Vikash,9999,0,9999,0
1668427873098,ECE 200,013,103598,Hall; Drew A.,9999,0,9999,0
1668427873098,ECE 200,014,103599,Hsueh; Tzu-Chien,9999,0,9999,0
1668427873098,ECE 200,015,103600,Javidi; Tara,9999,0,9999,0
1668427873098,ECE 200,016,103601,Kahng; Andrew Byun,9999,0,9999,0
1668427873098,ECE 200,017,103602,Kim; Young-Han,9999,0,9999,0
1668427873098,ECE 200,018,103603,Koushanfar; Farinaz,9999,0,9999,0
1668427873098,ECE 200,019,103604,Kuzum; Duygu,9999,0,9999,0
1668427873098,ECE 200,020,103605,Le; Hanh-Phuc,9999,0,9999,0
1668427873098,ECE 200,021,103606,Lin; Bill,9999,0,9999,0
1668427873098,ECE 200,022,103607,Liu; Zhaowei,9998,0,9999,1
1668427873098,ECE 200,023,103608,Lo; Yu-Hwa,9999,0,9999,0
1668427873098,ECE 200,024,103609,Lomakin; Vitaliy,9999,0,9999,0
1668427873098,ECE 200,025,103610,Mercier; Patrick Philip,9999,0,9999,0
1668427873098,ECE 200,026,103611,Meyer; Florian,9999,0,9999,0
1668427873098,ECE 200,027,103612,Milstein; Laurence B.,9999,0,9999,0
1668427873098,ECE 200,028,103613,Mir Arabbaygi; Siavash,9999,0,9999,0
1668427873098,ECE 200,029,103614,Mookherjea; Shayan,9999,0,9999,0
1668427873098,ECE 200,030,103615,Morris; Karcher William,9999,0,9999,0
1668427873098,ECE 200,031,103616,Ng; Tse Nga,9999,0,9999,0
1668427873098,ECE 200,032,103617,Nguyen; Truong Quang,9999,0,9999,0
1668427873098,ECE 200,033,103618,Nomura; Kenji,9999,0,9999,0
1668427873098,ECE 200,034,103619,Orlitsky; Alon,9999,0,9999,0
1668427873098,ECE 200,035,103620,Pal; Piya,9999,0,9999,0
1668427873098,ECE 200,036,103621,Papen; George C.,9999,0,9999,0
1668427873098,ECE 200,037,103622,Radic; Stojan,9999,0,9999,0
1668427873098,ECE 200,038,103623,Rao; Bhaskar D.,9999,0,9999,0
1668427873098,ECE 200,039,103624,Rao; Ramesh R,9999,0,9999,0
1668427873098,ECE 200,040,103625,Rebeiz; Gabriel,9999,0,9999,0
1668427873098,ECE 200,041,103626,Sanford; John R,9999,0,9999,0
1668427873098,ECE 200,042,103627,Siegel; Paul H.,9999,0,9999,0
1668427873098,ECE 200,043,103628,Sievenpiper; Daniel F.,9999,0,9999,0
1668427873098,ECE 200,044,103629,Sworder; David D.,9999,0,9999,0
1668427873098,ECE 200,045,103630,Taur; Yuan,9999,0,9999,0
1668427873098,ECE 200,046,103631,Touri; Behrouz,9999,0,9999,0
1668427873098,ECE 200,047,103632,Trivedi; Mohan M.,9999,0,9999,0
1668427873098,ECE 200,048,103633,Vasconcelos; Nuno,9999,0,9999,0
1668427873098,ECE 200,049,103634,Wang; Xiaolong,9999,0,9999,0
1668427873098,ECE 200,050,103635,Xie; Pengtao,9999,0,9999,0
1668427873098,ECE 200,051,103636,Yip; Michael,9999,0,9999,0
1668427873098,ECE 200,052,103637,Zeger; Kenneth A.,999,0,999,0
1668427873098,ECE 200,053,103638,Zhang; Xinyu,9999,0,9999,0
1668427873098,ECE 200,054,103639,Turakhia; Yatish Girish,9999,0,9999,0
1668427873098,ECE 200,055,103640,Kang; Mingu,9999,0,9999,0
1668427873098,ECE 200,056,103641,Shi; Yuanyuan,9999,0,9999,0
1668427873098,ECE 200,057,103642,Wang; Edward Jay,9999,0,9999,0
1668427873098,ECE 200,058,103643,Zheng; Yang,9999,0,9999,0
1668427873537,ECE 202,A00,103644,Kuzum; Duygu,0,21,0,0
1668427873961,ECE 212BN,A00,103646,Ng; Tse Nga,0,1,0,0
1668427874388,ECE 221,A00,111493,Staff,0,0,0,0
1668427874811,ECE 222B,A00,103647,Lomakin; Vitaliy,0,5,0,0
1668427875249,ECE 230B,A00,103648,Taur; Yuan,0,0,0,0
1668427875673,ECE 238B,A00,103649,Garay; Javier,0,0,0,0
1668427876100,ECE 240B,A00,112900,Fainman; Yeshaiahu,0,4,0,0
1668427876525,ECE 247A,A00,103650,Jokerst; Jesse Vincent,0,1,0,0
1668427876959,ECE 247B,A00,103651,Wang; Joseph,0,4,0,0
1668427877398,ECE 250,A00,103652,Siegel; Paul H.,0,42,0,0
1668427877828,ECE 251A,A00,103654,Rao; Bhaskar D.,0,29,0,0
1668427878252,ECE 257B,A00,103655,Bharadia; Dinesh,0,12,0,0
1668427878680,ECE 258A,A00,103656,Milstein; Laurence B.,0,10,0,0
1668427879108,ECE 260B,A00,103658,Kang; Mingu,0,64,0,0
1668427879539,ECE 264A,A00,103659,Galton; Ian A,0,31,0,0
1668427879971,ECE 265A,A00,103661,Gudem; Prasad S.S.,0,16,0,0
1668427880403,ECE 265D,A00,103662,Gudem; Prasad S.S.,0,11,0,0
1668427880831,ECE 268,A00,103663,Koushanfar; Farinaz,0,18,0,0
1668427881260,ECE 269,A01,103665,Pal; Piya,0,126,0,0
1668427881707,ECE 271B,A00,103666,Vasconcelos; Manuela,0,46,0,0
1668427882139,ECE 276A,A00,103667,Atanasov; Nikolay A.,0,67,0,0
1668427882564,ECE 277,A00,103668,An; Cheolhong,0,87,0,0
1668427882995,ECE 279,A00,117947,Hall; Drew A.,0,12,0,0
1668427883887,ECE 283,A00,103670,Hsueh; Tzu-Chien,0,22,0,0
1668427884310,ECE 284,A00,103671,Turakhia; Yatish Girish,0,22,0,0
1668427884739,ECE 285,A00,103672,Zheng; Yang,0,22,0,0
1668427884739,ECE 285,B00,103673,Sworder; David D.,0,36,0,0
1668427885162,ECE 287,A00,103676,Javidi; Tara,0,4,0,0
1668427885595,MATH 200B,A00,098023,Salehi Golsefidy; Alireza,12,0,15,3
1668427886021,MATH 202B,A00,098024,Rhoades; Brendon Patrick,9,0,15,6
1668427886446,MATH 203B,A00,098025,Oprea; Dragos N.,10,0,15,5
1668427886892,MATH 204B,A00,098026,Sorensen; Claus M,13,0,15,2
1668427887427,MATH 208,A00,098027,Izadi; Elham,7,0,10,3
1668427887856,MATH 209,A00,098028,Pollack; Aaron,10,0,10,0
1668427888286,MATH 211A,A00,112919,Rogalski; Daniel,9,0,10,1
1668427888723,MATH 211B,A00,112920,Seward; Brandon M.,9,0,10,1
1668427889151,MATH 218,A00,098029,Li; Bo,10,0,10,0
1668427889579,MATH 220B,A00,098030,Novak; Jonathan I,11,0,15,4
1668427890015,MATH 221A,A00,098031,Ebenfelt; Peter F,13,0,15,2
1668427890454,MATH 231B,A00,098032,Zlatos; Andrej,12,0,15,3
1668427890898,MATH 240B,A00,098033,Ni; Lei,9,0,15,6
1668427891341,MATH 243,A00,098034,Jekel; David Andrew,10,0,10,0
1668427891769,MATH 245A,A00,098035,Nie; Jiawang,0,1,15,16
1668427892194,MATH 248,A00,098036,Bejenaru; Ioan,10,0,10,0
1668427892629,MATH 250B,A00,098037,Spolaor; Luca,14,0,15,1
1668427893065,MATH 258,A00,098038,Ni; Lei,10,0,10,0
1668427893490,MATH 264B,A00,098041,Rhoades; Brendon Patrick,9,0,15,6
1668427893931,MATH 268,A00,098042,Buss; Samuel R,10,0,10,0
1668427894362,MATH 269,A00,098043,Rhoades; Brendon Patrick,10,0,10,0
1668427894789,MATH 270B,A00,098044,Li; Bo,10,0,15,5
1668427895229,MATH 272B,A00,098045,Holst; Michael J,13,0,15,2
1668427895654,MATH 273A,A00,098046,Tian; Xiaochuan,10,0,15,5
1668427896079,MATH 275,A01,098048,Tian; Xiaochuan,6,0,10,4
1668427896513,MATH 278A,A00,098049,Holst; Michael J,8,0,10,2
1668427896944,MATH 278B,A00,098050,Cloninger; Alexander,10,0,10,0
1668427897369,MATH 278C,A00,098051,Nie; Jiawang,6,0,10,4
1668427897797,MATH 280B,A00,098052,Zheng; Tianyi,8,0,15,7
1668427898242,MATH 281B,A00,098053,Bradic; Jelena,0,1,15,15
1668427898670,MATH 282B,A00,098054,Arias-Castro; Ery,0,0,15,15
1668427899107,MATH 285,A00,098055,Fitzsimmons; Patrick J,0,0,15,17
1668427899541,MATH 287B,A00,098056,Arias-Castro; Ery,2,0,15,13
1668427899968,MATH 288,A00,098057,Agarwal; Pooja,9,0,10,1
1668427899968,MATH 288,B00,098058,Zhang; Danna,8,0,10,2
1668427899968,MATH 288,C00,098059,Williams; Ruth J,9,0,10,1
1668427900403,MATH 290B,A00,098060,Roberts; Justin Deritter,13,0,15,2
1668427900840,MATH 292,A00,098061,Belmont; Eva Kinoshita,10,0,10,0
1668427901278,MATH 295,A00,098062,Suk; Andrew Hoon,48,0,50,2
1668427901705,MATH 296,A00,098063,Novak; Jonathan I,20,0,20,0
1668427902133,MATH 297,001,098064,Gamst; Anthony Collins,9997,0,9999,2
