time,subj_course_id,sec_code,sec_id,prof,available,waitlist,total,enrolled_ct
1668429161247,COGS 205,A00,101395,Chiba; Andrea,19,0,20,1
1668429161676,COGS 210B,001,101404,Greene; Deanna Jacquelyn,9998,0,9999,1
1668429161676,COGS 210B,002,101417,Xia; Haijun,9999,0,9999,0
1668429161676,COGS 210B,003,101422,Nitz; Douglas A.,9999,0,9999,0
1668429161676,COGS 210B,004,101423,Hollan; James D.,9998,0,9999,1
1668429161676,COGS 210B,005,101424,Deak; Gedeon O.,9998,0,9999,1
1668429161676,COGS 210B,006,101425,Rossano; Federico,9999,0,9999,0
1668429162103,COGS 211B,A00,101427,Coulson; Seana M,9996,0,9999,3
1668429162544,COGS 220,A00,101428,Hollan; James D.,1,2,25,24
1668429162968,COGS 229,A00,101429,Dow; Steven P,18,0,25,7
1668429163409,COGS 230,A00,101430,Klemmer; Scott R,11,0,17,6
1668429163838,COGS 234,A00,101431,Xia; Haijun,2,0,25,23
1668429164273,COGS 260,A00,101432,Kiyonaga; Anastasia,21,0,25,4
1668429164273,COGS 260,B00,101433,Kirsh; David Joel,15,0,25,10
1668429164705,CSE 202,A00,102371,Impagliazzo; Russell,0,31,0,0
1668429165134,CSE 203B,A01,102373,Cheng; Chung Kuan,0,25,0,0
1668429165560,CSE 208,A00,102374,Micciancio; Daniele,0,1,0,0
1668429165990,CSE 209A,A00,112895,Impagliazzo; Russell,0,3,15,15
1668429166420,CSE 209B,A00,108005,Bellare; Mihir,0,3,0,0
1668429166848,CSE 210,A00,113163,Coblenz; Michael J,0,41,0,0
1668429167282,CSE 219,A00,106111,Dow; Steven P,0,0,20,20
1668429167714,CSE 221,A00,102376,Voelker; Geoffrey M.,0,29,0,0
1668429168142,CSE 224,A01,102378,Porter; George M,0,102,0,0
1668429168571,CSE 229A,A00,102379,Savage; Stefan,0,4,0,0
1668429169012,CSE 229C,A00,102380,Munyaka; Imani N. S.,0,4,0,0
1668429169437,CSE 232B,A00,102382,Deutsch; Alin Bernard,0,13,0,0
1668429169864,CSE 234,A01,112904,Kumar; Arun Kumar,0,0,0,0
1668429170291,CSE 237A,A00,102383,Rosing; Tajana Simunic,0,25,0,0
1668429170718,CSE 239A,A00,102384,Deutsch; Alin Bernard,0,5,0,0
1668429171160,CSE 239B,A00,102385,Polikarpova; Nadezhda,0,3,0,0
1668429171598,CSE 240A,A00,102386,Pannuto; Patrick William,0,24,0,0
1668429172025,CSE 240B,A00,102387,Zhao; Jishen,0,23,0,0
1668429172458,CSE 241A,A00,106406,Kang; Mingu,0,2,0,0
1668429172889,CSE 249B,A00,102388,Kahng; Andrew Byun,0,1,8,8
1668429173323,CSE 251B,A01,102392,Cottrell; Garrison W,0,22,0,0
1668429173323,CSE 251B,A02,102393,Cottrell; Garrison W,0,21,0,0
1668429173751,CSE 252B,A00,102394,Ochoa; Benjamin Lawrence,0,36,0,0
1668429174179,CSE 257,A01,102396,Gao; Sicun,0,86,0,0
1668429174607,CSE 272,A00,102397,Li; Tzumao,0,7,0,0
1668429175037,CSE 274,A00,111323,Chern; Albert Ren-Haur,0,7,0,0
1668429175475,CSE 282,A00,102398,Pevzner; Pavel Arkadjevich,0,0,0,0
1668429175917,CSE 284,A00,114175,Gymrek; Melissa Ann,0,10,0,0
1668429176352,CSE 290,A00,102399,Chandraker; Manmohan Krishna,0,4,0,0
1668429176352,CSE 290,B00,102400,Vaccaro; Kristen Marie,0,1,25,25
1668429176352,CSE 290,C00,102414,Pannuto; Patrick William,0,1,25,25
1668429176352,CSE 290,D00,102427,Pevzner; Pavel Arkadjevich,0,0,0,0
1668429176352,CSE 290,E00,102429,Zhao; Jishen,0,1,0,0
1668429176352,CSE 290,F00,102436,Tullsen; Dean Michael,0,2,0,0
1668429176352,CSE 290,G00,102440,Christensen; Henrik I,0,3,20,20
1668429176779,CSE 291,A00,102443,Su; Hao,0,0,0,0
1668429176779,CSE 291,B00,102448,Polikarpova; Nadezhda,0,0,0,0
1668429176779,CSE 291,C00,102453,Vaccaro; Kristen Marie,0,0,0,0
1668429176779,CSE 291,D00,111343,Savage; Stefan,0,0,0,0
1668429176779,CSE 291,E00,116474,Claffy; Kimberly Claire,0,0,0,0
1668429176779,CSE 291,F00,116479,Pasquale; Joseph,0,0,0,0
1668429177227,CSE 293,001,119111,Bafna; Vineet,9999,0,9999,0
1668429177227,CSE 293,002,119118,Bellare; Mihir,9999,0,9999,0
1668429177227,CSE 293,003,119122,Berg-Kirkpatrick; Taylor D,9999,0,9999,0
1668429177227,CSE 293,004,119135,Christensen; Henrik I,9999,0,9999,0
1668429177227,CSE 293,005,119142,Cottrell; Garrison W,9999,0,9999,0
1668429177227,CSE 293,006,119146,Deutsch; Alin Bernard,9999,0,9999,0
1668429177227,CSE 293,007,119159,Esmaeilzadeh; Hadi,9999,0,9999,0
1668429177227,CSE 293,008,119166,Freund; Yoav,9999,0,9999,0
1668429177227,CSE 293,009,119170,Griswold; William G.,9999,0,9999,0
1668429177227,CSE 293,010,119183,Gymrek; Melissa Ann,9999,0,9999,0
1668429177227,CSE 293,011,119190,Heninger; Nadia A,9999,0,9999,0
1668429177227,CSE 293,012,119230,Impagliazzo; Russell,9999,0,9999,0
1668429177227,CSE 293,013,119232,Jhala; Ranjit,9999,0,9999,0
1668429177227,CSE 293,014,119233,Kahng; Andrew Byun,9999,0,9999,0
1668429177227,CSE 293,015,119298,Kane; Daniel Mertz,9999,0,9999,0
1668429177227,CSE 293,016,119299,Kriegman; David J,9999,0,9999,0
1668429177227,CSE 293,017,119300,Kumar; Arun Kumar,9999,0,9999,0
1668429177227,CSE 293,018,119301,Lerner; Sorin,9999,0,9999,0
1668429177227,CSE 293,019,119302,Lovett; Shachar,9999,0,9999,0
1668429177227,CSE 293,020,119303,McAuley; Julian John,9999,0,9999,0
1668429177227,CSE 293,021,119304,Micciancio; Daniele,9999,0,9999,0
1668429177227,CSE 293,022,119367,Orailoglu; Alex,9999,0,9999,0
1668429177227,CSE 293,023,119382,Paturi; Ramamohan,9999,0,9999,0
1668429177227,CSE 293,024,119404,Polikarpova; Nadezhda,9999,0,9999,0
1668429177227,CSE 293,025,119406,Politz; Joseph Gibbs,9999,0,9999,0
1668429177227,CSE 293,026,119411,Porter; George M,9999,0,9999,0
1668429177227,CSE 293,027,119414,Porter; Leonard Emerson,9999,0,9999,0
1668429177227,CSE 293,028,119416,Ramamoorthi; Ravi,9999,0,9999,0
1668429177227,CSE 293,029,119417,Sahoo; Debashis,9999,0,9999,0
1668429177227,CSE 293,030,119420,Saul; Lawrence,9999,0,9999,0
1668429177227,CSE 293,031,119421,Savage; Stefan,9999,0,9999,0
1668429177227,CSE 293,032,119425,Schulze; Jurgen P.,9999,0,9999,0
1668429177227,CSE 293,033,119426,Snoeren; Alex C.,9999,0,9999,0
1668429177227,CSE 293,034,119428,Shang; Jingbo,9999,0,9999,0
1668429177227,CSE 293,035,119430,Stefan; Deian,9999,0,9999,0
1668429177227,CSE 293,036,119431,Su; Hao,9999,0,9999,0
1668429177227,CSE 293,037,119433,Swanson; Steven James,9999,0,9999,0
1668429177227,CSE 293,038,119435,Tullsen; Dean Michael,9999,0,9999,0
1668429177227,CSE 293,039,119483,Voelker; Geoffrey M.,9999,0,9999,0
1668429177227,CSE 293,040,119537,Zhao; Jishen,9999,0,9999,0
1668429177227,CSE 293,041,119538,Zhou; Yuan-Yuan,9999,0,9999,0
1668429177227,CSE 293,042,119539,Gao; Sicun,9999,0,9999,0
1668429177227,CSE 293,043,119540,Weibel; Nadir,9999,0,9999,0
1668429177227,CSE 293,044,119541,Gupta; Rajesh K.,9999,0,9999,0
1668429177227,CSE 293,045,126410,Vaccaro; Kristen Marie,9999,0,9999,0
1668429177227,CSE 293,046,126411,Klemke; Richard,9999,0,9999,0
1668429177650,CSE 294,A00,102459,Voelker; Geoffrey M.,0,1,0,0
1668429177650,CSE 294,B00,111322,Orailoglu; Alex,0,0,0,0
1668429178078,DSE 201,A00,096914,Deutsch; Alin Bernard,30,0,30,0
1668429178507,DSE 210,A00,096915,Dasgupta; Sanjoy,30,0,30,0
1668429178943,DSE 260A,A00,096916,Altintas De Callaf; Ilkay,30,0,30,0
1668429179405,ECE 200,001,103586,Antipa; Nicholas A,9999,0,9999,0
1668429179405,ECE 200,002,103587,Atanasov; Nikolay A.,9999,0,9999,0
1668429179405,ECE 200,003,103588,Bharadia; Dinesh,9999,0,9999,0
1668429179405,ECE 200,004,103589,Cheng; Chung Kuan,9999,0,9999,0
1668429179405,ECE 200,005,103590,Cosman; Pamela C.,9999,0,9999,0
1668429179405,ECE 200,006,103591,Dayeh; Shadi Ahmad,9999,0,9999,0
1668429179405,ECE 200,007,103592,Fainman; Yeshaiahu,9999,0,9999,0
1668429179405,ECE 200,008,103593,Ford; Joseph Earl,9999,0,9999,0
1668429179405,ECE 200,009,103594,Franceschetti; Massimo,9999,0,9999,0
1668429179405,ECE 200,010,103595,Fullerton; Eric E,9999,0,9999,0
1668429179405,ECE 200,011,103596,Galton; Ian A,9999,0,9999,0
1668429179405,ECE 200,012,103597,Gilja; Vikash,9999,0,9999,0
1668429179405,ECE 200,013,103598,Hall; Drew A.,9999,0,9999,0
1668429179405,ECE 200,014,103599,Hsueh; Tzu-Chien,9999,0,9999,0
1668429179405,ECE 200,015,103600,Javidi; Tara,9999,0,9999,0
1668429179405,ECE 200,016,103601,Kahng; Andrew Byun,9999,0,9999,0
1668429179405,ECE 200,017,103602,Kim; Young-Han,9999,0,9999,0
1668429179405,ECE 200,018,103603,Koushanfar; Farinaz,9999,0,9999,0
1668429179405,ECE 200,019,103604,Kuzum; Duygu,9999,0,9999,0
1668429179405,ECE 200,020,103605,Le; Hanh-Phuc,9999,0,9999,0
1668429179405,ECE 200,021,103606,Lin; Bill,9999,0,9999,0
1668429179405,ECE 200,022,103607,Liu; Zhaowei,9998,0,9999,1
1668429179405,ECE 200,023,103608,Lo; Yu-Hwa,9999,0,9999,0
1668429179405,ECE 200,024,103609,Lomakin; Vitaliy,9999,0,9999,0
1668429179405,ECE 200,025,103610,Mercier; Patrick Philip,9999,0,9999,0
1668429179405,ECE 200,026,103611,Meyer; Florian,9999,0,9999,0
1668429179405,ECE 200,027,103612,Milstein; Laurence B.,9999,0,9999,0
1668429179405,ECE 200,028,103613,Mir Arabbaygi; Siavash,9999,0,9999,0
1668429179405,ECE 200,029,103614,Mookherjea; Shayan,9999,0,9999,0
1668429179405,ECE 200,030,103615,Morris; Karcher William,9999,0,9999,0
1668429179405,ECE 200,031,103616,Ng; Tse Nga,9999,0,9999,0
1668429179405,ECE 200,032,103617,Nguyen; Truong Quang,9999,0,9999,0
1668429179405,ECE 200,033,103618,Nomura; Kenji,9999,0,9999,0
1668429179405,ECE 200,034,103619,Orlitsky; Alon,9999,0,9999,0
1668429179405,ECE 200,035,103620,Pal; Piya,9999,0,9999,0
1668429179405,ECE 200,036,103621,Papen; George C.,9999,0,9999,0
1668429179405,ECE 200,037,103622,Radic; Stojan,9999,0,9999,0
1668429179405,ECE 200,038,103623,Rao; Bhaskar D.,9999,0,9999,0
1668429179405,ECE 200,039,103624,Rao; Ramesh R,9999,0,9999,0
1668429179405,ECE 200,040,103625,Rebeiz; Gabriel,9999,0,9999,0
1668429179405,ECE 200,041,103626,Sanford; John R,9999,0,9999,0
1668429179405,ECE 200,042,103627,Siegel; Paul H.,9999,0,9999,0
1668429179405,ECE 200,043,103628,Sievenpiper; Daniel F.,9999,0,9999,0
1668429179405,ECE 200,044,103629,Sworder; David D.,9999,0,9999,0
1668429179405,ECE 200,045,103630,Taur; Yuan,9999,0,9999,0
1668429179405,ECE 200,046,103631,Touri; Behrouz,9999,0,9999,0
1668429179405,ECE 200,047,103632,Trivedi; Mohan M.,9999,0,9999,0
1668429179405,ECE 200,048,103633,Vasconcelos; Nuno,9999,0,9999,0
1668429179405,ECE 200,049,103634,Wang; Xiaolong,9999,0,9999,0
1668429179405,ECE 200,050,103635,Xie; Pengtao,9999,0,9999,0
1668429179405,ECE 200,051,103636,Yip; Michael,9999,0,9999,0
1668429179405,ECE 200,052,103637,Zeger; Kenneth A.,999,0,999,0
1668429179405,ECE 200,053,103638,Zhang; Xinyu,9999,0,9999,0
1668429179405,ECE 200,054,103639,Turakhia; Yatish Girish,9999,0,9999,0
1668429179405,ECE 200,055,103640,Kang; Mingu,9999,0,9999,0
1668429179405,ECE 200,056,103641,Shi; Yuanyuan,9999,0,9999,0
1668429179405,ECE 200,057,103642,Wang; Edward Jay,9999,0,9999,0
1668429179405,ECE 200,058,103643,Zheng; Yang,9999,0,9999,0
1668429179830,ECE 202,A00,103644,Kuzum; Duygu,0,21,0,0
1668429180266,ECE 212BN,A00,103646,Ng; Tse Nga,0,1,0,0
1668429180795,ECE 221,A00,111493,Staff,0,0,0,0
1668429181231,ECE 222B,A00,103647,Lomakin; Vitaliy,0,5,0,0
1668429181656,ECE 230B,A00,103648,Taur; Yuan,0,0,0,0
1668429182084,ECE 238B,A00,103649,Garay; Javier,0,0,0,0
1668429182511,ECE 240B,A00,112900,Fainman; Yeshaiahu,0,4,0,0
1668429182945,ECE 247A,A00,103650,Jokerst; Jesse Vincent,0,1,0,0
1668429183383,ECE 247B,A00,103651,Wang; Joseph,0,4,0,0
1668429183809,ECE 250,A00,103652,Siegel; Paul H.,0,42,0,0
1668429184263,ECE 251A,A00,103654,Rao; Bhaskar D.,0,29,0,0
1668429184690,ECE 257B,A00,103655,Bharadia; Dinesh,0,12,0,0
1668429185117,ECE 258A,A00,103656,Milstein; Laurence B.,0,10,0,0
1668429185549,ECE 260B,A00,103658,Kang; Mingu,0,64,0,0
1668429185972,ECE 264A,A00,103659,Galton; Ian A,0,32,0,0
1668429186406,ECE 265A,A00,103661,Gudem; Prasad S.S.,0,17,0,0
1668429186830,ECE 265D,A00,103662,Gudem; Prasad S.S.,0,11,0,0
1668429187262,ECE 268,A00,103663,Koushanfar; Farinaz,0,18,0,0
1668429187691,ECE 269,A01,103665,Pal; Piya,0,126,0,0
1668429188118,ECE 271B,A00,103666,Vasconcelos; Manuela,0,46,0,0
1668429188545,ECE 276A,A00,103667,Atanasov; Nikolay A.,0,67,0,0
1668429188972,ECE 277,A00,103668,An; Cheolhong,0,87,0,0
1668429189412,ECE 279,A00,117947,Hall; Drew A.,0,12,0,0
1668429190262,ECE 283,A00,103670,Hsueh; Tzu-Chien,0,23,0,0
1668429190689,ECE 284,A00,103671,Turakhia; Yatish Girish,0,22,0,0
1668429191116,ECE 285,A00,103672,Zheng; Yang,0,22,0,0
1668429191116,ECE 285,B00,103673,Sworder; David D.,0,36,0,0
1668429191542,ECE 287,A00,103676,Javidi; Tara,0,4,0,0
1668429191971,MATH 200B,A00,098023,Salehi Golsefidy; Alireza,12,0,15,3
1668429192404,MATH 202B,A00,098024,Rhoades; Brendon Patrick,9,0,15,6
1668429192850,MATH 203B,A00,098025,Oprea; Dragos N.,10,0,15,5
1668429193290,MATH 204B,A00,098026,Sorensen; Claus M,13,0,15,2
1668429193735,MATH 208,A00,098027,Izadi; Elham,7,0,10,3
1668429194190,MATH 209,A00,098028,Pollack; Aaron,10,0,10,0
1668429194619,MATH 211A,A00,112919,Rogalski; Daniel,9,0,10,1
1668429195066,MATH 211B,A00,112920,Seward; Brandon M.,9,0,10,1
1668429195507,MATH 218,A00,098029,Li; Bo,10,0,10,0
1668429195936,MATH 220B,A00,098030,Novak; Jonathan I,11,0,15,4
1668429196364,MATH 221A,A00,098031,Ebenfelt; Peter F,13,0,15,2
1668429196799,MATH 231B,A00,098032,Zlatos; Andrej,12,0,15,3
1668429197249,MATH 240B,A00,098033,Ni; Lei,9,0,15,6
1668429197676,MATH 243,A00,098034,Jekel; David Andrew,10,0,10,0
1668429198105,MATH 245A,A00,098035,Nie; Jiawang,0,1,15,16
1668429198530,MATH 248,A00,098036,Bejenaru; Ioan,10,0,10,0
1668429198958,MATH 250B,A00,098037,Spolaor; Luca,14,0,15,1
1668429199395,MATH 258,A00,098038,Ni; Lei,10,0,10,0
1668429199825,MATH 264B,A00,098041,Rhoades; Brendon Patrick,9,0,15,6
1668429200251,MATH 268,A00,098042,Buss; Samuel R,10,0,10,0
1668429200678,MATH 269,A00,098043,Rhoades; Brendon Patrick,10,0,10,0
1668429201103,MATH 270B,A00,098044,Li; Bo,10,0,15,5
1668429201545,MATH 272B,A00,098045,Holst; Michael J,13,0,15,2
1668429201979,MATH 273A,A00,098046,Tian; Xiaochuan,10,0,15,5
1668429202406,MATH 275,A01,098048,Tian; Xiaochuan,6,0,10,4
1668429202842,MATH 278A,A00,098049,Holst; Michael J,8,0,10,2
1668429203270,MATH 278B,A00,098050,Cloninger; Alexander,10,0,10,0
1668429203712,MATH 278C,A00,098051,Nie; Jiawang,6,0,10,4
1668429204154,MATH 280B,A00,098052,Zheng; Tianyi,8,0,15,7
1668429204589,MATH 281B,A00,098053,Bradic; Jelena,0,1,15,15
1668429205019,MATH 282B,A00,098054,Arias-Castro; Ery,0,0,15,15
1668429205450,MATH 285,A00,098055,Fitzsimmons; Patrick J,0,0,15,17
1668429205875,MATH 287B,A00,098056,Arias-Castro; Ery,2,0,15,13
1668429206329,MATH 288,A00,098057,Agarwal; Pooja,9,0,10,1
1668429206329,MATH 288,B00,098058,Zhang; Danna,8,0,10,2
1668429206329,MATH 288,C00,098059,Williams; Ruth J,9,0,10,1
1668429206783,MATH 290B,A00,098060,Roberts; Justin Deritter,13,0,15,2
1668429207217,MATH 292,A00,098061,Belmont; Eva Kinoshita,10,0,10,0
1668429207647,MATH 295,A00,098062,Suk; Andrew Hoon,48,0,50,2
1668429208078,MATH 296,A00,098063,Novak; Jonathan I,20,0,20,0
1668429208502,MATH 297,001,098064,Gamst; Anthony Collins,9997,0,9999,2
1668429715426,COGS 205,A00,101395,Chiba; Andrea,19,0,20,1
1668429715874,COGS 210B,001,101404,Greene; Deanna Jacquelyn,9998,0,9999,1
1668429715874,COGS 210B,002,101417,Xia; Haijun,9999,0,9999,0
1668429715874,COGS 210B,003,101422,Nitz; Douglas A.,9999,0,9999,0
1668429715874,COGS 210B,004,101423,Hollan; James D.,9998,0,9999,1
1668429715874,COGS 210B,005,101424,Deak; Gedeon O.,9998,0,9999,1
1668429715874,COGS 210B,006,101425,Rossano; Federico,9999,0,9999,0
1668429716317,COGS 211B,A00,101427,Coulson; Seana M,9996,0,9999,3
1668429716743,COGS 220,A00,101428,Hollan; James D.,1,2,25,24
1668429717177,COGS 229,A00,101429,Dow; Steven P,18,0,25,7
1668429717614,COGS 230,A00,101430,Klemmer; Scott R,11,0,17,6
1668429718037,COGS 234,A00,101431,Xia; Haijun,2,0,25,23
1668429718472,COGS 260,A00,101432,Kiyonaga; Anastasia,21,0,25,4
1668429718472,COGS 260,B00,101433,Kirsh; David Joel,15,0,25,10
1668429718902,CSE 202,A00,102371,Impagliazzo; Russell,0,31,0,0
1668429719333,CSE 203B,A01,102373,Cheng; Chung Kuan,0,25,0,0
1668429719758,CSE 208,A00,102374,Micciancio; Daniele,0,1,0,0
1668429720197,CSE 209A,A00,112895,Impagliazzo; Russell,0,3,15,15
1668429720633,CSE 209B,A00,108005,Bellare; Mihir,0,3,0,0
1668429721067,CSE 210,A00,113163,Coblenz; Michael J,0,41,0,0
1668429721493,CSE 219,A00,106111,Dow; Steven P,0,0,20,20
1668429721919,CSE 221,A00,102376,Voelker; Geoffrey M.,0,29,0,0
1668429722344,CSE 224,A01,102378,Porter; George M,0,102,0,0
1668429722771,CSE 229A,A00,102379,Savage; Stefan,0,4,0,0
1668429723198,CSE 229C,A00,102380,Munyaka; Imani N. S.,0,4,0,0
1668429723630,CSE 232B,A00,102382,Deutsch; Alin Bernard,0,13,0,0
1668429724056,CSE 234,A01,112904,Kumar; Arun Kumar,0,0,0,0
1668429724502,CSE 237A,A00,102383,Rosing; Tajana Simunic,0,25,0,0
1668429724928,CSE 239A,A00,102384,Deutsch; Alin Bernard,0,5,0,0
1668429725369,CSE 239B,A00,102385,Polikarpova; Nadezhda,0,3,0,0
1668429725800,CSE 240A,A00,102386,Pannuto; Patrick William,0,24,0,0
1668429726226,CSE 240B,A00,102387,Zhao; Jishen,0,23,0,0
1668429726653,CSE 241A,A00,106406,Kang; Mingu,0,2,0,0
1668429727077,CSE 249B,A00,102388,Kahng; Andrew Byun,0,1,8,8
1668429727506,CSE 251B,A01,102392,Cottrell; Garrison W,0,22,0,0
1668429727506,CSE 251B,A02,102393,Cottrell; Garrison W,0,21,0,0
1668429727935,CSE 252B,A00,102394,Ochoa; Benjamin Lawrence,0,36,0,0
1668429728362,CSE 257,A01,102396,Gao; Sicun,0,86,0,0
1668429728785,CSE 272,A00,102397,Li; Tzumao,0,7,0,0
1668429729213,CSE 274,A00,111323,Chern; Albert Ren-Haur,0,7,0,0
1668429729651,CSE 282,A00,102398,Pevzner; Pavel Arkadjevich,0,0,0,0
1668429730086,CSE 284,A00,114175,Gymrek; Melissa Ann,0,10,0,0
1668429730530,CSE 290,A00,102399,Chandraker; Manmohan Krishna,0,4,0,0
1668429730530,CSE 290,B00,102400,Vaccaro; Kristen Marie,0,1,25,25
1668429730530,CSE 290,C00,102414,Pannuto; Patrick William,0,1,25,25
1668429730530,CSE 290,D00,102427,Pevzner; Pavel Arkadjevich,0,0,0,0
1668429730530,CSE 290,E00,102429,Zhao; Jishen,0,1,0,0
1668429730530,CSE 290,F00,102436,Tullsen; Dean Michael,0,2,0,0
1668429730530,CSE 290,G00,102440,Christensen; Henrik I,0,3,20,20
1668429730957,CSE 291,A00,102443,Su; Hao,0,0,0,0
1668429730957,CSE 291,B00,102448,Polikarpova; Nadezhda,0,0,0,0
1668429730957,CSE 291,C00,102453,Vaccaro; Kristen Marie,0,0,0,0
1668429730957,CSE 291,D00,111343,Savage; Stefan,0,0,0,0
1668429730957,CSE 291,E00,116474,Claffy; Kimberly Claire,0,0,0,0
1668429730957,CSE 291,F00,116479,Pasquale; Joseph,0,0,0,0
1668429731425,CSE 293,001,119111,Bafna; Vineet,9999,0,9999,0
1668429731425,CSE 293,002,119118,Bellare; Mihir,9999,0,9999,0
1668429731425,CSE 293,003,119122,Berg-Kirkpatrick; Taylor D,9999,0,9999,0
1668429731425,CSE 293,004,119135,Christensen; Henrik I,9999,0,9999,0
1668429731425,CSE 293,005,119142,Cottrell; Garrison W,9999,0,9999,0
1668429731425,CSE 293,006,119146,Deutsch; Alin Bernard,9999,0,9999,0
1668429731425,CSE 293,007,119159,Esmaeilzadeh; Hadi,9999,0,9999,0
1668429731425,CSE 293,008,119166,Freund; Yoav,9999,0,9999,0
1668429731425,CSE 293,009,119170,Griswold; William G.,9999,0,9999,0
1668429731425,CSE 293,010,119183,Gymrek; Melissa Ann,9999,0,9999,0
1668429731425,CSE 293,011,119190,Heninger; Nadia A,9999,0,9999,0
1668429731425,CSE 293,012,119230,Impagliazzo; Russell,9999,0,9999,0
1668429731425,CSE 293,013,119232,Jhala; Ranjit,9999,0,9999,0
1668429731425,CSE 293,014,119233,Kahng; Andrew Byun,9999,0,9999,0
1668429731425,CSE 293,015,119298,Kane; Daniel Mertz,9999,0,9999,0
1668429731425,CSE 293,016,119299,Kriegman; David J,9999,0,9999,0
1668429731425,CSE 293,017,119300,Kumar; Arun Kumar,9999,0,9999,0
1668429731425,CSE 293,018,119301,Lerner; Sorin,9999,0,9999,0
1668429731425,CSE 293,019,119302,Lovett; Shachar,9999,0,9999,0
1668429731425,CSE 293,020,119303,McAuley; Julian John,9999,0,9999,0
1668429731425,CSE 293,021,119304,Micciancio; Daniele,9999,0,9999,0
1668429731425,CSE 293,022,119367,Orailoglu; Alex,9999,0,9999,0
1668429731425,CSE 293,023,119382,Paturi; Ramamohan,9999,0,9999,0
1668429731425,CSE 293,024,119404,Polikarpova; Nadezhda,9999,0,9999,0
1668429731425,CSE 293,025,119406,Politz; Joseph Gibbs,9999,0,9999,0
1668429731425,CSE 293,026,119411,Porter; George M,9999,0,9999,0
1668429731425,CSE 293,027,119414,Porter; Leonard Emerson,9999,0,9999,0
1668429731425,CSE 293,028,119416,Ramamoorthi; Ravi,9999,0,9999,0
1668429731425,CSE 293,029,119417,Sahoo; Debashis,9999,0,9999,0
1668429731425,CSE 293,030,119420,Saul; Lawrence,9999,0,9999,0
1668429731425,CSE 293,031,119421,Savage; Stefan,9999,0,9999,0
1668429731425,CSE 293,032,119425,Schulze; Jurgen P.,9999,0,9999,0
1668429731425,CSE 293,033,119426,Snoeren; Alex C.,9999,0,9999,0
1668429731425,CSE 293,034,119428,Shang; Jingbo,9999,0,9999,0
1668429731425,CSE 293,035,119430,Stefan; Deian,9999,0,9999,0
1668429731425,CSE 293,036,119431,Su; Hao,9999,0,9999,0
1668429731425,CSE 293,037,119433,Swanson; Steven James,9999,0,9999,0
1668429731425,CSE 293,038,119435,Tullsen; Dean Michael,9999,0,9999,0
1668429731425,CSE 293,039,119483,Voelker; Geoffrey M.,9999,0,9999,0
1668429731425,CSE 293,040,119537,Zhao; Jishen,9999,0,9999,0
1668429731425,CSE 293,041,119538,Zhou; Yuan-Yuan,9999,0,9999,0
1668429731425,CSE 293,042,119539,Gao; Sicun,9999,0,9999,0
1668429731425,CSE 293,043,119540,Weibel; Nadir,9999,0,9999,0
1668429731425,CSE 293,044,119541,Gupta; Rajesh K.,9999,0,9999,0
1668429731425,CSE 293,045,126410,Vaccaro; Kristen Marie,9999,0,9999,0
1668429731425,CSE 293,046,126411,Klemke; Richard,9999,0,9999,0
1668429731870,CSE 294,A00,102459,Voelker; Geoffrey M.,0,1,0,0
1668429731870,CSE 294,B00,111322,Orailoglu; Alex,0,0,0,0
1668429732305,DSE 201,A00,096914,Deutsch; Alin Bernard,30,0,30,0
1668429732733,DSE 210,A00,096915,Dasgupta; Sanjoy,30,0,30,0
1668429733159,DSE 260A,A00,096916,Altintas De Callaf; Ilkay,30,0,30,0
1668429733615,ECE 200,001,103586,Antipa; Nicholas A,9999,0,9999,0
1668429733615,ECE 200,002,103587,Atanasov; Nikolay A.,9999,0,9999,0
1668429733615,ECE 200,003,103588,Bharadia; Dinesh,9999,0,9999,0
1668429733615,ECE 200,004,103589,Cheng; Chung Kuan,9999,0,9999,0
1668429733615,ECE 200,005,103590,Cosman; Pamela C.,9999,0,9999,0
1668429733615,ECE 200,006,103591,Dayeh; Shadi Ahmad,9999,0,9999,0
1668429733615,ECE 200,007,103592,Fainman; Yeshaiahu,9999,0,9999,0
1668429733615,ECE 200,008,103593,Ford; Joseph Earl,9999,0,9999,0
1668429733615,ECE 200,009,103594,Franceschetti; Massimo,9999,0,9999,0
1668429733615,ECE 200,010,103595,Fullerton; Eric E,9999,0,9999,0
1668429733615,ECE 200,011,103596,Galton; Ian A,9999,0,9999,0
1668429733615,ECE 200,012,103597,Gilja; Vikash,9999,0,9999,0
1668429733615,ECE 200,013,103598,Hall; Drew A.,9999,0,9999,0
1668429733615,ECE 200,014,103599,Hsueh; Tzu-Chien,9999,0,9999,0
1668429733615,ECE 200,015,103600,Javidi; Tara,9999,0,9999,0
1668429733615,ECE 200,016,103601,Kahng; Andrew Byun,9999,0,9999,0
1668429733615,ECE 200,017,103602,Kim; Young-Han,9999,0,9999,0
1668429733615,ECE 200,018,103603,Koushanfar; Farinaz,9999,0,9999,0
1668429733615,ECE 200,019,103604,Kuzum; Duygu,9999,0,9999,0
1668429733615,ECE 200,020,103605,Le; Hanh-Phuc,9999,0,9999,0
1668429733615,ECE 200,021,103606,Lin; Bill,9999,0,9999,0
1668429733615,ECE 200,022,103607,Liu; Zhaowei,9998,0,9999,1
1668429733615,ECE 200,023,103608,Lo; Yu-Hwa,9999,0,9999,0
1668429733615,ECE 200,024,103609,Lomakin; Vitaliy,9999,0,9999,0
1668429733615,ECE 200,025,103610,Mercier; Patrick Philip,9999,0,9999,0
1668429733615,ECE 200,026,103611,Meyer; Florian,9999,0,9999,0
1668429733615,ECE 200,027,103612,Milstein; Laurence B.,9999,0,9999,0
1668429733615,ECE 200,028,103613,Mir Arabbaygi; Siavash,9999,0,9999,0
1668429733615,ECE 200,029,103614,Mookherjea; Shayan,9999,0,9999,0
1668429733615,ECE 200,030,103615,Morris; Karcher William,9999,0,9999,0
1668429733615,ECE 200,031,103616,Ng; Tse Nga,9999,0,9999,0
1668429733615,ECE 200,032,103617,Nguyen; Truong Quang,9999,0,9999,0
1668429733615,ECE 200,033,103618,Nomura; Kenji,9999,0,9999,0
1668429733615,ECE 200,034,103619,Orlitsky; Alon,9999,0,9999,0
1668429733615,ECE 200,035,103620,Pal; Piya,9999,0,9999,0
1668429733615,ECE 200,036,103621,Papen; George C.,9999,0,9999,0
1668429733615,ECE 200,037,103622,Radic; Stojan,9999,0,9999,0
1668429733615,ECE 200,038,103623,Rao; Bhaskar D.,9999,0,9999,0
1668429733615,ECE 200,039,103624,Rao; Ramesh R,9999,0,9999,0
1668429733615,ECE 200,040,103625,Rebeiz; Gabriel,9999,0,9999,0
1668429733615,ECE 200,041,103626,Sanford; John R,9999,0,9999,0
1668429733615,ECE 200,042,103627,Siegel; Paul H.,9999,0,9999,0
1668429733615,ECE 200,043,103628,Sievenpiper; Daniel F.,9999,0,9999,0
1668429733615,ECE 200,044,103629,Sworder; David D.,9999,0,9999,0
1668429733615,ECE 200,045,103630,Taur; Yuan,9999,0,9999,0
1668429733615,ECE 200,046,103631,Touri; Behrouz,9999,0,9999,0
1668429733615,ECE 200,047,103632,Trivedi; Mohan M.,9999,0,9999,0
1668429733615,ECE 200,048,103633,Vasconcelos; Nuno,9999,0,9999,0
1668429733615,ECE 200,049,103634,Wang; Xiaolong,9999,0,9999,0
1668429733615,ECE 200,050,103635,Xie; Pengtao,9999,0,9999,0
1668429733615,ECE 200,051,103636,Yip; Michael,9999,0,9999,0
1668429733615,ECE 200,052,103637,Zeger; Kenneth A.,999,0,999,0
1668429733615,ECE 200,053,103638,Zhang; Xinyu,9999,0,9999,0
1668429733615,ECE 200,054,103639,Turakhia; Yatish Girish,9999,0,9999,0
1668429733615,ECE 200,055,103640,Kang; Mingu,9999,0,9999,0
1668429733615,ECE 200,056,103641,Shi; Yuanyuan,9999,0,9999,0
1668429733615,ECE 200,057,103642,Wang; Edward Jay,9999,0,9999,0
1668429733615,ECE 200,058,103643,Zheng; Yang,9999,0,9999,0
1668429734041,ECE 202,A00,103644,Kuzum; Duygu,0,21,0,0
1668429734487,ECE 212BN,A00,103646,Ng; Tse Nga,0,1,0,0
1668429734925,ECE 221,A00,111493,Staff,0,0,0,0
1668429735354,ECE 222B,A00,103647,Lomakin; Vitaliy,0,5,0,0
1668429735780,ECE 230B,A00,103648,Taur; Yuan,0,0,0,0
1668429736209,ECE 238B,A00,103649,Garay; Javier,0,0,0,0
1668429736633,ECE 240B,A00,112900,Fainman; Yeshaiahu,0,4,0,0
1668429737058,ECE 247A,A00,103650,Jokerst; Jesse Vincent,0,1,0,0
1668429737498,ECE 247B,A00,103651,Wang; Joseph,0,4,0,0
1668429737929,ECE 250,A00,103652,Siegel; Paul H.,0,42,0,0
1668429738366,ECE 251A,A00,103654,Rao; Bhaskar D.,0,29,0,0
1668429738799,ECE 257B,A00,103655,Bharadia; Dinesh,0,12,0,0
1668429739221,ECE 258A,A00,103656,Milstein; Laurence B.,0,10,0,0
1668429739654,ECE 260B,A00,103658,Kang; Mingu,0,64,0,0
1668429740082,ECE 264A,A00,103659,Galton; Ian A,0,32,0,0
1668429740510,ECE 265A,A00,103661,Gudem; Prasad S.S.,0,17,0,0
1668429740937,ECE 265D,A00,103662,Gudem; Prasad S.S.,0,11,0,0
1668429741361,ECE 268,A00,103663,Koushanfar; Farinaz,0,18,0,0
1668429741797,ECE 269,A01,103665,Pal; Piya,0,126,0,0
1668429742225,ECE 271B,A00,103666,Vasconcelos; Manuela,0,46,0,0
1668429742666,ECE 276A,A00,103667,Atanasov; Nikolay A.,0,67,0,0
1668429743098,ECE 277,A00,103668,An; Cheolhong,0,87,0,0
1668429743526,ECE 279,A00,117947,Hall; Drew A.,0,12,0,0
1668429744379,ECE 283,A00,103670,Hsueh; Tzu-Chien,0,23,0,0
1668429744803,ECE 284,A00,103671,Turakhia; Yatish Girish,0,22,0,0
1668429745239,ECE 285,A00,103672,Zheng; Yang,0,22,0,0
1668429745239,ECE 285,B00,103673,Sworder; David D.,0,36,0,0
1668429745666,ECE 287,A00,103676,Javidi; Tara,0,4,0,0
1668429746096,MATH 200B,A00,098023,Salehi Golsefidy; Alireza,12,0,15,3
1668429746528,MATH 202B,A00,098024,Rhoades; Brendon Patrick,9,0,15,6
1668429746967,MATH 203B,A00,098025,Oprea; Dragos N.,10,0,15,5
1668429747393,MATH 204B,A00,098026,Sorensen; Claus M,13,0,15,2
1668429747818,MATH 208,A00,098027,Izadi; Elham,7,0,10,3
1668429748245,MATH 209,A00,098028,Pollack; Aaron,10,0,10,0
1668429748674,MATH 211A,A00,112919,Rogalski; Daniel,9,0,10,1
1668429749098,MATH 211B,A00,112920,Seward; Brandon M.,9,0,10,1
1668429749523,MATH 218,A00,098029,Li; Bo,10,0,10,0
1668429749947,MATH 220B,A00,098030,Novak; Jonathan I,11,0,15,4
1668429750384,MATH 221A,A00,098031,Ebenfelt; Peter F,13,0,15,2
1668429750813,MATH 231B,A00,098032,Zlatos; Andrej,12,0,15,3
1668429751254,MATH 240B,A00,098033,Ni; Lei,9,0,15,6
1668429751769,MATH 243,A00,098034,Jekel; David Andrew,10,0,10,0
1668429752212,MATH 245A,A00,098035,Nie; Jiawang,0,1,15,16
1668429752650,MATH 248,A00,098036,Bejenaru; Ioan,10,0,10,0
1668429753076,MATH 250B,A00,098037,Spolaor; Luca,14,0,15,1
1668429753501,MATH 258,A00,098038,Ni; Lei,10,0,10,0
1668429753926,MATH 264B,A00,098041,Rhoades; Brendon Patrick,9,0,15,6
1668429754368,MATH 268,A00,098042,Buss; Samuel R,10,0,10,0
1668429754816,MATH 269,A00,098043,Rhoades; Brendon Patrick,10,0,10,0
1668429755246,MATH 270B,A00,098044,Li; Bo,10,0,15,5
1668429755675,MATH 272B,A00,098045,Holst; Michael J,13,0,15,2
1668429756101,MATH 273A,A00,098046,Tian; Xiaochuan,10,0,15,5
1668429756534,MATH 275,A01,098048,Tian; Xiaochuan,6,0,10,4
1668429756965,MATH 278A,A00,098049,Holst; Michael J,8,0,10,2
1668429757391,MATH 278B,A00,098050,Cloninger; Alexander,10,0,10,0
1668429757819,MATH 278C,A00,098051,Nie; Jiawang,6,0,10,4
1668429758263,MATH 280B,A00,098052,Zheng; Tianyi,8,0,15,7
1668429758688,MATH 281B,A00,098053,Bradic; Jelena,0,1,15,15
1668429759114,MATH 282B,A00,098054,Arias-Castro; Ery,0,0,15,15
1668429759539,MATH 285,A00,098055,Fitzsimmons; Patrick J,0,0,15,17
1668429759971,MATH 287B,A00,098056,Arias-Castro; Ery,2,0,15,13
1668429760403,MATH 288,A00,098057,Agarwal; Pooja,9,0,10,1
1668429760403,MATH 288,B00,098058,Zhang; Danna,8,0,10,2
1668429760403,MATH 288,C00,098059,Williams; Ruth J,9,0,10,1
1668429760836,MATH 290B,A00,098060,Roberts; Justin Deritter,13,0,15,2
1668429761274,MATH 292,A00,098061,Belmont; Eva Kinoshita,10,0,10,0
1668429761704,MATH 295,A00,098062,Suk; Andrew Hoon,48,0,50,2
1668429762130,MATH 296,A00,098063,Novak; Jonathan I,20,0,20,0
1668429762565,MATH 297,001,098064,Gamst; Anthony Collins,9997,0,9999,2
1668430265789,COGS 205,A00,101395,Chiba; Andrea,19,0,20,1
1668430266220,COGS 210B,001,101404,Greene; Deanna Jacquelyn,9998,0,9999,1
1668430266220,COGS 210B,002,101417,Xia; Haijun,9999,0,9999,0
1668430266220,COGS 210B,003,101422,Nitz; Douglas A.,9999,0,9999,0
1668430266220,COGS 210B,004,101423,Hollan; James D.,9998,0,9999,1
1668430266220,COGS 210B,005,101424,Deak; Gedeon O.,9998,0,9999,1
1668430266220,COGS 210B,006,101425,Rossano; Federico,9999,0,9999,0
1668430266646,COGS 211B,A00,101427,Coulson; Seana M,9996,0,9999,3
1668430267069,COGS 220,A00,101428,Hollan; James D.,1,2,25,24
1668430267498,COGS 229,A00,101429,Dow; Steven P,18,0,25,7
1668430267923,COGS 230,A00,101430,Klemmer; Scott R,11,0,17,6
1668430268349,COGS 234,A00,101431,Xia; Haijun,2,0,25,23
1668430268778,COGS 260,A00,101432,Kiyonaga; Anastasia,21,0,25,4
1668430268778,COGS 260,B00,101433,Kirsh; David Joel,15,0,25,10
1668430269203,CSE 202,A00,102371,Impagliazzo; Russell,0,31,0,0
1668430269629,CSE 203B,A01,102373,Cheng; Chung Kuan,0,25,0,0
1668430270071,CSE 208,A00,102374,Micciancio; Daniele,0,1,0,0
1668430270495,CSE 209A,A00,112895,Impagliazzo; Russell,0,3,15,15
1668430270920,CSE 209B,A00,108005,Bellare; Mihir,0,3,0,0
1668430271356,CSE 210,A00,113163,Coblenz; Michael J,0,41,0,0
1668430271781,CSE 219,A00,106111,Dow; Steven P,0,0,20,20
1668430272206,CSE 221,A00,102376,Voelker; Geoffrey M.,0,29,0,0
1668430272635,CSE 224,A01,102378,Porter; George M,0,102,0,0
1668430273059,CSE 229A,A00,102379,Savage; Stefan,0,4,0,0
1668430273487,CSE 229C,A00,102380,Munyaka; Imani N. S.,0,4,0,0
1668430273913,CSE 232B,A00,102382,Deutsch; Alin Bernard,0,13,0,0
1668430274338,CSE 234,A01,112904,Kumar; Arun Kumar,0,0,0,0
1668430274763,CSE 237A,A00,102383,Rosing; Tajana Simunic,0,25,0,0
1668430275305,CSE 239A,A00,102384,Deutsch; Alin Bernard,0,5,0,0
1668430275732,CSE 239B,A00,102385,Polikarpova; Nadezhda,0,3,0,0
1668430276161,CSE 240A,A00,102386,Pannuto; Patrick William,0,24,0,0
1668430276586,CSE 240B,A00,102387,Zhao; Jishen,0,23,0,0
1668430277009,CSE 241A,A00,106406,Kang; Mingu,0,2,0,0
1668430277433,CSE 249B,A00,102388,Kahng; Andrew Byun,0,1,8,8
1668430277856,CSE 251B,A01,102392,Cottrell; Garrison W,0,22,0,0
1668430277856,CSE 251B,A02,102393,Cottrell; Garrison W,0,21,0,0
1668430278285,CSE 252B,A00,102394,Ochoa; Benjamin Lawrence,0,36,0,0
1668430278709,CSE 257,A01,102396,Gao; Sicun,0,86,0,0
1668430279134,CSE 272,A00,102397,Li; Tzumao,0,7,0,0
1668430279559,CSE 274,A00,111323,Chern; Albert Ren-Haur,0,7,0,0
1668430279983,CSE 282,A00,102398,Pevzner; Pavel Arkadjevich,0,0,0,0
1668430280407,CSE 284,A00,114175,Gymrek; Melissa Ann,0,10,0,0
1668430280833,CSE 290,A00,102399,Chandraker; Manmohan Krishna,0,4,0,0
1668430280833,CSE 290,B00,102400,Vaccaro; Kristen Marie,0,1,25,25
1668430280833,CSE 290,C00,102414,Pannuto; Patrick William,0,1,25,25
1668430280833,CSE 290,D00,102427,Pevzner; Pavel Arkadjevich,0,0,0,0
1668430280833,CSE 290,E00,102429,Zhao; Jishen,0,1,0,0
1668430280833,CSE 290,F00,102436,Tullsen; Dean Michael,0,2,0,0
1668430280833,CSE 290,G00,102440,Christensen; Henrik I,0,3,20,20
1668430281258,CSE 291,A00,102443,Su; Hao,0,0,0,0
1668430281258,CSE 291,B00,102448,Polikarpova; Nadezhda,0,0,0,0
1668430281258,CSE 291,C00,102453,Vaccaro; Kristen Marie,0,0,0,0
1668430281258,CSE 291,D00,111343,Savage; Stefan,0,0,0,0
1668430281258,CSE 291,E00,116474,Claffy; Kimberly Claire,0,0,0,0
1668430281258,CSE 291,F00,116479,Pasquale; Joseph,0,0,0,0
1668430281707,CSE 293,001,119111,Bafna; Vineet,9999,0,9999,0
1668430281707,CSE 293,002,119118,Bellare; Mihir,9999,0,9999,0
1668430281707,CSE 293,003,119122,Berg-Kirkpatrick; Taylor D,9999,0,9999,0
1668430281707,CSE 293,004,119135,Christensen; Henrik I,9999,0,9999,0
1668430281707,CSE 293,005,119142,Cottrell; Garrison W,9999,0,9999,0
1668430281707,CSE 293,006,119146,Deutsch; Alin Bernard,9999,0,9999,0
1668430281707,CSE 293,007,119159,Esmaeilzadeh; Hadi,9999,0,9999,0
1668430281707,CSE 293,008,119166,Freund; Yoav,9999,0,9999,0
1668430281707,CSE 293,009,119170,Griswold; William G.,9999,0,9999,0
1668430281707,CSE 293,010,119183,Gymrek; Melissa Ann,9999,0,9999,0
1668430281707,CSE 293,011,119190,Heninger; Nadia A,9999,0,9999,0
1668430281707,CSE 293,012,119230,Impagliazzo; Russell,9999,0,9999,0
1668430281707,CSE 293,013,119232,Jhala; Ranjit,9999,0,9999,0
1668430281707,CSE 293,014,119233,Kahng; Andrew Byun,9999,0,9999,0
1668430281707,CSE 293,015,119298,Kane; Daniel Mertz,9999,0,9999,0
1668430281707,CSE 293,016,119299,Kriegman; David J,9999,0,9999,0
1668430281707,CSE 293,017,119300,Kumar; Arun Kumar,9999,0,9999,0
1668430281707,CSE 293,018,119301,Lerner; Sorin,9999,0,9999,0
1668430281707,CSE 293,019,119302,Lovett; Shachar,9999,0,9999,0
1668430281707,CSE 293,020,119303,McAuley; Julian John,9999,0,9999,0
1668430281707,CSE 293,021,119304,Micciancio; Daniele,9999,0,9999,0
1668430281707,CSE 293,022,119367,Orailoglu; Alex,9999,0,9999,0
1668430281707,CSE 293,023,119382,Paturi; Ramamohan,9999,0,9999,0
1668430281707,CSE 293,024,119404,Polikarpova; Nadezhda,9999,0,9999,0
1668430281707,CSE 293,025,119406,Politz; Joseph Gibbs,9999,0,9999,0
1668430281707,CSE 293,026,119411,Porter; George M,9999,0,9999,0
1668430281707,CSE 293,027,119414,Porter; Leonard Emerson,9999,0,9999,0
1668430281707,CSE 293,028,119416,Ramamoorthi; Ravi,9999,0,9999,0
1668430281707,CSE 293,029,119417,Sahoo; Debashis,9999,0,9999,0
1668430281707,CSE 293,030,119420,Saul; Lawrence,9999,0,9999,0
1668430281707,CSE 293,031,119421,Savage; Stefan,9999,0,9999,0
1668430281707,CSE 293,032,119425,Schulze; Jurgen P.,9999,0,9999,0
1668430281707,CSE 293,033,119426,Snoeren; Alex C.,9999,0,9999,0
1668430281707,CSE 293,034,119428,Shang; Jingbo,9999,0,9999,0
1668430281707,CSE 293,035,119430,Stefan; Deian,9999,0,9999,0
1668430281707,CSE 293,036,119431,Su; Hao,9999,0,9999,0
1668430281707,CSE 293,037,119433,Swanson; Steven James,9999,0,9999,0
1668430281707,CSE 293,038,119435,Tullsen; Dean Michael,9999,0,9999,0
1668430281707,CSE 293,039,119483,Voelker; Geoffrey M.,9999,0,9999,0
1668430281707,CSE 293,040,119537,Zhao; Jishen,9999,0,9999,0
1668430281707,CSE 293,041,119538,Zhou; Yuan-Yuan,9999,0,9999,0
1668430281707,CSE 293,042,119539,Gao; Sicun,9999,0,9999,0
1668430281707,CSE 293,043,119540,Weibel; Nadir,9999,0,9999,0
1668430281707,CSE 293,044,119541,Gupta; Rajesh K.,9999,0,9999,0
1668430281707,CSE 293,045,126410,Vaccaro; Kristen Marie,9999,0,9999,0
1668430281707,CSE 293,046,126411,Klemke; Richard,9999,0,9999,0
1668430282133,CSE 294,A00,102459,Voelker; Geoffrey M.,0,1,0,0
1668430282133,CSE 294,B00,111322,Orailoglu; Alex,0,0,0,0
1668430282558,DSE 201,A00,096914,Deutsch; Alin Bernard,30,0,30,0
1668430282986,DSE 210,A00,096915,Dasgupta; Sanjoy,30,0,30,0
1668430283413,DSE 260A,A00,096916,Altintas De Callaf; Ilkay,30,0,30,0
1668430283871,ECE 200,001,103586,Antipa; Nicholas A,9999,0,9999,0
1668430283871,ECE 200,002,103587,Atanasov; Nikolay A.,9999,0,9999,0
1668430283871,ECE 200,003,103588,Bharadia; Dinesh,9999,0,9999,0
1668430283871,ECE 200,004,103589,Cheng; Chung Kuan,9999,0,9999,0
1668430283871,ECE 200,005,103590,Cosman; Pamela C.,9999,0,9999,0
1668430283871,ECE 200,006,103591,Dayeh; Shadi Ahmad,9999,0,9999,0
1668430283871,ECE 200,007,103592,Fainman; Yeshaiahu,9999,0,9999,0
1668430283871,ECE 200,008,103593,Ford; Joseph Earl,9999,0,9999,0
1668430283871,ECE 200,009,103594,Franceschetti; Massimo,9999,0,9999,0
1668430283871,ECE 200,010,103595,Fullerton; Eric E,9999,0,9999,0
1668430283871,ECE 200,011,103596,Galton; Ian A,9999,0,9999,0
1668430283871,ECE 200,012,103597,Gilja; Vikash,9999,0,9999,0
1668430283871,ECE 200,013,103598,Hall; Drew A.,9999,0,9999,0
1668430283871,ECE 200,014,103599,Hsueh; Tzu-Chien,9999,0,9999,0
1668430283871,ECE 200,015,103600,Javidi; Tara,9999,0,9999,0
1668430283871,ECE 200,016,103601,Kahng; Andrew Byun,9999,0,9999,0
1668430283871,ECE 200,017,103602,Kim; Young-Han,9999,0,9999,0
1668430283871,ECE 200,018,103603,Koushanfar; Farinaz,9999,0,9999,0
1668430283871,ECE 200,019,103604,Kuzum; Duygu,9999,0,9999,0
1668430283871,ECE 200,020,103605,Le; Hanh-Phuc,9999,0,9999,0
1668430283871,ECE 200,021,103606,Lin; Bill,9999,0,9999,0
1668430283871,ECE 200,022,103607,Liu; Zhaowei,9998,0,9999,1
1668430283871,ECE 200,023,103608,Lo; Yu-Hwa,9999,0,9999,0
1668430283871,ECE 200,024,103609,Lomakin; Vitaliy,9999,0,9999,0
1668430283871,ECE 200,025,103610,Mercier; Patrick Philip,9999,0,9999,0
1668430283871,ECE 200,026,103611,Meyer; Florian,9999,0,9999,0
1668430283871,ECE 200,027,103612,Milstein; Laurence B.,9999,0,9999,0
1668430283871,ECE 200,028,103613,Mir Arabbaygi; Siavash,9999,0,9999,0
1668430283871,ECE 200,029,103614,Mookherjea; Shayan,9999,0,9999,0
1668430283871,ECE 200,030,103615,Morris; Karcher William,9999,0,9999,0
1668430283871,ECE 200,031,103616,Ng; Tse Nga,9999,0,9999,0
1668430283871,ECE 200,032,103617,Nguyen; Truong Quang,9999,0,9999,0
1668430283871,ECE 200,033,103618,Nomura; Kenji,9999,0,9999,0
1668430283871,ECE 200,034,103619,Orlitsky; Alon,9999,0,9999,0
1668430283871,ECE 200,035,103620,Pal; Piya,9999,0,9999,0
1668430283871,ECE 200,036,103621,Papen; George C.,9999,0,9999,0
1668430283871,ECE 200,037,103622,Radic; Stojan,9999,0,9999,0
1668430283871,ECE 200,038,103623,Rao; Bhaskar D.,9999,0,9999,0
1668430283871,ECE 200,039,103624,Rao; Ramesh R,9999,0,9999,0
1668430283871,ECE 200,040,103625,Rebeiz; Gabriel,9999,0,9999,0
1668430283871,ECE 200,041,103626,Sanford; John R,9999,0,9999,0
1668430283871,ECE 200,042,103627,Siegel; Paul H.,9999,0,9999,0
1668430283871,ECE 200,043,103628,Sievenpiper; Daniel F.,9999,0,9999,0
1668430283871,ECE 200,044,103629,Sworder; David D.,9999,0,9999,0
1668430283871,ECE 200,045,103630,Taur; Yuan,9999,0,9999,0
1668430283871,ECE 200,046,103631,Touri; Behrouz,9999,0,9999,0
1668430283871,ECE 200,047,103632,Trivedi; Mohan M.,9999,0,9999,0
1668430283871,ECE 200,048,103633,Vasconcelos; Nuno,9999,0,9999,0
1668430283871,ECE 200,049,103634,Wang; Xiaolong,9999,0,9999,0
1668430283871,ECE 200,050,103635,Xie; Pengtao,9999,0,9999,0
1668430283871,ECE 200,051,103636,Yip; Michael,9999,0,9999,0
1668430283871,ECE 200,052,103637,Zeger; Kenneth A.,999,0,999,0
1668430283871,ECE 200,053,103638,Zhang; Xinyu,9999,0,9999,0
1668430283871,ECE 200,054,103639,Turakhia; Yatish Girish,9999,0,9999,0
1668430283871,ECE 200,055,103640,Kang; Mingu,9999,0,9999,0
1668430283871,ECE 200,056,103641,Shi; Yuanyuan,9999,0,9999,0
1668430283871,ECE 200,057,103642,Wang; Edward Jay,9999,0,9999,0
1668430283871,ECE 200,058,103643,Zheng; Yang,9999,0,9999,0
1668430284299,ECE 202,A00,103644,Kuzum; Duygu,0,21,0,0
1668430284722,ECE 212BN,A00,103646,Ng; Tse Nga,0,1,0,0
1668430285158,ECE 221,A00,111493,Staff,0,0,0,0
1668430285586,ECE 222B,A00,103647,Lomakin; Vitaliy,0,5,0,0
1668430286010,ECE 230B,A00,103648,Taur; Yuan,0,0,0,0
1668430286439,ECE 238B,A00,103649,Garay; Javier,0,0,0,0
1668430286862,ECE 240B,A00,112900,Fainman; Yeshaiahu,0,4,0,0
1668430287289,ECE 247A,A00,103650,Jokerst; Jesse Vincent,0,1,0,0
1668430287725,ECE 247B,A00,103651,Wang; Joseph,0,4,0,0
1668430288155,ECE 250,A00,103652,Siegel; Paul H.,0,42,0,0
1668430288586,ECE 251A,A00,103654,Rao; Bhaskar D.,0,29,0,0
1668430289011,ECE 257B,A00,103655,Bharadia; Dinesh,0,12,0,0
1668430289437,ECE 258A,A00,103656,Milstein; Laurence B.,0,10,0,0
1668430289859,ECE 260B,A00,103658,Kang; Mingu,0,64,0,0
1668430290285,ECE 264A,A00,103659,Galton; Ian A,0,32,0,0
1668430290715,ECE 265A,A00,103661,Gudem; Prasad S.S.,0,17,0,0
1668430291139,ECE 265D,A00,103662,Gudem; Prasad S.S.,0,11,0,0
1668430291565,ECE 268,A00,103663,Koushanfar; Farinaz,0,18,0,0
1668430291991,ECE 269,A01,103665,Pal; Piya,0,126,0,0
1668430292423,ECE 271B,A00,103666,Vasconcelos; Manuela,0,46,0,0
1668430292848,ECE 276A,A00,103667,Atanasov; Nikolay A.,0,67,0,0
1668430293273,ECE 277,A00,103668,An; Cheolhong,0,87,0,0
1668430293696,ECE 279,A00,117947,Hall; Drew A.,0,12,0,0
1668430294561,ECE 283,A00,103670,Hsueh; Tzu-Chien,0,23,0,0
1668430294997,ECE 284,A00,103671,Turakhia; Yatish Girish,0,22,0,0
1668430295432,ECE 285,A00,103672,Zheng; Yang,0,22,0,0
1668430295432,ECE 285,B00,103673,Sworder; David D.,0,36,0,0
1668430295861,ECE 287,A00,103676,Javidi; Tara,0,4,0,0
1668430296286,MATH 200B,A00,098023,Salehi Golsefidy; Alireza,12,0,15,3
1668430296719,MATH 202B,A00,098024,Rhoades; Brendon Patrick,9,0,15,6
1668430297147,MATH 203B,A00,098025,Oprea; Dragos N.,10,0,15,5
1668430297571,MATH 204B,A00,098026,Sorensen; Claus M,13,0,15,2
1668430298009,MATH 208,A00,098027,Izadi; Elham,7,0,10,3
1668430298434,MATH 209,A00,098028,Pollack; Aaron,10,0,10,0
1668430298860,MATH 211A,A00,112919,Rogalski; Daniel,9,0,10,1
1668430299301,MATH 211B,A00,112920,Seward; Brandon M.,9,0,10,1
1668430299728,MATH 218,A00,098029,Li; Bo,10,0,10,0
1668430300156,MATH 220B,A00,098030,Novak; Jonathan I,11,0,15,4
1668430300584,MATH 221A,A00,098031,Ebenfelt; Peter F,13,0,15,2
1668430301018,MATH 231B,A00,098032,Zlatos; Andrej,12,0,15,3
1668430301449,MATH 240B,A00,098033,Ni; Lei,9,0,15,6
1668430301874,MATH 243,A00,098034,Jekel; David Andrew,10,0,10,0
1668430302301,MATH 245A,A00,098035,Nie; Jiawang,0,1,15,16
1668430302729,MATH 248,A00,098036,Bejenaru; Ioan,10,0,10,0
1668430303154,MATH 250B,A00,098037,Spolaor; Luca,14,0,15,1
1668430303582,MATH 258,A00,098038,Ni; Lei,10,0,10,0
1668430304009,MATH 264B,A00,098041,Rhoades; Brendon Patrick,9,0,15,6
1668430304434,MATH 268,A00,098042,Buss; Samuel R,10,0,10,0
1668430304858,MATH 269,A00,098043,Rhoades; Brendon Patrick,10,0,10,0
1668430305282,MATH 270B,A00,098044,Li; Bo,10,0,15,5
1668430305711,MATH 272B,A00,098045,Holst; Michael J,13,0,15,2
1668430306139,MATH 273A,A00,098046,Tian; Xiaochuan,10,0,15,5
1668430306570,MATH 275,A01,098048,Tian; Xiaochuan,6,0,10,4
1668430307004,MATH 278A,A00,098049,Holst; Michael J,8,0,10,2
1668430307428,MATH 278B,A00,098050,Cloninger; Alexander,10,0,10,0
1668430307852,MATH 278C,A00,098051,Nie; Jiawang,6,0,10,4
1668430308277,MATH 280B,A00,098052,Zheng; Tianyi,8,0,15,7
1668430308701,MATH 281B,A00,098053,Bradic; Jelena,0,1,15,15
1668430309126,MATH 282B,A00,098054,Arias-Castro; Ery,0,0,15,15
1668430309555,MATH 285,A00,098055,Fitzsimmons; Patrick J,0,0,15,17
1668430309981,MATH 287B,A00,098056,Arias-Castro; Ery,2,0,15,13
1668430310405,MATH 288,A00,098057,Agarwal; Pooja,9,0,10,1
1668430310405,MATH 288,B00,098058,Zhang; Danna,8,0,10,2
1668430310405,MATH 288,C00,098059,Williams; Ruth J,9,0,10,1
1668430310830,MATH 290B,A00,098060,Roberts; Justin Deritter,13,0,15,2
1668430311255,MATH 292,A00,098061,Belmont; Eva Kinoshita,10,0,10,0
1668430311680,MATH 295,A00,098062,Suk; Andrew Hoon,48,0,50,2
1668430312105,MATH 296,A00,098063,Novak; Jonathan I,20,0,20,0
1668430312534,MATH 297,001,098064,Gamst; Anthony Collins,9997,0,9999,2
1668430814192,COGS 205,A00,101395,Chiba; Andrea,19,0,20,1
1668430814640,COGS 210B,001,101404,Greene; Deanna Jacquelyn,9998,0,9999,1
1668430814640,COGS 210B,002,101417,Xia; Haijun,9999,0,9999,0
1668430814640,COGS 210B,003,101422,Nitz; Douglas A.,9999,0,9999,0
1668430814640,COGS 210B,004,101423,Hollan; James D.,9998,0,9999,1
1668430814640,COGS 210B,005,101424,Deak; Gedeon O.,9998,0,9999,1
1668430814640,COGS 210B,006,101425,Rossano; Federico,9999,0,9999,0
1668430815075,COGS 211B,A00,101427,Coulson; Seana M,9996,0,9999,3
1668430815497,COGS 220,A00,101428,Hollan; James D.,1,2,25,24
1668430815924,COGS 229,A00,101429,Dow; Steven P,18,0,25,7
1668430816350,COGS 230,A00,101430,Klemmer; Scott R,11,0,17,6
1668430816773,COGS 234,A00,101431,Xia; Haijun,2,0,25,23
1668430817201,COGS 260,A00,101432,Kiyonaga; Anastasia,21,0,25,4
1668430817201,COGS 260,B00,101433,Kirsh; David Joel,15,0,25,10
1668430817626,CSE 202,A00,102371,Impagliazzo; Russell,0,32,0,0
1668430818053,CSE 203B,A01,102373,Cheng; Chung Kuan,0,25,0,0
1668430818476,CSE 208,A00,102374,Micciancio; Daniele,0,1,0,0
1668430818905,CSE 209A,A00,112895,Impagliazzo; Russell,0,3,15,15
1668430819328,CSE 209B,A00,108005,Bellare; Mihir,0,3,0,0
1668430819754,CSE 210,A00,113163,Coblenz; Michael J,0,41,0,0
1668430820181,CSE 219,A00,106111,Dow; Steven P,0,0,20,20
1668430820632,CSE 221,A00,102376,Voelker; Geoffrey M.,0,29,0,0
1668430821056,CSE 224,A01,102378,Porter; George M,0,103,0,0
1668430821480,CSE 229A,A00,102379,Savage; Stefan,0,4,0,0
1668430821903,CSE 229C,A00,102380,Munyaka; Imani N. S.,0,4,0,0
1668430822326,CSE 232B,A00,102382,Deutsch; Alin Bernard,0,13,0,0
1668430822754,CSE 234,A01,112904,Kumar; Arun Kumar,0,0,0,0
1668430823184,CSE 237A,A00,102383,Rosing; Tajana Simunic,0,25,0,0
1668430823610,CSE 239A,A00,102384,Deutsch; Alin Bernard,0,5,0,0
1668430824034,CSE 239B,A00,102385,Polikarpova; Nadezhda,0,3,0,0
1668430824457,CSE 240A,A00,102386,Pannuto; Patrick William,0,25,0,0
1668430824887,CSE 240B,A00,102387,Zhao; Jishen,0,23,0,0
1668430825319,CSE 241A,A00,106406,Kang; Mingu,0,2,0,0
1668430825745,CSE 249B,A00,102388,Kahng; Andrew Byun,0,1,8,8
1668430826171,CSE 251B,A01,102392,Cottrell; Garrison W,0,22,0,0
1668430826171,CSE 251B,A02,102393,Cottrell; Garrison W,0,21,0,0
1668430826597,CSE 252B,A00,102394,Ochoa; Benjamin Lawrence,0,36,0,0
1668430827036,CSE 257,A01,102396,Gao; Sicun,0,86,0,0
1668430827461,CSE 272,A00,102397,Li; Tzumao,0,7,0,0
1668430827883,CSE 274,A00,111323,Chern; Albert Ren-Haur,0,7,0,0
1668430828307,CSE 282,A00,102398,Pevzner; Pavel Arkadjevich,0,0,0,0
1668430828734,CSE 284,A00,114175,Gymrek; Melissa Ann,0,10,0,0
1668430829162,CSE 290,A00,102399,Chandraker; Manmohan Krishna,0,4,0,0
1668430829162,CSE 290,B00,102400,Vaccaro; Kristen Marie,0,1,25,25
1668430829162,CSE 290,C00,102414,Pannuto; Patrick William,0,1,25,25
1668430829162,CSE 290,D00,102427,Pevzner; Pavel Arkadjevich,0,0,0,0
1668430829162,CSE 290,E00,102429,Zhao; Jishen,0,1,0,0
1668430829162,CSE 290,F00,102436,Tullsen; Dean Michael,0,2,0,0
1668430829162,CSE 290,G00,102440,Christensen; Henrik I,0,3,20,20
1668430829587,CSE 291,A00,102443,Su; Hao,0,0,0,0
1668430829587,CSE 291,B00,102448,Polikarpova; Nadezhda,0,0,0,0
1668430829587,CSE 291,C00,102453,Vaccaro; Kristen Marie,0,0,0,0
1668430829587,CSE 291,D00,111343,Savage; Stefan,0,0,0,0
1668430829587,CSE 291,E00,116474,Claffy; Kimberly Claire,0,0,0,0
1668430829587,CSE 291,F00,116479,Pasquale; Joseph,0,0,0,0
1668430830018,CSE 293,001,119111,Bafna; Vineet,9999,0,9999,0
1668430830018,CSE 293,002,119118,Bellare; Mihir,9999,0,9999,0
1668430830018,CSE 293,003,119122,Berg-Kirkpatrick; Taylor D,9999,0,9999,0
1668430830018,CSE 293,004,119135,Christensen; Henrik I,9999,0,9999,0
1668430830018,CSE 293,005,119142,Cottrell; Garrison W,9999,0,9999,0
1668430830018,CSE 293,006,119146,Deutsch; Alin Bernard,9999,0,9999,0
1668430830018,CSE 293,007,119159,Esmaeilzadeh; Hadi,9999,0,9999,0
1668430830018,CSE 293,008,119166,Freund; Yoav,9999,0,9999,0
1668430830018,CSE 293,009,119170,Griswold; William G.,9999,0,9999,0
1668430830018,CSE 293,010,119183,Gymrek; Melissa Ann,9999,0,9999,0
1668430830018,CSE 293,011,119190,Heninger; Nadia A,9999,0,9999,0
1668430830018,CSE 293,012,119230,Impagliazzo; Russell,9999,0,9999,0
1668430830018,CSE 293,013,119232,Jhala; Ranjit,9999,0,9999,0
1668430830018,CSE 293,014,119233,Kahng; Andrew Byun,9999,0,9999,0
1668430830018,CSE 293,015,119298,Kane; Daniel Mertz,9999,0,9999,0
1668430830018,CSE 293,016,119299,Kriegman; David J,9999,0,9999,0
1668430830018,CSE 293,017,119300,Kumar; Arun Kumar,9999,0,9999,0
1668430830018,CSE 293,018,119301,Lerner; Sorin,9999,0,9999,0
1668430830018,CSE 293,019,119302,Lovett; Shachar,9999,0,9999,0
1668430830018,CSE 293,020,119303,McAuley; Julian John,9999,0,9999,0
1668430830018,CSE 293,021,119304,Micciancio; Daniele,9999,0,9999,0
1668430830018,CSE 293,022,119367,Orailoglu; Alex,9999,0,9999,0
1668430830018,CSE 293,023,119382,Paturi; Ramamohan,9999,0,9999,0
1668430830018,CSE 293,024,119404,Polikarpova; Nadezhda,9999,0,9999,0
1668430830018,CSE 293,025,119406,Politz; Joseph Gibbs,9999,0,9999,0
1668430830018,CSE 293,026,119411,Porter; George M,9999,0,9999,0
1668430830018,CSE 293,027,119414,Porter; Leonard Emerson,9999,0,9999,0
1668430830018,CSE 293,028,119416,Ramamoorthi; Ravi,9999,0,9999,0
1668430830018,CSE 293,029,119417,Sahoo; Debashis,9999,0,9999,0
1668430830018,CSE 293,030,119420,Saul; Lawrence,9999,0,9999,0
1668430830018,CSE 293,031,119421,Savage; Stefan,9999,0,9999,0
1668430830018,CSE 293,032,119425,Schulze; Jurgen P.,9999,0,9999,0
1668430830018,CSE 293,033,119426,Snoeren; Alex C.,9999,0,9999,0
1668430830018,CSE 293,034,119428,Shang; Jingbo,9999,0,9999,0
1668430830018,CSE 293,035,119430,Stefan; Deian,9999,0,9999,0
1668430830018,CSE 293,036,119431,Su; Hao,9999,0,9999,0
1668430830018,CSE 293,037,119433,Swanson; Steven James,9999,0,9999,0
1668430830018,CSE 293,038,119435,Tullsen; Dean Michael,9999,0,9999,0
1668430830018,CSE 293,039,119483,Voelker; Geoffrey M.,9999,0,9999,0
1668430830018,CSE 293,040,119537,Zhao; Jishen,9999,0,9999,0
1668430830018,CSE 293,041,119538,Zhou; Yuan-Yuan,9999,0,9999,0
1668430830018,CSE 293,042,119539,Gao; Sicun,9999,0,9999,0
1668430830018,CSE 293,043,119540,Weibel; Nadir,9999,0,9999,0
1668430830018,CSE 293,044,119541,Gupta; Rajesh K.,9999,0,9999,0
1668430830018,CSE 293,045,126410,Vaccaro; Kristen Marie,9999,0,9999,0
1668430830018,CSE 293,046,126411,Klemke; Richard,9999,0,9999,0
1668430830441,CSE 294,A00,102459,Voelker; Geoffrey M.,0,1,0,0
1668430830441,CSE 294,B00,111322,Orailoglu; Alex,0,0,0,0
1668430830868,DSE 201,A00,096914,Deutsch; Alin Bernard,30,0,30,0
1668430831292,DSE 210,A00,096915,Dasgupta; Sanjoy,30,0,30,0
1668430831713,DSE 260A,A00,096916,Altintas De Callaf; Ilkay,30,0,30,0
1668430832150,ECE 200,001,103586,Antipa; Nicholas A,9999,0,9999,0
1668430832150,ECE 200,002,103587,Atanasov; Nikolay A.,9999,0,9999,0
1668430832150,ECE 200,003,103588,Bharadia; Dinesh,9999,0,9999,0
1668430832150,ECE 200,004,103589,Cheng; Chung Kuan,9999,0,9999,0
1668430832150,ECE 200,005,103590,Cosman; Pamela C.,9999,0,9999,0
1668430832150,ECE 200,006,103591,Dayeh; Shadi Ahmad,9999,0,9999,0
1668430832150,ECE 200,007,103592,Fainman; Yeshaiahu,9999,0,9999,0
1668430832150,ECE 200,008,103593,Ford; Joseph Earl,9999,0,9999,0
1668430832150,ECE 200,009,103594,Franceschetti; Massimo,9999,0,9999,0
1668430832150,ECE 200,010,103595,Fullerton; Eric E,9999,0,9999,0
1668430832150,ECE 200,011,103596,Galton; Ian A,9999,0,9999,0
1668430832150,ECE 200,012,103597,Gilja; Vikash,9999,0,9999,0
1668430832150,ECE 200,013,103598,Hall; Drew A.,9999,0,9999,0
1668430832150,ECE 200,014,103599,Hsueh; Tzu-Chien,9999,0,9999,0
1668430832150,ECE 200,015,103600,Javidi; Tara,9999,0,9999,0
1668430832150,ECE 200,016,103601,Kahng; Andrew Byun,9999,0,9999,0
1668430832150,ECE 200,017,103602,Kim; Young-Han,9999,0,9999,0
1668430832150,ECE 200,018,103603,Koushanfar; Farinaz,9999,0,9999,0
1668430832150,ECE 200,019,103604,Kuzum; Duygu,9999,0,9999,0
1668430832150,ECE 200,020,103605,Le; Hanh-Phuc,9999,0,9999,0
1668430832150,ECE 200,021,103606,Lin; Bill,9999,0,9999,0
1668430832150,ECE 200,022,103607,Liu; Zhaowei,9998,0,9999,1
1668430832150,ECE 200,023,103608,Lo; Yu-Hwa,9999,0,9999,0
1668430832150,ECE 200,024,103609,Lomakin; Vitaliy,9999,0,9999,0
1668430832150,ECE 200,025,103610,Mercier; Patrick Philip,9999,0,9999,0
1668430832150,ECE 200,026,103611,Meyer; Florian,9999,0,9999,0
1668430832150,ECE 200,027,103612,Milstein; Laurence B.,9999,0,9999,0
1668430832150,ECE 200,028,103613,Mir Arabbaygi; Siavash,9999,0,9999,0
1668430832150,ECE 200,029,103614,Mookherjea; Shayan,9999,0,9999,0
1668430832150,ECE 200,030,103615,Morris; Karcher William,9999,0,9999,0
1668430832150,ECE 200,031,103616,Ng; Tse Nga,9999,0,9999,0
1668430832150,ECE 200,032,103617,Nguyen; Truong Quang,9999,0,9999,0
1668430832150,ECE 200,033,103618,Nomura; Kenji,9999,0,9999,0
1668430832150,ECE 200,034,103619,Orlitsky; Alon,9999,0,9999,0
1668430832150,ECE 200,035,103620,Pal; Piya,9999,0,9999,0
1668430832150,ECE 200,036,103621,Papen; George C.,9999,0,9999,0
1668430832150,ECE 200,037,103622,Radic; Stojan,9999,0,9999,0
1668430832150,ECE 200,038,103623,Rao; Bhaskar D.,9999,0,9999,0
1668430832150,ECE 200,039,103624,Rao; Ramesh R,9999,0,9999,0
1668430832150,ECE 200,040,103625,Rebeiz; Gabriel,9999,0,9999,0
1668430832150,ECE 200,041,103626,Sanford; John R,9999,0,9999,0
1668430832150,ECE 200,042,103627,Siegel; Paul H.,9999,0,9999,0
1668430832150,ECE 200,043,103628,Sievenpiper; Daniel F.,9999,0,9999,0
1668430832150,ECE 200,044,103629,Sworder; David D.,9999,0,9999,0
1668430832150,ECE 200,045,103630,Taur; Yuan,9999,0,9999,0
1668430832150,ECE 200,046,103631,Touri; Behrouz,9999,0,9999,0
1668430832150,ECE 200,047,103632,Trivedi; Mohan M.,9999,0,9999,0
1668430832150,ECE 200,048,103633,Vasconcelos; Nuno,9999,0,9999,0
1668430832150,ECE 200,049,103634,Wang; Xiaolong,9999,0,9999,0
1668430832150,ECE 200,050,103635,Xie; Pengtao,9999,0,9999,0
1668430832150,ECE 200,051,103636,Yip; Michael,9999,0,9999,0
1668430832150,ECE 200,052,103637,Zeger; Kenneth A.,999,0,999,0
1668430832150,ECE 200,053,103638,Zhang; Xinyu,9999,0,9999,0
1668430832150,ECE 200,054,103639,Turakhia; Yatish Girish,9999,0,9999,0
1668430832150,ECE 200,055,103640,Kang; Mingu,9999,0,9999,0
1668430832150,ECE 200,056,103641,Shi; Yuanyuan,9999,0,9999,0
1668430832150,ECE 200,057,103642,Wang; Edward Jay,9999,0,9999,0
1668430832150,ECE 200,058,103643,Zheng; Yang,9999,0,9999,0
1668430832574,ECE 202,A00,103644,Kuzum; Duygu,0,21,0,0
1668430832998,ECE 212BN,A00,103646,Ng; Tse Nga,0,1,0,0
1668430833426,ECE 221,A00,111493,Staff,0,0,0,0
1668430833849,ECE 222B,A00,103647,Lomakin; Vitaliy,0,5,0,0
1668430834275,ECE 230B,A00,103648,Taur; Yuan,0,0,0,0
1668430834700,ECE 238B,A00,103649,Garay; Javier,0,0,0,0
1668430835124,ECE 240B,A00,112900,Fainman; Yeshaiahu,0,4,0,0
1668430835549,ECE 247A,A00,103650,Jokerst; Jesse Vincent,0,1,0,0
1668430835974,ECE 247B,A00,103651,Wang; Joseph,0,4,0,0
1668430836411,ECE 250,A00,103652,Siegel; Paul H.,0,42,0,0
1668430836849,ECE 251A,A00,103654,Rao; Bhaskar D.,0,29,0,0
1668430837273,ECE 257B,A00,103655,Bharadia; Dinesh,0,12,0,0
1668430837697,ECE 258A,A00,103656,Milstein; Laurence B.,0,10,0,0
1668430838121,ECE 260B,A00,103658,Kang; Mingu,0,64,0,0
1668430838545,ECE 264A,A00,103659,Galton; Ian A,0,32,0,0
1668430838973,ECE 265A,A00,103661,Gudem; Prasad S.S.,0,17,0,0
1668430839396,ECE 265D,A00,103662,Gudem; Prasad S.S.,0,11,0,0
1668430839824,ECE 268,A00,103663,Koushanfar; Farinaz,0,18,0,0
1668430840332,ECE 269,A01,103665,Pal; Piya,0,126,0,0
1668430840776,ECE 271B,A00,103666,Vasconcelos; Manuela,0,46,0,0
1668430841200,ECE 276A,A00,103667,Atanasov; Nikolay A.,0,67,0,0
1668430841626,ECE 277,A00,103668,An; Cheolhong,0,87,0,0
1668430842054,ECE 279,A00,117947,Hall; Drew A.,0,12,0,0
1668430842907,ECE 283,A00,103670,Hsueh; Tzu-Chien,0,23,0,0
1668430843333,ECE 284,A00,103671,Turakhia; Yatish Girish,0,22,0,0
1668430843763,ECE 285,A00,103672,Zheng; Yang,0,22,0,0
1668430843763,ECE 285,B00,103673,Sworder; David D.,0,36,0,0
1668430844189,ECE 287,A00,103676,Javidi; Tara,0,4,0,0
1668430844613,MATH 200B,A00,098023,Salehi Golsefidy; Alireza,12,0,15,3
1668430845041,MATH 202B,A00,098024,Rhoades; Brendon Patrick,9,0,15,6
1668430845467,MATH 203B,A00,098025,Oprea; Dragos N.,10,0,15,5
1668430845889,MATH 204B,A00,098026,Sorensen; Claus M,13,0,15,2
1668430846316,MATH 208,A00,098027,Izadi; Elham,7,0,10,3
1668430846744,MATH 209,A00,098028,Pollack; Aaron,10,0,10,0
1668430847167,MATH 211A,A00,112919,Rogalski; Daniel,9,0,10,1
1668430847594,MATH 211B,A00,112920,Seward; Brandon M.,9,0,10,1
1668430848022,MATH 218,A00,098029,Li; Bo,10,0,10,0
1668430848449,MATH 220B,A00,098030,Novak; Jonathan I,11,0,15,4
1668430848878,MATH 221A,A00,098031,Ebenfelt; Peter F,13,0,15,2
1668430849304,MATH 231B,A00,098032,Zlatos; Andrej,12,0,15,3
1668430849734,MATH 240B,A00,098033,Ni; Lei,9,0,15,6
1668430850161,MATH 243,A00,098034,Jekel; David Andrew,10,0,10,0
1668430850588,MATH 245A,A00,098035,Nie; Jiawang,0,1,15,16
1668430851011,MATH 248,A00,098036,Bejenaru; Ioan,10,0,10,0
1668430851441,MATH 250B,A00,098037,Spolaor; Luca,14,0,15,1
1668430851868,MATH 258,A00,098038,Ni; Lei,10,0,10,0
1668430852293,MATH 264B,A00,098041,Rhoades; Brendon Patrick,9,0,15,6
1668430852716,MATH 268,A00,098042,Buss; Samuel R,10,0,10,0
1668430853142,MATH 269,A00,098043,Rhoades; Brendon Patrick,10,0,10,0
1668430853566,MATH 270B,A00,098044,Li; Bo,10,0,15,5
1668430853993,MATH 272B,A00,098045,Holst; Michael J,13,0,15,2
1668430854426,MATH 273A,A00,098046,Tian; Xiaochuan,10,0,15,5
1668430854852,MATH 275,A01,098048,Tian; Xiaochuan,6,0,10,4
1668430855274,MATH 278A,A00,098049,Holst; Michael J,8,0,10,2
1668430855701,MATH 278B,A00,098050,Cloninger; Alexander,10,0,10,0
1668430856150,MATH 278C,A00,098051,Nie; Jiawang,6,0,10,4
1668430856578,MATH 280B,A00,098052,Zheng; Tianyi,8,0,15,7
1668430857005,MATH 281B,A00,098053,Bradic; Jelena,0,1,15,15
1668430857429,MATH 282B,A00,098054,Arias-Castro; Ery,0,0,15,15
1668430857854,MATH 285,A00,098055,Fitzsimmons; Patrick J,0,0,15,17
1668430858282,MATH 287B,A00,098056,Arias-Castro; Ery,2,0,15,13
1668430858706,MATH 288,A00,098057,Agarwal; Pooja,9,0,10,1
1668430858706,MATH 288,B00,098058,Zhang; Danna,8,0,10,2
1668430858706,MATH 288,C00,098059,Williams; Ruth J,9,0,10,1
1668430859134,MATH 290B,A00,098060,Roberts; Justin Deritter,13,0,15,2
1668430859558,MATH 292,A00,098061,Belmont; Eva Kinoshita,10,0,10,0
1668430859997,MATH 295,A00,098062,Suk; Andrew Hoon,48,0,50,2
1668430860425,MATH 296,A00,098063,Novak; Jonathan I,20,0,20,0
1668430860857,MATH 297,001,098064,Gamst; Anthony Collins,9997,0,9999,2
1668431362033,COGS 205,A00,101395,Chiba; Andrea,19,0,20,1
1668431362458,COGS 210B,001,101404,Greene; Deanna Jacquelyn,9998,0,9999,1
1668431362458,COGS 210B,002,101417,Xia; Haijun,9999,0,9999,0
1668431362458,COGS 210B,003,101422,Nitz; Douglas A.,9999,0,9999,0
1668431362458,COGS 210B,004,101423,Hollan; James D.,9998,0,9999,1
1668431362458,COGS 210B,005,101424,Deak; Gedeon O.,9998,0,9999,1
1668431362458,COGS 210B,006,101425,Rossano; Federico,9999,0,9999,0
1668431362885,COGS 211B,A00,101427,Coulson; Seana M,9996,0,9999,3
1668431363311,COGS 220,A00,101428,Hollan; James D.,1,2,25,24
1668431363742,COGS 229,A00,101429,Dow; Steven P,18,0,25,7
1668431364166,COGS 230,A00,101430,Klemmer; Scott R,11,0,17,6
1668431364589,COGS 234,A00,101431,Xia; Haijun,2,0,25,23
1668431365013,COGS 260,A00,101432,Kiyonaga; Anastasia,21,0,25,4
1668431365013,COGS 260,B00,101433,Kirsh; David Joel,15,0,25,10
1668431365440,CSE 202,A00,102371,Impagliazzo; Russell,0,32,0,0
1668431365867,CSE 203B,A01,102373,Cheng; Chung Kuan,0,25,0,0
1668431366291,CSE 208,A00,102374,Micciancio; Daniele,0,1,0,0
1668431366714,CSE 209A,A00,112895,Impagliazzo; Russell,0,3,15,15
1668431367142,CSE 209B,A00,108005,Bellare; Mihir,0,3,0,0
1668431367566,CSE 210,A00,113163,Coblenz; Michael J,0,41,0,0
1668431367991,CSE 219,A00,106111,Dow; Steven P,0,0,20,20
1668431368415,CSE 221,A00,102376,Voelker; Geoffrey M.,0,29,0,0
1668431368841,CSE 224,A01,102378,Porter; George M,0,103,0,0
1668431369264,CSE 229A,A00,102379,Savage; Stefan,0,4,0,0
1668431369688,CSE 229C,A00,102380,Munyaka; Imani N. S.,0,4,0,0
1668431370111,CSE 232B,A00,102382,Deutsch; Alin Bernard,0,13,0,0
1668431370538,CSE 234,A01,112904,Kumar; Arun Kumar,0,0,0,0
1668431370965,CSE 237A,A00,102383,Rosing; Tajana Simunic,0,25,0,0
1668431371394,CSE 239A,A00,102384,Deutsch; Alin Bernard,0,5,0,0
1668431371820,CSE 239B,A00,102385,Polikarpova; Nadezhda,0,3,0,0
1668431372256,CSE 240A,A00,102386,Pannuto; Patrick William,0,25,0,0
1668431372679,CSE 240B,A00,102387,Zhao; Jishen,0,23,0,0
1668431373102,CSE 241A,A00,106406,Kang; Mingu,0,2,0,0
1668431373525,CSE 249B,A00,102388,Kahng; Andrew Byun,0,1,8,8
1668431373955,CSE 251B,A01,102392,Cottrell; Garrison W,0,22,0,0
1668431373955,CSE 251B,A02,102393,Cottrell; Garrison W,0,21,0,0
1668431374380,CSE 252B,A00,102394,Ochoa; Benjamin Lawrence,0,37,0,0
1668431374814,CSE 257,A01,102396,Gao; Sicun,0,86,0,0
1668431375238,CSE 272,A00,102397,Li; Tzumao,0,7,0,0
1668431375664,CSE 274,A00,111323,Chern; Albert Ren-Haur,0,7,0,0
1668431376089,CSE 282,A00,102398,Pevzner; Pavel Arkadjevich,0,0,0,0
1668431376512,CSE 284,A00,114175,Gymrek; Melissa Ann,0,11,0,0
1668431376940,CSE 290,A00,102399,Chandraker; Manmohan Krishna,0,4,0,0
1668431376940,CSE 290,B00,102400,Vaccaro; Kristen Marie,0,1,25,25
1668431376940,CSE 290,C00,102414,Pannuto; Patrick William,0,1,25,25
1668431376940,CSE 290,D00,102427,Pevzner; Pavel Arkadjevich,0,0,0,0
1668431376940,CSE 290,E00,102429,Zhao; Jishen,0,1,0,0
1668431376940,CSE 290,F00,102436,Tullsen; Dean Michael,0,2,0,0
1668431376940,CSE 290,G00,102440,Christensen; Henrik I,0,3,20,20
1668431377366,CSE 291,A00,102443,Su; Hao,0,0,0,0
1668431377366,CSE 291,B00,102448,Polikarpova; Nadezhda,0,0,0,0
1668431377366,CSE 291,C00,102453,Vaccaro; Kristen Marie,0,0,0,0
1668431377366,CSE 291,D00,111343,Savage; Stefan,0,0,0,0
1668431377366,CSE 291,E00,116474,Claffy; Kimberly Claire,0,0,0,0
1668431377366,CSE 291,F00,116479,Pasquale; Joseph,0,0,0,0
1668431377804,CSE 293,001,119111,Bafna; Vineet,9999,0,9999,0
1668431377804,CSE 293,002,119118,Bellare; Mihir,9999,0,9999,0
1668431377804,CSE 293,003,119122,Berg-Kirkpatrick; Taylor D,9999,0,9999,0
1668431377804,CSE 293,004,119135,Christensen; Henrik I,9999,0,9999,0
1668431377804,CSE 293,005,119142,Cottrell; Garrison W,9999,0,9999,0
1668431377804,CSE 293,006,119146,Deutsch; Alin Bernard,9999,0,9999,0
1668431377804,CSE 293,007,119159,Esmaeilzadeh; Hadi,9999,0,9999,0
1668431377804,CSE 293,008,119166,Freund; Yoav,9999,0,9999,0
1668431377804,CSE 293,009,119170,Griswold; William G.,9999,0,9999,0
1668431377804,CSE 293,010,119183,Gymrek; Melissa Ann,9999,0,9999,0
1668431377804,CSE 293,011,119190,Heninger; Nadia A,9999,0,9999,0
1668431377804,CSE 293,012,119230,Impagliazzo; Russell,9999,0,9999,0
1668431377804,CSE 293,013,119232,Jhala; Ranjit,9999,0,9999,0
1668431377804,CSE 293,014,119233,Kahng; Andrew Byun,9999,0,9999,0
1668431377804,CSE 293,015,119298,Kane; Daniel Mertz,9999,0,9999,0
1668431377804,CSE 293,016,119299,Kriegman; David J,9999,0,9999,0
1668431377804,CSE 293,017,119300,Kumar; Arun Kumar,9999,0,9999,0
1668431377804,CSE 293,018,119301,Lerner; Sorin,9999,0,9999,0
1668431377804,CSE 293,019,119302,Lovett; Shachar,9999,0,9999,0
1668431377804,CSE 293,020,119303,McAuley; Julian John,9999,0,9999,0
1668431377804,CSE 293,021,119304,Micciancio; Daniele,9999,0,9999,0
1668431377804,CSE 293,022,119367,Orailoglu; Alex,9999,0,9999,0
1668431377804,CSE 293,023,119382,Paturi; Ramamohan,9999,0,9999,0
1668431377804,CSE 293,024,119404,Polikarpova; Nadezhda,9999,0,9999,0
1668431377804,CSE 293,025,119406,Politz; Joseph Gibbs,9999,0,9999,0
1668431377804,CSE 293,026,119411,Porter; George M,9999,0,9999,0
1668431377804,CSE 293,027,119414,Porter; Leonard Emerson,9999,0,9999,0
1668431377804,CSE 293,028,119416,Ramamoorthi; Ravi,9999,0,9999,0
1668431377804,CSE 293,029,119417,Sahoo; Debashis,9999,0,9999,0
1668431377804,CSE 293,030,119420,Saul; Lawrence,9999,0,9999,0
1668431377804,CSE 293,031,119421,Savage; Stefan,9999,0,9999,0
1668431377804,CSE 293,032,119425,Schulze; Jurgen P.,9999,0,9999,0
1668431377804,CSE 293,033,119426,Snoeren; Alex C.,9999,0,9999,0
1668431377804,CSE 293,034,119428,Shang; Jingbo,9999,0,9999,0
1668431377804,CSE 293,035,119430,Stefan; Deian,9999,0,9999,0
1668431377804,CSE 293,036,119431,Su; Hao,9999,0,9999,0
1668431377804,CSE 293,037,119433,Swanson; Steven James,9999,0,9999,0
1668431377804,CSE 293,038,119435,Tullsen; Dean Michael,9999,0,9999,0
1668431377804,CSE 293,039,119483,Voelker; Geoffrey M.,9999,0,9999,0
1668431377804,CSE 293,040,119537,Zhao; Jishen,9999,0,9999,0
1668431377804,CSE 293,041,119538,Zhou; Yuan-Yuan,9999,0,9999,0
1668431377804,CSE 293,042,119539,Gao; Sicun,9999,0,9999,0
1668431377804,CSE 293,043,119540,Weibel; Nadir,9999,0,9999,0
1668431377804,CSE 293,044,119541,Gupta; Rajesh K.,9999,0,9999,0
1668431377804,CSE 293,045,126410,Vaccaro; Kristen Marie,9999,0,9999,0
1668431377804,CSE 293,046,126411,Klemke; Richard,9999,0,9999,0
1668431378230,CSE 294,A00,102459,Voelker; Geoffrey M.,0,1,0,0
1668431378230,CSE 294,B00,111322,Orailoglu; Alex,0,0,0,0
1668431378657,DSE 201,A00,096914,Deutsch; Alin Bernard,30,0,30,0
1668431379082,DSE 210,A00,096915,Dasgupta; Sanjoy,30,0,30,0
1668431379506,DSE 260A,A00,096916,Altintas De Callaf; Ilkay,30,0,30,0
1668431379939,ECE 200,001,103586,Antipa; Nicholas A,9999,0,9999,0
1668431379939,ECE 200,002,103587,Atanasov; Nikolay A.,9999,0,9999,0
1668431379939,ECE 200,003,103588,Bharadia; Dinesh,9999,0,9999,0
1668431379939,ECE 200,004,103589,Cheng; Chung Kuan,9999,0,9999,0
1668431379939,ECE 200,005,103590,Cosman; Pamela C.,9999,0,9999,0
1668431379939,ECE 200,006,103591,Dayeh; Shadi Ahmad,9999,0,9999,0
1668431379939,ECE 200,007,103592,Fainman; Yeshaiahu,9999,0,9999,0
1668431379939,ECE 200,008,103593,Ford; Joseph Earl,9999,0,9999,0
1668431379939,ECE 200,009,103594,Franceschetti; Massimo,9999,0,9999,0
1668431379939,ECE 200,010,103595,Fullerton; Eric E,9999,0,9999,0
1668431379939,ECE 200,011,103596,Galton; Ian A,9999,0,9999,0
1668431379939,ECE 200,012,103597,Gilja; Vikash,9999,0,9999,0
1668431379939,ECE 200,013,103598,Hall; Drew A.,9999,0,9999,0
1668431379939,ECE 200,014,103599,Hsueh; Tzu-Chien,9999,0,9999,0
1668431379939,ECE 200,015,103600,Javidi; Tara,9999,0,9999,0
1668431379939,ECE 200,016,103601,Kahng; Andrew Byun,9999,0,9999,0
1668431379939,ECE 200,017,103602,Kim; Young-Han,9999,0,9999,0
1668431379939,ECE 200,018,103603,Koushanfar; Farinaz,9999,0,9999,0
1668431379939,ECE 200,019,103604,Kuzum; Duygu,9999,0,9999,0
1668431379939,ECE 200,020,103605,Le; Hanh-Phuc,9999,0,9999,0
1668431379939,ECE 200,021,103606,Lin; Bill,9999,0,9999,0
1668431379939,ECE 200,022,103607,Liu; Zhaowei,9998,0,9999,1
1668431379939,ECE 200,023,103608,Lo; Yu-Hwa,9999,0,9999,0
1668431379939,ECE 200,024,103609,Lomakin; Vitaliy,9999,0,9999,0
1668431379939,ECE 200,025,103610,Mercier; Patrick Philip,9999,0,9999,0
1668431379939,ECE 200,026,103611,Meyer; Florian,9999,0,9999,0
1668431379939,ECE 200,027,103612,Milstein; Laurence B.,9999,0,9999,0
1668431379939,ECE 200,028,103613,Mir Arabbaygi; Siavash,9999,0,9999,0
1668431379939,ECE 200,029,103614,Mookherjea; Shayan,9999,0,9999,0
1668431379939,ECE 200,030,103615,Morris; Karcher William,9999,0,9999,0
1668431379939,ECE 200,031,103616,Ng; Tse Nga,9999,0,9999,0
1668431379939,ECE 200,032,103617,Nguyen; Truong Quang,9999,0,9999,0
1668431379939,ECE 200,033,103618,Nomura; Kenji,9999,0,9999,0
1668431379939,ECE 200,034,103619,Orlitsky; Alon,9999,0,9999,0
1668431379939,ECE 200,035,103620,Pal; Piya,9999,0,9999,0
1668431379939,ECE 200,036,103621,Papen; George C.,9999,0,9999,0
1668431379939,ECE 200,037,103622,Radic; Stojan,9999,0,9999,0
1668431379939,ECE 200,038,103623,Rao; Bhaskar D.,9999,0,9999,0
1668431379939,ECE 200,039,103624,Rao; Ramesh R,9999,0,9999,0
1668431379939,ECE 200,040,103625,Rebeiz; Gabriel,9999,0,9999,0
1668431379939,ECE 200,041,103626,Sanford; John R,9999,0,9999,0
1668431379939,ECE 200,042,103627,Siegel; Paul H.,9999,0,9999,0
1668431379939,ECE 200,043,103628,Sievenpiper; Daniel F.,9999,0,9999,0
1668431379939,ECE 200,044,103629,Sworder; David D.,9999,0,9999,0
1668431379939,ECE 200,045,103630,Taur; Yuan,9999,0,9999,0
1668431379939,ECE 200,046,103631,Touri; Behrouz,9999,0,9999,0
1668431379939,ECE 200,047,103632,Trivedi; Mohan M.,9999,0,9999,0
1668431379939,ECE 200,048,103633,Vasconcelos; Nuno,9999,0,9999,0
1668431379939,ECE 200,049,103634,Wang; Xiaolong,9999,0,9999,0
1668431379939,ECE 200,050,103635,Xie; Pengtao,9999,0,9999,0
1668431379939,ECE 200,051,103636,Yip; Michael,9999,0,9999,0
1668431379939,ECE 200,052,103637,Zeger; Kenneth A.,999,0,999,0
1668431379939,ECE 200,053,103638,Zhang; Xinyu,9999,0,9999,0
1668431379939,ECE 200,054,103639,Turakhia; Yatish Girish,9999,0,9999,0
1668431379939,ECE 200,055,103640,Kang; Mingu,9999,0,9999,0
1668431379939,ECE 200,056,103641,Shi; Yuanyuan,9999,0,9999,0
1668431379939,ECE 200,057,103642,Wang; Edward Jay,9999,0,9999,0
1668431379939,ECE 200,058,103643,Zheng; Yang,9999,0,9999,0
1668431380365,ECE 202,A00,103644,Kuzum; Duygu,0,21,0,0
1668431380789,ECE 212BN,A00,103646,Ng; Tse Nga,0,1,0,0
1668431381212,ECE 221,A00,111493,Staff,0,0,0,0
1668431381635,ECE 222B,A00,103647,Lomakin; Vitaliy,0,5,0,0
1668431382068,ECE 230B,A00,103648,Taur; Yuan,0,0,0,0
1668431382492,ECE 238B,A00,103649,Garay; Javier,0,0,0,0
1668431382917,ECE 240B,A00,112900,Fainman; Yeshaiahu,0,4,0,0
1668431383341,ECE 247A,A00,103650,Jokerst; Jesse Vincent,0,1,0,0
1668431383765,ECE 247B,A00,103651,Wang; Joseph,0,4,0,0
1668431384192,ECE 250,A00,103652,Siegel; Paul H.,0,42,0,0
1668431384619,ECE 251A,A00,103654,Rao; Bhaskar D.,0,29,0,0
1668431385043,ECE 257B,A00,103655,Bharadia; Dinesh,0,12,0,0
1668431385466,ECE 258A,A00,103656,Milstein; Laurence B.,0,10,0,0
1668431385898,ECE 260B,A00,103658,Kang; Mingu,0,64,0,0
1668431386323,ECE 264A,A00,103659,Galton; Ian A,0,32,0,0
1668431386750,ECE 265A,A00,103661,Gudem; Prasad S.S.,0,17,0,0
1668431387177,ECE 265D,A00,103662,Gudem; Prasad S.S.,0,11,0,0
1668431387602,ECE 268,A00,103663,Koushanfar; Farinaz,0,18,0,0
1668431388026,ECE 269,A01,103665,Pal; Piya,0,126,0,0
1668431388455,ECE 271B,A00,103666,Vasconcelos; Manuela,0,46,0,0
1668431388878,ECE 276A,A00,103667,Atanasov; Nikolay A.,0,67,0,0
1668431389302,ECE 277,A00,103668,An; Cheolhong,0,87,0,0
1668431389725,ECE 279,A00,117947,Hall; Drew A.,0,12,0,0
1668431390577,ECE 283,A00,103670,Hsueh; Tzu-Chien,0,23,0,0
1668431391008,ECE 284,A00,103671,Turakhia; Yatish Girish,0,22,0,0
1668431391435,ECE 285,A00,103672,Zheng; Yang,0,22,0,0
1668431391435,ECE 285,B00,103673,Sworder; David D.,0,36,0,0
1668431391865,ECE 287,A00,103676,Javidi; Tara,0,4,0,0
1668431392289,MATH 200B,A00,098023,Salehi Golsefidy; Alireza,12,0,15,3
1668431392713,MATH 202B,A00,098024,Rhoades; Brendon Patrick,9,0,15,6
1668431393140,MATH 203B,A00,098025,Oprea; Dragos N.,10,0,15,5
1668431393567,MATH 204B,A00,098026,Sorensen; Claus M,13,0,15,2
1668431393990,MATH 208,A00,098027,Izadi; Elham,7,0,10,3
1668431394415,MATH 209,A00,098028,Pollack; Aaron,10,0,10,0
1668431394840,MATH 211A,A00,112919,Rogalski; Daniel,9,0,10,1
1668431395264,MATH 211B,A00,112920,Seward; Brandon M.,9,0,10,1
1668431395688,MATH 218,A00,098029,Li; Bo,10,0,10,0
1668431396114,MATH 220B,A00,098030,Novak; Jonathan I,11,0,15,4
1668431396536,MATH 221A,A00,098031,Ebenfelt; Peter F,13,0,15,2
1668431396960,MATH 231B,A00,098032,Zlatos; Andrej,12,0,15,3
1668431397387,MATH 240B,A00,098033,Ni; Lei,9,0,15,6
1668431397818,MATH 243,A00,098034,Jekel; David Andrew,10,0,10,0
1668431398256,MATH 245A,A00,098035,Nie; Jiawang,0,1,15,16
1668431398680,MATH 248,A00,098036,Bejenaru; Ioan,10,0,10,0
1668431399108,MATH 250B,A00,098037,Spolaor; Luca,14,0,15,1
1668431399534,MATH 258,A00,098038,Ni; Lei,10,0,10,0
1668431399960,MATH 264B,A00,098041,Rhoades; Brendon Patrick,9,0,15,6
1668431400392,MATH 268,A00,098042,Buss; Samuel R,10,0,10,0
1668431400816,MATH 269,A00,098043,Rhoades; Brendon Patrick,10,0,10,0
1668431401240,MATH 270B,A00,098044,Li; Bo,10,0,15,5
1668431401664,MATH 272B,A00,098045,Holst; Michael J,13,0,15,2
1668431402090,MATH 273A,A00,098046,Tian; Xiaochuan,10,0,15,5
1668431402520,MATH 275,A01,098048,Tian; Xiaochuan,6,0,10,4
1668431402944,MATH 278A,A00,098049,Holst; Michael J,8,0,10,2
1668431403369,MATH 278B,A00,098050,Cloninger; Alexander,10,0,10,0
1668431403792,MATH 278C,A00,098051,Nie; Jiawang,6,0,10,4
1668431404226,MATH 280B,A00,098052,Zheng; Tianyi,8,0,15,7
1668431404742,MATH 281B,A00,098053,Bradic; Jelena,0,1,15,15
1668431405166,MATH 282B,A00,098054,Arias-Castro; Ery,0,0,15,15
1668431405589,MATH 285,A00,098055,Fitzsimmons; Patrick J,0,0,15,17
1668431406015,MATH 287B,A00,098056,Arias-Castro; Ery,2,0,15,13
1668431406440,MATH 288,A00,098057,Agarwal; Pooja,9,0,10,1
1668431406440,MATH 288,B00,098058,Zhang; Danna,8,0,10,2
1668431406440,MATH 288,C00,098059,Williams; Ruth J,9,0,10,1
1668431406863,MATH 290B,A00,098060,Roberts; Justin Deritter,13,0,15,2
1668431407290,MATH 292,A00,098061,Belmont; Eva Kinoshita,10,0,10,0
1668431407714,MATH 295,A00,098062,Suk; Andrew Hoon,48,0,50,2
1668431408143,MATH 296,A00,098063,Novak; Jonathan I,20,0,20,0
1668431408567,MATH 297,001,098064,Gamst; Anthony Collins,9997,0,9999,2
1668431908802,COGS 205,A00,101395,Chiba; Andrea,19,0,20,1
1668431909231,COGS 210B,001,101404,Greene; Deanna Jacquelyn,9998,0,9999,1
1668431909231,COGS 210B,002,101417,Xia; Haijun,9999,0,9999,0
1668431909231,COGS 210B,003,101422,Nitz; Douglas A.,9999,0,9999,0
1668431909231,COGS 210B,004,101423,Hollan; James D.,9998,0,9999,1
1668431909231,COGS 210B,005,101424,Deak; Gedeon O.,9998,0,9999,1
1668431909231,COGS 210B,006,101425,Rossano; Federico,9999,0,9999,0
1668431909654,COGS 211B,A00,101427,Coulson; Seana M,9996,0,9999,3
1668431910080,COGS 220,A00,101428,Hollan; James D.,1,2,25,24
1668431910504,COGS 229,A00,101429,Dow; Steven P,18,0,25,7
1668431910928,COGS 230,A00,101430,Klemmer; Scott R,11,0,17,6
1668431911353,COGS 234,A00,101431,Xia; Haijun,2,0,25,23
1668431911786,COGS 260,A00,101432,Kiyonaga; Anastasia,21,0,25,4
1668431911786,COGS 260,B00,101433,Kirsh; David Joel,15,0,25,10
1668431912220,CSE 202,A00,102371,Impagliazzo; Russell,0,32,0,0
1668431912651,CSE 203B,A01,102373,Cheng; Chung Kuan,0,25,0,0
1668431913084,CSE 208,A00,102374,Micciancio; Daniele,0,1,0,0
1668431913512,CSE 209A,A00,112895,Impagliazzo; Russell,0,3,15,15
1668431913935,CSE 209B,A00,108005,Bellare; Mihir,0,3,0,0
1668431914361,CSE 210,A00,113163,Coblenz; Michael J,0,41,0,0
1668431914784,CSE 219,A00,106111,Dow; Steven P,0,0,20,20
1668431915207,CSE 221,A00,102376,Voelker; Geoffrey M.,0,29,0,0
1668431915630,CSE 224,A01,102378,Porter; George M,0,103,0,0
1668431916056,CSE 229A,A00,102379,Savage; Stefan,0,4,0,0
1668431916482,CSE 229C,A00,102380,Munyaka; Imani N. S.,0,4,0,0
1668431916912,CSE 232B,A00,102382,Deutsch; Alin Bernard,0,13,0,0
1668431917345,CSE 234,A01,112904,Kumar; Arun Kumar,0,0,0,0
1668431917769,CSE 237A,A00,102383,Rosing; Tajana Simunic,0,25,0,0
1668431918208,CSE 239A,A00,102384,Deutsch; Alin Bernard,0,5,0,0
1668431918634,CSE 239B,A00,102385,Polikarpova; Nadezhda,0,3,0,0
1668431919058,CSE 240A,A00,102386,Pannuto; Patrick William,0,25,0,0
1668431919485,CSE 240B,A00,102387,Zhao; Jishen,0,23,0,0
1668431919909,CSE 241A,A00,106406,Kang; Mingu,0,2,0,0
1668431920334,CSE 249B,A00,102388,Kahng; Andrew Byun,0,1,8,8
1668431920759,CSE 251B,A01,102392,Cottrell; Garrison W,0,22,0,0
1668431920759,CSE 251B,A02,102393,Cottrell; Garrison W,0,21,0,0
1668431921185,CSE 252B,A00,102394,Ochoa; Benjamin Lawrence,0,37,0,0
1668431921611,CSE 257,A01,102396,Gao; Sicun,0,86,0,0
1668431922043,CSE 272,A00,102397,Li; Tzumao,0,7,0,0
1668431922471,CSE 274,A00,111323,Chern; Albert Ren-Haur,0,7,0,0
1668431922895,CSE 282,A00,102398,Pevzner; Pavel Arkadjevich,0,0,0,0
1668431923319,CSE 284,A00,114175,Gymrek; Melissa Ann,0,11,0,0
1668431923751,CSE 290,A00,102399,Chandraker; Manmohan Krishna,0,4,0,0
1668431923751,CSE 290,B00,102400,Vaccaro; Kristen Marie,0,1,25,25
1668431923751,CSE 290,C00,102414,Pannuto; Patrick William,0,1,25,25
1668431923751,CSE 290,D00,102427,Pevzner; Pavel Arkadjevich,0,0,0,0
1668431923751,CSE 290,E00,102429,Zhao; Jishen,0,1,0,0
1668431923751,CSE 290,F00,102436,Tullsen; Dean Michael,0,2,0,0
1668431923751,CSE 290,G00,102440,Christensen; Henrik I,0,3,20,20
1668431924183,CSE 291,A00,102443,Su; Hao,0,0,0,0
1668431924183,CSE 291,B00,102448,Polikarpova; Nadezhda,0,0,0,0
1668431924183,CSE 291,C00,102453,Vaccaro; Kristen Marie,0,0,0,0
1668431924183,CSE 291,D00,111343,Savage; Stefan,0,0,0,0
1668431924183,CSE 291,E00,116474,Claffy; Kimberly Claire,0,0,0,0
1668431924183,CSE 291,F00,116479,Pasquale; Joseph,0,0,0,0
1668431924636,CSE 293,001,119111,Bafna; Vineet,9999,0,9999,0
1668431924636,CSE 293,002,119118,Bellare; Mihir,9999,0,9999,0
1668431924636,CSE 293,003,119122,Berg-Kirkpatrick; Taylor D,9999,0,9999,0
1668431924636,CSE 293,004,119135,Christensen; Henrik I,9999,0,9999,0
1668431924636,CSE 293,005,119142,Cottrell; Garrison W,9999,0,9999,0
1668431924636,CSE 293,006,119146,Deutsch; Alin Bernard,9999,0,9999,0
1668431924636,CSE 293,007,119159,Esmaeilzadeh; Hadi,9999,0,9999,0
1668431924636,CSE 293,008,119166,Freund; Yoav,9999,0,9999,0
1668431924636,CSE 293,009,119170,Griswold; William G.,9999,0,9999,0
1668431924636,CSE 293,010,119183,Gymrek; Melissa Ann,9999,0,9999,0
1668431924636,CSE 293,011,119190,Heninger; Nadia A,9999,0,9999,0
1668431924636,CSE 293,012,119230,Impagliazzo; Russell,9999,0,9999,0
1668431924636,CSE 293,013,119232,Jhala; Ranjit,9999,0,9999,0
1668431924636,CSE 293,014,119233,Kahng; Andrew Byun,9999,0,9999,0
1668431924636,CSE 293,015,119298,Kane; Daniel Mertz,9999,0,9999,0
1668431924636,CSE 293,016,119299,Kriegman; David J,9999,0,9999,0
1668431924636,CSE 293,017,119300,Kumar; Arun Kumar,9999,0,9999,0
1668431924636,CSE 293,018,119301,Lerner; Sorin,9999,0,9999,0
1668431924636,CSE 293,019,119302,Lovett; Shachar,9999,0,9999,0
1668431924636,CSE 293,020,119303,McAuley; Julian John,9999,0,9999,0
1668431924636,CSE 293,021,119304,Micciancio; Daniele,9999,0,9999,0
1668431924636,CSE 293,022,119367,Orailoglu; Alex,9999,0,9999,0
1668431924636,CSE 293,023,119382,Paturi; Ramamohan,9999,0,9999,0
1668431924636,CSE 293,024,119404,Polikarpova; Nadezhda,9999,0,9999,0
1668431924636,CSE 293,025,119406,Politz; Joseph Gibbs,9999,0,9999,0
1668431924636,CSE 293,026,119411,Porter; George M,9999,0,9999,0
1668431924636,CSE 293,027,119414,Porter; Leonard Emerson,9999,0,9999,0
1668431924636,CSE 293,028,119416,Ramamoorthi; Ravi,9999,0,9999,0
1668431924636,CSE 293,029,119417,Sahoo; Debashis,9999,0,9999,0
1668431924636,CSE 293,030,119420,Saul; Lawrence,9999,0,9999,0
1668431924636,CSE 293,031,119421,Savage; Stefan,9999,0,9999,0
1668431924636,CSE 293,032,119425,Schulze; Jurgen P.,9999,0,9999,0
1668431924636,CSE 293,033,119426,Snoeren; Alex C.,9999,0,9999,0
1668431924636,CSE 293,034,119428,Shang; Jingbo,9999,0,9999,0
1668431924636,CSE 293,035,119430,Stefan; Deian,9999,0,9999,0
1668431924636,CSE 293,036,119431,Su; Hao,9999,0,9999,0
1668431924636,CSE 293,037,119433,Swanson; Steven James,9999,0,9999,0
1668431924636,CSE 293,038,119435,Tullsen; Dean Michael,9999,0,9999,0
1668431924636,CSE 293,039,119483,Voelker; Geoffrey M.,9999,0,9999,0
1668431924636,CSE 293,040,119537,Zhao; Jishen,9999,0,9999,0
1668431924636,CSE 293,041,119538,Zhou; Yuan-Yuan,9999,0,9999,0
1668431924636,CSE 293,042,119539,Gao; Sicun,9999,0,9999,0
1668431924636,CSE 293,043,119540,Weibel; Nadir,9999,0,9999,0
1668431924636,CSE 293,044,119541,Gupta; Rajesh K.,9999,0,9999,0
1668431924636,CSE 293,045,126410,Vaccaro; Kristen Marie,9999,0,9999,0
1668431924636,CSE 293,046,126411,Klemke; Richard,9999,0,9999,0
1668431925157,CSE 294,A00,102459,Voelker; Geoffrey M.,0,1,0,0
1668431925157,CSE 294,B00,111322,Orailoglu; Alex,0,0,0,0
1668431925583,DSE 201,A00,096914,Deutsch; Alin Bernard,30,0,30,0
1668431926009,DSE 210,A00,096915,Dasgupta; Sanjoy,30,0,30,0
1668431926434,DSE 260A,A00,096916,Altintas De Callaf; Ilkay,30,0,30,0
1668431926902,ECE 200,001,103586,Antipa; Nicholas A,9999,0,9999,0
1668431926902,ECE 200,002,103587,Atanasov; Nikolay A.,9999,0,9999,0
1668431926902,ECE 200,003,103588,Bharadia; Dinesh,9999,0,9999,0
1668431926902,ECE 200,004,103589,Cheng; Chung Kuan,9999,0,9999,0
1668431926902,ECE 200,005,103590,Cosman; Pamela C.,9999,0,9999,0
1668431926902,ECE 200,006,103591,Dayeh; Shadi Ahmad,9999,0,9999,0
1668431926902,ECE 200,007,103592,Fainman; Yeshaiahu,9999,0,9999,0
1668431926902,ECE 200,008,103593,Ford; Joseph Earl,9999,0,9999,0
1668431926902,ECE 200,009,103594,Franceschetti; Massimo,9999,0,9999,0
1668431926902,ECE 200,010,103595,Fullerton; Eric E,9999,0,9999,0
1668431926902,ECE 200,011,103596,Galton; Ian A,9999,0,9999,0
1668431926902,ECE 200,012,103597,Gilja; Vikash,9999,0,9999,0
1668431926902,ECE 200,013,103598,Hall; Drew A.,9999,0,9999,0
1668431926902,ECE 200,014,103599,Hsueh; Tzu-Chien,9999,0,9999,0
1668431926902,ECE 200,015,103600,Javidi; Tara,9999,0,9999,0
1668431926902,ECE 200,016,103601,Kahng; Andrew Byun,9999,0,9999,0
1668431926902,ECE 200,017,103602,Kim; Young-Han,9999,0,9999,0
1668431926902,ECE 200,018,103603,Koushanfar; Farinaz,9999,0,9999,0
1668431926902,ECE 200,019,103604,Kuzum; Duygu,9999,0,9999,0
1668431926902,ECE 200,020,103605,Le; Hanh-Phuc,9999,0,9999,0
1668431926902,ECE 200,021,103606,Lin; Bill,9999,0,9999,0
1668431926902,ECE 200,022,103607,Liu; Zhaowei,9998,0,9999,1
1668431926902,ECE 200,023,103608,Lo; Yu-Hwa,9999,0,9999,0
1668431926902,ECE 200,024,103609,Lomakin; Vitaliy,9999,0,9999,0
1668431926902,ECE 200,025,103610,Mercier; Patrick Philip,9999,0,9999,0
1668431926902,ECE 200,026,103611,Meyer; Florian,9999,0,9999,0
1668431926902,ECE 200,027,103612,Milstein; Laurence B.,9999,0,9999,0
1668431926902,ECE 200,028,103613,Mir Arabbaygi; Siavash,9999,0,9999,0
1668431926902,ECE 200,029,103614,Mookherjea; Shayan,9999,0,9999,0
1668431926902,ECE 200,030,103615,Morris; Karcher William,9999,0,9999,0
1668431926902,ECE 200,031,103616,Ng; Tse Nga,9999,0,9999,0
1668431926902,ECE 200,032,103617,Nguyen; Truong Quang,9999,0,9999,0
1668431926902,ECE 200,033,103618,Nomura; Kenji,9999,0,9999,0
1668431926902,ECE 200,034,103619,Orlitsky; Alon,9999,0,9999,0
1668431926902,ECE 200,035,103620,Pal; Piya,9999,0,9999,0
1668431926902,ECE 200,036,103621,Papen; George C.,9999,0,9999,0
1668431926902,ECE 200,037,103622,Radic; Stojan,9999,0,9999,0
1668431926902,ECE 200,038,103623,Rao; Bhaskar D.,9999,0,9999,0
1668431926902,ECE 200,039,103624,Rao; Ramesh R,9999,0,9999,0
1668431926902,ECE 200,040,103625,Rebeiz; Gabriel,9999,0,9999,0
1668431926902,ECE 200,041,103626,Sanford; John R,9999,0,9999,0
1668431926902,ECE 200,042,103627,Siegel; Paul H.,9999,0,9999,0
1668431926902,ECE 200,043,103628,Sievenpiper; Daniel F.,9999,0,9999,0
1668431926902,ECE 200,044,103629,Sworder; David D.,9999,0,9999,0
1668431926902,ECE 200,045,103630,Taur; Yuan,9999,0,9999,0
1668431926902,ECE 200,046,103631,Touri; Behrouz,9999,0,9999,0
1668431926902,ECE 200,047,103632,Trivedi; Mohan M.,9999,0,9999,0
1668431926902,ECE 200,048,103633,Vasconcelos; Nuno,9999,0,9999,0
1668431926902,ECE 200,049,103634,Wang; Xiaolong,9999,0,9999,0
1668431926902,ECE 200,050,103635,Xie; Pengtao,9999,0,9999,0
1668431926902,ECE 200,051,103636,Yip; Michael,9999,0,9999,0
1668431926902,ECE 200,052,103637,Zeger; Kenneth A.,999,0,999,0
1668431926902,ECE 200,053,103638,Zhang; Xinyu,9999,0,9999,0
1668431926902,ECE 200,054,103639,Turakhia; Yatish Girish,9999,0,9999,0
1668431926902,ECE 200,055,103640,Kang; Mingu,9999,0,9999,0
1668431926902,ECE 200,056,103641,Shi; Yuanyuan,9999,0,9999,0
1668431926902,ECE 200,057,103642,Wang; Edward Jay,9999,0,9999,0
1668431926902,ECE 200,058,103643,Zheng; Yang,9999,0,9999,0
1668431927330,ECE 202,A00,103644,Kuzum; Duygu,0,21,0,0
1668431927753,ECE 212BN,A00,103646,Ng; Tse Nga,0,1,0,0
1668431928178,ECE 221,A00,111493,Staff,0,0,0,0
1668431928600,ECE 222B,A00,103647,Lomakin; Vitaliy,0,5,0,0
1668431929029,ECE 230B,A00,103648,Taur; Yuan,0,0,0,0
1668431929455,ECE 238B,A00,103649,Garay; Javier,0,0,0,0
1668431929882,ECE 240B,A00,112900,Fainman; Yeshaiahu,0,4,0,0
1668431930308,ECE 247A,A00,103650,Jokerst; Jesse Vincent,0,1,0,0
1668431930733,ECE 247B,A00,103651,Wang; Joseph,0,4,0,0
1668431931157,ECE 250,A00,103652,Siegel; Paul H.,0,42,0,0
1668431931584,ECE 251A,A00,103654,Rao; Bhaskar D.,0,29,0,0
1668431932007,ECE 257B,A00,103655,Bharadia; Dinesh,0,12,0,0
1668431932434,ECE 258A,A00,103656,Milstein; Laurence B.,0,10,0,0
1668431932860,ECE 260B,A00,103658,Kang; Mingu,0,64,0,0
1668431933283,ECE 264A,A00,103659,Galton; Ian A,0,32,0,0
1668431933709,ECE 265A,A00,103661,Gudem; Prasad S.S.,0,17,0,0
1668431934135,ECE 265D,A00,103662,Gudem; Prasad S.S.,0,11,0,0
1668431934559,ECE 268,A00,103663,Koushanfar; Farinaz,0,18,0,0
1668431934985,ECE 269,A01,103665,Pal; Piya,0,126,0,0
1668431935409,ECE 271B,A00,103666,Vasconcelos; Manuela,0,47,0,0
1668431935833,ECE 276A,A00,103667,Atanasov; Nikolay A.,0,67,0,0
1668431936260,ECE 277,A00,103668,An; Cheolhong,0,87,0,0
1668431936683,ECE 279,A00,117947,Hall; Drew A.,0,12,0,0
1668431937532,ECE 283,A00,103670,Hsueh; Tzu-Chien,0,23,0,0
1668431937956,ECE 284,A00,103671,Turakhia; Yatish Girish,0,22,0,0
1668431938381,ECE 285,A00,103672,Zheng; Yang,0,22,0,0
1668431938381,ECE 285,B00,103673,Sworder; David D.,0,36,0,0
1668431938804,ECE 287,A00,103676,Javidi; Tara,0,4,0,0
1668431939231,MATH 200B,A00,098023,Salehi Golsefidy; Alireza,12,0,15,3
1668431939655,MATH 202B,A00,098024,Rhoades; Brendon Patrick,9,0,15,6
1668431940081,MATH 203B,A00,098025,Oprea; Dragos N.,10,0,15,5
1668431940507,MATH 204B,A00,098026,Sorensen; Claus M,13,0,15,2
1668431940930,MATH 208,A00,098027,Izadi; Elham,7,0,10,3
1668431941355,MATH 209,A00,098028,Pollack; Aaron,10,0,10,0
1668431941791,MATH 211A,A00,112919,Rogalski; Daniel,9,0,10,1
1668431942216,MATH 211B,A00,112920,Seward; Brandon M.,9,0,10,1
1668431942641,MATH 218,A00,098029,Li; Bo,10,0,10,0
1668431943063,MATH 220B,A00,098030,Novak; Jonathan I,11,0,15,4
1668431943487,MATH 221A,A00,098031,Ebenfelt; Peter F,13,0,15,2
1668431943910,MATH 231B,A00,098032,Zlatos; Andrej,12,0,15,3
1668431944339,MATH 240B,A00,098033,Ni; Lei,9,0,15,6
1668431944766,MATH 243,A00,098034,Jekel; David Andrew,10,0,10,0
1668431945193,MATH 245A,A00,098035,Nie; Jiawang,0,1,15,16
1668431945616,MATH 248,A00,098036,Bejenaru; Ioan,10,0,10,0
1668431946038,MATH 250B,A00,098037,Spolaor; Luca,14,0,15,1
1668431946461,MATH 258,A00,098038,Ni; Lei,10,0,10,0
1668431946888,MATH 264B,A00,098041,Rhoades; Brendon Patrick,9,0,15,6
1668431947312,MATH 268,A00,098042,Buss; Samuel R,10,0,10,0
1668431947742,MATH 269,A00,098043,Rhoades; Brendon Patrick,10,0,10,0
1668431948167,MATH 270B,A00,098044,Li; Bo,10,0,15,5
1668431948596,MATH 272B,A00,098045,Holst; Michael J,13,0,15,2
1668431949029,MATH 273A,A00,098046,Tian; Xiaochuan,10,0,15,5
1668431949471,MATH 275,A01,098048,Tian; Xiaochuan,6,0,10,4
1668431949905,MATH 278A,A00,098049,Holst; Michael J,8,0,10,2
1668431950338,MATH 278B,A00,098050,Cloninger; Alexander,10,0,10,0
1668431950774,MATH 278C,A00,098051,Nie; Jiawang,6,0,10,4
1668431951206,MATH 280B,A00,098052,Zheng; Tianyi,8,0,15,7
1668431951632,MATH 281B,A00,098053,Bradic; Jelena,0,1,15,15
1668431952057,MATH 282B,A00,098054,Arias-Castro; Ery,0,0,15,15
1668431952483,MATH 285,A00,098055,Fitzsimmons; Patrick J,0,0,15,17
1668431952909,MATH 287B,A00,098056,Arias-Castro; Ery,2,0,15,13
1668431953332,MATH 288,A00,098057,Agarwal; Pooja,9,0,10,1
1668431953332,MATH 288,B00,098058,Zhang; Danna,8,0,10,2
1668431953332,MATH 288,C00,098059,Williams; Ruth J,9,0,10,1
1668431953755,MATH 290B,A00,098060,Roberts; Justin Deritter,13,0,15,2
1668431954176,MATH 292,A00,098061,Belmont; Eva Kinoshita,10,0,10,0
1668431954600,MATH 295,A00,098062,Suk; Andrew Hoon,48,0,50,2
1668431955022,MATH 296,A00,098063,Novak; Jonathan I,20,0,20,0
1668431955457,MATH 297,001,098064,Gamst; Anthony Collins,9997,0,9999,2
1668432455723,COGS 205,A00,101395,Chiba; Andrea,19,0,20,1
1668432456145,COGS 210B,001,101404,Greene; Deanna Jacquelyn,9998,0,9999,1
1668432456145,COGS 210B,002,101417,Xia; Haijun,9999,0,9999,0
1668432456145,COGS 210B,003,101422,Nitz; Douglas A.,9999,0,9999,0
1668432456145,COGS 210B,004,101423,Hollan; James D.,9998,0,9999,1
1668432456145,COGS 210B,005,101424,Deak; Gedeon O.,9998,0,9999,1
1668432456145,COGS 210B,006,101425,Rossano; Federico,9999,0,9999,0
1668432456568,COGS 211B,A00,101427,Coulson; Seana M,9996,0,9999,3
1668432456995,COGS 220,A00,101428,Hollan; James D.,1,2,25,24
1668432457417,COGS 229,A00,101429,Dow; Steven P,18,0,25,7
1668432457841,COGS 230,A00,101430,Klemmer; Scott R,11,0,17,6
1668432458264,COGS 234,A00,101431,Xia; Haijun,2,0,25,23
1668432458690,COGS 260,A00,101432,Kiyonaga; Anastasia,21,0,25,4
1668432458690,COGS 260,B00,101433,Kirsh; David Joel,15,0,25,10
1668432459117,CSE 202,A00,102371,Impagliazzo; Russell,0,32,0,0
1668432459544,CSE 203B,A01,102373,Cheng; Chung Kuan,0,25,0,0
1668432459978,CSE 208,A00,102374,Micciancio; Daniele,0,1,0,0
1668432460413,CSE 209A,A00,112895,Impagliazzo; Russell,0,3,15,15
1668432460847,CSE 209B,A00,108005,Bellare; Mihir,0,3,0,0
1668432461275,CSE 210,A00,113163,Coblenz; Michael J,0,41,0,0
1668432461713,CSE 219,A00,106111,Dow; Steven P,0,0,20,20
1668432462142,CSE 221,A00,102376,Voelker; Geoffrey M.,0,29,0,0
1668432462579,CSE 224,A01,102378,Porter; George M,0,103,0,0
1668432463002,CSE 229A,A00,102379,Savage; Stefan,0,4,0,0
1668432463432,CSE 229C,A00,102380,Munyaka; Imani N. S.,0,4,0,0
1668432463858,CSE 232B,A00,102382,Deutsch; Alin Bernard,0,14,0,0
1668432464281,CSE 234,A01,112904,Kumar; Arun Kumar,0,0,0,0
1668432464706,CSE 237A,A00,102383,Rosing; Tajana Simunic,0,25,0,0
1668432465128,CSE 239A,A00,102384,Deutsch; Alin Bernard,0,5,0,0
1668432465553,CSE 239B,A00,102385,Polikarpova; Nadezhda,0,3,0,0
1668432465979,CSE 240A,A00,102386,Pannuto; Patrick William,0,25,0,0
1668432466407,CSE 240B,A00,102387,Zhao; Jishen,0,23,0,0
1668432466831,CSE 241A,A00,106406,Kang; Mingu,0,2,0,0
1668432467256,CSE 249B,A00,102388,Kahng; Andrew Byun,0,1,8,8
1668432467685,CSE 251B,A01,102392,Cottrell; Garrison W,0,22,0,0
1668432467685,CSE 251B,A02,102393,Cottrell; Garrison W,0,21,0,0
1668432468108,CSE 252B,A00,102394,Ochoa; Benjamin Lawrence,0,37,0,0
1668432468534,CSE 257,A01,102396,Gao; Sicun,0,86,0,0
1668432468957,CSE 272,A00,102397,Li; Tzumao,0,7,0,0
1668432469381,CSE 274,A00,111323,Chern; Albert Ren-Haur,0,7,0,0
1668432469805,CSE 282,A00,102398,Pevzner; Pavel Arkadjevich,0,0,0,0
1668432470232,CSE 284,A00,114175,Gymrek; Melissa Ann,0,11,0,0
1668432470660,CSE 290,A00,102399,Chandraker; Manmohan Krishna,0,4,0,0
1668432470660,CSE 290,B00,102400,Vaccaro; Kristen Marie,0,1,25,25
1668432470660,CSE 290,C00,102414,Pannuto; Patrick William,0,1,25,25
1668432470660,CSE 290,D00,102427,Pevzner; Pavel Arkadjevich,0,0,0,0
1668432470660,CSE 290,E00,102429,Zhao; Jishen,0,1,0,0
1668432470660,CSE 290,F00,102436,Tullsen; Dean Michael,0,2,0,0
1668432470660,CSE 290,G00,102440,Christensen; Henrik I,0,3,20,20
1668432471084,CSE 291,A00,102443,Su; Hao,0,0,0,0
1668432471084,CSE 291,B00,102448,Polikarpova; Nadezhda,0,0,0,0
1668432471084,CSE 291,C00,102453,Vaccaro; Kristen Marie,0,0,0,0
1668432471084,CSE 291,D00,111343,Savage; Stefan,0,0,0,0
1668432471084,CSE 291,E00,116474,Claffy; Kimberly Claire,0,0,0,0
1668432471084,CSE 291,F00,116479,Pasquale; Joseph,0,0,0,0
1668432471517,CSE 293,001,119111,Bafna; Vineet,9999,0,9999,0
1668432471517,CSE 293,002,119118,Bellare; Mihir,9999,0,9999,0
1668432471517,CSE 293,003,119122,Berg-Kirkpatrick; Taylor D,9999,0,9999,0
1668432471517,CSE 293,004,119135,Christensen; Henrik I,9999,0,9999,0
1668432471517,CSE 293,005,119142,Cottrell; Garrison W,9999,0,9999,0
1668432471517,CSE 293,006,119146,Deutsch; Alin Bernard,9999,0,9999,0
1668432471517,CSE 293,007,119159,Esmaeilzadeh; Hadi,9999,0,9999,0
1668432471517,CSE 293,008,119166,Freund; Yoav,9999,0,9999,0
1668432471517,CSE 293,009,119170,Griswold; William G.,9999,0,9999,0
1668432471517,CSE 293,010,119183,Gymrek; Melissa Ann,9999,0,9999,0
1668432471517,CSE 293,011,119190,Heninger; Nadia A,9999,0,9999,0
1668432471517,CSE 293,012,119230,Impagliazzo; Russell,9999,0,9999,0
1668432471517,CSE 293,013,119232,Jhala; Ranjit,9999,0,9999,0
1668432471517,CSE 293,014,119233,Kahng; Andrew Byun,9999,0,9999,0
1668432471517,CSE 293,015,119298,Kane; Daniel Mertz,9999,0,9999,0
1668432471517,CSE 293,016,119299,Kriegman; David J,9999,0,9999,0
1668432471517,CSE 293,017,119300,Kumar; Arun Kumar,9999,0,9999,0
1668432471517,CSE 293,018,119301,Lerner; Sorin,9999,0,9999,0
1668432471517,CSE 293,019,119302,Lovett; Shachar,9999,0,9999,0
1668432471517,CSE 293,020,119303,McAuley; Julian John,9999,0,9999,0
1668432471517,CSE 293,021,119304,Micciancio; Daniele,9999,0,9999,0
1668432471517,CSE 293,022,119367,Orailoglu; Alex,9999,0,9999,0
1668432471517,CSE 293,023,119382,Paturi; Ramamohan,9999,0,9999,0
1668432471517,CSE 293,024,119404,Polikarpova; Nadezhda,9999,0,9999,0
1668432471517,CSE 293,025,119406,Politz; Joseph Gibbs,9999,0,9999,0
1668432471517,CSE 293,026,119411,Porter; George M,9999,0,9999,0
1668432471517,CSE 293,027,119414,Porter; Leonard Emerson,9999,0,9999,0
1668432471517,CSE 293,028,119416,Ramamoorthi; Ravi,9999,0,9999,0
1668432471517,CSE 293,029,119417,Sahoo; Debashis,9999,0,9999,0
1668432471517,CSE 293,030,119420,Saul; Lawrence,9999,0,9999,0
1668432471517,CSE 293,031,119421,Savage; Stefan,9999,0,9999,0
1668432471517,CSE 293,032,119425,Schulze; Jurgen P.,9999,0,9999,0
1668432471517,CSE 293,033,119426,Snoeren; Alex C.,9999,0,9999,0
1668432471517,CSE 293,034,119428,Shang; Jingbo,9999,0,9999,0
1668432471517,CSE 293,035,119430,Stefan; Deian,9999,0,9999,0
1668432471517,CSE 293,036,119431,Su; Hao,9999,0,9999,0
1668432471517,CSE 293,037,119433,Swanson; Steven James,9999,0,9999,0
1668432471517,CSE 293,038,119435,Tullsen; Dean Michael,9999,0,9999,0
1668432471517,CSE 293,039,119483,Voelker; Geoffrey M.,9999,0,9999,0
1668432471517,CSE 293,040,119537,Zhao; Jishen,9999,0,9999,0
1668432471517,CSE 293,041,119538,Zhou; Yuan-Yuan,9999,0,9999,0
1668432471517,CSE 293,042,119539,Gao; Sicun,9999,0,9999,0
1668432471517,CSE 293,043,119540,Weibel; Nadir,9999,0,9999,0
1668432471517,CSE 293,044,119541,Gupta; Rajesh K.,9999,0,9999,0
1668432471517,CSE 293,045,126410,Vaccaro; Kristen Marie,9999,0,9999,0
1668432471517,CSE 293,046,126411,Klemke; Richard,9999,0,9999,0
1668432471942,CSE 294,A00,102459,Voelker; Geoffrey M.,0,1,0,0
1668432471942,CSE 294,B00,111322,Orailoglu; Alex,0,0,0,0
1668432472367,DSE 201,A00,096914,Deutsch; Alin Bernard,30,0,30,0
1668432472792,DSE 210,A00,096915,Dasgupta; Sanjoy,30,0,30,0
1668432473229,DSE 260A,A00,096916,Altintas De Callaf; Ilkay,30,0,30,0
1668432473657,ECE 200,001,103586,Antipa; Nicholas A,9999,0,9999,0
1668432473657,ECE 200,002,103587,Atanasov; Nikolay A.,9999,0,9999,0
1668432473657,ECE 200,003,103588,Bharadia; Dinesh,9999,0,9999,0
1668432473657,ECE 200,004,103589,Cheng; Chung Kuan,9999,0,9999,0
1668432473657,ECE 200,005,103590,Cosman; Pamela C.,9999,0,9999,0
1668432473657,ECE 200,006,103591,Dayeh; Shadi Ahmad,9999,0,9999,0
1668432473657,ECE 200,007,103592,Fainman; Yeshaiahu,9999,0,9999,0
1668432473657,ECE 200,008,103593,Ford; Joseph Earl,9999,0,9999,0
1668432473657,ECE 200,009,103594,Franceschetti; Massimo,9999,0,9999,0
1668432473657,ECE 200,010,103595,Fullerton; Eric E,9999,0,9999,0
1668432473657,ECE 200,011,103596,Galton; Ian A,9999,0,9999,0
1668432473657,ECE 200,012,103597,Gilja; Vikash,9999,0,9999,0
1668432473657,ECE 200,013,103598,Hall; Drew A.,9999,0,9999,0
1668432473657,ECE 200,014,103599,Hsueh; Tzu-Chien,9999,0,9999,0
1668432473657,ECE 200,015,103600,Javidi; Tara,9999,0,9999,0
1668432473657,ECE 200,016,103601,Kahng; Andrew Byun,9999,0,9999,0
1668432473657,ECE 200,017,103602,Kim; Young-Han,9999,0,9999,0
1668432473657,ECE 200,018,103603,Koushanfar; Farinaz,9999,0,9999,0
1668432473657,ECE 200,019,103604,Kuzum; Duygu,9999,0,9999,0
1668432473657,ECE 200,020,103605,Le; Hanh-Phuc,9999,0,9999,0
1668432473657,ECE 200,021,103606,Lin; Bill,9999,0,9999,0
1668432473657,ECE 200,022,103607,Liu; Zhaowei,9998,0,9999,1
1668432473657,ECE 200,023,103608,Lo; Yu-Hwa,9999,0,9999,0
1668432473657,ECE 200,024,103609,Lomakin; Vitaliy,9999,0,9999,0
1668432473657,ECE 200,025,103610,Mercier; Patrick Philip,9999,0,9999,0
1668432473657,ECE 200,026,103611,Meyer; Florian,9999,0,9999,0
1668432473657,ECE 200,027,103612,Milstein; Laurence B.,9999,0,9999,0
1668432473657,ECE 200,028,103613,Mir Arabbaygi; Siavash,9999,0,9999,0
1668432473657,ECE 200,029,103614,Mookherjea; Shayan,9999,0,9999,0
1668432473657,ECE 200,030,103615,Morris; Karcher William,9999,0,9999,0
1668432473657,ECE 200,031,103616,Ng; Tse Nga,9999,0,9999,0
1668432473657,ECE 200,032,103617,Nguyen; Truong Quang,9999,0,9999,0
1668432473657,ECE 200,033,103618,Nomura; Kenji,9999,0,9999,0
1668432473657,ECE 200,034,103619,Orlitsky; Alon,9999,0,9999,0
1668432473657,ECE 200,035,103620,Pal; Piya,9999,0,9999,0
1668432473657,ECE 200,036,103621,Papen; George C.,9999,0,9999,0
1668432473657,ECE 200,037,103622,Radic; Stojan,9999,0,9999,0
1668432473657,ECE 200,038,103623,Rao; Bhaskar D.,9999,0,9999,0
1668432473657,ECE 200,039,103624,Rao; Ramesh R,9999,0,9999,0
1668432473657,ECE 200,040,103625,Rebeiz; Gabriel,9999,0,9999,0
1668432473657,ECE 200,041,103626,Sanford; John R,9999,0,9999,0
1668432473657,ECE 200,042,103627,Siegel; Paul H.,9999,0,9999,0
1668432473657,ECE 200,043,103628,Sievenpiper; Daniel F.,9999,0,9999,0
1668432473657,ECE 200,044,103629,Sworder; David D.,9999,0,9999,0
1668432473657,ECE 200,045,103630,Taur; Yuan,9999,0,9999,0
1668432473657,ECE 200,046,103631,Touri; Behrouz,9999,0,9999,0
1668432473657,ECE 200,047,103632,Trivedi; Mohan M.,9999,0,9999,0
1668432473657,ECE 200,048,103633,Vasconcelos; Nuno,9999,0,9999,0
1668432473657,ECE 200,049,103634,Wang; Xiaolong,9999,0,9999,0
1668432473657,ECE 200,050,103635,Xie; Pengtao,9999,0,9999,0
1668432473657,ECE 200,051,103636,Yip; Michael,9999,0,9999,0
1668432473657,ECE 200,052,103637,Zeger; Kenneth A.,999,0,999,0
1668432473657,ECE 200,053,103638,Zhang; Xinyu,9999,0,9999,0
1668432473657,ECE 200,054,103639,Turakhia; Yatish Girish,9999,0,9999,0
1668432473657,ECE 200,055,103640,Kang; Mingu,9999,0,9999,0
1668432473657,ECE 200,056,103641,Shi; Yuanyuan,9999,0,9999,0
1668432473657,ECE 200,057,103642,Wang; Edward Jay,9999,0,9999,0
1668432473657,ECE 200,058,103643,Zheng; Yang,9999,0,9999,0
1668432474080,ECE 202,A00,103644,Kuzum; Duygu,0,21,0,0
1668432474509,ECE 212BN,A00,103646,Ng; Tse Nga,0,1,0,0
1668432474935,ECE 221,A00,111493,Staff,0,0,0,0
1668432475361,ECE 222B,A00,103647,Lomakin; Vitaliy,0,5,0,0
1668432475784,ECE 230B,A00,103648,Taur; Yuan,0,0,0,0
1668432476208,ECE 238B,A00,103649,Garay; Javier,0,0,0,0
1668432476633,ECE 240B,A00,112900,Fainman; Yeshaiahu,0,4,0,0
1668432477055,ECE 247A,A00,103650,Jokerst; Jesse Vincent,0,1,0,0
1668432477486,ECE 247B,A00,103651,Wang; Joseph,0,4,0,0
1668432477916,ECE 250,A00,103652,Siegel; Paul H.,0,43,0,0
1668432478343,ECE 251A,A00,103654,Rao; Bhaskar D.,0,29,0,0
1668432478768,ECE 257B,A00,103655,Bharadia; Dinesh,0,12,0,0
1668432479206,ECE 258A,A00,103656,Milstein; Laurence B.,0,10,0,0
1668432479647,ECE 260B,A00,103658,Kang; Mingu,0,64,0,0
1668432480070,ECE 264A,A00,103659,Galton; Ian A,0,32,0,0
1668432480498,ECE 265A,A00,103661,Gudem; Prasad S.S.,0,17,0,0
1668432480922,ECE 265D,A00,103662,Gudem; Prasad S.S.,0,11,0,0
1668432481351,ECE 268,A00,103663,Koushanfar; Farinaz,0,18,0,0
1668432481775,ECE 269,A01,103665,Pal; Piya,0,126,0,0
1668432482215,ECE 271B,A00,103666,Vasconcelos; Manuela,0,47,0,0
1668432482638,ECE 276A,A00,103667,Atanasov; Nikolay A.,0,67,0,0
1668432483067,ECE 277,A00,103668,An; Cheolhong,0,87,0,0
1668432483498,ECE 279,A00,117947,Hall; Drew A.,0,12,0,0
1668432484356,ECE 283,A00,103670,Hsueh; Tzu-Chien,0,23,0,0
1668432484787,ECE 284,A00,103671,Turakhia; Yatish Girish,0,22,0,0
1668432485212,ECE 285,A00,103672,Zheng; Yang,0,23,0,0
1668432485212,ECE 285,B00,103673,Sworder; David D.,0,36,0,0
1668432485636,ECE 287,A00,103676,Javidi; Tara,0,4,0,0
1668432486067,MATH 200B,A00,098023,Salehi Golsefidy; Alireza,12,0,15,3
1668432486494,MATH 202B,A00,098024,Rhoades; Brendon Patrick,9,0,15,6
1668432486922,MATH 203B,A00,098025,Oprea; Dragos N.,10,0,15,5
1668432487348,MATH 204B,A00,098026,Sorensen; Claus M,13,0,15,2
1668432487771,MATH 208,A00,098027,Izadi; Elham,7,0,10,3
1668432488196,MATH 209,A00,098028,Pollack; Aaron,10,0,10,0
1668432488692,MATH 211A,A00,112919,Rogalski; Daniel,9,0,10,1
1668432489117,MATH 211B,A00,112920,Seward; Brandon M.,9,0,10,1
1668432489543,MATH 218,A00,098029,Li; Bo,10,0,10,0
1668432489969,MATH 220B,A00,098030,Novak; Jonathan I,11,0,15,4
1668432490397,MATH 221A,A00,098031,Ebenfelt; Peter F,13,0,15,2
1668432490820,MATH 231B,A00,098032,Zlatos; Andrej,12,0,15,3
1668432491244,MATH 240B,A00,098033,Ni; Lei,9,0,15,6
1668432491670,MATH 243,A00,098034,Jekel; David Andrew,10,0,10,0
1668432492103,MATH 245A,A00,098035,Nie; Jiawang,0,1,15,16
1668432492528,MATH 248,A00,098036,Bejenaru; Ioan,10,0,10,0
1668432492954,MATH 250B,A00,098037,Spolaor; Luca,14,0,15,1
1668432493377,MATH 258,A00,098038,Ni; Lei,10,0,10,0
1668432493803,MATH 264B,A00,098041,Rhoades; Brendon Patrick,9,0,15,6
1668432494231,MATH 268,A00,098042,Buss; Samuel R,10,0,10,0
1668432494656,MATH 269,A00,098043,Rhoades; Brendon Patrick,10,0,10,0
1668432495082,MATH 270B,A00,098044,Li; Bo,10,0,15,5
1668432495522,MATH 272B,A00,098045,Holst; Michael J,13,0,15,2
1668432495945,MATH 273A,A00,098046,Tian; Xiaochuan,10,0,15,5
1668432496368,MATH 275,A01,098048,Tian; Xiaochuan,6,0,10,4
1668432496791,MATH 278A,A00,098049,Holst; Michael J,8,0,10,2
1668432497217,MATH 278B,A00,098050,Cloninger; Alexander,10,0,10,0
1668432497644,MATH 278C,A00,098051,Nie; Jiawang,6,0,10,4
1668432498069,MATH 280B,A00,098052,Zheng; Tianyi,8,0,15,7
1668432498496,MATH 281B,A00,098053,Bradic; Jelena,0,1,15,15
1668432498923,MATH 282B,A00,098054,Arias-Castro; Ery,0,0,15,15
1668432499347,MATH 285,A00,098055,Fitzsimmons; Patrick J,0,0,15,17
1668432499771,MATH 287B,A00,098056,Arias-Castro; Ery,2,0,15,13
1668432500198,MATH 288,A00,098057,Agarwal; Pooja,9,0,10,1
1668432500198,MATH 288,B00,098058,Zhang; Danna,8,0,10,2
1668432500198,MATH 288,C00,098059,Williams; Ruth J,9,0,10,1
1668432500639,MATH 290B,A00,098060,Roberts; Justin Deritter,13,0,15,2
1668432501079,MATH 292,A00,098061,Belmont; Eva Kinoshita,10,0,10,0
1668432501503,MATH 295,A00,098062,Suk; Andrew Hoon,48,0,50,2
1668432501929,MATH 296,A00,098063,Novak; Jonathan I,20,0,20,0
1668432502358,MATH 297,001,098064,Gamst; Anthony Collins,9997,0,9999,2
1668433003009,COGS 205,A00,101395,Chiba; Andrea,19,0,20,1
1668433003432,COGS 210B,001,101404,Greene; Deanna Jacquelyn,9998,0,9999,1
1668433003432,COGS 210B,002,101417,Xia; Haijun,9999,0,9999,0
1668433003432,COGS 210B,003,101422,Nitz; Douglas A.,9999,0,9999,0
1668433003432,COGS 210B,004,101423,Hollan; James D.,9998,0,9999,1
1668433003432,COGS 210B,005,101424,Deak; Gedeon O.,9998,0,9999,1
1668433003432,COGS 210B,006,101425,Rossano; Federico,9999,0,9999,0
1668433003856,COGS 211B,A00,101427,Coulson; Seana M,9996,0,9999,3
1668433004280,COGS 220,A00,101428,Hollan; James D.,1,2,25,24
1668433004709,COGS 229,A00,101429,Dow; Steven P,18,0,25,7
1668433005133,COGS 230,A00,101430,Klemmer; Scott R,11,0,17,6
1668433005556,COGS 234,A00,101431,Xia; Haijun,2,0,25,23
1668433005979,COGS 260,A00,101432,Kiyonaga; Anastasia,21,0,25,4
1668433005979,COGS 260,B00,101433,Kirsh; David Joel,15,0,25,10
1668433006403,CSE 202,A00,102371,Impagliazzo; Russell,0,32,0,0
1668433006838,CSE 203B,A01,102373,Cheng; Chung Kuan,0,25,0,0
1668433007266,CSE 208,A00,102374,Micciancio; Daniele,0,1,0,0
1668433007689,CSE 209A,A00,112895,Impagliazzo; Russell,0,3,15,15
1668433008112,CSE 209B,A00,108005,Bellare; Mihir,0,3,0,0
1668433008537,CSE 210,A00,113163,Coblenz; Michael J,0,41,0,0
1668433008963,CSE 219,A00,106111,Dow; Steven P,0,0,20,20
1668433009465,CSE 221,A00,102376,Voelker; Geoffrey M.,0,29,0,0
1668433009898,CSE 224,A01,102378,Porter; George M,0,103,0,0
1668433010322,CSE 229A,A00,102379,Savage; Stefan,0,4,0,0
1668433010743,CSE 229C,A00,102380,Munyaka; Imani N. S.,0,4,0,0
1668433011167,CSE 232B,A00,102382,Deutsch; Alin Bernard,0,14,0,0
1668433011594,CSE 234,A01,112904,Kumar; Arun Kumar,0,0,0,0
1668433012018,CSE 237A,A00,102383,Rosing; Tajana Simunic,0,26,0,0
1668433012443,CSE 239A,A00,102384,Deutsch; Alin Bernard,0,5,0,0
1668433012868,CSE 239B,A00,102385,Polikarpova; Nadezhda,0,3,0,0
1668433013294,CSE 240A,A00,102386,Pannuto; Patrick William,0,26,0,0
1668433013719,CSE 240B,A00,102387,Zhao; Jishen,0,23,0,0
1668433014147,CSE 241A,A00,106406,Kang; Mingu,0,2,0,0
1668433014573,CSE 249B,A00,102388,Kahng; Andrew Byun,0,1,8,8
1668433014999,CSE 251B,A01,102392,Cottrell; Garrison W,0,22,0,0
1668433014999,CSE 251B,A02,102393,Cottrell; Garrison W,0,21,0,0
1668433015429,CSE 252B,A00,102394,Ochoa; Benjamin Lawrence,0,37,0,0
1668433015854,CSE 257,A01,102396,Gao; Sicun,0,86,0,0
1668433016276,CSE 272,A00,102397,Li; Tzumao,0,7,0,0
1668433016701,CSE 274,A00,111323,Chern; Albert Ren-Haur,0,7,0,0
1668433017124,CSE 282,A00,102398,Pevzner; Pavel Arkadjevich,0,0,0,0
1668433017548,CSE 284,A00,114175,Gymrek; Melissa Ann,0,11,0,0
1668433017974,CSE 290,A00,102399,Chandraker; Manmohan Krishna,0,4,0,0
1668433017974,CSE 290,B00,102400,Vaccaro; Kristen Marie,0,1,25,25
1668433017974,CSE 290,C00,102414,Pannuto; Patrick William,0,1,25,25
1668433017974,CSE 290,D00,102427,Pevzner; Pavel Arkadjevich,0,0,0,0
1668433017974,CSE 290,E00,102429,Zhao; Jishen,0,1,0,0
1668433017974,CSE 290,F00,102436,Tullsen; Dean Michael,0,2,0,0
1668433017974,CSE 290,G00,102440,Christensen; Henrik I,0,3,20,20
1668433018410,CSE 291,A00,102443,Su; Hao,0,0,0,0
1668433018410,CSE 291,B00,102448,Polikarpova; Nadezhda,0,0,0,0
1668433018410,CSE 291,C00,102453,Vaccaro; Kristen Marie,0,0,0,0
1668433018410,CSE 291,D00,111343,Savage; Stefan,0,0,0,0
1668433018410,CSE 291,E00,116474,Claffy; Kimberly Claire,0,0,0,0
1668433018410,CSE 291,F00,116479,Pasquale; Joseph,0,0,0,0
1668433018872,CSE 293,001,119111,Bafna; Vineet,9999,0,9999,0
1668433018872,CSE 293,002,119118,Bellare; Mihir,9999,0,9999,0
1668433018872,CSE 293,003,119122,Berg-Kirkpatrick; Taylor D,9999,0,9999,0
1668433018872,CSE 293,004,119135,Christensen; Henrik I,9999,0,9999,0
1668433018872,CSE 293,005,119142,Cottrell; Garrison W,9999,0,9999,0
1668433018872,CSE 293,006,119146,Deutsch; Alin Bernard,9999,0,9999,0
1668433018872,CSE 293,007,119159,Esmaeilzadeh; Hadi,9999,0,9999,0
1668433018872,CSE 293,008,119166,Freund; Yoav,9999,0,9999,0
1668433018872,CSE 293,009,119170,Griswold; William G.,9999,0,9999,0
1668433018872,CSE 293,010,119183,Gymrek; Melissa Ann,9999,0,9999,0
1668433018872,CSE 293,011,119190,Heninger; Nadia A,9999,0,9999,0
1668433018872,CSE 293,012,119230,Impagliazzo; Russell,9999,0,9999,0
1668433018872,CSE 293,013,119232,Jhala; Ranjit,9999,0,9999,0
1668433018872,CSE 293,014,119233,Kahng; Andrew Byun,9999,0,9999,0
1668433018872,CSE 293,015,119298,Kane; Daniel Mertz,9999,0,9999,0
1668433018872,CSE 293,016,119299,Kriegman; David J,9999,0,9999,0
1668433018872,CSE 293,017,119300,Kumar; Arun Kumar,9999,0,9999,0
1668433018872,CSE 293,018,119301,Lerner; Sorin,9999,0,9999,0
1668433018872,CSE 293,019,119302,Lovett; Shachar,9999,0,9999,0
1668433018872,CSE 293,020,119303,McAuley; Julian John,9999,0,9999,0
1668433018872,CSE 293,021,119304,Micciancio; Daniele,9999,0,9999,0
1668433018872,CSE 293,022,119367,Orailoglu; Alex,9999,0,9999,0
1668433018872,CSE 293,023,119382,Paturi; Ramamohan,9999,0,9999,0
1668433018872,CSE 293,024,119404,Polikarpova; Nadezhda,9999,0,9999,0
1668433018872,CSE 293,025,119406,Politz; Joseph Gibbs,9999,0,9999,0
1668433018872,CSE 293,026,119411,Porter; George M,9999,0,9999,0
1668433018872,CSE 293,027,119414,Porter; Leonard Emerson,9999,0,9999,0
1668433018872,CSE 293,028,119416,Ramamoorthi; Ravi,9999,0,9999,0
1668433018872,CSE 293,029,119417,Sahoo; Debashis,9999,0,9999,0
1668433018872,CSE 293,030,119420,Saul; Lawrence,9999,0,9999,0
1668433018872,CSE 293,031,119421,Savage; Stefan,9999,0,9999,0
1668433018872,CSE 293,032,119425,Schulze; Jurgen P.,9999,0,9999,0
1668433018872,CSE 293,033,119426,Snoeren; Alex C.,9999,0,9999,0
1668433018872,CSE 293,034,119428,Shang; Jingbo,9999,0,9999,0
1668433018872,CSE 293,035,119430,Stefan; Deian,9999,0,9999,0
1668433018872,CSE 293,036,119431,Su; Hao,9999,0,9999,0
1668433018872,CSE 293,037,119433,Swanson; Steven James,9999,0,9999,0
1668433018872,CSE 293,038,119435,Tullsen; Dean Michael,9999,0,9999,0
1668433018872,CSE 293,039,119483,Voelker; Geoffrey M.,9999,0,9999,0
1668433018872,CSE 293,040,119537,Zhao; Jishen,9999,0,9999,0
1668433018872,CSE 293,041,119538,Zhou; Yuan-Yuan,9999,0,9999,0
1668433018872,CSE 293,042,119539,Gao; Sicun,9999,0,9999,0
1668433018872,CSE 293,043,119540,Weibel; Nadir,9999,0,9999,0
1668433018872,CSE 293,044,119541,Gupta; Rajesh K.,9999,0,9999,0
1668433018872,CSE 293,045,126410,Vaccaro; Kristen Marie,9999,0,9999,0
1668433018872,CSE 293,046,126411,Klemke; Richard,9999,0,9999,0
1668433019296,CSE 294,A00,102459,Voelker; Geoffrey M.,0,1,0,0
1668433019296,CSE 294,B00,111322,Orailoglu; Alex,0,0,0,0
1668433019722,DSE 201,A00,096914,Deutsch; Alin Bernard,30,0,30,0
1668433020146,DSE 210,A00,096915,Dasgupta; Sanjoy,30,0,30,0
1668433020569,DSE 260A,A00,096916,Altintas De Callaf; Ilkay,30,0,30,0
1668433021005,ECE 200,001,103586,Antipa; Nicholas A,9999,0,9999,0
1668433021005,ECE 200,002,103587,Atanasov; Nikolay A.,9999,0,9999,0
1668433021005,ECE 200,003,103588,Bharadia; Dinesh,9999,0,9999,0
1668433021005,ECE 200,004,103589,Cheng; Chung Kuan,9999,0,9999,0
1668433021005,ECE 200,005,103590,Cosman; Pamela C.,9999,0,9999,0
1668433021005,ECE 200,006,103591,Dayeh; Shadi Ahmad,9999,0,9999,0
1668433021005,ECE 200,007,103592,Fainman; Yeshaiahu,9999,0,9999,0
1668433021005,ECE 200,008,103593,Ford; Joseph Earl,9999,0,9999,0
1668433021005,ECE 200,009,103594,Franceschetti; Massimo,9999,0,9999,0
1668433021005,ECE 200,010,103595,Fullerton; Eric E,9999,0,9999,0
1668433021005,ECE 200,011,103596,Galton; Ian A,9999,0,9999,0
1668433021005,ECE 200,012,103597,Gilja; Vikash,9999,0,9999,0
1668433021005,ECE 200,013,103598,Hall; Drew A.,9999,0,9999,0
1668433021005,ECE 200,014,103599,Hsueh; Tzu-Chien,9999,0,9999,0
1668433021005,ECE 200,015,103600,Javidi; Tara,9999,0,9999,0
1668433021005,ECE 200,016,103601,Kahng; Andrew Byun,9999,0,9999,0
1668433021005,ECE 200,017,103602,Kim; Young-Han,9999,0,9999,0
1668433021005,ECE 200,018,103603,Koushanfar; Farinaz,9999,0,9999,0
1668433021005,ECE 200,019,103604,Kuzum; Duygu,9999,0,9999,0
1668433021005,ECE 200,020,103605,Le; Hanh-Phuc,9999,0,9999,0
1668433021005,ECE 200,021,103606,Lin; Bill,9999,0,9999,0
1668433021005,ECE 200,022,103607,Liu; Zhaowei,9998,0,9999,1
1668433021005,ECE 200,023,103608,Lo; Yu-Hwa,9999,0,9999,0
1668433021005,ECE 200,024,103609,Lomakin; Vitaliy,9999,0,9999,0
1668433021005,ECE 200,025,103610,Mercier; Patrick Philip,9999,0,9999,0
1668433021005,ECE 200,026,103611,Meyer; Florian,9999,0,9999,0
1668433021005,ECE 200,027,103612,Milstein; Laurence B.,9999,0,9999,0
1668433021005,ECE 200,028,103613,Mir Arabbaygi; Siavash,9999,0,9999,0
1668433021005,ECE 200,029,103614,Mookherjea; Shayan,9999,0,9999,0
1668433021005,ECE 200,030,103615,Morris; Karcher William,9999,0,9999,0
1668433021005,ECE 200,031,103616,Ng; Tse Nga,9999,0,9999,0
1668433021005,ECE 200,032,103617,Nguyen; Truong Quang,9999,0,9999,0
1668433021005,ECE 200,033,103618,Nomura; Kenji,9999,0,9999,0
1668433021005,ECE 200,034,103619,Orlitsky; Alon,9999,0,9999,0
1668433021005,ECE 200,035,103620,Pal; Piya,9999,0,9999,0
1668433021005,ECE 200,036,103621,Papen; George C.,9999,0,9999,0
1668433021005,ECE 200,037,103622,Radic; Stojan,9999,0,9999,0
1668433021005,ECE 200,038,103623,Rao; Bhaskar D.,9999,0,9999,0
1668433021005,ECE 200,039,103624,Rao; Ramesh R,9999,0,9999,0
1668433021005,ECE 200,040,103625,Rebeiz; Gabriel,9999,0,9999,0
1668433021005,ECE 200,041,103626,Sanford; John R,9999,0,9999,0
1668433021005,ECE 200,042,103627,Siegel; Paul H.,9999,0,9999,0
1668433021005,ECE 200,043,103628,Sievenpiper; Daniel F.,9999,0,9999,0
1668433021005,ECE 200,044,103629,Sworder; David D.,9999,0,9999,0
1668433021005,ECE 200,045,103630,Taur; Yuan,9999,0,9999,0
1668433021005,ECE 200,046,103631,Touri; Behrouz,9999,0,9999,0
1668433021005,ECE 200,047,103632,Trivedi; Mohan M.,9999,0,9999,0
1668433021005,ECE 200,048,103633,Vasconcelos; Nuno,9999,0,9999,0
1668433021005,ECE 200,049,103634,Wang; Xiaolong,9999,0,9999,0
1668433021005,ECE 200,050,103635,Xie; Pengtao,9999,0,9999,0
1668433021005,ECE 200,051,103636,Yip; Michael,9999,0,9999,0
1668433021005,ECE 200,052,103637,Zeger; Kenneth A.,999,0,999,0
1668433021005,ECE 200,053,103638,Zhang; Xinyu,9999,0,9999,0
1668433021005,ECE 200,054,103639,Turakhia; Yatish Girish,9999,0,9999,0
1668433021005,ECE 200,055,103640,Kang; Mingu,9999,0,9999,0
1668433021005,ECE 200,056,103641,Shi; Yuanyuan,9999,0,9999,0
1668433021005,ECE 200,057,103642,Wang; Edward Jay,9999,0,9999,0
1668433021005,ECE 200,058,103643,Zheng; Yang,9999,0,9999,0
1668433021434,ECE 202,A00,103644,Kuzum; Duygu,0,21,0,0
1668433021862,ECE 212BN,A00,103646,Ng; Tse Nga,0,1,0,0
1668433022289,ECE 221,A00,111493,Staff,0,0,0,0
1668433022716,ECE 222B,A00,103647,Lomakin; Vitaliy,0,5,0,0
1668433023147,ECE 230B,A00,103648,Taur; Yuan,0,0,0,0
1668433023571,ECE 238B,A00,103649,Garay; Javier,0,0,0,0
1668433023996,ECE 240B,A00,112900,Fainman; Yeshaiahu,0,4,0,0
1668433024431,ECE 247A,A00,103650,Jokerst; Jesse Vincent,0,1,0,0
1668433024854,ECE 247B,A00,103651,Wang; Joseph,0,6,0,0
1668433025277,ECE 250,A00,103652,Siegel; Paul H.,0,43,0,0
1668433025700,ECE 251A,A00,103654,Rao; Bhaskar D.,0,29,0,0
1668433026124,ECE 257B,A00,103655,Bharadia; Dinesh,0,12,0,0
1668433026548,ECE 258A,A00,103656,Milstein; Laurence B.,0,10,0,0
1668433026975,ECE 260B,A00,103658,Kang; Mingu,0,65,0,0
1668433027404,ECE 264A,A00,103659,Galton; Ian A,0,32,0,0
1668433027827,ECE 265A,A00,103661,Gudem; Prasad S.S.,0,17,0,0
1668433028250,ECE 265D,A00,103662,Gudem; Prasad S.S.,0,11,0,0
1668433028678,ECE 268,A00,103663,Koushanfar; Farinaz,0,18,0,0
1668433029101,ECE 269,A01,103665,Pal; Piya,0,127,0,0
1668433029524,ECE 271B,A00,103666,Vasconcelos; Manuela,0,47,0,0
1668433029950,ECE 276A,A00,103667,Atanasov; Nikolay A.,0,69,0,0
1668433030375,ECE 277,A00,103668,An; Cheolhong,0,88,0,0
1668433030798,ECE 279,A00,117947,Hall; Drew A.,0,12,0,0
1668433031657,ECE 283,A00,103670,Hsueh; Tzu-Chien,0,23,0,0
1668433032081,ECE 284,A00,103671,Turakhia; Yatish Girish,0,22,0,0
1668433032509,ECE 285,A00,103672,Zheng; Yang,0,24,0,0
1668433032509,ECE 285,B00,103673,Sworder; David D.,0,36,0,0
1668433032934,ECE 287,A00,103676,Javidi; Tara,0,4,0,0
1668433033372,MATH 200B,A00,098023,Salehi Golsefidy; Alireza,12,0,15,3
1668433033800,MATH 202B,A00,098024,Rhoades; Brendon Patrick,9,0,15,6
1668433034228,MATH 203B,A00,098025,Oprea; Dragos N.,10,0,15,5
1668433034652,MATH 204B,A00,098026,Sorensen; Claus M,13,0,15,2
1668433035086,MATH 208,A00,098027,Izadi; Elham,7,0,10,3
1668433035520,MATH 209,A00,098028,Pollack; Aaron,10,0,10,0
1668433035950,MATH 211A,A00,112919,Rogalski; Daniel,9,0,10,1
1668433036374,MATH 211B,A00,112920,Seward; Brandon M.,9,0,10,1
1668433036800,MATH 218,A00,098029,Li; Bo,10,0,10,0
1668433037223,MATH 220B,A00,098030,Novak; Jonathan I,11,0,15,4
1668433037655,MATH 221A,A00,098031,Ebenfelt; Peter F,13,0,15,2
1668433038082,MATH 231B,A00,098032,Zlatos; Andrej,12,0,15,3
1668433038506,MATH 240B,A00,098033,Ni; Lei,9,0,15,6
1668433038932,MATH 243,A00,098034,Jekel; David Andrew,10,0,10,0
1668433039364,MATH 245A,A00,098035,Nie; Jiawang,0,1,15,16
1668433039792,MATH 248,A00,098036,Bejenaru; Ioan,10,0,10,0
1668433040216,MATH 250B,A00,098037,Spolaor; Luca,14,0,15,1
1668433040651,MATH 258,A00,098038,Ni; Lei,10,0,10,0
1668433041075,MATH 264B,A00,098041,Rhoades; Brendon Patrick,9,0,15,6
1668433041503,MATH 268,A00,098042,Buss; Samuel R,10,0,10,0
1668433041943,MATH 269,A00,098043,Rhoades; Brendon Patrick,10,0,10,0
1668433042388,MATH 270B,A00,098044,Li; Bo,10,0,15,5
1668433042829,MATH 272B,A00,098045,Holst; Michael J,13,0,15,2
1668433043271,MATH 273A,A00,098046,Tian; Xiaochuan,10,0,15,5
1668433043699,MATH 275,A01,098048,Tian; Xiaochuan,6,0,10,4
1668433044124,MATH 278A,A00,098049,Holst; Michael J,8,0,10,2
1668433044547,MATH 278B,A00,098050,Cloninger; Alexander,10,0,10,0
1668433044970,MATH 278C,A00,098051,Nie; Jiawang,6,0,10,4
1668433045395,MATH 280B,A00,098052,Zheng; Tianyi,8,0,15,7
1668433045818,MATH 281B,A00,098053,Bradic; Jelena,0,1,15,15
1668433046241,MATH 282B,A00,098054,Arias-Castro; Ery,0,0,15,15
1668433046664,MATH 285,A00,098055,Fitzsimmons; Patrick J,0,0,15,17
1668433047091,MATH 287B,A00,098056,Arias-Castro; Ery,2,0,15,13
1668433047523,MATH 288,A00,098057,Agarwal; Pooja,9,0,10,1
1668433047523,MATH 288,B00,098058,Zhang; Danna,8,0,10,2
1668433047523,MATH 288,C00,098059,Williams; Ruth J,9,0,10,1
1668433047949,MATH 290B,A00,098060,Roberts; Justin Deritter,13,0,15,2
1668433048374,MATH 292,A00,098061,Belmont; Eva Kinoshita,10,0,10,0
1668433048796,MATH 295,A00,098062,Suk; Andrew Hoon,48,0,50,2
1668433049233,MATH 296,A00,098063,Novak; Jonathan I,20,0,20,0
1668433049666,MATH 297,001,098064,Gamst; Anthony Collins,9997,0,9999,2
1668433550510,COGS 205,A00,101395,Chiba; Andrea,19,0,20,1
1668433550940,COGS 210B,001,101404,Greene; Deanna Jacquelyn,9998,0,9999,1
1668433550940,COGS 210B,002,101417,Xia; Haijun,9999,0,9999,0
1668433550940,COGS 210B,003,101422,Nitz; Douglas A.,9999,0,9999,0
1668433550940,COGS 210B,004,101423,Hollan; James D.,9998,0,9999,1
1668433550940,COGS 210B,005,101424,Deak; Gedeon O.,9998,0,9999,1
1668433550940,COGS 210B,006,101425,Rossano; Federico,9999,0,9999,0
1668433551366,COGS 211B,A00,101427,Coulson; Seana M,9996,0,9999,3
1668433551792,COGS 220,A00,101428,Hollan; James D.,1,3,25,24
1668433552222,COGS 229,A00,101429,Dow; Steven P,18,0,25,7
1668433552653,COGS 230,A00,101430,Klemmer; Scott R,11,0,17,6
1668433553093,COGS 234,A00,101431,Xia; Haijun,2,0,25,23
1668433553524,COGS 260,A00,101432,Kiyonaga; Anastasia,21,0,25,4
1668433553524,COGS 260,B00,101433,Kirsh; David Joel,15,0,25,10
1668433553946,CSE 202,A00,102371,Impagliazzo; Russell,0,32,0,0
1668433554370,CSE 203B,A01,102373,Cheng; Chung Kuan,0,25,0,0
1668433554797,CSE 208,A00,102374,Micciancio; Daniele,0,1,0,0
1668433555223,CSE 209A,A00,112895,Impagliazzo; Russell,0,3,15,15
1668433555654,CSE 209B,A00,108005,Bellare; Mihir,0,3,0,0
1668433556079,CSE 210,A00,113163,Coblenz; Michael J,0,41,0,0
1668433556504,CSE 219,A00,106111,Dow; Steven P,0,0,20,20
1668433556931,CSE 221,A00,102376,Voelker; Geoffrey M.,0,29,0,0
1668433557373,CSE 224,A01,102378,Porter; George M,0,103,0,0
1668433557796,CSE 229A,A00,102379,Savage; Stefan,0,4,0,0
1668433558222,CSE 229C,A00,102380,Munyaka; Imani N. S.,0,4,0,0
1668433558646,CSE 232B,A00,102382,Deutsch; Alin Bernard,0,14,0,0
1668433559071,CSE 234,A01,112904,Kumar; Arun Kumar,0,0,0,0
1668433559503,CSE 237A,A00,102383,Rosing; Tajana Simunic,0,26,0,0
1668433559933,CSE 239A,A00,102384,Deutsch; Alin Bernard,0,5,0,0
1668433560358,CSE 239B,A00,102385,Polikarpova; Nadezhda,0,3,0,0
1668433560782,CSE 240A,A00,102386,Pannuto; Patrick William,0,26,0,0
1668433561208,CSE 240B,A00,102387,Zhao; Jishen,0,23,0,0
1668433561633,CSE 241A,A00,106406,Kang; Mingu,0,2,0,0
1668433562059,CSE 249B,A00,102388,Kahng; Andrew Byun,0,1,8,8
1668433562485,CSE 251B,A01,102392,Cottrell; Garrison W,0,22,0,0
1668433562485,CSE 251B,A02,102393,Cottrell; Garrison W,0,21,0,0
1668433562910,CSE 252B,A00,102394,Ochoa; Benjamin Lawrence,0,37,0,0
1668433563341,CSE 257,A01,102396,Gao; Sicun,0,86,0,0
1668433563788,CSE 272,A00,102397,Li; Tzumao,0,7,0,0
1668433564225,CSE 274,A00,111323,Chern; Albert Ren-Haur,0,7,0,0
1668433564650,CSE 282,A00,102398,Pevzner; Pavel Arkadjevich,0,0,0,0
1668433565078,CSE 284,A00,114175,Gymrek; Melissa Ann,0,11,0,0
1668433565504,CSE 290,A00,102399,Chandraker; Manmohan Krishna,0,4,0,0
1668433565504,CSE 290,B00,102400,Vaccaro; Kristen Marie,0,1,25,25
1668433565504,CSE 290,C00,102414,Pannuto; Patrick William,0,1,25,25
1668433565504,CSE 290,D00,102427,Pevzner; Pavel Arkadjevich,0,0,0,0
1668433565504,CSE 290,E00,102429,Zhao; Jishen,0,1,0,0
1668433565504,CSE 290,F00,102436,Tullsen; Dean Michael,0,2,0,0
1668433565504,CSE 290,G00,102440,Christensen; Henrik I,0,3,20,20
1668433565926,CSE 291,A00,102443,Su; Hao,0,0,0,0
1668433565926,CSE 291,B00,102448,Polikarpova; Nadezhda,0,0,0,0
1668433565926,CSE 291,C00,102453,Vaccaro; Kristen Marie,0,0,0,0
1668433565926,CSE 291,D00,111343,Savage; Stefan,0,0,0,0
1668433565926,CSE 291,E00,116474,Claffy; Kimberly Claire,0,0,0,0
1668433565926,CSE 291,F00,116479,Pasquale; Joseph,0,0,0,0
1668433566353,CSE 293,001,119111,Bafna; Vineet,9999,0,9999,0
1668433566353,CSE 293,002,119118,Bellare; Mihir,9999,0,9999,0
1668433566353,CSE 293,003,119122,Berg-Kirkpatrick; Taylor D,9999,0,9999,0
1668433566353,CSE 293,004,119135,Christensen; Henrik I,9999,0,9999,0
1668433566353,CSE 293,005,119142,Cottrell; Garrison W,9999,0,9999,0
1668433566353,CSE 293,006,119146,Deutsch; Alin Bernard,9999,0,9999,0
1668433566353,CSE 293,007,119159,Esmaeilzadeh; Hadi,9999,0,9999,0
1668433566353,CSE 293,008,119166,Freund; Yoav,9999,0,9999,0
1668433566353,CSE 293,009,119170,Griswold; William G.,9999,0,9999,0
1668433566353,CSE 293,010,119183,Gymrek; Melissa Ann,9999,0,9999,0
1668433566353,CSE 293,011,119190,Heninger; Nadia A,9999,0,9999,0
1668433566353,CSE 293,012,119230,Impagliazzo; Russell,9999,0,9999,0
1668433566353,CSE 293,013,119232,Jhala; Ranjit,9999,0,9999,0
1668433566353,CSE 293,014,119233,Kahng; Andrew Byun,9999,0,9999,0
1668433566353,CSE 293,015,119298,Kane; Daniel Mertz,9999,0,9999,0
1668433566353,CSE 293,016,119299,Kriegman; David J,9999,0,9999,0
1668433566353,CSE 293,017,119300,Kumar; Arun Kumar,9999,0,9999,0
1668433566353,CSE 293,018,119301,Lerner; Sorin,9999,0,9999,0
1668433566353,CSE 293,019,119302,Lovett; Shachar,9999,0,9999,0
1668433566353,CSE 293,020,119303,McAuley; Julian John,9999,0,9999,0
1668433566353,CSE 293,021,119304,Micciancio; Daniele,9999,0,9999,0
1668433566353,CSE 293,022,119367,Orailoglu; Alex,9999,0,9999,0
1668433566353,CSE 293,023,119382,Paturi; Ramamohan,9999,0,9999,0
1668433566353,CSE 293,024,119404,Polikarpova; Nadezhda,9999,0,9999,0
1668433566353,CSE 293,025,119406,Politz; Joseph Gibbs,9999,0,9999,0
1668433566353,CSE 293,026,119411,Porter; George M,9999,0,9999,0
1668433566353,CSE 293,027,119414,Porter; Leonard Emerson,9999,0,9999,0
1668433566353,CSE 293,028,119416,Ramamoorthi; Ravi,9999,0,9999,0
1668433566353,CSE 293,029,119417,Sahoo; Debashis,9999,0,9999,0
1668433566353,CSE 293,030,119420,Saul; Lawrence,9999,0,9999,0
1668433566353,CSE 293,031,119421,Savage; Stefan,9999,0,9999,0
1668433566353,CSE 293,032,119425,Schulze; Jurgen P.,9999,0,9999,0
1668433566353,CSE 293,033,119426,Snoeren; Alex C.,9999,0,9999,0
1668433566353,CSE 293,034,119428,Shang; Jingbo,9999,0,9999,0
1668433566353,CSE 293,035,119430,Stefan; Deian,9999,0,9999,0
1668433566353,CSE 293,036,119431,Su; Hao,9999,0,9999,0
1668433566353,CSE 293,037,119433,Swanson; Steven James,9999,0,9999,0
1668433566353,CSE 293,038,119435,Tullsen; Dean Michael,9999,0,9999,0
1668433566353,CSE 293,039,119483,Voelker; Geoffrey M.,9999,0,9999,0
1668433566353,CSE 293,040,119537,Zhao; Jishen,9999,0,9999,0
1668433566353,CSE 293,041,119538,Zhou; Yuan-Yuan,9999,0,9999,0
1668433566353,CSE 293,042,119539,Gao; Sicun,9999,0,9999,0
1668433566353,CSE 293,043,119540,Weibel; Nadir,9999,0,9999,0
1668433566353,CSE 293,044,119541,Gupta; Rajesh K.,9999,0,9999,0
1668433566353,CSE 293,045,126410,Vaccaro; Kristen Marie,9999,0,9999,0
1668433566353,CSE 293,046,126411,Klemke; Richard,9999,0,9999,0
1668433566777,CSE 294,A00,102459,Voelker; Geoffrey M.,0,1,0,0
1668433566777,CSE 294,B00,111322,Orailoglu; Alex,0,0,0,0
1668433567205,DSE 201,A00,096914,Deutsch; Alin Bernard,30,0,30,0
1668433567633,DSE 210,A00,096915,Dasgupta; Sanjoy,30,0,30,0
1668433568056,DSE 260A,A00,096916,Altintas De Callaf; Ilkay,30,0,30,0
1668433568490,ECE 200,001,103586,Antipa; Nicholas A,9999,0,9999,0
1668433568490,ECE 200,002,103587,Atanasov; Nikolay A.,9999,0,9999,0
1668433568490,ECE 200,003,103588,Bharadia; Dinesh,9999,0,9999,0
1668433568490,ECE 200,004,103589,Cheng; Chung Kuan,9999,0,9999,0
1668433568490,ECE 200,005,103590,Cosman; Pamela C.,9999,0,9999,0
1668433568490,ECE 200,006,103591,Dayeh; Shadi Ahmad,9999,0,9999,0
1668433568490,ECE 200,007,103592,Fainman; Yeshaiahu,9999,0,9999,0
1668433568490,ECE 200,008,103593,Ford; Joseph Earl,9999,0,9999,0
1668433568490,ECE 200,009,103594,Franceschetti; Massimo,9999,0,9999,0
1668433568490,ECE 200,010,103595,Fullerton; Eric E,9999,0,9999,0
1668433568490,ECE 200,011,103596,Galton; Ian A,9999,0,9999,0
1668433568490,ECE 200,012,103597,Gilja; Vikash,9999,0,9999,0
1668433568490,ECE 200,013,103598,Hall; Drew A.,9999,0,9999,0
1668433568490,ECE 200,014,103599,Hsueh; Tzu-Chien,9999,0,9999,0
1668433568490,ECE 200,015,103600,Javidi; Tara,9999,0,9999,0
1668433568490,ECE 200,016,103601,Kahng; Andrew Byun,9999,0,9999,0
1668433568490,ECE 200,017,103602,Kim; Young-Han,9999,0,9999,0
1668433568490,ECE 200,018,103603,Koushanfar; Farinaz,9999,0,9999,0
1668433568490,ECE 200,019,103604,Kuzum; Duygu,9999,0,9999,0
1668433568490,ECE 200,020,103605,Le; Hanh-Phuc,9999,0,9999,0
1668433568490,ECE 200,021,103606,Lin; Bill,9999,0,9999,0
1668433568490,ECE 200,022,103607,Liu; Zhaowei,9998,0,9999,1
1668433568490,ECE 200,023,103608,Lo; Yu-Hwa,9999,0,9999,0
1668433568490,ECE 200,024,103609,Lomakin; Vitaliy,9999,0,9999,0
1668433568490,ECE 200,025,103610,Mercier; Patrick Philip,9999,0,9999,0
1668433568490,ECE 200,026,103611,Meyer; Florian,9999,0,9999,0
1668433568490,ECE 200,027,103612,Milstein; Laurence B.,9999,0,9999,0
1668433568490,ECE 200,028,103613,Mir Arabbaygi; Siavash,9999,0,9999,0
1668433568490,ECE 200,029,103614,Mookherjea; Shayan,9999,0,9999,0
1668433568490,ECE 200,030,103615,Morris; Karcher William,9999,0,9999,0
1668433568490,ECE 200,031,103616,Ng; Tse Nga,9999,0,9999,0
1668433568490,ECE 200,032,103617,Nguyen; Truong Quang,9999,0,9999,0
1668433568490,ECE 200,033,103618,Nomura; Kenji,9999,0,9999,0
1668433568490,ECE 200,034,103619,Orlitsky; Alon,9999,0,9999,0
1668433568490,ECE 200,035,103620,Pal; Piya,9999,0,9999,0
1668433568490,ECE 200,036,103621,Papen; George C.,9999,0,9999,0
1668433568490,ECE 200,037,103622,Radic; Stojan,9999,0,9999,0
1668433568490,ECE 200,038,103623,Rao; Bhaskar D.,9999,0,9999,0
1668433568490,ECE 200,039,103624,Rao; Ramesh R,9999,0,9999,0
1668433568490,ECE 200,040,103625,Rebeiz; Gabriel,9999,0,9999,0
1668433568490,ECE 200,041,103626,Sanford; John R,9999,0,9999,0
1668433568490,ECE 200,042,103627,Siegel; Paul H.,9999,0,9999,0
1668433568490,ECE 200,043,103628,Sievenpiper; Daniel F.,9999,0,9999,0
1668433568490,ECE 200,044,103629,Sworder; David D.,9999,0,9999,0
1668433568490,ECE 200,045,103630,Taur; Yuan,9999,0,9999,0
1668433568490,ECE 200,046,103631,Touri; Behrouz,9999,0,9999,0
1668433568490,ECE 200,047,103632,Trivedi; Mohan M.,9999,0,9999,0
1668433568490,ECE 200,048,103633,Vasconcelos; Nuno,9999,0,9999,0
1668433568490,ECE 200,049,103634,Wang; Xiaolong,9999,0,9999,0
1668433568490,ECE 200,050,103635,Xie; Pengtao,9999,0,9999,0
1668433568490,ECE 200,051,103636,Yip; Michael,9999,0,9999,0
1668433568490,ECE 200,052,103637,Zeger; Kenneth A.,999,0,999,0
1668433568490,ECE 200,053,103638,Zhang; Xinyu,9999,0,9999,0
1668433568490,ECE 200,054,103639,Turakhia; Yatish Girish,9999,0,9999,0
1668433568490,ECE 200,055,103640,Kang; Mingu,9999,0,9999,0
1668433568490,ECE 200,056,103641,Shi; Yuanyuan,9999,0,9999,0
1668433568490,ECE 200,057,103642,Wang; Edward Jay,9999,0,9999,0
1668433568490,ECE 200,058,103643,Zheng; Yang,9999,0,9999,0
1668433568927,ECE 202,A00,103644,Kuzum; Duygu,0,21,0,0
1668433569369,ECE 212BN,A00,103646,Ng; Tse Nga,0,1,0,0
1668433569792,ECE 221,A00,111493,Staff,0,0,0,0
1668433570216,ECE 222B,A00,103647,Lomakin; Vitaliy,0,5,0,0
1668433570643,ECE 230B,A00,103648,Taur; Yuan,0,0,0,0
1668433571077,ECE 238B,A00,103649,Garay; Javier,0,0,0,0
1668433571502,ECE 240B,A00,112900,Fainman; Yeshaiahu,0,4,0,0
1668433571927,ECE 247A,A00,103650,Jokerst; Jesse Vincent,0,1,0,0
1668433572352,ECE 247B,A00,103651,Wang; Joseph,0,6,0,0
1668433572783,ECE 250,A00,103652,Siegel; Paul H.,0,43,0,0
1668433573211,ECE 251A,A00,103654,Rao; Bhaskar D.,0,29,0,0
1668433573727,ECE 257B,A00,103655,Bharadia; Dinesh,0,12,0,0
1668433574152,ECE 258A,A00,103656,Milstein; Laurence B.,0,10,0,0
1668433574589,ECE 260B,A00,103658,Kang; Mingu,0,65,0,0
1668433575020,ECE 264A,A00,103659,Galton; Ian A,0,33,0,0
1668433575462,ECE 265A,A00,103661,Gudem; Prasad S.S.,0,17,0,0
1668433575886,ECE 265D,A00,103662,Gudem; Prasad S.S.,0,11,0,0
1668433576319,ECE 268,A00,103663,Koushanfar; Farinaz,0,18,0,0
1668433576760,ECE 269,A01,103665,Pal; Piya,0,128,0,0
1668433577187,ECE 271B,A00,103666,Vasconcelos; Manuela,0,47,0,0
1668433577614,ECE 276A,A00,103667,Atanasov; Nikolay A.,0,70,0,0
1668433578039,ECE 277,A00,103668,An; Cheolhong,0,88,0,0
1668433578466,ECE 279,A00,117947,Hall; Drew A.,0,12,0,0
1668433579316,ECE 283,A00,103670,Hsueh; Tzu-Chien,0,23,0,0
1668433579745,ECE 284,A00,103671,Turakhia; Yatish Girish,0,22,0,0
1668433580184,ECE 285,A00,103672,Zheng; Yang,0,24,0,0
1668433580184,ECE 285,B00,103673,Sworder; David D.,0,36,0,0
1668433580622,ECE 287,A00,103676,Javidi; Tara,0,4,0,0
1668433581046,MATH 200B,A00,098023,Salehi Golsefidy; Alireza,12,0,15,3
1668433581472,MATH 202B,A00,098024,Rhoades; Brendon Patrick,9,0,15,6
1668433581899,MATH 203B,A00,098025,Oprea; Dragos N.,10,0,15,5
1668433582324,MATH 204B,A00,098026,Sorensen; Claus M,13,0,15,2
1668433582747,MATH 208,A00,098027,Izadi; Elham,7,0,10,3
1668433583171,MATH 209,A00,098028,Pollack; Aaron,10,0,10,0
1668433583594,MATH 211A,A00,112919,Rogalski; Daniel,9,0,10,1
1668433584020,MATH 211B,A00,112920,Seward; Brandon M.,9,0,10,1
1668433584446,MATH 218,A00,098029,Li; Bo,10,0,10,0
1668433584875,MATH 220B,A00,098030,Novak; Jonathan I,11,0,15,4
1668433585299,MATH 221A,A00,098031,Ebenfelt; Peter F,13,0,15,2
1668433585727,MATH 231B,A00,098032,Zlatos; Andrej,12,0,15,3
1668433586150,MATH 240B,A00,098033,Ni; Lei,9,0,15,6
1668433586577,MATH 243,A00,098034,Jekel; David Andrew,10,0,10,0
1668433587003,MATH 245A,A00,098035,Nie; Jiawang,0,1,15,16
1668433587426,MATH 248,A00,098036,Bejenaru; Ioan,10,0,10,0
1668433587862,MATH 250B,A00,098037,Spolaor; Luca,14,0,15,1
1668433588286,MATH 258,A00,098038,Ni; Lei,10,0,10,0
1668433588710,MATH 264B,A00,098041,Rhoades; Brendon Patrick,9,0,15,6
1668433589138,MATH 268,A00,098042,Buss; Samuel R,10,0,10,0
1668433589565,MATH 269,A00,098043,Rhoades; Brendon Patrick,10,0,10,0
1668433589993,MATH 270B,A00,098044,Li; Bo,10,0,15,5
1668433590416,MATH 272B,A00,098045,Holst; Michael J,13,0,15,2
1668433590850,MATH 273A,A00,098046,Tian; Xiaochuan,10,0,15,5
1668433591278,MATH 275,A01,098048,Tian; Xiaochuan,6,0,10,4
1668433591702,MATH 278A,A00,098049,Holst; Michael J,8,0,10,2
1668433592129,MATH 278B,A00,098050,Cloninger; Alexander,10,0,10,0
1668433592555,MATH 278C,A00,098051,Nie; Jiawang,6,0,10,4
1668433592979,MATH 280B,A00,098052,Zheng; Tianyi,8,0,15,7
1668433593407,MATH 281B,A00,098053,Bradic; Jelena,0,1,15,15
1668433593845,MATH 282B,A00,098054,Arias-Castro; Ery,0,0,15,15
1668433594268,MATH 285,A00,098055,Fitzsimmons; Patrick J,0,0,15,17
1668433594696,MATH 287B,A00,098056,Arias-Castro; Ery,2,0,15,13
1668433595124,MATH 288,A00,098057,Agarwal; Pooja,9,0,10,1
1668433595124,MATH 288,B00,098058,Zhang; Danna,8,0,10,2
1668433595124,MATH 288,C00,098059,Williams; Ruth J,9,0,10,1
1668433595552,MATH 290B,A00,098060,Roberts; Justin Deritter,13,0,15,2
1668433595985,MATH 292,A00,098061,Belmont; Eva Kinoshita,10,0,10,0
1668433596421,MATH 295,A00,098062,Suk; Andrew Hoon,48,0,50,2
1668433596845,MATH 296,A00,098063,Novak; Jonathan I,20,0,20,0
1668433597277,MATH 297,001,098064,Gamst; Anthony Collins,9997,0,9999,2
1668434099980,COGS 205,A00,101395,Chiba; Andrea,19,0,20,1
1668434100418,COGS 210B,001,101404,Greene; Deanna Jacquelyn,9998,0,9999,1
1668434100418,COGS 210B,002,101417,Xia; Haijun,9999,0,9999,0
1668434100418,COGS 210B,003,101422,Nitz; Douglas A.,9999,0,9999,0
1668434100418,COGS 210B,004,101423,Hollan; James D.,9998,0,9999,1
1668434100418,COGS 210B,005,101424,Deak; Gedeon O.,9998,0,9999,1
1668434100418,COGS 210B,006,101425,Rossano; Federico,9999,0,9999,0
1668434100862,COGS 211B,A00,101427,Coulson; Seana M,9996,0,9999,3
1668434101285,COGS 220,A00,101428,Hollan; James D.,1,3,25,24
1668434101716,COGS 229,A00,101429,Dow; Steven P,18,0,25,7
1668434102157,COGS 230,A00,101430,Klemmer; Scott R,11,0,17,6
1668434102585,COGS 234,A00,101431,Xia; Haijun,2,0,25,23
1668434103009,COGS 260,A00,101432,Kiyonaga; Anastasia,21,0,25,4
1668434103009,COGS 260,B00,101433,Kirsh; David Joel,15,0,25,10
1668434103437,CSE 202,A00,102371,Impagliazzo; Russell,0,32,0,0
1668434103877,CSE 203B,A01,102373,Cheng; Chung Kuan,0,25,0,0
1668434104311,CSE 208,A00,102374,Micciancio; Daniele,0,1,0,0
1668434104738,CSE 209A,A00,112895,Impagliazzo; Russell,0,3,15,15
1668434105168,CSE 209B,A00,108005,Bellare; Mihir,0,3,0,0
1668434105594,CSE 210,A00,113163,Coblenz; Michael J,0,41,0,0
1668434106016,CSE 219,A00,106111,Dow; Steven P,0,0,20,20
1668434106447,CSE 221,A00,102376,Voelker; Geoffrey M.,0,29,0,0
1668434106879,CSE 224,A01,102378,Porter; George M,0,103,0,0
1668434107318,CSE 229A,A00,102379,Savage; Stefan,0,4,0,0
1668434107756,CSE 229C,A00,102380,Munyaka; Imani N. S.,0,4,0,0
1668434108192,CSE 232B,A00,102382,Deutsch; Alin Bernard,0,14,0,0
1668434108622,CSE 234,A01,112904,Kumar; Arun Kumar,0,0,0,0
1668434109054,CSE 237A,A00,102383,Rosing; Tajana Simunic,0,26,0,0
1668434109477,CSE 239A,A00,102384,Deutsch; Alin Bernard,0,5,0,0
1668434109917,CSE 239B,A00,102385,Polikarpova; Nadezhda,0,3,0,0
1668434110343,CSE 240A,A00,102386,Pannuto; Patrick William,0,26,0,0
1668434110779,CSE 240B,A00,102387,Zhao; Jishen,0,23,0,0
1668434111207,CSE 241A,A00,106406,Kang; Mingu,0,2,0,0
1668434111634,CSE 249B,A00,102388,Kahng; Andrew Byun,0,1,8,8
1668434112062,CSE 251B,A01,102392,Cottrell; Garrison W,0,22,0,0
1668434112062,CSE 251B,A02,102393,Cottrell; Garrison W,0,21,0,0
1668434112487,CSE 252B,A00,102394,Ochoa; Benjamin Lawrence,0,37,0,0
1668434112909,CSE 257,A01,102396,Gao; Sicun,0,86,0,0
1668434113333,CSE 272,A00,102397,Li; Tzumao,0,7,0,0
1668434113764,CSE 274,A00,111323,Chern; Albert Ren-Haur,0,7,0,0
1668434114188,CSE 282,A00,102398,Pevzner; Pavel Arkadjevich,0,0,0,0
1668434114618,CSE 284,A00,114175,Gymrek; Melissa Ann,0,11,0,0
1668434115044,CSE 290,A00,102399,Chandraker; Manmohan Krishna,0,4,0,0
1668434115044,CSE 290,B00,102400,Vaccaro; Kristen Marie,0,1,25,25
1668434115044,CSE 290,C00,102414,Pannuto; Patrick William,0,1,25,25
1668434115044,CSE 290,D00,102427,Pevzner; Pavel Arkadjevich,0,0,0,0
1668434115044,CSE 290,E00,102429,Zhao; Jishen,0,1,0,0
1668434115044,CSE 290,F00,102436,Tullsen; Dean Michael,0,2,0,0
1668434115044,CSE 290,G00,102440,Christensen; Henrik I,0,3,20,20
1668434115476,CSE 291,A00,102443,Su; Hao,0,0,0,0
1668434115476,CSE 291,B00,102448,Polikarpova; Nadezhda,0,0,0,0
1668434115476,CSE 291,C00,102453,Vaccaro; Kristen Marie,0,0,0,0
1668434115476,CSE 291,D00,111343,Savage; Stefan,0,0,0,0
1668434115476,CSE 291,E00,116474,Claffy; Kimberly Claire,0,0,0,0
1668434115476,CSE 291,F00,116479,Pasquale; Joseph,0,0,0,0
1668434115953,CSE 293,001,119111,Bafna; Vineet,9999,0,9999,0
1668434115953,CSE 293,002,119118,Bellare; Mihir,9999,0,9999,0
1668434115953,CSE 293,003,119122,Berg-Kirkpatrick; Taylor D,9999,0,9999,0
1668434115953,CSE 293,004,119135,Christensen; Henrik I,9999,0,9999,0
1668434115953,CSE 293,005,119142,Cottrell; Garrison W,9999,0,9999,0
1668434115953,CSE 293,006,119146,Deutsch; Alin Bernard,9999,0,9999,0
1668434115953,CSE 293,007,119159,Esmaeilzadeh; Hadi,9999,0,9999,0
1668434115953,CSE 293,008,119166,Freund; Yoav,9999,0,9999,0
1668434115953,CSE 293,009,119170,Griswold; William G.,9999,0,9999,0
1668434115953,CSE 293,010,119183,Gymrek; Melissa Ann,9999,0,9999,0
1668434115953,CSE 293,011,119190,Heninger; Nadia A,9999,0,9999,0
1668434115953,CSE 293,012,119230,Impagliazzo; Russell,9999,0,9999,0
1668434115953,CSE 293,013,119232,Jhala; Ranjit,9999,0,9999,0
1668434115953,CSE 293,014,119233,Kahng; Andrew Byun,9999,0,9999,0
1668434115953,CSE 293,015,119298,Kane; Daniel Mertz,9999,0,9999,0
1668434115953,CSE 293,016,119299,Kriegman; David J,9999,0,9999,0
1668434115953,CSE 293,017,119300,Kumar; Arun Kumar,9999,0,9999,0
1668434115953,CSE 293,018,119301,Lerner; Sorin,9999,0,9999,0
1668434115953,CSE 293,019,119302,Lovett; Shachar,9999,0,9999,0
1668434115953,CSE 293,020,119303,McAuley; Julian John,9999,0,9999,0
1668434115953,CSE 293,021,119304,Micciancio; Daniele,9999,0,9999,0
1668434115953,CSE 293,022,119367,Orailoglu; Alex,9999,0,9999,0
1668434115953,CSE 293,023,119382,Paturi; Ramamohan,9999,0,9999,0
1668434115953,CSE 293,024,119404,Polikarpova; Nadezhda,9999,0,9999,0
1668434115953,CSE 293,025,119406,Politz; Joseph Gibbs,9999,0,9999,0
1668434115953,CSE 293,026,119411,Porter; George M,9999,0,9999,0
1668434115953,CSE 293,027,119414,Porter; Leonard Emerson,9999,0,9999,0
1668434115953,CSE 293,028,119416,Ramamoorthi; Ravi,9999,0,9999,0
1668434115953,CSE 293,029,119417,Sahoo; Debashis,9999,0,9999,0
1668434115953,CSE 293,030,119420,Saul; Lawrence,9999,0,9999,0
1668434115953,CSE 293,031,119421,Savage; Stefan,9999,0,9999,0
1668434115953,CSE 293,032,119425,Schulze; Jurgen P.,9999,0,9999,0
1668434115953,CSE 293,033,119426,Snoeren; Alex C.,9999,0,9999,0
1668434115953,CSE 293,034,119428,Shang; Jingbo,9999,0,9999,0
1668434115953,CSE 293,035,119430,Stefan; Deian,9999,0,9999,0
1668434115953,CSE 293,036,119431,Su; Hao,9999,0,9999,0
1668434115953,CSE 293,037,119433,Swanson; Steven James,9999,0,9999,0
1668434115953,CSE 293,038,119435,Tullsen; Dean Michael,9999,0,9999,0
1668434115953,CSE 293,039,119483,Voelker; Geoffrey M.,9999,0,9999,0
1668434115953,CSE 293,040,119537,Zhao; Jishen,9999,0,9999,0
1668434115953,CSE 293,041,119538,Zhou; Yuan-Yuan,9999,0,9999,0
1668434115953,CSE 293,042,119539,Gao; Sicun,9999,0,9999,0
1668434115953,CSE 293,043,119540,Weibel; Nadir,9999,0,9999,0
1668434115953,CSE 293,044,119541,Gupta; Rajesh K.,9999,0,9999,0
1668434115953,CSE 293,045,126410,Vaccaro; Kristen Marie,9999,0,9999,0
1668434115953,CSE 293,046,126411,Klemke; Richard,9999,0,9999,0
1668434116384,CSE 294,A00,102459,Voelker; Geoffrey M.,0,1,0,0
1668434116384,CSE 294,B00,111322,Orailoglu; Alex,0,0,0,0
1668434116821,DSE 201,A00,096914,Deutsch; Alin Bernard,30,0,30,0
1668434117257,DSE 210,A00,096915,Dasgupta; Sanjoy,30,0,30,0
1668434117682,DSE 260A,A00,096916,Altintas De Callaf; Ilkay,30,0,30,0
1668434118135,ECE 200,001,103586,Antipa; Nicholas A,9999,0,9999,0
1668434118135,ECE 200,002,103587,Atanasov; Nikolay A.,9999,0,9999,0
1668434118135,ECE 200,003,103588,Bharadia; Dinesh,9999,0,9999,0
1668434118135,ECE 200,004,103589,Cheng; Chung Kuan,9999,0,9999,0
1668434118135,ECE 200,005,103590,Cosman; Pamela C.,9999,0,9999,0
1668434118135,ECE 200,006,103591,Dayeh; Shadi Ahmad,9999,0,9999,0
1668434118135,ECE 200,007,103592,Fainman; Yeshaiahu,9999,0,9999,0
1668434118135,ECE 200,008,103593,Ford; Joseph Earl,9999,0,9999,0
1668434118135,ECE 200,009,103594,Franceschetti; Massimo,9999,0,9999,0
1668434118135,ECE 200,010,103595,Fullerton; Eric E,9999,0,9999,0
1668434118135,ECE 200,011,103596,Galton; Ian A,9999,0,9999,0
1668434118135,ECE 200,012,103597,Gilja; Vikash,9999,0,9999,0
1668434118135,ECE 200,013,103598,Hall; Drew A.,9999,0,9999,0
1668434118135,ECE 200,014,103599,Hsueh; Tzu-Chien,9999,0,9999,0
1668434118135,ECE 200,015,103600,Javidi; Tara,9999,0,9999,0
1668434118135,ECE 200,016,103601,Kahng; Andrew Byun,9999,0,9999,0
1668434118135,ECE 200,017,103602,Kim; Young-Han,9999,0,9999,0
1668434118135,ECE 200,018,103603,Koushanfar; Farinaz,9999,0,9999,0
1668434118135,ECE 200,019,103604,Kuzum; Duygu,9999,0,9999,0
1668434118135,ECE 200,020,103605,Le; Hanh-Phuc,9999,0,9999,0
1668434118135,ECE 200,021,103606,Lin; Bill,9999,0,9999,0
1668434118135,ECE 200,022,103607,Liu; Zhaowei,9998,0,9999,1
1668434118135,ECE 200,023,103608,Lo; Yu-Hwa,9999,0,9999,0
1668434118135,ECE 200,024,103609,Lomakin; Vitaliy,9999,0,9999,0
1668434118135,ECE 200,025,103610,Mercier; Patrick Philip,9999,0,9999,0
1668434118135,ECE 200,026,103611,Meyer; Florian,9999,0,9999,0
1668434118135,ECE 200,027,103612,Milstein; Laurence B.,9999,0,9999,0
1668434118135,ECE 200,028,103613,Mir Arabbaygi; Siavash,9999,0,9999,0
1668434118135,ECE 200,029,103614,Mookherjea; Shayan,9999,0,9999,0
1668434118135,ECE 200,030,103615,Morris; Karcher William,9999,0,9999,0
1668434118135,ECE 200,031,103616,Ng; Tse Nga,9999,0,9999,0
1668434118135,ECE 200,032,103617,Nguyen; Truong Quang,9999,0,9999,0
1668434118135,ECE 200,033,103618,Nomura; Kenji,9999,0,9999,0
1668434118135,ECE 200,034,103619,Orlitsky; Alon,9999,0,9999,0
1668434118135,ECE 200,035,103620,Pal; Piya,9999,0,9999,0
1668434118135,ECE 200,036,103621,Papen; George C.,9999,0,9999,0
1668434118135,ECE 200,037,103622,Radic; Stojan,9999,0,9999,0
1668434118135,ECE 200,038,103623,Rao; Bhaskar D.,9999,0,9999,0
1668434118135,ECE 200,039,103624,Rao; Ramesh R,9999,0,9999,0
1668434118135,ECE 200,040,103625,Rebeiz; Gabriel,9999,0,9999,0
1668434118135,ECE 200,041,103626,Sanford; John R,9999,0,9999,0
1668434118135,ECE 200,042,103627,Siegel; Paul H.,9999,0,9999,0
1668434118135,ECE 200,043,103628,Sievenpiper; Daniel F.,9999,0,9999,0
1668434118135,ECE 200,044,103629,Sworder; David D.,9999,0,9999,0
1668434118135,ECE 200,045,103630,Taur; Yuan,9999,0,9999,0
1668434118135,ECE 200,046,103631,Touri; Behrouz,9999,0,9999,0
1668434118135,ECE 200,047,103632,Trivedi; Mohan M.,9999,0,9999,0
1668434118135,ECE 200,048,103633,Vasconcelos; Nuno,9999,0,9999,0
1668434118135,ECE 200,049,103634,Wang; Xiaolong,9999,0,9999,0
1668434118135,ECE 200,050,103635,Xie; Pengtao,9999,0,9999,0
1668434118135,ECE 200,051,103636,Yip; Michael,9999,0,9999,0
1668434118135,ECE 200,052,103637,Zeger; Kenneth A.,999,0,999,0
1668434118135,ECE 200,053,103638,Zhang; Xinyu,9999,0,9999,0
1668434118135,ECE 200,054,103639,Turakhia; Yatish Girish,9999,0,9999,0
1668434118135,ECE 200,055,103640,Kang; Mingu,9999,0,9999,0
1668434118135,ECE 200,056,103641,Shi; Yuanyuan,9999,0,9999,0
1668434118135,ECE 200,057,103642,Wang; Edward Jay,9999,0,9999,0
1668434118135,ECE 200,058,103643,Zheng; Yang,9999,0,9999,0
1668434118561,ECE 202,A00,103644,Kuzum; Duygu,0,21,0,0
1668434118984,ECE 212BN,A00,103646,Ng; Tse Nga,0,1,0,0
1668434119411,ECE 221,A00,111493,Staff,0,0,0,0
1668434119835,ECE 222B,A00,103647,Lomakin; Vitaliy,0,5,0,0
1668434120263,ECE 230B,A00,103648,Taur; Yuan,0,0,0,0
1668434120693,ECE 238B,A00,103649,Garay; Javier,0,0,0,0
1668434121120,ECE 240B,A00,112900,Fainman; Yeshaiahu,0,4,0,0
1668434121550,ECE 247A,A00,103650,Jokerst; Jesse Vincent,0,1,0,0
1668434121975,ECE 247B,A00,103651,Wang; Joseph,0,6,0,0
1668434122397,ECE 250,A00,103652,Siegel; Paul H.,0,44,0,0
1668434122830,ECE 251A,A00,103654,Rao; Bhaskar D.,0,29,0,0
1668434123259,ECE 257B,A00,103655,Bharadia; Dinesh,0,12,0,0
1668434123682,ECE 258A,A00,103656,Milstein; Laurence B.,0,10,0,0
1668434124110,ECE 260B,A00,103658,Kang; Mingu,0,65,0,0
1668434124533,ECE 264A,A00,103659,Galton; Ian A,0,33,0,0
1668434124959,ECE 265A,A00,103661,Gudem; Prasad S.S.,0,17,0,0
1668434125388,ECE 265D,A00,103662,Gudem; Prasad S.S.,0,11,0,0
1668434125817,ECE 268,A00,103663,Koushanfar; Farinaz,0,19,0,0
1668434126242,ECE 269,A01,103665,Pal; Piya,0,129,0,0
1668434126671,ECE 271B,A00,103666,Vasconcelos; Manuela,0,47,0,0
1668434127095,ECE 276A,A00,103667,Atanasov; Nikolay A.,0,70,0,0
1668434127520,ECE 277,A00,103668,An; Cheolhong,0,89,0,0
1668434127949,ECE 279,A00,117947,Hall; Drew A.,0,12,0,0
1668434128801,ECE 283,A00,103670,Hsueh; Tzu-Chien,0,23,0,0
1668434129226,ECE 284,A00,103671,Turakhia; Yatish Girish,0,22,0,0
1668434129660,ECE 285,A00,103672,Zheng; Yang,0,24,0,0
1668434129660,ECE 285,B00,103673,Sworder; David D.,0,36,0,0
1668434130099,ECE 287,A00,103676,Javidi; Tara,0,4,0,0
1668434130525,MATH 200B,A00,098023,Salehi Golsefidy; Alireza,12,0,15,3
1668434130953,MATH 202B,A00,098024,Rhoades; Brendon Patrick,9,0,15,6
1668434131382,MATH 203B,A00,098025,Oprea; Dragos N.,10,0,15,5
1668434131810,MATH 204B,A00,098026,Sorensen; Claus M,13,0,15,2
1668434132238,MATH 208,A00,098027,Izadi; Elham,7,0,10,3
1668434132665,MATH 209,A00,098028,Pollack; Aaron,10,0,10,0
1668434133089,MATH 211A,A00,112919,Rogalski; Daniel,9,0,10,1
1668434133512,MATH 211B,A00,112920,Seward; Brandon M.,9,0,10,1
1668434133944,MATH 218,A00,098029,Li; Bo,10,0,10,0
1668434134375,MATH 220B,A00,098030,Novak; Jonathan I,11,0,15,4
1668434134802,MATH 221A,A00,098031,Ebenfelt; Peter F,13,0,15,2
1668434135237,MATH 231B,A00,098032,Zlatos; Andrej,12,0,15,3
1668434135664,MATH 240B,A00,098033,Ni; Lei,9,0,15,6
1668434136087,MATH 243,A00,098034,Jekel; David Andrew,10,0,10,0
1668434136512,MATH 245A,A00,098035,Nie; Jiawang,0,1,15,16
1668434136938,MATH 248,A00,098036,Bejenaru; Ioan,10,0,10,0
1668434137363,MATH 250B,A00,098037,Spolaor; Luca,14,0,15,1
1668434137790,MATH 258,A00,098038,Ni; Lei,10,0,10,0
1668434138220,MATH 264B,A00,098041,Rhoades; Brendon Patrick,9,0,15,6
1668434138655,MATH 268,A00,098042,Buss; Samuel R,10,0,10,0
1668434139081,MATH 269,A00,098043,Rhoades; Brendon Patrick,10,0,10,0
1668434139508,MATH 270B,A00,098044,Li; Bo,10,0,15,5
1668434140027,MATH 272B,A00,098045,Holst; Michael J,13,0,15,2
1668434140455,MATH 273A,A00,098046,Tian; Xiaochuan,10,0,15,5
1668434140885,MATH 275,A01,098048,Tian; Xiaochuan,6,0,10,4
1668434141324,MATH 278A,A00,098049,Holst; Michael J,8,0,10,2
1668434141761,MATH 278B,A00,098050,Cloninger; Alexander,10,0,10,0
1668434142186,MATH 278C,A00,098051,Nie; Jiawang,6,0,10,4
1668434142611,MATH 280B,A00,098052,Zheng; Tianyi,8,0,15,7
1668434143034,MATH 281B,A00,098053,Bradic; Jelena,0,1,15,15
1668434143464,MATH 282B,A00,098054,Arias-Castro; Ery,0,0,15,15
1668434143901,MATH 285,A00,098055,Fitzsimmons; Patrick J,0,0,15,17
1668434144327,MATH 287B,A00,098056,Arias-Castro; Ery,2,0,15,13
1668434144752,MATH 288,A00,098057,Agarwal; Pooja,9,0,10,1
1668434144752,MATH 288,B00,098058,Zhang; Danna,8,0,10,2
1668434144752,MATH 288,C00,098059,Williams; Ruth J,9,0,10,1
1668434145177,MATH 290B,A00,098060,Roberts; Justin Deritter,13,0,15,2
1668434145602,MATH 292,A00,098061,Belmont; Eva Kinoshita,10,0,10,0
1668434146029,MATH 295,A00,098062,Suk; Andrew Hoon,48,0,50,2
1668434146463,MATH 296,A00,098063,Novak; Jonathan I,20,0,20,0
1668434146893,MATH 297,001,098064,Gamst; Anthony Collins,9997,0,9999,2
1668434651742,COGS 205,A00,101395,Chiba; Andrea,19,0,20,1
1668434652185,COGS 210B,001,101404,Greene; Deanna Jacquelyn,9998,0,9999,1
1668434652185,COGS 210B,002,101417,Xia; Haijun,9999,0,9999,0
1668434652185,COGS 210B,003,101422,Nitz; Douglas A.,9999,0,9999,0
1668434652185,COGS 210B,004,101423,Hollan; James D.,9998,0,9999,1
1668434652185,COGS 210B,005,101424,Deak; Gedeon O.,9998,0,9999,1
1668434652185,COGS 210B,006,101425,Rossano; Federico,9999,0,9999,0
1668434652621,COGS 211B,A00,101427,Coulson; Seana M,9996,0,9999,3
1668434653049,COGS 220,A00,101428,Hollan; James D.,1,3,25,24
1668434653473,COGS 229,A00,101429,Dow; Steven P,18,0,25,7
1668434653901,COGS 230,A00,101430,Klemmer; Scott R,11,0,17,6
1668434654328,COGS 234,A00,101431,Xia; Haijun,2,0,25,23
1668434654757,COGS 260,A00,101432,Kiyonaga; Anastasia,21,0,25,4
1668434654757,COGS 260,B00,101433,Kirsh; David Joel,15,0,25,10
1668434655196,CSE 202,A00,102371,Impagliazzo; Russell,0,32,0,0
1668434655633,CSE 203B,A01,102373,Cheng; Chung Kuan,0,25,0,0
1668434656064,CSE 208,A00,102374,Micciancio; Daniele,0,1,0,0
1668434656489,CSE 209A,A00,112895,Impagliazzo; Russell,0,3,15,15
1668434656918,CSE 209B,A00,108005,Bellare; Mihir,0,3,0,0
1668434657342,CSE 210,A00,113163,Coblenz; Michael J,0,41,0,0
1668434657769,CSE 219,A00,106111,Dow; Steven P,0,0,20,20
1668434658195,CSE 221,A00,102376,Voelker; Geoffrey M.,0,29,0,0
1668434658620,CSE 224,A01,102378,Porter; George M,0,104,0,0
1668434659057,CSE 229A,A00,102379,Savage; Stefan,0,4,0,0
1668434659484,CSE 229C,A00,102380,Munyaka; Imani N. S.,0,4,0,0
1668434659907,CSE 232B,A00,102382,Deutsch; Alin Bernard,0,14,0,0
1668434660331,CSE 234,A01,112904,Kumar; Arun Kumar,0,0,0,0
1668434660759,CSE 237A,A00,102383,Rosing; Tajana Simunic,0,26,0,0
1668434661185,CSE 239A,A00,102384,Deutsch; Alin Bernard,0,5,0,0
1668434661609,CSE 239B,A00,102385,Polikarpova; Nadezhda,0,3,0,0
1668434662035,CSE 240A,A00,102386,Pannuto; Patrick William,0,26,0,0
1668434662462,CSE 240B,A00,102387,Zhao; Jishen,0,23,0,0
1668434662892,CSE 241A,A00,106406,Kang; Mingu,0,2,0,0
1668434663320,CSE 249B,A00,102388,Kahng; Andrew Byun,0,1,8,8
1668434663753,CSE 251B,A01,102392,Cottrell; Garrison W,0,22,0,0
1668434663753,CSE 251B,A02,102393,Cottrell; Garrison W,0,21,0,0
1668434664177,CSE 252B,A00,102394,Ochoa; Benjamin Lawrence,0,37,0,0
1668434664601,CSE 257,A01,102396,Gao; Sicun,0,86,0,0
1668434665110,CSE 272,A00,102397,Li; Tzumao,0,7,0,0
1668434665541,CSE 274,A00,111323,Chern; Albert Ren-Haur,0,7,0,0
1668434665976,CSE 282,A00,102398,Pevzner; Pavel Arkadjevich,0,0,0,0
1668434666405,CSE 284,A00,114175,Gymrek; Melissa Ann,0,11,0,0
1668434666835,CSE 290,A00,102399,Chandraker; Manmohan Krishna,0,4,0,0
1668434666835,CSE 290,B00,102400,Vaccaro; Kristen Marie,0,1,25,25
1668434666835,CSE 290,C00,102414,Pannuto; Patrick William,0,1,25,25
1668434666835,CSE 290,D00,102427,Pevzner; Pavel Arkadjevich,0,0,0,0
1668434666835,CSE 290,E00,102429,Zhao; Jishen,0,1,0,0
1668434666835,CSE 290,F00,102436,Tullsen; Dean Michael,0,2,0,0
1668434666835,CSE 290,G00,102440,Christensen; Henrik I,0,3,20,20
1668434667262,CSE 291,A00,102443,Su; Hao,0,0,0,0
1668434667262,CSE 291,B00,102448,Polikarpova; Nadezhda,0,0,0,0
1668434667262,CSE 291,C00,102453,Vaccaro; Kristen Marie,0,0,0,0
1668434667262,CSE 291,D00,111343,Savage; Stefan,0,0,0,0
1668434667262,CSE 291,E00,116474,Claffy; Kimberly Claire,0,0,0,0
1668434667262,CSE 291,F00,116479,Pasquale; Joseph,0,0,0,0
1668434667698,CSE 293,001,119111,Bafna; Vineet,9999,0,9999,0
1668434667698,CSE 293,002,119118,Bellare; Mihir,9999,0,9999,0
1668434667698,CSE 293,003,119122,Berg-Kirkpatrick; Taylor D,9999,0,9999,0
1668434667698,CSE 293,004,119135,Christensen; Henrik I,9999,0,9999,0
1668434667698,CSE 293,005,119142,Cottrell; Garrison W,9999,0,9999,0
1668434667698,CSE 293,006,119146,Deutsch; Alin Bernard,9999,0,9999,0
1668434667698,CSE 293,007,119159,Esmaeilzadeh; Hadi,9999,0,9999,0
1668434667698,CSE 293,008,119166,Freund; Yoav,9999,0,9999,0
1668434667698,CSE 293,009,119170,Griswold; William G.,9999,0,9999,0
1668434667698,CSE 293,010,119183,Gymrek; Melissa Ann,9999,0,9999,0
1668434667698,CSE 293,011,119190,Heninger; Nadia A,9999,0,9999,0
1668434667698,CSE 293,012,119230,Impagliazzo; Russell,9999,0,9999,0
1668434667698,CSE 293,013,119232,Jhala; Ranjit,9999,0,9999,0
1668434667698,CSE 293,014,119233,Kahng; Andrew Byun,9999,0,9999,0
1668434667698,CSE 293,015,119298,Kane; Daniel Mertz,9999,0,9999,0
1668434667698,CSE 293,016,119299,Kriegman; David J,9999,0,9999,0
1668434667698,CSE 293,017,119300,Kumar; Arun Kumar,9999,0,9999,0
1668434667698,CSE 293,018,119301,Lerner; Sorin,9999,0,9999,0
1668434667698,CSE 293,019,119302,Lovett; Shachar,9999,0,9999,0
1668434667698,CSE 293,020,119303,McAuley; Julian John,9999,0,9999,0
1668434667698,CSE 293,021,119304,Micciancio; Daniele,9999,0,9999,0
1668434667698,CSE 293,022,119367,Orailoglu; Alex,9999,0,9999,0
1668434667698,CSE 293,023,119382,Paturi; Ramamohan,9999,0,9999,0
1668434667698,CSE 293,024,119404,Polikarpova; Nadezhda,9999,0,9999,0
1668434667698,CSE 293,025,119406,Politz; Joseph Gibbs,9999,0,9999,0
1668434667698,CSE 293,026,119411,Porter; George M,9999,0,9999,0
1668434667698,CSE 293,027,119414,Porter; Leonard Emerson,9999,0,9999,0
1668434667698,CSE 293,028,119416,Ramamoorthi; Ravi,9999,0,9999,0
1668434667698,CSE 293,029,119417,Sahoo; Debashis,9999,0,9999,0
1668434667698,CSE 293,030,119420,Saul; Lawrence,9999,0,9999,0
1668434667698,CSE 293,031,119421,Savage; Stefan,9999,0,9999,0
1668434667698,CSE 293,032,119425,Schulze; Jurgen P.,9999,0,9999,0
1668434667698,CSE 293,033,119426,Snoeren; Alex C.,9999,0,9999,0
1668434667698,CSE 293,034,119428,Shang; Jingbo,9999,0,9999,0
1668434667698,CSE 293,035,119430,Stefan; Deian,9999,0,9999,0
1668434667698,CSE 293,036,119431,Su; Hao,9999,0,9999,0
1668434667698,CSE 293,037,119433,Swanson; Steven James,9999,0,9999,0
1668434667698,CSE 293,038,119435,Tullsen; Dean Michael,9999,0,9999,0
1668434667698,CSE 293,039,119483,Voelker; Geoffrey M.,9999,0,9999,0
1668434667698,CSE 293,040,119537,Zhao; Jishen,9999,0,9999,0
1668434667698,CSE 293,041,119538,Zhou; Yuan-Yuan,9999,0,9999,0
1668434667698,CSE 293,042,119539,Gao; Sicun,9999,0,9999,0
1668434667698,CSE 293,043,119540,Weibel; Nadir,9999,0,9999,0
1668434667698,CSE 293,044,119541,Gupta; Rajesh K.,9999,0,9999,0
1668434667698,CSE 293,045,126410,Vaccaro; Kristen Marie,9999,0,9999,0
1668434667698,CSE 293,046,126411,Klemke; Richard,9999,0,9999,0
1668434668123,CSE 294,A00,102459,Voelker; Geoffrey M.,0,1,0,0
1668434668123,CSE 294,B00,111322,Orailoglu; Alex,0,0,0,0
1668434668550,DSE 201,A00,096914,Deutsch; Alin Bernard,30,0,30,0
1668434668977,DSE 210,A00,096915,Dasgupta; Sanjoy,30,0,30,0
1668434669400,DSE 260A,A00,096916,Altintas De Callaf; Ilkay,30,0,30,0
1668434669869,ECE 200,001,103586,Antipa; Nicholas A,9999,0,9999,0
1668434669869,ECE 200,002,103587,Atanasov; Nikolay A.,9999,0,9999,0
1668434669869,ECE 200,003,103588,Bharadia; Dinesh,9999,0,9999,0
1668434669869,ECE 200,004,103589,Cheng; Chung Kuan,9999,0,9999,0
1668434669869,ECE 200,005,103590,Cosman; Pamela C.,9999,0,9999,0
1668434669869,ECE 200,006,103591,Dayeh; Shadi Ahmad,9999,0,9999,0
1668434669869,ECE 200,007,103592,Fainman; Yeshaiahu,9999,0,9999,0
1668434669869,ECE 200,008,103593,Ford; Joseph Earl,9999,0,9999,0
1668434669869,ECE 200,009,103594,Franceschetti; Massimo,9999,0,9999,0
1668434669869,ECE 200,010,103595,Fullerton; Eric E,9999,0,9999,0
1668434669869,ECE 200,011,103596,Galton; Ian A,9999,0,9999,0
1668434669869,ECE 200,012,103597,Gilja; Vikash,9999,0,9999,0
1668434669869,ECE 200,013,103598,Hall; Drew A.,9999,0,9999,0
1668434669869,ECE 200,014,103599,Hsueh; Tzu-Chien,9999,0,9999,0
1668434669869,ECE 200,015,103600,Javidi; Tara,9999,0,9999,0
1668434669869,ECE 200,016,103601,Kahng; Andrew Byun,9999,0,9999,0
1668434669869,ECE 200,017,103602,Kim; Young-Han,9999,0,9999,0
1668434669869,ECE 200,018,103603,Koushanfar; Farinaz,9999,0,9999,0
1668434669869,ECE 200,019,103604,Kuzum; Duygu,9999,0,9999,0
1668434669869,ECE 200,020,103605,Le; Hanh-Phuc,9999,0,9999,0
1668434669869,ECE 200,021,103606,Lin; Bill,9999,0,9999,0
1668434669869,ECE 200,022,103607,Liu; Zhaowei,9998,0,9999,1
1668434669869,ECE 200,023,103608,Lo; Yu-Hwa,9999,0,9999,0
1668434669869,ECE 200,024,103609,Lomakin; Vitaliy,9999,0,9999,0
1668434669869,ECE 200,025,103610,Mercier; Patrick Philip,9999,0,9999,0
1668434669869,ECE 200,026,103611,Meyer; Florian,9999,0,9999,0
1668434669869,ECE 200,027,103612,Milstein; Laurence B.,9999,0,9999,0
1668434669869,ECE 200,028,103613,Mir Arabbaygi; Siavash,9999,0,9999,0
1668434669869,ECE 200,029,103614,Mookherjea; Shayan,9999,0,9999,0
1668434669869,ECE 200,030,103615,Morris; Karcher William,9999,0,9999,0
1668434669869,ECE 200,031,103616,Ng; Tse Nga,9999,0,9999,0
1668434669869,ECE 200,032,103617,Nguyen; Truong Quang,9999,0,9999,0
1668434669869,ECE 200,033,103618,Nomura; Kenji,9999,0,9999,0
1668434669869,ECE 200,034,103619,Orlitsky; Alon,9999,0,9999,0
1668434669869,ECE 200,035,103620,Pal; Piya,9999,0,9999,0
1668434669869,ECE 200,036,103621,Papen; George C.,9999,0,9999,0
1668434669869,ECE 200,037,103622,Radic; Stojan,9999,0,9999,0
1668434669869,ECE 200,038,103623,Rao; Bhaskar D.,9999,0,9999,0
1668434669869,ECE 200,039,103624,Rao; Ramesh R,9999,0,9999,0
1668434669869,ECE 200,040,103625,Rebeiz; Gabriel,9999,0,9999,0
1668434669869,ECE 200,041,103626,Sanford; John R,9999,0,9999,0
1668434669869,ECE 200,042,103627,Siegel; Paul H.,9999,0,9999,0
1668434669869,ECE 200,043,103628,Sievenpiper; Daniel F.,9999,0,9999,0
1668434669869,ECE 200,044,103629,Sworder; David D.,9999,0,9999,0
1668434669869,ECE 200,045,103630,Taur; Yuan,9999,0,9999,0
1668434669869,ECE 200,046,103631,Touri; Behrouz,9999,0,9999,0
1668434669869,ECE 200,047,103632,Trivedi; Mohan M.,9999,0,9999,0
1668434669869,ECE 200,048,103633,Vasconcelos; Nuno,9999,0,9999,0
1668434669869,ECE 200,049,103634,Wang; Xiaolong,9999,0,9999,0
1668434669869,ECE 200,050,103635,Xie; Pengtao,9999,0,9999,0
1668434669869,ECE 200,051,103636,Yip; Michael,9999,0,9999,0
1668434669869,ECE 200,052,103637,Zeger; Kenneth A.,999,0,999,0
1668434669869,ECE 200,053,103638,Zhang; Xinyu,9999,0,9999,0
1668434669869,ECE 200,054,103639,Turakhia; Yatish Girish,9999,0,9999,0
1668434669869,ECE 200,055,103640,Kang; Mingu,9999,0,9999,0
1668434669869,ECE 200,056,103641,Shi; Yuanyuan,9999,0,9999,0
1668434669869,ECE 200,057,103642,Wang; Edward Jay,9999,0,9999,0
1668434669869,ECE 200,058,103643,Zheng; Yang,9999,0,9999,0
1668434670310,ECE 202,A00,103644,Kuzum; Duygu,0,21,0,0
1668434670743,ECE 212BN,A00,103646,Ng; Tse Nga,0,1,0,0
1668434671177,ECE 221,A00,111493,Staff,0,0,0,0
1668434671606,ECE 222B,A00,103647,Lomakin; Vitaliy,0,5,0,0
1668434672041,ECE 230B,A00,103648,Taur; Yuan,0,0,0,0
1668434672469,ECE 238B,A00,103649,Garay; Javier,0,0,0,0
1668434672903,ECE 240B,A00,112900,Fainman; Yeshaiahu,0,4,0,0
1668434673325,ECE 247A,A00,103650,Jokerst; Jesse Vincent,0,1,0,0
1668434673753,ECE 247B,A00,103651,Wang; Joseph,0,6,0,0
1668434674178,ECE 250,A00,103652,Siegel; Paul H.,0,44,0,0
1668434674604,ECE 251A,A00,103654,Rao; Bhaskar D.,0,29,0,0
1668434675031,ECE 257B,A00,103655,Bharadia; Dinesh,0,12,0,0
1668434675457,ECE 258A,A00,103656,Milstein; Laurence B.,0,10,0,0
1668434675881,ECE 260B,A00,103658,Kang; Mingu,0,65,0,0
1668434676313,ECE 264A,A00,103659,Galton; Ian A,0,33,0,0
1668434676741,ECE 265A,A00,103661,Gudem; Prasad S.S.,0,17,0,0
1668434677165,ECE 265D,A00,103662,Gudem; Prasad S.S.,0,11,0,0
1668434677589,ECE 268,A00,103663,Koushanfar; Farinaz,0,19,0,0
1668434678017,ECE 269,A01,103665,Pal; Piya,0,129,0,0
1668434678443,ECE 271B,A00,103666,Vasconcelos; Manuela,0,47,0,0
1668434678868,ECE 276A,A00,103667,Atanasov; Nikolay A.,0,70,0,0
1668434679292,ECE 277,A00,103668,An; Cheolhong,0,89,0,0
1668434679716,ECE 279,A00,117947,Hall; Drew A.,0,12,0,0
1668434680572,ECE 283,A00,103670,Hsueh; Tzu-Chien,0,23,0,0
1668434681004,ECE 284,A00,103671,Turakhia; Yatish Girish,0,22,0,0
1668434681449,ECE 285,A00,103672,Zheng; Yang,0,24,0,0
1668434681449,ECE 285,B00,103673,Sworder; David D.,0,36,0,0
1668434681886,ECE 287,A00,103676,Javidi; Tara,0,4,0,0
1668434682325,MATH 200B,A00,098023,Salehi Golsefidy; Alireza,12,0,15,3
1668434682749,MATH 202B,A00,098024,Rhoades; Brendon Patrick,9,0,15,6
1668434683177,MATH 203B,A00,098025,Oprea; Dragos N.,10,0,15,5
1668434683610,MATH 204B,A00,098026,Sorensen; Claus M,13,0,15,2
1668434684035,MATH 208,A00,098027,Izadi; Elham,7,0,10,3
1668434684461,MATH 209,A00,098028,Pollack; Aaron,10,0,10,0
1668434684888,MATH 211A,A00,112919,Rogalski; Daniel,9,0,10,1
1668434685318,MATH 211B,A00,112920,Seward; Brandon M.,9,0,10,1
1668434685747,MATH 218,A00,098029,Li; Bo,10,0,10,0
1668434686170,MATH 220B,A00,098030,Novak; Jonathan I,11,0,15,4
1668434686599,MATH 221A,A00,098031,Ebenfelt; Peter F,13,0,15,2
1668434687026,MATH 231B,A00,098032,Zlatos; Andrej,12,0,15,3
1668434687452,MATH 240B,A00,098033,Ni; Lei,9,0,15,6
1668434687881,MATH 243,A00,098034,Jekel; David Andrew,10,0,10,0
1668434688309,MATH 245A,A00,098035,Nie; Jiawang,0,1,15,16
1668434688731,MATH 248,A00,098036,Bejenaru; Ioan,10,0,10,0
1668434689157,MATH 250B,A00,098037,Spolaor; Luca,14,0,15,1
1668434689584,MATH 258,A00,098038,Ni; Lei,10,0,10,0
1668434690013,MATH 264B,A00,098041,Rhoades; Brendon Patrick,9,0,15,6
1668434690442,MATH 268,A00,098042,Buss; Samuel R,10,0,10,0
1668434690871,MATH 269,A00,098043,Rhoades; Brendon Patrick,10,0,10,0
1668434691302,MATH 270B,A00,098044,Li; Bo,10,0,15,5
1668434691731,MATH 272B,A00,098045,Holst; Michael J,13,0,15,2
1668434692165,MATH 273A,A00,098046,Tian; Xiaochuan,10,0,15,5
1668434692591,MATH 275,A01,098048,Tian; Xiaochuan,6,0,10,4
1668434693022,MATH 278A,A00,098049,Holst; Michael J,8,0,10,2
1668434693447,MATH 278B,A00,098050,Cloninger; Alexander,10,0,10,0
1668434693871,MATH 278C,A00,098051,Nie; Jiawang,6,0,10,4
1668434694298,MATH 280B,A00,098052,Zheng; Tianyi,8,0,15,7
1668434694736,MATH 281B,A00,098053,Bradic; Jelena,0,1,15,15
1668434695175,MATH 282B,A00,098054,Arias-Castro; Ery,0,0,15,15
1668434695601,MATH 285,A00,098055,Fitzsimmons; Patrick J,0,0,15,17
1668434696027,MATH 287B,A00,098056,Arias-Castro; Ery,2,0,15,13
1668434696451,MATH 288,A00,098057,Agarwal; Pooja,9,0,10,1
1668434696451,MATH 288,B00,098058,Zhang; Danna,8,0,10,2
1668434696451,MATH 288,C00,098059,Williams; Ruth J,9,0,10,1
1668434696874,MATH 290B,A00,098060,Roberts; Justin Deritter,13,0,15,2
1668434697307,MATH 292,A00,098061,Belmont; Eva Kinoshita,10,0,10,0
1668434697739,MATH 295,A00,098062,Suk; Andrew Hoon,48,0,50,2
1668434698162,MATH 296,A00,098063,Novak; Jonathan I,20,0,20,0
1668434698600,MATH 297,001,098064,Gamst; Anthony Collins,9997,0,9999,2
1668435203031,COGS 205,A00,101395,Chiba; Andrea,19,0,20,1
1668435203466,COGS 210B,001,101404,Greene; Deanna Jacquelyn,9998,0,9999,1
1668435203466,COGS 210B,002,101417,Xia; Haijun,9999,0,9999,0
1668435203466,COGS 210B,003,101422,Nitz; Douglas A.,9999,0,9999,0
1668435203466,COGS 210B,004,101423,Hollan; James D.,9998,0,9999,1
1668435203466,COGS 210B,005,101424,Deak; Gedeon O.,9998,0,9999,1
1668435203466,COGS 210B,006,101425,Rossano; Federico,9999,0,9999,0
1668435203889,COGS 211B,A00,101427,Coulson; Seana M,9996,0,9999,3
1668435204327,COGS 220,A00,101428,Hollan; James D.,1,3,25,24
1668435204753,COGS 229,A00,101429,Dow; Steven P,18,0,25,7
1668435205176,COGS 230,A00,101430,Klemmer; Scott R,11,0,17,6
1668435205604,COGS 234,A00,101431,Xia; Haijun,2,0,25,23
1668435206031,COGS 260,A00,101432,Kiyonaga; Anastasia,21,0,25,4
1668435206031,COGS 260,B00,101433,Kirsh; David Joel,15,0,25,10
1668435206459,CSE 202,A00,102371,Impagliazzo; Russell,0,33,0,0
1668435206882,CSE 203B,A01,102373,Cheng; Chung Kuan,0,26,0,0
1668435207311,CSE 208,A00,102374,Micciancio; Daniele,0,1,0,0
1668435207737,CSE 209A,A00,112895,Impagliazzo; Russell,0,3,15,15
1668435208166,CSE 209B,A00,108005,Bellare; Mihir,0,3,0,0
1668435208597,CSE 210,A00,113163,Coblenz; Michael J,0,44,0,0
1668435209038,CSE 219,A00,106111,Dow; Steven P,0,0,20,20
1668435209466,CSE 221,A00,102376,Voelker; Geoffrey M.,0,30,0,0
1668435209890,CSE 224,A01,102378,Porter; George M,0,104,0,0
1668435210318,CSE 229A,A00,102379,Savage; Stefan,0,4,0,0
1668435210743,CSE 229C,A00,102380,Munyaka; Imani N. S.,0,4,0,0
1668435211171,CSE 232B,A00,102382,Deutsch; Alin Bernard,0,14,0,0
1668435211595,CSE 234,A01,112904,Kumar; Arun Kumar,0,0,0,0
1668435212019,CSE 237A,A00,102383,Rosing; Tajana Simunic,0,26,0,0
1668435212456,CSE 239A,A00,102384,Deutsch; Alin Bernard,0,5,0,0
1668435212885,CSE 239B,A00,102385,Polikarpova; Nadezhda,0,3,0,0
1668435213322,CSE 240A,A00,102386,Pannuto; Patrick William,0,27,0,0
1668435213752,CSE 240B,A00,102387,Zhao; Jishen,0,23,0,0
1668435214176,CSE 241A,A00,106406,Kang; Mingu,0,2,0,0
1668435214599,CSE 249B,A00,102388,Kahng; Andrew Byun,0,1,8,8
1668435215027,CSE 251B,A01,102392,Cottrell; Garrison W,0,22,0,0
1668435215027,CSE 251B,A02,102393,Cottrell; Garrison W,0,21,0,0
1668435215455,CSE 252B,A00,102394,Ochoa; Benjamin Lawrence,0,38,0,0
1668435215878,CSE 257,A01,102396,Gao; Sicun,0,86,0,0
1668435216309,CSE 272,A00,102397,Li; Tzumao,0,7,0,0
1668435216734,CSE 274,A00,111323,Chern; Albert Ren-Haur,0,7,0,0
1668435217165,CSE 282,A00,102398,Pevzner; Pavel Arkadjevich,0,0,0,0
1668435217605,CSE 284,A00,114175,Gymrek; Melissa Ann,0,12,0,0
1668435218036,CSE 290,A00,102399,Chandraker; Manmohan Krishna,0,4,0,0
1668435218036,CSE 290,B00,102400,Vaccaro; Kristen Marie,0,1,25,25
1668435218036,CSE 290,C00,102414,Pannuto; Patrick William,0,1,25,25
1668435218036,CSE 290,D00,102427,Pevzner; Pavel Arkadjevich,0,0,0,0
1668435218036,CSE 290,E00,102429,Zhao; Jishen,0,1,0,0
1668435218036,CSE 290,F00,102436,Tullsen; Dean Michael,0,2,0,0
1668435218036,CSE 290,G00,102440,Christensen; Henrik I,0,3,20,20
1668435218464,CSE 291,A00,102443,Su; Hao,0,0,0,0
1668435218464,CSE 291,B00,102448,Polikarpova; Nadezhda,0,0,0,0
1668435218464,CSE 291,C00,102453,Vaccaro; Kristen Marie,0,0,0,0
1668435218464,CSE 291,D00,111343,Savage; Stefan,0,0,0,0
1668435218464,CSE 291,E00,116474,Claffy; Kimberly Claire,0,0,0,0
1668435218464,CSE 291,F00,116479,Pasquale; Joseph,0,0,0,0
1668435218930,CSE 293,001,119111,Bafna; Vineet,9999,0,9999,0
1668435218930,CSE 293,002,119118,Bellare; Mihir,9999,0,9999,0
1668435218930,CSE 293,003,119122,Berg-Kirkpatrick; Taylor D,9999,0,9999,0
1668435218930,CSE 293,004,119135,Christensen; Henrik I,9999,0,9999,0
1668435218930,CSE 293,005,119142,Cottrell; Garrison W,9999,0,9999,0
1668435218930,CSE 293,006,119146,Deutsch; Alin Bernard,9999,0,9999,0
1668435218930,CSE 293,007,119159,Esmaeilzadeh; Hadi,9999,0,9999,0
1668435218930,CSE 293,008,119166,Freund; Yoav,9999,0,9999,0
1668435218930,CSE 293,009,119170,Griswold; William G.,9999,0,9999,0
1668435218930,CSE 293,010,119183,Gymrek; Melissa Ann,9999,0,9999,0
1668435218930,CSE 293,011,119190,Heninger; Nadia A,9999,0,9999,0
1668435218930,CSE 293,012,119230,Impagliazzo; Russell,9999,0,9999,0
1668435218930,CSE 293,013,119232,Jhala; Ranjit,9999,0,9999,0
1668435218930,CSE 293,014,119233,Kahng; Andrew Byun,9999,0,9999,0
1668435218930,CSE 293,015,119298,Kane; Daniel Mertz,9999,0,9999,0
1668435218930,CSE 293,016,119299,Kriegman; David J,9999,0,9999,0
1668435218930,CSE 293,017,119300,Kumar; Arun Kumar,9999,0,9999,0
1668435218930,CSE 293,018,119301,Lerner; Sorin,9999,0,9999,0
1668435218930,CSE 293,019,119302,Lovett; Shachar,9999,0,9999,0
1668435218930,CSE 293,020,119303,McAuley; Julian John,9999,0,9999,0
1668435218930,CSE 293,021,119304,Micciancio; Daniele,9999,0,9999,0
1668435218930,CSE 293,022,119367,Orailoglu; Alex,9999,0,9999,0
1668435218930,CSE 293,023,119382,Paturi; Ramamohan,9999,0,9999,0
1668435218930,CSE 293,024,119404,Polikarpova; Nadezhda,9999,0,9999,0
1668435218930,CSE 293,025,119406,Politz; Joseph Gibbs,9999,0,9999,0
1668435218930,CSE 293,026,119411,Porter; George M,9999,0,9999,0
1668435218930,CSE 293,027,119414,Porter; Leonard Emerson,9999,0,9999,0
1668435218930,CSE 293,028,119416,Ramamoorthi; Ravi,9999,0,9999,0
1668435218930,CSE 293,029,119417,Sahoo; Debashis,9999,0,9999,0
1668435218930,CSE 293,030,119420,Saul; Lawrence,9999,0,9999,0
1668435218930,CSE 293,031,119421,Savage; Stefan,9999,0,9999,0
1668435218930,CSE 293,032,119425,Schulze; Jurgen P.,9999,0,9999,0
1668435218930,CSE 293,033,119426,Snoeren; Alex C.,9999,0,9999,0
1668435218930,CSE 293,034,119428,Shang; Jingbo,9999,0,9999,0
1668435218930,CSE 293,035,119430,Stefan; Deian,9999,0,9999,0
1668435218930,CSE 293,036,119431,Su; Hao,9999,0,9999,0
1668435218930,CSE 293,037,119433,Swanson; Steven James,9999,0,9999,0
1668435218930,CSE 293,038,119435,Tullsen; Dean Michael,9999,0,9999,0
1668435218930,CSE 293,039,119483,Voelker; Geoffrey M.,9999,0,9999,0
1668435218930,CSE 293,040,119537,Zhao; Jishen,9999,0,9999,0
1668435218930,CSE 293,041,119538,Zhou; Yuan-Yuan,9999,0,9999,0
1668435218930,CSE 293,042,119539,Gao; Sicun,9999,0,9999,0
1668435218930,CSE 293,043,119540,Weibel; Nadir,9999,0,9999,0
1668435218930,CSE 293,044,119541,Gupta; Rajesh K.,9999,0,9999,0
1668435218930,CSE 293,045,126410,Vaccaro; Kristen Marie,9999,0,9999,0
1668435218930,CSE 293,046,126411,Klemke; Richard,9999,0,9999,0
1668435219362,CSE 294,A00,102459,Voelker; Geoffrey M.,0,1,0,0
1668435219362,CSE 294,B00,111322,Orailoglu; Alex,0,0,0,0
1668435219792,DSE 201,A00,096914,Deutsch; Alin Bernard,30,0,30,0
1668435220232,DSE 210,A00,096915,Dasgupta; Sanjoy,30,0,30,0
1668435220658,DSE 260A,A00,096916,Altintas De Callaf; Ilkay,30,0,30,0
1668435221106,ECE 200,001,103586,Antipa; Nicholas A,9999,0,9999,0
1668435221106,ECE 200,002,103587,Atanasov; Nikolay A.,9999,0,9999,0
1668435221106,ECE 200,003,103588,Bharadia; Dinesh,9999,0,9999,0
1668435221106,ECE 200,004,103589,Cheng; Chung Kuan,9999,0,9999,0
1668435221106,ECE 200,005,103590,Cosman; Pamela C.,9999,0,9999,0
1668435221106,ECE 200,006,103591,Dayeh; Shadi Ahmad,9999,0,9999,0
1668435221106,ECE 200,007,103592,Fainman; Yeshaiahu,9999,0,9999,0
1668435221106,ECE 200,008,103593,Ford; Joseph Earl,9999,0,9999,0
1668435221106,ECE 200,009,103594,Franceschetti; Massimo,9999,0,9999,0
1668435221106,ECE 200,010,103595,Fullerton; Eric E,9999,0,9999,0
1668435221106,ECE 200,011,103596,Galton; Ian A,9999,0,9999,0
1668435221106,ECE 200,012,103597,Gilja; Vikash,9999,0,9999,0
1668435221106,ECE 200,013,103598,Hall; Drew A.,9999,0,9999,0
1668435221106,ECE 200,014,103599,Hsueh; Tzu-Chien,9999,0,9999,0
1668435221106,ECE 200,015,103600,Javidi; Tara,9999,0,9999,0
1668435221106,ECE 200,016,103601,Kahng; Andrew Byun,9999,0,9999,0
1668435221106,ECE 200,017,103602,Kim; Young-Han,9999,0,9999,0
1668435221106,ECE 200,018,103603,Koushanfar; Farinaz,9999,0,9999,0
1668435221106,ECE 200,019,103604,Kuzum; Duygu,9999,0,9999,0
1668435221106,ECE 200,020,103605,Le; Hanh-Phuc,9999,0,9999,0
1668435221106,ECE 200,021,103606,Lin; Bill,9999,0,9999,0
1668435221106,ECE 200,022,103607,Liu; Zhaowei,9998,0,9999,1
1668435221106,ECE 200,023,103608,Lo; Yu-Hwa,9999,0,9999,0
1668435221106,ECE 200,024,103609,Lomakin; Vitaliy,9999,0,9999,0
1668435221106,ECE 200,025,103610,Mercier; Patrick Philip,9999,0,9999,0
1668435221106,ECE 200,026,103611,Meyer; Florian,9999,0,9999,0
1668435221106,ECE 200,027,103612,Milstein; Laurence B.,9999,0,9999,0
1668435221106,ECE 200,028,103613,Mir Arabbaygi; Siavash,9999,0,9999,0
1668435221106,ECE 200,029,103614,Mookherjea; Shayan,9999,0,9999,0
1668435221106,ECE 200,030,103615,Morris; Karcher William,9999,0,9999,0
1668435221106,ECE 200,031,103616,Ng; Tse Nga,9999,0,9999,0
1668435221106,ECE 200,032,103617,Nguyen; Truong Quang,9999,0,9999,0
1668435221106,ECE 200,033,103618,Nomura; Kenji,9999,0,9999,0
1668435221106,ECE 200,034,103619,Orlitsky; Alon,9999,0,9999,0
1668435221106,ECE 200,035,103620,Pal; Piya,9999,0,9999,0
1668435221106,ECE 200,036,103621,Papen; George C.,9999,0,9999,0
1668435221106,ECE 200,037,103622,Radic; Stojan,9999,0,9999,0
1668435221106,ECE 200,038,103623,Rao; Bhaskar D.,9999,0,9999,0
1668435221106,ECE 200,039,103624,Rao; Ramesh R,9999,0,9999,0
1668435221106,ECE 200,040,103625,Rebeiz; Gabriel,9999,0,9999,0
1668435221106,ECE 200,041,103626,Sanford; John R,9999,0,9999,0
1668435221106,ECE 200,042,103627,Siegel; Paul H.,9999,0,9999,0
1668435221106,ECE 200,043,103628,Sievenpiper; Daniel F.,9999,0,9999,0
1668435221106,ECE 200,044,103629,Sworder; David D.,9999,0,9999,0
1668435221106,ECE 200,045,103630,Taur; Yuan,9999,0,9999,0
1668435221106,ECE 200,046,103631,Touri; Behrouz,9999,0,9999,0
1668435221106,ECE 200,047,103632,Trivedi; Mohan M.,9999,0,9999,0
1668435221106,ECE 200,048,103633,Vasconcelos; Nuno,9999,0,9999,0
1668435221106,ECE 200,049,103634,Wang; Xiaolong,9999,0,9999,0
1668435221106,ECE 200,050,103635,Xie; Pengtao,9999,0,9999,0
1668435221106,ECE 200,051,103636,Yip; Michael,9999,0,9999,0
1668435221106,ECE 200,052,103637,Zeger; Kenneth A.,999,0,999,0
1668435221106,ECE 200,053,103638,Zhang; Xinyu,9999,0,9999,0
1668435221106,ECE 200,054,103639,Turakhia; Yatish Girish,9999,0,9999,0
1668435221106,ECE 200,055,103640,Kang; Mingu,9999,0,9999,0
1668435221106,ECE 200,056,103641,Shi; Yuanyuan,9999,0,9999,0
1668435221106,ECE 200,057,103642,Wang; Edward Jay,9999,0,9999,0
1668435221106,ECE 200,058,103643,Zheng; Yang,9999,0,9999,0
1668435221535,ECE 202,A00,103644,Kuzum; Duygu,0,21,0,0
1668435221971,ECE 212BN,A00,103646,Ng; Tse Nga,0,1,0,0
1668435222404,ECE 221,A00,111493,Staff,0,0,0,0
1668435222829,ECE 222B,A00,103647,Lomakin; Vitaliy,0,5,0,0
1668435223254,ECE 230B,A00,103648,Taur; Yuan,0,0,0,0
1668435223687,ECE 238B,A00,103649,Garay; Javier,0,0,0,0
1668435224125,ECE 240B,A00,112900,Fainman; Yeshaiahu,0,4,0,0
1668435224558,ECE 247A,A00,103650,Jokerst; Jesse Vincent,0,1,0,0
1668435224991,ECE 247B,A00,103651,Wang; Joseph,0,6,0,0
1668435225426,ECE 250,A00,103652,Siegel; Paul H.,0,44,0,0
1668435225851,ECE 251A,A00,103654,Rao; Bhaskar D.,0,29,0,0
1668435226277,ECE 257B,A00,103655,Bharadia; Dinesh,0,12,0,0
1668435226701,ECE 258A,A00,103656,Milstein; Laurence B.,0,10,0,0
1668435227148,ECE 260B,A00,103658,Kang; Mingu,0,65,0,0
1668435227573,ECE 264A,A00,103659,Galton; Ian A,0,33,0,0
1668435227999,ECE 265A,A00,103661,Gudem; Prasad S.S.,0,17,0,0
1668435228425,ECE 265D,A00,103662,Gudem; Prasad S.S.,0,11,0,0
1668435228849,ECE 268,A00,103663,Koushanfar; Farinaz,0,20,0,0
1668435229359,ECE 269,A01,103665,Pal; Piya,0,130,0,0
1668435229785,ECE 271B,A00,103666,Vasconcelos; Manuela,0,47,0,0
1668435230211,ECE 276A,A00,103667,Atanasov; Nikolay A.,0,71,0,0
1668435230652,ECE 277,A00,103668,An; Cheolhong,0,90,0,0
1668435231082,ECE 279,A00,117947,Hall; Drew A.,0,12,0,0
1668435231945,ECE 283,A00,103670,Hsueh; Tzu-Chien,0,23,0,0
1668435232385,ECE 284,A00,103671,Turakhia; Yatish Girish,0,23,0,0
1668435232814,ECE 285,A00,103672,Zheng; Yang,0,24,0,0
1668435232814,ECE 285,B00,103673,Sworder; David D.,0,36,0,0
1668435233329,ECE 287,A00,103676,Javidi; Tara,0,4,0,0
1668435233753,MATH 200B,A00,098023,Salehi Golsefidy; Alireza,12,0,15,3
1668435234192,MATH 202B,A00,098024,Rhoades; Brendon Patrick,9,0,15,6
1668435234620,MATH 203B,A00,098025,Oprea; Dragos N.,10,0,15,5
1668435235052,MATH 204B,A00,098026,Sorensen; Claus M,13,0,15,2
1668435235477,MATH 208,A00,098027,Izadi; Elham,7,0,10,3
1668435235900,MATH 209,A00,098028,Pollack; Aaron,10,0,10,0
1668435236325,MATH 211A,A00,112919,Rogalski; Daniel,9,0,10,1
1668435236748,MATH 211B,A00,112920,Seward; Brandon M.,9,0,10,1
1668435237175,MATH 218,A00,098029,Li; Bo,10,0,10,0
1668435237602,MATH 220B,A00,098030,Novak; Jonathan I,11,0,15,4
1668435238034,MATH 221A,A00,098031,Ebenfelt; Peter F,13,0,15,2
1668435238462,MATH 231B,A00,098032,Zlatos; Andrej,12,0,15,3
1668435238891,MATH 240B,A00,098033,Ni; Lei,9,0,15,6
1668435239315,MATH 243,A00,098034,Jekel; David Andrew,10,0,10,0
1668435239743,MATH 245A,A00,098035,Nie; Jiawang,0,1,15,16
1668435240168,MATH 248,A00,098036,Bejenaru; Ioan,10,0,10,0
1668435240604,MATH 250B,A00,098037,Spolaor; Luca,14,0,15,1
1668435241029,MATH 258,A00,098038,Ni; Lei,10,0,10,0
1668435241465,MATH 264B,A00,098041,Rhoades; Brendon Patrick,9,0,15,6
1668435241888,MATH 268,A00,098042,Buss; Samuel R,10,0,10,0
1668435242314,MATH 269,A00,098043,Rhoades; Brendon Patrick,10,0,10,0
1668435242739,MATH 270B,A00,098044,Li; Bo,10,0,15,5
1668435243171,MATH 272B,A00,098045,Holst; Michael J,13,0,15,2
1668435243601,MATH 273A,A00,098046,Tian; Xiaochuan,10,0,15,5
1668435244027,MATH 275,A01,098048,Tian; Xiaochuan,6,0,10,4
1668435244455,MATH 278A,A00,098049,Holst; Michael J,8,0,10,2
1668435244889,MATH 278B,A00,098050,Cloninger; Alexander,10,0,10,0
1668435245315,MATH 278C,A00,098051,Nie; Jiawang,6,0,10,4
1668435245737,MATH 280B,A00,098052,Zheng; Tianyi,8,0,15,7
1668435246165,MATH 281B,A00,098053,Bradic; Jelena,0,1,15,15
1668435246591,MATH 282B,A00,098054,Arias-Castro; Ery,0,0,15,15
1668435247061,MATH 285,A00,098055,Fitzsimmons; Patrick J,0,0,15,17
1668435247496,MATH 287B,A00,098056,Arias-Castro; Ery,2,0,15,13
1668435247934,MATH 288,A00,098057,Agarwal; Pooja,9,0,10,1
1668435247934,MATH 288,B00,098058,Zhang; Danna,8,0,10,2
1668435247934,MATH 288,C00,098059,Williams; Ruth J,9,0,10,1
1668435248358,MATH 290B,A00,098060,Roberts; Justin Deritter,13,0,15,2
1668435248783,MATH 292,A00,098061,Belmont; Eva Kinoshita,10,0,10,0
1668435249207,MATH 295,A00,098062,Suk; Andrew Hoon,48,0,50,2
1668435249631,MATH 296,A00,098063,Novak; Jonathan I,20,0,20,0
1668435250056,MATH 297,001,098064,Gamst; Anthony Collins,9997,0,9999,2
1668435756271,COGS 205,A00,101395,Chiba; Andrea,19,0,20,1
1668435756702,COGS 210B,001,101404,Greene; Deanna Jacquelyn,9998,0,9999,1
1668435756702,COGS 210B,002,101417,Xia; Haijun,9999,0,9999,0
1668435756702,COGS 210B,003,101422,Nitz; Douglas A.,9999,0,9999,0
1668435756702,COGS 210B,004,101423,Hollan; James D.,9998,0,9999,1
1668435756702,COGS 210B,005,101424,Deak; Gedeon O.,9998,0,9999,1
1668435756702,COGS 210B,006,101425,Rossano; Federico,9999,0,9999,0
1668435757131,COGS 211B,A00,101427,Coulson; Seana M,9996,0,9999,3
1668435757557,COGS 220,A00,101428,Hollan; James D.,1,3,25,24
1668435757998,COGS 229,A00,101429,Dow; Steven P,18,0,25,7
1668435758425,COGS 230,A00,101430,Klemmer; Scott R,11,0,17,6
1668435758849,COGS 234,A00,101431,Xia; Haijun,2,0,25,23
1668435759275,COGS 260,A00,101432,Kiyonaga; Anastasia,21,0,25,4
1668435759275,COGS 260,B00,101433,Kirsh; David Joel,15,0,25,10
1668435759794,CSE 202,A00,102371,Impagliazzo; Russell,0,33,0,0
1668435760222,CSE 203B,A01,102373,Cheng; Chung Kuan,0,26,0,0
1668435760645,CSE 208,A00,102374,Micciancio; Daniele,0,1,0,0
1668435761073,CSE 209A,A00,112895,Impagliazzo; Russell,0,3,15,15
1668435761514,CSE 209B,A00,108005,Bellare; Mihir,0,3,0,0
1668435761941,CSE 210,A00,113163,Coblenz; Michael J,0,44,0,0
1668435762364,CSE 219,A00,106111,Dow; Steven P,0,0,20,20
1668435762792,CSE 221,A00,102376,Voelker; Geoffrey M.,0,30,0,0
1668435763218,CSE 224,A01,102378,Porter; George M,0,104,0,0
1668435763642,CSE 229A,A00,102379,Savage; Stefan,0,4,0,0
1668435764069,CSE 229C,A00,102380,Munyaka; Imani N. S.,0,4,0,0
1668435764500,CSE 232B,A00,102382,Deutsch; Alin Bernard,0,14,0,0
1668435764923,CSE 234,A01,112904,Kumar; Arun Kumar,0,0,0,0
1668435765367,CSE 237A,A00,102383,Rosing; Tajana Simunic,0,26,0,0
1668435765793,CSE 239A,A00,102384,Deutsch; Alin Bernard,0,5,0,0
1668435766217,CSE 239B,A00,102385,Polikarpova; Nadezhda,0,3,0,0
1668435766646,CSE 240A,A00,102386,Pannuto; Patrick William,0,27,0,0
1668435767074,CSE 240B,A00,102387,Zhao; Jishen,0,23,0,0
1668435767497,CSE 241A,A00,106406,Kang; Mingu,0,2,0,0
1668435767925,CSE 249B,A00,102388,Kahng; Andrew Byun,0,1,8,8
1668435768349,CSE 251B,A01,102392,Cottrell; Garrison W,0,22,0,0
1668435768349,CSE 251B,A02,102393,Cottrell; Garrison W,0,21,0,0
1668435768774,CSE 252B,A00,102394,Ochoa; Benjamin Lawrence,0,38,0,0
1668435769204,CSE 257,A01,102396,Gao; Sicun,0,86,0,0
1668435769628,CSE 272,A00,102397,Li; Tzumao,0,7,0,0
1668435770068,CSE 274,A00,111323,Chern; Albert Ren-Haur,0,7,0,0
1668435770496,CSE 282,A00,102398,Pevzner; Pavel Arkadjevich,0,0,0,0
1668435770937,CSE 284,A00,114175,Gymrek; Melissa Ann,0,12,0,0
1668435771367,CSE 290,A00,102399,Chandraker; Manmohan Krishna,0,4,0,0
1668435771367,CSE 290,B00,102400,Vaccaro; Kristen Marie,0,1,25,25
1668435771367,CSE 290,C00,102414,Pannuto; Patrick William,0,1,25,25
1668435771367,CSE 290,D00,102427,Pevzner; Pavel Arkadjevich,0,0,0,0
1668435771367,CSE 290,E00,102429,Zhao; Jishen,0,1,0,0
1668435771367,CSE 290,F00,102436,Tullsen; Dean Michael,0,2,0,0
1668435771367,CSE 290,G00,102440,Christensen; Henrik I,0,3,20,20
1668435771805,CSE 291,A00,102443,Su; Hao,0,0,0,0
1668435771805,CSE 291,B00,102448,Polikarpova; Nadezhda,0,0,0,0
1668435771805,CSE 291,C00,102453,Vaccaro; Kristen Marie,0,0,0,0
1668435771805,CSE 291,D00,111343,Savage; Stefan,0,0,0,0
1668435771805,CSE 291,E00,116474,Claffy; Kimberly Claire,0,0,0,0
1668435771805,CSE 291,F00,116479,Pasquale; Joseph,0,0,0,0
1668435772255,CSE 293,001,119111,Bafna; Vineet,9999,0,9999,0
1668435772255,CSE 293,002,119118,Bellare; Mihir,9999,0,9999,0
1668435772255,CSE 293,003,119122,Berg-Kirkpatrick; Taylor D,9999,0,9999,0
1668435772255,CSE 293,004,119135,Christensen; Henrik I,9999,0,9999,0
1668435772255,CSE 293,005,119142,Cottrell; Garrison W,9999,0,9999,0
1668435772255,CSE 293,006,119146,Deutsch; Alin Bernard,9999,0,9999,0
1668435772255,CSE 293,007,119159,Esmaeilzadeh; Hadi,9999,0,9999,0
1668435772255,CSE 293,008,119166,Freund; Yoav,9999,0,9999,0
1668435772255,CSE 293,009,119170,Griswold; William G.,9999,0,9999,0
1668435772255,CSE 293,010,119183,Gymrek; Melissa Ann,9999,0,9999,0
1668435772255,CSE 293,011,119190,Heninger; Nadia A,9999,0,9999,0
1668435772255,CSE 293,012,119230,Impagliazzo; Russell,9999,0,9999,0
1668435772255,CSE 293,013,119232,Jhala; Ranjit,9999,0,9999,0
1668435772255,CSE 293,014,119233,Kahng; Andrew Byun,9999,0,9999,0
1668435772255,CSE 293,015,119298,Kane; Daniel Mertz,9999,0,9999,0
1668435772255,CSE 293,016,119299,Kriegman; David J,9999,0,9999,0
1668435772255,CSE 293,017,119300,Kumar; Arun Kumar,9999,0,9999,0
1668435772255,CSE 293,018,119301,Lerner; Sorin,9999,0,9999,0
1668435772255,CSE 293,019,119302,Lovett; Shachar,9999,0,9999,0
1668435772255,CSE 293,020,119303,McAuley; Julian John,9999,0,9999,0
1668435772255,CSE 293,021,119304,Micciancio; Daniele,9999,0,9999,0
1668435772255,CSE 293,022,119367,Orailoglu; Alex,9999,0,9999,0
1668435772255,CSE 293,023,119382,Paturi; Ramamohan,9999,0,9999,0
1668435772255,CSE 293,024,119404,Polikarpova; Nadezhda,9999,0,9999,0
1668435772255,CSE 293,025,119406,Politz; Joseph Gibbs,9999,0,9999,0
1668435772255,CSE 293,026,119411,Porter; George M,9999,0,9999,0
1668435772255,CSE 293,027,119414,Porter; Leonard Emerson,9999,0,9999,0
1668435772255,CSE 293,028,119416,Ramamoorthi; Ravi,9999,0,9999,0
1668435772255,CSE 293,029,119417,Sahoo; Debashis,9999,0,9999,0
1668435772255,CSE 293,030,119420,Saul; Lawrence,9999,0,9999,0
1668435772255,CSE 293,031,119421,Savage; Stefan,9999,0,9999,0
1668435772255,CSE 293,032,119425,Schulze; Jurgen P.,9999,0,9999,0
1668435772255,CSE 293,033,119426,Snoeren; Alex C.,9999,0,9999,0
1668435772255,CSE 293,034,119428,Shang; Jingbo,9999,0,9999,0
1668435772255,CSE 293,035,119430,Stefan; Deian,9999,0,9999,0
1668435772255,CSE 293,036,119431,Su; Hao,9999,0,9999,0
1668435772255,CSE 293,037,119433,Swanson; Steven James,9999,0,9999,0
1668435772255,CSE 293,038,119435,Tullsen; Dean Michael,9999,0,9999,0
1668435772255,CSE 293,039,119483,Voelker; Geoffrey M.,9999,0,9999,0
1668435772255,CSE 293,040,119537,Zhao; Jishen,9999,0,9999,0
1668435772255,CSE 293,041,119538,Zhou; Yuan-Yuan,9999,0,9999,0
1668435772255,CSE 293,042,119539,Gao; Sicun,9999,0,9999,0
1668435772255,CSE 293,043,119540,Weibel; Nadir,9999,0,9999,0
1668435772255,CSE 293,044,119541,Gupta; Rajesh K.,9999,0,9999,0
1668435772255,CSE 293,045,126410,Vaccaro; Kristen Marie,9999,0,9999,0
1668435772255,CSE 293,046,126411,Klemke; Richard,9999,0,9999,0
1668435772683,CSE 294,A00,102459,Voelker; Geoffrey M.,0,1,0,0
1668435772683,CSE 294,B00,111322,Orailoglu; Alex,0,0,0,0
1668435773107,DSE 201,A00,096914,Deutsch; Alin Bernard,30,0,30,0
1668435773532,DSE 210,A00,096915,Dasgupta; Sanjoy,30,0,30,0
1668435773960,DSE 260A,A00,096916,Altintas De Callaf; Ilkay,30,0,30,0
1668435774446,ECE 200,001,103586,Antipa; Nicholas A,9999,0,9999,0
1668435774446,ECE 200,002,103587,Atanasov; Nikolay A.,9999,0,9999,0
1668435774446,ECE 200,003,103588,Bharadia; Dinesh,9999,0,9999,0
1668435774446,ECE 200,004,103589,Cheng; Chung Kuan,9999,0,9999,0
1668435774446,ECE 200,005,103590,Cosman; Pamela C.,9999,0,9999,0
1668435774446,ECE 200,006,103591,Dayeh; Shadi Ahmad,9999,0,9999,0
1668435774446,ECE 200,007,103592,Fainman; Yeshaiahu,9999,0,9999,0
1668435774446,ECE 200,008,103593,Ford; Joseph Earl,9999,0,9999,0
1668435774446,ECE 200,009,103594,Franceschetti; Massimo,9999,0,9999,0
1668435774446,ECE 200,010,103595,Fullerton; Eric E,9999,0,9999,0
1668435774446,ECE 200,011,103596,Galton; Ian A,9999,0,9999,0
1668435774446,ECE 200,012,103597,Gilja; Vikash,9999,0,9999,0
1668435774446,ECE 200,013,103598,Hall; Drew A.,9999,0,9999,0
1668435774446,ECE 200,014,103599,Hsueh; Tzu-Chien,9999,0,9999,0
1668435774446,ECE 200,015,103600,Javidi; Tara,9999,0,9999,0
1668435774446,ECE 200,016,103601,Kahng; Andrew Byun,9999,0,9999,0
1668435774446,ECE 200,017,103602,Kim; Young-Han,9999,0,9999,0
1668435774446,ECE 200,018,103603,Koushanfar; Farinaz,9999,0,9999,0
1668435774446,ECE 200,019,103604,Kuzum; Duygu,9999,0,9999,0
1668435774446,ECE 200,020,103605,Le; Hanh-Phuc,9999,0,9999,0
1668435774446,ECE 200,021,103606,Lin; Bill,9999,0,9999,0
1668435774446,ECE 200,022,103607,Liu; Zhaowei,9998,0,9999,1
1668435774446,ECE 200,023,103608,Lo; Yu-Hwa,9999,0,9999,0
1668435774446,ECE 200,024,103609,Lomakin; Vitaliy,9999,0,9999,0
1668435774446,ECE 200,025,103610,Mercier; Patrick Philip,9999,0,9999,0
1668435774446,ECE 200,026,103611,Meyer; Florian,9999,0,9999,0
1668435774446,ECE 200,027,103612,Milstein; Laurence B.,9999,0,9999,0
1668435774446,ECE 200,028,103613,Mir Arabbaygi; Siavash,9999,0,9999,0
1668435774446,ECE 200,029,103614,Mookherjea; Shayan,9999,0,9999,0
1668435774446,ECE 200,030,103615,Morris; Karcher William,9999,0,9999,0
1668435774446,ECE 200,031,103616,Ng; Tse Nga,9999,0,9999,0
1668435774446,ECE 200,032,103617,Nguyen; Truong Quang,9999,0,9999,0
1668435774446,ECE 200,033,103618,Nomura; Kenji,9999,0,9999,0
1668435774446,ECE 200,034,103619,Orlitsky; Alon,9999,0,9999,0
1668435774446,ECE 200,035,103620,Pal; Piya,9999,0,9999,0
1668435774446,ECE 200,036,103621,Papen; George C.,9999,0,9999,0
1668435774446,ECE 200,037,103622,Radic; Stojan,9999,0,9999,0
1668435774446,ECE 200,038,103623,Rao; Bhaskar D.,9999,0,9999,0
1668435774446,ECE 200,039,103624,Rao; Ramesh R,9999,0,9999,0
1668435774446,ECE 200,040,103625,Rebeiz; Gabriel,9999,0,9999,0
1668435774446,ECE 200,041,103626,Sanford; John R,9999,0,9999,0
1668435774446,ECE 200,042,103627,Siegel; Paul H.,9999,0,9999,0
1668435774446,ECE 200,043,103628,Sievenpiper; Daniel F.,9999,0,9999,0
1668435774446,ECE 200,044,103629,Sworder; David D.,9999,0,9999,0
1668435774446,ECE 200,045,103630,Taur; Yuan,9999,0,9999,0
1668435774446,ECE 200,046,103631,Touri; Behrouz,9999,0,9999,0
1668435774446,ECE 200,047,103632,Trivedi; Mohan M.,9999,0,9999,0
1668435774446,ECE 200,048,103633,Vasconcelos; Nuno,9999,0,9999,0
1668435774446,ECE 200,049,103634,Wang; Xiaolong,9999,0,9999,0
1668435774446,ECE 200,050,103635,Xie; Pengtao,9999,0,9999,0
1668435774446,ECE 200,051,103636,Yip; Michael,9999,0,9999,0
1668435774446,ECE 200,052,103637,Zeger; Kenneth A.,999,0,999,0
1668435774446,ECE 200,053,103638,Zhang; Xinyu,9999,0,9999,0
1668435774446,ECE 200,054,103639,Turakhia; Yatish Girish,9999,0,9999,0
1668435774446,ECE 200,055,103640,Kang; Mingu,9999,0,9999,0
1668435774446,ECE 200,056,103641,Shi; Yuanyuan,9999,0,9999,0
1668435774446,ECE 200,057,103642,Wang; Edward Jay,9999,0,9999,0
1668435774446,ECE 200,058,103643,Zheng; Yang,9999,0,9999,0
1668435774877,ECE 202,A00,103644,Kuzum; Duygu,0,21,0,0
1668435775305,ECE 212BN,A00,103646,Ng; Tse Nga,0,1,0,0
1668435775732,ECE 221,A00,111493,Staff,0,0,0,0
1668435776155,ECE 222B,A00,103647,Lomakin; Vitaliy,0,5,0,0
1668435776592,ECE 230B,A00,103648,Taur; Yuan,0,0,0,0
1668435777019,ECE 238B,A00,103649,Garay; Javier,0,0,0,0
1668435777450,ECE 240B,A00,112900,Fainman; Yeshaiahu,0,4,0,0
1668435777875,ECE 247A,A00,103650,Jokerst; Jesse Vincent,0,1,0,0
1668435778306,ECE 247B,A00,103651,Wang; Joseph,0,6,0,0
1668435778742,ECE 250,A00,103652,Siegel; Paul H.,0,44,0,0
1668435779170,ECE 251A,A00,103654,Rao; Bhaskar D.,0,29,0,0
1668435779595,ECE 257B,A00,103655,Bharadia; Dinesh,0,12,0,0
1668435780030,ECE 258A,A00,103656,Milstein; Laurence B.,0,10,0,0
1668435780457,ECE 260B,A00,103658,Kang; Mingu,0,65,0,0
1668435780883,ECE 264A,A00,103659,Galton; Ian A,0,33,0,0
1668435781323,ECE 265A,A00,103661,Gudem; Prasad S.S.,0,17,0,0
1668435781745,ECE 265D,A00,103662,Gudem; Prasad S.S.,0,11,0,0
1668435782187,ECE 268,A00,103663,Koushanfar; Farinaz,0,20,0,0
1668435782614,ECE 269,A01,103665,Pal; Piya,0,131,0,0
1668435783041,ECE 271B,A00,103666,Vasconcelos; Manuela,0,47,0,0
1668435783469,ECE 276A,A00,103667,Atanasov; Nikolay A.,0,72,0,0
1668435783895,ECE 277,A00,103668,An; Cheolhong,0,90,0,0
1668435784320,ECE 279,A00,117947,Hall; Drew A.,0,12,0,0
1668435785172,ECE 283,A00,103670,Hsueh; Tzu-Chien,0,23,0,0
1668435785601,ECE 284,A00,103671,Turakhia; Yatish Girish,0,23,0,0
1668435786022,ECE 285,A00,103672,Zheng; Yang,0,25,0,0
1668435786022,ECE 285,B00,103673,Sworder; David D.,0,36,0,0
1668435786455,ECE 287,A00,103676,Javidi; Tara,0,4,0,0
1668435786890,MATH 200B,A00,098023,Salehi Golsefidy; Alireza,12,0,15,3
1668435787320,MATH 202B,A00,098024,Rhoades; Brendon Patrick,9,0,15,6
1668435787750,MATH 203B,A00,098025,Oprea; Dragos N.,10,0,15,5
1668435788185,MATH 204B,A00,098026,Sorensen; Claus M,13,0,15,2
1668435788616,MATH 208,A00,098027,Izadi; Elham,7,0,10,3
1668435789045,MATH 209,A00,098028,Pollack; Aaron,10,0,10,0
1668435789473,MATH 211A,A00,112919,Rogalski; Daniel,9,0,10,1
1668435789897,MATH 211B,A00,112920,Seward; Brandon M.,9,0,10,1
1668435790331,MATH 218,A00,098029,Li; Bo,10,0,10,0
1668435790761,MATH 220B,A00,098030,Novak; Jonathan I,11,0,15,4
1668435791192,MATH 221A,A00,098031,Ebenfelt; Peter F,13,0,15,2
1668435791618,MATH 231B,A00,098032,Zlatos; Andrej,12,0,15,3
1668435792052,MATH 240B,A00,098033,Ni; Lei,9,0,15,6
1668435792488,MATH 243,A00,098034,Jekel; David Andrew,10,0,10,0
1668435792937,MATH 245A,A00,098035,Nie; Jiawang,0,1,15,16
1668435793370,MATH 248,A00,098036,Bejenaru; Ioan,10,0,10,0
1668435793807,MATH 250B,A00,098037,Spolaor; Luca,14,0,15,1
1668435794233,MATH 258,A00,098038,Ni; Lei,10,0,10,0
1668435794657,MATH 264B,A00,098041,Rhoades; Brendon Patrick,9,0,15,6
1668435795083,MATH 268,A00,098042,Buss; Samuel R,10,0,10,0
1668435795507,MATH 269,A00,098043,Rhoades; Brendon Patrick,10,0,10,0
1668435795932,MATH 270B,A00,098044,Li; Bo,10,0,15,5
1668435796357,MATH 272B,A00,098045,Holst; Michael J,13,0,15,2
1668435796781,MATH 273A,A00,098046,Tian; Xiaochuan,10,0,15,5
1668435797209,MATH 275,A01,098048,Tian; Xiaochuan,6,0,10,4
1668435797635,MATH 278A,A00,098049,Holst; Michael J,8,0,10,2
1668435798062,MATH 278B,A00,098050,Cloninger; Alexander,10,0,10,0
1668435798499,MATH 278C,A00,098051,Nie; Jiawang,6,0,10,4
1668435798938,MATH 280B,A00,098052,Zheng; Tianyi,8,0,15,7
1668435799363,MATH 281B,A00,098053,Bradic; Jelena,0,1,15,15
1668435799801,MATH 282B,A00,098054,Arias-Castro; Ery,0,0,15,15
1668435800229,MATH 285,A00,098055,Fitzsimmons; Patrick J,0,0,15,17
1668435800653,MATH 287B,A00,098056,Arias-Castro; Ery,2,0,15,13
1668435801092,MATH 288,A00,098057,Agarwal; Pooja,9,0,10,1
1668435801092,MATH 288,B00,098058,Zhang; Danna,8,0,10,2
1668435801092,MATH 288,C00,098059,Williams; Ruth J,9,0,10,1
1668435801534,MATH 290B,A00,098060,Roberts; Justin Deritter,13,0,15,2
1668435801967,MATH 292,A00,098061,Belmont; Eva Kinoshita,10,0,10,0
1668435802399,MATH 295,A00,098062,Suk; Andrew Hoon,48,0,50,2
1668435802825,MATH 296,A00,098063,Novak; Jonathan I,20,0,20,0
1668435803334,MATH 297,001,098064,Gamst; Anthony Collins,9997,0,9999,2
1668436306540,COGS 205,A00,101395,Chiba; Andrea,19,0,20,1
1668436306973,COGS 210B,001,101404,Greene; Deanna Jacquelyn,9998,0,9999,1
1668436306973,COGS 210B,002,101417,Xia; Haijun,9999,0,9999,0
1668436306973,COGS 210B,003,101422,Nitz; Douglas A.,9999,0,9999,0
1668436306973,COGS 210B,004,101423,Hollan; James D.,9998,0,9999,1
1668436306973,COGS 210B,005,101424,Deak; Gedeon O.,9998,0,9999,1
1668436306973,COGS 210B,006,101425,Rossano; Federico,9999,0,9999,0
1668436307397,COGS 211B,A00,101427,Coulson; Seana M,9996,0,9999,3
1668436307823,COGS 220,A00,101428,Hollan; James D.,1,3,25,24
1668436308247,COGS 229,A00,101429,Dow; Steven P,18,0,25,7
1668436308671,COGS 230,A00,101430,Klemmer; Scott R,11,0,17,6
1668436309099,COGS 234,A00,101431,Xia; Haijun,2,0,25,23
1668436309529,COGS 260,A00,101432,Kiyonaga; Anastasia,21,0,25,4
1668436309529,COGS 260,B00,101433,Kirsh; David Joel,15,0,25,10
1668436309953,CSE 202,A00,102371,Impagliazzo; Russell,0,33,0,0
1668436310377,CSE 203B,A01,102373,Cheng; Chung Kuan,0,26,0,0
1668436310802,CSE 208,A00,102374,Micciancio; Daniele,0,1,0,0
1668436311238,CSE 209A,A00,112895,Impagliazzo; Russell,0,3,15,15
1668436311663,CSE 209B,A00,108005,Bellare; Mihir,0,3,0,0
1668436312091,CSE 210,A00,113163,Coblenz; Michael J,0,44,0,0
1668436312530,CSE 219,A00,106111,Dow; Steven P,0,0,20,20
1668436312953,CSE 221,A00,102376,Voelker; Geoffrey M.,0,30,0,0
1668436313378,CSE 224,A01,102378,Porter; George M,0,104,0,0
1668436313801,CSE 229A,A00,102379,Savage; Stefan,0,4,0,0
1668436314225,CSE 229C,A00,102380,Munyaka; Imani N. S.,0,4,0,0
1668436314649,CSE 232B,A00,102382,Deutsch; Alin Bernard,0,14,0,0
1668436315082,CSE 234,A01,112904,Kumar; Arun Kumar,0,0,0,0
1668436315509,CSE 237A,A00,102383,Rosing; Tajana Simunic,0,26,0,0
1668436315937,CSE 239A,A00,102384,Deutsch; Alin Bernard,0,5,0,0
1668436316361,CSE 239B,A00,102385,Polikarpova; Nadezhda,0,3,0,0
1668436316784,CSE 240A,A00,102386,Pannuto; Patrick William,0,27,0,0
1668436317212,CSE 240B,A00,102387,Zhao; Jishen,0,23,0,0
1668436317645,CSE 241A,A00,106406,Kang; Mingu,0,2,0,0
1668436318079,CSE 249B,A00,102388,Kahng; Andrew Byun,0,1,8,8
1668436318503,CSE 251B,A01,102392,Cottrell; Garrison W,0,22,0,0
1668436318503,CSE 251B,A02,102393,Cottrell; Garrison W,0,21,0,0
1668436318927,CSE 252B,A00,102394,Ochoa; Benjamin Lawrence,0,38,0,0
1668436319365,CSE 257,A01,102396,Gao; Sicun,0,86,0,0
1668436319793,CSE 272,A00,102397,Li; Tzumao,0,7,0,0
1668436320227,CSE 274,A00,111323,Chern; Albert Ren-Haur,0,7,0,0
1668436320652,CSE 282,A00,102398,Pevzner; Pavel Arkadjevich,0,0,0,0
1668436321085,CSE 284,A00,114175,Gymrek; Melissa Ann,0,12,0,0
1668436321512,CSE 290,A00,102399,Chandraker; Manmohan Krishna,0,4,0,0
1668436321512,CSE 290,B00,102400,Vaccaro; Kristen Marie,0,1,25,25
1668436321512,CSE 290,C00,102414,Pannuto; Patrick William,0,1,25,25
1668436321512,CSE 290,D00,102427,Pevzner; Pavel Arkadjevich,0,0,0,0
1668436321512,CSE 290,E00,102429,Zhao; Jishen,0,1,0,0
1668436321512,CSE 290,F00,102436,Tullsen; Dean Michael,0,2,0,0
1668436321512,CSE 290,G00,102440,Christensen; Henrik I,0,3,20,20
1668436321936,CSE 291,A00,102443,Su; Hao,0,0,0,0
1668436321936,CSE 291,B00,102448,Polikarpova; Nadezhda,0,0,0,0
1668436321936,CSE 291,C00,102453,Vaccaro; Kristen Marie,0,0,0,0
1668436321936,CSE 291,D00,111343,Savage; Stefan,0,0,0,0
1668436321936,CSE 291,E00,116474,Claffy; Kimberly Claire,0,0,0,0
1668436321936,CSE 291,F00,116479,Pasquale; Joseph,0,0,0,0
1668436322369,CSE 293,001,119111,Bafna; Vineet,9999,0,9999,0
1668436322369,CSE 293,002,119118,Bellare; Mihir,9999,0,9999,0
1668436322369,CSE 293,003,119122,Berg-Kirkpatrick; Taylor D,9999,0,9999,0
1668436322369,CSE 293,004,119135,Christensen; Henrik I,9999,0,9999,0
1668436322369,CSE 293,005,119142,Cottrell; Garrison W,9999,0,9999,0
1668436322369,CSE 293,006,119146,Deutsch; Alin Bernard,9999,0,9999,0
1668436322369,CSE 293,007,119159,Esmaeilzadeh; Hadi,9999,0,9999,0
1668436322369,CSE 293,008,119166,Freund; Yoav,9999,0,9999,0
1668436322369,CSE 293,009,119170,Griswold; William G.,9999,0,9999,0
1668436322369,CSE 293,010,119183,Gymrek; Melissa Ann,9999,0,9999,0
1668436322369,CSE 293,011,119190,Heninger; Nadia A,9999,0,9999,0
1668436322369,CSE 293,012,119230,Impagliazzo; Russell,9999,0,9999,0
1668436322369,CSE 293,013,119232,Jhala; Ranjit,9999,0,9999,0
1668436322369,CSE 293,014,119233,Kahng; Andrew Byun,9999,0,9999,0
1668436322369,CSE 293,015,119298,Kane; Daniel Mertz,9999,0,9999,0
1668436322369,CSE 293,016,119299,Kriegman; David J,9999,0,9999,0
1668436322369,CSE 293,017,119300,Kumar; Arun Kumar,9999,0,9999,0
1668436322369,CSE 293,018,119301,Lerner; Sorin,9999,0,9999,0
1668436322369,CSE 293,019,119302,Lovett; Shachar,9999,0,9999,0
1668436322369,CSE 293,020,119303,McAuley; Julian John,9999,0,9999,0
1668436322369,CSE 293,021,119304,Micciancio; Daniele,9999,0,9999,0
1668436322369,CSE 293,022,119367,Orailoglu; Alex,9999,0,9999,0
1668436322369,CSE 293,023,119382,Paturi; Ramamohan,9999,0,9999,0
1668436322369,CSE 293,024,119404,Polikarpova; Nadezhda,9999,0,9999,0
1668436322369,CSE 293,025,119406,Politz; Joseph Gibbs,9999,0,9999,0
1668436322369,CSE 293,026,119411,Porter; George M,9999,0,9999,0
1668436322369,CSE 293,027,119414,Porter; Leonard Emerson,9999,0,9999,0
1668436322369,CSE 293,028,119416,Ramamoorthi; Ravi,9999,0,9999,0
1668436322369,CSE 293,029,119417,Sahoo; Debashis,9999,0,9999,0
1668436322369,CSE 293,030,119420,Saul; Lawrence,9999,0,9999,0
1668436322369,CSE 293,031,119421,Savage; Stefan,9999,0,9999,0
1668436322369,CSE 293,032,119425,Schulze; Jurgen P.,9999,0,9999,0
1668436322369,CSE 293,033,119426,Snoeren; Alex C.,9999,0,9999,0
1668436322369,CSE 293,034,119428,Shang; Jingbo,9999,0,9999,0
1668436322369,CSE 293,035,119430,Stefan; Deian,9999,0,9999,0
1668436322369,CSE 293,036,119431,Su; Hao,9999,0,9999,0
1668436322369,CSE 293,037,119433,Swanson; Steven James,9999,0,9999,0
1668436322369,CSE 293,038,119435,Tullsen; Dean Michael,9999,0,9999,0
1668436322369,CSE 293,039,119483,Voelker; Geoffrey M.,9999,0,9999,0
1668436322369,CSE 293,040,119537,Zhao; Jishen,9999,0,9999,0
1668436322369,CSE 293,041,119538,Zhou; Yuan-Yuan,9999,0,9999,0
1668436322369,CSE 293,042,119539,Gao; Sicun,9999,0,9999,0
1668436322369,CSE 293,043,119540,Weibel; Nadir,9999,0,9999,0
1668436322369,CSE 293,044,119541,Gupta; Rajesh K.,9999,0,9999,0
1668436322369,CSE 293,045,126410,Vaccaro; Kristen Marie,9999,0,9999,0
1668436322369,CSE 293,046,126411,Klemke; Richard,9999,0,9999,0
1668436322793,CSE 294,A00,102459,Voelker; Geoffrey M.,0,1,0,0
1668436322793,CSE 294,B00,111322,Orailoglu; Alex,0,0,0,0
1668436323217,DSE 201,A00,096914,Deutsch; Alin Bernard,30,0,30,0
1668436323646,DSE 210,A00,096915,Dasgupta; Sanjoy,30,0,30,0
1668436324074,DSE 260A,A00,096916,Altintas De Callaf; Ilkay,30,0,30,0
1668436324505,ECE 200,001,103586,Antipa; Nicholas A,9999,0,9999,0
1668436324505,ECE 200,002,103587,Atanasov; Nikolay A.,9999,0,9999,0
1668436324505,ECE 200,003,103588,Bharadia; Dinesh,9999,0,9999,0
1668436324505,ECE 200,004,103589,Cheng; Chung Kuan,9999,0,9999,0
1668436324505,ECE 200,005,103590,Cosman; Pamela C.,9999,0,9999,0
1668436324505,ECE 200,006,103591,Dayeh; Shadi Ahmad,9999,0,9999,0
1668436324505,ECE 200,007,103592,Fainman; Yeshaiahu,9999,0,9999,0
1668436324505,ECE 200,008,103593,Ford; Joseph Earl,9999,0,9999,0
1668436324505,ECE 200,009,103594,Franceschetti; Massimo,9999,0,9999,0
1668436324505,ECE 200,010,103595,Fullerton; Eric E,9999,0,9999,0
1668436324505,ECE 200,011,103596,Galton; Ian A,9999,0,9999,0
1668436324505,ECE 200,012,103597,Gilja; Vikash,9999,0,9999,0
1668436324505,ECE 200,013,103598,Hall; Drew A.,9999,0,9999,0
1668436324505,ECE 200,014,103599,Hsueh; Tzu-Chien,9999,0,9999,0
1668436324505,ECE 200,015,103600,Javidi; Tara,9999,0,9999,0
1668436324505,ECE 200,016,103601,Kahng; Andrew Byun,9999,0,9999,0
1668436324505,ECE 200,017,103602,Kim; Young-Han,9999,0,9999,0
1668436324505,ECE 200,018,103603,Koushanfar; Farinaz,9999,0,9999,0
1668436324505,ECE 200,019,103604,Kuzum; Duygu,9999,0,9999,0
1668436324505,ECE 200,020,103605,Le; Hanh-Phuc,9999,0,9999,0
1668436324505,ECE 200,021,103606,Lin; Bill,9999,0,9999,0
1668436324505,ECE 200,022,103607,Liu; Zhaowei,9998,0,9999,1
1668436324505,ECE 200,023,103608,Lo; Yu-Hwa,9999,0,9999,0
1668436324505,ECE 200,024,103609,Lomakin; Vitaliy,9999,0,9999,0
1668436324505,ECE 200,025,103610,Mercier; Patrick Philip,9999,0,9999,0
1668436324505,ECE 200,026,103611,Meyer; Florian,9999,0,9999,0
1668436324505,ECE 200,027,103612,Milstein; Laurence B.,9999,0,9999,0
1668436324505,ECE 200,028,103613,Mir Arabbaygi; Siavash,9999,0,9999,0
1668436324505,ECE 200,029,103614,Mookherjea; Shayan,9999,0,9999,0
1668436324505,ECE 200,030,103615,Morris; Karcher William,9999,0,9999,0
1668436324505,ECE 200,031,103616,Ng; Tse Nga,9999,0,9999,0
1668436324505,ECE 200,032,103617,Nguyen; Truong Quang,9999,0,9999,0
1668436324505,ECE 200,033,103618,Nomura; Kenji,9999,0,9999,0
1668436324505,ECE 200,034,103619,Orlitsky; Alon,9999,0,9999,0
1668436324505,ECE 200,035,103620,Pal; Piya,9999,0,9999,0
1668436324505,ECE 200,036,103621,Papen; George C.,9999,0,9999,0
1668436324505,ECE 200,037,103622,Radic; Stojan,9999,0,9999,0
1668436324505,ECE 200,038,103623,Rao; Bhaskar D.,9999,0,9999,0
1668436324505,ECE 200,039,103624,Rao; Ramesh R,9999,0,9999,0
1668436324505,ECE 200,040,103625,Rebeiz; Gabriel,9999,0,9999,0
1668436324505,ECE 200,041,103626,Sanford; John R,9999,0,9999,0
1668436324505,ECE 200,042,103627,Siegel; Paul H.,9999,0,9999,0
1668436324505,ECE 200,043,103628,Sievenpiper; Daniel F.,9999,0,9999,0
1668436324505,ECE 200,044,103629,Sworder; David D.,9999,0,9999,0
1668436324505,ECE 200,045,103630,Taur; Yuan,9999,0,9999,0
1668436324505,ECE 200,046,103631,Touri; Behrouz,9999,0,9999,0
1668436324505,ECE 200,047,103632,Trivedi; Mohan M.,9999,0,9999,0
1668436324505,ECE 200,048,103633,Vasconcelos; Nuno,9999,0,9999,0
1668436324505,ECE 200,049,103634,Wang; Xiaolong,9999,0,9999,0
1668436324505,ECE 200,050,103635,Xie; Pengtao,9999,0,9999,0
1668436324505,ECE 200,051,103636,Yip; Michael,9999,0,9999,0
1668436324505,ECE 200,052,103637,Zeger; Kenneth A.,999,0,999,0
1668436324505,ECE 200,053,103638,Zhang; Xinyu,9999,0,9999,0
1668436324505,ECE 200,054,103639,Turakhia; Yatish Girish,9999,0,9999,0
1668436324505,ECE 200,055,103640,Kang; Mingu,9999,0,9999,0
1668436324505,ECE 200,056,103641,Shi; Yuanyuan,9999,0,9999,0
1668436324505,ECE 200,057,103642,Wang; Edward Jay,9999,0,9999,0
1668436324505,ECE 200,058,103643,Zheng; Yang,9999,0,9999,0
1668436324932,ECE 202,A00,103644,Kuzum; Duygu,0,21,0,0
1668436325357,ECE 212BN,A00,103646,Ng; Tse Nga,0,1,0,0
1668436325791,ECE 221,A00,111493,Staff,0,0,0,0
1668436326215,ECE 222B,A00,103647,Lomakin; Vitaliy,0,5,0,0
1668436326748,ECE 230B,A00,103648,Taur; Yuan,0,0,0,0
1668436327174,ECE 238B,A00,103649,Garay; Javier,0,0,0,0
1668436327600,ECE 240B,A00,112900,Fainman; Yeshaiahu,0,4,0,0
1668436328025,ECE 247A,A00,103650,Jokerst; Jesse Vincent,0,1,0,0
1668436328448,ECE 247B,A00,103651,Wang; Joseph,0,6,0,0
1668436328872,ECE 250,A00,103652,Siegel; Paul H.,0,44,0,0
1668436329299,ECE 251A,A00,103654,Rao; Bhaskar D.,0,29,0,0
1668436329732,ECE 257B,A00,103655,Bharadia; Dinesh,0,12,0,0
1668436330160,ECE 258A,A00,103656,Milstein; Laurence B.,0,10,0,0
1668436330587,ECE 260B,A00,103658,Kang; Mingu,0,65,0,0
1668436331017,ECE 264A,A00,103659,Galton; Ian A,0,33,0,0
1668436331452,ECE 265A,A00,103661,Gudem; Prasad S.S.,0,17,0,0
1668436331887,ECE 265D,A00,103662,Gudem; Prasad S.S.,0,11,0,0
1668436332310,ECE 268,A00,103663,Koushanfar; Farinaz,0,20,0,0
1668436332745,ECE 269,A01,103665,Pal; Piya,0,132,0,0
1668436333170,ECE 271B,A00,103666,Vasconcelos; Manuela,0,47,0,0
1668436333598,ECE 276A,A00,103667,Atanasov; Nikolay A.,0,72,0,0
1668436334022,ECE 277,A00,103668,An; Cheolhong,0,90,0,0
1668436334449,ECE 279,A00,117947,Hall; Drew A.,0,12,0,0
1668436335299,ECE 283,A00,103670,Hsueh; Tzu-Chien,0,23,0,0
1668436335722,ECE 284,A00,103671,Turakhia; Yatish Girish,0,23,0,0
1668436336156,ECE 285,A00,103672,Zheng; Yang,0,25,0,0
1668436336156,ECE 285,B00,103673,Sworder; David D.,0,36,0,0
1668436336581,ECE 287,A00,103676,Javidi; Tara,0,4,0,0
1668436337009,MATH 200B,A00,098023,Salehi Golsefidy; Alireza,12,0,15,3
1668436337431,MATH 202B,A00,098024,Rhoades; Brendon Patrick,9,0,15,6
1668436337856,MATH 203B,A00,098025,Oprea; Dragos N.,10,0,15,5
1668436338282,MATH 204B,A00,098026,Sorensen; Claus M,13,0,15,2
1668436338712,MATH 208,A00,098027,Izadi; Elham,7,0,10,3
1668436339140,MATH 209,A00,098028,Pollack; Aaron,10,0,10,0
1668436339569,MATH 211A,A00,112919,Rogalski; Daniel,9,0,10,1
1668436339995,MATH 211B,A00,112920,Seward; Brandon M.,9,0,10,1
1668436340422,MATH 218,A00,098029,Li; Bo,10,0,10,0
1668436340849,MATH 220B,A00,098030,Novak; Jonathan I,11,0,15,4
1668436341275,MATH 221A,A00,098031,Ebenfelt; Peter F,13,0,15,2
1668436341698,MATH 231B,A00,098032,Zlatos; Andrej,12,0,15,3
1668436342123,MATH 240B,A00,098033,Ni; Lei,9,0,15,6
1668436342550,MATH 243,A00,098034,Jekel; David Andrew,10,0,10,0
1668436342991,MATH 245A,A00,098035,Nie; Jiawang,0,1,15,16
1668436343416,MATH 248,A00,098036,Bejenaru; Ioan,10,0,10,0
1668436343840,MATH 250B,A00,098037,Spolaor; Luca,14,0,15,1
1668436344266,MATH 258,A00,098038,Ni; Lei,10,0,10,0
1668436344690,MATH 264B,A00,098041,Rhoades; Brendon Patrick,9,0,15,6
1668436345129,MATH 268,A00,098042,Buss; Samuel R,10,0,10,0
1668436345552,MATH 269,A00,098043,Rhoades; Brendon Patrick,10,0,10,0
1668436345980,MATH 270B,A00,098044,Li; Bo,10,0,15,5
1668436346411,MATH 272B,A00,098045,Holst; Michael J,13,0,15,2
1668436346838,MATH 273A,A00,098046,Tian; Xiaochuan,10,0,15,5
1668436347265,MATH 275,A01,098048,Tian; Xiaochuan,6,0,10,4
1668436347694,MATH 278A,A00,098049,Holst; Michael J,8,0,10,2
1668436348120,MATH 278B,A00,098050,Cloninger; Alexander,10,0,10,0
1668436348551,MATH 278C,A00,098051,Nie; Jiawang,6,0,10,4
1668436348975,MATH 280B,A00,098052,Zheng; Tianyi,8,0,15,7
1668436349398,MATH 281B,A00,098053,Bradic; Jelena,0,1,15,15
1668436349829,MATH 282B,A00,098054,Arias-Castro; Ery,0,0,15,15
1668436350273,MATH 285,A00,098055,Fitzsimmons; Patrick J,0,0,15,17
1668436350701,MATH 287B,A00,098056,Arias-Castro; Ery,2,0,15,13
1668436351139,MATH 288,A00,098057,Agarwal; Pooja,9,0,10,1
1668436351139,MATH 288,B00,098058,Zhang; Danna,8,0,10,2
1668436351139,MATH 288,C00,098059,Williams; Ruth J,9,0,10,1
1668436351562,MATH 290B,A00,098060,Roberts; Justin Deritter,13,0,15,2
1668436351997,MATH 292,A00,098061,Belmont; Eva Kinoshita,10,0,10,0
1668436352420,MATH 295,A00,098062,Suk; Andrew Hoon,48,0,50,2
1668436352857,MATH 296,A00,098063,Novak; Jonathan I,20,0,20,0
1668436353281,MATH 297,001,098064,Gamst; Anthony Collins,9997,0,9999,2
1668436856174,COGS 205,A00,101395,Chiba; Andrea,19,0,20,1
1668436856604,COGS 210B,001,101404,Greene; Deanna Jacquelyn,9998,0,9999,1
1668436856604,COGS 210B,002,101417,Xia; Haijun,9999,0,9999,0
1668436856604,COGS 210B,003,101422,Nitz; Douglas A.,9999,0,9999,0
1668436856604,COGS 210B,004,101423,Hollan; James D.,9998,0,9999,1
1668436856604,COGS 210B,005,101424,Deak; Gedeon O.,9998,0,9999,1
1668436856604,COGS 210B,006,101425,Rossano; Federico,9999,0,9999,0
1668436857035,COGS 211B,A00,101427,Coulson; Seana M,9996,0,9999,3
1668436857459,COGS 220,A00,101428,Hollan; James D.,1,3,25,24
1668436857884,COGS 229,A00,101429,Dow; Steven P,18,0,25,7
1668436858310,COGS 230,A00,101430,Klemmer; Scott R,11,0,17,6
1668436858735,COGS 234,A00,101431,Xia; Haijun,2,0,25,23
1668436859165,COGS 260,A00,101432,Kiyonaga; Anastasia,21,0,25,4
1668436859165,COGS 260,B00,101433,Kirsh; David Joel,15,0,25,10
1668436859595,CSE 202,A00,102371,Impagliazzo; Russell,0,33,0,0
1668436860018,CSE 203B,A01,102373,Cheng; Chung Kuan,0,26,0,0
1668436860450,CSE 208,A00,102374,Micciancio; Daniele,0,1,0,0
1668436860875,CSE 209A,A00,112895,Impagliazzo; Russell,0,3,15,15
1668436861301,CSE 209B,A00,108005,Bellare; Mihir,0,3,0,0
1668436861731,CSE 210,A00,113163,Coblenz; Michael J,0,44,0,0
1668436862160,CSE 219,A00,106111,Dow; Steven P,0,0,20,20
1668436862592,CSE 221,A00,102376,Voelker; Geoffrey M.,0,30,0,0
1668436863019,CSE 224,A01,102378,Porter; George M,0,104,0,0
1668436863455,CSE 229A,A00,102379,Savage; Stefan,0,4,0,0
1668436863881,CSE 229C,A00,102380,Munyaka; Imani N. S.,0,4,0,0
1668436864318,CSE 232B,A00,102382,Deutsch; Alin Bernard,0,14,0,0
1668436864750,CSE 234,A01,112904,Kumar; Arun Kumar,0,0,0,0
1668436865177,CSE 237A,A00,102383,Rosing; Tajana Simunic,0,26,0,0
1668436865602,CSE 239A,A00,102384,Deutsch; Alin Bernard,0,5,0,0
1668436866027,CSE 239B,A00,102385,Polikarpova; Nadezhda,0,3,0,0
1668436866455,CSE 240A,A00,102386,Pannuto; Patrick William,0,27,0,0
1668436866878,CSE 240B,A00,102387,Zhao; Jishen,0,23,0,0
1668436867323,CSE 241A,A00,106406,Kang; Mingu,0,2,0,0
1668436867753,CSE 249B,A00,102388,Kahng; Andrew Byun,0,1,8,8
1668436868179,CSE 251B,A01,102392,Cottrell; Garrison W,0,23,0,0
1668436868179,CSE 251B,A02,102393,Cottrell; Garrison W,0,21,0,0
1668436868603,CSE 252B,A00,102394,Ochoa; Benjamin Lawrence,0,38,0,0
1668436869030,CSE 257,A01,102396,Gao; Sicun,0,86,0,0
1668436869458,CSE 272,A00,102397,Li; Tzumao,0,7,0,0
1668436869881,CSE 274,A00,111323,Chern; Albert Ren-Haur,0,7,0,0
1668436870304,CSE 282,A00,102398,Pevzner; Pavel Arkadjevich,0,0,0,0
1668436870728,CSE 284,A00,114175,Gymrek; Melissa Ann,0,12,0,0
1668436871154,CSE 290,A00,102399,Chandraker; Manmohan Krishna,0,4,0,0
1668436871154,CSE 290,B00,102400,Vaccaro; Kristen Marie,0,1,25,25
1668436871154,CSE 290,C00,102414,Pannuto; Patrick William,0,1,25,25
1668436871154,CSE 290,D00,102427,Pevzner; Pavel Arkadjevich,0,0,0,0
1668436871154,CSE 290,E00,102429,Zhao; Jishen,0,1,0,0
1668436871154,CSE 290,F00,102436,Tullsen; Dean Michael,0,2,0,0
1668436871154,CSE 290,G00,102440,Christensen; Henrik I,0,3,20,20
1668436871590,CSE 291,A00,102443,Su; Hao,0,0,0,0
1668436871590,CSE 291,B00,102448,Polikarpova; Nadezhda,0,0,0,0
1668436871590,CSE 291,C00,102453,Vaccaro; Kristen Marie,0,0,0,0
1668436871590,CSE 291,D00,111343,Savage; Stefan,0,0,0,0
1668436871590,CSE 291,E00,116474,Claffy; Kimberly Claire,0,0,0,0
1668436871590,CSE 291,F00,116479,Pasquale; Joseph,0,0,0,0
1668436872020,CSE 293,001,119111,Bafna; Vineet,9999,0,9999,0
1668436872020,CSE 293,002,119118,Bellare; Mihir,9999,0,9999,0
1668436872020,CSE 293,003,119122,Berg-Kirkpatrick; Taylor D,9999,0,9999,0
1668436872020,CSE 293,004,119135,Christensen; Henrik I,9999,0,9999,0
1668436872020,CSE 293,005,119142,Cottrell; Garrison W,9999,0,9999,0
1668436872020,CSE 293,006,119146,Deutsch; Alin Bernard,9999,0,9999,0
1668436872020,CSE 293,007,119159,Esmaeilzadeh; Hadi,9999,0,9999,0
1668436872020,CSE 293,008,119166,Freund; Yoav,9999,0,9999,0
1668436872020,CSE 293,009,119170,Griswold; William G.,9999,0,9999,0
1668436872020,CSE 293,010,119183,Gymrek; Melissa Ann,9999,0,9999,0
1668436872020,CSE 293,011,119190,Heninger; Nadia A,9999,0,9999,0
1668436872020,CSE 293,012,119230,Impagliazzo; Russell,9999,0,9999,0
1668436872020,CSE 293,013,119232,Jhala; Ranjit,9999,0,9999,0
1668436872020,CSE 293,014,119233,Kahng; Andrew Byun,9999,0,9999,0
1668436872020,CSE 293,015,119298,Kane; Daniel Mertz,9999,0,9999,0
1668436872020,CSE 293,016,119299,Kriegman; David J,9999,0,9999,0
1668436872020,CSE 293,017,119300,Kumar; Arun Kumar,9999,0,9999,0
1668436872020,CSE 293,018,119301,Lerner; Sorin,9999,0,9999,0
1668436872020,CSE 293,019,119302,Lovett; Shachar,9999,0,9999,0
1668436872020,CSE 293,020,119303,McAuley; Julian John,9999,0,9999,0
1668436872020,CSE 293,021,119304,Micciancio; Daniele,9999,0,9999,0
1668436872020,CSE 293,022,119367,Orailoglu; Alex,9999,0,9999,0
1668436872020,CSE 293,023,119382,Paturi; Ramamohan,9999,0,9999,0
1668436872020,CSE 293,024,119404,Polikarpova; Nadezhda,9999,0,9999,0
1668436872020,CSE 293,025,119406,Politz; Joseph Gibbs,9999,0,9999,0
1668436872020,CSE 293,026,119411,Porter; George M,9999,0,9999,0
1668436872020,CSE 293,027,119414,Porter; Leonard Emerson,9999,0,9999,0
1668436872020,CSE 293,028,119416,Ramamoorthi; Ravi,9999,0,9999,0
1668436872020,CSE 293,029,119417,Sahoo; Debashis,9999,0,9999,0
1668436872020,CSE 293,030,119420,Saul; Lawrence,9999,0,9999,0
1668436872020,CSE 293,031,119421,Savage; Stefan,9999,0,9999,0
1668436872020,CSE 293,032,119425,Schulze; Jurgen P.,9999,0,9999,0
1668436872020,CSE 293,033,119426,Snoeren; Alex C.,9999,0,9999,0
1668436872020,CSE 293,034,119428,Shang; Jingbo,9999,0,9999,0
1668436872020,CSE 293,035,119430,Stefan; Deian,9999,0,9999,0
1668436872020,CSE 293,036,119431,Su; Hao,9999,0,9999,0
1668436872020,CSE 293,037,119433,Swanson; Steven James,9999,0,9999,0
1668436872020,CSE 293,038,119435,Tullsen; Dean Michael,9999,0,9999,0
1668436872020,CSE 293,039,119483,Voelker; Geoffrey M.,9999,0,9999,0
1668436872020,CSE 293,040,119537,Zhao; Jishen,9999,0,9999,0
1668436872020,CSE 293,041,119538,Zhou; Yuan-Yuan,9999,0,9999,0
1668436872020,CSE 293,042,119539,Gao; Sicun,9999,0,9999,0
1668436872020,CSE 293,043,119540,Weibel; Nadir,9999,0,9999,0
1668436872020,CSE 293,044,119541,Gupta; Rajesh K.,9999,0,9999,0
1668436872020,CSE 293,045,126410,Vaccaro; Kristen Marie,9999,0,9999,0
1668436872020,CSE 293,046,126411,Klemke; Richard,9999,0,9999,0
1668436872449,CSE 294,A00,102459,Voelker; Geoffrey M.,0,1,0,0
1668436872449,CSE 294,B00,111322,Orailoglu; Alex,0,0,0,0
1668436872873,DSE 201,A00,096914,Deutsch; Alin Bernard,30,0,30,0
1668436873300,DSE 210,A00,096915,Dasgupta; Sanjoy,30,0,30,0
1668436873735,DSE 260A,A00,096916,Altintas De Callaf; Ilkay,30,0,30,0
1668436874201,ECE 200,001,103586,Antipa; Nicholas A,9999,0,9999,0
1668436874201,ECE 200,002,103587,Atanasov; Nikolay A.,9999,0,9999,0
1668436874201,ECE 200,003,103588,Bharadia; Dinesh,9999,0,9999,0
1668436874201,ECE 200,004,103589,Cheng; Chung Kuan,9999,0,9999,0
1668436874201,ECE 200,005,103590,Cosman; Pamela C.,9999,0,9999,0
1668436874201,ECE 200,006,103591,Dayeh; Shadi Ahmad,9999,0,9999,0
1668436874201,ECE 200,007,103592,Fainman; Yeshaiahu,9999,0,9999,0
1668436874201,ECE 200,008,103593,Ford; Joseph Earl,9999,0,9999,0
1668436874201,ECE 200,009,103594,Franceschetti; Massimo,9999,0,9999,0
1668436874201,ECE 200,010,103595,Fullerton; Eric E,9999,0,9999,0
1668436874201,ECE 200,011,103596,Galton; Ian A,9999,0,9999,0
1668436874201,ECE 200,012,103597,Gilja; Vikash,9999,0,9999,0
1668436874201,ECE 200,013,103598,Hall; Drew A.,9999,0,9999,0
1668436874201,ECE 200,014,103599,Hsueh; Tzu-Chien,9999,0,9999,0
1668436874201,ECE 200,015,103600,Javidi; Tara,9999,0,9999,0
1668436874201,ECE 200,016,103601,Kahng; Andrew Byun,9999,0,9999,0
1668436874201,ECE 200,017,103602,Kim; Young-Han,9999,0,9999,0
1668436874201,ECE 200,018,103603,Koushanfar; Farinaz,9999,0,9999,0
1668436874201,ECE 200,019,103604,Kuzum; Duygu,9999,0,9999,0
1668436874201,ECE 200,020,103605,Le; Hanh-Phuc,9999,0,9999,0
1668436874201,ECE 200,021,103606,Lin; Bill,9999,0,9999,0
1668436874201,ECE 200,022,103607,Liu; Zhaowei,9998,0,9999,1
1668436874201,ECE 200,023,103608,Lo; Yu-Hwa,9999,0,9999,0
1668436874201,ECE 200,024,103609,Lomakin; Vitaliy,9999,0,9999,0
1668436874201,ECE 200,025,103610,Mercier; Patrick Philip,9999,0,9999,0
1668436874201,ECE 200,026,103611,Meyer; Florian,9999,0,9999,0
1668436874201,ECE 200,027,103612,Milstein; Laurence B.,9999,0,9999,0
1668436874201,ECE 200,028,103613,Mir Arabbaygi; Siavash,9999,0,9999,0
1668436874201,ECE 200,029,103614,Mookherjea; Shayan,9999,0,9999,0
1668436874201,ECE 200,030,103615,Morris; Karcher William,9999,0,9999,0
1668436874201,ECE 200,031,103616,Ng; Tse Nga,9999,0,9999,0
1668436874201,ECE 200,032,103617,Nguyen; Truong Quang,9999,0,9999,0
1668436874201,ECE 200,033,103618,Nomura; Kenji,9999,0,9999,0
1668436874201,ECE 200,034,103619,Orlitsky; Alon,9999,0,9999,0
1668436874201,ECE 200,035,103620,Pal; Piya,9999,0,9999,0
1668436874201,ECE 200,036,103621,Papen; George C.,9999,0,9999,0
1668436874201,ECE 200,037,103622,Radic; Stojan,9999,0,9999,0
1668436874201,ECE 200,038,103623,Rao; Bhaskar D.,9999,0,9999,0
1668436874201,ECE 200,039,103624,Rao; Ramesh R,9999,0,9999,0
1668436874201,ECE 200,040,103625,Rebeiz; Gabriel,9999,0,9999,0
1668436874201,ECE 200,041,103626,Sanford; John R,9999,0,9999,0
1668436874201,ECE 200,042,103627,Siegel; Paul H.,9999,0,9999,0
1668436874201,ECE 200,043,103628,Sievenpiper; Daniel F.,9999,0,9999,0
1668436874201,ECE 200,044,103629,Sworder; David D.,9999,0,9999,0
1668436874201,ECE 200,045,103630,Taur; Yuan,9999,0,9999,0
1668436874201,ECE 200,046,103631,Touri; Behrouz,9999,0,9999,0
1668436874201,ECE 200,047,103632,Trivedi; Mohan M.,9999,0,9999,0
1668436874201,ECE 200,048,103633,Vasconcelos; Nuno,9999,0,9999,0
1668436874201,ECE 200,049,103634,Wang; Xiaolong,9999,0,9999,0
1668436874201,ECE 200,050,103635,Xie; Pengtao,9999,0,9999,0
1668436874201,ECE 200,051,103636,Yip; Michael,9999,0,9999,0
1668436874201,ECE 200,052,103637,Zeger; Kenneth A.,999,0,999,0
1668436874201,ECE 200,053,103638,Zhang; Xinyu,9999,0,9999,0
1668436874201,ECE 200,054,103639,Turakhia; Yatish Girish,9999,0,9999,0
1668436874201,ECE 200,055,103640,Kang; Mingu,9999,0,9999,0
1668436874201,ECE 200,056,103641,Shi; Yuanyuan,9999,0,9999,0
1668436874201,ECE 200,057,103642,Wang; Edward Jay,9999,0,9999,0
1668436874201,ECE 200,058,103643,Zheng; Yang,9999,0,9999,0
1668436874641,ECE 202,A00,103644,Kuzum; Duygu,0,21,0,0
1668436875080,ECE 212BN,A00,103646,Ng; Tse Nga,0,1,0,0
1668436875502,ECE 221,A00,111493,Staff,0,0,0,0
1668436875928,ECE 222B,A00,103647,Lomakin; Vitaliy,0,5,0,0
1668436876349,ECE 230B,A00,103648,Taur; Yuan,0,0,0,0
1668436876773,ECE 238B,A00,103649,Garay; Javier,0,0,0,0
1668436877196,ECE 240B,A00,112900,Fainman; Yeshaiahu,0,4,0,0
1668436877629,ECE 247A,A00,103650,Jokerst; Jesse Vincent,0,1,0,0
1668436878053,ECE 247B,A00,103651,Wang; Joseph,0,6,0,0
1668436878482,ECE 250,A00,103652,Siegel; Paul H.,0,44,0,0
1668436878915,ECE 251A,A00,103654,Rao; Bhaskar D.,0,29,0,0
1668436879340,ECE 257B,A00,103655,Bharadia; Dinesh,0,12,0,0
1668436879762,ECE 258A,A00,103656,Milstein; Laurence B.,0,10,0,0
1668436880199,ECE 260B,A00,103658,Kang; Mingu,0,65,0,0
1668436880626,ECE 264A,A00,103659,Galton; Ian A,0,33,0,0
1668436881053,ECE 265A,A00,103661,Gudem; Prasad S.S.,0,17,0,0
1668436881479,ECE 265D,A00,103662,Gudem; Prasad S.S.,0,11,0,0
1668436881902,ECE 268,A00,103663,Koushanfar; Farinaz,0,20,0,0
1668436882334,ECE 269,A01,103665,Pal; Piya,0,133,0,0
1668436882762,ECE 271B,A00,103666,Vasconcelos; Manuela,0,47,0,0
1668436883200,ECE 276A,A00,103667,Atanasov; Nikolay A.,0,72,0,0
1668436883624,ECE 277,A00,103668,An; Cheolhong,0,90,0,0
1668436884048,ECE 279,A00,117947,Hall; Drew A.,0,12,0,0
1668436884900,ECE 283,A00,103670,Hsueh; Tzu-Chien,0,23,0,0
1668436885325,ECE 284,A00,103671,Turakhia; Yatish Girish,0,23,0,0
1668436885751,ECE 285,A00,103672,Zheng; Yang,0,25,0,0
1668436885751,ECE 285,B00,103673,Sworder; David D.,0,36,0,0
1668436886178,ECE 287,A00,103676,Javidi; Tara,0,4,0,0
1668436886603,MATH 200B,A00,098023,Salehi Golsefidy; Alireza,12,0,15,3
1668436887027,MATH 202B,A00,098024,Rhoades; Brendon Patrick,9,0,15,6
1668436887454,MATH 203B,A00,098025,Oprea; Dragos N.,10,0,15,5
1668436887879,MATH 204B,A00,098026,Sorensen; Claus M,13,0,15,2
1668436888302,MATH 208,A00,098027,Izadi; Elham,7,0,10,3
1668436888725,MATH 209,A00,098028,Pollack; Aaron,10,0,10,0
1668436889147,MATH 211A,A00,112919,Rogalski; Daniel,9,0,10,1
1668436889584,MATH 211B,A00,112920,Seward; Brandon M.,9,0,10,1
1668436890020,MATH 218,A00,098029,Li; Bo,10,0,10,0
1668436890450,MATH 220B,A00,098030,Novak; Jonathan I,11,0,15,4
1668436890877,MATH 221A,A00,098031,Ebenfelt; Peter F,13,0,15,2
1668436891303,MATH 231B,A00,098032,Zlatos; Andrej,12,0,15,3
1668436891728,MATH 240B,A00,098033,Ni; Lei,9,0,15,6
1668436892151,MATH 243,A00,098034,Jekel; David Andrew,10,0,10,0
1668436892576,MATH 245A,A00,098035,Nie; Jiawang,0,1,15,16
1668436893074,MATH 248,A00,098036,Bejenaru; Ioan,10,0,10,0
1668436893501,MATH 250B,A00,098037,Spolaor; Luca,14,0,15,1
1668436893925,MATH 258,A00,098038,Ni; Lei,10,0,10,0
1668436894354,MATH 264B,A00,098041,Rhoades; Brendon Patrick,9,0,15,6
1668436894781,MATH 268,A00,098042,Buss; Samuel R,10,0,10,0
1668436895204,MATH 269,A00,098043,Rhoades; Brendon Patrick,10,0,10,0
1668436895641,MATH 270B,A00,098044,Li; Bo,10,0,15,5
1668436896065,MATH 272B,A00,098045,Holst; Michael J,13,0,15,2
1668436896496,MATH 273A,A00,098046,Tian; Xiaochuan,10,0,15,5
1668436896919,MATH 275,A01,098048,Tian; Xiaochuan,6,0,10,4
1668436897343,MATH 278A,A00,098049,Holst; Michael J,8,0,10,2
1668436897784,MATH 278B,A00,098050,Cloninger; Alexander,10,0,10,0
1668436898211,MATH 278C,A00,098051,Nie; Jiawang,6,0,10,4
1668436898636,MATH 280B,A00,098052,Zheng; Tianyi,8,0,15,7
1668436899065,MATH 281B,A00,098053,Bradic; Jelena,0,1,15,15
1668436899490,MATH 282B,A00,098054,Arias-Castro; Ery,0,0,15,15
1668436899915,MATH 285,A00,098055,Fitzsimmons; Patrick J,0,0,15,17
1668436900340,MATH 287B,A00,098056,Arias-Castro; Ery,2,0,15,13
1668436900764,MATH 288,A00,098057,Agarwal; Pooja,9,0,10,1
1668436900764,MATH 288,B00,098058,Zhang; Danna,8,0,10,2
1668436900764,MATH 288,C00,098059,Williams; Ruth J,9,0,10,1
1668436901196,MATH 290B,A00,098060,Roberts; Justin Deritter,13,0,15,2
1668436901624,MATH 292,A00,098061,Belmont; Eva Kinoshita,10,0,10,0
1668436902053,MATH 295,A00,098062,Suk; Andrew Hoon,48,0,50,2
1668436902480,MATH 296,A00,098063,Novak; Jonathan I,20,0,20,0
1668436902907,MATH 297,001,098064,Gamst; Anthony Collins,9997,0,9999,2
1668437405467,COGS 205,A00,101395,Chiba; Andrea,19,0,20,1
1668437405892,COGS 210B,001,101404,Greene; Deanna Jacquelyn,9998,0,9999,1
1668437405892,COGS 210B,002,101417,Xia; Haijun,9999,0,9999,0
1668437405892,COGS 210B,003,101422,Nitz; Douglas A.,9999,0,9999,0
1668437405892,COGS 210B,004,101423,Hollan; James D.,9998,0,9999,1
1668437405892,COGS 210B,005,101424,Deak; Gedeon O.,9998,0,9999,1
1668437405892,COGS 210B,006,101425,Rossano; Federico,9999,0,9999,0
1668437406330,COGS 211B,A00,101427,Coulson; Seana M,9996,0,9999,3
1668437406757,COGS 220,A00,101428,Hollan; James D.,1,3,25,24
1668437407187,COGS 229,A00,101429,Dow; Steven P,18,0,25,7
1668437407618,COGS 230,A00,101430,Klemmer; Scott R,11,0,17,6
1668437408046,COGS 234,A00,101431,Xia; Haijun,2,0,25,23
1668437408492,COGS 260,A00,101432,Kiyonaga; Anastasia,21,0,25,4
1668437408492,COGS 260,B00,101433,Kirsh; David Joel,15,0,25,10
1668437408915,CSE 202,A00,102371,Impagliazzo; Russell,0,34,0,0
1668437409340,CSE 203B,A01,102373,Cheng; Chung Kuan,0,26,0,0
1668437409769,CSE 208,A00,102374,Micciancio; Daniele,0,1,0,0
1668437410203,CSE 209A,A00,112895,Impagliazzo; Russell,0,4,15,15
1668437410637,CSE 209B,A00,108005,Bellare; Mihir,0,3,0,0
1668437411069,CSE 210,A00,113163,Coblenz; Michael J,0,44,0,0
1668437411493,CSE 219,A00,106111,Dow; Steven P,0,0,20,20
1668437411918,CSE 221,A00,102376,Voelker; Geoffrey M.,0,30,0,0
1668437412352,CSE 224,A01,102378,Porter; George M,0,104,0,0
1668437412787,CSE 229A,A00,102379,Savage; Stefan,0,4,0,0
1668437413211,CSE 229C,A00,102380,Munyaka; Imani N. S.,0,4,0,0
1668437413638,CSE 232B,A00,102382,Deutsch; Alin Bernard,0,15,0,0
1668437414063,CSE 234,A01,112904,Kumar; Arun Kumar,0,0,0,0
1668437414488,CSE 237A,A00,102383,Rosing; Tajana Simunic,0,26,0,0
1668437414910,CSE 239A,A00,102384,Deutsch; Alin Bernard,0,6,0,0
1668437415335,CSE 239B,A00,102385,Polikarpova; Nadezhda,0,3,0,0
1668437415844,CSE 240A,A00,102386,Pannuto; Patrick William,0,27,0,0
1668437416273,CSE 240B,A00,102387,Zhao; Jishen,0,23,0,0
1668437416699,CSE 241A,A00,106406,Kang; Mingu,0,2,0,0
1668437417126,CSE 249B,A00,102388,Kahng; Andrew Byun,0,1,8,8
1668437417555,CSE 251B,A01,102392,Cottrell; Garrison W,0,24,0,0
1668437417555,CSE 251B,A02,102393,Cottrell; Garrison W,0,21,0,0
1668437417979,CSE 252B,A00,102394,Ochoa; Benjamin Lawrence,0,38,0,0
1668437418413,CSE 257,A01,102396,Gao; Sicun,0,86,0,0
1668437418836,CSE 272,A00,102397,Li; Tzumao,0,7,0,0
1668437419265,CSE 274,A00,111323,Chern; Albert Ren-Haur,0,7,0,0
1668437419691,CSE 282,A00,102398,Pevzner; Pavel Arkadjevich,0,0,0,0
1668437420119,CSE 284,A00,114175,Gymrek; Melissa Ann,0,12,0,0
1668437420547,CSE 290,A00,102399,Chandraker; Manmohan Krishna,0,4,0,0
1668437420547,CSE 290,B00,102400,Vaccaro; Kristen Marie,0,1,25,25
1668437420547,CSE 290,C00,102414,Pannuto; Patrick William,0,1,25,25
1668437420547,CSE 290,D00,102427,Pevzner; Pavel Arkadjevich,0,0,0,0
1668437420547,CSE 290,E00,102429,Zhao; Jishen,0,2,0,0
1668437420547,CSE 290,F00,102436,Tullsen; Dean Michael,0,3,0,0
1668437420547,CSE 290,G00,102440,Christensen; Henrik I,0,3,20,20
1668437420972,CSE 291,A00,102443,Su; Hao,0,0,0,0
1668437420972,CSE 291,B00,102448,Polikarpova; Nadezhda,0,0,0,0
1668437420972,CSE 291,C00,102453,Vaccaro; Kristen Marie,0,0,0,0
1668437420972,CSE 291,D00,111343,Savage; Stefan,0,0,0,0
1668437420972,CSE 291,E00,116474,Claffy; Kimberly Claire,0,0,0,0
1668437420972,CSE 291,F00,116479,Pasquale; Joseph,0,0,0,0
1668437421401,CSE 293,001,119111,Bafna; Vineet,9999,0,9999,0
1668437421401,CSE 293,002,119118,Bellare; Mihir,9999,0,9999,0
1668437421401,CSE 293,003,119122,Berg-Kirkpatrick; Taylor D,9999,0,9999,0
1668437421401,CSE 293,004,119135,Christensen; Henrik I,9999,0,9999,0
1668437421401,CSE 293,005,119142,Cottrell; Garrison W,9999,0,9999,0
1668437421401,CSE 293,006,119146,Deutsch; Alin Bernard,9999,0,9999,0
1668437421401,CSE 293,007,119159,Esmaeilzadeh; Hadi,9999,0,9999,0
1668437421401,CSE 293,008,119166,Freund; Yoav,9999,0,9999,0
1668437421401,CSE 293,009,119170,Griswold; William G.,9999,0,9999,0
1668437421401,CSE 293,010,119183,Gymrek; Melissa Ann,9999,0,9999,0
1668437421401,CSE 293,011,119190,Heninger; Nadia A,9999,0,9999,0
1668437421401,CSE 293,012,119230,Impagliazzo; Russell,9999,0,9999,0
1668437421401,CSE 293,013,119232,Jhala; Ranjit,9999,0,9999,0
1668437421401,CSE 293,014,119233,Kahng; Andrew Byun,9999,0,9999,0
1668437421401,CSE 293,015,119298,Kane; Daniel Mertz,9999,0,9999,0
1668437421401,CSE 293,016,119299,Kriegman; David J,9999,0,9999,0
1668437421401,CSE 293,017,119300,Kumar; Arun Kumar,9999,0,9999,0
1668437421401,CSE 293,018,119301,Lerner; Sorin,9999,0,9999,0
1668437421401,CSE 293,019,119302,Lovett; Shachar,9999,0,9999,0
1668437421401,CSE 293,020,119303,McAuley; Julian John,9999,0,9999,0
1668437421401,CSE 293,021,119304,Micciancio; Daniele,9999,0,9999,0
1668437421401,CSE 293,022,119367,Orailoglu; Alex,9999,0,9999,0
1668437421401,CSE 293,023,119382,Paturi; Ramamohan,9999,0,9999,0
1668437421401,CSE 293,024,119404,Polikarpova; Nadezhda,9999,0,9999,0
1668437421401,CSE 293,025,119406,Politz; Joseph Gibbs,9999,0,9999,0
1668437421401,CSE 293,026,119411,Porter; George M,9999,0,9999,0
1668437421401,CSE 293,027,119414,Porter; Leonard Emerson,9999,0,9999,0
1668437421401,CSE 293,028,119416,Ramamoorthi; Ravi,9999,0,9999,0
1668437421401,CSE 293,029,119417,Sahoo; Debashis,9999,0,9999,0
1668437421401,CSE 293,030,119420,Saul; Lawrence,9999,0,9999,0
1668437421401,CSE 293,031,119421,Savage; Stefan,9999,0,9999,0
1668437421401,CSE 293,032,119425,Schulze; Jurgen P.,9999,0,9999,0
1668437421401,CSE 293,033,119426,Snoeren; Alex C.,9999,0,9999,0
1668437421401,CSE 293,034,119428,Shang; Jingbo,9999,0,9999,0
1668437421401,CSE 293,035,119430,Stefan; Deian,9999,0,9999,0
1668437421401,CSE 293,036,119431,Su; Hao,9999,0,9999,0
1668437421401,CSE 293,037,119433,Swanson; Steven James,9999,0,9999,0
1668437421401,CSE 293,038,119435,Tullsen; Dean Michael,9999,0,9999,0
1668437421401,CSE 293,039,119483,Voelker; Geoffrey M.,9999,0,9999,0
1668437421401,CSE 293,040,119537,Zhao; Jishen,9999,0,9999,0
1668437421401,CSE 293,041,119538,Zhou; Yuan-Yuan,9999,0,9999,0
1668437421401,CSE 293,042,119539,Gao; Sicun,9999,0,9999,0
1668437421401,CSE 293,043,119540,Weibel; Nadir,9999,0,9999,0
1668437421401,CSE 293,044,119541,Gupta; Rajesh K.,9999,0,9999,0
1668437421401,CSE 293,045,126410,Vaccaro; Kristen Marie,9999,0,9999,0
1668437421401,CSE 293,046,126411,Klemke; Richard,9999,0,9999,0
1668437421835,CSE 294,A00,102459,Voelker; Geoffrey M.,0,1,0,0
1668437421835,CSE 294,B00,111322,Orailoglu; Alex,0,0,0,0
1668437422259,DSE 201,A00,096914,Deutsch; Alin Bernard,30,0,30,0
1668437422696,DSE 210,A00,096915,Dasgupta; Sanjoy,30,0,30,0
1668437423128,DSE 260A,A00,096916,Altintas De Callaf; Ilkay,30,0,30,0
1668437423566,ECE 200,001,103586,Antipa; Nicholas A,9999,0,9999,0
1668437423566,ECE 200,002,103587,Atanasov; Nikolay A.,9999,0,9999,0
1668437423566,ECE 200,003,103588,Bharadia; Dinesh,9999,0,9999,0
1668437423566,ECE 200,004,103589,Cheng; Chung Kuan,9999,0,9999,0
1668437423566,ECE 200,005,103590,Cosman; Pamela C.,9999,0,9999,0
1668437423566,ECE 200,006,103591,Dayeh; Shadi Ahmad,9999,0,9999,0
1668437423566,ECE 200,007,103592,Fainman; Yeshaiahu,9999,0,9999,0
1668437423566,ECE 200,008,103593,Ford; Joseph Earl,9999,0,9999,0
1668437423566,ECE 200,009,103594,Franceschetti; Massimo,9999,0,9999,0
1668437423566,ECE 200,010,103595,Fullerton; Eric E,9999,0,9999,0
1668437423566,ECE 200,011,103596,Galton; Ian A,9999,0,9999,0
1668437423566,ECE 200,012,103597,Gilja; Vikash,9999,0,9999,0
1668437423566,ECE 200,013,103598,Hall; Drew A.,9999,0,9999,0
1668437423566,ECE 200,014,103599,Hsueh; Tzu-Chien,9999,0,9999,0
1668437423566,ECE 200,015,103600,Javidi; Tara,9999,0,9999,0
1668437423566,ECE 200,016,103601,Kahng; Andrew Byun,9999,0,9999,0
1668437423566,ECE 200,017,103602,Kim; Young-Han,9999,0,9999,0
1668437423566,ECE 200,018,103603,Koushanfar; Farinaz,9999,0,9999,0
1668437423566,ECE 200,019,103604,Kuzum; Duygu,9999,0,9999,0
1668437423566,ECE 200,020,103605,Le; Hanh-Phuc,9999,0,9999,0
1668437423566,ECE 200,021,103606,Lin; Bill,9999,0,9999,0
1668437423566,ECE 200,022,103607,Liu; Zhaowei,9998,0,9999,1
1668437423566,ECE 200,023,103608,Lo; Yu-Hwa,9999,0,9999,0
1668437423566,ECE 200,024,103609,Lomakin; Vitaliy,9999,0,9999,0
1668437423566,ECE 200,025,103610,Mercier; Patrick Philip,9999,0,9999,0
1668437423566,ECE 200,026,103611,Meyer; Florian,9999,0,9999,0
1668437423566,ECE 200,027,103612,Milstein; Laurence B.,9999,0,9999,0
1668437423566,ECE 200,028,103613,Mir Arabbaygi; Siavash,9999,0,9999,0
1668437423566,ECE 200,029,103614,Mookherjea; Shayan,9999,0,9999,0
1668437423566,ECE 200,030,103615,Morris; Karcher William,9999,0,9999,0
1668437423566,ECE 200,031,103616,Ng; Tse Nga,9999,0,9999,0
1668437423566,ECE 200,032,103617,Nguyen; Truong Quang,9999,0,9999,0
1668437423566,ECE 200,033,103618,Nomura; Kenji,9999,0,9999,0
1668437423566,ECE 200,034,103619,Orlitsky; Alon,9999,0,9999,0
1668437423566,ECE 200,035,103620,Pal; Piya,9999,0,9999,0
1668437423566,ECE 200,036,103621,Papen; George C.,9999,0,9999,0
1668437423566,ECE 200,037,103622,Radic; Stojan,9999,0,9999,0
1668437423566,ECE 200,038,103623,Rao; Bhaskar D.,9999,0,9999,0
1668437423566,ECE 200,039,103624,Rao; Ramesh R,9999,0,9999,0
1668437423566,ECE 200,040,103625,Rebeiz; Gabriel,9999,0,9999,0
1668437423566,ECE 200,041,103626,Sanford; John R,9999,0,9999,0
1668437423566,ECE 200,042,103627,Siegel; Paul H.,9999,0,9999,0
1668437423566,ECE 200,043,103628,Sievenpiper; Daniel F.,9999,0,9999,0
1668437423566,ECE 200,044,103629,Sworder; David D.,9999,0,9999,0
1668437423566,ECE 200,045,103630,Taur; Yuan,9999,0,9999,0
1668437423566,ECE 200,046,103631,Touri; Behrouz,9999,0,9999,0
1668437423566,ECE 200,047,103632,Trivedi; Mohan M.,9999,0,9999,0
1668437423566,ECE 200,048,103633,Vasconcelos; Nuno,9999,0,9999,0
1668437423566,ECE 200,049,103634,Wang; Xiaolong,9999,0,9999,0
1668437423566,ECE 200,050,103635,Xie; Pengtao,9999,0,9999,0
1668437423566,ECE 200,051,103636,Yip; Michael,9999,0,9999,0
1668437423566,ECE 200,052,103637,Zeger; Kenneth A.,999,0,999,0
1668437423566,ECE 200,053,103638,Zhang; Xinyu,9999,0,9999,0
1668437423566,ECE 200,054,103639,Turakhia; Yatish Girish,9999,0,9999,0
1668437423566,ECE 200,055,103640,Kang; Mingu,9999,0,9999,0
1668437423566,ECE 200,056,103641,Shi; Yuanyuan,9999,0,9999,0
1668437423566,ECE 200,057,103642,Wang; Edward Jay,9999,0,9999,0
1668437423566,ECE 200,058,103643,Zheng; Yang,9999,0,9999,0
1668437423990,ECE 202,A00,103644,Kuzum; Duygu,0,21,0,0
1668437424416,ECE 212BN,A00,103646,Ng; Tse Nga,0,1,0,0
1668437424849,ECE 221,A00,111493,Staff,0,0,0,0
1668437425278,ECE 222B,A00,103647,Lomakin; Vitaliy,0,5,0,0
1668437425701,ECE 230B,A00,103648,Taur; Yuan,0,0,0,0
1668437426125,ECE 238B,A00,103649,Garay; Javier,0,0,0,0
1668437426554,ECE 240B,A00,112900,Fainman; Yeshaiahu,0,4,0,0
1668437426981,ECE 247A,A00,103650,Jokerst; Jesse Vincent,0,1,0,0
1668437427405,ECE 247B,A00,103651,Wang; Joseph,0,6,0,0
1668437427837,ECE 250,A00,103652,Siegel; Paul H.,0,45,0,0
1668437428262,ECE 251A,A00,103654,Rao; Bhaskar D.,0,29,0,0
1668437428695,ECE 257B,A00,103655,Bharadia; Dinesh,0,12,0,0
1668437429121,ECE 258A,A00,103656,Milstein; Laurence B.,0,10,0,0
1668437429544,ECE 260B,A00,103658,Kang; Mingu,0,65,0,0
1668437429967,ECE 264A,A00,103659,Galton; Ian A,0,33,0,0
1668437430397,ECE 265A,A00,103661,Gudem; Prasad S.S.,0,17,0,0
1668437430822,ECE 265D,A00,103662,Gudem; Prasad S.S.,0,11,0,0
1668437431252,ECE 268,A00,103663,Koushanfar; Farinaz,0,20,0,0
1668437431677,ECE 269,A01,103665,Pal; Piya,0,135,0,0
1668437432105,ECE 271B,A00,103666,Vasconcelos; Manuela,0,47,0,0
1668437432530,ECE 276A,A00,103667,Atanasov; Nikolay A.,0,73,0,0
1668437432955,ECE 277,A00,103668,An; Cheolhong,0,91,0,0
1668437433379,ECE 279,A00,117947,Hall; Drew A.,0,12,0,0
1668437434253,ECE 283,A00,103670,Hsueh; Tzu-Chien,0,23,0,0
1668437434678,ECE 284,A00,103671,Turakhia; Yatish Girish,0,23,0,0
1668437435112,ECE 285,A00,103672,Zheng; Yang,0,25,0,0
1668437435112,ECE 285,B00,103673,Sworder; David D.,0,37,0,0
1668437435541,ECE 287,A00,103676,Javidi; Tara,0,4,0,0
1668437435969,MATH 200B,A00,098023,Salehi Golsefidy; Alireza,12,0,15,3
1668437436407,MATH 202B,A00,098024,Rhoades; Brendon Patrick,9,0,15,6
1668437436835,MATH 203B,A00,098025,Oprea; Dragos N.,10,0,15,5
1668437437266,MATH 204B,A00,098026,Sorensen; Claus M,13,0,15,2
1668437437691,MATH 208,A00,098027,Izadi; Elham,7,0,10,3
1668437438118,MATH 209,A00,098028,Pollack; Aaron,10,0,10,0
1668437438545,MATH 211A,A00,112919,Rogalski; Daniel,9,0,10,1
1668437438986,MATH 211B,A00,112920,Seward; Brandon M.,9,0,10,1
1668437439411,MATH 218,A00,098029,Li; Bo,10,0,10,0
1668437439839,MATH 220B,A00,098030,Novak; Jonathan I,11,0,15,4
1668437440264,MATH 221A,A00,098031,Ebenfelt; Peter F,13,0,15,2
1668437440687,MATH 231B,A00,098032,Zlatos; Andrej,12,0,15,3
1668437441116,MATH 240B,A00,098033,Ni; Lei,9,0,15,6
1668437441539,MATH 243,A00,098034,Jekel; David Andrew,10,0,10,0
1668437441974,MATH 245A,A00,098035,Nie; Jiawang,0,1,15,16
1668437442402,MATH 248,A00,098036,Bejenaru; Ioan,10,0,10,0
1668437442828,MATH 250B,A00,098037,Spolaor; Luca,14,0,15,1
1668437443253,MATH 258,A00,098038,Ni; Lei,10,0,10,0
1668437443679,MATH 264B,A00,098041,Rhoades; Brendon Patrick,9,0,15,6
1668437444112,MATH 268,A00,098042,Buss; Samuel R,10,0,10,0
1668437444537,MATH 269,A00,098043,Rhoades; Brendon Patrick,10,0,10,0
1668437444975,MATH 270B,A00,098044,Li; Bo,10,0,15,5
1668437445412,MATH 272B,A00,098045,Holst; Michael J,13,0,15,2
1668437445839,MATH 273A,A00,098046,Tian; Xiaochuan,10,0,15,5
1668437446264,MATH 275,A01,098048,Tian; Xiaochuan,6,0,10,4
1668437446689,MATH 278A,A00,098049,Holst; Michael J,8,0,10,2
1668437447115,MATH 278B,A00,098050,Cloninger; Alexander,10,0,10,0
1668437447552,MATH 278C,A00,098051,Nie; Jiawang,6,0,10,4
1668437447978,MATH 280B,A00,098052,Zheng; Tianyi,8,0,15,7
1668437448401,MATH 281B,A00,098053,Bradic; Jelena,0,1,15,15
1668437448824,MATH 282B,A00,098054,Arias-Castro; Ery,0,0,15,15
1668437449247,MATH 285,A00,098055,Fitzsimmons; Patrick J,0,0,15,17
1668437449675,MATH 287B,A00,098056,Arias-Castro; Ery,2,0,15,13
1668437450098,MATH 288,A00,098057,Agarwal; Pooja,9,0,10,1
1668437450098,MATH 288,B00,098058,Zhang; Danna,8,0,10,2
1668437450098,MATH 288,C00,098059,Williams; Ruth J,9,0,10,1
1668437450526,MATH 290B,A00,098060,Roberts; Justin Deritter,13,0,15,2
1668437450958,MATH 292,A00,098061,Belmont; Eva Kinoshita,10,0,10,0
1668437451395,MATH 295,A00,098062,Suk; Andrew Hoon,48,0,50,2
1668437451818,MATH 296,A00,098063,Novak; Jonathan I,20,0,20,0
1668437452243,MATH 297,001,098064,Gamst; Anthony Collins,9997,0,9999,2
1668437954128,COGS 205,A00,101395,Chiba; Andrea,19,0,20,1
1668437954568,COGS 210B,001,101404,Greene; Deanna Jacquelyn,9998,0,9999,1
1668437954568,COGS 210B,002,101417,Xia; Haijun,9999,0,9999,0
1668437954568,COGS 210B,003,101422,Nitz; Douglas A.,9999,0,9999,0
1668437954568,COGS 210B,004,101423,Hollan; James D.,9998,0,9999,1
1668437954568,COGS 210B,005,101424,Deak; Gedeon O.,9998,0,9999,1
1668437954568,COGS 210B,006,101425,Rossano; Federico,9999,0,9999,0
1668437954991,COGS 211B,A00,101427,Coulson; Seana M,9996,0,9999,3
1668437955417,COGS 220,A00,101428,Hollan; James D.,1,3,25,24
1668437955842,COGS 229,A00,101429,Dow; Steven P,18,0,25,7
1668437956265,COGS 230,A00,101430,Klemmer; Scott R,11,0,17,6
1668437956689,COGS 234,A00,101431,Xia; Haijun,2,0,25,23
1668437957113,COGS 260,A00,101432,Kiyonaga; Anastasia,21,0,25,4
1668437957113,COGS 260,B00,101433,Kirsh; David Joel,15,0,25,10
1668437957536,CSE 202,A00,102371,Impagliazzo; Russell,0,34,0,0
1668437957970,CSE 203B,A01,102373,Cheng; Chung Kuan,0,26,0,0
1668437958405,CSE 208,A00,102374,Micciancio; Daniele,0,1,0,0
1668437958829,CSE 209A,A00,112895,Impagliazzo; Russell,0,4,15,15
1668437959256,CSE 209B,A00,108005,Bellare; Mihir,0,3,0,0
1668437959684,CSE 210,A00,113163,Coblenz; Michael J,0,44,0,0
1668437960110,CSE 219,A00,106111,Dow; Steven P,0,0,20,20
1668437960542,CSE 221,A00,102376,Voelker; Geoffrey M.,0,30,0,0
1668437960969,CSE 224,A01,102378,Porter; George M,0,104,0,0
1668437961393,CSE 229A,A00,102379,Savage; Stefan,0,4,0,0
1668437961816,CSE 229C,A00,102380,Munyaka; Imani N. S.,0,4,0,0
1668437962243,CSE 232B,A00,102382,Deutsch; Alin Bernard,0,15,0,0
1668437962667,CSE 234,A01,112904,Kumar; Arun Kumar,0,0,0,0
1668437963091,CSE 237A,A00,102383,Rosing; Tajana Simunic,0,26,0,0
1668437963540,CSE 239A,A00,102384,Deutsch; Alin Bernard,0,6,0,0
1668437963964,CSE 239B,A00,102385,Polikarpova; Nadezhda,0,3,0,0
1668437964391,CSE 240A,A00,102386,Pannuto; Patrick William,0,27,0,0
1668437964814,CSE 240B,A00,102387,Zhao; Jishen,0,23,0,0
1668437965242,CSE 241A,A00,106406,Kang; Mingu,0,2,0,0
1668437965665,CSE 249B,A00,102388,Kahng; Andrew Byun,0,1,8,8
1668437966092,CSE 251B,A01,102392,Cottrell; Garrison W,0,24,0,0
1668437966092,CSE 251B,A02,102393,Cottrell; Garrison W,0,21,0,0
1668437966519,CSE 252B,A00,102394,Ochoa; Benjamin Lawrence,0,38,0,0
1668437966943,CSE 257,A01,102396,Gao; Sicun,0,86,0,0
1668437967367,CSE 272,A00,102397,Li; Tzumao,0,7,0,0
1668437967803,CSE 274,A00,111323,Chern; Albert Ren-Haur,0,7,0,0
1668437968230,CSE 282,A00,102398,Pevzner; Pavel Arkadjevich,0,0,0,0
1668437968653,CSE 284,A00,114175,Gymrek; Melissa Ann,0,11,0,0
1668437969089,CSE 290,A00,102399,Chandraker; Manmohan Krishna,0,4,0,0
1668437969089,CSE 290,B00,102400,Vaccaro; Kristen Marie,0,1,25,25
1668437969089,CSE 290,C00,102414,Pannuto; Patrick William,0,1,25,25
1668437969089,CSE 290,D00,102427,Pevzner; Pavel Arkadjevich,0,0,0,0
1668437969089,CSE 290,E00,102429,Zhao; Jishen,0,2,0,0
1668437969089,CSE 290,F00,102436,Tullsen; Dean Michael,0,3,0,0
1668437969089,CSE 290,G00,102440,Christensen; Henrik I,0,3,20,20
1668437969513,CSE 291,A00,102443,Su; Hao,0,0,0,0
1668437969513,CSE 291,B00,102448,Polikarpova; Nadezhda,0,0,0,0
1668437969513,CSE 291,C00,102453,Vaccaro; Kristen Marie,0,0,0,0
1668437969513,CSE 291,D00,111343,Savage; Stefan,0,0,0,0
1668437969513,CSE 291,E00,116474,Claffy; Kimberly Claire,0,0,0,0
1668437969513,CSE 291,F00,116479,Pasquale; Joseph,0,0,0,0
1668437969945,CSE 293,001,119111,Bafna; Vineet,9999,0,9999,0
1668437969945,CSE 293,002,119118,Bellare; Mihir,9999,0,9999,0
1668437969945,CSE 293,003,119122,Berg-Kirkpatrick; Taylor D,9999,0,9999,0
1668437969945,CSE 293,004,119135,Christensen; Henrik I,9999,0,9999,0
1668437969945,CSE 293,005,119142,Cottrell; Garrison W,9999,0,9999,0
1668437969945,CSE 293,006,119146,Deutsch; Alin Bernard,9999,0,9999,0
1668437969945,CSE 293,007,119159,Esmaeilzadeh; Hadi,9999,0,9999,0
1668437969945,CSE 293,008,119166,Freund; Yoav,9999,0,9999,0
1668437969945,CSE 293,009,119170,Griswold; William G.,9999,0,9999,0
1668437969945,CSE 293,010,119183,Gymrek; Melissa Ann,9999,0,9999,0
1668437969945,CSE 293,011,119190,Heninger; Nadia A,9999,0,9999,0
1668437969945,CSE 293,012,119230,Impagliazzo; Russell,9999,0,9999,0
1668437969945,CSE 293,013,119232,Jhala; Ranjit,9999,0,9999,0
1668437969945,CSE 293,014,119233,Kahng; Andrew Byun,9999,0,9999,0
1668437969945,CSE 293,015,119298,Kane; Daniel Mertz,9999,0,9999,0
1668437969945,CSE 293,016,119299,Kriegman; David J,9999,0,9999,0
1668437969945,CSE 293,017,119300,Kumar; Arun Kumar,9999,0,9999,0
1668437969945,CSE 293,018,119301,Lerner; Sorin,9999,0,9999,0
1668437969945,CSE 293,019,119302,Lovett; Shachar,9999,0,9999,0
1668437969945,CSE 293,020,119303,McAuley; Julian John,9999,0,9999,0
1668437969945,CSE 293,021,119304,Micciancio; Daniele,9999,0,9999,0
1668437969945,CSE 293,022,119367,Orailoglu; Alex,9999,0,9999,0
1668437969945,CSE 293,023,119382,Paturi; Ramamohan,9999,0,9999,0
1668437969945,CSE 293,024,119404,Polikarpova; Nadezhda,9999,0,9999,0
1668437969945,CSE 293,025,119406,Politz; Joseph Gibbs,9999,0,9999,0
1668437969945,CSE 293,026,119411,Porter; George M,9999,0,9999,0
1668437969945,CSE 293,027,119414,Porter; Leonard Emerson,9999,0,9999,0
1668437969945,CSE 293,028,119416,Ramamoorthi; Ravi,9999,0,9999,0
1668437969945,CSE 293,029,119417,Sahoo; Debashis,9999,0,9999,0
1668437969945,CSE 293,030,119420,Saul; Lawrence,9999,0,9999,0
1668437969945,CSE 293,031,119421,Savage; Stefan,9999,0,9999,0
1668437969945,CSE 293,032,119425,Schulze; Jurgen P.,9999,0,9999,0
1668437969945,CSE 293,033,119426,Snoeren; Alex C.,9999,0,9999,0
1668437969945,CSE 293,034,119428,Shang; Jingbo,9999,0,9999,0
1668437969945,CSE 293,035,119430,Stefan; Deian,9999,0,9999,0
1668437969945,CSE 293,036,119431,Su; Hao,9999,0,9999,0
1668437969945,CSE 293,037,119433,Swanson; Steven James,9999,0,9999,0
1668437969945,CSE 293,038,119435,Tullsen; Dean Michael,9999,0,9999,0
1668437969945,CSE 293,039,119483,Voelker; Geoffrey M.,9999,0,9999,0
1668437969945,CSE 293,040,119537,Zhao; Jishen,9999,0,9999,0
1668437969945,CSE 293,041,119538,Zhou; Yuan-Yuan,9999,0,9999,0
1668437969945,CSE 293,042,119539,Gao; Sicun,9999,0,9999,0
1668437969945,CSE 293,043,119540,Weibel; Nadir,9999,0,9999,0
1668437969945,CSE 293,044,119541,Gupta; Rajesh K.,9999,0,9999,0
1668437969945,CSE 293,045,126410,Vaccaro; Kristen Marie,9999,0,9999,0
1668437969945,CSE 293,046,126411,Klemke; Richard,9999,0,9999,0
1668437970369,CSE 294,A00,102459,Voelker; Geoffrey M.,0,1,0,0
1668437970369,CSE 294,B00,111322,Orailoglu; Alex,0,0,0,0
1668437970792,DSE 201,A00,096914,Deutsch; Alin Bernard,30,0,30,0
1668437971216,DSE 210,A00,096915,Dasgupta; Sanjoy,30,0,30,0
1668437971640,DSE 260A,A00,096916,Altintas De Callaf; Ilkay,30,0,30,0
1668437972077,ECE 200,001,103586,Antipa; Nicholas A,9999,0,9999,0
1668437972077,ECE 200,002,103587,Atanasov; Nikolay A.,9999,0,9999,0
1668437972077,ECE 200,003,103588,Bharadia; Dinesh,9999,0,9999,0
1668437972077,ECE 200,004,103589,Cheng; Chung Kuan,9999,0,9999,0
1668437972077,ECE 200,005,103590,Cosman; Pamela C.,9999,0,9999,0
1668437972077,ECE 200,006,103591,Dayeh; Shadi Ahmad,9999,0,9999,0
1668437972077,ECE 200,007,103592,Fainman; Yeshaiahu,9999,0,9999,0
1668437972077,ECE 200,008,103593,Ford; Joseph Earl,9999,0,9999,0
1668437972077,ECE 200,009,103594,Franceschetti; Massimo,9999,0,9999,0
1668437972077,ECE 200,010,103595,Fullerton; Eric E,9999,0,9999,0
1668437972077,ECE 200,011,103596,Galton; Ian A,9999,0,9999,0
1668437972077,ECE 200,012,103597,Gilja; Vikash,9999,0,9999,0
1668437972077,ECE 200,013,103598,Hall; Drew A.,9999,0,9999,0
1668437972077,ECE 200,014,103599,Hsueh; Tzu-Chien,9999,0,9999,0
1668437972077,ECE 200,015,103600,Javidi; Tara,9999,0,9999,0
1668437972077,ECE 200,016,103601,Kahng; Andrew Byun,9999,0,9999,0
1668437972077,ECE 200,017,103602,Kim; Young-Han,9999,0,9999,0
1668437972077,ECE 200,018,103603,Koushanfar; Farinaz,9999,0,9999,0
1668437972077,ECE 200,019,103604,Kuzum; Duygu,9999,0,9999,0
1668437972077,ECE 200,020,103605,Le; Hanh-Phuc,9999,0,9999,0
1668437972077,ECE 200,021,103606,Lin; Bill,9999,0,9999,0
1668437972077,ECE 200,022,103607,Liu; Zhaowei,9998,0,9999,1
1668437972077,ECE 200,023,103608,Lo; Yu-Hwa,9999,0,9999,0
1668437972077,ECE 200,024,103609,Lomakin; Vitaliy,9999,0,9999,0
1668437972077,ECE 200,025,103610,Mercier; Patrick Philip,9999,0,9999,0
1668437972077,ECE 200,026,103611,Meyer; Florian,9999,0,9999,0
1668437972077,ECE 200,027,103612,Milstein; Laurence B.,9999,0,9999,0
1668437972077,ECE 200,028,103613,Mir Arabbaygi; Siavash,9999,0,9999,0
1668437972077,ECE 200,029,103614,Mookherjea; Shayan,9999,0,9999,0
1668437972077,ECE 200,030,103615,Morris; Karcher William,9999,0,9999,0
1668437972077,ECE 200,031,103616,Ng; Tse Nga,9999,0,9999,0
1668437972077,ECE 200,032,103617,Nguyen; Truong Quang,9999,0,9999,0
1668437972077,ECE 200,033,103618,Nomura; Kenji,9999,0,9999,0
1668437972077,ECE 200,034,103619,Orlitsky; Alon,9999,0,9999,0
1668437972077,ECE 200,035,103620,Pal; Piya,9999,0,9999,0
1668437972077,ECE 200,036,103621,Papen; George C.,9999,0,9999,0
1668437972077,ECE 200,037,103622,Radic; Stojan,9999,0,9999,0
1668437972077,ECE 200,038,103623,Rao; Bhaskar D.,9999,0,9999,0
1668437972077,ECE 200,039,103624,Rao; Ramesh R,9999,0,9999,0
1668437972077,ECE 200,040,103625,Rebeiz; Gabriel,9999,0,9999,0
1668437972077,ECE 200,041,103626,Sanford; John R,9999,0,9999,0
1668437972077,ECE 200,042,103627,Siegel; Paul H.,9999,0,9999,0
1668437972077,ECE 200,043,103628,Sievenpiper; Daniel F.,9999,0,9999,0
1668437972077,ECE 200,044,103629,Sworder; David D.,9999,0,9999,0
1668437972077,ECE 200,045,103630,Taur; Yuan,9999,0,9999,0
1668437972077,ECE 200,046,103631,Touri; Behrouz,9999,0,9999,0
1668437972077,ECE 200,047,103632,Trivedi; Mohan M.,9999,0,9999,0
1668437972077,ECE 200,048,103633,Vasconcelos; Nuno,9999,0,9999,0
1668437972077,ECE 200,049,103634,Wang; Xiaolong,9999,0,9999,0
1668437972077,ECE 200,050,103635,Xie; Pengtao,9999,0,9999,0
1668437972077,ECE 200,051,103636,Yip; Michael,9999,0,9999,0
1668437972077,ECE 200,052,103637,Zeger; Kenneth A.,999,0,999,0
1668437972077,ECE 200,053,103638,Zhang; Xinyu,9999,0,9999,0
1668437972077,ECE 200,054,103639,Turakhia; Yatish Girish,9999,0,9999,0
1668437972077,ECE 200,055,103640,Kang; Mingu,9999,0,9999,0
1668437972077,ECE 200,056,103641,Shi; Yuanyuan,9999,0,9999,0
1668437972077,ECE 200,057,103642,Wang; Edward Jay,9999,0,9999,0
1668437972077,ECE 200,058,103643,Zheng; Yang,9999,0,9999,0
1668437972504,ECE 202,A00,103644,Kuzum; Duygu,0,22,0,0
1668437972942,ECE 212BN,A00,103646,Ng; Tse Nga,0,1,0,0
1668437973377,ECE 221,A00,111493,Staff,0,0,0,0
1668437973800,ECE 222B,A00,103647,Lomakin; Vitaliy,0,5,0,0
1668437974228,ECE 230B,A00,103648,Taur; Yuan,0,0,0,0
1668437974652,ECE 238B,A00,103649,Garay; Javier,0,0,0,0
1668437975078,ECE 240B,A00,112900,Fainman; Yeshaiahu,0,4,0,0
1668437975510,ECE 247A,A00,103650,Jokerst; Jesse Vincent,0,1,0,0
1668437975932,ECE 247B,A00,103651,Wang; Joseph,0,6,0,0
1668437976356,ECE 250,A00,103652,Siegel; Paul H.,0,45,0,0
1668437976782,ECE 251A,A00,103654,Rao; Bhaskar D.,0,29,0,0
1668437977209,ECE 257B,A00,103655,Bharadia; Dinesh,0,12,0,0
1668437977632,ECE 258A,A00,103656,Milstein; Laurence B.,0,10,0,0
1668437978059,ECE 260B,A00,103658,Kang; Mingu,0,66,0,0
1668437978492,ECE 264A,A00,103659,Galton; Ian A,0,34,0,0
1668437978919,ECE 265A,A00,103661,Gudem; Prasad S.S.,0,17,0,0
1668437979345,ECE 265D,A00,103662,Gudem; Prasad S.S.,0,12,0,0
1668437979770,ECE 268,A00,103663,Koushanfar; Farinaz,0,20,0,0
1668437980194,ECE 269,A01,103665,Pal; Piya,0,135,0,0
1668437980618,ECE 271B,A00,103666,Vasconcelos; Manuela,0,47,0,0
1668437981142,ECE 276A,A00,103667,Atanasov; Nikolay A.,0,73,0,0
1668437981568,ECE 277,A00,103668,An; Cheolhong,0,91,0,0
1668437981994,ECE 279,A00,117947,Hall; Drew A.,0,12,0,0
1668437982846,ECE 283,A00,103670,Hsueh; Tzu-Chien,0,25,0,0
1668437983271,ECE 284,A00,103671,Turakhia; Yatish Girish,0,23,0,0
1668437983693,ECE 285,A00,103672,Zheng; Yang,0,25,0,0
1668437983693,ECE 285,B00,103673,Sworder; David D.,0,37,0,0
1668437984118,ECE 287,A00,103676,Javidi; Tara,0,4,0,0
1668437984544,MATH 200B,A00,098023,Salehi Golsefidy; Alireza,12,0,15,3
1668437984969,MATH 202B,A00,098024,Rhoades; Brendon Patrick,9,0,15,6
1668437985395,MATH 203B,A00,098025,Oprea; Dragos N.,10,0,15,5
1668437985818,MATH 204B,A00,098026,Sorensen; Claus M,13,0,15,2
1668437986246,MATH 208,A00,098027,Izadi; Elham,7,0,10,3
1668437986671,MATH 209,A00,098028,Pollack; Aaron,10,0,10,0
1668437987095,MATH 211A,A00,112919,Rogalski; Daniel,9,0,10,1
1668437987523,MATH 211B,A00,112920,Seward; Brandon M.,9,0,10,1
1668437987947,MATH 218,A00,098029,Li; Bo,10,0,10,0
1668437988373,MATH 220B,A00,098030,Novak; Jonathan I,11,0,15,4
1668437988798,MATH 221A,A00,098031,Ebenfelt; Peter F,13,0,15,2
1668437989222,MATH 231B,A00,098032,Zlatos; Andrej,12,0,15,3
1668437989647,MATH 240B,A00,098033,Ni; Lei,9,0,15,6
1668437990073,MATH 243,A00,098034,Jekel; David Andrew,10,0,10,0
1668437990501,MATH 245A,A00,098035,Nie; Jiawang,0,1,15,16
1668437990922,MATH 248,A00,098036,Bejenaru; Ioan,10,0,10,0
1668437991355,MATH 250B,A00,098037,Spolaor; Luca,14,0,15,1
1668437991782,MATH 258,A00,098038,Ni; Lei,10,0,10,0
1668437992217,MATH 264B,A00,098041,Rhoades; Brendon Patrick,9,0,15,6
1668437992642,MATH 268,A00,098042,Buss; Samuel R,10,0,10,0
1668437993068,MATH 269,A00,098043,Rhoades; Brendon Patrick,10,0,10,0
1668437993504,MATH 270B,A00,098044,Li; Bo,10,0,15,5
1668437993927,MATH 272B,A00,098045,Holst; Michael J,13,0,15,2
1668437994372,MATH 273A,A00,098046,Tian; Xiaochuan,10,0,15,5
1668437994797,MATH 275,A01,098048,Tian; Xiaochuan,6,0,10,4
1668437995220,MATH 278A,A00,098049,Holst; Michael J,8,0,10,2
1668437995645,MATH 278B,A00,098050,Cloninger; Alexander,10,0,10,0
1668437996067,MATH 278C,A00,098051,Nie; Jiawang,6,0,10,4
1668437996497,MATH 280B,A00,098052,Zheng; Tianyi,8,0,15,7
1668437996925,MATH 281B,A00,098053,Bradic; Jelena,0,1,15,15
1668437997358,MATH 282B,A00,098054,Arias-Castro; Ery,0,0,15,15
1668437997795,MATH 285,A00,098055,Fitzsimmons; Patrick J,0,0,15,17
1668437998225,MATH 287B,A00,098056,Arias-Castro; Ery,2,0,15,13
1668437998656,MATH 288,A00,098057,Agarwal; Pooja,9,0,10,1
1668437998656,MATH 288,B00,098058,Zhang; Danna,8,0,10,2
1668437998656,MATH 288,C00,098059,Williams; Ruth J,9,0,10,1
1668437999079,MATH 290B,A00,098060,Roberts; Justin Deritter,13,0,15,2
1668437999507,MATH 292,A00,098061,Belmont; Eva Kinoshita,10,0,10,0
1668437999932,MATH 295,A00,098062,Suk; Andrew Hoon,48,0,50,2
1668438000357,MATH 296,A00,098063,Novak; Jonathan I,20,0,20,0
1668438000780,MATH 297,001,098064,Gamst; Anthony Collins,9997,0,9999,2
1668438503414,COGS 205,A00,101395,Chiba; Andrea,19,0,20,1
1668438503927,COGS 210B,001,101404,Greene; Deanna Jacquelyn,9998,0,9999,1
1668438503927,COGS 210B,002,101417,Xia; Haijun,9999,0,9999,0
1668438503927,COGS 210B,003,101422,Nitz; Douglas A.,9999,0,9999,0
1668438503927,COGS 210B,004,101423,Hollan; James D.,9998,0,9999,1
1668438503927,COGS 210B,005,101424,Deak; Gedeon O.,9998,0,9999,1
1668438503927,COGS 210B,006,101425,Rossano; Federico,9999,0,9999,0
1668438504355,COGS 211B,A00,101427,Coulson; Seana M,9996,0,9999,3
1668438504781,COGS 220,A00,101428,Hollan; James D.,1,3,25,24
1668438505213,COGS 229,A00,101429,Dow; Steven P,18,0,25,7
1668438505639,COGS 230,A00,101430,Klemmer; Scott R,11,0,17,6
1668438506077,COGS 234,A00,101431,Xia; Haijun,2,0,25,23
1668438506504,COGS 260,A00,101432,Kiyonaga; Anastasia,21,0,25,4
1668438506504,COGS 260,B00,101433,Kirsh; David Joel,15,0,25,10
1668438506942,CSE 202,A00,102371,Impagliazzo; Russell,0,34,0,0
1668438507366,CSE 203B,A01,102373,Cheng; Chung Kuan,0,27,0,0
1668438507789,CSE 208,A00,102374,Micciancio; Daniele,0,1,0,0
1668438508224,CSE 209A,A00,112895,Impagliazzo; Russell,0,6,15,15
1668438508650,CSE 209B,A00,108005,Bellare; Mihir,0,3,0,0
1668438509075,CSE 210,A00,113163,Coblenz; Michael J,0,44,0,0
1668438509509,CSE 219,A00,106111,Dow; Steven P,0,0,20,20
1668438509931,CSE 221,A00,102376,Voelker; Geoffrey M.,0,30,0,0
1668438510359,CSE 224,A01,102378,Porter; George M,0,105,0,0
1668438510783,CSE 229A,A00,102379,Savage; Stefan,0,4,0,0
1668438511225,CSE 229C,A00,102380,Munyaka; Imani N. S.,0,4,0,0
1668438511655,CSE 232B,A00,102382,Deutsch; Alin Bernard,0,15,0,0
1668438512081,CSE 234,A01,112904,Kumar; Arun Kumar,0,0,0,0
1668438512523,CSE 237A,A00,102383,Rosing; Tajana Simunic,0,26,0,0
1668438512946,CSE 239A,A00,102384,Deutsch; Alin Bernard,0,6,0,0
1668438513385,CSE 239B,A00,102385,Polikarpova; Nadezhda,0,3,0,0
1668438513810,CSE 240A,A00,102386,Pannuto; Patrick William,0,27,0,0
1668438514233,CSE 240B,A00,102387,Zhao; Jishen,0,23,0,0
1668438514664,CSE 241A,A00,106406,Kang; Mingu,0,2,0,0
1668438515088,CSE 249B,A00,102388,Kahng; Andrew Byun,0,1,8,8
1668438515516,CSE 251B,A01,102392,Cottrell; Garrison W,0,24,0,0
1668438515516,CSE 251B,A02,102393,Cottrell; Garrison W,0,21,0,0
1668438515939,CSE 252B,A00,102394,Ochoa; Benjamin Lawrence,0,38,0,0
1668438516364,CSE 257,A01,102396,Gao; Sicun,0,86,0,0
1668438516794,CSE 272,A00,102397,Li; Tzumao,0,7,0,0
1668438517219,CSE 274,A00,111323,Chern; Albert Ren-Haur,0,7,0,0
1668438517653,CSE 282,A00,102398,Pevzner; Pavel Arkadjevich,0,0,0,0
1668438518081,CSE 284,A00,114175,Gymrek; Melissa Ann,0,11,0,0
1668438518517,CSE 290,A00,102399,Chandraker; Manmohan Krishna,0,4,0,0
1668438518517,CSE 290,B00,102400,Vaccaro; Kristen Marie,0,1,25,25
1668438518517,CSE 290,C00,102414,Pannuto; Patrick William,0,1,25,25
1668438518517,CSE 290,D00,102427,Pevzner; Pavel Arkadjevich,0,0,0,0
1668438518517,CSE 290,E00,102429,Zhao; Jishen,0,2,0,0
1668438518517,CSE 290,F00,102436,Tullsen; Dean Michael,0,3,0,0
1668438518517,CSE 290,G00,102440,Christensen; Henrik I,0,3,20,20
1668438518941,CSE 291,A00,102443,Su; Hao,0,0,0,0
1668438518941,CSE 291,B00,102448,Polikarpova; Nadezhda,0,0,0,0
1668438518941,CSE 291,C00,102453,Vaccaro; Kristen Marie,0,0,0,0
1668438518941,CSE 291,D00,111343,Savage; Stefan,0,0,0,0
1668438518941,CSE 291,E00,116474,Claffy; Kimberly Claire,0,0,0,0
1668438518941,CSE 291,F00,116479,Pasquale; Joseph,0,0,0,0
1668438519394,CSE 293,001,119111,Bafna; Vineet,9999,0,9999,0
1668438519394,CSE 293,002,119118,Bellare; Mihir,9999,0,9999,0
1668438519394,CSE 293,003,119122,Berg-Kirkpatrick; Taylor D,9999,0,9999,0
1668438519394,CSE 293,004,119135,Christensen; Henrik I,9999,0,9999,0
1668438519394,CSE 293,005,119142,Cottrell; Garrison W,9999,0,9999,0
1668438519394,CSE 293,006,119146,Deutsch; Alin Bernard,9999,0,9999,0
1668438519394,CSE 293,007,119159,Esmaeilzadeh; Hadi,9999,0,9999,0
1668438519394,CSE 293,008,119166,Freund; Yoav,9999,0,9999,0
1668438519394,CSE 293,009,119170,Griswold; William G.,9999,0,9999,0
1668438519394,CSE 293,010,119183,Gymrek; Melissa Ann,9999,0,9999,0
1668438519394,CSE 293,011,119190,Heninger; Nadia A,9999,0,9999,0
1668438519394,CSE 293,012,119230,Impagliazzo; Russell,9999,0,9999,0
1668438519394,CSE 293,013,119232,Jhala; Ranjit,9999,0,9999,0
1668438519394,CSE 293,014,119233,Kahng; Andrew Byun,9999,0,9999,0
1668438519394,CSE 293,015,119298,Kane; Daniel Mertz,9999,0,9999,0
1668438519394,CSE 293,016,119299,Kriegman; David J,9999,0,9999,0
1668438519394,CSE 293,017,119300,Kumar; Arun Kumar,9999,0,9999,0
1668438519394,CSE 293,018,119301,Lerner; Sorin,9999,0,9999,0
1668438519394,CSE 293,019,119302,Lovett; Shachar,9999,0,9999,0
1668438519394,CSE 293,020,119303,McAuley; Julian John,9999,0,9999,0
1668438519394,CSE 293,021,119304,Micciancio; Daniele,9999,0,9999,0
1668438519394,CSE 293,022,119367,Orailoglu; Alex,9999,0,9999,0
1668438519394,CSE 293,023,119382,Paturi; Ramamohan,9999,0,9999,0
1668438519394,CSE 293,024,119404,Polikarpova; Nadezhda,9999,0,9999,0
1668438519394,CSE 293,025,119406,Politz; Joseph Gibbs,9999,0,9999,0
1668438519394,CSE 293,026,119411,Porter; George M,9999,0,9999,0
1668438519394,CSE 293,027,119414,Porter; Leonard Emerson,9999,0,9999,0
1668438519394,CSE 293,028,119416,Ramamoorthi; Ravi,9999,0,9999,0
1668438519394,CSE 293,029,119417,Sahoo; Debashis,9999,0,9999,0
1668438519394,CSE 293,030,119420,Saul; Lawrence,9999,0,9999,0
1668438519394,CSE 293,031,119421,Savage; Stefan,9999,0,9999,0
1668438519394,CSE 293,032,119425,Schulze; Jurgen P.,9999,0,9999,0
1668438519394,CSE 293,033,119426,Snoeren; Alex C.,9999,0,9999,0
1668438519394,CSE 293,034,119428,Shang; Jingbo,9999,0,9999,0
1668438519394,CSE 293,035,119430,Stefan; Deian,9999,0,9999,0
1668438519394,CSE 293,036,119431,Su; Hao,9999,0,9999,0
1668438519394,CSE 293,037,119433,Swanson; Steven James,9999,0,9999,0
1668438519394,CSE 293,038,119435,Tullsen; Dean Michael,9999,0,9999,0
1668438519394,CSE 293,039,119483,Voelker; Geoffrey M.,9999,0,9999,0
1668438519394,CSE 293,040,119537,Zhao; Jishen,9999,0,9999,0
1668438519394,CSE 293,041,119538,Zhou; Yuan-Yuan,9999,0,9999,0
1668438519394,CSE 293,042,119539,Gao; Sicun,9999,0,9999,0
1668438519394,CSE 293,043,119540,Weibel; Nadir,9999,0,9999,0
1668438519394,CSE 293,044,119541,Gupta; Rajesh K.,9999,0,9999,0
1668438519394,CSE 293,045,126410,Vaccaro; Kristen Marie,9999,0,9999,0
1668438519394,CSE 293,046,126411,Klemke; Richard,9999,0,9999,0
1668438519818,CSE 294,A00,102459,Voelker; Geoffrey M.,0,1,0,0
1668438519818,CSE 294,B00,111322,Orailoglu; Alex,0,0,0,0
1668438520244,DSE 201,A00,096914,Deutsch; Alin Bernard,30,0,30,0
1668438520672,DSE 210,A00,096915,Dasgupta; Sanjoy,30,0,30,0
1668438521102,DSE 260A,A00,096916,Altintas De Callaf; Ilkay,30,0,30,0
1668438521539,ECE 200,001,103586,Antipa; Nicholas A,9999,0,9999,0
1668438521539,ECE 200,002,103587,Atanasov; Nikolay A.,9999,0,9999,0
1668438521539,ECE 200,003,103588,Bharadia; Dinesh,9999,0,9999,0
1668438521539,ECE 200,004,103589,Cheng; Chung Kuan,9999,0,9999,0
1668438521539,ECE 200,005,103590,Cosman; Pamela C.,9999,0,9999,0
1668438521539,ECE 200,006,103591,Dayeh; Shadi Ahmad,9999,0,9999,0
1668438521539,ECE 200,007,103592,Fainman; Yeshaiahu,9999,0,9999,0
1668438521539,ECE 200,008,103593,Ford; Joseph Earl,9999,0,9999,0
1668438521539,ECE 200,009,103594,Franceschetti; Massimo,9999,0,9999,0
1668438521539,ECE 200,010,103595,Fullerton; Eric E,9999,0,9999,0
1668438521539,ECE 200,011,103596,Galton; Ian A,9999,0,9999,0
1668438521539,ECE 200,012,103597,Gilja; Vikash,9999,0,9999,0
1668438521539,ECE 200,013,103598,Hall; Drew A.,9999,0,9999,0
1668438521539,ECE 200,014,103599,Hsueh; Tzu-Chien,9999,0,9999,0
1668438521539,ECE 200,015,103600,Javidi; Tara,9999,0,9999,0
1668438521539,ECE 200,016,103601,Kahng; Andrew Byun,9999,0,9999,0
1668438521539,ECE 200,017,103602,Kim; Young-Han,9999,0,9999,0
1668438521539,ECE 200,018,103603,Koushanfar; Farinaz,9999,0,9999,0
1668438521539,ECE 200,019,103604,Kuzum; Duygu,9999,0,9999,0
1668438521539,ECE 200,020,103605,Le; Hanh-Phuc,9999,0,9999,0
1668438521539,ECE 200,021,103606,Lin; Bill,9999,0,9999,0
1668438521539,ECE 200,022,103607,Liu; Zhaowei,9998,0,9999,1
1668438521539,ECE 200,023,103608,Lo; Yu-Hwa,9999,0,9999,0
1668438521539,ECE 200,024,103609,Lomakin; Vitaliy,9999,0,9999,0
1668438521539,ECE 200,025,103610,Mercier; Patrick Philip,9999,0,9999,0
1668438521539,ECE 200,026,103611,Meyer; Florian,9999,0,9999,0
1668438521539,ECE 200,027,103612,Milstein; Laurence B.,9999,0,9999,0
1668438521539,ECE 200,028,103613,Mir Arabbaygi; Siavash,9999,0,9999,0
1668438521539,ECE 200,029,103614,Mookherjea; Shayan,9999,0,9999,0
1668438521539,ECE 200,030,103615,Morris; Karcher William,9999,0,9999,0
1668438521539,ECE 200,031,103616,Ng; Tse Nga,9999,0,9999,0
1668438521539,ECE 200,032,103617,Nguyen; Truong Quang,9999,0,9999,0
1668438521539,ECE 200,033,103618,Nomura; Kenji,9999,0,9999,0
1668438521539,ECE 200,034,103619,Orlitsky; Alon,9999,0,9999,0
1668438521539,ECE 200,035,103620,Pal; Piya,9999,0,9999,0
1668438521539,ECE 200,036,103621,Papen; George C.,9999,0,9999,0
1668438521539,ECE 200,037,103622,Radic; Stojan,9999,0,9999,0
1668438521539,ECE 200,038,103623,Rao; Bhaskar D.,9999,0,9999,0
1668438521539,ECE 200,039,103624,Rao; Ramesh R,9999,0,9999,0
1668438521539,ECE 200,040,103625,Rebeiz; Gabriel,9999,0,9999,0
1668438521539,ECE 200,041,103626,Sanford; John R,9999,0,9999,0
1668438521539,ECE 200,042,103627,Siegel; Paul H.,9999,0,9999,0
1668438521539,ECE 200,043,103628,Sievenpiper; Daniel F.,9999,0,9999,0
1668438521539,ECE 200,044,103629,Sworder; David D.,9999,0,9999,0
1668438521539,ECE 200,045,103630,Taur; Yuan,9999,0,9999,0
1668438521539,ECE 200,046,103631,Touri; Behrouz,9999,0,9999,0
1668438521539,ECE 200,047,103632,Trivedi; Mohan M.,9999,0,9999,0
1668438521539,ECE 200,048,103633,Vasconcelos; Nuno,9999,0,9999,0
1668438521539,ECE 200,049,103634,Wang; Xiaolong,9999,0,9999,0
1668438521539,ECE 200,050,103635,Xie; Pengtao,9999,0,9999,0
1668438521539,ECE 200,051,103636,Yip; Michael,9999,0,9999,0
1668438521539,ECE 200,052,103637,Zeger; Kenneth A.,999,0,999,0
1668438521539,ECE 200,053,103638,Zhang; Xinyu,9999,0,9999,0
1668438521539,ECE 200,054,103639,Turakhia; Yatish Girish,9999,0,9999,0
1668438521539,ECE 200,055,103640,Kang; Mingu,9999,0,9999,0
1668438521539,ECE 200,056,103641,Shi; Yuanyuan,9999,0,9999,0
1668438521539,ECE 200,057,103642,Wang; Edward Jay,9999,0,9999,0
1668438521539,ECE 200,058,103643,Zheng; Yang,9999,0,9999,0
1668438521966,ECE 202,A00,103644,Kuzum; Duygu,0,23,0,0
1668438522405,ECE 212BN,A00,103646,Ng; Tse Nga,0,1,0,0
1668438522832,ECE 221,A00,111493,Staff,0,0,0,0
1668438523263,ECE 222B,A00,103647,Lomakin; Vitaliy,0,5,0,0
1668438523711,ECE 230B,A00,103648,Taur; Yuan,0,0,0,0
1668438524137,ECE 238B,A00,103649,Garay; Javier,0,0,0,0
1668438524575,ECE 240B,A00,112900,Fainman; Yeshaiahu,0,4,0,0
1668438524998,ECE 247A,A00,103650,Jokerst; Jesse Vincent,0,1,0,0
1668438525426,ECE 247B,A00,103651,Wang; Joseph,0,6,0,0
1668438525862,ECE 250,A00,103652,Siegel; Paul H.,0,45,0,0
1668438526285,ECE 251A,A00,103654,Rao; Bhaskar D.,0,30,0,0
1668438526711,ECE 257B,A00,103655,Bharadia; Dinesh,0,12,0,0
1668438527138,ECE 258A,A00,103656,Milstein; Laurence B.,0,10,0,0
1668438527562,ECE 260B,A00,103658,Kang; Mingu,0,66,0,0
1668438527985,ECE 264A,A00,103659,Galton; Ian A,0,35,0,0
1668438528410,ECE 265A,A00,103661,Gudem; Prasad S.S.,0,18,0,0
1668438528842,ECE 265D,A00,103662,Gudem; Prasad S.S.,0,12,0,0
1668438529267,ECE 268,A00,103663,Koushanfar; Farinaz,0,20,0,0
1668438529692,ECE 269,A01,103665,Pal; Piya,0,135,0,0
1668438530122,ECE 271B,A00,103666,Vasconcelos; Manuela,0,47,0,0
1668438530547,ECE 276A,A00,103667,Atanasov; Nikolay A.,0,73,0,0
1668438530969,ECE 277,A00,103668,An; Cheolhong,0,92,0,0
1668438531407,ECE 279,A00,117947,Hall; Drew A.,0,13,0,0
1668438532263,ECE 283,A00,103670,Hsueh; Tzu-Chien,0,25,0,0
1668438532689,ECE 284,A00,103671,Turakhia; Yatish Girish,0,24,0,0
1668438533118,ECE 285,A00,103672,Zheng; Yang,0,25,0,0
1668438533118,ECE 285,B00,103673,Sworder; David D.,0,39,0,0
1668438533559,ECE 287,A00,103676,Javidi; Tara,0,4,0,0
1668438533988,MATH 200B,A00,098023,Salehi Golsefidy; Alireza,12,0,15,3
1668438534414,MATH 202B,A00,098024,Rhoades; Brendon Patrick,9,0,15,6
1668438534838,MATH 203B,A00,098025,Oprea; Dragos N.,10,0,15,5
1668438535280,MATH 204B,A00,098026,Sorensen; Claus M,13,0,15,2
1668438535703,MATH 208,A00,098027,Izadi; Elham,7,0,10,3
1668438536126,MATH 209,A00,098028,Pollack; Aaron,10,0,10,0
1668438536553,MATH 211A,A00,112919,Rogalski; Daniel,9,0,10,1
1668438536980,MATH 211B,A00,112920,Seward; Brandon M.,9,0,10,1
1668438537405,MATH 218,A00,098029,Li; Bo,10,0,10,0
1668438537840,MATH 220B,A00,098030,Novak; Jonathan I,11,0,15,4
1668438538271,MATH 221A,A00,098031,Ebenfelt; Peter F,13,0,15,2
1668438538705,MATH 231B,A00,098032,Zlatos; Andrej,12,0,15,3
1668438539130,MATH 240B,A00,098033,Ni; Lei,9,0,15,6
1668438539555,MATH 243,A00,098034,Jekel; David Andrew,10,0,10,0
1668438539981,MATH 245A,A00,098035,Nie; Jiawang,0,1,15,16
1668438540416,MATH 248,A00,098036,Bejenaru; Ioan,10,0,10,0
1668438540841,MATH 250B,A00,098037,Spolaor; Luca,14,0,15,1
1668438541263,MATH 258,A00,098038,Ni; Lei,10,0,10,0
1668438541694,MATH 264B,A00,098041,Rhoades; Brendon Patrick,9,0,15,6
1668438542125,MATH 268,A00,098042,Buss; Samuel R,10,0,10,0
1668438542555,MATH 269,A00,098043,Rhoades; Brendon Patrick,10,0,10,0
1668438542983,MATH 270B,A00,098044,Li; Bo,10,0,15,5
1668438543409,MATH 272B,A00,098045,Holst; Michael J,13,0,15,2
1668438543832,MATH 273A,A00,098046,Tian; Xiaochuan,10,0,15,5
1668438544258,MATH 275,A01,098048,Tian; Xiaochuan,6,0,10,4
1668438544682,MATH 278A,A00,098049,Holst; Michael J,8,0,10,2
1668438545111,MATH 278B,A00,098050,Cloninger; Alexander,10,0,10,0
1668438545543,MATH 278C,A00,098051,Nie; Jiawang,6,0,10,4
1668438545964,MATH 280B,A00,098052,Zheng; Tianyi,8,0,15,7
1668438546387,MATH 281B,A00,098053,Bradic; Jelena,0,1,15,15
1668438546831,MATH 282B,A00,098054,Arias-Castro; Ery,0,0,15,15
1668438547366,MATH 285,A00,098055,Fitzsimmons; Patrick J,0,0,15,17
1668438547793,MATH 287B,A00,098056,Arias-Castro; Ery,2,0,15,13
1668438548217,MATH 288,A00,098057,Agarwal; Pooja,9,0,10,1
1668438548217,MATH 288,B00,098058,Zhang; Danna,8,0,10,2
1668438548217,MATH 288,C00,098059,Williams; Ruth J,9,0,10,1
1668438548650,MATH 290B,A00,098060,Roberts; Justin Deritter,13,0,15,2
1668438549075,MATH 292,A00,098061,Belmont; Eva Kinoshita,10,0,10,0
1668438549514,MATH 295,A00,098062,Suk; Andrew Hoon,48,0,50,2
1668438549941,MATH 296,A00,098063,Novak; Jonathan I,20,0,20,0
1668438550372,MATH 297,001,098064,Gamst; Anthony Collins,9997,0,9999,2
1668439053198,COGS 205,A00,101395,Chiba; Andrea,19,0,20,1
1668439053627,COGS 210B,001,101404,Greene; Deanna Jacquelyn,9998,0,9999,1
1668439053627,COGS 210B,002,101417,Xia; Haijun,9999,0,9999,0
1668439053627,COGS 210B,003,101422,Nitz; Douglas A.,9999,0,9999,0
1668439053627,COGS 210B,004,101423,Hollan; James D.,9998,0,9999,1
1668439053627,COGS 210B,005,101424,Deak; Gedeon O.,9998,0,9999,1
1668439053627,COGS 210B,006,101425,Rossano; Federico,9999,0,9999,0
1668439054053,COGS 211B,A00,101427,Coulson; Seana M,9996,0,9999,3
1668439054479,COGS 220,A00,101428,Hollan; James D.,1,3,25,24
1668439054905,COGS 229,A00,101429,Dow; Steven P,18,0,25,7
1668439055333,COGS 230,A00,101430,Klemmer; Scott R,11,0,17,6
1668439055754,COGS 234,A00,101431,Xia; Haijun,2,0,25,23
1668439056202,COGS 260,A00,101432,Kiyonaga; Anastasia,21,0,25,4
1668439056202,COGS 260,B00,101433,Kirsh; David Joel,15,0,25,10
1668439056629,CSE 202,A00,102371,Impagliazzo; Russell,0,34,0,0
1668439057056,CSE 203B,A01,102373,Cheng; Chung Kuan,0,27,0,0
1668439057485,CSE 208,A00,102374,Micciancio; Daniele,0,1,0,0
1668439057908,CSE 209A,A00,112895,Impagliazzo; Russell,0,6,15,15
1668439058343,CSE 209B,A00,108005,Bellare; Mihir,0,3,0,0
1668439058775,CSE 210,A00,113163,Coblenz; Michael J,0,44,0,0
1668439059202,CSE 219,A00,106111,Dow; Steven P,0,0,20,20
1668439059626,CSE 221,A00,102376,Voelker; Geoffrey M.,0,30,0,0
1668439060051,CSE 224,A01,102378,Porter; George M,0,105,0,0
1668439060478,CSE 229A,A00,102379,Savage; Stefan,0,4,0,0
1668439061474,CSE 229C,A00,102380,Munyaka; Imani N. S.,0,4,0,0
1668439061900,CSE 232B,A00,102382,Deutsch; Alin Bernard,0,15,0,0
1668439062325,CSE 234,A01,112904,Kumar; Arun Kumar,0,0,0,0
1668439062759,CSE 237A,A00,102383,Rosing; Tajana Simunic,0,26,0,0
1668439063184,CSE 239A,A00,102384,Deutsch; Alin Bernard,0,6,0,0
1668439063613,CSE 239B,A00,102385,Polikarpova; Nadezhda,0,3,0,0
1668439064044,CSE 240A,A00,102386,Pannuto; Patrick William,0,27,0,0
1668439064471,CSE 240B,A00,102387,Zhao; Jishen,0,23,0,0
1668439064910,CSE 241A,A00,106406,Kang; Mingu,0,2,0,0
1668439065333,CSE 249B,A00,102388,Kahng; Andrew Byun,0,1,8,8
1668439065765,CSE 251B,A01,102392,Cottrell; Garrison W,0,24,0,0
1668439065765,CSE 251B,A02,102393,Cottrell; Garrison W,0,21,0,0
1668439066189,CSE 252B,A00,102394,Ochoa; Benjamin Lawrence,0,38,0,0
1668439066625,CSE 257,A01,102396,Gao; Sicun,0,86,0,0
1668439067061,CSE 272,A00,102397,Li; Tzumao,0,7,0,0
1668439067488,CSE 274,A00,111323,Chern; Albert Ren-Haur,0,7,0,0
1668439067923,CSE 282,A00,102398,Pevzner; Pavel Arkadjevich,0,0,0,0
1668439068350,CSE 284,A00,114175,Gymrek; Melissa Ann,0,11,0,0
1668439068783,CSE 290,A00,102399,Chandraker; Manmohan Krishna,0,4,0,0
1668439068783,CSE 290,B00,102400,Vaccaro; Kristen Marie,0,1,25,25
1668439068783,CSE 290,C00,102414,Pannuto; Patrick William,0,1,25,25
1668439068783,CSE 290,D00,102427,Pevzner; Pavel Arkadjevich,0,0,0,0
1668439068783,CSE 290,E00,102429,Zhao; Jishen,0,2,0,0
1668439068783,CSE 290,F00,102436,Tullsen; Dean Michael,0,3,0,0
1668439068783,CSE 290,G00,102440,Christensen; Henrik I,0,3,20,20
1668439069208,CSE 291,A00,102443,Su; Hao,0,0,0,0
1668439069208,CSE 291,B00,102448,Polikarpova; Nadezhda,0,0,0,0
1668439069208,CSE 291,C00,102453,Vaccaro; Kristen Marie,0,0,0,0
1668439069208,CSE 291,D00,111343,Savage; Stefan,0,0,0,0
1668439069208,CSE 291,E00,116474,Claffy; Kimberly Claire,0,0,0,0
1668439069208,CSE 291,F00,116479,Pasquale; Joseph,0,0,0,0
1668439069634,CSE 293,001,119111,Bafna; Vineet,9999,0,9999,0
1668439069634,CSE 293,002,119118,Bellare; Mihir,9999,0,9999,0
1668439069634,CSE 293,003,119122,Berg-Kirkpatrick; Taylor D,9999,0,9999,0
1668439069634,CSE 293,004,119135,Christensen; Henrik I,9999,0,9999,0
1668439069634,CSE 293,005,119142,Cottrell; Garrison W,9999,0,9999,0
1668439069634,CSE 293,006,119146,Deutsch; Alin Bernard,9999,0,9999,0
1668439069634,CSE 293,007,119159,Esmaeilzadeh; Hadi,9999,0,9999,0
1668439069634,CSE 293,008,119166,Freund; Yoav,9999,0,9999,0
1668439069634,CSE 293,009,119170,Griswold; William G.,9999,0,9999,0
1668439069634,CSE 293,010,119183,Gymrek; Melissa Ann,9999,0,9999,0
1668439069634,CSE 293,011,119190,Heninger; Nadia A,9999,0,9999,0
1668439069634,CSE 293,012,119230,Impagliazzo; Russell,9999,0,9999,0
1668439069634,CSE 293,013,119232,Jhala; Ranjit,9999,0,9999,0
1668439069634,CSE 293,014,119233,Kahng; Andrew Byun,9999,0,9999,0
1668439069634,CSE 293,015,119298,Kane; Daniel Mertz,9999,0,9999,0
1668439069634,CSE 293,016,119299,Kriegman; David J,9999,0,9999,0
1668439069634,CSE 293,017,119300,Kumar; Arun Kumar,9999,0,9999,0
1668439069634,CSE 293,018,119301,Lerner; Sorin,9999,0,9999,0
1668439069634,CSE 293,019,119302,Lovett; Shachar,9999,0,9999,0
1668439069634,CSE 293,020,119303,McAuley; Julian John,9999,0,9999,0
1668439069634,CSE 293,021,119304,Micciancio; Daniele,9999,0,9999,0
1668439069634,CSE 293,022,119367,Orailoglu; Alex,9999,0,9999,0
1668439069634,CSE 293,023,119382,Paturi; Ramamohan,9999,0,9999,0
1668439069634,CSE 293,024,119404,Polikarpova; Nadezhda,9999,0,9999,0
1668439069634,CSE 293,025,119406,Politz; Joseph Gibbs,9999,0,9999,0
1668439069634,CSE 293,026,119411,Porter; George M,9999,0,9999,0
1668439069634,CSE 293,027,119414,Porter; Leonard Emerson,9999,0,9999,0
1668439069634,CSE 293,028,119416,Ramamoorthi; Ravi,9999,0,9999,0
1668439069634,CSE 293,029,119417,Sahoo; Debashis,9999,0,9999,0
1668439069634,CSE 293,030,119420,Saul; Lawrence,9999,0,9999,0
1668439069634,CSE 293,031,119421,Savage; Stefan,9999,0,9999,0
1668439069634,CSE 293,032,119425,Schulze; Jurgen P.,9999,0,9999,0
1668439069634,CSE 293,033,119426,Snoeren; Alex C.,9999,0,9999,0
1668439069634,CSE 293,034,119428,Shang; Jingbo,9999,0,9999,0
1668439069634,CSE 293,035,119430,Stefan; Deian,9999,0,9999,0
1668439069634,CSE 293,036,119431,Su; Hao,9999,0,9999,0
1668439069634,CSE 293,037,119433,Swanson; Steven James,9999,0,9999,0
1668439069634,CSE 293,038,119435,Tullsen; Dean Michael,9999,0,9999,0
1668439069634,CSE 293,039,119483,Voelker; Geoffrey M.,9999,0,9999,0
1668439069634,CSE 293,040,119537,Zhao; Jishen,9999,0,9999,0
1668439069634,CSE 293,041,119538,Zhou; Yuan-Yuan,9999,0,9999,0
1668439069634,CSE 293,042,119539,Gao; Sicun,9999,0,9999,0
1668439069634,CSE 293,043,119540,Weibel; Nadir,9999,0,9999,0
1668439069634,CSE 293,044,119541,Gupta; Rajesh K.,9999,0,9999,0
1668439069634,CSE 293,045,126410,Vaccaro; Kristen Marie,9999,0,9999,0
1668439069634,CSE 293,046,126411,Klemke; Richard,9999,0,9999,0
1668439070062,CSE 294,A00,102459,Voelker; Geoffrey M.,0,1,0,0
1668439070062,CSE 294,B00,111322,Orailoglu; Alex,0,0,0,0
1668439070493,DSE 201,A00,096914,Deutsch; Alin Bernard,30,0,30,0
1668439071021,DSE 210,A00,096915,Dasgupta; Sanjoy,30,0,30,0
1668439071447,DSE 260A,A00,096916,Altintas De Callaf; Ilkay,30,0,30,0
1668439071902,ECE 200,001,103586,Antipa; Nicholas A,9999,0,9999,0
1668439071902,ECE 200,002,103587,Atanasov; Nikolay A.,9999,0,9999,0
1668439071902,ECE 200,003,103588,Bharadia; Dinesh,9999,0,9999,0
1668439071902,ECE 200,004,103589,Cheng; Chung Kuan,9999,0,9999,0
1668439071902,ECE 200,005,103590,Cosman; Pamela C.,9999,0,9999,0
1668439071902,ECE 200,006,103591,Dayeh; Shadi Ahmad,9999,0,9999,0
1668439071902,ECE 200,007,103592,Fainman; Yeshaiahu,9999,0,9999,0
1668439071902,ECE 200,008,103593,Ford; Joseph Earl,9999,0,9999,0
1668439071902,ECE 200,009,103594,Franceschetti; Massimo,9999,0,9999,0
1668439071902,ECE 200,010,103595,Fullerton; Eric E,9999,0,9999,0
1668439071902,ECE 200,011,103596,Galton; Ian A,9999,0,9999,0
1668439071902,ECE 200,012,103597,Gilja; Vikash,9999,0,9999,0
1668439071902,ECE 200,013,103598,Hall; Drew A.,9999,0,9999,0
1668439071902,ECE 200,014,103599,Hsueh; Tzu-Chien,9999,0,9999,0
1668439071902,ECE 200,015,103600,Javidi; Tara,9999,0,9999,0
1668439071902,ECE 200,016,103601,Kahng; Andrew Byun,9999,0,9999,0
1668439071902,ECE 200,017,103602,Kim; Young-Han,9999,0,9999,0
1668439071902,ECE 200,018,103603,Koushanfar; Farinaz,9999,0,9999,0
1668439071902,ECE 200,019,103604,Kuzum; Duygu,9999,0,9999,0
1668439071902,ECE 200,020,103605,Le; Hanh-Phuc,9999,0,9999,0
1668439071902,ECE 200,021,103606,Lin; Bill,9999,0,9999,0
1668439071902,ECE 200,022,103607,Liu; Zhaowei,9998,0,9999,1
1668439071902,ECE 200,023,103608,Lo; Yu-Hwa,9999,0,9999,0
1668439071902,ECE 200,024,103609,Lomakin; Vitaliy,9999,0,9999,0
1668439071902,ECE 200,025,103610,Mercier; Patrick Philip,9999,0,9999,0
1668439071902,ECE 200,026,103611,Meyer; Florian,9999,0,9999,0
1668439071902,ECE 200,027,103612,Milstein; Laurence B.,9999,0,9999,0
1668439071902,ECE 200,028,103613,Mir Arabbaygi; Siavash,9999,0,9999,0
1668439071902,ECE 200,029,103614,Mookherjea; Shayan,9999,0,9999,0
1668439071902,ECE 200,030,103615,Morris; Karcher William,9999,0,9999,0
1668439071902,ECE 200,031,103616,Ng; Tse Nga,9999,0,9999,0
1668439071902,ECE 200,032,103617,Nguyen; Truong Quang,9999,0,9999,0
1668439071902,ECE 200,033,103618,Nomura; Kenji,9999,0,9999,0
1668439071902,ECE 200,034,103619,Orlitsky; Alon,9999,0,9999,0
1668439071902,ECE 200,035,103620,Pal; Piya,9999,0,9999,0
1668439071902,ECE 200,036,103621,Papen; George C.,9999,0,9999,0
1668439071902,ECE 200,037,103622,Radic; Stojan,9999,0,9999,0
1668439071902,ECE 200,038,103623,Rao; Bhaskar D.,9999,0,9999,0
1668439071902,ECE 200,039,103624,Rao; Ramesh R,9999,0,9999,0
1668439071902,ECE 200,040,103625,Rebeiz; Gabriel,9999,0,9999,0
1668439071902,ECE 200,041,103626,Sanford; John R,9999,0,9999,0
1668439071902,ECE 200,042,103627,Siegel; Paul H.,9999,0,9999,0
1668439071902,ECE 200,043,103628,Sievenpiper; Daniel F.,9999,0,9999,0
1668439071902,ECE 200,044,103629,Sworder; David D.,9999,0,9999,0
1668439071902,ECE 200,045,103630,Taur; Yuan,9999,0,9999,0
1668439071902,ECE 200,046,103631,Touri; Behrouz,9999,0,9999,0
1668439071902,ECE 200,047,103632,Trivedi; Mohan M.,9999,0,9999,0
1668439071902,ECE 200,048,103633,Vasconcelos; Nuno,9999,0,9999,0
1668439071902,ECE 200,049,103634,Wang; Xiaolong,9999,0,9999,0
1668439071902,ECE 200,050,103635,Xie; Pengtao,9999,0,9999,0
1668439071902,ECE 200,051,103636,Yip; Michael,9999,0,9999,0
1668439071902,ECE 200,052,103637,Zeger; Kenneth A.,999,0,999,0
1668439071902,ECE 200,053,103638,Zhang; Xinyu,9999,0,9999,0
1668439071902,ECE 200,054,103639,Turakhia; Yatish Girish,9999,0,9999,0
1668439071902,ECE 200,055,103640,Kang; Mingu,9999,0,9999,0
1668439071902,ECE 200,056,103641,Shi; Yuanyuan,9999,0,9999,0
1668439071902,ECE 200,057,103642,Wang; Edward Jay,9999,0,9999,0
1668439071902,ECE 200,058,103643,Zheng; Yang,9999,0,9999,0
1668439072325,ECE 202,A00,103644,Kuzum; Duygu,0,23,0,0
1668439072750,ECE 212BN,A00,103646,Ng; Tse Nga,0,1,0,0
1668439073182,ECE 221,A00,111493,Staff,0,0,0,0
1668439073605,ECE 222B,A00,103647,Lomakin; Vitaliy,0,5,0,0
1668439074039,ECE 230B,A00,103648,Taur; Yuan,0,0,0,0
1668439074469,ECE 238B,A00,103649,Garay; Javier,0,0,0,0
1668439074898,ECE 240B,A00,112900,Fainman; Yeshaiahu,0,4,0,0
1668439075332,ECE 247A,A00,103650,Jokerst; Jesse Vincent,0,1,0,0
1668439075758,ECE 247B,A00,103651,Wang; Joseph,0,6,0,0
1668439076184,ECE 250,A00,103652,Siegel; Paul H.,0,45,0,0
1668439076613,ECE 251A,A00,103654,Rao; Bhaskar D.,0,30,0,0
1668439077039,ECE 257B,A00,103655,Bharadia; Dinesh,0,12,0,0
1668439077466,ECE 258A,A00,103656,Milstein; Laurence B.,0,10,0,0
1668439077892,ECE 260B,A00,103658,Kang; Mingu,0,66,0,0
1668439078319,ECE 264A,A00,103659,Galton; Ian A,0,35,0,0
1668439078743,ECE 265A,A00,103661,Gudem; Prasad S.S.,0,18,0,0
1668439079167,ECE 265D,A00,103662,Gudem; Prasad S.S.,0,12,0,0
1668439079590,ECE 268,A00,103663,Koushanfar; Farinaz,0,20,0,0
1668439080029,ECE 269,A01,103665,Pal; Piya,0,136,0,0
1668439080452,ECE 271B,A00,103666,Vasconcelos; Manuela,0,47,0,0
1668439080878,ECE 276A,A00,103667,Atanasov; Nikolay A.,0,73,0,0
1668439081303,ECE 277,A00,103668,An; Cheolhong,0,92,0,0
1668439081741,ECE 279,A00,117947,Hall; Drew A.,0,13,0,0
1668439082589,ECE 283,A00,103670,Hsueh; Tzu-Chien,0,25,0,0
1668439083019,ECE 284,A00,103671,Turakhia; Yatish Girish,0,24,0,0
1668439083456,ECE 285,A00,103672,Zheng; Yang,0,25,0,0
1668439083456,ECE 285,B00,103673,Sworder; David D.,0,40,0,0
1668439083886,ECE 287,A00,103676,Javidi; Tara,0,4,0,0
1668439084320,MATH 200B,A00,098023,Salehi Golsefidy; Alireza,12,0,15,3
1668439084746,MATH 202B,A00,098024,Rhoades; Brendon Patrick,9,0,15,6
1668439085169,MATH 203B,A00,098025,Oprea; Dragos N.,10,0,15,5
1668439085596,MATH 204B,A00,098026,Sorensen; Claus M,13,0,15,2
1668439086029,MATH 208,A00,098027,Izadi; Elham,7,0,10,3
1668439086455,MATH 209,A00,098028,Pollack; Aaron,10,0,10,0
1668439086883,MATH 211A,A00,112919,Rogalski; Daniel,9,0,10,1
1668439087324,MATH 211B,A00,112920,Seward; Brandon M.,9,0,10,1
1668439087751,MATH 218,A00,098029,Li; Bo,10,0,10,0
1668439088181,MATH 220B,A00,098030,Novak; Jonathan I,11,0,15,4
1668439088620,MATH 221A,A00,098031,Ebenfelt; Peter F,13,0,15,2
1668439089043,MATH 231B,A00,098032,Zlatos; Andrej,12,0,15,3
1668439089474,MATH 240B,A00,098033,Ni; Lei,9,0,15,6
1668439089896,MATH 243,A00,098034,Jekel; David Andrew,10,0,10,0
1668439090323,MATH 245A,A00,098035,Nie; Jiawang,0,1,15,16
1668439090758,MATH 248,A00,098036,Bejenaru; Ioan,10,0,10,0
1668439091193,MATH 250B,A00,098037,Spolaor; Luca,14,0,15,1
1668439091619,MATH 258,A00,098038,Ni; Lei,10,0,10,0
1668439092048,MATH 264B,A00,098041,Rhoades; Brendon Patrick,9,0,15,6
1668439092471,MATH 268,A00,098042,Buss; Samuel R,10,0,10,0
1668439092895,MATH 269,A00,098043,Rhoades; Brendon Patrick,10,0,10,0
1668439093319,MATH 270B,A00,098044,Li; Bo,10,0,15,5
1668439093758,MATH 272B,A00,098045,Holst; Michael J,13,0,15,2
1668439094181,MATH 273A,A00,098046,Tian; Xiaochuan,10,0,15,5
1668439094620,MATH 275,A01,098048,Tian; Xiaochuan,6,0,10,4
1668439095043,MATH 278A,A00,098049,Holst; Michael J,8,0,10,2
1668439095470,MATH 278B,A00,098050,Cloninger; Alexander,10,0,10,0
1668439095895,MATH 278C,A00,098051,Nie; Jiawang,6,0,10,4
1668439096320,MATH 280B,A00,098052,Zheng; Tianyi,8,0,15,7
1668439096756,MATH 281B,A00,098053,Bradic; Jelena,0,1,15,15
1668439097190,MATH 282B,A00,098054,Arias-Castro; Ery,0,0,15,15
1668439097618,MATH 285,A00,098055,Fitzsimmons; Patrick J,0,0,15,17
1668439098041,MATH 287B,A00,098056,Arias-Castro; Ery,2,0,15,13
1668439098465,MATH 288,A00,098057,Agarwal; Pooja,9,0,10,1
1668439098465,MATH 288,B00,098058,Zhang; Danna,8,0,10,2
1668439098465,MATH 288,C00,098059,Williams; Ruth J,9,0,10,1
1668439098902,MATH 290B,A00,098060,Roberts; Justin Deritter,13,0,15,2
1668439099346,MATH 292,A00,098061,Belmont; Eva Kinoshita,10,0,10,0
1668439099771,MATH 295,A00,098062,Suk; Andrew Hoon,48,0,50,2
1668439100196,MATH 296,A00,098063,Novak; Jonathan I,20,0,20,0
1668439100624,MATH 297,001,098064,Gamst; Anthony Collins,9997,0,9999,2
1668439606882,COGS 205,A00,101395,Chiba; Andrea,19,0,20,1
1668439607326,COGS 210B,001,101404,Greene; Deanna Jacquelyn,9998,0,9999,1
1668439607326,COGS 210B,002,101417,Xia; Haijun,9999,0,9999,0
1668439607326,COGS 210B,003,101422,Nitz; Douglas A.,9999,0,9999,0
1668439607326,COGS 210B,004,101423,Hollan; James D.,9998,0,9999,1
1668439607326,COGS 210B,005,101424,Deak; Gedeon O.,9998,0,9999,1
1668439607326,COGS 210B,006,101425,Rossano; Federico,9999,0,9999,0
1668439607753,COGS 211B,A00,101427,Coulson; Seana M,9996,0,9999,3
1668439608177,COGS 220,A00,101428,Hollan; James D.,1,3,25,24
1668439608601,COGS 229,A00,101429,Dow; Steven P,18,0,25,7
1668439609026,COGS 230,A00,101430,Klemmer; Scott R,11,0,17,6
1668439609458,COGS 234,A00,101431,Xia; Haijun,2,0,25,23
1668439609882,COGS 260,A00,101432,Kiyonaga; Anastasia,21,0,25,4
1668439609882,COGS 260,B00,101433,Kirsh; David Joel,15,0,25,10
1668439610323,CSE 202,A00,102371,Impagliazzo; Russell,0,34,0,0
1668439610746,CSE 203B,A01,102373,Cheng; Chung Kuan,0,27,0,0
1668439611169,CSE 208,A00,102374,Micciancio; Daniele,0,1,0,0
1668439611593,CSE 209A,A00,112895,Impagliazzo; Russell,0,6,15,15
1668439612027,CSE 209B,A00,108005,Bellare; Mihir,0,3,0,0
1668439612465,CSE 210,A00,113163,Coblenz; Michael J,0,44,0,0
1668439612888,CSE 219,A00,106111,Dow; Steven P,0,0,20,20
1668439613311,CSE 221,A00,102376,Voelker; Geoffrey M.,0,31,0,0
1668439613746,CSE 224,A01,102378,Porter; George M,0,105,0,0
1668439614170,CSE 229A,A00,102379,Savage; Stefan,0,4,0,0
1668439614601,CSE 229C,A00,102380,Munyaka; Imani N. S.,0,4,0,0
1668439615025,CSE 232B,A00,102382,Deutsch; Alin Bernard,0,15,0,0
1668439615448,CSE 234,A01,112904,Kumar; Arun Kumar,0,0,0,0
1668439615872,CSE 237A,A00,102383,Rosing; Tajana Simunic,0,26,0,0
1668439616298,CSE 239A,A00,102384,Deutsch; Alin Bernard,0,6,0,0
1668439616725,CSE 239B,A00,102385,Polikarpova; Nadezhda,0,3,0,0
1668439617151,CSE 240A,A00,102386,Pannuto; Patrick William,0,28,0,0
1668439617579,CSE 240B,A00,102387,Zhao; Jishen,0,23,0,0
1668439618002,CSE 241A,A00,106406,Kang; Mingu,0,2,0,0
1668439618447,CSE 249B,A00,102388,Kahng; Andrew Byun,0,1,8,8
1668439618872,CSE 251B,A01,102392,Cottrell; Garrison W,0,25,0,0
1668439618872,CSE 251B,A02,102393,Cottrell; Garrison W,0,21,0,0
1668439619297,CSE 252B,A00,102394,Ochoa; Benjamin Lawrence,0,38,0,0
1668439619724,CSE 257,A01,102396,Gao; Sicun,0,86,0,0
1668439620151,CSE 272,A00,102397,Li; Tzumao,0,7,0,0
1668439620585,CSE 274,A00,111323,Chern; Albert Ren-Haur,0,7,0,0
1668439621009,CSE 282,A00,102398,Pevzner; Pavel Arkadjevich,0,0,0,0
1668439621436,CSE 284,A00,114175,Gymrek; Melissa Ann,0,11,0,0
1668439621867,CSE 290,A00,102399,Chandraker; Manmohan Krishna,0,4,0,0
1668439621867,CSE 290,B00,102400,Vaccaro; Kristen Marie,0,1,25,25
1668439621867,CSE 290,C00,102414,Pannuto; Patrick William,0,1,25,25
1668439621867,CSE 290,D00,102427,Pevzner; Pavel Arkadjevich,0,0,0,0
1668439621867,CSE 290,E00,102429,Zhao; Jishen,0,2,0,0
1668439621867,CSE 290,F00,102436,Tullsen; Dean Michael,0,4,0,0
1668439621867,CSE 290,G00,102440,Christensen; Henrik I,0,3,20,20
1668439622299,CSE 291,A00,102443,Su; Hao,0,0,0,0
1668439622299,CSE 291,B00,102448,Polikarpova; Nadezhda,0,0,0,0
1668439622299,CSE 291,C00,102453,Vaccaro; Kristen Marie,0,0,0,0
1668439622299,CSE 291,D00,111343,Savage; Stefan,0,0,0,0
1668439622299,CSE 291,E00,116474,Claffy; Kimberly Claire,0,0,0,0
1668439622299,CSE 291,F00,116479,Pasquale; Joseph,0,0,0,0
1668439622763,CSE 293,001,119111,Bafna; Vineet,9999,0,9999,0
1668439622763,CSE 293,002,119118,Bellare; Mihir,9999,0,9999,0
1668439622763,CSE 293,003,119122,Berg-Kirkpatrick; Taylor D,9999,0,9999,0
1668439622763,CSE 293,004,119135,Christensen; Henrik I,9999,0,9999,0
1668439622763,CSE 293,005,119142,Cottrell; Garrison W,9999,0,9999,0
1668439622763,CSE 293,006,119146,Deutsch; Alin Bernard,9999,0,9999,0
1668439622763,CSE 293,007,119159,Esmaeilzadeh; Hadi,9999,0,9999,0
1668439622763,CSE 293,008,119166,Freund; Yoav,9999,0,9999,0
1668439622763,CSE 293,009,119170,Griswold; William G.,9999,0,9999,0
1668439622763,CSE 293,010,119183,Gymrek; Melissa Ann,9999,0,9999,0
1668439622763,CSE 293,011,119190,Heninger; Nadia A,9999,0,9999,0
1668439622763,CSE 293,012,119230,Impagliazzo; Russell,9999,0,9999,0
1668439622763,CSE 293,013,119232,Jhala; Ranjit,9999,0,9999,0
1668439622763,CSE 293,014,119233,Kahng; Andrew Byun,9999,0,9999,0
1668439622763,CSE 293,015,119298,Kane; Daniel Mertz,9999,0,9999,0
1668439622763,CSE 293,016,119299,Kriegman; David J,9999,0,9999,0
1668439622763,CSE 293,017,119300,Kumar; Arun Kumar,9999,0,9999,0
1668439622763,CSE 293,018,119301,Lerner; Sorin,9999,0,9999,0
1668439622763,CSE 293,019,119302,Lovett; Shachar,9999,0,9999,0
1668439622763,CSE 293,020,119303,McAuley; Julian John,9999,0,9999,0
1668439622763,CSE 293,021,119304,Micciancio; Daniele,9999,0,9999,0
1668439622763,CSE 293,022,119367,Orailoglu; Alex,9999,0,9999,0
1668439622763,CSE 293,023,119382,Paturi; Ramamohan,9999,0,9999,0
1668439622763,CSE 293,024,119404,Polikarpova; Nadezhda,9999,0,9999,0
1668439622763,CSE 293,025,119406,Politz; Joseph Gibbs,9999,0,9999,0
1668439622763,CSE 293,026,119411,Porter; George M,9999,0,9999,0
1668439622763,CSE 293,027,119414,Porter; Leonard Emerson,9999,0,9999,0
1668439622763,CSE 293,028,119416,Ramamoorthi; Ravi,9999,0,9999,0
1668439622763,CSE 293,029,119417,Sahoo; Debashis,9999,0,9999,0
1668439622763,CSE 293,030,119420,Saul; Lawrence,9999,0,9999,0
1668439622763,CSE 293,031,119421,Savage; Stefan,9999,0,9999,0
1668439622763,CSE 293,032,119425,Schulze; Jurgen P.,9999,0,9999,0
1668439622763,CSE 293,033,119426,Snoeren; Alex C.,9999,0,9999,0
1668439622763,CSE 293,034,119428,Shang; Jingbo,9999,0,9999,0
1668439622763,CSE 293,035,119430,Stefan; Deian,9999,0,9999,0
1668439622763,CSE 293,036,119431,Su; Hao,9999,0,9999,0
1668439622763,CSE 293,037,119433,Swanson; Steven James,9999,0,9999,0
1668439622763,CSE 293,038,119435,Tullsen; Dean Michael,9999,0,9999,0
1668439622763,CSE 293,039,119483,Voelker; Geoffrey M.,9999,0,9999,0
1668439622763,CSE 293,040,119537,Zhao; Jishen,9999,0,9999,0
1668439622763,CSE 293,041,119538,Zhou; Yuan-Yuan,9999,0,9999,0
1668439622763,CSE 293,042,119539,Gao; Sicun,9999,0,9999,0
1668439622763,CSE 293,043,119540,Weibel; Nadir,9999,0,9999,0
1668439622763,CSE 293,044,119541,Gupta; Rajesh K.,9999,0,9999,0
1668439622763,CSE 293,045,126410,Vaccaro; Kristen Marie,9999,0,9999,0
1668439622763,CSE 293,046,126411,Klemke; Richard,9999,0,9999,0
1668439623187,CSE 294,A00,102459,Voelker; Geoffrey M.,0,1,0,0
1668439623187,CSE 294,B00,111322,Orailoglu; Alex,0,0,0,0
1668439623613,DSE 201,A00,096914,Deutsch; Alin Bernard,30,0,30,0
1668439624034,DSE 210,A00,096915,Dasgupta; Sanjoy,30,0,30,0
1668439624460,DSE 260A,A00,096916,Altintas De Callaf; Ilkay,30,0,30,0
1668439624905,ECE 200,001,103586,Antipa; Nicholas A,9999,0,9999,0
1668439624905,ECE 200,002,103587,Atanasov; Nikolay A.,9999,0,9999,0
1668439624905,ECE 200,003,103588,Bharadia; Dinesh,9999,0,9999,0
1668439624905,ECE 200,004,103589,Cheng; Chung Kuan,9999,0,9999,0
1668439624905,ECE 200,005,103590,Cosman; Pamela C.,9999,0,9999,0
1668439624905,ECE 200,006,103591,Dayeh; Shadi Ahmad,9999,0,9999,0
1668439624905,ECE 200,007,103592,Fainman; Yeshaiahu,9999,0,9999,0
1668439624905,ECE 200,008,103593,Ford; Joseph Earl,9999,0,9999,0
1668439624905,ECE 200,009,103594,Franceschetti; Massimo,9999,0,9999,0
1668439624905,ECE 200,010,103595,Fullerton; Eric E,9999,0,9999,0
1668439624905,ECE 200,011,103596,Galton; Ian A,9999,0,9999,0
1668439624905,ECE 200,012,103597,Gilja; Vikash,9999,0,9999,0
1668439624905,ECE 200,013,103598,Hall; Drew A.,9999,0,9999,0
1668439624905,ECE 200,014,103599,Hsueh; Tzu-Chien,9999,0,9999,0
1668439624905,ECE 200,015,103600,Javidi; Tara,9999,0,9999,0
1668439624905,ECE 200,016,103601,Kahng; Andrew Byun,9999,0,9999,0
1668439624905,ECE 200,017,103602,Kim; Young-Han,9999,0,9999,0
1668439624905,ECE 200,018,103603,Koushanfar; Farinaz,9999,0,9999,0
1668439624905,ECE 200,019,103604,Kuzum; Duygu,9999,0,9999,0
1668439624905,ECE 200,020,103605,Le; Hanh-Phuc,9999,0,9999,0
1668439624905,ECE 200,021,103606,Lin; Bill,9999,0,9999,0
1668439624905,ECE 200,022,103607,Liu; Zhaowei,9998,0,9999,1
1668439624905,ECE 200,023,103608,Lo; Yu-Hwa,9999,0,9999,0
1668439624905,ECE 200,024,103609,Lomakin; Vitaliy,9999,0,9999,0
1668439624905,ECE 200,025,103610,Mercier; Patrick Philip,9999,0,9999,0
1668439624905,ECE 200,026,103611,Meyer; Florian,9999,0,9999,0
1668439624905,ECE 200,027,103612,Milstein; Laurence B.,9999,0,9999,0
1668439624905,ECE 200,028,103613,Mir Arabbaygi; Siavash,9999,0,9999,0
1668439624905,ECE 200,029,103614,Mookherjea; Shayan,9999,0,9999,0
1668439624905,ECE 200,030,103615,Morris; Karcher William,9999,0,9999,0
1668439624905,ECE 200,031,103616,Ng; Tse Nga,9999,0,9999,0
1668439624905,ECE 200,032,103617,Nguyen; Truong Quang,9999,0,9999,0
1668439624905,ECE 200,033,103618,Nomura; Kenji,9999,0,9999,0
1668439624905,ECE 200,034,103619,Orlitsky; Alon,9999,0,9999,0
1668439624905,ECE 200,035,103620,Pal; Piya,9999,0,9999,0
1668439624905,ECE 200,036,103621,Papen; George C.,9999,0,9999,0
1668439624905,ECE 200,037,103622,Radic; Stojan,9999,0,9999,0
1668439624905,ECE 200,038,103623,Rao; Bhaskar D.,9999,0,9999,0
1668439624905,ECE 200,039,103624,Rao; Ramesh R,9999,0,9999,0
1668439624905,ECE 200,040,103625,Rebeiz; Gabriel,9999,0,9999,0
1668439624905,ECE 200,041,103626,Sanford; John R,9999,0,9999,0
1668439624905,ECE 200,042,103627,Siegel; Paul H.,9999,0,9999,0
1668439624905,ECE 200,043,103628,Sievenpiper; Daniel F.,9999,0,9999,0
1668439624905,ECE 200,044,103629,Sworder; David D.,9999,0,9999,0
1668439624905,ECE 200,045,103630,Taur; Yuan,9999,0,9999,0
1668439624905,ECE 200,046,103631,Touri; Behrouz,9999,0,9999,0
1668439624905,ECE 200,047,103632,Trivedi; Mohan M.,9999,0,9999,0
1668439624905,ECE 200,048,103633,Vasconcelos; Nuno,9999,0,9999,0
1668439624905,ECE 200,049,103634,Wang; Xiaolong,9999,0,9999,0
1668439624905,ECE 200,050,103635,Xie; Pengtao,9999,0,9999,0
1668439624905,ECE 200,051,103636,Yip; Michael,9999,0,9999,0
1668439624905,ECE 200,052,103637,Zeger; Kenneth A.,999,0,999,0
1668439624905,ECE 200,053,103638,Zhang; Xinyu,9999,0,9999,0
1668439624905,ECE 200,054,103639,Turakhia; Yatish Girish,9999,0,9999,0
1668439624905,ECE 200,055,103640,Kang; Mingu,9999,0,9999,0
1668439624905,ECE 200,056,103641,Shi; Yuanyuan,9999,0,9999,0
1668439624905,ECE 200,057,103642,Wang; Edward Jay,9999,0,9999,0
1668439624905,ECE 200,058,103643,Zheng; Yang,9999,0,9999,0
1668439625330,ECE 202,A00,103644,Kuzum; Duygu,0,23,0,0
1668439625769,ECE 212BN,A00,103646,Ng; Tse Nga,0,1,0,0
1668439626193,ECE 221,A00,111493,Staff,0,0,0,0
1668439626617,ECE 222B,A00,103647,Lomakin; Vitaliy,0,5,0,0
1668439627044,ECE 230B,A00,103648,Taur; Yuan,0,0,0,0
1668439627470,ECE 238B,A00,103649,Garay; Javier,0,0,0,0
1668439627897,ECE 240B,A00,112900,Fainman; Yeshaiahu,0,4,0,0
1668439628324,ECE 247A,A00,103650,Jokerst; Jesse Vincent,0,1,0,0
1668439628761,ECE 247B,A00,103651,Wang; Joseph,0,6,0,0
1668439629196,ECE 250,A00,103652,Siegel; Paul H.,0,45,0,0
1668439629621,ECE 251A,A00,103654,Rao; Bhaskar D.,0,30,0,0
1668439630049,ECE 257B,A00,103655,Bharadia; Dinesh,0,12,0,0
1668439630478,ECE 258A,A00,103656,Milstein; Laurence B.,0,10,0,0
1668439630911,ECE 260B,A00,103658,Kang; Mingu,0,66,0,0
1668439631337,ECE 264A,A00,103659,Galton; Ian A,0,36,0,0
1668439631758,ECE 265A,A00,103661,Gudem; Prasad S.S.,0,19,0,0
1668439632192,ECE 265D,A00,103662,Gudem; Prasad S.S.,0,12,0,0
1668439632620,ECE 268,A00,103663,Koushanfar; Farinaz,0,22,0,0
1668439633045,ECE 269,A01,103665,Pal; Piya,0,136,0,0
1668439633477,ECE 271B,A00,103666,Vasconcelos; Manuela,0,47,0,0
1668439633906,ECE 276A,A00,103667,Atanasov; Nikolay A.,0,73,0,0
1668439634333,ECE 277,A00,103668,An; Cheolhong,0,92,0,0
1668439634765,ECE 279,A00,117947,Hall; Drew A.,0,13,0,0
1668439635615,ECE 283,A00,103670,Hsueh; Tzu-Chien,0,25,0,0
1668439636054,ECE 284,A00,103671,Turakhia; Yatish Girish,0,26,0,0
1668439636482,ECE 285,A00,103672,Zheng; Yang,0,25,0,0
1668439636482,ECE 285,B00,103673,Sworder; David D.,0,40,0,0
1668439636908,ECE 287,A00,103676,Javidi; Tara,0,4,0,0
1668439637335,MATH 200B,A00,098023,Salehi Golsefidy; Alireza,12,0,15,3
1668439637768,MATH 202B,A00,098024,Rhoades; Brendon Patrick,9,0,15,6
1668439638193,MATH 203B,A00,098025,Oprea; Dragos N.,10,0,15,5
1668439638618,MATH 204B,A00,098026,Sorensen; Claus M,13,0,15,2
1668439639059,MATH 208,A00,098027,Izadi; Elham,7,0,10,3
1668439639485,MATH 209,A00,098028,Pollack; Aaron,10,0,10,0
1668439639918,MATH 211A,A00,112919,Rogalski; Daniel,9,0,10,1
1668439640357,MATH 211B,A00,112920,Seward; Brandon M.,9,0,10,1
1668439640865,MATH 218,A00,098029,Li; Bo,10,0,10,0
1668439641297,MATH 220B,A00,098030,Novak; Jonathan I,11,0,15,4
1668439641723,MATH 221A,A00,098031,Ebenfelt; Peter F,13,0,15,2
1668439642177,MATH 231B,A00,098032,Zlatos; Andrej,12,0,15,3
1668439642599,MATH 240B,A00,098033,Ni; Lei,9,0,15,6
1668439643034,MATH 243,A00,098034,Jekel; David Andrew,10,0,10,0
1668439643470,MATH 245A,A00,098035,Nie; Jiawang,0,1,15,16
1668439643904,MATH 248,A00,098036,Bejenaru; Ioan,10,0,10,0
1668439644331,MATH 250B,A00,098037,Spolaor; Luca,14,0,15,1
1668439644759,MATH 258,A00,098038,Ni; Lei,10,0,10,0
1668439645196,MATH 264B,A00,098041,Rhoades; Brendon Patrick,9,0,15,6
1668439645628,MATH 268,A00,098042,Buss; Samuel R,10,0,10,0
1668439646061,MATH 269,A00,098043,Rhoades; Brendon Patrick,10,0,10,0
1668439646491,MATH 270B,A00,098044,Li; Bo,10,0,15,5
1668439646915,MATH 272B,A00,098045,Holst; Michael J,13,0,15,2
1668439647353,MATH 273A,A00,098046,Tian; Xiaochuan,10,0,15,5
1668439647791,MATH 275,A01,098048,Tian; Xiaochuan,6,0,10,4
1668439648217,MATH 278A,A00,098049,Holst; Michael J,8,0,10,2
1668439648650,MATH 278B,A00,098050,Cloninger; Alexander,10,0,10,0
1668439649082,MATH 278C,A00,098051,Nie; Jiawang,6,0,10,4
1668439649506,MATH 280B,A00,098052,Zheng; Tianyi,8,0,15,7
1668439649932,MATH 281B,A00,098053,Bradic; Jelena,0,1,15,15
1668439650358,MATH 282B,A00,098054,Arias-Castro; Ery,0,0,15,15
1668439650790,MATH 285,A00,098055,Fitzsimmons; Patrick J,0,0,15,17
1668439651218,MATH 287B,A00,098056,Arias-Castro; Ery,2,0,15,13
1668439651642,MATH 288,A00,098057,Agarwal; Pooja,9,0,10,1
1668439651642,MATH 288,B00,098058,Zhang; Danna,8,0,10,2
1668439651642,MATH 288,C00,098059,Williams; Ruth J,9,0,10,1
1668439652078,MATH 290B,A00,098060,Roberts; Justin Deritter,13,0,15,2
1668439652512,MATH 292,A00,098061,Belmont; Eva Kinoshita,10,0,10,0
1668439652935,MATH 295,A00,098062,Suk; Andrew Hoon,48,0,50,2
1668439653375,MATH 296,A00,098063,Novak; Jonathan I,20,0,20,0
1668439653802,MATH 297,001,098064,Gamst; Anthony Collins,9997,0,9999,2
1668440157238,COGS 205,A00,101395,Chiba; Andrea,19,0,20,1
1668440157669,COGS 210B,001,101404,Greene; Deanna Jacquelyn,9998,0,9999,1
1668440157669,COGS 210B,002,101417,Xia; Haijun,9999,0,9999,0
1668440157669,COGS 210B,003,101422,Nitz; Douglas A.,9999,0,9999,0
1668440157669,COGS 210B,004,101423,Hollan; James D.,9998,0,9999,1
1668440157669,COGS 210B,005,101424,Deak; Gedeon O.,9998,0,9999,1
1668440157669,COGS 210B,006,101425,Rossano; Federico,9999,0,9999,0
1668440158093,COGS 211B,A00,101427,Coulson; Seana M,9996,0,9999,3
1668440158518,COGS 220,A00,101428,Hollan; James D.,1,3,25,24
1668440158942,COGS 229,A00,101429,Dow; Steven P,18,0,25,7
1668440159368,COGS 230,A00,101430,Klemmer; Scott R,11,0,17,6
1668440159792,COGS 234,A00,101431,Xia; Haijun,2,0,25,23
1668440160222,COGS 260,A00,101432,Kiyonaga; Anastasia,21,0,25,4
1668440160222,COGS 260,B00,101433,Kirsh; David Joel,15,0,25,10
1668440160647,CSE 202,A00,102371,Impagliazzo; Russell,0,34,0,0
1668440161070,CSE 203B,A01,102373,Cheng; Chung Kuan,0,27,0,0
1668440161496,CSE 208,A00,102374,Micciancio; Daniele,0,1,0,0
1668440161923,CSE 209A,A00,112895,Impagliazzo; Russell,0,6,15,15
1668440162350,CSE 209B,A00,108005,Bellare; Mihir,0,3,0,0
1668440162778,CSE 210,A00,113163,Coblenz; Michael J,0,44,0,0
1668440163202,CSE 219,A00,106111,Dow; Steven P,0,0,20,20
1668440163629,CSE 221,A00,102376,Voelker; Geoffrey M.,0,31,0,0
1668440164057,CSE 224,A01,102378,Porter; George M,0,105,0,0
1668440164562,CSE 229A,A00,102379,Savage; Stefan,0,4,0,0
1668440164993,CSE 229C,A00,102380,Munyaka; Imani N. S.,0,4,0,0
1668440165424,CSE 232B,A00,102382,Deutsch; Alin Bernard,0,15,0,0
1668440165846,CSE 234,A01,112904,Kumar; Arun Kumar,0,0,0,0
1668440166274,CSE 237A,A00,102383,Rosing; Tajana Simunic,0,27,0,0
1668440166699,CSE 239A,A00,102384,Deutsch; Alin Bernard,0,6,0,0
1668440167124,CSE 239B,A00,102385,Polikarpova; Nadezhda,0,3,0,0
1668440167552,CSE 240A,A00,102386,Pannuto; Patrick William,0,28,0,0
1668440167976,CSE 240B,A00,102387,Zhao; Jishen,0,23,0,0
1668440168400,CSE 241A,A00,106406,Kang; Mingu,0,2,0,0
1668440168837,CSE 249B,A00,102388,Kahng; Andrew Byun,0,1,8,8
1668440169265,CSE 251B,A01,102392,Cottrell; Garrison W,0,26,0,0
1668440169265,CSE 251B,A02,102393,Cottrell; Garrison W,0,21,0,0
1668440169708,CSE 252B,A00,102394,Ochoa; Benjamin Lawrence,0,38,0,0
1668440170134,CSE 257,A01,102396,Gao; Sicun,0,86,0,0
1668440170566,CSE 272,A00,102397,Li; Tzumao,0,7,0,0
1668440170997,CSE 274,A00,111323,Chern; Albert Ren-Haur,0,7,0,0
1668440171427,CSE 282,A00,102398,Pevzner; Pavel Arkadjevich,0,0,0,0
1668440171849,CSE 284,A00,114175,Gymrek; Melissa Ann,0,11,0,0
1668440172275,CSE 290,A00,102399,Chandraker; Manmohan Krishna,0,4,0,0
1668440172275,CSE 290,B00,102400,Vaccaro; Kristen Marie,0,1,25,25
1668440172275,CSE 290,C00,102414,Pannuto; Patrick William,0,1,25,25
1668440172275,CSE 290,D00,102427,Pevzner; Pavel Arkadjevich,0,0,0,0
1668440172275,CSE 290,E00,102429,Zhao; Jishen,0,2,0,0
1668440172275,CSE 290,F00,102436,Tullsen; Dean Michael,0,4,0,0
1668440172275,CSE 290,G00,102440,Christensen; Henrik I,0,3,20,20
1668440172707,CSE 291,A00,102443,Su; Hao,0,0,0,0
1668440172707,CSE 291,B00,102448,Polikarpova; Nadezhda,0,0,0,0
1668440172707,CSE 291,C00,102453,Vaccaro; Kristen Marie,0,0,0,0
1668440172707,CSE 291,D00,111343,Savage; Stefan,0,0,0,0
1668440172707,CSE 291,E00,116474,Claffy; Kimberly Claire,0,0,0,0
1668440172707,CSE 291,F00,116479,Pasquale; Joseph,0,0,0,0
1668440173179,CSE 293,001,119111,Bafna; Vineet,9999,0,9999,0
1668440173179,CSE 293,002,119118,Bellare; Mihir,9999,0,9999,0
1668440173179,CSE 293,003,119122,Berg-Kirkpatrick; Taylor D,9999,0,9999,0
1668440173179,CSE 293,004,119135,Christensen; Henrik I,9999,0,9999,0
1668440173179,CSE 293,005,119142,Cottrell; Garrison W,9999,0,9999,0
1668440173179,CSE 293,006,119146,Deutsch; Alin Bernard,9999,0,9999,0
1668440173179,CSE 293,007,119159,Esmaeilzadeh; Hadi,9999,0,9999,0
1668440173179,CSE 293,008,119166,Freund; Yoav,9999,0,9999,0
1668440173179,CSE 293,009,119170,Griswold; William G.,9999,0,9999,0
1668440173179,CSE 293,010,119183,Gymrek; Melissa Ann,9999,0,9999,0
1668440173179,CSE 293,011,119190,Heninger; Nadia A,9999,0,9999,0
1668440173179,CSE 293,012,119230,Impagliazzo; Russell,9999,0,9999,0
1668440173179,CSE 293,013,119232,Jhala; Ranjit,9999,0,9999,0
1668440173179,CSE 293,014,119233,Kahng; Andrew Byun,9999,0,9999,0
1668440173179,CSE 293,015,119298,Kane; Daniel Mertz,9999,0,9999,0
1668440173179,CSE 293,016,119299,Kriegman; David J,9999,0,9999,0
1668440173179,CSE 293,017,119300,Kumar; Arun Kumar,9999,0,9999,0
1668440173179,CSE 293,018,119301,Lerner; Sorin,9999,0,9999,0
1668440173179,CSE 293,019,119302,Lovett; Shachar,9999,0,9999,0
1668440173179,CSE 293,020,119303,McAuley; Julian John,9999,0,9999,0
1668440173179,CSE 293,021,119304,Micciancio; Daniele,9999,0,9999,0
1668440173179,CSE 293,022,119367,Orailoglu; Alex,9999,0,9999,0
1668440173179,CSE 293,023,119382,Paturi; Ramamohan,9999,0,9999,0
1668440173179,CSE 293,024,119404,Polikarpova; Nadezhda,9999,0,9999,0
1668440173179,CSE 293,025,119406,Politz; Joseph Gibbs,9999,0,9999,0
1668440173179,CSE 293,026,119411,Porter; George M,9999,0,9999,0
1668440173179,CSE 293,027,119414,Porter; Leonard Emerson,9999,0,9999,0
1668440173179,CSE 293,028,119416,Ramamoorthi; Ravi,9999,0,9999,0
1668440173179,CSE 293,029,119417,Sahoo; Debashis,9999,0,9999,0
1668440173179,CSE 293,030,119420,Saul; Lawrence,9999,0,9999,0
1668440173179,CSE 293,031,119421,Savage; Stefan,9999,0,9999,0
1668440173179,CSE 293,032,119425,Schulze; Jurgen P.,9999,0,9999,0
1668440173179,CSE 293,033,119426,Snoeren; Alex C.,9999,0,9999,0
1668440173179,CSE 293,034,119428,Shang; Jingbo,9999,0,9999,0
1668440173179,CSE 293,035,119430,Stefan; Deian,9999,0,9999,0
1668440173179,CSE 293,036,119431,Su; Hao,9999,0,9999,0
1668440173179,CSE 293,037,119433,Swanson; Steven James,9999,0,9999,0
1668440173179,CSE 293,038,119435,Tullsen; Dean Michael,9999,0,9999,0
1668440173179,CSE 293,039,119483,Voelker; Geoffrey M.,9999,0,9999,0
1668440173179,CSE 293,040,119537,Zhao; Jishen,9999,0,9999,0
1668440173179,CSE 293,041,119538,Zhou; Yuan-Yuan,9999,0,9999,0
1668440173179,CSE 293,042,119539,Gao; Sicun,9999,0,9999,0
1668440173179,CSE 293,043,119540,Weibel; Nadir,9999,0,9999,0
1668440173179,CSE 293,044,119541,Gupta; Rajesh K.,9999,0,9999,0
1668440173179,CSE 293,045,126410,Vaccaro; Kristen Marie,9999,0,9999,0
1668440173179,CSE 293,046,126411,Klemke; Richard,9999,0,9999,0
1668440173617,CSE 294,A00,102459,Voelker; Geoffrey M.,0,1,0,0
1668440173617,CSE 294,B00,111322,Orailoglu; Alex,0,0,0,0
1668440174043,DSE 201,A00,096914,Deutsch; Alin Bernard,30,0,30,0
1668440174465,DSE 210,A00,096915,Dasgupta; Sanjoy,30,0,30,0
1668440174910,DSE 260A,A00,096916,Altintas De Callaf; Ilkay,30,0,30,0
1668440175344,ECE 200,001,103586,Antipa; Nicholas A,9999,0,9999,0
1668440175344,ECE 200,002,103587,Atanasov; Nikolay A.,9999,0,9999,0
1668440175344,ECE 200,003,103588,Bharadia; Dinesh,9999,0,9999,0
1668440175344,ECE 200,004,103589,Cheng; Chung Kuan,9999,0,9999,0
1668440175344,ECE 200,005,103590,Cosman; Pamela C.,9999,0,9999,0
1668440175344,ECE 200,006,103591,Dayeh; Shadi Ahmad,9999,0,9999,0
1668440175344,ECE 200,007,103592,Fainman; Yeshaiahu,9999,0,9999,0
1668440175344,ECE 200,008,103593,Ford; Joseph Earl,9999,0,9999,0
1668440175344,ECE 200,009,103594,Franceschetti; Massimo,9999,0,9999,0
1668440175344,ECE 200,010,103595,Fullerton; Eric E,9999,0,9999,0
1668440175344,ECE 200,011,103596,Galton; Ian A,9999,0,9999,0
1668440175344,ECE 200,012,103597,Gilja; Vikash,9999,0,9999,0
1668440175344,ECE 200,013,103598,Hall; Drew A.,9999,0,9999,0
1668440175344,ECE 200,014,103599,Hsueh; Tzu-Chien,9999,0,9999,0
1668440175344,ECE 200,015,103600,Javidi; Tara,9999,0,9999,0
1668440175344,ECE 200,016,103601,Kahng; Andrew Byun,9999,0,9999,0
1668440175344,ECE 200,017,103602,Kim; Young-Han,9999,0,9999,0
1668440175344,ECE 200,018,103603,Koushanfar; Farinaz,9999,0,9999,0
1668440175344,ECE 200,019,103604,Kuzum; Duygu,9999,0,9999,0
1668440175344,ECE 200,020,103605,Le; Hanh-Phuc,9999,0,9999,0
1668440175344,ECE 200,021,103606,Lin; Bill,9999,0,9999,0
1668440175344,ECE 200,022,103607,Liu; Zhaowei,9998,0,9999,1
1668440175344,ECE 200,023,103608,Lo; Yu-Hwa,9999,0,9999,0
1668440175344,ECE 200,024,103609,Lomakin; Vitaliy,9999,0,9999,0
1668440175344,ECE 200,025,103610,Mercier; Patrick Philip,9999,0,9999,0
1668440175344,ECE 200,026,103611,Meyer; Florian,9999,0,9999,0
1668440175344,ECE 200,027,103612,Milstein; Laurence B.,9999,0,9999,0
1668440175344,ECE 200,028,103613,Mir Arabbaygi; Siavash,9999,0,9999,0
1668440175344,ECE 200,029,103614,Mookherjea; Shayan,9999,0,9999,0
1668440175344,ECE 200,030,103615,Morris; Karcher William,9999,0,9999,0
1668440175344,ECE 200,031,103616,Ng; Tse Nga,9999,0,9999,0
1668440175344,ECE 200,032,103617,Nguyen; Truong Quang,9999,0,9999,0
1668440175344,ECE 200,033,103618,Nomura; Kenji,9999,0,9999,0
1668440175344,ECE 200,034,103619,Orlitsky; Alon,9999,0,9999,0
1668440175344,ECE 200,035,103620,Pal; Piya,9999,0,9999,0
1668440175344,ECE 200,036,103621,Papen; George C.,9999,0,9999,0
1668440175344,ECE 200,037,103622,Radic; Stojan,9999,0,9999,0
1668440175344,ECE 200,038,103623,Rao; Bhaskar D.,9999,0,9999,0
1668440175344,ECE 200,039,103624,Rao; Ramesh R,9999,0,9999,0
1668440175344,ECE 200,040,103625,Rebeiz; Gabriel,9999,0,9999,0
1668440175344,ECE 200,041,103626,Sanford; John R,9999,0,9999,0
1668440175344,ECE 200,042,103627,Siegel; Paul H.,9999,0,9999,0
1668440175344,ECE 200,043,103628,Sievenpiper; Daniel F.,9999,0,9999,0
1668440175344,ECE 200,044,103629,Sworder; David D.,9999,0,9999,0
1668440175344,ECE 200,045,103630,Taur; Yuan,9999,0,9999,0
1668440175344,ECE 200,046,103631,Touri; Behrouz,9999,0,9999,0
1668440175344,ECE 200,047,103632,Trivedi; Mohan M.,9999,0,9999,0
1668440175344,ECE 200,048,103633,Vasconcelos; Nuno,9999,0,9999,0
1668440175344,ECE 200,049,103634,Wang; Xiaolong,9999,0,9999,0
1668440175344,ECE 200,050,103635,Xie; Pengtao,9999,0,9999,0
1668440175344,ECE 200,051,103636,Yip; Michael,9999,0,9999,0
1668440175344,ECE 200,052,103637,Zeger; Kenneth A.,999,0,999,0
1668440175344,ECE 200,053,103638,Zhang; Xinyu,9999,0,9999,0
1668440175344,ECE 200,054,103639,Turakhia; Yatish Girish,9999,0,9999,0
1668440175344,ECE 200,055,103640,Kang; Mingu,9999,0,9999,0
1668440175344,ECE 200,056,103641,Shi; Yuanyuan,9999,0,9999,0
1668440175344,ECE 200,057,103642,Wang; Edward Jay,9999,0,9999,0
1668440175344,ECE 200,058,103643,Zheng; Yang,9999,0,9999,0
1668440175770,ECE 202,A00,103644,Kuzum; Duygu,0,23,0,0
1668440176193,ECE 212BN,A00,103646,Ng; Tse Nga,0,1,0,0
1668440176626,ECE 221,A00,111493,Staff,0,0,0,0
1668440177061,ECE 222B,A00,103647,Lomakin; Vitaliy,0,5,0,0
1668440177484,ECE 230B,A00,103648,Taur; Yuan,0,0,0,0
1668440177909,ECE 238B,A00,103649,Garay; Javier,0,0,0,0
1668440178333,ECE 240B,A00,112900,Fainman; Yeshaiahu,0,4,0,0
1668440178766,ECE 247A,A00,103650,Jokerst; Jesse Vincent,0,1,0,0
1668440179189,ECE 247B,A00,103651,Wang; Joseph,0,6,0,0
1668440179616,ECE 250,A00,103652,Siegel; Paul H.,0,45,0,0
1668440180042,ECE 251A,A00,103654,Rao; Bhaskar D.,0,31,0,0
1668440180465,ECE 257B,A00,103655,Bharadia; Dinesh,0,13,0,0
1668440180907,ECE 258A,A00,103656,Milstein; Laurence B.,0,10,0,0
1668440181335,ECE 260B,A00,103658,Kang; Mingu,0,67,0,0
1668440181762,ECE 264A,A00,103659,Galton; Ian A,0,36,0,0
1668440182199,ECE 265A,A00,103661,Gudem; Prasad S.S.,0,19,0,0
1668440182623,ECE 265D,A00,103662,Gudem; Prasad S.S.,0,12,0,0
1668440183057,ECE 268,A00,103663,Koushanfar; Farinaz,0,22,0,0
1668440183484,ECE 269,A01,103665,Pal; Piya,0,137,0,0
1668440183917,ECE 271B,A00,103666,Vasconcelos; Manuela,0,48,0,0
1668440184344,ECE 276A,A00,103667,Atanasov; Nikolay A.,0,74,0,0
1668440184775,ECE 277,A00,103668,An; Cheolhong,0,93,0,0
1668440185226,ECE 279,A00,117947,Hall; Drew A.,0,13,0,0
1668440186083,ECE 283,A00,103670,Hsueh; Tzu-Chien,0,25,0,0
1668440186519,ECE 284,A00,103671,Turakhia; Yatish Girish,0,26,0,0
1668440186945,ECE 285,A00,103672,Zheng; Yang,0,25,0,0
1668440186945,ECE 285,B00,103673,Sworder; David D.,0,40,0,0
1668440187378,ECE 287,A00,103676,Javidi; Tara,0,4,0,0
1668440187806,MATH 200B,A00,098023,Salehi Golsefidy; Alireza,12,0,15,3
1668440188240,MATH 202B,A00,098024,Rhoades; Brendon Patrick,9,0,15,6
1668440188675,MATH 203B,A00,098025,Oprea; Dragos N.,10,0,15,5
1668440189099,MATH 204B,A00,098026,Sorensen; Claus M,13,0,15,2
1668440189534,MATH 208,A00,098027,Izadi; Elham,7,0,10,3
1668440189966,MATH 209,A00,098028,Pollack; Aaron,10,0,10,0
1668440190402,MATH 211A,A00,112919,Rogalski; Daniel,9,0,10,1
1668440190827,MATH 211B,A00,112920,Seward; Brandon M.,9,0,10,1
1668440191257,MATH 218,A00,098029,Li; Bo,10,0,10,0
1668440191680,MATH 220B,A00,098030,Novak; Jonathan I,11,0,15,4
1668440192106,MATH 221A,A00,098031,Ebenfelt; Peter F,13,0,15,2
1668440192538,MATH 231B,A00,098032,Zlatos; Andrej,12,0,15,3
1668440192965,MATH 240B,A00,098033,Ni; Lei,9,0,15,6
1668440193395,MATH 243,A00,098034,Jekel; David Andrew,10,0,10,0
1668440193819,MATH 245A,A00,098035,Nie; Jiawang,0,1,15,16
1668440194245,MATH 248,A00,098036,Bejenaru; Ioan,10,0,10,0
1668440194673,MATH 250B,A00,098037,Spolaor; Luca,14,0,15,1
1668440195113,MATH 258,A00,098038,Ni; Lei,10,0,10,0
1668440195547,MATH 264B,A00,098041,Rhoades; Brendon Patrick,9,0,15,6
1668440195969,MATH 268,A00,098042,Buss; Samuel R,10,0,10,0
1668440196399,MATH 269,A00,098043,Rhoades; Brendon Patrick,10,0,10,0
1668440196823,MATH 270B,A00,098044,Li; Bo,10,0,15,5
1668440197251,MATH 272B,A00,098045,Holst; Michael J,13,0,15,2
1668440197686,MATH 273A,A00,098046,Tian; Xiaochuan,10,0,15,5
1668440198109,MATH 275,A01,098048,Tian; Xiaochuan,6,0,10,4
1668440198531,MATH 278A,A00,098049,Holst; Michael J,8,0,10,2
1668440198959,MATH 278B,A00,098050,Cloninger; Alexander,10,0,10,0
1668440199387,MATH 278C,A00,098051,Nie; Jiawang,6,0,10,4
1668440199824,MATH 280B,A00,098052,Zheng; Tianyi,8,0,15,7
1668440200250,MATH 281B,A00,098053,Bradic; Jelena,0,1,15,15
1668440200672,MATH 282B,A00,098054,Arias-Castro; Ery,0,0,15,15
1668440201109,MATH 285,A00,098055,Fitzsimmons; Patrick J,0,1,15,17
1668440201533,MATH 287B,A00,098056,Arias-Castro; Ery,2,0,15,13
1668440201961,MATH 288,A00,098057,Agarwal; Pooja,9,0,10,1
1668440201961,MATH 288,B00,098058,Zhang; Danna,8,0,10,2
1668440201961,MATH 288,C00,098059,Williams; Ruth J,9,0,10,1
1668440202387,MATH 290B,A00,098060,Roberts; Justin Deritter,13,0,15,2
1668440202813,MATH 292,A00,098061,Belmont; Eva Kinoshita,10,0,10,0
1668440203247,MATH 295,A00,098062,Suk; Andrew Hoon,48,0,50,2
1668440203670,MATH 296,A00,098063,Novak; Jonathan I,20,0,20,0
1668440204095,MATH 297,001,098064,Gamst; Anthony Collins,9997,0,9999,2
1668440717693,COGS 205,A00,101395,Chiba; Andrea,19,0,20,1
1668440718122,COGS 210B,001,101404,Greene; Deanna Jacquelyn,9998,0,9999,1
1668440718122,COGS 210B,002,101417,Xia; Haijun,9999,0,9999,0
1668440718122,COGS 210B,003,101422,Nitz; Douglas A.,9999,0,9999,0
1668440718122,COGS 210B,004,101423,Hollan; James D.,9998,0,9999,1
1668440718122,COGS 210B,005,101424,Deak; Gedeon O.,9998,0,9999,1
1668440718122,COGS 210B,006,101425,Rossano; Federico,9999,0,9999,0
1668440718556,COGS 211B,A00,101427,Coulson; Seana M,9996,0,9999,3
1668440718980,COGS 220,A00,101428,Hollan; James D.,1,3,25,24
1668440719408,COGS 229,A00,101429,Dow; Steven P,18,0,25,7
1668440719831,COGS 230,A00,101430,Klemmer; Scott R,11,0,17,6
1668440720270,COGS 234,A00,101431,Xia; Haijun,2,0,25,23
1668440720693,COGS 260,A00,101432,Kiyonaga; Anastasia,21,0,25,4
1668440720693,COGS 260,B00,101433,Kirsh; David Joel,15,0,25,10
1668440721120,CSE 202,A00,102371,Impagliazzo; Russell,0,35,0,0
1668440721544,CSE 203B,A01,102373,Cheng; Chung Kuan,0,27,0,0
1668440721972,CSE 208,A00,102374,Micciancio; Daniele,0,1,0,0
1668440722404,CSE 209A,A00,112895,Impagliazzo; Russell,0,6,15,15
1668440722847,CSE 209B,A00,108005,Bellare; Mihir,0,3,0,0
1668440723269,CSE 210,A00,113163,Coblenz; Michael J,0,44,0,0
1668440723693,CSE 219,A00,106111,Dow; Steven P,0,0,20,20
1668440724118,CSE 221,A00,102376,Voelker; Geoffrey M.,0,32,0,0
1668440724541,CSE 224,A01,102378,Porter; George M,0,107,0,0
1668440724974,CSE 229A,A00,102379,Savage; Stefan,0,4,0,0
1668440725424,CSE 229C,A00,102380,Munyaka; Imani N. S.,0,4,0,0
1668440725863,CSE 232B,A00,102382,Deutsch; Alin Bernard,0,15,0,0
1668440726289,CSE 234,A01,112904,Kumar; Arun Kumar,0,0,0,0
1668440726713,CSE 237A,A00,102383,Rosing; Tajana Simunic,0,27,0,0
1668440727136,CSE 239A,A00,102384,Deutsch; Alin Bernard,0,6,0,0
1668440727560,CSE 239B,A00,102385,Polikarpova; Nadezhda,0,3,0,0
1668440727986,CSE 240A,A00,102386,Pannuto; Patrick William,0,28,0,0
1668440728412,CSE 240B,A00,102387,Zhao; Jishen,0,23,0,0
1668440728838,CSE 241A,A00,106406,Kang; Mingu,0,2,0,0
1668440729276,CSE 249B,A00,102388,Kahng; Andrew Byun,0,1,8,8
1668440729699,CSE 251B,A01,102392,Cottrell; Garrison W,0,26,0,0
1668440729699,CSE 251B,A02,102393,Cottrell; Garrison W,0,21,0,0
1668440730127,CSE 252B,A00,102394,Ochoa; Benjamin Lawrence,0,38,0,0
1668440730553,CSE 257,A01,102396,Gao; Sicun,0,88,0,0
1668440730977,CSE 272,A00,102397,Li; Tzumao,0,7,0,0
1668440731400,CSE 274,A00,111323,Chern; Albert Ren-Haur,0,7,0,0
1668440731831,CSE 282,A00,102398,Pevzner; Pavel Arkadjevich,0,0,0,0
1668440732266,CSE 284,A00,114175,Gymrek; Melissa Ann,0,11,0,0
1668440732693,CSE 290,A00,102399,Chandraker; Manmohan Krishna,0,4,0,0
1668440732693,CSE 290,B00,102400,Vaccaro; Kristen Marie,0,1,25,25
1668440732693,CSE 290,C00,102414,Pannuto; Patrick William,0,1,25,25
1668440732693,CSE 290,D00,102427,Pevzner; Pavel Arkadjevich,0,0,0,0
1668440732693,CSE 290,E00,102429,Zhao; Jishen,0,2,0,0
1668440732693,CSE 290,F00,102436,Tullsen; Dean Michael,0,4,0,0
1668440732693,CSE 290,G00,102440,Christensen; Henrik I,0,3,20,20
1668440733130,CSE 291,A00,102443,Su; Hao,0,0,0,0
1668440733130,CSE 291,B00,102448,Polikarpova; Nadezhda,0,0,0,0
1668440733130,CSE 291,C00,102453,Vaccaro; Kristen Marie,0,0,0,0
1668440733130,CSE 291,D00,111343,Savage; Stefan,0,0,0,0
1668440733130,CSE 291,E00,116474,Claffy; Kimberly Claire,0,0,0,0
1668440733130,CSE 291,F00,116479,Pasquale; Joseph,0,0,0,0
1668440733558,CSE 293,001,119111,Bafna; Vineet,9999,0,9999,0
1668440733558,CSE 293,002,119118,Bellare; Mihir,9999,0,9999,0
1668440733558,CSE 293,003,119122,Berg-Kirkpatrick; Taylor D,9999,0,9999,0
1668440733558,CSE 293,004,119135,Christensen; Henrik I,9999,0,9999,0
1668440733558,CSE 293,005,119142,Cottrell; Garrison W,9999,0,9999,0
1668440733558,CSE 293,006,119146,Deutsch; Alin Bernard,9999,0,9999,0
1668440733558,CSE 293,007,119159,Esmaeilzadeh; Hadi,9999,0,9999,0
1668440733558,CSE 293,008,119166,Freund; Yoav,9999,0,9999,0
1668440733558,CSE 293,009,119170,Griswold; William G.,9999,0,9999,0
1668440733558,CSE 293,010,119183,Gymrek; Melissa Ann,9999,0,9999,0
1668440733558,CSE 293,011,119190,Heninger; Nadia A,9999,0,9999,0
1668440733558,CSE 293,012,119230,Impagliazzo; Russell,9999,0,9999,0
1668440733558,CSE 293,013,119232,Jhala; Ranjit,9999,0,9999,0
1668440733558,CSE 293,014,119233,Kahng; Andrew Byun,9999,0,9999,0
1668440733558,CSE 293,015,119298,Kane; Daniel Mertz,9999,0,9999,0
1668440733558,CSE 293,016,119299,Kriegman; David J,9999,0,9999,0
1668440733558,CSE 293,017,119300,Kumar; Arun Kumar,9999,0,9999,0
1668440733558,CSE 293,018,119301,Lerner; Sorin,9999,0,9999,0
1668440733558,CSE 293,019,119302,Lovett; Shachar,9999,0,9999,0
1668440733558,CSE 293,020,119303,McAuley; Julian John,9999,0,9999,0
1668440733558,CSE 293,021,119304,Micciancio; Daniele,9999,0,9999,0
1668440733558,CSE 293,022,119367,Orailoglu; Alex,9999,0,9999,0
1668440733558,CSE 293,023,119382,Paturi; Ramamohan,9999,0,9999,0
1668440733558,CSE 293,024,119404,Polikarpova; Nadezhda,9999,0,9999,0
1668440733558,CSE 293,025,119406,Politz; Joseph Gibbs,9999,0,9999,0
1668440733558,CSE 293,026,119411,Porter; George M,9999,0,9999,0
1668440733558,CSE 293,027,119414,Porter; Leonard Emerson,9999,0,9999,0
1668440733558,CSE 293,028,119416,Ramamoorthi; Ravi,9999,0,9999,0
1668440733558,CSE 293,029,119417,Sahoo; Debashis,9999,0,9999,0
1668440733558,CSE 293,030,119420,Saul; Lawrence,9999,0,9999,0
1668440733558,CSE 293,031,119421,Savage; Stefan,9999,0,9999,0
1668440733558,CSE 293,032,119425,Schulze; Jurgen P.,9999,0,9999,0
1668440733558,CSE 293,033,119426,Snoeren; Alex C.,9999,0,9999,0
1668440733558,CSE 293,034,119428,Shang; Jingbo,9999,0,9999,0
1668440733558,CSE 293,035,119430,Stefan; Deian,9999,0,9999,0
1668440733558,CSE 293,036,119431,Su; Hao,9999,0,9999,0
1668440733558,CSE 293,037,119433,Swanson; Steven James,9999,0,9999,0
1668440733558,CSE 293,038,119435,Tullsen; Dean Michael,9999,0,9999,0
1668440733558,CSE 293,039,119483,Voelker; Geoffrey M.,9999,0,9999,0
1668440733558,CSE 293,040,119537,Zhao; Jishen,9999,0,9999,0
1668440733558,CSE 293,041,119538,Zhou; Yuan-Yuan,9999,0,9999,0
1668440733558,CSE 293,042,119539,Gao; Sicun,9999,0,9999,0
1668440733558,CSE 293,043,119540,Weibel; Nadir,9999,0,9999,0
1668440733558,CSE 293,044,119541,Gupta; Rajesh K.,9999,0,9999,0
1668440733558,CSE 293,045,126410,Vaccaro; Kristen Marie,9999,0,9999,0
1668440733558,CSE 293,046,126411,Klemke; Richard,9999,0,9999,0
1668440733980,CSE 294,A00,102459,Voelker; Geoffrey M.,0,1,0,0
1668440733980,CSE 294,B00,111322,Orailoglu; Alex,0,0,0,0
1668440734416,DSE 201,A00,096914,Deutsch; Alin Bernard,30,0,30,0
1668440734840,DSE 210,A00,096915,Dasgupta; Sanjoy,30,0,30,0
1668440735279,DSE 260A,A00,096916,Altintas De Callaf; Ilkay,30,0,30,0
1668440735711,ECE 200,001,103586,Antipa; Nicholas A,9999,0,9999,0
1668440735711,ECE 200,002,103587,Atanasov; Nikolay A.,9999,0,9999,0
1668440735711,ECE 200,003,103588,Bharadia; Dinesh,9999,0,9999,0
1668440735711,ECE 200,004,103589,Cheng; Chung Kuan,9999,0,9999,0
1668440735711,ECE 200,005,103590,Cosman; Pamela C.,9999,0,9999,0
1668440735711,ECE 200,006,103591,Dayeh; Shadi Ahmad,9999,0,9999,0
1668440735711,ECE 200,007,103592,Fainman; Yeshaiahu,9999,0,9999,0
1668440735711,ECE 200,008,103593,Ford; Joseph Earl,9999,0,9999,0
1668440735711,ECE 200,009,103594,Franceschetti; Massimo,9999,0,9999,0
1668440735711,ECE 200,010,103595,Fullerton; Eric E,9999,0,9999,0
1668440735711,ECE 200,011,103596,Galton; Ian A,9999,0,9999,0
1668440735711,ECE 200,012,103597,Gilja; Vikash,9999,0,9999,0
1668440735711,ECE 200,013,103598,Hall; Drew A.,9999,0,9999,0
1668440735711,ECE 200,014,103599,Hsueh; Tzu-Chien,9999,0,9999,0
1668440735711,ECE 200,015,103600,Javidi; Tara,9999,0,9999,0
1668440735711,ECE 200,016,103601,Kahng; Andrew Byun,9999,0,9999,0
1668440735711,ECE 200,017,103602,Kim; Young-Han,9999,0,9999,0
1668440735711,ECE 200,018,103603,Koushanfar; Farinaz,9999,0,9999,0
1668440735711,ECE 200,019,103604,Kuzum; Duygu,9999,0,9999,0
1668440735711,ECE 200,020,103605,Le; Hanh-Phuc,9999,0,9999,0
1668440735711,ECE 200,021,103606,Lin; Bill,9999,0,9999,0
1668440735711,ECE 200,022,103607,Liu; Zhaowei,9998,0,9999,1
1668440735711,ECE 200,023,103608,Lo; Yu-Hwa,9999,0,9999,0
1668440735711,ECE 200,024,103609,Lomakin; Vitaliy,9999,0,9999,0
1668440735711,ECE 200,025,103610,Mercier; Patrick Philip,9999,0,9999,0
1668440735711,ECE 200,026,103611,Meyer; Florian,9999,0,9999,0
1668440735711,ECE 200,027,103612,Milstein; Laurence B.,9999,0,9999,0
1668440735711,ECE 200,028,103613,Mir Arabbaygi; Siavash,9999,0,9999,0
1668440735711,ECE 200,029,103614,Mookherjea; Shayan,9999,0,9999,0
1668440735711,ECE 200,030,103615,Morris; Karcher William,9999,0,9999,0
1668440735711,ECE 200,031,103616,Ng; Tse Nga,9999,0,9999,0
1668440735711,ECE 200,032,103617,Nguyen; Truong Quang,9999,0,9999,0
1668440735711,ECE 200,033,103618,Nomura; Kenji,9999,0,9999,0
1668440735711,ECE 200,034,103619,Orlitsky; Alon,9999,0,9999,0
1668440735711,ECE 200,035,103620,Pal; Piya,9999,0,9999,0
1668440735711,ECE 200,036,103621,Papen; George C.,9999,0,9999,0
1668440735711,ECE 200,037,103622,Radic; Stojan,9999,0,9999,0
1668440735711,ECE 200,038,103623,Rao; Bhaskar D.,9999,0,9999,0
1668440735711,ECE 200,039,103624,Rao; Ramesh R,9999,0,9999,0
1668440735711,ECE 200,040,103625,Rebeiz; Gabriel,9999,0,9999,0
1668440735711,ECE 200,041,103626,Sanford; John R,9999,0,9999,0
1668440735711,ECE 200,042,103627,Siegel; Paul H.,9999,0,9999,0
1668440735711,ECE 200,043,103628,Sievenpiper; Daniel F.,9999,0,9999,0
1668440735711,ECE 200,044,103629,Sworder; David D.,9999,0,9999,0
1668440735711,ECE 200,045,103630,Taur; Yuan,9999,0,9999,0
1668440735711,ECE 200,046,103631,Touri; Behrouz,9999,0,9999,0
1668440735711,ECE 200,047,103632,Trivedi; Mohan M.,9999,0,9999,0
1668440735711,ECE 200,048,103633,Vasconcelos; Nuno,9999,0,9999,0
1668440735711,ECE 200,049,103634,Wang; Xiaolong,9999,0,9999,0
1668440735711,ECE 200,050,103635,Xie; Pengtao,9999,0,9999,0
1668440735711,ECE 200,051,103636,Yip; Michael,9999,0,9999,0
1668440735711,ECE 200,052,103637,Zeger; Kenneth A.,999,0,999,0
1668440735711,ECE 200,053,103638,Zhang; Xinyu,9999,0,9999,0
1668440735711,ECE 200,054,103639,Turakhia; Yatish Girish,9999,0,9999,0
1668440735711,ECE 200,055,103640,Kang; Mingu,9999,0,9999,0
1668440735711,ECE 200,056,103641,Shi; Yuanyuan,9999,0,9999,0
1668440735711,ECE 200,057,103642,Wang; Edward Jay,9999,0,9999,0
1668440735711,ECE 200,058,103643,Zheng; Yang,9999,0,9999,0
1668440736146,ECE 202,A00,103644,Kuzum; Duygu,0,24,0,0
1668440736578,ECE 212BN,A00,103646,Ng; Tse Nga,0,1,0,0
1668440737013,ECE 221,A00,111493,Staff,0,0,0,0
1668440737440,ECE 222B,A00,103647,Lomakin; Vitaliy,0,5,0,0
1668440737867,ECE 230B,A00,103648,Taur; Yuan,0,0,0,0
1668440738299,ECE 238B,A00,103649,Garay; Javier,0,0,0,0
1668440738746,ECE 240B,A00,112900,Fainman; Yeshaiahu,0,4,0,0
1668440739172,ECE 247A,A00,103650,Jokerst; Jesse Vincent,0,1,0,0
1668440739598,ECE 247B,A00,103651,Wang; Joseph,0,6,0,0
1668440740023,ECE 250,A00,103652,Siegel; Paul H.,0,45,0,0
1668440740450,ECE 251A,A00,103654,Rao; Bhaskar D.,0,31,0,0
1668440740874,ECE 257B,A00,103655,Bharadia; Dinesh,0,13,0,0
1668440741304,ECE 258A,A00,103656,Milstein; Laurence B.,0,10,0,0
1668440741838,ECE 260B,A00,103658,Kang; Mingu,0,68,0,0
1668440742261,ECE 264A,A00,103659,Galton; Ian A,0,36,0,0
1668440742692,ECE 265A,A00,103661,Gudem; Prasad S.S.,0,19,0,0
1668440743141,ECE 265D,A00,103662,Gudem; Prasad S.S.,0,12,0,0
1668440743564,ECE 268,A00,103663,Koushanfar; Farinaz,0,22,0,0
1668440743995,ECE 269,A01,103665,Pal; Piya,0,137,0,0
1668440744421,ECE 271B,A00,103666,Vasconcelos; Manuela,0,48,0,0
1668440744847,ECE 276A,A00,103667,Atanasov; Nikolay A.,0,74,0,0
1668440745281,ECE 277,A00,103668,An; Cheolhong,0,94,0,0
1668440745705,ECE 279,A00,117947,Hall; Drew A.,0,13,0,0
1668440746559,ECE 283,A00,103670,Hsueh; Tzu-Chien,0,25,0,0
1668440746984,ECE 284,A00,103671,Turakhia; Yatish Girish,0,26,0,0
1668440747420,ECE 285,A00,103672,Zheng; Yang,0,25,0,0
1668440747420,ECE 285,B00,103673,Sworder; David D.,0,40,0,0
1668440747845,ECE 287,A00,103676,Javidi; Tara,0,4,0,0
1668440748275,MATH 200B,A00,098023,Salehi Golsefidy; Alireza,12,0,15,3
1668440748699,MATH 202B,A00,098024,Rhoades; Brendon Patrick,9,0,15,6
1668440749122,MATH 203B,A00,098025,Oprea; Dragos N.,10,0,15,5
1668440749549,MATH 204B,A00,098026,Sorensen; Claus M,13,0,15,2
1668440749974,MATH 208,A00,098027,Izadi; Elham,7,0,10,3
1668440750429,MATH 209,A00,098028,Pollack; Aaron,10,0,10,0
1668440750854,MATH 211A,A00,112919,Rogalski; Daniel,9,0,10,1
1668440751286,MATH 211B,A00,112920,Seward; Brandon M.,9,0,10,1
1668440751723,MATH 218,A00,098029,Li; Bo,10,0,10,0
1668440752159,MATH 220B,A00,098030,Novak; Jonathan I,11,0,15,4
1668440752593,MATH 221A,A00,098031,Ebenfelt; Peter F,13,0,15,2
1668440753025,MATH 231B,A00,098032,Zlatos; Andrej,12,0,15,3
1668440753461,MATH 240B,A00,098033,Ni; Lei,9,0,15,6
1668440753893,MATH 243,A00,098034,Jekel; David Andrew,10,0,10,0
1668440754325,MATH 245A,A00,098035,Nie; Jiawang,0,1,15,16
1668440754755,MATH 248,A00,098036,Bejenaru; Ioan,10,0,10,0
1668440755179,MATH 250B,A00,098037,Spolaor; Luca,14,0,15,1
1668440755604,MATH 258,A00,098038,Ni; Lei,10,0,10,0
1668440756047,MATH 264B,A00,098041,Rhoades; Brendon Patrick,9,0,15,6
1668440756480,MATH 268,A00,098042,Buss; Samuel R,10,0,10,0
1668440756918,MATH 269,A00,098043,Rhoades; Brendon Patrick,10,0,10,0
1668440757365,MATH 270B,A00,098044,Li; Bo,10,0,15,5
1668440757799,MATH 272B,A00,098045,Holst; Michael J,13,0,15,2
1668440758229,MATH 273A,A00,098046,Tian; Xiaochuan,10,0,15,5
1668440758669,MATH 275,A01,098048,Tian; Xiaochuan,6,0,10,4
1668440759094,MATH 278A,A00,098049,Holst; Michael J,8,0,10,2
1668440759525,MATH 278B,A00,098050,Cloninger; Alexander,10,0,10,0
1668440759948,MATH 278C,A00,098051,Nie; Jiawang,6,0,10,4
1668440760382,MATH 280B,A00,098052,Zheng; Tianyi,8,0,15,7
1668440760808,MATH 281B,A00,098053,Bradic; Jelena,0,1,15,15
1668440761243,MATH 282B,A00,098054,Arias-Castro; Ery,0,0,15,15
1668440761733,MATH 285,A00,098055,Fitzsimmons; Patrick J,0,1,15,17
1668440762174,MATH 287B,A00,098056,Arias-Castro; Ery,2,0,15,13
1668440762599,MATH 288,A00,098057,Agarwal; Pooja,9,0,10,1
1668440762599,MATH 288,B00,098058,Zhang; Danna,8,0,10,2
1668440762599,MATH 288,C00,098059,Williams; Ruth J,9,0,10,1
1668440763037,MATH 290B,A00,098060,Roberts; Justin Deritter,13,0,15,2
1668440763468,MATH 292,A00,098061,Belmont; Eva Kinoshita,10,0,10,0
1668440763905,MATH 295,A00,098062,Suk; Andrew Hoon,48,0,50,2
1668440764332,MATH 296,A00,098063,Novak; Jonathan I,20,0,20,0
1668440764764,MATH 297,001,098064,Gamst; Anthony Collins,9997,0,9999,2
1668441268514,COGS 205,A00,101395,Chiba; Andrea,19,0,20,1
1668441268945,COGS 210B,001,101404,Greene; Deanna Jacquelyn,9998,0,9999,1
1668441268945,COGS 210B,002,101417,Xia; Haijun,9999,0,9999,0
1668441268945,COGS 210B,003,101422,Nitz; Douglas A.,9999,0,9999,0
1668441268945,COGS 210B,004,101423,Hollan; James D.,9998,0,9999,1
1668441268945,COGS 210B,005,101424,Deak; Gedeon O.,9998,0,9999,1
1668441268945,COGS 210B,006,101425,Rossano; Federico,9999,0,9999,0
1668441269369,COGS 211B,A00,101427,Coulson; Seana M,9996,0,9999,3
1668441269793,COGS 220,A00,101428,Hollan; James D.,1,3,25,24
1668441270217,COGS 229,A00,101429,Dow; Steven P,18,0,25,7
1668441270659,COGS 230,A00,101430,Klemmer; Scott R,11,0,17,6
1668441271092,COGS 234,A00,101431,Xia; Haijun,2,0,25,23
1668441271515,COGS 260,A00,101432,Kiyonaga; Anastasia,21,0,25,4
1668441271515,COGS 260,B00,101433,Kirsh; David Joel,15,0,25,10
1668441271938,CSE 202,A00,102371,Impagliazzo; Russell,0,35,0,0
1668441272365,CSE 203B,A01,102373,Cheng; Chung Kuan,0,27,0,0
1668441272791,CSE 208,A00,102374,Micciancio; Daniele,0,1,0,0
1668441273221,CSE 209A,A00,112895,Impagliazzo; Russell,0,6,15,15
1668441273661,CSE 209B,A00,108005,Bellare; Mihir,0,3,0,0
1668441274112,CSE 210,A00,113163,Coblenz; Michael J,0,44,0,0
1668441274543,CSE 219,A00,106111,Dow; Steven P,0,0,20,20
1668441274966,CSE 221,A00,102376,Voelker; Geoffrey M.,0,32,0,0
1668441275394,CSE 224,A01,102378,Porter; George M,0,107,0,0
1668441275817,CSE 229A,A00,102379,Savage; Stefan,0,4,0,0
1668441276245,CSE 229C,A00,102380,Munyaka; Imani N. S.,0,4,0,0
1668441276678,CSE 232B,A00,102382,Deutsch; Alin Bernard,0,15,0,0
1668441277106,CSE 234,A01,112904,Kumar; Arun Kumar,0,0,0,0
1668441277528,CSE 237A,A00,102383,Rosing; Tajana Simunic,0,27,0,0
1668441277953,CSE 239A,A00,102384,Deutsch; Alin Bernard,0,6,0,0
1668441278377,CSE 239B,A00,102385,Polikarpova; Nadezhda,0,3,0,0
1668441278805,CSE 240A,A00,102386,Pannuto; Patrick William,0,28,0,0
1668441279244,CSE 240B,A00,102387,Zhao; Jishen,0,23,0,0
1668441279668,CSE 241A,A00,106406,Kang; Mingu,0,2,0,0
1668441280103,CSE 249B,A00,102388,Kahng; Andrew Byun,0,1,8,8
1668441280529,CSE 251B,A01,102392,Cottrell; Garrison W,0,26,0,0
1668441280529,CSE 251B,A02,102393,Cottrell; Garrison W,0,21,0,0
1668441280959,CSE 252B,A00,102394,Ochoa; Benjamin Lawrence,0,38,0,0
1668441281397,CSE 257,A01,102396,Gao; Sicun,0,88,0,0
1668441281819,CSE 272,A00,102397,Li; Tzumao,0,7,0,0
1668441282243,CSE 274,A00,111323,Chern; Albert Ren-Haur,0,7,0,0
1668441282685,CSE 282,A00,102398,Pevzner; Pavel Arkadjevich,0,0,0,0
1668441283109,CSE 284,A00,114175,Gymrek; Melissa Ann,0,11,0,0
1668441283537,CSE 290,A00,102399,Chandraker; Manmohan Krishna,0,4,0,0
1668441283537,CSE 290,B00,102400,Vaccaro; Kristen Marie,0,1,25,25
1668441283537,CSE 290,C00,102414,Pannuto; Patrick William,0,1,25,25
1668441283537,CSE 290,D00,102427,Pevzner; Pavel Arkadjevich,0,0,0,0
1668441283537,CSE 290,E00,102429,Zhao; Jishen,0,2,0,0
1668441283537,CSE 290,F00,102436,Tullsen; Dean Michael,0,4,0,0
1668441283537,CSE 290,G00,102440,Christensen; Henrik I,0,3,20,20
1668441283968,CSE 291,A00,102443,Su; Hao,0,0,0,0
1668441283968,CSE 291,B00,102448,Polikarpova; Nadezhda,0,0,0,0
1668441283968,CSE 291,C00,102453,Vaccaro; Kristen Marie,0,0,0,0
1668441283968,CSE 291,D00,111343,Savage; Stefan,0,0,0,0
1668441283968,CSE 291,E00,116474,Claffy; Kimberly Claire,0,0,0,0
1668441283968,CSE 291,F00,116479,Pasquale; Joseph,0,0,0,0
1668441284417,CSE 293,001,119111,Bafna; Vineet,9999,0,9999,0
1668441284417,CSE 293,002,119118,Bellare; Mihir,9999,0,9999,0
1668441284417,CSE 293,003,119122,Berg-Kirkpatrick; Taylor D,9999,0,9999,0
1668441284417,CSE 293,004,119135,Christensen; Henrik I,9999,0,9999,0
1668441284417,CSE 293,005,119142,Cottrell; Garrison W,9999,0,9999,0
1668441284417,CSE 293,006,119146,Deutsch; Alin Bernard,9999,0,9999,0
1668441284417,CSE 293,007,119159,Esmaeilzadeh; Hadi,9999,0,9999,0
1668441284417,CSE 293,008,119166,Freund; Yoav,9999,0,9999,0
1668441284417,CSE 293,009,119170,Griswold; William G.,9999,0,9999,0
1668441284417,CSE 293,010,119183,Gymrek; Melissa Ann,9999,0,9999,0
1668441284417,CSE 293,011,119190,Heninger; Nadia A,9999,0,9999,0
1668441284417,CSE 293,012,119230,Impagliazzo; Russell,9999,0,9999,0
1668441284417,CSE 293,013,119232,Jhala; Ranjit,9999,0,9999,0
1668441284417,CSE 293,014,119233,Kahng; Andrew Byun,9999,0,9999,0
1668441284417,CSE 293,015,119298,Kane; Daniel Mertz,9999,0,9999,0
1668441284417,CSE 293,016,119299,Kriegman; David J,9999,0,9999,0
1668441284417,CSE 293,017,119300,Kumar; Arun Kumar,9999,0,9999,0
1668441284417,CSE 293,018,119301,Lerner; Sorin,9999,0,9999,0
1668441284417,CSE 293,019,119302,Lovett; Shachar,9999,0,9999,0
1668441284417,CSE 293,020,119303,McAuley; Julian John,9999,0,9999,0
1668441284417,CSE 293,021,119304,Micciancio; Daniele,9999,0,9999,0
1668441284417,CSE 293,022,119367,Orailoglu; Alex,9999,0,9999,0
1668441284417,CSE 293,023,119382,Paturi; Ramamohan,9999,0,9999,0
1668441284417,CSE 293,024,119404,Polikarpova; Nadezhda,9999,0,9999,0
1668441284417,CSE 293,025,119406,Politz; Joseph Gibbs,9999,0,9999,0
1668441284417,CSE 293,026,119411,Porter; George M,9999,0,9999,0
1668441284417,CSE 293,027,119414,Porter; Leonard Emerson,9999,0,9999,0
1668441284417,CSE 293,028,119416,Ramamoorthi; Ravi,9999,0,9999,0
1668441284417,CSE 293,029,119417,Sahoo; Debashis,9999,0,9999,0
1668441284417,CSE 293,030,119420,Saul; Lawrence,9999,0,9999,0
1668441284417,CSE 293,031,119421,Savage; Stefan,9999,0,9999,0
1668441284417,CSE 293,032,119425,Schulze; Jurgen P.,9999,0,9999,0
1668441284417,CSE 293,033,119426,Snoeren; Alex C.,9999,0,9999,0
1668441284417,CSE 293,034,119428,Shang; Jingbo,9999,0,9999,0
1668441284417,CSE 293,035,119430,Stefan; Deian,9999,0,9999,0
1668441284417,CSE 293,036,119431,Su; Hao,9999,0,9999,0
1668441284417,CSE 293,037,119433,Swanson; Steven James,9999,0,9999,0
1668441284417,CSE 293,038,119435,Tullsen; Dean Michael,9999,0,9999,0
1668441284417,CSE 293,039,119483,Voelker; Geoffrey M.,9999,0,9999,0
1668441284417,CSE 293,040,119537,Zhao; Jishen,9999,0,9999,0
1668441284417,CSE 293,041,119538,Zhou; Yuan-Yuan,9999,0,9999,0
1668441284417,CSE 293,042,119539,Gao; Sicun,9999,0,9999,0
1668441284417,CSE 293,043,119540,Weibel; Nadir,9999,0,9999,0
1668441284417,CSE 293,044,119541,Gupta; Rajesh K.,9999,0,9999,0
1668441284417,CSE 293,045,126410,Vaccaro; Kristen Marie,9999,0,9999,0
1668441284417,CSE 293,046,126411,Klemke; Richard,9999,0,9999,0
1668441284841,CSE 294,A00,102459,Voelker; Geoffrey M.,0,1,0,0
1668441284841,CSE 294,B00,111322,Orailoglu; Alex,0,0,0,0
1668441285279,DSE 201,A00,096914,Deutsch; Alin Bernard,30,0,30,0
1668441285702,DSE 210,A00,096915,Dasgupta; Sanjoy,30,0,30,0
1668441286136,DSE 260A,A00,096916,Altintas De Callaf; Ilkay,30,0,30,0
1668441286607,ECE 200,001,103586,Antipa; Nicholas A,9999,0,9999,0
1668441286607,ECE 200,002,103587,Atanasov; Nikolay A.,9999,0,9999,0
1668441286607,ECE 200,003,103588,Bharadia; Dinesh,9999,0,9999,0
1668441286607,ECE 200,004,103589,Cheng; Chung Kuan,9999,0,9999,0
1668441286607,ECE 200,005,103590,Cosman; Pamela C.,9999,0,9999,0
1668441286607,ECE 200,006,103591,Dayeh; Shadi Ahmad,9999,0,9999,0
1668441286607,ECE 200,007,103592,Fainman; Yeshaiahu,9999,0,9999,0
1668441286607,ECE 200,008,103593,Ford; Joseph Earl,9999,0,9999,0
1668441286607,ECE 200,009,103594,Franceschetti; Massimo,9999,0,9999,0
1668441286607,ECE 200,010,103595,Fullerton; Eric E,9999,0,9999,0
1668441286607,ECE 200,011,103596,Galton; Ian A,9999,0,9999,0
1668441286607,ECE 200,012,103597,Gilja; Vikash,9999,0,9999,0
1668441286607,ECE 200,013,103598,Hall; Drew A.,9999,0,9999,0
1668441286607,ECE 200,014,103599,Hsueh; Tzu-Chien,9999,0,9999,0
1668441286607,ECE 200,015,103600,Javidi; Tara,9999,0,9999,0
1668441286607,ECE 200,016,103601,Kahng; Andrew Byun,9999,0,9999,0
1668441286607,ECE 200,017,103602,Kim; Young-Han,9999,0,9999,0
1668441286607,ECE 200,018,103603,Koushanfar; Farinaz,9999,0,9999,0
1668441286607,ECE 200,019,103604,Kuzum; Duygu,9999,0,9999,0
1668441286607,ECE 200,020,103605,Le; Hanh-Phuc,9999,0,9999,0
1668441286607,ECE 200,021,103606,Lin; Bill,9999,0,9999,0
1668441286607,ECE 200,022,103607,Liu; Zhaowei,9998,0,9999,1
1668441286607,ECE 200,023,103608,Lo; Yu-Hwa,9999,0,9999,0
1668441286607,ECE 200,024,103609,Lomakin; Vitaliy,9999,0,9999,0
1668441286607,ECE 200,025,103610,Mercier; Patrick Philip,9999,0,9999,0
1668441286607,ECE 200,026,103611,Meyer; Florian,9999,0,9999,0
1668441286607,ECE 200,027,103612,Milstein; Laurence B.,9999,0,9999,0
1668441286607,ECE 200,028,103613,Mir Arabbaygi; Siavash,9999,0,9999,0
1668441286607,ECE 200,029,103614,Mookherjea; Shayan,9999,0,9999,0
1668441286607,ECE 200,030,103615,Morris; Karcher William,9999,0,9999,0
1668441286607,ECE 200,031,103616,Ng; Tse Nga,9999,0,9999,0
1668441286607,ECE 200,032,103617,Nguyen; Truong Quang,9999,0,9999,0
1668441286607,ECE 200,033,103618,Nomura; Kenji,9999,0,9999,0
1668441286607,ECE 200,034,103619,Orlitsky; Alon,9999,0,9999,0
1668441286607,ECE 200,035,103620,Pal; Piya,9999,0,9999,0
1668441286607,ECE 200,036,103621,Papen; George C.,9999,0,9999,0
1668441286607,ECE 200,037,103622,Radic; Stojan,9999,0,9999,0
1668441286607,ECE 200,038,103623,Rao; Bhaskar D.,9999,0,9999,0
1668441286607,ECE 200,039,103624,Rao; Ramesh R,9999,0,9999,0
1668441286607,ECE 200,040,103625,Rebeiz; Gabriel,9999,0,9999,0
1668441286607,ECE 200,041,103626,Sanford; John R,9999,0,9999,0
1668441286607,ECE 200,042,103627,Siegel; Paul H.,9999,0,9999,0
1668441286607,ECE 200,043,103628,Sievenpiper; Daniel F.,9999,0,9999,0
1668441286607,ECE 200,044,103629,Sworder; David D.,9999,0,9999,0
1668441286607,ECE 200,045,103630,Taur; Yuan,9999,0,9999,0
1668441286607,ECE 200,046,103631,Touri; Behrouz,9999,0,9999,0
1668441286607,ECE 200,047,103632,Trivedi; Mohan M.,9999,0,9999,0
1668441286607,ECE 200,048,103633,Vasconcelos; Nuno,9999,0,9999,0
1668441286607,ECE 200,049,103634,Wang; Xiaolong,9999,0,9999,0
1668441286607,ECE 200,050,103635,Xie; Pengtao,9999,0,9999,0
1668441286607,ECE 200,051,103636,Yip; Michael,9999,0,9999,0
1668441286607,ECE 200,052,103637,Zeger; Kenneth A.,999,0,999,0
1668441286607,ECE 200,053,103638,Zhang; Xinyu,9999,0,9999,0
1668441286607,ECE 200,054,103639,Turakhia; Yatish Girish,9999,0,9999,0
1668441286607,ECE 200,055,103640,Kang; Mingu,9999,0,9999,0
1668441286607,ECE 200,056,103641,Shi; Yuanyuan,9999,0,9999,0
1668441286607,ECE 200,057,103642,Wang; Edward Jay,9999,0,9999,0
1668441286607,ECE 200,058,103643,Zheng; Yang,9999,0,9999,0
1668441287045,ECE 202,A00,103644,Kuzum; Duygu,0,24,0,0
1668441287478,ECE 212BN,A00,103646,Ng; Tse Nga,0,1,0,0
1668441287900,ECE 221,A00,111493,Staff,0,0,0,0
1668441288324,ECE 222B,A00,103647,Lomakin; Vitaliy,0,5,0,0
1668441288752,ECE 230B,A00,103648,Taur; Yuan,0,0,0,0
1668441289187,ECE 238B,A00,103649,Garay; Javier,0,0,0,0
1668441289612,ECE 240B,A00,112900,Fainman; Yeshaiahu,0,4,0,0
1668441290035,ECE 247A,A00,103650,Jokerst; Jesse Vincent,0,1,0,0
1668441290471,ECE 247B,A00,103651,Wang; Joseph,0,7,0,0
1668441290904,ECE 250,A00,103652,Siegel; Paul H.,0,45,0,0
1668441291331,ECE 251A,A00,103654,Rao; Bhaskar D.,0,31,0,0
1668441291755,ECE 257B,A00,103655,Bharadia; Dinesh,0,14,0,0
1668441292181,ECE 258A,A00,103656,Milstein; Laurence B.,0,11,0,0
1668441292622,ECE 260B,A00,103658,Kang; Mingu,0,68,0,0
1668441293049,ECE 264A,A00,103659,Galton; Ian A,0,37,0,0
1668441293481,ECE 265A,A00,103661,Gudem; Prasad S.S.,0,21,0,0
1668441293904,ECE 265D,A00,103662,Gudem; Prasad S.S.,0,13,0,0
1668441294328,ECE 268,A00,103663,Koushanfar; Farinaz,0,22,0,0
1668441294751,ECE 269,A01,103665,Pal; Piya,0,138,0,0
1668441295175,ECE 271B,A00,103666,Vasconcelos; Manuela,0,48,0,0
1668441295600,ECE 276A,A00,103667,Atanasov; Nikolay A.,0,74,0,0
1668441296029,ECE 277,A00,103668,An; Cheolhong,0,94,0,0
1668441296453,ECE 279,A00,117947,Hall; Drew A.,0,13,0,0
1668441297306,ECE 283,A00,103670,Hsueh; Tzu-Chien,0,27,0,0
1668441297730,ECE 284,A00,103671,Turakhia; Yatish Girish,0,26,0,0
1668441298166,ECE 285,A00,103672,Zheng; Yang,0,25,0,0
1668441298166,ECE 285,B00,103673,Sworder; David D.,0,40,0,0
1668441298591,ECE 287,A00,103676,Javidi; Tara,0,4,0,0
1668441299016,MATH 200B,A00,098023,Salehi Golsefidy; Alireza,12,0,15,3
1668441299455,MATH 202B,A00,098024,Rhoades; Brendon Patrick,9,0,15,6
1668441299877,MATH 203B,A00,098025,Oprea; Dragos N.,10,0,15,5
1668441300299,MATH 204B,A00,098026,Sorensen; Claus M,13,0,15,2
1668441300723,MATH 208,A00,098027,Izadi; Elham,7,0,10,3
1668441301154,MATH 209,A00,098028,Pollack; Aaron,10,0,10,0
1668441301585,MATH 211A,A00,112919,Rogalski; Daniel,9,0,10,1
1668441302011,MATH 211B,A00,112920,Seward; Brandon M.,9,0,10,1
1668441302439,MATH 218,A00,098029,Li; Bo,10,0,10,0
1668441302861,MATH 220B,A00,098030,Novak; Jonathan I,11,0,15,4
1668441303309,MATH 221A,A00,098031,Ebenfelt; Peter F,13,0,15,2
1668441303738,MATH 231B,A00,098032,Zlatos; Andrej,12,0,15,3
1668441304186,MATH 240B,A00,098033,Ni; Lei,9,0,15,6
1668441304609,MATH 243,A00,098034,Jekel; David Andrew,10,0,10,0
1668441305039,MATH 245A,A00,098035,Nie; Jiawang,0,1,15,16
1668441305474,MATH 248,A00,098036,Bejenaru; Ioan,10,0,10,0
1668441305906,MATH 250B,A00,098037,Spolaor; Luca,14,0,15,1
1668441306334,MATH 258,A00,098038,Ni; Lei,10,0,10,0
1668441306760,MATH 264B,A00,098041,Rhoades; Brendon Patrick,9,0,15,6
1668441307184,MATH 268,A00,098042,Buss; Samuel R,10,0,10,0
1668441307609,MATH 269,A00,098043,Rhoades; Brendon Patrick,10,0,10,0
1668441308035,MATH 270B,A00,098044,Li; Bo,10,0,15,5
1668441308477,MATH 272B,A00,098045,Holst; Michael J,13,0,15,2
1668441308906,MATH 273A,A00,098046,Tian; Xiaochuan,10,0,15,5
1668441309414,MATH 275,A01,098048,Tian; Xiaochuan,6,0,10,4
1668441309850,MATH 278A,A00,098049,Holst; Michael J,8,0,10,2
1668441310284,MATH 278B,A00,098050,Cloninger; Alexander,10,0,10,0
1668441310722,MATH 278C,A00,098051,Nie; Jiawang,6,0,10,4
1668441311148,MATH 280B,A00,098052,Zheng; Tianyi,8,0,15,7
1668441311587,MATH 281B,A00,098053,Bradic; Jelena,0,1,15,15
1668441312025,MATH 282B,A00,098054,Arias-Castro; Ery,0,0,15,15
1668441312448,MATH 285,A00,098055,Fitzsimmons; Patrick J,0,1,15,17
1668441312875,MATH 287B,A00,098056,Arias-Castro; Ery,2,0,15,13
1668441313311,MATH 288,A00,098057,Agarwal; Pooja,9,0,10,1
1668441313311,MATH 288,B00,098058,Zhang; Danna,8,0,10,2
1668441313311,MATH 288,C00,098059,Williams; Ruth J,9,0,10,1
1668441313736,MATH 290B,A00,098060,Roberts; Justin Deritter,13,0,15,2
1668441314167,MATH 292,A00,098061,Belmont; Eva Kinoshita,10,0,10,0
1668441314593,MATH 295,A00,098062,Suk; Andrew Hoon,48,0,50,2
1668441315016,MATH 296,A00,098063,Novak; Jonathan I,20,0,20,0
1668441315440,MATH 297,001,098064,Gamst; Anthony Collins,9997,0,9999,2
1668441819337,COGS 205,A00,101395,Chiba; Andrea,19,0,20,1
1668441819760,COGS 210B,001,101404,Greene; Deanna Jacquelyn,9998,0,9999,1
1668441819760,COGS 210B,002,101417,Xia; Haijun,9999,0,9999,0
1668441819760,COGS 210B,003,101422,Nitz; Douglas A.,9999,0,9999,0
1668441819760,COGS 210B,004,101423,Hollan; James D.,9998,0,9999,1
1668441819760,COGS 210B,005,101424,Deak; Gedeon O.,9998,0,9999,1
1668441819760,COGS 210B,006,101425,Rossano; Federico,9999,0,9999,0
1668441820195,COGS 211B,A00,101427,Coulson; Seana M,9996,0,9999,3
1668441820621,COGS 220,A00,101428,Hollan; James D.,1,3,25,24
1668441821050,COGS 229,A00,101429,Dow; Steven P,18,0,25,7
1668441821474,COGS 230,A00,101430,Klemmer; Scott R,11,0,17,6
1668441821904,COGS 234,A00,101431,Xia; Haijun,2,0,25,23
1668441822332,COGS 260,A00,101432,Kiyonaga; Anastasia,21,0,25,4
1668441822332,COGS 260,B00,101433,Kirsh; David Joel,15,0,25,10
1668441822760,CSE 202,A00,102371,Impagliazzo; Russell,0,36,0,0
1668441823190,CSE 203B,A01,102373,Cheng; Chung Kuan,0,28,0,0
1668441823625,CSE 208,A00,102374,Micciancio; Daniele,0,1,0,0
1668441824059,CSE 209A,A00,112895,Impagliazzo; Russell,0,6,15,15
1668441824483,CSE 209B,A00,108005,Bellare; Mihir,0,3,0,0
1668441824927,CSE 210,A00,113163,Coblenz; Michael J,0,44,0,0
1668441825363,CSE 219,A00,106111,Dow; Steven P,0,0,20,20
1668441825786,CSE 221,A00,102376,Voelker; Geoffrey M.,0,32,0,0
1668441826236,CSE 224,A01,102378,Porter; George M,0,108,0,0
1668441826663,CSE 229A,A00,102379,Savage; Stefan,0,4,0,0
1668441827090,CSE 229C,A00,102380,Munyaka; Imani N. S.,0,4,0,0
1668441827514,CSE 232B,A00,102382,Deutsch; Alin Bernard,0,15,0,0
1668441827961,CSE 234,A01,112904,Kumar; Arun Kumar,0,0,0,0
1668441828386,CSE 237A,A00,102383,Rosing; Tajana Simunic,0,27,0,0
1668441828839,CSE 239A,A00,102384,Deutsch; Alin Bernard,0,6,0,0
1668441829283,CSE 239B,A00,102385,Polikarpova; Nadezhda,0,3,0,0
1668441829715,CSE 240A,A00,102386,Pannuto; Patrick William,0,28,0,0
1668441830159,CSE 240B,A00,102387,Zhao; Jishen,0,23,0,0
1668441830586,CSE 241A,A00,106406,Kang; Mingu,0,2,0,0
1668441831009,CSE 249B,A00,102388,Kahng; Andrew Byun,0,1,8,8
1668441831446,CSE 251B,A01,102392,Cottrell; Garrison W,0,27,0,0
1668441831446,CSE 251B,A02,102393,Cottrell; Garrison W,0,21,0,0
1668441831873,CSE 252B,A00,102394,Ochoa; Benjamin Lawrence,0,38,0,0
1668441832310,CSE 257,A01,102396,Gao; Sicun,0,88,0,0
1668441832751,CSE 272,A00,102397,Li; Tzumao,0,7,0,0
1668441833178,CSE 274,A00,111323,Chern; Albert Ren-Haur,0,7,0,0
1668441833690,CSE 282,A00,102398,Pevzner; Pavel Arkadjevich,0,0,0,0
1668441834125,CSE 284,A00,114175,Gymrek; Melissa Ann,0,11,0,0
1668441834556,CSE 290,A00,102399,Chandraker; Manmohan Krishna,0,4,0,0
1668441834556,CSE 290,B00,102400,Vaccaro; Kristen Marie,0,1,25,25
1668441834556,CSE 290,C00,102414,Pannuto; Patrick William,0,1,25,25
1668441834556,CSE 290,D00,102427,Pevzner; Pavel Arkadjevich,0,0,0,0
1668441834556,CSE 290,E00,102429,Zhao; Jishen,0,2,0,0
1668441834556,CSE 290,F00,102436,Tullsen; Dean Michael,0,4,0,0
1668441834556,CSE 290,G00,102440,Christensen; Henrik I,0,3,20,20
1668441834989,CSE 291,A00,102443,Su; Hao,0,0,0,0
1668441834989,CSE 291,B00,102448,Polikarpova; Nadezhda,0,0,0,0
1668441834989,CSE 291,C00,102453,Vaccaro; Kristen Marie,0,0,0,0
1668441834989,CSE 291,D00,111343,Savage; Stefan,0,0,0,0
1668441834989,CSE 291,E00,116474,Claffy; Kimberly Claire,0,0,0,0
1668441834989,CSE 291,F00,116479,Pasquale; Joseph,0,0,0,0
1668441835420,CSE 293,001,119111,Bafna; Vineet,9999,0,9999,0
1668441835420,CSE 293,002,119118,Bellare; Mihir,9999,0,9999,0
1668441835420,CSE 293,003,119122,Berg-Kirkpatrick; Taylor D,9999,0,9999,0
1668441835420,CSE 293,004,119135,Christensen; Henrik I,9999,0,9999,0
1668441835420,CSE 293,005,119142,Cottrell; Garrison W,9999,0,9999,0
1668441835420,CSE 293,006,119146,Deutsch; Alin Bernard,9999,0,9999,0
1668441835420,CSE 293,007,119159,Esmaeilzadeh; Hadi,9999,0,9999,0
1668441835420,CSE 293,008,119166,Freund; Yoav,9999,0,9999,0
1668441835420,CSE 293,009,119170,Griswold; William G.,9999,0,9999,0
1668441835420,CSE 293,010,119183,Gymrek; Melissa Ann,9999,0,9999,0
1668441835420,CSE 293,011,119190,Heninger; Nadia A,9999,0,9999,0
1668441835420,CSE 293,012,119230,Impagliazzo; Russell,9999,0,9999,0
1668441835420,CSE 293,013,119232,Jhala; Ranjit,9999,0,9999,0
1668441835420,CSE 293,014,119233,Kahng; Andrew Byun,9999,0,9999,0
1668441835420,CSE 293,015,119298,Kane; Daniel Mertz,9999,0,9999,0
1668441835420,CSE 293,016,119299,Kriegman; David J,9999,0,9999,0
1668441835420,CSE 293,017,119300,Kumar; Arun Kumar,9999,0,9999,0
1668441835420,CSE 293,018,119301,Lerner; Sorin,9999,0,9999,0
1668441835420,CSE 293,019,119302,Lovett; Shachar,9999,0,9999,0
1668441835420,CSE 293,020,119303,McAuley; Julian John,9999,0,9999,0
1668441835420,CSE 293,021,119304,Micciancio; Daniele,9999,0,9999,0
1668441835420,CSE 293,022,119367,Orailoglu; Alex,9999,0,9999,0
1668441835420,CSE 293,023,119382,Paturi; Ramamohan,9999,0,9999,0
1668441835420,CSE 293,024,119404,Polikarpova; Nadezhda,9999,0,9999,0
1668441835420,CSE 293,025,119406,Politz; Joseph Gibbs,9999,0,9999,0
1668441835420,CSE 293,026,119411,Porter; George M,9999,0,9999,0
1668441835420,CSE 293,027,119414,Porter; Leonard Emerson,9999,0,9999,0
1668441835420,CSE 293,028,119416,Ramamoorthi; Ravi,9999,0,9999,0
1668441835420,CSE 293,029,119417,Sahoo; Debashis,9999,0,9999,0
1668441835420,CSE 293,030,119420,Saul; Lawrence,9999,0,9999,0
1668441835420,CSE 293,031,119421,Savage; Stefan,9999,0,9999,0
1668441835420,CSE 293,032,119425,Schulze; Jurgen P.,9999,0,9999,0
1668441835420,CSE 293,033,119426,Snoeren; Alex C.,9999,0,9999,0
1668441835420,CSE 293,034,119428,Shang; Jingbo,9999,0,9999,0
1668441835420,CSE 293,035,119430,Stefan; Deian,9999,0,9999,0
1668441835420,CSE 293,036,119431,Su; Hao,9999,0,9999,0
1668441835420,CSE 293,037,119433,Swanson; Steven James,9999,0,9999,0
1668441835420,CSE 293,038,119435,Tullsen; Dean Michael,9999,0,9999,0
1668441835420,CSE 293,039,119483,Voelker; Geoffrey M.,9999,0,9999,0
1668441835420,CSE 293,040,119537,Zhao; Jishen,9999,0,9999,0
1668441835420,CSE 293,041,119538,Zhou; Yuan-Yuan,9999,0,9999,0
1668441835420,CSE 293,042,119539,Gao; Sicun,9999,0,9999,0
1668441835420,CSE 293,043,119540,Weibel; Nadir,9999,0,9999,0
1668441835420,CSE 293,044,119541,Gupta; Rajesh K.,9999,0,9999,0
1668441835420,CSE 293,045,126410,Vaccaro; Kristen Marie,9999,0,9999,0
1668441835420,CSE 293,046,126411,Klemke; Richard,9999,0,9999,0
1668441835848,CSE 294,A00,102459,Voelker; Geoffrey M.,0,2,0,0
1668441835848,CSE 294,B00,111322,Orailoglu; Alex,0,0,0,0
1668441836273,DSE 201,A00,096914,Deutsch; Alin Bernard,30,0,30,0
1668441836702,DSE 210,A00,096915,Dasgupta; Sanjoy,30,0,30,0
1668441837124,DSE 260A,A00,096916,Altintas De Callaf; Ilkay,30,0,30,0
1668441837567,ECE 200,001,103586,Antipa; Nicholas A,9999,0,9999,0
1668441837567,ECE 200,002,103587,Atanasov; Nikolay A.,9999,0,9999,0
1668441837567,ECE 200,003,103588,Bharadia; Dinesh,9999,0,9999,0
1668441837567,ECE 200,004,103589,Cheng; Chung Kuan,9999,0,9999,0
1668441837567,ECE 200,005,103590,Cosman; Pamela C.,9999,0,9999,0
1668441837567,ECE 200,006,103591,Dayeh; Shadi Ahmad,9999,0,9999,0
1668441837567,ECE 200,007,103592,Fainman; Yeshaiahu,9999,0,9999,0
1668441837567,ECE 200,008,103593,Ford; Joseph Earl,9999,0,9999,0
1668441837567,ECE 200,009,103594,Franceschetti; Massimo,9999,0,9999,0
1668441837567,ECE 200,010,103595,Fullerton; Eric E,9999,0,9999,0
1668441837567,ECE 200,011,103596,Galton; Ian A,9999,0,9999,0
1668441837567,ECE 200,012,103597,Gilja; Vikash,9999,0,9999,0
1668441837567,ECE 200,013,103598,Hall; Drew A.,9999,0,9999,0
1668441837567,ECE 200,014,103599,Hsueh; Tzu-Chien,9999,0,9999,0
1668441837567,ECE 200,015,103600,Javidi; Tara,9999,0,9999,0
1668441837567,ECE 200,016,103601,Kahng; Andrew Byun,9999,0,9999,0
1668441837567,ECE 200,017,103602,Kim; Young-Han,9999,0,9999,0
1668441837567,ECE 200,018,103603,Koushanfar; Farinaz,9999,0,9999,0
1668441837567,ECE 200,019,103604,Kuzum; Duygu,9999,0,9999,0
1668441837567,ECE 200,020,103605,Le; Hanh-Phuc,9999,0,9999,0
1668441837567,ECE 200,021,103606,Lin; Bill,9999,0,9999,0
1668441837567,ECE 200,022,103607,Liu; Zhaowei,9998,0,9999,1
1668441837567,ECE 200,023,103608,Lo; Yu-Hwa,9999,0,9999,0
1668441837567,ECE 200,024,103609,Lomakin; Vitaliy,9999,0,9999,0
1668441837567,ECE 200,025,103610,Mercier; Patrick Philip,9999,0,9999,0
1668441837567,ECE 200,026,103611,Meyer; Florian,9999,0,9999,0
1668441837567,ECE 200,027,103612,Milstein; Laurence B.,9999,0,9999,0
1668441837567,ECE 200,028,103613,Mir Arabbaygi; Siavash,9999,0,9999,0
1668441837567,ECE 200,029,103614,Mookherjea; Shayan,9999,0,9999,0
1668441837567,ECE 200,030,103615,Morris; Karcher William,9999,0,9999,0
1668441837567,ECE 200,031,103616,Ng; Tse Nga,9999,0,9999,0
1668441837567,ECE 200,032,103617,Nguyen; Truong Quang,9999,0,9999,0
1668441837567,ECE 200,033,103618,Nomura; Kenji,9999,0,9999,0
1668441837567,ECE 200,034,103619,Orlitsky; Alon,9999,0,9999,0
1668441837567,ECE 200,035,103620,Pal; Piya,9999,0,9999,0
1668441837567,ECE 200,036,103621,Papen; George C.,9999,0,9999,0
1668441837567,ECE 200,037,103622,Radic; Stojan,9999,0,9999,0
1668441837567,ECE 200,038,103623,Rao; Bhaskar D.,9999,0,9999,0
1668441837567,ECE 200,039,103624,Rao; Ramesh R,9999,0,9999,0
1668441837567,ECE 200,040,103625,Rebeiz; Gabriel,9999,0,9999,0
1668441837567,ECE 200,041,103626,Sanford; John R,9999,0,9999,0
1668441837567,ECE 200,042,103627,Siegel; Paul H.,9999,0,9999,0
1668441837567,ECE 200,043,103628,Sievenpiper; Daniel F.,9999,0,9999,0
1668441837567,ECE 200,044,103629,Sworder; David D.,9999,0,9999,0
1668441837567,ECE 200,045,103630,Taur; Yuan,9999,0,9999,0
1668441837567,ECE 200,046,103631,Touri; Behrouz,9999,0,9999,0
1668441837567,ECE 200,047,103632,Trivedi; Mohan M.,9999,0,9999,0
1668441837567,ECE 200,048,103633,Vasconcelos; Nuno,9999,0,9999,0
1668441837567,ECE 200,049,103634,Wang; Xiaolong,9999,0,9999,0
1668441837567,ECE 200,050,103635,Xie; Pengtao,9999,0,9999,0
1668441837567,ECE 200,051,103636,Yip; Michael,9999,0,9999,0
1668441837567,ECE 200,052,103637,Zeger; Kenneth A.,999,0,999,0
1668441837567,ECE 200,053,103638,Zhang; Xinyu,9999,0,9999,0
1668441837567,ECE 200,054,103639,Turakhia; Yatish Girish,9999,0,9999,0
1668441837567,ECE 200,055,103640,Kang; Mingu,9999,0,9999,0
1668441837567,ECE 200,056,103641,Shi; Yuanyuan,9999,0,9999,0
1668441837567,ECE 200,057,103642,Wang; Edward Jay,9999,0,9999,0
1668441837567,ECE 200,058,103643,Zheng; Yang,9999,0,9999,0
1668441837996,ECE 202,A00,103644,Kuzum; Duygu,0,25,0,0
1668441838420,ECE 212BN,A00,103646,Ng; Tse Nga,0,1,0,0
1668441838846,ECE 221,A00,111493,Staff,0,0,0,0
1668441839274,ECE 222B,A00,103647,Lomakin; Vitaliy,0,5,0,0
1668441839707,ECE 230B,A00,103648,Taur; Yuan,0,0,0,0
1668441840138,ECE 238B,A00,103649,Garay; Javier,0,0,0,0
1668441840573,ECE 240B,A00,112900,Fainman; Yeshaiahu,0,4,0,0
1668441840996,ECE 247A,A00,103650,Jokerst; Jesse Vincent,0,2,0,0
1668441841428,ECE 247B,A00,103651,Wang; Joseph,0,7,0,0
1668441841869,ECE 250,A00,103652,Siegel; Paul H.,0,45,0,0
1668441842294,ECE 251A,A00,103654,Rao; Bhaskar D.,0,31,0,0
1668441842731,ECE 257B,A00,103655,Bharadia; Dinesh,0,15,0,0
1668441843166,ECE 258A,A00,103656,Milstein; Laurence B.,0,12,0,0
1668441843590,ECE 260B,A00,103658,Kang; Mingu,0,68,0,0
1668441844018,ECE 264A,A00,103659,Galton; Ian A,0,38,0,0
1668441844443,ECE 265A,A00,103661,Gudem; Prasad S.S.,0,21,0,0
1668441844881,ECE 265D,A00,103662,Gudem; Prasad S.S.,0,14,0,0
1668441845314,ECE 268,A00,103663,Koushanfar; Farinaz,0,22,0,0
1668441845738,ECE 269,A01,103665,Pal; Piya,0,139,0,0
1668441846178,ECE 271B,A00,103666,Vasconcelos; Manuela,0,48,0,0
1668441846603,ECE 276A,A00,103667,Atanasov; Nikolay A.,0,74,0,0
1668441847025,ECE 277,A00,103668,An; Cheolhong,0,94,0,0
1668441847452,ECE 279,A00,117947,Hall; Drew A.,0,13,0,0
1668441848319,ECE 283,A00,103670,Hsueh; Tzu-Chien,0,30,0,0
1668441848753,ECE 284,A00,103671,Turakhia; Yatish Girish,0,26,0,0
1668441849182,ECE 285,A00,103672,Zheng; Yang,0,25,0,0
1668441849182,ECE 285,B00,103673,Sworder; David D.,0,41,0,0
1668441849611,ECE 287,A00,103676,Javidi; Tara,0,4,0,0
1668441850036,MATH 200B,A00,098023,Salehi Golsefidy; Alireza,12,0,15,3
1668441850462,MATH 202B,A00,098024,Rhoades; Brendon Patrick,9,0,15,6
1668441850892,MATH 203B,A00,098025,Oprea; Dragos N.,10,0,15,5
1668441851317,MATH 204B,A00,098026,Sorensen; Claus M,13,0,15,2
1668441851749,MATH 208,A00,098027,Izadi; Elham,7,0,10,3
1668441852185,MATH 209,A00,098028,Pollack; Aaron,10,0,10,0
1668441852616,MATH 211A,A00,112919,Rogalski; Daniel,9,0,10,1
1668441853038,MATH 211B,A00,112920,Seward; Brandon M.,9,0,10,1
1668441853478,MATH 218,A00,098029,Li; Bo,10,0,10,0
1668441853916,MATH 220B,A00,098030,Novak; Jonathan I,11,0,15,4
1668441854350,MATH 221A,A00,098031,Ebenfelt; Peter F,13,0,15,2
1668441854779,MATH 231B,A00,098032,Zlatos; Andrej,12,0,15,3
1668441855201,MATH 240B,A00,098033,Ni; Lei,9,0,15,6
1668441855631,MATH 243,A00,098034,Jekel; David Andrew,10,0,10,0
1668441856054,MATH 245A,A00,098035,Nie; Jiawang,0,1,15,16
1668441856477,MATH 248,A00,098036,Bejenaru; Ioan,10,0,10,0
1668441856919,MATH 250B,A00,098037,Spolaor; Luca,14,0,15,1
1668441857342,MATH 258,A00,098038,Ni; Lei,10,0,10,0
1668441857777,MATH 264B,A00,098041,Rhoades; Brendon Patrick,9,0,15,6
1668441858211,MATH 268,A00,098042,Buss; Samuel R,10,0,10,0
1668441858644,MATH 269,A00,098043,Rhoades; Brendon Patrick,10,0,10,0
1668441859070,MATH 270B,A00,098044,Li; Bo,10,0,15,5
1668441859497,MATH 272B,A00,098045,Holst; Michael J,13,0,15,2
1668441859926,MATH 273A,A00,098046,Tian; Xiaochuan,10,0,15,5
1668441860350,MATH 275,A01,098048,Tian; Xiaochuan,6,0,10,4
1668441860780,MATH 278A,A00,098049,Holst; Michael J,8,0,10,2
1668441861210,MATH 278B,A00,098050,Cloninger; Alexander,10,0,10,0
1668441861636,MATH 278C,A00,098051,Nie; Jiawang,6,0,10,4
1668441862062,MATH 280B,A00,098052,Zheng; Tianyi,8,0,15,7
1668441862488,MATH 281B,A00,098053,Bradic; Jelena,0,1,15,15
1668441862916,MATH 282B,A00,098054,Arias-Castro; Ery,0,0,15,15
1668441863341,MATH 285,A00,098055,Fitzsimmons; Patrick J,0,1,15,17
1668441863777,MATH 287B,A00,098056,Arias-Castro; Ery,2,0,15,13
1668441864201,MATH 288,A00,098057,Agarwal; Pooja,9,0,10,1
1668441864201,MATH 288,B00,098058,Zhang; Danna,8,0,10,2
1668441864201,MATH 288,C00,098059,Williams; Ruth J,9,0,10,1
1668441864625,MATH 290B,A00,098060,Roberts; Justin Deritter,13,0,15,2
1668441865057,MATH 292,A00,098061,Belmont; Eva Kinoshita,10,0,10,0
1668441865488,MATH 295,A00,098062,Suk; Andrew Hoon,48,0,50,2
1668441865910,MATH 296,A00,098063,Novak; Jonathan I,20,0,20,0
1668441866344,MATH 297,001,098064,Gamst; Anthony Collins,9997,0,9999,2
1668442370946,COGS 205,A00,101395,Chiba; Andrea,19,0,20,1
1668442371397,COGS 210B,001,101404,Greene; Deanna Jacquelyn,9998,0,9999,1
1668442371397,COGS 210B,002,101417,Xia; Haijun,9999,0,9999,0
1668442371397,COGS 210B,003,101422,Nitz; Douglas A.,9999,0,9999,0
1668442371397,COGS 210B,004,101423,Hollan; James D.,9998,0,9999,1
1668442371397,COGS 210B,005,101424,Deak; Gedeon O.,9998,0,9999,1
1668442371397,COGS 210B,006,101425,Rossano; Federico,9999,0,9999,0
1668442371823,COGS 211B,A00,101427,Coulson; Seana M,9996,0,9999,3
1668442372249,COGS 220,A00,101428,Hollan; James D.,1,3,25,24
1668442372677,COGS 229,A00,101429,Dow; Steven P,18,0,25,7
1668442373102,COGS 230,A00,101430,Klemmer; Scott R,11,0,17,6
1668442373533,COGS 234,A00,101431,Xia; Haijun,2,0,25,23
1668442373959,COGS 260,A00,101432,Kiyonaga; Anastasia,21,0,25,4
1668442373959,COGS 260,B00,101433,Kirsh; David Joel,15,0,25,10
1668442374403,CSE 202,A00,102371,Impagliazzo; Russell,0,36,0,0
1668442374830,CSE 203B,A01,102373,Cheng; Chung Kuan,0,28,0,0
1668442375262,CSE 208,A00,102374,Micciancio; Daniele,0,1,0,0
1668442375698,CSE 209A,A00,112895,Impagliazzo; Russell,0,6,15,15
1668442376122,CSE 209B,A00,108005,Bellare; Mihir,0,3,0,0
1668442376546,CSE 210,A00,113163,Coblenz; Michael J,0,46,0,0
1668442376969,CSE 219,A00,106111,Dow; Steven P,0,0,20,20
1668442377397,CSE 221,A00,102376,Voelker; Geoffrey M.,0,33,0,0
1668442377825,CSE 224,A01,102378,Porter; George M,0,108,0,0
1668442378249,CSE 229A,A00,102379,Savage; Stefan,0,4,0,0
1668442378680,CSE 229C,A00,102380,Munyaka; Imani N. S.,0,4,0,0
1668442379113,CSE 232B,A00,102382,Deutsch; Alin Bernard,0,15,0,0
1668442379539,CSE 234,A01,112904,Kumar; Arun Kumar,0,0,0,0
1668442379976,CSE 237A,A00,102383,Rosing; Tajana Simunic,0,27,0,0
1668442380407,CSE 239A,A00,102384,Deutsch; Alin Bernard,0,6,0,0
1668442380835,CSE 239B,A00,102385,Polikarpova; Nadezhda,0,3,0,0
1668442381261,CSE 240A,A00,102386,Pannuto; Patrick William,0,29,0,0
1668442381686,CSE 240B,A00,102387,Zhao; Jishen,0,24,0,0
1668442382109,CSE 241A,A00,106406,Kang; Mingu,0,2,0,0
1668442382533,CSE 249B,A00,102388,Kahng; Andrew Byun,0,1,8,8
1668442382957,CSE 251B,A01,102392,Cottrell; Garrison W,0,28,0,0
1668442382957,CSE 251B,A02,102393,Cottrell; Garrison W,0,21,0,0
1668442383403,CSE 252B,A00,102394,Ochoa; Benjamin Lawrence,0,38,0,0
1668442383828,CSE 257,A01,102396,Gao; Sicun,0,88,0,0
1668442384252,CSE 272,A00,102397,Li; Tzumao,0,7,0,0
1668442384681,CSE 274,A00,111323,Chern; Albert Ren-Haur,0,7,0,0
1668442385105,CSE 282,A00,102398,Pevzner; Pavel Arkadjevich,0,0,0,0
1668442385527,CSE 284,A00,114175,Gymrek; Melissa Ann,0,12,0,0
1668442385948,CSE 290,A00,102399,Chandraker; Manmohan Krishna,0,4,0,0
1668442385948,CSE 290,B00,102400,Vaccaro; Kristen Marie,0,1,25,25
1668442385948,CSE 290,C00,102414,Pannuto; Patrick William,0,1,25,25
1668442385948,CSE 290,D00,102427,Pevzner; Pavel Arkadjevich,0,0,0,0
1668442385948,CSE 290,E00,102429,Zhao; Jishen,0,2,0,0
1668442385948,CSE 290,F00,102436,Tullsen; Dean Michael,0,4,0,0
1668442385948,CSE 290,G00,102440,Christensen; Henrik I,0,3,20,20
1668442386379,CSE 291,A00,102443,Su; Hao,0,0,0,0
1668442386379,CSE 291,B00,102448,Polikarpova; Nadezhda,0,0,0,0
1668442386379,CSE 291,C00,102453,Vaccaro; Kristen Marie,0,0,0,0
1668442386379,CSE 291,D00,111343,Savage; Stefan,0,0,0,0
1668442386379,CSE 291,E00,116474,Claffy; Kimberly Claire,0,0,0,0
1668442386379,CSE 291,F00,116479,Pasquale; Joseph,0,0,0,0
1668442386805,CSE 293,001,119111,Bafna; Vineet,9999,0,9999,0
1668442386805,CSE 293,002,119118,Bellare; Mihir,9999,0,9999,0
1668442386805,CSE 293,003,119122,Berg-Kirkpatrick; Taylor D,9999,0,9999,0
1668442386805,CSE 293,004,119135,Christensen; Henrik I,9999,0,9999,0
1668442386805,CSE 293,005,119142,Cottrell; Garrison W,9999,0,9999,0
1668442386805,CSE 293,006,119146,Deutsch; Alin Bernard,9999,0,9999,0
1668442386805,CSE 293,007,119159,Esmaeilzadeh; Hadi,9999,0,9999,0
1668442386805,CSE 293,008,119166,Freund; Yoav,9999,0,9999,0
1668442386805,CSE 293,009,119170,Griswold; William G.,9999,0,9999,0
1668442386805,CSE 293,010,119183,Gymrek; Melissa Ann,9999,0,9999,0
1668442386805,CSE 293,011,119190,Heninger; Nadia A,9999,0,9999,0
1668442386805,CSE 293,012,119230,Impagliazzo; Russell,9999,0,9999,0
1668442386805,CSE 293,013,119232,Jhala; Ranjit,9999,0,9999,0
1668442386805,CSE 293,014,119233,Kahng; Andrew Byun,9999,0,9999,0
1668442386805,CSE 293,015,119298,Kane; Daniel Mertz,9999,0,9999,0
1668442386805,CSE 293,016,119299,Kriegman; David J,9999,0,9999,0
1668442386805,CSE 293,017,119300,Kumar; Arun Kumar,9999,0,9999,0
1668442386805,CSE 293,018,119301,Lerner; Sorin,9999,0,9999,0
1668442386805,CSE 293,019,119302,Lovett; Shachar,9999,0,9999,0
1668442386805,CSE 293,020,119303,McAuley; Julian John,9999,0,9999,0
1668442386805,CSE 293,021,119304,Micciancio; Daniele,9999,0,9999,0
1668442386805,CSE 293,022,119367,Orailoglu; Alex,9999,0,9999,0
1668442386805,CSE 293,023,119382,Paturi; Ramamohan,9999,0,9999,0
1668442386805,CSE 293,024,119404,Polikarpova; Nadezhda,9999,0,9999,0
1668442386805,CSE 293,025,119406,Politz; Joseph Gibbs,9999,0,9999,0
1668442386805,CSE 293,026,119411,Porter; George M,9999,0,9999,0
1668442386805,CSE 293,027,119414,Porter; Leonard Emerson,9999,0,9999,0
1668442386805,CSE 293,028,119416,Ramamoorthi; Ravi,9999,0,9999,0
1668442386805,CSE 293,029,119417,Sahoo; Debashis,9999,0,9999,0
1668442386805,CSE 293,030,119420,Saul; Lawrence,9999,0,9999,0
1668442386805,CSE 293,031,119421,Savage; Stefan,9999,0,9999,0
1668442386805,CSE 293,032,119425,Schulze; Jurgen P.,9999,0,9999,0
1668442386805,CSE 293,033,119426,Snoeren; Alex C.,9999,0,9999,0
1668442386805,CSE 293,034,119428,Shang; Jingbo,9999,0,9999,0
1668442386805,CSE 293,035,119430,Stefan; Deian,9999,0,9999,0
1668442386805,CSE 293,036,119431,Su; Hao,9999,0,9999,0
1668442386805,CSE 293,037,119433,Swanson; Steven James,9999,0,9999,0
1668442386805,CSE 293,038,119435,Tullsen; Dean Michael,9999,0,9999,0
1668442386805,CSE 293,039,119483,Voelker; Geoffrey M.,9999,0,9999,0
1668442386805,CSE 293,040,119537,Zhao; Jishen,9999,0,9999,0
1668442386805,CSE 293,041,119538,Zhou; Yuan-Yuan,9999,0,9999,0
1668442386805,CSE 293,042,119539,Gao; Sicun,9999,0,9999,0
1668442386805,CSE 293,043,119540,Weibel; Nadir,9999,0,9999,0
1668442386805,CSE 293,044,119541,Gupta; Rajesh K.,9999,0,9999,0
1668442386805,CSE 293,045,126410,Vaccaro; Kristen Marie,9999,0,9999,0
1668442386805,CSE 293,046,126411,Klemke; Richard,9999,0,9999,0
1668442387241,CSE 294,A00,102459,Voelker; Geoffrey M.,0,2,0,0
1668442387241,CSE 294,B00,111322,Orailoglu; Alex,0,0,0,0
1668442387664,DSE 201,A00,096914,Deutsch; Alin Bernard,30,0,30,0
1668442388091,DSE 210,A00,096915,Dasgupta; Sanjoy,30,0,30,0
1668442388521,DSE 260A,A00,096916,Altintas De Callaf; Ilkay,30,0,30,0
1668442388962,ECE 200,001,103586,Antipa; Nicholas A,9999,0,9999,0
1668442388962,ECE 200,002,103587,Atanasov; Nikolay A.,9999,0,9999,0
1668442388962,ECE 200,003,103588,Bharadia; Dinesh,9999,0,9999,0
1668442388962,ECE 200,004,103589,Cheng; Chung Kuan,9999,0,9999,0
1668442388962,ECE 200,005,103590,Cosman; Pamela C.,9999,0,9999,0
1668442388962,ECE 200,006,103591,Dayeh; Shadi Ahmad,9999,0,9999,0
1668442388962,ECE 200,007,103592,Fainman; Yeshaiahu,9999,0,9999,0
1668442388962,ECE 200,008,103593,Ford; Joseph Earl,9999,0,9999,0
1668442388962,ECE 200,009,103594,Franceschetti; Massimo,9999,0,9999,0
1668442388962,ECE 200,010,103595,Fullerton; Eric E,9999,0,9999,0
1668442388962,ECE 200,011,103596,Galton; Ian A,9999,0,9999,0
1668442388962,ECE 200,012,103597,Gilja; Vikash,9999,0,9999,0
1668442388962,ECE 200,013,103598,Hall; Drew A.,9999,0,9999,0
1668442388962,ECE 200,014,103599,Hsueh; Tzu-Chien,9999,0,9999,0
1668442388962,ECE 200,015,103600,Javidi; Tara,9999,0,9999,0
1668442388962,ECE 200,016,103601,Kahng; Andrew Byun,9999,0,9999,0
1668442388962,ECE 200,017,103602,Kim; Young-Han,9999,0,9999,0
1668442388962,ECE 200,018,103603,Koushanfar; Farinaz,9999,0,9999,0
1668442388962,ECE 200,019,103604,Kuzum; Duygu,9999,0,9999,0
1668442388962,ECE 200,020,103605,Le; Hanh-Phuc,9999,0,9999,0
1668442388962,ECE 200,021,103606,Lin; Bill,9999,0,9999,0
1668442388962,ECE 200,022,103607,Liu; Zhaowei,9998,0,9999,1
1668442388962,ECE 200,023,103608,Lo; Yu-Hwa,9999,0,9999,0
1668442388962,ECE 200,024,103609,Lomakin; Vitaliy,9999,0,9999,0
1668442388962,ECE 200,025,103610,Mercier; Patrick Philip,9999,0,9999,0
1668442388962,ECE 200,026,103611,Meyer; Florian,9999,0,9999,0
1668442388962,ECE 200,027,103612,Milstein; Laurence B.,9999,0,9999,0
1668442388962,ECE 200,028,103613,Mir Arabbaygi; Siavash,9999,0,9999,0
1668442388962,ECE 200,029,103614,Mookherjea; Shayan,9999,0,9999,0
1668442388962,ECE 200,030,103615,Morris; Karcher William,9999,0,9999,0
1668442388962,ECE 200,031,103616,Ng; Tse Nga,9999,0,9999,0
1668442388962,ECE 200,032,103617,Nguyen; Truong Quang,9999,0,9999,0
1668442388962,ECE 200,033,103618,Nomura; Kenji,9999,0,9999,0
1668442388962,ECE 200,034,103619,Orlitsky; Alon,9999,0,9999,0
1668442388962,ECE 200,035,103620,Pal; Piya,9999,0,9999,0
1668442388962,ECE 200,036,103621,Papen; George C.,9999,0,9999,0
1668442388962,ECE 200,037,103622,Radic; Stojan,9999,0,9999,0
1668442388962,ECE 200,038,103623,Rao; Bhaskar D.,9999,0,9999,0
1668442388962,ECE 200,039,103624,Rao; Ramesh R,9999,0,9999,0
1668442388962,ECE 200,040,103625,Rebeiz; Gabriel,9999,0,9999,0
1668442388962,ECE 200,041,103626,Sanford; John R,9999,0,9999,0
1668442388962,ECE 200,042,103627,Siegel; Paul H.,9999,0,9999,0
1668442388962,ECE 200,043,103628,Sievenpiper; Daniel F.,9999,0,9999,0
1668442388962,ECE 200,044,103629,Sworder; David D.,9999,0,9999,0
1668442388962,ECE 200,045,103630,Taur; Yuan,9999,0,9999,0
1668442388962,ECE 200,046,103631,Touri; Behrouz,9999,0,9999,0
1668442388962,ECE 200,047,103632,Trivedi; Mohan M.,9999,0,9999,0
1668442388962,ECE 200,048,103633,Vasconcelos; Nuno,9999,0,9999,0
1668442388962,ECE 200,049,103634,Wang; Xiaolong,9999,0,9999,0
1668442388962,ECE 200,050,103635,Xie; Pengtao,9999,0,9999,0
1668442388962,ECE 200,051,103636,Yip; Michael,9999,0,9999,0
1668442388962,ECE 200,052,103637,Zeger; Kenneth A.,999,0,999,0
1668442388962,ECE 200,053,103638,Zhang; Xinyu,9999,0,9999,0
1668442388962,ECE 200,054,103639,Turakhia; Yatish Girish,9999,0,9999,0
1668442388962,ECE 200,055,103640,Kang; Mingu,9999,0,9999,0
1668442388962,ECE 200,056,103641,Shi; Yuanyuan,9999,0,9999,0
1668442388962,ECE 200,057,103642,Wang; Edward Jay,9999,0,9999,0
1668442388962,ECE 200,058,103643,Zheng; Yang,9999,0,9999,0
1668442389386,ECE 202,A00,103644,Kuzum; Duygu,0,25,0,0
1668442389813,ECE 212BN,A00,103646,Ng; Tse Nga,0,1,0,0
1668442390240,ECE 221,A00,111493,Staff,0,0,0,0
1668442390671,ECE 222B,A00,103647,Lomakin; Vitaliy,0,5,0,0
1668442391096,ECE 230B,A00,103648,Taur; Yuan,0,0,0,0
1668442391531,ECE 238B,A00,103649,Garay; Javier,0,0,0,0
1668442391969,ECE 240B,A00,112900,Fainman; Yeshaiahu,0,4,0,0
1668442392397,ECE 247A,A00,103650,Jokerst; Jesse Vincent,0,2,0,0
1668442392833,ECE 247B,A00,103651,Wang; Joseph,0,7,0,0
1668442393278,ECE 250,A00,103652,Siegel; Paul H.,0,45,0,0
1668442393701,ECE 251A,A00,103654,Rao; Bhaskar D.,0,32,0,0
1668442394135,ECE 257B,A00,103655,Bharadia; Dinesh,0,15,0,0
1668442394563,ECE 258A,A00,103656,Milstein; Laurence B.,0,12,0,0
1668442394989,ECE 260B,A00,103658,Kang; Mingu,0,69,0,0
1668442395424,ECE 264A,A00,103659,Galton; Ian A,0,38,0,0
1668442395851,ECE 265A,A00,103661,Gudem; Prasad S.S.,0,21,0,0
1668442396293,ECE 265D,A00,103662,Gudem; Prasad S.S.,0,14,0,0
1668442396720,ECE 268,A00,103663,Koushanfar; Farinaz,0,23,0,0
1668442397144,ECE 269,A01,103665,Pal; Piya,0,140,0,0
1668442397577,ECE 271B,A00,103666,Vasconcelos; Manuela,0,49,0,0
1668442398007,ECE 276A,A00,103667,Atanasov; Nikolay A.,0,75,0,0
1668442398430,ECE 277,A00,103668,An; Cheolhong,0,95,0,0
1668442398866,ECE 279,A00,117947,Hall; Drew A.,0,13,0,0
1668442399719,ECE 283,A00,103670,Hsueh; Tzu-Chien,0,30,0,0
1668442400154,ECE 284,A00,103671,Turakhia; Yatish Girish,0,26,0,0
1668442400581,ECE 285,A00,103672,Zheng; Yang,0,25,0,0
1668442400581,ECE 285,B00,103673,Sworder; David D.,0,41,0,0
1668442401103,ECE 287,A00,103676,Javidi; Tara,0,4,0,0
1668442401527,MATH 200B,A00,098023,Salehi Golsefidy; Alireza,12,0,15,3
1668442401951,MATH 202B,A00,098024,Rhoades; Brendon Patrick,9,0,15,6
1668442402383,MATH 203B,A00,098025,Oprea; Dragos N.,10,0,15,5
1668442402813,MATH 204B,A00,098026,Sorensen; Claus M,13,0,15,2
1668442403245,MATH 208,A00,098027,Izadi; Elham,7,0,10,3
1668442403683,MATH 209,A00,098028,Pollack; Aaron,10,0,10,0
1668442404122,MATH 211A,A00,112919,Rogalski; Daniel,9,0,10,1
1668442404546,MATH 211B,A00,112920,Seward; Brandon M.,9,0,10,1
1668442404977,MATH 218,A00,098029,Li; Bo,10,0,10,0
1668442405402,MATH 220B,A00,098030,Novak; Jonathan I,11,0,15,4
1668442405839,MATH 221A,A00,098031,Ebenfelt; Peter F,13,0,15,2
1668442406265,MATH 231B,A00,098032,Zlatos; Andrej,12,0,15,3
1668442406705,MATH 240B,A00,098033,Ni; Lei,9,0,15,6
1668442407141,MATH 243,A00,098034,Jekel; David Andrew,10,0,10,0
1668442407566,MATH 245A,A00,098035,Nie; Jiawang,0,2,15,16
1668442407992,MATH 248,A00,098036,Bejenaru; Ioan,10,0,10,0
1668442408417,MATH 250B,A00,098037,Spolaor; Luca,14,0,15,1
1668442408843,MATH 258,A00,098038,Ni; Lei,10,0,10,0
1668442409277,MATH 264B,A00,098041,Rhoades; Brendon Patrick,9,0,15,6
1668442409702,MATH 268,A00,098042,Buss; Samuel R,10,0,10,0
1668442410137,MATH 269,A00,098043,Rhoades; Brendon Patrick,10,0,10,0
1668442410565,MATH 270B,A00,098044,Li; Bo,10,0,15,5
1668442411006,MATH 272B,A00,098045,Holst; Michael J,13,0,15,2
1668442411434,MATH 273A,A00,098046,Tian; Xiaochuan,10,0,15,5
1668442411858,MATH 275,A01,098048,Tian; Xiaochuan,6,0,10,4
1668442412290,MATH 278A,A00,098049,Holst; Michael J,8,0,10,2
1668442412716,MATH 278B,A00,098050,Cloninger; Alexander,10,0,10,0
1668442413140,MATH 278C,A00,098051,Nie; Jiawang,6,0,10,4
1668442413566,MATH 280B,A00,098052,Zheng; Tianyi,8,0,15,7
1668442414006,MATH 281B,A00,098053,Bradic; Jelena,0,1,15,15
1668442414440,MATH 282B,A00,098054,Arias-Castro; Ery,0,0,15,15
1668442414874,MATH 285,A00,098055,Fitzsimmons; Patrick J,0,1,15,17
1668442415297,MATH 287B,A00,098056,Arias-Castro; Ery,2,0,15,13
1668442415741,MATH 288,A00,098057,Agarwal; Pooja,9,0,10,1
1668442415741,MATH 288,B00,098058,Zhang; Danna,8,0,10,2
1668442415741,MATH 288,C00,098059,Williams; Ruth J,9,0,10,1
1668442416172,MATH 290B,A00,098060,Roberts; Justin Deritter,13,0,15,2
1668442416604,MATH 292,A00,098061,Belmont; Eva Kinoshita,10,0,10,0
1668442417028,MATH 295,A00,098062,Suk; Andrew Hoon,48,0,50,2
1668442417454,MATH 296,A00,098063,Novak; Jonathan I,20,0,20,0
1668442417884,MATH 297,001,098064,Gamst; Anthony Collins,9997,0,9999,2
1668442922579,COGS 205,A00,101395,Chiba; Andrea,19,0,20,1
1668442923003,COGS 210B,001,101404,Greene; Deanna Jacquelyn,9998,0,9999,1
1668442923003,COGS 210B,002,101417,Xia; Haijun,9999,0,9999,0
1668442923003,COGS 210B,003,101422,Nitz; Douglas A.,9999,0,9999,0
1668442923003,COGS 210B,004,101423,Hollan; James D.,9998,0,9999,1
1668442923003,COGS 210B,005,101424,Deak; Gedeon O.,9998,0,9999,1
1668442923003,COGS 210B,006,101425,Rossano; Federico,9999,0,9999,0
1668442923433,COGS 211B,A00,101427,Coulson; Seana M,9996,0,9999,3
1668442923866,COGS 220,A00,101428,Hollan; James D.,1,3,25,24
1668442924290,COGS 229,A00,101429,Dow; Steven P,18,0,25,7
1668442924718,COGS 230,A00,101430,Klemmer; Scott R,11,0,17,6
1668442925257,COGS 234,A00,101431,Xia; Haijun,2,0,25,23
1668442925695,COGS 260,A00,101432,Kiyonaga; Anastasia,21,0,25,4
1668442925695,COGS 260,B00,101433,Kirsh; David Joel,15,0,25,10
1668442926119,CSE 202,A00,102371,Impagliazzo; Russell,0,38,0,0
1668442926548,CSE 203B,A01,102373,Cheng; Chung Kuan,0,28,0,0
1668442926971,CSE 208,A00,102374,Micciancio; Daniele,0,1,0,0
1668442927407,CSE 209A,A00,112895,Impagliazzo; Russell,0,6,15,15
1668442927837,CSE 209B,A00,108005,Bellare; Mihir,0,3,0,0
1668442928262,CSE 210,A00,113163,Coblenz; Michael J,0,46,0,0
1668442928690,CSE 219,A00,106111,Dow; Steven P,0,0,20,20
1668442929113,CSE 221,A00,102376,Voelker; Geoffrey M.,0,33,0,0
1668442929539,CSE 224,A01,102378,Porter; George M,0,108,0,0
1668442929980,CSE 229A,A00,102379,Savage; Stefan,0,4,0,0
1668442930417,CSE 229C,A00,102380,Munyaka; Imani N. S.,0,4,0,0
1668442930858,CSE 232B,A00,102382,Deutsch; Alin Bernard,0,15,0,0
1668442931283,CSE 234,A01,112904,Kumar; Arun Kumar,0,0,0,0
1668442931710,CSE 237A,A00,102383,Rosing; Tajana Simunic,0,27,0,0
1668442932134,CSE 239A,A00,102384,Deutsch; Alin Bernard,0,6,0,0
1668442932570,CSE 239B,A00,102385,Polikarpova; Nadezhda,0,3,0,0
1668442932996,CSE 240A,A00,102386,Pannuto; Patrick William,0,30,0,0
1668442933419,CSE 240B,A00,102387,Zhao; Jishen,0,25,0,0
1668442933855,CSE 241A,A00,106406,Kang; Mingu,0,2,0,0
1668442934278,CSE 249B,A00,102388,Kahng; Andrew Byun,0,1,8,8
1668442934707,CSE 251B,A01,102392,Cottrell; Garrison W,0,28,0,0
1668442934707,CSE 251B,A02,102393,Cottrell; Garrison W,0,23,0,0
1668442935130,CSE 252B,A00,102394,Ochoa; Benjamin Lawrence,0,38,0,0
1668442935554,CSE 257,A01,102396,Gao; Sicun,0,88,0,0
1668442935977,CSE 272,A00,102397,Li; Tzumao,0,7,0,0
1668442936401,CSE 274,A00,111323,Chern; Albert Ren-Haur,0,7,0,0
1668442936824,CSE 282,A00,102398,Pevzner; Pavel Arkadjevich,0,0,0,0
1668442937250,CSE 284,A00,114175,Gymrek; Melissa Ann,0,13,0,0
1668442937685,CSE 290,A00,102399,Chandraker; Manmohan Krishna,0,4,0,0
1668442937685,CSE 290,B00,102400,Vaccaro; Kristen Marie,0,1,25,25
1668442937685,CSE 290,C00,102414,Pannuto; Patrick William,0,1,25,25
1668442937685,CSE 290,D00,102427,Pevzner; Pavel Arkadjevich,0,0,0,0
1668442937685,CSE 290,E00,102429,Zhao; Jishen,0,2,0,0
1668442937685,CSE 290,F00,102436,Tullsen; Dean Michael,0,4,0,0
1668442937685,CSE 290,G00,102440,Christensen; Henrik I,0,3,20,20
1668442938122,CSE 291,A00,102443,Su; Hao,0,0,0,0
1668442938122,CSE 291,B00,102448,Polikarpova; Nadezhda,0,0,0,0
1668442938122,CSE 291,C00,102453,Vaccaro; Kristen Marie,0,0,0,0
1668442938122,CSE 291,D00,111343,Savage; Stefan,0,0,0,0
1668442938122,CSE 291,E00,116474,Claffy; Kimberly Claire,0,0,0,0
1668442938122,CSE 291,F00,116479,Pasquale; Joseph,0,0,0,0
1668442938548,CSE 293,001,119111,Bafna; Vineet,9999,0,9999,0
1668442938548,CSE 293,002,119118,Bellare; Mihir,9999,0,9999,0
1668442938548,CSE 293,003,119122,Berg-Kirkpatrick; Taylor D,9999,0,9999,0
1668442938548,CSE 293,004,119135,Christensen; Henrik I,9999,0,9999,0
1668442938548,CSE 293,005,119142,Cottrell; Garrison W,9999,0,9999,0
1668442938548,CSE 293,006,119146,Deutsch; Alin Bernard,9999,0,9999,0
1668442938548,CSE 293,007,119159,Esmaeilzadeh; Hadi,9999,0,9999,0
1668442938548,CSE 293,008,119166,Freund; Yoav,9999,0,9999,0
1668442938548,CSE 293,009,119170,Griswold; William G.,9999,0,9999,0
1668442938548,CSE 293,010,119183,Gymrek; Melissa Ann,9999,0,9999,0
1668442938548,CSE 293,011,119190,Heninger; Nadia A,9999,0,9999,0
1668442938548,CSE 293,012,119230,Impagliazzo; Russell,9999,0,9999,0
1668442938548,CSE 293,013,119232,Jhala; Ranjit,9999,0,9999,0
1668442938548,CSE 293,014,119233,Kahng; Andrew Byun,9999,0,9999,0
1668442938548,CSE 293,015,119298,Kane; Daniel Mertz,9999,0,9999,0
1668442938548,CSE 293,016,119299,Kriegman; David J,9999,0,9999,0
1668442938548,CSE 293,017,119300,Kumar; Arun Kumar,9999,0,9999,0
1668442938548,CSE 293,018,119301,Lerner; Sorin,9999,0,9999,0
1668442938548,CSE 293,019,119302,Lovett; Shachar,9999,0,9999,0
1668442938548,CSE 293,020,119303,McAuley; Julian John,9999,0,9999,0
1668442938548,CSE 293,021,119304,Micciancio; Daniele,9999,0,9999,0
1668442938548,CSE 293,022,119367,Orailoglu; Alex,9999,0,9999,0
1668442938548,CSE 293,023,119382,Paturi; Ramamohan,9999,0,9999,0
1668442938548,CSE 293,024,119404,Polikarpova; Nadezhda,9999,0,9999,0
1668442938548,CSE 293,025,119406,Politz; Joseph Gibbs,9999,0,9999,0
1668442938548,CSE 293,026,119411,Porter; George M,9999,0,9999,0
1668442938548,CSE 293,027,119414,Porter; Leonard Emerson,9999,0,9999,0
1668442938548,CSE 293,028,119416,Ramamoorthi; Ravi,9999,0,9999,0
1668442938548,CSE 293,029,119417,Sahoo; Debashis,9999,0,9999,0
1668442938548,CSE 293,030,119420,Saul; Lawrence,9999,0,9999,0
1668442938548,CSE 293,031,119421,Savage; Stefan,9999,0,9999,0
1668442938548,CSE 293,032,119425,Schulze; Jurgen P.,9999,0,9999,0
1668442938548,CSE 293,033,119426,Snoeren; Alex C.,9999,0,9999,0
1668442938548,CSE 293,034,119428,Shang; Jingbo,9999,0,9999,0
1668442938548,CSE 293,035,119430,Stefan; Deian,9999,0,9999,0
1668442938548,CSE 293,036,119431,Su; Hao,9999,0,9999,0
1668442938548,CSE 293,037,119433,Swanson; Steven James,9999,0,9999,0
1668442938548,CSE 293,038,119435,Tullsen; Dean Michael,9999,0,9999,0
1668442938548,CSE 293,039,119483,Voelker; Geoffrey M.,9999,0,9999,0
1668442938548,CSE 293,040,119537,Zhao; Jishen,9999,0,9999,0
1668442938548,CSE 293,041,119538,Zhou; Yuan-Yuan,9999,0,9999,0
1668442938548,CSE 293,042,119539,Gao; Sicun,9999,0,9999,0
1668442938548,CSE 293,043,119540,Weibel; Nadir,9999,0,9999,0
1668442938548,CSE 293,044,119541,Gupta; Rajesh K.,9999,0,9999,0
1668442938548,CSE 293,045,126410,Vaccaro; Kristen Marie,9999,0,9999,0
1668442938548,CSE 293,046,126411,Klemke; Richard,9999,0,9999,0
1668442938974,CSE 294,A00,102459,Voelker; Geoffrey M.,0,2,0,0
1668442938974,CSE 294,B00,111322,Orailoglu; Alex,0,0,0,0
1668442939404,DSE 201,A00,096914,Deutsch; Alin Bernard,30,0,30,0
1668442939844,DSE 210,A00,096915,Dasgupta; Sanjoy,30,0,30,0
1668442940270,DSE 260A,A00,096916,Altintas De Callaf; Ilkay,30,0,30,0
1668442940745,ECE 200,001,103586,Antipa; Nicholas A,9999,0,9999,0
1668442940745,ECE 200,002,103587,Atanasov; Nikolay A.,9999,0,9999,0
1668442940745,ECE 200,003,103588,Bharadia; Dinesh,9999,0,9999,0
1668442940745,ECE 200,004,103589,Cheng; Chung Kuan,9999,0,9999,0
1668442940745,ECE 200,005,103590,Cosman; Pamela C.,9999,0,9999,0
1668442940745,ECE 200,006,103591,Dayeh; Shadi Ahmad,9999,0,9999,0
1668442940745,ECE 200,007,103592,Fainman; Yeshaiahu,9999,0,9999,0
1668442940745,ECE 200,008,103593,Ford; Joseph Earl,9999,0,9999,0
1668442940745,ECE 200,009,103594,Franceschetti; Massimo,9999,0,9999,0
1668442940745,ECE 200,010,103595,Fullerton; Eric E,9999,0,9999,0
1668442940745,ECE 200,011,103596,Galton; Ian A,9999,0,9999,0
1668442940745,ECE 200,012,103597,Gilja; Vikash,9999,0,9999,0
1668442940745,ECE 200,013,103598,Hall; Drew A.,9999,0,9999,0
1668442940745,ECE 200,014,103599,Hsueh; Tzu-Chien,9999,0,9999,0
1668442940745,ECE 200,015,103600,Javidi; Tara,9999,0,9999,0
1668442940745,ECE 200,016,103601,Kahng; Andrew Byun,9999,0,9999,0
1668442940745,ECE 200,017,103602,Kim; Young-Han,9999,0,9999,0
1668442940745,ECE 200,018,103603,Koushanfar; Farinaz,9999,0,9999,0
1668442940745,ECE 200,019,103604,Kuzum; Duygu,9999,0,9999,0
1668442940745,ECE 200,020,103605,Le; Hanh-Phuc,9999,0,9999,0
1668442940745,ECE 200,021,103606,Lin; Bill,9999,0,9999,0
1668442940745,ECE 200,022,103607,Liu; Zhaowei,9998,0,9999,1
1668442940745,ECE 200,023,103608,Lo; Yu-Hwa,9999,0,9999,0
1668442940745,ECE 200,024,103609,Lomakin; Vitaliy,9999,0,9999,0
1668442940745,ECE 200,025,103610,Mercier; Patrick Philip,9999,0,9999,0
1668442940745,ECE 200,026,103611,Meyer; Florian,9999,0,9999,0
1668442940745,ECE 200,027,103612,Milstein; Laurence B.,9999,0,9999,0
1668442940745,ECE 200,028,103613,Mir Arabbaygi; Siavash,9999,0,9999,0
1668442940745,ECE 200,029,103614,Mookherjea; Shayan,9999,0,9999,0
1668442940745,ECE 200,030,103615,Morris; Karcher William,9999,0,9999,0
1668442940745,ECE 200,031,103616,Ng; Tse Nga,9999,0,9999,0
1668442940745,ECE 200,032,103617,Nguyen; Truong Quang,9999,0,9999,0
1668442940745,ECE 200,033,103618,Nomura; Kenji,9999,0,9999,0
1668442940745,ECE 200,034,103619,Orlitsky; Alon,9999,0,9999,0
1668442940745,ECE 200,035,103620,Pal; Piya,9999,0,9999,0
1668442940745,ECE 200,036,103621,Papen; George C.,9999,0,9999,0
1668442940745,ECE 200,037,103622,Radic; Stojan,9999,0,9999,0
1668442940745,ECE 200,038,103623,Rao; Bhaskar D.,9999,0,9999,0
1668442940745,ECE 200,039,103624,Rao; Ramesh R,9999,0,9999,0
1668442940745,ECE 200,040,103625,Rebeiz; Gabriel,9999,0,9999,0
1668442940745,ECE 200,041,103626,Sanford; John R,9999,0,9999,0
1668442940745,ECE 200,042,103627,Siegel; Paul H.,9999,0,9999,0
1668442940745,ECE 200,043,103628,Sievenpiper; Daniel F.,9999,0,9999,0
1668442940745,ECE 200,044,103629,Sworder; David D.,9999,0,9999,0
1668442940745,ECE 200,045,103630,Taur; Yuan,9999,0,9999,0
1668442940745,ECE 200,046,103631,Touri; Behrouz,9999,0,9999,0
1668442940745,ECE 200,047,103632,Trivedi; Mohan M.,9999,0,9999,0
1668442940745,ECE 200,048,103633,Vasconcelos; Nuno,9999,0,9999,0
1668442940745,ECE 200,049,103634,Wang; Xiaolong,9999,0,9999,0
1668442940745,ECE 200,050,103635,Xie; Pengtao,9999,0,9999,0
1668442940745,ECE 200,051,103636,Yip; Michael,9999,0,9999,0
1668442940745,ECE 200,052,103637,Zeger; Kenneth A.,999,0,999,0
1668442940745,ECE 200,053,103638,Zhang; Xinyu,9999,0,9999,0
1668442940745,ECE 200,054,103639,Turakhia; Yatish Girish,9999,0,9999,0
1668442940745,ECE 200,055,103640,Kang; Mingu,9999,0,9999,0
1668442940745,ECE 200,056,103641,Shi; Yuanyuan,9999,0,9999,0
1668442940745,ECE 200,057,103642,Wang; Edward Jay,9999,0,9999,0
1668442940745,ECE 200,058,103643,Zheng; Yang,9999,0,9999,0
1668442941169,ECE 202,A00,103644,Kuzum; Duygu,0,25,0,0
1668442941595,ECE 212BN,A00,103646,Ng; Tse Nga,0,1,0,0
1668442942026,ECE 221,A00,111493,Staff,0,0,0,0
1668442942449,ECE 222B,A00,103647,Lomakin; Vitaliy,0,5,0,0
1668442942875,ECE 230B,A00,103648,Taur; Yuan,0,0,0,0
1668442943301,ECE 238B,A00,103649,Garay; Javier,0,0,0,0
1668442943742,ECE 240B,A00,112900,Fainman; Yeshaiahu,0,4,0,0
1668442944165,ECE 247A,A00,103650,Jokerst; Jesse Vincent,0,2,0,0
1668442944597,ECE 247B,A00,103651,Wang; Joseph,0,7,0,0
1668442945023,ECE 250,A00,103652,Siegel; Paul H.,0,45,0,0
1668442945450,ECE 251A,A00,103654,Rao; Bhaskar D.,0,32,0,0
1668442945876,ECE 257B,A00,103655,Bharadia; Dinesh,0,15,0,0
1668442946303,ECE 258A,A00,103656,Milstein; Laurence B.,0,12,0,0
1668442946727,ECE 260B,A00,103658,Kang; Mingu,0,70,0,0
1668442947154,ECE 264A,A00,103659,Galton; Ian A,0,38,0,0
1668442947588,ECE 265A,A00,103661,Gudem; Prasad S.S.,0,21,0,0
1668442948014,ECE 265D,A00,103662,Gudem; Prasad S.S.,0,15,0,0
1668442948436,ECE 268,A00,103663,Koushanfar; Farinaz,0,23,0,0
1668442948864,ECE 269,A01,103665,Pal; Piya,0,140,0,0
1668442949291,ECE 271B,A00,103666,Vasconcelos; Manuela,0,49,0,0
1668442949714,ECE 276A,A00,103667,Atanasov; Nikolay A.,0,75,0,0
1668442950138,ECE 277,A00,103668,An; Cheolhong,0,95,0,0
1668442950569,ECE 279,A00,117947,Hall; Drew A.,0,13,0,0
1668442951442,ECE 283,A00,103670,Hsueh; Tzu-Chien,0,31,0,0
1668442951867,ECE 284,A00,103671,Turakhia; Yatish Girish,0,26,0,0
1668442952300,ECE 285,A00,103672,Zheng; Yang,0,25,0,0
1668442952300,ECE 285,B00,103673,Sworder; David D.,0,41,0,0
1668442952727,ECE 287,A00,103676,Javidi; Tara,0,4,0,0
1668442953155,MATH 200B,A00,098023,Salehi Golsefidy; Alireza,12,0,15,3
1668442953585,MATH 202B,A00,098024,Rhoades; Brendon Patrick,9,0,15,6
1668442954013,MATH 203B,A00,098025,Oprea; Dragos N.,10,0,15,5
1668442954438,MATH 204B,A00,098026,Sorensen; Claus M,13,0,15,2
1668442954861,MATH 208,A00,098027,Izadi; Elham,7,0,10,3
1668442955285,MATH 209,A00,098028,Pollack; Aaron,10,0,10,0
1668442955711,MATH 211A,A00,112919,Rogalski; Daniel,9,0,10,1
1668442956135,MATH 211B,A00,112920,Seward; Brandon M.,9,0,10,1
1668442956558,MATH 218,A00,098029,Li; Bo,10,0,10,0
1668442956979,MATH 220B,A00,098030,Novak; Jonathan I,11,0,15,4
1668442957414,MATH 221A,A00,098031,Ebenfelt; Peter F,13,0,15,2
1668442957849,MATH 231B,A00,098032,Zlatos; Andrej,11,0,15,4
1668442958274,MATH 240B,A00,098033,Ni; Lei,9,0,15,6
1668442958699,MATH 243,A00,098034,Jekel; David Andrew,10,0,10,0
1668442959136,MATH 245A,A00,098035,Nie; Jiawang,0,2,15,16
1668442959573,MATH 248,A00,098036,Bejenaru; Ioan,10,0,10,0
1668442960003,MATH 250B,A00,098037,Spolaor; Luca,14,0,15,1
1668442960440,MATH 258,A00,098038,Ni; Lei,10,0,10,0
1668442960863,MATH 264B,A00,098041,Rhoades; Brendon Patrick,9,0,15,6
1668442961288,MATH 268,A00,098042,Buss; Samuel R,10,0,10,0
1668442961727,MATH 269,A00,098043,Rhoades; Brendon Patrick,10,0,10,0
1668442962165,MATH 270B,A00,098044,Li; Bo,10,0,15,5
1668442962590,MATH 272B,A00,098045,Holst; Michael J,13,0,15,2
1668442963025,MATH 273A,A00,098046,Tian; Xiaochuan,10,0,15,5
1668442963464,MATH 275,A01,098048,Tian; Xiaochuan,6,0,10,4
1668442963905,MATH 278A,A00,098049,Holst; Michael J,8,0,10,2
1668442964331,MATH 278B,A00,098050,Cloninger; Alexander,10,0,10,0
1668442964758,MATH 278C,A00,098051,Nie; Jiawang,6,0,10,4
1668442965199,MATH 280B,A00,098052,Zheng; Tianyi,7,0,15,8
1668442965622,MATH 281B,A00,098053,Bradic; Jelena,0,1,15,15
1668442966049,MATH 282B,A00,098054,Arias-Castro; Ery,0,0,15,15
1668442966475,MATH 285,A00,098055,Fitzsimmons; Patrick J,0,1,15,17
1668442966913,MATH 287B,A00,098056,Arias-Castro; Ery,2,0,15,13
1668442967336,MATH 288,A00,098057,Agarwal; Pooja,9,0,10,1
1668442967336,MATH 288,B00,098058,Zhang; Danna,8,0,10,2
1668442967336,MATH 288,C00,098059,Williams; Ruth J,9,0,10,1
1668442967775,MATH 290B,A00,098060,Roberts; Justin Deritter,13,0,15,2
1668442968207,MATH 292,A00,098061,Belmont; Eva Kinoshita,10,0,10,0
1668442968718,MATH 295,A00,098062,Suk; Andrew Hoon,48,0,50,2
1668442969157,MATH 296,A00,098063,Novak; Jonathan I,20,0,20,0
1668442969581,MATH 297,001,098064,Gamst; Anthony Collins,9997,0,9999,2
1668443475072,COGS 205,A00,101395,Chiba; Andrea,19,0,20,1
1668443475501,COGS 210B,001,101404,Greene; Deanna Jacquelyn,9998,0,9999,1
1668443475501,COGS 210B,002,101417,Xia; Haijun,9999,0,9999,0
1668443475501,COGS 210B,003,101422,Nitz; Douglas A.,9999,0,9999,0
1668443475501,COGS 210B,004,101423,Hollan; James D.,9998,0,9999,1
1668443475501,COGS 210B,005,101424,Deak; Gedeon O.,9998,0,9999,1
1668443475501,COGS 210B,006,101425,Rossano; Federico,9999,0,9999,0
1668443475924,COGS 211B,A00,101427,Coulson; Seana M,9996,0,9999,3
1668443476347,COGS 220,A00,101428,Hollan; James D.,1,4,25,24
1668443476777,COGS 229,A00,101429,Dow; Steven P,18,0,25,7
1668443477203,COGS 230,A00,101430,Klemmer; Scott R,11,0,17,6
1668443477625,COGS 234,A00,101431,Xia; Haijun,2,0,25,23
1668443478048,COGS 260,A00,101432,Kiyonaga; Anastasia,21,0,25,4
1668443478048,COGS 260,B00,101433,Kirsh; David Joel,15,0,25,10
1668443478482,CSE 202,A00,102371,Impagliazzo; Russell,0,39,0,0
1668443478908,CSE 203B,A01,102373,Cheng; Chung Kuan,0,29,0,0
1668443479337,CSE 208,A00,102374,Micciancio; Daniele,0,1,0,0
1668443479766,CSE 209A,A00,112895,Impagliazzo; Russell,0,6,15,15
1668443480190,CSE 209B,A00,108005,Bellare; Mihir,0,3,0,0
1668443480617,CSE 210,A00,113163,Coblenz; Michael J,0,48,0,0
1668443481046,CSE 219,A00,106111,Dow; Steven P,0,0,20,20
1668443481501,CSE 221,A00,102376,Voelker; Geoffrey M.,0,35,0,0
1668443481929,CSE 224,A01,102378,Porter; George M,0,109,0,0
1668443482359,CSE 229A,A00,102379,Savage; Stefan,0,4,0,0
1668443482784,CSE 229C,A00,102380,Munyaka; Imani N. S.,0,4,0,0
1668443483210,CSE 232B,A00,102382,Deutsch; Alin Bernard,0,17,0,0
1668443483634,CSE 234,A01,112904,Kumar; Arun Kumar,0,0,0,0
1668443484077,CSE 237A,A00,102383,Rosing; Tajana Simunic,0,27,0,0
1668443484502,CSE 239A,A00,102384,Deutsch; Alin Bernard,0,6,0,0
1668443484927,CSE 239B,A00,102385,Polikarpova; Nadezhda,0,3,0,0
1668443485350,CSE 240A,A00,102386,Pannuto; Patrick William,0,30,0,0
1668443485785,CSE 240B,A00,102387,Zhao; Jishen,0,25,0,0
1668443486209,CSE 241A,A00,106406,Kang; Mingu,0,2,0,0
1668443486647,CSE 249B,A00,102388,Kahng; Andrew Byun,0,1,8,8
1668443487088,CSE 251B,A01,102392,Cottrell; Garrison W,0,28,0,0
1668443487088,CSE 251B,A02,102393,Cottrell; Garrison W,0,23,0,0
1668443487511,CSE 252B,A00,102394,Ochoa; Benjamin Lawrence,0,38,0,0
1668443487935,CSE 257,A01,102396,Gao; Sicun,0,90,0,0
1668443488369,CSE 272,A00,102397,Li; Tzumao,0,7,0,0
1668443488803,CSE 274,A00,111323,Chern; Albert Ren-Haur,0,7,0,0
1668443489228,CSE 282,A00,102398,Pevzner; Pavel Arkadjevich,0,0,0,0
1668443489654,CSE 284,A00,114175,Gymrek; Melissa Ann,0,13,0,0
1668443490092,CSE 290,A00,102399,Chandraker; Manmohan Krishna,0,4,0,0
1668443490092,CSE 290,B00,102400,Vaccaro; Kristen Marie,0,1,25,25
1668443490092,CSE 290,C00,102414,Pannuto; Patrick William,0,1,25,25
1668443490092,CSE 290,D00,102427,Pevzner; Pavel Arkadjevich,0,0,0,0
1668443490092,CSE 290,E00,102429,Zhao; Jishen,0,2,0,0
1668443490092,CSE 290,F00,102436,Tullsen; Dean Michael,0,4,0,0
1668443490092,CSE 290,G00,102440,Christensen; Henrik I,0,3,20,20
1668443490525,CSE 291,A00,102443,Su; Hao,0,0,0,0
1668443490525,CSE 291,B00,102448,Polikarpova; Nadezhda,0,0,0,0
1668443490525,CSE 291,C00,102453,Vaccaro; Kristen Marie,0,0,0,0
1668443490525,CSE 291,D00,111343,Savage; Stefan,0,0,0,0
1668443490525,CSE 291,E00,116474,Claffy; Kimberly Claire,0,0,0,0
1668443490525,CSE 291,F00,116479,Pasquale; Joseph,0,0,0,0
1668443490962,CSE 293,001,119111,Bafna; Vineet,9999,0,9999,0
1668443490962,CSE 293,002,119118,Bellare; Mihir,9999,0,9999,0
1668443490962,CSE 293,003,119122,Berg-Kirkpatrick; Taylor D,9999,0,9999,0
1668443490962,CSE 293,004,119135,Christensen; Henrik I,9999,0,9999,0
1668443490962,CSE 293,005,119142,Cottrell; Garrison W,9999,0,9999,0
1668443490962,CSE 293,006,119146,Deutsch; Alin Bernard,9999,0,9999,0
1668443490962,CSE 293,007,119159,Esmaeilzadeh; Hadi,9999,0,9999,0
1668443490962,CSE 293,008,119166,Freund; Yoav,9999,0,9999,0
1668443490962,CSE 293,009,119170,Griswold; William G.,9999,0,9999,0
1668443490962,CSE 293,010,119183,Gymrek; Melissa Ann,9999,0,9999,0
1668443490962,CSE 293,011,119190,Heninger; Nadia A,9999,0,9999,0
1668443490962,CSE 293,012,119230,Impagliazzo; Russell,9999,0,9999,0
1668443490962,CSE 293,013,119232,Jhala; Ranjit,9999,0,9999,0
1668443490962,CSE 293,014,119233,Kahng; Andrew Byun,9999,0,9999,0
1668443490962,CSE 293,015,119298,Kane; Daniel Mertz,9999,0,9999,0
1668443490962,CSE 293,016,119299,Kriegman; David J,9999,0,9999,0
1668443490962,CSE 293,017,119300,Kumar; Arun Kumar,9999,0,9999,0
1668443490962,CSE 293,018,119301,Lerner; Sorin,9999,0,9999,0
1668443490962,CSE 293,019,119302,Lovett; Shachar,9999,0,9999,0
1668443490962,CSE 293,020,119303,McAuley; Julian John,9999,0,9999,0
1668443490962,CSE 293,021,119304,Micciancio; Daniele,9999,0,9999,0
1668443490962,CSE 293,022,119367,Orailoglu; Alex,9999,0,9999,0
1668443490962,CSE 293,023,119382,Paturi; Ramamohan,9999,0,9999,0
1668443490962,CSE 293,024,119404,Polikarpova; Nadezhda,9999,0,9999,0
1668443490962,CSE 293,025,119406,Politz; Joseph Gibbs,9999,0,9999,0
1668443490962,CSE 293,026,119411,Porter; George M,9999,0,9999,0
1668443490962,CSE 293,027,119414,Porter; Leonard Emerson,9999,0,9999,0
1668443490962,CSE 293,028,119416,Ramamoorthi; Ravi,9999,0,9999,0
1668443490962,CSE 293,029,119417,Sahoo; Debashis,9999,0,9999,0
1668443490962,CSE 293,030,119420,Saul; Lawrence,9999,0,9999,0
1668443490962,CSE 293,031,119421,Savage; Stefan,9999,0,9999,0
1668443490962,CSE 293,032,119425,Schulze; Jurgen P.,9999,0,9999,0
1668443490962,CSE 293,033,119426,Snoeren; Alex C.,9999,0,9999,0
1668443490962,CSE 293,034,119428,Shang; Jingbo,9999,0,9999,0
1668443490962,CSE 293,035,119430,Stefan; Deian,9999,0,9999,0
1668443490962,CSE 293,036,119431,Su; Hao,9999,0,9999,0
1668443490962,CSE 293,037,119433,Swanson; Steven James,9999,0,9999,0
1668443490962,CSE 293,038,119435,Tullsen; Dean Michael,9999,0,9999,0
1668443490962,CSE 293,039,119483,Voelker; Geoffrey M.,9999,0,9999,0
1668443490962,CSE 293,040,119537,Zhao; Jishen,9999,0,9999,0
1668443490962,CSE 293,041,119538,Zhou; Yuan-Yuan,9999,0,9999,0
1668443490962,CSE 293,042,119539,Gao; Sicun,9999,0,9999,0
1668443490962,CSE 293,043,119540,Weibel; Nadir,9999,0,9999,0
1668443490962,CSE 293,044,119541,Gupta; Rajesh K.,9999,0,9999,0
1668443490962,CSE 293,045,126410,Vaccaro; Kristen Marie,9999,0,9999,0
1668443490962,CSE 293,046,126411,Klemke; Richard,9999,0,9999,0
1668443491400,CSE 294,A00,102459,Voelker; Geoffrey M.,0,2,0,0
1668443491400,CSE 294,B00,111322,Orailoglu; Alex,0,0,0,0
1668443491823,DSE 201,A00,096914,Deutsch; Alin Bernard,30,0,30,0
1668443492249,DSE 210,A00,096915,Dasgupta; Sanjoy,30,0,30,0
1668443492683,DSE 260A,A00,096916,Altintas De Callaf; Ilkay,30,0,30,0
1668443493141,ECE 200,001,103586,Antipa; Nicholas A,9999,0,9999,0
1668443493141,ECE 200,002,103587,Atanasov; Nikolay A.,9999,0,9999,0
1668443493141,ECE 200,003,103588,Bharadia; Dinesh,9999,0,9999,0
1668443493141,ECE 200,004,103589,Cheng; Chung Kuan,9999,0,9999,0
1668443493141,ECE 200,005,103590,Cosman; Pamela C.,9999,0,9999,0
1668443493141,ECE 200,006,103591,Dayeh; Shadi Ahmad,9999,0,9999,0
1668443493141,ECE 200,007,103592,Fainman; Yeshaiahu,9999,0,9999,0
1668443493141,ECE 200,008,103593,Ford; Joseph Earl,9999,0,9999,0
1668443493141,ECE 200,009,103594,Franceschetti; Massimo,9999,0,9999,0
1668443493141,ECE 200,010,103595,Fullerton; Eric E,9999,0,9999,0
1668443493141,ECE 200,011,103596,Galton; Ian A,9999,0,9999,0
1668443493141,ECE 200,012,103597,Gilja; Vikash,9999,0,9999,0
1668443493141,ECE 200,013,103598,Hall; Drew A.,9999,0,9999,0
1668443493141,ECE 200,014,103599,Hsueh; Tzu-Chien,9999,0,9999,0
1668443493141,ECE 200,015,103600,Javidi; Tara,9999,0,9999,0
1668443493141,ECE 200,016,103601,Kahng; Andrew Byun,9999,0,9999,0
1668443493141,ECE 200,017,103602,Kim; Young-Han,9999,0,9999,0
1668443493141,ECE 200,018,103603,Koushanfar; Farinaz,9999,0,9999,0
1668443493141,ECE 200,019,103604,Kuzum; Duygu,9999,0,9999,0
1668443493141,ECE 200,020,103605,Le; Hanh-Phuc,9999,0,9999,0
1668443493141,ECE 200,021,103606,Lin; Bill,9999,0,9999,0
1668443493141,ECE 200,022,103607,Liu; Zhaowei,9998,0,9999,1
1668443493141,ECE 200,023,103608,Lo; Yu-Hwa,9999,0,9999,0
1668443493141,ECE 200,024,103609,Lomakin; Vitaliy,9999,0,9999,0
1668443493141,ECE 200,025,103610,Mercier; Patrick Philip,9999,0,9999,0
1668443493141,ECE 200,026,103611,Meyer; Florian,9999,0,9999,0
1668443493141,ECE 200,027,103612,Milstein; Laurence B.,9999,0,9999,0
1668443493141,ECE 200,028,103613,Mir Arabbaygi; Siavash,9999,0,9999,0
1668443493141,ECE 200,029,103614,Mookherjea; Shayan,9999,0,9999,0
1668443493141,ECE 200,030,103615,Morris; Karcher William,9999,0,9999,0
1668443493141,ECE 200,031,103616,Ng; Tse Nga,9999,0,9999,0
1668443493141,ECE 200,032,103617,Nguyen; Truong Quang,9999,0,9999,0
1668443493141,ECE 200,033,103618,Nomura; Kenji,9999,0,9999,0
1668443493141,ECE 200,034,103619,Orlitsky; Alon,9999,0,9999,0
1668443493141,ECE 200,035,103620,Pal; Piya,9999,0,9999,0
1668443493141,ECE 200,036,103621,Papen; George C.,9999,0,9999,0
1668443493141,ECE 200,037,103622,Radic; Stojan,9999,0,9999,0
1668443493141,ECE 200,038,103623,Rao; Bhaskar D.,9999,0,9999,0
1668443493141,ECE 200,039,103624,Rao; Ramesh R,9999,0,9999,0
1668443493141,ECE 200,040,103625,Rebeiz; Gabriel,9999,0,9999,0
1668443493141,ECE 200,041,103626,Sanford; John R,9999,0,9999,0
1668443493141,ECE 200,042,103627,Siegel; Paul H.,9999,0,9999,0
1668443493141,ECE 200,043,103628,Sievenpiper; Daniel F.,9999,0,9999,0
1668443493141,ECE 200,044,103629,Sworder; David D.,9999,0,9999,0
1668443493141,ECE 200,045,103630,Taur; Yuan,9999,0,9999,0
1668443493141,ECE 200,046,103631,Touri; Behrouz,9999,0,9999,0
1668443493141,ECE 200,047,103632,Trivedi; Mohan M.,9999,0,9999,0
1668443493141,ECE 200,048,103633,Vasconcelos; Nuno,9999,0,9999,0
1668443493141,ECE 200,049,103634,Wang; Xiaolong,9999,0,9999,0
1668443493141,ECE 200,050,103635,Xie; Pengtao,9999,0,9999,0
1668443493141,ECE 200,051,103636,Yip; Michael,9999,0,9999,0
1668443493141,ECE 200,052,103637,Zeger; Kenneth A.,999,0,999,0
1668443493141,ECE 200,053,103638,Zhang; Xinyu,9999,0,9999,0
1668443493141,ECE 200,054,103639,Turakhia; Yatish Girish,9999,0,9999,0
1668443493141,ECE 200,055,103640,Kang; Mingu,9999,0,9999,0
1668443493141,ECE 200,056,103641,Shi; Yuanyuan,9999,0,9999,0
1668443493141,ECE 200,057,103642,Wang; Edward Jay,9999,0,9999,0
1668443493141,ECE 200,058,103643,Zheng; Yang,9999,0,9999,0
1668443493704,ECE 202,A00,103644,Kuzum; Duygu,0,25,0,0
1668443494138,ECE 212BN,A00,103646,Ng; Tse Nga,0,1,0,0
1668443494562,ECE 221,A00,111493,Staff,0,0,0,0
1668443494986,ECE 222B,A00,103647,Lomakin; Vitaliy,0,5,0,0
1668443495416,ECE 230B,A00,103648,Taur; Yuan,0,0,0,0
1668443495839,ECE 238B,A00,103649,Garay; Javier,0,0,0,0
1668443496265,ECE 240B,A00,112900,Fainman; Yeshaiahu,0,4,0,0
1668443496691,ECE 247A,A00,103650,Jokerst; Jesse Vincent,0,2,0,0
1668443497137,ECE 247B,A00,103651,Wang; Joseph,0,7,0,0
1668443497560,ECE 250,A00,103652,Siegel; Paul H.,0,47,0,0
1668443497990,ECE 251A,A00,103654,Rao; Bhaskar D.,0,33,0,0
1668443498414,ECE 257B,A00,103655,Bharadia; Dinesh,0,16,0,0
1668443498840,ECE 258A,A00,103656,Milstein; Laurence B.,0,12,0,0
1668443499269,ECE 260B,A00,103658,Kang; Mingu,0,72,0,0
1668443499697,ECE 264A,A00,103659,Galton; Ian A,0,39,0,0
1668443500125,ECE 265A,A00,103661,Gudem; Prasad S.S.,0,21,0,0
1668443500550,ECE 265D,A00,103662,Gudem; Prasad S.S.,0,15,0,0
1668443500982,ECE 268,A00,103663,Koushanfar; Farinaz,0,24,0,0
1668443501406,ECE 269,A01,103665,Pal; Piya,0,142,0,0
1668443501828,ECE 271B,A00,103666,Vasconcelos; Manuela,0,50,0,0
1668443502271,ECE 276A,A00,103667,Atanasov; Nikolay A.,0,76,0,0
1668443502694,ECE 277,A00,103668,An; Cheolhong,0,95,0,0
1668443503121,ECE 279,A00,117947,Hall; Drew A.,0,13,0,0
1668443503982,ECE 283,A00,103670,Hsueh; Tzu-Chien,0,31,0,0
1668443504410,ECE 284,A00,103671,Turakhia; Yatish Girish,0,26,0,0
1668443504851,ECE 285,A00,103672,Zheng; Yang,0,25,0,0
1668443504851,ECE 285,B00,103673,Sworder; David D.,0,41,0,0
1668443505275,ECE 287,A00,103676,Javidi; Tara,0,4,0,0
1668443505698,MATH 200B,A00,098023,Salehi Golsefidy; Alireza,12,0,15,3
1668443506128,MATH 202B,A00,098024,Rhoades; Brendon Patrick,9,0,15,6
1668443506561,MATH 203B,A00,098025,Oprea; Dragos N.,10,0,15,5
1668443506985,MATH 204B,A00,098026,Sorensen; Claus M,13,0,15,2
1668443507408,MATH 208,A00,098027,Izadi; Elham,7,0,10,3
1668443507843,MATH 209,A00,098028,Pollack; Aaron,10,0,10,0
1668443508276,MATH 211A,A00,112919,Rogalski; Daniel,9,0,10,1
1668443508702,MATH 211B,A00,112920,Seward; Brandon M.,9,0,10,1
1668443509131,MATH 218,A00,098029,Li; Bo,10,0,10,0
1668443509568,MATH 220B,A00,098030,Novak; Jonathan I,11,0,15,4
1668443509992,MATH 221A,A00,098031,Ebenfelt; Peter F,13,0,15,2
1668443510429,MATH 231B,A00,098032,Zlatos; Andrej,11,0,15,4
1668443510855,MATH 240B,A00,098033,Ni; Lei,9,0,15,6
1668443511281,MATH 243,A00,098034,Jekel; David Andrew,10,0,10,0
1668443511704,MATH 245A,A00,098035,Nie; Jiawang,0,2,15,16
1668443512131,MATH 248,A00,098036,Bejenaru; Ioan,10,0,10,0
1668443512565,MATH 250B,A00,098037,Spolaor; Luca,14,0,15,1
1668443512991,MATH 258,A00,098038,Ni; Lei,10,0,10,0
1668443513415,MATH 264B,A00,098041,Rhoades; Brendon Patrick,9,0,15,6
1668443513840,MATH 268,A00,098042,Buss; Samuel R,10,0,10,0
1668443514270,MATH 269,A00,098043,Rhoades; Brendon Patrick,10,0,10,0
1668443514695,MATH 270B,A00,098044,Li; Bo,10,0,15,5
1668443515119,MATH 272B,A00,098045,Holst; Michael J,13,0,15,2
1668443515546,MATH 273A,A00,098046,Tian; Xiaochuan,10,0,15,5
1668443515970,MATH 275,A01,098048,Tian; Xiaochuan,6,0,10,4
1668443516397,MATH 278A,A00,098049,Holst; Michael J,8,0,10,2
1668443516820,MATH 278B,A00,098050,Cloninger; Alexander,10,0,10,0
1668443517249,MATH 278C,A00,098051,Nie; Jiawang,6,0,10,4
1668443517675,MATH 280B,A00,098052,Zheng; Tianyi,7,0,15,8
1668443518109,MATH 281B,A00,098053,Bradic; Jelena,0,1,15,15
1668443518539,MATH 282B,A00,098054,Arias-Castro; Ery,0,0,15,15
1668443518969,MATH 285,A00,098055,Fitzsimmons; Patrick J,0,1,15,17
1668443519393,MATH 287B,A00,098056,Arias-Castro; Ery,2,0,15,13
1668443519816,MATH 288,A00,098057,Agarwal; Pooja,9,0,10,1
1668443519816,MATH 288,B00,098058,Zhang; Danna,8,0,10,2
1668443519816,MATH 288,C00,098059,Williams; Ruth J,9,0,10,1
1668443520240,MATH 290B,A00,098060,Roberts; Justin Deritter,13,0,15,2
1668443520667,MATH 292,A00,098061,Belmont; Eva Kinoshita,10,0,10,0
1668443521088,MATH 295,A00,098062,Suk; Andrew Hoon,48,0,50,2
1668443521527,MATH 296,A00,098063,Novak; Jonathan I,20,0,20,0
1668443521961,MATH 297,001,098064,Gamst; Anthony Collins,9997,0,9999,2
1668444027229,COGS 205,A00,101395,Chiba; Andrea,19,0,20,1
1668444027661,COGS 210B,001,101404,Greene; Deanna Jacquelyn,9998,0,9999,1
1668444027661,COGS 210B,002,101417,Xia; Haijun,9999,0,9999,0
1668444027661,COGS 210B,003,101422,Nitz; Douglas A.,9999,0,9999,0
1668444027661,COGS 210B,004,101423,Hollan; James D.,9998,0,9999,1
1668444027661,COGS 210B,005,101424,Deak; Gedeon O.,9998,0,9999,1
1668444027661,COGS 210B,006,101425,Rossano; Federico,9999,0,9999,0
1668444028086,COGS 211B,A00,101427,Coulson; Seana M,9996,0,9999,3
1668444028509,COGS 220,A00,101428,Hollan; James D.,1,4,25,24
1668444028936,COGS 229,A00,101429,Dow; Steven P,18,0,25,7
1668444029358,COGS 230,A00,101430,Klemmer; Scott R,11,0,17,6
1668444029780,COGS 234,A00,101431,Xia; Haijun,2,0,25,23
1668444030205,COGS 260,A00,101432,Kiyonaga; Anastasia,21,0,25,4
1668444030205,COGS 260,B00,101433,Kirsh; David Joel,15,0,25,10
1668444030636,CSE 202,A00,102371,Impagliazzo; Russell,0,40,0,0
1668444031063,CSE 203B,A01,102373,Cheng; Chung Kuan,0,29,0,0
1668444031489,CSE 208,A00,102374,Micciancio; Daniele,0,2,0,0
1668444031913,CSE 209A,A00,112895,Impagliazzo; Russell,0,7,15,15
1668444032339,CSE 209B,A00,108005,Bellare; Mihir,0,3,0,0
1668444032777,CSE 210,A00,113163,Coblenz; Michael J,0,48,0,0
1668444033213,CSE 219,A00,106111,Dow; Steven P,0,0,20,20
1668444033637,CSE 221,A00,102376,Voelker; Geoffrey M.,0,36,0,0
1668444034072,CSE 224,A01,102378,Porter; George M,0,109,0,0
1668444034495,CSE 229A,A00,102379,Savage; Stefan,0,4,0,0
1668444034922,CSE 229C,A00,102380,Munyaka; Imani N. S.,0,4,0,0
1668444035346,CSE 232B,A00,102382,Deutsch; Alin Bernard,0,17,0,0
1668444035788,CSE 234,A01,112904,Kumar; Arun Kumar,0,0,0,0
1668444036215,CSE 237A,A00,102383,Rosing; Tajana Simunic,0,28,0,0
1668444036638,CSE 239A,A00,102384,Deutsch; Alin Bernard,0,6,0,0
1668444037069,CSE 239B,A00,102385,Polikarpova; Nadezhda,0,3,0,0
1668444037491,CSE 240A,A00,102386,Pannuto; Patrick William,0,30,0,0
1668444037914,CSE 240B,A00,102387,Zhao; Jishen,0,28,0,0
1668444038343,CSE 241A,A00,106406,Kang; Mingu,0,4,0,0
1668444038775,CSE 249B,A00,102388,Kahng; Andrew Byun,0,1,8,8
1668444039210,CSE 251B,A01,102392,Cottrell; Garrison W,0,28,0,0
1668444039210,CSE 251B,A02,102393,Cottrell; Garrison W,0,23,0,0
1668444039637,CSE 252B,A00,102394,Ochoa; Benjamin Lawrence,0,39,0,0
1668444040064,CSE 257,A01,102396,Gao; Sicun,0,91,0,0
1668444040490,CSE 272,A00,102397,Li; Tzumao,0,8,0,0
1668444040914,CSE 274,A00,111323,Chern; Albert Ren-Haur,0,8,0,0
1668444041339,CSE 282,A00,102398,Pevzner; Pavel Arkadjevich,0,0,0,0
1668444041761,CSE 284,A00,114175,Gymrek; Melissa Ann,0,14,0,0
1668444042197,CSE 290,A00,102399,Chandraker; Manmohan Krishna,0,4,0,0
1668444042197,CSE 290,B00,102400,Vaccaro; Kristen Marie,0,1,25,25
1668444042197,CSE 290,C00,102414,Pannuto; Patrick William,0,1,25,25
1668444042197,CSE 290,D00,102427,Pevzner; Pavel Arkadjevich,0,0,0,0
1668444042197,CSE 290,E00,102429,Zhao; Jishen,0,2,0,0
1668444042197,CSE 290,F00,102436,Tullsen; Dean Michael,0,4,0,0
1668444042197,CSE 290,G00,102440,Christensen; Henrik I,0,3,20,20
1668444042628,CSE 291,A00,102443,Su; Hao,0,0,0,0
1668444042628,CSE 291,B00,102448,Polikarpova; Nadezhda,0,0,0,0
1668444042628,CSE 291,C00,102453,Vaccaro; Kristen Marie,0,0,0,0
1668444042628,CSE 291,D00,111343,Savage; Stefan,0,0,0,0
1668444042628,CSE 291,E00,116474,Claffy; Kimberly Claire,0,0,0,0
1668444042628,CSE 291,F00,116479,Pasquale; Joseph,0,0,0,0
1668444043059,CSE 293,001,119111,Bafna; Vineet,9999,0,9999,0
1668444043059,CSE 293,002,119118,Bellare; Mihir,9999,0,9999,0
1668444043059,CSE 293,003,119122,Berg-Kirkpatrick; Taylor D,9999,0,9999,0
1668444043059,CSE 293,004,119135,Christensen; Henrik I,9999,0,9999,0
1668444043059,CSE 293,005,119142,Cottrell; Garrison W,9999,0,9999,0
1668444043059,CSE 293,006,119146,Deutsch; Alin Bernard,9999,0,9999,0
1668444043059,CSE 293,007,119159,Esmaeilzadeh; Hadi,9999,0,9999,0
1668444043059,CSE 293,008,119166,Freund; Yoav,9999,0,9999,0
1668444043059,CSE 293,009,119170,Griswold; William G.,9999,0,9999,0
1668444043059,CSE 293,010,119183,Gymrek; Melissa Ann,9999,0,9999,0
1668444043059,CSE 293,011,119190,Heninger; Nadia A,9999,0,9999,0
1668444043059,CSE 293,012,119230,Impagliazzo; Russell,9999,0,9999,0
1668444043059,CSE 293,013,119232,Jhala; Ranjit,9999,0,9999,0
1668444043059,CSE 293,014,119233,Kahng; Andrew Byun,9999,0,9999,0
1668444043059,CSE 293,015,119298,Kane; Daniel Mertz,9999,0,9999,0
1668444043059,CSE 293,016,119299,Kriegman; David J,9999,0,9999,0
1668444043059,CSE 293,017,119300,Kumar; Arun Kumar,9999,0,9999,0
1668444043059,CSE 293,018,119301,Lerner; Sorin,9999,0,9999,0
1668444043059,CSE 293,019,119302,Lovett; Shachar,9999,0,9999,0
1668444043059,CSE 293,020,119303,McAuley; Julian John,9999,0,9999,0
1668444043059,CSE 293,021,119304,Micciancio; Daniele,9999,0,9999,0
1668444043059,CSE 293,022,119367,Orailoglu; Alex,9999,0,9999,0
1668444043059,CSE 293,023,119382,Paturi; Ramamohan,9999,0,9999,0
1668444043059,CSE 293,024,119404,Polikarpova; Nadezhda,9999,0,9999,0
1668444043059,CSE 293,025,119406,Politz; Joseph Gibbs,9999,0,9999,0
1668444043059,CSE 293,026,119411,Porter; George M,9999,0,9999,0
1668444043059,CSE 293,027,119414,Porter; Leonard Emerson,9999,0,9999,0
1668444043059,CSE 293,028,119416,Ramamoorthi; Ravi,9999,0,9999,0
1668444043059,CSE 293,029,119417,Sahoo; Debashis,9999,0,9999,0
1668444043059,CSE 293,030,119420,Saul; Lawrence,9999,0,9999,0
1668444043059,CSE 293,031,119421,Savage; Stefan,9999,0,9999,0
1668444043059,CSE 293,032,119425,Schulze; Jurgen P.,9999,0,9999,0
1668444043059,CSE 293,033,119426,Snoeren; Alex C.,9999,0,9999,0
1668444043059,CSE 293,034,119428,Shang; Jingbo,9999,0,9999,0
1668444043059,CSE 293,035,119430,Stefan; Deian,9999,0,9999,0
1668444043059,CSE 293,036,119431,Su; Hao,9999,0,9999,0
1668444043059,CSE 293,037,119433,Swanson; Steven James,9999,0,9999,0
1668444043059,CSE 293,038,119435,Tullsen; Dean Michael,9999,0,9999,0
1668444043059,CSE 293,039,119483,Voelker; Geoffrey M.,9999,0,9999,0
1668444043059,CSE 293,040,119537,Zhao; Jishen,9999,0,9999,0
1668444043059,CSE 293,041,119538,Zhou; Yuan-Yuan,9999,0,9999,0
1668444043059,CSE 293,042,119539,Gao; Sicun,9999,0,9999,0
1668444043059,CSE 293,043,119540,Weibel; Nadir,9999,0,9999,0
1668444043059,CSE 293,044,119541,Gupta; Rajesh K.,9999,0,9999,0
1668444043059,CSE 293,045,126410,Vaccaro; Kristen Marie,9999,0,9999,0
1668444043059,CSE 293,046,126411,Klemke; Richard,9999,0,9999,0
1668444043481,CSE 294,A00,102459,Voelker; Geoffrey M.,0,2,0,0
1668444043481,CSE 294,B00,111322,Orailoglu; Alex,0,0,0,0
1668444043908,DSE 201,A00,096914,Deutsch; Alin Bernard,30,0,30,0
1668444044333,DSE 210,A00,096915,Dasgupta; Sanjoy,30,0,30,0
1668444044769,DSE 260A,A00,096916,Altintas De Callaf; Ilkay,30,0,30,0
1668444045230,ECE 200,001,103586,Antipa; Nicholas A,9999,0,9999,0
1668444045230,ECE 200,002,103587,Atanasov; Nikolay A.,9999,0,9999,0
1668444045230,ECE 200,003,103588,Bharadia; Dinesh,9999,0,9999,0
1668444045230,ECE 200,004,103589,Cheng; Chung Kuan,9999,0,9999,0
1668444045230,ECE 200,005,103590,Cosman; Pamela C.,9999,0,9999,0
1668444045230,ECE 200,006,103591,Dayeh; Shadi Ahmad,9999,0,9999,0
1668444045230,ECE 200,007,103592,Fainman; Yeshaiahu,9999,0,9999,0
1668444045230,ECE 200,008,103593,Ford; Joseph Earl,9999,0,9999,0
1668444045230,ECE 200,009,103594,Franceschetti; Massimo,9999,0,9999,0
1668444045230,ECE 200,010,103595,Fullerton; Eric E,9999,0,9999,0
1668444045230,ECE 200,011,103596,Galton; Ian A,9999,0,9999,0
1668444045230,ECE 200,012,103597,Gilja; Vikash,9999,0,9999,0
1668444045230,ECE 200,013,103598,Hall; Drew A.,9999,0,9999,0
1668444045230,ECE 200,014,103599,Hsueh; Tzu-Chien,9999,0,9999,0
1668444045230,ECE 200,015,103600,Javidi; Tara,9999,0,9999,0
1668444045230,ECE 200,016,103601,Kahng; Andrew Byun,9999,0,9999,0
1668444045230,ECE 200,017,103602,Kim; Young-Han,9999,0,9999,0
1668444045230,ECE 200,018,103603,Koushanfar; Farinaz,9999,0,9999,0
1668444045230,ECE 200,019,103604,Kuzum; Duygu,9999,0,9999,0
1668444045230,ECE 200,020,103605,Le; Hanh-Phuc,9999,0,9999,0
1668444045230,ECE 200,021,103606,Lin; Bill,9999,0,9999,0
1668444045230,ECE 200,022,103607,Liu; Zhaowei,9998,0,9999,1
1668444045230,ECE 200,023,103608,Lo; Yu-Hwa,9999,0,9999,0
1668444045230,ECE 200,024,103609,Lomakin; Vitaliy,9999,0,9999,0
1668444045230,ECE 200,025,103610,Mercier; Patrick Philip,9999,0,9999,0
1668444045230,ECE 200,026,103611,Meyer; Florian,9999,0,9999,0
1668444045230,ECE 200,027,103612,Milstein; Laurence B.,9999,0,9999,0
1668444045230,ECE 200,028,103613,Mir Arabbaygi; Siavash,9999,0,9999,0
1668444045230,ECE 200,029,103614,Mookherjea; Shayan,9999,0,9999,0
1668444045230,ECE 200,030,103615,Morris; Karcher William,9999,0,9999,0
1668444045230,ECE 200,031,103616,Ng; Tse Nga,9999,0,9999,0
1668444045230,ECE 200,032,103617,Nguyen; Truong Quang,9999,0,9999,0
1668444045230,ECE 200,033,103618,Nomura; Kenji,9999,0,9999,0
1668444045230,ECE 200,034,103619,Orlitsky; Alon,9999,0,9999,0
1668444045230,ECE 200,035,103620,Pal; Piya,9999,0,9999,0
1668444045230,ECE 200,036,103621,Papen; George C.,9999,0,9999,0
1668444045230,ECE 200,037,103622,Radic; Stojan,9999,0,9999,0
1668444045230,ECE 200,038,103623,Rao; Bhaskar D.,9999,0,9999,0
1668444045230,ECE 200,039,103624,Rao; Ramesh R,9999,0,9999,0
1668444045230,ECE 200,040,103625,Rebeiz; Gabriel,9999,0,9999,0
1668444045230,ECE 200,041,103626,Sanford; John R,9999,0,9999,0
1668444045230,ECE 200,042,103627,Siegel; Paul H.,9999,0,9999,0
1668444045230,ECE 200,043,103628,Sievenpiper; Daniel F.,9999,0,9999,0
1668444045230,ECE 200,044,103629,Sworder; David D.,9999,0,9999,0
1668444045230,ECE 200,045,103630,Taur; Yuan,9999,0,9999,0
1668444045230,ECE 200,046,103631,Touri; Behrouz,9999,0,9999,0
1668444045230,ECE 200,047,103632,Trivedi; Mohan M.,9999,0,9999,0
1668444045230,ECE 200,048,103633,Vasconcelos; Nuno,9999,0,9999,0
1668444045230,ECE 200,049,103634,Wang; Xiaolong,9999,0,9999,0
1668444045230,ECE 200,050,103635,Xie; Pengtao,9999,0,9999,0
1668444045230,ECE 200,051,103636,Yip; Michael,9999,0,9999,0
1668444045230,ECE 200,052,103637,Zeger; Kenneth A.,999,0,999,0
1668444045230,ECE 200,053,103638,Zhang; Xinyu,9999,0,9999,0
1668444045230,ECE 200,054,103639,Turakhia; Yatish Girish,9999,0,9999,0
1668444045230,ECE 200,055,103640,Kang; Mingu,9999,0,9999,0
1668444045230,ECE 200,056,103641,Shi; Yuanyuan,9999,0,9999,0
1668444045230,ECE 200,057,103642,Wang; Edward Jay,9999,0,9999,0
1668444045230,ECE 200,058,103643,Zheng; Yang,9999,0,9999,0
1668444045652,ECE 202,A00,103644,Kuzum; Duygu,0,25,0,0
1668444046077,ECE 212BN,A00,103646,Ng; Tse Nga,0,1,0,0
1668444046507,ECE 221,A00,111493,Staff,0,0,0,0
1668444046951,ECE 222B,A00,103647,Lomakin; Vitaliy,0,5,0,0
1668444047381,ECE 230B,A00,103648,Taur; Yuan,0,0,0,0
1668444047811,ECE 238B,A00,103649,Garay; Javier,0,0,0,0
1668444048234,ECE 240B,A00,112900,Fainman; Yeshaiahu,0,4,0,0
1668444048662,ECE 247A,A00,103650,Jokerst; Jesse Vincent,0,2,0,0
1668444049105,ECE 247B,A00,103651,Wang; Joseph,0,7,0,0
1668444049531,ECE 250,A00,103652,Siegel; Paul H.,0,47,0,0
1668444049955,ECE 251A,A00,103654,Rao; Bhaskar D.,0,33,0,0
1668444050391,ECE 257B,A00,103655,Bharadia; Dinesh,0,16,0,0
1668444050819,ECE 258A,A00,103656,Milstein; Laurence B.,0,12,0,0
1668444051247,ECE 260B,A00,103658,Kang; Mingu,0,73,0,0
1668444051700,ECE 264A,A00,103659,Galton; Ian A,0,39,0,0
1668444052125,ECE 265A,A00,103661,Gudem; Prasad S.S.,0,22,0,0
1668444052550,ECE 265D,A00,103662,Gudem; Prasad S.S.,0,15,0,0
1668444052975,ECE 268,A00,103663,Koushanfar; Farinaz,0,24,0,0
1668444053404,ECE 269,A01,103665,Pal; Piya,0,142,0,0
1668444053827,ECE 271B,A00,103666,Vasconcelos; Manuela,0,50,0,0
1668444054256,ECE 276A,A00,103667,Atanasov; Nikolay A.,0,76,0,0
1668444054680,ECE 277,A00,103668,An; Cheolhong,0,97,0,0
1668444055113,ECE 279,A00,117947,Hall; Drew A.,0,14,0,0
1668444055966,ECE 283,A00,103670,Hsueh; Tzu-Chien,0,32,0,0
1668444056406,ECE 284,A00,103671,Turakhia; Yatish Girish,0,28,0,0
1668444056831,ECE 285,A00,103672,Zheng; Yang,0,25,0,0
1668444056831,ECE 285,B00,103673,Sworder; David D.,0,41,0,0
1668444057261,ECE 287,A00,103676,Javidi; Tara,0,4,0,0
1668444057690,MATH 200B,A00,098023,Salehi Golsefidy; Alireza,12,0,15,3
1668444058117,MATH 202B,A00,098024,Rhoades; Brendon Patrick,9,0,15,6
1668444058541,MATH 203B,A00,098025,Oprea; Dragos N.,10,0,15,5
1668444058967,MATH 204B,A00,098026,Sorensen; Claus M,13,0,15,2
1668444059390,MATH 208,A00,098027,Izadi; Elham,7,0,10,3
1668444059813,MATH 209,A00,098028,Pollack; Aaron,10,0,10,0
1668444060235,MATH 211A,A00,112919,Rogalski; Daniel,9,0,10,1
1668444060668,MATH 211B,A00,112920,Seward; Brandon M.,9,0,10,1
1668444061093,MATH 218,A00,098029,Li; Bo,10,0,10,0
1668444061612,MATH 220B,A00,098030,Novak; Jonathan I,11,0,15,4
1668444062038,MATH 221A,A00,098031,Ebenfelt; Peter F,13,0,15,2
1668444062464,MATH 231B,A00,098032,Zlatos; Andrej,11,0,15,4
1668444062893,MATH 240B,A00,098033,Ni; Lei,9,0,15,6
1668444063317,MATH 243,A00,098034,Jekel; David Andrew,10,0,10,0
1668444063744,MATH 245A,A00,098035,Nie; Jiawang,0,2,15,16
1668444064169,MATH 248,A00,098036,Bejenaru; Ioan,10,0,10,0
1668444064594,MATH 250B,A00,098037,Spolaor; Luca,14,0,15,1
1668444065033,MATH 258,A00,098038,Ni; Lei,10,0,10,0
1668444065462,MATH 264B,A00,098041,Rhoades; Brendon Patrick,9,0,15,6
1668444065886,MATH 268,A00,098042,Buss; Samuel R,10,0,10,0
1668444066314,MATH 269,A00,098043,Rhoades; Brendon Patrick,10,0,10,0
1668444066740,MATH 270B,A00,098044,Li; Bo,10,0,15,5
1668444067185,MATH 272B,A00,098045,Holst; Michael J,13,0,15,2
1668444067612,MATH 273A,A00,098046,Tian; Xiaochuan,10,0,15,5
1668444068039,MATH 275,A01,098048,Tian; Xiaochuan,6,0,10,4
1668444068465,MATH 278A,A00,098049,Holst; Michael J,8,0,10,2
1668444068905,MATH 278B,A00,098050,Cloninger; Alexander,10,0,10,0
1668444069337,MATH 278C,A00,098051,Nie; Jiawang,6,0,10,4
1668444069760,MATH 280B,A00,098052,Zheng; Tianyi,7,0,15,8
1668444070186,MATH 281B,A00,098053,Bradic; Jelena,0,1,15,15
1668444070627,MATH 282B,A00,098054,Arias-Castro; Ery,0,0,15,15
1668444071062,MATH 285,A00,098055,Fitzsimmons; Patrick J,0,1,15,17
1668444071496,MATH 287B,A00,098056,Arias-Castro; Ery,3,0,15,12
1668444071919,MATH 288,A00,098057,Agarwal; Pooja,9,0,10,1
1668444071919,MATH 288,B00,098058,Zhang; Danna,8,0,10,2
1668444071919,MATH 288,C00,098059,Williams; Ruth J,9,0,10,1
1668444072358,MATH 290B,A00,098060,Roberts; Justin Deritter,13,0,15,2
1668444072784,MATH 292,A00,098061,Belmont; Eva Kinoshita,10,0,10,0
1668444073209,MATH 295,A00,098062,Suk; Andrew Hoon,48,0,50,2
1668444073646,MATH 296,A00,098063,Novak; Jonathan I,20,0,20,0
1668444074070,MATH 297,001,098064,Gamst; Anthony Collins,9997,0,9999,2
1668444578347,COGS 205,A00,101395,Chiba; Andrea,19,0,20,1
1668444578771,COGS 210B,001,101404,Greene; Deanna Jacquelyn,9998,0,9999,1
1668444578771,COGS 210B,002,101417,Xia; Haijun,9999,0,9999,0
1668444578771,COGS 210B,003,101422,Nitz; Douglas A.,9999,0,9999,0
1668444578771,COGS 210B,004,101423,Hollan; James D.,9998,0,9999,1
1668444578771,COGS 210B,005,101424,Deak; Gedeon O.,9998,0,9999,1
1668444578771,COGS 210B,006,101425,Rossano; Federico,9999,0,9999,0
1668444579201,COGS 211B,A00,101427,Coulson; Seana M,9996,0,9999,3
1668444579627,COGS 220,A00,101428,Hollan; James D.,1,4,25,24
1668444580063,COGS 229,A00,101429,Dow; Steven P,18,0,25,7
1668444580502,COGS 230,A00,101430,Klemmer; Scott R,11,0,17,6
1668444580925,COGS 234,A00,101431,Xia; Haijun,2,0,25,23
1668444581357,COGS 260,A00,101432,Kiyonaga; Anastasia,21,0,25,4
1668444581357,COGS 260,B00,101433,Kirsh; David Joel,15,0,25,10
1668444581782,CSE 202,A00,102371,Impagliazzo; Russell,0,41,0,0
1668444582209,CSE 203B,A01,102373,Cheng; Chung Kuan,0,31,0,0
1668444582634,CSE 208,A00,102374,Micciancio; Daniele,0,2,0,0
1668444583061,CSE 209A,A00,112895,Impagliazzo; Russell,0,7,15,15
1668444583483,CSE 209B,A00,108005,Bellare; Mihir,0,3,0,0
1668444583906,CSE 210,A00,113163,Coblenz; Michael J,0,49,0,0
1668444584335,CSE 219,A00,106111,Dow; Steven P,0,0,20,20
1668444584763,CSE 221,A00,102376,Voelker; Geoffrey M.,0,36,0,0
1668444585267,CSE 224,A01,102378,Porter; George M,0,109,0,0
1668444585698,CSE 229A,A00,102379,Savage; Stefan,0,4,0,0
1668444586119,CSE 229C,A00,102380,Munyaka; Imani N. S.,0,4,0,0
1668444586543,CSE 232B,A00,102382,Deutsch; Alin Bernard,0,18,0,0
1668444586967,CSE 234,A01,112904,Kumar; Arun Kumar,0,0,0,0
1668444587396,CSE 237A,A00,102383,Rosing; Tajana Simunic,0,28,0,0
1668444587820,CSE 239A,A00,102384,Deutsch; Alin Bernard,0,6,0,0
1668444588245,CSE 239B,A00,102385,Polikarpova; Nadezhda,0,3,0,0
1668444588687,CSE 240A,A00,102386,Pannuto; Patrick William,0,31,0,0
1668444589115,CSE 240B,A00,102387,Zhao; Jishen,0,30,0,0
1668444589538,CSE 241A,A00,106406,Kang; Mingu,0,4,0,0
1668444589963,CSE 249B,A00,102388,Kahng; Andrew Byun,0,1,8,8
1668444590405,CSE 251B,A01,102392,Cottrell; Garrison W,0,28,0,0
1668444590405,CSE 251B,A02,102393,Cottrell; Garrison W,0,23,0,0
1668444590829,CSE 252B,A00,102394,Ochoa; Benjamin Lawrence,0,40,0,0
1668444591266,CSE 257,A01,102396,Gao; Sicun,0,92,0,0
1668444591690,CSE 272,A00,102397,Li; Tzumao,0,8,0,0
1668444592132,CSE 274,A00,111323,Chern; Albert Ren-Haur,0,8,0,0
1668444592567,CSE 282,A00,102398,Pevzner; Pavel Arkadjevich,0,0,0,0
1668444593000,CSE 284,A00,114175,Gymrek; Melissa Ann,0,14,0,0
1668444593426,CSE 290,A00,102399,Chandraker; Manmohan Krishna,0,4,0,0
1668444593426,CSE 290,B00,102400,Vaccaro; Kristen Marie,0,1,25,25
1668444593426,CSE 290,C00,102414,Pannuto; Patrick William,0,1,25,25
1668444593426,CSE 290,D00,102427,Pevzner; Pavel Arkadjevich,0,0,0,0
1668444593426,CSE 290,E00,102429,Zhao; Jishen,0,2,0,0
1668444593426,CSE 290,F00,102436,Tullsen; Dean Michael,0,4,0,0
1668444593426,CSE 290,G00,102440,Christensen; Henrik I,0,3,20,20
1668444593870,CSE 291,A00,102443,Su; Hao,0,0,0,0
1668444593870,CSE 291,B00,102448,Polikarpova; Nadezhda,0,0,0,0
1668444593870,CSE 291,C00,102453,Vaccaro; Kristen Marie,0,0,0,0
1668444593870,CSE 291,D00,111343,Savage; Stefan,0,0,0,0
1668444593870,CSE 291,E00,116474,Claffy; Kimberly Claire,0,0,0,0
1668444593870,CSE 291,F00,116479,Pasquale; Joseph,0,0,0,0
1668444594294,CSE 293,001,119111,Bafna; Vineet,9999,0,9999,0
1668444594294,CSE 293,002,119118,Bellare; Mihir,9999,0,9999,0
1668444594294,CSE 293,003,119122,Berg-Kirkpatrick; Taylor D,9999,0,9999,0
1668444594294,CSE 293,004,119135,Christensen; Henrik I,9999,0,9999,0
1668444594294,CSE 293,005,119142,Cottrell; Garrison W,9999,0,9999,0
1668444594294,CSE 293,006,119146,Deutsch; Alin Bernard,9999,0,9999,0
1668444594294,CSE 293,007,119159,Esmaeilzadeh; Hadi,9999,0,9999,0
1668444594294,CSE 293,008,119166,Freund; Yoav,9999,0,9999,0
1668444594294,CSE 293,009,119170,Griswold; William G.,9999,0,9999,0
1668444594294,CSE 293,010,119183,Gymrek; Melissa Ann,9999,0,9999,0
1668444594294,CSE 293,011,119190,Heninger; Nadia A,9999,0,9999,0
1668444594294,CSE 293,012,119230,Impagliazzo; Russell,9999,0,9999,0
1668444594294,CSE 293,013,119232,Jhala; Ranjit,9999,0,9999,0
1668444594294,CSE 293,014,119233,Kahng; Andrew Byun,9999,0,9999,0
1668444594294,CSE 293,015,119298,Kane; Daniel Mertz,9999,0,9999,0
1668444594294,CSE 293,016,119299,Kriegman; David J,9999,0,9999,0
1668444594294,CSE 293,017,119300,Kumar; Arun Kumar,9999,0,9999,0
1668444594294,CSE 293,018,119301,Lerner; Sorin,9999,0,9999,0
1668444594294,CSE 293,019,119302,Lovett; Shachar,9999,0,9999,0
1668444594294,CSE 293,020,119303,McAuley; Julian John,9999,0,9999,0
1668444594294,CSE 293,021,119304,Micciancio; Daniele,9999,0,9999,0
1668444594294,CSE 293,022,119367,Orailoglu; Alex,9999,0,9999,0
1668444594294,CSE 293,023,119382,Paturi; Ramamohan,9999,0,9999,0
1668444594294,CSE 293,024,119404,Polikarpova; Nadezhda,9999,0,9999,0
1668444594294,CSE 293,025,119406,Politz; Joseph Gibbs,9999,0,9999,0
1668444594294,CSE 293,026,119411,Porter; George M,9999,0,9999,0
1668444594294,CSE 293,027,119414,Porter; Leonard Emerson,9999,0,9999,0
1668444594294,CSE 293,028,119416,Ramamoorthi; Ravi,9999,0,9999,0
1668444594294,CSE 293,029,119417,Sahoo; Debashis,9999,0,9999,0
1668444594294,CSE 293,030,119420,Saul; Lawrence,9999,0,9999,0
1668444594294,CSE 293,031,119421,Savage; Stefan,9999,0,9999,0
1668444594294,CSE 293,032,119425,Schulze; Jurgen P.,9999,0,9999,0
1668444594294,CSE 293,033,119426,Snoeren; Alex C.,9999,0,9999,0
1668444594294,CSE 293,034,119428,Shang; Jingbo,9999,0,9999,0
1668444594294,CSE 293,035,119430,Stefan; Deian,9999,0,9999,0
1668444594294,CSE 293,036,119431,Su; Hao,9999,0,9999,0
1668444594294,CSE 293,037,119433,Swanson; Steven James,9999,0,9999,0
1668444594294,CSE 293,038,119435,Tullsen; Dean Michael,9999,0,9999,0
1668444594294,CSE 293,039,119483,Voelker; Geoffrey M.,9999,0,9999,0
1668444594294,CSE 293,040,119537,Zhao; Jishen,9999,0,9999,0
1668444594294,CSE 293,041,119538,Zhou; Yuan-Yuan,9999,0,9999,0
1668444594294,CSE 293,042,119539,Gao; Sicun,9999,0,9999,0
1668444594294,CSE 293,043,119540,Weibel; Nadir,9999,0,9999,0
1668444594294,CSE 293,044,119541,Gupta; Rajesh K.,9999,0,9999,0
1668444594294,CSE 293,045,126410,Vaccaro; Kristen Marie,9999,0,9999,0
1668444594294,CSE 293,046,126411,Klemke; Richard,9999,0,9999,0
1668444594722,CSE 294,A00,102459,Voelker; Geoffrey M.,0,2,0,0
1668444594722,CSE 294,B00,111322,Orailoglu; Alex,0,0,0,0
1668444595148,DSE 201,A00,096914,Deutsch; Alin Bernard,30,0,30,0
1668444595584,DSE 210,A00,096915,Dasgupta; Sanjoy,30,0,30,0
1668444596022,DSE 260A,A00,096916,Altintas De Callaf; Ilkay,30,0,30,0
1668444596477,ECE 200,001,103586,Antipa; Nicholas A,9999,0,9999,0
1668444596477,ECE 200,002,103587,Atanasov; Nikolay A.,9999,0,9999,0
1668444596477,ECE 200,003,103588,Bharadia; Dinesh,9999,0,9999,0
1668444596477,ECE 200,004,103589,Cheng; Chung Kuan,9999,0,9999,0
1668444596477,ECE 200,005,103590,Cosman; Pamela C.,9999,0,9999,0
1668444596477,ECE 200,006,103591,Dayeh; Shadi Ahmad,9999,0,9999,0
1668444596477,ECE 200,007,103592,Fainman; Yeshaiahu,9999,0,9999,0
1668444596477,ECE 200,008,103593,Ford; Joseph Earl,9999,0,9999,0
1668444596477,ECE 200,009,103594,Franceschetti; Massimo,9999,0,9999,0
1668444596477,ECE 200,010,103595,Fullerton; Eric E,9999,0,9999,0
1668444596477,ECE 200,011,103596,Galton; Ian A,9999,0,9999,0
1668444596477,ECE 200,012,103597,Gilja; Vikash,9999,0,9999,0
1668444596477,ECE 200,013,103598,Hall; Drew A.,9999,0,9999,0
1668444596477,ECE 200,014,103599,Hsueh; Tzu-Chien,9999,0,9999,0
1668444596477,ECE 200,015,103600,Javidi; Tara,9999,0,9999,0
1668444596477,ECE 200,016,103601,Kahng; Andrew Byun,9999,0,9999,0
1668444596477,ECE 200,017,103602,Kim; Young-Han,9999,0,9999,0
1668444596477,ECE 200,018,103603,Koushanfar; Farinaz,9999,0,9999,0
1668444596477,ECE 200,019,103604,Kuzum; Duygu,9999,0,9999,0
1668444596477,ECE 200,020,103605,Le; Hanh-Phuc,9999,0,9999,0
1668444596477,ECE 200,021,103606,Lin; Bill,9999,0,9999,0
1668444596477,ECE 200,022,103607,Liu; Zhaowei,9998,0,9999,1
1668444596477,ECE 200,023,103608,Lo; Yu-Hwa,9999,0,9999,0
1668444596477,ECE 200,024,103609,Lomakin; Vitaliy,9999,0,9999,0
1668444596477,ECE 200,025,103610,Mercier; Patrick Philip,9999,0,9999,0
1668444596477,ECE 200,026,103611,Meyer; Florian,9999,0,9999,0
1668444596477,ECE 200,027,103612,Milstein; Laurence B.,9999,0,9999,0
1668444596477,ECE 200,028,103613,Mir Arabbaygi; Siavash,9999,0,9999,0
1668444596477,ECE 200,029,103614,Mookherjea; Shayan,9999,0,9999,0
1668444596477,ECE 200,030,103615,Morris; Karcher William,9999,0,9999,0
1668444596477,ECE 200,031,103616,Ng; Tse Nga,9999,0,9999,0
1668444596477,ECE 200,032,103617,Nguyen; Truong Quang,9999,0,9999,0
1668444596477,ECE 200,033,103618,Nomura; Kenji,9999,0,9999,0
1668444596477,ECE 200,034,103619,Orlitsky; Alon,9999,0,9999,0
1668444596477,ECE 200,035,103620,Pal; Piya,9999,0,9999,0
1668444596477,ECE 200,036,103621,Papen; George C.,9999,0,9999,0
1668444596477,ECE 200,037,103622,Radic; Stojan,9999,0,9999,0
1668444596477,ECE 200,038,103623,Rao; Bhaskar D.,9999,0,9999,0
1668444596477,ECE 200,039,103624,Rao; Ramesh R,9999,0,9999,0
1668444596477,ECE 200,040,103625,Rebeiz; Gabriel,9999,0,9999,0
1668444596477,ECE 200,041,103626,Sanford; John R,9999,0,9999,0
1668444596477,ECE 200,042,103627,Siegel; Paul H.,9999,0,9999,0
1668444596477,ECE 200,043,103628,Sievenpiper; Daniel F.,9999,0,9999,0
1668444596477,ECE 200,044,103629,Sworder; David D.,9999,0,9999,0
1668444596477,ECE 200,045,103630,Taur; Yuan,9999,0,9999,0
1668444596477,ECE 200,046,103631,Touri; Behrouz,9999,0,9999,0
1668444596477,ECE 200,047,103632,Trivedi; Mohan M.,9999,0,9999,0
1668444596477,ECE 200,048,103633,Vasconcelos; Nuno,9999,0,9999,0
1668444596477,ECE 200,049,103634,Wang; Xiaolong,9999,0,9999,0
1668444596477,ECE 200,050,103635,Xie; Pengtao,9999,0,9999,0
1668444596477,ECE 200,051,103636,Yip; Michael,9999,0,9999,0
1668444596477,ECE 200,052,103637,Zeger; Kenneth A.,999,0,999,0
1668444596477,ECE 200,053,103638,Zhang; Xinyu,9999,0,9999,0
1668444596477,ECE 200,054,103639,Turakhia; Yatish Girish,9999,0,9999,0
1668444596477,ECE 200,055,103640,Kang; Mingu,9999,0,9999,0
1668444596477,ECE 200,056,103641,Shi; Yuanyuan,9999,0,9999,0
1668444596477,ECE 200,057,103642,Wang; Edward Jay,9999,0,9999,0
1668444596477,ECE 200,058,103643,Zheng; Yang,9999,0,9999,0
1668444596905,ECE 202,A00,103644,Kuzum; Duygu,0,26,0,0
1668444597341,ECE 212BN,A00,103646,Ng; Tse Nga,0,1,0,0
1668444597767,ECE 221,A00,111493,Staff,0,0,0,0
1668444598192,ECE 222B,A00,103647,Lomakin; Vitaliy,0,5,0,0
1668444598629,ECE 230B,A00,103648,Taur; Yuan,0,0,0,0
1668444599057,ECE 238B,A00,103649,Garay; Javier,0,0,0,0
1668444599494,ECE 240B,A00,112900,Fainman; Yeshaiahu,0,4,0,0
1668444599917,ECE 247A,A00,103650,Jokerst; Jesse Vincent,0,2,0,0
1668444600351,ECE 247B,A00,103651,Wang; Joseph,0,7,0,0
1668444600784,ECE 250,A00,103652,Siegel; Paul H.,0,49,0,0
1668444601221,ECE 251A,A00,103654,Rao; Bhaskar D.,0,34,0,0
1668444601647,ECE 257B,A00,103655,Bharadia; Dinesh,0,17,0,0
1668444602071,ECE 258A,A00,103656,Milstein; Laurence B.,0,13,0,0
1668444602501,ECE 260B,A00,103658,Kang; Mingu,0,73,0,0
1668444602939,ECE 264A,A00,103659,Galton; Ian A,0,40,0,0
1668444603363,ECE 265A,A00,103661,Gudem; Prasad S.S.,0,23,0,0
1668444603789,ECE 265D,A00,103662,Gudem; Prasad S.S.,0,15,0,0
1668444604217,ECE 268,A00,103663,Koushanfar; Farinaz,0,26,0,0
1668444604658,ECE 269,A01,103665,Pal; Piya,0,143,0,0
1668444605085,ECE 271B,A00,103666,Vasconcelos; Manuela,0,50,0,0
1668444605511,ECE 276A,A00,103667,Atanasov; Nikolay A.,0,76,0,0
1668444605939,ECE 277,A00,103668,An; Cheolhong,0,98,0,0
1668444606368,ECE 279,A00,117947,Hall; Drew A.,0,15,0,0
1668444607218,ECE 283,A00,103670,Hsueh; Tzu-Chien,0,32,0,0
1668444607651,ECE 284,A00,103671,Turakhia; Yatish Girish,0,28,0,0
1668444608107,ECE 285,A00,103672,Zheng; Yang,0,25,0,0
1668444608107,ECE 285,B00,103673,Sworder; David D.,0,41,0,0
1668444608529,ECE 287,A00,103676,Javidi; Tara,0,4,0,0
1668444608953,MATH 200B,A00,098023,Salehi Golsefidy; Alireza,12,0,15,3
1668444609395,MATH 202B,A00,098024,Rhoades; Brendon Patrick,9,0,15,6
1668444609822,MATH 203B,A00,098025,Oprea; Dragos N.,10,0,15,5
1668444610245,MATH 204B,A00,098026,Sorensen; Claus M,13,0,15,2
1668444610670,MATH 208,A00,098027,Izadi; Elham,7,0,10,3
1668444611097,MATH 209,A00,098028,Pollack; Aaron,10,0,10,0
1668444611528,MATH 211A,A00,112919,Rogalski; Daniel,9,0,10,1
1668444611953,MATH 211B,A00,112920,Seward; Brandon M.,9,0,10,1
1668444612375,MATH 218,A00,098029,Li; Bo,10,0,10,0
1668444612806,MATH 220B,A00,098030,Novak; Jonathan I,11,0,15,4
1668444613244,MATH 221A,A00,098031,Ebenfelt; Peter F,13,0,15,2
1668444613680,MATH 231B,A00,098032,Zlatos; Andrej,11,0,15,4
1668444614118,MATH 240B,A00,098033,Ni; Lei,9,0,15,6
1668444614545,MATH 243,A00,098034,Jekel; David Andrew,10,0,10,0
1668444614969,MATH 245A,A00,098035,Nie; Jiawang,0,2,15,16
1668444615401,MATH 248,A00,098036,Bejenaru; Ioan,10,0,10,0
1668444615830,MATH 250B,A00,098037,Spolaor; Luca,14,0,15,1
1668444616253,MATH 258,A00,098038,Ni; Lei,10,0,10,0
1668444616675,MATH 264B,A00,098041,Rhoades; Brendon Patrick,9,0,15,6
1668444617101,MATH 268,A00,098042,Buss; Samuel R,10,0,10,0
1668444617525,MATH 269,A00,098043,Rhoades; Brendon Patrick,10,0,10,0
1668444617955,MATH 270B,A00,098044,Li; Bo,10,0,15,5
1668444618378,MATH 272B,A00,098045,Holst; Michael J,13,0,15,2
1668444618814,MATH 273A,A00,098046,Tian; Xiaochuan,10,0,15,5
1668444619242,MATH 275,A01,098048,Tian; Xiaochuan,6,0,10,4
1668444619665,MATH 278A,A00,098049,Holst; Michael J,8,0,10,2
1668444620088,MATH 278B,A00,098050,Cloninger; Alexander,10,0,10,0
1668444620512,MATH 278C,A00,098051,Nie; Jiawang,6,0,10,4
1668444620936,MATH 280B,A00,098052,Zheng; Tianyi,7,0,15,8
1668444621359,MATH 281B,A00,098053,Bradic; Jelena,0,1,15,15
1668444621782,MATH 282B,A00,098054,Arias-Castro; Ery,0,0,15,15
1668444622205,MATH 285,A00,098055,Fitzsimmons; Patrick J,0,1,15,17
1668444622637,MATH 287B,A00,098056,Arias-Castro; Ery,3,0,15,12
1668444623066,MATH 288,A00,098057,Agarwal; Pooja,9,0,10,1
1668444623066,MATH 288,B00,098058,Zhang; Danna,8,0,10,2
1668444623066,MATH 288,C00,098059,Williams; Ruth J,9,0,10,1
1668444623490,MATH 290B,A00,098060,Roberts; Justin Deritter,13,0,15,2
1668444623913,MATH 292,A00,098061,Belmont; Eva Kinoshita,10,0,10,0
1668444624342,MATH 295,A00,098062,Suk; Andrew Hoon,48,0,50,2
1668444624781,MATH 296,A00,098063,Novak; Jonathan I,20,0,20,0
1668444625208,MATH 297,001,098064,Gamst; Anthony Collins,9997,0,9999,2
1668445129571,COGS 205,A00,101395,Chiba; Andrea,19,0,20,1
1668445130013,COGS 210B,001,101404,Greene; Deanna Jacquelyn,9998,0,9999,1
1668445130013,COGS 210B,002,101417,Xia; Haijun,9999,0,9999,0
1668445130013,COGS 210B,003,101422,Nitz; Douglas A.,9999,0,9999,0
1668445130013,COGS 210B,004,101423,Hollan; James D.,9998,0,9999,1
1668445130013,COGS 210B,005,101424,Deak; Gedeon O.,9998,0,9999,1
1668445130013,COGS 210B,006,101425,Rossano; Federico,9999,0,9999,0
1668445130439,COGS 211B,A00,101427,Coulson; Seana M,9996,0,9999,3
1668445130863,COGS 220,A00,101428,Hollan; James D.,1,4,25,24
1668445131287,COGS 229,A00,101429,Dow; Steven P,18,0,25,7
1668445131713,COGS 230,A00,101430,Klemmer; Scott R,11,0,17,6
1668445132137,COGS 234,A00,101431,Xia; Haijun,2,0,25,23
1668445132561,COGS 260,A00,101432,Kiyonaga; Anastasia,21,0,25,4
1668445132561,COGS 260,B00,101433,Kirsh; David Joel,15,0,25,10
1668445132984,CSE 202,A00,102371,Impagliazzo; Russell,0,41,0,0
1668445133417,CSE 203B,A01,102373,Cheng; Chung Kuan,0,32,0,0
1668445133839,CSE 208,A00,102374,Micciancio; Daniele,0,2,0,0
1668445134270,CSE 209A,A00,112895,Impagliazzo; Russell,0,7,15,15
1668445134694,CSE 209B,A00,108005,Bellare; Mihir,0,3,0,0
1668445135136,CSE 210,A00,113163,Coblenz; Michael J,0,49,0,0
1668445135559,CSE 219,A00,106111,Dow; Steven P,0,0,20,20
1668445135984,CSE 221,A00,102376,Voelker; Geoffrey M.,0,38,0,0
1668445136413,CSE 224,A01,102378,Porter; George M,0,109,0,0
1668445136841,CSE 229A,A00,102379,Savage; Stefan,0,4,0,0
1668445137270,CSE 229C,A00,102380,Munyaka; Imani N. S.,0,4,0,0
1668445137712,CSE 232B,A00,102382,Deutsch; Alin Bernard,0,18,0,0
1668445138136,CSE 234,A01,112904,Kumar; Arun Kumar,0,0,0,0
1668445138585,CSE 237A,A00,102383,Rosing; Tajana Simunic,0,28,0,0
1668445139015,CSE 239A,A00,102384,Deutsch; Alin Bernard,0,6,0,0
1668445139453,CSE 239B,A00,102385,Polikarpova; Nadezhda,0,3,0,0
1668445139874,CSE 240A,A00,102386,Pannuto; Patrick William,0,31,0,0
1668445140303,CSE 240B,A00,102387,Zhao; Jishen,0,31,0,0
1668445140728,CSE 241A,A00,106406,Kang; Mingu,0,4,0,0
1668445141165,CSE 249B,A00,102388,Kahng; Andrew Byun,0,1,8,8
1668445141597,CSE 251B,A01,102392,Cottrell; Garrison W,0,29,0,0
1668445141597,CSE 251B,A02,102393,Cottrell; Garrison W,0,24,0,0
1668445142025,CSE 252B,A00,102394,Ochoa; Benjamin Lawrence,0,40,0,0
1668445142459,CSE 257,A01,102396,Gao; Sicun,0,93,0,0
1668445142892,CSE 272,A00,102397,Li; Tzumao,0,9,0,0
1668445143343,CSE 274,A00,111323,Chern; Albert Ren-Haur,0,8,0,0
1668445143771,CSE 282,A00,102398,Pevzner; Pavel Arkadjevich,0,0,0,0
1668445144201,CSE 284,A00,114175,Gymrek; Melissa Ann,0,14,0,0
1668445144639,CSE 290,A00,102399,Chandraker; Manmohan Krishna,0,4,0,0
1668445144639,CSE 290,B00,102400,Vaccaro; Kristen Marie,0,1,25,25
1668445144639,CSE 290,C00,102414,Pannuto; Patrick William,0,1,25,25
1668445144639,CSE 290,D00,102427,Pevzner; Pavel Arkadjevich,0,0,0,0
1668445144639,CSE 290,E00,102429,Zhao; Jishen,0,2,0,0
1668445144639,CSE 290,F00,102436,Tullsen; Dean Michael,0,4,0,0
1668445144639,CSE 290,G00,102440,Christensen; Henrik I,0,3,20,20
1668445145067,CSE 291,A00,102443,Su; Hao,0,0,0,0
1668445145067,CSE 291,B00,102448,Polikarpova; Nadezhda,0,0,0,0
1668445145067,CSE 291,C00,102453,Vaccaro; Kristen Marie,0,0,0,0
1668445145067,CSE 291,D00,111343,Savage; Stefan,0,0,0,0
1668445145067,CSE 291,E00,116474,Claffy; Kimberly Claire,0,0,0,0
1668445145067,CSE 291,F00,116479,Pasquale; Joseph,0,0,0,0
1668445145499,CSE 293,001,119111,Bafna; Vineet,9999,0,9999,0
1668445145499,CSE 293,002,119118,Bellare; Mihir,9999,0,9999,0
1668445145499,CSE 293,003,119122,Berg-Kirkpatrick; Taylor D,9999,0,9999,0
1668445145499,CSE 293,004,119135,Christensen; Henrik I,9999,0,9999,0
1668445145499,CSE 293,005,119142,Cottrell; Garrison W,9999,0,9999,0
1668445145499,CSE 293,006,119146,Deutsch; Alin Bernard,9999,0,9999,0
1668445145499,CSE 293,007,119159,Esmaeilzadeh; Hadi,9999,0,9999,0
1668445145499,CSE 293,008,119166,Freund; Yoav,9999,0,9999,0
1668445145499,CSE 293,009,119170,Griswold; William G.,9999,0,9999,0
1668445145499,CSE 293,010,119183,Gymrek; Melissa Ann,9999,0,9999,0
1668445145499,CSE 293,011,119190,Heninger; Nadia A,9999,0,9999,0
1668445145499,CSE 293,012,119230,Impagliazzo; Russell,9999,0,9999,0
1668445145499,CSE 293,013,119232,Jhala; Ranjit,9999,0,9999,0
1668445145499,CSE 293,014,119233,Kahng; Andrew Byun,9999,0,9999,0
1668445145499,CSE 293,015,119298,Kane; Daniel Mertz,9999,0,9999,0
1668445145499,CSE 293,016,119299,Kriegman; David J,9999,0,9999,0
1668445145499,CSE 293,017,119300,Kumar; Arun Kumar,9999,0,9999,0
1668445145499,CSE 293,018,119301,Lerner; Sorin,9999,0,9999,0
1668445145499,CSE 293,019,119302,Lovett; Shachar,9999,0,9999,0
1668445145499,CSE 293,020,119303,McAuley; Julian John,9999,0,9999,0
1668445145499,CSE 293,021,119304,Micciancio; Daniele,9999,0,9999,0
1668445145499,CSE 293,022,119367,Orailoglu; Alex,9999,0,9999,0
1668445145499,CSE 293,023,119382,Paturi; Ramamohan,9999,0,9999,0
1668445145499,CSE 293,024,119404,Polikarpova; Nadezhda,9999,0,9999,0
1668445145499,CSE 293,025,119406,Politz; Joseph Gibbs,9999,0,9999,0
1668445145499,CSE 293,026,119411,Porter; George M,9999,0,9999,0
1668445145499,CSE 293,027,119414,Porter; Leonard Emerson,9999,0,9999,0
1668445145499,CSE 293,028,119416,Ramamoorthi; Ravi,9999,0,9999,0
1668445145499,CSE 293,029,119417,Sahoo; Debashis,9999,0,9999,0
1668445145499,CSE 293,030,119420,Saul; Lawrence,9999,0,9999,0
1668445145499,CSE 293,031,119421,Savage; Stefan,9999,0,9999,0
1668445145499,CSE 293,032,119425,Schulze; Jurgen P.,9999,0,9999,0
1668445145499,CSE 293,033,119426,Snoeren; Alex C.,9999,0,9999,0
1668445145499,CSE 293,034,119428,Shang; Jingbo,9999,0,9999,0
1668445145499,CSE 293,035,119430,Stefan; Deian,9999,0,9999,0
1668445145499,CSE 293,036,119431,Su; Hao,9999,0,9999,0
1668445145499,CSE 293,037,119433,Swanson; Steven James,9999,0,9999,0
1668445145499,CSE 293,038,119435,Tullsen; Dean Michael,9999,0,9999,0
1668445145499,CSE 293,039,119483,Voelker; Geoffrey M.,9999,0,9999,0
1668445145499,CSE 293,040,119537,Zhao; Jishen,9999,0,9999,0
1668445145499,CSE 293,041,119538,Zhou; Yuan-Yuan,9999,0,9999,0
1668445145499,CSE 293,042,119539,Gao; Sicun,9999,0,9999,0
1668445145499,CSE 293,043,119540,Weibel; Nadir,9999,0,9999,0
1668445145499,CSE 293,044,119541,Gupta; Rajesh K.,9999,0,9999,0
1668445145499,CSE 293,045,126410,Vaccaro; Kristen Marie,9999,0,9999,0
1668445145499,CSE 293,046,126411,Klemke; Richard,9999,0,9999,0
1668445145928,CSE 294,A00,102459,Voelker; Geoffrey M.,0,2,0,0
1668445145928,CSE 294,B00,111322,Orailoglu; Alex,0,0,0,0
1668445146351,DSE 201,A00,096914,Deutsch; Alin Bernard,30,0,30,0
1668445146786,DSE 210,A00,096915,Dasgupta; Sanjoy,30,0,30,0
1668445147212,DSE 260A,A00,096916,Altintas De Callaf; Ilkay,30,0,30,0
1668445147658,ECE 200,001,103586,Antipa; Nicholas A,9999,0,9999,0
1668445147658,ECE 200,002,103587,Atanasov; Nikolay A.,9999,0,9999,0
1668445147658,ECE 200,003,103588,Bharadia; Dinesh,9999,0,9999,0
1668445147658,ECE 200,004,103589,Cheng; Chung Kuan,9999,0,9999,0
1668445147658,ECE 200,005,103590,Cosman; Pamela C.,9999,0,9999,0
1668445147658,ECE 200,006,103591,Dayeh; Shadi Ahmad,9999,0,9999,0
1668445147658,ECE 200,007,103592,Fainman; Yeshaiahu,9999,0,9999,0
1668445147658,ECE 200,008,103593,Ford; Joseph Earl,9999,0,9999,0
1668445147658,ECE 200,009,103594,Franceschetti; Massimo,9999,0,9999,0
1668445147658,ECE 200,010,103595,Fullerton; Eric E,9999,0,9999,0
1668445147658,ECE 200,011,103596,Galton; Ian A,9999,0,9999,0
1668445147658,ECE 200,012,103597,Gilja; Vikash,9999,0,9999,0
1668445147658,ECE 200,013,103598,Hall; Drew A.,9999,0,9999,0
1668445147658,ECE 200,014,103599,Hsueh; Tzu-Chien,9999,0,9999,0
1668445147658,ECE 200,015,103600,Javidi; Tara,9999,0,9999,0
1668445147658,ECE 200,016,103601,Kahng; Andrew Byun,9999,0,9999,0
1668445147658,ECE 200,017,103602,Kim; Young-Han,9999,0,9999,0
1668445147658,ECE 200,018,103603,Koushanfar; Farinaz,9999,0,9999,0
1668445147658,ECE 200,019,103604,Kuzum; Duygu,9999,0,9999,0
1668445147658,ECE 200,020,103605,Le; Hanh-Phuc,9999,0,9999,0
1668445147658,ECE 200,021,103606,Lin; Bill,9999,0,9999,0
1668445147658,ECE 200,022,103607,Liu; Zhaowei,9998,0,9999,1
1668445147658,ECE 200,023,103608,Lo; Yu-Hwa,9999,0,9999,0
1668445147658,ECE 200,024,103609,Lomakin; Vitaliy,9999,0,9999,0
1668445147658,ECE 200,025,103610,Mercier; Patrick Philip,9999,0,9999,0
1668445147658,ECE 200,026,103611,Meyer; Florian,9999,0,9999,0
1668445147658,ECE 200,027,103612,Milstein; Laurence B.,9999,0,9999,0
1668445147658,ECE 200,028,103613,Mir Arabbaygi; Siavash,9999,0,9999,0
1668445147658,ECE 200,029,103614,Mookherjea; Shayan,9999,0,9999,0
1668445147658,ECE 200,030,103615,Morris; Karcher William,9999,0,9999,0
1668445147658,ECE 200,031,103616,Ng; Tse Nga,9999,0,9999,0
1668445147658,ECE 200,032,103617,Nguyen; Truong Quang,9999,0,9999,0
1668445147658,ECE 200,033,103618,Nomura; Kenji,9999,0,9999,0
1668445147658,ECE 200,034,103619,Orlitsky; Alon,9999,0,9999,0
1668445147658,ECE 200,035,103620,Pal; Piya,9999,0,9999,0
1668445147658,ECE 200,036,103621,Papen; George C.,9999,0,9999,0
1668445147658,ECE 200,037,103622,Radic; Stojan,9999,0,9999,0
1668445147658,ECE 200,038,103623,Rao; Bhaskar D.,9999,0,9999,0
1668445147658,ECE 200,039,103624,Rao; Ramesh R,9999,0,9999,0
1668445147658,ECE 200,040,103625,Rebeiz; Gabriel,9999,0,9999,0
1668445147658,ECE 200,041,103626,Sanford; John R,9999,0,9999,0
1668445147658,ECE 200,042,103627,Siegel; Paul H.,9999,0,9999,0
1668445147658,ECE 200,043,103628,Sievenpiper; Daniel F.,9999,0,9999,0
1668445147658,ECE 200,044,103629,Sworder; David D.,9999,0,9999,0
1668445147658,ECE 200,045,103630,Taur; Yuan,9999,0,9999,0
1668445147658,ECE 200,046,103631,Touri; Behrouz,9999,0,9999,0
1668445147658,ECE 200,047,103632,Trivedi; Mohan M.,9999,0,9999,0
1668445147658,ECE 200,048,103633,Vasconcelos; Nuno,9999,0,9999,0
1668445147658,ECE 200,049,103634,Wang; Xiaolong,9999,0,9999,0
1668445147658,ECE 200,050,103635,Xie; Pengtao,9999,0,9999,0
1668445147658,ECE 200,051,103636,Yip; Michael,9999,0,9999,0
1668445147658,ECE 200,052,103637,Zeger; Kenneth A.,999,0,999,0
1668445147658,ECE 200,053,103638,Zhang; Xinyu,9999,0,9999,0
1668445147658,ECE 200,054,103639,Turakhia; Yatish Girish,9999,0,9999,0
1668445147658,ECE 200,055,103640,Kang; Mingu,9999,0,9999,0
1668445147658,ECE 200,056,103641,Shi; Yuanyuan,9999,0,9999,0
1668445147658,ECE 200,057,103642,Wang; Edward Jay,9999,0,9999,0
1668445147658,ECE 200,058,103643,Zheng; Yang,9999,0,9999,0
1668445148095,ECE 202,A00,103644,Kuzum; Duygu,0,26,0,0
1668445148519,ECE 212BN,A00,103646,Ng; Tse Nga,0,1,0,0
1668445148941,ECE 221,A00,111493,Staff,0,0,0,0
1668445149364,ECE 222B,A00,103647,Lomakin; Vitaliy,0,5,0,0
1668445149787,ECE 230B,A00,103648,Taur; Yuan,0,0,0,0
1668445150219,ECE 238B,A00,103649,Garay; Javier,0,0,0,0
1668445150643,ECE 240B,A00,112900,Fainman; Yeshaiahu,0,4,0,0
1668445151070,ECE 247A,A00,103650,Jokerst; Jesse Vincent,0,2,0,0
1668445151495,ECE 247B,A00,103651,Wang; Joseph,0,7,0,0
1668445151925,ECE 250,A00,103652,Siegel; Paul H.,0,49,0,0
1668445152450,ECE 251A,A00,103654,Rao; Bhaskar D.,0,34,0,0
1668445152882,ECE 257B,A00,103655,Bharadia; Dinesh,0,18,0,0
1668445153314,ECE 258A,A00,103656,Milstein; Laurence B.,0,13,0,0
1668445153745,ECE 260B,A00,103658,Kang; Mingu,0,73,0,0
1668445154173,ECE 264A,A00,103659,Galton; Ian A,0,40,0,0
1668445154598,ECE 265A,A00,103661,Gudem; Prasad S.S.,0,23,0,0
1668445155021,ECE 265D,A00,103662,Gudem; Prasad S.S.,0,16,0,0
1668445155459,ECE 268,A00,103663,Koushanfar; Farinaz,0,26,0,0
1668445155883,ECE 269,A01,103665,Pal; Piya,0,144,0,0
1668445156306,ECE 271B,A00,103666,Vasconcelos; Manuela,0,50,0,0
1668445156735,ECE 276A,A00,103667,Atanasov; Nikolay A.,0,76,0,0
1668445157159,ECE 277,A00,103668,An; Cheolhong,0,99,0,0
1668445157583,ECE 279,A00,117947,Hall; Drew A.,0,14,0,0
1668445158438,ECE 283,A00,103670,Hsueh; Tzu-Chien,0,32,0,0
1668445158861,ECE 284,A00,103671,Turakhia; Yatish Girish,0,28,0,0
1668445159292,ECE 285,A00,103672,Zheng; Yang,0,25,0,0
1668445159292,ECE 285,B00,103673,Sworder; David D.,0,41,0,0
1668445159723,ECE 287,A00,103676,Javidi; Tara,0,4,0,0
1668445160151,MATH 200B,A00,098023,Salehi Golsefidy; Alireza,12,0,15,3
1668445160576,MATH 202B,A00,098024,Rhoades; Brendon Patrick,9,0,15,6
1668445161013,MATH 203B,A00,098025,Oprea; Dragos N.,10,0,15,5
1668445161437,MATH 204B,A00,098026,Sorensen; Claus M,13,0,15,2
1668445161874,MATH 208,A00,098027,Izadi; Elham,7,0,10,3
1668445162301,MATH 209,A00,098028,Pollack; Aaron,10,0,10,0
1668445162728,MATH 211A,A00,112919,Rogalski; Daniel,9,0,10,1
1668445163155,MATH 211B,A00,112920,Seward; Brandon M.,9,0,10,1
1668445163586,MATH 218,A00,098029,Li; Bo,10,0,10,0
1668445164013,MATH 220B,A00,098030,Novak; Jonathan I,11,0,15,4
1668445164438,MATH 221A,A00,098031,Ebenfelt; Peter F,13,0,15,2
1668445164868,MATH 231B,A00,098032,Zlatos; Andrej,11,0,15,4
1668445165304,MATH 240B,A00,098033,Ni; Lei,9,0,15,6
1668445165727,MATH 243,A00,098034,Jekel; David Andrew,10,0,10,0
1668445166153,MATH 245A,A00,098035,Nie; Jiawang,0,2,15,16
1668445166583,MATH 248,A00,098036,Bejenaru; Ioan,10,0,10,0
1668445167020,MATH 250B,A00,098037,Spolaor; Luca,14,0,15,1
1668445167446,MATH 258,A00,098038,Ni; Lei,10,0,10,0
1668445167869,MATH 264B,A00,098041,Rhoades; Brendon Patrick,9,0,15,6
1668445168303,MATH 268,A00,098042,Buss; Samuel R,10,0,10,0
1668445168731,MATH 269,A00,098043,Rhoades; Brendon Patrick,10,0,10,0
1668445169159,MATH 270B,A00,098044,Li; Bo,10,0,15,5
1668445169584,MATH 272B,A00,098045,Holst; Michael J,13,0,15,2
1668445170008,MATH 273A,A00,098046,Tian; Xiaochuan,10,0,15,5
1668445170440,MATH 275,A01,098048,Tian; Xiaochuan,6,0,10,4
1668445170880,MATH 278A,A00,098049,Holst; Michael J,8,0,10,2
1668445171305,MATH 278B,A00,098050,Cloninger; Alexander,10,0,10,0
1668445171746,MATH 278C,A00,098051,Nie; Jiawang,6,0,10,4
1668445172170,MATH 280B,A00,098052,Zheng; Tianyi,7,0,15,8
1668445172599,MATH 281B,A00,098053,Bradic; Jelena,0,1,15,15
1668445173029,MATH 282B,A00,098054,Arias-Castro; Ery,0,0,15,15
1668445173452,MATH 285,A00,098055,Fitzsimmons; Patrick J,0,1,15,17
1668445173879,MATH 287B,A00,098056,Arias-Castro; Ery,2,0,15,13
1668445174314,MATH 288,A00,098057,Agarwal; Pooja,9,0,10,1
1668445174314,MATH 288,B00,098058,Zhang; Danna,8,0,10,2
1668445174314,MATH 288,C00,098059,Williams; Ruth J,9,0,10,1
1668445174738,MATH 290B,A00,098060,Roberts; Justin Deritter,13,0,15,2
1668445175170,MATH 292,A00,098061,Belmont; Eva Kinoshita,10,0,10,0
1668445175593,MATH 295,A00,098062,Suk; Andrew Hoon,48,0,50,2
1668445176023,MATH 296,A00,098063,Novak; Jonathan I,20,0,20,0
1668445176460,MATH 297,001,098064,Gamst; Anthony Collins,9997,0,9999,2
1668445680186,COGS 205,A00,101395,Chiba; Andrea,19,0,20,1
1668445680613,COGS 210B,001,101404,Greene; Deanna Jacquelyn,9998,0,9999,1
1668445680613,COGS 210B,002,101417,Xia; Haijun,9999,0,9999,0
1668445680613,COGS 210B,003,101422,Nitz; Douglas A.,9999,0,9999,0
1668445680613,COGS 210B,004,101423,Hollan; James D.,9998,0,9999,1
1668445680613,COGS 210B,005,101424,Deak; Gedeon O.,9998,0,9999,1
1668445680613,COGS 210B,006,101425,Rossano; Federico,9999,0,9999,0
1668445681053,COGS 211B,A00,101427,Coulson; Seana M,9996,0,9999,3
1668445681478,COGS 220,A00,101428,Hollan; James D.,1,4,25,24
1668445681904,COGS 229,A00,101429,Dow; Steven P,18,0,25,7
1668445682327,COGS 230,A00,101430,Klemmer; Scott R,11,0,17,6
1668445682752,COGS 234,A00,101431,Xia; Haijun,2,0,25,23
1668445683186,COGS 260,A00,101432,Kiyonaga; Anastasia,21,0,25,4
1668445683186,COGS 260,B00,101433,Kirsh; David Joel,15,0,25,10
1668445683613,CSE 202,A00,102371,Impagliazzo; Russell,0,41,0,0
1668445684037,CSE 203B,A01,102373,Cheng; Chung Kuan,0,32,0,0
1668445684468,CSE 208,A00,102374,Micciancio; Daniele,0,2,0,0
1668445684894,CSE 209A,A00,112895,Impagliazzo; Russell,0,7,15,15
1668445685317,CSE 209B,A00,108005,Bellare; Mihir,0,3,0,0
1668445685744,CSE 210,A00,113163,Coblenz; Michael J,0,49,0,0
1668445686167,CSE 219,A00,106111,Dow; Steven P,0,0,20,20
1668445686593,CSE 221,A00,102376,Voelker; Geoffrey M.,0,38,0,0
1668445687019,CSE 224,A01,102378,Porter; George M,0,109,0,0
1668445687447,CSE 229A,A00,102379,Savage; Stefan,0,4,0,0
1668445687873,CSE 229C,A00,102380,Munyaka; Imani N. S.,0,4,0,0
1668445688303,CSE 232B,A00,102382,Deutsch; Alin Bernard,0,18,0,0
1668445688728,CSE 234,A01,112904,Kumar; Arun Kumar,0,0,0,0
1668445689152,CSE 237A,A00,102383,Rosing; Tajana Simunic,0,28,0,0
1668445689582,CSE 239A,A00,102384,Deutsch; Alin Bernard,0,6,0,0
1668445690017,CSE 239B,A00,102385,Polikarpova; Nadezhda,0,4,0,0
1668445690452,CSE 240A,A00,102386,Pannuto; Patrick William,0,31,0,0
1668445690878,CSE 240B,A00,102387,Zhao; Jishen,0,31,0,0
1668445691307,CSE 241A,A00,106406,Kang; Mingu,0,4,0,0
1668445691740,CSE 249B,A00,102388,Kahng; Andrew Byun,0,1,8,8
1668445692173,CSE 251B,A01,102392,Cottrell; Garrison W,0,29,0,0
1668445692173,CSE 251B,A02,102393,Cottrell; Garrison W,0,24,0,0
1668445692598,CSE 252B,A00,102394,Ochoa; Benjamin Lawrence,0,40,0,0
1668445693024,CSE 257,A01,102396,Gao; Sicun,0,94,0,0
1668445693458,CSE 272,A00,102397,Li; Tzumao,0,9,0,0
1668445693882,CSE 274,A00,111323,Chern; Albert Ren-Haur,0,8,0,0
1668445694312,CSE 282,A00,102398,Pevzner; Pavel Arkadjevich,0,0,0,0
1668445694736,CSE 284,A00,114175,Gymrek; Melissa Ann,0,14,0,0
1668445695167,CSE 290,A00,102399,Chandraker; Manmohan Krishna,0,4,0,0
1668445695167,CSE 290,B00,102400,Vaccaro; Kristen Marie,0,1,25,25
1668445695167,CSE 290,C00,102414,Pannuto; Patrick William,0,1,25,25
1668445695167,CSE 290,D00,102427,Pevzner; Pavel Arkadjevich,0,0,0,0
1668445695167,CSE 290,E00,102429,Zhao; Jishen,0,2,0,0
1668445695167,CSE 290,F00,102436,Tullsen; Dean Michael,0,4,0,0
1668445695167,CSE 290,G00,102440,Christensen; Henrik I,0,3,20,20
1668445695595,CSE 291,A00,102443,Su; Hao,0,0,0,0
1668445695595,CSE 291,B00,102448,Polikarpova; Nadezhda,0,0,0,0
1668445695595,CSE 291,C00,102453,Vaccaro; Kristen Marie,0,0,0,0
1668445695595,CSE 291,D00,111343,Savage; Stefan,0,0,0,0
1668445695595,CSE 291,E00,116474,Claffy; Kimberly Claire,0,0,0,0
1668445695595,CSE 291,F00,116479,Pasquale; Joseph,0,0,0,0
1668445696022,CSE 293,001,119111,Bafna; Vineet,9999,0,9999,0
1668445696022,CSE 293,002,119118,Bellare; Mihir,9999,0,9999,0
1668445696022,CSE 293,003,119122,Berg-Kirkpatrick; Taylor D,9999,0,9999,0
1668445696022,CSE 293,004,119135,Christensen; Henrik I,9999,0,9999,0
1668445696022,CSE 293,005,119142,Cottrell; Garrison W,9999,0,9999,0
1668445696022,CSE 293,006,119146,Deutsch; Alin Bernard,9999,0,9999,0
1668445696022,CSE 293,007,119159,Esmaeilzadeh; Hadi,9999,0,9999,0
1668445696022,CSE 293,008,119166,Freund; Yoav,9999,0,9999,0
1668445696022,CSE 293,009,119170,Griswold; William G.,9999,0,9999,0
1668445696022,CSE 293,010,119183,Gymrek; Melissa Ann,9999,0,9999,0
1668445696022,CSE 293,011,119190,Heninger; Nadia A,9999,0,9999,0
1668445696022,CSE 293,012,119230,Impagliazzo; Russell,9999,0,9999,0
1668445696022,CSE 293,013,119232,Jhala; Ranjit,9999,0,9999,0
1668445696022,CSE 293,014,119233,Kahng; Andrew Byun,9999,0,9999,0
1668445696022,CSE 293,015,119298,Kane; Daniel Mertz,9999,0,9999,0
1668445696022,CSE 293,016,119299,Kriegman; David J,9999,0,9999,0
1668445696022,CSE 293,017,119300,Kumar; Arun Kumar,9999,0,9999,0
1668445696022,CSE 293,018,119301,Lerner; Sorin,9999,0,9999,0
1668445696022,CSE 293,019,119302,Lovett; Shachar,9999,0,9999,0
1668445696022,CSE 293,020,119303,McAuley; Julian John,9999,0,9999,0
1668445696022,CSE 293,021,119304,Micciancio; Daniele,9999,0,9999,0
1668445696022,CSE 293,022,119367,Orailoglu; Alex,9999,0,9999,0
1668445696022,CSE 293,023,119382,Paturi; Ramamohan,9999,0,9999,0
1668445696022,CSE 293,024,119404,Polikarpova; Nadezhda,9999,0,9999,0
1668445696022,CSE 293,025,119406,Politz; Joseph Gibbs,9999,0,9999,0
1668445696022,CSE 293,026,119411,Porter; George M,9999,0,9999,0
1668445696022,CSE 293,027,119414,Porter; Leonard Emerson,9999,0,9999,0
1668445696022,CSE 293,028,119416,Ramamoorthi; Ravi,9999,0,9999,0
1668445696022,CSE 293,029,119417,Sahoo; Debashis,9999,0,9999,0
1668445696022,CSE 293,030,119420,Saul; Lawrence,9999,0,9999,0
1668445696022,CSE 293,031,119421,Savage; Stefan,9999,0,9999,0
1668445696022,CSE 293,032,119425,Schulze; Jurgen P.,9999,0,9999,0
1668445696022,CSE 293,033,119426,Snoeren; Alex C.,9999,0,9999,0
1668445696022,CSE 293,034,119428,Shang; Jingbo,9999,0,9999,0
1668445696022,CSE 293,035,119430,Stefan; Deian,9999,0,9999,0
1668445696022,CSE 293,036,119431,Su; Hao,9999,0,9999,0
1668445696022,CSE 293,037,119433,Swanson; Steven James,9999,0,9999,0
1668445696022,CSE 293,038,119435,Tullsen; Dean Michael,9999,0,9999,0
1668445696022,CSE 293,039,119483,Voelker; Geoffrey M.,9999,0,9999,0
1668445696022,CSE 293,040,119537,Zhao; Jishen,9999,0,9999,0
1668445696022,CSE 293,041,119538,Zhou; Yuan-Yuan,9999,0,9999,0
1668445696022,CSE 293,042,119539,Gao; Sicun,9999,0,9999,0
1668445696022,CSE 293,043,119540,Weibel; Nadir,9999,0,9999,0
1668445696022,CSE 293,044,119541,Gupta; Rajesh K.,9999,0,9999,0
1668445696022,CSE 293,045,126410,Vaccaro; Kristen Marie,9999,0,9999,0
1668445696022,CSE 293,046,126411,Klemke; Richard,9999,0,9999,0
1668445696451,CSE 294,A00,102459,Voelker; Geoffrey M.,0,2,0,0
1668445696451,CSE 294,B00,111322,Orailoglu; Alex,0,0,0,0
1668445696884,DSE 201,A00,096914,Deutsch; Alin Bernard,30,0,30,0
1668445697314,DSE 210,A00,096915,Dasgupta; Sanjoy,30,0,30,0
1668445697751,DSE 260A,A00,096916,Altintas De Callaf; Ilkay,30,0,30,0
1668445698230,ECE 200,001,103586,Antipa; Nicholas A,9999,0,9999,0
1668445698230,ECE 200,002,103587,Atanasov; Nikolay A.,9999,0,9999,0
1668445698230,ECE 200,003,103588,Bharadia; Dinesh,9999,0,9999,0
1668445698230,ECE 200,004,103589,Cheng; Chung Kuan,9999,0,9999,0
1668445698230,ECE 200,005,103590,Cosman; Pamela C.,9999,0,9999,0
1668445698230,ECE 200,006,103591,Dayeh; Shadi Ahmad,9999,0,9999,0
1668445698230,ECE 200,007,103592,Fainman; Yeshaiahu,9999,0,9999,0
1668445698230,ECE 200,008,103593,Ford; Joseph Earl,9999,0,9999,0
1668445698230,ECE 200,009,103594,Franceschetti; Massimo,9999,0,9999,0
1668445698230,ECE 200,010,103595,Fullerton; Eric E,9999,0,9999,0
1668445698230,ECE 200,011,103596,Galton; Ian A,9999,0,9999,0
1668445698230,ECE 200,012,103597,Gilja; Vikash,9999,0,9999,0
1668445698230,ECE 200,013,103598,Hall; Drew A.,9999,0,9999,0
1668445698230,ECE 200,014,103599,Hsueh; Tzu-Chien,9999,0,9999,0
1668445698230,ECE 200,015,103600,Javidi; Tara,9999,0,9999,0
1668445698230,ECE 200,016,103601,Kahng; Andrew Byun,9999,0,9999,0
1668445698230,ECE 200,017,103602,Kim; Young-Han,9999,0,9999,0
1668445698230,ECE 200,018,103603,Koushanfar; Farinaz,9999,0,9999,0
1668445698230,ECE 200,019,103604,Kuzum; Duygu,9999,0,9999,0
1668445698230,ECE 200,020,103605,Le; Hanh-Phuc,9999,0,9999,0
1668445698230,ECE 200,021,103606,Lin; Bill,9999,0,9999,0
1668445698230,ECE 200,022,103607,Liu; Zhaowei,9998,0,9999,1
1668445698230,ECE 200,023,103608,Lo; Yu-Hwa,9999,0,9999,0
1668445698230,ECE 200,024,103609,Lomakin; Vitaliy,9999,0,9999,0
1668445698230,ECE 200,025,103610,Mercier; Patrick Philip,9999,0,9999,0
1668445698230,ECE 200,026,103611,Meyer; Florian,9999,0,9999,0
1668445698230,ECE 200,027,103612,Milstein; Laurence B.,9999,0,9999,0
1668445698230,ECE 200,028,103613,Mir Arabbaygi; Siavash,9999,0,9999,0
1668445698230,ECE 200,029,103614,Mookherjea; Shayan,9999,0,9999,0
1668445698230,ECE 200,030,103615,Morris; Karcher William,9999,0,9999,0
1668445698230,ECE 200,031,103616,Ng; Tse Nga,9999,0,9999,0
1668445698230,ECE 200,032,103617,Nguyen; Truong Quang,9999,0,9999,0
1668445698230,ECE 200,033,103618,Nomura; Kenji,9999,0,9999,0
1668445698230,ECE 200,034,103619,Orlitsky; Alon,9999,0,9999,0
1668445698230,ECE 200,035,103620,Pal; Piya,9999,0,9999,0
1668445698230,ECE 200,036,103621,Papen; George C.,9999,0,9999,0
1668445698230,ECE 200,037,103622,Radic; Stojan,9999,0,9999,0
1668445698230,ECE 200,038,103623,Rao; Bhaskar D.,9999,0,9999,0
1668445698230,ECE 200,039,103624,Rao; Ramesh R,9999,0,9999,0
1668445698230,ECE 200,040,103625,Rebeiz; Gabriel,9999,0,9999,0
1668445698230,ECE 200,041,103626,Sanford; John R,9999,0,9999,0
1668445698230,ECE 200,042,103627,Siegel; Paul H.,9999,0,9999,0
1668445698230,ECE 200,043,103628,Sievenpiper; Daniel F.,9999,0,9999,0
1668445698230,ECE 200,044,103629,Sworder; David D.,9999,0,9999,0
1668445698230,ECE 200,045,103630,Taur; Yuan,9999,0,9999,0
1668445698230,ECE 200,046,103631,Touri; Behrouz,9999,0,9999,0
1668445698230,ECE 200,047,103632,Trivedi; Mohan M.,9999,0,9999,0
1668445698230,ECE 200,048,103633,Vasconcelos; Nuno,9999,0,9999,0
1668445698230,ECE 200,049,103634,Wang; Xiaolong,9999,0,9999,0
1668445698230,ECE 200,050,103635,Xie; Pengtao,9999,0,9999,0
1668445698230,ECE 200,051,103636,Yip; Michael,9999,0,9999,0
1668445698230,ECE 200,052,103637,Zeger; Kenneth A.,999,0,999,0
1668445698230,ECE 200,053,103638,Zhang; Xinyu,9999,0,9999,0
1668445698230,ECE 200,054,103639,Turakhia; Yatish Girish,9999,0,9999,0
1668445698230,ECE 200,055,103640,Kang; Mingu,9999,0,9999,0
1668445698230,ECE 200,056,103641,Shi; Yuanyuan,9999,0,9999,0
1668445698230,ECE 200,057,103642,Wang; Edward Jay,9999,0,9999,0
1668445698230,ECE 200,058,103643,Zheng; Yang,9999,0,9999,0
1668445698658,ECE 202,A00,103644,Kuzum; Duygu,0,27,0,0
1668445699087,ECE 212BN,A00,103646,Ng; Tse Nga,0,1,0,0
1668445699515,ECE 221,A00,111493,Staff,0,0,0,0
1668445699949,ECE 222B,A00,103647,Lomakin; Vitaliy,0,5,0,0
1668445700376,ECE 230B,A00,103648,Taur; Yuan,0,0,0,0
1668445700797,ECE 238B,A00,103649,Garay; Javier,0,0,0,0
1668445701224,ECE 240B,A00,112900,Fainman; Yeshaiahu,0,4,0,0
1668445701661,ECE 247A,A00,103650,Jokerst; Jesse Vincent,0,2,0,0
1668445702084,ECE 247B,A00,103651,Wang; Joseph,0,7,0,0
1668445702508,ECE 250,A00,103652,Siegel; Paul H.,0,50,0,0
1668445702943,ECE 251A,A00,103654,Rao; Bhaskar D.,0,35,0,0
1668445703368,ECE 257B,A00,103655,Bharadia; Dinesh,0,18,0,0
1668445703806,ECE 258A,A00,103656,Milstein; Laurence B.,0,13,0,0
1668445704228,ECE 260B,A00,103658,Kang; Mingu,0,73,0,0
1668445704653,ECE 264A,A00,103659,Galton; Ian A,0,41,0,0
1668445705078,ECE 265A,A00,103661,Gudem; Prasad S.S.,0,23,0,0
1668445705505,ECE 265D,A00,103662,Gudem; Prasad S.S.,0,16,0,0
1668445705938,ECE 268,A00,103663,Koushanfar; Farinaz,0,27,0,0
1668445706373,ECE 269,A01,103665,Pal; Piya,0,144,0,0
1668445706797,ECE 271B,A00,103666,Vasconcelos; Manuela,0,50,0,0
1668445707221,ECE 276A,A00,103667,Atanasov; Nikolay A.,0,78,0,0
1668445707648,ECE 277,A00,103668,An; Cheolhong,0,100,0,0
1668445708080,ECE 279,A00,117947,Hall; Drew A.,0,14,0,0
1668445708932,ECE 283,A00,103670,Hsueh; Tzu-Chien,0,32,0,0
1668445709355,ECE 284,A00,103671,Turakhia; Yatish Girish,0,28,0,0
1668445709782,ECE 285,A00,103672,Zheng; Yang,0,26,0,0
1668445709782,ECE 285,B00,103673,Sworder; David D.,0,41,0,0
1668445710215,ECE 287,A00,103676,Javidi; Tara,0,4,0,0
1668445710642,MATH 200B,A00,098023,Salehi Golsefidy; Alireza,12,0,15,3
1668445711075,MATH 202B,A00,098024,Rhoades; Brendon Patrick,9,0,15,6
1668445711499,MATH 203B,A00,098025,Oprea; Dragos N.,10,0,15,5
1668445711937,MATH 204B,A00,098026,Sorensen; Claus M,13,0,15,2
1668445712359,MATH 208,A00,098027,Izadi; Elham,7,0,10,3
1668445712785,MATH 209,A00,098028,Pollack; Aaron,10,0,10,0
1668445713218,MATH 211A,A00,112919,Rogalski; Daniel,9,0,10,1
1668445713653,MATH 211B,A00,112920,Seward; Brandon M.,9,0,10,1
1668445714076,MATH 218,A00,098029,Li; Bo,10,0,10,0
1668445714511,MATH 220B,A00,098030,Novak; Jonathan I,11,0,15,4
1668445714950,MATH 221A,A00,098031,Ebenfelt; Peter F,13,0,15,2
1668445715375,MATH 231B,A00,098032,Zlatos; Andrej,11,0,15,4
1668445715798,MATH 240B,A00,098033,Ni; Lei,9,0,15,6
1668445716222,MATH 243,A00,098034,Jekel; David Andrew,10,0,10,0
1668445716649,MATH 245A,A00,098035,Nie; Jiawang,0,2,15,16
1668445717075,MATH 248,A00,098036,Bejenaru; Ioan,10,0,10,0
1668445717499,MATH 250B,A00,098037,Spolaor; Luca,14,0,15,1
1668445717938,MATH 258,A00,098038,Ni; Lei,10,0,10,0
1668445718368,MATH 264B,A00,098041,Rhoades; Brendon Patrick,9,0,15,6
1668445718873,MATH 268,A00,098042,Buss; Samuel R,10,0,10,0
1668445719310,MATH 269,A00,098043,Rhoades; Brendon Patrick,10,0,10,0
1668445719751,MATH 270B,A00,098044,Li; Bo,10,0,15,5
1668445720187,MATH 272B,A00,098045,Holst; Michael J,13,0,15,2
1668445720612,MATH 273A,A00,098046,Tian; Xiaochuan,10,0,15,5
1668445721038,MATH 275,A01,098048,Tian; Xiaochuan,6,0,10,4
1668445721461,MATH 278A,A00,098049,Holst; Michael J,8,0,10,2
1668445721886,MATH 278B,A00,098050,Cloninger; Alexander,10,0,10,0
1668445722312,MATH 278C,A00,098051,Nie; Jiawang,6,0,10,4
1668445722737,MATH 280B,A00,098052,Zheng; Tianyi,7,0,15,8
1668445723164,MATH 281B,A00,098053,Bradic; Jelena,0,1,15,15
1668445723597,MATH 282B,A00,098054,Arias-Castro; Ery,0,0,15,15
1668445724021,MATH 285,A00,098055,Fitzsimmons; Patrick J,0,1,15,17
1668445724445,MATH 287B,A00,098056,Arias-Castro; Ery,2,0,15,13
1668445724881,MATH 288,A00,098057,Agarwal; Pooja,9,0,10,1
1668445724881,MATH 288,B00,098058,Zhang; Danna,8,0,10,2
1668445724881,MATH 288,C00,098059,Williams; Ruth J,9,0,10,1
1668445725316,MATH 290B,A00,098060,Roberts; Justin Deritter,13,0,15,2
1668445725766,MATH 292,A00,098061,Belmont; Eva Kinoshita,10,0,10,0
1668445726188,MATH 295,A00,098062,Suk; Andrew Hoon,48,0,50,2
1668445726611,MATH 296,A00,098063,Novak; Jonathan I,20,0,20,0
1668445727039,MATH 297,001,098064,Gamst; Anthony Collins,9997,0,9999,2
1668446230809,COGS 205,A00,101395,Chiba; Andrea,19,0,20,1
1668446231237,COGS 210B,001,101404,Greene; Deanna Jacquelyn,9998,0,9999,1
1668446231237,COGS 210B,002,101417,Xia; Haijun,9999,0,9999,0
1668446231237,COGS 210B,003,101422,Nitz; Douglas A.,9999,0,9999,0
1668446231237,COGS 210B,004,101423,Hollan; James D.,9998,0,9999,1
1668446231237,COGS 210B,005,101424,Deak; Gedeon O.,9998,0,9999,1
1668446231237,COGS 210B,006,101425,Rossano; Federico,9999,0,9999,0
1668446231678,COGS 211B,A00,101427,Coulson; Seana M,9996,0,9999,3
1668446232119,COGS 220,A00,101428,Hollan; James D.,1,4,25,24
1668446232549,COGS 229,A00,101429,Dow; Steven P,18,0,25,7
1668446232972,COGS 230,A00,101430,Klemmer; Scott R,11,0,17,6
1668446233422,COGS 234,A00,101431,Xia; Haijun,2,0,25,23
1668446233851,COGS 260,A00,101432,Kiyonaga; Anastasia,21,0,25,4
1668446233851,COGS 260,B00,101433,Kirsh; David Joel,15,0,25,10
1668446234276,CSE 202,A00,102371,Impagliazzo; Russell,0,41,0,0
1668446234699,CSE 203B,A01,102373,Cheng; Chung Kuan,0,32,0,0
1668446235138,CSE 208,A00,102374,Micciancio; Daniele,0,2,0,0
1668446235561,CSE 209A,A00,112895,Impagliazzo; Russell,0,7,15,15
1668446235994,CSE 209B,A00,108005,Bellare; Mihir,0,3,0,0
1668446236428,CSE 210,A00,113163,Coblenz; Michael J,0,49,0,0
1668446236854,CSE 219,A00,106111,Dow; Steven P,0,0,20,20
1668446237281,CSE 221,A00,102376,Voelker; Geoffrey M.,0,38,0,0
1668446237711,CSE 224,A01,102378,Porter; George M,0,111,0,0
1668446238135,CSE 229A,A00,102379,Savage; Stefan,0,4,0,0
1668446238579,CSE 229C,A00,102380,Munyaka; Imani N. S.,0,4,0,0
1668446239005,CSE 232B,A00,102382,Deutsch; Alin Bernard,0,18,0,0
1668446239428,CSE 234,A01,112904,Kumar; Arun Kumar,0,0,0,0
1668446239852,CSE 237A,A00,102383,Rosing; Tajana Simunic,0,29,0,0
1668446240274,CSE 239A,A00,102384,Deutsch; Alin Bernard,0,6,0,0
1668446240700,CSE 239B,A00,102385,Polikarpova; Nadezhda,0,4,0,0
1668446241135,CSE 240A,A00,102386,Pannuto; Patrick William,0,31,0,0
1668446241564,CSE 240B,A00,102387,Zhao; Jishen,0,31,0,0
1668446242090,CSE 241A,A00,106406,Kang; Mingu,0,5,0,0
1668446242520,CSE 249B,A00,102388,Kahng; Andrew Byun,0,1,8,8
1668446242953,CSE 251B,A01,102392,Cottrell; Garrison W,0,30,0,0
1668446242953,CSE 251B,A02,102393,Cottrell; Garrison W,0,24,0,0
1668446243384,CSE 252B,A00,102394,Ochoa; Benjamin Lawrence,0,40,0,0
1668446243808,CSE 257,A01,102396,Gao; Sicun,0,94,0,0
1668446244232,CSE 272,A00,102397,Li; Tzumao,0,9,0,0
1668446244656,CSE 274,A00,111323,Chern; Albert Ren-Haur,0,8,0,0
1668446245079,CSE 282,A00,102398,Pevzner; Pavel Arkadjevich,0,0,0,0
1668446245507,CSE 284,A00,114175,Gymrek; Melissa Ann,0,14,0,0
1668446245936,CSE 290,A00,102399,Chandraker; Manmohan Krishna,0,4,0,0
1668446245936,CSE 290,B00,102400,Vaccaro; Kristen Marie,0,2,25,25
1668446245936,CSE 290,C00,102414,Pannuto; Patrick William,0,1,25,25
1668446245936,CSE 290,D00,102427,Pevzner; Pavel Arkadjevich,0,0,0,0
1668446245936,CSE 290,E00,102429,Zhao; Jishen,0,2,0,0
1668446245936,CSE 290,F00,102436,Tullsen; Dean Michael,0,4,0,0
1668446245936,CSE 290,G00,102440,Christensen; Henrik I,0,3,20,20
1668446246361,CSE 291,A00,102443,Su; Hao,0,0,0,0
1668446246361,CSE 291,B00,102448,Polikarpova; Nadezhda,0,0,0,0
1668446246361,CSE 291,C00,102453,Vaccaro; Kristen Marie,0,0,0,0
1668446246361,CSE 291,D00,111343,Savage; Stefan,0,0,0,0
1668446246361,CSE 291,E00,116474,Claffy; Kimberly Claire,0,0,0,0
1668446246361,CSE 291,F00,116479,Pasquale; Joseph,0,0,0,0
1668446246789,CSE 293,001,119111,Bafna; Vineet,9999,0,9999,0
1668446246789,CSE 293,002,119118,Bellare; Mihir,9999,0,9999,0
1668446246789,CSE 293,003,119122,Berg-Kirkpatrick; Taylor D,9999,0,9999,0
1668446246789,CSE 293,004,119135,Christensen; Henrik I,9999,0,9999,0
1668446246789,CSE 293,005,119142,Cottrell; Garrison W,9999,0,9999,0
1668446246789,CSE 293,006,119146,Deutsch; Alin Bernard,9999,0,9999,0
1668446246789,CSE 293,007,119159,Esmaeilzadeh; Hadi,9999,0,9999,0
1668446246789,CSE 293,008,119166,Freund; Yoav,9999,0,9999,0
1668446246789,CSE 293,009,119170,Griswold; William G.,9999,0,9999,0
1668446246789,CSE 293,010,119183,Gymrek; Melissa Ann,9999,0,9999,0
1668446246789,CSE 293,011,119190,Heninger; Nadia A,9999,0,9999,0
1668446246789,CSE 293,012,119230,Impagliazzo; Russell,9999,0,9999,0
1668446246789,CSE 293,013,119232,Jhala; Ranjit,9999,0,9999,0
1668446246789,CSE 293,014,119233,Kahng; Andrew Byun,9999,0,9999,0
1668446246789,CSE 293,015,119298,Kane; Daniel Mertz,9999,0,9999,0
1668446246789,CSE 293,016,119299,Kriegman; David J,9999,0,9999,0
1668446246789,CSE 293,017,119300,Kumar; Arun Kumar,9999,0,9999,0
1668446246789,CSE 293,018,119301,Lerner; Sorin,9999,0,9999,0
1668446246789,CSE 293,019,119302,Lovett; Shachar,9999,0,9999,0
1668446246789,CSE 293,020,119303,McAuley; Julian John,9999,0,9999,0
1668446246789,CSE 293,021,119304,Micciancio; Daniele,9999,0,9999,0
1668446246789,CSE 293,022,119367,Orailoglu; Alex,9999,0,9999,0
1668446246789,CSE 293,023,119382,Paturi; Ramamohan,9999,0,9999,0
1668446246789,CSE 293,024,119404,Polikarpova; Nadezhda,9999,0,9999,0
1668446246789,CSE 293,025,119406,Politz; Joseph Gibbs,9999,0,9999,0
1668446246789,CSE 293,026,119411,Porter; George M,9999,0,9999,0
1668446246789,CSE 293,027,119414,Porter; Leonard Emerson,9999,0,9999,0
1668446246789,CSE 293,028,119416,Ramamoorthi; Ravi,9999,0,9999,0
1668446246789,CSE 293,029,119417,Sahoo; Debashis,9999,0,9999,0
1668446246789,CSE 293,030,119420,Saul; Lawrence,9999,0,9999,0
1668446246789,CSE 293,031,119421,Savage; Stefan,9999,0,9999,0
1668446246789,CSE 293,032,119425,Schulze; Jurgen P.,9999,0,9999,0
1668446246789,CSE 293,033,119426,Snoeren; Alex C.,9999,0,9999,0
1668446246789,CSE 293,034,119428,Shang; Jingbo,9999,0,9999,0
1668446246789,CSE 293,035,119430,Stefan; Deian,9999,0,9999,0
1668446246789,CSE 293,036,119431,Su; Hao,9999,0,9999,0
1668446246789,CSE 293,037,119433,Swanson; Steven James,9999,0,9999,0
1668446246789,CSE 293,038,119435,Tullsen; Dean Michael,9999,0,9999,0
1668446246789,CSE 293,039,119483,Voelker; Geoffrey M.,9999,0,9999,0
1668446246789,CSE 293,040,119537,Zhao; Jishen,9999,0,9999,0
1668446246789,CSE 293,041,119538,Zhou; Yuan-Yuan,9999,0,9999,0
1668446246789,CSE 293,042,119539,Gao; Sicun,9999,0,9999,0
1668446246789,CSE 293,043,119540,Weibel; Nadir,9999,0,9999,0
1668446246789,CSE 293,044,119541,Gupta; Rajesh K.,9999,0,9999,0
1668446246789,CSE 293,045,126410,Vaccaro; Kristen Marie,9999,0,9999,0
1668446246789,CSE 293,046,126411,Klemke; Richard,9999,0,9999,0
1668446247217,CSE 294,A00,102459,Voelker; Geoffrey M.,0,2,0,0
1668446247217,CSE 294,B00,111322,Orailoglu; Alex,0,0,0,0
1668446247651,DSE 201,A00,096914,Deutsch; Alin Bernard,30,0,30,0
1668446248082,DSE 210,A00,096915,Dasgupta; Sanjoy,30,0,30,0
1668446248505,DSE 260A,A00,096916,Altintas De Callaf; Ilkay,30,0,30,0
1668446248975,ECE 200,001,103586,Antipa; Nicholas A,9999,0,9999,0
1668446248975,ECE 200,002,103587,Atanasov; Nikolay A.,9999,0,9999,0
1668446248975,ECE 200,003,103588,Bharadia; Dinesh,9999,0,9999,0
1668446248975,ECE 200,004,103589,Cheng; Chung Kuan,9999,0,9999,0
1668446248975,ECE 200,005,103590,Cosman; Pamela C.,9999,0,9999,0
1668446248975,ECE 200,006,103591,Dayeh; Shadi Ahmad,9999,0,9999,0
1668446248975,ECE 200,007,103592,Fainman; Yeshaiahu,9999,0,9999,0
1668446248975,ECE 200,008,103593,Ford; Joseph Earl,9999,0,9999,0
1668446248975,ECE 200,009,103594,Franceschetti; Massimo,9999,0,9999,0
1668446248975,ECE 200,010,103595,Fullerton; Eric E,9999,0,9999,0
1668446248975,ECE 200,011,103596,Galton; Ian A,9999,0,9999,0
1668446248975,ECE 200,012,103597,Gilja; Vikash,9999,0,9999,0
1668446248975,ECE 200,013,103598,Hall; Drew A.,9999,0,9999,0
1668446248975,ECE 200,014,103599,Hsueh; Tzu-Chien,9999,0,9999,0
1668446248975,ECE 200,015,103600,Javidi; Tara,9999,0,9999,0
1668446248975,ECE 200,016,103601,Kahng; Andrew Byun,9999,0,9999,0
1668446248975,ECE 200,017,103602,Kim; Young-Han,9999,0,9999,0
1668446248975,ECE 200,018,103603,Koushanfar; Farinaz,9999,0,9999,0
1668446248975,ECE 200,019,103604,Kuzum; Duygu,9999,0,9999,0
1668446248975,ECE 200,020,103605,Le; Hanh-Phuc,9999,0,9999,0
1668446248975,ECE 200,021,103606,Lin; Bill,9999,0,9999,0
1668446248975,ECE 200,022,103607,Liu; Zhaowei,9998,0,9999,1
1668446248975,ECE 200,023,103608,Lo; Yu-Hwa,9999,0,9999,0
1668446248975,ECE 200,024,103609,Lomakin; Vitaliy,9999,0,9999,0
1668446248975,ECE 200,025,103610,Mercier; Patrick Philip,9999,0,9999,0
1668446248975,ECE 200,026,103611,Meyer; Florian,9999,0,9999,0
1668446248975,ECE 200,027,103612,Milstein; Laurence B.,9999,0,9999,0
1668446248975,ECE 200,028,103613,Mir Arabbaygi; Siavash,9999,0,9999,0
1668446248975,ECE 200,029,103614,Mookherjea; Shayan,9999,0,9999,0
1668446248975,ECE 200,030,103615,Morris; Karcher William,9999,0,9999,0
1668446248975,ECE 200,031,103616,Ng; Tse Nga,9999,0,9999,0
1668446248975,ECE 200,032,103617,Nguyen; Truong Quang,9999,0,9999,0
1668446248975,ECE 200,033,103618,Nomura; Kenji,9999,0,9999,0
1668446248975,ECE 200,034,103619,Orlitsky; Alon,9999,0,9999,0
1668446248975,ECE 200,035,103620,Pal; Piya,9999,0,9999,0
1668446248975,ECE 200,036,103621,Papen; George C.,9999,0,9999,0
1668446248975,ECE 200,037,103622,Radic; Stojan,9999,0,9999,0
1668446248975,ECE 200,038,103623,Rao; Bhaskar D.,9999,0,9999,0
1668446248975,ECE 200,039,103624,Rao; Ramesh R,9999,0,9999,0
1668446248975,ECE 200,040,103625,Rebeiz; Gabriel,9999,0,9999,0
1668446248975,ECE 200,041,103626,Sanford; John R,9999,0,9999,0
1668446248975,ECE 200,042,103627,Siegel; Paul H.,9999,0,9999,0
1668446248975,ECE 200,043,103628,Sievenpiper; Daniel F.,9999,0,9999,0
1668446248975,ECE 200,044,103629,Sworder; David D.,9999,0,9999,0
1668446248975,ECE 200,045,103630,Taur; Yuan,9999,0,9999,0
1668446248975,ECE 200,046,103631,Touri; Behrouz,9999,0,9999,0
1668446248975,ECE 200,047,103632,Trivedi; Mohan M.,9999,0,9999,0
1668446248975,ECE 200,048,103633,Vasconcelos; Nuno,9999,0,9999,0
1668446248975,ECE 200,049,103634,Wang; Xiaolong,9999,0,9999,0
1668446248975,ECE 200,050,103635,Xie; Pengtao,9999,0,9999,0
1668446248975,ECE 200,051,103636,Yip; Michael,9999,0,9999,0
1668446248975,ECE 200,052,103637,Zeger; Kenneth A.,999,0,999,0
1668446248975,ECE 200,053,103638,Zhang; Xinyu,9999,0,9999,0
1668446248975,ECE 200,054,103639,Turakhia; Yatish Girish,9999,0,9999,0
1668446248975,ECE 200,055,103640,Kang; Mingu,9999,0,9999,0
1668446248975,ECE 200,056,103641,Shi; Yuanyuan,9999,0,9999,0
1668446248975,ECE 200,057,103642,Wang; Edward Jay,9999,0,9999,0
1668446248975,ECE 200,058,103643,Zheng; Yang,9999,0,9999,0
1668446249406,ECE 202,A00,103644,Kuzum; Duygu,0,27,0,0
1668446249828,ECE 212BN,A00,103646,Ng; Tse Nga,0,1,0,0
1668446250253,ECE 221,A00,111493,Staff,0,0,0,0
1668446250678,ECE 222B,A00,103647,Lomakin; Vitaliy,0,5,0,0
1668446251106,ECE 230B,A00,103648,Taur; Yuan,0,0,0,0
1668446251531,ECE 238B,A00,103649,Garay; Javier,0,0,0,0
1668446251957,ECE 240B,A00,112900,Fainman; Yeshaiahu,0,4,0,0
1668446252382,ECE 247A,A00,103650,Jokerst; Jesse Vincent,0,2,0,0
1668446252809,ECE 247B,A00,103651,Wang; Joseph,0,7,0,0
1668446253245,ECE 250,A00,103652,Siegel; Paul H.,0,50,0,0
1668446253670,ECE 251A,A00,103654,Rao; Bhaskar D.,0,36,0,0
1668446254093,ECE 257B,A00,103655,Bharadia; Dinesh,0,18,0,0
1668446254520,ECE 258A,A00,103656,Milstein; Laurence B.,0,14,0,0
1668446254945,ECE 260B,A00,103658,Kang; Mingu,0,75,0,0
1668446255375,ECE 264A,A00,103659,Galton; Ian A,0,42,0,0
1668446255811,ECE 265A,A00,103661,Gudem; Prasad S.S.,0,24,0,0
1668446256235,ECE 265D,A00,103662,Gudem; Prasad S.S.,0,16,0,0
1668446256661,ECE 268,A00,103663,Koushanfar; Farinaz,0,27,0,0
1668446257083,ECE 269,A01,103665,Pal; Piya,0,144,0,0
1668446257507,ECE 271B,A00,103666,Vasconcelos; Manuela,0,50,0,0
1668446257943,ECE 276A,A00,103667,Atanasov; Nikolay A.,0,78,0,0
1668446258368,ECE 277,A00,103668,An; Cheolhong,0,100,0,0
1668446258793,ECE 279,A00,117947,Hall; Drew A.,0,15,0,0
1668446259656,ECE 283,A00,103670,Hsueh; Tzu-Chien,0,32,0,0
1668446260081,ECE 284,A00,103671,Turakhia; Yatish Girish,0,29,0,0
1668446260512,ECE 285,A00,103672,Zheng; Yang,0,27,0,0
1668446260512,ECE 285,B00,103673,Sworder; David D.,0,41,0,0
1668446260949,ECE 287,A00,103676,Javidi; Tara,0,4,0,0
1668446261372,MATH 200B,A00,098023,Salehi Golsefidy; Alireza,12,0,15,3
1668446261799,MATH 202B,A00,098024,Rhoades; Brendon Patrick,9,0,15,6
1668446262221,MATH 203B,A00,098025,Oprea; Dragos N.,10,0,15,5
1668446262647,MATH 204B,A00,098026,Sorensen; Claus M,13,0,15,2
1668446263071,MATH 208,A00,098027,Izadi; Elham,7,0,10,3
1668446263494,MATH 209,A00,098028,Pollack; Aaron,10,0,10,0
1668446263921,MATH 211A,A00,112919,Rogalski; Daniel,9,0,10,1
1668446264347,MATH 211B,A00,112920,Seward; Brandon M.,9,0,10,1
1668446264779,MATH 218,A00,098029,Li; Bo,10,0,10,0
1668446265203,MATH 220B,A00,098030,Novak; Jonathan I,11,0,15,4
1668446265630,MATH 221A,A00,098031,Ebenfelt; Peter F,13,0,15,2
1668446266059,MATH 231B,A00,098032,Zlatos; Andrej,11,0,15,4
1668446266483,MATH 240B,A00,098033,Ni; Lei,9,0,15,6
1668446266905,MATH 243,A00,098034,Jekel; David Andrew,10,0,10,0
1668446267336,MATH 245A,A00,098035,Nie; Jiawang,0,2,15,16
1668446267760,MATH 248,A00,098036,Bejenaru; Ioan,10,0,10,0
1668446268187,MATH 250B,A00,098037,Spolaor; Luca,14,0,15,1
1668446268612,MATH 258,A00,098038,Ni; Lei,10,0,10,0
1668446269037,MATH 264B,A00,098041,Rhoades; Brendon Patrick,9,0,15,6
1668446269460,MATH 268,A00,098042,Buss; Samuel R,10,0,10,0
1668446269882,MATH 269,A00,098043,Rhoades; Brendon Patrick,10,0,10,0
1668446270316,MATH 270B,A00,098044,Li; Bo,10,0,15,5
1668446270740,MATH 272B,A00,098045,Holst; Michael J,13,0,15,2
1668446271166,MATH 273A,A00,098046,Tian; Xiaochuan,10,0,15,5
1668446271594,MATH 275,A01,098048,Tian; Xiaochuan,6,0,10,4
1668446272022,MATH 278A,A00,098049,Holst; Michael J,8,0,10,2
1668446272460,MATH 278B,A00,098050,Cloninger; Alexander,10,0,10,0
1668446272886,MATH 278C,A00,098051,Nie; Jiawang,6,0,10,4
1668446273313,MATH 280B,A00,098052,Zheng; Tianyi,7,0,15,8
1668446273736,MATH 281B,A00,098053,Bradic; Jelena,0,1,15,15
1668446274163,MATH 282B,A00,098054,Arias-Castro; Ery,0,0,15,15
1668446274590,MATH 285,A00,098055,Fitzsimmons; Patrick J,0,1,15,17
1668446275016,MATH 287B,A00,098056,Arias-Castro; Ery,2,0,15,13
1668446275450,MATH 288,A00,098057,Agarwal; Pooja,9,0,10,1
1668446275450,MATH 288,B00,098058,Zhang; Danna,8,0,10,2
1668446275450,MATH 288,C00,098059,Williams; Ruth J,9,0,10,1
1668446275873,MATH 290B,A00,098060,Roberts; Justin Deritter,13,0,15,2
1668446276296,MATH 292,A00,098061,Belmont; Eva Kinoshita,10,0,10,0
1668446276722,MATH 295,A00,098062,Suk; Andrew Hoon,48,0,50,2
1668446277145,MATH 296,A00,098063,Novak; Jonathan I,20,0,20,0
1668446277567,MATH 297,001,098064,Gamst; Anthony Collins,9997,0,9999,2
1668446787227,COGS 205,A00,101395,Chiba; Andrea,19,0,20,1
1668446787653,COGS 210B,001,101404,Greene; Deanna Jacquelyn,9998,0,9999,1
1668446787653,COGS 210B,002,101417,Xia; Haijun,9999,0,9999,0
1668446787653,COGS 210B,003,101422,Nitz; Douglas A.,9999,0,9999,0
1668446787653,COGS 210B,004,101423,Hollan; James D.,9998,0,9999,1
1668446787653,COGS 210B,005,101424,Deak; Gedeon O.,9998,0,9999,1
1668446787653,COGS 210B,006,101425,Rossano; Federico,9999,0,9999,0
1668446788099,COGS 211B,A00,101427,Coulson; Seana M,9996,0,9999,3
1668446788524,COGS 220,A00,101428,Hollan; James D.,1,4,25,24
1668446788950,COGS 229,A00,101429,Dow; Steven P,18,0,25,7
1668446789385,COGS 230,A00,101430,Klemmer; Scott R,11,0,17,6
1668446789815,COGS 234,A00,101431,Xia; Haijun,2,0,25,23
1668446790249,COGS 260,A00,101432,Kiyonaga; Anastasia,21,0,25,4
1668446790249,COGS 260,B00,101433,Kirsh; David Joel,15,0,25,10
1668446790672,CSE 202,A00,102371,Impagliazzo; Russell,0,42,0,0
1668446791095,CSE 203B,A01,102373,Cheng; Chung Kuan,0,32,0,0
1668446791520,CSE 208,A00,102374,Micciancio; Daniele,0,2,0,0
1668446791944,CSE 209A,A00,112895,Impagliazzo; Russell,0,7,15,15
1668446792368,CSE 209B,A00,108005,Bellare; Mihir,0,3,0,0
1668446792791,CSE 210,A00,113163,Coblenz; Michael J,0,50,0,0
1668446793218,CSE 219,A00,106111,Dow; Steven P,0,2,20,20
1668446793643,CSE 221,A00,102376,Voelker; Geoffrey M.,0,38,0,0
1668446794072,CSE 224,A01,102378,Porter; George M,0,112,0,0
1668446794497,CSE 229A,A00,102379,Savage; Stefan,0,4,0,0
1668446794922,CSE 229C,A00,102380,Munyaka; Imani N. S.,0,4,0,0
1668446795359,CSE 232B,A00,102382,Deutsch; Alin Bernard,0,18,0,0
1668446795793,CSE 234,A01,112904,Kumar; Arun Kumar,0,0,0,0
1668446796238,CSE 237A,A00,102383,Rosing; Tajana Simunic,0,31,0,0
1668446796669,CSE 239A,A00,102384,Deutsch; Alin Bernard,0,6,0,0
1668446797107,CSE 239B,A00,102385,Polikarpova; Nadezhda,0,4,0,0
1668446797542,CSE 240A,A00,102386,Pannuto; Patrick William,0,32,0,0
1668446797969,CSE 240B,A00,102387,Zhao; Jishen,0,31,0,0
1668446798392,CSE 241A,A00,106406,Kang; Mingu,0,5,0,0
1668446798815,CSE 249B,A00,102388,Kahng; Andrew Byun,0,1,8,8
1668446799265,CSE 251B,A01,102392,Cottrell; Garrison W,0,30,0,0
1668446799265,CSE 251B,A02,102393,Cottrell; Garrison W,0,24,0,0
1668446799698,CSE 252B,A00,102394,Ochoa; Benjamin Lawrence,0,40,0,0
1668446800132,CSE 257,A01,102396,Gao; Sicun,0,94,0,0
1668446800562,CSE 272,A00,102397,Li; Tzumao,0,9,0,0
1668446801003,CSE 274,A00,111323,Chern; Albert Ren-Haur,0,8,0,0
1668446801427,CSE 282,A00,102398,Pevzner; Pavel Arkadjevich,0,0,0,0
1668446801852,CSE 284,A00,114175,Gymrek; Melissa Ann,0,14,0,0
1668446802283,CSE 290,A00,102399,Chandraker; Manmohan Krishna,0,4,0,0
1668446802283,CSE 290,B00,102400,Vaccaro; Kristen Marie,0,2,25,25
1668446802283,CSE 290,C00,102414,Pannuto; Patrick William,0,1,25,25
1668446802283,CSE 290,D00,102427,Pevzner; Pavel Arkadjevich,0,0,0,0
1668446802283,CSE 290,E00,102429,Zhao; Jishen,0,2,0,0
1668446802283,CSE 290,F00,102436,Tullsen; Dean Michael,0,4,0,0
1668446802283,CSE 290,G00,102440,Christensen; Henrik I,0,3,20,20
1668446802724,CSE 291,A00,102443,Su; Hao,0,0,0,0
1668446802724,CSE 291,B00,102448,Polikarpova; Nadezhda,0,0,0,0
1668446802724,CSE 291,C00,102453,Vaccaro; Kristen Marie,0,0,0,0
1668446802724,CSE 291,D00,111343,Savage; Stefan,0,0,0,0
1668446802724,CSE 291,E00,116474,Claffy; Kimberly Claire,0,0,0,0
1668446802724,CSE 291,F00,116479,Pasquale; Joseph,0,0,0,0
1668446803172,CSE 293,001,119111,Bafna; Vineet,9999,0,9999,0
1668446803172,CSE 293,002,119118,Bellare; Mihir,9999,0,9999,0
1668446803172,CSE 293,003,119122,Berg-Kirkpatrick; Taylor D,9999,0,9999,0
1668446803172,CSE 293,004,119135,Christensen; Henrik I,9999,0,9999,0
1668446803172,CSE 293,005,119142,Cottrell; Garrison W,9999,0,9999,0
1668446803172,CSE 293,006,119146,Deutsch; Alin Bernard,9999,0,9999,0
1668446803172,CSE 293,007,119159,Esmaeilzadeh; Hadi,9999,0,9999,0
1668446803172,CSE 293,008,119166,Freund; Yoav,9999,0,9999,0
1668446803172,CSE 293,009,119170,Griswold; William G.,9999,0,9999,0
1668446803172,CSE 293,010,119183,Gymrek; Melissa Ann,9999,0,9999,0
1668446803172,CSE 293,011,119190,Heninger; Nadia A,9999,0,9999,0
1668446803172,CSE 293,012,119230,Impagliazzo; Russell,9999,0,9999,0
1668446803172,CSE 293,013,119232,Jhala; Ranjit,9999,0,9999,0
1668446803172,CSE 293,014,119233,Kahng; Andrew Byun,9999,0,9999,0
1668446803172,CSE 293,015,119298,Kane; Daniel Mertz,9999,0,9999,0
1668446803172,CSE 293,016,119299,Kriegman; David J,9999,0,9999,0
1668446803172,CSE 293,017,119300,Kumar; Arun Kumar,9999,0,9999,0
1668446803172,CSE 293,018,119301,Lerner; Sorin,9999,0,9999,0
1668446803172,CSE 293,019,119302,Lovett; Shachar,9999,0,9999,0
1668446803172,CSE 293,020,119303,McAuley; Julian John,9999,0,9999,0
1668446803172,CSE 293,021,119304,Micciancio; Daniele,9999,0,9999,0
1668446803172,CSE 293,022,119367,Orailoglu; Alex,9999,0,9999,0
1668446803172,CSE 293,023,119382,Paturi; Ramamohan,9999,0,9999,0
1668446803172,CSE 293,024,119404,Polikarpova; Nadezhda,9999,0,9999,0
1668446803172,CSE 293,025,119406,Politz; Joseph Gibbs,9999,0,9999,0
1668446803172,CSE 293,026,119411,Porter; George M,9999,0,9999,0
1668446803172,CSE 293,027,119414,Porter; Leonard Emerson,9999,0,9999,0
1668446803172,CSE 293,028,119416,Ramamoorthi; Ravi,9999,0,9999,0
1668446803172,CSE 293,029,119417,Sahoo; Debashis,9999,0,9999,0
1668446803172,CSE 293,030,119420,Saul; Lawrence,9999,0,9999,0
1668446803172,CSE 293,031,119421,Savage; Stefan,9999,0,9999,0
1668446803172,CSE 293,032,119425,Schulze; Jurgen P.,9999,0,9999,0
1668446803172,CSE 293,033,119426,Snoeren; Alex C.,9999,0,9999,0
1668446803172,CSE 293,034,119428,Shang; Jingbo,9999,0,9999,0
1668446803172,CSE 293,035,119430,Stefan; Deian,9999,0,9999,0
1668446803172,CSE 293,036,119431,Su; Hao,9999,0,9999,0
1668446803172,CSE 293,037,119433,Swanson; Steven James,9999,0,9999,0
1668446803172,CSE 293,038,119435,Tullsen; Dean Michael,9999,0,9999,0
1668446803172,CSE 293,039,119483,Voelker; Geoffrey M.,9999,0,9999,0
1668446803172,CSE 293,040,119537,Zhao; Jishen,9999,0,9999,0
1668446803172,CSE 293,041,119538,Zhou; Yuan-Yuan,9999,0,9999,0
1668446803172,CSE 293,042,119539,Gao; Sicun,9999,0,9999,0
1668446803172,CSE 293,043,119540,Weibel; Nadir,9999,0,9999,0
1668446803172,CSE 293,044,119541,Gupta; Rajesh K.,9999,0,9999,0
1668446803172,CSE 293,045,126410,Vaccaro; Kristen Marie,9999,0,9999,0
1668446803172,CSE 293,046,126411,Klemke; Richard,9999,0,9999,0
1668446803597,CSE 294,A00,102459,Voelker; Geoffrey M.,0,2,0,0
1668446803597,CSE 294,B00,111322,Orailoglu; Alex,0,0,0,0
1668446804035,DSE 201,A00,096914,Deutsch; Alin Bernard,30,0,30,0
1668446804460,DSE 210,A00,096915,Dasgupta; Sanjoy,30,0,30,0
1668446804896,DSE 260A,A00,096916,Altintas De Callaf; Ilkay,30,0,30,0
1668446805357,ECE 200,001,103586,Antipa; Nicholas A,9999,0,9999,0
1668446805357,ECE 200,002,103587,Atanasov; Nikolay A.,9999,0,9999,0
1668446805357,ECE 200,003,103588,Bharadia; Dinesh,9999,0,9999,0
1668446805357,ECE 200,004,103589,Cheng; Chung Kuan,9999,0,9999,0
1668446805357,ECE 200,005,103590,Cosman; Pamela C.,9999,0,9999,0
1668446805357,ECE 200,006,103591,Dayeh; Shadi Ahmad,9999,0,9999,0
1668446805357,ECE 200,007,103592,Fainman; Yeshaiahu,9999,0,9999,0
1668446805357,ECE 200,008,103593,Ford; Joseph Earl,9999,0,9999,0
1668446805357,ECE 200,009,103594,Franceschetti; Massimo,9999,0,9999,0
1668446805357,ECE 200,010,103595,Fullerton; Eric E,9999,0,9999,0
1668446805357,ECE 200,011,103596,Galton; Ian A,9999,0,9999,0
1668446805357,ECE 200,012,103597,Gilja; Vikash,9999,0,9999,0
1668446805357,ECE 200,013,103598,Hall; Drew A.,9999,0,9999,0
1668446805357,ECE 200,014,103599,Hsueh; Tzu-Chien,9999,0,9999,0
1668446805357,ECE 200,015,103600,Javidi; Tara,9999,0,9999,0
1668446805357,ECE 200,016,103601,Kahng; Andrew Byun,9999,0,9999,0
1668446805357,ECE 200,017,103602,Kim; Young-Han,9999,0,9999,0
1668446805357,ECE 200,018,103603,Koushanfar; Farinaz,9999,0,9999,0
1668446805357,ECE 200,019,103604,Kuzum; Duygu,9999,0,9999,0
1668446805357,ECE 200,020,103605,Le; Hanh-Phuc,9999,0,9999,0
1668446805357,ECE 200,021,103606,Lin; Bill,9999,0,9999,0
1668446805357,ECE 200,022,103607,Liu; Zhaowei,9998,0,9999,1
1668446805357,ECE 200,023,103608,Lo; Yu-Hwa,9999,0,9999,0
1668446805357,ECE 200,024,103609,Lomakin; Vitaliy,9999,0,9999,0
1668446805357,ECE 200,025,103610,Mercier; Patrick Philip,9999,0,9999,0
1668446805357,ECE 200,026,103611,Meyer; Florian,9999,0,9999,0
1668446805357,ECE 200,027,103612,Milstein; Laurence B.,9999,0,9999,0
1668446805357,ECE 200,028,103613,Mir Arabbaygi; Siavash,9999,0,9999,0
1668446805357,ECE 200,029,103614,Mookherjea; Shayan,9999,0,9999,0
1668446805357,ECE 200,030,103615,Morris; Karcher William,9999,0,9999,0
1668446805357,ECE 200,031,103616,Ng; Tse Nga,9999,0,9999,0
1668446805357,ECE 200,032,103617,Nguyen; Truong Quang,9999,0,9999,0
1668446805357,ECE 200,033,103618,Nomura; Kenji,9999,0,9999,0
1668446805357,ECE 200,034,103619,Orlitsky; Alon,9999,0,9999,0
1668446805357,ECE 200,035,103620,Pal; Piya,9999,0,9999,0
1668446805357,ECE 200,036,103621,Papen; George C.,9999,0,9999,0
1668446805357,ECE 200,037,103622,Radic; Stojan,9999,0,9999,0
1668446805357,ECE 200,038,103623,Rao; Bhaskar D.,9999,0,9999,0
1668446805357,ECE 200,039,103624,Rao; Ramesh R,9999,0,9999,0
1668446805357,ECE 200,040,103625,Rebeiz; Gabriel,9999,0,9999,0
1668446805357,ECE 200,041,103626,Sanford; John R,9999,0,9999,0
1668446805357,ECE 200,042,103627,Siegel; Paul H.,9999,0,9999,0
1668446805357,ECE 200,043,103628,Sievenpiper; Daniel F.,9999,0,9999,0
1668446805357,ECE 200,044,103629,Sworder; David D.,9999,0,9999,0
1668446805357,ECE 200,045,103630,Taur; Yuan,9999,0,9999,0
1668446805357,ECE 200,046,103631,Touri; Behrouz,9999,0,9999,0
1668446805357,ECE 200,047,103632,Trivedi; Mohan M.,9999,0,9999,0
1668446805357,ECE 200,048,103633,Vasconcelos; Nuno,9999,0,9999,0
1668446805357,ECE 200,049,103634,Wang; Xiaolong,9999,0,9999,0
1668446805357,ECE 200,050,103635,Xie; Pengtao,9999,0,9999,0
1668446805357,ECE 200,051,103636,Yip; Michael,9999,0,9999,0
1668446805357,ECE 200,052,103637,Zeger; Kenneth A.,999,0,999,0
1668446805357,ECE 200,053,103638,Zhang; Xinyu,9999,0,9999,0
1668446805357,ECE 200,054,103639,Turakhia; Yatish Girish,9999,0,9999,0
1668446805357,ECE 200,055,103640,Kang; Mingu,9999,0,9999,0
1668446805357,ECE 200,056,103641,Shi; Yuanyuan,9999,0,9999,0
1668446805357,ECE 200,057,103642,Wang; Edward Jay,9999,0,9999,0
1668446805357,ECE 200,058,103643,Zheng; Yang,9999,0,9999,0
1668446805790,ECE 202,A00,103644,Kuzum; Duygu,0,28,0,0
1668446806229,ECE 212BN,A00,103646,Ng; Tse Nga,0,1,0,0
1668446806655,ECE 221,A00,111493,Staff,0,0,0,0
1668446807086,ECE 222B,A00,103647,Lomakin; Vitaliy,0,5,0,0
1668446807512,ECE 230B,A00,103648,Taur; Yuan,0,0,0,0
1668446807936,ECE 238B,A00,103649,Garay; Javier,0,0,0,0
1668446808368,ECE 240B,A00,112900,Fainman; Yeshaiahu,0,4,0,0
1668446808801,ECE 247A,A00,103650,Jokerst; Jesse Vincent,0,2,0,0
1668446809226,ECE 247B,A00,103651,Wang; Joseph,0,7,0,0
1668446809655,ECE 250,A00,103652,Siegel; Paul H.,0,50,0,0
1668446810078,ECE 251A,A00,103654,Rao; Bhaskar D.,0,36,0,0
1668446810513,ECE 257B,A00,103655,Bharadia; Dinesh,0,18,0,0
1668446810934,ECE 258A,A00,103656,Milstein; Laurence B.,0,14,0,0
1668446811375,ECE 260B,A00,103658,Kang; Mingu,0,80,0,0
1668446811805,ECE 264A,A00,103659,Galton; Ian A,0,44,0,0
1668446812234,ECE 265A,A00,103661,Gudem; Prasad S.S.,0,24,0,0
1668446812657,ECE 265D,A00,103662,Gudem; Prasad S.S.,0,16,0,0
1668446813082,ECE 268,A00,103663,Koushanfar; Farinaz,0,29,0,0
1668446813508,ECE 269,A01,103665,Pal; Piya,0,147,0,0
1668446813934,ECE 271B,A00,103666,Vasconcelos; Manuela,0,51,0,0
1668446814455,ECE 276A,A00,103667,Atanasov; Nikolay A.,0,80,0,0
1668446814877,ECE 277,A00,103668,An; Cheolhong,0,102,0,0
1668446815299,ECE 279,A00,117947,Hall; Drew A.,0,15,0,0
1668446816155,ECE 283,A00,103670,Hsueh; Tzu-Chien,0,33,0,0
1668446816578,ECE 284,A00,103671,Turakhia; Yatish Girish,0,30,0,0
1668446817012,ECE 285,A00,103672,Zheng; Yang,0,26,0,0
1668446817012,ECE 285,B00,103673,Sworder; David D.,0,41,0,0
1668446817453,ECE 287,A00,103676,Javidi; Tara,0,4,0,0
1668446817884,MATH 200B,A00,098023,Salehi Golsefidy; Alireza,12,0,15,3
1668446818316,MATH 202B,A00,098024,Rhoades; Brendon Patrick,9,0,15,6
1668446818743,MATH 203B,A00,098025,Oprea; Dragos N.,10,0,15,5
1668446819179,MATH 204B,A00,098026,Sorensen; Claus M,13,0,15,2
1668446819602,MATH 208,A00,098027,Izadi; Elham,7,0,10,3
1668446820035,MATH 209,A00,098028,Pollack; Aaron,10,0,10,0
1668446820461,MATH 211A,A00,112919,Rogalski; Daniel,9,0,10,1
1668446820902,MATH 211B,A00,112920,Seward; Brandon M.,9,0,10,1
1668446821342,MATH 218,A00,098029,Li; Bo,10,0,10,0
1668446821766,MATH 220B,A00,098030,Novak; Jonathan I,11,0,15,4
1668446822193,MATH 221A,A00,098031,Ebenfelt; Peter F,13,0,15,2
1668446822616,MATH 231B,A00,098032,Zlatos; Andrej,11,0,15,4
1668446823049,MATH 240B,A00,098033,Ni; Lei,9,0,15,6
1668446823479,MATH 243,A00,098034,Jekel; David Andrew,10,0,10,0
1668446823902,MATH 245A,A00,098035,Nie; Jiawang,0,2,15,16
1668446824333,MATH 248,A00,098036,Bejenaru; Ioan,10,0,10,0
1668446824757,MATH 250B,A00,098037,Spolaor; Luca,14,0,15,1
1668446825179,MATH 258,A00,098038,Ni; Lei,10,0,10,0
1668446825602,MATH 264B,A00,098041,Rhoades; Brendon Patrick,9,0,15,6
1668446826025,MATH 268,A00,098042,Buss; Samuel R,10,0,10,0
1668446826447,MATH 269,A00,098043,Rhoades; Brendon Patrick,10,0,10,0
1668446826879,MATH 270B,A00,098044,Li; Bo,10,0,15,5
1668446827316,MATH 272B,A00,098045,Holst; Michael J,13,0,15,2
1668446827754,MATH 273A,A00,098046,Tian; Xiaochuan,10,0,15,5
1668446828176,MATH 275,A01,098048,Tian; Xiaochuan,6,0,10,4
1668446828603,MATH 278A,A00,098049,Holst; Michael J,8,0,10,2
1668446829034,MATH 278B,A00,098050,Cloninger; Alexander,10,0,10,0
1668446829458,MATH 278C,A00,098051,Nie; Jiawang,6,0,10,4
1668446829882,MATH 280B,A00,098052,Zheng; Tianyi,7,0,15,8
1668446830309,MATH 281B,A00,098053,Bradic; Jelena,0,1,15,15
1668446830746,MATH 282B,A00,098054,Arias-Castro; Ery,0,0,15,15
1668446831181,MATH 285,A00,098055,Fitzsimmons; Patrick J,0,1,15,17
1668446831617,MATH 287B,A00,098056,Arias-Castro; Ery,2,0,15,13
1668446832047,MATH 288,A00,098057,Agarwal; Pooja,9,0,10,1
1668446832047,MATH 288,B00,098058,Zhang; Danna,8,0,10,2
1668446832047,MATH 288,C00,098059,Williams; Ruth J,9,0,10,1
1668446832479,MATH 290B,A00,098060,Roberts; Justin Deritter,13,0,15,2
1668446832903,MATH 292,A00,098061,Belmont; Eva Kinoshita,10,0,10,0
1668446833327,MATH 295,A00,098062,Suk; Andrew Hoon,48,0,50,2
1668446833758,MATH 296,A00,098063,Novak; Jonathan I,20,0,20,0
1668446834197,MATH 297,001,098064,Gamst; Anthony Collins,9997,0,9999,2
1668447350921,COGS 205,A00,101395,Chiba; Andrea,19,0,20,1
1668447351346,COGS 210B,001,101404,Greene; Deanna Jacquelyn,9998,0,9999,1
1668447351346,COGS 210B,002,101417,Xia; Haijun,9999,0,9999,0
1668447351346,COGS 210B,003,101422,Nitz; Douglas A.,9999,0,9999,0
1668447351346,COGS 210B,004,101423,Hollan; James D.,9998,0,9999,1
1668447351346,COGS 210B,005,101424,Deak; Gedeon O.,9998,0,9999,1
1668447351346,COGS 210B,006,101425,Rossano; Federico,9999,0,9999,0
1668447351771,COGS 211B,A00,101427,Coulson; Seana M,9996,0,9999,3
1668447352197,COGS 220,A00,101428,Hollan; James D.,1,4,25,24
1668447352627,COGS 229,A00,101429,Dow; Steven P,18,0,25,7
1668447353066,COGS 230,A00,101430,Klemmer; Scott R,11,0,17,6
1668447353490,COGS 234,A00,101431,Xia; Haijun,2,0,25,23
1668447353916,COGS 260,A00,101432,Kiyonaga; Anastasia,21,0,25,4
1668447353916,COGS 260,B00,101433,Kirsh; David Joel,15,0,25,10
1668447354342,CSE 202,A00,102371,Impagliazzo; Russell,0,42,0,0
1668447354771,CSE 203B,A01,102373,Cheng; Chung Kuan,0,32,0,0
1668447355193,CSE 208,A00,102374,Micciancio; Daniele,0,2,0,0
1668447355621,CSE 209A,A00,112895,Impagliazzo; Russell,0,7,15,15
1668447356043,CSE 209B,A00,108005,Bellare; Mihir,0,3,0,0
1668447356483,CSE 210,A00,113163,Coblenz; Michael J,0,51,0,0
1668447356905,CSE 219,A00,106111,Dow; Steven P,0,2,20,20
1668447357329,CSE 221,A00,102376,Voelker; Geoffrey M.,0,38,0,0
1668447357752,CSE 224,A01,102378,Porter; George M,0,112,0,0
1668447358183,CSE 229A,A00,102379,Savage; Stefan,0,4,0,0
1668447358609,CSE 229C,A00,102380,Munyaka; Imani N. S.,0,4,0,0
1668447359034,CSE 232B,A00,102382,Deutsch; Alin Bernard,0,18,0,0
1668447359465,CSE 234,A01,112904,Kumar; Arun Kumar,0,0,0,0
1668447359900,CSE 237A,A00,102383,Rosing; Tajana Simunic,0,32,0,0
1668447360323,CSE 239A,A00,102384,Deutsch; Alin Bernard,0,6,0,0
1668447360748,CSE 239B,A00,102385,Polikarpova; Nadezhda,0,4,0,0
1668447361170,CSE 240A,A00,102386,Pannuto; Patrick William,0,32,0,0
1668447361600,CSE 240B,A00,102387,Zhao; Jishen,0,31,0,0
1668447362023,CSE 241A,A00,106406,Kang; Mingu,0,5,0,0
1668447362449,CSE 249B,A00,102388,Kahng; Andrew Byun,0,1,8,8
1668447362881,CSE 251B,A01,102392,Cottrell; Garrison W,0,30,0,0
1668447362881,CSE 251B,A02,102393,Cottrell; Garrison W,0,24,0,0
1668447363313,CSE 252B,A00,102394,Ochoa; Benjamin Lawrence,0,41,0,0
1668447363752,CSE 257,A01,102396,Gao; Sicun,0,94,0,0
1668447364188,CSE 272,A00,102397,Li; Tzumao,0,9,0,0
1668447364614,CSE 274,A00,111323,Chern; Albert Ren-Haur,0,8,0,0
1668447365043,CSE 282,A00,102398,Pevzner; Pavel Arkadjevich,0,0,0,0
1668447365486,CSE 284,A00,114175,Gymrek; Melissa Ann,0,14,0,0
1668447365922,CSE 290,A00,102399,Chandraker; Manmohan Krishna,0,4,0,0
1668447365922,CSE 290,B00,102400,Vaccaro; Kristen Marie,0,2,25,25
1668447365922,CSE 290,C00,102414,Pannuto; Patrick William,0,1,25,25
1668447365922,CSE 290,D00,102427,Pevzner; Pavel Arkadjevich,0,0,0,0
1668447365922,CSE 290,E00,102429,Zhao; Jishen,0,2,0,0
1668447365922,CSE 290,F00,102436,Tullsen; Dean Michael,0,4,0,0
1668447365922,CSE 290,G00,102440,Christensen; Henrik I,0,3,20,20
1668447366346,CSE 291,A00,102443,Su; Hao,0,0,0,0
1668447366346,CSE 291,B00,102448,Polikarpova; Nadezhda,0,0,0,0
1668447366346,CSE 291,C00,102453,Vaccaro; Kristen Marie,0,0,0,0
1668447366346,CSE 291,D00,111343,Savage; Stefan,0,0,0,0
1668447366346,CSE 291,E00,116474,Claffy; Kimberly Claire,0,0,0,0
1668447366346,CSE 291,F00,116479,Pasquale; Joseph,0,0,0,0
1668447366796,CSE 293,001,119111,Bafna; Vineet,9999,0,9999,0
1668447366796,CSE 293,002,119118,Bellare; Mihir,9999,0,9999,0
1668447366796,CSE 293,003,119122,Berg-Kirkpatrick; Taylor D,9999,0,9999,0
1668447366796,CSE 293,004,119135,Christensen; Henrik I,9999,0,9999,0
1668447366796,CSE 293,005,119142,Cottrell; Garrison W,9999,0,9999,0
1668447366796,CSE 293,006,119146,Deutsch; Alin Bernard,9999,0,9999,0
1668447366796,CSE 293,007,119159,Esmaeilzadeh; Hadi,9999,0,9999,0
1668447366796,CSE 293,008,119166,Freund; Yoav,9999,0,9999,0
1668447366796,CSE 293,009,119170,Griswold; William G.,9999,0,9999,0
1668447366796,CSE 293,010,119183,Gymrek; Melissa Ann,9999,0,9999,0
1668447366796,CSE 293,011,119190,Heninger; Nadia A,9999,0,9999,0
1668447366796,CSE 293,012,119230,Impagliazzo; Russell,9999,0,9999,0
1668447366796,CSE 293,013,119232,Jhala; Ranjit,9999,0,9999,0
1668447366796,CSE 293,014,119233,Kahng; Andrew Byun,9999,0,9999,0
1668447366796,CSE 293,015,119298,Kane; Daniel Mertz,9999,0,9999,0
1668447366796,CSE 293,016,119299,Kriegman; David J,9999,0,9999,0
1668447366796,CSE 293,017,119300,Kumar; Arun Kumar,9999,0,9999,0
1668447366796,CSE 293,018,119301,Lerner; Sorin,9999,0,9999,0
1668447366796,CSE 293,019,119302,Lovett; Shachar,9999,0,9999,0
1668447366796,CSE 293,020,119303,McAuley; Julian John,9999,0,9999,0
1668447366796,CSE 293,021,119304,Micciancio; Daniele,9999,0,9999,0
1668447366796,CSE 293,022,119367,Orailoglu; Alex,9999,0,9999,0
1668447366796,CSE 293,023,119382,Paturi; Ramamohan,9999,0,9999,0
1668447366796,CSE 293,024,119404,Polikarpova; Nadezhda,9999,0,9999,0
1668447366796,CSE 293,025,119406,Politz; Joseph Gibbs,9999,0,9999,0
1668447366796,CSE 293,026,119411,Porter; George M,9999,0,9999,0
1668447366796,CSE 293,027,119414,Porter; Leonard Emerson,9999,0,9999,0
1668447366796,CSE 293,028,119416,Ramamoorthi; Ravi,9999,0,9999,0
1668447366796,CSE 293,029,119417,Sahoo; Debashis,9999,0,9999,0
1668447366796,CSE 293,030,119420,Saul; Lawrence,9999,0,9999,0
1668447366796,CSE 293,031,119421,Savage; Stefan,9999,0,9999,0
1668447366796,CSE 293,032,119425,Schulze; Jurgen P.,9999,0,9999,0
1668447366796,CSE 293,033,119426,Snoeren; Alex C.,9999,0,9999,0
1668447366796,CSE 293,034,119428,Shang; Jingbo,9999,0,9999,0
1668447366796,CSE 293,035,119430,Stefan; Deian,9999,0,9999,0
1668447366796,CSE 293,036,119431,Su; Hao,9999,0,9999,0
1668447366796,CSE 293,037,119433,Swanson; Steven James,9999,0,9999,0
1668447366796,CSE 293,038,119435,Tullsen; Dean Michael,9999,0,9999,0
1668447366796,CSE 293,039,119483,Voelker; Geoffrey M.,9999,0,9999,0
1668447366796,CSE 293,040,119537,Zhao; Jishen,9999,0,9999,0
1668447366796,CSE 293,041,119538,Zhou; Yuan-Yuan,9999,0,9999,0
1668447366796,CSE 293,042,119539,Gao; Sicun,9999,0,9999,0
1668447366796,CSE 293,043,119540,Weibel; Nadir,9999,0,9999,0
1668447366796,CSE 293,044,119541,Gupta; Rajesh K.,9999,0,9999,0
1668447366796,CSE 293,045,126410,Vaccaro; Kristen Marie,9999,0,9999,0
1668447366796,CSE 293,046,126411,Klemke; Richard,9999,0,9999,0
1668447367230,CSE 294,A00,102459,Voelker; Geoffrey M.,0,2,0,0
1668447367230,CSE 294,B00,111322,Orailoglu; Alex,0,0,0,0
1668447367657,DSE 201,A00,096914,Deutsch; Alin Bernard,30,0,30,0
1668447368098,DSE 210,A00,096915,Dasgupta; Sanjoy,30,0,30,0
1668447368536,DSE 260A,A00,096916,Altintas De Callaf; Ilkay,30,0,30,0
1668447368963,ECE 200,001,103586,Antipa; Nicholas A,9999,0,9999,0
1668447368963,ECE 200,002,103587,Atanasov; Nikolay A.,9999,0,9999,0
1668447368963,ECE 200,003,103588,Bharadia; Dinesh,9999,0,9999,0
1668447368963,ECE 200,004,103589,Cheng; Chung Kuan,9999,0,9999,0
1668447368963,ECE 200,005,103590,Cosman; Pamela C.,9999,0,9999,0
1668447368963,ECE 200,006,103591,Dayeh; Shadi Ahmad,9999,0,9999,0
1668447368963,ECE 200,007,103592,Fainman; Yeshaiahu,9999,0,9999,0
1668447368963,ECE 200,008,103593,Ford; Joseph Earl,9999,0,9999,0
1668447368963,ECE 200,009,103594,Franceschetti; Massimo,9999,0,9999,0
1668447368963,ECE 200,010,103595,Fullerton; Eric E,9999,0,9999,0
1668447368963,ECE 200,011,103596,Galton; Ian A,9999,0,9999,0
1668447368963,ECE 200,012,103597,Gilja; Vikash,9999,0,9999,0
1668447368963,ECE 200,013,103598,Hall; Drew A.,9999,0,9999,0
1668447368963,ECE 200,014,103599,Hsueh; Tzu-Chien,9999,0,9999,0
1668447368963,ECE 200,015,103600,Javidi; Tara,9999,0,9999,0
1668447368963,ECE 200,016,103601,Kahng; Andrew Byun,9999,0,9999,0
1668447368963,ECE 200,017,103602,Kim; Young-Han,9999,0,9999,0
1668447368963,ECE 200,018,103603,Koushanfar; Farinaz,9999,0,9999,0
1668447368963,ECE 200,019,103604,Kuzum; Duygu,9999,0,9999,0
1668447368963,ECE 200,020,103605,Le; Hanh-Phuc,9999,0,9999,0
1668447368963,ECE 200,021,103606,Lin; Bill,9999,0,9999,0
1668447368963,ECE 200,022,103607,Liu; Zhaowei,9998,0,9999,1
1668447368963,ECE 200,023,103608,Lo; Yu-Hwa,9999,0,9999,0
1668447368963,ECE 200,024,103609,Lomakin; Vitaliy,9999,0,9999,0
1668447368963,ECE 200,025,103610,Mercier; Patrick Philip,9999,0,9999,0
1668447368963,ECE 200,026,103611,Meyer; Florian,9999,0,9999,0
1668447368963,ECE 200,027,103612,Milstein; Laurence B.,9999,0,9999,0
1668447368963,ECE 200,028,103613,Mir Arabbaygi; Siavash,9999,0,9999,0
1668447368963,ECE 200,029,103614,Mookherjea; Shayan,9999,0,9999,0
1668447368963,ECE 200,030,103615,Morris; Karcher William,9999,0,9999,0
1668447368963,ECE 200,031,103616,Ng; Tse Nga,9999,0,9999,0
1668447368963,ECE 200,032,103617,Nguyen; Truong Quang,9999,0,9999,0
1668447368963,ECE 200,033,103618,Nomura; Kenji,9999,0,9999,0
1668447368963,ECE 200,034,103619,Orlitsky; Alon,9999,0,9999,0
1668447368963,ECE 200,035,103620,Pal; Piya,9999,0,9999,0
1668447368963,ECE 200,036,103621,Papen; George C.,9999,0,9999,0
1668447368963,ECE 200,037,103622,Radic; Stojan,9999,0,9999,0
1668447368963,ECE 200,038,103623,Rao; Bhaskar D.,9999,0,9999,0
1668447368963,ECE 200,039,103624,Rao; Ramesh R,9999,0,9999,0
1668447368963,ECE 200,040,103625,Rebeiz; Gabriel,9999,0,9999,0
1668447368963,ECE 200,041,103626,Sanford; John R,9999,0,9999,0
1668447368963,ECE 200,042,103627,Siegel; Paul H.,9999,0,9999,0
1668447368963,ECE 200,043,103628,Sievenpiper; Daniel F.,9999,0,9999,0
1668447368963,ECE 200,044,103629,Sworder; David D.,9999,0,9999,0
1668447368963,ECE 200,045,103630,Taur; Yuan,9999,0,9999,0
1668447368963,ECE 200,046,103631,Touri; Behrouz,9999,0,9999,0
1668447368963,ECE 200,047,103632,Trivedi; Mohan M.,9999,0,9999,0
1668447368963,ECE 200,048,103633,Vasconcelos; Nuno,9999,0,9999,0
1668447368963,ECE 200,049,103634,Wang; Xiaolong,9999,0,9999,0
1668447368963,ECE 200,050,103635,Xie; Pengtao,9999,0,9999,0
1668447368963,ECE 200,051,103636,Yip; Michael,9999,0,9999,0
1668447368963,ECE 200,052,103637,Zeger; Kenneth A.,999,0,999,0
1668447368963,ECE 200,053,103638,Zhang; Xinyu,9999,0,9999,0
1668447368963,ECE 200,054,103639,Turakhia; Yatish Girish,9999,0,9999,0
1668447368963,ECE 200,055,103640,Kang; Mingu,9999,0,9999,0
1668447368963,ECE 200,056,103641,Shi; Yuanyuan,9999,0,9999,0
1668447368963,ECE 200,057,103642,Wang; Edward Jay,9999,0,9999,0
1668447368963,ECE 200,058,103643,Zheng; Yang,9999,0,9999,0
1668447369394,ECE 202,A00,103644,Kuzum; Duygu,0,28,0,0
1668447369821,ECE 212BN,A00,103646,Ng; Tse Nga,0,1,0,0
1668447370245,ECE 221,A00,111493,Staff,0,0,0,0
1668447370682,ECE 222B,A00,103647,Lomakin; Vitaliy,0,5,0,0
1668447371107,ECE 230B,A00,103648,Taur; Yuan,0,1,0,0
1668447371539,ECE 238B,A00,103649,Garay; Javier,0,0,0,0
1668447371963,ECE 240B,A00,112900,Fainman; Yeshaiahu,0,4,0,0
1668447372405,ECE 247A,A00,103650,Jokerst; Jesse Vincent,0,2,0,0
1668447372831,ECE 247B,A00,103651,Wang; Joseph,0,7,0,0
1668447373276,ECE 250,A00,103652,Siegel; Paul H.,0,51,0,0
1668447373709,ECE 251A,A00,103654,Rao; Bhaskar D.,0,36,0,0
1668447374132,ECE 257B,A00,103655,Bharadia; Dinesh,0,18,0,0
1668447374558,ECE 258A,A00,103656,Milstein; Laurence B.,0,14,0,0
1668447374988,ECE 260B,A00,103658,Kang; Mingu,0,83,0,0
1668447375418,ECE 264A,A00,103659,Galton; Ian A,0,46,0,0
1668447375847,ECE 265A,A00,103661,Gudem; Prasad S.S.,0,24,0,0
1668447376274,ECE 265D,A00,103662,Gudem; Prasad S.S.,0,16,0,0
1668447376706,ECE 268,A00,103663,Koushanfar; Farinaz,0,30,0,0
1668447377139,ECE 269,A01,103665,Pal; Piya,0,147,0,0
1668447377576,ECE 271B,A00,103666,Vasconcelos; Manuela,0,52,0,0
1668447378005,ECE 276A,A00,103667,Atanasov; Nikolay A.,0,80,0,0
1668447378447,ECE 277,A00,103668,An; Cheolhong,0,103,0,0
1668447378886,ECE 279,A00,117947,Hall; Drew A.,0,15,0,0
1668447379744,ECE 283,A00,103670,Hsueh; Tzu-Chien,0,33,0,0
1668447380172,ECE 284,A00,103671,Turakhia; Yatish Girish,0,30,0,0
1668447380599,ECE 285,A00,103672,Zheng; Yang,0,26,0,0
1668447380599,ECE 285,B00,103673,Sworder; David D.,0,41,0,0
1668447381040,ECE 287,A00,103676,Javidi; Tara,0,4,0,0
1668447381464,MATH 200B,A00,098023,Salehi Golsefidy; Alireza,12,0,15,3
1668447381894,MATH 202B,A00,098024,Rhoades; Brendon Patrick,9,0,15,6
1668447382332,MATH 203B,A00,098025,Oprea; Dragos N.,10,0,15,5
1668447382755,MATH 204B,A00,098026,Sorensen; Claus M,13,0,15,2
1668447383181,MATH 208,A00,098027,Izadi; Elham,7,0,10,3
1668447383612,MATH 209,A00,098028,Pollack; Aaron,10,0,10,0
1668447384046,MATH 211A,A00,112919,Rogalski; Daniel,9,0,10,1
1668447384477,MATH 211B,A00,112920,Seward; Brandon M.,9,0,10,1
1668447384906,MATH 218,A00,098029,Li; Bo,10,0,10,0
1668447385334,MATH 220B,A00,098030,Novak; Jonathan I,11,0,15,4
1668447385767,MATH 221A,A00,098031,Ebenfelt; Peter F,13,0,15,2
1668447386209,MATH 231B,A00,098032,Zlatos; Andrej,11,0,15,4
1668447386634,MATH 240B,A00,098033,Ni; Lei,9,0,15,6
1668447387057,MATH 243,A00,098034,Jekel; David Andrew,10,0,10,0
1668447387482,MATH 245A,A00,098035,Nie; Jiawang,0,2,15,16
1668447387917,MATH 248,A00,098036,Bejenaru; Ioan,10,0,10,0
1668447388347,MATH 250B,A00,098037,Spolaor; Luca,14,0,15,1
1668447388777,MATH 258,A00,098038,Ni; Lei,10,0,10,0
1668447389203,MATH 264B,A00,098041,Rhoades; Brendon Patrick,9,0,15,6
1668447389629,MATH 268,A00,098042,Buss; Samuel R,10,0,10,0
1668447390070,MATH 269,A00,098043,Rhoades; Brendon Patrick,10,0,10,0
1668447390506,MATH 270B,A00,098044,Li; Bo,10,0,15,5
1668447390945,MATH 272B,A00,098045,Holst; Michael J,13,0,15,2
1668447391380,MATH 273A,A00,098046,Tian; Xiaochuan,10,0,15,5
1668447391809,MATH 275,A01,098048,Tian; Xiaochuan,6,0,10,4
1668447392246,MATH 278A,A00,098049,Holst; Michael J,8,0,10,2
1668447392678,MATH 278B,A00,098050,Cloninger; Alexander,10,0,10,0
1668447393108,MATH 278C,A00,098051,Nie; Jiawang,6,0,10,4
1668447393556,MATH 280B,A00,098052,Zheng; Tianyi,7,0,15,8
1668447394110,MATH 281B,A00,098053,Bradic; Jelena,0,1,15,15
1668447394535,MATH 282B,A00,098054,Arias-Castro; Ery,0,0,15,15
1668447394969,MATH 285,A00,098055,Fitzsimmons; Patrick J,0,1,15,17
1668447395397,MATH 287B,A00,098056,Arias-Castro; Ery,2,0,15,13
1668447395825,MATH 288,A00,098057,Agarwal; Pooja,9,0,10,1
1668447395825,MATH 288,B00,098058,Zhang; Danna,8,0,10,2
1668447395825,MATH 288,C00,098059,Williams; Ruth J,9,0,10,1
1668447396249,MATH 290B,A00,098060,Roberts; Justin Deritter,13,0,15,2
1668447396673,MATH 292,A00,098061,Belmont; Eva Kinoshita,10,0,10,0
1668447397112,MATH 295,A00,098062,Suk; Andrew Hoon,48,0,50,2
1668447397538,MATH 296,A00,098063,Novak; Jonathan I,20,0,20,0
1668447397961,MATH 297,001,098064,Gamst; Anthony Collins,9997,0,9999,2
1668447902146,COGS 205,A00,101395,Chiba; Andrea,19,0,20,1
1668447902576,COGS 210B,001,101404,Greene; Deanna Jacquelyn,9998,0,9999,1
1668447902576,COGS 210B,002,101417,Xia; Haijun,9999,0,9999,0
1668447902576,COGS 210B,003,101422,Nitz; Douglas A.,9999,0,9999,0
1668447902576,COGS 210B,004,101423,Hollan; James D.,9998,0,9999,1
1668447902576,COGS 210B,005,101424,Deak; Gedeon O.,9998,0,9999,1
1668447902576,COGS 210B,006,101425,Rossano; Federico,9999,0,9999,0
1668447903000,COGS 211B,A00,101427,Coulson; Seana M,9996,0,9999,3
1668447903422,COGS 220,A00,101428,Hollan; James D.,1,4,25,24
1668447903847,COGS 229,A00,101429,Dow; Steven P,18,0,25,7
1668447904275,COGS 230,A00,101430,Klemmer; Scott R,11,0,17,6
1668447904699,COGS 234,A00,101431,Xia; Haijun,2,0,25,23
1668447905122,COGS 260,A00,101432,Kiyonaga; Anastasia,21,0,25,4
1668447905122,COGS 260,B00,101433,Kirsh; David Joel,15,0,25,10
1668447905545,CSE 202,A00,102371,Impagliazzo; Russell,0,42,0,0
1668447905970,CSE 203B,A01,102373,Cheng; Chung Kuan,0,33,0,0
1668447906393,CSE 208,A00,102374,Micciancio; Daniele,0,2,0,0
1668447906816,CSE 209A,A00,112895,Impagliazzo; Russell,0,7,15,15
1668447907259,CSE 209B,A00,108005,Bellare; Mihir,0,3,0,0
1668447907690,CSE 210,A00,113163,Coblenz; Michael J,0,51,0,0
1668447908118,CSE 219,A00,106111,Dow; Steven P,0,2,20,20
1668447908548,CSE 221,A00,102376,Voelker; Geoffrey M.,0,38,0,0
1668447908984,CSE 224,A01,102378,Porter; George M,0,113,0,0
1668447909406,CSE 229A,A00,102379,Savage; Stefan,0,5,0,0
1668447909833,CSE 229C,A00,102380,Munyaka; Imani N. S.,0,5,0,0
1668447910269,CSE 232B,A00,102382,Deutsch; Alin Bernard,0,18,0,0
1668447910696,CSE 234,A01,112904,Kumar; Arun Kumar,0,0,0,0
1668447911131,CSE 237A,A00,102383,Rosing; Tajana Simunic,0,32,0,0
1668447911556,CSE 239A,A00,102384,Deutsch; Alin Bernard,0,6,0,0
1668447911980,CSE 239B,A00,102385,Polikarpova; Nadezhda,0,4,0,0
1668447912405,CSE 240A,A00,102386,Pannuto; Patrick William,0,33,0,0
1668447912837,CSE 240B,A00,102387,Zhao; Jishen,0,31,0,0
1668447913262,CSE 241A,A00,106406,Kang; Mingu,0,5,0,0
1668447913686,CSE 249B,A00,102388,Kahng; Andrew Byun,0,1,8,8
1668447914111,CSE 251B,A01,102392,Cottrell; Garrison W,0,30,0,0
1668447914111,CSE 251B,A02,102393,Cottrell; Garrison W,0,25,0,0
1668447914535,CSE 252B,A00,102394,Ochoa; Benjamin Lawrence,0,42,0,0
1668447914959,CSE 257,A01,102396,Gao; Sicun,0,95,0,0
1668447915385,CSE 272,A00,102397,Li; Tzumao,0,9,0,0
1668447915808,CSE 274,A00,111323,Chern; Albert Ren-Haur,0,8,0,0
1668447916234,CSE 282,A00,102398,Pevzner; Pavel Arkadjevich,0,0,0,0
1668447916667,CSE 284,A00,114175,Gymrek; Melissa Ann,0,14,0,0
1668447917109,CSE 290,A00,102399,Chandraker; Manmohan Krishna,0,4,0,0
1668447917109,CSE 290,B00,102400,Vaccaro; Kristen Marie,0,2,25,25
1668447917109,CSE 290,C00,102414,Pannuto; Patrick William,0,1,25,25
1668447917109,CSE 290,D00,102427,Pevzner; Pavel Arkadjevich,0,0,0,0
1668447917109,CSE 290,E00,102429,Zhao; Jishen,0,2,0,0
1668447917109,CSE 290,F00,102436,Tullsen; Dean Michael,0,4,0,0
1668447917109,CSE 290,G00,102440,Christensen; Henrik I,0,3,20,20
1668447917629,CSE 291,A00,102443,Su; Hao,0,0,0,0
1668447917629,CSE 291,B00,102448,Polikarpova; Nadezhda,0,0,0,0
1668447917629,CSE 291,C00,102453,Vaccaro; Kristen Marie,0,0,0,0
1668447917629,CSE 291,D00,111343,Savage; Stefan,0,0,0,0
1668447917629,CSE 291,E00,116474,Claffy; Kimberly Claire,0,0,0,0
1668447917629,CSE 291,F00,116479,Pasquale; Joseph,0,0,0,0
1668447918079,CSE 293,001,119111,Bafna; Vineet,9999,0,9999,0
1668447918079,CSE 293,002,119118,Bellare; Mihir,9999,0,9999,0
1668447918079,CSE 293,003,119122,Berg-Kirkpatrick; Taylor D,9999,0,9999,0
1668447918079,CSE 293,004,119135,Christensen; Henrik I,9999,0,9999,0
1668447918079,CSE 293,005,119142,Cottrell; Garrison W,9999,0,9999,0
1668447918079,CSE 293,006,119146,Deutsch; Alin Bernard,9999,0,9999,0
1668447918079,CSE 293,007,119159,Esmaeilzadeh; Hadi,9999,0,9999,0
1668447918079,CSE 293,008,119166,Freund; Yoav,9999,0,9999,0
1668447918079,CSE 293,009,119170,Griswold; William G.,9999,0,9999,0
1668447918079,CSE 293,010,119183,Gymrek; Melissa Ann,9999,0,9999,0
1668447918079,CSE 293,011,119190,Heninger; Nadia A,9999,0,9999,0
1668447918079,CSE 293,012,119230,Impagliazzo; Russell,9999,0,9999,0
1668447918079,CSE 293,013,119232,Jhala; Ranjit,9999,0,9999,0
1668447918079,CSE 293,014,119233,Kahng; Andrew Byun,9999,0,9999,0
1668447918079,CSE 293,015,119298,Kane; Daniel Mertz,9999,0,9999,0
1668447918079,CSE 293,016,119299,Kriegman; David J,9999,0,9999,0
1668447918079,CSE 293,017,119300,Kumar; Arun Kumar,9999,0,9999,0
1668447918079,CSE 293,018,119301,Lerner; Sorin,9999,0,9999,0
1668447918079,CSE 293,019,119302,Lovett; Shachar,9999,0,9999,0
1668447918079,CSE 293,020,119303,McAuley; Julian John,9999,0,9999,0
1668447918079,CSE 293,021,119304,Micciancio; Daniele,9999,0,9999,0
1668447918079,CSE 293,022,119367,Orailoglu; Alex,9999,0,9999,0
1668447918079,CSE 293,023,119382,Paturi; Ramamohan,9999,0,9999,0
1668447918079,CSE 293,024,119404,Polikarpova; Nadezhda,9999,0,9999,0
1668447918079,CSE 293,025,119406,Politz; Joseph Gibbs,9999,0,9999,0
1668447918079,CSE 293,026,119411,Porter; George M,9999,0,9999,0
1668447918079,CSE 293,027,119414,Porter; Leonard Emerson,9999,0,9999,0
1668447918079,CSE 293,028,119416,Ramamoorthi; Ravi,9999,0,9999,0
1668447918079,CSE 293,029,119417,Sahoo; Debashis,9999,0,9999,0
1668447918079,CSE 293,030,119420,Saul; Lawrence,9999,0,9999,0
1668447918079,CSE 293,031,119421,Savage; Stefan,9999,0,9999,0
1668447918079,CSE 293,032,119425,Schulze; Jurgen P.,9999,0,9999,0
1668447918079,CSE 293,033,119426,Snoeren; Alex C.,9999,0,9999,0
1668447918079,CSE 293,034,119428,Shang; Jingbo,9999,0,9999,0
1668447918079,CSE 293,035,119430,Stefan; Deian,9999,0,9999,0
1668447918079,CSE 293,036,119431,Su; Hao,9999,0,9999,0
1668447918079,CSE 293,037,119433,Swanson; Steven James,9999,0,9999,0
1668447918079,CSE 293,038,119435,Tullsen; Dean Michael,9999,0,9999,0
1668447918079,CSE 293,039,119483,Voelker; Geoffrey M.,9999,0,9999,0
1668447918079,CSE 293,040,119537,Zhao; Jishen,9999,0,9999,0
1668447918079,CSE 293,041,119538,Zhou; Yuan-Yuan,9999,0,9999,0
1668447918079,CSE 293,042,119539,Gao; Sicun,9999,0,9999,0
1668447918079,CSE 293,043,119540,Weibel; Nadir,9999,0,9999,0
1668447918079,CSE 293,044,119541,Gupta; Rajesh K.,9999,0,9999,0
1668447918079,CSE 293,045,126410,Vaccaro; Kristen Marie,9999,0,9999,0
1668447918079,CSE 293,046,126411,Klemke; Richard,9999,0,9999,0
1668447918502,CSE 294,A00,102459,Voelker; Geoffrey M.,0,2,0,0
1668447918502,CSE 294,B00,111322,Orailoglu; Alex,0,0,0,0
1668447918940,DSE 201,A00,096914,Deutsch; Alin Bernard,30,0,30,0
1668447919364,DSE 210,A00,096915,Dasgupta; Sanjoy,30,0,30,0
1668447919796,DSE 260A,A00,096916,Altintas De Callaf; Ilkay,30,0,30,0
1668447920222,ECE 200,001,103586,Antipa; Nicholas A,9999,0,9999,0
1668447920222,ECE 200,002,103587,Atanasov; Nikolay A.,9999,0,9999,0
1668447920222,ECE 200,003,103588,Bharadia; Dinesh,9999,0,9999,0
1668447920222,ECE 200,004,103589,Cheng; Chung Kuan,9999,0,9999,0
1668447920222,ECE 200,005,103590,Cosman; Pamela C.,9999,0,9999,0
1668447920222,ECE 200,006,103591,Dayeh; Shadi Ahmad,9999,0,9999,0
1668447920222,ECE 200,007,103592,Fainman; Yeshaiahu,9999,0,9999,0
1668447920222,ECE 200,008,103593,Ford; Joseph Earl,9999,0,9999,0
1668447920222,ECE 200,009,103594,Franceschetti; Massimo,9999,0,9999,0
1668447920222,ECE 200,010,103595,Fullerton; Eric E,9999,0,9999,0
1668447920222,ECE 200,011,103596,Galton; Ian A,9999,0,9999,0
1668447920222,ECE 200,012,103597,Gilja; Vikash,9999,0,9999,0
1668447920222,ECE 200,013,103598,Hall; Drew A.,9999,0,9999,0
1668447920222,ECE 200,014,103599,Hsueh; Tzu-Chien,9999,0,9999,0
1668447920222,ECE 200,015,103600,Javidi; Tara,9999,0,9999,0
1668447920222,ECE 200,016,103601,Kahng; Andrew Byun,9999,0,9999,0
1668447920222,ECE 200,017,103602,Kim; Young-Han,9999,0,9999,0
1668447920222,ECE 200,018,103603,Koushanfar; Farinaz,9999,0,9999,0
1668447920222,ECE 200,019,103604,Kuzum; Duygu,9999,0,9999,0
1668447920222,ECE 200,020,103605,Le; Hanh-Phuc,9999,0,9999,0
1668447920222,ECE 200,021,103606,Lin; Bill,9999,0,9999,0
1668447920222,ECE 200,022,103607,Liu; Zhaowei,9998,0,9999,1
1668447920222,ECE 200,023,103608,Lo; Yu-Hwa,9999,0,9999,0
1668447920222,ECE 200,024,103609,Lomakin; Vitaliy,9999,0,9999,0
1668447920222,ECE 200,025,103610,Mercier; Patrick Philip,9999,0,9999,0
1668447920222,ECE 200,026,103611,Meyer; Florian,9999,0,9999,0
1668447920222,ECE 200,027,103612,Milstein; Laurence B.,9999,0,9999,0
1668447920222,ECE 200,028,103613,Mir Arabbaygi; Siavash,9999,0,9999,0
1668447920222,ECE 200,029,103614,Mookherjea; Shayan,9999,0,9999,0
1668447920222,ECE 200,030,103615,Morris; Karcher William,9999,0,9999,0
1668447920222,ECE 200,031,103616,Ng; Tse Nga,9999,0,9999,0
1668447920222,ECE 200,032,103617,Nguyen; Truong Quang,9999,0,9999,0
1668447920222,ECE 200,033,103618,Nomura; Kenji,9999,0,9999,0
1668447920222,ECE 200,034,103619,Orlitsky; Alon,9999,0,9999,0
1668447920222,ECE 200,035,103620,Pal; Piya,9999,0,9999,0
1668447920222,ECE 200,036,103621,Papen; George C.,9999,0,9999,0
1668447920222,ECE 200,037,103622,Radic; Stojan,9999,0,9999,0
1668447920222,ECE 200,038,103623,Rao; Bhaskar D.,9999,0,9999,0
1668447920222,ECE 200,039,103624,Rao; Ramesh R,9999,0,9999,0
1668447920222,ECE 200,040,103625,Rebeiz; Gabriel,9999,0,9999,0
1668447920222,ECE 200,041,103626,Sanford; John R,9999,0,9999,0
1668447920222,ECE 200,042,103627,Siegel; Paul H.,9999,0,9999,0
1668447920222,ECE 200,043,103628,Sievenpiper; Daniel F.,9999,0,9999,0
1668447920222,ECE 200,044,103629,Sworder; David D.,9999,0,9999,0
1668447920222,ECE 200,045,103630,Taur; Yuan,9999,0,9999,0
1668447920222,ECE 200,046,103631,Touri; Behrouz,9999,0,9999,0
1668447920222,ECE 200,047,103632,Trivedi; Mohan M.,9999,0,9999,0
1668447920222,ECE 200,048,103633,Vasconcelos; Nuno,9999,0,9999,0
1668447920222,ECE 200,049,103634,Wang; Xiaolong,9999,0,9999,0
1668447920222,ECE 200,050,103635,Xie; Pengtao,9999,0,9999,0
1668447920222,ECE 200,051,103636,Yip; Michael,9999,0,9999,0
1668447920222,ECE 200,052,103637,Zeger; Kenneth A.,999,0,999,0
1668447920222,ECE 200,053,103638,Zhang; Xinyu,9999,0,9999,0
1668447920222,ECE 200,054,103639,Turakhia; Yatish Girish,9999,0,9999,0
1668447920222,ECE 200,055,103640,Kang; Mingu,9999,0,9999,0
1668447920222,ECE 200,056,103641,Shi; Yuanyuan,9999,0,9999,0
1668447920222,ECE 200,057,103642,Wang; Edward Jay,9999,0,9999,0
1668447920222,ECE 200,058,103643,Zheng; Yang,9999,0,9999,0
1668447920646,ECE 202,A00,103644,Kuzum; Duygu,0,28,0,0
1668447921093,ECE 212BN,A00,103646,Ng; Tse Nga,0,1,0,0
1668447921530,ECE 221,A00,111493,Staff,0,0,0,0
1668447921954,ECE 222B,A00,103647,Lomakin; Vitaliy,0,6,0,0
1668447922385,ECE 230B,A00,103648,Taur; Yuan,0,1,0,0
1668447922811,ECE 238B,A00,103649,Garay; Javier,0,0,0,0
1668447923249,ECE 240B,A00,112900,Fainman; Yeshaiahu,0,4,0,0
1668447923674,ECE 247A,A00,103650,Jokerst; Jesse Vincent,0,2,0,0
1668447924109,ECE 247B,A00,103651,Wang; Joseph,0,7,0,0
1668447924542,ECE 250,A00,103652,Siegel; Paul H.,0,52,0,0
1668447924967,ECE 251A,A00,103654,Rao; Bhaskar D.,0,38,0,0
1668447925394,ECE 257B,A00,103655,Bharadia; Dinesh,0,19,0,0
1668447925825,ECE 258A,A00,103656,Milstein; Laurence B.,0,16,0,0
1668447926251,ECE 260B,A00,103658,Kang; Mingu,0,83,0,0
1668447926687,ECE 264A,A00,103659,Galton; Ian A,0,47,0,0
1668447927117,ECE 265A,A00,103661,Gudem; Prasad S.S.,0,26,0,0
1668447927544,ECE 265D,A00,103662,Gudem; Prasad S.S.,0,16,0,0
1668447927968,ECE 268,A00,103663,Koushanfar; Farinaz,0,30,0,0
1668447928403,ECE 269,A01,103665,Pal; Piya,0,149,0,0
1668447928843,ECE 271B,A00,103666,Vasconcelos; Manuela,0,52,0,0
1668447929266,ECE 276A,A00,103667,Atanasov; Nikolay A.,0,80,0,0
1668447929697,ECE 277,A00,103668,An; Cheolhong,0,104,0,0
1668447930121,ECE 279,A00,117947,Hall; Drew A.,0,15,0,0
1668447930979,ECE 283,A00,103670,Hsueh; Tzu-Chien,0,33,0,0
1668447931408,ECE 284,A00,103671,Turakhia; Yatish Girish,0,30,0,0
1668447931845,ECE 285,A00,103672,Zheng; Yang,0,27,0,0
1668447931845,ECE 285,B00,103673,Sworder; David D.,0,41,0,0
1668447932273,ECE 287,A00,103676,Javidi; Tara,0,5,0,0
1668447932700,MATH 200B,A00,098023,Salehi Golsefidy; Alireza,12,0,15,3
1668447933124,MATH 202B,A00,098024,Rhoades; Brendon Patrick,9,0,15,6
1668447933550,MATH 203B,A00,098025,Oprea; Dragos N.,10,0,15,5
1668447933983,MATH 204B,A00,098026,Sorensen; Claus M,13,0,15,2
1668447934412,MATH 208,A00,098027,Izadi; Elham,7,0,10,3
1668447934834,MATH 209,A00,098028,Pollack; Aaron,10,0,10,0
1668447935261,MATH 211A,A00,112919,Rogalski; Daniel,9,0,10,1
1668447935687,MATH 211B,A00,112920,Seward; Brandon M.,9,0,10,1
1668447936119,MATH 218,A00,098029,Li; Bo,10,0,10,0
1668447936548,MATH 220B,A00,098030,Novak; Jonathan I,11,0,15,4
1668447936974,MATH 221A,A00,098031,Ebenfelt; Peter F,13,0,15,2
1668447937413,MATH 231B,A00,098032,Zlatos; Andrej,11,0,15,4
1668447937840,MATH 240B,A00,098033,Ni; Lei,9,0,15,6
1668447938267,MATH 243,A00,098034,Jekel; David Andrew,10,0,10,0
1668447938695,MATH 245A,A00,098035,Nie; Jiawang,0,2,15,16
1668447939135,MATH 248,A00,098036,Bejenaru; Ioan,10,0,10,0
1668447939559,MATH 250B,A00,098037,Spolaor; Luca,14,0,15,1
1668447939996,MATH 258,A00,098038,Ni; Lei,10,0,10,0
1668447940431,MATH 264B,A00,098041,Rhoades; Brendon Patrick,9,0,15,6
1668447940869,MATH 268,A00,098042,Buss; Samuel R,10,0,10,0
1668447941290,MATH 269,A00,098043,Rhoades; Brendon Patrick,10,0,10,0
1668447941723,MATH 270B,A00,098044,Li; Bo,10,0,15,5
1668447942155,MATH 272B,A00,098045,Holst; Michael J,13,0,15,2
1668447942592,MATH 273A,A00,098046,Tian; Xiaochuan,10,0,15,5
1668447943026,MATH 275,A01,098048,Tian; Xiaochuan,6,0,10,4
1668447943460,MATH 278A,A00,098049,Holst; Michael J,8,0,10,2
1668447943898,MATH 278B,A00,098050,Cloninger; Alexander,10,0,10,0
1668447944326,MATH 278C,A00,098051,Nie; Jiawang,6,0,10,4
1668447944750,MATH 280B,A00,098052,Zheng; Tianyi,7,0,15,8
1668447945175,MATH 281B,A00,098053,Bradic; Jelena,0,1,15,15
1668447945599,MATH 282B,A00,098054,Arias-Castro; Ery,0,0,15,15
1668447946022,MATH 285,A00,098055,Fitzsimmons; Patrick J,0,1,15,17
1668447946449,MATH 287B,A00,098056,Arias-Castro; Ery,2,0,15,13
1668447946892,MATH 288,A00,098057,Agarwal; Pooja,9,0,10,1
1668447946892,MATH 288,B00,098058,Zhang; Danna,8,0,10,2
1668447946892,MATH 288,C00,098059,Williams; Ruth J,9,0,10,1
1668447947319,MATH 290B,A00,098060,Roberts; Justin Deritter,13,0,15,2
1668447947745,MATH 292,A00,098061,Belmont; Eva Kinoshita,10,0,10,0
1668447948168,MATH 295,A00,098062,Suk; Andrew Hoon,48,0,50,2
1668447948606,MATH 296,A00,098063,Novak; Jonathan I,20,0,20,0
1668447949032,MATH 297,001,098064,Gamst; Anthony Collins,9997,0,9999,2
1668448453509,COGS 205,A00,101395,Chiba; Andrea,19,0,20,1
1668448453939,COGS 210B,001,101404,Greene; Deanna Jacquelyn,9998,0,9999,1
1668448453939,COGS 210B,002,101417,Xia; Haijun,9999,0,9999,0
1668448453939,COGS 210B,003,101422,Nitz; Douglas A.,9999,0,9999,0
1668448453939,COGS 210B,004,101423,Hollan; James D.,9998,0,9999,1
1668448453939,COGS 210B,005,101424,Deak; Gedeon O.,9998,0,9999,1
1668448453939,COGS 210B,006,101425,Rossano; Federico,9999,0,9999,0
1668448454364,COGS 211B,A00,101427,Coulson; Seana M,9996,0,9999,3
1668448454786,COGS 220,A00,101428,Hollan; James D.,1,4,25,24
1668448455209,COGS 229,A00,101429,Dow; Steven P,18,0,25,7
1668448455632,COGS 230,A00,101430,Klemmer; Scott R,11,0,17,6
1668448456063,COGS 234,A00,101431,Xia; Haijun,2,0,25,23
1668448456494,COGS 260,A00,101432,Kiyonaga; Anastasia,21,0,25,4
1668448456494,COGS 260,B00,101433,Kirsh; David Joel,15,0,25,10
1668448456917,CSE 202,A00,102371,Impagliazzo; Russell,0,42,0,0
1668448457339,CSE 203B,A01,102373,Cheng; Chung Kuan,0,33,0,0
1668448457764,CSE 208,A00,102374,Micciancio; Daniele,0,2,0,0
1668448458191,CSE 209A,A00,112895,Impagliazzo; Russell,0,7,15,15
1668448458621,CSE 209B,A00,108005,Bellare; Mihir,0,3,0,0
1668448459048,CSE 210,A00,113163,Coblenz; Michael J,0,51,0,0
1668448459478,CSE 219,A00,106111,Dow; Steven P,0,2,20,20
1668448459910,CSE 221,A00,102376,Voelker; Geoffrey M.,0,39,0,0
1668448460335,CSE 224,A01,102378,Porter; George M,0,113,0,0
1668448460761,CSE 229A,A00,102379,Savage; Stefan,0,5,0,0
1668448461185,CSE 229C,A00,102380,Munyaka; Imani N. S.,0,5,0,0
1668448461607,CSE 232B,A00,102382,Deutsch; Alin Bernard,0,18,0,0
1668448462043,CSE 234,A01,112904,Kumar; Arun Kumar,0,0,0,0
1668448462467,CSE 237A,A00,102383,Rosing; Tajana Simunic,0,32,0,0
1668448462895,CSE 239A,A00,102384,Deutsch; Alin Bernard,0,6,0,0
1668448463332,CSE 239B,A00,102385,Polikarpova; Nadezhda,0,4,0,0
1668448463753,CSE 240A,A00,102386,Pannuto; Patrick William,0,34,0,0
1668448464177,CSE 240B,A00,102387,Zhao; Jishen,0,31,0,0
1668448464598,CSE 241A,A00,106406,Kang; Mingu,0,5,0,0
1668448465022,CSE 249B,A00,102388,Kahng; Andrew Byun,0,1,8,8
1668448465451,CSE 251B,A01,102392,Cottrell; Garrison W,0,30,0,0
1668448465451,CSE 251B,A02,102393,Cottrell; Garrison W,0,25,0,0
1668448465877,CSE 252B,A00,102394,Ochoa; Benjamin Lawrence,0,42,0,0
1668448466302,CSE 257,A01,102396,Gao; Sicun,0,95,0,0
1668448466730,CSE 272,A00,102397,Li; Tzumao,0,9,0,0
1668448467153,CSE 274,A00,111323,Chern; Albert Ren-Haur,0,8,0,0
1668448467581,CSE 282,A00,102398,Pevzner; Pavel Arkadjevich,0,0,0,0
1668448468007,CSE 284,A00,114175,Gymrek; Melissa Ann,0,14,0,0
1668448468434,CSE 290,A00,102399,Chandraker; Manmohan Krishna,0,4,0,0
1668448468434,CSE 290,B00,102400,Vaccaro; Kristen Marie,0,2,25,25
1668448468434,CSE 290,C00,102414,Pannuto; Patrick William,0,1,25,25
1668448468434,CSE 290,D00,102427,Pevzner; Pavel Arkadjevich,0,0,0,0
1668448468434,CSE 290,E00,102429,Zhao; Jishen,0,2,0,0
1668448468434,CSE 290,F00,102436,Tullsen; Dean Michael,0,4,0,0
1668448468434,CSE 290,G00,102440,Christensen; Henrik I,0,3,20,20
1668448468861,CSE 291,A00,102443,Su; Hao,0,0,0,0
1668448468861,CSE 291,B00,102448,Polikarpova; Nadezhda,0,0,0,0
1668448468861,CSE 291,C00,102453,Vaccaro; Kristen Marie,0,0,0,0
1668448468861,CSE 291,D00,111343,Savage; Stefan,0,0,0,0
1668448468861,CSE 291,E00,116474,Claffy; Kimberly Claire,0,0,0,0
1668448468861,CSE 291,F00,116479,Pasquale; Joseph,0,0,0,0
1668448469293,CSE 293,001,119111,Bafna; Vineet,9999,0,9999,0
1668448469293,CSE 293,002,119118,Bellare; Mihir,9999,0,9999,0
1668448469293,CSE 293,003,119122,Berg-Kirkpatrick; Taylor D,9999,0,9999,0
1668448469293,CSE 293,004,119135,Christensen; Henrik I,9999,0,9999,0
1668448469293,CSE 293,005,119142,Cottrell; Garrison W,9999,0,9999,0
1668448469293,CSE 293,006,119146,Deutsch; Alin Bernard,9999,0,9999,0
1668448469293,CSE 293,007,119159,Esmaeilzadeh; Hadi,9999,0,9999,0
1668448469293,CSE 293,008,119166,Freund; Yoav,9999,0,9999,0
1668448469293,CSE 293,009,119170,Griswold; William G.,9999,0,9999,0
1668448469293,CSE 293,010,119183,Gymrek; Melissa Ann,9999,0,9999,0
1668448469293,CSE 293,011,119190,Heninger; Nadia A,9999,0,9999,0
1668448469293,CSE 293,012,119230,Impagliazzo; Russell,9999,0,9999,0
1668448469293,CSE 293,013,119232,Jhala; Ranjit,9999,0,9999,0
1668448469293,CSE 293,014,119233,Kahng; Andrew Byun,9999,0,9999,0
1668448469293,CSE 293,015,119298,Kane; Daniel Mertz,9999,0,9999,0
1668448469293,CSE 293,016,119299,Kriegman; David J,9999,0,9999,0
1668448469293,CSE 293,017,119300,Kumar; Arun Kumar,9999,0,9999,0
1668448469293,CSE 293,018,119301,Lerner; Sorin,9999,0,9999,0
1668448469293,CSE 293,019,119302,Lovett; Shachar,9999,0,9999,0
1668448469293,CSE 293,020,119303,McAuley; Julian John,9999,0,9999,0
1668448469293,CSE 293,021,119304,Micciancio; Daniele,9999,0,9999,0
1668448469293,CSE 293,022,119367,Orailoglu; Alex,9999,0,9999,0
1668448469293,CSE 293,023,119382,Paturi; Ramamohan,9999,0,9999,0
1668448469293,CSE 293,024,119404,Polikarpova; Nadezhda,9999,0,9999,0
1668448469293,CSE 293,025,119406,Politz; Joseph Gibbs,9999,0,9999,0
1668448469293,CSE 293,026,119411,Porter; George M,9999,0,9999,0
1668448469293,CSE 293,027,119414,Porter; Leonard Emerson,9999,0,9999,0
1668448469293,CSE 293,028,119416,Ramamoorthi; Ravi,9999,0,9999,0
1668448469293,CSE 293,029,119417,Sahoo; Debashis,9999,0,9999,0
1668448469293,CSE 293,030,119420,Saul; Lawrence,9999,0,9999,0
1668448469293,CSE 293,031,119421,Savage; Stefan,9999,0,9999,0
1668448469293,CSE 293,032,119425,Schulze; Jurgen P.,9999,0,9999,0
1668448469293,CSE 293,033,119426,Snoeren; Alex C.,9999,0,9999,0
1668448469293,CSE 293,034,119428,Shang; Jingbo,9999,0,9999,0
1668448469293,CSE 293,035,119430,Stefan; Deian,9999,0,9999,0
1668448469293,CSE 293,036,119431,Su; Hao,9999,0,9999,0
1668448469293,CSE 293,037,119433,Swanson; Steven James,9999,0,9999,0
1668448469293,CSE 293,038,119435,Tullsen; Dean Michael,9999,0,9999,0
1668448469293,CSE 293,039,119483,Voelker; Geoffrey M.,9999,0,9999,0
1668448469293,CSE 293,040,119537,Zhao; Jishen,9999,0,9999,0
1668448469293,CSE 293,041,119538,Zhou; Yuan-Yuan,9999,0,9999,0
1668448469293,CSE 293,042,119539,Gao; Sicun,9999,0,9999,0
1668448469293,CSE 293,043,119540,Weibel; Nadir,9999,0,9999,0
1668448469293,CSE 293,044,119541,Gupta; Rajesh K.,9999,0,9999,0
1668448469293,CSE 293,045,126410,Vaccaro; Kristen Marie,9999,0,9999,0
1668448469293,CSE 293,046,126411,Klemke; Richard,9999,0,9999,0
1668448469718,CSE 294,A00,102459,Voelker; Geoffrey M.,0,2,0,0
1668448469718,CSE 294,B00,111322,Orailoglu; Alex,0,0,0,0
1668448470141,DSE 201,A00,096914,Deutsch; Alin Bernard,30,0,30,0
1668448470570,DSE 210,A00,096915,Dasgupta; Sanjoy,30,0,30,0
1668448470999,DSE 260A,A00,096916,Altintas De Callaf; Ilkay,30,0,30,0
1668448471427,ECE 200,001,103586,Antipa; Nicholas A,9999,0,9999,0
1668448471427,ECE 200,002,103587,Atanasov; Nikolay A.,9999,0,9999,0
1668448471427,ECE 200,003,103588,Bharadia; Dinesh,9999,0,9999,0
1668448471427,ECE 200,004,103589,Cheng; Chung Kuan,9999,0,9999,0
1668448471427,ECE 200,005,103590,Cosman; Pamela C.,9999,0,9999,0
1668448471427,ECE 200,006,103591,Dayeh; Shadi Ahmad,9999,0,9999,0
1668448471427,ECE 200,007,103592,Fainman; Yeshaiahu,9999,0,9999,0
1668448471427,ECE 200,008,103593,Ford; Joseph Earl,9999,0,9999,0
1668448471427,ECE 200,009,103594,Franceschetti; Massimo,9999,0,9999,0
1668448471427,ECE 200,010,103595,Fullerton; Eric E,9999,0,9999,0
1668448471427,ECE 200,011,103596,Galton; Ian A,9999,0,9999,0
1668448471427,ECE 200,012,103597,Gilja; Vikash,9999,0,9999,0
1668448471427,ECE 200,013,103598,Hall; Drew A.,9999,0,9999,0
1668448471427,ECE 200,014,103599,Hsueh; Tzu-Chien,9999,0,9999,0
1668448471427,ECE 200,015,103600,Javidi; Tara,9999,0,9999,0
1668448471427,ECE 200,016,103601,Kahng; Andrew Byun,9999,0,9999,0
1668448471427,ECE 200,017,103602,Kim; Young-Han,9999,0,9999,0
1668448471427,ECE 200,018,103603,Koushanfar; Farinaz,9999,0,9999,0
1668448471427,ECE 200,019,103604,Kuzum; Duygu,9999,0,9999,0
1668448471427,ECE 200,020,103605,Le; Hanh-Phuc,9999,0,9999,0
1668448471427,ECE 200,021,103606,Lin; Bill,9999,0,9999,0
1668448471427,ECE 200,022,103607,Liu; Zhaowei,9998,0,9999,1
1668448471427,ECE 200,023,103608,Lo; Yu-Hwa,9999,0,9999,0
1668448471427,ECE 200,024,103609,Lomakin; Vitaliy,9999,0,9999,0
1668448471427,ECE 200,025,103610,Mercier; Patrick Philip,9999,0,9999,0
1668448471427,ECE 200,026,103611,Meyer; Florian,9999,0,9999,0
1668448471427,ECE 200,027,103612,Milstein; Laurence B.,9999,0,9999,0
1668448471427,ECE 200,028,103613,Mir Arabbaygi; Siavash,9999,0,9999,0
1668448471427,ECE 200,029,103614,Mookherjea; Shayan,9999,0,9999,0
1668448471427,ECE 200,030,103615,Morris; Karcher William,9999,0,9999,0
1668448471427,ECE 200,031,103616,Ng; Tse Nga,9999,0,9999,0
1668448471427,ECE 200,032,103617,Nguyen; Truong Quang,9999,0,9999,0
1668448471427,ECE 200,033,103618,Nomura; Kenji,9999,0,9999,0
1668448471427,ECE 200,034,103619,Orlitsky; Alon,9999,0,9999,0
1668448471427,ECE 200,035,103620,Pal; Piya,9999,0,9999,0
1668448471427,ECE 200,036,103621,Papen; George C.,9999,0,9999,0
1668448471427,ECE 200,037,103622,Radic; Stojan,9999,0,9999,0
1668448471427,ECE 200,038,103623,Rao; Bhaskar D.,9999,0,9999,0
1668448471427,ECE 200,039,103624,Rao; Ramesh R,9999,0,9999,0
1668448471427,ECE 200,040,103625,Rebeiz; Gabriel,9999,0,9999,0
1668448471427,ECE 200,041,103626,Sanford; John R,9999,0,9999,0
1668448471427,ECE 200,042,103627,Siegel; Paul H.,9999,0,9999,0
1668448471427,ECE 200,043,103628,Sievenpiper; Daniel F.,9999,0,9999,0
1668448471427,ECE 200,044,103629,Sworder; David D.,9999,0,9999,0
1668448471427,ECE 200,045,103630,Taur; Yuan,9999,0,9999,0
1668448471427,ECE 200,046,103631,Touri; Behrouz,9999,0,9999,0
1668448471427,ECE 200,047,103632,Trivedi; Mohan M.,9999,0,9999,0
1668448471427,ECE 200,048,103633,Vasconcelos; Nuno,9999,0,9999,0
1668448471427,ECE 200,049,103634,Wang; Xiaolong,9999,0,9999,0
1668448471427,ECE 200,050,103635,Xie; Pengtao,9999,0,9999,0
1668448471427,ECE 200,051,103636,Yip; Michael,9999,0,9999,0
1668448471427,ECE 200,052,103637,Zeger; Kenneth A.,999,0,999,0
1668448471427,ECE 200,053,103638,Zhang; Xinyu,9999,0,9999,0
1668448471427,ECE 200,054,103639,Turakhia; Yatish Girish,9999,0,9999,0
1668448471427,ECE 200,055,103640,Kang; Mingu,9999,0,9999,0
1668448471427,ECE 200,056,103641,Shi; Yuanyuan,9999,0,9999,0
1668448471427,ECE 200,057,103642,Wang; Edward Jay,9999,0,9999,0
1668448471427,ECE 200,058,103643,Zheng; Yang,9999,0,9999,0
1668448471856,ECE 202,A00,103644,Kuzum; Duygu,0,30,0,0
1668448472289,ECE 212BN,A00,103646,Ng; Tse Nga,0,1,0,0
1668448472714,ECE 221,A00,111493,Staff,0,0,0,0
1668448473145,ECE 222B,A00,103647,Lomakin; Vitaliy,0,6,0,0
1668448473570,ECE 230B,A00,103648,Taur; Yuan,0,1,0,0
1668448473995,ECE 238B,A00,103649,Garay; Javier,0,0,0,0
1668448474422,ECE 240B,A00,112900,Fainman; Yeshaiahu,0,4,0,0
1668448474844,ECE 247A,A00,103650,Jokerst; Jesse Vincent,0,2,0,0
1668448475274,ECE 247B,A00,103651,Wang; Joseph,0,7,0,0
1668448475698,ECE 250,A00,103652,Siegel; Paul H.,0,53,0,0
1668448476120,ECE 251A,A00,103654,Rao; Bhaskar D.,0,38,0,0
1668448476556,ECE 257B,A00,103655,Bharadia; Dinesh,0,21,0,0
1668448476980,ECE 258A,A00,103656,Milstein; Laurence B.,0,18,0,0
1668448477412,ECE 260B,A00,103658,Kang; Mingu,0,84,0,0
1668448477840,ECE 264A,A00,103659,Galton; Ian A,0,48,0,0
1668448478276,ECE 265A,A00,103661,Gudem; Prasad S.S.,0,27,0,0
1668448478698,ECE 265D,A00,103662,Gudem; Prasad S.S.,0,16,0,0
1668448479122,ECE 268,A00,103663,Koushanfar; Farinaz,0,30,0,0
1668448479547,ECE 269,A01,103665,Pal; Piya,0,152,0,0
1668448479992,ECE 271B,A00,103666,Vasconcelos; Manuela,0,52,0,0
1668448480417,ECE 276A,A00,103667,Atanasov; Nikolay A.,0,81,0,0
1668448480839,ECE 277,A00,103668,An; Cheolhong,0,104,0,0
1668448481261,ECE 279,A00,117947,Hall; Drew A.,0,15,0,0
1668448482110,ECE 283,A00,103670,Hsueh; Tzu-Chien,0,34,0,0
1668448482540,ECE 284,A00,103671,Turakhia; Yatish Girish,0,30,0,0
1668448482969,ECE 285,A00,103672,Zheng; Yang,0,27,0,0
1668448482969,ECE 285,B00,103673,Sworder; David D.,0,41,0,0
1668448483393,ECE 287,A00,103676,Javidi; Tara,0,5,0,0
1668448483828,MATH 200B,A00,098023,Salehi Golsefidy; Alireza,12,0,15,3
1668448484254,MATH 202B,A00,098024,Rhoades; Brendon Patrick,9,0,15,6
1668448484755,MATH 203B,A00,098025,Oprea; Dragos N.,10,0,15,5
1668448485186,MATH 204B,A00,098026,Sorensen; Claus M,13,0,15,2
1668448485620,MATH 208,A00,098027,Izadi; Elham,7,0,10,3
1668448486047,MATH 209,A00,098028,Pollack; Aaron,10,0,10,0
1668448486472,MATH 211A,A00,112919,Rogalski; Daniel,9,0,10,1
1668448486901,MATH 211B,A00,112920,Seward; Brandon M.,9,0,10,1
1668448487343,MATH 218,A00,098029,Li; Bo,10,0,10,0
1668448487783,MATH 220B,A00,098030,Novak; Jonathan I,11,0,15,4
1668448488207,MATH 221A,A00,098031,Ebenfelt; Peter F,13,0,15,2
1668448488633,MATH 231B,A00,098032,Zlatos; Andrej,11,0,15,4
1668448489060,MATH 240B,A00,098033,Ni; Lei,9,0,15,6
1668448489484,MATH 243,A00,098034,Jekel; David Andrew,10,0,10,0
1668448489921,MATH 245A,A00,098035,Nie; Jiawang,0,2,15,16
1668448490360,MATH 248,A00,098036,Bejenaru; Ioan,10,0,10,0
1668448490787,MATH 250B,A00,098037,Spolaor; Luca,14,0,15,1
1668448491210,MATH 258,A00,098038,Ni; Lei,10,0,10,0
1668448491644,MATH 264B,A00,098041,Rhoades; Brendon Patrick,9,0,15,6
1668448492073,MATH 268,A00,098042,Buss; Samuel R,10,0,10,0
1668448492504,MATH 269,A00,098043,Rhoades; Brendon Patrick,10,0,10,0
1668448492934,MATH 270B,A00,098044,Li; Bo,10,0,15,5
1668448493365,MATH 272B,A00,098045,Holst; Michael J,13,0,15,2
1668448493787,MATH 273A,A00,098046,Tian; Xiaochuan,10,0,15,5
1668448494210,MATH 275,A01,098048,Tian; Xiaochuan,6,0,10,4
1668448494639,MATH 278A,A00,098049,Holst; Michael J,8,0,10,2
1668448495074,MATH 278B,A00,098050,Cloninger; Alexander,10,0,10,0
1668448495498,MATH 278C,A00,098051,Nie; Jiawang,6,0,10,4
1668448495926,MATH 280B,A00,098052,Zheng; Tianyi,7,0,15,8
1668448496350,MATH 281B,A00,098053,Bradic; Jelena,0,1,15,15
1668448496785,MATH 282B,A00,098054,Arias-Castro; Ery,0,0,15,15
1668448497212,MATH 285,A00,098055,Fitzsimmons; Patrick J,0,1,15,17
1668448497647,MATH 287B,A00,098056,Arias-Castro; Ery,2,0,15,13
1668448498068,MATH 288,A00,098057,Agarwal; Pooja,9,0,10,1
1668448498068,MATH 288,B00,098058,Zhang; Danna,8,0,10,2
1668448498068,MATH 288,C00,098059,Williams; Ruth J,9,0,10,1
1668448498506,MATH 290B,A00,098060,Roberts; Justin Deritter,13,0,15,2
1668448498943,MATH 292,A00,098061,Belmont; Eva Kinoshita,10,0,10,0
1668448499369,MATH 295,A00,098062,Suk; Andrew Hoon,48,0,50,2
1668448499798,MATH 296,A00,098063,Novak; Jonathan I,20,0,20,0
1668448500235,MATH 297,001,098064,Gamst; Anthony Collins,9997,0,9999,2
1668449004658,COGS 205,A00,101395,Chiba; Andrea,19,0,20,1
1668449005081,COGS 210B,001,101404,Greene; Deanna Jacquelyn,9998,0,9999,1
1668449005081,COGS 210B,002,101417,Xia; Haijun,9999,0,9999,0
1668449005081,COGS 210B,003,101422,Nitz; Douglas A.,9999,0,9999,0
1668449005081,COGS 210B,004,101423,Hollan; James D.,9998,0,9999,1
1668449005081,COGS 210B,005,101424,Deak; Gedeon O.,9998,0,9999,1
1668449005081,COGS 210B,006,101425,Rossano; Federico,9999,0,9999,0
1668449005508,COGS 211B,A00,101427,Coulson; Seana M,9996,0,9999,3
1668449005935,COGS 220,A00,101428,Hollan; James D.,1,4,25,24
1668449006361,COGS 229,A00,101429,Dow; Steven P,18,0,25,7
1668449006784,COGS 230,A00,101430,Klemmer; Scott R,10,0,17,7
1668449007210,COGS 234,A00,101431,Xia; Haijun,2,0,25,23
1668449007643,COGS 260,A00,101432,Kiyonaga; Anastasia,21,0,25,4
1668449007643,COGS 260,B00,101433,Kirsh; David Joel,15,0,25,10
1668449008067,CSE 202,A00,102371,Impagliazzo; Russell,0,42,0,0
1668449008574,CSE 203B,A01,102373,Cheng; Chung Kuan,0,33,0,0
1668449009009,CSE 208,A00,102374,Micciancio; Daniele,0,2,0,0
1668449009434,CSE 209A,A00,112895,Impagliazzo; Russell,0,7,15,15
1668449009859,CSE 209B,A00,108005,Bellare; Mihir,0,3,0,0
1668449010293,CSE 210,A00,113163,Coblenz; Michael J,0,51,0,0
1668449010716,CSE 219,A00,106111,Dow; Steven P,0,2,20,20
1668449011138,CSE 221,A00,102376,Voelker; Geoffrey M.,0,39,0,0
1668449011573,CSE 224,A01,102378,Porter; George M,0,113,0,0
1668449012005,CSE 229A,A00,102379,Savage; Stefan,0,5,0,0
1668449012443,CSE 229C,A00,102380,Munyaka; Imani N. S.,0,5,0,0
1668449012876,CSE 232B,A00,102382,Deutsch; Alin Bernard,0,18,0,0
1668449013299,CSE 234,A01,112904,Kumar; Arun Kumar,0,0,0,0
1668449013722,CSE 237A,A00,102383,Rosing; Tajana Simunic,0,32,0,0
1668449014146,CSE 239A,A00,102384,Deutsch; Alin Bernard,0,6,0,0
1668449014577,CSE 239B,A00,102385,Polikarpova; Nadezhda,0,4,0,0
1668449014999,CSE 240A,A00,102386,Pannuto; Patrick William,0,34,0,0
1668449015426,CSE 240B,A00,102387,Zhao; Jishen,0,31,0,0
1668449015850,CSE 241A,A00,106406,Kang; Mingu,0,5,0,0
1668449016277,CSE 249B,A00,102388,Kahng; Andrew Byun,0,1,8,8
1668449016717,CSE 251B,A01,102392,Cottrell; Garrison W,0,30,0,0
1668449016717,CSE 251B,A02,102393,Cottrell; Garrison W,0,26,0,0
1668449017140,CSE 252B,A00,102394,Ochoa; Benjamin Lawrence,0,42,0,0
1668449017563,CSE 257,A01,102396,Gao; Sicun,0,97,0,0
1668449017985,CSE 272,A00,102397,Li; Tzumao,0,9,0,0
1668449018411,CSE 274,A00,111323,Chern; Albert Ren-Haur,0,8,0,0
1668449018837,CSE 282,A00,102398,Pevzner; Pavel Arkadjevich,0,0,0,0
1668449019262,CSE 284,A00,114175,Gymrek; Melissa Ann,0,14,0,0
1668449019690,CSE 290,A00,102399,Chandraker; Manmohan Krishna,0,5,0,0
1668449019690,CSE 290,B00,102400,Vaccaro; Kristen Marie,0,2,25,25
1668449019690,CSE 290,C00,102414,Pannuto; Patrick William,0,1,25,25
1668449019690,CSE 290,D00,102427,Pevzner; Pavel Arkadjevich,0,0,0,0
1668449019690,CSE 290,E00,102429,Zhao; Jishen,0,2,0,0
1668449019690,CSE 290,F00,102436,Tullsen; Dean Michael,0,4,0,0
1668449019690,CSE 290,G00,102440,Christensen; Henrik I,0,3,20,20
1668449020123,CSE 291,A00,102443,Su; Hao,0,0,0,0
1668449020123,CSE 291,B00,102448,Polikarpova; Nadezhda,0,0,0,0
1668449020123,CSE 291,C00,102453,Vaccaro; Kristen Marie,0,0,0,0
1668449020123,CSE 291,D00,111343,Savage; Stefan,0,0,0,0
1668449020123,CSE 291,E00,116474,Claffy; Kimberly Claire,0,0,0,0
1668449020123,CSE 291,F00,116479,Pasquale; Joseph,0,0,0,0
1668449020571,CSE 293,001,119111,Bafna; Vineet,9999,0,9999,0
1668449020571,CSE 293,002,119118,Bellare; Mihir,9999,0,9999,0
1668449020571,CSE 293,003,119122,Berg-Kirkpatrick; Taylor D,9999,0,9999,0
1668449020571,CSE 293,004,119135,Christensen; Henrik I,9999,0,9999,0
1668449020571,CSE 293,005,119142,Cottrell; Garrison W,9999,0,9999,0
1668449020571,CSE 293,006,119146,Deutsch; Alin Bernard,9999,0,9999,0
1668449020571,CSE 293,007,119159,Esmaeilzadeh; Hadi,9999,0,9999,0
1668449020571,CSE 293,008,119166,Freund; Yoav,9999,0,9999,0
1668449020571,CSE 293,009,119170,Griswold; William G.,9999,0,9999,0
1668449020571,CSE 293,010,119183,Gymrek; Melissa Ann,9999,0,9999,0
1668449020571,CSE 293,011,119190,Heninger; Nadia A,9999,0,9999,0
1668449020571,CSE 293,012,119230,Impagliazzo; Russell,9999,0,9999,0
1668449020571,CSE 293,013,119232,Jhala; Ranjit,9999,0,9999,0
1668449020571,CSE 293,014,119233,Kahng; Andrew Byun,9999,0,9999,0
1668449020571,CSE 293,015,119298,Kane; Daniel Mertz,9999,0,9999,0
1668449020571,CSE 293,016,119299,Kriegman; David J,9999,0,9999,0
1668449020571,CSE 293,017,119300,Kumar; Arun Kumar,9999,0,9999,0
1668449020571,CSE 293,018,119301,Lerner; Sorin,9999,0,9999,0
1668449020571,CSE 293,019,119302,Lovett; Shachar,9999,0,9999,0
1668449020571,CSE 293,020,119303,McAuley; Julian John,9999,0,9999,0
1668449020571,CSE 293,021,119304,Micciancio; Daniele,9999,0,9999,0
1668449020571,CSE 293,022,119367,Orailoglu; Alex,9999,0,9999,0
1668449020571,CSE 293,023,119382,Paturi; Ramamohan,9999,0,9999,0
1668449020571,CSE 293,024,119404,Polikarpova; Nadezhda,9999,0,9999,0
1668449020571,CSE 293,025,119406,Politz; Joseph Gibbs,9999,0,9999,0
1668449020571,CSE 293,026,119411,Porter; George M,9999,0,9999,0
1668449020571,CSE 293,027,119414,Porter; Leonard Emerson,9999,0,9999,0
1668449020571,CSE 293,028,119416,Ramamoorthi; Ravi,9999,0,9999,0
1668449020571,CSE 293,029,119417,Sahoo; Debashis,9999,0,9999,0
1668449020571,CSE 293,030,119420,Saul; Lawrence,9999,0,9999,0
1668449020571,CSE 293,031,119421,Savage; Stefan,9999,0,9999,0
1668449020571,CSE 293,032,119425,Schulze; Jurgen P.,9999,0,9999,0
1668449020571,CSE 293,033,119426,Snoeren; Alex C.,9999,0,9999,0
1668449020571,CSE 293,034,119428,Shang; Jingbo,9999,0,9999,0
1668449020571,CSE 293,035,119430,Stefan; Deian,9999,0,9999,0
1668449020571,CSE 293,036,119431,Su; Hao,9999,0,9999,0
1668449020571,CSE 293,037,119433,Swanson; Steven James,9999,0,9999,0
1668449020571,CSE 293,038,119435,Tullsen; Dean Michael,9999,0,9999,0
1668449020571,CSE 293,039,119483,Voelker; Geoffrey M.,9999,0,9999,0
1668449020571,CSE 293,040,119537,Zhao; Jishen,9999,0,9999,0
1668449020571,CSE 293,041,119538,Zhou; Yuan-Yuan,9999,0,9999,0
1668449020571,CSE 293,042,119539,Gao; Sicun,9999,0,9999,0
1668449020571,CSE 293,043,119540,Weibel; Nadir,9999,0,9999,0
1668449020571,CSE 293,044,119541,Gupta; Rajesh K.,9999,0,9999,0
1668449020571,CSE 293,045,126410,Vaccaro; Kristen Marie,9999,0,9999,0
1668449020571,CSE 293,046,126411,Klemke; Richard,9999,0,9999,0
1668449020994,CSE 294,A00,102459,Voelker; Geoffrey M.,0,2,0,0
1668449020994,CSE 294,B00,111322,Orailoglu; Alex,0,0,0,0
1668449021421,DSE 201,A00,096914,Deutsch; Alin Bernard,30,0,30,0
1668449021846,DSE 210,A00,096915,Dasgupta; Sanjoy,30,0,30,0
1668449022278,DSE 260A,A00,096916,Altintas De Callaf; Ilkay,30,0,30,0
1668449022714,ECE 200,001,103586,Antipa; Nicholas A,9999,0,9999,0
1668449022714,ECE 200,002,103587,Atanasov; Nikolay A.,9999,0,9999,0
1668449022714,ECE 200,003,103588,Bharadia; Dinesh,9999,0,9999,0
1668449022714,ECE 200,004,103589,Cheng; Chung Kuan,9999,0,9999,0
1668449022714,ECE 200,005,103590,Cosman; Pamela C.,9999,0,9999,0
1668449022714,ECE 200,006,103591,Dayeh; Shadi Ahmad,9999,0,9999,0
1668449022714,ECE 200,007,103592,Fainman; Yeshaiahu,9999,0,9999,0
1668449022714,ECE 200,008,103593,Ford; Joseph Earl,9999,0,9999,0
1668449022714,ECE 200,009,103594,Franceschetti; Massimo,9999,0,9999,0
1668449022714,ECE 200,010,103595,Fullerton; Eric E,9999,0,9999,0
1668449022714,ECE 200,011,103596,Galton; Ian A,9999,0,9999,0
1668449022714,ECE 200,012,103597,Gilja; Vikash,9999,0,9999,0
1668449022714,ECE 200,013,103598,Hall; Drew A.,9999,0,9999,0
1668449022714,ECE 200,014,103599,Hsueh; Tzu-Chien,9999,0,9999,0
1668449022714,ECE 200,015,103600,Javidi; Tara,9999,0,9999,0
1668449022714,ECE 200,016,103601,Kahng; Andrew Byun,9999,0,9999,0
1668449022714,ECE 200,017,103602,Kim; Young-Han,9999,0,9999,0
1668449022714,ECE 200,018,103603,Koushanfar; Farinaz,9999,0,9999,0
1668449022714,ECE 200,019,103604,Kuzum; Duygu,9999,0,9999,0
1668449022714,ECE 200,020,103605,Le; Hanh-Phuc,9999,0,9999,0
1668449022714,ECE 200,021,103606,Lin; Bill,9999,0,9999,0
1668449022714,ECE 200,022,103607,Liu; Zhaowei,9998,0,9999,1
1668449022714,ECE 200,023,103608,Lo; Yu-Hwa,9999,0,9999,0
1668449022714,ECE 200,024,103609,Lomakin; Vitaliy,9999,0,9999,0
1668449022714,ECE 200,025,103610,Mercier; Patrick Philip,9999,0,9999,0
1668449022714,ECE 200,026,103611,Meyer; Florian,9999,0,9999,0
1668449022714,ECE 200,027,103612,Milstein; Laurence B.,9999,0,9999,0
1668449022714,ECE 200,028,103613,Mir Arabbaygi; Siavash,9999,0,9999,0
1668449022714,ECE 200,029,103614,Mookherjea; Shayan,9999,0,9999,0
1668449022714,ECE 200,030,103615,Morris; Karcher William,9999,0,9999,0
1668449022714,ECE 200,031,103616,Ng; Tse Nga,9999,0,9999,0
1668449022714,ECE 200,032,103617,Nguyen; Truong Quang,9999,0,9999,0
1668449022714,ECE 200,033,103618,Nomura; Kenji,9999,0,9999,0
1668449022714,ECE 200,034,103619,Orlitsky; Alon,9999,0,9999,0
1668449022714,ECE 200,035,103620,Pal; Piya,9999,0,9999,0
1668449022714,ECE 200,036,103621,Papen; George C.,9999,0,9999,0
1668449022714,ECE 200,037,103622,Radic; Stojan,9999,0,9999,0
1668449022714,ECE 200,038,103623,Rao; Bhaskar D.,9999,0,9999,0
1668449022714,ECE 200,039,103624,Rao; Ramesh R,9999,0,9999,0
1668449022714,ECE 200,040,103625,Rebeiz; Gabriel,9999,0,9999,0
1668449022714,ECE 200,041,103626,Sanford; John R,9999,0,9999,0
1668449022714,ECE 200,042,103627,Siegel; Paul H.,9999,0,9999,0
1668449022714,ECE 200,043,103628,Sievenpiper; Daniel F.,9999,0,9999,0
1668449022714,ECE 200,044,103629,Sworder; David D.,9999,0,9999,0
1668449022714,ECE 200,045,103630,Taur; Yuan,9999,0,9999,0
1668449022714,ECE 200,046,103631,Touri; Behrouz,9999,0,9999,0
1668449022714,ECE 200,047,103632,Trivedi; Mohan M.,9999,0,9999,0
1668449022714,ECE 200,048,103633,Vasconcelos; Nuno,9999,0,9999,0
1668449022714,ECE 200,049,103634,Wang; Xiaolong,9999,0,9999,0
1668449022714,ECE 200,050,103635,Xie; Pengtao,9999,0,9999,0
1668449022714,ECE 200,051,103636,Yip; Michael,9999,0,9999,0
1668449022714,ECE 200,052,103637,Zeger; Kenneth A.,999,0,999,0
1668449022714,ECE 200,053,103638,Zhang; Xinyu,9999,0,9999,0
1668449022714,ECE 200,054,103639,Turakhia; Yatish Girish,9999,0,9999,0
1668449022714,ECE 200,055,103640,Kang; Mingu,9999,0,9999,0
1668449022714,ECE 200,056,103641,Shi; Yuanyuan,9999,0,9999,0
1668449022714,ECE 200,057,103642,Wang; Edward Jay,9999,0,9999,0
1668449022714,ECE 200,058,103643,Zheng; Yang,9999,0,9999,0
1668449023146,ECE 202,A00,103644,Kuzum; Duygu,0,30,0,0
1668449023573,ECE 212BN,A00,103646,Ng; Tse Nga,0,1,0,0
1668449023998,ECE 221,A00,111493,Staff,0,0,0,0
1668449024423,ECE 222B,A00,103647,Lomakin; Vitaliy,0,6,0,0
1668449024849,ECE 230B,A00,103648,Taur; Yuan,0,1,0,0
1668449025275,ECE 238B,A00,103649,Garay; Javier,0,0,0,0
1668449025698,ECE 240B,A00,112900,Fainman; Yeshaiahu,0,4,0,0
1668449026121,ECE 247A,A00,103650,Jokerst; Jesse Vincent,0,2,0,0
1668449026551,ECE 247B,A00,103651,Wang; Joseph,0,7,0,0
1668449026981,ECE 250,A00,103652,Siegel; Paul H.,0,53,0,0
1668449027403,ECE 251A,A00,103654,Rao; Bhaskar D.,0,39,0,0
1668449027830,ECE 257B,A00,103655,Bharadia; Dinesh,0,21,0,0
1668449028255,ECE 258A,A00,103656,Milstein; Laurence B.,0,19,0,0
1668449028679,ECE 260B,A00,103658,Kang; Mingu,0,84,0,0
1668449029107,ECE 264A,A00,103659,Galton; Ian A,0,48,0,0
1668449029537,ECE 265A,A00,103661,Gudem; Prasad S.S.,0,27,0,0
1668449029960,ECE 265D,A00,103662,Gudem; Prasad S.S.,0,18,0,0
1668449030384,ECE 268,A00,103663,Koushanfar; Farinaz,0,30,0,0
1668449030814,ECE 269,A01,103665,Pal; Piya,0,155,0,0
1668449031252,ECE 271B,A00,103666,Vasconcelos; Manuela,0,53,0,0
1668449031676,ECE 276A,A00,103667,Atanasov; Nikolay A.,0,81,0,0
1668449032099,ECE 277,A00,103668,An; Cheolhong,0,105,0,0
1668449032521,ECE 279,A00,117947,Hall; Drew A.,0,16,0,0
1668449033369,ECE 283,A00,103670,Hsueh; Tzu-Chien,0,36,0,0
1668449033791,ECE 284,A00,103671,Turakhia; Yatish Girish,0,31,0,0
1668449034214,ECE 285,A00,103672,Zheng; Yang,0,28,0,0
1668449034214,ECE 285,B00,103673,Sworder; David D.,0,41,0,0
1668449034644,ECE 287,A00,103676,Javidi; Tara,0,5,0,0
1668449035081,MATH 200B,A00,098023,Salehi Golsefidy; Alireza,12,0,15,3
1668449035505,MATH 202B,A00,098024,Rhoades; Brendon Patrick,9,0,15,6
1668449035934,MATH 203B,A00,098025,Oprea; Dragos N.,10,0,15,5
1668449036361,MATH 204B,A00,098026,Sorensen; Claus M,13,0,15,2
1668449036801,MATH 208,A00,098027,Izadi; Elham,7,0,10,3
1668449037225,MATH 209,A00,098028,Pollack; Aaron,10,0,10,0
1668449037650,MATH 211A,A00,112919,Rogalski; Daniel,9,0,10,1
1668449038077,MATH 211B,A00,112920,Seward; Brandon M.,9,0,10,1
1668449038500,MATH 218,A00,098029,Li; Bo,10,0,10,0
1668449038930,MATH 220B,A00,098030,Novak; Jonathan I,11,0,15,4
1668449039352,MATH 221A,A00,098031,Ebenfelt; Peter F,13,0,15,2
1668449039783,MATH 231B,A00,098032,Zlatos; Andrej,11,0,15,4
1668449040214,MATH 240B,A00,098033,Ni; Lei,9,0,15,6
1668449040639,MATH 243,A00,098034,Jekel; David Andrew,10,0,10,0
1668449041066,MATH 245A,A00,098035,Nie; Jiawang,0,2,15,16
1668449041504,MATH 248,A00,098036,Bejenaru; Ioan,10,0,10,0
1668449041933,MATH 250B,A00,098037,Spolaor; Luca,14,0,15,1
1668449042369,MATH 258,A00,098038,Ni; Lei,10,0,10,0
1668449042803,MATH 264B,A00,098041,Rhoades; Brendon Patrick,9,0,15,6
1668449043235,MATH 268,A00,098042,Buss; Samuel R,10,0,10,0
1668449043673,MATH 269,A00,098043,Rhoades; Brendon Patrick,10,0,10,0
1668449044098,MATH 270B,A00,098044,Li; Bo,10,0,15,5
1668449044528,MATH 272B,A00,098045,Holst; Michael J,13,0,15,2
1668449044951,MATH 273A,A00,098046,Tian; Xiaochuan,10,0,15,5
1668449045377,MATH 275,A01,098048,Tian; Xiaochuan,6,0,10,4
1668449045809,MATH 278A,A00,098049,Holst; Michael J,8,0,10,2
1668449046249,MATH 278B,A00,098050,Cloninger; Alexander,10,0,10,0
1668449046671,MATH 278C,A00,098051,Nie; Jiawang,6,0,10,4
1668449047103,MATH 280B,A00,098052,Zheng; Tianyi,7,0,15,8
1668449047542,MATH 281B,A00,098053,Bradic; Jelena,0,2,15,15
1668449047965,MATH 282B,A00,098054,Arias-Castro; Ery,0,0,15,15
1668449048387,MATH 285,A00,098055,Fitzsimmons; Patrick J,0,1,15,17
1668449048811,MATH 287B,A00,098056,Arias-Castro; Ery,2,0,15,13
1668449049242,MATH 288,A00,098057,Agarwal; Pooja,9,0,10,1
1668449049242,MATH 288,B00,098058,Zhang; Danna,8,0,10,2
1668449049242,MATH 288,C00,098059,Williams; Ruth J,9,0,10,1
1668449049676,MATH 290B,A00,098060,Roberts; Justin Deritter,13,0,15,2
1668449050099,MATH 292,A00,098061,Belmont; Eva Kinoshita,10,0,10,0
1668449050524,MATH 295,A00,098062,Suk; Andrew Hoon,48,0,50,2
1668449050948,MATH 296,A00,098063,Novak; Jonathan I,20,0,20,0
1668449051375,MATH 297,001,098064,Gamst; Anthony Collins,9997,0,9999,2
1668449554371,COGS 205,A00,101395,Chiba; Andrea,19,0,20,1
1668449554799,COGS 210B,001,101404,Greene; Deanna Jacquelyn,9998,0,9999,1
1668449554799,COGS 210B,002,101417,Xia; Haijun,9999,0,9999,0
1668449554799,COGS 210B,003,101422,Nitz; Douglas A.,9999,0,9999,0
1668449554799,COGS 210B,004,101423,Hollan; James D.,9998,0,9999,1
1668449554799,COGS 210B,005,101424,Deak; Gedeon O.,9998,0,9999,1
1668449554799,COGS 210B,006,101425,Rossano; Federico,9999,0,9999,0
1668449555222,COGS 211B,A00,101427,Coulson; Seana M,9996,0,9999,3
1668449555663,COGS 220,A00,101428,Hollan; James D.,1,4,25,24
1668449556087,COGS 229,A00,101429,Dow; Steven P,18,0,25,7
1668449556511,COGS 230,A00,101430,Klemmer; Scott R,10,0,17,7
1668449556939,COGS 234,A00,101431,Xia; Haijun,2,0,25,23
1668449557370,COGS 260,A00,101432,Kiyonaga; Anastasia,21,0,25,4
1668449557370,COGS 260,B00,101433,Kirsh; David Joel,15,0,25,10
1668449557795,CSE 202,A00,102371,Impagliazzo; Russell,0,43,0,0
1668449558220,CSE 203B,A01,102373,Cheng; Chung Kuan,0,33,0,0
1668449558642,CSE 208,A00,102374,Micciancio; Daniele,0,2,0,0
1668449559067,CSE 209A,A00,112895,Impagliazzo; Russell,0,7,15,15
1668449559500,CSE 209B,A00,108005,Bellare; Mihir,0,3,0,0
1668449559941,CSE 210,A00,113163,Coblenz; Michael J,0,52,0,0
1668449560371,CSE 219,A00,106111,Dow; Steven P,0,2,20,20
1668449560804,CSE 221,A00,102376,Voelker; Geoffrey M.,0,39,0,0
1668449561234,CSE 224,A01,102378,Porter; George M,0,113,0,0
1668449561673,CSE 229A,A00,102379,Savage; Stefan,0,5,0,0
1668449562109,CSE 229C,A00,102380,Munyaka; Imani N. S.,0,5,0,0
1668449562531,CSE 232B,A00,102382,Deutsch; Alin Bernard,0,18,0,0
1668449562959,CSE 234,A01,112904,Kumar; Arun Kumar,0,0,0,0
1668449563393,CSE 237A,A00,102383,Rosing; Tajana Simunic,0,32,0,0
1668449563829,CSE 239A,A00,102384,Deutsch; Alin Bernard,0,6,0,0
1668449564254,CSE 239B,A00,102385,Polikarpova; Nadezhda,0,4,0,0
1668449564685,CSE 240A,A00,102386,Pannuto; Patrick William,0,34,0,0
1668449565107,CSE 240B,A00,102387,Zhao; Jishen,0,31,0,0
1668449565541,CSE 241A,A00,106406,Kang; Mingu,0,5,0,0
1668449565978,CSE 249B,A00,102388,Kahng; Andrew Byun,0,1,8,8
1668449566402,CSE 251B,A01,102392,Cottrell; Garrison W,0,31,0,0
1668449566402,CSE 251B,A02,102393,Cottrell; Garrison W,0,26,0,0
1668449566833,CSE 252B,A00,102394,Ochoa; Benjamin Lawrence,0,42,0,0
1668449567257,CSE 257,A01,102396,Gao; Sicun,0,97,0,0
1668449567680,CSE 272,A00,102397,Li; Tzumao,0,9,0,0
1668449568104,CSE 274,A00,111323,Chern; Albert Ren-Haur,0,8,0,0
1668449568527,CSE 282,A00,102398,Pevzner; Pavel Arkadjevich,0,0,0,0
1668449568950,CSE 284,A00,114175,Gymrek; Melissa Ann,0,14,0,0
1668449569377,CSE 290,A00,102399,Chandraker; Manmohan Krishna,0,5,0,0
1668449569377,CSE 290,B00,102400,Vaccaro; Kristen Marie,0,2,25,25
1668449569377,CSE 290,C00,102414,Pannuto; Patrick William,0,1,25,25
1668449569377,CSE 290,D00,102427,Pevzner; Pavel Arkadjevich,0,0,0,0
1668449569377,CSE 290,E00,102429,Zhao; Jishen,0,2,0,0
1668449569377,CSE 290,F00,102436,Tullsen; Dean Michael,0,4,0,0
1668449569377,CSE 290,G00,102440,Christensen; Henrik I,0,3,20,20
1668449569801,CSE 291,A00,102443,Su; Hao,0,0,0,0
1668449569801,CSE 291,B00,102448,Polikarpova; Nadezhda,0,0,0,0
1668449569801,CSE 291,C00,102453,Vaccaro; Kristen Marie,0,0,0,0
1668449569801,CSE 291,D00,111343,Savage; Stefan,0,0,0,0
1668449569801,CSE 291,E00,116474,Claffy; Kimberly Claire,0,0,0,0
1668449569801,CSE 291,F00,116479,Pasquale; Joseph,0,0,0,0
1668449570230,CSE 293,001,119111,Bafna; Vineet,9999,0,9999,0
1668449570230,CSE 293,002,119118,Bellare; Mihir,9999,0,9999,0
1668449570230,CSE 293,003,119122,Berg-Kirkpatrick; Taylor D,9999,0,9999,0
1668449570230,CSE 293,004,119135,Christensen; Henrik I,9999,0,9999,0
1668449570230,CSE 293,005,119142,Cottrell; Garrison W,9999,0,9999,0
1668449570230,CSE 293,006,119146,Deutsch; Alin Bernard,9999,0,9999,0
1668449570230,CSE 293,007,119159,Esmaeilzadeh; Hadi,9999,0,9999,0
1668449570230,CSE 293,008,119166,Freund; Yoav,9999,0,9999,0
1668449570230,CSE 293,009,119170,Griswold; William G.,9999,0,9999,0
1668449570230,CSE 293,010,119183,Gymrek; Melissa Ann,9999,0,9999,0
1668449570230,CSE 293,011,119190,Heninger; Nadia A,9999,0,9999,0
1668449570230,CSE 293,012,119230,Impagliazzo; Russell,9999,0,9999,0
1668449570230,CSE 293,013,119232,Jhala; Ranjit,9999,0,9999,0
1668449570230,CSE 293,014,119233,Kahng; Andrew Byun,9999,0,9999,0
1668449570230,CSE 293,015,119298,Kane; Daniel Mertz,9999,0,9999,0
1668449570230,CSE 293,016,119299,Kriegman; David J,9999,0,9999,0
1668449570230,CSE 293,017,119300,Kumar; Arun Kumar,9999,0,9999,0
1668449570230,CSE 293,018,119301,Lerner; Sorin,9999,0,9999,0
1668449570230,CSE 293,019,119302,Lovett; Shachar,9999,0,9999,0
1668449570230,CSE 293,020,119303,McAuley; Julian John,9999,0,9999,0
1668449570230,CSE 293,021,119304,Micciancio; Daniele,9999,0,9999,0
1668449570230,CSE 293,022,119367,Orailoglu; Alex,9999,0,9999,0
1668449570230,CSE 293,023,119382,Paturi; Ramamohan,9999,0,9999,0
1668449570230,CSE 293,024,119404,Polikarpova; Nadezhda,9999,0,9999,0
1668449570230,CSE 293,025,119406,Politz; Joseph Gibbs,9999,0,9999,0
1668449570230,CSE 293,026,119411,Porter; George M,9999,0,9999,0
1668449570230,CSE 293,027,119414,Porter; Leonard Emerson,9999,0,9999,0
1668449570230,CSE 293,028,119416,Ramamoorthi; Ravi,9999,0,9999,0
1668449570230,CSE 293,029,119417,Sahoo; Debashis,9999,0,9999,0
1668449570230,CSE 293,030,119420,Saul; Lawrence,9999,0,9999,0
1668449570230,CSE 293,031,119421,Savage; Stefan,9999,0,9999,0
1668449570230,CSE 293,032,119425,Schulze; Jurgen P.,9999,0,9999,0
1668449570230,CSE 293,033,119426,Snoeren; Alex C.,9999,0,9999,0
1668449570230,CSE 293,034,119428,Shang; Jingbo,9999,0,9999,0
1668449570230,CSE 293,035,119430,Stefan; Deian,9999,0,9999,0
1668449570230,CSE 293,036,119431,Su; Hao,9999,0,9999,0
1668449570230,CSE 293,037,119433,Swanson; Steven James,9999,0,9999,0
1668449570230,CSE 293,038,119435,Tullsen; Dean Michael,9999,0,9999,0
1668449570230,CSE 293,039,119483,Voelker; Geoffrey M.,9999,0,9999,0
1668449570230,CSE 293,040,119537,Zhao; Jishen,9999,0,9999,0
1668449570230,CSE 293,041,119538,Zhou; Yuan-Yuan,9999,0,9999,0
1668449570230,CSE 293,042,119539,Gao; Sicun,9999,0,9999,0
1668449570230,CSE 293,043,119540,Weibel; Nadir,9999,0,9999,0
1668449570230,CSE 293,044,119541,Gupta; Rajesh K.,9999,0,9999,0
1668449570230,CSE 293,045,126410,Vaccaro; Kristen Marie,9999,0,9999,0
1668449570230,CSE 293,046,126411,Klemke; Richard,9999,0,9999,0
1668449570654,CSE 294,A00,102459,Voelker; Geoffrey M.,0,2,0,0
1668449570654,CSE 294,B00,111322,Orailoglu; Alex,0,0,0,0
1668449571080,DSE 201,A00,096914,Deutsch; Alin Bernard,30,0,30,0
1668449571509,DSE 210,A00,096915,Dasgupta; Sanjoy,30,0,30,0
1668449571933,DSE 260A,A00,096916,Altintas De Callaf; Ilkay,30,0,30,0
1668449572371,ECE 200,001,103586,Antipa; Nicholas A,9999,0,9999,0
1668449572371,ECE 200,002,103587,Atanasov; Nikolay A.,9999,0,9999,0
1668449572371,ECE 200,003,103588,Bharadia; Dinesh,9999,0,9999,0
1668449572371,ECE 200,004,103589,Cheng; Chung Kuan,9999,0,9999,0
1668449572371,ECE 200,005,103590,Cosman; Pamela C.,9999,0,9999,0
1668449572371,ECE 200,006,103591,Dayeh; Shadi Ahmad,9999,0,9999,0
1668449572371,ECE 200,007,103592,Fainman; Yeshaiahu,9999,0,9999,0
1668449572371,ECE 200,008,103593,Ford; Joseph Earl,9999,0,9999,0
1668449572371,ECE 200,009,103594,Franceschetti; Massimo,9999,0,9999,0
1668449572371,ECE 200,010,103595,Fullerton; Eric E,9999,0,9999,0
1668449572371,ECE 200,011,103596,Galton; Ian A,9999,0,9999,0
1668449572371,ECE 200,012,103597,Gilja; Vikash,9999,0,9999,0
1668449572371,ECE 200,013,103598,Hall; Drew A.,9999,0,9999,0
1668449572371,ECE 200,014,103599,Hsueh; Tzu-Chien,9999,0,9999,0
1668449572371,ECE 200,015,103600,Javidi; Tara,9999,0,9999,0
1668449572371,ECE 200,016,103601,Kahng; Andrew Byun,9999,0,9999,0
1668449572371,ECE 200,017,103602,Kim; Young-Han,9999,0,9999,0
1668449572371,ECE 200,018,103603,Koushanfar; Farinaz,9999,0,9999,0
1668449572371,ECE 200,019,103604,Kuzum; Duygu,9999,0,9999,0
1668449572371,ECE 200,020,103605,Le; Hanh-Phuc,9999,0,9999,0
1668449572371,ECE 200,021,103606,Lin; Bill,9999,0,9999,0
1668449572371,ECE 200,022,103607,Liu; Zhaowei,9998,0,9999,1
1668449572371,ECE 200,023,103608,Lo; Yu-Hwa,9999,0,9999,0
1668449572371,ECE 200,024,103609,Lomakin; Vitaliy,9999,0,9999,0
1668449572371,ECE 200,025,103610,Mercier; Patrick Philip,9999,0,9999,0
1668449572371,ECE 200,026,103611,Meyer; Florian,9999,0,9999,0
1668449572371,ECE 200,027,103612,Milstein; Laurence B.,9999,0,9999,0
1668449572371,ECE 200,028,103613,Mir Arabbaygi; Siavash,9999,0,9999,0
1668449572371,ECE 200,029,103614,Mookherjea; Shayan,9999,0,9999,0
1668449572371,ECE 200,030,103615,Morris; Karcher William,9999,0,9999,0
1668449572371,ECE 200,031,103616,Ng; Tse Nga,9999,0,9999,0
1668449572371,ECE 200,032,103617,Nguyen; Truong Quang,9999,0,9999,0
1668449572371,ECE 200,033,103618,Nomura; Kenji,9999,0,9999,0
1668449572371,ECE 200,034,103619,Orlitsky; Alon,9999,0,9999,0
1668449572371,ECE 200,035,103620,Pal; Piya,9999,0,9999,0
1668449572371,ECE 200,036,103621,Papen; George C.,9999,0,9999,0
1668449572371,ECE 200,037,103622,Radic; Stojan,9999,0,9999,0
1668449572371,ECE 200,038,103623,Rao; Bhaskar D.,9999,0,9999,0
1668449572371,ECE 200,039,103624,Rao; Ramesh R,9999,0,9999,0
1668449572371,ECE 200,040,103625,Rebeiz; Gabriel,9999,0,9999,0
1668449572371,ECE 200,041,103626,Sanford; John R,9999,0,9999,0
1668449572371,ECE 200,042,103627,Siegel; Paul H.,9999,0,9999,0
1668449572371,ECE 200,043,103628,Sievenpiper; Daniel F.,9999,0,9999,0
1668449572371,ECE 200,044,103629,Sworder; David D.,9999,0,9999,0
1668449572371,ECE 200,045,103630,Taur; Yuan,9999,0,9999,0
1668449572371,ECE 200,046,103631,Touri; Behrouz,9999,0,9999,0
1668449572371,ECE 200,047,103632,Trivedi; Mohan M.,9999,0,9999,0
1668449572371,ECE 200,048,103633,Vasconcelos; Nuno,9999,0,9999,0
1668449572371,ECE 200,049,103634,Wang; Xiaolong,9999,0,9999,0
1668449572371,ECE 200,050,103635,Xie; Pengtao,9999,0,9999,0
1668449572371,ECE 200,051,103636,Yip; Michael,9999,0,9999,0
1668449572371,ECE 200,052,103637,Zeger; Kenneth A.,999,0,999,0
1668449572371,ECE 200,053,103638,Zhang; Xinyu,9999,0,9999,0
1668449572371,ECE 200,054,103639,Turakhia; Yatish Girish,9999,0,9999,0
1668449572371,ECE 200,055,103640,Kang; Mingu,9999,0,9999,0
1668449572371,ECE 200,056,103641,Shi; Yuanyuan,9999,0,9999,0
1668449572371,ECE 200,057,103642,Wang; Edward Jay,9999,0,9999,0
1668449572371,ECE 200,058,103643,Zheng; Yang,9999,0,9999,0
1668449572795,ECE 202,A00,103644,Kuzum; Duygu,0,30,0,0
1668449573226,ECE 212BN,A00,103646,Ng; Tse Nga,0,1,0,0
1668449573659,ECE 221,A00,111493,Staff,0,0,0,0
1668449574205,ECE 222B,A00,103647,Lomakin; Vitaliy,0,6,0,0
1668449574627,ECE 230B,A00,103648,Taur; Yuan,0,1,0,0
1668449575055,ECE 238B,A00,103649,Garay; Javier,0,0,0,0
1668449575477,ECE 240B,A00,112900,Fainman; Yeshaiahu,0,4,0,0
1668449575907,ECE 247A,A00,103650,Jokerst; Jesse Vincent,0,2,0,0
1668449576331,ECE 247B,A00,103651,Wang; Joseph,0,7,0,0
1668449576769,ECE 250,A00,103652,Siegel; Paul H.,0,54,0,0
1668449577195,ECE 251A,A00,103654,Rao; Bhaskar D.,0,39,0,0
1668449577623,ECE 257B,A00,103655,Bharadia; Dinesh,0,21,0,0
1668449578046,ECE 258A,A00,103656,Milstein; Laurence B.,0,19,0,0
1668449578469,ECE 260B,A00,103658,Kang; Mingu,0,86,0,0
1668449578904,ECE 264A,A00,103659,Galton; Ian A,0,50,0,0
1668449579334,ECE 265A,A00,103661,Gudem; Prasad S.S.,0,29,0,0
1668449579762,ECE 265D,A00,103662,Gudem; Prasad S.S.,0,18,0,0
1668449580210,ECE 268,A00,103663,Koushanfar; Farinaz,0,30,0,0
1668449580647,ECE 269,A01,103665,Pal; Piya,0,157,0,0
1668449581072,ECE 271B,A00,103666,Vasconcelos; Manuela,0,53,0,0
1668449581500,ECE 276A,A00,103667,Atanasov; Nikolay A.,0,82,0,0
1668449581923,ECE 277,A00,103668,An; Cheolhong,0,106,0,0
1668449582345,ECE 279,A00,117947,Hall; Drew A.,0,16,0,0
1668449583205,ECE 283,A00,103670,Hsueh; Tzu-Chien,0,36,0,0
1668449583631,ECE 284,A00,103671,Turakhia; Yatish Girish,0,32,0,0
1668449584053,ECE 285,A00,103672,Zheng; Yang,0,28,0,0
1668449584053,ECE 285,B00,103673,Sworder; David D.,0,41,0,0
1668449584481,ECE 287,A00,103676,Javidi; Tara,0,5,0,0
1668449584909,MATH 200B,A00,098023,Salehi Golsefidy; Alireza,12,0,15,3
1668449585333,MATH 202B,A00,098024,Rhoades; Brendon Patrick,9,0,15,6
1668449585761,MATH 203B,A00,098025,Oprea; Dragos N.,10,0,15,5
1668449586185,MATH 204B,A00,098026,Sorensen; Claus M,13,0,15,2
1668449586609,MATH 208,A00,098027,Izadi; Elham,7,0,10,3
1668449587034,MATH 209,A00,098028,Pollack; Aaron,10,0,10,0
1668449587457,MATH 211A,A00,112919,Rogalski; Daniel,9,0,10,1
1668449587882,MATH 211B,A00,112920,Seward; Brandon M.,9,0,10,1
1668449588309,MATH 218,A00,098029,Li; Bo,10,0,10,0
1668449588736,MATH 220B,A00,098030,Novak; Jonathan I,11,0,15,4
1668449589161,MATH 221A,A00,098031,Ebenfelt; Peter F,13,0,15,2
1668449589600,MATH 231B,A00,098032,Zlatos; Andrej,11,0,15,4
1668449590023,MATH 240B,A00,098033,Ni; Lei,9,0,15,6
1668449590462,MATH 243,A00,098034,Jekel; David Andrew,10,0,10,0
1668449590887,MATH 245A,A00,098035,Nie; Jiawang,0,2,15,16
1668449591319,MATH 248,A00,098036,Bejenaru; Ioan,10,0,10,0
1668449591763,MATH 250B,A00,098037,Spolaor; Luca,14,0,15,1
1668449592189,MATH 258,A00,098038,Ni; Lei,10,0,10,0
1668449592611,MATH 264B,A00,098041,Rhoades; Brendon Patrick,9,0,15,6
1668449593043,MATH 268,A00,098042,Buss; Samuel R,10,0,10,0
1668449593464,MATH 269,A00,098043,Rhoades; Brendon Patrick,10,0,10,0
1668449593890,MATH 270B,A00,098044,Li; Bo,10,0,15,5
1668449594320,MATH 272B,A00,098045,Holst; Michael J,13,0,15,2
1668449594742,MATH 273A,A00,098046,Tian; Xiaochuan,10,0,15,5
1668449595169,MATH 275,A01,098048,Tian; Xiaochuan,6,0,10,4
1668449595593,MATH 278A,A00,098049,Holst; Michael J,8,0,10,2
1668449596025,MATH 278B,A00,098050,Cloninger; Alexander,10,0,10,0
1668449596453,MATH 278C,A00,098051,Nie; Jiawang,6,0,10,4
1668449596884,MATH 280B,A00,098052,Zheng; Tianyi,7,0,15,8
1668449597308,MATH 281B,A00,098053,Bradic; Jelena,0,2,15,15
1668449597743,MATH 282B,A00,098054,Arias-Castro; Ery,0,0,15,15
1668449598169,MATH 285,A00,098055,Fitzsimmons; Patrick J,0,1,15,17
1668449598599,MATH 287B,A00,098056,Arias-Castro; Ery,2,0,15,13
1668449599023,MATH 288,A00,098057,Agarwal; Pooja,9,0,10,1
1668449599023,MATH 288,B00,098058,Zhang; Danna,8,0,10,2
1668449599023,MATH 288,C00,098059,Williams; Ruth J,9,0,10,1
1668449599454,MATH 290B,A00,098060,Roberts; Justin Deritter,13,0,15,2
1668449599877,MATH 292,A00,098061,Belmont; Eva Kinoshita,10,0,10,0
1668449600306,MATH 295,A00,098062,Suk; Andrew Hoon,48,0,50,2
1668449600733,MATH 296,A00,098063,Novak; Jonathan I,20,0,20,0
1668449601157,MATH 297,001,098064,Gamst; Anthony Collins,9997,0,9999,2
1668450103920,COGS 205,A00,101395,Chiba; Andrea,19,0,20,1
1668450104357,COGS 210B,001,101404,Greene; Deanna Jacquelyn,9998,0,9999,1
1668450104357,COGS 210B,002,101417,Xia; Haijun,9999,0,9999,0
1668450104357,COGS 210B,003,101422,Nitz; Douglas A.,9999,0,9999,0
1668450104357,COGS 210B,004,101423,Hollan; James D.,9998,0,9999,1
1668450104357,COGS 210B,005,101424,Deak; Gedeon O.,9998,0,9999,1
1668450104357,COGS 210B,006,101425,Rossano; Federico,9999,0,9999,0
1668450104790,COGS 211B,A00,101427,Coulson; Seana M,9996,0,9999,3
1668450105224,COGS 220,A00,101428,Hollan; James D.,1,4,25,24
1668450105652,COGS 229,A00,101429,Dow; Steven P,18,0,25,7
1668450106084,COGS 230,A00,101430,Klemmer; Scott R,10,0,17,7
1668450106507,COGS 234,A00,101431,Xia; Haijun,2,0,25,23
1668450106932,COGS 260,A00,101432,Kiyonaga; Anastasia,21,0,25,4
1668450106932,COGS 260,B00,101433,Kirsh; David Joel,15,0,25,10
1668450107354,CSE 202,A00,102371,Impagliazzo; Russell,0,42,0,0
1668450107776,CSE 203B,A01,102373,Cheng; Chung Kuan,0,33,0,0
1668450108203,CSE 208,A00,102374,Micciancio; Daniele,0,2,0,0
1668450108633,CSE 209A,A00,112895,Impagliazzo; Russell,0,7,15,15
1668450109061,CSE 209B,A00,108005,Bellare; Mihir,0,3,0,0
1668450109484,CSE 210,A00,113163,Coblenz; Michael J,0,53,0,0
1668450109914,CSE 219,A00,106111,Dow; Steven P,0,2,20,20
1668450110339,CSE 221,A00,102376,Voelker; Geoffrey M.,0,42,0,0
1668450110761,CSE 224,A01,102378,Porter; George M,0,116,0,0
1668450111191,CSE 229A,A00,102379,Savage; Stefan,0,5,0,0
1668450111620,CSE 229C,A00,102380,Munyaka; Imani N. S.,0,5,0,0
1668450112059,CSE 232B,A00,102382,Deutsch; Alin Bernard,0,19,0,0
1668450112492,CSE 234,A01,112904,Kumar; Arun Kumar,0,0,0,0
1668450112915,CSE 237A,A00,102383,Rosing; Tajana Simunic,0,32,0,0
1668450113338,CSE 239A,A00,102384,Deutsch; Alin Bernard,0,6,0,0
1668450113784,CSE 239B,A00,102385,Polikarpova; Nadezhda,0,4,0,0
1668450114206,CSE 240A,A00,102386,Pannuto; Patrick William,0,34,0,0
1668450114638,CSE 240B,A00,102387,Zhao; Jishen,0,31,0,0
1668450115061,CSE 241A,A00,106406,Kang; Mingu,0,5,0,0
1668450115484,CSE 249B,A00,102388,Kahng; Andrew Byun,0,1,8,8
1668450115910,CSE 251B,A01,102392,Cottrell; Garrison W,0,31,0,0
1668450115910,CSE 251B,A02,102393,Cottrell; Garrison W,0,26,0,0
1668450116333,CSE 252B,A00,102394,Ochoa; Benjamin Lawrence,0,42,0,0
1668450116765,CSE 257,A01,102396,Gao; Sicun,0,97,0,0
1668450117191,CSE 272,A00,102397,Li; Tzumao,0,9,0,0
1668450117616,CSE 274,A00,111323,Chern; Albert Ren-Haur,0,8,0,0
1668450118048,CSE 282,A00,102398,Pevzner; Pavel Arkadjevich,0,0,0,0
1668450118492,CSE 284,A00,114175,Gymrek; Melissa Ann,0,14,0,0
1668450118919,CSE 290,A00,102399,Chandraker; Manmohan Krishna,0,5,0,0
1668450118919,CSE 290,B00,102400,Vaccaro; Kristen Marie,0,2,25,25
1668450118919,CSE 290,C00,102414,Pannuto; Patrick William,0,1,25,25
1668450118919,CSE 290,D00,102427,Pevzner; Pavel Arkadjevich,0,0,0,0
1668450118919,CSE 290,E00,102429,Zhao; Jishen,0,2,0,0
1668450118919,CSE 290,F00,102436,Tullsen; Dean Michael,0,4,0,0
1668450118919,CSE 290,G00,102440,Christensen; Henrik I,0,3,20,20
1668450119349,CSE 291,A00,102443,Su; Hao,0,0,0,0
1668450119349,CSE 291,B00,102448,Polikarpova; Nadezhda,0,0,0,0
1668450119349,CSE 291,C00,102453,Vaccaro; Kristen Marie,0,0,0,0
1668450119349,CSE 291,D00,111343,Savage; Stefan,0,0,0,0
1668450119349,CSE 291,E00,116474,Claffy; Kimberly Claire,0,0,0,0
1668450119349,CSE 291,F00,116479,Pasquale; Joseph,0,0,0,0
1668450119805,CSE 293,001,119111,Bafna; Vineet,9999,0,9999,0
1668450119805,CSE 293,002,119118,Bellare; Mihir,9999,0,9999,0
1668450119805,CSE 293,003,119122,Berg-Kirkpatrick; Taylor D,9999,0,9999,0
1668450119805,CSE 293,004,119135,Christensen; Henrik I,9999,0,9999,0
1668450119805,CSE 293,005,119142,Cottrell; Garrison W,9999,0,9999,0
1668450119805,CSE 293,006,119146,Deutsch; Alin Bernard,9999,0,9999,0
1668450119805,CSE 293,007,119159,Esmaeilzadeh; Hadi,9999,0,9999,0
1668450119805,CSE 293,008,119166,Freund; Yoav,9999,0,9999,0
1668450119805,CSE 293,009,119170,Griswold; William G.,9999,0,9999,0
1668450119805,CSE 293,010,119183,Gymrek; Melissa Ann,9999,0,9999,0
1668450119805,CSE 293,011,119190,Heninger; Nadia A,9999,0,9999,0
1668450119805,CSE 293,012,119230,Impagliazzo; Russell,9999,0,9999,0
1668450119805,CSE 293,013,119232,Jhala; Ranjit,9999,0,9999,0
1668450119805,CSE 293,014,119233,Kahng; Andrew Byun,9999,0,9999,0
1668450119805,CSE 293,015,119298,Kane; Daniel Mertz,9999,0,9999,0
1668450119805,CSE 293,016,119299,Kriegman; David J,9999,0,9999,0
1668450119805,CSE 293,017,119300,Kumar; Arun Kumar,9999,0,9999,0
1668450119805,CSE 293,018,119301,Lerner; Sorin,9999,0,9999,0
1668450119805,CSE 293,019,119302,Lovett; Shachar,9999,0,9999,0
1668450119805,CSE 293,020,119303,McAuley; Julian John,9999,0,9999,0
1668450119805,CSE 293,021,119304,Micciancio; Daniele,9999,0,9999,0
1668450119805,CSE 293,022,119367,Orailoglu; Alex,9999,0,9999,0
1668450119805,CSE 293,023,119382,Paturi; Ramamohan,9999,0,9999,0
1668450119805,CSE 293,024,119404,Polikarpova; Nadezhda,9999,0,9999,0
1668450119805,CSE 293,025,119406,Politz; Joseph Gibbs,9999,0,9999,0
1668450119805,CSE 293,026,119411,Porter; George M,9999,0,9999,0
1668450119805,CSE 293,027,119414,Porter; Leonard Emerson,9999,0,9999,0
1668450119805,CSE 293,028,119416,Ramamoorthi; Ravi,9999,0,9999,0
1668450119805,CSE 293,029,119417,Sahoo; Debashis,9999,0,9999,0
1668450119805,CSE 293,030,119420,Saul; Lawrence,9999,0,9999,0
1668450119805,CSE 293,031,119421,Savage; Stefan,9999,0,9999,0
1668450119805,CSE 293,032,119425,Schulze; Jurgen P.,9999,0,9999,0
1668450119805,CSE 293,033,119426,Snoeren; Alex C.,9999,0,9999,0
1668450119805,CSE 293,034,119428,Shang; Jingbo,9999,0,9999,0
1668450119805,CSE 293,035,119430,Stefan; Deian,9999,0,9999,0
1668450119805,CSE 293,036,119431,Su; Hao,9999,0,9999,0
1668450119805,CSE 293,037,119433,Swanson; Steven James,9999,0,9999,0
1668450119805,CSE 293,038,119435,Tullsen; Dean Michael,9999,0,9999,0
1668450119805,CSE 293,039,119483,Voelker; Geoffrey M.,9999,0,9999,0
1668450119805,CSE 293,040,119537,Zhao; Jishen,9999,0,9999,0
1668450119805,CSE 293,041,119538,Zhou; Yuan-Yuan,9999,0,9999,0
1668450119805,CSE 293,042,119539,Gao; Sicun,9999,0,9999,0
1668450119805,CSE 293,043,119540,Weibel; Nadir,9999,0,9999,0
1668450119805,CSE 293,044,119541,Gupta; Rajesh K.,9999,0,9999,0
1668450119805,CSE 293,045,126410,Vaccaro; Kristen Marie,9999,0,9999,0
1668450119805,CSE 293,046,126411,Klemke; Richard,9999,0,9999,0
1668450120230,CSE 294,A00,102459,Voelker; Geoffrey M.,0,2,0,0
1668450120230,CSE 294,B00,111322,Orailoglu; Alex,0,0,0,0
1668450120656,DSE 201,A00,096914,Deutsch; Alin Bernard,30,0,30,0
1668450121079,DSE 210,A00,096915,Dasgupta; Sanjoy,30,0,30,0
1668450121510,DSE 260A,A00,096916,Altintas De Callaf; Ilkay,30,0,30,0
1668450121944,ECE 200,001,103586,Antipa; Nicholas A,9999,0,9999,0
1668450121944,ECE 200,002,103587,Atanasov; Nikolay A.,9999,0,9999,0
1668450121944,ECE 200,003,103588,Bharadia; Dinesh,9999,0,9999,0
1668450121944,ECE 200,004,103589,Cheng; Chung Kuan,9999,0,9999,0
1668450121944,ECE 200,005,103590,Cosman; Pamela C.,9999,0,9999,0
1668450121944,ECE 200,006,103591,Dayeh; Shadi Ahmad,9999,0,9999,0
1668450121944,ECE 200,007,103592,Fainman; Yeshaiahu,9999,0,9999,0
1668450121944,ECE 200,008,103593,Ford; Joseph Earl,9999,0,9999,0
1668450121944,ECE 200,009,103594,Franceschetti; Massimo,9999,0,9999,0
1668450121944,ECE 200,010,103595,Fullerton; Eric E,9999,0,9999,0
1668450121944,ECE 200,011,103596,Galton; Ian A,9999,0,9999,0
1668450121944,ECE 200,012,103597,Gilja; Vikash,9999,0,9999,0
1668450121944,ECE 200,013,103598,Hall; Drew A.,9999,0,9999,0
1668450121944,ECE 200,014,103599,Hsueh; Tzu-Chien,9999,0,9999,0
1668450121944,ECE 200,015,103600,Javidi; Tara,9999,0,9999,0
1668450121944,ECE 200,016,103601,Kahng; Andrew Byun,9999,0,9999,0
1668450121944,ECE 200,017,103602,Kim; Young-Han,9999,0,9999,0
1668450121944,ECE 200,018,103603,Koushanfar; Farinaz,9999,0,9999,0
1668450121944,ECE 200,019,103604,Kuzum; Duygu,9999,0,9999,0
1668450121944,ECE 200,020,103605,Le; Hanh-Phuc,9999,0,9999,0
1668450121944,ECE 200,021,103606,Lin; Bill,9999,0,9999,0
1668450121944,ECE 200,022,103607,Liu; Zhaowei,9998,0,9999,1
1668450121944,ECE 200,023,103608,Lo; Yu-Hwa,9999,0,9999,0
1668450121944,ECE 200,024,103609,Lomakin; Vitaliy,9999,0,9999,0
1668450121944,ECE 200,025,103610,Mercier; Patrick Philip,9999,0,9999,0
1668450121944,ECE 200,026,103611,Meyer; Florian,9999,0,9999,0
1668450121944,ECE 200,027,103612,Milstein; Laurence B.,9999,0,9999,0
1668450121944,ECE 200,028,103613,Mir Arabbaygi; Siavash,9999,0,9999,0
1668450121944,ECE 200,029,103614,Mookherjea; Shayan,9999,0,9999,0
1668450121944,ECE 200,030,103615,Morris; Karcher William,9999,0,9999,0
1668450121944,ECE 200,031,103616,Ng; Tse Nga,9999,0,9999,0
1668450121944,ECE 200,032,103617,Nguyen; Truong Quang,9999,0,9999,0
1668450121944,ECE 200,033,103618,Nomura; Kenji,9999,0,9999,0
1668450121944,ECE 200,034,103619,Orlitsky; Alon,9999,0,9999,0
1668450121944,ECE 200,035,103620,Pal; Piya,9999,0,9999,0
1668450121944,ECE 200,036,103621,Papen; George C.,9999,0,9999,0
1668450121944,ECE 200,037,103622,Radic; Stojan,9999,0,9999,0
1668450121944,ECE 200,038,103623,Rao; Bhaskar D.,9999,0,9999,0
1668450121944,ECE 200,039,103624,Rao; Ramesh R,9999,0,9999,0
1668450121944,ECE 200,040,103625,Rebeiz; Gabriel,9999,0,9999,0
1668450121944,ECE 200,041,103626,Sanford; John R,9999,0,9999,0
1668450121944,ECE 200,042,103627,Siegel; Paul H.,9999,0,9999,0
1668450121944,ECE 200,043,103628,Sievenpiper; Daniel F.,9999,0,9999,0
1668450121944,ECE 200,044,103629,Sworder; David D.,9999,0,9999,0
1668450121944,ECE 200,045,103630,Taur; Yuan,9999,0,9999,0
1668450121944,ECE 200,046,103631,Touri; Behrouz,9999,0,9999,0
1668450121944,ECE 200,047,103632,Trivedi; Mohan M.,9999,0,9999,0
1668450121944,ECE 200,048,103633,Vasconcelos; Nuno,9999,0,9999,0
1668450121944,ECE 200,049,103634,Wang; Xiaolong,9999,0,9999,0
1668450121944,ECE 200,050,103635,Xie; Pengtao,9999,0,9999,0
1668450121944,ECE 200,051,103636,Yip; Michael,9999,0,9999,0
1668450121944,ECE 200,052,103637,Zeger; Kenneth A.,999,0,999,0
1668450121944,ECE 200,053,103638,Zhang; Xinyu,9999,0,9999,0
1668450121944,ECE 200,054,103639,Turakhia; Yatish Girish,9999,0,9999,0
1668450121944,ECE 200,055,103640,Kang; Mingu,9999,0,9999,0
1668450121944,ECE 200,056,103641,Shi; Yuanyuan,9999,0,9999,0
1668450121944,ECE 200,057,103642,Wang; Edward Jay,9999,0,9999,0
1668450121944,ECE 200,058,103643,Zheng; Yang,9999,0,9999,0
1668450122366,ECE 202,A00,103644,Kuzum; Duygu,0,30,0,0
1668450122787,ECE 212BN,A00,103646,Ng; Tse Nga,0,1,0,0
1668450123210,ECE 221,A00,111493,Staff,0,0,0,0
1668450123635,ECE 222B,A00,103647,Lomakin; Vitaliy,0,6,0,0
1668450124063,ECE 230B,A00,103648,Taur; Yuan,0,1,0,0
1668450124490,ECE 238B,A00,103649,Garay; Javier,0,0,0,0
1668450124914,ECE 240B,A00,112900,Fainman; Yeshaiahu,0,4,0,0
1668450125338,ECE 247A,A00,103650,Jokerst; Jesse Vincent,0,2,0,0
1668450125763,ECE 247B,A00,103651,Wang; Joseph,0,7,0,0
1668450126186,ECE 250,A00,103652,Siegel; Paul H.,0,54,0,0
1668450126611,ECE 251A,A00,103654,Rao; Bhaskar D.,0,39,0,0
1668450127037,ECE 257B,A00,103655,Bharadia; Dinesh,0,21,0,0
1668450127459,ECE 258A,A00,103656,Milstein; Laurence B.,0,20,0,0
1668450127891,ECE 260B,A00,103658,Kang; Mingu,0,87,0,0
1668450128317,ECE 264A,A00,103659,Galton; Ian A,0,51,0,0
1668450128758,ECE 265A,A00,103661,Gudem; Prasad S.S.,0,29,0,0
1668450129189,ECE 265D,A00,103662,Gudem; Prasad S.S.,0,18,0,0
1668450129614,ECE 268,A00,103663,Koushanfar; Farinaz,0,30,0,0
1668450130047,ECE 269,A01,103665,Pal; Piya,0,158,0,0
1668450130479,ECE 271B,A00,103666,Vasconcelos; Manuela,0,53,0,0
1668450130905,ECE 276A,A00,103667,Atanasov; Nikolay A.,0,82,0,0
1668450131337,ECE 277,A00,103668,An; Cheolhong,0,107,0,0
1668450131761,ECE 279,A00,117947,Hall; Drew A.,0,16,0,0
1668450132612,ECE 283,A00,103670,Hsueh; Tzu-Chien,0,36,0,0
1668450133035,ECE 284,A00,103671,Turakhia; Yatish Girish,0,32,0,0
1668450133460,ECE 285,A00,103672,Zheng; Yang,0,28,0,0
1668450133460,ECE 285,B00,103673,Sworder; David D.,0,41,0,0
1668450133886,ECE 287,A00,103676,Javidi; Tara,0,5,0,0
1668450134325,MATH 200B,A00,098023,Salehi Golsefidy; Alireza,12,0,15,3
1668450134750,MATH 202B,A00,098024,Rhoades; Brendon Patrick,9,0,15,6
1668450135176,MATH 203B,A00,098025,Oprea; Dragos N.,10,0,15,5
1668450135600,MATH 204B,A00,098026,Sorensen; Claus M,13,0,15,2
1668450136024,MATH 208,A00,098027,Izadi; Elham,7,0,10,3
1668450136448,MATH 209,A00,098028,Pollack; Aaron,10,0,10,0
1668450136873,MATH 211A,A00,112919,Rogalski; Daniel,9,0,10,1
1668450137298,MATH 211B,A00,112920,Seward; Brandon M.,9,0,10,1
1668450137721,MATH 218,A00,098029,Li; Bo,10,0,10,0
1668450138145,MATH 220B,A00,098030,Novak; Jonathan I,11,0,15,4
1668450138571,MATH 221A,A00,098031,Ebenfelt; Peter F,13,0,15,2
1668450138997,MATH 231B,A00,098032,Zlatos; Andrej,11,0,15,4
1668450141304,MATH 240B,A00,098033,Ni; Lei,9,0,15,6
1668450141731,MATH 243,A00,098034,Jekel; David Andrew,10,0,10,0
1668450142173,MATH 245A,A00,098035,Nie; Jiawang,0,2,15,16
1668450142598,MATH 248,A00,098036,Bejenaru; Ioan,10,0,10,0
1668450143021,MATH 250B,A00,098037,Spolaor; Luca,14,0,15,1
1668450143451,MATH 258,A00,098038,Ni; Lei,10,0,10,0
1668450143888,MATH 264B,A00,098041,Rhoades; Brendon Patrick,9,0,15,6
1668450144313,MATH 268,A00,098042,Buss; Samuel R,10,0,10,0
1668450144738,MATH 269,A00,098043,Rhoades; Brendon Patrick,10,0,10,0
1668450145166,MATH 270B,A00,098044,Li; Bo,10,0,15,5
1668450145590,MATH 272B,A00,098045,Holst; Michael J,13,0,15,2
1668450146027,MATH 273A,A00,098046,Tian; Xiaochuan,10,0,15,5
1668450146449,MATH 275,A01,098048,Tian; Xiaochuan,6,0,10,4
1668450146872,MATH 278A,A00,098049,Holst; Michael J,8,0,10,2
1668450147294,MATH 278B,A00,098050,Cloninger; Alexander,10,0,10,0
1668450147730,MATH 278C,A00,098051,Nie; Jiawang,6,0,10,4
1668450148167,MATH 280B,A00,098052,Zheng; Tianyi,7,0,15,8
1668450148599,MATH 281B,A00,098053,Bradic; Jelena,0,2,15,15
1668450149033,MATH 282B,A00,098054,Arias-Castro; Ery,0,0,15,15
1668450149456,MATH 285,A00,098055,Fitzsimmons; Patrick J,0,1,15,17
1668450149881,MATH 287B,A00,098056,Arias-Castro; Ery,2,0,15,13
1668450150303,MATH 288,A00,098057,Agarwal; Pooja,9,0,10,1
1668450150303,MATH 288,B00,098058,Zhang; Danna,8,0,10,2
1668450150303,MATH 288,C00,098059,Williams; Ruth J,9,0,10,1
1668450150737,MATH 290B,A00,098060,Roberts; Justin Deritter,13,0,15,2
1668450151168,MATH 292,A00,098061,Belmont; Eva Kinoshita,10,0,10,0
1668450151594,MATH 295,A00,098062,Suk; Andrew Hoon,48,0,50,2
1668450152020,MATH 296,A00,098063,Novak; Jonathan I,20,0,20,0
1668450152460,MATH 297,001,098064,Gamst; Anthony Collins,9997,0,9999,2
1668450654798,COGS 205,A00,101395,Chiba; Andrea,19,0,20,1
1668450655230,COGS 210B,001,101404,Greene; Deanna Jacquelyn,9998,0,9999,1
1668450655230,COGS 210B,002,101417,Xia; Haijun,9999,0,9999,0
1668450655230,COGS 210B,003,101422,Nitz; Douglas A.,9999,0,9999,0
1668450655230,COGS 210B,004,101423,Hollan; James D.,9998,0,9999,1
1668450655230,COGS 210B,005,101424,Deak; Gedeon O.,9998,0,9999,1
1668450655230,COGS 210B,006,101425,Rossano; Federico,9999,0,9999,0
1668450655665,COGS 211B,A00,101427,Coulson; Seana M,9996,0,9999,3
1668450656101,COGS 220,A00,101428,Hollan; James D.,1,4,25,24
1668450656527,COGS 229,A00,101429,Dow; Steven P,18,0,25,7
1668450656952,COGS 230,A00,101430,Klemmer; Scott R,10,0,17,7
1668450657377,COGS 234,A00,101431,Xia; Haijun,2,0,25,23
1668450657804,COGS 260,A00,101432,Kiyonaga; Anastasia,21,0,25,4
1668450657804,COGS 260,B00,101433,Kirsh; David Joel,15,0,25,10
1668450658228,CSE 202,A00,102371,Impagliazzo; Russell,0,42,0,0
1668450658656,CSE 203B,A01,102373,Cheng; Chung Kuan,0,33,0,0
1668450659081,CSE 208,A00,102374,Micciancio; Daniele,0,2,0,0
1668450659515,CSE 209A,A00,112895,Impagliazzo; Russell,0,7,15,15
1668450659939,CSE 209B,A00,108005,Bellare; Mihir,0,3,0,0
1668450660365,CSE 210,A00,113163,Coblenz; Michael J,0,56,0,0
1668450660797,CSE 219,A00,106111,Dow; Steven P,0,2,20,20
1668450661233,CSE 221,A00,102376,Voelker; Geoffrey M.,0,42,0,0
1668450661753,CSE 224,A01,102378,Porter; George M,0,117,0,0
1668450662178,CSE 229A,A00,102379,Savage; Stefan,0,5,0,0
1668450662613,CSE 229C,A00,102380,Munyaka; Imani N. S.,0,5,0,0
1668450663143,CSE 232B,A00,102382,Deutsch; Alin Bernard,0,19,0,0
1668450663567,CSE 234,A01,112904,Kumar; Arun Kumar,0,0,0,0
1668450663998,CSE 237A,A00,102383,Rosing; Tajana Simunic,0,32,0,0
1668450664437,CSE 239A,A00,102384,Deutsch; Alin Bernard,0,6,0,0
1668450664864,CSE 239B,A00,102385,Polikarpova; Nadezhda,0,4,0,0
1668450665287,CSE 240A,A00,102386,Pannuto; Patrick William,0,34,0,0
1668450665713,CSE 240B,A00,102387,Zhao; Jishen,0,32,0,0
1668450666136,CSE 241A,A00,106406,Kang; Mingu,0,5,0,0
1668450666562,CSE 249B,A00,102388,Kahng; Andrew Byun,0,1,8,8
1668450666998,CSE 251B,A01,102392,Cottrell; Garrison W,0,30,0,0
1668450666998,CSE 251B,A02,102393,Cottrell; Garrison W,0,27,0,0
1668450667425,CSE 252B,A00,102394,Ochoa; Benjamin Lawrence,0,42,0,0
1668450667851,CSE 257,A01,102396,Gao; Sicun,0,98,0,0
1668450668275,CSE 272,A00,102397,Li; Tzumao,0,9,0,0
1668450668704,CSE 274,A00,111323,Chern; Albert Ren-Haur,0,8,0,0
1668450669127,CSE 282,A00,102398,Pevzner; Pavel Arkadjevich,0,0,0,0
1668450669550,CSE 284,A00,114175,Gymrek; Melissa Ann,0,14,0,0
1668450669977,CSE 290,A00,102399,Chandraker; Manmohan Krishna,0,5,0,0
1668450669977,CSE 290,B00,102400,Vaccaro; Kristen Marie,0,2,25,25
1668450669977,CSE 290,C00,102414,Pannuto; Patrick William,0,1,25,25
1668450669977,CSE 290,D00,102427,Pevzner; Pavel Arkadjevich,0,0,0,0
1668450669977,CSE 290,E00,102429,Zhao; Jishen,0,2,0,0
1668450669977,CSE 290,F00,102436,Tullsen; Dean Michael,0,4,0,0
1668450669977,CSE 290,G00,102440,Christensen; Henrik I,0,3,20,20
1668450670407,CSE 291,A00,102443,Su; Hao,0,0,0,0
1668450670407,CSE 291,B00,102448,Polikarpova; Nadezhda,0,0,0,0
1668450670407,CSE 291,C00,102453,Vaccaro; Kristen Marie,0,0,0,0
1668450670407,CSE 291,D00,111343,Savage; Stefan,0,0,0,0
1668450670407,CSE 291,E00,116474,Claffy; Kimberly Claire,0,0,0,0
1668450670407,CSE 291,F00,116479,Pasquale; Joseph,0,0,0,0
1668450670848,CSE 293,001,119111,Bafna; Vineet,9999,0,9999,0
1668450670848,CSE 293,002,119118,Bellare; Mihir,9999,0,9999,0
1668450670848,CSE 293,003,119122,Berg-Kirkpatrick; Taylor D,9999,0,9999,0
1668450670848,CSE 293,004,119135,Christensen; Henrik I,9999,0,9999,0
1668450670848,CSE 293,005,119142,Cottrell; Garrison W,9999,0,9999,0
1668450670848,CSE 293,006,119146,Deutsch; Alin Bernard,9999,0,9999,0
1668450670848,CSE 293,007,119159,Esmaeilzadeh; Hadi,9999,0,9999,0
1668450670848,CSE 293,008,119166,Freund; Yoav,9999,0,9999,0
1668450670848,CSE 293,009,119170,Griswold; William G.,9999,0,9999,0
1668450670848,CSE 293,010,119183,Gymrek; Melissa Ann,9999,0,9999,0
1668450670848,CSE 293,011,119190,Heninger; Nadia A,9999,0,9999,0
1668450670848,CSE 293,012,119230,Impagliazzo; Russell,9999,0,9999,0
1668450670848,CSE 293,013,119232,Jhala; Ranjit,9999,0,9999,0
1668450670848,CSE 293,014,119233,Kahng; Andrew Byun,9999,0,9999,0
1668450670848,CSE 293,015,119298,Kane; Daniel Mertz,9999,0,9999,0
1668450670848,CSE 293,016,119299,Kriegman; David J,9999,0,9999,0
1668450670848,CSE 293,017,119300,Kumar; Arun Kumar,9999,0,9999,0
1668450670848,CSE 293,018,119301,Lerner; Sorin,9999,0,9999,0
1668450670848,CSE 293,019,119302,Lovett; Shachar,9999,0,9999,0
1668450670848,CSE 293,020,119303,McAuley; Julian John,9999,0,9999,0
1668450670848,CSE 293,021,119304,Micciancio; Daniele,9999,0,9999,0
1668450670848,CSE 293,022,119367,Orailoglu; Alex,9999,0,9999,0
1668450670848,CSE 293,023,119382,Paturi; Ramamohan,9999,0,9999,0
1668450670848,CSE 293,024,119404,Polikarpova; Nadezhda,9999,0,9999,0
1668450670848,CSE 293,025,119406,Politz; Joseph Gibbs,9999,0,9999,0
1668450670848,CSE 293,026,119411,Porter; George M,9999,0,9999,0
1668450670848,CSE 293,027,119414,Porter; Leonard Emerson,9999,0,9999,0
1668450670848,CSE 293,028,119416,Ramamoorthi; Ravi,9999,0,9999,0
1668450670848,CSE 293,029,119417,Sahoo; Debashis,9999,0,9999,0
1668450670848,CSE 293,030,119420,Saul; Lawrence,9999,0,9999,0
1668450670848,CSE 293,031,119421,Savage; Stefan,9999,0,9999,0
1668450670848,CSE 293,032,119425,Schulze; Jurgen P.,9999,0,9999,0
1668450670848,CSE 293,033,119426,Snoeren; Alex C.,9999,0,9999,0
1668450670848,CSE 293,034,119428,Shang; Jingbo,9999,0,9999,0
1668450670848,CSE 293,035,119430,Stefan; Deian,9999,0,9999,0
1668450670848,CSE 293,036,119431,Su; Hao,9999,0,9999,0
1668450670848,CSE 293,037,119433,Swanson; Steven James,9999,0,9999,0
1668450670848,CSE 293,038,119435,Tullsen; Dean Michael,9999,0,9999,0
1668450670848,CSE 293,039,119483,Voelker; Geoffrey M.,9999,0,9999,0
1668450670848,CSE 293,040,119537,Zhao; Jishen,9999,0,9999,0
1668450670848,CSE 293,041,119538,Zhou; Yuan-Yuan,9999,0,9999,0
1668450670848,CSE 293,042,119539,Gao; Sicun,9999,0,9999,0
1668450670848,CSE 293,043,119540,Weibel; Nadir,9999,0,9999,0
1668450670848,CSE 293,044,119541,Gupta; Rajesh K.,9999,0,9999,0
1668450670848,CSE 293,045,126410,Vaccaro; Kristen Marie,9999,0,9999,0
1668450670848,CSE 293,046,126411,Klemke; Richard,9999,0,9999,0
1668450671276,CSE 294,A00,102459,Voelker; Geoffrey M.,0,2,0,0
1668450671276,CSE 294,B00,111322,Orailoglu; Alex,0,0,0,0
1668450671704,DSE 201,A00,096914,Deutsch; Alin Bernard,30,0,30,0
1668450672129,DSE 210,A00,096915,Dasgupta; Sanjoy,30,0,30,0
1668450672565,DSE 260A,A00,096916,Altintas De Callaf; Ilkay,30,0,30,0
1668450673035,ECE 200,001,103586,Antipa; Nicholas A,9999,0,9999,0
1668450673035,ECE 200,002,103587,Atanasov; Nikolay A.,9999,0,9999,0
1668450673035,ECE 200,003,103588,Bharadia; Dinesh,9999,0,9999,0
1668450673035,ECE 200,004,103589,Cheng; Chung Kuan,9999,0,9999,0
1668450673035,ECE 200,005,103590,Cosman; Pamela C.,9999,0,9999,0
1668450673035,ECE 200,006,103591,Dayeh; Shadi Ahmad,9999,0,9999,0
1668450673035,ECE 200,007,103592,Fainman; Yeshaiahu,9999,0,9999,0
1668450673035,ECE 200,008,103593,Ford; Joseph Earl,9999,0,9999,0
1668450673035,ECE 200,009,103594,Franceschetti; Massimo,9999,0,9999,0
1668450673035,ECE 200,010,103595,Fullerton; Eric E,9999,0,9999,0
1668450673035,ECE 200,011,103596,Galton; Ian A,9999,0,9999,0
1668450673035,ECE 200,012,103597,Gilja; Vikash,9999,0,9999,0
1668450673035,ECE 200,013,103598,Hall; Drew A.,9999,0,9999,0
1668450673035,ECE 200,014,103599,Hsueh; Tzu-Chien,9999,0,9999,0
1668450673035,ECE 200,015,103600,Javidi; Tara,9999,0,9999,0
1668450673035,ECE 200,016,103601,Kahng; Andrew Byun,9999,0,9999,0
1668450673035,ECE 200,017,103602,Kim; Young-Han,9999,0,9999,0
1668450673035,ECE 200,018,103603,Koushanfar; Farinaz,9999,0,9999,0
1668450673035,ECE 200,019,103604,Kuzum; Duygu,9999,0,9999,0
1668450673035,ECE 200,020,103605,Le; Hanh-Phuc,9999,0,9999,0
1668450673035,ECE 200,021,103606,Lin; Bill,9999,0,9999,0
1668450673035,ECE 200,022,103607,Liu; Zhaowei,9998,0,9999,1
1668450673035,ECE 200,023,103608,Lo; Yu-Hwa,9999,0,9999,0
1668450673035,ECE 200,024,103609,Lomakin; Vitaliy,9999,0,9999,0
1668450673035,ECE 200,025,103610,Mercier; Patrick Philip,9999,0,9999,0
1668450673035,ECE 200,026,103611,Meyer; Florian,9999,0,9999,0
1668450673035,ECE 200,027,103612,Milstein; Laurence B.,9999,0,9999,0
1668450673035,ECE 200,028,103613,Mir Arabbaygi; Siavash,9999,0,9999,0
1668450673035,ECE 200,029,103614,Mookherjea; Shayan,9999,0,9999,0
1668450673035,ECE 200,030,103615,Morris; Karcher William,9999,0,9999,0
1668450673035,ECE 200,031,103616,Ng; Tse Nga,9999,0,9999,0
1668450673035,ECE 200,032,103617,Nguyen; Truong Quang,9999,0,9999,0
1668450673035,ECE 200,033,103618,Nomura; Kenji,9999,0,9999,0
1668450673035,ECE 200,034,103619,Orlitsky; Alon,9999,0,9999,0
1668450673035,ECE 200,035,103620,Pal; Piya,9999,0,9999,0
1668450673035,ECE 200,036,103621,Papen; George C.,9999,0,9999,0
1668450673035,ECE 200,037,103622,Radic; Stojan,9999,0,9999,0
1668450673035,ECE 200,038,103623,Rao; Bhaskar D.,9999,0,9999,0
1668450673035,ECE 200,039,103624,Rao; Ramesh R,9999,0,9999,0
1668450673035,ECE 200,040,103625,Rebeiz; Gabriel,9999,0,9999,0
1668450673035,ECE 200,041,103626,Sanford; John R,9999,0,9999,0
1668450673035,ECE 200,042,103627,Siegel; Paul H.,9999,0,9999,0
1668450673035,ECE 200,043,103628,Sievenpiper; Daniel F.,9999,0,9999,0
1668450673035,ECE 200,044,103629,Sworder; David D.,9999,0,9999,0
1668450673035,ECE 200,045,103630,Taur; Yuan,9999,0,9999,0
1668450673035,ECE 200,046,103631,Touri; Behrouz,9999,0,9999,0
1668450673035,ECE 200,047,103632,Trivedi; Mohan M.,9999,0,9999,0
1668450673035,ECE 200,048,103633,Vasconcelos; Nuno,9999,0,9999,0
1668450673035,ECE 200,049,103634,Wang; Xiaolong,9999,0,9999,0
1668450673035,ECE 200,050,103635,Xie; Pengtao,9999,0,9999,0
1668450673035,ECE 200,051,103636,Yip; Michael,9999,0,9999,0
1668450673035,ECE 200,052,103637,Zeger; Kenneth A.,999,0,999,0
1668450673035,ECE 200,053,103638,Zhang; Xinyu,9999,0,9999,0
1668450673035,ECE 200,054,103639,Turakhia; Yatish Girish,9999,0,9999,0
1668450673035,ECE 200,055,103640,Kang; Mingu,9999,0,9999,0
1668450673035,ECE 200,056,103641,Shi; Yuanyuan,9999,0,9999,0
1668450673035,ECE 200,057,103642,Wang; Edward Jay,9999,0,9999,0
1668450673035,ECE 200,058,103643,Zheng; Yang,9999,0,9999,0
1668450673458,ECE 202,A00,103644,Kuzum; Duygu,0,31,0,0
1668450673888,ECE 212BN,A00,103646,Ng; Tse Nga,0,2,0,0
1668450674314,ECE 221,A00,111493,Staff,0,0,0,0
1668450674738,ECE 222B,A00,103647,Lomakin; Vitaliy,0,7,0,0
1668450675162,ECE 230B,A00,103648,Taur; Yuan,0,1,0,0
1668450675589,ECE 238B,A00,103649,Garay; Javier,0,0,0,0
1668450676021,ECE 240B,A00,112900,Fainman; Yeshaiahu,0,4,0,0
1668450676446,ECE 247A,A00,103650,Jokerst; Jesse Vincent,0,2,0,0
1668450676869,ECE 247B,A00,103651,Wang; Joseph,0,8,0,0
1668450677295,ECE 250,A00,103652,Siegel; Paul H.,0,54,0,0
1668450677733,ECE 251A,A00,103654,Rao; Bhaskar D.,0,39,0,0
1668450678156,ECE 257B,A00,103655,Bharadia; Dinesh,0,21,0,0
1668450678581,ECE 258A,A00,103656,Milstein; Laurence B.,0,21,0,0
1668450679013,ECE 260B,A00,103658,Kang; Mingu,0,88,0,0
1668450679442,ECE 264A,A00,103659,Galton; Ian A,0,51,0,0
1668450679873,ECE 265A,A00,103661,Gudem; Prasad S.S.,0,30,0,0
1668450680296,ECE 265D,A00,103662,Gudem; Prasad S.S.,0,18,0,0
1668450680718,ECE 268,A00,103663,Koushanfar; Farinaz,0,30,0,0
1668450681145,ECE 269,A01,103665,Pal; Piya,0,159,0,0
1668450681569,ECE 271B,A00,103666,Vasconcelos; Manuela,0,54,0,0
1668450681993,ECE 276A,A00,103667,Atanasov; Nikolay A.,0,84,0,0
1668450682416,ECE 277,A00,103668,An; Cheolhong,0,109,0,0
1668450682845,ECE 279,A00,117947,Hall; Drew A.,0,16,0,0
1668450683700,ECE 283,A00,103670,Hsueh; Tzu-Chien,0,36,0,0
1668450684124,ECE 284,A00,103671,Turakhia; Yatish Girish,0,32,0,0
1668450684546,ECE 285,A00,103672,Zheng; Yang,0,28,0,0
1668450684546,ECE 285,B00,103673,Sworder; David D.,0,43,0,0
1668450684977,ECE 287,A00,103676,Javidi; Tara,0,5,0,0
1668450685406,MATH 200B,A00,098023,Salehi Golsefidy; Alireza,12,0,15,3
1668450685829,MATH 202B,A00,098024,Rhoades; Brendon Patrick,9,0,15,6
1668450686253,MATH 203B,A00,098025,Oprea; Dragos N.,10,0,15,5
1668450686677,MATH 204B,A00,098026,Sorensen; Claus M,13,0,15,2
1668450687112,MATH 208,A00,098027,Izadi; Elham,7,0,10,3
1668450687541,MATH 209,A00,098028,Pollack; Aaron,10,0,10,0
1668450687967,MATH 211A,A00,112919,Rogalski; Daniel,9,0,10,1
1668450688390,MATH 211B,A00,112920,Seward; Brandon M.,9,0,10,1
1668450688830,MATH 218,A00,098029,Li; Bo,10,0,10,0
1668450689259,MATH 220B,A00,098030,Novak; Jonathan I,11,0,15,4
1668450689685,MATH 221A,A00,098031,Ebenfelt; Peter F,13,0,15,2
1668450690119,MATH 231B,A00,098032,Zlatos; Andrej,11,0,15,4
1668450690543,MATH 240B,A00,098033,Ni; Lei,9,0,15,6
1668450690969,MATH 243,A00,098034,Jekel; David Andrew,10,0,10,0
1668450691394,MATH 245A,A00,098035,Nie; Jiawang,0,2,15,16
1668450691816,MATH 248,A00,098036,Bejenaru; Ioan,10,0,10,0
1668450692244,MATH 250B,A00,098037,Spolaor; Luca,14,0,15,1
1668450692684,MATH 258,A00,098038,Ni; Lei,10,0,10,0
1668450693110,MATH 264B,A00,098041,Rhoades; Brendon Patrick,9,0,15,6
1668450693537,MATH 268,A00,098042,Buss; Samuel R,10,0,10,0
1668450693969,MATH 269,A00,098043,Rhoades; Brendon Patrick,10,0,10,0
1668450694397,MATH 270B,A00,098044,Li; Bo,10,0,15,5
1668450694827,MATH 272B,A00,098045,Holst; Michael J,13,0,15,2
1668450695253,MATH 273A,A00,098046,Tian; Xiaochuan,10,0,15,5
1668450695677,MATH 275,A01,098048,Tian; Xiaochuan,6,0,10,4
1668450696102,MATH 278A,A00,098049,Holst; Michael J,8,0,10,2
1668450696526,MATH 278B,A00,098050,Cloninger; Alexander,10,0,10,0
1668450696951,MATH 278C,A00,098051,Nie; Jiawang,6,0,10,4
1668450697380,MATH 280B,A00,098052,Zheng; Tianyi,7,0,15,8
1668450697803,MATH 281B,A00,098053,Bradic; Jelena,0,2,15,15
1668450698230,MATH 282B,A00,098054,Arias-Castro; Ery,0,0,15,15
1668450698659,MATH 285,A00,098055,Fitzsimmons; Patrick J,0,1,15,17
1668450699081,MATH 287B,A00,098056,Arias-Castro; Ery,2,0,15,13
1668450699512,MATH 288,A00,098057,Agarwal; Pooja,9,0,10,1
1668450699512,MATH 288,B00,098058,Zhang; Danna,8,0,10,2
1668450699512,MATH 288,C00,098059,Williams; Ruth J,9,0,10,1
1668450699939,MATH 290B,A00,098060,Roberts; Justin Deritter,13,0,15,2
1668450700373,MATH 292,A00,098061,Belmont; Eva Kinoshita,10,0,10,0
1668450700796,MATH 295,A00,098062,Suk; Andrew Hoon,48,0,50,2
1668450701221,MATH 296,A00,098063,Novak; Jonathan I,20,0,20,0
1668450701657,MATH 297,001,098064,Gamst; Anthony Collins,9997,0,9999,2
1668451215958,COGS 205,A00,101395,Chiba; Andrea,19,0,20,1
1668451216383,COGS 210B,001,101404,Greene; Deanna Jacquelyn,9998,0,9999,1
1668451216383,COGS 210B,002,101417,Xia; Haijun,9999,0,9999,0
1668451216383,COGS 210B,003,101422,Nitz; Douglas A.,9999,0,9999,0
1668451216383,COGS 210B,004,101423,Hollan; James D.,9998,0,9999,1
1668451216383,COGS 210B,005,101424,Deak; Gedeon O.,9998,0,9999,1
1668451216383,COGS 210B,006,101425,Rossano; Federico,9999,0,9999,0
1668451216806,COGS 211B,A00,101427,Coulson; Seana M,9996,0,9999,3
1668451217234,COGS 220,A00,101428,Hollan; James D.,1,4,25,24
1668451217659,COGS 229,A00,101429,Dow; Steven P,18,0,25,7
1668451218086,COGS 230,A00,101430,Klemmer; Scott R,9,0,17,8
1668451218520,COGS 234,A00,101431,Xia; Haijun,2,0,25,23
1668451218943,COGS 260,A00,101432,Kiyonaga; Anastasia,21,0,25,4
1668451218943,COGS 260,B00,101433,Kirsh; David Joel,15,0,25,10
1668451219379,CSE 202,A00,102371,Impagliazzo; Russell,0,42,0,0
1668451219803,CSE 203B,A01,102373,Cheng; Chung Kuan,0,33,0,0
1668451220228,CSE 208,A00,102374,Micciancio; Daniele,0,2,0,0
1668451220662,CSE 209A,A00,112895,Impagliazzo; Russell,0,7,15,15
1668451221086,CSE 209B,A00,108005,Bellare; Mihir,0,3,0,0
1668451221510,CSE 210,A00,113163,Coblenz; Michael J,0,56,0,0
1668451221944,CSE 219,A00,106111,Dow; Steven P,0,2,20,20
1668451222367,CSE 221,A00,102376,Voelker; Geoffrey M.,0,42,0,0
1668451222793,CSE 224,A01,102378,Porter; George M,0,118,0,0
1668451223217,CSE 229A,A00,102379,Savage; Stefan,0,5,0,0
1668451223643,CSE 229C,A00,102380,Munyaka; Imani N. S.,0,5,0,0
1668451224070,CSE 232B,A00,102382,Deutsch; Alin Bernard,0,19,0,0
1668451224519,CSE 234,A01,112904,Kumar; Arun Kumar,0,0,0,0
1668451224953,CSE 237A,A00,102383,Rosing; Tajana Simunic,0,36,0,0
1668451225382,CSE 239A,A00,102384,Deutsch; Alin Bernard,0,6,0,0
1668451225807,CSE 239B,A00,102385,Polikarpova; Nadezhda,0,4,0,0
1668451226231,CSE 240A,A00,102386,Pannuto; Patrick William,0,35,0,0
1668451226655,CSE 240B,A00,102387,Zhao; Jishen,0,33,0,0
1668451227085,CSE 241A,A00,106406,Kang; Mingu,0,6,0,0
1668451227515,CSE 249B,A00,102388,Kahng; Andrew Byun,0,2,8,8
1668451227946,CSE 251B,A01,102392,Cottrell; Garrison W,0,30,0,0
1668451227946,CSE 251B,A02,102393,Cottrell; Garrison W,0,27,0,0
1668451228369,CSE 252B,A00,102394,Ochoa; Benjamin Lawrence,0,42,0,0
1668451228792,CSE 257,A01,102396,Gao; Sicun,0,99,0,0
1668451229220,CSE 272,A00,102397,Li; Tzumao,0,9,0,0
1668451229644,CSE 274,A00,111323,Chern; Albert Ren-Haur,0,8,0,0
1668451230071,CSE 282,A00,102398,Pevzner; Pavel Arkadjevich,0,0,0,0
1668451230495,CSE 284,A00,114175,Gymrek; Melissa Ann,0,14,0,0
1668451230934,CSE 290,A00,102399,Chandraker; Manmohan Krishna,0,6,0,0
1668451230934,CSE 290,B00,102400,Vaccaro; Kristen Marie,0,2,25,25
1668451230934,CSE 290,C00,102414,Pannuto; Patrick William,0,1,25,25
1668451230934,CSE 290,D00,102427,Pevzner; Pavel Arkadjevich,0,0,0,0
1668451230934,CSE 290,E00,102429,Zhao; Jishen,0,2,0,0
1668451230934,CSE 290,F00,102436,Tullsen; Dean Michael,0,4,0,0
1668451230934,CSE 290,G00,102440,Christensen; Henrik I,0,3,20,20
1668451231358,CSE 291,A00,102443,Su; Hao,0,0,0,0
1668451231358,CSE 291,B00,102448,Polikarpova; Nadezhda,0,0,0,0
1668451231358,CSE 291,C00,102453,Vaccaro; Kristen Marie,0,0,0,0
1668451231358,CSE 291,D00,111343,Savage; Stefan,0,0,0,0
1668451231358,CSE 291,E00,116474,Claffy; Kimberly Claire,0,0,0,0
1668451231358,CSE 291,F00,116479,Pasquale; Joseph,0,0,0,0
1668451231814,CSE 293,001,119111,Bafna; Vineet,9999,0,9999,0
1668451231814,CSE 293,002,119118,Bellare; Mihir,9999,0,9999,0
1668451231814,CSE 293,003,119122,Berg-Kirkpatrick; Taylor D,9999,0,9999,0
1668451231814,CSE 293,004,119135,Christensen; Henrik I,9999,0,9999,0
1668451231814,CSE 293,005,119142,Cottrell; Garrison W,9999,0,9999,0
1668451231814,CSE 293,006,119146,Deutsch; Alin Bernard,9999,0,9999,0
1668451231814,CSE 293,007,119159,Esmaeilzadeh; Hadi,9999,0,9999,0
1668451231814,CSE 293,008,119166,Freund; Yoav,9999,0,9999,0
1668451231814,CSE 293,009,119170,Griswold; William G.,9999,0,9999,0
1668451231814,CSE 293,010,119183,Gymrek; Melissa Ann,9999,0,9999,0
1668451231814,CSE 293,011,119190,Heninger; Nadia A,9999,0,9999,0
1668451231814,CSE 293,012,119230,Impagliazzo; Russell,9999,0,9999,0
1668451231814,CSE 293,013,119232,Jhala; Ranjit,9999,0,9999,0
1668451231814,CSE 293,014,119233,Kahng; Andrew Byun,9999,0,9999,0
1668451231814,CSE 293,015,119298,Kane; Daniel Mertz,9999,0,9999,0
1668451231814,CSE 293,016,119299,Kriegman; David J,9999,0,9999,0
1668451231814,CSE 293,017,119300,Kumar; Arun Kumar,9999,0,9999,0
1668451231814,CSE 293,018,119301,Lerner; Sorin,9999,0,9999,0
1668451231814,CSE 293,019,119302,Lovett; Shachar,9999,0,9999,0
1668451231814,CSE 293,020,119303,McAuley; Julian John,9999,0,9999,0
1668451231814,CSE 293,021,119304,Micciancio; Daniele,9999,0,9999,0
1668451231814,CSE 293,022,119367,Orailoglu; Alex,9999,0,9999,0
1668451231814,CSE 293,023,119382,Paturi; Ramamohan,9999,0,9999,0
1668451231814,CSE 293,024,119404,Polikarpova; Nadezhda,9999,0,9999,0
1668451231814,CSE 293,025,119406,Politz; Joseph Gibbs,9999,0,9999,0
1668451231814,CSE 293,026,119411,Porter; George M,9999,0,9999,0
1668451231814,CSE 293,027,119414,Porter; Leonard Emerson,9999,0,9999,0
1668451231814,CSE 293,028,119416,Ramamoorthi; Ravi,9999,0,9999,0
1668451231814,CSE 293,029,119417,Sahoo; Debashis,9999,0,9999,0
1668451231814,CSE 293,030,119420,Saul; Lawrence,9999,0,9999,0
1668451231814,CSE 293,031,119421,Savage; Stefan,9999,0,9999,0
1668451231814,CSE 293,032,119425,Schulze; Jurgen P.,9999,0,9999,0
1668451231814,CSE 293,033,119426,Snoeren; Alex C.,9999,0,9999,0
1668451231814,CSE 293,034,119428,Shang; Jingbo,9999,0,9999,0
1668451231814,CSE 293,035,119430,Stefan; Deian,9999,0,9999,0
1668451231814,CSE 293,036,119431,Su; Hao,9999,0,9999,0
1668451231814,CSE 293,037,119433,Swanson; Steven James,9999,0,9999,0
1668451231814,CSE 293,038,119435,Tullsen; Dean Michael,9999,0,9999,0
1668451231814,CSE 293,039,119483,Voelker; Geoffrey M.,9999,0,9999,0
1668451231814,CSE 293,040,119537,Zhao; Jishen,9999,0,9999,0
1668451231814,CSE 293,041,119538,Zhou; Yuan-Yuan,9999,0,9999,0
1668451231814,CSE 293,042,119539,Gao; Sicun,9999,0,9999,0
1668451231814,CSE 293,043,119540,Weibel; Nadir,9999,0,9999,0
1668451231814,CSE 293,044,119541,Gupta; Rajesh K.,9999,0,9999,0
1668451231814,CSE 293,045,126410,Vaccaro; Kristen Marie,9999,0,9999,0
1668451231814,CSE 293,046,126411,Klemke; Richard,9999,0,9999,0
1668451232239,CSE 294,A00,102459,Voelker; Geoffrey M.,0,2,0,0
1668451232239,CSE 294,B00,111322,Orailoglu; Alex,0,0,0,0
1668451238865,DSE 201,A00,096914,Deutsch; Alin Bernard,30,0,30,0
1668451239292,DSE 210,A00,096915,Dasgupta; Sanjoy,30,0,30,0
1668451239717,DSE 260A,A00,096916,Altintas De Callaf; Ilkay,30,0,30,0
1668451240193,ECE 200,001,103586,Antipa; Nicholas A,9999,0,9999,0
1668451240193,ECE 200,002,103587,Atanasov; Nikolay A.,9999,0,9999,0
1668451240193,ECE 200,003,103588,Bharadia; Dinesh,9999,0,9999,0
1668451240193,ECE 200,004,103589,Cheng; Chung Kuan,9999,0,9999,0
1668451240193,ECE 200,005,103590,Cosman; Pamela C.,9999,0,9999,0
1668451240193,ECE 200,006,103591,Dayeh; Shadi Ahmad,9999,0,9999,0
1668451240193,ECE 200,007,103592,Fainman; Yeshaiahu,9999,0,9999,0
1668451240193,ECE 200,008,103593,Ford; Joseph Earl,9999,0,9999,0
1668451240193,ECE 200,009,103594,Franceschetti; Massimo,9999,0,9999,0
1668451240193,ECE 200,010,103595,Fullerton; Eric E,9999,0,9999,0
1668451240193,ECE 200,011,103596,Galton; Ian A,9999,0,9999,0
1668451240193,ECE 200,012,103597,Gilja; Vikash,9999,0,9999,0
1668451240193,ECE 200,013,103598,Hall; Drew A.,9999,0,9999,0
1668451240193,ECE 200,014,103599,Hsueh; Tzu-Chien,9999,0,9999,0
1668451240193,ECE 200,015,103600,Javidi; Tara,9999,0,9999,0
1668451240193,ECE 200,016,103601,Kahng; Andrew Byun,9999,0,9999,0
1668451240193,ECE 200,017,103602,Kim; Young-Han,9999,0,9999,0
1668451240193,ECE 200,018,103603,Koushanfar; Farinaz,9999,0,9999,0
1668451240193,ECE 200,019,103604,Kuzum; Duygu,9999,0,9999,0
1668451240193,ECE 200,020,103605,Le; Hanh-Phuc,9999,0,9999,0
1668451240193,ECE 200,021,103606,Lin; Bill,9999,0,9999,0
1668451240193,ECE 200,022,103607,Liu; Zhaowei,9998,0,9999,1
1668451240193,ECE 200,023,103608,Lo; Yu-Hwa,9999,0,9999,0
1668451240193,ECE 200,024,103609,Lomakin; Vitaliy,9999,0,9999,0
1668451240193,ECE 200,025,103610,Mercier; Patrick Philip,9999,0,9999,0
1668451240193,ECE 200,026,103611,Meyer; Florian,9999,0,9999,0
1668451240193,ECE 200,027,103612,Milstein; Laurence B.,9999,0,9999,0
1668451240193,ECE 200,028,103613,Mir Arabbaygi; Siavash,9999,0,9999,0
1668451240193,ECE 200,029,103614,Mookherjea; Shayan,9999,0,9999,0
1668451240193,ECE 200,030,103615,Morris; Karcher William,9999,0,9999,0
1668451240193,ECE 200,031,103616,Ng; Tse Nga,9999,0,9999,0
1668451240193,ECE 200,032,103617,Nguyen; Truong Quang,9999,0,9999,0
1668451240193,ECE 200,033,103618,Nomura; Kenji,9999,0,9999,0
1668451240193,ECE 200,034,103619,Orlitsky; Alon,9999,0,9999,0
1668451240193,ECE 200,035,103620,Pal; Piya,9999,0,9999,0
1668451240193,ECE 200,036,103621,Papen; George C.,9999,0,9999,0
1668451240193,ECE 200,037,103622,Radic; Stojan,9999,0,9999,0
1668451240193,ECE 200,038,103623,Rao; Bhaskar D.,9999,0,9999,0
1668451240193,ECE 200,039,103624,Rao; Ramesh R,9999,0,9999,0
1668451240193,ECE 200,040,103625,Rebeiz; Gabriel,9999,0,9999,0
1668451240193,ECE 200,041,103626,Sanford; John R,9999,0,9999,0
1668451240193,ECE 200,042,103627,Siegel; Paul H.,9999,0,9999,0
1668451240193,ECE 200,043,103628,Sievenpiper; Daniel F.,9999,0,9999,0
1668451240193,ECE 200,044,103629,Sworder; David D.,9999,0,9999,0
1668451240193,ECE 200,045,103630,Taur; Yuan,9999,0,9999,0
1668451240193,ECE 200,046,103631,Touri; Behrouz,9999,0,9999,0
1668451240193,ECE 200,047,103632,Trivedi; Mohan M.,9999,0,9999,0
1668451240193,ECE 200,048,103633,Vasconcelos; Nuno,9999,0,9999,0
1668451240193,ECE 200,049,103634,Wang; Xiaolong,9999,0,9999,0
1668451240193,ECE 200,050,103635,Xie; Pengtao,9999,0,9999,0
1668451240193,ECE 200,051,103636,Yip; Michael,9999,0,9999,0
1668451240193,ECE 200,052,103637,Zeger; Kenneth A.,999,0,999,0
1668451240193,ECE 200,053,103638,Zhang; Xinyu,9999,0,9999,0
1668451240193,ECE 200,054,103639,Turakhia; Yatish Girish,9999,0,9999,0
1668451240193,ECE 200,055,103640,Kang; Mingu,9999,0,9999,0
1668451240193,ECE 200,056,103641,Shi; Yuanyuan,9999,0,9999,0
1668451240193,ECE 200,057,103642,Wang; Edward Jay,9999,0,9999,0
1668451240193,ECE 200,058,103643,Zheng; Yang,9999,0,9999,0
1668451240617,ECE 202,A00,103644,Kuzum; Duygu,0,31,0,0
1668451241042,ECE 212BN,A00,103646,Ng; Tse Nga,0,2,0,0
1668451241473,ECE 221,A00,111493,Staff,0,0,0,0
1668451241900,ECE 222B,A00,103647,Lomakin; Vitaliy,0,7,0,0
1668451242333,ECE 230B,A00,103648,Taur; Yuan,0,1,0,0
1668451242756,ECE 238B,A00,103649,Garay; Javier,0,0,0,0
1668451243189,ECE 240B,A00,112900,Fainman; Yeshaiahu,0,4,0,0
1668451243619,ECE 247A,A00,103650,Jokerst; Jesse Vincent,0,2,0,0
1668451244046,ECE 247B,A00,103651,Wang; Joseph,0,8,0,0
1668451244484,ECE 250,A00,103652,Siegel; Paul H.,0,55,0,0
1668451244913,ECE 251A,A00,103654,Rao; Bhaskar D.,0,39,0,0
1668451245337,ECE 257B,A00,103655,Bharadia; Dinesh,0,22,0,0
1668451245772,ECE 258A,A00,103656,Milstein; Laurence B.,0,21,0,0
1668451246292,ECE 260B,A00,103658,Kang; Mingu,0,92,0,0
1668451246722,ECE 264A,A00,103659,Galton; Ian A,0,52,0,0
1668451247151,ECE 265A,A00,103661,Gudem; Prasad S.S.,0,30,0,0
1668451247573,ECE 265D,A00,103662,Gudem; Prasad S.S.,0,18,0,0
1668451248004,ECE 268,A00,103663,Koushanfar; Farinaz,0,32,0,0
1668451248439,ECE 269,A01,103665,Pal; Piya,0,160,0,0
1668451248868,ECE 271B,A00,103666,Vasconcelos; Manuela,0,54,0,0
1668451249308,ECE 276A,A00,103667,Atanasov; Nikolay A.,0,85,0,0
1668451249734,ECE 277,A00,103668,An; Cheolhong,0,112,0,0
1668451250157,ECE 279,A00,117947,Hall; Drew A.,0,16,0,0
1668451251013,ECE 283,A00,103670,Hsueh; Tzu-Chien,0,36,0,0
1668451251443,ECE 284,A00,103671,Turakhia; Yatish Girish,0,32,0,0
1668451251866,ECE 285,A00,103672,Zheng; Yang,0,28,0,0
1668451251866,ECE 285,B00,103673,Sworder; David D.,0,43,0,0
1668451252297,ECE 287,A00,103676,Javidi; Tara,0,5,0,0
1668451252723,MATH 200B,A00,098023,Salehi Golsefidy; Alireza,12,0,15,3
1668451253154,MATH 202B,A00,098024,Rhoades; Brendon Patrick,9,0,15,6
1668451253589,MATH 203B,A00,098025,Oprea; Dragos N.,10,0,15,5
1668451254012,MATH 204B,A00,098026,Sorensen; Claus M,13,0,15,2
1668451254438,MATH 208,A00,098027,Izadi; Elham,7,0,10,3
1668451254864,MATH 209,A00,098028,Pollack; Aaron,10,0,10,0
1668451255297,MATH 211A,A00,112919,Rogalski; Daniel,9,0,10,1
1668451255724,MATH 211B,A00,112920,Seward; Brandon M.,9,0,10,1
1668451256155,MATH 218,A00,098029,Li; Bo,10,0,10,0
1668451256581,MATH 220B,A00,098030,Novak; Jonathan I,11,0,15,4
1668451257009,MATH 221A,A00,098031,Ebenfelt; Peter F,13,0,15,2
1668451257436,MATH 231B,A00,098032,Zlatos; Andrej,11,0,15,4
1668451257862,MATH 240B,A00,098033,Ni; Lei,9,0,15,6
1668451258285,MATH 243,A00,098034,Jekel; David Andrew,10,0,10,0
1668451258718,MATH 245A,A00,098035,Nie; Jiawang,0,2,15,16
1668451259146,MATH 248,A00,098036,Bejenaru; Ioan,10,0,10,0
1668451259570,MATH 250B,A00,098037,Spolaor; Luca,14,0,15,1
1668451259994,MATH 258,A00,098038,Ni; Lei,10,0,10,0
1668451260427,MATH 264B,A00,098041,Rhoades; Brendon Patrick,9,0,15,6
1668451260850,MATH 268,A00,098042,Buss; Samuel R,10,0,10,0
1668451261273,MATH 269,A00,098043,Rhoades; Brendon Patrick,10,0,10,0
1668451261703,MATH 270B,A00,098044,Li; Bo,10,0,15,5
1668451262128,MATH 272B,A00,098045,Holst; Michael J,13,0,15,2
1668451262570,MATH 273A,A00,098046,Tian; Xiaochuan,10,0,15,5
1668451262997,MATH 275,A01,098048,Tian; Xiaochuan,6,0,10,4
1668451263422,MATH 278A,A00,098049,Holst; Michael J,8,0,10,2
1668451263846,MATH 278B,A00,098050,Cloninger; Alexander,10,0,10,0
1668451264279,MATH 278C,A00,098051,Nie; Jiawang,6,0,10,4
1668451264711,MATH 280B,A00,098052,Zheng; Tianyi,7,0,15,8
1668451265141,MATH 281B,A00,098053,Bradic; Jelena,0,2,15,15
1668451265575,MATH 282B,A00,098054,Arias-Castro; Ery,0,0,15,15
1668451266005,MATH 285,A00,098055,Fitzsimmons; Patrick J,0,1,15,17
1668451266434,MATH 287B,A00,098056,Arias-Castro; Ery,2,0,15,13
1668451266858,MATH 288,A00,098057,Agarwal; Pooja,9,0,10,1
1668451266858,MATH 288,B00,098058,Zhang; Danna,8,0,10,2
1668451266858,MATH 288,C00,098059,Williams; Ruth J,9,0,10,1
1668451267280,MATH 290B,A00,098060,Roberts; Justin Deritter,13,0,15,2
1668451267706,MATH 292,A00,098061,Belmont; Eva Kinoshita,10,0,10,0
1668451268144,MATH 295,A00,098062,Suk; Andrew Hoon,48,0,50,2
1668451268575,MATH 296,A00,098063,Novak; Jonathan I,20,0,20,0
1668451269005,MATH 297,001,098064,Gamst; Anthony Collins,9997,0,9999,2
1668451772609,COGS 205,A00,101395,Chiba; Andrea,19,0,20,1
1668451773040,COGS 210B,001,101404,Greene; Deanna Jacquelyn,9998,0,9999,1
1668451773040,COGS 210B,002,101417,Xia; Haijun,9999,0,9999,0
1668451773040,COGS 210B,003,101422,Nitz; Douglas A.,9999,0,9999,0
1668451773040,COGS 210B,004,101423,Hollan; James D.,9998,0,9999,1
1668451773040,COGS 210B,005,101424,Deak; Gedeon O.,9998,0,9999,1
1668451773040,COGS 210B,006,101425,Rossano; Federico,9999,0,9999,0
1668451773471,COGS 211B,A00,101427,Coulson; Seana M,9996,0,9999,3
1668451773901,COGS 220,A00,101428,Hollan; James D.,1,4,25,24
1668451774323,COGS 229,A00,101429,Dow; Steven P,18,0,25,7
1668451774754,COGS 230,A00,101430,Klemmer; Scott R,9,0,17,8
1668451775204,COGS 234,A00,101431,Xia; Haijun,2,0,25,23
1668451775628,COGS 260,A00,101432,Kiyonaga; Anastasia,21,0,25,4
1668451775628,COGS 260,B00,101433,Kirsh; David Joel,15,0,25,10
1668451776051,CSE 202,A00,102371,Impagliazzo; Russell,0,44,0,0
1668451776475,CSE 203B,A01,102373,Cheng; Chung Kuan,0,34,0,0
1668451776906,CSE 208,A00,102374,Micciancio; Daniele,0,2,0,0
1668451777333,CSE 209A,A00,112895,Impagliazzo; Russell,0,7,15,15
1668451777766,CSE 209B,A00,108005,Bellare; Mihir,0,3,0,0
1668451778191,CSE 210,A00,113163,Coblenz; Michael J,0,56,0,0
1668451778618,CSE 219,A00,106111,Dow; Steven P,0,2,20,20
1668451779052,CSE 221,A00,102376,Voelker; Geoffrey M.,0,42,0,0
1668451779482,CSE 224,A01,102378,Porter; George M,0,122,0,0
1668451779909,CSE 229A,A00,102379,Savage; Stefan,0,5,0,0
1668451780347,CSE 229C,A00,102380,Munyaka; Imani N. S.,0,5,0,0
1668451780773,CSE 232B,A00,102382,Deutsch; Alin Bernard,0,19,0,0
1668451781202,CSE 234,A01,112904,Kumar; Arun Kumar,0,0,0,0
1668451781627,CSE 237A,A00,102383,Rosing; Tajana Simunic,0,39,0,0
1668451782052,CSE 239A,A00,102384,Deutsch; Alin Bernard,0,7,0,0
1668451782485,CSE 239B,A00,102385,Polikarpova; Nadezhda,0,5,0,0
1668451782910,CSE 240A,A00,102386,Pannuto; Patrick William,0,35,0,0
1668451783334,CSE 240B,A00,102387,Zhao; Jishen,0,34,0,0
1668451783762,CSE 241A,A00,106406,Kang; Mingu,0,5,0,0
1668451784193,CSE 249B,A00,102388,Kahng; Andrew Byun,0,2,8,8
1668451784627,CSE 251B,A01,102392,Cottrell; Garrison W,0,30,0,0
1668451784627,CSE 251B,A02,102393,Cottrell; Garrison W,0,27,0,0
1668451785054,CSE 252B,A00,102394,Ochoa; Benjamin Lawrence,0,42,0,0
1668451785483,CSE 257,A01,102396,Gao; Sicun,0,100,0,0
1668451785906,CSE 272,A00,102397,Li; Tzumao,0,9,0,0
1668451786336,CSE 274,A00,111323,Chern; Albert Ren-Haur,0,8,0,0
1668451786762,CSE 282,A00,102398,Pevzner; Pavel Arkadjevich,0,0,0,0
1668451787184,CSE 284,A00,114175,Gymrek; Melissa Ann,0,14,0,0
1668451787613,CSE 290,A00,102399,Chandraker; Manmohan Krishna,0,6,0,0
1668451787613,CSE 290,B00,102400,Vaccaro; Kristen Marie,0,2,25,25
1668451787613,CSE 290,C00,102414,Pannuto; Patrick William,0,1,25,25
1668451787613,CSE 290,D00,102427,Pevzner; Pavel Arkadjevich,0,0,0,0
1668451787613,CSE 290,E00,102429,Zhao; Jishen,0,2,0,0
1668451787613,CSE 290,F00,102436,Tullsen; Dean Michael,0,4,0,0
1668451787613,CSE 290,G00,102440,Christensen; Henrik I,0,3,20,20
1668451788047,CSE 291,A00,102443,Su; Hao,0,0,0,0
1668451788047,CSE 291,B00,102448,Polikarpova; Nadezhda,0,0,0,0
1668451788047,CSE 291,C00,102453,Vaccaro; Kristen Marie,0,0,0,0
1668451788047,CSE 291,D00,111343,Savage; Stefan,0,0,0,0
1668451788047,CSE 291,E00,116474,Claffy; Kimberly Claire,0,0,0,0
1668451788047,CSE 291,F00,116479,Pasquale; Joseph,0,0,0,0
1668451788479,CSE 293,001,119111,Bafna; Vineet,9999,0,9999,0
1668451788479,CSE 293,002,119118,Bellare; Mihir,9999,0,9999,0
1668451788479,CSE 293,003,119122,Berg-Kirkpatrick; Taylor D,9999,0,9999,0
1668451788479,CSE 293,004,119135,Christensen; Henrik I,9999,0,9999,0
1668451788479,CSE 293,005,119142,Cottrell; Garrison W,9999,0,9999,0
1668451788479,CSE 293,006,119146,Deutsch; Alin Bernard,9999,0,9999,0
1668451788479,CSE 293,007,119159,Esmaeilzadeh; Hadi,9999,0,9999,0
1668451788479,CSE 293,008,119166,Freund; Yoav,9999,0,9999,0
1668451788479,CSE 293,009,119170,Griswold; William G.,9999,0,9999,0
1668451788479,CSE 293,010,119183,Gymrek; Melissa Ann,9999,0,9999,0
1668451788479,CSE 293,011,119190,Heninger; Nadia A,9999,0,9999,0
1668451788479,CSE 293,012,119230,Impagliazzo; Russell,9999,0,9999,0
1668451788479,CSE 293,013,119232,Jhala; Ranjit,9999,0,9999,0
1668451788479,CSE 293,014,119233,Kahng; Andrew Byun,9999,0,9999,0
1668451788479,CSE 293,015,119298,Kane; Daniel Mertz,9999,0,9999,0
1668451788479,CSE 293,016,119299,Kriegman; David J,9999,0,9999,0
1668451788479,CSE 293,017,119300,Kumar; Arun Kumar,9999,0,9999,0
1668451788479,CSE 293,018,119301,Lerner; Sorin,9999,0,9999,0
1668451788479,CSE 293,019,119302,Lovett; Shachar,9999,0,9999,0
1668451788479,CSE 293,020,119303,McAuley; Julian John,9999,0,9999,0
1668451788479,CSE 293,021,119304,Micciancio; Daniele,9999,0,9999,0
1668451788479,CSE 293,022,119367,Orailoglu; Alex,9999,0,9999,0
1668451788479,CSE 293,023,119382,Paturi; Ramamohan,9999,0,9999,0
1668451788479,CSE 293,024,119404,Polikarpova; Nadezhda,9999,0,9999,0
1668451788479,CSE 293,025,119406,Politz; Joseph Gibbs,9999,0,9999,0
1668451788479,CSE 293,026,119411,Porter; George M,9999,0,9999,0
1668451788479,CSE 293,027,119414,Porter; Leonard Emerson,9999,0,9999,0
1668451788479,CSE 293,028,119416,Ramamoorthi; Ravi,9999,0,9999,0
1668451788479,CSE 293,029,119417,Sahoo; Debashis,9999,0,9999,0
1668451788479,CSE 293,030,119420,Saul; Lawrence,9999,0,9999,0
1668451788479,CSE 293,031,119421,Savage; Stefan,9999,0,9999,0
1668451788479,CSE 293,032,119425,Schulze; Jurgen P.,9999,0,9999,0
1668451788479,CSE 293,033,119426,Snoeren; Alex C.,9999,0,9999,0
1668451788479,CSE 293,034,119428,Shang; Jingbo,9999,0,9999,0
1668451788479,CSE 293,035,119430,Stefan; Deian,9999,0,9999,0
1668451788479,CSE 293,036,119431,Su; Hao,9999,0,9999,0
1668451788479,CSE 293,037,119433,Swanson; Steven James,9999,0,9999,0
1668451788479,CSE 293,038,119435,Tullsen; Dean Michael,9999,0,9999,0
1668451788479,CSE 293,039,119483,Voelker; Geoffrey M.,9999,0,9999,0
1668451788479,CSE 293,040,119537,Zhao; Jishen,9999,0,9999,0
1668451788479,CSE 293,041,119538,Zhou; Yuan-Yuan,9999,0,9999,0
1668451788479,CSE 293,042,119539,Gao; Sicun,9999,0,9999,0
1668451788479,CSE 293,043,119540,Weibel; Nadir,9999,0,9999,0
1668451788479,CSE 293,044,119541,Gupta; Rajesh K.,9999,0,9999,0
1668451788479,CSE 293,045,126410,Vaccaro; Kristen Marie,9999,0,9999,0
1668451788479,CSE 293,046,126411,Klemke; Richard,9999,0,9999,0
1668451788903,CSE 294,A00,102459,Voelker; Geoffrey M.,0,2,0,0
1668451788903,CSE 294,B00,111322,Orailoglu; Alex,0,0,0,0
1668451789346,DSE 201,A00,096914,Deutsch; Alin Bernard,30,0,30,0
1668451789773,DSE 210,A00,096915,Dasgupta; Sanjoy,30,0,30,0
1668451790204,DSE 260A,A00,096916,Altintas De Callaf; Ilkay,30,0,30,0
1668451790640,ECE 200,001,103586,Antipa; Nicholas A,9999,0,9999,0
1668451790640,ECE 200,002,103587,Atanasov; Nikolay A.,9999,0,9999,0
1668451790640,ECE 200,003,103588,Bharadia; Dinesh,9999,0,9999,0
1668451790640,ECE 200,004,103589,Cheng; Chung Kuan,9999,0,9999,0
1668451790640,ECE 200,005,103590,Cosman; Pamela C.,9999,0,9999,0
1668451790640,ECE 200,006,103591,Dayeh; Shadi Ahmad,9999,0,9999,0
1668451790640,ECE 200,007,103592,Fainman; Yeshaiahu,9999,0,9999,0
1668451790640,ECE 200,008,103593,Ford; Joseph Earl,9999,0,9999,0
1668451790640,ECE 200,009,103594,Franceschetti; Massimo,9999,0,9999,0
1668451790640,ECE 200,010,103595,Fullerton; Eric E,9999,0,9999,0
1668451790640,ECE 200,011,103596,Galton; Ian A,9999,0,9999,0
1668451790640,ECE 200,012,103597,Gilja; Vikash,9999,0,9999,0
1668451790640,ECE 200,013,103598,Hall; Drew A.,9999,0,9999,0
1668451790640,ECE 200,014,103599,Hsueh; Tzu-Chien,9999,0,9999,0
1668451790640,ECE 200,015,103600,Javidi; Tara,9999,0,9999,0
1668451790640,ECE 200,016,103601,Kahng; Andrew Byun,9999,0,9999,0
1668451790640,ECE 200,017,103602,Kim; Young-Han,9999,0,9999,0
1668451790640,ECE 200,018,103603,Koushanfar; Farinaz,9999,0,9999,0
1668451790640,ECE 200,019,103604,Kuzum; Duygu,9999,0,9999,0
1668451790640,ECE 200,020,103605,Le; Hanh-Phuc,9999,0,9999,0
1668451790640,ECE 200,021,103606,Lin; Bill,9999,0,9999,0
1668451790640,ECE 200,022,103607,Liu; Zhaowei,9998,0,9999,1
1668451790640,ECE 200,023,103608,Lo; Yu-Hwa,9999,0,9999,0
1668451790640,ECE 200,024,103609,Lomakin; Vitaliy,9999,0,9999,0
1668451790640,ECE 200,025,103610,Mercier; Patrick Philip,9999,0,9999,0
1668451790640,ECE 200,026,103611,Meyer; Florian,9999,0,9999,0
1668451790640,ECE 200,027,103612,Milstein; Laurence B.,9999,0,9999,0
1668451790640,ECE 200,028,103613,Mir Arabbaygi; Siavash,9999,0,9999,0
1668451790640,ECE 200,029,103614,Mookherjea; Shayan,9999,0,9999,0
1668451790640,ECE 200,030,103615,Morris; Karcher William,9999,0,9999,0
1668451790640,ECE 200,031,103616,Ng; Tse Nga,9999,0,9999,0
1668451790640,ECE 200,032,103617,Nguyen; Truong Quang,9999,0,9999,0
1668451790640,ECE 200,033,103618,Nomura; Kenji,9999,0,9999,0
1668451790640,ECE 200,034,103619,Orlitsky; Alon,9999,0,9999,0
1668451790640,ECE 200,035,103620,Pal; Piya,9999,0,9999,0
1668451790640,ECE 200,036,103621,Papen; George C.,9999,0,9999,0
1668451790640,ECE 200,037,103622,Radic; Stojan,9999,0,9999,0
1668451790640,ECE 200,038,103623,Rao; Bhaskar D.,9999,0,9999,0
1668451790640,ECE 200,039,103624,Rao; Ramesh R,9999,0,9999,0
1668451790640,ECE 200,040,103625,Rebeiz; Gabriel,9999,0,9999,0
1668451790640,ECE 200,041,103626,Sanford; John R,9999,0,9999,0
1668451790640,ECE 200,042,103627,Siegel; Paul H.,9999,0,9999,0
1668451790640,ECE 200,043,103628,Sievenpiper; Daniel F.,9999,0,9999,0
1668451790640,ECE 200,044,103629,Sworder; David D.,9999,0,9999,0
1668451790640,ECE 200,045,103630,Taur; Yuan,9999,0,9999,0
1668451790640,ECE 200,046,103631,Touri; Behrouz,9999,0,9999,0
1668451790640,ECE 200,047,103632,Trivedi; Mohan M.,9999,0,9999,0
1668451790640,ECE 200,048,103633,Vasconcelos; Nuno,9999,0,9999,0
1668451790640,ECE 200,049,103634,Wang; Xiaolong,9999,0,9999,0
1668451790640,ECE 200,050,103635,Xie; Pengtao,9999,0,9999,0
1668451790640,ECE 200,051,103636,Yip; Michael,9999,0,9999,0
1668451790640,ECE 200,052,103637,Zeger; Kenneth A.,999,0,999,0
1668451790640,ECE 200,053,103638,Zhang; Xinyu,9999,0,9999,0
1668451790640,ECE 200,054,103639,Turakhia; Yatish Girish,9999,0,9999,0
1668451790640,ECE 200,055,103640,Kang; Mingu,9999,0,9999,0
1668451790640,ECE 200,056,103641,Shi; Yuanyuan,9999,0,9999,0
1668451790640,ECE 200,057,103642,Wang; Edward Jay,9999,0,9999,0
1668451790640,ECE 200,058,103643,Zheng; Yang,9999,0,9999,0
1668451791071,ECE 202,A00,103644,Kuzum; Duygu,0,31,0,0
1668451791502,ECE 212BN,A00,103646,Ng; Tse Nga,0,2,0,0
1668451791938,ECE 221,A00,111493,Staff,0,0,0,0
1668451792362,ECE 222B,A00,103647,Lomakin; Vitaliy,0,7,0,0
1668451792790,ECE 230B,A00,103648,Taur; Yuan,0,1,0,0
1668451793218,ECE 238B,A00,103649,Garay; Javier,0,0,0,0
1668451793643,ECE 240B,A00,112900,Fainman; Yeshaiahu,0,4,0,0
1668451794066,ECE 247A,A00,103650,Jokerst; Jesse Vincent,0,2,0,0
1668451794490,ECE 247B,A00,103651,Wang; Joseph,0,8,0,0
1668451794923,ECE 250,A00,103652,Siegel; Paul H.,0,55,0,0
1668451795349,ECE 251A,A00,103654,Rao; Bhaskar D.,0,40,0,0
1668451795772,ECE 257B,A00,103655,Bharadia; Dinesh,0,22,0,0
1668451796206,ECE 258A,A00,103656,Milstein; Laurence B.,0,21,0,0
1668451796627,ECE 260B,A00,103658,Kang; Mingu,0,96,0,0
1668451797051,ECE 264A,A00,103659,Galton; Ian A,0,53,0,0
1668451797478,ECE 265A,A00,103661,Gudem; Prasad S.S.,0,30,0,0
1668451797905,ECE 265D,A00,103662,Gudem; Prasad S.S.,0,18,0,0
1668451798328,ECE 268,A00,103663,Koushanfar; Farinaz,0,34,0,0
1668451798755,ECE 269,A01,103665,Pal; Piya,0,160,0,0
1668451799179,ECE 271B,A00,103666,Vasconcelos; Manuela,0,54,0,0
1668451799608,ECE 276A,A00,103667,Atanasov; Nikolay A.,0,86,0,0
1668451800032,ECE 277,A00,103668,An; Cheolhong,0,113,0,0
1668451800482,ECE 279,A00,117947,Hall; Drew A.,0,16,0,0
1668451801338,ECE 283,A00,103670,Hsueh; Tzu-Chien,0,37,0,0
1668451801763,ECE 284,A00,103671,Turakhia; Yatish Girish,0,32,0,0
1668451802203,ECE 285,A00,103672,Zheng; Yang,0,28,0,0
1668451802203,ECE 285,B00,103673,Sworder; David D.,0,43,0,0
1668451802630,ECE 287,A00,103676,Javidi; Tara,0,6,0,0
1668451803054,MATH 200B,A00,098023,Salehi Golsefidy; Alireza,12,0,15,3
1668451803488,MATH 202B,A00,098024,Rhoades; Brendon Patrick,9,0,15,6
1668451803912,MATH 203B,A00,098025,Oprea; Dragos N.,10,0,15,5
1668451804335,MATH 204B,A00,098026,Sorensen; Claus M,13,0,15,2
1668451804760,MATH 208,A00,098027,Izadi; Elham,7,0,10,3
1668451805186,MATH 209,A00,098028,Pollack; Aaron,10,0,10,0
1668451805610,MATH 211A,A00,112919,Rogalski; Daniel,9,0,10,1
1668451806035,MATH 211B,A00,112920,Seward; Brandon M.,9,0,10,1
1668451806457,MATH 218,A00,098029,Li; Bo,10,0,10,0
1668451806887,MATH 220B,A00,098030,Novak; Jonathan I,11,0,15,4
1668451807324,MATH 221A,A00,098031,Ebenfelt; Peter F,13,0,15,2
1668451807758,MATH 231B,A00,098032,Zlatos; Andrej,11,0,15,4
1668451808182,MATH 240B,A00,098033,Ni; Lei,9,0,15,6
1668451808610,MATH 243,A00,098034,Jekel; David Andrew,10,0,10,0
1668451809034,MATH 245A,A00,098035,Nie; Jiawang,0,2,15,16
1668451809458,MATH 248,A00,098036,Bejenaru; Ioan,10,0,10,0
1668451809889,MATH 250B,A00,098037,Spolaor; Luca,14,0,15,1
1668451810321,MATH 258,A00,098038,Ni; Lei,10,0,10,0
1668451810754,MATH 264B,A00,098041,Rhoades; Brendon Patrick,9,0,15,6
1668451811193,MATH 268,A00,098042,Buss; Samuel R,10,0,10,0
1668451811618,MATH 269,A00,098043,Rhoades; Brendon Patrick,10,0,10,0
1668451812048,MATH 270B,A00,098044,Li; Bo,10,0,15,5
1668451812554,MATH 272B,A00,098045,Holst; Michael J,13,0,15,2
1668451812981,MATH 273A,A00,098046,Tian; Xiaochuan,10,0,15,5
1668451813419,MATH 275,A01,098048,Tian; Xiaochuan,6,0,10,4
1668451813849,MATH 278A,A00,098049,Holst; Michael J,8,0,10,2
1668451814273,MATH 278B,A00,098050,Cloninger; Alexander,10,0,10,0
1668451814696,MATH 278C,A00,098051,Nie; Jiawang,6,0,10,4
1668451815120,MATH 280B,A00,098052,Zheng; Tianyi,7,0,15,8
1668451815544,MATH 281B,A00,098053,Bradic; Jelena,0,2,15,15
1668451815977,MATH 282B,A00,098054,Arias-Castro; Ery,0,0,15,15
1668451816408,MATH 285,A00,098055,Fitzsimmons; Patrick J,0,1,15,17
1668451816832,MATH 287B,A00,098056,Arias-Castro; Ery,2,0,15,13
1668451817264,MATH 288,A00,098057,Agarwal; Pooja,9,0,10,1
1668451817264,MATH 288,B00,098058,Zhang; Danna,8,0,10,2
1668451817264,MATH 288,C00,098059,Williams; Ruth J,9,0,10,1
1668451817690,MATH 290B,A00,098060,Roberts; Justin Deritter,13,0,15,2
1668451818123,MATH 292,A00,098061,Belmont; Eva Kinoshita,10,0,10,0
1668451818549,MATH 295,A00,098062,Suk; Andrew Hoon,48,0,50,2
1668451818973,MATH 296,A00,098063,Novak; Jonathan I,20,0,20,0
1668451819402,MATH 297,001,098064,Gamst; Anthony Collins,9997,0,9999,2
1668452323152,COGS 205,A00,101395,Chiba; Andrea,19,0,20,1
1668452323579,COGS 210B,001,101404,Greene; Deanna Jacquelyn,9998,0,9999,1
1668452323579,COGS 210B,002,101417,Xia; Haijun,9999,0,9999,0
1668452323579,COGS 210B,003,101422,Nitz; Douglas A.,9999,0,9999,0
1668452323579,COGS 210B,004,101423,Hollan; James D.,9998,0,9999,1
1668452323579,COGS 210B,005,101424,Deak; Gedeon O.,9998,0,9999,1
1668452323579,COGS 210B,006,101425,Rossano; Federico,9999,0,9999,0
1668452324006,COGS 211B,A00,101427,Coulson; Seana M,9996,0,9999,3
1668452324435,COGS 220,A00,101428,Hollan; James D.,1,4,25,24
1668452324874,COGS 229,A00,101429,Dow; Steven P,18,0,25,7
1668452325300,COGS 230,A00,101430,Klemmer; Scott R,9,0,17,8
1668452325722,COGS 234,A00,101431,Xia; Haijun,2,0,25,23
1668452326160,COGS 260,A00,101432,Kiyonaga; Anastasia,21,0,25,4
1668452326160,COGS 260,B00,101433,Kirsh; David Joel,15,0,25,10
1668452326585,CSE 202,A00,102371,Impagliazzo; Russell,0,45,0,0
1668452327012,CSE 203B,A01,102373,Cheng; Chung Kuan,0,34,0,0
1668452327443,CSE 208,A00,102374,Micciancio; Daniele,0,2,0,0
1668452327872,CSE 209A,A00,112895,Impagliazzo; Russell,0,7,15,15
1668452328301,CSE 209B,A00,108005,Bellare; Mihir,0,3,0,0
1668452328726,CSE 210,A00,113163,Coblenz; Michael J,0,56,0,0
1668452329149,CSE 219,A00,106111,Dow; Steven P,0,2,20,20
1668452329578,CSE 221,A00,102376,Voelker; Geoffrey M.,0,42,0,0
1668452330008,CSE 224,A01,102378,Porter; George M,0,121,0,0
1668452330448,CSE 229A,A00,102379,Savage; Stefan,0,5,0,0
1668452330872,CSE 229C,A00,102380,Munyaka; Imani N. S.,0,5,0,0
1668452331303,CSE 232B,A00,102382,Deutsch; Alin Bernard,0,19,0,0
1668452331728,CSE 234,A01,112904,Kumar; Arun Kumar,0,0,0,0
1668452332158,CSE 237A,A00,102383,Rosing; Tajana Simunic,0,40,0,0
1668452332590,CSE 239A,A00,102384,Deutsch; Alin Bernard,0,7,0,0
1668452333013,CSE 239B,A00,102385,Polikarpova; Nadezhda,0,6,0,0
1668452333439,CSE 240A,A00,102386,Pannuto; Patrick William,0,35,0,0
1668452333867,CSE 240B,A00,102387,Zhao; Jishen,0,34,0,0
1668452334298,CSE 241A,A00,106406,Kang; Mingu,0,5,0,0
1668452334721,CSE 249B,A00,102388,Kahng; Andrew Byun,0,3,8,8
1668452335149,CSE 251B,A01,102392,Cottrell; Garrison W,0,31,0,0
1668452335149,CSE 251B,A02,102393,Cottrell; Garrison W,0,27,0,0
1668452335663,CSE 252B,A00,102394,Ochoa; Benjamin Lawrence,0,42,0,0
1668452336086,CSE 257,A01,102396,Gao; Sicun,0,100,0,0
1668452336522,CSE 272,A00,102397,Li; Tzumao,0,9,0,0
1668452336953,CSE 274,A00,111323,Chern; Albert Ren-Haur,0,8,0,0
1668452337376,CSE 282,A00,102398,Pevzner; Pavel Arkadjevich,0,0,0,0
1668452337803,CSE 284,A00,114175,Gymrek; Melissa Ann,0,14,0,0
1668452338227,CSE 290,A00,102399,Chandraker; Manmohan Krishna,0,7,0,0
1668452338227,CSE 290,B00,102400,Vaccaro; Kristen Marie,0,3,25,25
1668452338227,CSE 290,C00,102414,Pannuto; Patrick William,0,1,25,25
1668452338227,CSE 290,D00,102427,Pevzner; Pavel Arkadjevich,0,0,0,0
1668452338227,CSE 290,E00,102429,Zhao; Jishen,0,2,0,0
1668452338227,CSE 290,F00,102436,Tullsen; Dean Michael,0,4,0,0
1668452338227,CSE 290,G00,102440,Christensen; Henrik I,0,4,20,20
1668452338651,CSE 291,A00,102443,Su; Hao,0,0,0,0
1668452338651,CSE 291,B00,102448,Polikarpova; Nadezhda,0,0,0,0
1668452338651,CSE 291,C00,102453,Vaccaro; Kristen Marie,0,0,0,0
1668452338651,CSE 291,D00,111343,Savage; Stefan,0,0,0,0
1668452338651,CSE 291,E00,116474,Claffy; Kimberly Claire,0,0,0,0
1668452338651,CSE 291,F00,116479,Pasquale; Joseph,0,0,0,0
1668452339078,CSE 293,001,119111,Bafna; Vineet,9999,0,9999,0
1668452339078,CSE 293,002,119118,Bellare; Mihir,9999,0,9999,0
1668452339078,CSE 293,003,119122,Berg-Kirkpatrick; Taylor D,9999,0,9999,0
1668452339078,CSE 293,004,119135,Christensen; Henrik I,9999,0,9999,0
1668452339078,CSE 293,005,119142,Cottrell; Garrison W,9999,0,9999,0
1668452339078,CSE 293,006,119146,Deutsch; Alin Bernard,9999,0,9999,0
1668452339078,CSE 293,007,119159,Esmaeilzadeh; Hadi,9999,0,9999,0
1668452339078,CSE 293,008,119166,Freund; Yoav,9999,0,9999,0
1668452339078,CSE 293,009,119170,Griswold; William G.,9999,0,9999,0
1668452339078,CSE 293,010,119183,Gymrek; Melissa Ann,9999,0,9999,0
1668452339078,CSE 293,011,119190,Heninger; Nadia A,9999,0,9999,0
1668452339078,CSE 293,012,119230,Impagliazzo; Russell,9999,0,9999,0
1668452339078,CSE 293,013,119232,Jhala; Ranjit,9999,0,9999,0
1668452339078,CSE 293,014,119233,Kahng; Andrew Byun,9999,0,9999,0
1668452339078,CSE 293,015,119298,Kane; Daniel Mertz,9999,0,9999,0
1668452339078,CSE 293,016,119299,Kriegman; David J,9999,0,9999,0
1668452339078,CSE 293,017,119300,Kumar; Arun Kumar,9999,0,9999,0
1668452339078,CSE 293,018,119301,Lerner; Sorin,9999,0,9999,0
1668452339078,CSE 293,019,119302,Lovett; Shachar,9999,0,9999,0
1668452339078,CSE 293,020,119303,McAuley; Julian John,9999,0,9999,0
1668452339078,CSE 293,021,119304,Micciancio; Daniele,9999,0,9999,0
1668452339078,CSE 293,022,119367,Orailoglu; Alex,9999,0,9999,0
1668452339078,CSE 293,023,119382,Paturi; Ramamohan,9999,0,9999,0
1668452339078,CSE 293,024,119404,Polikarpova; Nadezhda,9999,0,9999,0
1668452339078,CSE 293,025,119406,Politz; Joseph Gibbs,9999,0,9999,0
1668452339078,CSE 293,026,119411,Porter; George M,9999,0,9999,0
1668452339078,CSE 293,027,119414,Porter; Leonard Emerson,9999,0,9999,0
1668452339078,CSE 293,028,119416,Ramamoorthi; Ravi,9999,0,9999,0
1668452339078,CSE 293,029,119417,Sahoo; Debashis,9999,0,9999,0
1668452339078,CSE 293,030,119420,Saul; Lawrence,9999,0,9999,0
1668452339078,CSE 293,031,119421,Savage; Stefan,9999,0,9999,0
1668452339078,CSE 293,032,119425,Schulze; Jurgen P.,9999,0,9999,0
1668452339078,CSE 293,033,119426,Snoeren; Alex C.,9999,0,9999,0
1668452339078,CSE 293,034,119428,Shang; Jingbo,9999,0,9999,0
1668452339078,CSE 293,035,119430,Stefan; Deian,9999,0,9999,0
1668452339078,CSE 293,036,119431,Su; Hao,9999,0,9999,0
1668452339078,CSE 293,037,119433,Swanson; Steven James,9999,0,9999,0
1668452339078,CSE 293,038,119435,Tullsen; Dean Michael,9999,0,9999,0
1668452339078,CSE 293,039,119483,Voelker; Geoffrey M.,9999,0,9999,0
1668452339078,CSE 293,040,119537,Zhao; Jishen,9999,0,9999,0
1668452339078,CSE 293,041,119538,Zhou; Yuan-Yuan,9999,0,9999,0
1668452339078,CSE 293,042,119539,Gao; Sicun,9999,0,9999,0
1668452339078,CSE 293,043,119540,Weibel; Nadir,9999,0,9999,0
1668452339078,CSE 293,044,119541,Gupta; Rajesh K.,9999,0,9999,0
1668452339078,CSE 293,045,126410,Vaccaro; Kristen Marie,9999,0,9999,0
1668452339078,CSE 293,046,126411,Klemke; Richard,9999,0,9999,0
1668452339502,CSE 294,A00,102459,Voelker; Geoffrey M.,0,2,0,0
1668452339502,CSE 294,B00,111322,Orailoglu; Alex,0,0,0,0
1668452339928,DSE 201,A00,096914,Deutsch; Alin Bernard,30,0,30,0
1668452340363,DSE 210,A00,096915,Dasgupta; Sanjoy,30,0,30,0
1668452340787,DSE 260A,A00,096916,Altintas De Callaf; Ilkay,30,0,30,0
1668452341229,ECE 200,001,103586,Antipa; Nicholas A,9999,0,9999,0
1668452341229,ECE 200,002,103587,Atanasov; Nikolay A.,9999,0,9999,0
1668452341229,ECE 200,003,103588,Bharadia; Dinesh,9999,0,9999,0
1668452341229,ECE 200,004,103589,Cheng; Chung Kuan,9999,0,9999,0
1668452341229,ECE 200,005,103590,Cosman; Pamela C.,9999,0,9999,0
1668452341229,ECE 200,006,103591,Dayeh; Shadi Ahmad,9999,0,9999,0
1668452341229,ECE 200,007,103592,Fainman; Yeshaiahu,9999,0,9999,0
1668452341229,ECE 200,008,103593,Ford; Joseph Earl,9999,0,9999,0
1668452341229,ECE 200,009,103594,Franceschetti; Massimo,9999,0,9999,0
1668452341229,ECE 200,010,103595,Fullerton; Eric E,9999,0,9999,0
1668452341229,ECE 200,011,103596,Galton; Ian A,9999,0,9999,0
1668452341229,ECE 200,012,103597,Gilja; Vikash,9999,0,9999,0
1668452341229,ECE 200,013,103598,Hall; Drew A.,9999,0,9999,0
1668452341229,ECE 200,014,103599,Hsueh; Tzu-Chien,9999,0,9999,0
1668452341229,ECE 200,015,103600,Javidi; Tara,9999,0,9999,0
1668452341229,ECE 200,016,103601,Kahng; Andrew Byun,9999,0,9999,0
1668452341229,ECE 200,017,103602,Kim; Young-Han,9999,0,9999,0
1668452341229,ECE 200,018,103603,Koushanfar; Farinaz,9999,0,9999,0
1668452341229,ECE 200,019,103604,Kuzum; Duygu,9999,0,9999,0
1668452341229,ECE 200,020,103605,Le; Hanh-Phuc,9999,0,9999,0
1668452341229,ECE 200,021,103606,Lin; Bill,9999,0,9999,0
1668452341229,ECE 200,022,103607,Liu; Zhaowei,9998,0,9999,1
1668452341229,ECE 200,023,103608,Lo; Yu-Hwa,9999,0,9999,0
1668452341229,ECE 200,024,103609,Lomakin; Vitaliy,9999,0,9999,0
1668452341229,ECE 200,025,103610,Mercier; Patrick Philip,9999,0,9999,0
1668452341229,ECE 200,026,103611,Meyer; Florian,9999,0,9999,0
1668452341229,ECE 200,027,103612,Milstein; Laurence B.,9999,0,9999,0
1668452341229,ECE 200,028,103613,Mir Arabbaygi; Siavash,9999,0,9999,0
1668452341229,ECE 200,029,103614,Mookherjea; Shayan,9999,0,9999,0
1668452341229,ECE 200,030,103615,Morris; Karcher William,9999,0,9999,0
1668452341229,ECE 200,031,103616,Ng; Tse Nga,9999,0,9999,0
1668452341229,ECE 200,032,103617,Nguyen; Truong Quang,9999,0,9999,0
1668452341229,ECE 200,033,103618,Nomura; Kenji,9999,0,9999,0
1668452341229,ECE 200,034,103619,Orlitsky; Alon,9999,0,9999,0
1668452341229,ECE 200,035,103620,Pal; Piya,9999,0,9999,0
1668452341229,ECE 200,036,103621,Papen; George C.,9999,0,9999,0
1668452341229,ECE 200,037,103622,Radic; Stojan,9999,0,9999,0
1668452341229,ECE 200,038,103623,Rao; Bhaskar D.,9999,0,9999,0
1668452341229,ECE 200,039,103624,Rao; Ramesh R,9999,0,9999,0
1668452341229,ECE 200,040,103625,Rebeiz; Gabriel,9999,0,9999,0
1668452341229,ECE 200,041,103626,Sanford; John R,9999,0,9999,0
1668452341229,ECE 200,042,103627,Siegel; Paul H.,9999,0,9999,0
1668452341229,ECE 200,043,103628,Sievenpiper; Daniel F.,9999,0,9999,0
1668452341229,ECE 200,044,103629,Sworder; David D.,9999,0,9999,0
1668452341229,ECE 200,045,103630,Taur; Yuan,9999,0,9999,0
1668452341229,ECE 200,046,103631,Touri; Behrouz,9999,0,9999,0
1668452341229,ECE 200,047,103632,Trivedi; Mohan M.,9999,0,9999,0
1668452341229,ECE 200,048,103633,Vasconcelos; Nuno,9999,0,9999,0
1668452341229,ECE 200,049,103634,Wang; Xiaolong,9999,0,9999,0
1668452341229,ECE 200,050,103635,Xie; Pengtao,9999,0,9999,0
1668452341229,ECE 200,051,103636,Yip; Michael,9999,0,9999,0
1668452341229,ECE 200,052,103637,Zeger; Kenneth A.,999,0,999,0
1668452341229,ECE 200,053,103638,Zhang; Xinyu,9999,0,9999,0
1668452341229,ECE 200,054,103639,Turakhia; Yatish Girish,9999,0,9999,0
1668452341229,ECE 200,055,103640,Kang; Mingu,9999,0,9999,0
1668452341229,ECE 200,056,103641,Shi; Yuanyuan,9999,0,9999,0
1668452341229,ECE 200,057,103642,Wang; Edward Jay,9999,0,9999,0
1668452341229,ECE 200,058,103643,Zheng; Yang,9999,0,9999,0
1668452341661,ECE 202,A00,103644,Kuzum; Duygu,0,31,0,0
1668452342093,ECE 212BN,A00,103646,Ng; Tse Nga,0,2,0,0
1668452342518,ECE 221,A00,111493,Staff,0,0,0,0
1668452342952,ECE 222B,A00,103647,Lomakin; Vitaliy,0,7,0,0
1668452343383,ECE 230B,A00,103648,Taur; Yuan,0,1,0,0
1668452343806,ECE 238B,A00,103649,Garay; Javier,0,0,0,0
1668452344231,ECE 240B,A00,112900,Fainman; Yeshaiahu,0,4,0,0
1668452344660,ECE 247A,A00,103650,Jokerst; Jesse Vincent,0,2,0,0
1668452345084,ECE 247B,A00,103651,Wang; Joseph,0,8,0,0
1668452345521,ECE 250,A00,103652,Siegel; Paul H.,0,55,0,0
1668452345942,ECE 251A,A00,103654,Rao; Bhaskar D.,0,40,0,0
1668452346374,ECE 257B,A00,103655,Bharadia; Dinesh,0,22,0,0
1668452346803,ECE 258A,A00,103656,Milstein; Laurence B.,0,21,0,0
1668452347229,ECE 260B,A00,103658,Kang; Mingu,0,97,0,0
1668452347658,ECE 264A,A00,103659,Galton; Ian A,0,54,0,0
1668452348094,ECE 265A,A00,103661,Gudem; Prasad S.S.,0,30,0,0
1668452348524,ECE 265D,A00,103662,Gudem; Prasad S.S.,0,18,0,0
1668452348946,ECE 268,A00,103663,Koushanfar; Farinaz,0,33,0,0
1668452349384,ECE 269,A01,103665,Pal; Piya,0,160,0,0
1668452349809,ECE 271B,A00,103666,Vasconcelos; Manuela,0,55,0,0
1668452350232,ECE 276A,A00,103667,Atanasov; Nikolay A.,0,86,0,0
1668452350663,ECE 277,A00,103668,An; Cheolhong,0,113,0,0
1668452351089,ECE 279,A00,117947,Hall; Drew A.,0,16,0,0
1668452351937,ECE 283,A00,103670,Hsueh; Tzu-Chien,0,37,0,0
1668452352362,ECE 284,A00,103671,Turakhia; Yatish Girish,0,31,0,0
1668452352790,ECE 285,A00,103672,Zheng; Yang,0,28,0,0
1668452352790,ECE 285,B00,103673,Sworder; David D.,0,43,0,0
1668452353218,ECE 287,A00,103676,Javidi; Tara,0,6,0,0
1668452353654,MATH 200B,A00,098023,Salehi Golsefidy; Alireza,12,0,15,3
1668452354094,MATH 202B,A00,098024,Rhoades; Brendon Patrick,9,0,15,6
1668452354527,MATH 203B,A00,098025,Oprea; Dragos N.,10,0,15,5
1668452354954,MATH 204B,A00,098026,Sorensen; Claus M,13,0,15,2
1668452355382,MATH 208,A00,098027,Izadi; Elham,7,0,10,3
1668452355807,MATH 209,A00,098028,Pollack; Aaron,10,0,10,0
1668452356238,MATH 211A,A00,112919,Rogalski; Daniel,9,0,10,1
1668452356664,MATH 211B,A00,112920,Seward; Brandon M.,9,0,10,1
1668452357093,MATH 218,A00,098029,Li; Bo,10,0,10,0
1668452357524,MATH 220B,A00,098030,Novak; Jonathan I,11,0,15,4
1668452357954,MATH 221A,A00,098031,Ebenfelt; Peter F,13,0,15,2
1668452358402,MATH 231B,A00,098032,Zlatos; Andrej,11,0,15,4
1668452358840,MATH 240B,A00,098033,Ni; Lei,9,0,15,6
1668452359263,MATH 243,A00,098034,Jekel; David Andrew,10,0,10,0
1668452359687,MATH 245A,A00,098035,Nie; Jiawang,0,2,15,16
1668452360114,MATH 248,A00,098036,Bejenaru; Ioan,10,0,10,0
1668452360538,MATH 250B,A00,098037,Spolaor; Luca,14,0,15,1
1668452360963,MATH 258,A00,098038,Ni; Lei,10,0,10,0
1668452361400,MATH 264B,A00,098041,Rhoades; Brendon Patrick,9,0,15,6
1668452361826,MATH 268,A00,098042,Buss; Samuel R,10,0,10,0
1668452362254,MATH 269,A00,098043,Rhoades; Brendon Patrick,10,0,10,0
1668452362678,MATH 270B,A00,098044,Li; Bo,10,0,15,5
1668452363115,MATH 272B,A00,098045,Holst; Michael J,13,0,15,2
1668452363540,MATH 273A,A00,098046,Tian; Xiaochuan,10,0,15,5
1668452363963,MATH 275,A01,098048,Tian; Xiaochuan,6,0,10,4
1668452364389,MATH 278A,A00,098049,Holst; Michael J,8,0,10,2
1668452364817,MATH 278B,A00,098050,Cloninger; Alexander,10,0,10,0
1668452365241,MATH 278C,A00,098051,Nie; Jiawang,6,0,10,4
1668452365676,MATH 280B,A00,098052,Zheng; Tianyi,7,0,15,8
1668452366100,MATH 281B,A00,098053,Bradic; Jelena,0,2,15,15
1668452366528,MATH 282B,A00,098054,Arias-Castro; Ery,0,0,15,15
1668452366961,MATH 285,A00,098055,Fitzsimmons; Patrick J,0,1,15,17
1668452367389,MATH 287B,A00,098056,Arias-Castro; Ery,2,0,15,13
1668452367813,MATH 288,A00,098057,Agarwal; Pooja,9,0,10,1
1668452367813,MATH 288,B00,098058,Zhang; Danna,8,0,10,2
1668452367813,MATH 288,C00,098059,Williams; Ruth J,9,0,10,1
1668452368237,MATH 290B,A00,098060,Roberts; Justin Deritter,13,0,15,2
1668452368661,MATH 292,A00,098061,Belmont; Eva Kinoshita,10,0,10,0
1668452369084,MATH 295,A00,098062,Suk; Andrew Hoon,48,0,50,2
1668452369511,MATH 296,A00,098063,Novak; Jonathan I,20,0,20,0
1668452369939,MATH 297,001,098064,Gamst; Anthony Collins,9997,0,9999,2
1668452874953,COGS 205,A00,101395,Chiba; Andrea,19,0,20,1
1668452875387,COGS 210B,001,101404,Greene; Deanna Jacquelyn,9998,0,9999,1
1668452875387,COGS 210B,002,101417,Xia; Haijun,9999,0,9999,0
1668452875387,COGS 210B,003,101422,Nitz; Douglas A.,9999,0,9999,0
1668452875387,COGS 210B,004,101423,Hollan; James D.,9998,0,9999,1
1668452875387,COGS 210B,005,101424,Deak; Gedeon O.,9998,0,9999,1
1668452875387,COGS 210B,006,101425,Rossano; Federico,9999,0,9999,0
1668452875826,COGS 211B,A00,101427,Coulson; Seana M,9996,0,9999,3
1668452876262,COGS 220,A00,101428,Hollan; James D.,1,4,25,24
1668452876685,COGS 229,A00,101429,Dow; Steven P,18,0,25,7
1668452877109,COGS 230,A00,101430,Klemmer; Scott R,9,0,17,8
1668452877532,COGS 234,A00,101431,Xia; Haijun,2,0,25,23
1668452877957,COGS 260,A00,101432,Kiyonaga; Anastasia,21,0,25,4
1668452877957,COGS 260,B00,101433,Kirsh; David Joel,15,0,25,10
1668452878394,CSE 202,A00,102371,Impagliazzo; Russell,0,45,0,0
1668452878820,CSE 203B,A01,102373,Cheng; Chung Kuan,0,34,0,0
1668452879242,CSE 208,A00,102374,Micciancio; Daniele,0,2,0,0
1668452879667,CSE 209A,A00,112895,Impagliazzo; Russell,0,7,15,15
1668452880093,CSE 209B,A00,108005,Bellare; Mihir,0,3,0,0
1668452880524,CSE 210,A00,113163,Coblenz; Michael J,0,56,0,0
1668452880966,CSE 219,A00,106111,Dow; Steven P,0,2,20,20
1668452881394,CSE 221,A00,102376,Voelker; Geoffrey M.,0,42,0,0
1668452881818,CSE 224,A01,102378,Porter; George M,0,121,0,0
1668452882245,CSE 229A,A00,102379,Savage; Stefan,0,5,0,0
1668452882669,CSE 229C,A00,102380,Munyaka; Imani N. S.,0,5,0,0
1668452883093,CSE 232B,A00,102382,Deutsch; Alin Bernard,0,19,0,0
1668452883519,CSE 234,A01,112904,Kumar; Arun Kumar,0,0,0,0
1668452883948,CSE 237A,A00,102383,Rosing; Tajana Simunic,0,41,0,0
1668452884371,CSE 239A,A00,102384,Deutsch; Alin Bernard,0,7,0,0
1668452884797,CSE 239B,A00,102385,Polikarpova; Nadezhda,0,6,0,0
1668452885223,CSE 240A,A00,102386,Pannuto; Patrick William,0,35,0,0
1668452885646,CSE 240B,A00,102387,Zhao; Jishen,0,34,0,0
1668452886069,CSE 241A,A00,106406,Kang; Mingu,0,5,0,0
1668452886495,CSE 249B,A00,102388,Kahng; Andrew Byun,0,3,8,8
1668452886921,CSE 251B,A01,102392,Cottrell; Garrison W,0,31,0,0
1668452886921,CSE 251B,A02,102393,Cottrell; Garrison W,0,27,0,0
1668452887349,CSE 252B,A00,102394,Ochoa; Benjamin Lawrence,0,42,0,0
1668452887777,CSE 257,A01,102396,Gao; Sicun,0,100,0,0
1668452888222,CSE 272,A00,102397,Li; Tzumao,0,9,0,0
1668452888655,CSE 274,A00,111323,Chern; Albert Ren-Haur,0,8,0,0
1668452889103,CSE 282,A00,102398,Pevzner; Pavel Arkadjevich,0,0,0,0
1668452889547,CSE 284,A00,114175,Gymrek; Melissa Ann,0,14,0,0
1668452889970,CSE 290,A00,102399,Chandraker; Manmohan Krishna,0,7,0,0
1668452889970,CSE 290,B00,102400,Vaccaro; Kristen Marie,0,3,25,25
1668452889970,CSE 290,C00,102414,Pannuto; Patrick William,0,1,25,25
1668452889970,CSE 290,D00,102427,Pevzner; Pavel Arkadjevich,0,0,0,0
1668452889970,CSE 290,E00,102429,Zhao; Jishen,0,2,0,0
1668452889970,CSE 290,F00,102436,Tullsen; Dean Michael,0,4,0,0
1668452889970,CSE 290,G00,102440,Christensen; Henrik I,0,4,20,20
1668452890404,CSE 291,A00,102443,Su; Hao,0,0,0,0
1668452890404,CSE 291,B00,102448,Polikarpova; Nadezhda,0,0,0,0
1668452890404,CSE 291,C00,102453,Vaccaro; Kristen Marie,0,0,0,0
1668452890404,CSE 291,D00,111343,Savage; Stefan,0,0,0,0
1668452890404,CSE 291,E00,116474,Claffy; Kimberly Claire,0,0,0,0
1668452890404,CSE 291,F00,116479,Pasquale; Joseph,0,0,0,0
1668452890867,CSE 293,001,119111,Bafna; Vineet,9999,0,9999,0
1668452890867,CSE 293,002,119118,Bellare; Mihir,9999,0,9999,0
1668452890867,CSE 293,003,119122,Berg-Kirkpatrick; Taylor D,9999,0,9999,0
1668452890867,CSE 293,004,119135,Christensen; Henrik I,9999,0,9999,0
1668452890867,CSE 293,005,119142,Cottrell; Garrison W,9999,0,9999,0
1668452890867,CSE 293,006,119146,Deutsch; Alin Bernard,9999,0,9999,0
1668452890867,CSE 293,007,119159,Esmaeilzadeh; Hadi,9999,0,9999,0
1668452890867,CSE 293,008,119166,Freund; Yoav,9999,0,9999,0
1668452890867,CSE 293,009,119170,Griswold; William G.,9999,0,9999,0
1668452890867,CSE 293,010,119183,Gymrek; Melissa Ann,9999,0,9999,0
1668452890867,CSE 293,011,119190,Heninger; Nadia A,9999,0,9999,0
1668452890867,CSE 293,012,119230,Impagliazzo; Russell,9999,0,9999,0
1668452890867,CSE 293,013,119232,Jhala; Ranjit,9999,0,9999,0
1668452890867,CSE 293,014,119233,Kahng; Andrew Byun,9999,0,9999,0
1668452890867,CSE 293,015,119298,Kane; Daniel Mertz,9999,0,9999,0
1668452890867,CSE 293,016,119299,Kriegman; David J,9999,0,9999,0
1668452890867,CSE 293,017,119300,Kumar; Arun Kumar,9999,0,9999,0
1668452890867,CSE 293,018,119301,Lerner; Sorin,9999,0,9999,0
1668452890867,CSE 293,019,119302,Lovett; Shachar,9999,0,9999,0
1668452890867,CSE 293,020,119303,McAuley; Julian John,9999,0,9999,0
1668452890867,CSE 293,021,119304,Micciancio; Daniele,9999,0,9999,0
1668452890867,CSE 293,022,119367,Orailoglu; Alex,9999,0,9999,0
1668452890867,CSE 293,023,119382,Paturi; Ramamohan,9999,0,9999,0
1668452890867,CSE 293,024,119404,Polikarpova; Nadezhda,9999,0,9999,0
1668452890867,CSE 293,025,119406,Politz; Joseph Gibbs,9999,0,9999,0
1668452890867,CSE 293,026,119411,Porter; George M,9999,0,9999,0
1668452890867,CSE 293,027,119414,Porter; Leonard Emerson,9999,0,9999,0
1668452890867,CSE 293,028,119416,Ramamoorthi; Ravi,9999,0,9999,0
1668452890867,CSE 293,029,119417,Sahoo; Debashis,9999,0,9999,0
1668452890867,CSE 293,030,119420,Saul; Lawrence,9999,0,9999,0
1668452890867,CSE 293,031,119421,Savage; Stefan,9999,0,9999,0
1668452890867,CSE 293,032,119425,Schulze; Jurgen P.,9999,0,9999,0
1668452890867,CSE 293,033,119426,Snoeren; Alex C.,9999,0,9999,0
1668452890867,CSE 293,034,119428,Shang; Jingbo,9999,0,9999,0
1668452890867,CSE 293,035,119430,Stefan; Deian,9999,0,9999,0
1668452890867,CSE 293,036,119431,Su; Hao,9999,0,9999,0
1668452890867,CSE 293,037,119433,Swanson; Steven James,9999,0,9999,0
1668452890867,CSE 293,038,119435,Tullsen; Dean Michael,9999,0,9999,0
1668452890867,CSE 293,039,119483,Voelker; Geoffrey M.,9999,0,9999,0
1668452890867,CSE 293,040,119537,Zhao; Jishen,9999,0,9999,0
1668452890867,CSE 293,041,119538,Zhou; Yuan-Yuan,9999,0,9999,0
1668452890867,CSE 293,042,119539,Gao; Sicun,9999,0,9999,0
1668452890867,CSE 293,043,119540,Weibel; Nadir,9999,0,9999,0
1668452890867,CSE 293,044,119541,Gupta; Rajesh K.,9999,0,9999,0
1668452890867,CSE 293,045,126410,Vaccaro; Kristen Marie,9999,0,9999,0
1668452890867,CSE 293,046,126411,Klemke; Richard,9999,0,9999,0
1668452891291,CSE 294,A00,102459,Voelker; Geoffrey M.,0,2,0,0
1668452891291,CSE 294,B00,111322,Orailoglu; Alex,0,0,0,0
1668452891726,DSE 201,A00,096914,Deutsch; Alin Bernard,30,0,30,0
1668452892153,DSE 210,A00,096915,Dasgupta; Sanjoy,30,0,30,0
1668452892576,DSE 260A,A00,096916,Altintas De Callaf; Ilkay,30,0,30,0
1668452893014,ECE 200,001,103586,Antipa; Nicholas A,9999,0,9999,0
1668452893014,ECE 200,002,103587,Atanasov; Nikolay A.,9999,0,9999,0
1668452893014,ECE 200,003,103588,Bharadia; Dinesh,9999,0,9999,0
1668452893014,ECE 200,004,103589,Cheng; Chung Kuan,9999,0,9999,0
1668452893014,ECE 200,005,103590,Cosman; Pamela C.,9999,0,9999,0
1668452893014,ECE 200,006,103591,Dayeh; Shadi Ahmad,9999,0,9999,0
1668452893014,ECE 200,007,103592,Fainman; Yeshaiahu,9999,0,9999,0
1668452893014,ECE 200,008,103593,Ford; Joseph Earl,9999,0,9999,0
1668452893014,ECE 200,009,103594,Franceschetti; Massimo,9999,0,9999,0
1668452893014,ECE 200,010,103595,Fullerton; Eric E,9999,0,9999,0
1668452893014,ECE 200,011,103596,Galton; Ian A,9999,0,9999,0
1668452893014,ECE 200,012,103597,Gilja; Vikash,9999,0,9999,0
1668452893014,ECE 200,013,103598,Hall; Drew A.,9999,0,9999,0
1668452893014,ECE 200,014,103599,Hsueh; Tzu-Chien,9999,0,9999,0
1668452893014,ECE 200,015,103600,Javidi; Tara,9999,0,9999,0
1668452893014,ECE 200,016,103601,Kahng; Andrew Byun,9999,0,9999,0
1668452893014,ECE 200,017,103602,Kim; Young-Han,9999,0,9999,0
1668452893014,ECE 200,018,103603,Koushanfar; Farinaz,9999,0,9999,0
1668452893014,ECE 200,019,103604,Kuzum; Duygu,9999,0,9999,0
1668452893014,ECE 200,020,103605,Le; Hanh-Phuc,9999,0,9999,0
1668452893014,ECE 200,021,103606,Lin; Bill,9999,0,9999,0
1668452893014,ECE 200,022,103607,Liu; Zhaowei,9998,0,9999,1
1668452893014,ECE 200,023,103608,Lo; Yu-Hwa,9999,0,9999,0
1668452893014,ECE 200,024,103609,Lomakin; Vitaliy,9999,0,9999,0
1668452893014,ECE 200,025,103610,Mercier; Patrick Philip,9999,0,9999,0
1668452893014,ECE 200,026,103611,Meyer; Florian,9999,0,9999,0
1668452893014,ECE 200,027,103612,Milstein; Laurence B.,9999,0,9999,0
1668452893014,ECE 200,028,103613,Mir Arabbaygi; Siavash,9999,0,9999,0
1668452893014,ECE 200,029,103614,Mookherjea; Shayan,9999,0,9999,0
1668452893014,ECE 200,030,103615,Morris; Karcher William,9999,0,9999,0
1668452893014,ECE 200,031,103616,Ng; Tse Nga,9999,0,9999,0
1668452893014,ECE 200,032,103617,Nguyen; Truong Quang,9999,0,9999,0
1668452893014,ECE 200,033,103618,Nomura; Kenji,9999,0,9999,0
1668452893014,ECE 200,034,103619,Orlitsky; Alon,9999,0,9999,0
1668452893014,ECE 200,035,103620,Pal; Piya,9999,0,9999,0
1668452893014,ECE 200,036,103621,Papen; George C.,9999,0,9999,0
1668452893014,ECE 200,037,103622,Radic; Stojan,9999,0,9999,0
1668452893014,ECE 200,038,103623,Rao; Bhaskar D.,9999,0,9999,0
1668452893014,ECE 200,039,103624,Rao; Ramesh R,9999,0,9999,0
1668452893014,ECE 200,040,103625,Rebeiz; Gabriel,9999,0,9999,0
1668452893014,ECE 200,041,103626,Sanford; John R,9999,0,9999,0
1668452893014,ECE 200,042,103627,Siegel; Paul H.,9999,0,9999,0
1668452893014,ECE 200,043,103628,Sievenpiper; Daniel F.,9999,0,9999,0
1668452893014,ECE 200,044,103629,Sworder; David D.,9999,0,9999,0
1668452893014,ECE 200,045,103630,Taur; Yuan,9999,0,9999,0
1668452893014,ECE 200,046,103631,Touri; Behrouz,9999,0,9999,0
1668452893014,ECE 200,047,103632,Trivedi; Mohan M.,9999,0,9999,0
1668452893014,ECE 200,048,103633,Vasconcelos; Nuno,9999,0,9999,0
1668452893014,ECE 200,049,103634,Wang; Xiaolong,9999,0,9999,0
1668452893014,ECE 200,050,103635,Xie; Pengtao,9999,0,9999,0
1668452893014,ECE 200,051,103636,Yip; Michael,9999,0,9999,0
1668452893014,ECE 200,052,103637,Zeger; Kenneth A.,999,0,999,0
1668452893014,ECE 200,053,103638,Zhang; Xinyu,9999,0,9999,0
1668452893014,ECE 200,054,103639,Turakhia; Yatish Girish,9999,0,9999,0
1668452893014,ECE 200,055,103640,Kang; Mingu,9999,0,9999,0
1668452893014,ECE 200,056,103641,Shi; Yuanyuan,9999,0,9999,0
1668452893014,ECE 200,057,103642,Wang; Edward Jay,9999,0,9999,0
1668452893014,ECE 200,058,103643,Zheng; Yang,9999,0,9999,0
1668452893439,ECE 202,A00,103644,Kuzum; Duygu,0,31,0,0
1668452893868,ECE 212BN,A00,103646,Ng; Tse Nga,0,2,0,0
1668452894298,ECE 221,A00,111493,Staff,0,0,0,0
1668452894744,ECE 222B,A00,103647,Lomakin; Vitaliy,0,7,0,0
1668452895171,ECE 230B,A00,103648,Taur; Yuan,0,1,0,0
1668452895596,ECE 238B,A00,103649,Garay; Javier,0,0,0,0
1668452896024,ECE 240B,A00,112900,Fainman; Yeshaiahu,0,4,0,0
1668452896452,ECE 247A,A00,103650,Jokerst; Jesse Vincent,0,2,0,0
1668452896880,ECE 247B,A00,103651,Wang; Joseph,0,8,0,0
1668452897305,ECE 250,A00,103652,Siegel; Paul H.,0,55,0,0
1668452897732,ECE 251A,A00,103654,Rao; Bhaskar D.,0,42,0,0
1668452898162,ECE 257B,A00,103655,Bharadia; Dinesh,0,22,0,0
1668452898586,ECE 258A,A00,103656,Milstein; Laurence B.,0,21,0,0
1668452899016,ECE 260B,A00,103658,Kang; Mingu,0,97,0,0
1668452899450,ECE 264A,A00,103659,Galton; Ian A,0,55,0,0
1668452899881,ECE 265A,A00,103661,Gudem; Prasad S.S.,0,31,0,0
1668452900316,ECE 265D,A00,103662,Gudem; Prasad S.S.,0,18,0,0
1668452900738,ECE 268,A00,103663,Koushanfar; Farinaz,0,33,0,0
1668452901166,ECE 269,A01,103665,Pal; Piya,0,162,0,0
1668452901590,ECE 271B,A00,103666,Vasconcelos; Manuela,0,55,0,0
1668452902011,ECE 276A,A00,103667,Atanasov; Nikolay A.,0,87,0,0
1668452902445,ECE 277,A00,103668,An; Cheolhong,0,114,0,0
1668452902877,ECE 279,A00,117947,Hall; Drew A.,0,16,0,0
1668452903843,ECE 283,A00,103670,Hsueh; Tzu-Chien,0,37,0,0
1668452904266,ECE 284,A00,103671,Turakhia; Yatish Girish,0,31,0,0
1668452904689,ECE 285,A00,103672,Zheng; Yang,0,28,0,0
1668452904689,ECE 285,B00,103673,Sworder; David D.,0,44,0,0
1668452905112,ECE 287,A00,103676,Javidi; Tara,0,6,0,0
1668452905541,MATH 200B,A00,098023,Salehi Golsefidy; Alireza,12,0,15,3
1668452905969,MATH 202B,A00,098024,Rhoades; Brendon Patrick,9,0,15,6
1668452906393,MATH 203B,A00,098025,Oprea; Dragos N.,10,0,15,5
1668452906828,MATH 204B,A00,098026,Sorensen; Claus M,13,0,15,2
1668452907254,MATH 208,A00,098027,Izadi; Elham,7,0,10,3
1668452907690,MATH 209,A00,098028,Pollack; Aaron,10,0,10,0
1668452908129,MATH 211A,A00,112919,Rogalski; Daniel,9,0,10,1
1668452908563,MATH 211B,A00,112920,Seward; Brandon M.,9,0,10,1
1668452908990,MATH 218,A00,098029,Li; Bo,10,0,10,0
1668452909414,MATH 220B,A00,098030,Novak; Jonathan I,11,0,15,4
1668452909844,MATH 221A,A00,098031,Ebenfelt; Peter F,13,0,15,2
1668452910286,MATH 231B,A00,098032,Zlatos; Andrej,11,0,15,4
1668452910716,MATH 240B,A00,098033,Ni; Lei,9,0,15,6
1668452911138,MATH 243,A00,098034,Jekel; David Andrew,10,0,10,0
1668452911561,MATH 245A,A00,098035,Nie; Jiawang,0,2,15,16
1668452912015,MATH 248,A00,098036,Bejenaru; Ioan,10,0,10,0
1668452912438,MATH 250B,A00,098037,Spolaor; Luca,14,0,15,1
1668452912861,MATH 258,A00,098038,Ni; Lei,10,0,10,0
1668452913294,MATH 264B,A00,098041,Rhoades; Brendon Patrick,9,0,15,6
1668452913725,MATH 268,A00,098042,Buss; Samuel R,10,0,10,0
1668452914175,MATH 269,A00,098043,Rhoades; Brendon Patrick,10,0,10,0
1668452914600,MATH 270B,A00,098044,Li; Bo,10,0,15,5
1668452915027,MATH 272B,A00,098045,Holst; Michael J,13,0,15,2
1668452915454,MATH 273A,A00,098046,Tian; Xiaochuan,10,0,15,5
1668452915877,MATH 275,A01,098048,Tian; Xiaochuan,6,0,10,4
1668452916318,MATH 278A,A00,098049,Holst; Michael J,8,0,10,2
1668452916745,MATH 278B,A00,098050,Cloninger; Alexander,10,0,10,0
1668452917174,MATH 278C,A00,098051,Nie; Jiawang,6,0,10,4
1668452917599,MATH 280B,A00,098052,Zheng; Tianyi,7,0,15,8
1668452918034,MATH 281B,A00,098053,Bradic; Jelena,0,2,15,15
1668452918459,MATH 282B,A00,098054,Arias-Castro; Ery,0,0,15,15
1668452918891,MATH 285,A00,098055,Fitzsimmons; Patrick J,0,1,15,17
1668452919315,MATH 287B,A00,098056,Arias-Castro; Ery,2,0,15,13
1668452919756,MATH 288,A00,098057,Agarwal; Pooja,9,0,10,1
1668452919756,MATH 288,B00,098058,Zhang; Danna,8,0,10,2
1668452919756,MATH 288,C00,098059,Williams; Ruth J,9,0,10,1
1668452920182,MATH 290B,A00,098060,Roberts; Justin Deritter,13,0,15,2
1668452920610,MATH 292,A00,098061,Belmont; Eva Kinoshita,10,0,10,0
1668452921036,MATH 295,A00,098062,Suk; Andrew Hoon,48,0,50,2
1668452921467,MATH 296,A00,098063,Novak; Jonathan I,20,0,20,0
1668452921889,MATH 297,001,098064,Gamst; Anthony Collins,9997,0,9999,2
1668453426493,COGS 205,A00,101395,Chiba; Andrea,19,0,20,1
1668453426916,COGS 210B,001,101404,Greene; Deanna Jacquelyn,9998,0,9999,1
1668453426916,COGS 210B,002,101417,Xia; Haijun,9999,0,9999,0
1668453426916,COGS 210B,003,101422,Nitz; Douglas A.,9999,0,9999,0
1668453426916,COGS 210B,004,101423,Hollan; James D.,9998,0,9999,1
1668453426916,COGS 210B,005,101424,Deak; Gedeon O.,9998,0,9999,1
1668453426916,COGS 210B,006,101425,Rossano; Federico,9999,0,9999,0
1668453427443,COGS 211B,A00,101427,Coulson; Seana M,9996,0,9999,3
1668453427866,COGS 220,A00,101428,Hollan; James D.,1,5,25,24
1668453428300,COGS 229,A00,101429,Dow; Steven P,18,0,25,7
1668453428734,COGS 230,A00,101430,Klemmer; Scott R,9,0,17,8
1668453429156,COGS 234,A00,101431,Xia; Haijun,2,0,25,23
1668453429583,COGS 260,A00,101432,Kiyonaga; Anastasia,21,0,25,4
1668453429583,COGS 260,B00,101433,Kirsh; David Joel,15,0,25,10
1668453430012,CSE 202,A00,102371,Impagliazzo; Russell,0,45,0,0
1668453430436,CSE 203B,A01,102373,Cheng; Chung Kuan,0,34,0,0
1668453430863,CSE 208,A00,102374,Micciancio; Daniele,0,2,0,0
1668453431287,CSE 209A,A00,112895,Impagliazzo; Russell,0,7,15,15
1668453431726,CSE 209B,A00,108005,Bellare; Mihir,0,3,0,0
1668453432161,CSE 210,A00,113163,Coblenz; Michael J,0,56,0,0
1668453432583,CSE 219,A00,106111,Dow; Steven P,0,2,20,20
1668453433008,CSE 221,A00,102376,Voelker; Geoffrey M.,0,42,0,0
1668453433441,CSE 224,A01,102378,Porter; George M,0,121,0,0
1668453433875,CSE 229A,A00,102379,Savage; Stefan,0,5,0,0
1668453434303,CSE 229C,A00,102380,Munyaka; Imani N. S.,0,5,0,0
1668453434747,CSE 232B,A00,102382,Deutsch; Alin Bernard,0,20,0,0
1668453435176,CSE 234,A01,112904,Kumar; Arun Kumar,0,0,0,0
1668453435613,CSE 237A,A00,102383,Rosing; Tajana Simunic,0,41,0,0
1668453436036,CSE 239A,A00,102384,Deutsch; Alin Bernard,0,6,0,0
1668453436461,CSE 239B,A00,102385,Polikarpova; Nadezhda,0,6,0,0
1668453436884,CSE 240A,A00,102386,Pannuto; Patrick William,0,35,0,0
1668453437313,CSE 240B,A00,102387,Zhao; Jishen,0,34,0,0
1668453437750,CSE 241A,A00,106406,Kang; Mingu,0,5,0,0
1668453438171,CSE 249B,A00,102388,Kahng; Andrew Byun,0,3,8,8
1668453438600,CSE 251B,A01,102392,Cottrell; Garrison W,0,31,0,0
1668453438600,CSE 251B,A02,102393,Cottrell; Garrison W,0,27,0,0
1668453439032,CSE 252B,A00,102394,Ochoa; Benjamin Lawrence,0,42,0,0
1668453439460,CSE 257,A01,102396,Gao; Sicun,0,100,0,0
1668453439883,CSE 272,A00,102397,Li; Tzumao,0,9,0,0
1668453440308,CSE 274,A00,111323,Chern; Albert Ren-Haur,0,8,0,0
1668453440734,CSE 282,A00,102398,Pevzner; Pavel Arkadjevich,0,0,0,0
1668453441174,CSE 284,A00,114175,Gymrek; Melissa Ann,0,15,0,0
1668453441610,CSE 290,A00,102399,Chandraker; Manmohan Krishna,0,7,0,0
1668453441610,CSE 290,B00,102400,Vaccaro; Kristen Marie,0,3,25,25
1668453441610,CSE 290,C00,102414,Pannuto; Patrick William,0,1,25,25
1668453441610,CSE 290,D00,102427,Pevzner; Pavel Arkadjevich,0,0,0,0
1668453441610,CSE 290,E00,102429,Zhao; Jishen,0,2,0,0
1668453441610,CSE 290,F00,102436,Tullsen; Dean Michael,0,4,0,0
1668453441610,CSE 290,G00,102440,Christensen; Henrik I,0,4,20,20
1668453442039,CSE 291,A00,102443,Su; Hao,0,0,0,0
1668453442039,CSE 291,B00,102448,Polikarpova; Nadezhda,0,0,0,0
1668453442039,CSE 291,C00,102453,Vaccaro; Kristen Marie,0,0,0,0
1668453442039,CSE 291,D00,111343,Savage; Stefan,0,0,0,0
1668453442039,CSE 291,E00,116474,Claffy; Kimberly Claire,0,0,0,0
1668453442039,CSE 291,F00,116479,Pasquale; Joseph,0,0,0,0
1668453442470,CSE 293,001,119111,Bafna; Vineet,9999,0,9999,0
1668453442470,CSE 293,002,119118,Bellare; Mihir,9999,0,9999,0
1668453442470,CSE 293,003,119122,Berg-Kirkpatrick; Taylor D,9999,0,9999,0
1668453442470,CSE 293,004,119135,Christensen; Henrik I,9999,0,9999,0
1668453442470,CSE 293,005,119142,Cottrell; Garrison W,9999,0,9999,0
1668453442470,CSE 293,006,119146,Deutsch; Alin Bernard,9999,0,9999,0
1668453442470,CSE 293,007,119159,Esmaeilzadeh; Hadi,9999,0,9999,0
1668453442470,CSE 293,008,119166,Freund; Yoav,9999,0,9999,0
1668453442470,CSE 293,009,119170,Griswold; William G.,9999,0,9999,0
1668453442470,CSE 293,010,119183,Gymrek; Melissa Ann,9999,0,9999,0
1668453442470,CSE 293,011,119190,Heninger; Nadia A,9999,0,9999,0
1668453442470,CSE 293,012,119230,Impagliazzo; Russell,9999,0,9999,0
1668453442470,CSE 293,013,119232,Jhala; Ranjit,9999,0,9999,0
1668453442470,CSE 293,014,119233,Kahng; Andrew Byun,9999,0,9999,0
1668453442470,CSE 293,015,119298,Kane; Daniel Mertz,9999,0,9999,0
1668453442470,CSE 293,016,119299,Kriegman; David J,9999,0,9999,0
1668453442470,CSE 293,017,119300,Kumar; Arun Kumar,9999,0,9999,0
1668453442470,CSE 293,018,119301,Lerner; Sorin,9999,0,9999,0
1668453442470,CSE 293,019,119302,Lovett; Shachar,9999,0,9999,0
1668453442470,CSE 293,020,119303,McAuley; Julian John,9999,0,9999,0
1668453442470,CSE 293,021,119304,Micciancio; Daniele,9999,0,9999,0
1668453442470,CSE 293,022,119367,Orailoglu; Alex,9999,0,9999,0
1668453442470,CSE 293,023,119382,Paturi; Ramamohan,9999,0,9999,0
1668453442470,CSE 293,024,119404,Polikarpova; Nadezhda,9999,0,9999,0
1668453442470,CSE 293,025,119406,Politz; Joseph Gibbs,9999,0,9999,0
1668453442470,CSE 293,026,119411,Porter; George M,9999,0,9999,0
1668453442470,CSE 293,027,119414,Porter; Leonard Emerson,9999,0,9999,0
1668453442470,CSE 293,028,119416,Ramamoorthi; Ravi,9999,0,9999,0
1668453442470,CSE 293,029,119417,Sahoo; Debashis,9999,0,9999,0
1668453442470,CSE 293,030,119420,Saul; Lawrence,9999,0,9999,0
1668453442470,CSE 293,031,119421,Savage; Stefan,9999,0,9999,0
1668453442470,CSE 293,032,119425,Schulze; Jurgen P.,9999,0,9999,0
1668453442470,CSE 293,033,119426,Snoeren; Alex C.,9999,0,9999,0
1668453442470,CSE 293,034,119428,Shang; Jingbo,9999,0,9999,0
1668453442470,CSE 293,035,119430,Stefan; Deian,9999,0,9999,0
1668453442470,CSE 293,036,119431,Su; Hao,9999,0,9999,0
1668453442470,CSE 293,037,119433,Swanson; Steven James,9999,0,9999,0
1668453442470,CSE 293,038,119435,Tullsen; Dean Michael,9999,0,9999,0
1668453442470,CSE 293,039,119483,Voelker; Geoffrey M.,9999,0,9999,0
1668453442470,CSE 293,040,119537,Zhao; Jishen,9999,0,9999,0
1668453442470,CSE 293,041,119538,Zhou; Yuan-Yuan,9999,0,9999,0
1668453442470,CSE 293,042,119539,Gao; Sicun,9999,0,9999,0
1668453442470,CSE 293,043,119540,Weibel; Nadir,9999,0,9999,0
1668453442470,CSE 293,044,119541,Gupta; Rajesh K.,9999,0,9999,0
1668453442470,CSE 293,045,126410,Vaccaro; Kristen Marie,9999,0,9999,0
1668453442470,CSE 293,046,126411,Klemke; Richard,9999,0,9999,0
1668453442898,CSE 294,A00,102459,Voelker; Geoffrey M.,0,2,0,0
1668453442898,CSE 294,B00,111322,Orailoglu; Alex,0,0,0,0
1668453443322,DSE 201,A00,096914,Deutsch; Alin Bernard,30,0,30,0
1668453443750,DSE 210,A00,096915,Dasgupta; Sanjoy,30,0,30,0
1668453444190,DSE 260A,A00,096916,Altintas De Callaf; Ilkay,30,0,30,0
1668453444644,ECE 200,001,103586,Antipa; Nicholas A,9999,0,9999,0
1668453444644,ECE 200,002,103587,Atanasov; Nikolay A.,9999,0,9999,0
1668453444644,ECE 200,003,103588,Bharadia; Dinesh,9999,0,9999,0
1668453444644,ECE 200,004,103589,Cheng; Chung Kuan,9999,0,9999,0
1668453444644,ECE 200,005,103590,Cosman; Pamela C.,9999,0,9999,0
1668453444644,ECE 200,006,103591,Dayeh; Shadi Ahmad,9999,0,9999,0
1668453444644,ECE 200,007,103592,Fainman; Yeshaiahu,9999,0,9999,0
1668453444644,ECE 200,008,103593,Ford; Joseph Earl,9999,0,9999,0
1668453444644,ECE 200,009,103594,Franceschetti; Massimo,9999,0,9999,0
1668453444644,ECE 200,010,103595,Fullerton; Eric E,9999,0,9999,0
1668453444644,ECE 200,011,103596,Galton; Ian A,9999,0,9999,0
1668453444644,ECE 200,012,103597,Gilja; Vikash,9999,0,9999,0
1668453444644,ECE 200,013,103598,Hall; Drew A.,9999,0,9999,0
1668453444644,ECE 200,014,103599,Hsueh; Tzu-Chien,9999,0,9999,0
1668453444644,ECE 200,015,103600,Javidi; Tara,9999,0,9999,0
1668453444644,ECE 200,016,103601,Kahng; Andrew Byun,9999,0,9999,0
1668453444644,ECE 200,017,103602,Kim; Young-Han,9999,0,9999,0
1668453444644,ECE 200,018,103603,Koushanfar; Farinaz,9999,0,9999,0
1668453444644,ECE 200,019,103604,Kuzum; Duygu,9999,0,9999,0
1668453444644,ECE 200,020,103605,Le; Hanh-Phuc,9999,0,9999,0
1668453444644,ECE 200,021,103606,Lin; Bill,9999,0,9999,0
1668453444644,ECE 200,022,103607,Liu; Zhaowei,9998,0,9999,1
1668453444644,ECE 200,023,103608,Lo; Yu-Hwa,9999,0,9999,0
1668453444644,ECE 200,024,103609,Lomakin; Vitaliy,9999,0,9999,0
1668453444644,ECE 200,025,103610,Mercier; Patrick Philip,9999,0,9999,0
1668453444644,ECE 200,026,103611,Meyer; Florian,9999,0,9999,0
1668453444644,ECE 200,027,103612,Milstein; Laurence B.,9999,0,9999,0
1668453444644,ECE 200,028,103613,Mir Arabbaygi; Siavash,9999,0,9999,0
1668453444644,ECE 200,029,103614,Mookherjea; Shayan,9999,0,9999,0
1668453444644,ECE 200,030,103615,Morris; Karcher William,9999,0,9999,0
1668453444644,ECE 200,031,103616,Ng; Tse Nga,9999,0,9999,0
1668453444644,ECE 200,032,103617,Nguyen; Truong Quang,9999,0,9999,0
1668453444644,ECE 200,033,103618,Nomura; Kenji,9999,0,9999,0
1668453444644,ECE 200,034,103619,Orlitsky; Alon,9999,0,9999,0
1668453444644,ECE 200,035,103620,Pal; Piya,9999,0,9999,0
1668453444644,ECE 200,036,103621,Papen; George C.,9999,0,9999,0
1668453444644,ECE 200,037,103622,Radic; Stojan,9999,0,9999,0
1668453444644,ECE 200,038,103623,Rao; Bhaskar D.,9999,0,9999,0
1668453444644,ECE 200,039,103624,Rao; Ramesh R,9999,0,9999,0
1668453444644,ECE 200,040,103625,Rebeiz; Gabriel,9999,0,9999,0
1668453444644,ECE 200,041,103626,Sanford; John R,9999,0,9999,0
1668453444644,ECE 200,042,103627,Siegel; Paul H.,9999,0,9999,0
1668453444644,ECE 200,043,103628,Sievenpiper; Daniel F.,9999,0,9999,0
1668453444644,ECE 200,044,103629,Sworder; David D.,9999,0,9999,0
1668453444644,ECE 200,045,103630,Taur; Yuan,9999,0,9999,0
1668453444644,ECE 200,046,103631,Touri; Behrouz,9999,0,9999,0
1668453444644,ECE 200,047,103632,Trivedi; Mohan M.,9999,0,9999,0
1668453444644,ECE 200,048,103633,Vasconcelos; Nuno,9999,0,9999,0
1668453444644,ECE 200,049,103634,Wang; Xiaolong,9999,0,9999,0
1668453444644,ECE 200,050,103635,Xie; Pengtao,9999,0,9999,0
1668453444644,ECE 200,051,103636,Yip; Michael,9999,0,9999,0
1668453444644,ECE 200,052,103637,Zeger; Kenneth A.,999,0,999,0
1668453444644,ECE 200,053,103638,Zhang; Xinyu,9999,0,9999,0
1668453444644,ECE 200,054,103639,Turakhia; Yatish Girish,9999,0,9999,0
1668453444644,ECE 200,055,103640,Kang; Mingu,9999,0,9999,0
1668453444644,ECE 200,056,103641,Shi; Yuanyuan,9999,0,9999,0
1668453444644,ECE 200,057,103642,Wang; Edward Jay,9999,0,9999,0
1668453444644,ECE 200,058,103643,Zheng; Yang,9999,0,9999,0
1668453445074,ECE 202,A00,103644,Kuzum; Duygu,0,31,0,0
1668453445501,ECE 212BN,A00,103646,Ng; Tse Nga,0,3,0,0
1668453445931,ECE 221,A00,111493,Staff,0,0,0,0
1668453446355,ECE 222B,A00,103647,Lomakin; Vitaliy,0,7,0,0
1668453446788,ECE 230B,A00,103648,Taur; Yuan,0,2,0,0
1668453447213,ECE 238B,A00,103649,Garay; Javier,0,0,0,0
1668453447639,ECE 240B,A00,112900,Fainman; Yeshaiahu,0,4,0,0
1668453448063,ECE 247A,A00,103650,Jokerst; Jesse Vincent,0,2,0,0
1668453448488,ECE 247B,A00,103651,Wang; Joseph,0,8,0,0
1668453448923,ECE 250,A00,103652,Siegel; Paul H.,0,56,0,0
1668453449349,ECE 251A,A00,103654,Rao; Bhaskar D.,0,41,0,0
1668453449774,ECE 257B,A00,103655,Bharadia; Dinesh,0,23,0,0
1668453450198,ECE 258A,A00,103656,Milstein; Laurence B.,0,21,0,0
1668453450623,ECE 260B,A00,103658,Kang; Mingu,0,97,0,0
1668453451056,ECE 264A,A00,103659,Galton; Ian A,0,55,0,0
1668453451479,ECE 265A,A00,103661,Gudem; Prasad S.S.,0,31,0,0
1668453451902,ECE 265D,A00,103662,Gudem; Prasad S.S.,0,18,0,0
1668453452325,ECE 268,A00,103663,Koushanfar; Farinaz,0,33,0,0
1668453452766,ECE 269,A01,103665,Pal; Piya,0,162,0,0
1668453453199,ECE 271B,A00,103666,Vasconcelos; Manuela,0,55,0,0
1668453453632,ECE 276A,A00,103667,Atanasov; Nikolay A.,0,87,0,0
1668453454062,ECE 277,A00,103668,An; Cheolhong,0,114,0,0
1668453454489,ECE 279,A00,117947,Hall; Drew A.,0,16,0,0
1668453455343,ECE 283,A00,103670,Hsueh; Tzu-Chien,0,37,0,0
1668453455770,ECE 284,A00,103671,Turakhia; Yatish Girish,0,31,0,0
1668453456208,ECE 285,A00,103672,Zheng; Yang,0,28,0,0
1668453456208,ECE 285,B00,103673,Sworder; David D.,0,44,0,0
1668453456630,ECE 287,A00,103676,Javidi; Tara,0,6,0,0
1668453457054,MATH 200B,A00,098023,Salehi Golsefidy; Alireza,12,0,15,3
1668453457478,MATH 202B,A00,098024,Rhoades; Brendon Patrick,9,0,15,6
1668453457917,MATH 203B,A00,098025,Oprea; Dragos N.,10,0,15,5
1668453458362,MATH 204B,A00,098026,Sorensen; Claus M,13,0,15,2
1668453458795,MATH 208,A00,098027,Izadi; Elham,7,0,10,3
1668453459221,MATH 209,A00,098028,Pollack; Aaron,10,0,10,0
1668453459648,MATH 211A,A00,112919,Rogalski; Daniel,9,0,10,1
1668453460074,MATH 211B,A00,112920,Seward; Brandon M.,9,0,10,1
1668453460501,MATH 218,A00,098029,Li; Bo,10,0,10,0
1668453460934,MATH 220B,A00,098030,Novak; Jonathan I,11,0,15,4
1668453461364,MATH 221A,A00,098031,Ebenfelt; Peter F,13,0,15,2
1668453461797,MATH 231B,A00,098032,Zlatos; Andrej,11,0,15,4
1668453462220,MATH 240B,A00,098033,Ni; Lei,9,0,15,6
1668453462645,MATH 243,A00,098034,Jekel; David Andrew,10,0,10,0
1668453463079,MATH 245A,A00,098035,Nie; Jiawang,0,2,15,16
1668453463502,MATH 248,A00,098036,Bejenaru; Ioan,10,0,10,0
1668453463942,MATH 250B,A00,098037,Spolaor; Luca,14,0,15,1
1668453464370,MATH 258,A00,098038,Ni; Lei,10,0,10,0
1668453464796,MATH 264B,A00,098041,Rhoades; Brendon Patrick,9,0,15,6
1668453465219,MATH 268,A00,098042,Buss; Samuel R,10,0,10,0
1668453465646,MATH 269,A00,098043,Rhoades; Brendon Patrick,10,0,10,0
1668453466074,MATH 270B,A00,098044,Li; Bo,10,0,15,5
1668453466506,MATH 272B,A00,098045,Holst; Michael J,13,0,15,2
1668453466931,MATH 273A,A00,098046,Tian; Xiaochuan,10,0,15,5
1668453467355,MATH 275,A01,098048,Tian; Xiaochuan,6,0,10,4
1668453467778,MATH 278A,A00,098049,Holst; Michael J,8,0,10,2
1668453468205,MATH 278B,A00,098050,Cloninger; Alexander,10,0,10,0
1668453468630,MATH 278C,A00,098051,Nie; Jiawang,6,0,10,4
1668453469062,MATH 280B,A00,098052,Zheng; Tianyi,7,0,15,8
1668453469486,MATH 281B,A00,098053,Bradic; Jelena,0,2,15,15
1668453469909,MATH 282B,A00,098054,Arias-Castro; Ery,0,0,15,15
1668453470341,MATH 285,A00,098055,Fitzsimmons; Patrick J,0,1,15,17
1668453470843,MATH 287B,A00,098056,Arias-Castro; Ery,2,0,15,13
1668453471274,MATH 288,A00,098057,Agarwal; Pooja,9,0,10,1
1668453471274,MATH 288,B00,098058,Zhang; Danna,8,0,10,2
1668453471274,MATH 288,C00,098059,Williams; Ruth J,9,0,10,1
1668453471701,MATH 290B,A00,098060,Roberts; Justin Deritter,13,0,15,2
1668453472130,MATH 292,A00,098061,Belmont; Eva Kinoshita,10,0,10,0
1668453472555,MATH 295,A00,098062,Suk; Andrew Hoon,48,0,50,2
1668453472981,MATH 296,A00,098063,Novak; Jonathan I,20,0,20,0
1668453473405,MATH 297,001,098064,Gamst; Anthony Collins,9997,0,9999,2
1668453976706,COGS 205,A00,101395,Chiba; Andrea,19,0,20,1
1668453977133,COGS 210B,001,101404,Greene; Deanna Jacquelyn,9998,0,9999,1
1668453977133,COGS 210B,002,101417,Xia; Haijun,9999,0,9999,0
1668453977133,COGS 210B,003,101422,Nitz; Douglas A.,9999,0,9999,0
1668453977133,COGS 210B,004,101423,Hollan; James D.,9998,0,9999,1
1668453977133,COGS 210B,005,101424,Deak; Gedeon O.,9998,0,9999,1
1668453977133,COGS 210B,006,101425,Rossano; Federico,9999,0,9999,0
1668453977557,COGS 211B,A00,101427,Coulson; Seana M,9996,0,9999,3
1668453977998,COGS 220,A00,101428,Hollan; James D.,1,5,25,24
1668453978437,COGS 229,A00,101429,Dow; Steven P,18,0,25,7
1668453978866,COGS 230,A00,101430,Klemmer; Scott R,9,0,17,8
1668453979292,COGS 234,A00,101431,Xia; Haijun,2,0,25,23
1668453979725,COGS 260,A00,101432,Kiyonaga; Anastasia,21,0,25,4
1668453979725,COGS 260,B00,101433,Kirsh; David Joel,15,0,25,10
1668453980149,CSE 202,A00,102371,Impagliazzo; Russell,0,47,0,0
1668453980578,CSE 203B,A01,102373,Cheng; Chung Kuan,0,34,0,0
1668453981005,CSE 208,A00,102374,Micciancio; Daniele,0,2,0,0
1668453981429,CSE 209A,A00,112895,Impagliazzo; Russell,0,7,15,15
1668453981854,CSE 209B,A00,108005,Bellare; Mihir,0,3,0,0
1668453982280,CSE 210,A00,113163,Coblenz; Michael J,0,58,0,0
1668453982703,CSE 219,A00,106111,Dow; Steven P,0,2,20,20
1668453983134,CSE 221,A00,102376,Voelker; Geoffrey M.,0,42,0,0
1668453983558,CSE 224,A01,102378,Porter; George M,0,123,0,0
1668453983987,CSE 229A,A00,102379,Savage; Stefan,0,5,0,0
1668453984412,CSE 229C,A00,102380,Munyaka; Imani N. S.,0,5,0,0
1668453984837,CSE 232B,A00,102382,Deutsch; Alin Bernard,0,22,0,0
1668453985272,CSE 234,A01,112904,Kumar; Arun Kumar,0,0,0,0
1668453985696,CSE 237A,A00,102383,Rosing; Tajana Simunic,0,42,0,0
1668453986122,CSE 239A,A00,102384,Deutsch; Alin Bernard,0,6,0,0
1668453986551,CSE 239B,A00,102385,Polikarpova; Nadezhda,0,7,0,0
1668453986985,CSE 240A,A00,102386,Pannuto; Patrick William,0,36,0,0
1668453987407,CSE 240B,A00,102387,Zhao; Jishen,0,34,0,0
1668453987833,CSE 241A,A00,106406,Kang; Mingu,0,6,0,0
1668453988258,CSE 249B,A00,102388,Kahng; Andrew Byun,0,3,8,8
1668453988684,CSE 251B,A01,102392,Cottrell; Garrison W,0,31,0,0
1668453988684,CSE 251B,A02,102393,Cottrell; Garrison W,0,27,0,0
1668453989116,CSE 252B,A00,102394,Ochoa; Benjamin Lawrence,0,42,0,0
1668453989542,CSE 257,A01,102396,Gao; Sicun,0,100,0,0
1668453989973,CSE 272,A00,102397,Li; Tzumao,0,9,0,0
1668453990395,CSE 274,A00,111323,Chern; Albert Ren-Haur,0,8,0,0
1668453990826,CSE 282,A00,102398,Pevzner; Pavel Arkadjevich,0,0,0,0
1668453991249,CSE 284,A00,114175,Gymrek; Melissa Ann,0,15,0,0
1668453991690,CSE 290,A00,102399,Chandraker; Manmohan Krishna,0,7,0,0
1668453991690,CSE 290,B00,102400,Vaccaro; Kristen Marie,0,4,25,25
1668453991690,CSE 290,C00,102414,Pannuto; Patrick William,0,1,25,25
1668453991690,CSE 290,D00,102427,Pevzner; Pavel Arkadjevich,0,0,0,0
1668453991690,CSE 290,E00,102429,Zhao; Jishen,0,2,0,0
1668453991690,CSE 290,F00,102436,Tullsen; Dean Michael,0,4,0,0
1668453991690,CSE 290,G00,102440,Christensen; Henrik I,0,4,20,20
1668453992131,CSE 291,A00,102443,Su; Hao,0,0,0,0
1668453992131,CSE 291,B00,102448,Polikarpova; Nadezhda,0,0,0,0
1668453992131,CSE 291,C00,102453,Vaccaro; Kristen Marie,0,0,0,0
1668453992131,CSE 291,D00,111343,Savage; Stefan,0,0,0,0
1668453992131,CSE 291,E00,116474,Claffy; Kimberly Claire,0,0,0,0
1668453992131,CSE 291,F00,116479,Pasquale; Joseph,0,0,0,0
1668453992559,CSE 293,001,119111,Bafna; Vineet,9999,0,9999,0
1668453992559,CSE 293,002,119118,Bellare; Mihir,9999,0,9999,0
1668453992559,CSE 293,003,119122,Berg-Kirkpatrick; Taylor D,9999,0,9999,0
1668453992559,CSE 293,004,119135,Christensen; Henrik I,9999,0,9999,0
1668453992559,CSE 293,005,119142,Cottrell; Garrison W,9999,0,9999,0
1668453992559,CSE 293,006,119146,Deutsch; Alin Bernard,9999,0,9999,0
1668453992559,CSE 293,007,119159,Esmaeilzadeh; Hadi,9999,0,9999,0
1668453992559,CSE 293,008,119166,Freund; Yoav,9999,0,9999,0
1668453992559,CSE 293,009,119170,Griswold; William G.,9999,0,9999,0
1668453992559,CSE 293,010,119183,Gymrek; Melissa Ann,9999,0,9999,0
1668453992559,CSE 293,011,119190,Heninger; Nadia A,9999,0,9999,0
1668453992559,CSE 293,012,119230,Impagliazzo; Russell,9999,0,9999,0
1668453992559,CSE 293,013,119232,Jhala; Ranjit,9999,0,9999,0
1668453992559,CSE 293,014,119233,Kahng; Andrew Byun,9999,0,9999,0
1668453992559,CSE 293,015,119298,Kane; Daniel Mertz,9999,0,9999,0
1668453992559,CSE 293,016,119299,Kriegman; David J,9999,0,9999,0
1668453992559,CSE 293,017,119300,Kumar; Arun Kumar,9999,0,9999,0
1668453992559,CSE 293,018,119301,Lerner; Sorin,9999,0,9999,0
1668453992559,CSE 293,019,119302,Lovett; Shachar,9999,0,9999,0
1668453992559,CSE 293,020,119303,McAuley; Julian John,9999,0,9999,0
1668453992559,CSE 293,021,119304,Micciancio; Daniele,9999,0,9999,0
1668453992559,CSE 293,022,119367,Orailoglu; Alex,9999,0,9999,0
1668453992559,CSE 293,023,119382,Paturi; Ramamohan,9999,0,9999,0
1668453992559,CSE 293,024,119404,Polikarpova; Nadezhda,9999,0,9999,0
1668453992559,CSE 293,025,119406,Politz; Joseph Gibbs,9999,0,9999,0
1668453992559,CSE 293,026,119411,Porter; George M,9999,0,9999,0
1668453992559,CSE 293,027,119414,Porter; Leonard Emerson,9999,0,9999,0
1668453992559,CSE 293,028,119416,Ramamoorthi; Ravi,9999,0,9999,0
1668453992559,CSE 293,029,119417,Sahoo; Debashis,9999,0,9999,0
1668453992559,CSE 293,030,119420,Saul; Lawrence,9999,0,9999,0
1668453992559,CSE 293,031,119421,Savage; Stefan,9999,0,9999,0
1668453992559,CSE 293,032,119425,Schulze; Jurgen P.,9999,0,9999,0
1668453992559,CSE 293,033,119426,Snoeren; Alex C.,9999,0,9999,0
1668453992559,CSE 293,034,119428,Shang; Jingbo,9999,0,9999,0
1668453992559,CSE 293,035,119430,Stefan; Deian,9999,0,9999,0
1668453992559,CSE 293,036,119431,Su; Hao,9999,0,9999,0
1668453992559,CSE 293,037,119433,Swanson; Steven James,9999,0,9999,0
1668453992559,CSE 293,038,119435,Tullsen; Dean Michael,9999,0,9999,0
1668453992559,CSE 293,039,119483,Voelker; Geoffrey M.,9999,0,9999,0
1668453992559,CSE 293,040,119537,Zhao; Jishen,9999,0,9999,0
1668453992559,CSE 293,041,119538,Zhou; Yuan-Yuan,9999,0,9999,0
1668453992559,CSE 293,042,119539,Gao; Sicun,9999,0,9999,0
1668453992559,CSE 293,043,119540,Weibel; Nadir,9999,0,9999,0
1668453992559,CSE 293,044,119541,Gupta; Rajesh K.,9999,0,9999,0
1668453992559,CSE 293,045,126410,Vaccaro; Kristen Marie,9999,0,9999,0
1668453992559,CSE 293,046,126411,Klemke; Richard,9999,0,9999,0
1668453992987,CSE 294,A00,102459,Voelker; Geoffrey M.,0,2,0,0
1668453992987,CSE 294,B00,111322,Orailoglu; Alex,0,1,0,0
1668453993489,DSE 201,A00,096914,Deutsch; Alin Bernard,30,0,30,0
1668453993912,DSE 210,A00,096915,Dasgupta; Sanjoy,30,0,30,0
1668453994344,DSE 260A,A00,096916,Altintas De Callaf; Ilkay,30,0,30,0
1668453994790,ECE 200,001,103586,Antipa; Nicholas A,9999,0,9999,0
1668453994790,ECE 200,002,103587,Atanasov; Nikolay A.,9999,0,9999,0
1668453994790,ECE 200,003,103588,Bharadia; Dinesh,9999,0,9999,0
1668453994790,ECE 200,004,103589,Cheng; Chung Kuan,9999,0,9999,0
1668453994790,ECE 200,005,103590,Cosman; Pamela C.,9999,0,9999,0
1668453994790,ECE 200,006,103591,Dayeh; Shadi Ahmad,9999,0,9999,0
1668453994790,ECE 200,007,103592,Fainman; Yeshaiahu,9999,0,9999,0
1668453994790,ECE 200,008,103593,Ford; Joseph Earl,9999,0,9999,0
1668453994790,ECE 200,009,103594,Franceschetti; Massimo,9999,0,9999,0
1668453994790,ECE 200,010,103595,Fullerton; Eric E,9999,0,9999,0
1668453994790,ECE 200,011,103596,Galton; Ian A,9999,0,9999,0
1668453994790,ECE 200,012,103597,Gilja; Vikash,9999,0,9999,0
1668453994790,ECE 200,013,103598,Hall; Drew A.,9999,0,9999,0
1668453994790,ECE 200,014,103599,Hsueh; Tzu-Chien,9999,0,9999,0
1668453994790,ECE 200,015,103600,Javidi; Tara,9999,0,9999,0
1668453994790,ECE 200,016,103601,Kahng; Andrew Byun,9999,0,9999,0
1668453994790,ECE 200,017,103602,Kim; Young-Han,9999,0,9999,0
1668453994790,ECE 200,018,103603,Koushanfar; Farinaz,9999,0,9999,0
1668453994790,ECE 200,019,103604,Kuzum; Duygu,9999,0,9999,0
1668453994790,ECE 200,020,103605,Le; Hanh-Phuc,9999,0,9999,0
1668453994790,ECE 200,021,103606,Lin; Bill,9999,0,9999,0
1668453994790,ECE 200,022,103607,Liu; Zhaowei,9998,0,9999,1
1668453994790,ECE 200,023,103608,Lo; Yu-Hwa,9999,0,9999,0
1668453994790,ECE 200,024,103609,Lomakin; Vitaliy,9999,0,9999,0
1668453994790,ECE 200,025,103610,Mercier; Patrick Philip,9999,0,9999,0
1668453994790,ECE 200,026,103611,Meyer; Florian,9999,0,9999,0
1668453994790,ECE 200,027,103612,Milstein; Laurence B.,9999,0,9999,0
1668453994790,ECE 200,028,103613,Mir Arabbaygi; Siavash,9999,0,9999,0
1668453994790,ECE 200,029,103614,Mookherjea; Shayan,9999,0,9999,0
1668453994790,ECE 200,030,103615,Morris; Karcher William,9999,0,9999,0
1668453994790,ECE 200,031,103616,Ng; Tse Nga,9999,0,9999,0
1668453994790,ECE 200,032,103617,Nguyen; Truong Quang,9999,0,9999,0
1668453994790,ECE 200,033,103618,Nomura; Kenji,9999,0,9999,0
1668453994790,ECE 200,034,103619,Orlitsky; Alon,9999,0,9999,0
1668453994790,ECE 200,035,103620,Pal; Piya,9999,0,9999,0
1668453994790,ECE 200,036,103621,Papen; George C.,9999,0,9999,0
1668453994790,ECE 200,037,103622,Radic; Stojan,9999,0,9999,0
1668453994790,ECE 200,038,103623,Rao; Bhaskar D.,9999,0,9999,0
1668453994790,ECE 200,039,103624,Rao; Ramesh R,9999,0,9999,0
1668453994790,ECE 200,040,103625,Rebeiz; Gabriel,9999,0,9999,0
1668453994790,ECE 200,041,103626,Sanford; John R,9999,0,9999,0
1668453994790,ECE 200,042,103627,Siegel; Paul H.,9999,0,9999,0
1668453994790,ECE 200,043,103628,Sievenpiper; Daniel F.,9999,0,9999,0
1668453994790,ECE 200,044,103629,Sworder; David D.,9999,0,9999,0
1668453994790,ECE 200,045,103630,Taur; Yuan,9999,0,9999,0
1668453994790,ECE 200,046,103631,Touri; Behrouz,9999,0,9999,0
1668453994790,ECE 200,047,103632,Trivedi; Mohan M.,9999,0,9999,0
1668453994790,ECE 200,048,103633,Vasconcelos; Nuno,9999,0,9999,0
1668453994790,ECE 200,049,103634,Wang; Xiaolong,9999,0,9999,0
1668453994790,ECE 200,050,103635,Xie; Pengtao,9999,0,9999,0
1668453994790,ECE 200,051,103636,Yip; Michael,9999,0,9999,0
1668453994790,ECE 200,052,103637,Zeger; Kenneth A.,999,0,999,0
1668453994790,ECE 200,053,103638,Zhang; Xinyu,9999,0,9999,0
1668453994790,ECE 200,054,103639,Turakhia; Yatish Girish,9999,0,9999,0
1668453994790,ECE 200,055,103640,Kang; Mingu,9999,0,9999,0
1668453994790,ECE 200,056,103641,Shi; Yuanyuan,9999,0,9999,0
1668453994790,ECE 200,057,103642,Wang; Edward Jay,9999,0,9999,0
1668453994790,ECE 200,058,103643,Zheng; Yang,9999,0,9999,0
1668453995235,ECE 202,A00,103644,Kuzum; Duygu,0,32,0,0
1668453995658,ECE 212BN,A00,103646,Ng; Tse Nga,0,3,0,0
1668453996087,ECE 221,A00,111493,Staff,0,0,0,0
1668453996513,ECE 222B,A00,103647,Lomakin; Vitaliy,0,8,0,0
1668453996944,ECE 230B,A00,103648,Taur; Yuan,0,2,0,0
1668453997371,ECE 238B,A00,103649,Garay; Javier,0,0,0,0
1668453997809,ECE 240B,A00,112900,Fainman; Yeshaiahu,0,4,0,0
1668453998234,ECE 247A,A00,103650,Jokerst; Jesse Vincent,0,2,0,0
1668453998657,ECE 247B,A00,103651,Wang; Joseph,0,8,0,0
1668453999080,ECE 250,A00,103652,Siegel; Paul H.,0,56,0,0
1668453999514,ECE 251A,A00,103654,Rao; Bhaskar D.,0,41,0,0
1668453999945,ECE 257B,A00,103655,Bharadia; Dinesh,0,24,0,0
1668454000382,ECE 258A,A00,103656,Milstein; Laurence B.,0,21,0,0
1668454000810,ECE 260B,A00,103658,Kang; Mingu,0,98,0,0
1668454001235,ECE 264A,A00,103659,Galton; Ian A,0,54,0,0
1668454001674,ECE 265A,A00,103661,Gudem; Prasad S.S.,0,32,0,0
1668454002111,ECE 265D,A00,103662,Gudem; Prasad S.S.,0,18,0,0
1668454002535,ECE 268,A00,103663,Koushanfar; Farinaz,0,33,0,0
1668454002964,ECE 269,A01,103665,Pal; Piya,0,162,0,0
1668454003397,ECE 271B,A00,103666,Vasconcelos; Manuela,0,55,0,0
1668454003824,ECE 276A,A00,103667,Atanasov; Nikolay A.,0,87,0,0
1668454004263,ECE 277,A00,103668,An; Cheolhong,0,114,0,0
1668454004686,ECE 279,A00,117947,Hall; Drew A.,0,17,0,0
1668454005532,ECE 283,A00,103670,Hsueh; Tzu-Chien,0,38,0,0
1668454005960,ECE 284,A00,103671,Turakhia; Yatish Girish,0,31,0,0
1668454006388,ECE 285,A00,103672,Zheng; Yang,0,28,0,0
1668454006388,ECE 285,B00,103673,Sworder; David D.,0,44,0,0
1668454006814,ECE 287,A00,103676,Javidi; Tara,0,6,0,0
1668454007239,MATH 200B,A00,098023,Salehi Golsefidy; Alireza,12,0,15,3
1668454007662,MATH 202B,A00,098024,Rhoades; Brendon Patrick,9,0,15,6
1668454008091,MATH 203B,A00,098025,Oprea; Dragos N.,10,0,15,5
1668454008517,MATH 204B,A00,098026,Sorensen; Claus M,13,0,15,2
1668454008942,MATH 208,A00,098027,Izadi; Elham,7,0,10,3
1668454009364,MATH 209,A00,098028,Pollack; Aaron,10,0,10,0
1668454009790,MATH 211A,A00,112919,Rogalski; Daniel,9,0,10,1
1668454010216,MATH 211B,A00,112920,Seward; Brandon M.,9,0,10,1
1668454010645,MATH 218,A00,098029,Li; Bo,10,0,10,0
1668454011069,MATH 220B,A00,098030,Novak; Jonathan I,11,0,15,4
1668454011493,MATH 221A,A00,098031,Ebenfelt; Peter F,13,0,15,2
1668454011920,MATH 231B,A00,098032,Zlatos; Andrej,11,0,15,4
1668454012351,MATH 240B,A00,098033,Ni; Lei,9,0,15,6
1668454012776,MATH 243,A00,098034,Jekel; David Andrew,10,0,10,0
1668454013199,MATH 245A,A00,098035,Nie; Jiawang,0,2,15,16
1668454013624,MATH 248,A00,098036,Bejenaru; Ioan,10,0,10,0
1668454014045,MATH 250B,A00,098037,Spolaor; Luca,14,0,15,1
1668454014467,MATH 258,A00,098038,Ni; Lei,10,0,10,0
1668454014896,MATH 264B,A00,098041,Rhoades; Brendon Patrick,9,0,15,6
1668454015320,MATH 268,A00,098042,Buss; Samuel R,10,0,10,0
1668454015747,MATH 269,A00,098043,Rhoades; Brendon Patrick,10,0,10,0
1668454016173,MATH 270B,A00,098044,Li; Bo,10,0,15,5
1668454016597,MATH 272B,A00,098045,Holst; Michael J,13,0,15,2
1668454017019,MATH 273A,A00,098046,Tian; Xiaochuan,10,0,15,5
1668454017445,MATH 275,A01,098048,Tian; Xiaochuan,6,0,10,4
1668454017869,MATH 278A,A00,098049,Holst; Michael J,8,0,10,2
1668454018298,MATH 278B,A00,098050,Cloninger; Alexander,10,0,10,0
1668454018731,MATH 278C,A00,098051,Nie; Jiawang,6,0,10,4
1668454019161,MATH 280B,A00,098052,Zheng; Tianyi,7,0,15,8
1668454019585,MATH 281B,A00,098053,Bradic; Jelena,0,2,15,15
1668454020010,MATH 282B,A00,098054,Arias-Castro; Ery,0,0,15,15
1668454020435,MATH 285,A00,098055,Fitzsimmons; Patrick J,0,1,15,17
1668454020860,MATH 287B,A00,098056,Arias-Castro; Ery,2,0,15,13
1668454021284,MATH 288,A00,098057,Agarwal; Pooja,9,0,10,1
1668454021284,MATH 288,B00,098058,Zhang; Danna,8,0,10,2
1668454021284,MATH 288,C00,098059,Williams; Ruth J,9,0,10,1
1668454021711,MATH 290B,A00,098060,Roberts; Justin Deritter,13,0,15,2
1668454022143,MATH 292,A00,098061,Belmont; Eva Kinoshita,10,0,10,0
1668454022570,MATH 295,A00,098062,Suk; Andrew Hoon,48,0,50,2
1668454023002,MATH 296,A00,098063,Novak; Jonathan I,20,0,20,0
1668454023424,MATH 297,001,098064,Gamst; Anthony Collins,9997,0,9999,2
1668454537107,COGS 205,A00,101395,Chiba; Andrea,19,0,20,1
1668454537537,COGS 210B,001,101404,Greene; Deanna Jacquelyn,9998,0,9999,1
1668454537537,COGS 210B,002,101417,Xia; Haijun,9999,0,9999,0
1668454537537,COGS 210B,003,101422,Nitz; Douglas A.,9999,0,9999,0
1668454537537,COGS 210B,004,101423,Hollan; James D.,9998,0,9999,1
1668454537537,COGS 210B,005,101424,Deak; Gedeon O.,9998,0,9999,1
1668454537537,COGS 210B,006,101425,Rossano; Federico,9999,0,9999,0
1668454537966,COGS 211B,A00,101427,Coulson; Seana M,9996,0,9999,3
1668454538390,COGS 220,A00,101428,Hollan; James D.,1,5,25,24
1668454538813,COGS 229,A00,101429,Dow; Steven P,18,0,25,7
1668454539242,COGS 230,A00,101430,Klemmer; Scott R,9,0,17,8
1668454539667,COGS 234,A00,101431,Xia; Haijun,2,0,25,23
1668454540092,COGS 260,A00,101432,Kiyonaga; Anastasia,21,0,25,4
1668454540092,COGS 260,B00,101433,Kirsh; David Joel,15,0,25,10
1668454540516,CSE 202,A00,102371,Impagliazzo; Russell,0,46,0,0
1668454540948,CSE 203B,A01,102373,Cheng; Chung Kuan,0,34,0,0
1668454541387,CSE 208,A00,102374,Micciancio; Daniele,0,3,0,0
1668454541813,CSE 209A,A00,112895,Impagliazzo; Russell,0,8,15,15
1668454542250,CSE 209B,A00,108005,Bellare; Mihir,0,4,0,0
1668454542675,CSE 210,A00,113163,Coblenz; Michael J,0,57,0,0
1668454543104,CSE 219,A00,106111,Dow; Steven P,0,2,20,20
1668454543532,CSE 221,A00,102376,Voelker; Geoffrey M.,0,43,0,0
1668454543964,CSE 224,A01,102378,Porter; George M,0,123,0,0
1668454544396,CSE 229A,A00,102379,Savage; Stefan,0,6,0,0
1668454544819,CSE 229C,A00,102380,Munyaka; Imani N. S.,0,6,0,0
1668454545247,CSE 232B,A00,102382,Deutsch; Alin Bernard,0,22,0,0
1668454545670,CSE 234,A01,112904,Kumar; Arun Kumar,0,0,0,0
1668454546094,CSE 237A,A00,102383,Rosing; Tajana Simunic,0,42,0,0
1668454546521,CSE 239A,A00,102384,Deutsch; Alin Bernard,0,7,0,0
1668454546946,CSE 239B,A00,102385,Polikarpova; Nadezhda,0,7,0,0
1668454547379,CSE 240A,A00,102386,Pannuto; Patrick William,0,36,0,0
1668454547802,CSE 240B,A00,102387,Zhao; Jishen,0,35,0,0
1668454548227,CSE 241A,A00,106406,Kang; Mingu,0,6,0,0
1668454548649,CSE 249B,A00,102388,Kahng; Andrew Byun,0,3,8,8
1668454549074,CSE 251B,A01,102392,Cottrell; Garrison W,0,31,0,0
1668454549074,CSE 251B,A02,102393,Cottrell; Garrison W,0,27,0,0
1668454549499,CSE 252B,A00,102394,Ochoa; Benjamin Lawrence,0,42,0,0
1668454549921,CSE 257,A01,102396,Gao; Sicun,0,101,0,0
1668454550347,CSE 272,A00,102397,Li; Tzumao,0,9,0,0
1668454550774,CSE 274,A00,111323,Chern; Albert Ren-Haur,0,8,0,0
1668454551208,CSE 282,A00,102398,Pevzner; Pavel Arkadjevich,0,0,0,0
1668454551641,CSE 284,A00,114175,Gymrek; Melissa Ann,0,15,0,0
1668454552067,CSE 290,A00,102399,Chandraker; Manmohan Krishna,0,7,0,0
1668454552067,CSE 290,B00,102400,Vaccaro; Kristen Marie,0,5,25,25
1668454552067,CSE 290,C00,102414,Pannuto; Patrick William,0,1,25,25
1668454552067,CSE 290,D00,102427,Pevzner; Pavel Arkadjevich,0,0,0,0
1668454552067,CSE 290,E00,102429,Zhao; Jishen,0,2,0,0
1668454552067,CSE 290,F00,102436,Tullsen; Dean Michael,0,4,0,0
1668454552067,CSE 290,G00,102440,Christensen; Henrik I,0,4,20,20
1668454552493,CSE 291,A00,102443,Su; Hao,0,0,0,0
1668454552493,CSE 291,B00,102448,Polikarpova; Nadezhda,0,0,0,0
1668454552493,CSE 291,C00,102453,Vaccaro; Kristen Marie,0,0,0,0
1668454552493,CSE 291,D00,111343,Savage; Stefan,0,0,0,0
1668454552493,CSE 291,E00,116474,Claffy; Kimberly Claire,0,0,0,0
1668454552493,CSE 291,F00,116479,Pasquale; Joseph,0,0,0,0
1668454552922,CSE 293,001,119111,Bafna; Vineet,9999,0,9999,0
1668454552922,CSE 293,002,119118,Bellare; Mihir,9999,0,9999,0
1668454552922,CSE 293,003,119122,Berg-Kirkpatrick; Taylor D,9999,0,9999,0
1668454552922,CSE 293,004,119135,Christensen; Henrik I,9999,0,9999,0
1668454552922,CSE 293,005,119142,Cottrell; Garrison W,9999,0,9999,0
1668454552922,CSE 293,006,119146,Deutsch; Alin Bernard,9999,0,9999,0
1668454552922,CSE 293,007,119159,Esmaeilzadeh; Hadi,9999,0,9999,0
1668454552922,CSE 293,008,119166,Freund; Yoav,9999,0,9999,0
1668454552922,CSE 293,009,119170,Griswold; William G.,9999,0,9999,0
1668454552922,CSE 293,010,119183,Gymrek; Melissa Ann,9999,0,9999,0
1668454552922,CSE 293,011,119190,Heninger; Nadia A,9999,0,9999,0
1668454552922,CSE 293,012,119230,Impagliazzo; Russell,9999,0,9999,0
1668454552922,CSE 293,013,119232,Jhala; Ranjit,9999,0,9999,0
1668454552922,CSE 293,014,119233,Kahng; Andrew Byun,9999,0,9999,0
1668454552922,CSE 293,015,119298,Kane; Daniel Mertz,9999,0,9999,0
1668454552922,CSE 293,016,119299,Kriegman; David J,9999,0,9999,0
1668454552922,CSE 293,017,119300,Kumar; Arun Kumar,9999,0,9999,0
1668454552922,CSE 293,018,119301,Lerner; Sorin,9999,0,9999,0
1668454552922,CSE 293,019,119302,Lovett; Shachar,9999,0,9999,0
1668454552922,CSE 293,020,119303,McAuley; Julian John,9999,0,9999,0
1668454552922,CSE 293,021,119304,Micciancio; Daniele,9999,0,9999,0
1668454552922,CSE 293,022,119367,Orailoglu; Alex,9999,0,9999,0
1668454552922,CSE 293,023,119382,Paturi; Ramamohan,9999,0,9999,0
1668454552922,CSE 293,024,119404,Polikarpova; Nadezhda,9999,0,9999,0
1668454552922,CSE 293,025,119406,Politz; Joseph Gibbs,9999,0,9999,0
1668454552922,CSE 293,026,119411,Porter; George M,9999,0,9999,0
1668454552922,CSE 293,027,119414,Porter; Leonard Emerson,9999,0,9999,0
1668454552922,CSE 293,028,119416,Ramamoorthi; Ravi,9999,0,9999,0
1668454552922,CSE 293,029,119417,Sahoo; Debashis,9999,0,9999,0
1668454552922,CSE 293,030,119420,Saul; Lawrence,9999,0,9999,0
1668454552922,CSE 293,031,119421,Savage; Stefan,9999,0,9999,0
1668454552922,CSE 293,032,119425,Schulze; Jurgen P.,9999,0,9999,0
1668454552922,CSE 293,033,119426,Snoeren; Alex C.,9999,0,9999,0
1668454552922,CSE 293,034,119428,Shang; Jingbo,9999,0,9999,0
1668454552922,CSE 293,035,119430,Stefan; Deian,9999,0,9999,0
1668454552922,CSE 293,036,119431,Su; Hao,9999,0,9999,0
1668454552922,CSE 293,037,119433,Swanson; Steven James,9999,0,9999,0
1668454552922,CSE 293,038,119435,Tullsen; Dean Michael,9999,0,9999,0
1668454552922,CSE 293,039,119483,Voelker; Geoffrey M.,9999,0,9999,0
1668454552922,CSE 293,040,119537,Zhao; Jishen,9999,0,9999,0
1668454552922,CSE 293,041,119538,Zhou; Yuan-Yuan,9999,0,9999,0
1668454552922,CSE 293,042,119539,Gao; Sicun,9999,0,9999,0
1668454552922,CSE 293,043,119540,Weibel; Nadir,9999,0,9999,0
1668454552922,CSE 293,044,119541,Gupta; Rajesh K.,9999,0,9999,0
1668454552922,CSE 293,045,126410,Vaccaro; Kristen Marie,9999,0,9999,0
1668454552922,CSE 293,046,126411,Klemke; Richard,9999,0,9999,0
1668454553364,CSE 294,A00,102459,Voelker; Geoffrey M.,0,2,0,0
1668454553364,CSE 294,B00,111322,Orailoglu; Alex,0,1,0,0
1668454553793,DSE 201,A00,096914,Deutsch; Alin Bernard,30,0,30,0
1668454554221,DSE 210,A00,096915,Dasgupta; Sanjoy,30,0,30,0
1668454554650,DSE 260A,A00,096916,Altintas De Callaf; Ilkay,30,0,30,0
1668454555088,ECE 200,001,103586,Antipa; Nicholas A,9999,0,9999,0
1668454555088,ECE 200,002,103587,Atanasov; Nikolay A.,9999,0,9999,0
1668454555088,ECE 200,003,103588,Bharadia; Dinesh,9999,0,9999,0
1668454555088,ECE 200,004,103589,Cheng; Chung Kuan,9999,0,9999,0
1668454555088,ECE 200,005,103590,Cosman; Pamela C.,9999,0,9999,0
1668454555088,ECE 200,006,103591,Dayeh; Shadi Ahmad,9999,0,9999,0
1668454555088,ECE 200,007,103592,Fainman; Yeshaiahu,9999,0,9999,0
1668454555088,ECE 200,008,103593,Ford; Joseph Earl,9999,0,9999,0
1668454555088,ECE 200,009,103594,Franceschetti; Massimo,9999,0,9999,0
1668454555088,ECE 200,010,103595,Fullerton; Eric E,9999,0,9999,0
1668454555088,ECE 200,011,103596,Galton; Ian A,9999,0,9999,0
1668454555088,ECE 200,012,103597,Gilja; Vikash,9999,0,9999,0
1668454555088,ECE 200,013,103598,Hall; Drew A.,9999,0,9999,0
1668454555088,ECE 200,014,103599,Hsueh; Tzu-Chien,9999,0,9999,0
1668454555088,ECE 200,015,103600,Javidi; Tara,9999,0,9999,0
1668454555088,ECE 200,016,103601,Kahng; Andrew Byun,9999,0,9999,0
1668454555088,ECE 200,017,103602,Kim; Young-Han,9999,0,9999,0
1668454555088,ECE 200,018,103603,Koushanfar; Farinaz,9999,0,9999,0
1668454555088,ECE 200,019,103604,Kuzum; Duygu,9999,0,9999,0
1668454555088,ECE 200,020,103605,Le; Hanh-Phuc,9999,0,9999,0
1668454555088,ECE 200,021,103606,Lin; Bill,9999,0,9999,0
1668454555088,ECE 200,022,103607,Liu; Zhaowei,9998,0,9999,1
1668454555088,ECE 200,023,103608,Lo; Yu-Hwa,9999,0,9999,0
1668454555088,ECE 200,024,103609,Lomakin; Vitaliy,9999,0,9999,0
1668454555088,ECE 200,025,103610,Mercier; Patrick Philip,9999,0,9999,0
1668454555088,ECE 200,026,103611,Meyer; Florian,9999,0,9999,0
1668454555088,ECE 200,027,103612,Milstein; Laurence B.,9999,0,9999,0
1668454555088,ECE 200,028,103613,Mir Arabbaygi; Siavash,9999,0,9999,0
1668454555088,ECE 200,029,103614,Mookherjea; Shayan,9999,0,9999,0
1668454555088,ECE 200,030,103615,Morris; Karcher William,9999,0,9999,0
1668454555088,ECE 200,031,103616,Ng; Tse Nga,9999,0,9999,0
1668454555088,ECE 200,032,103617,Nguyen; Truong Quang,9999,0,9999,0
1668454555088,ECE 200,033,103618,Nomura; Kenji,9999,0,9999,0
1668454555088,ECE 200,034,103619,Orlitsky; Alon,9999,0,9999,0
1668454555088,ECE 200,035,103620,Pal; Piya,9999,0,9999,0
1668454555088,ECE 200,036,103621,Papen; George C.,9999,0,9999,0
1668454555088,ECE 200,037,103622,Radic; Stojan,9999,0,9999,0
1668454555088,ECE 200,038,103623,Rao; Bhaskar D.,9999,0,9999,0
1668454555088,ECE 200,039,103624,Rao; Ramesh R,9999,0,9999,0
1668454555088,ECE 200,040,103625,Rebeiz; Gabriel,9999,0,9999,0
1668454555088,ECE 200,041,103626,Sanford; John R,9999,0,9999,0
1668454555088,ECE 200,042,103627,Siegel; Paul H.,9999,0,9999,0
1668454555088,ECE 200,043,103628,Sievenpiper; Daniel F.,9999,0,9999,0
1668454555088,ECE 200,044,103629,Sworder; David D.,9999,0,9999,0
1668454555088,ECE 200,045,103630,Taur; Yuan,9999,0,9999,0
1668454555088,ECE 200,046,103631,Touri; Behrouz,9999,0,9999,0
1668454555088,ECE 200,047,103632,Trivedi; Mohan M.,9999,0,9999,0
1668454555088,ECE 200,048,103633,Vasconcelos; Nuno,9999,0,9999,0
1668454555088,ECE 200,049,103634,Wang; Xiaolong,9999,0,9999,0
1668454555088,ECE 200,050,103635,Xie; Pengtao,9999,0,9999,0
1668454555088,ECE 200,051,103636,Yip; Michael,9999,0,9999,0
1668454555088,ECE 200,052,103637,Zeger; Kenneth A.,999,0,999,0
1668454555088,ECE 200,053,103638,Zhang; Xinyu,9999,0,9999,0
1668454555088,ECE 200,054,103639,Turakhia; Yatish Girish,9999,0,9999,0
1668454555088,ECE 200,055,103640,Kang; Mingu,9999,0,9999,0
1668454555088,ECE 200,056,103641,Shi; Yuanyuan,9999,0,9999,0
1668454555088,ECE 200,057,103642,Wang; Edward Jay,9999,0,9999,0
1668454555088,ECE 200,058,103643,Zheng; Yang,9999,0,9999,0
1668454555518,ECE 202,A00,103644,Kuzum; Duygu,0,32,0,0
1668454555943,ECE 212BN,A00,103646,Ng; Tse Nga,0,3,0,0
1668454556381,ECE 221,A00,111493,Staff,0,0,0,0
1668454556808,ECE 222B,A00,103647,Lomakin; Vitaliy,0,8,0,0
1668454557237,ECE 230B,A00,103648,Taur; Yuan,0,2,0,0
1668454557660,ECE 238B,A00,103649,Garay; Javier,0,0,0,0
1668454558082,ECE 240B,A00,112900,Fainman; Yeshaiahu,0,4,0,0
1668454558512,ECE 247A,A00,103650,Jokerst; Jesse Vincent,0,2,0,0
1668454558940,ECE 247B,A00,103651,Wang; Joseph,0,8,0,0
1668454559364,ECE 250,A00,103652,Siegel; Paul H.,0,58,0,0
1668454559791,ECE 251A,A00,103654,Rao; Bhaskar D.,0,42,0,0
1668454560224,ECE 257B,A00,103655,Bharadia; Dinesh,0,24,0,0
1668454560648,ECE 258A,A00,103656,Milstein; Laurence B.,0,21,0,0
1668454561072,ECE 260B,A00,103658,Kang; Mingu,0,99,0,0
1668454561495,ECE 264A,A00,103659,Galton; Ian A,0,54,0,0
1668454561924,ECE 265A,A00,103661,Gudem; Prasad S.S.,0,32,0,0
1668454562363,ECE 265D,A00,103662,Gudem; Prasad S.S.,0,18,0,0
1668454562786,ECE 268,A00,103663,Koushanfar; Farinaz,0,34,0,0
1668454563214,ECE 269,A01,103665,Pal; Piya,0,163,0,0
1668454563644,ECE 271B,A00,103666,Vasconcelos; Manuela,0,56,0,0
1668454564066,ECE 276A,A00,103667,Atanasov; Nikolay A.,0,88,0,0
1668454564490,ECE 277,A00,103668,An; Cheolhong,0,116,0,0
1668454564915,ECE 279,A00,117947,Hall; Drew A.,0,17,0,0
1668454565762,ECE 283,A00,103670,Hsueh; Tzu-Chien,0,38,0,0
1668454566191,ECE 284,A00,103671,Turakhia; Yatish Girish,0,31,0,0
1668454566624,ECE 285,A00,103672,Zheng; Yang,0,28,0,0
1668454566624,ECE 285,B00,103673,Sworder; David D.,0,44,0,0
1668454567051,ECE 287,A00,103676,Javidi; Tara,0,6,0,0
1668454567482,MATH 200B,A00,098023,Salehi Golsefidy; Alireza,12,0,15,3
1668454567905,MATH 202B,A00,098024,Rhoades; Brendon Patrick,9,0,15,6
1668454568334,MATH 203B,A00,098025,Oprea; Dragos N.,10,0,15,5
1668454568760,MATH 204B,A00,098026,Sorensen; Claus M,13,0,15,2
1668454569198,MATH 208,A00,098027,Izadi; Elham,7,0,10,3
1668454569734,MATH 209,A00,098028,Pollack; Aaron,10,0,10,0
1668454570158,MATH 211A,A00,112919,Rogalski; Daniel,9,0,10,1
1668454570606,MATH 211B,A00,112920,Seward; Brandon M.,9,0,10,1
1668454571031,MATH 218,A00,098029,Li; Bo,10,0,10,0
1668454571455,MATH 220B,A00,098030,Novak; Jonathan I,11,0,15,4
1668454571881,MATH 221A,A00,098031,Ebenfelt; Peter F,13,0,15,2
1668454572317,MATH 231B,A00,098032,Zlatos; Andrej,11,0,15,4
1668454572757,MATH 240B,A00,098033,Ni; Lei,9,0,15,6
1668454573195,MATH 243,A00,098034,Jekel; David Andrew,10,0,10,0
1668454573617,MATH 245A,A00,098035,Nie; Jiawang,0,2,15,16
1668454574062,MATH 248,A00,098036,Bejenaru; Ioan,10,0,10,0
1668454574488,MATH 250B,A00,098037,Spolaor; Luca,14,0,15,1
1668454574910,MATH 258,A00,098038,Ni; Lei,10,0,10,0
1668454575336,MATH 264B,A00,098041,Rhoades; Brendon Patrick,9,0,15,6
1668454575759,MATH 268,A00,098042,Buss; Samuel R,10,0,10,0
1668454576183,MATH 269,A00,098043,Rhoades; Brendon Patrick,10,0,10,0
1668454576618,MATH 270B,A00,098044,Li; Bo,10,0,15,5
1668454577053,MATH 272B,A00,098045,Holst; Michael J,13,0,15,2
1668454577481,MATH 273A,A00,098046,Tian; Xiaochuan,10,0,15,5
1668454577904,MATH 275,A01,098048,Tian; Xiaochuan,6,0,10,4
1668454578335,MATH 278A,A00,098049,Holst; Michael J,8,0,10,2
1668454578764,MATH 278B,A00,098050,Cloninger; Alexander,10,0,10,0
1668454579197,MATH 278C,A00,098051,Nie; Jiawang,6,0,10,4
1668454579637,MATH 280B,A00,098052,Zheng; Tianyi,7,0,15,8
1668454580068,MATH 281B,A00,098053,Bradic; Jelena,0,2,15,15
1668454580493,MATH 282B,A00,098054,Arias-Castro; Ery,0,0,15,15
1668454580933,MATH 285,A00,098055,Fitzsimmons; Patrick J,0,1,15,17
1668454581357,MATH 287B,A00,098056,Arias-Castro; Ery,2,0,15,13
1668454581785,MATH 288,A00,098057,Agarwal; Pooja,9,0,10,1
1668454581785,MATH 288,B00,098058,Zhang; Danna,8,0,10,2
1668454581785,MATH 288,C00,098059,Williams; Ruth J,9,0,10,1
1668454582211,MATH 290B,A00,098060,Roberts; Justin Deritter,13,0,15,2
1668454582634,MATH 292,A00,098061,Belmont; Eva Kinoshita,10,0,10,0
1668454583073,MATH 295,A00,098062,Suk; Andrew Hoon,48,0,50,2
1668454583516,MATH 296,A00,098063,Novak; Jonathan I,20,0,20,0
1668454583948,MATH 297,001,098064,Gamst; Anthony Collins,9997,0,9999,2
1668455086584,COGS 205,A00,101395,Chiba; Andrea,19,0,20,1
1668455087011,COGS 210B,001,101404,Greene; Deanna Jacquelyn,9998,0,9999,1
1668455087011,COGS 210B,002,101417,Xia; Haijun,9999,0,9999,0
1668455087011,COGS 210B,003,101422,Nitz; Douglas A.,9999,0,9999,0
1668455087011,COGS 210B,004,101423,Hollan; James D.,9998,0,9999,1
1668455087011,COGS 210B,005,101424,Deak; Gedeon O.,9998,0,9999,1
1668455087011,COGS 210B,006,101425,Rossano; Federico,9999,0,9999,0
1668455087439,COGS 211B,A00,101427,Coulson; Seana M,9996,0,9999,3
1668455087863,COGS 220,A00,101428,Hollan; James D.,1,5,25,24
1668455088291,COGS 229,A00,101429,Dow; Steven P,18,0,25,7
1668455088724,COGS 230,A00,101430,Klemmer; Scott R,9,0,17,8
1668455089151,COGS 234,A00,101431,Xia; Haijun,2,0,25,23
1668455089579,COGS 260,A00,101432,Kiyonaga; Anastasia,21,0,25,4
1668455089579,COGS 260,B00,101433,Kirsh; David Joel,15,0,25,10
1668455090006,CSE 202,A00,102371,Impagliazzo; Russell,0,46,0,0
1668455090430,CSE 203B,A01,102373,Cheng; Chung Kuan,0,35,0,0
1668455090857,CSE 208,A00,102374,Micciancio; Daniele,0,3,0,0
1668455091280,CSE 209A,A00,112895,Impagliazzo; Russell,0,8,15,15
1668455091799,CSE 209B,A00,108005,Bellare; Mihir,0,4,0,0
1668455092232,CSE 210,A00,113163,Coblenz; Michael J,0,57,0,0
1668455092667,CSE 219,A00,106111,Dow; Steven P,0,3,20,20
1668455093092,CSE 221,A00,102376,Voelker; Geoffrey M.,0,43,0,0
1668455093521,CSE 224,A01,102378,Porter; George M,0,124,0,0
1668455093946,CSE 229A,A00,102379,Savage; Stefan,0,6,0,0
1668455094379,CSE 229C,A00,102380,Munyaka; Imani N. S.,0,6,0,0
1668455094804,CSE 232B,A00,102382,Deutsch; Alin Bernard,0,23,0,0
1668455095237,CSE 234,A01,112904,Kumar; Arun Kumar,0,0,0,0
1668455095675,CSE 237A,A00,102383,Rosing; Tajana Simunic,0,42,0,0
1668455096101,CSE 239A,A00,102384,Deutsch; Alin Bernard,0,7,0,0
1668455096524,CSE 239B,A00,102385,Polikarpova; Nadezhda,0,7,0,0
1668455096950,CSE 240A,A00,102386,Pannuto; Patrick William,0,36,0,0
1668455097379,CSE 240B,A00,102387,Zhao; Jishen,0,37,0,0
1668455097802,CSE 241A,A00,106406,Kang; Mingu,0,6,0,0
1668455098231,CSE 249B,A00,102388,Kahng; Andrew Byun,0,3,8,8
1668455098656,CSE 251B,A01,102392,Cottrell; Garrison W,0,31,0,0
1668455098656,CSE 251B,A02,102393,Cottrell; Garrison W,0,28,0,0
1668455099080,CSE 252B,A00,102394,Ochoa; Benjamin Lawrence,0,43,0,0
1668455099504,CSE 257,A01,102396,Gao; Sicun,0,104,0,0
1668455099928,CSE 272,A00,102397,Li; Tzumao,0,10,0,0
1668455100359,CSE 274,A00,111323,Chern; Albert Ren-Haur,0,8,0,0
1668455100785,CSE 282,A00,102398,Pevzner; Pavel Arkadjevich,0,0,0,0
1668455101213,CSE 284,A00,114175,Gymrek; Melissa Ann,0,15,0,0
1668455101648,CSE 290,A00,102399,Chandraker; Manmohan Krishna,0,8,0,0
1668455101648,CSE 290,B00,102400,Vaccaro; Kristen Marie,0,5,25,25
1668455101648,CSE 290,C00,102414,Pannuto; Patrick William,0,1,25,25
1668455101648,CSE 290,D00,102427,Pevzner; Pavel Arkadjevich,0,0,0,0
1668455101648,CSE 290,E00,102429,Zhao; Jishen,0,2,0,0
1668455101648,CSE 290,F00,102436,Tullsen; Dean Michael,0,4,0,0
1668455101648,CSE 290,G00,102440,Christensen; Henrik I,0,4,20,20
1668455102077,CSE 291,A00,102443,Su; Hao,0,0,0,0
1668455102077,CSE 291,B00,102448,Polikarpova; Nadezhda,0,0,0,0
1668455102077,CSE 291,C00,102453,Vaccaro; Kristen Marie,0,0,0,0
1668455102077,CSE 291,D00,111343,Savage; Stefan,0,0,0,0
1668455102077,CSE 291,E00,116474,Claffy; Kimberly Claire,0,0,0,0
1668455102077,CSE 291,F00,116479,Pasquale; Joseph,0,0,0,0
1668455102523,CSE 293,001,119111,Bafna; Vineet,9999,0,9999,0
1668455102523,CSE 293,002,119118,Bellare; Mihir,9999,0,9999,0
1668455102523,CSE 293,003,119122,Berg-Kirkpatrick; Taylor D,9999,0,9999,0
1668455102523,CSE 293,004,119135,Christensen; Henrik I,9999,0,9999,0
1668455102523,CSE 293,005,119142,Cottrell; Garrison W,9999,0,9999,0
1668455102523,CSE 293,006,119146,Deutsch; Alin Bernard,9999,0,9999,0
1668455102523,CSE 293,007,119159,Esmaeilzadeh; Hadi,9999,0,9999,0
1668455102523,CSE 293,008,119166,Freund; Yoav,9999,0,9999,0
1668455102523,CSE 293,009,119170,Griswold; William G.,9999,0,9999,0
1668455102523,CSE 293,010,119183,Gymrek; Melissa Ann,9999,0,9999,0
1668455102523,CSE 293,011,119190,Heninger; Nadia A,9999,0,9999,0
1668455102523,CSE 293,012,119230,Impagliazzo; Russell,9999,0,9999,0
1668455102523,CSE 293,013,119232,Jhala; Ranjit,9999,0,9999,0
1668455102523,CSE 293,014,119233,Kahng; Andrew Byun,9999,0,9999,0
1668455102523,CSE 293,015,119298,Kane; Daniel Mertz,9999,0,9999,0
1668455102523,CSE 293,016,119299,Kriegman; David J,9999,0,9999,0
1668455102523,CSE 293,017,119300,Kumar; Arun Kumar,9999,0,9999,0
1668455102523,CSE 293,018,119301,Lerner; Sorin,9999,0,9999,0
1668455102523,CSE 293,019,119302,Lovett; Shachar,9999,0,9999,0
1668455102523,CSE 293,020,119303,McAuley; Julian John,9999,0,9999,0
1668455102523,CSE 293,021,119304,Micciancio; Daniele,9999,0,9999,0
1668455102523,CSE 293,022,119367,Orailoglu; Alex,9999,0,9999,0
1668455102523,CSE 293,023,119382,Paturi; Ramamohan,9999,0,9999,0
1668455102523,CSE 293,024,119404,Polikarpova; Nadezhda,9999,0,9999,0
1668455102523,CSE 293,025,119406,Politz; Joseph Gibbs,9999,0,9999,0
1668455102523,CSE 293,026,119411,Porter; George M,9999,0,9999,0
1668455102523,CSE 293,027,119414,Porter; Leonard Emerson,9999,0,9999,0
1668455102523,CSE 293,028,119416,Ramamoorthi; Ravi,9999,0,9999,0
1668455102523,CSE 293,029,119417,Sahoo; Debashis,9999,0,9999,0
1668455102523,CSE 293,030,119420,Saul; Lawrence,9999,0,9999,0
1668455102523,CSE 293,031,119421,Savage; Stefan,9999,0,9999,0
1668455102523,CSE 293,032,119425,Schulze; Jurgen P.,9999,0,9999,0
1668455102523,CSE 293,033,119426,Snoeren; Alex C.,9999,0,9999,0
1668455102523,CSE 293,034,119428,Shang; Jingbo,9999,0,9999,0
1668455102523,CSE 293,035,119430,Stefan; Deian,9999,0,9999,0
1668455102523,CSE 293,036,119431,Su; Hao,9999,0,9999,0
1668455102523,CSE 293,037,119433,Swanson; Steven James,9999,0,9999,0
1668455102523,CSE 293,038,119435,Tullsen; Dean Michael,9999,0,9999,0
1668455102523,CSE 293,039,119483,Voelker; Geoffrey M.,9999,0,9999,0
1668455102523,CSE 293,040,119537,Zhao; Jishen,9999,0,9999,0
1668455102523,CSE 293,041,119538,Zhou; Yuan-Yuan,9999,0,9999,0
1668455102523,CSE 293,042,119539,Gao; Sicun,9999,0,9999,0
1668455102523,CSE 293,043,119540,Weibel; Nadir,9999,0,9999,0
1668455102523,CSE 293,044,119541,Gupta; Rajesh K.,9999,0,9999,0
1668455102523,CSE 293,045,126410,Vaccaro; Kristen Marie,9999,0,9999,0
1668455102523,CSE 293,046,126411,Klemke; Richard,9999,0,9999,0
1668455102948,CSE 294,A00,102459,Voelker; Geoffrey M.,0,2,0,0
1668455102948,CSE 294,B00,111322,Orailoglu; Alex,0,1,0,0
1668455103371,DSE 201,A00,096914,Deutsch; Alin Bernard,30,0,30,0
1668455103802,DSE 210,A00,096915,Dasgupta; Sanjoy,30,0,30,0
1668455104230,DSE 260A,A00,096916,Altintas De Callaf; Ilkay,30,0,30,0
1668455104694,ECE 200,001,103586,Antipa; Nicholas A,9999,0,9999,0
1668455104694,ECE 200,002,103587,Atanasov; Nikolay A.,9999,0,9999,0
1668455104694,ECE 200,003,103588,Bharadia; Dinesh,9999,0,9999,0
1668455104694,ECE 200,004,103589,Cheng; Chung Kuan,9999,0,9999,0
1668455104694,ECE 200,005,103590,Cosman; Pamela C.,9999,0,9999,0
1668455104694,ECE 200,006,103591,Dayeh; Shadi Ahmad,9999,0,9999,0
1668455104694,ECE 200,007,103592,Fainman; Yeshaiahu,9999,0,9999,0
1668455104694,ECE 200,008,103593,Ford; Joseph Earl,9999,0,9999,0
1668455104694,ECE 200,009,103594,Franceschetti; Massimo,9999,0,9999,0
1668455104694,ECE 200,010,103595,Fullerton; Eric E,9999,0,9999,0
1668455104694,ECE 200,011,103596,Galton; Ian A,9999,0,9999,0
1668455104694,ECE 200,012,103597,Gilja; Vikash,9999,0,9999,0
1668455104694,ECE 200,013,103598,Hall; Drew A.,9999,0,9999,0
1668455104694,ECE 200,014,103599,Hsueh; Tzu-Chien,9999,0,9999,0
1668455104694,ECE 200,015,103600,Javidi; Tara,9999,0,9999,0
1668455104694,ECE 200,016,103601,Kahng; Andrew Byun,9999,0,9999,0
1668455104694,ECE 200,017,103602,Kim; Young-Han,9999,0,9999,0
1668455104694,ECE 200,018,103603,Koushanfar; Farinaz,9999,0,9999,0
1668455104694,ECE 200,019,103604,Kuzum; Duygu,9999,0,9999,0
1668455104694,ECE 200,020,103605,Le; Hanh-Phuc,9999,0,9999,0
1668455104694,ECE 200,021,103606,Lin; Bill,9999,0,9999,0
1668455104694,ECE 200,022,103607,Liu; Zhaowei,9998,0,9999,1
1668455104694,ECE 200,023,103608,Lo; Yu-Hwa,9999,0,9999,0
1668455104694,ECE 200,024,103609,Lomakin; Vitaliy,9999,0,9999,0
1668455104694,ECE 200,025,103610,Mercier; Patrick Philip,9999,0,9999,0
1668455104694,ECE 200,026,103611,Meyer; Florian,9999,0,9999,0
1668455104694,ECE 200,027,103612,Milstein; Laurence B.,9999,0,9999,0
1668455104694,ECE 200,028,103613,Mir Arabbaygi; Siavash,9999,0,9999,0
1668455104694,ECE 200,029,103614,Mookherjea; Shayan,9999,0,9999,0
1668455104694,ECE 200,030,103615,Morris; Karcher William,9999,0,9999,0
1668455104694,ECE 200,031,103616,Ng; Tse Nga,9999,0,9999,0
1668455104694,ECE 200,032,103617,Nguyen; Truong Quang,9999,0,9999,0
1668455104694,ECE 200,033,103618,Nomura; Kenji,9999,0,9999,0
1668455104694,ECE 200,034,103619,Orlitsky; Alon,9999,0,9999,0
1668455104694,ECE 200,035,103620,Pal; Piya,9999,0,9999,0
1668455104694,ECE 200,036,103621,Papen; George C.,9999,0,9999,0
1668455104694,ECE 200,037,103622,Radic; Stojan,9999,0,9999,0
1668455104694,ECE 200,038,103623,Rao; Bhaskar D.,9999,0,9999,0
1668455104694,ECE 200,039,103624,Rao; Ramesh R,9999,0,9999,0
1668455104694,ECE 200,040,103625,Rebeiz; Gabriel,9999,0,9999,0
1668455104694,ECE 200,041,103626,Sanford; John R,9999,0,9999,0
1668455104694,ECE 200,042,103627,Siegel; Paul H.,9999,0,9999,0
1668455104694,ECE 200,043,103628,Sievenpiper; Daniel F.,9999,0,9999,0
1668455104694,ECE 200,044,103629,Sworder; David D.,9999,0,9999,0
1668455104694,ECE 200,045,103630,Taur; Yuan,9999,0,9999,0
1668455104694,ECE 200,046,103631,Touri; Behrouz,9999,0,9999,0
1668455104694,ECE 200,047,103632,Trivedi; Mohan M.,9999,0,9999,0
1668455104694,ECE 200,048,103633,Vasconcelos; Nuno,9999,0,9999,0
1668455104694,ECE 200,049,103634,Wang; Xiaolong,9999,0,9999,0
1668455104694,ECE 200,050,103635,Xie; Pengtao,9999,0,9999,0
1668455104694,ECE 200,051,103636,Yip; Michael,9999,0,9999,0
1668455104694,ECE 200,052,103637,Zeger; Kenneth A.,999,0,999,0
1668455104694,ECE 200,053,103638,Zhang; Xinyu,9999,0,9999,0
1668455104694,ECE 200,054,103639,Turakhia; Yatish Girish,9999,0,9999,0
1668455104694,ECE 200,055,103640,Kang; Mingu,9999,0,9999,0
1668455104694,ECE 200,056,103641,Shi; Yuanyuan,9999,0,9999,0
1668455104694,ECE 200,057,103642,Wang; Edward Jay,9999,0,9999,0
1668455104694,ECE 200,058,103643,Zheng; Yang,9999,0,9999,0
1668455105118,ECE 202,A00,103644,Kuzum; Duygu,0,33,0,0
1668455105550,ECE 212BN,A00,103646,Ng; Tse Nga,0,4,0,0
1668455105986,ECE 221,A00,111493,Staff,0,0,0,0
1668455106410,ECE 222B,A00,103647,Lomakin; Vitaliy,0,9,0,0
1668455106833,ECE 230B,A00,103648,Taur; Yuan,0,2,0,0
1668455107256,ECE 238B,A00,103649,Garay; Javier,0,0,0,0
1668455107684,ECE 240B,A00,112900,Fainman; Yeshaiahu,0,4,0,0
1668455108110,ECE 247A,A00,103650,Jokerst; Jesse Vincent,0,2,0,0
1668455108543,ECE 247B,A00,103651,Wang; Joseph,0,8,0,0
1668455108975,ECE 250,A00,103652,Siegel; Paul H.,0,59,0,0
1668455109403,ECE 251A,A00,103654,Rao; Bhaskar D.,0,43,0,0
1668455109827,ECE 257B,A00,103655,Bharadia; Dinesh,0,24,0,0
1668455110253,ECE 258A,A00,103656,Milstein; Laurence B.,0,21,0,0
1668455110689,ECE 260B,A00,103658,Kang; Mingu,0,100,0,0
1668455111114,ECE 264A,A00,103659,Galton; Ian A,0,54,0,0
1668455111541,ECE 265A,A00,103661,Gudem; Prasad S.S.,0,32,0,0
1668455111966,ECE 265D,A00,103662,Gudem; Prasad S.S.,0,19,0,0
1668455112395,ECE 268,A00,103663,Koushanfar; Farinaz,0,36,0,0
1668455112822,ECE 269,A01,103665,Pal; Piya,0,162,0,0
1668455113244,ECE 271B,A00,103666,Vasconcelos; Manuela,0,56,0,0
1668455113679,ECE 276A,A00,103667,Atanasov; Nikolay A.,0,88,0,0
1668455114105,ECE 277,A00,103668,An; Cheolhong,0,119,0,0
1668455114536,ECE 279,A00,117947,Hall; Drew A.,0,17,0,0
1668455115393,ECE 283,A00,103670,Hsueh; Tzu-Chien,0,38,0,0
1668455115831,ECE 284,A00,103671,Turakhia; Yatish Girish,0,33,0,0
1668455116261,ECE 285,A00,103672,Zheng; Yang,0,28,0,0
1668455116261,ECE 285,B00,103673,Sworder; David D.,0,44,0,0
1668455116690,ECE 287,A00,103676,Javidi; Tara,0,6,0,0
1668455117113,MATH 200B,A00,098023,Salehi Golsefidy; Alireza,12,0,15,3
1668455117546,MATH 202B,A00,098024,Rhoades; Brendon Patrick,9,0,15,6
1668455117970,MATH 203B,A00,098025,Oprea; Dragos N.,10,0,15,5
1668455118395,MATH 204B,A00,098026,Sorensen; Claus M,13,0,15,2
1668455118819,MATH 208,A00,098027,Izadi; Elham,7,0,10,3
1668455119244,MATH 209,A00,098028,Pollack; Aaron,10,0,10,0
1668455119684,MATH 211A,A00,112919,Rogalski; Daniel,9,0,10,1
1668455120114,MATH 211B,A00,112920,Seward; Brandon M.,9,0,10,1
1668455120544,MATH 218,A00,098029,Li; Bo,10,0,10,0
1668455120971,MATH 220B,A00,098030,Novak; Jonathan I,11,0,15,4
1668455121397,MATH 221A,A00,098031,Ebenfelt; Peter F,13,0,15,2
1668455121825,MATH 231B,A00,098032,Zlatos; Andrej,11,0,15,4
1668455122258,MATH 240B,A00,098033,Ni; Lei,9,0,15,6
1668455122687,MATH 243,A00,098034,Jekel; David Andrew,10,0,10,0
1668455123114,MATH 245A,A00,098035,Nie; Jiawang,0,2,15,16
1668455123540,MATH 248,A00,098036,Bejenaru; Ioan,10,0,10,0
1668455123964,MATH 250B,A00,098037,Spolaor; Luca,14,0,15,1
1668455124389,MATH 258,A00,098038,Ni; Lei,10,0,10,0
1668455124814,MATH 264B,A00,098041,Rhoades; Brendon Patrick,9,0,15,6
1668455125238,MATH 268,A00,098042,Buss; Samuel R,10,0,10,0
1668455125671,MATH 269,A00,098043,Rhoades; Brendon Patrick,10,0,10,0
1668455126098,MATH 270B,A00,098044,Li; Bo,10,0,15,5
1668455126521,MATH 272B,A00,098045,Holst; Michael J,13,0,15,2
1668455126943,MATH 273A,A00,098046,Tian; Xiaochuan,10,0,15,5
1668455127374,MATH 275,A01,098048,Tian; Xiaochuan,6,0,10,4
1668455127797,MATH 278A,A00,098049,Holst; Michael J,8,0,10,2
1668455128223,MATH 278B,A00,098050,Cloninger; Alexander,10,0,10,0
1668455128649,MATH 278C,A00,098051,Nie; Jiawang,6,0,10,4
1668455129079,MATH 280B,A00,098052,Zheng; Tianyi,7,0,15,8
1668455129507,MATH 281B,A00,098053,Bradic; Jelena,0,2,15,15
1668455129939,MATH 282B,A00,098054,Arias-Castro; Ery,0,0,15,15
1668455130362,MATH 285,A00,098055,Fitzsimmons; Patrick J,0,1,15,17
1668455130788,MATH 287B,A00,098056,Arias-Castro; Ery,2,0,15,13
1668455131212,MATH 288,A00,098057,Agarwal; Pooja,9,0,10,1
1668455131212,MATH 288,B00,098058,Zhang; Danna,8,0,10,2
1668455131212,MATH 288,C00,098059,Williams; Ruth J,9,0,10,1
1668455131644,MATH 290B,A00,098060,Roberts; Justin Deritter,13,0,15,2
1668455132068,MATH 292,A00,098061,Belmont; Eva Kinoshita,10,0,10,0
1668455132509,MATH 295,A00,098062,Suk; Andrew Hoon,48,0,50,2
1668455132932,MATH 296,A00,098063,Novak; Jonathan I,20,0,20,0
1668455133356,MATH 297,001,098064,Gamst; Anthony Collins,9997,0,9999,2
1668455636516,COGS 205,A00,101395,Chiba; Andrea,19,0,20,1
1668455636941,COGS 210B,001,101404,Greene; Deanna Jacquelyn,9998,0,9999,1
1668455636941,COGS 210B,002,101417,Xia; Haijun,9999,0,9999,0
1668455636941,COGS 210B,003,101422,Nitz; Douglas A.,9999,0,9999,0
1668455636941,COGS 210B,004,101423,Hollan; James D.,9998,0,9999,1
1668455636941,COGS 210B,005,101424,Deak; Gedeon O.,9998,0,9999,1
1668455636941,COGS 210B,006,101425,Rossano; Federico,9999,0,9999,0
1668455637370,COGS 211B,A00,101427,Coulson; Seana M,9996,0,9999,3
1668455637794,COGS 220,A00,101428,Hollan; James D.,1,6,25,24
1668455638218,COGS 229,A00,101429,Dow; Steven P,17,0,25,8
1668455638642,COGS 230,A00,101430,Klemmer; Scott R,9,0,17,8
1668455639064,COGS 234,A00,101431,Xia; Haijun,2,0,25,23
1668455639500,COGS 260,A00,101432,Kiyonaga; Anastasia,21,0,25,4
1668455639500,COGS 260,B00,101433,Kirsh; David Joel,15,0,25,10
1668455639962,CSE 202,A00,102371,Impagliazzo; Russell,0,46,0,0
1668455640396,CSE 203B,A01,102373,Cheng; Chung Kuan,0,36,0,0
1668455640824,CSE 208,A00,102374,Micciancio; Daniele,0,3,0,0
1668455641247,CSE 209A,A00,112895,Impagliazzo; Russell,0,8,15,15
1668455641670,CSE 209B,A00,108005,Bellare; Mihir,0,4,0,0
1668455642097,CSE 210,A00,113163,Coblenz; Michael J,0,58,0,0
1668455642529,CSE 219,A00,106111,Dow; Steven P,0,3,20,20
1668455642953,CSE 221,A00,102376,Voelker; Geoffrey M.,0,43,0,0
1668455643376,CSE 224,A01,102378,Porter; George M,0,124,0,0
1668455643802,CSE 229A,A00,102379,Savage; Stefan,0,6,0,0
1668455644228,CSE 229C,A00,102380,Munyaka; Imani N. S.,0,6,0,0
1668455644654,CSE 232B,A00,102382,Deutsch; Alin Bernard,0,23,0,0
1668455645081,CSE 234,A01,112904,Kumar; Arun Kumar,0,0,0,0
1668455645508,CSE 237A,A00,102383,Rosing; Tajana Simunic,0,42,0,0
1668455645938,CSE 239A,A00,102384,Deutsch; Alin Bernard,0,7,0,0
1668455646365,CSE 239B,A00,102385,Polikarpova; Nadezhda,0,7,0,0
1668455646787,CSE 240A,A00,102386,Pannuto; Patrick William,0,36,0,0
1668455647210,CSE 240B,A00,102387,Zhao; Jishen,0,37,0,0
1668455647653,CSE 241A,A00,106406,Kang; Mingu,0,6,0,0
1668455648090,CSE 249B,A00,102388,Kahng; Andrew Byun,0,3,8,8
1668455648520,CSE 251B,A01,102392,Cottrell; Garrison W,0,31,0,0
1668455648520,CSE 251B,A02,102393,Cottrell; Garrison W,0,28,0,0
1668455648944,CSE 252B,A00,102394,Ochoa; Benjamin Lawrence,0,44,0,0
1668455649370,CSE 257,A01,102396,Gao; Sicun,0,105,0,0
1668455649795,CSE 272,A00,102397,Li; Tzumao,0,10,0,0
1668455650219,CSE 274,A00,111323,Chern; Albert Ren-Haur,0,8,0,0
1668455650657,CSE 282,A00,102398,Pevzner; Pavel Arkadjevich,0,0,0,0
1668455651085,CSE 284,A00,114175,Gymrek; Melissa Ann,0,15,0,0
1668455651509,CSE 290,A00,102399,Chandraker; Manmohan Krishna,0,8,0,0
1668455651509,CSE 290,B00,102400,Vaccaro; Kristen Marie,0,5,25,25
1668455651509,CSE 290,C00,102414,Pannuto; Patrick William,0,1,25,25
1668455651509,CSE 290,D00,102427,Pevzner; Pavel Arkadjevich,0,0,0,0
1668455651509,CSE 290,E00,102429,Zhao; Jishen,0,2,0,0
1668455651509,CSE 290,F00,102436,Tullsen; Dean Michael,0,4,0,0
1668455651509,CSE 290,G00,102440,Christensen; Henrik I,0,4,20,20
1668455651943,CSE 291,A00,102443,Su; Hao,0,0,0,0
1668455651943,CSE 291,B00,102448,Polikarpova; Nadezhda,0,0,0,0
1668455651943,CSE 291,C00,102453,Vaccaro; Kristen Marie,0,0,0,0
1668455651943,CSE 291,D00,111343,Savage; Stefan,0,0,0,0
1668455651943,CSE 291,E00,116474,Claffy; Kimberly Claire,0,0,0,0
1668455651943,CSE 291,F00,116479,Pasquale; Joseph,0,0,0,0
1668455652385,CSE 293,001,119111,Bafna; Vineet,9999,0,9999,0
1668455652385,CSE 293,002,119118,Bellare; Mihir,9999,0,9999,0
1668455652385,CSE 293,003,119122,Berg-Kirkpatrick; Taylor D,9999,0,9999,0
1668455652385,CSE 293,004,119135,Christensen; Henrik I,9999,0,9999,0
1668455652385,CSE 293,005,119142,Cottrell; Garrison W,9999,0,9999,0
1668455652385,CSE 293,006,119146,Deutsch; Alin Bernard,9999,0,9999,0
1668455652385,CSE 293,007,119159,Esmaeilzadeh; Hadi,9999,0,9999,0
1668455652385,CSE 293,008,119166,Freund; Yoav,9999,0,9999,0
1668455652385,CSE 293,009,119170,Griswold; William G.,9999,0,9999,0
1668455652385,CSE 293,010,119183,Gymrek; Melissa Ann,9999,0,9999,0
1668455652385,CSE 293,011,119190,Heninger; Nadia A,9999,0,9999,0
1668455652385,CSE 293,012,119230,Impagliazzo; Russell,9999,0,9999,0
1668455652385,CSE 293,013,119232,Jhala; Ranjit,9999,0,9999,0
1668455652385,CSE 293,014,119233,Kahng; Andrew Byun,9999,0,9999,0
1668455652385,CSE 293,015,119298,Kane; Daniel Mertz,9999,0,9999,0
1668455652385,CSE 293,016,119299,Kriegman; David J,9999,0,9999,0
1668455652385,CSE 293,017,119300,Kumar; Arun Kumar,9999,0,9999,0
1668455652385,CSE 293,018,119301,Lerner; Sorin,9999,0,9999,0
1668455652385,CSE 293,019,119302,Lovett; Shachar,9999,0,9999,0
1668455652385,CSE 293,020,119303,McAuley; Julian John,9999,0,9999,0
1668455652385,CSE 293,021,119304,Micciancio; Daniele,9999,0,9999,0
1668455652385,CSE 293,022,119367,Orailoglu; Alex,9999,0,9999,0
1668455652385,CSE 293,023,119382,Paturi; Ramamohan,9999,0,9999,0
1668455652385,CSE 293,024,119404,Polikarpova; Nadezhda,9999,0,9999,0
1668455652385,CSE 293,025,119406,Politz; Joseph Gibbs,9999,0,9999,0
1668455652385,CSE 293,026,119411,Porter; George M,9999,0,9999,0
1668455652385,CSE 293,027,119414,Porter; Leonard Emerson,9999,0,9999,0
1668455652385,CSE 293,028,119416,Ramamoorthi; Ravi,9999,0,9999,0
1668455652385,CSE 293,029,119417,Sahoo; Debashis,9999,0,9999,0
1668455652385,CSE 293,030,119420,Saul; Lawrence,9999,0,9999,0
1668455652385,CSE 293,031,119421,Savage; Stefan,9999,0,9999,0
1668455652385,CSE 293,032,119425,Schulze; Jurgen P.,9999,0,9999,0
1668455652385,CSE 293,033,119426,Snoeren; Alex C.,9999,0,9999,0
1668455652385,CSE 293,034,119428,Shang; Jingbo,9999,0,9999,0
1668455652385,CSE 293,035,119430,Stefan; Deian,9999,0,9999,0
1668455652385,CSE 293,036,119431,Su; Hao,9999,0,9999,0
1668455652385,CSE 293,037,119433,Swanson; Steven James,9999,0,9999,0
1668455652385,CSE 293,038,119435,Tullsen; Dean Michael,9999,0,9999,0
1668455652385,CSE 293,039,119483,Voelker; Geoffrey M.,9999,0,9999,0
1668455652385,CSE 293,040,119537,Zhao; Jishen,9999,0,9999,0
1668455652385,CSE 293,041,119538,Zhou; Yuan-Yuan,9999,0,9999,0
1668455652385,CSE 293,042,119539,Gao; Sicun,9999,0,9999,0
1668455652385,CSE 293,043,119540,Weibel; Nadir,9999,0,9999,0
1668455652385,CSE 293,044,119541,Gupta; Rajesh K.,9999,0,9999,0
1668455652385,CSE 293,045,126410,Vaccaro; Kristen Marie,9999,0,9999,0
1668455652385,CSE 293,046,126411,Klemke; Richard,9999,0,9999,0
1668455652823,CSE 294,A00,102459,Voelker; Geoffrey M.,0,2,0,0
1668455652823,CSE 294,B00,111322,Orailoglu; Alex,0,1,0,0
1668455653254,DSE 201,A00,096914,Deutsch; Alin Bernard,30,0,30,0
1668455653680,DSE 210,A00,096915,Dasgupta; Sanjoy,30,0,30,0
1668455654108,DSE 260A,A00,096916,Altintas De Callaf; Ilkay,30,0,30,0
1668455654537,ECE 200,001,103586,Antipa; Nicholas A,9999,0,9999,0
1668455654537,ECE 200,002,103587,Atanasov; Nikolay A.,9999,0,9999,0
1668455654537,ECE 200,003,103588,Bharadia; Dinesh,9999,0,9999,0
1668455654537,ECE 200,004,103589,Cheng; Chung Kuan,9999,0,9999,0
1668455654537,ECE 200,005,103590,Cosman; Pamela C.,9999,0,9999,0
1668455654537,ECE 200,006,103591,Dayeh; Shadi Ahmad,9999,0,9999,0
1668455654537,ECE 200,007,103592,Fainman; Yeshaiahu,9999,0,9999,0
1668455654537,ECE 200,008,103593,Ford; Joseph Earl,9999,0,9999,0
1668455654537,ECE 200,009,103594,Franceschetti; Massimo,9999,0,9999,0
1668455654537,ECE 200,010,103595,Fullerton; Eric E,9999,0,9999,0
1668455654537,ECE 200,011,103596,Galton; Ian A,9999,0,9999,0
1668455654537,ECE 200,012,103597,Gilja; Vikash,9999,0,9999,0
1668455654537,ECE 200,013,103598,Hall; Drew A.,9999,0,9999,0
1668455654537,ECE 200,014,103599,Hsueh; Tzu-Chien,9999,0,9999,0
1668455654537,ECE 200,015,103600,Javidi; Tara,9999,0,9999,0
1668455654537,ECE 200,016,103601,Kahng; Andrew Byun,9999,0,9999,0
1668455654537,ECE 200,017,103602,Kim; Young-Han,9999,0,9999,0
1668455654537,ECE 200,018,103603,Koushanfar; Farinaz,9999,0,9999,0
1668455654537,ECE 200,019,103604,Kuzum; Duygu,9999,0,9999,0
1668455654537,ECE 200,020,103605,Le; Hanh-Phuc,9999,0,9999,0
1668455654537,ECE 200,021,103606,Lin; Bill,9999,0,9999,0
1668455654537,ECE 200,022,103607,Liu; Zhaowei,9998,0,9999,1
1668455654537,ECE 200,023,103608,Lo; Yu-Hwa,9999,0,9999,0
1668455654537,ECE 200,024,103609,Lomakin; Vitaliy,9999,0,9999,0
1668455654537,ECE 200,025,103610,Mercier; Patrick Philip,9999,0,9999,0
1668455654537,ECE 200,026,103611,Meyer; Florian,9999,0,9999,0
1668455654537,ECE 200,027,103612,Milstein; Laurence B.,9999,0,9999,0
1668455654537,ECE 200,028,103613,Mir Arabbaygi; Siavash,9999,0,9999,0
1668455654537,ECE 200,029,103614,Mookherjea; Shayan,9999,0,9999,0
1668455654537,ECE 200,030,103615,Morris; Karcher William,9999,0,9999,0
1668455654537,ECE 200,031,103616,Ng; Tse Nga,9999,0,9999,0
1668455654537,ECE 200,032,103617,Nguyen; Truong Quang,9999,0,9999,0
1668455654537,ECE 200,033,103618,Nomura; Kenji,9999,0,9999,0
1668455654537,ECE 200,034,103619,Orlitsky; Alon,9999,0,9999,0
1668455654537,ECE 200,035,103620,Pal; Piya,9999,0,9999,0
1668455654537,ECE 200,036,103621,Papen; George C.,9999,0,9999,0
1668455654537,ECE 200,037,103622,Radic; Stojan,9999,0,9999,0
1668455654537,ECE 200,038,103623,Rao; Bhaskar D.,9999,0,9999,0
1668455654537,ECE 200,039,103624,Rao; Ramesh R,9999,0,9999,0
1668455654537,ECE 200,040,103625,Rebeiz; Gabriel,9999,0,9999,0
1668455654537,ECE 200,041,103626,Sanford; John R,9999,0,9999,0
1668455654537,ECE 200,042,103627,Siegel; Paul H.,9999,0,9999,0
1668455654537,ECE 200,043,103628,Sievenpiper; Daniel F.,9999,0,9999,0
1668455654537,ECE 200,044,103629,Sworder; David D.,9999,0,9999,0
1668455654537,ECE 200,045,103630,Taur; Yuan,9999,0,9999,0
1668455654537,ECE 200,046,103631,Touri; Behrouz,9999,0,9999,0
1668455654537,ECE 200,047,103632,Trivedi; Mohan M.,9999,0,9999,0
1668455654537,ECE 200,048,103633,Vasconcelos; Nuno,9999,0,9999,0
1668455654537,ECE 200,049,103634,Wang; Xiaolong,9999,0,9999,0
1668455654537,ECE 200,050,103635,Xie; Pengtao,9999,0,9999,0
1668455654537,ECE 200,051,103636,Yip; Michael,9999,0,9999,0
1668455654537,ECE 200,052,103637,Zeger; Kenneth A.,999,0,999,0
1668455654537,ECE 200,053,103638,Zhang; Xinyu,9999,0,9999,0
1668455654537,ECE 200,054,103639,Turakhia; Yatish Girish,9999,0,9999,0
1668455654537,ECE 200,055,103640,Kang; Mingu,9999,0,9999,0
1668455654537,ECE 200,056,103641,Shi; Yuanyuan,9999,0,9999,0
1668455654537,ECE 200,057,103642,Wang; Edward Jay,9999,0,9999,0
1668455654537,ECE 200,058,103643,Zheng; Yang,9999,0,9999,0
1668455654960,ECE 202,A00,103644,Kuzum; Duygu,0,33,0,0
1668455655384,ECE 212BN,A00,103646,Ng; Tse Nga,0,4,0,0
1668455655814,ECE 221,A00,111493,Staff,0,0,0,0
1668455656241,ECE 222B,A00,103647,Lomakin; Vitaliy,0,9,0,0
1668455656674,ECE 230B,A00,103648,Taur; Yuan,0,2,0,0
1668455657100,ECE 238B,A00,103649,Garay; Javier,0,0,0,0
1668455657622,ECE 240B,A00,112900,Fainman; Yeshaiahu,0,4,0,0
1668455658052,ECE 247A,A00,103650,Jokerst; Jesse Vincent,0,2,0,0
1668455658480,ECE 247B,A00,103651,Wang; Joseph,0,8,0,0
1668455658904,ECE 250,A00,103652,Siegel; Paul H.,0,59,0,0
1668455659331,ECE 251A,A00,103654,Rao; Bhaskar D.,0,43,0,0
1668455659763,ECE 257B,A00,103655,Bharadia; Dinesh,0,24,0,0
1668455660187,ECE 258A,A00,103656,Milstein; Laurence B.,0,21,0,0
1668455660615,ECE 260B,A00,103658,Kang; Mingu,0,100,0,0
1668455661039,ECE 264A,A00,103659,Galton; Ian A,0,55,0,0
1668455661468,ECE 265A,A00,103661,Gudem; Prasad S.S.,0,32,0,0
1668455661896,ECE 265D,A00,103662,Gudem; Prasad S.S.,0,19,0,0
1668455662319,ECE 268,A00,103663,Koushanfar; Farinaz,0,36,0,0
1668455662744,ECE 269,A01,103665,Pal; Piya,0,165,0,0
1668455663184,ECE 271B,A00,103666,Vasconcelos; Manuela,0,58,0,0
1668455663615,ECE 276A,A00,103667,Atanasov; Nikolay A.,0,88,0,0
1668455664042,ECE 277,A00,103668,An; Cheolhong,0,121,0,0
1668455664471,ECE 279,A00,117947,Hall; Drew A.,0,17,0,0
1668455665328,ECE 283,A00,103670,Hsueh; Tzu-Chien,0,38,0,0
1668455665752,ECE 284,A00,103671,Turakhia; Yatish Girish,0,34,0,0
1668455666187,ECE 285,A00,103672,Zheng; Yang,0,28,0,0
1668455666187,ECE 285,B00,103673,Sworder; David D.,0,44,0,0
1668455666612,ECE 287,A00,103676,Javidi; Tara,0,6,0,0
1668455667047,MATH 200B,A00,098023,Salehi Golsefidy; Alireza,12,0,15,3
1668455667475,MATH 202B,A00,098024,Rhoades; Brendon Patrick,9,0,15,6
1668455667898,MATH 203B,A00,098025,Oprea; Dragos N.,10,0,15,5
1668455668323,MATH 204B,A00,098026,Sorensen; Claus M,13,0,15,2
1668455668746,MATH 208,A00,098027,Izadi; Elham,7,0,10,3
1668455669176,MATH 209,A00,098028,Pollack; Aaron,10,0,10,0
1668455669602,MATH 211A,A00,112919,Rogalski; Daniel,9,0,10,1
1668455670028,MATH 211B,A00,112920,Seward; Brandon M.,9,0,10,1
1668455670460,MATH 218,A00,098029,Li; Bo,10,0,10,0
1668455670888,MATH 220B,A00,098030,Novak; Jonathan I,11,0,15,4
1668455671317,MATH 221A,A00,098031,Ebenfelt; Peter F,13,0,15,2
1668455671748,MATH 231B,A00,098032,Zlatos; Andrej,11,0,15,4
1668455672175,MATH 240B,A00,098033,Ni; Lei,9,0,15,6
1668455672600,MATH 243,A00,098034,Jekel; David Andrew,10,0,10,0
1668455673024,MATH 245A,A00,098035,Nie; Jiawang,0,2,15,16
1668455673447,MATH 248,A00,098036,Bejenaru; Ioan,10,0,10,0
1668455673872,MATH 250B,A00,098037,Spolaor; Luca,14,0,15,1
1668455674298,MATH 258,A00,098038,Ni; Lei,10,0,10,0
1668455674728,MATH 264B,A00,098041,Rhoades; Brendon Patrick,9,0,15,6
1668455675153,MATH 268,A00,098042,Buss; Samuel R,10,0,10,0
1668455675579,MATH 269,A00,098043,Rhoades; Brendon Patrick,10,0,10,0
1668455676005,MATH 270B,A00,098044,Li; Bo,10,0,15,5
1668455676433,MATH 272B,A00,098045,Holst; Michael J,13,0,15,2
1668455676857,MATH 273A,A00,098046,Tian; Xiaochuan,10,0,15,5
1668455677283,MATH 275,A01,098048,Tian; Xiaochuan,6,0,10,4
1668455677709,MATH 278A,A00,098049,Holst; Michael J,8,0,10,2
1668455678132,MATH 278B,A00,098050,Cloninger; Alexander,10,0,10,0
1668455678555,MATH 278C,A00,098051,Nie; Jiawang,6,0,10,4
1668455678981,MATH 280B,A00,098052,Zheng; Tianyi,7,0,15,8
1668455679415,MATH 281B,A00,098053,Bradic; Jelena,0,2,15,15
1668455679846,MATH 282B,A00,098054,Arias-Castro; Ery,0,0,15,15
1668455680282,MATH 285,A00,098055,Fitzsimmons; Patrick J,0,1,15,17
1668455680709,MATH 287B,A00,098056,Arias-Castro; Ery,2,0,15,13
1668455681138,MATH 288,A00,098057,Agarwal; Pooja,9,0,10,1
1668455681138,MATH 288,B00,098058,Zhang; Danna,8,0,10,2
1668455681138,MATH 288,C00,098059,Williams; Ruth J,9,0,10,1
1668455681565,MATH 290B,A00,098060,Roberts; Justin Deritter,13,0,15,2
1668455681988,MATH 292,A00,098061,Belmont; Eva Kinoshita,10,0,10,0
1668455682423,MATH 295,A00,098062,Suk; Andrew Hoon,48,0,50,2
1668455682853,MATH 296,A00,098063,Novak; Jonathan I,20,0,20,0
1668455683279,MATH 297,001,098064,Gamst; Anthony Collins,9997,0,9999,2
1668456186918,COGS 205,A00,101395,Chiba; Andrea,19,0,20,1
1668456187345,COGS 210B,001,101404,Greene; Deanna Jacquelyn,9998,0,9999,1
1668456187345,COGS 210B,002,101417,Xia; Haijun,9999,0,9999,0
1668456187345,COGS 210B,003,101422,Nitz; Douglas A.,9999,0,9999,0
1668456187345,COGS 210B,004,101423,Hollan; James D.,9998,0,9999,1
1668456187345,COGS 210B,005,101424,Deak; Gedeon O.,9998,0,9999,1
1668456187345,COGS 210B,006,101425,Rossano; Federico,9999,0,9999,0
1668456187786,COGS 211B,A00,101427,Coulson; Seana M,9996,0,9999,3
1668456188208,COGS 220,A00,101428,Hollan; James D.,1,6,25,24
1668456188631,COGS 229,A00,101429,Dow; Steven P,17,0,25,8
1668456189054,COGS 230,A00,101430,Klemmer; Scott R,9,0,17,8
1668456189479,COGS 234,A00,101431,Xia; Haijun,2,0,25,23
1668456189902,COGS 260,A00,101432,Kiyonaga; Anastasia,21,0,25,4
1668456189902,COGS 260,B00,101433,Kirsh; David Joel,15,0,25,10
1668456190329,CSE 202,A00,102371,Impagliazzo; Russell,0,46,0,0
1668456190758,CSE 203B,A01,102373,Cheng; Chung Kuan,0,36,0,0
1668456191184,CSE 208,A00,102374,Micciancio; Daniele,0,3,0,0
1668456191617,CSE 209A,A00,112895,Impagliazzo; Russell,0,8,15,15
1668456192051,CSE 209B,A00,108005,Bellare; Mihir,0,4,0,0
1668456192483,CSE 210,A00,113163,Coblenz; Michael J,0,60,0,0
1668456192910,CSE 219,A00,106111,Dow; Steven P,0,3,20,20
1668456193333,CSE 221,A00,102376,Voelker; Geoffrey M.,0,43,0,0
1668456193756,CSE 224,A01,102378,Porter; George M,0,124,0,0
1668456194196,CSE 229A,A00,102379,Savage; Stefan,0,6,0,0
1668456194636,CSE 229C,A00,102380,Munyaka; Imani N. S.,0,6,0,0
1668456195061,CSE 232B,A00,102382,Deutsch; Alin Bernard,0,23,0,0
1668456195497,CSE 234,A01,112904,Kumar; Arun Kumar,0,0,0,0
1668456195920,CSE 237A,A00,102383,Rosing; Tajana Simunic,0,42,0,0
1668456196346,CSE 239A,A00,102384,Deutsch; Alin Bernard,0,7,0,0
1668456196773,CSE 239B,A00,102385,Polikarpova; Nadezhda,0,7,0,0
1668456197197,CSE 240A,A00,102386,Pannuto; Patrick William,0,36,0,0
1668456197621,CSE 240B,A00,102387,Zhao; Jishen,0,37,0,0
1668456198046,CSE 241A,A00,106406,Kang; Mingu,0,6,0,0
1668456198470,CSE 249B,A00,102388,Kahng; Andrew Byun,0,3,8,8
1668456198892,CSE 251B,A01,102392,Cottrell; Garrison W,0,31,0,0
1668456198892,CSE 251B,A02,102393,Cottrell; Garrison W,0,31,0,0
1668456199318,CSE 252B,A00,102394,Ochoa; Benjamin Lawrence,0,44,0,0
1668456199749,CSE 257,A01,102396,Gao; Sicun,0,105,0,0
1668456200175,CSE 272,A00,102397,Li; Tzumao,0,10,0,0
1668456200597,CSE 274,A00,111323,Chern; Albert Ren-Haur,0,8,0,0
1668456201022,CSE 282,A00,102398,Pevzner; Pavel Arkadjevich,0,0,0,0
1668456201453,CSE 284,A00,114175,Gymrek; Melissa Ann,0,15,0,0
1668456201882,CSE 290,A00,102399,Chandraker; Manmohan Krishna,0,8,0,0
1668456201882,CSE 290,B00,102400,Vaccaro; Kristen Marie,0,5,25,25
1668456201882,CSE 290,C00,102414,Pannuto; Patrick William,0,1,25,25
1668456201882,CSE 290,D00,102427,Pevzner; Pavel Arkadjevich,0,0,0,0
1668456201882,CSE 290,E00,102429,Zhao; Jishen,0,2,0,0
1668456201882,CSE 290,F00,102436,Tullsen; Dean Michael,0,4,0,0
1668456201882,CSE 290,G00,102440,Christensen; Henrik I,0,4,20,20
1668456202305,CSE 291,A00,102443,Su; Hao,0,0,0,0
1668456202305,CSE 291,B00,102448,Polikarpova; Nadezhda,0,0,0,0
1668456202305,CSE 291,C00,102453,Vaccaro; Kristen Marie,0,0,0,0
1668456202305,CSE 291,D00,111343,Savage; Stefan,0,0,0,0
1668456202305,CSE 291,E00,116474,Claffy; Kimberly Claire,0,0,0,0
1668456202305,CSE 291,F00,116479,Pasquale; Joseph,0,0,0,0
1668456202738,CSE 293,001,119111,Bafna; Vineet,9999,0,9999,0
1668456202738,CSE 293,002,119118,Bellare; Mihir,9999,0,9999,0
1668456202738,CSE 293,003,119122,Berg-Kirkpatrick; Taylor D,9999,0,9999,0
1668456202738,CSE 293,004,119135,Christensen; Henrik I,9999,0,9999,0
1668456202738,CSE 293,005,119142,Cottrell; Garrison W,9999,0,9999,0
1668456202738,CSE 293,006,119146,Deutsch; Alin Bernard,9999,0,9999,0
1668456202738,CSE 293,007,119159,Esmaeilzadeh; Hadi,9999,0,9999,0
1668456202738,CSE 293,008,119166,Freund; Yoav,9999,0,9999,0
1668456202738,CSE 293,009,119170,Griswold; William G.,9999,0,9999,0
1668456202738,CSE 293,010,119183,Gymrek; Melissa Ann,9999,0,9999,0
1668456202738,CSE 293,011,119190,Heninger; Nadia A,9999,0,9999,0
1668456202738,CSE 293,012,119230,Impagliazzo; Russell,9999,0,9999,0
1668456202738,CSE 293,013,119232,Jhala; Ranjit,9999,0,9999,0
1668456202738,CSE 293,014,119233,Kahng; Andrew Byun,9999,0,9999,0
1668456202738,CSE 293,015,119298,Kane; Daniel Mertz,9999,0,9999,0
1668456202738,CSE 293,016,119299,Kriegman; David J,9999,0,9999,0
1668456202738,CSE 293,017,119300,Kumar; Arun Kumar,9999,0,9999,0
1668456202738,CSE 293,018,119301,Lerner; Sorin,9999,0,9999,0
1668456202738,CSE 293,019,119302,Lovett; Shachar,9999,0,9999,0
1668456202738,CSE 293,020,119303,McAuley; Julian John,9999,0,9999,0
1668456202738,CSE 293,021,119304,Micciancio; Daniele,9999,0,9999,0
1668456202738,CSE 293,022,119367,Orailoglu; Alex,9999,0,9999,0
1668456202738,CSE 293,023,119382,Paturi; Ramamohan,9999,0,9999,0
1668456202738,CSE 293,024,119404,Polikarpova; Nadezhda,9999,0,9999,0
1668456202738,CSE 293,025,119406,Politz; Joseph Gibbs,9999,0,9999,0
1668456202738,CSE 293,026,119411,Porter; George M,9999,0,9999,0
1668456202738,CSE 293,027,119414,Porter; Leonard Emerson,9999,0,9999,0
1668456202738,CSE 293,028,119416,Ramamoorthi; Ravi,9999,0,9999,0
1668456202738,CSE 293,029,119417,Sahoo; Debashis,9999,0,9999,0
1668456202738,CSE 293,030,119420,Saul; Lawrence,9999,0,9999,0
1668456202738,CSE 293,031,119421,Savage; Stefan,9999,0,9999,0
1668456202738,CSE 293,032,119425,Schulze; Jurgen P.,9999,0,9999,0
1668456202738,CSE 293,033,119426,Snoeren; Alex C.,9999,0,9999,0
1668456202738,CSE 293,034,119428,Shang; Jingbo,9999,0,9999,0
1668456202738,CSE 293,035,119430,Stefan; Deian,9999,0,9999,0
1668456202738,CSE 293,036,119431,Su; Hao,9999,0,9999,0
1668456202738,CSE 293,037,119433,Swanson; Steven James,9999,0,9999,0
1668456202738,CSE 293,038,119435,Tullsen; Dean Michael,9999,0,9999,0
1668456202738,CSE 293,039,119483,Voelker; Geoffrey M.,9999,0,9999,0
1668456202738,CSE 293,040,119537,Zhao; Jishen,9999,0,9999,0
1668456202738,CSE 293,041,119538,Zhou; Yuan-Yuan,9999,0,9999,0
1668456202738,CSE 293,042,119539,Gao; Sicun,9999,0,9999,0
1668456202738,CSE 293,043,119540,Weibel; Nadir,9999,0,9999,0
1668456202738,CSE 293,044,119541,Gupta; Rajesh K.,9999,0,9999,0
1668456202738,CSE 293,045,126410,Vaccaro; Kristen Marie,9999,0,9999,0
1668456202738,CSE 293,046,126411,Klemke; Richard,9999,0,9999,0
1668456203165,CSE 294,A00,102459,Voelker; Geoffrey M.,0,2,0,0
1668456203165,CSE 294,B00,111322,Orailoglu; Alex,0,1,0,0
1668456203594,DSE 201,A00,096914,Deutsch; Alin Bernard,30,0,30,0
1668456204022,DSE 210,A00,096915,Dasgupta; Sanjoy,30,0,30,0
1668456204446,DSE 260A,A00,096916,Altintas De Callaf; Ilkay,30,0,30,0
1668456204883,ECE 200,001,103586,Antipa; Nicholas A,9999,0,9999,0
1668456204883,ECE 200,002,103587,Atanasov; Nikolay A.,9999,0,9999,0
1668456204883,ECE 200,003,103588,Bharadia; Dinesh,9999,0,9999,0
1668456204883,ECE 200,004,103589,Cheng; Chung Kuan,9999,0,9999,0
1668456204883,ECE 200,005,103590,Cosman; Pamela C.,9999,0,9999,0
1668456204883,ECE 200,006,103591,Dayeh; Shadi Ahmad,9999,0,9999,0
1668456204883,ECE 200,007,103592,Fainman; Yeshaiahu,9999,0,9999,0
1668456204883,ECE 200,008,103593,Ford; Joseph Earl,9999,0,9999,0
1668456204883,ECE 200,009,103594,Franceschetti; Massimo,9999,0,9999,0
1668456204883,ECE 200,010,103595,Fullerton; Eric E,9999,0,9999,0
1668456204883,ECE 200,011,103596,Galton; Ian A,9999,0,9999,0
1668456204883,ECE 200,012,103597,Gilja; Vikash,9999,0,9999,0
1668456204883,ECE 200,013,103598,Hall; Drew A.,9999,0,9999,0
1668456204883,ECE 200,014,103599,Hsueh; Tzu-Chien,9999,0,9999,0
1668456204883,ECE 200,015,103600,Javidi; Tara,9999,0,9999,0
1668456204883,ECE 200,016,103601,Kahng; Andrew Byun,9999,0,9999,0
1668456204883,ECE 200,017,103602,Kim; Young-Han,9999,0,9999,0
1668456204883,ECE 200,018,103603,Koushanfar; Farinaz,9999,0,9999,0
1668456204883,ECE 200,019,103604,Kuzum; Duygu,9999,0,9999,0
1668456204883,ECE 200,020,103605,Le; Hanh-Phuc,9999,0,9999,0
1668456204883,ECE 200,021,103606,Lin; Bill,9999,0,9999,0
1668456204883,ECE 200,022,103607,Liu; Zhaowei,9998,0,9999,1
1668456204883,ECE 200,023,103608,Lo; Yu-Hwa,9999,0,9999,0
1668456204883,ECE 200,024,103609,Lomakin; Vitaliy,9999,0,9999,0
1668456204883,ECE 200,025,103610,Mercier; Patrick Philip,9999,0,9999,0
1668456204883,ECE 200,026,103611,Meyer; Florian,9999,0,9999,0
1668456204883,ECE 200,027,103612,Milstein; Laurence B.,9999,0,9999,0
1668456204883,ECE 200,028,103613,Mir Arabbaygi; Siavash,9999,0,9999,0
1668456204883,ECE 200,029,103614,Mookherjea; Shayan,9999,0,9999,0
1668456204883,ECE 200,030,103615,Morris; Karcher William,9999,0,9999,0
1668456204883,ECE 200,031,103616,Ng; Tse Nga,9999,0,9999,0
1668456204883,ECE 200,032,103617,Nguyen; Truong Quang,9999,0,9999,0
1668456204883,ECE 200,033,103618,Nomura; Kenji,9999,0,9999,0
1668456204883,ECE 200,034,103619,Orlitsky; Alon,9999,0,9999,0
1668456204883,ECE 200,035,103620,Pal; Piya,9999,0,9999,0
1668456204883,ECE 200,036,103621,Papen; George C.,9999,0,9999,0
1668456204883,ECE 200,037,103622,Radic; Stojan,9999,0,9999,0
1668456204883,ECE 200,038,103623,Rao; Bhaskar D.,9999,0,9999,0
1668456204883,ECE 200,039,103624,Rao; Ramesh R,9999,0,9999,0
1668456204883,ECE 200,040,103625,Rebeiz; Gabriel,9999,0,9999,0
1668456204883,ECE 200,041,103626,Sanford; John R,9999,0,9999,0
1668456204883,ECE 200,042,103627,Siegel; Paul H.,9999,0,9999,0
1668456204883,ECE 200,043,103628,Sievenpiper; Daniel F.,9999,0,9999,0
1668456204883,ECE 200,044,103629,Sworder; David D.,9999,0,9999,0
1668456204883,ECE 200,045,103630,Taur; Yuan,9999,0,9999,0
1668456204883,ECE 200,046,103631,Touri; Behrouz,9999,0,9999,0
1668456204883,ECE 200,047,103632,Trivedi; Mohan M.,9999,0,9999,0
1668456204883,ECE 200,048,103633,Vasconcelos; Nuno,9999,0,9999,0
1668456204883,ECE 200,049,103634,Wang; Xiaolong,9999,0,9999,0
1668456204883,ECE 200,050,103635,Xie; Pengtao,9999,0,9999,0
1668456204883,ECE 200,051,103636,Yip; Michael,9999,0,9999,0
1668456204883,ECE 200,052,103637,Zeger; Kenneth A.,999,0,999,0
1668456204883,ECE 200,053,103638,Zhang; Xinyu,9999,0,9999,0
1668456204883,ECE 200,054,103639,Turakhia; Yatish Girish,9999,0,9999,0
1668456204883,ECE 200,055,103640,Kang; Mingu,9999,0,9999,0
1668456204883,ECE 200,056,103641,Shi; Yuanyuan,9999,0,9999,0
1668456204883,ECE 200,057,103642,Wang; Edward Jay,9999,0,9999,0
1668456204883,ECE 200,058,103643,Zheng; Yang,9999,0,9999,0
1668456205310,ECE 202,A00,103644,Kuzum; Duygu,0,33,0,0
1668456205743,ECE 212BN,A00,103646,Ng; Tse Nga,0,4,0,0
1668456206169,ECE 221,A00,111493,Staff,0,0,0,0
1668456206598,ECE 222B,A00,103647,Lomakin; Vitaliy,0,9,0,0
1668456207025,ECE 230B,A00,103648,Taur; Yuan,0,3,0,0
1668456207450,ECE 238B,A00,103649,Garay; Javier,0,0,0,0
1668456207875,ECE 240B,A00,112900,Fainman; Yeshaiahu,0,4,0,0
1668456208298,ECE 247A,A00,103650,Jokerst; Jesse Vincent,0,2,0,0
1668456208725,ECE 247B,A00,103651,Wang; Joseph,0,8,0,0
1668456209159,ECE 250,A00,103652,Siegel; Paul H.,0,59,0,0
1668456209602,ECE 251A,A00,103654,Rao; Bhaskar D.,0,44,0,0
1668456210026,ECE 257B,A00,103655,Bharadia; Dinesh,0,24,0,0
1668456210451,ECE 258A,A00,103656,Milstein; Laurence B.,0,21,0,0
1668456210877,ECE 260B,A00,103658,Kang; Mingu,0,101,0,0
1668456211311,ECE 264A,A00,103659,Galton; Ian A,0,56,0,0
1668456211736,ECE 265A,A00,103661,Gudem; Prasad S.S.,0,32,0,0
1668456212161,ECE 265D,A00,103662,Gudem; Prasad S.S.,0,19,0,0
1668456212585,ECE 268,A00,103663,Koushanfar; Farinaz,0,36,0,0
1668456213016,ECE 269,A01,103665,Pal; Piya,0,166,0,0
1668456213445,ECE 271B,A00,103666,Vasconcelos; Manuela,0,58,0,0
1668456213871,ECE 276A,A00,103667,Atanasov; Nikolay A.,0,90,0,0
1668456214310,ECE 277,A00,103668,An; Cheolhong,0,122,0,0
1668456214743,ECE 279,A00,117947,Hall; Drew A.,0,17,0,0
1668456215589,ECE 283,A00,103670,Hsueh; Tzu-Chien,0,38,0,0
1668456216012,ECE 284,A00,103671,Turakhia; Yatish Girish,0,34,0,0
1668456216446,ECE 285,A00,103672,Zheng; Yang,0,28,0,0
1668456216446,ECE 285,B00,103673,Sworder; David D.,0,44,0,0
1668456216881,ECE 287,A00,103676,Javidi; Tara,0,6,0,0
1668456217305,MATH 200B,A00,098023,Salehi Golsefidy; Alireza,12,0,15,3
1668456217735,MATH 202B,A00,098024,Rhoades; Brendon Patrick,9,0,15,6
1668456218167,MATH 203B,A00,098025,Oprea; Dragos N.,10,0,15,5
1668456218590,MATH 204B,A00,098026,Sorensen; Claus M,13,0,15,2
1668456219017,MATH 208,A00,098027,Izadi; Elham,7,0,10,3
1668456219444,MATH 209,A00,098028,Pollack; Aaron,10,0,10,0
1668456219883,MATH 211A,A00,112919,Rogalski; Daniel,9,0,10,1
1668456220308,MATH 211B,A00,112920,Seward; Brandon M.,9,0,10,1
1668456220737,MATH 218,A00,098029,Li; Bo,10,0,10,0
1668456221161,MATH 220B,A00,098030,Novak; Jonathan I,11,0,15,4
1668456221587,MATH 221A,A00,098031,Ebenfelt; Peter F,13,0,15,2
1668456222021,MATH 231B,A00,098032,Zlatos; Andrej,11,0,15,4
1668456222444,MATH 240B,A00,098033,Ni; Lei,9,0,15,6
1668456222868,MATH 243,A00,098034,Jekel; David Andrew,10,0,10,0
1668456223294,MATH 245A,A00,098035,Nie; Jiawang,0,2,15,16
1668456223798,MATH 248,A00,098036,Bejenaru; Ioan,10,0,10,0
1668456224225,MATH 250B,A00,098037,Spolaor; Luca,14,0,15,1
1668456224647,MATH 258,A00,098038,Ni; Lei,10,0,10,0
1668456225074,MATH 264B,A00,098041,Rhoades; Brendon Patrick,9,0,15,6
1668456225505,MATH 268,A00,098042,Buss; Samuel R,10,0,10,0
1668456225938,MATH 269,A00,098043,Rhoades; Brendon Patrick,10,0,10,0
1668456226364,MATH 270B,A00,098044,Li; Bo,10,0,15,5
1668456226796,MATH 272B,A00,098045,Holst; Michael J,13,0,15,2
1668456227235,MATH 273A,A00,098046,Tian; Xiaochuan,10,0,15,5
1668456227665,MATH 275,A01,098048,Tian; Xiaochuan,6,0,10,4
1668456228097,MATH 278A,A00,098049,Holst; Michael J,8,0,10,2
1668456228523,MATH 278B,A00,098050,Cloninger; Alexander,10,0,10,0
1668456228958,MATH 278C,A00,098051,Nie; Jiawang,6,0,10,4
1668456229387,MATH 280B,A00,098052,Zheng; Tianyi,7,0,15,8
1668456229814,MATH 281B,A00,098053,Bradic; Jelena,0,2,15,15
1668456230237,MATH 282B,A00,098054,Arias-Castro; Ery,0,0,15,15
1668456230665,MATH 285,A00,098055,Fitzsimmons; Patrick J,0,1,15,17
1668456231091,MATH 287B,A00,098056,Arias-Castro; Ery,2,0,15,13
1668456231520,MATH 288,A00,098057,Agarwal; Pooja,9,0,10,1
1668456231520,MATH 288,B00,098058,Zhang; Danna,8,0,10,2
1668456231520,MATH 288,C00,098059,Williams; Ruth J,9,0,10,1
1668456231949,MATH 290B,A00,098060,Roberts; Justin Deritter,13,0,15,2
1668456232373,MATH 292,A00,098061,Belmont; Eva Kinoshita,10,0,10,0
1668456232798,MATH 295,A00,098062,Suk; Andrew Hoon,48,0,50,2
1668456233226,MATH 296,A00,098063,Novak; Jonathan I,20,0,20,0
1668456233652,MATH 297,001,098064,Gamst; Anthony Collins,9997,0,9999,2
1668456737584,COGS 205,A00,101395,Chiba; Andrea,19,0,20,1
1668456738009,COGS 210B,001,101404,Greene; Deanna Jacquelyn,9998,0,9999,1
1668456738009,COGS 210B,002,101417,Xia; Haijun,9999,0,9999,0
1668456738009,COGS 210B,003,101422,Nitz; Douglas A.,9999,0,9999,0
1668456738009,COGS 210B,004,101423,Hollan; James D.,9998,0,9999,1
1668456738009,COGS 210B,005,101424,Deak; Gedeon O.,9998,0,9999,1
1668456738009,COGS 210B,006,101425,Rossano; Federico,9999,0,9999,0
1668456738441,COGS 211B,A00,101427,Coulson; Seana M,9996,0,9999,3
1668456738868,COGS 220,A00,101428,Hollan; James D.,1,6,25,24
1668456739294,COGS 229,A00,101429,Dow; Steven P,17,0,25,8
1668456739717,COGS 230,A00,101430,Klemmer; Scott R,8,0,17,9
1668456740174,COGS 234,A00,101431,Xia; Haijun,2,0,25,23
1668456740599,COGS 260,A00,101432,Kiyonaga; Anastasia,21,0,25,4
1668456740599,COGS 260,B00,101433,Kirsh; David Joel,15,0,25,10
1668456741023,CSE 202,A00,102371,Impagliazzo; Russell,0,48,0,0
1668456741447,CSE 203B,A01,102373,Cheng; Chung Kuan,0,38,0,0
1668456741879,CSE 208,A00,102374,Micciancio; Daniele,0,3,0,0
1668456742308,CSE 209A,A00,112895,Impagliazzo; Russell,0,8,15,15
1668456742747,CSE 209B,A00,108005,Bellare; Mihir,0,4,0,0
1668456743177,CSE 210,A00,113163,Coblenz; Michael J,0,60,0,0
1668456743602,CSE 219,A00,106111,Dow; Steven P,0,3,20,20
1668456744034,CSE 221,A00,102376,Voelker; Geoffrey M.,0,45,0,0
1668456744457,CSE 224,A01,102378,Porter; George M,0,128,0,0
1668456744881,CSE 229A,A00,102379,Savage; Stefan,0,6,0,0
1668456745317,CSE 229C,A00,102380,Munyaka; Imani N. S.,0,6,0,0
1668456745743,CSE 232B,A00,102382,Deutsch; Alin Bernard,0,23,0,0
1668456746178,CSE 234,A01,112904,Kumar; Arun Kumar,0,0,0,0
1668456746616,CSE 237A,A00,102383,Rosing; Tajana Simunic,0,42,0,0
1668456747117,CSE 239A,A00,102384,Deutsch; Alin Bernard,0,7,0,0
1668456747547,CSE 239B,A00,102385,Polikarpova; Nadezhda,0,7,0,0
1668456747977,CSE 240A,A00,102386,Pannuto; Patrick William,0,36,0,0
1668456748414,CSE 240B,A00,102387,Zhao; Jishen,0,37,0,0
1668456748840,CSE 241A,A00,106406,Kang; Mingu,0,6,0,0
1668456749262,CSE 249B,A00,102388,Kahng; Andrew Byun,0,3,8,8
1668456749693,CSE 251B,A01,102392,Cottrell; Garrison W,0,31,0,0
1668456749693,CSE 251B,A02,102393,Cottrell; Garrison W,0,30,0,0
1668456750118,CSE 252B,A00,102394,Ochoa; Benjamin Lawrence,0,44,0,0
1668456750543,CSE 257,A01,102396,Gao; Sicun,0,106,0,0
1668456750970,CSE 272,A00,102397,Li; Tzumao,0,10,0,0
1668456751403,CSE 274,A00,111323,Chern; Albert Ren-Haur,0,8,0,0
1668456751831,CSE 282,A00,102398,Pevzner; Pavel Arkadjevich,0,0,0,0
1668456752258,CSE 284,A00,114175,Gymrek; Melissa Ann,0,15,0,0
1668456752688,CSE 290,A00,102399,Chandraker; Manmohan Krishna,0,8,0,0
1668456752688,CSE 290,B00,102400,Vaccaro; Kristen Marie,0,5,25,25
1668456752688,CSE 290,C00,102414,Pannuto; Patrick William,0,1,25,25
1668456752688,CSE 290,D00,102427,Pevzner; Pavel Arkadjevich,0,0,0,0
1668456752688,CSE 290,E00,102429,Zhao; Jishen,0,2,0,0
1668456752688,CSE 290,F00,102436,Tullsen; Dean Michael,0,4,0,0
1668456752688,CSE 290,G00,102440,Christensen; Henrik I,0,4,20,20
1668456753113,CSE 291,A00,102443,Su; Hao,0,0,0,0
1668456753113,CSE 291,B00,102448,Polikarpova; Nadezhda,0,0,0,0
1668456753113,CSE 291,C00,102453,Vaccaro; Kristen Marie,0,0,0,0
1668456753113,CSE 291,D00,111343,Savage; Stefan,0,0,0,0
1668456753113,CSE 291,E00,116474,Claffy; Kimberly Claire,0,0,0,0
1668456753113,CSE 291,F00,116479,Pasquale; Joseph,0,0,0,0
1668456753540,CSE 293,001,119111,Bafna; Vineet,9999,0,9999,0
1668456753540,CSE 293,002,119118,Bellare; Mihir,9999,0,9999,0
1668456753540,CSE 293,003,119122,Berg-Kirkpatrick; Taylor D,9999,0,9999,0
1668456753540,CSE 293,004,119135,Christensen; Henrik I,9999,0,9999,0
1668456753540,CSE 293,005,119142,Cottrell; Garrison W,9999,0,9999,0
1668456753540,CSE 293,006,119146,Deutsch; Alin Bernard,9999,0,9999,0
1668456753540,CSE 293,007,119159,Esmaeilzadeh; Hadi,9999,0,9999,0
1668456753540,CSE 293,008,119166,Freund; Yoav,9999,0,9999,0
1668456753540,CSE 293,009,119170,Griswold; William G.,9999,0,9999,0
1668456753540,CSE 293,010,119183,Gymrek; Melissa Ann,9999,0,9999,0
1668456753540,CSE 293,011,119190,Heninger; Nadia A,9999,0,9999,0
1668456753540,CSE 293,012,119230,Impagliazzo; Russell,9999,0,9999,0
1668456753540,CSE 293,013,119232,Jhala; Ranjit,9999,0,9999,0
1668456753540,CSE 293,014,119233,Kahng; Andrew Byun,9999,0,9999,0
1668456753540,CSE 293,015,119298,Kane; Daniel Mertz,9999,0,9999,0
1668456753540,CSE 293,016,119299,Kriegman; David J,9999,0,9999,0
1668456753540,CSE 293,017,119300,Kumar; Arun Kumar,9999,0,9999,0
1668456753540,CSE 293,018,119301,Lerner; Sorin,9999,0,9999,0
1668456753540,CSE 293,019,119302,Lovett; Shachar,9999,0,9999,0
1668456753540,CSE 293,020,119303,McAuley; Julian John,9999,0,9999,0
1668456753540,CSE 293,021,119304,Micciancio; Daniele,9999,0,9999,0
1668456753540,CSE 293,022,119367,Orailoglu; Alex,9999,0,9999,0
1668456753540,CSE 293,023,119382,Paturi; Ramamohan,9999,0,9999,0
1668456753540,CSE 293,024,119404,Polikarpova; Nadezhda,9999,0,9999,0
1668456753540,CSE 293,025,119406,Politz; Joseph Gibbs,9999,0,9999,0
1668456753540,CSE 293,026,119411,Porter; George M,9999,0,9999,0
1668456753540,CSE 293,027,119414,Porter; Leonard Emerson,9999,0,9999,0
1668456753540,CSE 293,028,119416,Ramamoorthi; Ravi,9999,0,9999,0
1668456753540,CSE 293,029,119417,Sahoo; Debashis,9999,0,9999,0
1668456753540,CSE 293,030,119420,Saul; Lawrence,9999,0,9999,0
1668456753540,CSE 293,031,119421,Savage; Stefan,9999,0,9999,0
1668456753540,CSE 293,032,119425,Schulze; Jurgen P.,9999,0,9999,0
1668456753540,CSE 293,033,119426,Snoeren; Alex C.,9999,0,9999,0
1668456753540,CSE 293,034,119428,Shang; Jingbo,9999,0,9999,0
1668456753540,CSE 293,035,119430,Stefan; Deian,9999,0,9999,0
1668456753540,CSE 293,036,119431,Su; Hao,9999,0,9999,0
1668456753540,CSE 293,037,119433,Swanson; Steven James,9999,0,9999,0
1668456753540,CSE 293,038,119435,Tullsen; Dean Michael,9999,0,9999,0
1668456753540,CSE 293,039,119483,Voelker; Geoffrey M.,9999,0,9999,0
1668456753540,CSE 293,040,119537,Zhao; Jishen,9999,0,9999,0
1668456753540,CSE 293,041,119538,Zhou; Yuan-Yuan,9999,0,9999,0
1668456753540,CSE 293,042,119539,Gao; Sicun,9999,0,9999,0
1668456753540,CSE 293,043,119540,Weibel; Nadir,9999,0,9999,0
1668456753540,CSE 293,044,119541,Gupta; Rajesh K.,9999,0,9999,0
1668456753540,CSE 293,045,126410,Vaccaro; Kristen Marie,9999,0,9999,0
1668456753540,CSE 293,046,126411,Klemke; Richard,9999,0,9999,0
1668456753964,CSE 294,A00,102459,Voelker; Geoffrey M.,0,2,0,0
1668456753964,CSE 294,B00,111322,Orailoglu; Alex,0,1,0,0
1668456754402,DSE 201,A00,096914,Deutsch; Alin Bernard,30,0,30,0
1668456754835,DSE 210,A00,096915,Dasgupta; Sanjoy,30,0,30,0
1668456755275,DSE 260A,A00,096916,Altintas De Callaf; Ilkay,30,0,30,0
1668456755719,ECE 200,001,103586,Antipa; Nicholas A,9999,0,9999,0
1668456755719,ECE 200,002,103587,Atanasov; Nikolay A.,9999,0,9999,0
1668456755719,ECE 200,003,103588,Bharadia; Dinesh,9999,0,9999,0
1668456755719,ECE 200,004,103589,Cheng; Chung Kuan,9999,0,9999,0
1668456755719,ECE 200,005,103590,Cosman; Pamela C.,9999,0,9999,0
1668456755719,ECE 200,006,103591,Dayeh; Shadi Ahmad,9999,0,9999,0
1668456755719,ECE 200,007,103592,Fainman; Yeshaiahu,9999,0,9999,0
1668456755719,ECE 200,008,103593,Ford; Joseph Earl,9999,0,9999,0
1668456755719,ECE 200,009,103594,Franceschetti; Massimo,9999,0,9999,0
1668456755719,ECE 200,010,103595,Fullerton; Eric E,9999,0,9999,0
1668456755719,ECE 200,011,103596,Galton; Ian A,9999,0,9999,0
1668456755719,ECE 200,012,103597,Gilja; Vikash,9999,0,9999,0
1668456755719,ECE 200,013,103598,Hall; Drew A.,9999,0,9999,0
1668456755719,ECE 200,014,103599,Hsueh; Tzu-Chien,9999,0,9999,0
1668456755719,ECE 200,015,103600,Javidi; Tara,9999,0,9999,0
1668456755719,ECE 200,016,103601,Kahng; Andrew Byun,9999,0,9999,0
1668456755719,ECE 200,017,103602,Kim; Young-Han,9999,0,9999,0
1668456755719,ECE 200,018,103603,Koushanfar; Farinaz,9999,0,9999,0
1668456755719,ECE 200,019,103604,Kuzum; Duygu,9999,0,9999,0
1668456755719,ECE 200,020,103605,Le; Hanh-Phuc,9999,0,9999,0
1668456755719,ECE 200,021,103606,Lin; Bill,9999,0,9999,0
1668456755719,ECE 200,022,103607,Liu; Zhaowei,9998,0,9999,1
1668456755719,ECE 200,023,103608,Lo; Yu-Hwa,9999,0,9999,0
1668456755719,ECE 200,024,103609,Lomakin; Vitaliy,9999,0,9999,0
1668456755719,ECE 200,025,103610,Mercier; Patrick Philip,9999,0,9999,0
1668456755719,ECE 200,026,103611,Meyer; Florian,9999,0,9999,0
1668456755719,ECE 200,027,103612,Milstein; Laurence B.,9999,0,9999,0
1668456755719,ECE 200,028,103613,Mir Arabbaygi; Siavash,9999,0,9999,0
1668456755719,ECE 200,029,103614,Mookherjea; Shayan,9999,0,9999,0
1668456755719,ECE 200,030,103615,Morris; Karcher William,9999,0,9999,0
1668456755719,ECE 200,031,103616,Ng; Tse Nga,9999,0,9999,0
1668456755719,ECE 200,032,103617,Nguyen; Truong Quang,9999,0,9999,0
1668456755719,ECE 200,033,103618,Nomura; Kenji,9999,0,9999,0
1668456755719,ECE 200,034,103619,Orlitsky; Alon,9999,0,9999,0
1668456755719,ECE 200,035,103620,Pal; Piya,9999,0,9999,0
1668456755719,ECE 200,036,103621,Papen; George C.,9999,0,9999,0
1668456755719,ECE 200,037,103622,Radic; Stojan,9999,0,9999,0
1668456755719,ECE 200,038,103623,Rao; Bhaskar D.,9999,0,9999,0
1668456755719,ECE 200,039,103624,Rao; Ramesh R,9999,0,9999,0
1668456755719,ECE 200,040,103625,Rebeiz; Gabriel,9999,0,9999,0
1668456755719,ECE 200,041,103626,Sanford; John R,9999,0,9999,0
1668456755719,ECE 200,042,103627,Siegel; Paul H.,9999,0,9999,0
1668456755719,ECE 200,043,103628,Sievenpiper; Daniel F.,9999,0,9999,0
1668456755719,ECE 200,044,103629,Sworder; David D.,9999,0,9999,0
1668456755719,ECE 200,045,103630,Taur; Yuan,9999,0,9999,0
1668456755719,ECE 200,046,103631,Touri; Behrouz,9999,0,9999,0
1668456755719,ECE 200,047,103632,Trivedi; Mohan M.,9999,0,9999,0
1668456755719,ECE 200,048,103633,Vasconcelos; Nuno,9999,0,9999,0
1668456755719,ECE 200,049,103634,Wang; Xiaolong,9999,0,9999,0
1668456755719,ECE 200,050,103635,Xie; Pengtao,9999,0,9999,0
1668456755719,ECE 200,051,103636,Yip; Michael,9999,0,9999,0
1668456755719,ECE 200,052,103637,Zeger; Kenneth A.,999,0,999,0
1668456755719,ECE 200,053,103638,Zhang; Xinyu,9999,0,9999,0
1668456755719,ECE 200,054,103639,Turakhia; Yatish Girish,9999,0,9999,0
1668456755719,ECE 200,055,103640,Kang; Mingu,9999,0,9999,0
1668456755719,ECE 200,056,103641,Shi; Yuanyuan,9999,0,9999,0
1668456755719,ECE 200,057,103642,Wang; Edward Jay,9999,0,9999,0
1668456755719,ECE 200,058,103643,Zheng; Yang,9999,0,9999,0
1668456756149,ECE 202,A00,103644,Kuzum; Duygu,0,33,0,0
1668456756575,ECE 212BN,A00,103646,Ng; Tse Nga,0,4,0,0
1668456756999,ECE 221,A00,111493,Staff,0,0,0,0
1668456757426,ECE 222B,A00,103647,Lomakin; Vitaliy,0,9,0,0
1668456757858,ECE 230B,A00,103648,Taur; Yuan,0,3,0,0
1668456758284,ECE 238B,A00,103649,Garay; Javier,0,0,0,0
1668456758718,ECE 240B,A00,112900,Fainman; Yeshaiahu,0,4,0,0
1668456759149,ECE 247A,A00,103650,Jokerst; Jesse Vincent,0,2,0,0
1668456759589,ECE 247B,A00,103651,Wang; Joseph,0,8,0,0
1668456760015,ECE 250,A00,103652,Siegel; Paul H.,0,59,0,0
1668456760439,ECE 251A,A00,103654,Rao; Bhaskar D.,0,44,0,0
1668456760879,ECE 257B,A00,103655,Bharadia; Dinesh,0,24,0,0
1668456761311,ECE 258A,A00,103656,Milstein; Laurence B.,0,21,0,0
1668456761743,ECE 260B,A00,103658,Kang; Mingu,0,101,0,0
1668456762169,ECE 264A,A00,103659,Galton; Ian A,0,56,0,0
1668456762591,ECE 265A,A00,103661,Gudem; Prasad S.S.,0,32,0,0
1668456763031,ECE 265D,A00,103662,Gudem; Prasad S.S.,0,19,0,0
1668456763454,ECE 268,A00,103663,Koushanfar; Farinaz,0,36,0,0
1668456763887,ECE 269,A01,103665,Pal; Piya,0,166,0,0
1668456764320,ECE 271B,A00,103666,Vasconcelos; Manuela,0,58,0,0
1668456764754,ECE 276A,A00,103667,Atanasov; Nikolay A.,0,90,0,0
1668456765185,ECE 277,A00,103668,An; Cheolhong,0,122,0,0
1668456765616,ECE 279,A00,117947,Hall; Drew A.,0,17,0,0
1668456766478,ECE 283,A00,103670,Hsueh; Tzu-Chien,0,38,0,0
1668456766922,ECE 284,A00,103671,Turakhia; Yatish Girish,0,34,0,0
1668456767367,ECE 285,A00,103672,Zheng; Yang,0,28,0,0
1668456767367,ECE 285,B00,103673,Sworder; David D.,0,44,0,0
1668456767792,ECE 287,A00,103676,Javidi; Tara,0,6,0,0
1668456768222,MATH 200B,A00,098023,Salehi Golsefidy; Alireza,12,0,15,3
1668456768657,MATH 202B,A00,098024,Rhoades; Brendon Patrick,9,0,15,6
1668456769084,MATH 203B,A00,098025,Oprea; Dragos N.,10,0,15,5
1668456769510,MATH 204B,A00,098026,Sorensen; Claus M,13,0,15,2
1668456769933,MATH 208,A00,098027,Izadi; Elham,7,0,10,3
1668456770356,MATH 209,A00,098028,Pollack; Aaron,10,0,10,0
1668456770786,MATH 211A,A00,112919,Rogalski; Daniel,9,0,10,1
1668456771213,MATH 211B,A00,112920,Seward; Brandon M.,9,0,10,1
1668456771642,MATH 218,A00,098029,Li; Bo,10,0,10,0
1668456772078,MATH 220B,A00,098030,Novak; Jonathan I,11,0,15,4
1668456772503,MATH 221A,A00,098031,Ebenfelt; Peter F,13,0,15,2
1668456772935,MATH 231B,A00,098032,Zlatos; Andrej,11,0,15,4
1668456773357,MATH 240B,A00,098033,Ni; Lei,9,0,15,6
1668456773783,MATH 243,A00,098034,Jekel; David Andrew,10,0,10,0
1668456774207,MATH 245A,A00,098035,Nie; Jiawang,0,2,15,16
1668456774631,MATH 248,A00,098036,Bejenaru; Ioan,10,0,10,0
1668456775058,MATH 250B,A00,098037,Spolaor; Luca,14,0,15,1
1668456775481,MATH 258,A00,098038,Ni; Lei,10,0,10,0
1668456775907,MATH 264B,A00,098041,Rhoades; Brendon Patrick,9,0,15,6
1668456776330,MATH 268,A00,098042,Buss; Samuel R,10,0,10,0
1668456776774,MATH 269,A00,098043,Rhoades; Brendon Patrick,10,0,10,0
1668456777201,MATH 270B,A00,098044,Li; Bo,10,0,15,5
1668456777630,MATH 272B,A00,098045,Holst; Michael J,13,0,15,2
1668456778056,MATH 273A,A00,098046,Tian; Xiaochuan,10,0,15,5
1668456778480,MATH 275,A01,098048,Tian; Xiaochuan,6,0,10,4
1668456778905,MATH 278A,A00,098049,Holst; Michael J,8,0,10,2
1668456779333,MATH 278B,A00,098050,Cloninger; Alexander,10,0,10,0
1668456779765,MATH 278C,A00,098051,Nie; Jiawang,6,0,10,4
1668456780193,MATH 280B,A00,098052,Zheng; Tianyi,7,0,15,8
1668456780623,MATH 281B,A00,098053,Bradic; Jelena,0,2,15,15
1668456781049,MATH 282B,A00,098054,Arias-Castro; Ery,0,0,15,15
1668456781487,MATH 285,A00,098055,Fitzsimmons; Patrick J,0,1,15,17
1668456781912,MATH 287B,A00,098056,Arias-Castro; Ery,2,0,15,13
1668456782337,MATH 288,A00,098057,Agarwal; Pooja,9,0,10,1
1668456782337,MATH 288,B00,098058,Zhang; Danna,8,0,10,2
1668456782337,MATH 288,C00,098059,Williams; Ruth J,9,0,10,1
1668456782759,MATH 290B,A00,098060,Roberts; Justin Deritter,13,0,15,2
1668456783188,MATH 292,A00,098061,Belmont; Eva Kinoshita,10,0,10,0
1668456783611,MATH 295,A00,098062,Suk; Andrew Hoon,48,0,50,2
1668456784036,MATH 296,A00,098063,Novak; Jonathan I,20,0,20,0
1668456784476,MATH 297,001,098064,Gamst; Anthony Collins,9997,0,9999,2
1668457298582,COGS 205,A00,101395,Chiba; Andrea,19,0,20,1
1668457299006,COGS 210B,001,101404,Greene; Deanna Jacquelyn,9998,0,9999,1
1668457299006,COGS 210B,002,101417,Xia; Haijun,9999,0,9999,0
1668457299006,COGS 210B,003,101422,Nitz; Douglas A.,9999,0,9999,0
1668457299006,COGS 210B,004,101423,Hollan; James D.,9998,0,9999,1
1668457299006,COGS 210B,005,101424,Deak; Gedeon O.,9998,0,9999,1
1668457299006,COGS 210B,006,101425,Rossano; Federico,9999,0,9999,0
1668457299429,COGS 211B,A00,101427,Coulson; Seana M,9996,0,9999,3
1668457299862,COGS 220,A00,101428,Hollan; James D.,1,7,25,24
1668457300292,COGS 229,A00,101429,Dow; Steven P,17,0,25,8
1668457300725,COGS 230,A00,101430,Klemmer; Scott R,8,0,17,9
1668457301149,COGS 234,A00,101431,Xia; Haijun,2,0,25,23
1668457301573,COGS 260,A00,101432,Kiyonaga; Anastasia,21,0,25,4
1668457301573,COGS 260,B00,101433,Kirsh; David Joel,15,0,25,10
1668457302000,CSE 202,A00,102371,Impagliazzo; Russell,0,48,0,0
1668457302432,CSE 203B,A01,102373,Cheng; Chung Kuan,0,38,0,0
1668457302865,CSE 208,A00,102374,Micciancio; Daniele,0,3,0,0
1668457303299,CSE 209A,A00,112895,Impagliazzo; Russell,0,8,15,15
1668457303732,CSE 209B,A00,108005,Bellare; Mihir,0,4,0,0
1668457304159,CSE 210,A00,113163,Coblenz; Michael J,0,61,0,0
1668457304582,CSE 219,A00,106111,Dow; Steven P,0,4,20,20
1668457305018,CSE 221,A00,102376,Voelker; Geoffrey M.,0,45,0,0
1668457305443,CSE 224,A01,102378,Porter; George M,0,130,0,0
1668457305877,CSE 229A,A00,102379,Savage; Stefan,0,6,0,0
1668457306313,CSE 229C,A00,102380,Munyaka; Imani N. S.,0,6,0,0
1668457306741,CSE 232B,A00,102382,Deutsch; Alin Bernard,0,23,0,0
1668457307166,CSE 234,A01,112904,Kumar; Arun Kumar,0,0,0,0
1668457307593,CSE 237A,A00,102383,Rosing; Tajana Simunic,0,43,0,0
1668457308017,CSE 239A,A00,102384,Deutsch; Alin Bernard,0,7,0,0
1668457308449,CSE 239B,A00,102385,Polikarpova; Nadezhda,0,7,0,0
1668457308873,CSE 240A,A00,102386,Pannuto; Patrick William,0,36,0,0
1668457309300,CSE 240B,A00,102387,Zhao; Jishen,0,37,0,0
1668457309724,CSE 241A,A00,106406,Kang; Mingu,0,6,0,0
1668457310159,CSE 249B,A00,102388,Kahng; Andrew Byun,0,3,8,8
1668457310588,CSE 251B,A01,102392,Cottrell; Garrison W,0,31,0,0
1668457310588,CSE 251B,A02,102393,Cottrell; Garrison W,0,30,0,0
1668457311019,CSE 252B,A00,102394,Ochoa; Benjamin Lawrence,0,44,0,0
1668457311446,CSE 257,A01,102396,Gao; Sicun,0,107,0,0
1668457311887,CSE 272,A00,102397,Li; Tzumao,0,10,0,0
1668457312310,CSE 274,A00,111323,Chern; Albert Ren-Haur,0,8,0,0
1668457312734,CSE 282,A00,102398,Pevzner; Pavel Arkadjevich,0,0,0,0
1668457313173,CSE 284,A00,114175,Gymrek; Melissa Ann,0,15,0,0
1668457313597,CSE 290,A00,102399,Chandraker; Manmohan Krishna,0,8,0,0
1668457313597,CSE 290,B00,102400,Vaccaro; Kristen Marie,0,5,25,25
1668457313597,CSE 290,C00,102414,Pannuto; Patrick William,0,1,25,25
1668457313597,CSE 290,D00,102427,Pevzner; Pavel Arkadjevich,0,0,0,0
1668457313597,CSE 290,E00,102429,Zhao; Jishen,0,2,0,0
1668457313597,CSE 290,F00,102436,Tullsen; Dean Michael,0,4,0,0
1668457313597,CSE 290,G00,102440,Christensen; Henrik I,0,4,20,20
1668457314027,CSE 291,A00,102443,Su; Hao,0,0,0,0
1668457314027,CSE 291,B00,102448,Polikarpova; Nadezhda,0,0,0,0
1668457314027,CSE 291,C00,102453,Vaccaro; Kristen Marie,0,0,0,0
1668457314027,CSE 291,D00,111343,Savage; Stefan,0,0,0,0
1668457314027,CSE 291,E00,116474,Claffy; Kimberly Claire,0,0,0,0
1668457314027,CSE 291,F00,116479,Pasquale; Joseph,0,0,0,0
1668457314465,CSE 293,001,119111,Bafna; Vineet,9999,0,9999,0
1668457314465,CSE 293,002,119118,Bellare; Mihir,9999,0,9999,0
1668457314465,CSE 293,003,119122,Berg-Kirkpatrick; Taylor D,9999,0,9999,0
1668457314465,CSE 293,004,119135,Christensen; Henrik I,9999,0,9999,0
1668457314465,CSE 293,005,119142,Cottrell; Garrison W,9999,0,9999,0
1668457314465,CSE 293,006,119146,Deutsch; Alin Bernard,9999,0,9999,0
1668457314465,CSE 293,007,119159,Esmaeilzadeh; Hadi,9999,0,9999,0
1668457314465,CSE 293,008,119166,Freund; Yoav,9999,0,9999,0
1668457314465,CSE 293,009,119170,Griswold; William G.,9999,0,9999,0
1668457314465,CSE 293,010,119183,Gymrek; Melissa Ann,9999,0,9999,0
1668457314465,CSE 293,011,119190,Heninger; Nadia A,9999,0,9999,0
1668457314465,CSE 293,012,119230,Impagliazzo; Russell,9999,0,9999,0
1668457314465,CSE 293,013,119232,Jhala; Ranjit,9999,0,9999,0
1668457314465,CSE 293,014,119233,Kahng; Andrew Byun,9999,0,9999,0
1668457314465,CSE 293,015,119298,Kane; Daniel Mertz,9999,0,9999,0
1668457314465,CSE 293,016,119299,Kriegman; David J,9999,0,9999,0
1668457314465,CSE 293,017,119300,Kumar; Arun Kumar,9999,0,9999,0
1668457314465,CSE 293,018,119301,Lerner; Sorin,9999,0,9999,0
1668457314465,CSE 293,019,119302,Lovett; Shachar,9999,0,9999,0
1668457314465,CSE 293,020,119303,McAuley; Julian John,9999,0,9999,0
1668457314465,CSE 293,021,119304,Micciancio; Daniele,9999,0,9999,0
1668457314465,CSE 293,022,119367,Orailoglu; Alex,9999,0,9999,0
1668457314465,CSE 293,023,119382,Paturi; Ramamohan,9999,0,9999,0
1668457314465,CSE 293,024,119404,Polikarpova; Nadezhda,9999,0,9999,0
1668457314465,CSE 293,025,119406,Politz; Joseph Gibbs,9999,0,9999,0
1668457314465,CSE 293,026,119411,Porter; George M,9999,0,9999,0
1668457314465,CSE 293,027,119414,Porter; Leonard Emerson,9999,0,9999,0
1668457314465,CSE 293,028,119416,Ramamoorthi; Ravi,9999,0,9999,0
1668457314465,CSE 293,029,119417,Sahoo; Debashis,9999,0,9999,0
1668457314465,CSE 293,030,119420,Saul; Lawrence,9999,0,9999,0
1668457314465,CSE 293,031,119421,Savage; Stefan,9999,0,9999,0
1668457314465,CSE 293,032,119425,Schulze; Jurgen P.,9999,0,9999,0
1668457314465,CSE 293,033,119426,Snoeren; Alex C.,9999,0,9999,0
1668457314465,CSE 293,034,119428,Shang; Jingbo,9999,0,9999,0
1668457314465,CSE 293,035,119430,Stefan; Deian,9999,0,9999,0
1668457314465,CSE 293,036,119431,Su; Hao,9999,0,9999,0
1668457314465,CSE 293,037,119433,Swanson; Steven James,9999,0,9999,0
1668457314465,CSE 293,038,119435,Tullsen; Dean Michael,9999,0,9999,0
1668457314465,CSE 293,039,119483,Voelker; Geoffrey M.,9999,0,9999,0
1668457314465,CSE 293,040,119537,Zhao; Jishen,9999,0,9999,0
1668457314465,CSE 293,041,119538,Zhou; Yuan-Yuan,9999,0,9999,0
1668457314465,CSE 293,042,119539,Gao; Sicun,9999,0,9999,0
1668457314465,CSE 293,043,119540,Weibel; Nadir,9999,0,9999,0
1668457314465,CSE 293,044,119541,Gupta; Rajesh K.,9999,0,9999,0
1668457314465,CSE 293,045,126410,Vaccaro; Kristen Marie,9999,0,9999,0
1668457314465,CSE 293,046,126411,Klemke; Richard,9999,0,9999,0
1668457314902,CSE 294,A00,102459,Voelker; Geoffrey M.,0,2,0,0
1668457314902,CSE 294,B00,111322,Orailoglu; Alex,0,1,0,0
1668457315327,DSE 201,A00,096914,Deutsch; Alin Bernard,30,0,30,0
1668457315757,DSE 210,A00,096915,Dasgupta; Sanjoy,30,0,30,0
1668457316179,DSE 260A,A00,096916,Altintas De Callaf; Ilkay,30,0,30,0
1668457316612,ECE 200,001,103586,Antipa; Nicholas A,9999,0,9999,0
1668457316612,ECE 200,002,103587,Atanasov; Nikolay A.,9999,0,9999,0
1668457316612,ECE 200,003,103588,Bharadia; Dinesh,9999,0,9999,0
1668457316612,ECE 200,004,103589,Cheng; Chung Kuan,9999,0,9999,0
1668457316612,ECE 200,005,103590,Cosman; Pamela C.,9999,0,9999,0
1668457316612,ECE 200,006,103591,Dayeh; Shadi Ahmad,9999,0,9999,0
1668457316612,ECE 200,007,103592,Fainman; Yeshaiahu,9999,0,9999,0
1668457316612,ECE 200,008,103593,Ford; Joseph Earl,9999,0,9999,0
1668457316612,ECE 200,009,103594,Franceschetti; Massimo,9999,0,9999,0
1668457316612,ECE 200,010,103595,Fullerton; Eric E,9999,0,9999,0
1668457316612,ECE 200,011,103596,Galton; Ian A,9999,0,9999,0
1668457316612,ECE 200,012,103597,Gilja; Vikash,9999,0,9999,0
1668457316612,ECE 200,013,103598,Hall; Drew A.,9999,0,9999,0
1668457316612,ECE 200,014,103599,Hsueh; Tzu-Chien,9999,0,9999,0
1668457316612,ECE 200,015,103600,Javidi; Tara,9999,0,9999,0
1668457316612,ECE 200,016,103601,Kahng; Andrew Byun,9999,0,9999,0
1668457316612,ECE 200,017,103602,Kim; Young-Han,9999,0,9999,0
1668457316612,ECE 200,018,103603,Koushanfar; Farinaz,9999,0,9999,0
1668457316612,ECE 200,019,103604,Kuzum; Duygu,9999,0,9999,0
1668457316612,ECE 200,020,103605,Le; Hanh-Phuc,9999,0,9999,0
1668457316612,ECE 200,021,103606,Lin; Bill,9999,0,9999,0
1668457316612,ECE 200,022,103607,Liu; Zhaowei,9998,0,9999,1
1668457316612,ECE 200,023,103608,Lo; Yu-Hwa,9999,0,9999,0
1668457316612,ECE 200,024,103609,Lomakin; Vitaliy,9999,0,9999,0
1668457316612,ECE 200,025,103610,Mercier; Patrick Philip,9999,0,9999,0
1668457316612,ECE 200,026,103611,Meyer; Florian,9999,0,9999,0
1668457316612,ECE 200,027,103612,Milstein; Laurence B.,9999,0,9999,0
1668457316612,ECE 200,028,103613,Mir Arabbaygi; Siavash,9999,0,9999,0
1668457316612,ECE 200,029,103614,Mookherjea; Shayan,9999,0,9999,0
1668457316612,ECE 200,030,103615,Morris; Karcher William,9999,0,9999,0
1668457316612,ECE 200,031,103616,Ng; Tse Nga,9999,0,9999,0
1668457316612,ECE 200,032,103617,Nguyen; Truong Quang,9999,0,9999,0
1668457316612,ECE 200,033,103618,Nomura; Kenji,9999,0,9999,0
1668457316612,ECE 200,034,103619,Orlitsky; Alon,9999,0,9999,0
1668457316612,ECE 200,035,103620,Pal; Piya,9999,0,9999,0
1668457316612,ECE 200,036,103621,Papen; George C.,9999,0,9999,0
1668457316612,ECE 200,037,103622,Radic; Stojan,9999,0,9999,0
1668457316612,ECE 200,038,103623,Rao; Bhaskar D.,9999,0,9999,0
1668457316612,ECE 200,039,103624,Rao; Ramesh R,9999,0,9999,0
1668457316612,ECE 200,040,103625,Rebeiz; Gabriel,9999,0,9999,0
1668457316612,ECE 200,041,103626,Sanford; John R,9999,0,9999,0
1668457316612,ECE 200,042,103627,Siegel; Paul H.,9999,0,9999,0
1668457316612,ECE 200,043,103628,Sievenpiper; Daniel F.,9999,0,9999,0
1668457316612,ECE 200,044,103629,Sworder; David D.,9999,0,9999,0
1668457316612,ECE 200,045,103630,Taur; Yuan,9999,0,9999,0
1668457316612,ECE 200,046,103631,Touri; Behrouz,9999,0,9999,0
1668457316612,ECE 200,047,103632,Trivedi; Mohan M.,9999,0,9999,0
1668457316612,ECE 200,048,103633,Vasconcelos; Nuno,9999,0,9999,0
1668457316612,ECE 200,049,103634,Wang; Xiaolong,9999,0,9999,0
1668457316612,ECE 200,050,103635,Xie; Pengtao,9999,0,9999,0
1668457316612,ECE 200,051,103636,Yip; Michael,9999,0,9999,0
1668457316612,ECE 200,052,103637,Zeger; Kenneth A.,999,0,999,0
1668457316612,ECE 200,053,103638,Zhang; Xinyu,9999,0,9999,0
1668457316612,ECE 200,054,103639,Turakhia; Yatish Girish,9999,0,9999,0
1668457316612,ECE 200,055,103640,Kang; Mingu,9999,0,9999,0
1668457316612,ECE 200,056,103641,Shi; Yuanyuan,9999,0,9999,0
1668457316612,ECE 200,057,103642,Wang; Edward Jay,9999,0,9999,0
1668457316612,ECE 200,058,103643,Zheng; Yang,9999,0,9999,0
1668457317039,ECE 202,A00,103644,Kuzum; Duygu,0,33,0,0
1668457317475,ECE 212BN,A00,103646,Ng; Tse Nga,0,4,0,0
1668457317904,ECE 221,A00,111493,Staff,0,0,0,0
1668457318336,ECE 222B,A00,103647,Lomakin; Vitaliy,0,9,0,0
1668457318765,ECE 230B,A00,103648,Taur; Yuan,0,2,0,0
1668457319191,ECE 238B,A00,103649,Garay; Javier,0,0,0,0
1668457319615,ECE 240B,A00,112900,Fainman; Yeshaiahu,0,4,0,0
1668457320046,ECE 247A,A00,103650,Jokerst; Jesse Vincent,0,2,0,0
1668457320473,ECE 247B,A00,103651,Wang; Joseph,0,8,0,0
1668457320899,ECE 250,A00,103652,Siegel; Paul H.,0,60,0,0
1668457321330,ECE 251A,A00,103654,Rao; Bhaskar D.,0,45,0,0
1668457321756,ECE 257B,A00,103655,Bharadia; Dinesh,0,25,0,0
1668457322180,ECE 258A,A00,103656,Milstein; Laurence B.,0,22,0,0
1668457322617,ECE 260B,A00,103658,Kang; Mingu,0,102,0,0
1668457323041,ECE 264A,A00,103659,Galton; Ian A,0,56,0,0
1668457323474,ECE 265A,A00,103661,Gudem; Prasad S.S.,0,34,0,0
1668457323997,ECE 265D,A00,103662,Gudem; Prasad S.S.,0,19,0,0
1668457324421,ECE 268,A00,103663,Koushanfar; Farinaz,0,36,0,0
1668457324855,ECE 269,A01,103665,Pal; Piya,0,167,0,0
1668457325280,ECE 271B,A00,103666,Vasconcelos; Manuela,0,58,0,0
1668457325711,ECE 276A,A00,103667,Atanasov; Nikolay A.,0,90,0,0
1668457326136,ECE 277,A00,103668,An; Cheolhong,0,122,0,0
1668457326560,ECE 279,A00,117947,Hall; Drew A.,0,17,0,0
1668457327420,ECE 283,A00,103670,Hsueh; Tzu-Chien,0,39,0,0
1668457327850,ECE 284,A00,103671,Turakhia; Yatish Girish,0,34,0,0
1668457328305,ECE 285,A00,103672,Zheng; Yang,0,30,0,0
1668457328305,ECE 285,B00,103673,Sworder; David D.,0,44,0,0
1668457328729,ECE 287,A00,103676,Javidi; Tara,0,6,0,0
1668457329153,MATH 200B,A00,098023,Salehi Golsefidy; Alireza,12,0,15,3
1668457329581,MATH 202B,A00,098024,Rhoades; Brendon Patrick,9,0,15,6
1668457330005,MATH 203B,A00,098025,Oprea; Dragos N.,10,0,15,5
1668457330428,MATH 204B,A00,098026,Sorensen; Claus M,13,0,15,2
1668457330853,MATH 208,A00,098027,Izadi; Elham,7,0,10,3
1668457331279,MATH 209,A00,098028,Pollack; Aaron,10,0,10,0
1668457331704,MATH 211A,A00,112919,Rogalski; Daniel,9,0,10,1
1668457332133,MATH 211B,A00,112920,Seward; Brandon M.,9,0,10,1
1668457332556,MATH 218,A00,098029,Li; Bo,10,0,10,0
1668457332988,MATH 220B,A00,098030,Novak; Jonathan I,11,0,15,4
1668457333421,MATH 221A,A00,098031,Ebenfelt; Peter F,13,0,15,2
1668457333846,MATH 231B,A00,098032,Zlatos; Andrej,11,0,15,4
1668457334271,MATH 240B,A00,098033,Ni; Lei,9,0,15,6
1668457334699,MATH 243,A00,098034,Jekel; David Andrew,10,0,10,0
1668457335132,MATH 245A,A00,098035,Nie; Jiawang,0,2,15,16
1668457335556,MATH 248,A00,098036,Bejenaru; Ioan,10,0,10,0
1668457335979,MATH 250B,A00,098037,Spolaor; Luca,14,0,15,1
1668457336403,MATH 258,A00,098038,Ni; Lei,10,0,10,0
1668457336834,MATH 264B,A00,098041,Rhoades; Brendon Patrick,9,0,15,6
1668457337260,MATH 268,A00,098042,Buss; Samuel R,10,0,10,0
1668457337692,MATH 269,A00,098043,Rhoades; Brendon Patrick,10,0,10,0
1668457338124,MATH 270B,A00,098044,Li; Bo,10,0,15,5
1668457338549,MATH 272B,A00,098045,Holst; Michael J,13,0,15,2
1668457338975,MATH 273A,A00,098046,Tian; Xiaochuan,10,0,15,5
1668457339402,MATH 275,A01,098048,Tian; Xiaochuan,6,0,10,4
1668457339832,MATH 278A,A00,098049,Holst; Michael J,8,0,10,2
1668457340255,MATH 278B,A00,098050,Cloninger; Alexander,10,0,10,0
1668457340678,MATH 278C,A00,098051,Nie; Jiawang,6,0,10,4
1668457341106,MATH 280B,A00,098052,Zheng; Tianyi,7,0,15,8
1668457341529,MATH 281B,A00,098053,Bradic; Jelena,0,2,15,15
1668457341955,MATH 282B,A00,098054,Arias-Castro; Ery,0,0,15,15
1668457342393,MATH 285,A00,098055,Fitzsimmons; Patrick J,0,1,15,17
1668457342817,MATH 287B,A00,098056,Arias-Castro; Ery,2,0,15,13
1668457343247,MATH 288,A00,098057,Agarwal; Pooja,9,0,10,1
1668457343247,MATH 288,B00,098058,Zhang; Danna,8,0,10,2
1668457343247,MATH 288,C00,098059,Williams; Ruth J,9,0,10,1
1668457343671,MATH 290B,A00,098060,Roberts; Justin Deritter,13,0,15,2
1668457344094,MATH 292,A00,098061,Belmont; Eva Kinoshita,10,0,10,0
1668457344532,MATH 295,A00,098062,Suk; Andrew Hoon,48,0,50,2
1668457344958,MATH 296,A00,098063,Novak; Jonathan I,20,0,20,0
1668457345397,MATH 297,001,098064,Gamst; Anthony Collins,9997,0,9999,2
1668457849284,COGS 205,A00,101395,Chiba; Andrea,19,0,20,1
1668457849726,COGS 210B,001,101404,Greene; Deanna Jacquelyn,9998,0,9999,1
1668457849726,COGS 210B,002,101417,Xia; Haijun,9999,0,9999,0
1668457849726,COGS 210B,003,101422,Nitz; Douglas A.,9999,0,9999,0
1668457849726,COGS 210B,004,101423,Hollan; James D.,9998,0,9999,1
1668457849726,COGS 210B,005,101424,Deak; Gedeon O.,9998,0,9999,1
1668457849726,COGS 210B,006,101425,Rossano; Federico,9999,0,9999,0
1668457850156,COGS 211B,A00,101427,Coulson; Seana M,9996,0,9999,3
1668457850594,COGS 220,A00,101428,Hollan; James D.,1,7,25,24
1668457851035,COGS 229,A00,101429,Dow; Steven P,17,0,25,8
1668457851468,COGS 230,A00,101430,Klemmer; Scott R,8,0,17,9
1668457851901,COGS 234,A00,101431,Xia; Haijun,2,0,25,23
1668457852335,COGS 260,A00,101432,Kiyonaga; Anastasia,21,0,25,4
1668457852335,COGS 260,B00,101433,Kirsh; David Joel,15,0,25,10
1668457852761,CSE 202,A00,102371,Impagliazzo; Russell,0,50,0,0
1668457853187,CSE 203B,A01,102373,Cheng; Chung Kuan,0,39,0,0
1668457853611,CSE 208,A00,102374,Micciancio; Daniele,0,3,0,0
1668457854035,CSE 209A,A00,112895,Impagliazzo; Russell,0,8,15,15
1668457854467,CSE 209B,A00,108005,Bellare; Mihir,0,4,0,0
1668457854896,CSE 210,A00,113163,Coblenz; Michael J,0,61,0,0
1668457855329,CSE 219,A00,106111,Dow; Steven P,0,4,20,20
1668457855765,CSE 221,A00,102376,Voelker; Geoffrey M.,0,46,0,0
1668457856198,CSE 224,A01,102378,Porter; George M,0,133,0,0
1668457856628,CSE 229A,A00,102379,Savage; Stefan,0,6,0,0
1668457857066,CSE 229C,A00,102380,Munyaka; Imani N. S.,0,6,0,0
1668457857496,CSE 232B,A00,102382,Deutsch; Alin Bernard,0,23,0,0
1668457857930,CSE 234,A01,112904,Kumar; Arun Kumar,0,0,0,0
1668457858374,CSE 237A,A00,102383,Rosing; Tajana Simunic,0,43,0,0
1668457858802,CSE 239A,A00,102384,Deutsch; Alin Bernard,0,7,0,0
1668457859226,CSE 239B,A00,102385,Polikarpova; Nadezhda,0,7,0,0
1668457859652,CSE 240A,A00,102386,Pannuto; Patrick William,0,37,0,0
1668457860080,CSE 240B,A00,102387,Zhao; Jishen,0,37,0,0
1668457860523,CSE 241A,A00,106406,Kang; Mingu,0,6,0,0
1668457860954,CSE 249B,A00,102388,Kahng; Andrew Byun,0,3,8,8
1668457861382,CSE 251B,A01,102392,Cottrell; Garrison W,0,31,0,0
1668457861382,CSE 251B,A02,102393,Cottrell; Garrison W,0,30,0,0
1668457861822,CSE 252B,A00,102394,Ochoa; Benjamin Lawrence,0,44,0,0
1668457862247,CSE 257,A01,102396,Gao; Sicun,0,111,0,0
1668457862672,CSE 272,A00,102397,Li; Tzumao,0,11,0,0
1668457863097,CSE 274,A00,111323,Chern; Albert Ren-Haur,0,8,0,0
1668457863535,CSE 282,A00,102398,Pevzner; Pavel Arkadjevich,0,0,0,0
1668457863960,CSE 284,A00,114175,Gymrek; Melissa Ann,0,16,0,0
1668457864383,CSE 290,A00,102399,Chandraker; Manmohan Krishna,0,8,0,0
1668457864383,CSE 290,B00,102400,Vaccaro; Kristen Marie,0,5,25,25
1668457864383,CSE 290,C00,102414,Pannuto; Patrick William,0,1,25,25
1668457864383,CSE 290,D00,102427,Pevzner; Pavel Arkadjevich,0,0,0,0
1668457864383,CSE 290,E00,102429,Zhao; Jishen,0,2,0,0
1668457864383,CSE 290,F00,102436,Tullsen; Dean Michael,0,4,0,0
1668457864383,CSE 290,G00,102440,Christensen; Henrik I,0,4,20,20
1668457864817,CSE 291,A00,102443,Su; Hao,0,0,0,0
1668457864817,CSE 291,B00,102448,Polikarpova; Nadezhda,0,0,0,0
1668457864817,CSE 291,C00,102453,Vaccaro; Kristen Marie,0,0,0,0
1668457864817,CSE 291,D00,111343,Savage; Stefan,0,0,0,0
1668457864817,CSE 291,E00,116474,Claffy; Kimberly Claire,0,0,0,0
1668457864817,CSE 291,F00,116479,Pasquale; Joseph,0,0,0,0
1668457865245,CSE 293,001,119111,Bafna; Vineet,9999,0,9999,0
1668457865245,CSE 293,002,119118,Bellare; Mihir,9999,0,9999,0
1668457865245,CSE 293,003,119122,Berg-Kirkpatrick; Taylor D,9999,0,9999,0
1668457865245,CSE 293,004,119135,Christensen; Henrik I,9999,0,9999,0
1668457865245,CSE 293,005,119142,Cottrell; Garrison W,9999,0,9999,0
1668457865245,CSE 293,006,119146,Deutsch; Alin Bernard,9999,0,9999,0
1668457865245,CSE 293,007,119159,Esmaeilzadeh; Hadi,9999,0,9999,0
1668457865245,CSE 293,008,119166,Freund; Yoav,9999,0,9999,0
1668457865245,CSE 293,009,119170,Griswold; William G.,9999,0,9999,0
1668457865245,CSE 293,010,119183,Gymrek; Melissa Ann,9999,0,9999,0
1668457865245,CSE 293,011,119190,Heninger; Nadia A,9999,0,9999,0
1668457865245,CSE 293,012,119230,Impagliazzo; Russell,9999,0,9999,0
1668457865245,CSE 293,013,119232,Jhala; Ranjit,9999,0,9999,0
1668457865245,CSE 293,014,119233,Kahng; Andrew Byun,9999,0,9999,0
1668457865245,CSE 293,015,119298,Kane; Daniel Mertz,9999,0,9999,0
1668457865245,CSE 293,016,119299,Kriegman; David J,9999,0,9999,0
1668457865245,CSE 293,017,119300,Kumar; Arun Kumar,9999,0,9999,0
1668457865245,CSE 293,018,119301,Lerner; Sorin,9999,0,9999,0
1668457865245,CSE 293,019,119302,Lovett; Shachar,9999,0,9999,0
1668457865245,CSE 293,020,119303,McAuley; Julian John,9999,0,9999,0
1668457865245,CSE 293,021,119304,Micciancio; Daniele,9999,0,9999,0
1668457865245,CSE 293,022,119367,Orailoglu; Alex,9999,0,9999,0
1668457865245,CSE 293,023,119382,Paturi; Ramamohan,9999,0,9999,0
1668457865245,CSE 293,024,119404,Polikarpova; Nadezhda,9999,0,9999,0
1668457865245,CSE 293,025,119406,Politz; Joseph Gibbs,9999,0,9999,0
1668457865245,CSE 293,026,119411,Porter; George M,9999,0,9999,0
1668457865245,CSE 293,027,119414,Porter; Leonard Emerson,9999,0,9999,0
1668457865245,CSE 293,028,119416,Ramamoorthi; Ravi,9999,0,9999,0
1668457865245,CSE 293,029,119417,Sahoo; Debashis,9999,0,9999,0
1668457865245,CSE 293,030,119420,Saul; Lawrence,9999,0,9999,0
1668457865245,CSE 293,031,119421,Savage; Stefan,9999,0,9999,0
1668457865245,CSE 293,032,119425,Schulze; Jurgen P.,9999,0,9999,0
1668457865245,CSE 293,033,119426,Snoeren; Alex C.,9999,0,9999,0
1668457865245,CSE 293,034,119428,Shang; Jingbo,9999,0,9999,0
1668457865245,CSE 293,035,119430,Stefan; Deian,9999,0,9999,0
1668457865245,CSE 293,036,119431,Su; Hao,9999,0,9999,0
1668457865245,CSE 293,037,119433,Swanson; Steven James,9999,0,9999,0
1668457865245,CSE 293,038,119435,Tullsen; Dean Michael,9999,0,9999,0
1668457865245,CSE 293,039,119483,Voelker; Geoffrey M.,9999,0,9999,0
1668457865245,CSE 293,040,119537,Zhao; Jishen,9999,0,9999,0
1668457865245,CSE 293,041,119538,Zhou; Yuan-Yuan,9999,0,9999,0
1668457865245,CSE 293,042,119539,Gao; Sicun,9999,0,9999,0
1668457865245,CSE 293,043,119540,Weibel; Nadir,9999,0,9999,0
1668457865245,CSE 293,044,119541,Gupta; Rajesh K.,9999,0,9999,0
1668457865245,CSE 293,045,126410,Vaccaro; Kristen Marie,9999,0,9999,0
1668457865245,CSE 293,046,126411,Klemke; Richard,9999,0,9999,0
1668457865682,CSE 294,A00,102459,Voelker; Geoffrey M.,0,2,0,0
1668457865682,CSE 294,B00,111322,Orailoglu; Alex,0,1,0,0
1668457866108,DSE 201,A00,096914,Deutsch; Alin Bernard,30,0,30,0
1668457866532,DSE 210,A00,096915,Dasgupta; Sanjoy,30,0,30,0
1668457866958,DSE 260A,A00,096916,Altintas De Callaf; Ilkay,30,0,30,0
1668457867411,ECE 200,001,103586,Antipa; Nicholas A,9999,0,9999,0
1668457867411,ECE 200,002,103587,Atanasov; Nikolay A.,9999,0,9999,0
1668457867411,ECE 200,003,103588,Bharadia; Dinesh,9999,0,9999,0
1668457867411,ECE 200,004,103589,Cheng; Chung Kuan,9999,0,9999,0
1668457867411,ECE 200,005,103590,Cosman; Pamela C.,9999,0,9999,0
1668457867411,ECE 200,006,103591,Dayeh; Shadi Ahmad,9999,0,9999,0
1668457867411,ECE 200,007,103592,Fainman; Yeshaiahu,9999,0,9999,0
1668457867411,ECE 200,008,103593,Ford; Joseph Earl,9999,0,9999,0
1668457867411,ECE 200,009,103594,Franceschetti; Massimo,9999,0,9999,0
1668457867411,ECE 200,010,103595,Fullerton; Eric E,9999,0,9999,0
1668457867411,ECE 200,011,103596,Galton; Ian A,9999,0,9999,0
1668457867411,ECE 200,012,103597,Gilja; Vikash,9999,0,9999,0
1668457867411,ECE 200,013,103598,Hall; Drew A.,9999,0,9999,0
1668457867411,ECE 200,014,103599,Hsueh; Tzu-Chien,9999,0,9999,0
1668457867411,ECE 200,015,103600,Javidi; Tara,9999,0,9999,0
1668457867411,ECE 200,016,103601,Kahng; Andrew Byun,9999,0,9999,0
1668457867411,ECE 200,017,103602,Kim; Young-Han,9999,0,9999,0
1668457867411,ECE 200,018,103603,Koushanfar; Farinaz,9999,0,9999,0
1668457867411,ECE 200,019,103604,Kuzum; Duygu,9999,0,9999,0
1668457867411,ECE 200,020,103605,Le; Hanh-Phuc,9999,0,9999,0
1668457867411,ECE 200,021,103606,Lin; Bill,9999,0,9999,0
1668457867411,ECE 200,022,103607,Liu; Zhaowei,9998,0,9999,1
1668457867411,ECE 200,023,103608,Lo; Yu-Hwa,9999,0,9999,0
1668457867411,ECE 200,024,103609,Lomakin; Vitaliy,9999,0,9999,0
1668457867411,ECE 200,025,103610,Mercier; Patrick Philip,9999,0,9999,0
1668457867411,ECE 200,026,103611,Meyer; Florian,9999,0,9999,0
1668457867411,ECE 200,027,103612,Milstein; Laurence B.,9999,0,9999,0
1668457867411,ECE 200,028,103613,Mir Arabbaygi; Siavash,9999,0,9999,0
1668457867411,ECE 200,029,103614,Mookherjea; Shayan,9999,0,9999,0
1668457867411,ECE 200,030,103615,Morris; Karcher William,9999,0,9999,0
1668457867411,ECE 200,031,103616,Ng; Tse Nga,9999,0,9999,0
1668457867411,ECE 200,032,103617,Nguyen; Truong Quang,9999,0,9999,0
1668457867411,ECE 200,033,103618,Nomura; Kenji,9999,0,9999,0
1668457867411,ECE 200,034,103619,Orlitsky; Alon,9999,0,9999,0
1668457867411,ECE 200,035,103620,Pal; Piya,9999,0,9999,0
1668457867411,ECE 200,036,103621,Papen; George C.,9999,0,9999,0
1668457867411,ECE 200,037,103622,Radic; Stojan,9999,0,9999,0
1668457867411,ECE 200,038,103623,Rao; Bhaskar D.,9999,0,9999,0
1668457867411,ECE 200,039,103624,Rao; Ramesh R,9999,0,9999,0
1668457867411,ECE 200,040,103625,Rebeiz; Gabriel,9999,0,9999,0
1668457867411,ECE 200,041,103626,Sanford; John R,9999,0,9999,0
1668457867411,ECE 200,042,103627,Siegel; Paul H.,9999,0,9999,0
1668457867411,ECE 200,043,103628,Sievenpiper; Daniel F.,9999,0,9999,0
1668457867411,ECE 200,044,103629,Sworder; David D.,9999,0,9999,0
1668457867411,ECE 200,045,103630,Taur; Yuan,9999,0,9999,0
1668457867411,ECE 200,046,103631,Touri; Behrouz,9999,0,9999,0
1668457867411,ECE 200,047,103632,Trivedi; Mohan M.,9999,0,9999,0
1668457867411,ECE 200,048,103633,Vasconcelos; Nuno,9999,0,9999,0
1668457867411,ECE 200,049,103634,Wang; Xiaolong,9999,0,9999,0
1668457867411,ECE 200,050,103635,Xie; Pengtao,9999,0,9999,0
1668457867411,ECE 200,051,103636,Yip; Michael,9999,0,9999,0
1668457867411,ECE 200,052,103637,Zeger; Kenneth A.,999,0,999,0
1668457867411,ECE 200,053,103638,Zhang; Xinyu,9999,0,9999,0
1668457867411,ECE 200,054,103639,Turakhia; Yatish Girish,9999,0,9999,0
1668457867411,ECE 200,055,103640,Kang; Mingu,9999,0,9999,0
1668457867411,ECE 200,056,103641,Shi; Yuanyuan,9999,0,9999,0
1668457867411,ECE 200,057,103642,Wang; Edward Jay,9999,0,9999,0
1668457867411,ECE 200,058,103643,Zheng; Yang,9999,0,9999,0
1668457867838,ECE 202,A00,103644,Kuzum; Duygu,0,35,0,0
1668457868261,ECE 212BN,A00,103646,Ng; Tse Nga,0,4,0,0
1668457868684,ECE 221,A00,111493,Staff,0,0,0,0
1668457869114,ECE 222B,A00,103647,Lomakin; Vitaliy,0,9,0,0
1668457869541,ECE 230B,A00,103648,Taur; Yuan,0,2,0,0
1668457869969,ECE 238B,A00,103649,Garay; Javier,0,0,0,0
1668457870397,ECE 240B,A00,112900,Fainman; Yeshaiahu,0,4,0,0
1668457870822,ECE 247A,A00,103650,Jokerst; Jesse Vincent,0,2,0,0
1668457871253,ECE 247B,A00,103651,Wang; Joseph,0,8,0,0
1668457871678,ECE 250,A00,103652,Siegel; Paul H.,0,61,0,0
1668457872111,ECE 251A,A00,103654,Rao; Bhaskar D.,0,45,0,0
1668457872549,ECE 257B,A00,103655,Bharadia; Dinesh,0,26,0,0
1668457872979,ECE 258A,A00,103656,Milstein; Laurence B.,0,22,0,0
1668457873415,ECE 260B,A00,103658,Kang; Mingu,0,103,0,0
1668457873843,ECE 264A,A00,103659,Galton; Ian A,0,56,0,0
1668457874270,ECE 265A,A00,103661,Gudem; Prasad S.S.,0,34,0,0
1668457874701,ECE 265D,A00,103662,Gudem; Prasad S.S.,0,20,0,0
1668457875139,ECE 268,A00,103663,Koushanfar; Farinaz,0,36,0,0
1668457875573,ECE 269,A01,103665,Pal; Piya,0,169,0,0
1668457876009,ECE 271B,A00,103666,Vasconcelos; Manuela,0,58,0,0
1668457876436,ECE 276A,A00,103667,Atanasov; Nikolay A.,0,90,0,0
1668457876861,ECE 277,A00,103668,An; Cheolhong,0,123,0,0
1668457877299,ECE 279,A00,117947,Hall; Drew A.,0,17,0,0
1668457878156,ECE 283,A00,103670,Hsueh; Tzu-Chien,0,40,0,0
1668457878579,ECE 284,A00,103671,Turakhia; Yatish Girish,0,34,0,0
1668457879006,ECE 285,A00,103672,Zheng; Yang,0,30,0,0
1668457879006,ECE 285,B00,103673,Sworder; David D.,0,44,0,0
1668457879433,ECE 287,A00,103676,Javidi; Tara,0,6,0,0
1668457879859,MATH 200B,A00,098023,Salehi Golsefidy; Alireza,12,0,15,3
1668457880286,MATH 202B,A00,098024,Rhoades; Brendon Patrick,9,0,15,6
1668457880712,MATH 203B,A00,098025,Oprea; Dragos N.,10,0,15,5
1668457881140,MATH 204B,A00,098026,Sorensen; Claus M,13,0,15,2
1668457881564,MATH 208,A00,098027,Izadi; Elham,7,0,10,3
1668457881992,MATH 209,A00,098028,Pollack; Aaron,10,0,10,0
1668457882418,MATH 211A,A00,112919,Rogalski; Daniel,9,0,10,1
1668457882851,MATH 211B,A00,112920,Seward; Brandon M.,9,0,10,1
1668457883275,MATH 218,A00,098029,Li; Bo,10,0,10,0
1668457883701,MATH 220B,A00,098030,Novak; Jonathan I,11,0,15,4
1668457884136,MATH 221A,A00,098031,Ebenfelt; Peter F,13,0,15,2
1668457884564,MATH 231B,A00,098032,Zlatos; Andrej,11,0,15,4
1668457884990,MATH 240B,A00,098033,Ni; Lei,9,0,15,6
1668457885414,MATH 243,A00,098034,Jekel; David Andrew,10,0,10,0
1668457885842,MATH 245A,A00,098035,Nie; Jiawang,0,2,15,16
1668457886271,MATH 248,A00,098036,Bejenaru; Ioan,10,0,10,0
1668457886705,MATH 250B,A00,098037,Spolaor; Luca,14,0,15,1
1668457887134,MATH 258,A00,098038,Ni; Lei,10,0,10,0
1668457887560,MATH 264B,A00,098041,Rhoades; Brendon Patrick,9,0,15,6
1668457887993,MATH 268,A00,098042,Buss; Samuel R,10,0,10,0
1668457888415,MATH 269,A00,098043,Rhoades; Brendon Patrick,10,0,10,0
1668457888846,MATH 270B,A00,098044,Li; Bo,10,0,15,5
1668457889285,MATH 272B,A00,098045,Holst; Michael J,13,0,15,2
1668457889722,MATH 273A,A00,098046,Tian; Xiaochuan,10,0,15,5
1668457890150,MATH 275,A01,098048,Tian; Xiaochuan,6,0,10,4
1668457890654,MATH 278A,A00,098049,Holst; Michael J,8,0,10,2
1668457891078,MATH 278B,A00,098050,Cloninger; Alexander,10,0,10,0
1668457891505,MATH 278C,A00,098051,Nie; Jiawang,6,0,10,4
1668457891939,MATH 280B,A00,098052,Zheng; Tianyi,7,0,15,8
1668457892363,MATH 281B,A00,098053,Bradic; Jelena,0,2,15,15
1668457892790,MATH 282B,A00,098054,Arias-Castro; Ery,0,0,15,15
1668457893214,MATH 285,A00,098055,Fitzsimmons; Patrick J,0,1,15,17
1668457893637,MATH 287B,A00,098056,Arias-Castro; Ery,2,0,15,13
1668457894061,MATH 288,A00,098057,Agarwal; Pooja,9,0,10,1
1668457894061,MATH 288,B00,098058,Zhang; Danna,8,0,10,2
1668457894061,MATH 288,C00,098059,Williams; Ruth J,9,0,10,1
1668457894488,MATH 290B,A00,098060,Roberts; Justin Deritter,13,0,15,2
1668457894928,MATH 292,A00,098061,Belmont; Eva Kinoshita,10,0,10,0
1668457895353,MATH 295,A00,098062,Suk; Andrew Hoon,48,0,50,2
1668457895787,MATH 296,A00,098063,Novak; Jonathan I,20,0,20,0
1668457896213,MATH 297,001,098064,Gamst; Anthony Collins,9997,0,9999,2
1668458399529,COGS 205,A00,101395,Chiba; Andrea,19,0,20,1
1668458399956,COGS 210B,001,101404,Greene; Deanna Jacquelyn,9998,0,9999,1
1668458399956,COGS 210B,002,101417,Xia; Haijun,9999,0,9999,0
1668458399956,COGS 210B,003,101422,Nitz; Douglas A.,9999,0,9999,0
1668458399956,COGS 210B,004,101423,Hollan; James D.,9998,0,9999,1
1668458399956,COGS 210B,005,101424,Deak; Gedeon O.,9998,0,9999,1
1668458399956,COGS 210B,006,101425,Rossano; Federico,9999,0,9999,0
1668458400773,COGS 211B,A00,101427,Coulson; Seana M,9996,0,9999,3
1668458401204,COGS 220,A00,101428,Hollan; James D.,1,7,25,24
1668458401637,COGS 229,A00,101429,Dow; Steven P,17,0,25,8
1668458402062,COGS 230,A00,101430,Klemmer; Scott R,8,0,17,9
1668458402490,COGS 234,A00,101431,Xia; Haijun,2,0,25,23
1668458402912,COGS 260,A00,101432,Kiyonaga; Anastasia,21,0,25,4
1668458402912,COGS 260,B00,101433,Kirsh; David Joel,15,0,25,10
1668458403336,CSE 202,A00,102371,Impagliazzo; Russell,0,50,0,0
1668458403765,CSE 203B,A01,102373,Cheng; Chung Kuan,0,40,0,0
1668458404201,CSE 208,A00,102374,Micciancio; Daniele,0,3,0,0
1668458404634,CSE 209A,A00,112895,Impagliazzo; Russell,0,8,15,15
1668458405058,CSE 209B,A00,108005,Bellare; Mihir,0,4,0,0
1668458405483,CSE 210,A00,113163,Coblenz; Michael J,0,66,0,0
1668458405914,CSE 219,A00,106111,Dow; Steven P,0,4,20,20
1668458406342,CSE 221,A00,102376,Voelker; Geoffrey M.,0,47,0,0
1668458406771,CSE 224,A01,102378,Porter; George M,0,133,0,0
1668458407199,CSE 229A,A00,102379,Savage; Stefan,0,6,0,0
1668458407625,CSE 229C,A00,102380,Munyaka; Imani N. S.,0,6,0,0
1668458408050,CSE 232B,A00,102382,Deutsch; Alin Bernard,0,24,0,0
1668458408484,CSE 234,A01,112904,Kumar; Arun Kumar,0,0,0,0
1668458408919,CSE 237A,A00,102383,Rosing; Tajana Simunic,0,43,0,0
1668458409355,CSE 239A,A00,102384,Deutsch; Alin Bernard,0,7,0,0
1668458409795,CSE 239B,A00,102385,Polikarpova; Nadezhda,0,7,0,0
1668458410218,CSE 240A,A00,102386,Pannuto; Patrick William,0,37,0,0
1668458410647,CSE 240B,A00,102387,Zhao; Jishen,0,37,0,0
1668458411074,CSE 241A,A00,106406,Kang; Mingu,0,6,0,0
1668458411541,CSE 249B,A00,102388,Kahng; Andrew Byun,0,3,8,8
1668458411976,CSE 251B,A01,102392,Cottrell; Garrison W,0,33,0,0
1668458411976,CSE 251B,A02,102393,Cottrell; Garrison W,0,31,0,0
1668458412400,CSE 252B,A00,102394,Ochoa; Benjamin Lawrence,0,44,0,0
1668458412837,CSE 257,A01,102396,Gao; Sicun,0,112,0,0
1668458413262,CSE 272,A00,102397,Li; Tzumao,0,13,0,0
1668458413786,CSE 274,A00,111323,Chern; Albert Ren-Haur,0,9,0,0
1668458414213,CSE 282,A00,102398,Pevzner; Pavel Arkadjevich,0,0,0,0
1668458414643,CSE 284,A00,114175,Gymrek; Melissa Ann,0,16,0,0
1668458415075,CSE 290,A00,102399,Chandraker; Manmohan Krishna,0,9,0,0
1668458415075,CSE 290,B00,102400,Vaccaro; Kristen Marie,0,5,25,25
1668458415075,CSE 290,C00,102414,Pannuto; Patrick William,0,1,25,25
1668458415075,CSE 290,D00,102427,Pevzner; Pavel Arkadjevich,0,0,0,0
1668458415075,CSE 290,E00,102429,Zhao; Jishen,0,2,0,0
1668458415075,CSE 290,F00,102436,Tullsen; Dean Michael,0,4,0,0
1668458415075,CSE 290,G00,102440,Christensen; Henrik I,0,4,20,20
1668458415501,CSE 291,A00,102443,Su; Hao,0,0,0,0
1668458415501,CSE 291,B00,102448,Polikarpova; Nadezhda,0,0,0,0
1668458415501,CSE 291,C00,102453,Vaccaro; Kristen Marie,0,0,0,0
1668458415501,CSE 291,D00,111343,Savage; Stefan,0,0,0,0
1668458415501,CSE 291,E00,116474,Claffy; Kimberly Claire,0,0,0,0
1668458415501,CSE 291,F00,116479,Pasquale; Joseph,0,0,0,0
1668458415931,CSE 293,001,119111,Bafna; Vineet,9999,0,9999,0
1668458415931,CSE 293,002,119118,Bellare; Mihir,9999,0,9999,0
1668458415931,CSE 293,003,119122,Berg-Kirkpatrick; Taylor D,9999,0,9999,0
1668458415931,CSE 293,004,119135,Christensen; Henrik I,9999,0,9999,0
1668458415931,CSE 293,005,119142,Cottrell; Garrison W,9999,0,9999,0
1668458415931,CSE 293,006,119146,Deutsch; Alin Bernard,9999,0,9999,0
1668458415931,CSE 293,007,119159,Esmaeilzadeh; Hadi,9999,0,9999,0
1668458415931,CSE 293,008,119166,Freund; Yoav,9999,0,9999,0
1668458415931,CSE 293,009,119170,Griswold; William G.,9999,0,9999,0
1668458415931,CSE 293,010,119183,Gymrek; Melissa Ann,9999,0,9999,0
1668458415931,CSE 293,011,119190,Heninger; Nadia A,9999,0,9999,0
1668458415931,CSE 293,012,119230,Impagliazzo; Russell,9999,0,9999,0
1668458415931,CSE 293,013,119232,Jhala; Ranjit,9999,0,9999,0
1668458415931,CSE 293,014,119233,Kahng; Andrew Byun,9999,0,9999,0
1668458415931,CSE 293,015,119298,Kane; Daniel Mertz,9999,0,9999,0
1668458415931,CSE 293,016,119299,Kriegman; David J,9999,0,9999,0
1668458415931,CSE 293,017,119300,Kumar; Arun Kumar,9999,0,9999,0
1668458415931,CSE 293,018,119301,Lerner; Sorin,9999,0,9999,0
1668458415931,CSE 293,019,119302,Lovett; Shachar,9999,0,9999,0
1668458415931,CSE 293,020,119303,McAuley; Julian John,9999,0,9999,0
1668458415931,CSE 293,021,119304,Micciancio; Daniele,9999,0,9999,0
1668458415931,CSE 293,022,119367,Orailoglu; Alex,9999,0,9999,0
1668458415931,CSE 293,023,119382,Paturi; Ramamohan,9999,0,9999,0
1668458415931,CSE 293,024,119404,Polikarpova; Nadezhda,9999,0,9999,0
1668458415931,CSE 293,025,119406,Politz; Joseph Gibbs,9999,0,9999,0
1668458415931,CSE 293,026,119411,Porter; George M,9999,0,9999,0
1668458415931,CSE 293,027,119414,Porter; Leonard Emerson,9999,0,9999,0
1668458415931,CSE 293,028,119416,Ramamoorthi; Ravi,9999,0,9999,0
1668458415931,CSE 293,029,119417,Sahoo; Debashis,9999,0,9999,0
1668458415931,CSE 293,030,119420,Saul; Lawrence,9999,0,9999,0
1668458415931,CSE 293,031,119421,Savage; Stefan,9999,0,9999,0
1668458415931,CSE 293,032,119425,Schulze; Jurgen P.,9999,0,9999,0
1668458415931,CSE 293,033,119426,Snoeren; Alex C.,9999,0,9999,0
1668458415931,CSE 293,034,119428,Shang; Jingbo,9999,0,9999,0
1668458415931,CSE 293,035,119430,Stefan; Deian,9999,0,9999,0
1668458415931,CSE 293,036,119431,Su; Hao,9999,0,9999,0
1668458415931,CSE 293,037,119433,Swanson; Steven James,9999,0,9999,0
1668458415931,CSE 293,038,119435,Tullsen; Dean Michael,9999,0,9999,0
1668458415931,CSE 293,039,119483,Voelker; Geoffrey M.,9999,0,9999,0
1668458415931,CSE 293,040,119537,Zhao; Jishen,9999,0,9999,0
1668458415931,CSE 293,041,119538,Zhou; Yuan-Yuan,9999,0,9999,0
1668458415931,CSE 293,042,119539,Gao; Sicun,9999,0,9999,0
1668458415931,CSE 293,043,119540,Weibel; Nadir,9999,0,9999,0
1668458415931,CSE 293,044,119541,Gupta; Rajesh K.,9999,0,9999,0
1668458415931,CSE 293,045,126410,Vaccaro; Kristen Marie,9999,0,9999,0
1668458415931,CSE 293,046,126411,Klemke; Richard,9999,0,9999,0
1668458416363,CSE 294,A00,102459,Voelker; Geoffrey M.,0,2,0,0
1668458416363,CSE 294,B00,111322,Orailoglu; Alex,0,1,0,0
1668458416788,DSE 201,A00,096914,Deutsch; Alin Bernard,30,0,30,0
1668458417210,DSE 210,A00,096915,Dasgupta; Sanjoy,30,0,30,0
1668458417638,DSE 260A,A00,096916,Altintas De Callaf; Ilkay,30,0,30,0
1668458418071,ECE 200,001,103586,Antipa; Nicholas A,9999,0,9999,0
1668458418071,ECE 200,002,103587,Atanasov; Nikolay A.,9999,0,9999,0
1668458418071,ECE 200,003,103588,Bharadia; Dinesh,9999,0,9999,0
1668458418071,ECE 200,004,103589,Cheng; Chung Kuan,9999,0,9999,0
1668458418071,ECE 200,005,103590,Cosman; Pamela C.,9999,0,9999,0
1668458418071,ECE 200,006,103591,Dayeh; Shadi Ahmad,9999,0,9999,0
1668458418071,ECE 200,007,103592,Fainman; Yeshaiahu,9999,0,9999,0
1668458418071,ECE 200,008,103593,Ford; Joseph Earl,9999,0,9999,0
1668458418071,ECE 200,009,103594,Franceschetti; Massimo,9999,0,9999,0
1668458418071,ECE 200,010,103595,Fullerton; Eric E,9999,0,9999,0
1668458418071,ECE 200,011,103596,Galton; Ian A,9999,0,9999,0
1668458418071,ECE 200,012,103597,Gilja; Vikash,9999,0,9999,0
1668458418071,ECE 200,013,103598,Hall; Drew A.,9999,0,9999,0
1668458418071,ECE 200,014,103599,Hsueh; Tzu-Chien,9999,0,9999,0
1668458418071,ECE 200,015,103600,Javidi; Tara,9999,0,9999,0
1668458418071,ECE 200,016,103601,Kahng; Andrew Byun,9999,0,9999,0
1668458418071,ECE 200,017,103602,Kim; Young-Han,9999,0,9999,0
1668458418071,ECE 200,018,103603,Koushanfar; Farinaz,9999,0,9999,0
1668458418071,ECE 200,019,103604,Kuzum; Duygu,9999,0,9999,0
1668458418071,ECE 200,020,103605,Le; Hanh-Phuc,9999,0,9999,0
1668458418071,ECE 200,021,103606,Lin; Bill,9999,0,9999,0
1668458418071,ECE 200,022,103607,Liu; Zhaowei,9998,0,9999,1
1668458418071,ECE 200,023,103608,Lo; Yu-Hwa,9999,0,9999,0
1668458418071,ECE 200,024,103609,Lomakin; Vitaliy,9999,0,9999,0
1668458418071,ECE 200,025,103610,Mercier; Patrick Philip,9999,0,9999,0
1668458418071,ECE 200,026,103611,Meyer; Florian,9999,0,9999,0
1668458418071,ECE 200,027,103612,Milstein; Laurence B.,9999,0,9999,0
1668458418071,ECE 200,028,103613,Mir Arabbaygi; Siavash,9999,0,9999,0
1668458418071,ECE 200,029,103614,Mookherjea; Shayan,9999,0,9999,0
1668458418071,ECE 200,030,103615,Morris; Karcher William,9999,0,9999,0
1668458418071,ECE 200,031,103616,Ng; Tse Nga,9999,0,9999,0
1668458418071,ECE 200,032,103617,Nguyen; Truong Quang,9999,0,9999,0
1668458418071,ECE 200,033,103618,Nomura; Kenji,9999,0,9999,0
1668458418071,ECE 200,034,103619,Orlitsky; Alon,9999,0,9999,0
1668458418071,ECE 200,035,103620,Pal; Piya,9999,0,9999,0
1668458418071,ECE 200,036,103621,Papen; George C.,9999,0,9999,0
1668458418071,ECE 200,037,103622,Radic; Stojan,9999,0,9999,0
1668458418071,ECE 200,038,103623,Rao; Bhaskar D.,9999,0,9999,0
1668458418071,ECE 200,039,103624,Rao; Ramesh R,9999,0,9999,0
1668458418071,ECE 200,040,103625,Rebeiz; Gabriel,9999,0,9999,0
1668458418071,ECE 200,041,103626,Sanford; John R,9999,0,9999,0
1668458418071,ECE 200,042,103627,Siegel; Paul H.,9999,0,9999,0
1668458418071,ECE 200,043,103628,Sievenpiper; Daniel F.,9999,0,9999,0
1668458418071,ECE 200,044,103629,Sworder; David D.,9999,0,9999,0
1668458418071,ECE 200,045,103630,Taur; Yuan,9999,0,9999,0
1668458418071,ECE 200,046,103631,Touri; Behrouz,9999,0,9999,0
1668458418071,ECE 200,047,103632,Trivedi; Mohan M.,9999,0,9999,0
1668458418071,ECE 200,048,103633,Vasconcelos; Nuno,9999,0,9999,0
1668458418071,ECE 200,049,103634,Wang; Xiaolong,9999,0,9999,0
1668458418071,ECE 200,050,103635,Xie; Pengtao,9999,0,9999,0
1668458418071,ECE 200,051,103636,Yip; Michael,9999,0,9999,0
1668458418071,ECE 200,052,103637,Zeger; Kenneth A.,999,0,999,0
1668458418071,ECE 200,053,103638,Zhang; Xinyu,9999,0,9999,0
1668458418071,ECE 200,054,103639,Turakhia; Yatish Girish,9999,0,9999,0
1668458418071,ECE 200,055,103640,Kang; Mingu,9999,0,9999,0
1668458418071,ECE 200,056,103641,Shi; Yuanyuan,9999,0,9999,0
1668458418071,ECE 200,057,103642,Wang; Edward Jay,9999,0,9999,0
1668458418071,ECE 200,058,103643,Zheng; Yang,9999,0,9999,0
1668458418493,ECE 202,A00,103644,Kuzum; Duygu,0,36,0,0
1668458418918,ECE 212BN,A00,103646,Ng; Tse Nga,0,4,0,0
1668458419356,ECE 221,A00,111493,Staff,0,0,0,0
1668458419793,ECE 222B,A00,103647,Lomakin; Vitaliy,0,9,0,0
1668458420220,ECE 230B,A00,103648,Taur; Yuan,0,2,0,0
1668458420645,ECE 238B,A00,103649,Garay; Javier,0,0,0,0
1668458421068,ECE 240B,A00,112900,Fainman; Yeshaiahu,0,4,0,0
1668458421501,ECE 247A,A00,103650,Jokerst; Jesse Vincent,0,2,0,0
1668458421946,ECE 247B,A00,103651,Wang; Joseph,0,8,0,0
1668458422376,ECE 250,A00,103652,Siegel; Paul H.,0,62,0,0
1668458422800,ECE 251A,A00,103654,Rao; Bhaskar D.,0,45,0,0
1668458423233,ECE 257B,A00,103655,Bharadia; Dinesh,0,26,0,0
1668458423657,ECE 258A,A00,103656,Milstein; Laurence B.,0,22,0,0
1668458424081,ECE 260B,A00,103658,Kang; Mingu,0,103,0,0
1668458424509,ECE 264A,A00,103659,Galton; Ian A,0,56,0,0
1668458424932,ECE 265A,A00,103661,Gudem; Prasad S.S.,0,34,0,0
1668458425362,ECE 265D,A00,103662,Gudem; Prasad S.S.,0,20,0,0
1668458425786,ECE 268,A00,103663,Koushanfar; Farinaz,0,36,0,0
1668458426218,ECE 269,A01,103665,Pal; Piya,0,170,0,0
1668458426647,ECE 271B,A00,103666,Vasconcelos; Manuela,0,58,0,0
1668458427070,ECE 276A,A00,103667,Atanasov; Nikolay A.,0,90,0,0
1668458427495,ECE 277,A00,103668,An; Cheolhong,0,124,0,0
1668458427925,ECE 279,A00,117947,Hall; Drew A.,0,17,0,0
1668458428777,ECE 283,A00,103670,Hsueh; Tzu-Chien,0,40,0,0
1668458429208,ECE 284,A00,103671,Turakhia; Yatish Girish,0,34,0,0
1668458429632,ECE 285,A00,103672,Zheng; Yang,0,30,0,0
1668458429632,ECE 285,B00,103673,Sworder; David D.,0,44,0,0
1668458430059,ECE 287,A00,103676,Javidi; Tara,0,6,0,0
1668458430483,MATH 200B,A00,098023,Salehi Golsefidy; Alireza,12,0,15,3
1668458430907,MATH 202B,A00,098024,Rhoades; Brendon Patrick,9,0,15,6
1668458431341,MATH 203B,A00,098025,Oprea; Dragos N.,10,0,15,5
1668458431797,MATH 204B,A00,098026,Sorensen; Claus M,13,0,15,2
1668458432225,MATH 208,A00,098027,Izadi; Elham,7,0,10,3
1668458432650,MATH 209,A00,098028,Pollack; Aaron,10,0,10,0
1668458433074,MATH 211A,A00,112919,Rogalski; Daniel,9,0,10,1
1668458433495,MATH 211B,A00,112920,Seward; Brandon M.,9,0,10,1
1668458433924,MATH 218,A00,098029,Li; Bo,10,0,10,0
1668458434347,MATH 220B,A00,098030,Novak; Jonathan I,11,0,15,4
1668458434770,MATH 221A,A00,098031,Ebenfelt; Peter F,13,0,15,2
1668458435204,MATH 231B,A00,098032,Zlatos; Andrej,11,0,15,4
1668458435636,MATH 240B,A00,098033,Ni; Lei,9,0,15,6
1668458436067,MATH 243,A00,098034,Jekel; David Andrew,10,0,10,0
1668458436493,MATH 245A,A00,098035,Nie; Jiawang,0,2,15,16
1668458436930,MATH 248,A00,098036,Bejenaru; Ioan,10,0,10,0
1668458437371,MATH 250B,A00,098037,Spolaor; Luca,14,0,15,1
1668458437807,MATH 258,A00,098038,Ni; Lei,10,0,10,0
1668458438238,MATH 264B,A00,098041,Rhoades; Brendon Patrick,9,0,15,6
1668458438661,MATH 268,A00,098042,Buss; Samuel R,10,0,10,0
1668458439086,MATH 269,A00,098043,Rhoades; Brendon Patrick,10,0,10,0
1668458439519,MATH 270B,A00,098044,Li; Bo,10,0,15,5
1668458439945,MATH 272B,A00,098045,Holst; Michael J,13,0,15,2
1668458440386,MATH 273A,A00,098046,Tian; Xiaochuan,10,0,15,5
1668458440813,MATH 275,A01,098048,Tian; Xiaochuan,6,0,10,4
1668458441243,MATH 278A,A00,098049,Holst; Michael J,8,0,10,2
1668458441674,MATH 278B,A00,098050,Cloninger; Alexander,10,0,10,0
1668458442111,MATH 278C,A00,098051,Nie; Jiawang,6,0,10,4
1668458442535,MATH 280B,A00,098052,Zheng; Tianyi,7,0,15,8
1668458442965,MATH 281B,A00,098053,Bradic; Jelena,0,2,15,15
1668458443389,MATH 282B,A00,098054,Arias-Castro; Ery,0,0,15,15
1668458443822,MATH 285,A00,098055,Fitzsimmons; Patrick J,0,1,15,17
1668458444251,MATH 287B,A00,098056,Arias-Castro; Ery,2,0,15,13
1668458444674,MATH 288,A00,098057,Agarwal; Pooja,9,0,10,1
1668458444674,MATH 288,B00,098058,Zhang; Danna,8,0,10,2
1668458444674,MATH 288,C00,098059,Williams; Ruth J,9,0,10,1
1668458445100,MATH 290B,A00,098060,Roberts; Justin Deritter,13,0,15,2
1668458445527,MATH 292,A00,098061,Belmont; Eva Kinoshita,10,0,10,0
1668458445949,MATH 295,A00,098062,Suk; Andrew Hoon,48,0,50,2
1668458446373,MATH 296,A00,098063,Novak; Jonathan I,20,0,20,0
1668458446795,MATH 297,001,098064,Gamst; Anthony Collins,9997,0,9999,2
1668458948860,COGS 205,A00,101395,Chiba; Andrea,19,0,20,1
1668458949285,COGS 210B,001,101404,Greene; Deanna Jacquelyn,9998,0,9999,1
1668458949285,COGS 210B,002,101417,Xia; Haijun,9999,0,9999,0
1668458949285,COGS 210B,003,101422,Nitz; Douglas A.,9999,0,9999,0
1668458949285,COGS 210B,004,101423,Hollan; James D.,9998,0,9999,1
1668458949285,COGS 210B,005,101424,Deak; Gedeon O.,9998,0,9999,1
1668458949285,COGS 210B,006,101425,Rossano; Federico,9999,0,9999,0
1668458949709,COGS 211B,A00,101427,Coulson; Seana M,9996,0,9999,3
1668458950140,COGS 220,A00,101428,Hollan; James D.,1,7,25,24
1668458950575,COGS 229,A00,101429,Dow; Steven P,17,0,25,8
1668458951006,COGS 230,A00,101430,Klemmer; Scott R,8,0,17,9
1668458951437,COGS 234,A00,101431,Xia; Haijun,2,0,25,23
1668458951866,COGS 260,A00,101432,Kiyonaga; Anastasia,21,0,25,4
1668458951866,COGS 260,B00,101433,Kirsh; David Joel,15,0,25,10
1668458952300,CSE 202,A00,102371,Impagliazzo; Russell,0,53,0,0
1668458952730,CSE 203B,A01,102373,Cheng; Chung Kuan,0,44,0,0
1668458953154,CSE 208,A00,102374,Micciancio; Daniele,0,3,0,0
1668458953581,CSE 209A,A00,112895,Impagliazzo; Russell,0,8,15,15
1668458954005,CSE 209B,A00,108005,Bellare; Mihir,0,4,0,0
1668458954430,CSE 210,A00,113163,Coblenz; Michael J,0,69,0,0
1668458954861,CSE 219,A00,106111,Dow; Steven P,0,4,20,20
1668458955296,CSE 221,A00,102376,Voelker; Geoffrey M.,0,50,0,0
1668458955730,CSE 224,A01,102378,Porter; George M,0,139,0,0
1668458956154,CSE 229A,A00,102379,Savage; Stefan,0,6,0,0
1668458956586,CSE 229C,A00,102380,Munyaka; Imani N. S.,0,6,0,0
1668458957022,CSE 232B,A00,102382,Deutsch; Alin Bernard,0,25,0,0
1668458957449,CSE 234,A01,112904,Kumar; Arun Kumar,0,0,0,0
1668458957881,CSE 237A,A00,102383,Rosing; Tajana Simunic,0,43,0,0
1668458958305,CSE 239A,A00,102384,Deutsch; Alin Bernard,0,8,0,0
1668458958732,CSE 239B,A00,102385,Polikarpova; Nadezhda,0,7,0,0
1668458959170,CSE 240A,A00,102386,Pannuto; Patrick William,0,37,0,0
1668458959596,CSE 240B,A00,102387,Zhao; Jishen,0,37,0,0
1668458960024,CSE 241A,A00,106406,Kang; Mingu,0,6,0,0
1668458960462,CSE 249B,A00,102388,Kahng; Andrew Byun,0,3,8,8
1668458960884,CSE 251B,A01,102392,Cottrell; Garrison W,0,34,0,0
1668458960884,CSE 251B,A02,102393,Cottrell; Garrison W,0,31,0,0
1668458961315,CSE 252B,A00,102394,Ochoa; Benjamin Lawrence,0,45,0,0
1668458961742,CSE 257,A01,102396,Gao; Sicun,0,115,0,0
1668458962167,CSE 272,A00,102397,Li; Tzumao,0,14,0,0
1668458962592,CSE 274,A00,111323,Chern; Albert Ren-Haur,0,9,0,0
1668458963016,CSE 282,A00,102398,Pevzner; Pavel Arkadjevich,0,0,0,0
1668458963440,CSE 284,A00,114175,Gymrek; Melissa Ann,0,16,0,0
1668458963867,CSE 290,A00,102399,Chandraker; Manmohan Krishna,0,9,0,0
1668458963867,CSE 290,B00,102400,Vaccaro; Kristen Marie,0,5,25,25
1668458963867,CSE 290,C00,102414,Pannuto; Patrick William,0,1,25,25
1668458963867,CSE 290,D00,102427,Pevzner; Pavel Arkadjevich,0,0,0,0
1668458963867,CSE 290,E00,102429,Zhao; Jishen,0,2,0,0
1668458963867,CSE 290,F00,102436,Tullsen; Dean Michael,0,4,0,0
1668458963867,CSE 290,G00,102440,Christensen; Henrik I,0,5,20,20
1668458964296,CSE 291,A00,102443,Su; Hao,0,0,0,0
1668458964296,CSE 291,B00,102448,Polikarpova; Nadezhda,0,0,0,0
1668458964296,CSE 291,C00,102453,Vaccaro; Kristen Marie,0,0,0,0
1668458964296,CSE 291,D00,111343,Savage; Stefan,0,0,0,0
1668458964296,CSE 291,E00,116474,Claffy; Kimberly Claire,0,0,0,0
1668458964296,CSE 291,F00,116479,Pasquale; Joseph,0,0,0,0
1668458964735,CSE 293,001,119111,Bafna; Vineet,9999,0,9999,0
1668458964735,CSE 293,002,119118,Bellare; Mihir,9999,0,9999,0
1668458964735,CSE 293,003,119122,Berg-Kirkpatrick; Taylor D,9999,0,9999,0
1668458964735,CSE 293,004,119135,Christensen; Henrik I,9999,0,9999,0
1668458964735,CSE 293,005,119142,Cottrell; Garrison W,9999,0,9999,0
1668458964735,CSE 293,006,119146,Deutsch; Alin Bernard,9999,0,9999,0
1668458964735,CSE 293,007,119159,Esmaeilzadeh; Hadi,9999,0,9999,0
1668458964735,CSE 293,008,119166,Freund; Yoav,9999,0,9999,0
1668458964735,CSE 293,009,119170,Griswold; William G.,9999,0,9999,0
1668458964735,CSE 293,010,119183,Gymrek; Melissa Ann,9999,0,9999,0
1668458964735,CSE 293,011,119190,Heninger; Nadia A,9999,0,9999,0
1668458964735,CSE 293,012,119230,Impagliazzo; Russell,9999,0,9999,0
1668458964735,CSE 293,013,119232,Jhala; Ranjit,9999,0,9999,0
1668458964735,CSE 293,014,119233,Kahng; Andrew Byun,9999,0,9999,0
1668458964735,CSE 293,015,119298,Kane; Daniel Mertz,9999,0,9999,0
1668458964735,CSE 293,016,119299,Kriegman; David J,9999,0,9999,0
1668458964735,CSE 293,017,119300,Kumar; Arun Kumar,9999,0,9999,0
1668458964735,CSE 293,018,119301,Lerner; Sorin,9999,0,9999,0
1668458964735,CSE 293,019,119302,Lovett; Shachar,9999,0,9999,0
1668458964735,CSE 293,020,119303,McAuley; Julian John,9999,0,9999,0
1668458964735,CSE 293,021,119304,Micciancio; Daniele,9999,0,9999,0
1668458964735,CSE 293,022,119367,Orailoglu; Alex,9999,0,9999,0
1668458964735,CSE 293,023,119382,Paturi; Ramamohan,9999,0,9999,0
1668458964735,CSE 293,024,119404,Polikarpova; Nadezhda,9999,0,9999,0
1668458964735,CSE 293,025,119406,Politz; Joseph Gibbs,9999,0,9999,0
1668458964735,CSE 293,026,119411,Porter; George M,9999,0,9999,0
1668458964735,CSE 293,027,119414,Porter; Leonard Emerson,9999,0,9999,0
1668458964735,CSE 293,028,119416,Ramamoorthi; Ravi,9999,0,9999,0
1668458964735,CSE 293,029,119417,Sahoo; Debashis,9999,0,9999,0
1668458964735,CSE 293,030,119420,Saul; Lawrence,9999,0,9999,0
1668458964735,CSE 293,031,119421,Savage; Stefan,9999,0,9999,0
1668458964735,CSE 293,032,119425,Schulze; Jurgen P.,9999,0,9999,0
1668458964735,CSE 293,033,119426,Snoeren; Alex C.,9999,0,9999,0
1668458964735,CSE 293,034,119428,Shang; Jingbo,9999,0,9999,0
1668458964735,CSE 293,035,119430,Stefan; Deian,9999,0,9999,0
1668458964735,CSE 293,036,119431,Su; Hao,9999,0,9999,0
1668458964735,CSE 293,037,119433,Swanson; Steven James,9999,0,9999,0
1668458964735,CSE 293,038,119435,Tullsen; Dean Michael,9999,0,9999,0
1668458964735,CSE 293,039,119483,Voelker; Geoffrey M.,9999,0,9999,0
1668458964735,CSE 293,040,119537,Zhao; Jishen,9999,0,9999,0
1668458964735,CSE 293,041,119538,Zhou; Yuan-Yuan,9999,0,9999,0
1668458964735,CSE 293,042,119539,Gao; Sicun,9999,0,9999,0
1668458964735,CSE 293,043,119540,Weibel; Nadir,9999,0,9999,0
1668458964735,CSE 293,044,119541,Gupta; Rajesh K.,9999,0,9999,0
1668458964735,CSE 293,045,126410,Vaccaro; Kristen Marie,9999,0,9999,0
1668458964735,CSE 293,046,126411,Klemke; Richard,9999,0,9999,0
1668458965166,CSE 294,A00,102459,Voelker; Geoffrey M.,0,2,0,0
1668458965166,CSE 294,B00,111322,Orailoglu; Alex,0,1,0,0
1668458965590,DSE 201,A00,096914,Deutsch; Alin Bernard,30,0,30,0
1668458966012,DSE 210,A00,096915,Dasgupta; Sanjoy,30,0,30,0
1668458966447,DSE 260A,A00,096916,Altintas De Callaf; Ilkay,30,0,30,0
1668458966896,ECE 200,001,103586,Antipa; Nicholas A,9999,0,9999,0
1668458966896,ECE 200,002,103587,Atanasov; Nikolay A.,9999,0,9999,0
1668458966896,ECE 200,003,103588,Bharadia; Dinesh,9999,0,9999,0
1668458966896,ECE 200,004,103589,Cheng; Chung Kuan,9999,0,9999,0
1668458966896,ECE 200,005,103590,Cosman; Pamela C.,9999,0,9999,0
1668458966896,ECE 200,006,103591,Dayeh; Shadi Ahmad,9999,0,9999,0
1668458966896,ECE 200,007,103592,Fainman; Yeshaiahu,9999,0,9999,0
1668458966896,ECE 200,008,103593,Ford; Joseph Earl,9999,0,9999,0
1668458966896,ECE 200,009,103594,Franceschetti; Massimo,9999,0,9999,0
1668458966896,ECE 200,010,103595,Fullerton; Eric E,9999,0,9999,0
1668458966896,ECE 200,011,103596,Galton; Ian A,9999,0,9999,0
1668458966896,ECE 200,012,103597,Gilja; Vikash,9999,0,9999,0
1668458966896,ECE 200,013,103598,Hall; Drew A.,9999,0,9999,0
1668458966896,ECE 200,014,103599,Hsueh; Tzu-Chien,9999,0,9999,0
1668458966896,ECE 200,015,103600,Javidi; Tara,9999,0,9999,0
1668458966896,ECE 200,016,103601,Kahng; Andrew Byun,9999,0,9999,0
1668458966896,ECE 200,017,103602,Kim; Young-Han,9999,0,9999,0
1668458966896,ECE 200,018,103603,Koushanfar; Farinaz,9999,0,9999,0
1668458966896,ECE 200,019,103604,Kuzum; Duygu,9999,0,9999,0
1668458966896,ECE 200,020,103605,Le; Hanh-Phuc,9999,0,9999,0
1668458966896,ECE 200,021,103606,Lin; Bill,9999,0,9999,0
1668458966896,ECE 200,022,103607,Liu; Zhaowei,9998,0,9999,1
1668458966896,ECE 200,023,103608,Lo; Yu-Hwa,9999,0,9999,0
1668458966896,ECE 200,024,103609,Lomakin; Vitaliy,9999,0,9999,0
1668458966896,ECE 200,025,103610,Mercier; Patrick Philip,9999,0,9999,0
1668458966896,ECE 200,026,103611,Meyer; Florian,9999,0,9999,0
1668458966896,ECE 200,027,103612,Milstein; Laurence B.,9999,0,9999,0
1668458966896,ECE 200,028,103613,Mir Arabbaygi; Siavash,9999,0,9999,0
1668458966896,ECE 200,029,103614,Mookherjea; Shayan,9999,0,9999,0
1668458966896,ECE 200,030,103615,Morris; Karcher William,9999,0,9999,0
1668458966896,ECE 200,031,103616,Ng; Tse Nga,9999,0,9999,0
1668458966896,ECE 200,032,103617,Nguyen; Truong Quang,9999,0,9999,0
1668458966896,ECE 200,033,103618,Nomura; Kenji,9999,0,9999,0
1668458966896,ECE 200,034,103619,Orlitsky; Alon,9999,0,9999,0
1668458966896,ECE 200,035,103620,Pal; Piya,9999,0,9999,0
1668458966896,ECE 200,036,103621,Papen; George C.,9999,0,9999,0
1668458966896,ECE 200,037,103622,Radic; Stojan,9999,0,9999,0
1668458966896,ECE 200,038,103623,Rao; Bhaskar D.,9999,0,9999,0
1668458966896,ECE 200,039,103624,Rao; Ramesh R,9999,0,9999,0
1668458966896,ECE 200,040,103625,Rebeiz; Gabriel,9999,0,9999,0
1668458966896,ECE 200,041,103626,Sanford; John R,9999,0,9999,0
1668458966896,ECE 200,042,103627,Siegel; Paul H.,9999,0,9999,0
1668458966896,ECE 200,043,103628,Sievenpiper; Daniel F.,9999,0,9999,0
1668458966896,ECE 200,044,103629,Sworder; David D.,9999,0,9999,0
1668458966896,ECE 200,045,103630,Taur; Yuan,9999,0,9999,0
1668458966896,ECE 200,046,103631,Touri; Behrouz,9999,0,9999,0
1668458966896,ECE 200,047,103632,Trivedi; Mohan M.,9999,0,9999,0
1668458966896,ECE 200,048,103633,Vasconcelos; Nuno,9999,0,9999,0
1668458966896,ECE 200,049,103634,Wang; Xiaolong,9999,0,9999,0
1668458966896,ECE 200,050,103635,Xie; Pengtao,9999,0,9999,0
1668458966896,ECE 200,051,103636,Yip; Michael,9999,0,9999,0
1668458966896,ECE 200,052,103637,Zeger; Kenneth A.,999,0,999,0
1668458966896,ECE 200,053,103638,Zhang; Xinyu,9999,0,9999,0
1668458966896,ECE 200,054,103639,Turakhia; Yatish Girish,9999,0,9999,0
1668458966896,ECE 200,055,103640,Kang; Mingu,9999,0,9999,0
1668458966896,ECE 200,056,103641,Shi; Yuanyuan,9999,0,9999,0
1668458966896,ECE 200,057,103642,Wang; Edward Jay,9999,0,9999,0
1668458966896,ECE 200,058,103643,Zheng; Yang,9999,0,9999,0
1668458967319,ECE 202,A00,103644,Kuzum; Duygu,0,36,0,0
1668458967746,ECE 212BN,A00,103646,Ng; Tse Nga,0,4,0,0
1668458968168,ECE 221,A00,111493,Staff,0,0,0,0
1668458968592,ECE 222B,A00,103647,Lomakin; Vitaliy,0,10,0,0
1668458969016,ECE 230B,A00,103648,Taur; Yuan,0,2,0,0
1668458969450,ECE 238B,A00,103649,Garay; Javier,0,0,0,0
1668458969872,ECE 240B,A00,112900,Fainman; Yeshaiahu,0,4,0,0
1668458970298,ECE 247A,A00,103650,Jokerst; Jesse Vincent,0,3,0,0
1668458970724,ECE 247B,A00,103651,Wang; Joseph,0,9,0,0
1668458971152,ECE 250,A00,103652,Siegel; Paul H.,0,62,0,0
1668458971576,ECE 251A,A00,103654,Rao; Bhaskar D.,0,46,0,0
1668458972001,ECE 257B,A00,103655,Bharadia; Dinesh,0,26,0,0
1668458972426,ECE 258A,A00,103656,Milstein; Laurence B.,0,23,0,0
1668458972848,ECE 260B,A00,103658,Kang; Mingu,0,104,0,0
1668458973283,ECE 264A,A00,103659,Galton; Ian A,0,58,0,0
1668458973707,ECE 265A,A00,103661,Gudem; Prasad S.S.,0,37,0,0
1668458974131,ECE 265D,A00,103662,Gudem; Prasad S.S.,0,20,0,0
1668458974570,ECE 268,A00,103663,Koushanfar; Farinaz,0,36,0,0
1668458974994,ECE 269,A01,103665,Pal; Piya,0,171,0,0
1668458975424,ECE 271B,A00,103666,Vasconcelos; Manuela,0,59,0,0
1668458975850,ECE 276A,A00,103667,Atanasov; Nikolay A.,0,91,0,0
1668458976277,ECE 277,A00,103668,An; Cheolhong,0,125,0,0
1668458976706,ECE 279,A00,117947,Hall; Drew A.,0,18,0,0
1668458977556,ECE 283,A00,103670,Hsueh; Tzu-Chien,0,42,0,0
1668458977988,ECE 284,A00,103671,Turakhia; Yatish Girish,0,34,0,0
1668458978547,ECE 285,A00,103672,Zheng; Yang,0,30,0,0
1668458978547,ECE 285,B00,103673,Sworder; David D.,0,44,0,0
1668458978977,ECE 287,A00,103676,Javidi; Tara,0,6,0,0
1668458979400,MATH 200B,A00,098023,Salehi Golsefidy; Alireza,12,0,15,3
1668458979825,MATH 202B,A00,098024,Rhoades; Brendon Patrick,9,0,15,6
1668458980250,MATH 203B,A00,098025,Oprea; Dragos N.,10,0,15,5
1668458980672,MATH 204B,A00,098026,Sorensen; Claus M,13,0,15,2
1668458981096,MATH 208,A00,098027,Izadi; Elham,7,0,10,3
1668458981525,MATH 209,A00,098028,Pollack; Aaron,10,0,10,0
1668458981958,MATH 211A,A00,112919,Rogalski; Daniel,9,0,10,1
1668458982384,MATH 211B,A00,112920,Seward; Brandon M.,9,0,10,1
1668458982808,MATH 218,A00,098029,Li; Bo,10,0,10,0
1668458983234,MATH 220B,A00,098030,Novak; Jonathan I,11,0,15,4
1668458983662,MATH 221A,A00,098031,Ebenfelt; Peter F,13,0,15,2
1668458984090,MATH 231B,A00,098032,Zlatos; Andrej,11,0,15,4
1668458984519,MATH 240B,A00,098033,Ni; Lei,9,0,15,6
1668458984949,MATH 243,A00,098034,Jekel; David Andrew,10,0,10,0
1668458985380,MATH 245A,A00,098035,Nie; Jiawang,0,2,15,16
1668458985806,MATH 248,A00,098036,Bejenaru; Ioan,10,0,10,0
1668458986231,MATH 250B,A00,098037,Spolaor; Luca,14,0,15,1
1668458986658,MATH 258,A00,098038,Ni; Lei,10,0,10,0
1668458987079,MATH 264B,A00,098041,Rhoades; Brendon Patrick,9,0,15,6
1668458987502,MATH 268,A00,098042,Buss; Samuel R,10,0,10,0
1668458987928,MATH 269,A00,098043,Rhoades; Brendon Patrick,10,0,10,0
1668458988355,MATH 270B,A00,098044,Li; Bo,10,0,15,5
1668458988780,MATH 272B,A00,098045,Holst; Michael J,13,0,15,2
1668458989212,MATH 273A,A00,098046,Tian; Xiaochuan,10,0,15,5
1668458989637,MATH 275,A01,098048,Tian; Xiaochuan,6,0,10,4
1668458990066,MATH 278A,A00,098049,Holst; Michael J,8,0,10,2
1668458990490,MATH 278B,A00,098050,Cloninger; Alexander,10,0,10,0
1668458990913,MATH 278C,A00,098051,Nie; Jiawang,6,0,10,4
1668458991337,MATH 280B,A00,098052,Zheng; Tianyi,7,0,15,8
1668458991762,MATH 281B,A00,098053,Bradic; Jelena,0,2,15,15
1668458992195,MATH 282B,A00,098054,Arias-Castro; Ery,0,0,15,15
1668458992620,MATH 285,A00,098055,Fitzsimmons; Patrick J,0,1,15,17
1668458993046,MATH 287B,A00,098056,Arias-Castro; Ery,2,0,15,13
1668458993474,MATH 288,A00,098057,Agarwal; Pooja,9,0,10,1
1668458993474,MATH 288,B00,098058,Zhang; Danna,8,0,10,2
1668458993474,MATH 288,C00,098059,Williams; Ruth J,9,0,10,1
1668458993908,MATH 290B,A00,098060,Roberts; Justin Deritter,13,0,15,2
1668458994333,MATH 292,A00,098061,Belmont; Eva Kinoshita,10,0,10,0
1668458994757,MATH 295,A00,098062,Suk; Andrew Hoon,48,0,50,2
1668458995185,MATH 296,A00,098063,Novak; Jonathan I,20,0,20,0
1668458995615,MATH 297,001,098064,Gamst; Anthony Collins,9997,0,9999,2
1668459499470,COGS 205,A00,101395,Chiba; Andrea,19,0,20,1
1668459499904,COGS 210B,001,101404,Greene; Deanna Jacquelyn,9998,0,9999,1
1668459499904,COGS 210B,002,101417,Xia; Haijun,9999,0,9999,0
1668459499904,COGS 210B,003,101422,Nitz; Douglas A.,9999,0,9999,0
1668459499904,COGS 210B,004,101423,Hollan; James D.,9998,0,9999,1
1668459499904,COGS 210B,005,101424,Deak; Gedeon O.,9998,0,9999,1
1668459499904,COGS 210B,006,101425,Rossano; Federico,9999,0,9999,0
1668459500328,COGS 211B,A00,101427,Coulson; Seana M,9996,0,9999,3
1668459500750,COGS 220,A00,101428,Hollan; James D.,1,7,25,24
1668459501176,COGS 229,A00,101429,Dow; Steven P,17,0,25,8
1668459501712,COGS 230,A00,101430,Klemmer; Scott R,8,0,17,9
1668459502138,COGS 234,A00,101431,Xia; Haijun,2,0,25,23
1668459502602,COGS 260,A00,101432,Kiyonaga; Anastasia,21,0,25,4
1668459502602,COGS 260,B00,101433,Kirsh; David Joel,15,0,25,10
1668459503026,CSE 202,A00,102371,Impagliazzo; Russell,0,52,0,0
1668459503451,CSE 203B,A01,102373,Cheng; Chung Kuan,0,44,0,0
1668459503878,CSE 208,A00,102374,Micciancio; Daniele,0,3,0,0
1668459504300,CSE 209A,A00,112895,Impagliazzo; Russell,0,8,15,15
1668459504724,CSE 209B,A00,108005,Bellare; Mihir,0,4,0,0
1668459505147,CSE 210,A00,113163,Coblenz; Michael J,0,69,0,0
1668459505573,CSE 219,A00,106111,Dow; Steven P,0,4,20,20
1668459505999,CSE 221,A00,102376,Voelker; Geoffrey M.,0,50,0,0
1668459506430,CSE 224,A01,102378,Porter; George M,0,139,0,0
1668459506855,CSE 229A,A00,102379,Savage; Stefan,0,6,0,0
1668459507279,CSE 229C,A00,102380,Munyaka; Imani N. S.,0,6,0,0
1668459507705,CSE 232B,A00,102382,Deutsch; Alin Bernard,0,27,0,0
1668459508132,CSE 234,A01,112904,Kumar; Arun Kumar,0,0,0,0
1668459508555,CSE 237A,A00,102383,Rosing; Tajana Simunic,0,44,0,0
1668459508977,CSE 239A,A00,102384,Deutsch; Alin Bernard,0,8,0,0
1668459509412,CSE 239B,A00,102385,Polikarpova; Nadezhda,0,7,0,0
1668459509838,CSE 240A,A00,102386,Pannuto; Patrick William,0,38,0,0
1668459510262,CSE 240B,A00,102387,Zhao; Jishen,0,37,0,0
1668459510692,CSE 241A,A00,106406,Kang; Mingu,0,6,0,0
1668459511114,CSE 249B,A00,102388,Kahng; Andrew Byun,0,3,8,8
1668459511542,CSE 251B,A01,102392,Cottrell; Garrison W,0,34,0,0
1668459511542,CSE 251B,A02,102393,Cottrell; Garrison W,0,31,0,0
1668459511982,CSE 252B,A00,102394,Ochoa; Benjamin Lawrence,0,45,0,0
1668459512415,CSE 257,A01,102396,Gao; Sicun,0,115,0,0
1668459512844,CSE 272,A00,102397,Li; Tzumao,0,14,0,0
1668459513273,CSE 274,A00,111323,Chern; Albert Ren-Haur,0,9,0,0
1668459513697,CSE 282,A00,102398,Pevzner; Pavel Arkadjevich,0,0,0,0
1668459514120,CSE 284,A00,114175,Gymrek; Melissa Ann,0,16,0,0
1668459514547,CSE 290,A00,102399,Chandraker; Manmohan Krishna,0,9,0,0
1668459514547,CSE 290,B00,102400,Vaccaro; Kristen Marie,0,5,25,25
1668459514547,CSE 290,C00,102414,Pannuto; Patrick William,0,1,25,25
1668459514547,CSE 290,D00,102427,Pevzner; Pavel Arkadjevich,0,0,0,0
1668459514547,CSE 290,E00,102429,Zhao; Jishen,0,2,0,0
1668459514547,CSE 290,F00,102436,Tullsen; Dean Michael,0,4,0,0
1668459514547,CSE 290,G00,102440,Christensen; Henrik I,0,5,20,20
1668459514976,CSE 291,A00,102443,Su; Hao,0,0,0,0
1668459514976,CSE 291,B00,102448,Polikarpova; Nadezhda,0,0,0,0
1668459514976,CSE 291,C00,102453,Vaccaro; Kristen Marie,0,0,0,0
1668459514976,CSE 291,D00,111343,Savage; Stefan,0,0,0,0
1668459514976,CSE 291,E00,116474,Claffy; Kimberly Claire,0,0,0,0
1668459514976,CSE 291,F00,116479,Pasquale; Joseph,0,0,0,0
1668459515412,CSE 293,001,119111,Bafna; Vineet,9999,0,9999,0
1668459515412,CSE 293,002,119118,Bellare; Mihir,9999,0,9999,0
1668459515412,CSE 293,003,119122,Berg-Kirkpatrick; Taylor D,9999,0,9999,0
1668459515412,CSE 293,004,119135,Christensen; Henrik I,9999,0,9999,0
1668459515412,CSE 293,005,119142,Cottrell; Garrison W,9999,0,9999,0
1668459515412,CSE 293,006,119146,Deutsch; Alin Bernard,9999,0,9999,0
1668459515412,CSE 293,007,119159,Esmaeilzadeh; Hadi,9999,0,9999,0
1668459515412,CSE 293,008,119166,Freund; Yoav,9999,0,9999,0
1668459515412,CSE 293,009,119170,Griswold; William G.,9999,0,9999,0
1668459515412,CSE 293,010,119183,Gymrek; Melissa Ann,9999,0,9999,0
1668459515412,CSE 293,011,119190,Heninger; Nadia A,9999,0,9999,0
1668459515412,CSE 293,012,119230,Impagliazzo; Russell,9999,0,9999,0
1668459515412,CSE 293,013,119232,Jhala; Ranjit,9999,0,9999,0
1668459515412,CSE 293,014,119233,Kahng; Andrew Byun,9999,0,9999,0
1668459515412,CSE 293,015,119298,Kane; Daniel Mertz,9999,0,9999,0
1668459515412,CSE 293,016,119299,Kriegman; David J,9999,0,9999,0
1668459515412,CSE 293,017,119300,Kumar; Arun Kumar,9999,0,9999,0
1668459515412,CSE 293,018,119301,Lerner; Sorin,9999,0,9999,0
1668459515412,CSE 293,019,119302,Lovett; Shachar,9999,0,9999,0
1668459515412,CSE 293,020,119303,McAuley; Julian John,9999,0,9999,0
1668459515412,CSE 293,021,119304,Micciancio; Daniele,9999,0,9999,0
1668459515412,CSE 293,022,119367,Orailoglu; Alex,9999,0,9999,0
1668459515412,CSE 293,023,119382,Paturi; Ramamohan,9999,0,9999,0
1668459515412,CSE 293,024,119404,Polikarpova; Nadezhda,9999,0,9999,0
1668459515412,CSE 293,025,119406,Politz; Joseph Gibbs,9999,0,9999,0
1668459515412,CSE 293,026,119411,Porter; George M,9999,0,9999,0
1668459515412,CSE 293,027,119414,Porter; Leonard Emerson,9999,0,9999,0
1668459515412,CSE 293,028,119416,Ramamoorthi; Ravi,9999,0,9999,0
1668459515412,CSE 293,029,119417,Sahoo; Debashis,9999,0,9999,0
1668459515412,CSE 293,030,119420,Saul; Lawrence,9999,0,9999,0
1668459515412,CSE 293,031,119421,Savage; Stefan,9999,0,9999,0
1668459515412,CSE 293,032,119425,Schulze; Jurgen P.,9999,0,9999,0
1668459515412,CSE 293,033,119426,Snoeren; Alex C.,9999,0,9999,0
1668459515412,CSE 293,034,119428,Shang; Jingbo,9999,0,9999,0
1668459515412,CSE 293,035,119430,Stefan; Deian,9999,0,9999,0
1668459515412,CSE 293,036,119431,Su; Hao,9999,0,9999,0
1668459515412,CSE 293,037,119433,Swanson; Steven James,9999,0,9999,0
1668459515412,CSE 293,038,119435,Tullsen; Dean Michael,9999,0,9999,0
1668459515412,CSE 293,039,119483,Voelker; Geoffrey M.,9999,0,9999,0
1668459515412,CSE 293,040,119537,Zhao; Jishen,9999,0,9999,0
1668459515412,CSE 293,041,119538,Zhou; Yuan-Yuan,9999,0,9999,0
1668459515412,CSE 293,042,119539,Gao; Sicun,9999,0,9999,0
1668459515412,CSE 293,043,119540,Weibel; Nadir,9999,0,9999,0
1668459515412,CSE 293,044,119541,Gupta; Rajesh K.,9999,0,9999,0
1668459515412,CSE 293,045,126410,Vaccaro; Kristen Marie,9999,0,9999,0
1668459515412,CSE 293,046,126411,Klemke; Richard,9999,0,9999,0
1668459515844,CSE 294,A00,102459,Voelker; Geoffrey M.,0,2,0,0
1668459515844,CSE 294,B00,111322,Orailoglu; Alex,0,1,0,0
1668459516267,DSE 201,A00,096914,Deutsch; Alin Bernard,30,0,30,0
1668459516699,DSE 210,A00,096915,Dasgupta; Sanjoy,30,0,30,0
1668459517131,DSE 260A,A00,096916,Altintas De Callaf; Ilkay,30,0,30,0
1668459517566,ECE 200,001,103586,Antipa; Nicholas A,9999,0,9999,0
1668459517566,ECE 200,002,103587,Atanasov; Nikolay A.,9999,0,9999,0
1668459517566,ECE 200,003,103588,Bharadia; Dinesh,9999,0,9999,0
1668459517566,ECE 200,004,103589,Cheng; Chung Kuan,9999,0,9999,0
1668459517566,ECE 200,005,103590,Cosman; Pamela C.,9999,0,9999,0
1668459517566,ECE 200,006,103591,Dayeh; Shadi Ahmad,9999,0,9999,0
1668459517566,ECE 200,007,103592,Fainman; Yeshaiahu,9999,0,9999,0
1668459517566,ECE 200,008,103593,Ford; Joseph Earl,9999,0,9999,0
1668459517566,ECE 200,009,103594,Franceschetti; Massimo,9999,0,9999,0
1668459517566,ECE 200,010,103595,Fullerton; Eric E,9999,0,9999,0
1668459517566,ECE 200,011,103596,Galton; Ian A,9999,0,9999,0
1668459517566,ECE 200,012,103597,Gilja; Vikash,9999,0,9999,0
1668459517566,ECE 200,013,103598,Hall; Drew A.,9999,0,9999,0
1668459517566,ECE 200,014,103599,Hsueh; Tzu-Chien,9999,0,9999,0
1668459517566,ECE 200,015,103600,Javidi; Tara,9999,0,9999,0
1668459517566,ECE 200,016,103601,Kahng; Andrew Byun,9999,0,9999,0
1668459517566,ECE 200,017,103602,Kim; Young-Han,9999,0,9999,0
1668459517566,ECE 200,018,103603,Koushanfar; Farinaz,9999,0,9999,0
1668459517566,ECE 200,019,103604,Kuzum; Duygu,9999,0,9999,0
1668459517566,ECE 200,020,103605,Le; Hanh-Phuc,9999,0,9999,0
1668459517566,ECE 200,021,103606,Lin; Bill,9999,0,9999,0
1668459517566,ECE 200,022,103607,Liu; Zhaowei,9998,0,9999,1
1668459517566,ECE 200,023,103608,Lo; Yu-Hwa,9999,0,9999,0
1668459517566,ECE 200,024,103609,Lomakin; Vitaliy,9999,0,9999,0
1668459517566,ECE 200,025,103610,Mercier; Patrick Philip,9999,0,9999,0
1668459517566,ECE 200,026,103611,Meyer; Florian,9999,0,9999,0
1668459517566,ECE 200,027,103612,Milstein; Laurence B.,9999,0,9999,0
1668459517566,ECE 200,028,103613,Mir Arabbaygi; Siavash,9999,0,9999,0
1668459517566,ECE 200,029,103614,Mookherjea; Shayan,9999,0,9999,0
1668459517566,ECE 200,030,103615,Morris; Karcher William,9999,0,9999,0
1668459517566,ECE 200,031,103616,Ng; Tse Nga,9999,0,9999,0
1668459517566,ECE 200,032,103617,Nguyen; Truong Quang,9999,0,9999,0
1668459517566,ECE 200,033,103618,Nomura; Kenji,9999,0,9999,0
1668459517566,ECE 200,034,103619,Orlitsky; Alon,9999,0,9999,0
1668459517566,ECE 200,035,103620,Pal; Piya,9999,0,9999,0
1668459517566,ECE 200,036,103621,Papen; George C.,9999,0,9999,0
1668459517566,ECE 200,037,103622,Radic; Stojan,9999,0,9999,0
1668459517566,ECE 200,038,103623,Rao; Bhaskar D.,9999,0,9999,0
1668459517566,ECE 200,039,103624,Rao; Ramesh R,9999,0,9999,0
1668459517566,ECE 200,040,103625,Rebeiz; Gabriel,9999,0,9999,0
1668459517566,ECE 200,041,103626,Sanford; John R,9999,0,9999,0
1668459517566,ECE 200,042,103627,Siegel; Paul H.,9999,0,9999,0
1668459517566,ECE 200,043,103628,Sievenpiper; Daniel F.,9999,0,9999,0
1668459517566,ECE 200,044,103629,Sworder; David D.,9999,0,9999,0
1668459517566,ECE 200,045,103630,Taur; Yuan,9999,0,9999,0
1668459517566,ECE 200,046,103631,Touri; Behrouz,9999,0,9999,0
1668459517566,ECE 200,047,103632,Trivedi; Mohan M.,9999,0,9999,0
1668459517566,ECE 200,048,103633,Vasconcelos; Nuno,9999,0,9999,0
1668459517566,ECE 200,049,103634,Wang; Xiaolong,9999,0,9999,0
1668459517566,ECE 200,050,103635,Xie; Pengtao,9999,0,9999,0
1668459517566,ECE 200,051,103636,Yip; Michael,9999,0,9999,0
1668459517566,ECE 200,052,103637,Zeger; Kenneth A.,999,0,999,0
1668459517566,ECE 200,053,103638,Zhang; Xinyu,9999,0,9999,0
1668459517566,ECE 200,054,103639,Turakhia; Yatish Girish,9999,0,9999,0
1668459517566,ECE 200,055,103640,Kang; Mingu,9999,0,9999,0
1668459517566,ECE 200,056,103641,Shi; Yuanyuan,9999,0,9999,0
1668459517566,ECE 200,057,103642,Wang; Edward Jay,9999,0,9999,0
1668459517566,ECE 200,058,103643,Zheng; Yang,9999,0,9999,0
1668459517999,ECE 202,A00,103644,Kuzum; Duygu,0,37,0,0
1668459518428,ECE 212BN,A00,103646,Ng; Tse Nga,0,4,0,0
1668459518857,ECE 221,A00,111493,Staff,0,0,0,0
1668459519287,ECE 222B,A00,103647,Lomakin; Vitaliy,0,10,0,0
1668459519709,ECE 230B,A00,103648,Taur; Yuan,0,2,0,0
1668459520144,ECE 238B,A00,103649,Garay; Javier,0,0,0,0
1668459520577,ECE 240B,A00,112900,Fainman; Yeshaiahu,0,4,0,0
1668459521009,ECE 247A,A00,103650,Jokerst; Jesse Vincent,0,3,0,0
1668459521434,ECE 247B,A00,103651,Wang; Joseph,0,9,0,0
1668459521865,ECE 250,A00,103652,Siegel; Paul H.,0,62,0,0
1668459522292,ECE 251A,A00,103654,Rao; Bhaskar D.,0,46,0,0
1668459522715,ECE 257B,A00,103655,Bharadia; Dinesh,0,26,0,0
1668459523137,ECE 258A,A00,103656,Milstein; Laurence B.,0,23,0,0
1668459523564,ECE 260B,A00,103658,Kang; Mingu,0,105,0,0
1668459524001,ECE 264A,A00,103659,Galton; Ian A,0,59,0,0
1668459524430,ECE 265A,A00,103661,Gudem; Prasad S.S.,0,38,0,0
1668459524858,ECE 265D,A00,103662,Gudem; Prasad S.S.,0,20,0,0
1668459525286,ECE 268,A00,103663,Koushanfar; Farinaz,0,36,0,0
1668459525721,ECE 269,A01,103665,Pal; Piya,0,172,0,0
1668459526150,ECE 271B,A00,103666,Vasconcelos; Manuela,0,59,0,0
1668459526584,ECE 276A,A00,103667,Atanasov; Nikolay A.,0,93,0,0
1668459527009,ECE 277,A00,103668,An; Cheolhong,0,125,0,0
1668459527434,ECE 279,A00,117947,Hall; Drew A.,0,18,0,0
1668459528289,ECE 283,A00,103670,Hsueh; Tzu-Chien,0,43,0,0
1668459528715,ECE 284,A00,103671,Turakhia; Yatish Girish,0,34,0,0
1668459529139,ECE 285,A00,103672,Zheng; Yang,0,31,0,0
1668459529139,ECE 285,B00,103673,Sworder; David D.,0,45,0,0
1668459529567,ECE 287,A00,103676,Javidi; Tara,0,6,0,0
1668459530009,MATH 200B,A00,098023,Salehi Golsefidy; Alireza,12,0,15,3
1668459530432,MATH 202B,A00,098024,Rhoades; Brendon Patrick,9,0,15,6
1668459530854,MATH 203B,A00,098025,Oprea; Dragos N.,10,0,15,5
1668459531277,MATH 204B,A00,098026,Sorensen; Claus M,13,0,15,2
1668459531702,MATH 208,A00,098027,Izadi; Elham,7,0,10,3
1668459532124,MATH 209,A00,098028,Pollack; Aaron,10,0,10,0
1668459532563,MATH 211A,A00,112919,Rogalski; Daniel,9,0,10,1
1668459532990,MATH 211B,A00,112920,Seward; Brandon M.,9,0,10,1
1668459533415,MATH 218,A00,098029,Li; Bo,10,0,10,0
1668459533852,MATH 220B,A00,098030,Novak; Jonathan I,11,0,15,4
1668459534291,MATH 221A,A00,098031,Ebenfelt; Peter F,13,0,15,2
1668459534716,MATH 231B,A00,098032,Zlatos; Andrej,11,0,15,4
1668459535143,MATH 240B,A00,098033,Ni; Lei,9,0,15,6
1668459535574,MATH 243,A00,098034,Jekel; David Andrew,10,0,10,0
1668459536002,MATH 245A,A00,098035,Nie; Jiawang,0,2,15,16
1668459536433,MATH 248,A00,098036,Bejenaru; Ioan,10,0,10,0
1668459536863,MATH 250B,A00,098037,Spolaor; Luca,14,0,15,1
1668459537289,MATH 258,A00,098038,Ni; Lei,10,0,10,0
1668459537720,MATH 264B,A00,098041,Rhoades; Brendon Patrick,9,0,15,6
1668459538143,MATH 268,A00,098042,Buss; Samuel R,10,0,10,0
1668459538569,MATH 269,A00,098043,Rhoades; Brendon Patrick,10,0,10,0
1668459539000,MATH 270B,A00,098044,Li; Bo,10,0,15,5
1668459539440,MATH 272B,A00,098045,Holst; Michael J,13,0,15,2
1668459539868,MATH 273A,A00,098046,Tian; Xiaochuan,10,0,15,5
1668459540297,MATH 275,A01,098048,Tian; Xiaochuan,6,0,10,4
1668459540720,MATH 278A,A00,098049,Holst; Michael J,8,0,10,2
1668459541148,MATH 278B,A00,098050,Cloninger; Alexander,10,0,10,0
1668459541569,MATH 278C,A00,098051,Nie; Jiawang,6,0,10,4
1668459541992,MATH 280B,A00,098052,Zheng; Tianyi,7,0,15,8
1668459542417,MATH 281B,A00,098053,Bradic; Jelena,0,2,15,15
1668459542844,MATH 282B,A00,098054,Arias-Castro; Ery,0,0,15,15
1668459543268,MATH 285,A00,098055,Fitzsimmons; Patrick J,0,1,15,17
1668459543695,MATH 287B,A00,098056,Arias-Castro; Ery,2,0,15,13
1668459544120,MATH 288,A00,098057,Agarwal; Pooja,9,0,10,1
1668459544120,MATH 288,B00,098058,Zhang; Danna,8,0,10,2
1668459544120,MATH 288,C00,098059,Williams; Ruth J,9,0,10,1
1668459544553,MATH 290B,A00,098060,Roberts; Justin Deritter,13,0,15,2
1668459545090,MATH 292,A00,098061,Belmont; Eva Kinoshita,10,0,10,0
1668459545515,MATH 295,A00,098062,Suk; Andrew Hoon,48,0,50,2
1668459545946,MATH 296,A00,098063,Novak; Jonathan I,20,0,20,0
1668459546377,MATH 297,001,098064,Gamst; Anthony Collins,9997,0,9999,2
1668460049972,COGS 205,A00,101395,Chiba; Andrea,19,0,20,1
1668460050396,COGS 210B,001,101404,Greene; Deanna Jacquelyn,9998,0,9999,1
1668460050396,COGS 210B,002,101417,Xia; Haijun,9999,0,9999,0
1668460050396,COGS 210B,003,101422,Nitz; Douglas A.,9999,0,9999,0
1668460050396,COGS 210B,004,101423,Hollan; James D.,9998,0,9999,1
1668460050396,COGS 210B,005,101424,Deak; Gedeon O.,9998,0,9999,1
1668460050396,COGS 210B,006,101425,Rossano; Federico,9999,0,9999,0
1668460050824,COGS 211B,A00,101427,Coulson; Seana M,9996,0,9999,3
1668460051247,COGS 220,A00,101428,Hollan; James D.,1,8,25,24
1668460051692,COGS 229,A00,101429,Dow; Steven P,17,0,25,8
1668460052117,COGS 230,A00,101430,Klemmer; Scott R,8,0,17,9
1668460052542,COGS 234,A00,101431,Xia; Haijun,2,0,25,23
1668460052967,COGS 260,A00,101432,Kiyonaga; Anastasia,21,0,25,4
1668460052967,COGS 260,B00,101433,Kirsh; David Joel,15,0,25,10
1668460053390,CSE 202,A00,102371,Impagliazzo; Russell,0,53,0,0
1668460053814,CSE 203B,A01,102373,Cheng; Chung Kuan,0,44,0,0
1668460054237,CSE 208,A00,102374,Micciancio; Daniele,0,3,0,0
1668460054669,CSE 209A,A00,112895,Impagliazzo; Russell,0,8,15,15
1668460055099,CSE 209B,A00,108005,Bellare; Mihir,0,4,0,0
1668460055528,CSE 210,A00,113163,Coblenz; Michael J,0,70,0,0
1668460055951,CSE 219,A00,106111,Dow; Steven P,0,4,20,20
1668460056383,CSE 221,A00,102376,Voelker; Geoffrey M.,0,50,0,0
1668460056821,CSE 224,A01,102378,Porter; George M,0,141,0,0
1668460057242,CSE 229A,A00,102379,Savage; Stefan,0,6,0,0
1668460057665,CSE 229C,A00,102380,Munyaka; Imani N. S.,0,6,0,0
1668460058089,CSE 232B,A00,102382,Deutsch; Alin Bernard,0,27,0,0
1668460058520,CSE 234,A01,112904,Kumar; Arun Kumar,0,0,0,0
1668460058948,CSE 237A,A00,102383,Rosing; Tajana Simunic,0,44,0,0
1668460059372,CSE 239A,A00,102384,Deutsch; Alin Bernard,0,8,0,0
1668460059797,CSE 239B,A00,102385,Polikarpova; Nadezhda,0,7,0,0
1668460060240,CSE 240A,A00,102386,Pannuto; Patrick William,0,38,0,0
1668460060670,CSE 240B,A00,102387,Zhao; Jishen,0,37,0,0
1668460061099,CSE 241A,A00,106406,Kang; Mingu,0,6,0,0
1668460061538,CSE 249B,A00,102388,Kahng; Andrew Byun,0,3,8,8
1668460061960,CSE 251B,A01,102392,Cottrell; Garrison W,0,34,0,0
1668460061960,CSE 251B,A02,102393,Cottrell; Garrison W,0,30,0,0
1668460062384,CSE 252B,A00,102394,Ochoa; Benjamin Lawrence,0,45,0,0
1668460062808,CSE 257,A01,102396,Gao; Sicun,0,118,0,0
1668460063235,CSE 272,A00,102397,Li; Tzumao,0,14,0,0
1668460063662,CSE 274,A00,111323,Chern; Albert Ren-Haur,0,9,0,0
1668460064085,CSE 282,A00,102398,Pevzner; Pavel Arkadjevich,0,0,0,0
1668460064507,CSE 284,A00,114175,Gymrek; Melissa Ann,0,16,0,0
1668460064952,CSE 290,A00,102399,Chandraker; Manmohan Krishna,0,9,0,0
1668460064952,CSE 290,B00,102400,Vaccaro; Kristen Marie,0,5,25,25
1668460064952,CSE 290,C00,102414,Pannuto; Patrick William,0,1,25,25
1668460064952,CSE 290,D00,102427,Pevzner; Pavel Arkadjevich,0,0,0,0
1668460064952,CSE 290,E00,102429,Zhao; Jishen,0,2,0,0
1668460064952,CSE 290,F00,102436,Tullsen; Dean Michael,0,4,0,0
1668460064952,CSE 290,G00,102440,Christensen; Henrik I,0,5,20,20
1668460065392,CSE 291,A00,102443,Su; Hao,0,0,0,0
1668460065392,CSE 291,B00,102448,Polikarpova; Nadezhda,0,0,0,0
1668460065392,CSE 291,C00,102453,Vaccaro; Kristen Marie,0,0,0,0
1668460065392,CSE 291,D00,111343,Savage; Stefan,0,0,0,0
1668460065392,CSE 291,E00,116474,Claffy; Kimberly Claire,0,0,0,0
1668460065392,CSE 291,F00,116479,Pasquale; Joseph,0,0,0,0
1668460065853,CSE 293,001,119111,Bafna; Vineet,9999,0,9999,0
1668460065853,CSE 293,002,119118,Bellare; Mihir,9999,0,9999,0
1668460065853,CSE 293,003,119122,Berg-Kirkpatrick; Taylor D,9999,0,9999,0
1668460065853,CSE 293,004,119135,Christensen; Henrik I,9999,0,9999,0
1668460065853,CSE 293,005,119142,Cottrell; Garrison W,9999,0,9999,0
1668460065853,CSE 293,006,119146,Deutsch; Alin Bernard,9999,0,9999,0
1668460065853,CSE 293,007,119159,Esmaeilzadeh; Hadi,9999,0,9999,0
1668460065853,CSE 293,008,119166,Freund; Yoav,9999,0,9999,0
1668460065853,CSE 293,009,119170,Griswold; William G.,9999,0,9999,0
1668460065853,CSE 293,010,119183,Gymrek; Melissa Ann,9999,0,9999,0
1668460065853,CSE 293,011,119190,Heninger; Nadia A,9999,0,9999,0
1668460065853,CSE 293,012,119230,Impagliazzo; Russell,9999,0,9999,0
1668460065853,CSE 293,013,119232,Jhala; Ranjit,9999,0,9999,0
1668460065853,CSE 293,014,119233,Kahng; Andrew Byun,9999,0,9999,0
1668460065853,CSE 293,015,119298,Kane; Daniel Mertz,9999,0,9999,0
1668460065853,CSE 293,016,119299,Kriegman; David J,9999,0,9999,0
1668460065853,CSE 293,017,119300,Kumar; Arun Kumar,9999,0,9999,0
1668460065853,CSE 293,018,119301,Lerner; Sorin,9999,0,9999,0
1668460065853,CSE 293,019,119302,Lovett; Shachar,9999,0,9999,0
1668460065853,CSE 293,020,119303,McAuley; Julian John,9999,0,9999,0
1668460065853,CSE 293,021,119304,Micciancio; Daniele,9999,0,9999,0
1668460065853,CSE 293,022,119367,Orailoglu; Alex,9999,0,9999,0
1668460065853,CSE 293,023,119382,Paturi; Ramamohan,9999,0,9999,0
1668460065853,CSE 293,024,119404,Polikarpova; Nadezhda,9999,0,9999,0
1668460065853,CSE 293,025,119406,Politz; Joseph Gibbs,9999,0,9999,0
1668460065853,CSE 293,026,119411,Porter; George M,9999,0,9999,0
1668460065853,CSE 293,027,119414,Porter; Leonard Emerson,9999,0,9999,0
1668460065853,CSE 293,028,119416,Ramamoorthi; Ravi,9999,0,9999,0
1668460065853,CSE 293,029,119417,Sahoo; Debashis,9999,0,9999,0
1668460065853,CSE 293,030,119420,Saul; Lawrence,9999,0,9999,0
1668460065853,CSE 293,031,119421,Savage; Stefan,9999,0,9999,0
1668460065853,CSE 293,032,119425,Schulze; Jurgen P.,9999,0,9999,0
1668460065853,CSE 293,033,119426,Snoeren; Alex C.,9999,0,9999,0
1668460065853,CSE 293,034,119428,Shang; Jingbo,9999,0,9999,0
1668460065853,CSE 293,035,119430,Stefan; Deian,9999,0,9999,0
1668460065853,CSE 293,036,119431,Su; Hao,9999,0,9999,0
1668460065853,CSE 293,037,119433,Swanson; Steven James,9999,0,9999,0
1668460065853,CSE 293,038,119435,Tullsen; Dean Michael,9999,0,9999,0
1668460065853,CSE 293,039,119483,Voelker; Geoffrey M.,9999,0,9999,0
1668460065853,CSE 293,040,119537,Zhao; Jishen,9999,0,9999,0
1668460065853,CSE 293,041,119538,Zhou; Yuan-Yuan,9999,0,9999,0
1668460065853,CSE 293,042,119539,Gao; Sicun,9999,0,9999,0
1668460065853,CSE 293,043,119540,Weibel; Nadir,9999,0,9999,0
1668460065853,CSE 293,044,119541,Gupta; Rajesh K.,9999,0,9999,0
1668460065853,CSE 293,045,126410,Vaccaro; Kristen Marie,9999,0,9999,0
1668460065853,CSE 293,046,126411,Klemke; Richard,9999,0,9999,0
1668460066281,CSE 294,A00,102459,Voelker; Geoffrey M.,0,2,0,0
1668460066281,CSE 294,B00,111322,Orailoglu; Alex,0,1,0,0
1668460066707,DSE 201,A00,096914,Deutsch; Alin Bernard,30,0,30,0
1668460067131,DSE 210,A00,096915,Dasgupta; Sanjoy,30,0,30,0
1668460067556,DSE 260A,A00,096916,Altintas De Callaf; Ilkay,30,0,30,0
1668460068098,ECE 200,001,103586,Antipa; Nicholas A,9999,0,9999,0
1668460068098,ECE 200,002,103587,Atanasov; Nikolay A.,9999,0,9999,0
1668460068098,ECE 200,003,103588,Bharadia; Dinesh,9999,0,9999,0
1668460068098,ECE 200,004,103589,Cheng; Chung Kuan,9999,0,9999,0
1668460068098,ECE 200,005,103590,Cosman; Pamela C.,9999,0,9999,0
1668460068098,ECE 200,006,103591,Dayeh; Shadi Ahmad,9999,0,9999,0
1668460068098,ECE 200,007,103592,Fainman; Yeshaiahu,9999,0,9999,0
1668460068098,ECE 200,008,103593,Ford; Joseph Earl,9999,0,9999,0
1668460068098,ECE 200,009,103594,Franceschetti; Massimo,9999,0,9999,0
1668460068098,ECE 200,010,103595,Fullerton; Eric E,9999,0,9999,0
1668460068098,ECE 200,011,103596,Galton; Ian A,9999,0,9999,0
1668460068098,ECE 200,012,103597,Gilja; Vikash,9999,0,9999,0
1668460068098,ECE 200,013,103598,Hall; Drew A.,9999,0,9999,0
1668460068098,ECE 200,014,103599,Hsueh; Tzu-Chien,9999,0,9999,0
1668460068098,ECE 200,015,103600,Javidi; Tara,9999,0,9999,0
1668460068098,ECE 200,016,103601,Kahng; Andrew Byun,9999,0,9999,0
1668460068098,ECE 200,017,103602,Kim; Young-Han,9999,0,9999,0
1668460068098,ECE 200,018,103603,Koushanfar; Farinaz,9999,0,9999,0
1668460068098,ECE 200,019,103604,Kuzum; Duygu,9999,0,9999,0
1668460068098,ECE 200,020,103605,Le; Hanh-Phuc,9999,0,9999,0
1668460068098,ECE 200,021,103606,Lin; Bill,9999,0,9999,0
1668460068098,ECE 200,022,103607,Liu; Zhaowei,9998,0,9999,1
1668460068098,ECE 200,023,103608,Lo; Yu-Hwa,9999,0,9999,0
1668460068098,ECE 200,024,103609,Lomakin; Vitaliy,9999,0,9999,0
1668460068098,ECE 200,025,103610,Mercier; Patrick Philip,9999,0,9999,0
1668460068098,ECE 200,026,103611,Meyer; Florian,9999,0,9999,0
1668460068098,ECE 200,027,103612,Milstein; Laurence B.,9999,0,9999,0
1668460068098,ECE 200,028,103613,Mir Arabbaygi; Siavash,9999,0,9999,0
1668460068098,ECE 200,029,103614,Mookherjea; Shayan,9999,0,9999,0
1668460068098,ECE 200,030,103615,Morris; Karcher William,9999,0,9999,0
1668460068098,ECE 200,031,103616,Ng; Tse Nga,9999,0,9999,0
1668460068098,ECE 200,032,103617,Nguyen; Truong Quang,9999,0,9999,0
1668460068098,ECE 200,033,103618,Nomura; Kenji,9999,0,9999,0
1668460068098,ECE 200,034,103619,Orlitsky; Alon,9999,0,9999,0
1668460068098,ECE 200,035,103620,Pal; Piya,9999,0,9999,0
1668460068098,ECE 200,036,103621,Papen; George C.,9999,0,9999,0
1668460068098,ECE 200,037,103622,Radic; Stojan,9999,0,9999,0
1668460068098,ECE 200,038,103623,Rao; Bhaskar D.,9999,0,9999,0
1668460068098,ECE 200,039,103624,Rao; Ramesh R,9999,0,9999,0
1668460068098,ECE 200,040,103625,Rebeiz; Gabriel,9999,0,9999,0
1668460068098,ECE 200,041,103626,Sanford; John R,9999,0,9999,0
1668460068098,ECE 200,042,103627,Siegel; Paul H.,9999,0,9999,0
1668460068098,ECE 200,043,103628,Sievenpiper; Daniel F.,9999,0,9999,0
1668460068098,ECE 200,044,103629,Sworder; David D.,9999,0,9999,0
1668460068098,ECE 200,045,103630,Taur; Yuan,9999,0,9999,0
1668460068098,ECE 200,046,103631,Touri; Behrouz,9999,0,9999,0
1668460068098,ECE 200,047,103632,Trivedi; Mohan M.,9999,0,9999,0
1668460068098,ECE 200,048,103633,Vasconcelos; Nuno,9999,0,9999,0
1668460068098,ECE 200,049,103634,Wang; Xiaolong,9999,0,9999,0
1668460068098,ECE 200,050,103635,Xie; Pengtao,9999,0,9999,0
1668460068098,ECE 200,051,103636,Yip; Michael,9999,0,9999,0
1668460068098,ECE 200,052,103637,Zeger; Kenneth A.,999,0,999,0
1668460068098,ECE 200,053,103638,Zhang; Xinyu,9999,0,9999,0
1668460068098,ECE 200,054,103639,Turakhia; Yatish Girish,9999,0,9999,0
1668460068098,ECE 200,055,103640,Kang; Mingu,9999,0,9999,0
1668460068098,ECE 200,056,103641,Shi; Yuanyuan,9999,0,9999,0
1668460068098,ECE 200,057,103642,Wang; Edward Jay,9999,0,9999,0
1668460068098,ECE 200,058,103643,Zheng; Yang,9999,0,9999,0
1668460068521,ECE 202,A00,103644,Kuzum; Duygu,0,37,0,0
1668460068956,ECE 212BN,A00,103646,Ng; Tse Nga,0,4,0,0
1668460069380,ECE 221,A00,111493,Staff,0,0,0,0
1668460069804,ECE 222B,A00,103647,Lomakin; Vitaliy,0,10,0,0
1668460070247,ECE 230B,A00,103648,Taur; Yuan,0,2,0,0
1668460070673,ECE 238B,A00,103649,Garay; Javier,0,0,0,0
1668460071100,ECE 240B,A00,112900,Fainman; Yeshaiahu,0,4,0,0
1668460071536,ECE 247A,A00,103650,Jokerst; Jesse Vincent,0,3,0,0
1668460071959,ECE 247B,A00,103651,Wang; Joseph,0,9,0,0
1668460072382,ECE 250,A00,103652,Siegel; Paul H.,0,63,0,0
1668460072814,ECE 251A,A00,103654,Rao; Bhaskar D.,0,46,0,0
1668460073236,ECE 257B,A00,103655,Bharadia; Dinesh,0,26,0,0
1668460073659,ECE 258A,A00,103656,Milstein; Laurence B.,0,23,0,0
1668460074094,ECE 260B,A00,103658,Kang; Mingu,0,106,0,0
1668460074521,ECE 264A,A00,103659,Galton; Ian A,0,60,0,0
1668460074947,ECE 265A,A00,103661,Gudem; Prasad S.S.,0,38,0,0
1668460075375,ECE 265D,A00,103662,Gudem; Prasad S.S.,0,20,0,0
1668460075801,ECE 268,A00,103663,Koushanfar; Farinaz,0,36,0,0
1668460076231,ECE 269,A01,103665,Pal; Piya,0,174,0,0
1668460076655,ECE 271B,A00,103666,Vasconcelos; Manuela,0,60,0,0
1668460077089,ECE 276A,A00,103667,Atanasov; Nikolay A.,0,94,0,0
1668460077514,ECE 277,A00,103668,An; Cheolhong,0,126,0,0
1668460077953,ECE 279,A00,117947,Hall; Drew A.,0,18,0,0
1668460078800,ECE 283,A00,103670,Hsueh; Tzu-Chien,0,43,0,0
1668460079227,ECE 284,A00,103671,Turakhia; Yatish Girish,0,35,0,0
1668460079658,ECE 285,A00,103672,Zheng; Yang,0,31,0,0
1668460079658,ECE 285,B00,103673,Sworder; David D.,0,46,0,0
1668460080080,ECE 287,A00,103676,Javidi; Tara,0,6,0,0
1668460080507,MATH 200B,A00,098023,Salehi Golsefidy; Alireza,12,0,15,3
1668460080933,MATH 202B,A00,098024,Rhoades; Brendon Patrick,9,0,15,6
1668460081357,MATH 203B,A00,098025,Oprea; Dragos N.,10,0,15,5
1668460081782,MATH 204B,A00,098026,Sorensen; Claus M,13,0,15,2
1668460082210,MATH 208,A00,098027,Izadi; Elham,7,0,10,3
1668460082634,MATH 209,A00,098028,Pollack; Aaron,10,0,10,0
1668460083068,MATH 211A,A00,112919,Rogalski; Daniel,9,0,10,1
1668460083500,MATH 211B,A00,112920,Seward; Brandon M.,9,0,10,1
1668460083926,MATH 218,A00,098029,Li; Bo,10,0,10,0
1668460084363,MATH 220B,A00,098030,Novak; Jonathan I,11,0,15,4
1668460084796,MATH 221A,A00,098031,Ebenfelt; Peter F,13,0,15,2
1668460085219,MATH 231B,A00,098032,Zlatos; Andrej,11,0,15,4
1668460085665,MATH 240B,A00,098033,Ni; Lei,9,0,15,6
1668460086098,MATH 243,A00,098034,Jekel; David Andrew,10,0,10,0
1668460086538,MATH 245A,A00,098035,Nie; Jiawang,0,2,15,16
1668460086961,MATH 248,A00,098036,Bejenaru; Ioan,10,0,10,0
1668460087390,MATH 250B,A00,098037,Spolaor; Luca,14,0,15,1
1668460087816,MATH 258,A00,098038,Ni; Lei,10,0,10,0
1668460088241,MATH 264B,A00,098041,Rhoades; Brendon Patrick,9,0,15,6
1668460088677,MATH 268,A00,098042,Buss; Samuel R,10,0,10,0
1668460089100,MATH 269,A00,098043,Rhoades; Brendon Patrick,10,0,10,0
1668460089525,MATH 270B,A00,098044,Li; Bo,10,0,15,5
1668460089958,MATH 272B,A00,098045,Holst; Michael J,13,0,15,2
1668460090385,MATH 273A,A00,098046,Tian; Xiaochuan,10,0,15,5
1668460090813,MATH 275,A01,098048,Tian; Xiaochuan,6,0,10,4
1668460091243,MATH 278A,A00,098049,Holst; Michael J,8,0,10,2
1668460091671,MATH 278B,A00,098050,Cloninger; Alexander,10,0,10,0
1668460092094,MATH 278C,A00,098051,Nie; Jiawang,6,0,10,4
1668460092519,MATH 280B,A00,098052,Zheng; Tianyi,7,0,15,8
1668460092951,MATH 281B,A00,098053,Bradic; Jelena,0,2,15,15
1668460093385,MATH 282B,A00,098054,Arias-Castro; Ery,0,0,15,15
1668460093814,MATH 285,A00,098055,Fitzsimmons; Patrick J,0,1,15,17
1668460094241,MATH 287B,A00,098056,Arias-Castro; Ery,2,0,15,13
1668460094666,MATH 288,A00,098057,Agarwal; Pooja,9,0,10,1
1668460094666,MATH 288,B00,098058,Zhang; Danna,8,0,10,2
1668460094666,MATH 288,C00,098059,Williams; Ruth J,9,0,10,1
1668460095088,MATH 290B,A00,098060,Roberts; Justin Deritter,13,0,15,2
1668460095511,MATH 292,A00,098061,Belmont; Eva Kinoshita,10,0,10,0
1668460095933,MATH 295,A00,098062,Suk; Andrew Hoon,48,0,50,2
1668460096357,MATH 296,A00,098063,Novak; Jonathan I,20,0,20,0
1668460096790,MATH 297,001,098064,Gamst; Anthony Collins,9997,0,9999,2
1668460610357,COGS 205,A00,101395,Chiba; Andrea,19,0,20,1
1668460610783,COGS 210B,001,101404,Greene; Deanna Jacquelyn,9998,0,9999,1
1668460610783,COGS 210B,002,101417,Xia; Haijun,9999,0,9999,0
1668460610783,COGS 210B,003,101422,Nitz; Douglas A.,9999,0,9999,0
1668460610783,COGS 210B,004,101423,Hollan; James D.,9998,0,9999,1
1668460610783,COGS 210B,005,101424,Deak; Gedeon O.,9998,0,9999,1
1668460610783,COGS 210B,006,101425,Rossano; Federico,9999,0,9999,0
1668460611209,COGS 211B,A00,101427,Coulson; Seana M,9996,0,9999,3
1668460611632,COGS 220,A00,101428,Hollan; James D.,1,8,25,24
1668460612059,COGS 229,A00,101429,Dow; Steven P,17,0,25,8
1668460612484,COGS 230,A00,101430,Klemmer; Scott R,8,0,17,9
1668460612909,COGS 234,A00,101431,Xia; Haijun,2,0,25,23
1668460613335,COGS 260,A00,101432,Kiyonaga; Anastasia,21,0,25,4
1668460613335,COGS 260,B00,101433,Kirsh; David Joel,15,0,25,10
1668460613757,CSE 202,A00,102371,Impagliazzo; Russell,0,54,0,0
1668460614181,CSE 203B,A01,102373,Cheng; Chung Kuan,0,44,0,0
1668460614607,CSE 208,A00,102374,Micciancio; Daniele,0,3,0,0
1668460615032,CSE 209A,A00,112895,Impagliazzo; Russell,0,9,15,15
1668460615455,CSE 209B,A00,108005,Bellare; Mihir,0,5,0,0
1668460615882,CSE 210,A00,113163,Coblenz; Michael J,0,70,0,0
1668460616304,CSE 219,A00,106111,Dow; Steven P,0,5,20,20
1668460616728,CSE 221,A00,102376,Voelker; Geoffrey M.,0,51,0,0
1668460617156,CSE 224,A01,102378,Porter; George M,0,141,0,0
1668460617581,CSE 229A,A00,102379,Savage; Stefan,0,7,0,0
1668460618006,CSE 229C,A00,102380,Munyaka; Imani N. S.,0,7,0,0
1668460618430,CSE 232B,A00,102382,Deutsch; Alin Bernard,0,27,0,0
1668460618865,CSE 234,A01,112904,Kumar; Arun Kumar,0,0,0,0
1668460619291,CSE 237A,A00,102383,Rosing; Tajana Simunic,0,44,0,0
1668460619715,CSE 239A,A00,102384,Deutsch; Alin Bernard,0,9,0,0
1668460620156,CSE 239B,A00,102385,Polikarpova; Nadezhda,0,7,0,0
1668460620597,CSE 240A,A00,102386,Pannuto; Patrick William,0,38,0,0
1668460621022,CSE 240B,A00,102387,Zhao; Jishen,0,37,0,0
1668460621461,CSE 241A,A00,106406,Kang; Mingu,0,6,0,0
1668460621898,CSE 249B,A00,102388,Kahng; Andrew Byun,0,3,8,8
1668460622407,CSE 251B,A01,102392,Cottrell; Garrison W,0,34,0,0
1668460622407,CSE 251B,A02,102393,Cottrell; Garrison W,0,30,0,0
1668460622834,CSE 252B,A00,102394,Ochoa; Benjamin Lawrence,0,46,0,0
1668460623267,CSE 257,A01,102396,Gao; Sicun,0,120,0,0
1668460623693,CSE 272,A00,102397,Li; Tzumao,0,14,0,0
1668460624117,CSE 274,A00,111323,Chern; Albert Ren-Haur,0,9,0,0
1668460624542,CSE 282,A00,102398,Pevzner; Pavel Arkadjevich,0,0,0,0
1668460624976,CSE 284,A00,114175,Gymrek; Melissa Ann,0,16,0,0
1668460625409,CSE 290,A00,102399,Chandraker; Manmohan Krishna,0,9,0,0
1668460625409,CSE 290,B00,102400,Vaccaro; Kristen Marie,0,5,25,25
1668460625409,CSE 290,C00,102414,Pannuto; Patrick William,0,1,25,25
1668460625409,CSE 290,D00,102427,Pevzner; Pavel Arkadjevich,0,0,0,0
1668460625409,CSE 290,E00,102429,Zhao; Jishen,0,2,0,0
1668460625409,CSE 290,F00,102436,Tullsen; Dean Michael,0,4,0,0
1668460625409,CSE 290,G00,102440,Christensen; Henrik I,0,5,20,20
1668460625833,CSE 291,A00,102443,Su; Hao,0,0,0,0
1668460625833,CSE 291,B00,102448,Polikarpova; Nadezhda,0,0,0,0
1668460625833,CSE 291,C00,102453,Vaccaro; Kristen Marie,0,0,0,0
1668460625833,CSE 291,D00,111343,Savage; Stefan,0,0,0,0
1668460625833,CSE 291,E00,116474,Claffy; Kimberly Claire,0,0,0,0
1668460625833,CSE 291,F00,116479,Pasquale; Joseph,0,0,0,0
1668460626266,CSE 293,001,119111,Bafna; Vineet,9999,0,9999,0
1668460626266,CSE 293,002,119118,Bellare; Mihir,9999,0,9999,0
1668460626266,CSE 293,003,119122,Berg-Kirkpatrick; Taylor D,9999,0,9999,0
1668460626266,CSE 293,004,119135,Christensen; Henrik I,9999,0,9999,0
1668460626266,CSE 293,005,119142,Cottrell; Garrison W,9999,0,9999,0
1668460626266,CSE 293,006,119146,Deutsch; Alin Bernard,9999,0,9999,0
1668460626266,CSE 293,007,119159,Esmaeilzadeh; Hadi,9999,0,9999,0
1668460626266,CSE 293,008,119166,Freund; Yoav,9999,0,9999,0
1668460626266,CSE 293,009,119170,Griswold; William G.,9999,0,9999,0
1668460626266,CSE 293,010,119183,Gymrek; Melissa Ann,9999,0,9999,0
1668460626266,CSE 293,011,119190,Heninger; Nadia A,9999,0,9999,0
1668460626266,CSE 293,012,119230,Impagliazzo; Russell,9999,0,9999,0
1668460626266,CSE 293,013,119232,Jhala; Ranjit,9999,0,9999,0
1668460626266,CSE 293,014,119233,Kahng; Andrew Byun,9999,0,9999,0
1668460626266,CSE 293,015,119298,Kane; Daniel Mertz,9999,0,9999,0
1668460626266,CSE 293,016,119299,Kriegman; David J,9999,0,9999,0
1668460626266,CSE 293,017,119300,Kumar; Arun Kumar,9999,0,9999,0
1668460626266,CSE 293,018,119301,Lerner; Sorin,9999,0,9999,0
1668460626266,CSE 293,019,119302,Lovett; Shachar,9999,0,9999,0
1668460626266,CSE 293,020,119303,McAuley; Julian John,9999,0,9999,0
1668460626266,CSE 293,021,119304,Micciancio; Daniele,9999,0,9999,0
1668460626266,CSE 293,022,119367,Orailoglu; Alex,9999,0,9999,0
1668460626266,CSE 293,023,119382,Paturi; Ramamohan,9999,0,9999,0
1668460626266,CSE 293,024,119404,Polikarpova; Nadezhda,9999,0,9999,0
1668460626266,CSE 293,025,119406,Politz; Joseph Gibbs,9999,0,9999,0
1668460626266,CSE 293,026,119411,Porter; George M,9999,0,9999,0
1668460626266,CSE 293,027,119414,Porter; Leonard Emerson,9999,0,9999,0
1668460626266,CSE 293,028,119416,Ramamoorthi; Ravi,9999,0,9999,0
1668460626266,CSE 293,029,119417,Sahoo; Debashis,9999,0,9999,0
1668460626266,CSE 293,030,119420,Saul; Lawrence,9999,0,9999,0
1668460626266,CSE 293,031,119421,Savage; Stefan,9999,0,9999,0
1668460626266,CSE 293,032,119425,Schulze; Jurgen P.,9999,0,9999,0
1668460626266,CSE 293,033,119426,Snoeren; Alex C.,9999,0,9999,0
1668460626266,CSE 293,034,119428,Shang; Jingbo,9999,0,9999,0
1668460626266,CSE 293,035,119430,Stefan; Deian,9999,0,9999,0
1668460626266,CSE 293,036,119431,Su; Hao,9999,0,9999,0
1668460626266,CSE 293,037,119433,Swanson; Steven James,9999,0,9999,0
1668460626266,CSE 293,038,119435,Tullsen; Dean Michael,9999,0,9999,0
1668460626266,CSE 293,039,119483,Voelker; Geoffrey M.,9999,0,9999,0
1668460626266,CSE 293,040,119537,Zhao; Jishen,9999,0,9999,0
1668460626266,CSE 293,041,119538,Zhou; Yuan-Yuan,9999,0,9999,0
1668460626266,CSE 293,042,119539,Gao; Sicun,9999,0,9999,0
1668460626266,CSE 293,043,119540,Weibel; Nadir,9999,0,9999,0
1668460626266,CSE 293,044,119541,Gupta; Rajesh K.,9999,0,9999,0
1668460626266,CSE 293,045,126410,Vaccaro; Kristen Marie,9999,0,9999,0
1668460626266,CSE 293,046,126411,Klemke; Richard,9999,0,9999,0
1668460626689,CSE 294,A00,102459,Voelker; Geoffrey M.,0,2,0,0
1668460626689,CSE 294,B00,111322,Orailoglu; Alex,0,1,0,0
1668460627129,DSE 201,A00,096914,Deutsch; Alin Bernard,30,0,30,0
1668460627555,DSE 210,A00,096915,Dasgupta; Sanjoy,30,0,30,0
1668460627981,DSE 260A,A00,096916,Altintas De Callaf; Ilkay,30,0,30,0
1668460628413,ECE 200,001,103586,Antipa; Nicholas A,9999,0,9999,0
1668460628413,ECE 200,002,103587,Atanasov; Nikolay A.,9999,0,9999,0
1668460628413,ECE 200,003,103588,Bharadia; Dinesh,9999,0,9999,0
1668460628413,ECE 200,004,103589,Cheng; Chung Kuan,9999,0,9999,0
1668460628413,ECE 200,005,103590,Cosman; Pamela C.,9999,0,9999,0
1668460628413,ECE 200,006,103591,Dayeh; Shadi Ahmad,9999,0,9999,0
1668460628413,ECE 200,007,103592,Fainman; Yeshaiahu,9999,0,9999,0
1668460628413,ECE 200,008,103593,Ford; Joseph Earl,9999,0,9999,0
1668460628413,ECE 200,009,103594,Franceschetti; Massimo,9999,0,9999,0
1668460628413,ECE 200,010,103595,Fullerton; Eric E,9999,0,9999,0
1668460628413,ECE 200,011,103596,Galton; Ian A,9999,0,9999,0
1668460628413,ECE 200,012,103597,Gilja; Vikash,9999,0,9999,0
1668460628413,ECE 200,013,103598,Hall; Drew A.,9999,0,9999,0
1668460628413,ECE 200,014,103599,Hsueh; Tzu-Chien,9999,0,9999,0
1668460628413,ECE 200,015,103600,Javidi; Tara,9999,0,9999,0
1668460628413,ECE 200,016,103601,Kahng; Andrew Byun,9999,0,9999,0
1668460628413,ECE 200,017,103602,Kim; Young-Han,9999,0,9999,0
1668460628413,ECE 200,018,103603,Koushanfar; Farinaz,9999,0,9999,0
1668460628413,ECE 200,019,103604,Kuzum; Duygu,9999,0,9999,0
1668460628413,ECE 200,020,103605,Le; Hanh-Phuc,9999,0,9999,0
1668460628413,ECE 200,021,103606,Lin; Bill,9999,0,9999,0
1668460628413,ECE 200,022,103607,Liu; Zhaowei,9998,0,9999,1
1668460628413,ECE 200,023,103608,Lo; Yu-Hwa,9999,0,9999,0
1668460628413,ECE 200,024,103609,Lomakin; Vitaliy,9999,0,9999,0
1668460628413,ECE 200,025,103610,Mercier; Patrick Philip,9999,0,9999,0
1668460628413,ECE 200,026,103611,Meyer; Florian,9999,0,9999,0
1668460628413,ECE 200,027,103612,Milstein; Laurence B.,9999,0,9999,0
1668460628413,ECE 200,028,103613,Mir Arabbaygi; Siavash,9999,0,9999,0
1668460628413,ECE 200,029,103614,Mookherjea; Shayan,9999,0,9999,0
1668460628413,ECE 200,030,103615,Morris; Karcher William,9999,0,9999,0
1668460628413,ECE 200,031,103616,Ng; Tse Nga,9999,0,9999,0
1668460628413,ECE 200,032,103617,Nguyen; Truong Quang,9999,0,9999,0
1668460628413,ECE 200,033,103618,Nomura; Kenji,9999,0,9999,0
1668460628413,ECE 200,034,103619,Orlitsky; Alon,9999,0,9999,0
1668460628413,ECE 200,035,103620,Pal; Piya,9999,0,9999,0
1668460628413,ECE 200,036,103621,Papen; George C.,9999,0,9999,0
1668460628413,ECE 200,037,103622,Radic; Stojan,9999,0,9999,0
1668460628413,ECE 200,038,103623,Rao; Bhaskar D.,9999,0,9999,0
1668460628413,ECE 200,039,103624,Rao; Ramesh R,9999,0,9999,0
1668460628413,ECE 200,040,103625,Rebeiz; Gabriel,9999,0,9999,0
1668460628413,ECE 200,041,103626,Sanford; John R,9999,0,9999,0
1668460628413,ECE 200,042,103627,Siegel; Paul H.,9999,0,9999,0
1668460628413,ECE 200,043,103628,Sievenpiper; Daniel F.,9999,0,9999,0
1668460628413,ECE 200,044,103629,Sworder; David D.,9999,0,9999,0
1668460628413,ECE 200,045,103630,Taur; Yuan,9999,0,9999,0
1668460628413,ECE 200,046,103631,Touri; Behrouz,9999,0,9999,0
1668460628413,ECE 200,047,103632,Trivedi; Mohan M.,9999,0,9999,0
1668460628413,ECE 200,048,103633,Vasconcelos; Nuno,9999,0,9999,0
1668460628413,ECE 200,049,103634,Wang; Xiaolong,9999,0,9999,0
1668460628413,ECE 200,050,103635,Xie; Pengtao,9999,0,9999,0
1668460628413,ECE 200,051,103636,Yip; Michael,9999,0,9999,0
1668460628413,ECE 200,052,103637,Zeger; Kenneth A.,999,0,999,0
1668460628413,ECE 200,053,103638,Zhang; Xinyu,9999,0,9999,0
1668460628413,ECE 200,054,103639,Turakhia; Yatish Girish,9999,0,9999,0
1668460628413,ECE 200,055,103640,Kang; Mingu,9999,0,9999,0
1668460628413,ECE 200,056,103641,Shi; Yuanyuan,9999,0,9999,0
1668460628413,ECE 200,057,103642,Wang; Edward Jay,9999,0,9999,0
1668460628413,ECE 200,058,103643,Zheng; Yang,9999,0,9999,0
1668460628835,ECE 202,A00,103644,Kuzum; Duygu,0,37,0,0
1668460629269,ECE 212BN,A00,103646,Ng; Tse Nga,0,4,0,0
1668460629707,ECE 221,A00,111493,Staff,0,0,0,0
1668460630143,ECE 222B,A00,103647,Lomakin; Vitaliy,0,10,0,0
1668460630570,ECE 230B,A00,103648,Taur; Yuan,0,2,0,0
1668460630998,ECE 238B,A00,103649,Garay; Javier,0,0,0,0
1668460631421,ECE 240B,A00,112900,Fainman; Yeshaiahu,0,4,0,0
1668460631844,ECE 247A,A00,103650,Jokerst; Jesse Vincent,0,3,0,0
1668460632272,ECE 247B,A00,103651,Wang; Joseph,0,9,0,0
1668460632701,ECE 250,A00,103652,Siegel; Paul H.,0,63,0,0
1668460633135,ECE 251A,A00,103654,Rao; Bhaskar D.,0,47,0,0
1668460633564,ECE 257B,A00,103655,Bharadia; Dinesh,0,26,0,0
1668460633992,ECE 258A,A00,103656,Milstein; Laurence B.,0,23,0,0
1668460634419,ECE 260B,A00,103658,Kang; Mingu,0,106,0,0
1668460634843,ECE 264A,A00,103659,Galton; Ian A,0,60,0,0
1668460635274,ECE 265A,A00,103661,Gudem; Prasad S.S.,0,38,0,0
1668460635698,ECE 265D,A00,103662,Gudem; Prasad S.S.,0,20,0,0
1668460636122,ECE 268,A00,103663,Koushanfar; Farinaz,0,36,0,0
1668460636559,ECE 269,A01,103665,Pal; Piya,0,174,0,0
1668460636982,ECE 271B,A00,103666,Vasconcelos; Manuela,0,60,0,0
1668460637405,ECE 276A,A00,103667,Atanasov; Nikolay A.,0,94,0,0
1668460637831,ECE 277,A00,103668,An; Cheolhong,0,126,0,0
1668460638253,ECE 279,A00,117947,Hall; Drew A.,0,18,0,0
1668460639105,ECE 283,A00,103670,Hsueh; Tzu-Chien,0,43,0,0
1668460639543,ECE 284,A00,103671,Turakhia; Yatish Girish,0,35,0,0
1668460639983,ECE 285,A00,103672,Zheng; Yang,0,31,0,0
1668460639983,ECE 285,B00,103673,Sworder; David D.,0,46,0,0
1668460640413,ECE 287,A00,103676,Javidi; Tara,0,6,0,0
1668460640842,MATH 200B,A00,098023,Salehi Golsefidy; Alireza,12,0,15,3
1668460641270,MATH 202B,A00,098024,Rhoades; Brendon Patrick,9,0,15,6
1668460641698,MATH 203B,A00,098025,Oprea; Dragos N.,10,0,15,5
1668460642130,MATH 204B,A00,098026,Sorensen; Claus M,13,0,15,2
1668460642554,MATH 208,A00,098027,Izadi; Elham,7,0,10,3
1668460642977,MATH 209,A00,098028,Pollack; Aaron,10,0,10,0
1668460643417,MATH 211A,A00,112919,Rogalski; Daniel,9,0,10,1
1668460643843,MATH 211B,A00,112920,Seward; Brandon M.,9,0,10,1
1668460644343,MATH 218,A00,098029,Li; Bo,10,0,10,0
1668460644770,MATH 220B,A00,098030,Novak; Jonathan I,11,0,15,4
1668460645204,MATH 221A,A00,098031,Ebenfelt; Peter F,13,0,15,2
1668460645639,MATH 231B,A00,098032,Zlatos; Andrej,11,0,15,4
1668460646067,MATH 240B,A00,098033,Ni; Lei,9,0,15,6
1668460646489,MATH 243,A00,098034,Jekel; David Andrew,10,0,10,0
1668460646930,MATH 245A,A00,098035,Nie; Jiawang,0,2,15,16
1668460647352,MATH 248,A00,098036,Bejenaru; Ioan,10,0,10,0
1668460647786,MATH 250B,A00,098037,Spolaor; Luca,14,0,15,1
1668460648215,MATH 258,A00,098038,Ni; Lei,10,0,10,0
1668460648642,MATH 264B,A00,098041,Rhoades; Brendon Patrick,9,0,15,6
1668460649070,MATH 268,A00,098042,Buss; Samuel R,10,0,10,0
1668460649507,MATH 269,A00,098043,Rhoades; Brendon Patrick,10,0,10,0
1668460649934,MATH 270B,A00,098044,Li; Bo,10,0,15,5
1668460650357,MATH 272B,A00,098045,Holst; Michael J,13,0,15,2
1668460650783,MATH 273A,A00,098046,Tian; Xiaochuan,10,0,15,5
1668460651206,MATH 275,A01,098048,Tian; Xiaochuan,6,0,10,4
1668460651633,MATH 278A,A00,098049,Holst; Michael J,8,0,10,2
1668460652068,MATH 278B,A00,098050,Cloninger; Alexander,10,0,10,0
1668460652493,MATH 278C,A00,098051,Nie; Jiawang,6,0,10,4
1668460652917,MATH 280B,A00,098052,Zheng; Tianyi,7,0,15,8
1668460653339,MATH 281B,A00,098053,Bradic; Jelena,0,2,15,15
1668460653772,MATH 282B,A00,098054,Arias-Castro; Ery,0,0,15,15
1668460654199,MATH 285,A00,098055,Fitzsimmons; Patrick J,0,1,15,17
1668460654625,MATH 287B,A00,098056,Arias-Castro; Ery,2,0,15,13
1668460655056,MATH 288,A00,098057,Agarwal; Pooja,9,0,10,1
1668460655056,MATH 288,B00,098058,Zhang; Danna,8,0,10,2
1668460655056,MATH 288,C00,098059,Williams; Ruth J,9,0,10,1
1668460655481,MATH 290B,A00,098060,Roberts; Justin Deritter,13,0,15,2
1668460655903,MATH 292,A00,098061,Belmont; Eva Kinoshita,10,0,10,0
1668460656327,MATH 295,A00,098062,Suk; Andrew Hoon,48,0,50,2
1668460656750,MATH 296,A00,098063,Novak; Jonathan I,20,0,20,0
1668460657172,MATH 297,001,098064,Gamst; Anthony Collins,9997,0,9999,2
1668461163736,COGS 205,A00,101395,Chiba; Andrea,19,0,20,1
1668461164173,COGS 210B,001,101404,Greene; Deanna Jacquelyn,9998,0,9999,1
1668461164173,COGS 210B,002,101417,Xia; Haijun,9999,0,9999,0
1668461164173,COGS 210B,003,101422,Nitz; Douglas A.,9999,0,9999,0
1668461164173,COGS 210B,004,101423,Hollan; James D.,9998,0,9999,1
1668461164173,COGS 210B,005,101424,Deak; Gedeon O.,9998,0,9999,1
1668461164173,COGS 210B,006,101425,Rossano; Federico,9999,0,9999,0
1668461164602,COGS 211B,A00,101427,Coulson; Seana M,9996,0,9999,3
1668461165031,COGS 220,A00,101428,Hollan; James D.,1,8,25,24
1668461165459,COGS 229,A00,101429,Dow; Steven P,17,0,25,8
1668461165884,COGS 230,A00,101430,Klemmer; Scott R,8,0,17,9
1668461166313,COGS 234,A00,101431,Xia; Haijun,2,0,25,23
1668461166747,COGS 260,A00,101432,Kiyonaga; Anastasia,21,0,25,4
1668461166747,COGS 260,B00,101433,Kirsh; David Joel,15,0,25,10
1668461167173,CSE 202,A00,102371,Impagliazzo; Russell,0,56,0,0
1668461167598,CSE 203B,A01,102373,Cheng; Chung Kuan,0,44,0,0
1668461168020,CSE 208,A00,102374,Micciancio; Daniele,0,3,0,0
1668461168447,CSE 209A,A00,112895,Impagliazzo; Russell,0,11,15,15
1668461168873,CSE 209B,A00,108005,Bellare; Mihir,0,6,0,0
1668461169300,CSE 210,A00,113163,Coblenz; Michael J,0,70,0,0
1668461169730,CSE 219,A00,106111,Dow; Steven P,0,5,20,20
1668461170230,CSE 221,A00,102376,Voelker; Geoffrey M.,0,52,0,0
1668461170655,CSE 224,A01,102378,Porter; George M,0,141,0,0
1668461171081,CSE 229A,A00,102379,Savage; Stefan,0,9,0,0
1668461171509,CSE 229C,A00,102380,Munyaka; Imani N. S.,0,8,0,0
1668461171937,CSE 232B,A00,102382,Deutsch; Alin Bernard,0,27,0,0
1668461172361,CSE 234,A01,112904,Kumar; Arun Kumar,0,0,0,0
1668461172786,CSE 237A,A00,102383,Rosing; Tajana Simunic,0,44,0,0
1668461173210,CSE 239A,A00,102384,Deutsch; Alin Bernard,0,11,0,0
1668461173659,CSE 239B,A00,102385,Polikarpova; Nadezhda,0,9,0,0
1668461174085,CSE 240A,A00,102386,Pannuto; Patrick William,0,39,0,0
1668461174519,CSE 240B,A00,102387,Zhao; Jishen,0,37,0,0
1668461174958,CSE 241A,A00,106406,Kang; Mingu,0,6,0,0
1668461175386,CSE 249B,A00,102388,Kahng; Andrew Byun,0,3,8,8
1668461175812,CSE 251B,A01,102392,Cottrell; Garrison W,0,34,0,0
1668461175812,CSE 251B,A02,102393,Cottrell; Garrison W,0,30,0,0
1668461176237,CSE 252B,A00,102394,Ochoa; Benjamin Lawrence,0,46,0,0
1668461176686,CSE 257,A01,102396,Gao; Sicun,0,120,0,0
1668461177116,CSE 272,A00,102397,Li; Tzumao,0,14,0,0
1668461177542,CSE 274,A00,111323,Chern; Albert Ren-Haur,0,9,0,0
1668461177971,CSE 282,A00,102398,Pevzner; Pavel Arkadjevich,0,0,0,0
1668461178398,CSE 284,A00,114175,Gymrek; Melissa Ann,0,16,0,0
1668461178829,CSE 290,A00,102399,Chandraker; Manmohan Krishna,0,9,0,0
1668461178829,CSE 290,B00,102400,Vaccaro; Kristen Marie,0,5,25,25
1668461178829,CSE 290,C00,102414,Pannuto; Patrick William,0,1,25,25
1668461178829,CSE 290,D00,102427,Pevzner; Pavel Arkadjevich,0,0,0,0
1668461178829,CSE 290,E00,102429,Zhao; Jishen,0,4,0,0
1668461178829,CSE 290,F00,102436,Tullsen; Dean Michael,0,4,0,0
1668461178829,CSE 290,G00,102440,Christensen; Henrik I,0,5,20,20
1668461179261,CSE 291,A00,102443,Su; Hao,0,0,0,0
1668461179261,CSE 291,B00,102448,Polikarpova; Nadezhda,0,0,0,0
1668461179261,CSE 291,C00,102453,Vaccaro; Kristen Marie,0,0,0,0
1668461179261,CSE 291,D00,111343,Savage; Stefan,0,0,0,0
1668461179261,CSE 291,E00,116474,Claffy; Kimberly Claire,0,0,0,0
1668461179261,CSE 291,F00,116479,Pasquale; Joseph,0,0,0,0
1668461179715,CSE 293,001,119111,Bafna; Vineet,9999,0,9999,0
1668461179715,CSE 293,002,119118,Bellare; Mihir,9999,0,9999,0
1668461179715,CSE 293,003,119122,Berg-Kirkpatrick; Taylor D,9999,0,9999,0
1668461179715,CSE 293,004,119135,Christensen; Henrik I,9999,0,9999,0
1668461179715,CSE 293,005,119142,Cottrell; Garrison W,9999,0,9999,0
1668461179715,CSE 293,006,119146,Deutsch; Alin Bernard,9999,0,9999,0
1668461179715,CSE 293,007,119159,Esmaeilzadeh; Hadi,9999,0,9999,0
1668461179715,CSE 293,008,119166,Freund; Yoav,9999,0,9999,0
1668461179715,CSE 293,009,119170,Griswold; William G.,9999,0,9999,0
1668461179715,CSE 293,010,119183,Gymrek; Melissa Ann,9999,0,9999,0
1668461179715,CSE 293,011,119190,Heninger; Nadia A,9999,0,9999,0
1668461179715,CSE 293,012,119230,Impagliazzo; Russell,9999,0,9999,0
1668461179715,CSE 293,013,119232,Jhala; Ranjit,9999,0,9999,0
1668461179715,CSE 293,014,119233,Kahng; Andrew Byun,9999,0,9999,0
1668461179715,CSE 293,015,119298,Kane; Daniel Mertz,9999,0,9999,0
1668461179715,CSE 293,016,119299,Kriegman; David J,9999,0,9999,0
1668461179715,CSE 293,017,119300,Kumar; Arun Kumar,9999,0,9999,0
1668461179715,CSE 293,018,119301,Lerner; Sorin,9999,0,9999,0
1668461179715,CSE 293,019,119302,Lovett; Shachar,9999,0,9999,0
1668461179715,CSE 293,020,119303,McAuley; Julian John,9999,0,9999,0
1668461179715,CSE 293,021,119304,Micciancio; Daniele,9999,0,9999,0
1668461179715,CSE 293,022,119367,Orailoglu; Alex,9999,0,9999,0
1668461179715,CSE 293,023,119382,Paturi; Ramamohan,9999,0,9999,0
1668461179715,CSE 293,024,119404,Polikarpova; Nadezhda,9999,0,9999,0
1668461179715,CSE 293,025,119406,Politz; Joseph Gibbs,9999,0,9999,0
1668461179715,CSE 293,026,119411,Porter; George M,9999,0,9999,0
1668461179715,CSE 293,027,119414,Porter; Leonard Emerson,9999,0,9999,0
1668461179715,CSE 293,028,119416,Ramamoorthi; Ravi,9999,0,9999,0
1668461179715,CSE 293,029,119417,Sahoo; Debashis,9999,0,9999,0
1668461179715,CSE 293,030,119420,Saul; Lawrence,9999,0,9999,0
1668461179715,CSE 293,031,119421,Savage; Stefan,9999,0,9999,0
1668461179715,CSE 293,032,119425,Schulze; Jurgen P.,9999,0,9999,0
1668461179715,CSE 293,033,119426,Snoeren; Alex C.,9999,0,9999,0
1668461179715,CSE 293,034,119428,Shang; Jingbo,9999,0,9999,0
1668461179715,CSE 293,035,119430,Stefan; Deian,9999,0,9999,0
1668461179715,CSE 293,036,119431,Su; Hao,9999,0,9999,0
1668461179715,CSE 293,037,119433,Swanson; Steven James,9999,0,9999,0
1668461179715,CSE 293,038,119435,Tullsen; Dean Michael,9999,0,9999,0
1668461179715,CSE 293,039,119483,Voelker; Geoffrey M.,9999,0,9999,0
1668461179715,CSE 293,040,119537,Zhao; Jishen,9999,0,9999,0
1668461179715,CSE 293,041,119538,Zhou; Yuan-Yuan,9999,0,9999,0
1668461179715,CSE 293,042,119539,Gao; Sicun,9999,0,9999,0
1668461179715,CSE 293,043,119540,Weibel; Nadir,9999,0,9999,0
1668461179715,CSE 293,044,119541,Gupta; Rajesh K.,9999,0,9999,0
1668461179715,CSE 293,045,126410,Vaccaro; Kristen Marie,9999,0,9999,0
1668461179715,CSE 293,046,126411,Klemke; Richard,9999,0,9999,0
1668461180141,CSE 294,A00,102459,Voelker; Geoffrey M.,0,2,0,0
1668461180141,CSE 294,B00,111322,Orailoglu; Alex,0,1,0,0
1668461180568,DSE 201,A00,096914,Deutsch; Alin Bernard,30,0,30,0
1668461180999,DSE 210,A00,096915,Dasgupta; Sanjoy,30,0,30,0
1668461181423,DSE 260A,A00,096916,Altintas De Callaf; Ilkay,30,0,30,0
1668461181885,ECE 200,001,103586,Antipa; Nicholas A,9999,0,9999,0
1668461181885,ECE 200,002,103587,Atanasov; Nikolay A.,9999,0,9999,0
1668461181885,ECE 200,003,103588,Bharadia; Dinesh,9999,0,9999,0
1668461181885,ECE 200,004,103589,Cheng; Chung Kuan,9999,0,9999,0
1668461181885,ECE 200,005,103590,Cosman; Pamela C.,9999,0,9999,0
1668461181885,ECE 200,006,103591,Dayeh; Shadi Ahmad,9999,0,9999,0
1668461181885,ECE 200,007,103592,Fainman; Yeshaiahu,9999,0,9999,0
1668461181885,ECE 200,008,103593,Ford; Joseph Earl,9999,0,9999,0
1668461181885,ECE 200,009,103594,Franceschetti; Massimo,9999,0,9999,0
1668461181885,ECE 200,010,103595,Fullerton; Eric E,9999,0,9999,0
1668461181885,ECE 200,011,103596,Galton; Ian A,9999,0,9999,0
1668461181885,ECE 200,012,103597,Gilja; Vikash,9999,0,9999,0
1668461181885,ECE 200,013,103598,Hall; Drew A.,9999,0,9999,0
1668461181885,ECE 200,014,103599,Hsueh; Tzu-Chien,9999,0,9999,0
1668461181885,ECE 200,015,103600,Javidi; Tara,9999,0,9999,0
1668461181885,ECE 200,016,103601,Kahng; Andrew Byun,9999,0,9999,0
1668461181885,ECE 200,017,103602,Kim; Young-Han,9999,0,9999,0
1668461181885,ECE 200,018,103603,Koushanfar; Farinaz,9999,0,9999,0
1668461181885,ECE 200,019,103604,Kuzum; Duygu,9999,0,9999,0
1668461181885,ECE 200,020,103605,Le; Hanh-Phuc,9999,0,9999,0
1668461181885,ECE 200,021,103606,Lin; Bill,9999,0,9999,0
1668461181885,ECE 200,022,103607,Liu; Zhaowei,9998,0,9999,1
1668461181885,ECE 200,023,103608,Lo; Yu-Hwa,9999,0,9999,0
1668461181885,ECE 200,024,103609,Lomakin; Vitaliy,9999,0,9999,0
1668461181885,ECE 200,025,103610,Mercier; Patrick Philip,9999,0,9999,0
1668461181885,ECE 200,026,103611,Meyer; Florian,9999,0,9999,0
1668461181885,ECE 200,027,103612,Milstein; Laurence B.,9999,0,9999,0
1668461181885,ECE 200,028,103613,Mir Arabbaygi; Siavash,9999,0,9999,0
1668461181885,ECE 200,029,103614,Mookherjea; Shayan,9999,0,9999,0
1668461181885,ECE 200,030,103615,Morris; Karcher William,9999,0,9999,0
1668461181885,ECE 200,031,103616,Ng; Tse Nga,9999,0,9999,0
1668461181885,ECE 200,032,103617,Nguyen; Truong Quang,9999,0,9999,0
1668461181885,ECE 200,033,103618,Nomura; Kenji,9999,0,9999,0
1668461181885,ECE 200,034,103619,Orlitsky; Alon,9999,0,9999,0
1668461181885,ECE 200,035,103620,Pal; Piya,9999,0,9999,0
1668461181885,ECE 200,036,103621,Papen; George C.,9999,0,9999,0
1668461181885,ECE 200,037,103622,Radic; Stojan,9999,0,9999,0
1668461181885,ECE 200,038,103623,Rao; Bhaskar D.,9999,0,9999,0
1668461181885,ECE 200,039,103624,Rao; Ramesh R,9999,0,9999,0
1668461181885,ECE 200,040,103625,Rebeiz; Gabriel,9999,0,9999,0
1668461181885,ECE 200,041,103626,Sanford; John R,9999,0,9999,0
1668461181885,ECE 200,042,103627,Siegel; Paul H.,9999,0,9999,0
1668461181885,ECE 200,043,103628,Sievenpiper; Daniel F.,9999,0,9999,0
1668461181885,ECE 200,044,103629,Sworder; David D.,9999,0,9999,0
1668461181885,ECE 200,045,103630,Taur; Yuan,9999,0,9999,0
1668461181885,ECE 200,046,103631,Touri; Behrouz,9999,0,9999,0
1668461181885,ECE 200,047,103632,Trivedi; Mohan M.,9999,0,9999,0
1668461181885,ECE 200,048,103633,Vasconcelos; Nuno,9999,0,9999,0
1668461181885,ECE 200,049,103634,Wang; Xiaolong,9999,0,9999,0
1668461181885,ECE 200,050,103635,Xie; Pengtao,9999,0,9999,0
1668461181885,ECE 200,051,103636,Yip; Michael,9999,0,9999,0
1668461181885,ECE 200,052,103637,Zeger; Kenneth A.,999,0,999,0
1668461181885,ECE 200,053,103638,Zhang; Xinyu,9999,0,9999,0
1668461181885,ECE 200,054,103639,Turakhia; Yatish Girish,9999,0,9999,0
1668461181885,ECE 200,055,103640,Kang; Mingu,9999,0,9999,0
1668461181885,ECE 200,056,103641,Shi; Yuanyuan,9999,0,9999,0
1668461181885,ECE 200,057,103642,Wang; Edward Jay,9999,0,9999,0
1668461181885,ECE 200,058,103643,Zheng; Yang,9999,0,9999,0
1668461182310,ECE 202,A00,103644,Kuzum; Duygu,0,37,0,0
1668461182737,ECE 212BN,A00,103646,Ng; Tse Nga,0,4,0,0
1668461183166,ECE 221,A00,111493,Staff,0,0,0,0
1668461183590,ECE 222B,A00,103647,Lomakin; Vitaliy,0,10,0,0
1668461184019,ECE 230B,A00,103648,Taur; Yuan,0,2,0,0
1668461184445,ECE 238B,A00,103649,Garay; Javier,0,0,0,0
1668461184873,ECE 240B,A00,112900,Fainman; Yeshaiahu,0,4,0,0
1668461185312,ECE 247A,A00,103650,Jokerst; Jesse Vincent,0,3,0,0
1668461185748,ECE 247B,A00,103651,Wang; Joseph,0,9,0,0
1668461186177,ECE 250,A00,103652,Siegel; Paul H.,0,63,0,0
1668461186605,ECE 251A,A00,103654,Rao; Bhaskar D.,0,47,0,0
1668461187044,ECE 257B,A00,103655,Bharadia; Dinesh,0,26,0,0
1668461187473,ECE 258A,A00,103656,Milstein; Laurence B.,0,24,0,0
1668461187901,ECE 260B,A00,103658,Kang; Mingu,0,106,0,0
1668461188323,ECE 264A,A00,103659,Galton; Ian A,0,60,0,0
1668461188769,ECE 265A,A00,103661,Gudem; Prasad S.S.,0,38,0,0
1668461189195,ECE 265D,A00,103662,Gudem; Prasad S.S.,0,20,0,0
1668461189622,ECE 268,A00,103663,Koushanfar; Farinaz,0,36,0,0
1668461190046,ECE 269,A01,103665,Pal; Piya,0,174,0,0
1668461190487,ECE 271B,A00,103666,Vasconcelos; Manuela,0,60,0,0
1668461190913,ECE 276A,A00,103667,Atanasov; Nikolay A.,0,94,0,0
1668461191343,ECE 277,A00,103668,An; Cheolhong,0,126,0,0
1668461191769,ECE 279,A00,117947,Hall; Drew A.,0,18,0,0
1668461192619,ECE 283,A00,103670,Hsueh; Tzu-Chien,0,44,0,0
1668461193048,ECE 284,A00,103671,Turakhia; Yatish Girish,0,35,0,0
1668461193485,ECE 285,A00,103672,Zheng; Yang,0,31,0,0
1668461193485,ECE 285,B00,103673,Sworder; David D.,0,46,0,0
1668461193922,ECE 287,A00,103676,Javidi; Tara,0,6,0,0
1668461194360,MATH 200B,A00,098023,Salehi Golsefidy; Alireza,12,0,15,3
1668461194789,MATH 202B,A00,098024,Rhoades; Brendon Patrick,9,0,15,6
1668461195220,MATH 203B,A00,098025,Oprea; Dragos N.,10,0,15,5
1668461195662,MATH 204B,A00,098026,Sorensen; Claus M,13,0,15,2
1668461196085,MATH 208,A00,098027,Izadi; Elham,7,0,10,3
1668461196517,MATH 209,A00,098028,Pollack; Aaron,10,0,10,0
1668461196941,MATH 211A,A00,112919,Rogalski; Daniel,9,0,10,1
1668461197365,MATH 211B,A00,112920,Seward; Brandon M.,9,0,10,1
1668461197798,MATH 218,A00,098029,Li; Bo,10,0,10,0
1668461198222,MATH 220B,A00,098030,Novak; Jonathan I,11,0,15,4
1668461198657,MATH 221A,A00,098031,Ebenfelt; Peter F,13,0,15,2
1668461199081,MATH 231B,A00,098032,Zlatos; Andrej,11,0,15,4
1668461199521,MATH 240B,A00,098033,Ni; Lei,9,0,15,6
1668461199953,MATH 243,A00,098034,Jekel; David Andrew,10,0,10,0
1668461200383,MATH 245A,A00,098035,Nie; Jiawang,0,2,15,16
1668461200810,MATH 248,A00,098036,Bejenaru; Ioan,10,0,10,0
1668461201241,MATH 250B,A00,098037,Spolaor; Luca,14,0,15,1
1668461201668,MATH 258,A00,098038,Ni; Lei,10,0,10,0
1668461202092,MATH 264B,A00,098041,Rhoades; Brendon Patrick,9,0,15,6
1668461202523,MATH 268,A00,098042,Buss; Samuel R,10,0,10,0
1668461202960,MATH 269,A00,098043,Rhoades; Brendon Patrick,10,0,10,0
1668461203387,MATH 270B,A00,098044,Li; Bo,10,0,15,5
1668461203815,MATH 272B,A00,098045,Holst; Michael J,13,0,15,2
1668461204239,MATH 273A,A00,098046,Tian; Xiaochuan,10,0,15,5
1668461204667,MATH 275,A01,098048,Tian; Xiaochuan,6,0,10,4
1668461205097,MATH 278A,A00,098049,Holst; Michael J,8,0,10,2
1668461205519,MATH 278B,A00,098050,Cloninger; Alexander,10,0,10,0
1668461205956,MATH 278C,A00,098051,Nie; Jiawang,6,0,10,4
1668461206391,MATH 280B,A00,098052,Zheng; Tianyi,7,0,15,8
1668461206820,MATH 281B,A00,098053,Bradic; Jelena,0,2,15,15
1668461207243,MATH 282B,A00,098054,Arias-Castro; Ery,0,0,15,15
1668461207672,MATH 285,A00,098055,Fitzsimmons; Patrick J,0,1,15,17
1668461208097,MATH 287B,A00,098056,Arias-Castro; Ery,2,0,15,13
1668461208523,MATH 288,A00,098057,Agarwal; Pooja,9,0,10,1
1668461208523,MATH 288,B00,098058,Zhang; Danna,8,0,10,2
1668461208523,MATH 288,C00,098059,Williams; Ruth J,9,0,10,1
1668461208956,MATH 290B,A00,098060,Roberts; Justin Deritter,13,0,15,2
1668461209379,MATH 292,A00,098061,Belmont; Eva Kinoshita,10,0,10,0
1668461209802,MATH 295,A00,098062,Suk; Andrew Hoon,48,0,50,2
1668461210226,MATH 296,A00,098063,Novak; Jonathan I,20,0,20,0
1668461210655,MATH 297,001,098064,Gamst; Anthony Collins,9997,0,9999,2
1668461713897,COGS 205,A00,101395,Chiba; Andrea,19,0,20,1
1668461714321,COGS 210B,001,101404,Greene; Deanna Jacquelyn,9998,0,9999,1
1668461714321,COGS 210B,002,101417,Xia; Haijun,9999,0,9999,0
1668461714321,COGS 210B,003,101422,Nitz; Douglas A.,9999,0,9999,0
1668461714321,COGS 210B,004,101423,Hollan; James D.,9998,0,9999,1
1668461714321,COGS 210B,005,101424,Deak; Gedeon O.,9998,0,9999,1
1668461714321,COGS 210B,006,101425,Rossano; Federico,9999,0,9999,0
1668461714744,COGS 211B,A00,101427,Coulson; Seana M,9996,0,9999,3
1668461715166,COGS 220,A00,101428,Hollan; James D.,1,8,25,24
1668461715593,COGS 229,A00,101429,Dow; Steven P,17,0,25,8
1668461716036,COGS 230,A00,101430,Klemmer; Scott R,8,0,17,9
1668461716471,COGS 234,A00,101431,Xia; Haijun,2,0,25,23
1668461716899,COGS 260,A00,101432,Kiyonaga; Anastasia,21,0,25,4
1668461716899,COGS 260,B00,101433,Kirsh; David Joel,15,0,25,10
1668461717322,CSE 202,A00,102371,Impagliazzo; Russell,0,56,0,0
1668461717747,CSE 203B,A01,102373,Cheng; Chung Kuan,0,45,0,0
1668461718182,CSE 208,A00,102374,Micciancio; Daniele,0,3,0,0
1668461718607,CSE 209A,A00,112895,Impagliazzo; Russell,0,11,15,15
1668461719031,CSE 209B,A00,108005,Bellare; Mihir,0,6,0,0
1668461719454,CSE 210,A00,113163,Coblenz; Michael J,0,71,0,0
1668461719877,CSE 219,A00,106111,Dow; Steven P,0,5,20,20
1668461720300,CSE 221,A00,102376,Voelker; Geoffrey M.,0,55,0,0
1668461720724,CSE 224,A01,102378,Porter; George M,0,141,0,0
1668461721153,CSE 229A,A00,102379,Savage; Stefan,0,9,0,0
1668461721589,CSE 229C,A00,102380,Munyaka; Imani N. S.,0,8,0,0
1668461722017,CSE 232B,A00,102382,Deutsch; Alin Bernard,0,27,0,0
1668461722443,CSE 234,A01,112904,Kumar; Arun Kumar,0,0,0,0
1668461722875,CSE 237A,A00,102383,Rosing; Tajana Simunic,0,44,0,0
1668461723309,CSE 239A,A00,102384,Deutsch; Alin Bernard,0,11,0,0
1668461723736,CSE 239B,A00,102385,Polikarpova; Nadezhda,0,9,0,0
1668461724159,CSE 240A,A00,102386,Pannuto; Patrick William,0,40,0,0
1668461724582,CSE 240B,A00,102387,Zhao; Jishen,0,37,0,0
1668461725006,CSE 241A,A00,106406,Kang; Mingu,0,6,0,0
1668461725440,CSE 249B,A00,102388,Kahng; Andrew Byun,0,3,8,8
1668461725867,CSE 251B,A01,102392,Cottrell; Garrison W,0,34,0,0
1668461725867,CSE 251B,A02,102393,Cottrell; Garrison W,0,30,0,0
1668461726291,CSE 252B,A00,102394,Ochoa; Benjamin Lawrence,0,47,0,0
1668461726715,CSE 257,A01,102396,Gao; Sicun,0,123,0,0
1668461727153,CSE 272,A00,102397,Li; Tzumao,0,14,0,0
1668461727587,CSE 274,A00,111323,Chern; Albert Ren-Haur,0,9,0,0
1668461728017,CSE 282,A00,102398,Pevzner; Pavel Arkadjevich,0,0,0,0
1668461728462,CSE 284,A00,114175,Gymrek; Melissa Ann,0,16,0,0
1668461728885,CSE 290,A00,102399,Chandraker; Manmohan Krishna,0,9,0,0
1668461728885,CSE 290,B00,102400,Vaccaro; Kristen Marie,0,5,25,25
1668461728885,CSE 290,C00,102414,Pannuto; Patrick William,0,1,25,25
1668461728885,CSE 290,D00,102427,Pevzner; Pavel Arkadjevich,0,0,0,0
1668461728885,CSE 290,E00,102429,Zhao; Jishen,0,4,0,0
1668461728885,CSE 290,F00,102436,Tullsen; Dean Michael,0,4,0,0
1668461728885,CSE 290,G00,102440,Christensen; Henrik I,0,5,20,20
1668461729317,CSE 291,A00,102443,Su; Hao,0,0,0,0
1668461729317,CSE 291,B00,102448,Polikarpova; Nadezhda,0,0,0,0
1668461729317,CSE 291,C00,102453,Vaccaro; Kristen Marie,0,0,0,0
1668461729317,CSE 291,D00,111343,Savage; Stefan,0,0,0,0
1668461729317,CSE 291,E00,116474,Claffy; Kimberly Claire,0,0,0,0
1668461729317,CSE 291,F00,116479,Pasquale; Joseph,0,0,0,0
1668461729752,CSE 293,001,119111,Bafna; Vineet,9999,0,9999,0
1668461729752,CSE 293,002,119118,Bellare; Mihir,9999,0,9999,0
1668461729752,CSE 293,003,119122,Berg-Kirkpatrick; Taylor D,9999,0,9999,0
1668461729752,CSE 293,004,119135,Christensen; Henrik I,9999,0,9999,0
1668461729752,CSE 293,005,119142,Cottrell; Garrison W,9999,0,9999,0
1668461729752,CSE 293,006,119146,Deutsch; Alin Bernard,9999,0,9999,0
1668461729752,CSE 293,007,119159,Esmaeilzadeh; Hadi,9999,0,9999,0
1668461729752,CSE 293,008,119166,Freund; Yoav,9999,0,9999,0
1668461729752,CSE 293,009,119170,Griswold; William G.,9999,0,9999,0
1668461729752,CSE 293,010,119183,Gymrek; Melissa Ann,9999,0,9999,0
1668461729752,CSE 293,011,119190,Heninger; Nadia A,9999,0,9999,0
1668461729752,CSE 293,012,119230,Impagliazzo; Russell,9999,0,9999,0
1668461729752,CSE 293,013,119232,Jhala; Ranjit,9999,0,9999,0
1668461729752,CSE 293,014,119233,Kahng; Andrew Byun,9999,0,9999,0
1668461729752,CSE 293,015,119298,Kane; Daniel Mertz,9999,0,9999,0
1668461729752,CSE 293,016,119299,Kriegman; David J,9999,0,9999,0
1668461729752,CSE 293,017,119300,Kumar; Arun Kumar,9999,0,9999,0
1668461729752,CSE 293,018,119301,Lerner; Sorin,9999,0,9999,0
1668461729752,CSE 293,019,119302,Lovett; Shachar,9999,0,9999,0
1668461729752,CSE 293,020,119303,McAuley; Julian John,9999,0,9999,0
1668461729752,CSE 293,021,119304,Micciancio; Daniele,9999,0,9999,0
1668461729752,CSE 293,022,119367,Orailoglu; Alex,9999,0,9999,0
1668461729752,CSE 293,023,119382,Paturi; Ramamohan,9999,0,9999,0
1668461729752,CSE 293,024,119404,Polikarpova; Nadezhda,9999,0,9999,0
1668461729752,CSE 293,025,119406,Politz; Joseph Gibbs,9999,0,9999,0
1668461729752,CSE 293,026,119411,Porter; George M,9999,0,9999,0
1668461729752,CSE 293,027,119414,Porter; Leonard Emerson,9999,0,9999,0
1668461729752,CSE 293,028,119416,Ramamoorthi; Ravi,9999,0,9999,0
1668461729752,CSE 293,029,119417,Sahoo; Debashis,9999,0,9999,0
1668461729752,CSE 293,030,119420,Saul; Lawrence,9999,0,9999,0
1668461729752,CSE 293,031,119421,Savage; Stefan,9999,0,9999,0
1668461729752,CSE 293,032,119425,Schulze; Jurgen P.,9999,0,9999,0
1668461729752,CSE 293,033,119426,Snoeren; Alex C.,9999,0,9999,0
1668461729752,CSE 293,034,119428,Shang; Jingbo,9999,0,9999,0
1668461729752,CSE 293,035,119430,Stefan; Deian,9999,0,9999,0
1668461729752,CSE 293,036,119431,Su; Hao,9999,0,9999,0
1668461729752,CSE 293,037,119433,Swanson; Steven James,9999,0,9999,0
1668461729752,CSE 293,038,119435,Tullsen; Dean Michael,9999,0,9999,0
1668461729752,CSE 293,039,119483,Voelker; Geoffrey M.,9999,0,9999,0
1668461729752,CSE 293,040,119537,Zhao; Jishen,9999,0,9999,0
1668461729752,CSE 293,041,119538,Zhou; Yuan-Yuan,9999,0,9999,0
1668461729752,CSE 293,042,119539,Gao; Sicun,9999,0,9999,0
1668461729752,CSE 293,043,119540,Weibel; Nadir,9999,0,9999,0
1668461729752,CSE 293,044,119541,Gupta; Rajesh K.,9999,0,9999,0
1668461729752,CSE 293,045,126410,Vaccaro; Kristen Marie,9999,0,9999,0
1668461729752,CSE 293,046,126411,Klemke; Richard,9999,0,9999,0
1668461730178,CSE 294,A00,102459,Voelker; Geoffrey M.,0,2,0,0
1668461730178,CSE 294,B00,111322,Orailoglu; Alex,0,1,0,0
1668461730603,DSE 201,A00,096914,Deutsch; Alin Bernard,30,0,30,0
1668461731038,DSE 210,A00,096915,Dasgupta; Sanjoy,30,0,30,0
1668461731489,DSE 260A,A00,096916,Altintas De Callaf; Ilkay,30,0,30,0
1668461731919,ECE 200,001,103586,Antipa; Nicholas A,9999,0,9999,0
1668461731919,ECE 200,002,103587,Atanasov; Nikolay A.,9999,0,9999,0
1668461731919,ECE 200,003,103588,Bharadia; Dinesh,9999,0,9999,0
1668461731919,ECE 200,004,103589,Cheng; Chung Kuan,9999,0,9999,0
1668461731919,ECE 200,005,103590,Cosman; Pamela C.,9999,0,9999,0
1668461731919,ECE 200,006,103591,Dayeh; Shadi Ahmad,9999,0,9999,0
1668461731919,ECE 200,007,103592,Fainman; Yeshaiahu,9999,0,9999,0
1668461731919,ECE 200,008,103593,Ford; Joseph Earl,9999,0,9999,0
1668461731919,ECE 200,009,103594,Franceschetti; Massimo,9999,0,9999,0
1668461731919,ECE 200,010,103595,Fullerton; Eric E,9999,0,9999,0
1668461731919,ECE 200,011,103596,Galton; Ian A,9999,0,9999,0
1668461731919,ECE 200,012,103597,Gilja; Vikash,9999,0,9999,0
1668461731919,ECE 200,013,103598,Hall; Drew A.,9999,0,9999,0
1668461731919,ECE 200,014,103599,Hsueh; Tzu-Chien,9999,0,9999,0
1668461731919,ECE 200,015,103600,Javidi; Tara,9999,0,9999,0
1668461731919,ECE 200,016,103601,Kahng; Andrew Byun,9999,0,9999,0
1668461731919,ECE 200,017,103602,Kim; Young-Han,9999,0,9999,0
1668461731919,ECE 200,018,103603,Koushanfar; Farinaz,9999,0,9999,0
1668461731919,ECE 200,019,103604,Kuzum; Duygu,9999,0,9999,0
1668461731919,ECE 200,020,103605,Le; Hanh-Phuc,9999,0,9999,0
1668461731919,ECE 200,021,103606,Lin; Bill,9999,0,9999,0
1668461731919,ECE 200,022,103607,Liu; Zhaowei,9998,0,9999,1
1668461731919,ECE 200,023,103608,Lo; Yu-Hwa,9999,0,9999,0
1668461731919,ECE 200,024,103609,Lomakin; Vitaliy,9999,0,9999,0
1668461731919,ECE 200,025,103610,Mercier; Patrick Philip,9999,0,9999,0
1668461731919,ECE 200,026,103611,Meyer; Florian,9999,0,9999,0
1668461731919,ECE 200,027,103612,Milstein; Laurence B.,9999,0,9999,0
1668461731919,ECE 200,028,103613,Mir Arabbaygi; Siavash,9999,0,9999,0
1668461731919,ECE 200,029,103614,Mookherjea; Shayan,9999,0,9999,0
1668461731919,ECE 200,030,103615,Morris; Karcher William,9999,0,9999,0
1668461731919,ECE 200,031,103616,Ng; Tse Nga,9999,0,9999,0
1668461731919,ECE 200,032,103617,Nguyen; Truong Quang,9999,0,9999,0
1668461731919,ECE 200,033,103618,Nomura; Kenji,9999,0,9999,0
1668461731919,ECE 200,034,103619,Orlitsky; Alon,9999,0,9999,0
1668461731919,ECE 200,035,103620,Pal; Piya,9999,0,9999,0
1668461731919,ECE 200,036,103621,Papen; George C.,9999,0,9999,0
1668461731919,ECE 200,037,103622,Radic; Stojan,9999,0,9999,0
1668461731919,ECE 200,038,103623,Rao; Bhaskar D.,9999,0,9999,0
1668461731919,ECE 200,039,103624,Rao; Ramesh R,9999,0,9999,0
1668461731919,ECE 200,040,103625,Rebeiz; Gabriel,9999,0,9999,0
1668461731919,ECE 200,041,103626,Sanford; John R,9999,0,9999,0
1668461731919,ECE 200,042,103627,Siegel; Paul H.,9999,0,9999,0
1668461731919,ECE 200,043,103628,Sievenpiper; Daniel F.,9999,0,9999,0
1668461731919,ECE 200,044,103629,Sworder; David D.,9999,0,9999,0
1668461731919,ECE 200,045,103630,Taur; Yuan,9999,0,9999,0
1668461731919,ECE 200,046,103631,Touri; Behrouz,9999,0,9999,0
1668461731919,ECE 200,047,103632,Trivedi; Mohan M.,9999,0,9999,0
1668461731919,ECE 200,048,103633,Vasconcelos; Nuno,9999,0,9999,0
1668461731919,ECE 200,049,103634,Wang; Xiaolong,9999,0,9999,0
1668461731919,ECE 200,050,103635,Xie; Pengtao,9999,0,9999,0
1668461731919,ECE 200,051,103636,Yip; Michael,9999,0,9999,0
1668461731919,ECE 200,052,103637,Zeger; Kenneth A.,999,0,999,0
1668461731919,ECE 200,053,103638,Zhang; Xinyu,9999,0,9999,0
1668461731919,ECE 200,054,103639,Turakhia; Yatish Girish,9999,0,9999,0
1668461731919,ECE 200,055,103640,Kang; Mingu,9999,0,9999,0
1668461731919,ECE 200,056,103641,Shi; Yuanyuan,9999,0,9999,0
1668461731919,ECE 200,057,103642,Wang; Edward Jay,9999,0,9999,0
1668461731919,ECE 200,058,103643,Zheng; Yang,9999,0,9999,0
1668461732343,ECE 202,A00,103644,Kuzum; Duygu,0,37,0,0
1668461732773,ECE 212BN,A00,103646,Ng; Tse Nga,0,4,0,0
1668461733201,ECE 221,A00,111493,Staff,0,0,0,0
1668461733633,ECE 222B,A00,103647,Lomakin; Vitaliy,0,11,0,0
1668461734083,ECE 230B,A00,103648,Taur; Yuan,0,2,0,0
1668461734510,ECE 238B,A00,103649,Garay; Javier,0,0,0,0
1668461734941,ECE 240B,A00,112900,Fainman; Yeshaiahu,0,4,0,0
1668461735375,ECE 247A,A00,103650,Jokerst; Jesse Vincent,0,3,0,0
1668461735799,ECE 247B,A00,103651,Wang; Joseph,0,9,0,0
1668461736321,ECE 250,A00,103652,Siegel; Paul H.,0,64,0,0
1668461736745,ECE 251A,A00,103654,Rao; Bhaskar D.,0,47,0,0
1668461737183,ECE 257B,A00,103655,Bharadia; Dinesh,0,26,0,0
1668461737613,ECE 258A,A00,103656,Milstein; Laurence B.,0,24,0,0
1668461738046,ECE 260B,A00,103658,Kang; Mingu,0,107,0,0
1668461738478,ECE 264A,A00,103659,Galton; Ian A,0,60,0,0
1668461738906,ECE 265A,A00,103661,Gudem; Prasad S.S.,0,38,0,0
1668461739345,ECE 265D,A00,103662,Gudem; Prasad S.S.,0,20,0,0
1668461739771,ECE 268,A00,103663,Koushanfar; Farinaz,0,36,0,0
1668461740216,ECE 269,A01,103665,Pal; Piya,0,174,0,0
1668461740764,ECE 271B,A00,103666,Vasconcelos; Manuela,0,60,0,0
1668461741189,ECE 276A,A00,103667,Atanasov; Nikolay A.,0,94,0,0
1668461741622,ECE 277,A00,103668,An; Cheolhong,0,126,0,0
1668461742055,ECE 279,A00,117947,Hall; Drew A.,0,18,0,0
1668461742921,ECE 283,A00,103670,Hsueh; Tzu-Chien,0,44,0,0
1668461743347,ECE 284,A00,103671,Turakhia; Yatish Girish,0,35,0,0
1668461743785,ECE 285,A00,103672,Zheng; Yang,0,31,0,0
1668461743785,ECE 285,B00,103673,Sworder; David D.,0,47,0,0
1668461744227,ECE 287,A00,103676,Javidi; Tara,0,6,0,0
1668461744657,MATH 200B,A00,098023,Salehi Golsefidy; Alireza,12,0,15,3
1668461745091,MATH 202B,A00,098024,Rhoades; Brendon Patrick,9,0,15,6
1668461745516,MATH 203B,A00,098025,Oprea; Dragos N.,10,0,15,5
1668461745941,MATH 204B,A00,098026,Sorensen; Claus M,13,0,15,2
1668461746364,MATH 208,A00,098027,Izadi; Elham,7,0,10,3
1668461746798,MATH 209,A00,098028,Pollack; Aaron,10,0,10,0
1668461747220,MATH 211A,A00,112919,Rogalski; Daniel,9,0,10,1
1668461747653,MATH 211B,A00,112920,Seward; Brandon M.,9,0,10,1
1668461748077,MATH 218,A00,098029,Li; Bo,10,0,10,0
1668461748499,MATH 220B,A00,098030,Novak; Jonathan I,11,0,15,4
1668461748930,MATH 221A,A00,098031,Ebenfelt; Peter F,13,0,15,2
1668461749354,MATH 231B,A00,098032,Zlatos; Andrej,11,0,15,4
1668461749782,MATH 240B,A00,098033,Ni; Lei,9,0,15,6
1668461750211,MATH 243,A00,098034,Jekel; David Andrew,10,0,10,0
1668461750668,MATH 245A,A00,098035,Nie; Jiawang,0,2,15,16
1668461751093,MATH 248,A00,098036,Bejenaru; Ioan,10,0,10,0
1668461751516,MATH 250B,A00,098037,Spolaor; Luca,14,0,15,1
1668461751952,MATH 258,A00,098038,Ni; Lei,10,0,10,0
1668461752390,MATH 264B,A00,098041,Rhoades; Brendon Patrick,9,0,15,6
1668461752815,MATH 268,A00,098042,Buss; Samuel R,10,0,10,0
1668461753244,MATH 269,A00,098043,Rhoades; Brendon Patrick,10,0,10,0
1668461753668,MATH 270B,A00,098044,Li; Bo,10,0,15,5
1668461754091,MATH 272B,A00,098045,Holst; Michael J,13,0,15,2
1668461754518,MATH 273A,A00,098046,Tian; Xiaochuan,10,0,15,5
1668461754940,MATH 275,A01,098048,Tian; Xiaochuan,6,0,10,4
1668461755374,MATH 278A,A00,098049,Holst; Michael J,8,0,10,2
1668461755799,MATH 278B,A00,098050,Cloninger; Alexander,10,0,10,0
1668461756241,MATH 278C,A00,098051,Nie; Jiawang,6,0,10,4
1668461756671,MATH 280B,A00,098052,Zheng; Tianyi,7,0,15,8
1668461757102,MATH 281B,A00,098053,Bradic; Jelena,0,2,15,15
1668461757530,MATH 282B,A00,098054,Arias-Castro; Ery,0,0,15,15
1668461757954,MATH 285,A00,098055,Fitzsimmons; Patrick J,0,1,15,17
1668461758378,MATH 287B,A00,098056,Arias-Castro; Ery,2,0,15,13
1668461758812,MATH 288,A00,098057,Agarwal; Pooja,9,0,10,1
1668461758812,MATH 288,B00,098058,Zhang; Danna,8,0,10,2
1668461758812,MATH 288,C00,098059,Williams; Ruth J,9,0,10,1
1668461759239,MATH 290B,A00,098060,Roberts; Justin Deritter,13,0,15,2
1668461759671,MATH 292,A00,098061,Belmont; Eva Kinoshita,10,0,10,0
1668461760102,MATH 295,A00,098062,Suk; Andrew Hoon,48,0,50,2
1668461760534,MATH 296,A00,098063,Novak; Jonathan I,20,0,20,0
1668461760970,MATH 297,001,098064,Gamst; Anthony Collins,9997,0,9999,2
1668462265767,COGS 205,A00,101395,Chiba; Andrea,19,0,20,1
1668462266191,COGS 210B,001,101404,Greene; Deanna Jacquelyn,9998,0,9999,1
1668462266191,COGS 210B,002,101417,Xia; Haijun,9999,0,9999,0
1668462266191,COGS 210B,003,101422,Nitz; Douglas A.,9999,0,9999,0
1668462266191,COGS 210B,004,101423,Hollan; James D.,9998,0,9999,1
1668462266191,COGS 210B,005,101424,Deak; Gedeon O.,9998,0,9999,1
1668462266191,COGS 210B,006,101425,Rossano; Federico,9999,0,9999,0
1668462266616,COGS 211B,A00,101427,Coulson; Seana M,9996,0,9999,3
1668462267041,COGS 220,A00,101428,Hollan; James D.,1,8,25,24
1668462267472,COGS 229,A00,101429,Dow; Steven P,17,0,25,8
1668462267914,COGS 230,A00,101430,Klemmer; Scott R,8,0,17,9
1668462268363,COGS 234,A00,101431,Xia; Haijun,2,0,25,23
1668462268794,COGS 260,A00,101432,Kiyonaga; Anastasia,21,0,25,4
1668462268794,COGS 260,B00,101433,Kirsh; David Joel,15,0,25,10
1668462269232,CSE 202,A00,102371,Impagliazzo; Russell,0,56,0,0
1668462269655,CSE 203B,A01,102373,Cheng; Chung Kuan,0,46,0,0
1668462270085,CSE 208,A00,102374,Micciancio; Daniele,0,3,0,0
1668462270519,CSE 209A,A00,112895,Impagliazzo; Russell,0,11,15,15
1668462270946,CSE 209B,A00,108005,Bellare; Mihir,0,6,0,0
1668462271388,CSE 210,A00,113163,Coblenz; Michael J,0,71,0,0
1668462271811,CSE 219,A00,106111,Dow; Steven P,0,5,20,20
1668462272238,CSE 221,A00,102376,Voelker; Geoffrey M.,0,56,0,0
1668462272669,CSE 224,A01,102378,Porter; George M,0,141,0,0
1668462273106,CSE 229A,A00,102379,Savage; Stefan,0,9,0,0
1668462273530,CSE 229C,A00,102380,Munyaka; Imani N. S.,0,8,0,0
1668462273954,CSE 232B,A00,102382,Deutsch; Alin Bernard,0,27,0,0
1668462274376,CSE 234,A01,112904,Kumar; Arun Kumar,0,0,0,0
1668462274803,CSE 237A,A00,102383,Rosing; Tajana Simunic,0,44,0,0
1668462275227,CSE 239A,A00,102384,Deutsch; Alin Bernard,0,11,0,0
1668462275650,CSE 239B,A00,102385,Polikarpova; Nadezhda,0,9,0,0
1668462276076,CSE 240A,A00,102386,Pannuto; Patrick William,0,40,0,0
1668462276504,CSE 240B,A00,102387,Zhao; Jishen,0,38,0,0
1668462276938,CSE 241A,A00,106406,Kang; Mingu,0,6,0,0
1668462277373,CSE 249B,A00,102388,Kahng; Andrew Byun,0,3,8,8
1668462277802,CSE 251B,A01,102392,Cottrell; Garrison W,0,34,0,0
1668462277802,CSE 251B,A02,102393,Cottrell; Garrison W,0,30,0,0
1668462278229,CSE 252B,A00,102394,Ochoa; Benjamin Lawrence,0,47,0,0
1668462278661,CSE 257,A01,102396,Gao; Sicun,0,124,0,0
1668462279089,CSE 272,A00,102397,Li; Tzumao,0,14,0,0
1668462279516,CSE 274,A00,111323,Chern; Albert Ren-Haur,0,9,0,0
1668462279940,CSE 282,A00,102398,Pevzner; Pavel Arkadjevich,0,0,0,0
1668462280368,CSE 284,A00,114175,Gymrek; Melissa Ann,0,16,0,0
1668462280801,CSE 290,A00,102399,Chandraker; Manmohan Krishna,0,9,0,0
1668462280801,CSE 290,B00,102400,Vaccaro; Kristen Marie,0,5,25,25
1668462280801,CSE 290,C00,102414,Pannuto; Patrick William,0,1,25,25
1668462280801,CSE 290,D00,102427,Pevzner; Pavel Arkadjevich,0,0,0,0
1668462280801,CSE 290,E00,102429,Zhao; Jishen,0,4,0,0
1668462280801,CSE 290,F00,102436,Tullsen; Dean Michael,0,4,0,0
1668462280801,CSE 290,G00,102440,Christensen; Henrik I,0,5,20,20
1668462281225,CSE 291,A00,102443,Su; Hao,0,0,0,0
1668462281225,CSE 291,B00,102448,Polikarpova; Nadezhda,0,0,0,0
1668462281225,CSE 291,C00,102453,Vaccaro; Kristen Marie,0,0,0,0
1668462281225,CSE 291,D00,111343,Savage; Stefan,0,0,0,0
1668462281225,CSE 291,E00,116474,Claffy; Kimberly Claire,0,0,0,0
1668462281225,CSE 291,F00,116479,Pasquale; Joseph,0,0,0,0
1668462281698,CSE 293,001,119111,Bafna; Vineet,9999,0,9999,0
1668462281698,CSE 293,002,119118,Bellare; Mihir,9999,0,9999,0
1668462281698,CSE 293,003,119122,Berg-Kirkpatrick; Taylor D,9999,0,9999,0
1668462281698,CSE 293,004,119135,Christensen; Henrik I,9999,0,9999,0
1668462281698,CSE 293,005,119142,Cottrell; Garrison W,9999,0,9999,0
1668462281698,CSE 293,006,119146,Deutsch; Alin Bernard,9999,0,9999,0
1668462281698,CSE 293,007,119159,Esmaeilzadeh; Hadi,9999,0,9999,0
1668462281698,CSE 293,008,119166,Freund; Yoav,9999,0,9999,0
1668462281698,CSE 293,009,119170,Griswold; William G.,9999,0,9999,0
1668462281698,CSE 293,010,119183,Gymrek; Melissa Ann,9999,0,9999,0
1668462281698,CSE 293,011,119190,Heninger; Nadia A,9999,0,9999,0
1668462281698,CSE 293,012,119230,Impagliazzo; Russell,9999,0,9999,0
1668462281698,CSE 293,013,119232,Jhala; Ranjit,9999,0,9999,0
1668462281698,CSE 293,014,119233,Kahng; Andrew Byun,9999,0,9999,0
1668462281698,CSE 293,015,119298,Kane; Daniel Mertz,9999,0,9999,0
1668462281698,CSE 293,016,119299,Kriegman; David J,9999,0,9999,0
1668462281698,CSE 293,017,119300,Kumar; Arun Kumar,9999,0,9999,0
1668462281698,CSE 293,018,119301,Lerner; Sorin,9999,0,9999,0
1668462281698,CSE 293,019,119302,Lovett; Shachar,9999,0,9999,0
1668462281698,CSE 293,020,119303,McAuley; Julian John,9999,0,9999,0
1668462281698,CSE 293,021,119304,Micciancio; Daniele,9999,0,9999,0
1668462281698,CSE 293,022,119367,Orailoglu; Alex,9999,0,9999,0
1668462281698,CSE 293,023,119382,Paturi; Ramamohan,9999,0,9999,0
1668462281698,CSE 293,024,119404,Polikarpova; Nadezhda,9999,0,9999,0
1668462281698,CSE 293,025,119406,Politz; Joseph Gibbs,9999,0,9999,0
1668462281698,CSE 293,026,119411,Porter; George M,9999,0,9999,0
1668462281698,CSE 293,027,119414,Porter; Leonard Emerson,9999,0,9999,0
1668462281698,CSE 293,028,119416,Ramamoorthi; Ravi,9999,0,9999,0
1668462281698,CSE 293,029,119417,Sahoo; Debashis,9999,0,9999,0
1668462281698,CSE 293,030,119420,Saul; Lawrence,9999,0,9999,0
1668462281698,CSE 293,031,119421,Savage; Stefan,9999,0,9999,0
1668462281698,CSE 293,032,119425,Schulze; Jurgen P.,9999,0,9999,0
1668462281698,CSE 293,033,119426,Snoeren; Alex C.,9999,0,9999,0
1668462281698,CSE 293,034,119428,Shang; Jingbo,9999,0,9999,0
1668462281698,CSE 293,035,119430,Stefan; Deian,9999,0,9999,0
1668462281698,CSE 293,036,119431,Su; Hao,9999,0,9999,0
1668462281698,CSE 293,037,119433,Swanson; Steven James,9999,0,9999,0
1668462281698,CSE 293,038,119435,Tullsen; Dean Michael,9999,0,9999,0
1668462281698,CSE 293,039,119483,Voelker; Geoffrey M.,9999,0,9999,0
1668462281698,CSE 293,040,119537,Zhao; Jishen,9999,0,9999,0
1668462281698,CSE 293,041,119538,Zhou; Yuan-Yuan,9999,0,9999,0
1668462281698,CSE 293,042,119539,Gao; Sicun,9999,0,9999,0
1668462281698,CSE 293,043,119540,Weibel; Nadir,9999,0,9999,0
1668462281698,CSE 293,044,119541,Gupta; Rajesh K.,9999,0,9999,0
1668462281698,CSE 293,045,126410,Vaccaro; Kristen Marie,9999,0,9999,0
1668462281698,CSE 293,046,126411,Klemke; Richard,9999,0,9999,0
1668462282124,CSE 294,A00,102459,Voelker; Geoffrey M.,0,2,0,0
1668462282124,CSE 294,B00,111322,Orailoglu; Alex,0,1,0,0
1668462282547,DSE 201,A00,096914,Deutsch; Alin Bernard,30,0,30,0
1668462282970,DSE 210,A00,096915,Dasgupta; Sanjoy,30,0,30,0
1668462283401,DSE 260A,A00,096916,Altintas De Callaf; Ilkay,30,0,30,0
1668462283836,ECE 200,001,103586,Antipa; Nicholas A,9999,0,9999,0
1668462283836,ECE 200,002,103587,Atanasov; Nikolay A.,9999,0,9999,0
1668462283836,ECE 200,003,103588,Bharadia; Dinesh,9999,0,9999,0
1668462283836,ECE 200,004,103589,Cheng; Chung Kuan,9999,0,9999,0
1668462283836,ECE 200,005,103590,Cosman; Pamela C.,9999,0,9999,0
1668462283836,ECE 200,006,103591,Dayeh; Shadi Ahmad,9999,0,9999,0
1668462283836,ECE 200,007,103592,Fainman; Yeshaiahu,9999,0,9999,0
1668462283836,ECE 200,008,103593,Ford; Joseph Earl,9999,0,9999,0
1668462283836,ECE 200,009,103594,Franceschetti; Massimo,9999,0,9999,0
1668462283836,ECE 200,010,103595,Fullerton; Eric E,9999,0,9999,0
1668462283836,ECE 200,011,103596,Galton; Ian A,9999,0,9999,0
1668462283836,ECE 200,012,103597,Gilja; Vikash,9999,0,9999,0
1668462283836,ECE 200,013,103598,Hall; Drew A.,9999,0,9999,0
1668462283836,ECE 200,014,103599,Hsueh; Tzu-Chien,9999,0,9999,0
1668462283836,ECE 200,015,103600,Javidi; Tara,9999,0,9999,0
1668462283836,ECE 200,016,103601,Kahng; Andrew Byun,9999,0,9999,0
1668462283836,ECE 200,017,103602,Kim; Young-Han,9999,0,9999,0
1668462283836,ECE 200,018,103603,Koushanfar; Farinaz,9999,0,9999,0
1668462283836,ECE 200,019,103604,Kuzum; Duygu,9999,0,9999,0
1668462283836,ECE 200,020,103605,Le; Hanh-Phuc,9999,0,9999,0
1668462283836,ECE 200,021,103606,Lin; Bill,9999,0,9999,0
1668462283836,ECE 200,022,103607,Liu; Zhaowei,9998,0,9999,1
1668462283836,ECE 200,023,103608,Lo; Yu-Hwa,9999,0,9999,0
1668462283836,ECE 200,024,103609,Lomakin; Vitaliy,9999,0,9999,0
1668462283836,ECE 200,025,103610,Mercier; Patrick Philip,9999,0,9999,0
1668462283836,ECE 200,026,103611,Meyer; Florian,9999,0,9999,0
1668462283836,ECE 200,027,103612,Milstein; Laurence B.,9999,0,9999,0
1668462283836,ECE 200,028,103613,Mir Arabbaygi; Siavash,9999,0,9999,0
1668462283836,ECE 200,029,103614,Mookherjea; Shayan,9999,0,9999,0
1668462283836,ECE 200,030,103615,Morris; Karcher William,9999,0,9999,0
1668462283836,ECE 200,031,103616,Ng; Tse Nga,9999,0,9999,0
1668462283836,ECE 200,032,103617,Nguyen; Truong Quang,9999,0,9999,0
1668462283836,ECE 200,033,103618,Nomura; Kenji,9999,0,9999,0
1668462283836,ECE 200,034,103619,Orlitsky; Alon,9999,0,9999,0
1668462283836,ECE 200,035,103620,Pal; Piya,9999,0,9999,0
1668462283836,ECE 200,036,103621,Papen; George C.,9999,0,9999,0
1668462283836,ECE 200,037,103622,Radic; Stojan,9999,0,9999,0
1668462283836,ECE 200,038,103623,Rao; Bhaskar D.,9999,0,9999,0
1668462283836,ECE 200,039,103624,Rao; Ramesh R,9999,0,9999,0
1668462283836,ECE 200,040,103625,Rebeiz; Gabriel,9999,0,9999,0
1668462283836,ECE 200,041,103626,Sanford; John R,9999,0,9999,0
1668462283836,ECE 200,042,103627,Siegel; Paul H.,9999,0,9999,0
1668462283836,ECE 200,043,103628,Sievenpiper; Daniel F.,9999,0,9999,0
1668462283836,ECE 200,044,103629,Sworder; David D.,9999,0,9999,0
1668462283836,ECE 200,045,103630,Taur; Yuan,9999,0,9999,0
1668462283836,ECE 200,046,103631,Touri; Behrouz,9999,0,9999,0
1668462283836,ECE 200,047,103632,Trivedi; Mohan M.,9999,0,9999,0
1668462283836,ECE 200,048,103633,Vasconcelos; Nuno,9999,0,9999,0
1668462283836,ECE 200,049,103634,Wang; Xiaolong,9999,0,9999,0
1668462283836,ECE 200,050,103635,Xie; Pengtao,9999,0,9999,0
1668462283836,ECE 200,051,103636,Yip; Michael,9999,0,9999,0
1668462283836,ECE 200,052,103637,Zeger; Kenneth A.,999,0,999,0
1668462283836,ECE 200,053,103638,Zhang; Xinyu,9999,0,9999,0
1668462283836,ECE 200,054,103639,Turakhia; Yatish Girish,9999,0,9999,0
1668462283836,ECE 200,055,103640,Kang; Mingu,9999,0,9999,0
1668462283836,ECE 200,056,103641,Shi; Yuanyuan,9999,0,9999,0
1668462283836,ECE 200,057,103642,Wang; Edward Jay,9999,0,9999,0
1668462283836,ECE 200,058,103643,Zheng; Yang,9999,0,9999,0
1668462284261,ECE 202,A00,103644,Kuzum; Duygu,0,37,0,0
1668462284686,ECE 212BN,A00,103646,Ng; Tse Nga,0,4,0,0
1668462285118,ECE 221,A00,111493,Staff,0,0,0,0
1668462285549,ECE 222B,A00,103647,Lomakin; Vitaliy,0,11,0,0
1668462285973,ECE 230B,A00,103648,Taur; Yuan,0,2,0,0
1668462286397,ECE 238B,A00,103649,Garay; Javier,0,0,0,0
1668462286847,ECE 240B,A00,112900,Fainman; Yeshaiahu,0,4,0,0
1668462287279,ECE 247A,A00,103650,Jokerst; Jesse Vincent,0,3,0,0
1668462287703,ECE 247B,A00,103651,Wang; Joseph,0,9,0,0
1668462288133,ECE 250,A00,103652,Siegel; Paul H.,0,65,0,0
1668462288557,ECE 251A,A00,103654,Rao; Bhaskar D.,0,48,0,0
1668462288983,ECE 257B,A00,103655,Bharadia; Dinesh,0,26,0,0
1668462289408,ECE 258A,A00,103656,Milstein; Laurence B.,0,24,0,0
1668462289831,ECE 260B,A00,103658,Kang; Mingu,0,107,0,0
1668462290253,ECE 264A,A00,103659,Galton; Ian A,0,60,0,0
1668462290677,ECE 265A,A00,103661,Gudem; Prasad S.S.,0,38,0,0
1668462291107,ECE 265D,A00,103662,Gudem; Prasad S.S.,0,20,0,0
1668462291534,ECE 268,A00,103663,Koushanfar; Farinaz,0,36,0,0
1668462291957,ECE 269,A01,103665,Pal; Piya,0,174,0,0
1668462292387,ECE 271B,A00,103666,Vasconcelos; Manuela,0,60,0,0
1668462292834,ECE 276A,A00,103667,Atanasov; Nikolay A.,0,96,0,0
1668462293268,ECE 277,A00,103668,An; Cheolhong,0,127,0,0
1668462293693,ECE 279,A00,117947,Hall; Drew A.,0,18,0,0
1668462294549,ECE 283,A00,103670,Hsueh; Tzu-Chien,0,44,0,0
1668462294972,ECE 284,A00,103671,Turakhia; Yatish Girish,0,35,0,0
1668462295402,ECE 285,A00,103672,Zheng; Yang,0,31,0,0
1668462295402,ECE 285,B00,103673,Sworder; David D.,0,47,0,0
1668462295828,ECE 287,A00,103676,Javidi; Tara,0,6,0,0
1668462296253,MATH 200B,A00,098023,Salehi Golsefidy; Alireza,12,0,15,3
1668462296676,MATH 202B,A00,098024,Rhoades; Brendon Patrick,9,0,15,6
1668462297115,MATH 203B,A00,098025,Oprea; Dragos N.,10,0,15,5
1668462297540,MATH 204B,A00,098026,Sorensen; Claus M,13,0,15,2
1668462297963,MATH 208,A00,098027,Izadi; Elham,7,0,10,3
1668462298403,MATH 209,A00,098028,Pollack; Aaron,10,0,10,0
1668462298828,MATH 211A,A00,112919,Rogalski; Daniel,9,0,10,1
1668462299261,MATH 211B,A00,112920,Seward; Brandon M.,9,0,10,1
1668462299686,MATH 218,A00,098029,Li; Bo,10,0,10,0
1668462300114,MATH 220B,A00,098030,Novak; Jonathan I,11,0,15,4
1668462300550,MATH 221A,A00,098031,Ebenfelt; Peter F,13,0,15,2
1668462300974,MATH 231B,A00,098032,Zlatos; Andrej,11,0,15,4
1668462301414,MATH 240B,A00,098033,Ni; Lei,9,0,15,6
1668462301845,MATH 243,A00,098034,Jekel; David Andrew,10,0,10,0
1668462302272,MATH 245A,A00,098035,Nie; Jiawang,0,2,15,16
1668462302699,MATH 248,A00,098036,Bejenaru; Ioan,10,0,10,0
1668462303140,MATH 250B,A00,098037,Spolaor; Luca,14,0,15,1
1668462303571,MATH 258,A00,098038,Ni; Lei,10,0,10,0
1668462304069,MATH 264B,A00,098041,Rhoades; Brendon Patrick,9,0,15,6
1668462304504,MATH 268,A00,098042,Buss; Samuel R,10,0,10,0
1668462304936,MATH 269,A00,098043,Rhoades; Brendon Patrick,10,0,10,0
1668462305377,MATH 270B,A00,098044,Li; Bo,10,0,15,5
1668462305807,MATH 272B,A00,098045,Holst; Michael J,13,0,15,2
1668462306238,MATH 273A,A00,098046,Tian; Xiaochuan,10,0,15,5
1668462306672,MATH 275,A01,098048,Tian; Xiaochuan,6,0,10,4
1668462307095,MATH 278A,A00,098049,Holst; Michael J,8,0,10,2
1668462307533,MATH 278B,A00,098050,Cloninger; Alexander,10,0,10,0
1668462307957,MATH 278C,A00,098051,Nie; Jiawang,6,0,10,4
1668462308382,MATH 280B,A00,098052,Zheng; Tianyi,7,0,15,8
1668462308810,MATH 281B,A00,098053,Bradic; Jelena,0,2,15,15
1668462309237,MATH 282B,A00,098054,Arias-Castro; Ery,0,0,15,15
1668462309664,MATH 285,A00,098055,Fitzsimmons; Patrick J,0,1,15,17
1668462310090,MATH 287B,A00,098056,Arias-Castro; Ery,2,0,15,13
1668462310527,MATH 288,A00,098057,Agarwal; Pooja,9,0,10,1
1668462310527,MATH 288,B00,098058,Zhang; Danna,8,0,10,2
1668462310527,MATH 288,C00,098059,Williams; Ruth J,9,0,10,1
1668462310956,MATH 290B,A00,098060,Roberts; Justin Deritter,13,0,15,2
1668462311380,MATH 292,A00,098061,Belmont; Eva Kinoshita,10,0,10,0
1668462311806,MATH 295,A00,098062,Suk; Andrew Hoon,48,0,50,2
1668462312236,MATH 296,A00,098063,Novak; Jonathan I,20,0,20,0
1668462312659,MATH 297,001,098064,Gamst; Anthony Collins,9997,0,9999,2
1668462816275,COGS 205,A00,101395,Chiba; Andrea,19,0,20,1
1668462816699,COGS 210B,001,101404,Greene; Deanna Jacquelyn,9998,0,9999,1
1668462816699,COGS 210B,002,101417,Xia; Haijun,9999,0,9999,0
1668462816699,COGS 210B,003,101422,Nitz; Douglas A.,9999,0,9999,0
1668462816699,COGS 210B,004,101423,Hollan; James D.,9998,0,9999,1
1668462816699,COGS 210B,005,101424,Deak; Gedeon O.,9998,0,9999,1
1668462816699,COGS 210B,006,101425,Rossano; Federico,9999,0,9999,0
1668462817127,COGS 211B,A00,101427,Coulson; Seana M,9996,0,9999,3
1668462817560,COGS 220,A00,101428,Hollan; James D.,1,8,25,24
1668462817992,COGS 229,A00,101429,Dow; Steven P,17,0,25,8
1668462818422,COGS 230,A00,101430,Klemmer; Scott R,8,0,17,9
1668462818845,COGS 234,A00,101431,Xia; Haijun,2,0,25,23
1668462819285,COGS 260,A00,101432,Kiyonaga; Anastasia,21,0,25,4
1668462819285,COGS 260,B00,101433,Kirsh; David Joel,15,0,25,10
1668462819708,CSE 202,A00,102371,Impagliazzo; Russell,0,56,0,0
1668462820138,CSE 203B,A01,102373,Cheng; Chung Kuan,0,47,0,0
1668462820572,CSE 208,A00,102374,Micciancio; Daniele,0,3,0,0
1668462821005,CSE 209A,A00,112895,Impagliazzo; Russell,0,11,15,15
1668462821439,CSE 209B,A00,108005,Bellare; Mihir,0,6,0,0
1668462821868,CSE 210,A00,113163,Coblenz; Michael J,0,71,0,0
1668462822293,CSE 219,A00,106111,Dow; Steven P,0,5,20,20
1668462822716,CSE 221,A00,102376,Voelker; Geoffrey M.,0,55,0,0
1668462823146,CSE 224,A01,102378,Porter; George M,0,142,0,0
1668462823575,CSE 229A,A00,102379,Savage; Stefan,0,9,0,0
1668462824001,CSE 229C,A00,102380,Munyaka; Imani N. S.,0,8,0,0
1668462824435,CSE 232B,A00,102382,Deutsch; Alin Bernard,0,27,0,0
1668462824863,CSE 234,A01,112904,Kumar; Arun Kumar,0,0,0,0
1668462825286,CSE 237A,A00,102383,Rosing; Tajana Simunic,0,44,0,0
1668462825710,CSE 239A,A00,102384,Deutsch; Alin Bernard,0,11,0,0
1668462826142,CSE 239B,A00,102385,Polikarpova; Nadezhda,0,9,0,0
1668462826568,CSE 240A,A00,102386,Pannuto; Patrick William,0,40,0,0
1668462827071,CSE 240B,A00,102387,Zhao; Jishen,0,38,0,0
1668462827511,CSE 241A,A00,106406,Kang; Mingu,0,6,0,0
1668462827942,CSE 249B,A00,102388,Kahng; Andrew Byun,0,3,8,8
1668462828365,CSE 251B,A01,102392,Cottrell; Garrison W,0,34,0,0
1668462828365,CSE 251B,A02,102393,Cottrell; Garrison W,0,30,0,0
1668462828793,CSE 252B,A00,102394,Ochoa; Benjamin Lawrence,0,47,0,0
1668462829220,CSE 257,A01,102396,Gao; Sicun,0,124,0,0
1668462829660,CSE 272,A00,102397,Li; Tzumao,0,15,0,0
1668462830085,CSE 274,A00,111323,Chern; Albert Ren-Haur,0,9,0,0
1668462830514,CSE 282,A00,102398,Pevzner; Pavel Arkadjevich,0,0,0,0
1668462830938,CSE 284,A00,114175,Gymrek; Melissa Ann,0,16,0,0
1668462831365,CSE 290,A00,102399,Chandraker; Manmohan Krishna,0,9,0,0
1668462831365,CSE 290,B00,102400,Vaccaro; Kristen Marie,0,5,25,25
1668462831365,CSE 290,C00,102414,Pannuto; Patrick William,0,1,25,25
1668462831365,CSE 290,D00,102427,Pevzner; Pavel Arkadjevich,0,0,0,0
1668462831365,CSE 290,E00,102429,Zhao; Jishen,0,4,0,0
1668462831365,CSE 290,F00,102436,Tullsen; Dean Michael,0,4,0,0
1668462831365,CSE 290,G00,102440,Christensen; Henrik I,0,5,20,20
1668462831789,CSE 291,A00,102443,Su; Hao,0,0,0,0
1668462831789,CSE 291,B00,102448,Polikarpova; Nadezhda,0,0,0,0
1668462831789,CSE 291,C00,102453,Vaccaro; Kristen Marie,0,0,0,0
1668462831789,CSE 291,D00,111343,Savage; Stefan,0,0,0,0
1668462831789,CSE 291,E00,116474,Claffy; Kimberly Claire,0,0,0,0
1668462831789,CSE 291,F00,116479,Pasquale; Joseph,0,0,0,0
1668462832249,CSE 293,001,119111,Bafna; Vineet,9999,0,9999,0
1668462832249,CSE 293,002,119118,Bellare; Mihir,9999,0,9999,0
1668462832249,CSE 293,003,119122,Berg-Kirkpatrick; Taylor D,9999,0,9999,0
1668462832249,CSE 293,004,119135,Christensen; Henrik I,9999,0,9999,0
1668462832249,CSE 293,005,119142,Cottrell; Garrison W,9999,0,9999,0
1668462832249,CSE 293,006,119146,Deutsch; Alin Bernard,9999,0,9999,0
1668462832249,CSE 293,007,119159,Esmaeilzadeh; Hadi,9999,0,9999,0
1668462832249,CSE 293,008,119166,Freund; Yoav,9999,0,9999,0
1668462832249,CSE 293,009,119170,Griswold; William G.,9999,0,9999,0
1668462832249,CSE 293,010,119183,Gymrek; Melissa Ann,9999,0,9999,0
1668462832249,CSE 293,011,119190,Heninger; Nadia A,9999,0,9999,0
1668462832249,CSE 293,012,119230,Impagliazzo; Russell,9999,0,9999,0
1668462832249,CSE 293,013,119232,Jhala; Ranjit,9999,0,9999,0
1668462832249,CSE 293,014,119233,Kahng; Andrew Byun,9999,0,9999,0
1668462832249,CSE 293,015,119298,Kane; Daniel Mertz,9999,0,9999,0
1668462832249,CSE 293,016,119299,Kriegman; David J,9999,0,9999,0
1668462832249,CSE 293,017,119300,Kumar; Arun Kumar,9999,0,9999,0
1668462832249,CSE 293,018,119301,Lerner; Sorin,9999,0,9999,0
1668462832249,CSE 293,019,119302,Lovett; Shachar,9999,0,9999,0
1668462832249,CSE 293,020,119303,McAuley; Julian John,9999,0,9999,0
1668462832249,CSE 293,021,119304,Micciancio; Daniele,9999,0,9999,0
1668462832249,CSE 293,022,119367,Orailoglu; Alex,9999,0,9999,0
1668462832249,CSE 293,023,119382,Paturi; Ramamohan,9999,0,9999,0
1668462832249,CSE 293,024,119404,Polikarpova; Nadezhda,9999,0,9999,0
1668462832249,CSE 293,025,119406,Politz; Joseph Gibbs,9999,0,9999,0
1668462832249,CSE 293,026,119411,Porter; George M,9999,0,9999,0
1668462832249,CSE 293,027,119414,Porter; Leonard Emerson,9999,0,9999,0
1668462832249,CSE 293,028,119416,Ramamoorthi; Ravi,9999,0,9999,0
1668462832249,CSE 293,029,119417,Sahoo; Debashis,9999,0,9999,0
1668462832249,CSE 293,030,119420,Saul; Lawrence,9999,0,9999,0
1668462832249,CSE 293,031,119421,Savage; Stefan,9999,0,9999,0
1668462832249,CSE 293,032,119425,Schulze; Jurgen P.,9999,0,9999,0
1668462832249,CSE 293,033,119426,Snoeren; Alex C.,9999,0,9999,0
1668462832249,CSE 293,034,119428,Shang; Jingbo,9999,0,9999,0
1668462832249,CSE 293,035,119430,Stefan; Deian,9999,0,9999,0
1668462832249,CSE 293,036,119431,Su; Hao,9999,0,9999,0
1668462832249,CSE 293,037,119433,Swanson; Steven James,9999,0,9999,0
1668462832249,CSE 293,038,119435,Tullsen; Dean Michael,9999,0,9999,0
1668462832249,CSE 293,039,119483,Voelker; Geoffrey M.,9999,0,9999,0
1668462832249,CSE 293,040,119537,Zhao; Jishen,9999,0,9999,0
1668462832249,CSE 293,041,119538,Zhou; Yuan-Yuan,9999,0,9999,0
1668462832249,CSE 293,042,119539,Gao; Sicun,9999,0,9999,0
1668462832249,CSE 293,043,119540,Weibel; Nadir,9999,0,9999,0
1668462832249,CSE 293,044,119541,Gupta; Rajesh K.,9999,0,9999,0
1668462832249,CSE 293,045,126410,Vaccaro; Kristen Marie,9999,0,9999,0
1668462832249,CSE 293,046,126411,Klemke; Richard,9999,0,9999,0
1668462832674,CSE 294,A00,102459,Voelker; Geoffrey M.,0,2,0,0
1668462832674,CSE 294,B00,111322,Orailoglu; Alex,0,1,0,0
1668462833104,DSE 201,A00,096914,Deutsch; Alin Bernard,30,0,30,0
1668462833527,DSE 210,A00,096915,Dasgupta; Sanjoy,30,0,30,0
1668462833953,DSE 260A,A00,096916,Altintas De Callaf; Ilkay,30,0,30,0
1668462834414,ECE 200,001,103586,Antipa; Nicholas A,9999,0,9999,0
1668462834414,ECE 200,002,103587,Atanasov; Nikolay A.,9999,0,9999,0
1668462834414,ECE 200,003,103588,Bharadia; Dinesh,9999,0,9999,0
1668462834414,ECE 200,004,103589,Cheng; Chung Kuan,9999,0,9999,0
1668462834414,ECE 200,005,103590,Cosman; Pamela C.,9999,0,9999,0
1668462834414,ECE 200,006,103591,Dayeh; Shadi Ahmad,9999,0,9999,0
1668462834414,ECE 200,007,103592,Fainman; Yeshaiahu,9999,0,9999,0
1668462834414,ECE 200,008,103593,Ford; Joseph Earl,9999,0,9999,0
1668462834414,ECE 200,009,103594,Franceschetti; Massimo,9999,0,9999,0
1668462834414,ECE 200,010,103595,Fullerton; Eric E,9999,0,9999,0
1668462834414,ECE 200,011,103596,Galton; Ian A,9999,0,9999,0
1668462834414,ECE 200,012,103597,Gilja; Vikash,9999,0,9999,0
1668462834414,ECE 200,013,103598,Hall; Drew A.,9999,0,9999,0
1668462834414,ECE 200,014,103599,Hsueh; Tzu-Chien,9999,0,9999,0
1668462834414,ECE 200,015,103600,Javidi; Tara,9999,0,9999,0
1668462834414,ECE 200,016,103601,Kahng; Andrew Byun,9999,0,9999,0
1668462834414,ECE 200,017,103602,Kim; Young-Han,9999,0,9999,0
1668462834414,ECE 200,018,103603,Koushanfar; Farinaz,9999,0,9999,0
1668462834414,ECE 200,019,103604,Kuzum; Duygu,9999,0,9999,0
1668462834414,ECE 200,020,103605,Le; Hanh-Phuc,9999,0,9999,0
1668462834414,ECE 200,021,103606,Lin; Bill,9999,0,9999,0
1668462834414,ECE 200,022,103607,Liu; Zhaowei,9998,0,9999,1
1668462834414,ECE 200,023,103608,Lo; Yu-Hwa,9999,0,9999,0
1668462834414,ECE 200,024,103609,Lomakin; Vitaliy,9999,0,9999,0
1668462834414,ECE 200,025,103610,Mercier; Patrick Philip,9999,0,9999,0
1668462834414,ECE 200,026,103611,Meyer; Florian,9999,0,9999,0
1668462834414,ECE 200,027,103612,Milstein; Laurence B.,9999,0,9999,0
1668462834414,ECE 200,028,103613,Mir Arabbaygi; Siavash,9999,0,9999,0
1668462834414,ECE 200,029,103614,Mookherjea; Shayan,9999,0,9999,0
1668462834414,ECE 200,030,103615,Morris; Karcher William,9999,0,9999,0
1668462834414,ECE 200,031,103616,Ng; Tse Nga,9999,0,9999,0
1668462834414,ECE 200,032,103617,Nguyen; Truong Quang,9999,0,9999,0
1668462834414,ECE 200,033,103618,Nomura; Kenji,9999,0,9999,0
1668462834414,ECE 200,034,103619,Orlitsky; Alon,9999,0,9999,0
1668462834414,ECE 200,035,103620,Pal; Piya,9999,0,9999,0
1668462834414,ECE 200,036,103621,Papen; George C.,9999,0,9999,0
1668462834414,ECE 200,037,103622,Radic; Stojan,9999,0,9999,0
1668462834414,ECE 200,038,103623,Rao; Bhaskar D.,9999,0,9999,0
1668462834414,ECE 200,039,103624,Rao; Ramesh R,9999,0,9999,0
1668462834414,ECE 200,040,103625,Rebeiz; Gabriel,9999,0,9999,0
1668462834414,ECE 200,041,103626,Sanford; John R,9999,0,9999,0
1668462834414,ECE 200,042,103627,Siegel; Paul H.,9999,0,9999,0
1668462834414,ECE 200,043,103628,Sievenpiper; Daniel F.,9999,0,9999,0
1668462834414,ECE 200,044,103629,Sworder; David D.,9999,0,9999,0
1668462834414,ECE 200,045,103630,Taur; Yuan,9999,0,9999,0
1668462834414,ECE 200,046,103631,Touri; Behrouz,9999,0,9999,0
1668462834414,ECE 200,047,103632,Trivedi; Mohan M.,9999,0,9999,0
1668462834414,ECE 200,048,103633,Vasconcelos; Nuno,9999,0,9999,0
1668462834414,ECE 200,049,103634,Wang; Xiaolong,9999,0,9999,0
1668462834414,ECE 200,050,103635,Xie; Pengtao,9999,0,9999,0
1668462834414,ECE 200,051,103636,Yip; Michael,9999,0,9999,0
1668462834414,ECE 200,052,103637,Zeger; Kenneth A.,999,0,999,0
1668462834414,ECE 200,053,103638,Zhang; Xinyu,9999,0,9999,0
1668462834414,ECE 200,054,103639,Turakhia; Yatish Girish,9999,0,9999,0
1668462834414,ECE 200,055,103640,Kang; Mingu,9999,0,9999,0
1668462834414,ECE 200,056,103641,Shi; Yuanyuan,9999,0,9999,0
1668462834414,ECE 200,057,103642,Wang; Edward Jay,9999,0,9999,0
1668462834414,ECE 200,058,103643,Zheng; Yang,9999,0,9999,0
1668462834848,ECE 202,A00,103644,Kuzum; Duygu,0,38,0,0
1668462835272,ECE 212BN,A00,103646,Ng; Tse Nga,0,5,0,0
1668462835697,ECE 221,A00,111493,Staff,0,0,0,0
1668462836126,ECE 222B,A00,103647,Lomakin; Vitaliy,0,11,0,0
1668462836566,ECE 230B,A00,103648,Taur; Yuan,0,2,0,0
1668462836993,ECE 238B,A00,103649,Garay; Javier,0,0,0,0
1668462837421,ECE 240B,A00,112900,Fainman; Yeshaiahu,0,4,0,0
1668462837846,ECE 247A,A00,103650,Jokerst; Jesse Vincent,0,4,0,0
1668462838278,ECE 247B,A00,103651,Wang; Joseph,0,10,0,0
1668462838716,ECE 250,A00,103652,Siegel; Paul H.,0,65,0,0
1668462839147,ECE 251A,A00,103654,Rao; Bhaskar D.,0,48,0,0
1668462839573,ECE 257B,A00,103655,Bharadia; Dinesh,0,27,0,0
1668462840004,ECE 258A,A00,103656,Milstein; Laurence B.,0,24,0,0
1668462840427,ECE 260B,A00,103658,Kang; Mingu,0,107,0,0
1668462840849,ECE 264A,A00,103659,Galton; Ian A,0,60,0,0
1668462841280,ECE 265A,A00,103661,Gudem; Prasad S.S.,0,39,0,0
1668462841717,ECE 265D,A00,103662,Gudem; Prasad S.S.,0,20,0,0
1668462842144,ECE 268,A00,103663,Koushanfar; Farinaz,0,36,0,0
1668462842569,ECE 269,A01,103665,Pal; Piya,0,177,0,0
1668462842991,ECE 271B,A00,103666,Vasconcelos; Manuela,0,61,0,0
1668462843414,ECE 276A,A00,103667,Atanasov; Nikolay A.,0,102,0,0
1668462843839,ECE 277,A00,103668,An; Cheolhong,0,127,0,0
1668462844265,ECE 279,A00,117947,Hall; Drew A.,0,19,0,0
1668462845125,ECE 283,A00,103670,Hsueh; Tzu-Chien,0,44,0,0
1668462845556,ECE 284,A00,103671,Turakhia; Yatish Girish,0,35,0,0
1668462845991,ECE 285,A00,103672,Zheng; Yang,0,31,0,0
1668462845991,ECE 285,B00,103673,Sworder; David D.,0,48,0,0
1668462846419,ECE 287,A00,103676,Javidi; Tara,0,6,0,0
1668462846849,MATH 200B,A00,098023,Salehi Golsefidy; Alireza,12,0,15,3
1668462847276,MATH 202B,A00,098024,Rhoades; Brendon Patrick,9,0,15,6
1668462847704,MATH 203B,A00,098025,Oprea; Dragos N.,10,0,15,5
1668462848142,MATH 204B,A00,098026,Sorensen; Claus M,13,0,15,2
1668462848573,MATH 208,A00,098027,Izadi; Elham,7,0,10,3
1668462848997,MATH 209,A00,098028,Pollack; Aaron,10,0,10,0
1668462849428,MATH 211A,A00,112919,Rogalski; Daniel,9,0,10,1
1668462849851,MATH 211B,A00,112920,Seward; Brandon M.,9,0,10,1
1668462850276,MATH 218,A00,098029,Li; Bo,10,0,10,0
1668462850703,MATH 220B,A00,098030,Novak; Jonathan I,11,0,15,4
1668462851134,MATH 221A,A00,098031,Ebenfelt; Peter F,13,0,15,2
1668462851563,MATH 231B,A00,098032,Zlatos; Andrej,11,0,15,4
1668462852015,MATH 240B,A00,098033,Ni; Lei,9,0,15,6
1668462852449,MATH 243,A00,098034,Jekel; David Andrew,10,0,10,0
1668462852885,MATH 245A,A00,098035,Nie; Jiawang,0,2,15,16
1668462853308,MATH 248,A00,098036,Bejenaru; Ioan,10,0,10,0
1668462853735,MATH 250B,A00,098037,Spolaor; Luca,14,0,15,1
1668462854167,MATH 258,A00,098038,Ni; Lei,10,0,10,0
1668462854591,MATH 264B,A00,098041,Rhoades; Brendon Patrick,9,0,15,6
1668462855015,MATH 268,A00,098042,Buss; Samuel R,10,0,10,0
1668462855439,MATH 269,A00,098043,Rhoades; Brendon Patrick,10,0,10,0
1668462855866,MATH 270B,A00,098044,Li; Bo,10,0,15,5
1668462856290,MATH 272B,A00,098045,Holst; Michael J,13,0,15,2
1668462856717,MATH 273A,A00,098046,Tian; Xiaochuan,10,0,15,5
1668462857141,MATH 275,A01,098048,Tian; Xiaochuan,6,0,10,4
1668462857567,MATH 278A,A00,098049,Holst; Michael J,8,0,10,2
1668462857992,MATH 278B,A00,098050,Cloninger; Alexander,10,0,10,0
1668462858424,MATH 278C,A00,098051,Nie; Jiawang,6,0,10,4
1668462858847,MATH 280B,A00,098052,Zheng; Tianyi,7,0,15,8
1668462859271,MATH 281B,A00,098053,Bradic; Jelena,0,2,15,15
1668462859699,MATH 282B,A00,098054,Arias-Castro; Ery,0,0,15,15
1668462860129,MATH 285,A00,098055,Fitzsimmons; Patrick J,0,1,15,17
1668462860551,MATH 287B,A00,098056,Arias-Castro; Ery,2,0,15,13
1668462860982,MATH 288,A00,098057,Agarwal; Pooja,9,0,10,1
1668462860982,MATH 288,B00,098058,Zhang; Danna,8,0,10,2
1668462860982,MATH 288,C00,098059,Williams; Ruth J,9,0,10,1
1668462861408,MATH 290B,A00,098060,Roberts; Justin Deritter,13,0,15,2
1668462861843,MATH 292,A00,098061,Belmont; Eva Kinoshita,10,0,10,0
1668462862267,MATH 295,A00,098062,Suk; Andrew Hoon,48,0,50,2
1668462862693,MATH 296,A00,098063,Novak; Jonathan I,20,0,20,0
1668462863115,MATH 297,001,098064,Gamst; Anthony Collins,9997,0,9999,2
1668463378898,COGS 205,A00,101395,Chiba; Andrea,19,0,20,1
1668463379325,COGS 210B,001,101404,Greene; Deanna Jacquelyn,9998,0,9999,1
1668463379325,COGS 210B,002,101417,Xia; Haijun,9999,0,9999,0
1668463379325,COGS 210B,003,101422,Nitz; Douglas A.,9999,0,9999,0
1668463379325,COGS 210B,004,101423,Hollan; James D.,9998,0,9999,1
1668463379325,COGS 210B,005,101424,Deak; Gedeon O.,9998,0,9999,1
1668463379325,COGS 210B,006,101425,Rossano; Federico,9999,0,9999,0
1668463379754,COGS 211B,A00,101427,Coulson; Seana M,9996,0,9999,3
1668463380180,COGS 220,A00,101428,Hollan; James D.,1,8,25,24
1668463380604,COGS 229,A00,101429,Dow; Steven P,17,0,25,8
1668463381030,COGS 230,A00,101430,Klemmer; Scott R,8,0,17,9
1668463381457,COGS 234,A00,101431,Xia; Haijun,2,0,25,23
1668463381888,COGS 260,A00,101432,Kiyonaga; Anastasia,21,0,25,4
1668463381888,COGS 260,B00,101433,Kirsh; David Joel,15,0,25,10
1668463382313,CSE 202,A00,102371,Impagliazzo; Russell,0,56,0,0
1668463382747,CSE 203B,A01,102373,Cheng; Chung Kuan,0,47,0,0
1668463383172,CSE 208,A00,102374,Micciancio; Daniele,0,3,0,0
1668463383606,CSE 209A,A00,112895,Impagliazzo; Russell,0,11,15,15
1668463384037,CSE 209B,A00,108005,Bellare; Mihir,0,6,0,0
1668463384472,CSE 210,A00,113163,Coblenz; Michael J,0,73,0,0
1668463384901,CSE 219,A00,106111,Dow; Steven P,0,5,20,20
1668463385328,CSE 221,A00,102376,Voelker; Geoffrey M.,0,57,0,0
1668463385754,CSE 224,A01,102378,Porter; George M,0,143,0,0
1668463386181,CSE 229A,A00,102379,Savage; Stefan,0,9,0,0
1668463386610,CSE 229C,A00,102380,Munyaka; Imani N. S.,0,8,0,0
1668463387033,CSE 232B,A00,102382,Deutsch; Alin Bernard,0,28,0,0
1668463387458,CSE 234,A01,112904,Kumar; Arun Kumar,0,0,0,0
1668463387887,CSE 237A,A00,102383,Rosing; Tajana Simunic,0,44,0,0
1668463388323,CSE 239A,A00,102384,Deutsch; Alin Bernard,0,11,0,0
1668463388746,CSE 239B,A00,102385,Polikarpova; Nadezhda,0,9,0,0
1668463389186,CSE 240A,A00,102386,Pannuto; Patrick William,0,41,0,0
1668463389611,CSE 240B,A00,102387,Zhao; Jishen,0,41,0,0
1668463390041,CSE 241A,A00,106406,Kang; Mingu,0,6,0,0
1668463390465,CSE 249B,A00,102388,Kahng; Andrew Byun,0,3,8,8
1668463390902,CSE 251B,A01,102392,Cottrell; Garrison W,0,34,0,0
1668463390902,CSE 251B,A02,102393,Cottrell; Garrison W,0,30,0,0
1668463391340,CSE 252B,A00,102394,Ochoa; Benjamin Lawrence,0,47,0,0
1668463391769,CSE 257,A01,102396,Gao; Sicun,0,124,0,0
1668463392206,CSE 272,A00,102397,Li; Tzumao,0,15,0,0
1668463392630,CSE 274,A00,111323,Chern; Albert Ren-Haur,0,10,0,0
1668463393068,CSE 282,A00,102398,Pevzner; Pavel Arkadjevich,0,0,0,0
1668463393492,CSE 284,A00,114175,Gymrek; Melissa Ann,0,16,0,0
1668463393920,CSE 290,A00,102399,Chandraker; Manmohan Krishna,0,9,0,0
1668463393920,CSE 290,B00,102400,Vaccaro; Kristen Marie,0,5,25,25
1668463393920,CSE 290,C00,102414,Pannuto; Patrick William,0,1,25,25
1668463393920,CSE 290,D00,102427,Pevzner; Pavel Arkadjevich,0,0,0,0
1668463393920,CSE 290,E00,102429,Zhao; Jishen,0,4,0,0
1668463393920,CSE 290,F00,102436,Tullsen; Dean Michael,0,4,0,0
1668463393920,CSE 290,G00,102440,Christensen; Henrik I,0,5,20,20
1668463394342,CSE 291,A00,102443,Su; Hao,0,0,0,0
1668463394342,CSE 291,B00,102448,Polikarpova; Nadezhda,0,0,0,0
1668463394342,CSE 291,C00,102453,Vaccaro; Kristen Marie,0,0,0,0
1668463394342,CSE 291,D00,111343,Savage; Stefan,0,0,0,0
1668463394342,CSE 291,E00,116474,Claffy; Kimberly Claire,0,0,0,0
1668463394342,CSE 291,F00,116479,Pasquale; Joseph,0,0,0,0
1668463394769,CSE 293,001,119111,Bafna; Vineet,9999,0,9999,0
1668463394769,CSE 293,002,119118,Bellare; Mihir,9999,0,9999,0
1668463394769,CSE 293,003,119122,Berg-Kirkpatrick; Taylor D,9999,0,9999,0
1668463394769,CSE 293,004,119135,Christensen; Henrik I,9999,0,9999,0
1668463394769,CSE 293,005,119142,Cottrell; Garrison W,9999,0,9999,0
1668463394769,CSE 293,006,119146,Deutsch; Alin Bernard,9999,0,9999,0
1668463394769,CSE 293,007,119159,Esmaeilzadeh; Hadi,9999,0,9999,0
1668463394769,CSE 293,008,119166,Freund; Yoav,9999,0,9999,0
1668463394769,CSE 293,009,119170,Griswold; William G.,9999,0,9999,0
1668463394769,CSE 293,010,119183,Gymrek; Melissa Ann,9999,0,9999,0
1668463394769,CSE 293,011,119190,Heninger; Nadia A,9999,0,9999,0
1668463394769,CSE 293,012,119230,Impagliazzo; Russell,9999,0,9999,0
1668463394769,CSE 293,013,119232,Jhala; Ranjit,9999,0,9999,0
1668463394769,CSE 293,014,119233,Kahng; Andrew Byun,9999,0,9999,0
1668463394769,CSE 293,015,119298,Kane; Daniel Mertz,9999,0,9999,0
1668463394769,CSE 293,016,119299,Kriegman; David J,9999,0,9999,0
1668463394769,CSE 293,017,119300,Kumar; Arun Kumar,9999,0,9999,0
1668463394769,CSE 293,018,119301,Lerner; Sorin,9999,0,9999,0
1668463394769,CSE 293,019,119302,Lovett; Shachar,9999,0,9999,0
1668463394769,CSE 293,020,119303,McAuley; Julian John,9999,0,9999,0
1668463394769,CSE 293,021,119304,Micciancio; Daniele,9999,0,9999,0
1668463394769,CSE 293,022,119367,Orailoglu; Alex,9999,0,9999,0
1668463394769,CSE 293,023,119382,Paturi; Ramamohan,9999,0,9999,0
1668463394769,CSE 293,024,119404,Polikarpova; Nadezhda,9999,0,9999,0
1668463394769,CSE 293,025,119406,Politz; Joseph Gibbs,9999,0,9999,0
1668463394769,CSE 293,026,119411,Porter; George M,9999,0,9999,0
1668463394769,CSE 293,027,119414,Porter; Leonard Emerson,9999,0,9999,0
1668463394769,CSE 293,028,119416,Ramamoorthi; Ravi,9999,0,9999,0
1668463394769,CSE 293,029,119417,Sahoo; Debashis,9999,0,9999,0
1668463394769,CSE 293,030,119420,Saul; Lawrence,9999,0,9999,0
1668463394769,CSE 293,031,119421,Savage; Stefan,9999,0,9999,0
1668463394769,CSE 293,032,119425,Schulze; Jurgen P.,9999,0,9999,0
1668463394769,CSE 293,033,119426,Snoeren; Alex C.,9999,0,9999,0
1668463394769,CSE 293,034,119428,Shang; Jingbo,9999,0,9999,0
1668463394769,CSE 293,035,119430,Stefan; Deian,9999,0,9999,0
1668463394769,CSE 293,036,119431,Su; Hao,9999,0,9999,0
1668463394769,CSE 293,037,119433,Swanson; Steven James,9999,0,9999,0
1668463394769,CSE 293,038,119435,Tullsen; Dean Michael,9999,0,9999,0
1668463394769,CSE 293,039,119483,Voelker; Geoffrey M.,9999,0,9999,0
1668463394769,CSE 293,040,119537,Zhao; Jishen,9999,0,9999,0
1668463394769,CSE 293,041,119538,Zhou; Yuan-Yuan,9999,0,9999,0
1668463394769,CSE 293,042,119539,Gao; Sicun,9999,0,9999,0
1668463394769,CSE 293,043,119540,Weibel; Nadir,9999,0,9999,0
1668463394769,CSE 293,044,119541,Gupta; Rajesh K.,9999,0,9999,0
1668463394769,CSE 293,045,126410,Vaccaro; Kristen Marie,9999,0,9999,0
1668463394769,CSE 293,046,126411,Klemke; Richard,9999,0,9999,0
1668463395194,CSE 294,A00,102459,Voelker; Geoffrey M.,0,2,0,0
1668463395194,CSE 294,B00,111322,Orailoglu; Alex,0,1,0,0
1668463395618,DSE 201,A00,096914,Deutsch; Alin Bernard,30,0,30,0
1668463396047,DSE 210,A00,096915,Dasgupta; Sanjoy,30,0,30,0
1668463396476,DSE 260A,A00,096916,Altintas De Callaf; Ilkay,30,0,30,0
1668463396906,ECE 200,001,103586,Antipa; Nicholas A,9999,0,9999,0
1668463396906,ECE 200,002,103587,Atanasov; Nikolay A.,9999,0,9999,0
1668463396906,ECE 200,003,103588,Bharadia; Dinesh,9999,0,9999,0
1668463396906,ECE 200,004,103589,Cheng; Chung Kuan,9999,0,9999,0
1668463396906,ECE 200,005,103590,Cosman; Pamela C.,9999,0,9999,0
1668463396906,ECE 200,006,103591,Dayeh; Shadi Ahmad,9999,0,9999,0
1668463396906,ECE 200,007,103592,Fainman; Yeshaiahu,9999,0,9999,0
1668463396906,ECE 200,008,103593,Ford; Joseph Earl,9999,0,9999,0
1668463396906,ECE 200,009,103594,Franceschetti; Massimo,9999,0,9999,0
1668463396906,ECE 200,010,103595,Fullerton; Eric E,9999,0,9999,0
1668463396906,ECE 200,011,103596,Galton; Ian A,9999,0,9999,0
1668463396906,ECE 200,012,103597,Gilja; Vikash,9999,0,9999,0
1668463396906,ECE 200,013,103598,Hall; Drew A.,9999,0,9999,0
1668463396906,ECE 200,014,103599,Hsueh; Tzu-Chien,9999,0,9999,0
1668463396906,ECE 200,015,103600,Javidi; Tara,9999,0,9999,0
1668463396906,ECE 200,016,103601,Kahng; Andrew Byun,9999,0,9999,0
1668463396906,ECE 200,017,103602,Kim; Young-Han,9999,0,9999,0
1668463396906,ECE 200,018,103603,Koushanfar; Farinaz,9999,0,9999,0
1668463396906,ECE 200,019,103604,Kuzum; Duygu,9999,0,9999,0
1668463396906,ECE 200,020,103605,Le; Hanh-Phuc,9999,0,9999,0
1668463396906,ECE 200,021,103606,Lin; Bill,9999,0,9999,0
1668463396906,ECE 200,022,103607,Liu; Zhaowei,9998,0,9999,1
1668463396906,ECE 200,023,103608,Lo; Yu-Hwa,9999,0,9999,0
1668463396906,ECE 200,024,103609,Lomakin; Vitaliy,9999,0,9999,0
1668463396906,ECE 200,025,103610,Mercier; Patrick Philip,9999,0,9999,0
1668463396906,ECE 200,026,103611,Meyer; Florian,9999,0,9999,0
1668463396906,ECE 200,027,103612,Milstein; Laurence B.,9999,0,9999,0
1668463396906,ECE 200,028,103613,Mir Arabbaygi; Siavash,9999,0,9999,0
1668463396906,ECE 200,029,103614,Mookherjea; Shayan,9999,0,9999,0
1668463396906,ECE 200,030,103615,Morris; Karcher William,9999,0,9999,0
1668463396906,ECE 200,031,103616,Ng; Tse Nga,9999,0,9999,0
1668463396906,ECE 200,032,103617,Nguyen; Truong Quang,9999,0,9999,0
1668463396906,ECE 200,033,103618,Nomura; Kenji,9999,0,9999,0
1668463396906,ECE 200,034,103619,Orlitsky; Alon,9999,0,9999,0
1668463396906,ECE 200,035,103620,Pal; Piya,9999,0,9999,0
1668463396906,ECE 200,036,103621,Papen; George C.,9999,0,9999,0
1668463396906,ECE 200,037,103622,Radic; Stojan,9999,0,9999,0
1668463396906,ECE 200,038,103623,Rao; Bhaskar D.,9999,0,9999,0
1668463396906,ECE 200,039,103624,Rao; Ramesh R,9999,0,9999,0
1668463396906,ECE 200,040,103625,Rebeiz; Gabriel,9999,0,9999,0
1668463396906,ECE 200,041,103626,Sanford; John R,9999,0,9999,0
1668463396906,ECE 200,042,103627,Siegel; Paul H.,9999,0,9999,0
1668463396906,ECE 200,043,103628,Sievenpiper; Daniel F.,9999,0,9999,0
1668463396906,ECE 200,044,103629,Sworder; David D.,9999,0,9999,0
1668463396906,ECE 200,045,103630,Taur; Yuan,9999,0,9999,0
1668463396906,ECE 200,046,103631,Touri; Behrouz,9999,0,9999,0
1668463396906,ECE 200,047,103632,Trivedi; Mohan M.,9999,0,9999,0
1668463396906,ECE 200,048,103633,Vasconcelos; Nuno,9999,0,9999,0
1668463396906,ECE 200,049,103634,Wang; Xiaolong,9999,0,9999,0
1668463396906,ECE 200,050,103635,Xie; Pengtao,9999,0,9999,0
1668463396906,ECE 200,051,103636,Yip; Michael,9999,0,9999,0
1668463396906,ECE 200,052,103637,Zeger; Kenneth A.,999,0,999,0
1668463396906,ECE 200,053,103638,Zhang; Xinyu,9999,0,9999,0
1668463396906,ECE 200,054,103639,Turakhia; Yatish Girish,9999,0,9999,0
1668463396906,ECE 200,055,103640,Kang; Mingu,9999,0,9999,0
1668463396906,ECE 200,056,103641,Shi; Yuanyuan,9999,0,9999,0
1668463396906,ECE 200,057,103642,Wang; Edward Jay,9999,0,9999,0
1668463396906,ECE 200,058,103643,Zheng; Yang,9999,0,9999,0
1668463397330,ECE 202,A00,103644,Kuzum; Duygu,0,38,0,0
1668463397766,ECE 212BN,A00,103646,Ng; Tse Nga,0,5,0,0
1668463398196,ECE 221,A00,111493,Staff,0,0,0,0
1668463398642,ECE 222B,A00,103647,Lomakin; Vitaliy,0,12,0,0
1668463399080,ECE 230B,A00,103648,Taur; Yuan,0,2,0,0
1668463399525,ECE 238B,A00,103649,Garay; Javier,0,0,0,0
1668463399949,ECE 240B,A00,112900,Fainman; Yeshaiahu,0,4,0,0
1668463400397,ECE 247A,A00,103650,Jokerst; Jesse Vincent,0,4,0,0
1668463400822,ECE 247B,A00,103651,Wang; Joseph,0,10,0,0
1668463401246,ECE 250,A00,103652,Siegel; Paul H.,0,68,0,0
1668463401674,ECE 251A,A00,103654,Rao; Bhaskar D.,0,53,0,0
1668463402115,ECE 257B,A00,103655,Bharadia; Dinesh,0,28,0,0
1668463402542,ECE 258A,A00,103656,Milstein; Laurence B.,0,25,0,0
1668463402972,ECE 260B,A00,103658,Kang; Mingu,0,111,0,0
1668463403406,ECE 264A,A00,103659,Galton; Ian A,0,61,0,0
1668463403838,ECE 265A,A00,103661,Gudem; Prasad S.S.,0,41,0,0
1668463404278,ECE 265D,A00,103662,Gudem; Prasad S.S.,0,20,0,0
1668463404701,ECE 268,A00,103663,Koushanfar; Farinaz,0,36,0,0
1668463405129,ECE 269,A01,103665,Pal; Piya,0,180,0,0
1668463405671,ECE 271B,A00,103666,Vasconcelos; Manuela,0,61,0,0
1668463406104,ECE 276A,A00,103667,Atanasov; Nikolay A.,0,102,0,0
1668463406538,ECE 277,A00,103668,An; Cheolhong,0,127,0,0
1668463406965,ECE 279,A00,117947,Hall; Drew A.,0,20,0,0
1668463407822,ECE 283,A00,103670,Hsueh; Tzu-Chien,0,45,0,0
1668463408258,ECE 284,A00,103671,Turakhia; Yatish Girish,0,35,0,0
1668463408699,ECE 285,A00,103672,Zheng; Yang,0,32,0,0
1668463408699,ECE 285,B00,103673,Sworder; David D.,0,49,0,0
1668463409235,ECE 287,A00,103676,Javidi; Tara,0,6,0,0
1668463409659,MATH 200B,A00,098023,Salehi Golsefidy; Alireza,12,0,15,3
1668463410093,MATH 202B,A00,098024,Rhoades; Brendon Patrick,9,0,15,6
1668463410518,MATH 203B,A00,098025,Oprea; Dragos N.,10,0,15,5
1668463410945,MATH 204B,A00,098026,Sorensen; Claus M,13,0,15,2
1668463411376,MATH 208,A00,098027,Izadi; Elham,7,0,10,3
1668463411810,MATH 209,A00,098028,Pollack; Aaron,10,0,10,0
1668463412250,MATH 211A,A00,112919,Rogalski; Daniel,9,0,10,1
1668463412680,MATH 211B,A00,112920,Seward; Brandon M.,9,0,10,1
1668463413105,MATH 218,A00,098029,Li; Bo,10,0,10,0
1668463413544,MATH 220B,A00,098030,Novak; Jonathan I,11,0,15,4
1668463413968,MATH 221A,A00,098031,Ebenfelt; Peter F,13,0,15,2
1668463414402,MATH 231B,A00,098032,Zlatos; Andrej,11,0,15,4
1668463414829,MATH 240B,A00,098033,Ni; Lei,9,0,15,6
1668463415252,MATH 243,A00,098034,Jekel; David Andrew,10,0,10,0
1668463415683,MATH 245A,A00,098035,Nie; Jiawang,0,2,15,16
1668463416114,MATH 248,A00,098036,Bejenaru; Ioan,10,0,10,0
1668463416551,MATH 250B,A00,098037,Spolaor; Luca,14,0,15,1
1668463416975,MATH 258,A00,098038,Ni; Lei,10,0,10,0
1668463417402,MATH 264B,A00,098041,Rhoades; Brendon Patrick,9,0,15,6
1668463417826,MATH 268,A00,098042,Buss; Samuel R,10,0,10,0
1668463418258,MATH 269,A00,098043,Rhoades; Brendon Patrick,10,0,10,0
1668463418682,MATH 270B,A00,098044,Li; Bo,10,0,15,5
1668463419115,MATH 272B,A00,098045,Holst; Michael J,13,0,15,2
1668463419537,MATH 273A,A00,098046,Tian; Xiaochuan,10,0,15,5
1668463419973,MATH 275,A01,098048,Tian; Xiaochuan,6,0,10,4
1668463420405,MATH 278A,A00,098049,Holst; Michael J,8,0,10,2
1668463420830,MATH 278B,A00,098050,Cloninger; Alexander,10,0,10,0
1668463421260,MATH 278C,A00,098051,Nie; Jiawang,6,0,10,4
1668463421684,MATH 280B,A00,098052,Zheng; Tianyi,7,0,15,8
1668463422110,MATH 281B,A00,098053,Bradic; Jelena,0,2,15,15
1668463422543,MATH 282B,A00,098054,Arias-Castro; Ery,0,0,15,15
1668463422970,MATH 285,A00,098055,Fitzsimmons; Patrick J,0,1,15,17
1668463423397,MATH 287B,A00,098056,Arias-Castro; Ery,2,0,15,13
1668463423829,MATH 288,A00,098057,Agarwal; Pooja,9,0,10,1
1668463423829,MATH 288,B00,098058,Zhang; Danna,8,0,10,2
1668463423829,MATH 288,C00,098059,Williams; Ruth J,9,0,10,1
1668463424257,MATH 290B,A00,098060,Roberts; Justin Deritter,13,0,15,2
1668463424688,MATH 292,A00,098061,Belmont; Eva Kinoshita,10,0,10,0
1668463425122,MATH 295,A00,098062,Suk; Andrew Hoon,48,0,50,2
1668463425547,MATH 296,A00,098063,Novak; Jonathan I,20,0,20,0
1668463425973,MATH 297,001,098064,Gamst; Anthony Collins,9997,0,9999,2
1668463929996,COGS 205,A00,101395,Chiba; Andrea,19,0,20,1
1668463930427,COGS 210B,001,101404,Greene; Deanna Jacquelyn,9998,0,9999,1
1668463930427,COGS 210B,002,101417,Xia; Haijun,9999,0,9999,0
1668463930427,COGS 210B,003,101422,Nitz; Douglas A.,9999,0,9999,0
1668463930427,COGS 210B,004,101423,Hollan; James D.,9998,0,9999,1
1668463930427,COGS 210B,005,101424,Deak; Gedeon O.,9998,0,9999,1
1668463930427,COGS 210B,006,101425,Rossano; Federico,9999,0,9999,0
1668463930848,COGS 211B,A00,101427,Coulson; Seana M,9996,0,9999,3
1668463931272,COGS 220,A00,101428,Hollan; James D.,1,8,25,24
1668463931698,COGS 229,A00,101429,Dow; Steven P,17,0,25,8
1668463932127,COGS 230,A00,101430,Klemmer; Scott R,8,0,17,9
1668463932550,COGS 234,A00,101431,Xia; Haijun,2,0,25,23
1668463932980,COGS 260,A00,101432,Kiyonaga; Anastasia,21,0,25,4
1668463932980,COGS 260,B00,101433,Kirsh; David Joel,15,0,25,10
1668463933403,CSE 202,A00,102371,Impagliazzo; Russell,0,57,0,0
1668463933836,CSE 203B,A01,102373,Cheng; Chung Kuan,0,47,0,0
1668463934265,CSE 208,A00,102374,Micciancio; Daniele,0,3,0,0
1668463934688,CSE 209A,A00,112895,Impagliazzo; Russell,0,11,15,15
1668463935112,CSE 209B,A00,108005,Bellare; Mihir,0,6,0,0
1668463935558,CSE 210,A00,113163,Coblenz; Michael J,0,74,0,0
1668463935983,CSE 219,A00,106111,Dow; Steven P,0,5,20,20
1668463936405,CSE 221,A00,102376,Voelker; Geoffrey M.,0,57,0,0
1668463936833,CSE 224,A01,102378,Porter; George M,0,144,0,0
1668463937260,CSE 229A,A00,102379,Savage; Stefan,0,9,0,0
1668463937694,CSE 229C,A00,102380,Munyaka; Imani N. S.,0,8,0,0
1668463938118,CSE 232B,A00,102382,Deutsch; Alin Bernard,0,29,0,0
1668463938542,CSE 234,A01,112904,Kumar; Arun Kumar,0,0,0,0
1668463938978,CSE 237A,A00,102383,Rosing; Tajana Simunic,0,44,0,0
1668463939403,CSE 239A,A00,102384,Deutsch; Alin Bernard,0,12,0,0
1668463939828,CSE 239B,A00,102385,Polikarpova; Nadezhda,0,9,0,0
1668463940252,CSE 240A,A00,102386,Pannuto; Patrick William,0,41,0,0
1668463940689,CSE 240B,A00,102387,Zhao; Jishen,0,41,0,0
1668463941115,CSE 241A,A00,106406,Kang; Mingu,0,6,0,0
1668463941540,CSE 249B,A00,102388,Kahng; Andrew Byun,0,3,8,8
1668463941970,CSE 251B,A01,102392,Cottrell; Garrison W,0,36,0,0
1668463941970,CSE 251B,A02,102393,Cottrell; Garrison W,0,30,0,0
1668463942391,CSE 252B,A00,102394,Ochoa; Benjamin Lawrence,0,47,0,0
1668463942815,CSE 257,A01,102396,Gao; Sicun,0,124,0,0
1668463943238,CSE 272,A00,102397,Li; Tzumao,0,15,0,0
1668463943672,CSE 274,A00,111323,Chern; Albert Ren-Haur,0,10,0,0
1668463944099,CSE 282,A00,102398,Pevzner; Pavel Arkadjevich,0,0,0,0
1668463944526,CSE 284,A00,114175,Gymrek; Melissa Ann,0,16,0,0
1668463944952,CSE 290,A00,102399,Chandraker; Manmohan Krishna,0,9,0,0
1668463944952,CSE 290,B00,102400,Vaccaro; Kristen Marie,0,5,25,25
1668463944952,CSE 290,C00,102414,Pannuto; Patrick William,0,1,25,25
1668463944952,CSE 290,D00,102427,Pevzner; Pavel Arkadjevich,0,0,0,0
1668463944952,CSE 290,E00,102429,Zhao; Jishen,0,4,0,0
1668463944952,CSE 290,F00,102436,Tullsen; Dean Michael,0,4,0,0
1668463944952,CSE 290,G00,102440,Christensen; Henrik I,0,5,20,20
1668463945380,CSE 291,A00,102443,Su; Hao,0,0,0,0
1668463945380,CSE 291,B00,102448,Polikarpova; Nadezhda,0,0,0,0
1668463945380,CSE 291,C00,102453,Vaccaro; Kristen Marie,0,0,0,0
1668463945380,CSE 291,D00,111343,Savage; Stefan,0,0,0,0
1668463945380,CSE 291,E00,116474,Claffy; Kimberly Claire,0,0,0,0
1668463945380,CSE 291,F00,116479,Pasquale; Joseph,0,0,0,0
1668463945814,CSE 293,001,119111,Bafna; Vineet,9999,0,9999,0
1668463945814,CSE 293,002,119118,Bellare; Mihir,9999,0,9999,0
1668463945814,CSE 293,003,119122,Berg-Kirkpatrick; Taylor D,9999,0,9999,0
1668463945814,CSE 293,004,119135,Christensen; Henrik I,9999,0,9999,0
1668463945814,CSE 293,005,119142,Cottrell; Garrison W,9999,0,9999,0
1668463945814,CSE 293,006,119146,Deutsch; Alin Bernard,9999,0,9999,0
1668463945814,CSE 293,007,119159,Esmaeilzadeh; Hadi,9999,0,9999,0
1668463945814,CSE 293,008,119166,Freund; Yoav,9999,0,9999,0
1668463945814,CSE 293,009,119170,Griswold; William G.,9999,0,9999,0
1668463945814,CSE 293,010,119183,Gymrek; Melissa Ann,9999,0,9999,0
1668463945814,CSE 293,011,119190,Heninger; Nadia A,9999,0,9999,0
1668463945814,CSE 293,012,119230,Impagliazzo; Russell,9999,0,9999,0
1668463945814,CSE 293,013,119232,Jhala; Ranjit,9999,0,9999,0
1668463945814,CSE 293,014,119233,Kahng; Andrew Byun,9999,0,9999,0
1668463945814,CSE 293,015,119298,Kane; Daniel Mertz,9999,0,9999,0
1668463945814,CSE 293,016,119299,Kriegman; David J,9999,0,9999,0
1668463945814,CSE 293,017,119300,Kumar; Arun Kumar,9999,0,9999,0
1668463945814,CSE 293,018,119301,Lerner; Sorin,9999,0,9999,0
1668463945814,CSE 293,019,119302,Lovett; Shachar,9999,0,9999,0
1668463945814,CSE 293,020,119303,McAuley; Julian John,9999,0,9999,0
1668463945814,CSE 293,021,119304,Micciancio; Daniele,9999,0,9999,0
1668463945814,CSE 293,022,119367,Orailoglu; Alex,9999,0,9999,0
1668463945814,CSE 293,023,119382,Paturi; Ramamohan,9999,0,9999,0
1668463945814,CSE 293,024,119404,Polikarpova; Nadezhda,9999,0,9999,0
1668463945814,CSE 293,025,119406,Politz; Joseph Gibbs,9999,0,9999,0
1668463945814,CSE 293,026,119411,Porter; George M,9999,0,9999,0
1668463945814,CSE 293,027,119414,Porter; Leonard Emerson,9999,0,9999,0
1668463945814,CSE 293,028,119416,Ramamoorthi; Ravi,9999,0,9999,0
1668463945814,CSE 293,029,119417,Sahoo; Debashis,9999,0,9999,0
1668463945814,CSE 293,030,119420,Saul; Lawrence,9999,0,9999,0
1668463945814,CSE 293,031,119421,Savage; Stefan,9999,0,9999,0
1668463945814,CSE 293,032,119425,Schulze; Jurgen P.,9999,0,9999,0
1668463945814,CSE 293,033,119426,Snoeren; Alex C.,9999,0,9999,0
1668463945814,CSE 293,034,119428,Shang; Jingbo,9999,0,9999,0
1668463945814,CSE 293,035,119430,Stefan; Deian,9999,0,9999,0
1668463945814,CSE 293,036,119431,Su; Hao,9999,0,9999,0
1668463945814,CSE 293,037,119433,Swanson; Steven James,9999,0,9999,0
1668463945814,CSE 293,038,119435,Tullsen; Dean Michael,9999,0,9999,0
1668463945814,CSE 293,039,119483,Voelker; Geoffrey M.,9999,0,9999,0
1668463945814,CSE 293,040,119537,Zhao; Jishen,9999,0,9999,0
1668463945814,CSE 293,041,119538,Zhou; Yuan-Yuan,9999,0,9999,0
1668463945814,CSE 293,042,119539,Gao; Sicun,9999,0,9999,0
1668463945814,CSE 293,043,119540,Weibel; Nadir,9999,0,9999,0
1668463945814,CSE 293,044,119541,Gupta; Rajesh K.,9999,0,9999,0
1668463945814,CSE 293,045,126410,Vaccaro; Kristen Marie,9999,0,9999,0
1668463945814,CSE 293,046,126411,Klemke; Richard,9999,0,9999,0
1668463946236,CSE 294,A00,102459,Voelker; Geoffrey M.,0,2,0,0
1668463946236,CSE 294,B00,111322,Orailoglu; Alex,0,1,0,0
1668463946670,DSE 201,A00,096914,Deutsch; Alin Bernard,30,0,30,0
1668463947096,DSE 210,A00,096915,Dasgupta; Sanjoy,30,0,30,0
1668463947522,DSE 260A,A00,096916,Altintas De Callaf; Ilkay,30,0,30,0
1668463947959,ECE 200,001,103586,Antipa; Nicholas A,9999,0,9999,0
1668463947959,ECE 200,002,103587,Atanasov; Nikolay A.,9999,0,9999,0
1668463947959,ECE 200,003,103588,Bharadia; Dinesh,9999,0,9999,0
1668463947959,ECE 200,004,103589,Cheng; Chung Kuan,9999,0,9999,0
1668463947959,ECE 200,005,103590,Cosman; Pamela C.,9999,0,9999,0
1668463947959,ECE 200,006,103591,Dayeh; Shadi Ahmad,9999,0,9999,0
1668463947959,ECE 200,007,103592,Fainman; Yeshaiahu,9999,0,9999,0
1668463947959,ECE 200,008,103593,Ford; Joseph Earl,9999,0,9999,0
1668463947959,ECE 200,009,103594,Franceschetti; Massimo,9999,0,9999,0
1668463947959,ECE 200,010,103595,Fullerton; Eric E,9999,0,9999,0
1668463947959,ECE 200,011,103596,Galton; Ian A,9999,0,9999,0
1668463947959,ECE 200,012,103597,Gilja; Vikash,9999,0,9999,0
1668463947959,ECE 200,013,103598,Hall; Drew A.,9999,0,9999,0
1668463947959,ECE 200,014,103599,Hsueh; Tzu-Chien,9999,0,9999,0
1668463947959,ECE 200,015,103600,Javidi; Tara,9999,0,9999,0
1668463947959,ECE 200,016,103601,Kahng; Andrew Byun,9999,0,9999,0
1668463947959,ECE 200,017,103602,Kim; Young-Han,9999,0,9999,0
1668463947959,ECE 200,018,103603,Koushanfar; Farinaz,9999,0,9999,0
1668463947959,ECE 200,019,103604,Kuzum; Duygu,9999,0,9999,0
1668463947959,ECE 200,020,103605,Le; Hanh-Phuc,9999,0,9999,0
1668463947959,ECE 200,021,103606,Lin; Bill,9999,0,9999,0
1668463947959,ECE 200,022,103607,Liu; Zhaowei,9998,0,9999,1
1668463947959,ECE 200,023,103608,Lo; Yu-Hwa,9999,0,9999,0
1668463947959,ECE 200,024,103609,Lomakin; Vitaliy,9999,0,9999,0
1668463947959,ECE 200,025,103610,Mercier; Patrick Philip,9999,0,9999,0
1668463947959,ECE 200,026,103611,Meyer; Florian,9999,0,9999,0
1668463947959,ECE 200,027,103612,Milstein; Laurence B.,9999,0,9999,0
1668463947959,ECE 200,028,103613,Mir Arabbaygi; Siavash,9999,0,9999,0
1668463947959,ECE 200,029,103614,Mookherjea; Shayan,9999,0,9999,0
1668463947959,ECE 200,030,103615,Morris; Karcher William,9999,0,9999,0
1668463947959,ECE 200,031,103616,Ng; Tse Nga,9999,0,9999,0
1668463947959,ECE 200,032,103617,Nguyen; Truong Quang,9999,0,9999,0
1668463947959,ECE 200,033,103618,Nomura; Kenji,9999,0,9999,0
1668463947959,ECE 200,034,103619,Orlitsky; Alon,9999,0,9999,0
1668463947959,ECE 200,035,103620,Pal; Piya,9999,0,9999,0
1668463947959,ECE 200,036,103621,Papen; George C.,9999,0,9999,0
1668463947959,ECE 200,037,103622,Radic; Stojan,9999,0,9999,0
1668463947959,ECE 200,038,103623,Rao; Bhaskar D.,9999,0,9999,0
1668463947959,ECE 200,039,103624,Rao; Ramesh R,9999,0,9999,0
1668463947959,ECE 200,040,103625,Rebeiz; Gabriel,9999,0,9999,0
1668463947959,ECE 200,041,103626,Sanford; John R,9999,0,9999,0
1668463947959,ECE 200,042,103627,Siegel; Paul H.,9999,0,9999,0
1668463947959,ECE 200,043,103628,Sievenpiper; Daniel F.,9999,0,9999,0
1668463947959,ECE 200,044,103629,Sworder; David D.,9999,0,9999,0
1668463947959,ECE 200,045,103630,Taur; Yuan,9999,0,9999,0
1668463947959,ECE 200,046,103631,Touri; Behrouz,9999,0,9999,0
1668463947959,ECE 200,047,103632,Trivedi; Mohan M.,9999,0,9999,0
1668463947959,ECE 200,048,103633,Vasconcelos; Nuno,9999,0,9999,0
1668463947959,ECE 200,049,103634,Wang; Xiaolong,9999,0,9999,0
1668463947959,ECE 200,050,103635,Xie; Pengtao,9999,0,9999,0
1668463947959,ECE 200,051,103636,Yip; Michael,9999,0,9999,0
1668463947959,ECE 200,052,103637,Zeger; Kenneth A.,999,0,999,0
1668463947959,ECE 200,053,103638,Zhang; Xinyu,9999,0,9999,0
1668463947959,ECE 200,054,103639,Turakhia; Yatish Girish,9999,0,9999,0
1668463947959,ECE 200,055,103640,Kang; Mingu,9999,0,9999,0
1668463947959,ECE 200,056,103641,Shi; Yuanyuan,9999,0,9999,0
1668463947959,ECE 200,057,103642,Wang; Edward Jay,9999,0,9999,0
1668463947959,ECE 200,058,103643,Zheng; Yang,9999,0,9999,0
1668463948385,ECE 202,A00,103644,Kuzum; Duygu,0,40,0,0
1668463948816,ECE 212BN,A00,103646,Ng; Tse Nga,0,7,0,0
1668463949241,ECE 221,A00,111493,Staff,0,0,0,0
1668463949684,ECE 222B,A00,103647,Lomakin; Vitaliy,0,13,0,0
1668463950110,ECE 230B,A00,103648,Taur; Yuan,0,2,0,0
1668463950541,ECE 238B,A00,103649,Garay; Javier,0,0,0,0
1668463950963,ECE 240B,A00,112900,Fainman; Yeshaiahu,0,5,0,0
1668463951395,ECE 247A,A00,103650,Jokerst; Jesse Vincent,0,4,0,0
1668463951823,ECE 247B,A00,103651,Wang; Joseph,0,10,0,0
1668463952251,ECE 250,A00,103652,Siegel; Paul H.,0,70,0,0
1668463952675,ECE 251A,A00,103654,Rao; Bhaskar D.,0,55,0,0
1668463953097,ECE 257B,A00,103655,Bharadia; Dinesh,0,29,0,0
1668463953525,ECE 258A,A00,103656,Milstein; Laurence B.,0,26,0,0
1668463954018,ECE 260B,A00,103658,Kang; Mingu,0,111,0,0
1668463954448,ECE 264A,A00,103659,Galton; Ian A,0,62,0,0
1668463954875,ECE 265A,A00,103661,Gudem; Prasad S.S.,0,42,0,0
1668463955309,ECE 265D,A00,103662,Gudem; Prasad S.S.,0,20,0,0
1668463955733,ECE 268,A00,103663,Koushanfar; Farinaz,0,38,0,0
1668463956157,ECE 269,A01,103665,Pal; Piya,0,182,0,0
1668463956588,ECE 271B,A00,103666,Vasconcelos; Manuela,0,63,0,0
1668463957032,ECE 276A,A00,103667,Atanasov; Nikolay A.,0,105,0,0
1668463957469,ECE 277,A00,103668,An; Cheolhong,0,132,0,0
1668463957904,ECE 279,A00,117947,Hall; Drew A.,0,20,0,0
1668463958761,ECE 283,A00,103670,Hsueh; Tzu-Chien,0,46,0,0
1668463959210,ECE 284,A00,103671,Turakhia; Yatish Girish,0,36,0,0
1668463959635,ECE 285,A00,103672,Zheng; Yang,0,32,0,0
1668463959635,ECE 285,B00,103673,Sworder; David D.,0,49,0,0
1668463960062,ECE 287,A00,103676,Javidi; Tara,0,6,0,0
1668463960486,MATH 200B,A00,098023,Salehi Golsefidy; Alireza,12,0,15,3
1668463960911,MATH 202B,A00,098024,Rhoades; Brendon Patrick,9,0,15,6
1668463961332,MATH 203B,A00,098025,Oprea; Dragos N.,10,0,15,5
1668463961758,MATH 204B,A00,098026,Sorensen; Claus M,13,0,15,2
1668463962185,MATH 208,A00,098027,Izadi; Elham,7,0,10,3
1668463962611,MATH 209,A00,098028,Pollack; Aaron,10,0,10,0
1668463963032,MATH 211A,A00,112919,Rogalski; Daniel,9,0,10,1
1668463963472,MATH 211B,A00,112920,Seward; Brandon M.,9,0,10,1
1668463963902,MATH 218,A00,098029,Li; Bo,10,0,10,0
1668463964329,MATH 220B,A00,098030,Novak; Jonathan I,11,0,15,4
1668463964771,MATH 221A,A00,098031,Ebenfelt; Peter F,13,0,15,2
1668463965201,MATH 231B,A00,098032,Zlatos; Andrej,11,0,15,4
1668463965624,MATH 240B,A00,098033,Ni; Lei,9,0,15,6
1668463966067,MATH 243,A00,098034,Jekel; David Andrew,10,0,10,0
1668463966492,MATH 245A,A00,098035,Nie; Jiawang,0,2,15,16
1668463966916,MATH 248,A00,098036,Bejenaru; Ioan,10,0,10,0
1668463967346,MATH 250B,A00,098037,Spolaor; Luca,14,0,15,1
1668463967769,MATH 258,A00,098038,Ni; Lei,10,0,10,0
1668463968205,MATH 264B,A00,098041,Rhoades; Brendon Patrick,9,0,15,6
1668463968637,MATH 268,A00,098042,Buss; Samuel R,10,0,10,0
1668463969064,MATH 269,A00,098043,Rhoades; Brendon Patrick,10,0,10,0
1668463969489,MATH 270B,A00,098044,Li; Bo,10,0,15,5
1668463969925,MATH 272B,A00,098045,Holst; Michael J,13,0,15,2
1668463970351,MATH 273A,A00,098046,Tian; Xiaochuan,10,0,15,5
1668463970780,MATH 275,A01,098048,Tian; Xiaochuan,6,0,10,4
1668463971202,MATH 278A,A00,098049,Holst; Michael J,8,0,10,2
1668463971626,MATH 278B,A00,098050,Cloninger; Alexander,10,0,10,0
1668463972141,MATH 278C,A00,098051,Nie; Jiawang,6,0,10,4
1668463972647,MATH 280B,A00,098052,Zheng; Tianyi,7,0,15,8
1668463973079,MATH 281B,A00,098053,Bradic; Jelena,0,2,15,15
1668463973506,MATH 282B,A00,098054,Arias-Castro; Ery,0,0,15,15
1668463973928,MATH 285,A00,098055,Fitzsimmons; Patrick J,0,1,15,17
1668463974354,MATH 287B,A00,098056,Arias-Castro; Ery,2,0,15,13
1668463974777,MATH 288,A00,098057,Agarwal; Pooja,9,0,10,1
1668463974777,MATH 288,B00,098058,Zhang; Danna,8,0,10,2
1668463974777,MATH 288,C00,098059,Williams; Ruth J,9,0,10,1
1668463975203,MATH 290B,A00,098060,Roberts; Justin Deritter,13,0,15,2
1668463975638,MATH 292,A00,098061,Belmont; Eva Kinoshita,10,0,10,0
1668463976062,MATH 295,A00,098062,Suk; Andrew Hoon,48,0,50,2
1668463976491,MATH 296,A00,098063,Novak; Jonathan I,20,0,20,0
1668463976926,MATH 297,001,098064,Gamst; Anthony Collins,9997,0,9999,2
1668464480360,COGS 205,A00,101395,Chiba; Andrea,19,0,20,1
1668464480791,COGS 210B,001,101404,Greene; Deanna Jacquelyn,9998,0,9999,1
1668464480791,COGS 210B,002,101417,Xia; Haijun,9999,0,9999,0
1668464480791,COGS 210B,003,101422,Nitz; Douglas A.,9999,0,9999,0
1668464480791,COGS 210B,004,101423,Hollan; James D.,9998,0,9999,1
1668464480791,COGS 210B,005,101424,Deak; Gedeon O.,9998,0,9999,1
1668464480791,COGS 210B,006,101425,Rossano; Federico,9999,0,9999,0
1668464481213,COGS 211B,A00,101427,Coulson; Seana M,9996,0,9999,3
1668464481638,COGS 220,A00,101428,Hollan; James D.,1,8,25,24
1668464482062,COGS 229,A00,101429,Dow; Steven P,17,0,25,8
1668464482506,COGS 230,A00,101430,Klemmer; Scott R,8,0,17,9
1668464482932,COGS 234,A00,101431,Xia; Haijun,2,0,25,23
1668464483359,COGS 260,A00,101432,Kiyonaga; Anastasia,21,0,25,4
1668464483359,COGS 260,B00,101433,Kirsh; David Joel,15,0,25,10
1668464483785,CSE 202,A00,102371,Impagliazzo; Russell,0,58,0,0
1668464484212,CSE 203B,A01,102373,Cheng; Chung Kuan,0,49,0,0
1668464484643,CSE 208,A00,102374,Micciancio; Daniele,0,3,0,0
1668464485064,CSE 209A,A00,112895,Impagliazzo; Russell,0,11,15,15
1668464485494,CSE 209B,A00,108005,Bellare; Mihir,0,6,0,0
1668464485918,CSE 210,A00,113163,Coblenz; Michael J,0,74,0,0
1668464486349,CSE 219,A00,106111,Dow; Steven P,0,5,20,20
1668464486794,CSE 221,A00,102376,Voelker; Geoffrey M.,0,57,0,0
1668464487235,CSE 224,A01,102378,Porter; George M,0,144,0,0
1668464487662,CSE 229A,A00,102379,Savage; Stefan,0,9,0,0
1668464488090,CSE 229C,A00,102380,Munyaka; Imani N. S.,0,8,0,0
1668464488530,CSE 232B,A00,102382,Deutsch; Alin Bernard,0,29,0,0
1668464488963,CSE 234,A01,112904,Kumar; Arun Kumar,0,0,0,0
1668464489388,CSE 237A,A00,102383,Rosing; Tajana Simunic,0,45,0,0
1668464489810,CSE 239A,A00,102384,Deutsch; Alin Bernard,0,12,0,0
1668464490240,CSE 239B,A00,102385,Polikarpova; Nadezhda,0,9,0,0
1668464490678,CSE 240A,A00,102386,Pannuto; Patrick William,0,41,0,0
1668464491106,CSE 240B,A00,102387,Zhao; Jishen,0,42,0,0
1668464491532,CSE 241A,A00,106406,Kang; Mingu,0,6,0,0
1668464491956,CSE 249B,A00,102388,Kahng; Andrew Byun,0,4,8,8
1668464492396,CSE 251B,A01,102392,Cottrell; Garrison W,0,38,0,0
1668464492396,CSE 251B,A02,102393,Cottrell; Garrison W,0,30,0,0
1668464492827,CSE 252B,A00,102394,Ochoa; Benjamin Lawrence,0,48,0,0
1668464493262,CSE 257,A01,102396,Gao; Sicun,0,124,0,0
1668464493684,CSE 272,A00,102397,Li; Tzumao,0,15,0,0
1668464494123,CSE 274,A00,111323,Chern; Albert Ren-Haur,0,11,0,0
1668464494545,CSE 282,A00,102398,Pevzner; Pavel Arkadjevich,0,0,0,0
1668464494973,CSE 284,A00,114175,Gymrek; Melissa Ann,0,16,0,0
1668464495477,CSE 290,A00,102399,Chandraker; Manmohan Krishna,0,10,0,0
1668464495477,CSE 290,B00,102400,Vaccaro; Kristen Marie,0,5,25,25
1668464495477,CSE 290,C00,102414,Pannuto; Patrick William,0,1,25,25
1668464495477,CSE 290,D00,102427,Pevzner; Pavel Arkadjevich,0,0,0,0
1668464495477,CSE 290,E00,102429,Zhao; Jishen,0,4,0,0
1668464495477,CSE 290,F00,102436,Tullsen; Dean Michael,0,4,0,0
1668464495477,CSE 290,G00,102440,Christensen; Henrik I,0,5,20,20
1668464495901,CSE 291,A00,102443,Su; Hao,0,0,0,0
1668464495901,CSE 291,B00,102448,Polikarpova; Nadezhda,0,0,0,0
1668464495901,CSE 291,C00,102453,Vaccaro; Kristen Marie,0,0,0,0
1668464495901,CSE 291,D00,111343,Savage; Stefan,0,0,0,0
1668464495901,CSE 291,E00,116474,Claffy; Kimberly Claire,0,0,0,0
1668464495901,CSE 291,F00,116479,Pasquale; Joseph,0,0,0,0
1668464496362,CSE 293,001,119111,Bafna; Vineet,9999,0,9999,0
1668464496362,CSE 293,002,119118,Bellare; Mihir,9999,0,9999,0
1668464496362,CSE 293,003,119122,Berg-Kirkpatrick; Taylor D,9999,0,9999,0
1668464496362,CSE 293,004,119135,Christensen; Henrik I,9999,0,9999,0
1668464496362,CSE 293,005,119142,Cottrell; Garrison W,9999,0,9999,0
1668464496362,CSE 293,006,119146,Deutsch; Alin Bernard,9999,0,9999,0
1668464496362,CSE 293,007,119159,Esmaeilzadeh; Hadi,9999,0,9999,0
1668464496362,CSE 293,008,119166,Freund; Yoav,9999,0,9999,0
1668464496362,CSE 293,009,119170,Griswold; William G.,9999,0,9999,0
1668464496362,CSE 293,010,119183,Gymrek; Melissa Ann,9999,0,9999,0
1668464496362,CSE 293,011,119190,Heninger; Nadia A,9999,0,9999,0
1668464496362,CSE 293,012,119230,Impagliazzo; Russell,9999,0,9999,0
1668464496362,CSE 293,013,119232,Jhala; Ranjit,9999,0,9999,0
1668464496362,CSE 293,014,119233,Kahng; Andrew Byun,9999,0,9999,0
1668464496362,CSE 293,015,119298,Kane; Daniel Mertz,9999,0,9999,0
1668464496362,CSE 293,016,119299,Kriegman; David J,9999,0,9999,0
1668464496362,CSE 293,017,119300,Kumar; Arun Kumar,9999,0,9999,0
1668464496362,CSE 293,018,119301,Lerner; Sorin,9999,0,9999,0
1668464496362,CSE 293,019,119302,Lovett; Shachar,9999,0,9999,0
1668464496362,CSE 293,020,119303,McAuley; Julian John,9999,0,9999,0
1668464496362,CSE 293,021,119304,Micciancio; Daniele,9999,0,9999,0
1668464496362,CSE 293,022,119367,Orailoglu; Alex,9999,0,9999,0
1668464496362,CSE 293,023,119382,Paturi; Ramamohan,9999,0,9999,0
1668464496362,CSE 293,024,119404,Polikarpova; Nadezhda,9999,0,9999,0
1668464496362,CSE 293,025,119406,Politz; Joseph Gibbs,9999,0,9999,0
1668464496362,CSE 293,026,119411,Porter; George M,9999,0,9999,0
1668464496362,CSE 293,027,119414,Porter; Leonard Emerson,9999,0,9999,0
1668464496362,CSE 293,028,119416,Ramamoorthi; Ravi,9999,0,9999,0
1668464496362,CSE 293,029,119417,Sahoo; Debashis,9999,0,9999,0
1668464496362,CSE 293,030,119420,Saul; Lawrence,9999,0,9999,0
1668464496362,CSE 293,031,119421,Savage; Stefan,9999,0,9999,0
1668464496362,CSE 293,032,119425,Schulze; Jurgen P.,9999,0,9999,0
1668464496362,CSE 293,033,119426,Snoeren; Alex C.,9999,0,9999,0
1668464496362,CSE 293,034,119428,Shang; Jingbo,9999,0,9999,0
1668464496362,CSE 293,035,119430,Stefan; Deian,9999,0,9999,0
1668464496362,CSE 293,036,119431,Su; Hao,9999,0,9999,0
1668464496362,CSE 293,037,119433,Swanson; Steven James,9999,0,9999,0
1668464496362,CSE 293,038,119435,Tullsen; Dean Michael,9999,0,9999,0
1668464496362,CSE 293,039,119483,Voelker; Geoffrey M.,9999,0,9999,0
1668464496362,CSE 293,040,119537,Zhao; Jishen,9999,0,9999,0
1668464496362,CSE 293,041,119538,Zhou; Yuan-Yuan,9999,0,9999,0
1668464496362,CSE 293,042,119539,Gao; Sicun,9999,0,9999,0
1668464496362,CSE 293,043,119540,Weibel; Nadir,9999,0,9999,0
1668464496362,CSE 293,044,119541,Gupta; Rajesh K.,9999,0,9999,0
1668464496362,CSE 293,045,126410,Vaccaro; Kristen Marie,9999,0,9999,0
1668464496362,CSE 293,046,126411,Klemke; Richard,9999,0,9999,0
1668464496794,CSE 294,A00,102459,Voelker; Geoffrey M.,0,2,0,0
1668464496794,CSE 294,B00,111322,Orailoglu; Alex,0,1,0,0
1668464497222,DSE 201,A00,096914,Deutsch; Alin Bernard,30,0,30,0
1668464497651,DSE 210,A00,096915,Dasgupta; Sanjoy,30,0,30,0
1668464498074,DSE 260A,A00,096916,Altintas De Callaf; Ilkay,30,0,30,0
1668464498534,ECE 200,001,103586,Antipa; Nicholas A,9999,0,9999,0
1668464498534,ECE 200,002,103587,Atanasov; Nikolay A.,9999,0,9999,0
1668464498534,ECE 200,003,103588,Bharadia; Dinesh,9999,0,9999,0
1668464498534,ECE 200,004,103589,Cheng; Chung Kuan,9999,0,9999,0
1668464498534,ECE 200,005,103590,Cosman; Pamela C.,9999,0,9999,0
1668464498534,ECE 200,006,103591,Dayeh; Shadi Ahmad,9999,0,9999,0
1668464498534,ECE 200,007,103592,Fainman; Yeshaiahu,9999,0,9999,0
1668464498534,ECE 200,008,103593,Ford; Joseph Earl,9999,0,9999,0
1668464498534,ECE 200,009,103594,Franceschetti; Massimo,9999,0,9999,0
1668464498534,ECE 200,010,103595,Fullerton; Eric E,9999,0,9999,0
1668464498534,ECE 200,011,103596,Galton; Ian A,9999,0,9999,0
1668464498534,ECE 200,012,103597,Gilja; Vikash,9999,0,9999,0
1668464498534,ECE 200,013,103598,Hall; Drew A.,9999,0,9999,0
1668464498534,ECE 200,014,103599,Hsueh; Tzu-Chien,9999,0,9999,0
1668464498534,ECE 200,015,103600,Javidi; Tara,9999,0,9999,0
1668464498534,ECE 200,016,103601,Kahng; Andrew Byun,9999,0,9999,0
1668464498534,ECE 200,017,103602,Kim; Young-Han,9999,0,9999,0
1668464498534,ECE 200,018,103603,Koushanfar; Farinaz,9999,0,9999,0
1668464498534,ECE 200,019,103604,Kuzum; Duygu,9999,0,9999,0
1668464498534,ECE 200,020,103605,Le; Hanh-Phuc,9999,0,9999,0
1668464498534,ECE 200,021,103606,Lin; Bill,9999,0,9999,0
1668464498534,ECE 200,022,103607,Liu; Zhaowei,9998,0,9999,1
1668464498534,ECE 200,023,103608,Lo; Yu-Hwa,9999,0,9999,0
1668464498534,ECE 200,024,103609,Lomakin; Vitaliy,9999,0,9999,0
1668464498534,ECE 200,025,103610,Mercier; Patrick Philip,9999,0,9999,0
1668464498534,ECE 200,026,103611,Meyer; Florian,9999,0,9999,0
1668464498534,ECE 200,027,103612,Milstein; Laurence B.,9999,0,9999,0
1668464498534,ECE 200,028,103613,Mir Arabbaygi; Siavash,9999,0,9999,0
1668464498534,ECE 200,029,103614,Mookherjea; Shayan,9999,0,9999,0
1668464498534,ECE 200,030,103615,Morris; Karcher William,9999,0,9999,0
1668464498534,ECE 200,031,103616,Ng; Tse Nga,9999,0,9999,0
1668464498534,ECE 200,032,103617,Nguyen; Truong Quang,9999,0,9999,0
1668464498534,ECE 200,033,103618,Nomura; Kenji,9999,0,9999,0
1668464498534,ECE 200,034,103619,Orlitsky; Alon,9999,0,9999,0
1668464498534,ECE 200,035,103620,Pal; Piya,9999,0,9999,0
1668464498534,ECE 200,036,103621,Papen; George C.,9999,0,9999,0
1668464498534,ECE 200,037,103622,Radic; Stojan,9999,0,9999,0
1668464498534,ECE 200,038,103623,Rao; Bhaskar D.,9999,0,9999,0
1668464498534,ECE 200,039,103624,Rao; Ramesh R,9999,0,9999,0
1668464498534,ECE 200,040,103625,Rebeiz; Gabriel,9999,0,9999,0
1668464498534,ECE 200,041,103626,Sanford; John R,9999,0,9999,0
1668464498534,ECE 200,042,103627,Siegel; Paul H.,9999,0,9999,0
1668464498534,ECE 200,043,103628,Sievenpiper; Daniel F.,9999,0,9999,0
1668464498534,ECE 200,044,103629,Sworder; David D.,9999,0,9999,0
1668464498534,ECE 200,045,103630,Taur; Yuan,9999,0,9999,0
1668464498534,ECE 200,046,103631,Touri; Behrouz,9999,0,9999,0
1668464498534,ECE 200,047,103632,Trivedi; Mohan M.,9999,0,9999,0
1668464498534,ECE 200,048,103633,Vasconcelos; Nuno,9999,0,9999,0
1668464498534,ECE 200,049,103634,Wang; Xiaolong,9999,0,9999,0
1668464498534,ECE 200,050,103635,Xie; Pengtao,9999,0,9999,0
1668464498534,ECE 200,051,103636,Yip; Michael,9999,0,9999,0
1668464498534,ECE 200,052,103637,Zeger; Kenneth A.,999,0,999,0
1668464498534,ECE 200,053,103638,Zhang; Xinyu,9999,0,9999,0
1668464498534,ECE 200,054,103639,Turakhia; Yatish Girish,9999,0,9999,0
1668464498534,ECE 200,055,103640,Kang; Mingu,9999,0,9999,0
1668464498534,ECE 200,056,103641,Shi; Yuanyuan,9999,0,9999,0
1668464498534,ECE 200,057,103642,Wang; Edward Jay,9999,0,9999,0
1668464498534,ECE 200,058,103643,Zheng; Yang,9999,0,9999,0
1668464498960,ECE 202,A00,103644,Kuzum; Duygu,0,40,0,0
1668464499388,ECE 212BN,A00,103646,Ng; Tse Nga,0,7,0,0
1668464499813,ECE 221,A00,111493,Staff,0,0,0,0
1668464500252,ECE 222B,A00,103647,Lomakin; Vitaliy,0,13,0,0
1668464500681,ECE 230B,A00,103648,Taur; Yuan,0,2,0,0
1668464501115,ECE 238B,A00,103649,Garay; Javier,0,0,0,0
1668464501540,ECE 240B,A00,112900,Fainman; Yeshaiahu,0,5,0,0
1668464501974,ECE 247A,A00,103650,Jokerst; Jesse Vincent,0,4,0,0
1668464502397,ECE 247B,A00,103651,Wang; Joseph,0,10,0,0
1668464502827,ECE 250,A00,103652,Siegel; Paul H.,0,72,0,0
1668464503254,ECE 251A,A00,103654,Rao; Bhaskar D.,0,58,0,0
1668464503681,ECE 257B,A00,103655,Bharadia; Dinesh,0,29,0,0
1668464504119,ECE 258A,A00,103656,Milstein; Laurence B.,0,27,0,0
1668464504547,ECE 260B,A00,103658,Kang; Mingu,0,113,0,0
1668464504973,ECE 264A,A00,103659,Galton; Ian A,0,62,0,0
1668464505399,ECE 265A,A00,103661,Gudem; Prasad S.S.,0,43,0,0
1668464505824,ECE 265D,A00,103662,Gudem; Prasad S.S.,0,21,0,0
1668464506250,ECE 268,A00,103663,Koushanfar; Farinaz,0,39,0,0
1668464506674,ECE 269,A01,103665,Pal; Piya,0,185,0,0
1668464507100,ECE 271B,A00,103666,Vasconcelos; Manuela,0,65,0,0
1668464507526,ECE 276A,A00,103667,Atanasov; Nikolay A.,0,106,0,0
1668464507961,ECE 277,A00,103668,An; Cheolhong,0,133,0,0
1668464508384,ECE 279,A00,117947,Hall; Drew A.,0,21,0,0
1668464509238,ECE 283,A00,103670,Hsueh; Tzu-Chien,0,46,0,0
1668464509668,ECE 284,A00,103671,Turakhia; Yatish Girish,0,37,0,0
1668464510095,ECE 285,A00,103672,Zheng; Yang,0,33,0,0
1668464510095,ECE 285,B00,103673,Sworder; David D.,0,51,0,0
1668464510526,ECE 287,A00,103676,Javidi; Tara,0,7,0,0
1668464510955,MATH 200B,A00,098023,Salehi Golsefidy; Alireza,12,0,15,3
1668464511382,MATH 202B,A00,098024,Rhoades; Brendon Patrick,9,0,15,6
1668464511807,MATH 203B,A00,098025,Oprea; Dragos N.,10,0,15,5
1668464512233,MATH 204B,A00,098026,Sorensen; Claus M,13,0,15,2
1668464512657,MATH 208,A00,098027,Izadi; Elham,7,0,10,3
1668464513092,MATH 209,A00,098028,Pollack; Aaron,10,0,10,0
1668464513516,MATH 211A,A00,112919,Rogalski; Daniel,9,0,10,1
1668464513938,MATH 211B,A00,112920,Seward; Brandon M.,9,0,10,1
1668464514365,MATH 218,A00,098029,Li; Bo,10,0,10,0
1668464514788,MATH 220B,A00,098030,Novak; Jonathan I,11,0,15,4
1668464515213,MATH 221A,A00,098031,Ebenfelt; Peter F,13,0,15,2
1668464515652,MATH 231B,A00,098032,Zlatos; Andrej,11,0,15,4
1668464516078,MATH 240B,A00,098033,Ni; Lei,9,0,15,6
1668464516509,MATH 243,A00,098034,Jekel; David Andrew,10,0,10,0
1668464516933,MATH 245A,A00,098035,Nie; Jiawang,0,2,15,16
1668464517364,MATH 248,A00,098036,Bejenaru; Ioan,10,0,10,0
1668464517797,MATH 250B,A00,098037,Spolaor; Luca,14,0,15,1
1668464518222,MATH 258,A00,098038,Ni; Lei,10,0,10,0
1668464518645,MATH 264B,A00,098041,Rhoades; Brendon Patrick,9,0,15,6
1668464519069,MATH 268,A00,098042,Buss; Samuel R,10,0,10,0
1668464519495,MATH 269,A00,098043,Rhoades; Brendon Patrick,10,0,10,0
1668464519932,MATH 270B,A00,098044,Li; Bo,10,0,15,5
1668464520356,MATH 272B,A00,098045,Holst; Michael J,13,0,15,2
1668464520779,MATH 273A,A00,098046,Tian; Xiaochuan,10,0,15,5
1668464521215,MATH 275,A01,098048,Tian; Xiaochuan,6,0,10,4
1668464521642,MATH 278A,A00,098049,Holst; Michael J,8,0,10,2
1668464522070,MATH 278B,A00,098050,Cloninger; Alexander,10,0,10,0
1668464522493,MATH 278C,A00,098051,Nie; Jiawang,6,0,10,4
1668464522920,MATH 280B,A00,098052,Zheng; Tianyi,7,0,15,8
1668464523347,MATH 281B,A00,098053,Bradic; Jelena,0,2,15,15
1668464523775,MATH 282B,A00,098054,Arias-Castro; Ery,0,0,15,15
1668464524212,MATH 285,A00,098055,Fitzsimmons; Patrick J,0,1,15,17
1668464524647,MATH 287B,A00,098056,Arias-Castro; Ery,2,0,15,13
1668464525082,MATH 288,A00,098057,Agarwal; Pooja,9,0,10,1
1668464525082,MATH 288,B00,098058,Zhang; Danna,8,0,10,2
1668464525082,MATH 288,C00,098059,Williams; Ruth J,9,0,10,1
1668464525509,MATH 290B,A00,098060,Roberts; Justin Deritter,13,0,15,2
1668464525940,MATH 292,A00,098061,Belmont; Eva Kinoshita,10,0,10,0
1668464526364,MATH 295,A00,098062,Suk; Andrew Hoon,48,0,50,2
1668464526787,MATH 296,A00,098063,Novak; Jonathan I,20,0,20,0
1668464527218,MATH 297,001,098064,Gamst; Anthony Collins,9997,0,9999,2
1668465031239,COGS 205,A00,101395,Chiba; Andrea,19,0,20,1
1668465031682,COGS 210B,001,101404,Greene; Deanna Jacquelyn,9998,0,9999,1
1668465031682,COGS 210B,002,101417,Xia; Haijun,9999,0,9999,0
1668465031682,COGS 210B,003,101422,Nitz; Douglas A.,9999,0,9999,0
1668465031682,COGS 210B,004,101423,Hollan; James D.,9998,0,9999,1
1668465031682,COGS 210B,005,101424,Deak; Gedeon O.,9998,0,9999,1
1668465031682,COGS 210B,006,101425,Rossano; Federico,9999,0,9999,0
1668465032109,COGS 211B,A00,101427,Coulson; Seana M,9996,0,9999,3
1668465032548,COGS 220,A00,101428,Hollan; James D.,1,8,25,24
1668465032971,COGS 229,A00,101429,Dow; Steven P,17,0,25,8
1668465033404,COGS 230,A00,101430,Klemmer; Scott R,8,0,17,9
1668465033828,COGS 234,A00,101431,Xia; Haijun,2,0,25,23
1668465034255,COGS 260,A00,101432,Kiyonaga; Anastasia,21,0,25,4
1668465034255,COGS 260,B00,101433,Kirsh; David Joel,15,0,25,10
1668465034692,CSE 202,A00,102371,Impagliazzo; Russell,0,58,0,0
1668465035120,CSE 203B,A01,102373,Cheng; Chung Kuan,0,49,0,0
1668465035547,CSE 208,A00,102374,Micciancio; Daniele,0,4,0,0
1668465035979,CSE 209A,A00,112895,Impagliazzo; Russell,0,11,15,15
1668465036410,CSE 209B,A00,108005,Bellare; Mihir,0,6,0,0
1668465036835,CSE 210,A00,113163,Coblenz; Michael J,0,74,0,0
1668465037259,CSE 219,A00,106111,Dow; Steven P,0,5,20,20
1668465037697,CSE 221,A00,102376,Voelker; Geoffrey M.,0,58,0,0
1668465038140,CSE 224,A01,102378,Porter; George M,0,145,0,0
1668465038572,CSE 229A,A00,102379,Savage; Stefan,0,9,0,0
1668465038996,CSE 229C,A00,102380,Munyaka; Imani N. S.,0,8,0,0
1668465039418,CSE 232B,A00,102382,Deutsch; Alin Bernard,0,29,0,0
1668465039843,CSE 234,A01,112904,Kumar; Arun Kumar,0,0,0,0
1668465040275,CSE 237A,A00,102383,Rosing; Tajana Simunic,0,46,0,0
1668465040700,CSE 239A,A00,102384,Deutsch; Alin Bernard,0,12,0,0
1668465041137,CSE 239B,A00,102385,Polikarpova; Nadezhda,0,9,0,0
1668465041578,CSE 240A,A00,102386,Pannuto; Patrick William,0,41,0,0
1668465042006,CSE 240B,A00,102387,Zhao; Jishen,0,42,0,0
1668465042438,CSE 241A,A00,106406,Kang; Mingu,0,6,0,0
1668465042878,CSE 249B,A00,102388,Kahng; Andrew Byun,0,4,8,8
1668465043308,CSE 251B,A01,102392,Cottrell; Garrison W,0,38,0,0
1668465043308,CSE 251B,A02,102393,Cottrell; Garrison W,0,31,0,0
1668465043735,CSE 252B,A00,102394,Ochoa; Benjamin Lawrence,0,49,0,0
1668465044162,CSE 257,A01,102396,Gao; Sicun,0,124,0,0
1668465044595,CSE 272,A00,102397,Li; Tzumao,0,16,0,0
1668465045023,CSE 274,A00,111323,Chern; Albert Ren-Haur,0,11,0,0
1668465045446,CSE 282,A00,102398,Pevzner; Pavel Arkadjevich,0,0,0,0
1668465045871,CSE 284,A00,114175,Gymrek; Melissa Ann,0,16,0,0
1668465046301,CSE 290,A00,102399,Chandraker; Manmohan Krishna,0,10,0,0
1668465046301,CSE 290,B00,102400,Vaccaro; Kristen Marie,0,5,25,25
1668465046301,CSE 290,C00,102414,Pannuto; Patrick William,0,1,25,25
1668465046301,CSE 290,D00,102427,Pevzner; Pavel Arkadjevich,0,0,0,0
1668465046301,CSE 290,E00,102429,Zhao; Jishen,0,4,0,0
1668465046301,CSE 290,F00,102436,Tullsen; Dean Michael,0,4,0,0
1668465046301,CSE 290,G00,102440,Christensen; Henrik I,0,5,20,20
1668465046726,CSE 291,A00,102443,Su; Hao,0,0,0,0
1668465046726,CSE 291,B00,102448,Polikarpova; Nadezhda,0,0,0,0
1668465046726,CSE 291,C00,102453,Vaccaro; Kristen Marie,0,0,0,0
1668465046726,CSE 291,D00,111343,Savage; Stefan,0,0,0,0
1668465046726,CSE 291,E00,116474,Claffy; Kimberly Claire,0,0,0,0
1668465046726,CSE 291,F00,116479,Pasquale; Joseph,0,0,0,0
1668465047164,CSE 293,001,119111,Bafna; Vineet,9999,0,9999,0
1668465047164,CSE 293,002,119118,Bellare; Mihir,9999,0,9999,0
1668465047164,CSE 293,003,119122,Berg-Kirkpatrick; Taylor D,9999,0,9999,0
1668465047164,CSE 293,004,119135,Christensen; Henrik I,9999,0,9999,0
1668465047164,CSE 293,005,119142,Cottrell; Garrison W,9999,0,9999,0
1668465047164,CSE 293,006,119146,Deutsch; Alin Bernard,9999,0,9999,0
1668465047164,CSE 293,007,119159,Esmaeilzadeh; Hadi,9999,0,9999,0
1668465047164,CSE 293,008,119166,Freund; Yoav,9999,0,9999,0
1668465047164,CSE 293,009,119170,Griswold; William G.,9999,0,9999,0
1668465047164,CSE 293,010,119183,Gymrek; Melissa Ann,9999,0,9999,0
1668465047164,CSE 293,011,119190,Heninger; Nadia A,9999,0,9999,0
1668465047164,CSE 293,012,119230,Impagliazzo; Russell,9999,0,9999,0
1668465047164,CSE 293,013,119232,Jhala; Ranjit,9999,0,9999,0
1668465047164,CSE 293,014,119233,Kahng; Andrew Byun,9999,0,9999,0
1668465047164,CSE 293,015,119298,Kane; Daniel Mertz,9999,0,9999,0
1668465047164,CSE 293,016,119299,Kriegman; David J,9999,0,9999,0
1668465047164,CSE 293,017,119300,Kumar; Arun Kumar,9999,0,9999,0
1668465047164,CSE 293,018,119301,Lerner; Sorin,9999,0,9999,0
1668465047164,CSE 293,019,119302,Lovett; Shachar,9999,0,9999,0
1668465047164,CSE 293,020,119303,McAuley; Julian John,9999,0,9999,0
1668465047164,CSE 293,021,119304,Micciancio; Daniele,9999,0,9999,0
1668465047164,CSE 293,022,119367,Orailoglu; Alex,9999,0,9999,0
1668465047164,CSE 293,023,119382,Paturi; Ramamohan,9999,0,9999,0
1668465047164,CSE 293,024,119404,Polikarpova; Nadezhda,9999,0,9999,0
1668465047164,CSE 293,025,119406,Politz; Joseph Gibbs,9999,0,9999,0
1668465047164,CSE 293,026,119411,Porter; George M,9999,0,9999,0
1668465047164,CSE 293,027,119414,Porter; Leonard Emerson,9999,0,9999,0
1668465047164,CSE 293,028,119416,Ramamoorthi; Ravi,9999,0,9999,0
1668465047164,CSE 293,029,119417,Sahoo; Debashis,9999,0,9999,0
1668465047164,CSE 293,030,119420,Saul; Lawrence,9999,0,9999,0
1668465047164,CSE 293,031,119421,Savage; Stefan,9999,0,9999,0
1668465047164,CSE 293,032,119425,Schulze; Jurgen P.,9999,0,9999,0
1668465047164,CSE 293,033,119426,Snoeren; Alex C.,9999,0,9999,0
1668465047164,CSE 293,034,119428,Shang; Jingbo,9999,0,9999,0
1668465047164,CSE 293,035,119430,Stefan; Deian,9999,0,9999,0
1668465047164,CSE 293,036,119431,Su; Hao,9999,0,9999,0
1668465047164,CSE 293,037,119433,Swanson; Steven James,9999,0,9999,0
1668465047164,CSE 293,038,119435,Tullsen; Dean Michael,9999,0,9999,0
1668465047164,CSE 293,039,119483,Voelker; Geoffrey M.,9999,0,9999,0
1668465047164,CSE 293,040,119537,Zhao; Jishen,9999,0,9999,0
1668465047164,CSE 293,041,119538,Zhou; Yuan-Yuan,9999,0,9999,0
1668465047164,CSE 293,042,119539,Gao; Sicun,9999,0,9999,0
1668465047164,CSE 293,043,119540,Weibel; Nadir,9999,0,9999,0
1668465047164,CSE 293,044,119541,Gupta; Rajesh K.,9999,0,9999,0
1668465047164,CSE 293,045,126410,Vaccaro; Kristen Marie,9999,0,9999,0
1668465047164,CSE 293,046,126411,Klemke; Richard,9999,0,9999,0
1668465047590,CSE 294,A00,102459,Voelker; Geoffrey M.,0,2,0,0
1668465047590,CSE 294,B00,111322,Orailoglu; Alex,0,1,0,0
1668465048028,DSE 201,A00,096914,Deutsch; Alin Bernard,30,0,30,0
1668465048470,DSE 210,A00,096915,Dasgupta; Sanjoy,30,0,30,0
1668465048910,DSE 260A,A00,096916,Altintas De Callaf; Ilkay,30,0,30,0
1668465049361,ECE 200,001,103586,Antipa; Nicholas A,9999,0,9999,0
1668465049361,ECE 200,002,103587,Atanasov; Nikolay A.,9999,0,9999,0
1668465049361,ECE 200,003,103588,Bharadia; Dinesh,9999,0,9999,0
1668465049361,ECE 200,004,103589,Cheng; Chung Kuan,9999,0,9999,0
1668465049361,ECE 200,005,103590,Cosman; Pamela C.,9999,0,9999,0
1668465049361,ECE 200,006,103591,Dayeh; Shadi Ahmad,9999,0,9999,0
1668465049361,ECE 200,007,103592,Fainman; Yeshaiahu,9999,0,9999,0
1668465049361,ECE 200,008,103593,Ford; Joseph Earl,9999,0,9999,0
1668465049361,ECE 200,009,103594,Franceschetti; Massimo,9999,0,9999,0
1668465049361,ECE 200,010,103595,Fullerton; Eric E,9999,0,9999,0
1668465049361,ECE 200,011,103596,Galton; Ian A,9999,0,9999,0
1668465049361,ECE 200,012,103597,Gilja; Vikash,9999,0,9999,0
1668465049361,ECE 200,013,103598,Hall; Drew A.,9999,0,9999,0
1668465049361,ECE 200,014,103599,Hsueh; Tzu-Chien,9999,0,9999,0
1668465049361,ECE 200,015,103600,Javidi; Tara,9999,0,9999,0
1668465049361,ECE 200,016,103601,Kahng; Andrew Byun,9999,0,9999,0
1668465049361,ECE 200,017,103602,Kim; Young-Han,9999,0,9999,0
1668465049361,ECE 200,018,103603,Koushanfar; Farinaz,9999,0,9999,0
1668465049361,ECE 200,019,103604,Kuzum; Duygu,9999,0,9999,0
1668465049361,ECE 200,020,103605,Le; Hanh-Phuc,9999,0,9999,0
1668465049361,ECE 200,021,103606,Lin; Bill,9999,0,9999,0
1668465049361,ECE 200,022,103607,Liu; Zhaowei,9998,0,9999,1
1668465049361,ECE 200,023,103608,Lo; Yu-Hwa,9999,0,9999,0
1668465049361,ECE 200,024,103609,Lomakin; Vitaliy,9999,0,9999,0
1668465049361,ECE 200,025,103610,Mercier; Patrick Philip,9999,0,9999,0
1668465049361,ECE 200,026,103611,Meyer; Florian,9999,0,9999,0
1668465049361,ECE 200,027,103612,Milstein; Laurence B.,9999,0,9999,0
1668465049361,ECE 200,028,103613,Mir Arabbaygi; Siavash,9999,0,9999,0
1668465049361,ECE 200,029,103614,Mookherjea; Shayan,9999,0,9999,0
1668465049361,ECE 200,030,103615,Morris; Karcher William,9999,0,9999,0
1668465049361,ECE 200,031,103616,Ng; Tse Nga,9999,0,9999,0
1668465049361,ECE 200,032,103617,Nguyen; Truong Quang,9999,0,9999,0
1668465049361,ECE 200,033,103618,Nomura; Kenji,9999,0,9999,0
1668465049361,ECE 200,034,103619,Orlitsky; Alon,9999,0,9999,0
1668465049361,ECE 200,035,103620,Pal; Piya,9999,0,9999,0
1668465049361,ECE 200,036,103621,Papen; George C.,9999,0,9999,0
1668465049361,ECE 200,037,103622,Radic; Stojan,9999,0,9999,0
1668465049361,ECE 200,038,103623,Rao; Bhaskar D.,9999,0,9999,0
1668465049361,ECE 200,039,103624,Rao; Ramesh R,9999,0,9999,0
1668465049361,ECE 200,040,103625,Rebeiz; Gabriel,9999,0,9999,0
1668465049361,ECE 200,041,103626,Sanford; John R,9999,0,9999,0
1668465049361,ECE 200,042,103627,Siegel; Paul H.,9999,0,9999,0
1668465049361,ECE 200,043,103628,Sievenpiper; Daniel F.,9999,0,9999,0
1668465049361,ECE 200,044,103629,Sworder; David D.,9999,0,9999,0
1668465049361,ECE 200,045,103630,Taur; Yuan,9999,0,9999,0
1668465049361,ECE 200,046,103631,Touri; Behrouz,9999,0,9999,0
1668465049361,ECE 200,047,103632,Trivedi; Mohan M.,9999,0,9999,0
1668465049361,ECE 200,048,103633,Vasconcelos; Nuno,9999,0,9999,0
1668465049361,ECE 200,049,103634,Wang; Xiaolong,9999,0,9999,0
1668465049361,ECE 200,050,103635,Xie; Pengtao,9999,0,9999,0
1668465049361,ECE 200,051,103636,Yip; Michael,9999,0,9999,0
1668465049361,ECE 200,052,103637,Zeger; Kenneth A.,999,0,999,0
1668465049361,ECE 200,053,103638,Zhang; Xinyu,9999,0,9999,0
1668465049361,ECE 200,054,103639,Turakhia; Yatish Girish,9999,0,9999,0
1668465049361,ECE 200,055,103640,Kang; Mingu,9999,0,9999,0
1668465049361,ECE 200,056,103641,Shi; Yuanyuan,9999,0,9999,0
1668465049361,ECE 200,057,103642,Wang; Edward Jay,9999,0,9999,0
1668465049361,ECE 200,058,103643,Zheng; Yang,9999,0,9999,0
1668465049784,ECE 202,A00,103644,Kuzum; Duygu,0,40,0,0
1668465050212,ECE 212BN,A00,103646,Ng; Tse Nga,0,7,0,0
1668465050641,ECE 221,A00,111493,Staff,0,0,0,0
1668465051064,ECE 222B,A00,103647,Lomakin; Vitaliy,0,13,0,0
1668465051510,ECE 230B,A00,103648,Taur; Yuan,0,2,0,0
1668465051949,ECE 238B,A00,103649,Garay; Javier,0,0,0,0
1668465052373,ECE 240B,A00,112900,Fainman; Yeshaiahu,0,5,0,0
1668465052805,ECE 247A,A00,103650,Jokerst; Jesse Vincent,0,4,0,0
1668465053228,ECE 247B,A00,103651,Wang; Joseph,0,10,0,0
1668465053652,ECE 250,A00,103652,Siegel; Paul H.,0,73,0,0
1668465054075,ECE 251A,A00,103654,Rao; Bhaskar D.,0,58,0,0
1668465054522,ECE 257B,A00,103655,Bharadia; Dinesh,0,30,0,0
1668465054956,ECE 258A,A00,103656,Milstein; Laurence B.,0,27,0,0
1668465055394,ECE 260B,A00,103658,Kang; Mingu,0,114,0,0
1668465055821,ECE 264A,A00,103659,Galton; Ian A,0,63,0,0
1668465056245,ECE 265A,A00,103661,Gudem; Prasad S.S.,0,44,0,0
1668465056673,ECE 265D,A00,103662,Gudem; Prasad S.S.,0,21,0,0
1668465057103,ECE 268,A00,103663,Koushanfar; Farinaz,0,39,0,0
1668465057535,ECE 269,A01,103665,Pal; Piya,0,187,0,0
1668465057958,ECE 271B,A00,103666,Vasconcelos; Manuela,0,65,0,0
1668465058382,ECE 276A,A00,103667,Atanasov; Nikolay A.,0,107,0,0
1668465058805,ECE 277,A00,103668,An; Cheolhong,0,135,0,0
1668465059235,ECE 279,A00,117947,Hall; Drew A.,0,21,0,0
1668465060091,ECE 283,A00,103670,Hsueh; Tzu-Chien,0,46,0,0
1668465060518,ECE 284,A00,103671,Turakhia; Yatish Girish,0,37,0,0
1668465060953,ECE 285,A00,103672,Zheng; Yang,0,34,0,0
1668465060953,ECE 285,B00,103673,Sworder; David D.,0,51,0,0
1668465061374,ECE 287,A00,103676,Javidi; Tara,0,7,0,0
1668465061799,MATH 200B,A00,098023,Salehi Golsefidy; Alireza,12,0,15,3
1668465062325,MATH 202B,A00,098024,Rhoades; Brendon Patrick,9,0,15,6
1668465062759,MATH 203B,A00,098025,Oprea; Dragos N.,10,0,15,5
1668465063183,MATH 204B,A00,098026,Sorensen; Claus M,13,0,15,2
1668465063606,MATH 208,A00,098027,Izadi; Elham,7,0,10,3
1668465064040,MATH 209,A00,098028,Pollack; Aaron,10,0,10,0
1668465064464,MATH 211A,A00,112919,Rogalski; Daniel,9,0,10,1
1668465064894,MATH 211B,A00,112920,Seward; Brandon M.,9,0,10,1
1668465065322,MATH 218,A00,098029,Li; Bo,10,0,10,0
1668465065749,MATH 220B,A00,098030,Novak; Jonathan I,11,0,15,4
1668465066174,MATH 221A,A00,098031,Ebenfelt; Peter F,13,0,15,2
1668465066602,MATH 231B,A00,098032,Zlatos; Andrej,11,0,15,4
1668465067031,MATH 240B,A00,098033,Ni; Lei,9,0,15,6
1668465067457,MATH 243,A00,098034,Jekel; David Andrew,10,0,10,0
1668465067881,MATH 245A,A00,098035,Nie; Jiawang,0,2,15,16
1668465068315,MATH 248,A00,098036,Bejenaru; Ioan,10,0,10,0
1668465068750,MATH 250B,A00,098037,Spolaor; Luca,14,0,15,1
1668465069188,MATH 258,A00,098038,Ni; Lei,9,0,10,1
1668465069611,MATH 264B,A00,098041,Rhoades; Brendon Patrick,9,0,15,6
1668465070062,MATH 268,A00,098042,Buss; Samuel R,10,0,10,0
1668465070494,MATH 269,A00,098043,Rhoades; Brendon Patrick,10,0,10,0
1668465070918,MATH 270B,A00,098044,Li; Bo,10,0,15,5
1668465071352,MATH 272B,A00,098045,Holst; Michael J,13,0,15,2
1668465071778,MATH 273A,A00,098046,Tian; Xiaochuan,10,0,15,5
1668465072220,MATH 275,A01,098048,Tian; Xiaochuan,6,0,10,4
1668465072655,MATH 278A,A00,098049,Holst; Michael J,8,0,10,2
1668465073100,MATH 278B,A00,098050,Cloninger; Alexander,10,0,10,0
1668465073536,MATH 278C,A00,098051,Nie; Jiawang,6,0,10,4
1668465073959,MATH 280B,A00,098052,Zheng; Tianyi,7,0,15,8
1668465074383,MATH 281B,A00,098053,Bradic; Jelena,0,2,15,15
1668465074807,MATH 282B,A00,098054,Arias-Castro; Ery,0,0,15,15
1668465075245,MATH 285,A00,098055,Fitzsimmons; Patrick J,0,1,15,17
1668465075683,MATH 287B,A00,098056,Arias-Castro; Ery,2,0,15,13
1668465076124,MATH 288,A00,098057,Agarwal; Pooja,9,0,10,1
1668465076124,MATH 288,B00,098058,Zhang; Danna,8,0,10,2
1668465076124,MATH 288,C00,098059,Williams; Ruth J,9,0,10,1
1668465076554,MATH 290B,A00,098060,Roberts; Justin Deritter,13,0,15,2
1668465076988,MATH 292,A00,098061,Belmont; Eva Kinoshita,10,0,10,0
1668465077418,MATH 295,A00,098062,Suk; Andrew Hoon,48,0,50,2
1668465077844,MATH 296,A00,098063,Novak; Jonathan I,20,0,20,0
1668465078267,MATH 297,001,098064,Gamst; Anthony Collins,9997,0,9999,2
1668465582336,COGS 205,A00,101395,Chiba; Andrea,19,0,20,1
1668465582772,COGS 210B,001,101404,Greene; Deanna Jacquelyn,9998,0,9999,1
1668465582772,COGS 210B,002,101417,Xia; Haijun,9999,0,9999,0
1668465582772,COGS 210B,003,101422,Nitz; Douglas A.,9999,0,9999,0
1668465582772,COGS 210B,004,101423,Hollan; James D.,9998,0,9999,1
1668465582772,COGS 210B,005,101424,Deak; Gedeon O.,9998,0,9999,1
1668465582772,COGS 210B,006,101425,Rossano; Federico,9999,0,9999,0
1668465583212,COGS 211B,A00,101427,Coulson; Seana M,9996,0,9999,3
1668465583643,COGS 220,A00,101428,Hollan; James D.,1,8,25,24
1668465584068,COGS 229,A00,101429,Dow; Steven P,17,0,25,8
1668465584493,COGS 230,A00,101430,Klemmer; Scott R,8,0,17,9
1668465584923,COGS 234,A00,101431,Xia; Haijun,2,0,25,23
1668465585350,COGS 260,A00,101432,Kiyonaga; Anastasia,21,0,25,4
1668465585350,COGS 260,B00,101433,Kirsh; David Joel,15,0,25,10
1668465585849,CSE 202,A00,102371,Impagliazzo; Russell,0,58,0,0
1668465586292,CSE 203B,A01,102373,Cheng; Chung Kuan,0,49,0,0
1668465586733,CSE 208,A00,102374,Micciancio; Daniele,0,4,0,0
1668465587160,CSE 209A,A00,112895,Impagliazzo; Russell,0,11,15,15
1668465587604,CSE 209B,A00,108005,Bellare; Mihir,0,6,0,0
1668465588038,CSE 210,A00,113163,Coblenz; Michael J,0,75,0,0
1668465588468,CSE 219,A00,106111,Dow; Steven P,0,5,20,20
1668465588896,CSE 221,A00,102376,Voelker; Geoffrey M.,0,59,0,0
1668465589322,CSE 224,A01,102378,Porter; George M,0,148,0,0
1668465589752,CSE 229A,A00,102379,Savage; Stefan,0,9,0,0
1668465590177,CSE 229C,A00,102380,Munyaka; Imani N. S.,0,8,0,0
1668465590608,CSE 232B,A00,102382,Deutsch; Alin Bernard,0,29,0,0
1668465591033,CSE 234,A01,112904,Kumar; Arun Kumar,0,0,0,0
1668465591465,CSE 237A,A00,102383,Rosing; Tajana Simunic,0,46,0,0
1668465591888,CSE 239A,A00,102384,Deutsch; Alin Bernard,0,12,0,0
1668465592311,CSE 239B,A00,102385,Polikarpova; Nadezhda,0,9,0,0
1668465592736,CSE 240A,A00,102386,Pannuto; Patrick William,0,41,0,0
1668465593160,CSE 240B,A00,102387,Zhao; Jishen,0,42,0,0
1668465593588,CSE 241A,A00,106406,Kang; Mingu,0,6,0,0
1668465594018,CSE 249B,A00,102388,Kahng; Andrew Byun,0,4,8,8
1668465594442,CSE 251B,A01,102392,Cottrell; Garrison W,0,39,0,0
1668465594442,CSE 251B,A02,102393,Cottrell; Garrison W,0,32,0,0
1668465594865,CSE 252B,A00,102394,Ochoa; Benjamin Lawrence,0,49,0,0
1668465595301,CSE 257,A01,102396,Gao; Sicun,0,125,0,0
1668465595726,CSE 272,A00,102397,Li; Tzumao,0,16,0,0
1668465596149,CSE 274,A00,111323,Chern; Albert Ren-Haur,0,11,0,0
1668465596576,CSE 282,A00,102398,Pevzner; Pavel Arkadjevich,0,0,0,0
1668465596998,CSE 284,A00,114175,Gymrek; Melissa Ann,0,16,0,0
1668465597430,CSE 290,A00,102399,Chandraker; Manmohan Krishna,0,10,0,0
1668465597430,CSE 290,B00,102400,Vaccaro; Kristen Marie,0,5,25,25
1668465597430,CSE 290,C00,102414,Pannuto; Patrick William,0,1,25,25
1668465597430,CSE 290,D00,102427,Pevzner; Pavel Arkadjevich,0,0,0,0
1668465597430,CSE 290,E00,102429,Zhao; Jishen,0,4,0,0
1668465597430,CSE 290,F00,102436,Tullsen; Dean Michael,0,4,0,0
1668465597430,CSE 290,G00,102440,Christensen; Henrik I,0,6,20,20
1668465597862,CSE 291,A00,102443,Su; Hao,0,0,0,0
1668465597862,CSE 291,B00,102448,Polikarpova; Nadezhda,0,0,0,0
1668465597862,CSE 291,C00,102453,Vaccaro; Kristen Marie,0,0,0,0
1668465597862,CSE 291,D00,111343,Savage; Stefan,0,0,0,0
1668465597862,CSE 291,E00,116474,Claffy; Kimberly Claire,0,0,0,0
1668465597862,CSE 291,F00,116479,Pasquale; Joseph,0,0,0,0
1668465598289,CSE 293,001,119111,Bafna; Vineet,9999,0,9999,0
1668465598289,CSE 293,002,119118,Bellare; Mihir,9999,0,9999,0
1668465598289,CSE 293,003,119122,Berg-Kirkpatrick; Taylor D,9999,0,9999,0
1668465598289,CSE 293,004,119135,Christensen; Henrik I,9999,0,9999,0
1668465598289,CSE 293,005,119142,Cottrell; Garrison W,9999,0,9999,0
1668465598289,CSE 293,006,119146,Deutsch; Alin Bernard,9999,0,9999,0
1668465598289,CSE 293,007,119159,Esmaeilzadeh; Hadi,9999,0,9999,0
1668465598289,CSE 293,008,119166,Freund; Yoav,9999,0,9999,0
1668465598289,CSE 293,009,119170,Griswold; William G.,9999,0,9999,0
1668465598289,CSE 293,010,119183,Gymrek; Melissa Ann,9999,0,9999,0
1668465598289,CSE 293,011,119190,Heninger; Nadia A,9999,0,9999,0
1668465598289,CSE 293,012,119230,Impagliazzo; Russell,9999,0,9999,0
1668465598289,CSE 293,013,119232,Jhala; Ranjit,9999,0,9999,0
1668465598289,CSE 293,014,119233,Kahng; Andrew Byun,9999,0,9999,0
1668465598289,CSE 293,015,119298,Kane; Daniel Mertz,9999,0,9999,0
1668465598289,CSE 293,016,119299,Kriegman; David J,9999,0,9999,0
1668465598289,CSE 293,017,119300,Kumar; Arun Kumar,9999,0,9999,0
1668465598289,CSE 293,018,119301,Lerner; Sorin,9999,0,9999,0
1668465598289,CSE 293,019,119302,Lovett; Shachar,9999,0,9999,0
1668465598289,CSE 293,020,119303,McAuley; Julian John,9999,0,9999,0
1668465598289,CSE 293,021,119304,Micciancio; Daniele,9999,0,9999,0
1668465598289,CSE 293,022,119367,Orailoglu; Alex,9999,0,9999,0
1668465598289,CSE 293,023,119382,Paturi; Ramamohan,9999,0,9999,0
1668465598289,CSE 293,024,119404,Polikarpova; Nadezhda,9999,0,9999,0
1668465598289,CSE 293,025,119406,Politz; Joseph Gibbs,9999,0,9999,0
1668465598289,CSE 293,026,119411,Porter; George M,9999,0,9999,0
1668465598289,CSE 293,027,119414,Porter; Leonard Emerson,9999,0,9999,0
1668465598289,CSE 293,028,119416,Ramamoorthi; Ravi,9999,0,9999,0
1668465598289,CSE 293,029,119417,Sahoo; Debashis,9999,0,9999,0
1668465598289,CSE 293,030,119420,Saul; Lawrence,9999,0,9999,0
1668465598289,CSE 293,031,119421,Savage; Stefan,9999,0,9999,0
1668465598289,CSE 293,032,119425,Schulze; Jurgen P.,9999,0,9999,0
1668465598289,CSE 293,033,119426,Snoeren; Alex C.,9999,0,9999,0
1668465598289,CSE 293,034,119428,Shang; Jingbo,9999,0,9999,0
1668465598289,CSE 293,035,119430,Stefan; Deian,9999,0,9999,0
1668465598289,CSE 293,036,119431,Su; Hao,9999,0,9999,0
1668465598289,CSE 293,037,119433,Swanson; Steven James,9999,0,9999,0
1668465598289,CSE 293,038,119435,Tullsen; Dean Michael,9999,0,9999,0
1668465598289,CSE 293,039,119483,Voelker; Geoffrey M.,9999,0,9999,0
1668465598289,CSE 293,040,119537,Zhao; Jishen,9999,0,9999,0
1668465598289,CSE 293,041,119538,Zhou; Yuan-Yuan,9999,0,9999,0
1668465598289,CSE 293,042,119539,Gao; Sicun,9999,0,9999,0
1668465598289,CSE 293,043,119540,Weibel; Nadir,9999,0,9999,0
1668465598289,CSE 293,044,119541,Gupta; Rajesh K.,9999,0,9999,0
1668465598289,CSE 293,045,126410,Vaccaro; Kristen Marie,9999,0,9999,0
1668465598289,CSE 293,046,126411,Klemke; Richard,9999,0,9999,0
1668465598714,CSE 294,A00,102459,Voelker; Geoffrey M.,0,2,0,0
1668465598714,CSE 294,B00,111322,Orailoglu; Alex,0,1,0,0
1668465599139,DSE 201,A00,096914,Deutsch; Alin Bernard,30,0,30,0
1668465599563,DSE 210,A00,096915,Dasgupta; Sanjoy,30,0,30,0
1668465599985,DSE 260A,A00,096916,Altintas De Callaf; Ilkay,30,0,30,0
1668465600470,ECE 200,001,103586,Antipa; Nicholas A,9999,0,9999,0
1668465600470,ECE 200,002,103587,Atanasov; Nikolay A.,9999,0,9999,0
1668465600470,ECE 200,003,103588,Bharadia; Dinesh,9999,0,9999,0
1668465600470,ECE 200,004,103589,Cheng; Chung Kuan,9999,0,9999,0
1668465600470,ECE 200,005,103590,Cosman; Pamela C.,9999,0,9999,0
1668465600470,ECE 200,006,103591,Dayeh; Shadi Ahmad,9999,0,9999,0
1668465600470,ECE 200,007,103592,Fainman; Yeshaiahu,9999,0,9999,0
1668465600470,ECE 200,008,103593,Ford; Joseph Earl,9999,0,9999,0
1668465600470,ECE 200,009,103594,Franceschetti; Massimo,9999,0,9999,0
1668465600470,ECE 200,010,103595,Fullerton; Eric E,9999,0,9999,0
1668465600470,ECE 200,011,103596,Galton; Ian A,9999,0,9999,0
1668465600470,ECE 200,012,103597,Gilja; Vikash,9999,0,9999,0
1668465600470,ECE 200,013,103598,Hall; Drew A.,9999,0,9999,0
1668465600470,ECE 200,014,103599,Hsueh; Tzu-Chien,9999,0,9999,0
1668465600470,ECE 200,015,103600,Javidi; Tara,9999,0,9999,0
1668465600470,ECE 200,016,103601,Kahng; Andrew Byun,9999,0,9999,0
1668465600470,ECE 200,017,103602,Kim; Young-Han,9999,0,9999,0
1668465600470,ECE 200,018,103603,Koushanfar; Farinaz,9999,0,9999,0
1668465600470,ECE 200,019,103604,Kuzum; Duygu,9999,0,9999,0
1668465600470,ECE 200,020,103605,Le; Hanh-Phuc,9999,0,9999,0
1668465600470,ECE 200,021,103606,Lin; Bill,9999,0,9999,0
1668465600470,ECE 200,022,103607,Liu; Zhaowei,9998,0,9999,1
1668465600470,ECE 200,023,103608,Lo; Yu-Hwa,9999,0,9999,0
1668465600470,ECE 200,024,103609,Lomakin; Vitaliy,9999,0,9999,0
1668465600470,ECE 200,025,103610,Mercier; Patrick Philip,9999,0,9999,0
1668465600470,ECE 200,026,103611,Meyer; Florian,9999,0,9999,0
1668465600470,ECE 200,027,103612,Milstein; Laurence B.,9999,0,9999,0
1668465600470,ECE 200,028,103613,Mir Arabbaygi; Siavash,9999,0,9999,0
1668465600470,ECE 200,029,103614,Mookherjea; Shayan,9999,0,9999,0
1668465600470,ECE 200,030,103615,Morris; Karcher William,9999,0,9999,0
1668465600470,ECE 200,031,103616,Ng; Tse Nga,9999,0,9999,0
1668465600470,ECE 200,032,103617,Nguyen; Truong Quang,9999,0,9999,0
1668465600470,ECE 200,033,103618,Nomura; Kenji,9999,0,9999,0
1668465600470,ECE 200,034,103619,Orlitsky; Alon,9999,0,9999,0
1668465600470,ECE 200,035,103620,Pal; Piya,9999,0,9999,0
1668465600470,ECE 200,036,103621,Papen; George C.,9999,0,9999,0
1668465600470,ECE 200,037,103622,Radic; Stojan,9999,0,9999,0
1668465600470,ECE 200,038,103623,Rao; Bhaskar D.,9999,0,9999,0
1668465600470,ECE 200,039,103624,Rao; Ramesh R,9999,0,9999,0
1668465600470,ECE 200,040,103625,Rebeiz; Gabriel,9999,0,9999,0
1668465600470,ECE 200,041,103626,Sanford; John R,9999,0,9999,0
1668465600470,ECE 200,042,103627,Siegel; Paul H.,9999,0,9999,0
1668465600470,ECE 200,043,103628,Sievenpiper; Daniel F.,9999,0,9999,0
1668465600470,ECE 200,044,103629,Sworder; David D.,9999,0,9999,0
1668465600470,ECE 200,045,103630,Taur; Yuan,9999,0,9999,0
1668465600470,ECE 200,046,103631,Touri; Behrouz,9999,0,9999,0
1668465600470,ECE 200,047,103632,Trivedi; Mohan M.,9999,0,9999,0
1668465600470,ECE 200,048,103633,Vasconcelos; Nuno,9999,0,9999,0
1668465600470,ECE 200,049,103634,Wang; Xiaolong,9999,0,9999,0
1668465600470,ECE 200,050,103635,Xie; Pengtao,9999,0,9999,0
1668465600470,ECE 200,051,103636,Yip; Michael,9999,0,9999,0
1668465600470,ECE 200,052,103637,Zeger; Kenneth A.,999,0,999,0
1668465600470,ECE 200,053,103638,Zhang; Xinyu,9999,0,9999,0
1668465600470,ECE 200,054,103639,Turakhia; Yatish Girish,9999,0,9999,0
1668465600470,ECE 200,055,103640,Kang; Mingu,9999,0,9999,0
1668465600470,ECE 200,056,103641,Shi; Yuanyuan,9999,0,9999,0
1668465600470,ECE 200,057,103642,Wang; Edward Jay,9999,0,9999,0
1668465600470,ECE 200,058,103643,Zheng; Yang,9999,0,9999,0
1668465600894,ECE 202,A00,103644,Kuzum; Duygu,0,40,0,0
1668465601320,ECE 212BN,A00,103646,Ng; Tse Nga,0,7,0,0
1668465601754,ECE 221,A00,111493,Staff,0,0,0,0
1668465602179,ECE 222B,A00,103647,Lomakin; Vitaliy,0,13,0,0
1668465602604,ECE 230B,A00,103648,Taur; Yuan,0,2,0,0
1668465603033,ECE 238B,A00,103649,Garay; Javier,0,0,0,0
1668465603456,ECE 240B,A00,112900,Fainman; Yeshaiahu,0,5,0,0
1668465603895,ECE 247A,A00,103650,Jokerst; Jesse Vincent,0,4,0,0
1668465604322,ECE 247B,A00,103651,Wang; Joseph,0,10,0,0
1668465604749,ECE 250,A00,103652,Siegel; Paul H.,0,73,0,0
1668465605195,ECE 251A,A00,103654,Rao; Bhaskar D.,0,58,0,0
1668465605619,ECE 257B,A00,103655,Bharadia; Dinesh,0,30,0,0
1668465606061,ECE 258A,A00,103656,Milstein; Laurence B.,0,27,0,0
1668465606485,ECE 260B,A00,103658,Kang; Mingu,0,115,0,0
1668465606908,ECE 264A,A00,103659,Galton; Ian A,0,63,0,0
1668465607332,ECE 265A,A00,103661,Gudem; Prasad S.S.,0,45,0,0
1668465607769,ECE 265D,A00,103662,Gudem; Prasad S.S.,0,21,0,0
1668465608192,ECE 268,A00,103663,Koushanfar; Farinaz,0,40,0,0
1668465608626,ECE 269,A01,103665,Pal; Piya,0,188,0,0
1668465609059,ECE 271B,A00,103666,Vasconcelos; Manuela,0,65,0,0
1668465609487,ECE 276A,A00,103667,Atanasov; Nikolay A.,0,107,0,0
1668465609922,ECE 277,A00,103668,An; Cheolhong,0,136,0,0
1668465610346,ECE 279,A00,117947,Hall; Drew A.,0,21,0,0
1668465611195,ECE 283,A00,103670,Hsueh; Tzu-Chien,0,46,0,0
1668465611619,ECE 284,A00,103671,Turakhia; Yatish Girish,0,37,0,0
1668465612046,ECE 285,A00,103672,Zheng; Yang,0,34,0,0
1668465612046,ECE 285,B00,103673,Sworder; David D.,0,51,0,0
1668465612471,ECE 287,A00,103676,Javidi; Tara,0,8,0,0
1668465612898,MATH 200B,A00,098023,Salehi Golsefidy; Alireza,12,0,15,3
1668465613338,MATH 202B,A00,098024,Rhoades; Brendon Patrick,9,0,15,6
1668465613774,MATH 203B,A00,098025,Oprea; Dragos N.,10,0,15,5
1668465614200,MATH 204B,A00,098026,Sorensen; Claus M,13,0,15,2
1668465614625,MATH 208,A00,098027,Izadi; Elham,7,0,10,3
1668465615063,MATH 209,A00,098028,Pollack; Aaron,10,0,10,0
1668465615486,MATH 211A,A00,112919,Rogalski; Daniel,9,0,10,1
1668465615915,MATH 211B,A00,112920,Seward; Brandon M.,9,0,10,1
1668465616337,MATH 218,A00,098029,Li; Bo,10,0,10,0
1668465616778,MATH 220B,A00,098030,Novak; Jonathan I,11,0,15,4
1668465617207,MATH 221A,A00,098031,Ebenfelt; Peter F,13,0,15,2
1668465617647,MATH 231B,A00,098032,Zlatos; Andrej,11,0,15,4
1668465618072,MATH 240B,A00,098033,Ni; Lei,9,0,15,6
1668465618498,MATH 243,A00,098034,Jekel; David Andrew,10,0,10,0
1668465618922,MATH 245A,A00,098035,Nie; Jiawang,0,2,15,16
1668465619346,MATH 248,A00,098036,Bejenaru; Ioan,10,0,10,0
1668465619772,MATH 250B,A00,098037,Spolaor; Luca,14,0,15,1
1668465620196,MATH 258,A00,098038,Ni; Lei,9,0,10,1
1668465620625,MATH 264B,A00,098041,Rhoades; Brendon Patrick,9,0,15,6
1668465621050,MATH 268,A00,098042,Buss; Samuel R,10,0,10,0
1668465621472,MATH 269,A00,098043,Rhoades; Brendon Patrick,10,0,10,0
1668465621896,MATH 270B,A00,098044,Li; Bo,10,0,15,5
1668465622321,MATH 272B,A00,098045,Holst; Michael J,13,0,15,2
1668465622757,MATH 273A,A00,098046,Tian; Xiaochuan,10,0,15,5
1668465623181,MATH 275,A01,098048,Tian; Xiaochuan,6,0,10,4
1668465623604,MATH 278A,A00,098049,Holst; Michael J,8,0,10,2
1668465624031,MATH 278B,A00,098050,Cloninger; Alexander,10,0,10,0
1668465624457,MATH 278C,A00,098051,Nie; Jiawang,6,0,10,4
1668465624896,MATH 280B,A00,098052,Zheng; Tianyi,7,0,15,8
1668465625321,MATH 281B,A00,098053,Bradic; Jelena,0,2,15,15
1668465625744,MATH 282B,A00,098054,Arias-Castro; Ery,0,0,15,15
1668465626173,MATH 285,A00,098055,Fitzsimmons; Patrick J,0,1,15,17
1668465626604,MATH 287B,A00,098056,Arias-Castro; Ery,2,0,15,13
1668465627027,MATH 288,A00,098057,Agarwal; Pooja,9,0,10,1
1668465627027,MATH 288,B00,098058,Zhang; Danna,8,0,10,2
1668465627027,MATH 288,C00,098059,Williams; Ruth J,9,0,10,1
1668465627457,MATH 290B,A00,098060,Roberts; Justin Deritter,13,0,15,2
1668465627883,MATH 292,A00,098061,Belmont; Eva Kinoshita,10,0,10,0
1668465628319,MATH 295,A00,098062,Suk; Andrew Hoon,48,0,50,2
1668465628752,MATH 296,A00,098063,Novak; Jonathan I,20,0,20,0
1668465629294,MATH 297,001,098064,Gamst; Anthony Collins,9997,0,9999,2
1668466145782,COGS 205,A00,101395,Chiba; Andrea,19,0,20,1
1668466146207,COGS 210B,001,101404,Greene; Deanna Jacquelyn,9998,0,9999,1
1668466146207,COGS 210B,002,101417,Xia; Haijun,9999,0,9999,0
1668466146207,COGS 210B,003,101422,Nitz; Douglas A.,9999,0,9999,0
1668466146207,COGS 210B,004,101423,Hollan; James D.,9998,0,9999,1
1668466146207,COGS 210B,005,101424,Deak; Gedeon O.,9998,0,9999,1
1668466146207,COGS 210B,006,101425,Rossano; Federico,9999,0,9999,0
1668466146642,COGS 211B,A00,101427,Coulson; Seana M,9996,0,9999,3
1668466147067,COGS 220,A00,101428,Hollan; James D.,1,8,25,24
1668466147498,COGS 229,A00,101429,Dow; Steven P,17,0,25,8
1668466147926,COGS 230,A00,101430,Klemmer; Scott R,8,0,17,9
1668466148353,COGS 234,A00,101431,Xia; Haijun,2,0,25,23
1668466148777,COGS 260,A00,101432,Kiyonaga; Anastasia,21,0,25,4
1668466148777,COGS 260,B00,101433,Kirsh; David Joel,15,0,25,10
1668466149201,CSE 202,A00,102371,Impagliazzo; Russell,0,58,0,0
1668466149638,CSE 203B,A01,102373,Cheng; Chung Kuan,0,49,0,0
1668466150065,CSE 208,A00,102374,Micciancio; Daniele,0,4,0,0
1668466150498,CSE 209A,A00,112895,Impagliazzo; Russell,0,11,15,15
1668466150923,CSE 209B,A00,108005,Bellare; Mihir,0,6,0,0
1668466151347,CSE 210,A00,113163,Coblenz; Michael J,0,75,0,0
1668466151772,CSE 219,A00,106111,Dow; Steven P,0,5,20,20
1668466152201,CSE 221,A00,102376,Voelker; Geoffrey M.,0,60,0,0
1668466152628,CSE 224,A01,102378,Porter; George M,0,148,0,0
1668466153061,CSE 229A,A00,102379,Savage; Stefan,0,9,0,0
1668466153508,CSE 229C,A00,102380,Munyaka; Imani N. S.,0,8,0,0
1668466153943,CSE 232B,A00,102382,Deutsch; Alin Bernard,0,29,0,0
1668466154381,CSE 234,A01,112904,Kumar; Arun Kumar,0,0,0,0
1668466154804,CSE 237A,A00,102383,Rosing; Tajana Simunic,0,46,0,0
1668466155226,CSE 239A,A00,102384,Deutsch; Alin Bernard,0,12,0,0
1668466155658,CSE 239B,A00,102385,Polikarpova; Nadezhda,0,9,0,0
1668466156087,CSE 240A,A00,102386,Pannuto; Patrick William,0,41,0,0
1668466156514,CSE 240B,A00,102387,Zhao; Jishen,0,43,0,0
1668466156954,CSE 241A,A00,106406,Kang; Mingu,0,6,0,0
1668466157388,CSE 249B,A00,102388,Kahng; Andrew Byun,0,4,8,8
1668466157814,CSE 251B,A01,102392,Cottrell; Garrison W,0,38,0,0
1668466157814,CSE 251B,A02,102393,Cottrell; Garrison W,0,32,0,0
1668466158247,CSE 252B,A00,102394,Ochoa; Benjamin Lawrence,0,50,0,0
1668466158674,CSE 257,A01,102396,Gao; Sicun,0,125,0,0
1668466159103,CSE 272,A00,102397,Li; Tzumao,0,16,0,0
1668466159525,CSE 274,A00,111323,Chern; Albert Ren-Haur,0,11,0,0
1668466159950,CSE 282,A00,102398,Pevzner; Pavel Arkadjevich,0,0,0,0
1668466160377,CSE 284,A00,114175,Gymrek; Melissa Ann,0,16,0,0
1668466160805,CSE 290,A00,102399,Chandraker; Manmohan Krishna,0,10,0,0
1668466160805,CSE 290,B00,102400,Vaccaro; Kristen Marie,0,5,25,25
1668466160805,CSE 290,C00,102414,Pannuto; Patrick William,0,1,25,25
1668466160805,CSE 290,D00,102427,Pevzner; Pavel Arkadjevich,0,0,0,0
1668466160805,CSE 290,E00,102429,Zhao; Jishen,0,4,0,0
1668466160805,CSE 290,F00,102436,Tullsen; Dean Michael,0,4,0,0
1668466160805,CSE 290,G00,102440,Christensen; Henrik I,0,6,20,20
1668466161230,CSE 291,A00,102443,Su; Hao,0,0,0,0
1668466161230,CSE 291,B00,102448,Polikarpova; Nadezhda,0,0,0,0
1668466161230,CSE 291,C00,102453,Vaccaro; Kristen Marie,0,0,0,0
1668466161230,CSE 291,D00,111343,Savage; Stefan,0,0,0,0
1668466161230,CSE 291,E00,116474,Claffy; Kimberly Claire,0,0,0,0
1668466161230,CSE 291,F00,116479,Pasquale; Joseph,0,0,0,0
1668466161659,CSE 293,001,119111,Bafna; Vineet,9999,0,9999,0
1668466161659,CSE 293,002,119118,Bellare; Mihir,9999,0,9999,0
1668466161659,CSE 293,003,119122,Berg-Kirkpatrick; Taylor D,9999,0,9999,0
1668466161659,CSE 293,004,119135,Christensen; Henrik I,9999,0,9999,0
1668466161659,CSE 293,005,119142,Cottrell; Garrison W,9999,0,9999,0
1668466161659,CSE 293,006,119146,Deutsch; Alin Bernard,9999,0,9999,0
1668466161659,CSE 293,007,119159,Esmaeilzadeh; Hadi,9999,0,9999,0
1668466161659,CSE 293,008,119166,Freund; Yoav,9999,0,9999,0
1668466161659,CSE 293,009,119170,Griswold; William G.,9999,0,9999,0
1668466161659,CSE 293,010,119183,Gymrek; Melissa Ann,9999,0,9999,0
1668466161659,CSE 293,011,119190,Heninger; Nadia A,9999,0,9999,0
1668466161659,CSE 293,012,119230,Impagliazzo; Russell,9999,0,9999,0
1668466161659,CSE 293,013,119232,Jhala; Ranjit,9999,0,9999,0
1668466161659,CSE 293,014,119233,Kahng; Andrew Byun,9999,0,9999,0
1668466161659,CSE 293,015,119298,Kane; Daniel Mertz,9999,0,9999,0
1668466161659,CSE 293,016,119299,Kriegman; David J,9999,0,9999,0
1668466161659,CSE 293,017,119300,Kumar; Arun Kumar,9999,0,9999,0
1668466161659,CSE 293,018,119301,Lerner; Sorin,9999,0,9999,0
1668466161659,CSE 293,019,119302,Lovett; Shachar,9999,0,9999,0
1668466161659,CSE 293,020,119303,McAuley; Julian John,9999,0,9999,0
1668466161659,CSE 293,021,119304,Micciancio; Daniele,9999,0,9999,0
1668466161659,CSE 293,022,119367,Orailoglu; Alex,9999,0,9999,0
1668466161659,CSE 293,023,119382,Paturi; Ramamohan,9999,0,9999,0
1668466161659,CSE 293,024,119404,Polikarpova; Nadezhda,9999,0,9999,0
1668466161659,CSE 293,025,119406,Politz; Joseph Gibbs,9999,0,9999,0
1668466161659,CSE 293,026,119411,Porter; George M,9999,0,9999,0
1668466161659,CSE 293,027,119414,Porter; Leonard Emerson,9999,0,9999,0
1668466161659,CSE 293,028,119416,Ramamoorthi; Ravi,9999,0,9999,0
1668466161659,CSE 293,029,119417,Sahoo; Debashis,9999,0,9999,0
1668466161659,CSE 293,030,119420,Saul; Lawrence,9999,0,9999,0
1668466161659,CSE 293,031,119421,Savage; Stefan,9999,0,9999,0
1668466161659,CSE 293,032,119425,Schulze; Jurgen P.,9999,0,9999,0
1668466161659,CSE 293,033,119426,Snoeren; Alex C.,9999,0,9999,0
1668466161659,CSE 293,034,119428,Shang; Jingbo,9999,0,9999,0
1668466161659,CSE 293,035,119430,Stefan; Deian,9999,0,9999,0
1668466161659,CSE 293,036,119431,Su; Hao,9999,0,9999,0
1668466161659,CSE 293,037,119433,Swanson; Steven James,9999,0,9999,0
1668466161659,CSE 293,038,119435,Tullsen; Dean Michael,9999,0,9999,0
1668466161659,CSE 293,039,119483,Voelker; Geoffrey M.,9999,0,9999,0
1668466161659,CSE 293,040,119537,Zhao; Jishen,9999,0,9999,0
1668466161659,CSE 293,041,119538,Zhou; Yuan-Yuan,9999,0,9999,0
1668466161659,CSE 293,042,119539,Gao; Sicun,9999,0,9999,0
1668466161659,CSE 293,043,119540,Weibel; Nadir,9999,0,9999,0
1668466161659,CSE 293,044,119541,Gupta; Rajesh K.,9999,0,9999,0
1668466161659,CSE 293,045,126410,Vaccaro; Kristen Marie,9999,0,9999,0
1668466161659,CSE 293,046,126411,Klemke; Richard,9999,0,9999,0
1668466162082,CSE 294,A00,102459,Voelker; Geoffrey M.,0,2,0,0
1668466162082,CSE 294,B00,111322,Orailoglu; Alex,0,1,0,0
1668466162505,DSE 201,A00,096914,Deutsch; Alin Bernard,30,0,30,0
1668466162929,DSE 210,A00,096915,Dasgupta; Sanjoy,30,0,30,0
1668466163353,DSE 260A,A00,096916,Altintas De Callaf; Ilkay,30,0,30,0
1668466163781,ECE 200,001,103586,Antipa; Nicholas A,9999,0,9999,0
1668466163781,ECE 200,002,103587,Atanasov; Nikolay A.,9999,0,9999,0
1668466163781,ECE 200,003,103588,Bharadia; Dinesh,9999,0,9999,0
1668466163781,ECE 200,004,103589,Cheng; Chung Kuan,9999,0,9999,0
1668466163781,ECE 200,005,103590,Cosman; Pamela C.,9999,0,9999,0
1668466163781,ECE 200,006,103591,Dayeh; Shadi Ahmad,9999,0,9999,0
1668466163781,ECE 200,007,103592,Fainman; Yeshaiahu,9999,0,9999,0
1668466163781,ECE 200,008,103593,Ford; Joseph Earl,9999,0,9999,0
1668466163781,ECE 200,009,103594,Franceschetti; Massimo,9999,0,9999,0
1668466163781,ECE 200,010,103595,Fullerton; Eric E,9999,0,9999,0
1668466163781,ECE 200,011,103596,Galton; Ian A,9999,0,9999,0
1668466163781,ECE 200,012,103597,Gilja; Vikash,9999,0,9999,0
1668466163781,ECE 200,013,103598,Hall; Drew A.,9999,0,9999,0
1668466163781,ECE 200,014,103599,Hsueh; Tzu-Chien,9999,0,9999,0
1668466163781,ECE 200,015,103600,Javidi; Tara,9999,0,9999,0
1668466163781,ECE 200,016,103601,Kahng; Andrew Byun,9999,0,9999,0
1668466163781,ECE 200,017,103602,Kim; Young-Han,9999,0,9999,0
1668466163781,ECE 200,018,103603,Koushanfar; Farinaz,9999,0,9999,0
1668466163781,ECE 200,019,103604,Kuzum; Duygu,9999,0,9999,0
1668466163781,ECE 200,020,103605,Le; Hanh-Phuc,9999,0,9999,0
1668466163781,ECE 200,021,103606,Lin; Bill,9999,0,9999,0
1668466163781,ECE 200,022,103607,Liu; Zhaowei,9998,0,9999,1
1668466163781,ECE 200,023,103608,Lo; Yu-Hwa,9999,0,9999,0
1668466163781,ECE 200,024,103609,Lomakin; Vitaliy,9999,0,9999,0
1668466163781,ECE 200,025,103610,Mercier; Patrick Philip,9999,0,9999,0
1668466163781,ECE 200,026,103611,Meyer; Florian,9999,0,9999,0
1668466163781,ECE 200,027,103612,Milstein; Laurence B.,9999,0,9999,0
1668466163781,ECE 200,028,103613,Mir Arabbaygi; Siavash,9999,0,9999,0
1668466163781,ECE 200,029,103614,Mookherjea; Shayan,9999,0,9999,0
1668466163781,ECE 200,030,103615,Morris; Karcher William,9999,0,9999,0
1668466163781,ECE 200,031,103616,Ng; Tse Nga,9999,0,9999,0
1668466163781,ECE 200,032,103617,Nguyen; Truong Quang,9999,0,9999,0
1668466163781,ECE 200,033,103618,Nomura; Kenji,9999,0,9999,0
1668466163781,ECE 200,034,103619,Orlitsky; Alon,9999,0,9999,0
1668466163781,ECE 200,035,103620,Pal; Piya,9999,0,9999,0
1668466163781,ECE 200,036,103621,Papen; George C.,9999,0,9999,0
1668466163781,ECE 200,037,103622,Radic; Stojan,9999,0,9999,0
1668466163781,ECE 200,038,103623,Rao; Bhaskar D.,9999,0,9999,0
1668466163781,ECE 200,039,103624,Rao; Ramesh R,9999,0,9999,0
1668466163781,ECE 200,040,103625,Rebeiz; Gabriel,9999,0,9999,0
1668466163781,ECE 200,041,103626,Sanford; John R,9999,0,9999,0
1668466163781,ECE 200,042,103627,Siegel; Paul H.,9999,0,9999,0
1668466163781,ECE 200,043,103628,Sievenpiper; Daniel F.,9999,0,9999,0
1668466163781,ECE 200,044,103629,Sworder; David D.,9999,0,9999,0
1668466163781,ECE 200,045,103630,Taur; Yuan,9999,0,9999,0
1668466163781,ECE 200,046,103631,Touri; Behrouz,9999,0,9999,0
1668466163781,ECE 200,047,103632,Trivedi; Mohan M.,9999,0,9999,0
1668466163781,ECE 200,048,103633,Vasconcelos; Nuno,9999,0,9999,0
1668466163781,ECE 200,049,103634,Wang; Xiaolong,9999,0,9999,0
1668466163781,ECE 200,050,103635,Xie; Pengtao,9999,0,9999,0
1668466163781,ECE 200,051,103636,Yip; Michael,9999,0,9999,0
1668466163781,ECE 200,052,103637,Zeger; Kenneth A.,999,0,999,0
1668466163781,ECE 200,053,103638,Zhang; Xinyu,9999,0,9999,0
1668466163781,ECE 200,054,103639,Turakhia; Yatish Girish,9999,0,9999,0
1668466163781,ECE 200,055,103640,Kang; Mingu,9999,0,9999,0
1668466163781,ECE 200,056,103641,Shi; Yuanyuan,9999,0,9999,0
1668466163781,ECE 200,057,103642,Wang; Edward Jay,9999,0,9999,0
1668466163781,ECE 200,058,103643,Zheng; Yang,9999,0,9999,0
1668466164218,ECE 202,A00,103644,Kuzum; Duygu,0,40,0,0
1668466164642,ECE 212BN,A00,103646,Ng; Tse Nga,0,7,0,0
1668466165151,ECE 221,A00,111493,Staff,0,0,0,0
1668466165578,ECE 222B,A00,103647,Lomakin; Vitaliy,0,14,0,0
1668466166018,ECE 230B,A00,103648,Taur; Yuan,0,2,0,0
1668466166454,ECE 238B,A00,103649,Garay; Javier,0,0,0,0
1668466166880,ECE 240B,A00,112900,Fainman; Yeshaiahu,0,5,0,0
1668466167303,ECE 247A,A00,103650,Jokerst; Jesse Vincent,0,4,0,0
1668466167729,ECE 247B,A00,103651,Wang; Joseph,0,10,0,0
1668466168157,ECE 250,A00,103652,Siegel; Paul H.,0,74,0,0
1668466168581,ECE 251A,A00,103654,Rao; Bhaskar D.,0,58,0,0
1668466169005,ECE 257B,A00,103655,Bharadia; Dinesh,0,30,0,0
1668466169436,ECE 258A,A00,103656,Milstein; Laurence B.,0,27,0,0
1668466169860,ECE 260B,A00,103658,Kang; Mingu,0,115,0,0
1668466170295,ECE 264A,A00,103659,Galton; Ian A,0,63,0,0
1668466170733,ECE 265A,A00,103661,Gudem; Prasad S.S.,0,45,0,0
1668466171164,ECE 265D,A00,103662,Gudem; Prasad S.S.,0,21,0,0
1668466171590,ECE 268,A00,103663,Koushanfar; Farinaz,0,40,0,0
1668466172017,ECE 269,A01,103665,Pal; Piya,0,190,0,0
1668466172444,ECE 271B,A00,103666,Vasconcelos; Manuela,0,65,0,0
1668466172868,ECE 276A,A00,103667,Atanasov; Nikolay A.,0,108,0,0
1668466173299,ECE 277,A00,103668,An; Cheolhong,0,136,0,0
1668466173722,ECE 279,A00,117947,Hall; Drew A.,0,21,0,0
1668466174580,ECE 283,A00,103670,Hsueh; Tzu-Chien,0,47,0,0
1668466175009,ECE 284,A00,103671,Turakhia; Yatish Girish,0,37,0,0
1668466175444,ECE 285,A00,103672,Zheng; Yang,0,35,0,0
1668466175444,ECE 285,B00,103673,Sworder; David D.,0,51,0,0
1668466175865,ECE 287,A00,103676,Javidi; Tara,0,8,0,0
1668466176305,MATH 200B,A00,098023,Salehi Golsefidy; Alireza,12,0,15,3
1668466176729,MATH 202B,A00,098024,Rhoades; Brendon Patrick,9,0,15,6
1668466177155,MATH 203B,A00,098025,Oprea; Dragos N.,10,0,15,5
1668466177577,MATH 204B,A00,098026,Sorensen; Claus M,13,0,15,2
1668466178009,MATH 208,A00,098027,Izadi; Elham,7,0,10,3
1668466178432,MATH 209,A00,098028,Pollack; Aaron,10,0,10,0
1668466178865,MATH 211A,A00,112919,Rogalski; Daniel,9,0,10,1
1668466179291,MATH 211B,A00,112920,Seward; Brandon M.,9,0,10,1
1668466179722,MATH 218,A00,098029,Li; Bo,10,0,10,0
1668466180155,MATH 220B,A00,098030,Novak; Jonathan I,11,0,15,4
1668466180578,MATH 221A,A00,098031,Ebenfelt; Peter F,13,0,15,2
1668466181008,MATH 231B,A00,098032,Zlatos; Andrej,11,0,15,4
1668466181435,MATH 240B,A00,098033,Ni; Lei,9,0,15,6
1668466181877,MATH 243,A00,098034,Jekel; David Andrew,10,0,10,0
1668466182305,MATH 245A,A00,098035,Nie; Jiawang,0,2,15,16
1668466182730,MATH 248,A00,098036,Bejenaru; Ioan,10,0,10,0
1668466183155,MATH 250B,A00,098037,Spolaor; Luca,14,0,15,1
1668466183582,MATH 258,A00,098038,Ni; Lei,9,0,10,1
1668466184005,MATH 264B,A00,098041,Rhoades; Brendon Patrick,9,0,15,6
1668466184430,MATH 268,A00,098042,Buss; Samuel R,10,0,10,0
1668466184851,MATH 269,A00,098043,Rhoades; Brendon Patrick,10,0,10,0
1668466185277,MATH 270B,A00,098044,Li; Bo,10,0,15,5
1668466185703,MATH 272B,A00,098045,Holst; Michael J,13,0,15,2
1668466186125,MATH 273A,A00,098046,Tian; Xiaochuan,10,0,15,5
1668466186550,MATH 275,A01,098048,Tian; Xiaochuan,6,0,10,4
1668466186976,MATH 278A,A00,098049,Holst; Michael J,8,0,10,2
1668466187409,MATH 278B,A00,098050,Cloninger; Alexander,10,0,10,0
1668466187843,MATH 278C,A00,098051,Nie; Jiawang,6,0,10,4
1668466188280,MATH 280B,A00,098052,Zheng; Tianyi,7,0,15,8
1668466188710,MATH 281B,A00,098053,Bradic; Jelena,0,2,15,15
1668466189135,MATH 282B,A00,098054,Arias-Castro; Ery,0,0,15,15
1668466189570,MATH 285,A00,098055,Fitzsimmons; Patrick J,0,1,15,17
1668466190002,MATH 287B,A00,098056,Arias-Castro; Ery,2,0,15,13
1668466190425,MATH 288,A00,098057,Agarwal; Pooja,9,0,10,1
1668466190425,MATH 288,B00,098058,Zhang; Danna,8,0,10,2
1668466190425,MATH 288,C00,098059,Williams; Ruth J,9,0,10,1
1668466190848,MATH 290B,A00,098060,Roberts; Justin Deritter,13,0,15,2
1668466191274,MATH 292,A00,098061,Belmont; Eva Kinoshita,10,0,10,0
1668466191709,MATH 295,A00,098062,Suk; Andrew Hoon,48,0,50,2
1668466192131,MATH 296,A00,098063,Novak; Jonathan I,20,0,20,0
1668466192561,MATH 297,001,098064,Gamst; Anthony Collins,9997,0,9999,2
1668466695982,COGS 205,A00,101395,Chiba; Andrea,19,0,20,1
1668466696418,COGS 210B,001,101404,Greene; Deanna Jacquelyn,9998,0,9999,1
1668466696418,COGS 210B,002,101417,Xia; Haijun,9999,0,9999,0
1668466696418,COGS 210B,003,101422,Nitz; Douglas A.,9999,0,9999,0
1668466696418,COGS 210B,004,101423,Hollan; James D.,9998,0,9999,1
1668466696418,COGS 210B,005,101424,Deak; Gedeon O.,9998,0,9999,1
1668466696418,COGS 210B,006,101425,Rossano; Federico,9999,0,9999,0
1668466696850,COGS 211B,A00,101427,Coulson; Seana M,9996,0,9999,3
1668466697273,COGS 220,A00,101428,Hollan; James D.,1,8,25,24
1668466697708,COGS 229,A00,101429,Dow; Steven P,17,0,25,8
1668466698133,COGS 230,A00,101430,Klemmer; Scott R,8,0,17,9
1668466698560,COGS 234,A00,101431,Xia; Haijun,2,0,25,23
1668466698992,COGS 260,A00,101432,Kiyonaga; Anastasia,21,0,25,4
1668466698992,COGS 260,B00,101433,Kirsh; David Joel,15,0,25,10
1668466699419,CSE 202,A00,102371,Impagliazzo; Russell,0,58,0,0
1668466699853,CSE 203B,A01,102373,Cheng; Chung Kuan,0,49,0,0
1668466700280,CSE 208,A00,102374,Micciancio; Daniele,0,4,0,0
1668466700706,CSE 209A,A00,112895,Impagliazzo; Russell,0,11,15,15
1668466701134,CSE 209B,A00,108005,Bellare; Mihir,0,6,0,0
1668466701569,CSE 210,A00,113163,Coblenz; Michael J,0,75,0,0
1668466701994,CSE 219,A00,106111,Dow; Steven P,0,5,20,20
1668466702435,CSE 221,A00,102376,Voelker; Geoffrey M.,0,61,0,0
1668466702865,CSE 224,A01,102378,Porter; George M,0,149,0,0
1668466703293,CSE 229A,A00,102379,Savage; Stefan,0,9,0,0
1668466703722,CSE 229C,A00,102380,Munyaka; Imani N. S.,0,8,0,0
1668466704157,CSE 232B,A00,102382,Deutsch; Alin Bernard,0,29,0,0
1668466704584,CSE 234,A01,112904,Kumar; Arun Kumar,0,0,0,0
1668466705009,CSE 237A,A00,102383,Rosing; Tajana Simunic,0,46,0,0
1668466705433,CSE 239A,A00,102384,Deutsch; Alin Bernard,0,12,0,0
1668466705857,CSE 239B,A00,102385,Polikarpova; Nadezhda,0,9,0,0
1668466706285,CSE 240A,A00,102386,Pannuto; Patrick William,0,42,0,0
1668466706709,CSE 240B,A00,102387,Zhao; Jishen,0,43,0,0
1668466707144,CSE 241A,A00,106406,Kang; Mingu,0,6,0,0
1668466707575,CSE 249B,A00,102388,Kahng; Andrew Byun,0,4,8,8
1668466708004,CSE 251B,A01,102392,Cottrell; Garrison W,0,38,0,0
1668466708004,CSE 251B,A02,102393,Cottrell; Garrison W,0,32,0,0
1668466708428,CSE 252B,A00,102394,Ochoa; Benjamin Lawrence,0,50,0,0
1668466708853,CSE 257,A01,102396,Gao; Sicun,0,125,0,0
1668466709277,CSE 272,A00,102397,Li; Tzumao,0,16,0,0
1668466709701,CSE 274,A00,111323,Chern; Albert Ren-Haur,0,11,0,0
1668466710125,CSE 282,A00,102398,Pevzner; Pavel Arkadjevich,0,0,0,0
1668466710547,CSE 284,A00,114175,Gymrek; Melissa Ann,0,16,0,0
1668466710977,CSE 290,A00,102399,Chandraker; Manmohan Krishna,0,10,0,0
1668466710977,CSE 290,B00,102400,Vaccaro; Kristen Marie,0,5,25,25
1668466710977,CSE 290,C00,102414,Pannuto; Patrick William,0,1,25,25
1668466710977,CSE 290,D00,102427,Pevzner; Pavel Arkadjevich,0,0,0,0
1668466710977,CSE 290,E00,102429,Zhao; Jishen,0,4,0,0
1668466710977,CSE 290,F00,102436,Tullsen; Dean Michael,0,4,0,0
1668466710977,CSE 290,G00,102440,Christensen; Henrik I,0,6,20,20
1668466711407,CSE 291,A00,102443,Su; Hao,0,0,0,0
1668466711407,CSE 291,B00,102448,Polikarpova; Nadezhda,0,0,0,0
1668466711407,CSE 291,C00,102453,Vaccaro; Kristen Marie,0,0,0,0
1668466711407,CSE 291,D00,111343,Savage; Stefan,0,0,0,0
1668466711407,CSE 291,E00,116474,Claffy; Kimberly Claire,0,0,0,0
1668466711407,CSE 291,F00,116479,Pasquale; Joseph,0,0,0,0
1668466711850,CSE 293,001,119111,Bafna; Vineet,9999,0,9999,0
1668466711850,CSE 293,002,119118,Bellare; Mihir,9999,0,9999,0
1668466711850,CSE 293,003,119122,Berg-Kirkpatrick; Taylor D,9999,0,9999,0
1668466711850,CSE 293,004,119135,Christensen; Henrik I,9999,0,9999,0
1668466711850,CSE 293,005,119142,Cottrell; Garrison W,9999,0,9999,0
1668466711850,CSE 293,006,119146,Deutsch; Alin Bernard,9999,0,9999,0
1668466711850,CSE 293,007,119159,Esmaeilzadeh; Hadi,9999,0,9999,0
1668466711850,CSE 293,008,119166,Freund; Yoav,9999,0,9999,0
1668466711850,CSE 293,009,119170,Griswold; William G.,9999,0,9999,0
1668466711850,CSE 293,010,119183,Gymrek; Melissa Ann,9999,0,9999,0
1668466711850,CSE 293,011,119190,Heninger; Nadia A,9999,0,9999,0
1668466711850,CSE 293,012,119230,Impagliazzo; Russell,9999,0,9999,0
1668466711850,CSE 293,013,119232,Jhala; Ranjit,9999,0,9999,0
1668466711850,CSE 293,014,119233,Kahng; Andrew Byun,9999,0,9999,0
1668466711850,CSE 293,015,119298,Kane; Daniel Mertz,9999,0,9999,0
1668466711850,CSE 293,016,119299,Kriegman; David J,9999,0,9999,0
1668466711850,CSE 293,017,119300,Kumar; Arun Kumar,9999,0,9999,0
1668466711850,CSE 293,018,119301,Lerner; Sorin,9999,0,9999,0
1668466711850,CSE 293,019,119302,Lovett; Shachar,9999,0,9999,0
1668466711850,CSE 293,020,119303,McAuley; Julian John,9999,0,9999,0
1668466711850,CSE 293,021,119304,Micciancio; Daniele,9999,0,9999,0
1668466711850,CSE 293,022,119367,Orailoglu; Alex,9999,0,9999,0
1668466711850,CSE 293,023,119382,Paturi; Ramamohan,9999,0,9999,0
1668466711850,CSE 293,024,119404,Polikarpova; Nadezhda,9999,0,9999,0
1668466711850,CSE 293,025,119406,Politz; Joseph Gibbs,9999,0,9999,0
1668466711850,CSE 293,026,119411,Porter; George M,9999,0,9999,0
1668466711850,CSE 293,027,119414,Porter; Leonard Emerson,9999,0,9999,0
1668466711850,CSE 293,028,119416,Ramamoorthi; Ravi,9999,0,9999,0
1668466711850,CSE 293,029,119417,Sahoo; Debashis,9999,0,9999,0
1668466711850,CSE 293,030,119420,Saul; Lawrence,9999,0,9999,0
1668466711850,CSE 293,031,119421,Savage; Stefan,9999,0,9999,0
1668466711850,CSE 293,032,119425,Schulze; Jurgen P.,9999,0,9999,0
1668466711850,CSE 293,033,119426,Snoeren; Alex C.,9999,0,9999,0
1668466711850,CSE 293,034,119428,Shang; Jingbo,9999,0,9999,0
1668466711850,CSE 293,035,119430,Stefan; Deian,9999,0,9999,0
1668466711850,CSE 293,036,119431,Su; Hao,9999,0,9999,0
1668466711850,CSE 293,037,119433,Swanson; Steven James,9999,0,9999,0
1668466711850,CSE 293,038,119435,Tullsen; Dean Michael,9999,0,9999,0
1668466711850,CSE 293,039,119483,Voelker; Geoffrey M.,9999,0,9999,0
1668466711850,CSE 293,040,119537,Zhao; Jishen,9999,0,9999,0
1668466711850,CSE 293,041,119538,Zhou; Yuan-Yuan,9999,0,9999,0
1668466711850,CSE 293,042,119539,Gao; Sicun,9999,0,9999,0
1668466711850,CSE 293,043,119540,Weibel; Nadir,9999,0,9999,0
1668466711850,CSE 293,044,119541,Gupta; Rajesh K.,9999,0,9999,0
1668466711850,CSE 293,045,126410,Vaccaro; Kristen Marie,9999,0,9999,0
1668466711850,CSE 293,046,126411,Klemke; Richard,9999,0,9999,0
1668466712281,CSE 294,A00,102459,Voelker; Geoffrey M.,0,2,0,0
1668466712281,CSE 294,B00,111322,Orailoglu; Alex,0,1,0,0
1668466712714,DSE 201,A00,096914,Deutsch; Alin Bernard,30,0,30,0
1668466713143,DSE 210,A00,096915,Dasgupta; Sanjoy,30,0,30,0
1668466713566,DSE 260A,A00,096916,Altintas De Callaf; Ilkay,30,0,30,0
1668466714009,ECE 200,001,103586,Antipa; Nicholas A,9999,0,9999,0
1668466714009,ECE 200,002,103587,Atanasov; Nikolay A.,9999,0,9999,0
1668466714009,ECE 200,003,103588,Bharadia; Dinesh,9999,0,9999,0
1668466714009,ECE 200,004,103589,Cheng; Chung Kuan,9999,0,9999,0
1668466714009,ECE 200,005,103590,Cosman; Pamela C.,9999,0,9999,0
1668466714009,ECE 200,006,103591,Dayeh; Shadi Ahmad,9999,0,9999,0
1668466714009,ECE 200,007,103592,Fainman; Yeshaiahu,9999,0,9999,0
1668466714009,ECE 200,008,103593,Ford; Joseph Earl,9999,0,9999,0
1668466714009,ECE 200,009,103594,Franceschetti; Massimo,9999,0,9999,0
1668466714009,ECE 200,010,103595,Fullerton; Eric E,9999,0,9999,0
1668466714009,ECE 200,011,103596,Galton; Ian A,9999,0,9999,0
1668466714009,ECE 200,012,103597,Gilja; Vikash,9999,0,9999,0
1668466714009,ECE 200,013,103598,Hall; Drew A.,9999,0,9999,0
1668466714009,ECE 200,014,103599,Hsueh; Tzu-Chien,9999,0,9999,0
1668466714009,ECE 200,015,103600,Javidi; Tara,9999,0,9999,0
1668466714009,ECE 200,016,103601,Kahng; Andrew Byun,9999,0,9999,0
1668466714009,ECE 200,017,103602,Kim; Young-Han,9999,0,9999,0
1668466714009,ECE 200,018,103603,Koushanfar; Farinaz,9999,0,9999,0
1668466714009,ECE 200,019,103604,Kuzum; Duygu,9999,0,9999,0
1668466714009,ECE 200,020,103605,Le; Hanh-Phuc,9999,0,9999,0
1668466714009,ECE 200,021,103606,Lin; Bill,9999,0,9999,0
1668466714009,ECE 200,022,103607,Liu; Zhaowei,9998,0,9999,1
1668466714009,ECE 200,023,103608,Lo; Yu-Hwa,9999,0,9999,0
1668466714009,ECE 200,024,103609,Lomakin; Vitaliy,9999,0,9999,0
1668466714009,ECE 200,025,103610,Mercier; Patrick Philip,9999,0,9999,0
1668466714009,ECE 200,026,103611,Meyer; Florian,9999,0,9999,0
1668466714009,ECE 200,027,103612,Milstein; Laurence B.,9999,0,9999,0
1668466714009,ECE 200,028,103613,Mir Arabbaygi; Siavash,9999,0,9999,0
1668466714009,ECE 200,029,103614,Mookherjea; Shayan,9999,0,9999,0
1668466714009,ECE 200,030,103615,Morris; Karcher William,9999,0,9999,0
1668466714009,ECE 200,031,103616,Ng; Tse Nga,9999,0,9999,0
1668466714009,ECE 200,032,103617,Nguyen; Truong Quang,9999,0,9999,0
1668466714009,ECE 200,033,103618,Nomura; Kenji,9999,0,9999,0
1668466714009,ECE 200,034,103619,Orlitsky; Alon,9999,0,9999,0
1668466714009,ECE 200,035,103620,Pal; Piya,9999,0,9999,0
1668466714009,ECE 200,036,103621,Papen; George C.,9999,0,9999,0
1668466714009,ECE 200,037,103622,Radic; Stojan,9999,0,9999,0
1668466714009,ECE 200,038,103623,Rao; Bhaskar D.,9999,0,9999,0
1668466714009,ECE 200,039,103624,Rao; Ramesh R,9999,0,9999,0
1668466714009,ECE 200,040,103625,Rebeiz; Gabriel,9999,0,9999,0
1668466714009,ECE 200,041,103626,Sanford; John R,9999,0,9999,0
1668466714009,ECE 200,042,103627,Siegel; Paul H.,9999,0,9999,0
1668466714009,ECE 200,043,103628,Sievenpiper; Daniel F.,9999,0,9999,0
1668466714009,ECE 200,044,103629,Sworder; David D.,9999,0,9999,0
1668466714009,ECE 200,045,103630,Taur; Yuan,9999,0,9999,0
1668466714009,ECE 200,046,103631,Touri; Behrouz,9999,0,9999,0
1668466714009,ECE 200,047,103632,Trivedi; Mohan M.,9999,0,9999,0
1668466714009,ECE 200,048,103633,Vasconcelos; Nuno,9999,0,9999,0
1668466714009,ECE 200,049,103634,Wang; Xiaolong,9999,0,9999,0
1668466714009,ECE 200,050,103635,Xie; Pengtao,9999,0,9999,0
1668466714009,ECE 200,051,103636,Yip; Michael,9999,0,9999,0
1668466714009,ECE 200,052,103637,Zeger; Kenneth A.,999,0,999,0
1668466714009,ECE 200,053,103638,Zhang; Xinyu,9999,0,9999,0
1668466714009,ECE 200,054,103639,Turakhia; Yatish Girish,9999,0,9999,0
1668466714009,ECE 200,055,103640,Kang; Mingu,9999,0,9999,0
1668466714009,ECE 200,056,103641,Shi; Yuanyuan,9999,0,9999,0
1668466714009,ECE 200,057,103642,Wang; Edward Jay,9999,0,9999,0
1668466714009,ECE 200,058,103643,Zheng; Yang,9999,0,9999,0
1668466714436,ECE 202,A00,103644,Kuzum; Duygu,0,39,0,0
1668466714877,ECE 212BN,A00,103646,Ng; Tse Nga,0,7,0,0
1668466715301,ECE 221,A00,111493,Staff,0,0,0,0
1668466715734,ECE 222B,A00,103647,Lomakin; Vitaliy,0,14,0,0
1668466716156,ECE 230B,A00,103648,Taur; Yuan,0,2,0,0
1668466716591,ECE 238B,A00,103649,Garay; Javier,0,0,0,0
1668466717027,ECE 240B,A00,112900,Fainman; Yeshaiahu,0,5,0,0
1668466717456,ECE 247A,A00,103650,Jokerst; Jesse Vincent,0,4,0,0
1668466717879,ECE 247B,A00,103651,Wang; Joseph,0,10,0,0
1668466718311,ECE 250,A00,103652,Siegel; Paul H.,0,76,0,0
1668466718735,ECE 251A,A00,103654,Rao; Bhaskar D.,0,59,0,0
1668466719158,ECE 257B,A00,103655,Bharadia; Dinesh,0,30,0,0
1668466719591,ECE 258A,A00,103656,Milstein; Laurence B.,0,27,0,0
1668466720031,ECE 260B,A00,103658,Kang; Mingu,0,115,0,0
1668466720454,ECE 264A,A00,103659,Galton; Ian A,0,63,0,0
1668466720886,ECE 265A,A00,103661,Gudem; Prasad S.S.,0,46,0,0
1668466721320,ECE 265D,A00,103662,Gudem; Prasad S.S.,0,22,0,0
1668466721742,ECE 268,A00,103663,Koushanfar; Farinaz,0,40,0,0
1668466722167,ECE 269,A01,103665,Pal; Piya,0,192,0,0
1668466722599,ECE 271B,A00,103666,Vasconcelos; Manuela,0,66,0,0
1668466723030,ECE 276A,A00,103667,Atanasov; Nikolay A.,0,108,0,0
1668466723461,ECE 277,A00,103668,An; Cheolhong,0,136,0,0
1668466723884,ECE 279,A00,117947,Hall; Drew A.,0,21,0,0
1668466724737,ECE 283,A00,103670,Hsueh; Tzu-Chien,0,47,0,0
1668466725161,ECE 284,A00,103671,Turakhia; Yatish Girish,0,37,0,0
1668466725591,ECE 285,A00,103672,Zheng; Yang,0,35,0,0
1668466725591,ECE 285,B00,103673,Sworder; David D.,0,52,0,0
1668466726015,ECE 287,A00,103676,Javidi; Tara,0,8,0,0
1668466726442,MATH 200B,A00,098023,Salehi Golsefidy; Alireza,12,0,15,3
1668466726866,MATH 202B,A00,098024,Rhoades; Brendon Patrick,9,0,15,6
1668466727290,MATH 203B,A00,098025,Oprea; Dragos N.,10,0,15,5
1668466727731,MATH 204B,A00,098026,Sorensen; Claus M,13,0,15,2
1668466728158,MATH 208,A00,098027,Izadi; Elham,7,0,10,3
1668466728589,MATH 209,A00,098028,Pollack; Aaron,10,0,10,0
1668466729016,MATH 211A,A00,112919,Rogalski; Daniel,9,0,10,1
1668466729454,MATH 211B,A00,112920,Seward; Brandon M.,9,0,10,1
1668466729880,MATH 218,A00,098029,Li; Bo,10,0,10,0
1668466730307,MATH 220B,A00,098030,Novak; Jonathan I,11,0,15,4
1668466730735,MATH 221A,A00,098031,Ebenfelt; Peter F,13,0,15,2
1668466731264,MATH 231B,A00,098032,Zlatos; Andrej,11,0,15,4
1668466731699,MATH 240B,A00,098033,Ni; Lei,9,0,15,6
1668466732127,MATH 243,A00,098034,Jekel; David Andrew,10,0,10,0
1668466732550,MATH 245A,A00,098035,Nie; Jiawang,0,2,15,16
1668466732976,MATH 248,A00,098036,Bejenaru; Ioan,10,0,10,0
1668466733400,MATH 250B,A00,098037,Spolaor; Luca,14,0,15,1
1668466733826,MATH 258,A00,098038,Ni; Lei,9,0,10,1
1668466734252,MATH 264B,A00,098041,Rhoades; Brendon Patrick,9,0,15,6
1668466734679,MATH 268,A00,098042,Buss; Samuel R,10,0,10,0
1668466735125,MATH 269,A00,098043,Rhoades; Brendon Patrick,10,0,10,0
1668466735549,MATH 270B,A00,098044,Li; Bo,10,0,15,5
1668466735977,MATH 272B,A00,098045,Holst; Michael J,13,0,15,2
1668466736409,MATH 273A,A00,098046,Tian; Xiaochuan,10,0,15,5
1668466736844,MATH 275,A01,098048,Tian; Xiaochuan,6,0,10,4
1668466737273,MATH 278A,A00,098049,Holst; Michael J,8,0,10,2
1668466737700,MATH 278B,A00,098050,Cloninger; Alexander,10,0,10,0
1668466738131,MATH 278C,A00,098051,Nie; Jiawang,6,0,10,4
1668466738556,MATH 280B,A00,098052,Zheng; Tianyi,7,0,15,8
1668466738983,MATH 281B,A00,098053,Bradic; Jelena,0,2,15,15
1668466739406,MATH 282B,A00,098054,Arias-Castro; Ery,0,0,15,15
1668466739831,MATH 285,A00,098055,Fitzsimmons; Patrick J,0,1,15,17
1668466740260,MATH 287B,A00,098056,Arias-Castro; Ery,2,0,15,13
1668466740684,MATH 288,A00,098057,Agarwal; Pooja,9,0,10,1
1668466740684,MATH 288,B00,098058,Zhang; Danna,8,0,10,2
1668466740684,MATH 288,C00,098059,Williams; Ruth J,9,0,10,1
1668466741122,MATH 290B,A00,098060,Roberts; Justin Deritter,13,0,15,2
1668466741550,MATH 292,A00,098061,Belmont; Eva Kinoshita,10,0,10,0
1668466741972,MATH 295,A00,098062,Suk; Andrew Hoon,48,0,50,2
1668466742406,MATH 296,A00,098063,Novak; Jonathan I,20,0,20,0
1668466742834,MATH 297,001,098064,Gamst; Anthony Collins,9997,0,9999,2
1668467246400,COGS 205,A00,101395,Chiba; Andrea,19,0,20,1
1668467246824,COGS 210B,001,101404,Greene; Deanna Jacquelyn,9998,0,9999,1
1668467246824,COGS 210B,002,101417,Xia; Haijun,9999,0,9999,0
1668467246824,COGS 210B,003,101422,Nitz; Douglas A.,9999,0,9999,0
1668467246824,COGS 210B,004,101423,Hollan; James D.,9998,0,9999,1
1668467246824,COGS 210B,005,101424,Deak; Gedeon O.,9998,0,9999,1
1668467246824,COGS 210B,006,101425,Rossano; Federico,9999,0,9999,0
1668467247251,COGS 211B,A00,101427,Coulson; Seana M,9996,0,9999,3
1668467247704,COGS 220,A00,101428,Hollan; James D.,1,8,25,24
1668467248130,COGS 229,A00,101429,Dow; Steven P,17,0,25,8
1668467248561,COGS 230,A00,101430,Klemmer; Scott R,8,0,17,9
1668467248996,COGS 234,A00,101431,Xia; Haijun,2,0,25,23
1668467249421,COGS 260,A00,101432,Kiyonaga; Anastasia,21,0,25,4
1668467249421,COGS 260,B00,101433,Kirsh; David Joel,15,0,25,10
1668467249843,CSE 202,A00,102371,Impagliazzo; Russell,0,58,0,0
1668467250286,CSE 203B,A01,102373,Cheng; Chung Kuan,0,49,0,0
1668467250712,CSE 208,A00,102374,Micciancio; Daniele,0,4,0,0
1668467251135,CSE 209A,A00,112895,Impagliazzo; Russell,0,11,15,15
1668467251558,CSE 209B,A00,108005,Bellare; Mihir,0,6,0,0
1668467251993,CSE 210,A00,113163,Coblenz; Michael J,0,75,0,0
1668467252433,CSE 219,A00,106111,Dow; Steven P,0,5,20,20
1668467252867,CSE 221,A00,102376,Voelker; Geoffrey M.,0,61,0,0
1668467253292,CSE 224,A01,102378,Porter; George M,0,150,0,0
1668467253803,CSE 229A,A00,102379,Savage; Stefan,0,9,0,0
1668467254235,CSE 229C,A00,102380,Munyaka; Imani N. S.,0,8,0,0
1668467254667,CSE 232B,A00,102382,Deutsch; Alin Bernard,0,29,0,0
1668467255110,CSE 234,A01,112904,Kumar; Arun Kumar,0,0,0,0
1668467255534,CSE 237A,A00,102383,Rosing; Tajana Simunic,0,47,0,0
1668467255958,CSE 239A,A00,102384,Deutsch; Alin Bernard,0,12,0,0
1668467256393,CSE 239B,A00,102385,Polikarpova; Nadezhda,0,9,0,0
1668467256825,CSE 240A,A00,102386,Pannuto; Patrick William,0,42,0,0
1668467257253,CSE 240B,A00,102387,Zhao; Jishen,0,42,0,0
1668467257678,CSE 241A,A00,106406,Kang; Mingu,0,6,0,0
1668467258110,CSE 249B,A00,102388,Kahng; Andrew Byun,0,4,8,8
1668467258544,CSE 251B,A01,102392,Cottrell; Garrison W,0,38,0,0
1668467258544,CSE 251B,A02,102393,Cottrell; Garrison W,0,32,0,0
1668467258985,CSE 252B,A00,102394,Ochoa; Benjamin Lawrence,0,51,0,0
1668467259419,CSE 257,A01,102396,Gao; Sicun,0,125,0,0
1668467259847,CSE 272,A00,102397,Li; Tzumao,0,17,0,0
1668467260280,CSE 274,A00,111323,Chern; Albert Ren-Haur,0,11,0,0
1668467260715,CSE 282,A00,102398,Pevzner; Pavel Arkadjevich,0,0,0,0
1668467261143,CSE 284,A00,114175,Gymrek; Melissa Ann,0,16,0,0
1668467261570,CSE 290,A00,102399,Chandraker; Manmohan Krishna,0,10,0,0
1668467261570,CSE 290,B00,102400,Vaccaro; Kristen Marie,0,5,25,25
1668467261570,CSE 290,C00,102414,Pannuto; Patrick William,0,1,25,25
1668467261570,CSE 290,D00,102427,Pevzner; Pavel Arkadjevich,0,0,0,0
1668467261570,CSE 290,E00,102429,Zhao; Jishen,0,4,0,0
1668467261570,CSE 290,F00,102436,Tullsen; Dean Michael,0,4,0,0
1668467261570,CSE 290,G00,102440,Christensen; Henrik I,0,6,20,20
1668467261997,CSE 291,A00,102443,Su; Hao,0,0,0,0
1668467261997,CSE 291,B00,102448,Polikarpova; Nadezhda,0,0,0,0
1668467261997,CSE 291,C00,102453,Vaccaro; Kristen Marie,0,0,0,0
1668467261997,CSE 291,D00,111343,Savage; Stefan,0,0,0,0
1668467261997,CSE 291,E00,116474,Claffy; Kimberly Claire,0,0,0,0
1668467261997,CSE 291,F00,116479,Pasquale; Joseph,0,0,0,0
1668467262449,CSE 293,001,119111,Bafna; Vineet,9999,0,9999,0
1668467262449,CSE 293,002,119118,Bellare; Mihir,9999,0,9999,0
1668467262449,CSE 293,003,119122,Berg-Kirkpatrick; Taylor D,9999,0,9999,0
1668467262449,CSE 293,004,119135,Christensen; Henrik I,9999,0,9999,0
1668467262449,CSE 293,005,119142,Cottrell; Garrison W,9999,0,9999,0
1668467262449,CSE 293,006,119146,Deutsch; Alin Bernard,9999,0,9999,0
1668467262449,CSE 293,007,119159,Esmaeilzadeh; Hadi,9999,0,9999,0
1668467262449,CSE 293,008,119166,Freund; Yoav,9999,0,9999,0
1668467262449,CSE 293,009,119170,Griswold; William G.,9999,0,9999,0
1668467262449,CSE 293,010,119183,Gymrek; Melissa Ann,9999,0,9999,0
1668467262449,CSE 293,011,119190,Heninger; Nadia A,9999,0,9999,0
1668467262449,CSE 293,012,119230,Impagliazzo; Russell,9999,0,9999,0
1668467262449,CSE 293,013,119232,Jhala; Ranjit,9999,0,9999,0
1668467262449,CSE 293,014,119233,Kahng; Andrew Byun,9999,0,9999,0
1668467262449,CSE 293,015,119298,Kane; Daniel Mertz,9999,0,9999,0
1668467262449,CSE 293,016,119299,Kriegman; David J,9999,0,9999,0
1668467262449,CSE 293,017,119300,Kumar; Arun Kumar,9999,0,9999,0
1668467262449,CSE 293,018,119301,Lerner; Sorin,9999,0,9999,0
1668467262449,CSE 293,019,119302,Lovett; Shachar,9999,0,9999,0
1668467262449,CSE 293,020,119303,McAuley; Julian John,9999,0,9999,0
1668467262449,CSE 293,021,119304,Micciancio; Daniele,9999,0,9999,0
1668467262449,CSE 293,022,119367,Orailoglu; Alex,9999,0,9999,0
1668467262449,CSE 293,023,119382,Paturi; Ramamohan,9999,0,9999,0
1668467262449,CSE 293,024,119404,Polikarpova; Nadezhda,9999,0,9999,0
1668467262449,CSE 293,025,119406,Politz; Joseph Gibbs,9999,0,9999,0
1668467262449,CSE 293,026,119411,Porter; George M,9999,0,9999,0
1668467262449,CSE 293,027,119414,Porter; Leonard Emerson,9999,0,9999,0
1668467262449,CSE 293,028,119416,Ramamoorthi; Ravi,9999,0,9999,0
1668467262449,CSE 293,029,119417,Sahoo; Debashis,9999,0,9999,0
1668467262449,CSE 293,030,119420,Saul; Lawrence,9999,0,9999,0
1668467262449,CSE 293,031,119421,Savage; Stefan,9999,0,9999,0
1668467262449,CSE 293,032,119425,Schulze; Jurgen P.,9999,0,9999,0
1668467262449,CSE 293,033,119426,Snoeren; Alex C.,9999,0,9999,0
1668467262449,CSE 293,034,119428,Shang; Jingbo,9999,0,9999,0
1668467262449,CSE 293,035,119430,Stefan; Deian,9999,0,9999,0
1668467262449,CSE 293,036,119431,Su; Hao,9999,0,9999,0
1668467262449,CSE 293,037,119433,Swanson; Steven James,9999,0,9999,0
1668467262449,CSE 293,038,119435,Tullsen; Dean Michael,9999,0,9999,0
1668467262449,CSE 293,039,119483,Voelker; Geoffrey M.,9999,0,9999,0
1668467262449,CSE 293,040,119537,Zhao; Jishen,9999,0,9999,0
1668467262449,CSE 293,041,119538,Zhou; Yuan-Yuan,9999,0,9999,0
1668467262449,CSE 293,042,119539,Gao; Sicun,9999,0,9999,0
1668467262449,CSE 293,043,119540,Weibel; Nadir,9999,0,9999,0
1668467262449,CSE 293,044,119541,Gupta; Rajesh K.,9999,0,9999,0
1668467262449,CSE 293,045,126410,Vaccaro; Kristen Marie,9999,0,9999,0
1668467262449,CSE 293,046,126411,Klemke; Richard,9999,0,9999,0
1668467262873,CSE 294,A00,102459,Voelker; Geoffrey M.,0,2,0,0
1668467262873,CSE 294,B00,111322,Orailoglu; Alex,0,1,0,0
1668467263305,DSE 201,A00,096914,Deutsch; Alin Bernard,30,0,30,0
1668467263728,DSE 210,A00,096915,Dasgupta; Sanjoy,30,0,30,0
1668467264158,DSE 260A,A00,096916,Altintas De Callaf; Ilkay,30,0,30,0
1668467264586,ECE 200,001,103586,Antipa; Nicholas A,9999,0,9999,0
1668467264586,ECE 200,002,103587,Atanasov; Nikolay A.,9999,0,9999,0
1668467264586,ECE 200,003,103588,Bharadia; Dinesh,9999,0,9999,0
1668467264586,ECE 200,004,103589,Cheng; Chung Kuan,9999,0,9999,0
1668467264586,ECE 200,005,103590,Cosman; Pamela C.,9999,0,9999,0
1668467264586,ECE 200,006,103591,Dayeh; Shadi Ahmad,9999,0,9999,0
1668467264586,ECE 200,007,103592,Fainman; Yeshaiahu,9999,0,9999,0
1668467264586,ECE 200,008,103593,Ford; Joseph Earl,9999,0,9999,0
1668467264586,ECE 200,009,103594,Franceschetti; Massimo,9999,0,9999,0
1668467264586,ECE 200,010,103595,Fullerton; Eric E,9999,0,9999,0
1668467264586,ECE 200,011,103596,Galton; Ian A,9999,0,9999,0
1668467264586,ECE 200,012,103597,Gilja; Vikash,9999,0,9999,0
1668467264586,ECE 200,013,103598,Hall; Drew A.,9999,0,9999,0
1668467264586,ECE 200,014,103599,Hsueh; Tzu-Chien,9999,0,9999,0
1668467264586,ECE 200,015,103600,Javidi; Tara,9999,0,9999,0
1668467264586,ECE 200,016,103601,Kahng; Andrew Byun,9999,0,9999,0
1668467264586,ECE 200,017,103602,Kim; Young-Han,9999,0,9999,0
1668467264586,ECE 200,018,103603,Koushanfar; Farinaz,9999,0,9999,0
1668467264586,ECE 200,019,103604,Kuzum; Duygu,9999,0,9999,0
1668467264586,ECE 200,020,103605,Le; Hanh-Phuc,9999,0,9999,0
1668467264586,ECE 200,021,103606,Lin; Bill,9999,0,9999,0
1668467264586,ECE 200,022,103607,Liu; Zhaowei,9998,0,9999,1
1668467264586,ECE 200,023,103608,Lo; Yu-Hwa,9999,0,9999,0
1668467264586,ECE 200,024,103609,Lomakin; Vitaliy,9999,0,9999,0
1668467264586,ECE 200,025,103610,Mercier; Patrick Philip,9999,0,9999,0
1668467264586,ECE 200,026,103611,Meyer; Florian,9999,0,9999,0
1668467264586,ECE 200,027,103612,Milstein; Laurence B.,9999,0,9999,0
1668467264586,ECE 200,028,103613,Mir Arabbaygi; Siavash,9999,0,9999,0
1668467264586,ECE 200,029,103614,Mookherjea; Shayan,9999,0,9999,0
1668467264586,ECE 200,030,103615,Morris; Karcher William,9999,0,9999,0
1668467264586,ECE 200,031,103616,Ng; Tse Nga,9999,0,9999,0
1668467264586,ECE 200,032,103617,Nguyen; Truong Quang,9999,0,9999,0
1668467264586,ECE 200,033,103618,Nomura; Kenji,9999,0,9999,0
1668467264586,ECE 200,034,103619,Orlitsky; Alon,9999,0,9999,0
1668467264586,ECE 200,035,103620,Pal; Piya,9999,0,9999,0
1668467264586,ECE 200,036,103621,Papen; George C.,9999,0,9999,0
1668467264586,ECE 200,037,103622,Radic; Stojan,9999,0,9999,0
1668467264586,ECE 200,038,103623,Rao; Bhaskar D.,9999,0,9999,0
1668467264586,ECE 200,039,103624,Rao; Ramesh R,9999,0,9999,0
1668467264586,ECE 200,040,103625,Rebeiz; Gabriel,9999,0,9999,0
1668467264586,ECE 200,041,103626,Sanford; John R,9999,0,9999,0
1668467264586,ECE 200,042,103627,Siegel; Paul H.,9999,0,9999,0
1668467264586,ECE 200,043,103628,Sievenpiper; Daniel F.,9999,0,9999,0
1668467264586,ECE 200,044,103629,Sworder; David D.,9999,0,9999,0
1668467264586,ECE 200,045,103630,Taur; Yuan,9999,0,9999,0
1668467264586,ECE 200,046,103631,Touri; Behrouz,9999,0,9999,0
1668467264586,ECE 200,047,103632,Trivedi; Mohan M.,9999,0,9999,0
1668467264586,ECE 200,048,103633,Vasconcelos; Nuno,9999,0,9999,0
1668467264586,ECE 200,049,103634,Wang; Xiaolong,9999,0,9999,0
1668467264586,ECE 200,050,103635,Xie; Pengtao,9999,0,9999,0
1668467264586,ECE 200,051,103636,Yip; Michael,9999,0,9999,0
1668467264586,ECE 200,052,103637,Zeger; Kenneth A.,999,0,999,0
1668467264586,ECE 200,053,103638,Zhang; Xinyu,9999,0,9999,0
1668467264586,ECE 200,054,103639,Turakhia; Yatish Girish,9999,0,9999,0
1668467264586,ECE 200,055,103640,Kang; Mingu,9999,0,9999,0
1668467264586,ECE 200,056,103641,Shi; Yuanyuan,9999,0,9999,0
1668467264586,ECE 200,057,103642,Wang; Edward Jay,9999,0,9999,0
1668467264586,ECE 200,058,103643,Zheng; Yang,9999,0,9999,0
1668467265014,ECE 202,A00,103644,Kuzum; Duygu,0,39,0,0
1668467265437,ECE 212BN,A00,103646,Ng; Tse Nga,0,7,0,0
1668467265862,ECE 221,A00,111493,Staff,0,0,0,0
1668467266290,ECE 222B,A00,103647,Lomakin; Vitaliy,0,14,0,0
1668467266719,ECE 230B,A00,103648,Taur; Yuan,0,2,0,0
1668467267147,ECE 238B,A00,103649,Garay; Javier,0,0,0,0
1668467267573,ECE 240B,A00,112900,Fainman; Yeshaiahu,0,5,0,0
1668467267997,ECE 247A,A00,103650,Jokerst; Jesse Vincent,0,4,0,0
1668467268433,ECE 247B,A00,103651,Wang; Joseph,0,10,0,0
1668467268856,ECE 250,A00,103652,Siegel; Paul H.,0,76,0,0
1668467269291,ECE 251A,A00,103654,Rao; Bhaskar D.,0,60,0,0
1668467269724,ECE 257B,A00,103655,Bharadia; Dinesh,0,30,0,0
1668467270150,ECE 258A,A00,103656,Milstein; Laurence B.,0,27,0,0
1668467270574,ECE 260B,A00,103658,Kang; Mingu,0,116,0,0
1668467270997,ECE 264A,A00,103659,Galton; Ian A,0,63,0,0
1668467271420,ECE 265A,A00,103661,Gudem; Prasad S.S.,0,47,0,0
1668467271846,ECE 265D,A00,103662,Gudem; Prasad S.S.,0,22,0,0
1668467272273,ECE 268,A00,103663,Koushanfar; Farinaz,0,41,0,0
1668467272697,ECE 269,A01,103665,Pal; Piya,0,192,0,0
1668467273120,ECE 271B,A00,103666,Vasconcelos; Manuela,0,66,0,0
1668467273546,ECE 276A,A00,103667,Atanasov; Nikolay A.,0,109,0,0
1668467273973,ECE 277,A00,103668,An; Cheolhong,0,137,0,0
1668467274395,ECE 279,A00,117947,Hall; Drew A.,0,21,0,0
1668467275256,ECE 283,A00,103670,Hsueh; Tzu-Chien,0,48,0,0
1668467275680,ECE 284,A00,103671,Turakhia; Yatish Girish,0,38,0,0
1668467276111,ECE 285,A00,103672,Zheng; Yang,0,36,0,0
1668467276111,ECE 285,B00,103673,Sworder; David D.,0,52,0,0
1668467276543,ECE 287,A00,103676,Javidi; Tara,0,8,0,0
1668467276967,MATH 200B,A00,098023,Salehi Golsefidy; Alireza,12,0,15,3
1668467277391,MATH 202B,A00,098024,Rhoades; Brendon Patrick,9,0,15,6
1668467277826,MATH 203B,A00,098025,Oprea; Dragos N.,10,0,15,5
1668467278265,MATH 204B,A00,098026,Sorensen; Claus M,13,0,15,2
1668467278695,MATH 208,A00,098027,Izadi; Elham,7,0,10,3
1668467279117,MATH 209,A00,098028,Pollack; Aaron,10,0,10,0
1668467279539,MATH 211A,A00,112919,Rogalski; Daniel,9,0,10,1
1668467279964,MATH 211B,A00,112920,Seward; Brandon M.,9,0,10,1
1668467280391,MATH 218,A00,098029,Li; Bo,10,0,10,0
1668467280815,MATH 220B,A00,098030,Novak; Jonathan I,11,0,15,4
1668467281249,MATH 221A,A00,098031,Ebenfelt; Peter F,13,0,15,2
1668467281675,MATH 231B,A00,098032,Zlatos; Andrej,11,0,15,4
1668467282101,MATH 240B,A00,098033,Ni; Lei,9,0,15,6
1668467282528,MATH 243,A00,098034,Jekel; David Andrew,10,0,10,0
1668467282950,MATH 245A,A00,098035,Nie; Jiawang,0,2,15,16
1668467283390,MATH 248,A00,098036,Bejenaru; Ioan,10,0,10,0
1668467283829,MATH 250B,A00,098037,Spolaor; Luca,14,0,15,1
1668467284265,MATH 258,A00,098038,Ni; Lei,9,0,10,1
1668467284689,MATH 264B,A00,098041,Rhoades; Brendon Patrick,9,0,15,6
1668467285113,MATH 268,A00,098042,Buss; Samuel R,10,0,10,0
1668467285535,MATH 269,A00,098043,Rhoades; Brendon Patrick,10,0,10,0
1668467285960,MATH 270B,A00,098044,Li; Bo,10,0,15,5
1668467286396,MATH 272B,A00,098045,Holst; Michael J,13,0,15,2
1668467286821,MATH 273A,A00,098046,Tian; Xiaochuan,10,0,15,5
1668467287258,MATH 275,A01,098048,Tian; Xiaochuan,6,0,10,4
1668467287685,MATH 278A,A00,098049,Holst; Michael J,8,0,10,2
1668467288117,MATH 278B,A00,098050,Cloninger; Alexander,10,0,10,0
1668467288541,MATH 278C,A00,098051,Nie; Jiawang,6,0,10,4
1668467288977,MATH 280B,A00,098052,Zheng; Tianyi,7,0,15,8
1668467289422,MATH 281B,A00,098053,Bradic; Jelena,0,2,15,15
1668467289847,MATH 282B,A00,098054,Arias-Castro; Ery,0,0,15,15
1668467290270,MATH 285,A00,098055,Fitzsimmons; Patrick J,0,1,15,17
1668467290696,MATH 287B,A00,098056,Arias-Castro; Ery,2,0,15,13
1668467291119,MATH 288,A00,098057,Agarwal; Pooja,9,0,10,1
1668467291119,MATH 288,B00,098058,Zhang; Danna,8,0,10,2
1668467291119,MATH 288,C00,098059,Williams; Ruth J,9,0,10,1
1668467291546,MATH 290B,A00,098060,Roberts; Justin Deritter,13,0,15,2
1668467291972,MATH 292,A00,098061,Belmont; Eva Kinoshita,10,0,10,0
1668467292395,MATH 295,A00,098062,Suk; Andrew Hoon,48,0,50,2
1668467292819,MATH 296,A00,098063,Novak; Jonathan I,20,0,20,0
1668467293260,MATH 297,001,098064,Gamst; Anthony Collins,9997,0,9999,2
1668467796701,COGS 205,A00,101395,Chiba; Andrea,19,0,20,1
1668467797139,COGS 210B,001,101404,Greene; Deanna Jacquelyn,9998,0,9999,1
1668467797139,COGS 210B,002,101417,Xia; Haijun,9999,0,9999,0
1668467797139,COGS 210B,003,101422,Nitz; Douglas A.,9999,0,9999,0
1668467797139,COGS 210B,004,101423,Hollan; James D.,9998,0,9999,1
1668467797139,COGS 210B,005,101424,Deak; Gedeon O.,9998,0,9999,1
1668467797139,COGS 210B,006,101425,Rossano; Federico,9999,0,9999,0
1668467797566,COGS 211B,A00,101427,Coulson; Seana M,9996,0,9999,3
1668467797991,COGS 220,A00,101428,Hollan; James D.,1,9,25,24
1668467798417,COGS 229,A00,101429,Dow; Steven P,17,0,25,8
1668467798842,COGS 230,A00,101430,Klemmer; Scott R,8,0,17,9
1668467799267,COGS 234,A00,101431,Xia; Haijun,2,0,25,23
1668467799695,COGS 260,A00,101432,Kiyonaga; Anastasia,21,0,25,4
1668467799695,COGS 260,B00,101433,Kirsh; David Joel,15,0,25,10
1668467800121,CSE 202,A00,102371,Impagliazzo; Russell,0,58,0,0
1668467800551,CSE 203B,A01,102373,Cheng; Chung Kuan,0,49,0,0
1668467800976,CSE 208,A00,102374,Micciancio; Daniele,0,4,0,0
1668467801403,CSE 209A,A00,112895,Impagliazzo; Russell,0,11,15,15
1668467801841,CSE 209B,A00,108005,Bellare; Mihir,0,6,0,0
1668467802267,CSE 210,A00,113163,Coblenz; Michael J,0,76,0,0
1668467802697,CSE 219,A00,106111,Dow; Steven P,0,5,20,20
1668467803121,CSE 221,A00,102376,Voelker; Geoffrey M.,0,61,0,0
1668467803544,CSE 224,A01,102378,Porter; George M,0,151,0,0
1668467803969,CSE 229A,A00,102379,Savage; Stefan,0,9,0,0
1668467804393,CSE 229C,A00,102380,Munyaka; Imani N. S.,0,8,0,0
1668467804815,CSE 232B,A00,102382,Deutsch; Alin Bernard,0,29,0,0
1668467805242,CSE 234,A01,112904,Kumar; Arun Kumar,0,0,0,0
1668467805666,CSE 237A,A00,102383,Rosing; Tajana Simunic,0,47,0,0
1668467806091,CSE 239A,A00,102384,Deutsch; Alin Bernard,0,12,0,0
1668467806514,CSE 239B,A00,102385,Polikarpova; Nadezhda,0,9,0,0
1668467806942,CSE 240A,A00,102386,Pannuto; Patrick William,0,43,0,0
1668467807387,CSE 240B,A00,102387,Zhao; Jishen,0,42,0,0
1668467807812,CSE 241A,A00,106406,Kang; Mingu,0,6,0,0
1668467808238,CSE 249B,A00,102388,Kahng; Andrew Byun,0,4,8,8
1668467808668,CSE 251B,A01,102392,Cottrell; Garrison W,0,39,0,0
1668467808668,CSE 251B,A02,102393,Cottrell; Garrison W,0,32,0,0
1668467809097,CSE 252B,A00,102394,Ochoa; Benjamin Lawrence,0,51,0,0
1668467809524,CSE 257,A01,102396,Gao; Sicun,0,126,0,0
1668467809950,CSE 272,A00,102397,Li; Tzumao,0,17,0,0
1668467810375,CSE 274,A00,111323,Chern; Albert Ren-Haur,0,11,0,0
1668467810799,CSE 282,A00,102398,Pevzner; Pavel Arkadjevich,0,0,0,0
1668467811224,CSE 284,A00,114175,Gymrek; Melissa Ann,0,17,0,0
1668467811651,CSE 290,A00,102399,Chandraker; Manmohan Krishna,0,10,0,0
1668467811651,CSE 290,B00,102400,Vaccaro; Kristen Marie,0,7,25,25
1668467811651,CSE 290,C00,102414,Pannuto; Patrick William,0,1,25,25
1668467811651,CSE 290,D00,102427,Pevzner; Pavel Arkadjevich,0,0,0,0
1668467811651,CSE 290,E00,102429,Zhao; Jishen,0,4,0,0
1668467811651,CSE 290,F00,102436,Tullsen; Dean Michael,0,4,0,0
1668467811651,CSE 290,G00,102440,Christensen; Henrik I,0,6,20,20
1668467812074,CSE 291,A00,102443,Su; Hao,0,0,0,0
1668467812074,CSE 291,B00,102448,Polikarpova; Nadezhda,0,0,0,0
1668467812074,CSE 291,C00,102453,Vaccaro; Kristen Marie,0,0,0,0
1668467812074,CSE 291,D00,111343,Savage; Stefan,0,0,0,0
1668467812074,CSE 291,E00,116474,Claffy; Kimberly Claire,0,0,0,0
1668467812074,CSE 291,F00,116479,Pasquale; Joseph,0,0,0,0
1668467812505,CSE 293,001,119111,Bafna; Vineet,9999,0,9999,0
1668467812505,CSE 293,002,119118,Bellare; Mihir,9999,0,9999,0
1668467812505,CSE 293,003,119122,Berg-Kirkpatrick; Taylor D,9999,0,9999,0
1668467812505,CSE 293,004,119135,Christensen; Henrik I,9999,0,9999,0
1668467812505,CSE 293,005,119142,Cottrell; Garrison W,9999,0,9999,0
1668467812505,CSE 293,006,119146,Deutsch; Alin Bernard,9999,0,9999,0
1668467812505,CSE 293,007,119159,Esmaeilzadeh; Hadi,9999,0,9999,0
1668467812505,CSE 293,008,119166,Freund; Yoav,9999,0,9999,0
1668467812505,CSE 293,009,119170,Griswold; William G.,9999,0,9999,0
1668467812505,CSE 293,010,119183,Gymrek; Melissa Ann,9999,0,9999,0
1668467812505,CSE 293,011,119190,Heninger; Nadia A,9999,0,9999,0
1668467812505,CSE 293,012,119230,Impagliazzo; Russell,9999,0,9999,0
1668467812505,CSE 293,013,119232,Jhala; Ranjit,9999,0,9999,0
1668467812505,CSE 293,014,119233,Kahng; Andrew Byun,9999,0,9999,0
1668467812505,CSE 293,015,119298,Kane; Daniel Mertz,9999,0,9999,0
1668467812505,CSE 293,016,119299,Kriegman; David J,9999,0,9999,0
1668467812505,CSE 293,017,119300,Kumar; Arun Kumar,9999,0,9999,0
1668467812505,CSE 293,018,119301,Lerner; Sorin,9999,0,9999,0
1668467812505,CSE 293,019,119302,Lovett; Shachar,9999,0,9999,0
1668467812505,CSE 293,020,119303,McAuley; Julian John,9999,0,9999,0
1668467812505,CSE 293,021,119304,Micciancio; Daniele,9999,0,9999,0
1668467812505,CSE 293,022,119367,Orailoglu; Alex,9999,0,9999,0
1668467812505,CSE 293,023,119382,Paturi; Ramamohan,9999,0,9999,0
1668467812505,CSE 293,024,119404,Polikarpova; Nadezhda,9999,0,9999,0
1668467812505,CSE 293,025,119406,Politz; Joseph Gibbs,9999,0,9999,0
1668467812505,CSE 293,026,119411,Porter; George M,9999,0,9999,0
1668467812505,CSE 293,027,119414,Porter; Leonard Emerson,9999,0,9999,0
1668467812505,CSE 293,028,119416,Ramamoorthi; Ravi,9999,0,9999,0
1668467812505,CSE 293,029,119417,Sahoo; Debashis,9999,0,9999,0
1668467812505,CSE 293,030,119420,Saul; Lawrence,9999,0,9999,0
1668467812505,CSE 293,031,119421,Savage; Stefan,9999,0,9999,0
1668467812505,CSE 293,032,119425,Schulze; Jurgen P.,9999,0,9999,0
1668467812505,CSE 293,033,119426,Snoeren; Alex C.,9999,0,9999,0
1668467812505,CSE 293,034,119428,Shang; Jingbo,9999,0,9999,0
1668467812505,CSE 293,035,119430,Stefan; Deian,9999,0,9999,0
1668467812505,CSE 293,036,119431,Su; Hao,9999,0,9999,0
1668467812505,CSE 293,037,119433,Swanson; Steven James,9999,0,9999,0
1668467812505,CSE 293,038,119435,Tullsen; Dean Michael,9999,0,9999,0
1668467812505,CSE 293,039,119483,Voelker; Geoffrey M.,9999,0,9999,0
1668467812505,CSE 293,040,119537,Zhao; Jishen,9999,0,9999,0
1668467812505,CSE 293,041,119538,Zhou; Yuan-Yuan,9999,0,9999,0
1668467812505,CSE 293,042,119539,Gao; Sicun,9999,0,9999,0
1668467812505,CSE 293,043,119540,Weibel; Nadir,9999,0,9999,0
1668467812505,CSE 293,044,119541,Gupta; Rajesh K.,9999,0,9999,0
1668467812505,CSE 293,045,126410,Vaccaro; Kristen Marie,9999,0,9999,0
1668467812505,CSE 293,046,126411,Klemke; Richard,9999,0,9999,0
1668467812930,CSE 294,A00,102459,Voelker; Geoffrey M.,0,2,0,0
1668467812930,CSE 294,B00,111322,Orailoglu; Alex,0,1,0,0
1668467813365,DSE 201,A00,096914,Deutsch; Alin Bernard,30,0,30,0
1668467813796,DSE 210,A00,096915,Dasgupta; Sanjoy,30,0,30,0
1668467814230,DSE 260A,A00,096916,Altintas De Callaf; Ilkay,30,0,30,0
1668467814691,ECE 200,001,103586,Antipa; Nicholas A,9999,0,9999,0
1668467814691,ECE 200,002,103587,Atanasov; Nikolay A.,9999,0,9999,0
1668467814691,ECE 200,003,103588,Bharadia; Dinesh,9999,0,9999,0
1668467814691,ECE 200,004,103589,Cheng; Chung Kuan,9999,0,9999,0
1668467814691,ECE 200,005,103590,Cosman; Pamela C.,9999,0,9999,0
1668467814691,ECE 200,006,103591,Dayeh; Shadi Ahmad,9999,0,9999,0
1668467814691,ECE 200,007,103592,Fainman; Yeshaiahu,9999,0,9999,0
1668467814691,ECE 200,008,103593,Ford; Joseph Earl,9999,0,9999,0
1668467814691,ECE 200,009,103594,Franceschetti; Massimo,9999,0,9999,0
1668467814691,ECE 200,010,103595,Fullerton; Eric E,9999,0,9999,0
1668467814691,ECE 200,011,103596,Galton; Ian A,9999,0,9999,0
1668467814691,ECE 200,012,103597,Gilja; Vikash,9999,0,9999,0
1668467814691,ECE 200,013,103598,Hall; Drew A.,9999,0,9999,0
1668467814691,ECE 200,014,103599,Hsueh; Tzu-Chien,9999,0,9999,0
1668467814691,ECE 200,015,103600,Javidi; Tara,9999,0,9999,0
1668467814691,ECE 200,016,103601,Kahng; Andrew Byun,9999,0,9999,0
1668467814691,ECE 200,017,103602,Kim; Young-Han,9999,0,9999,0
1668467814691,ECE 200,018,103603,Koushanfar; Farinaz,9999,0,9999,0
1668467814691,ECE 200,019,103604,Kuzum; Duygu,9999,0,9999,0
1668467814691,ECE 200,020,103605,Le; Hanh-Phuc,9999,0,9999,0
1668467814691,ECE 200,021,103606,Lin; Bill,9999,0,9999,0
1668467814691,ECE 200,022,103607,Liu; Zhaowei,9998,0,9999,1
1668467814691,ECE 200,023,103608,Lo; Yu-Hwa,9999,0,9999,0
1668467814691,ECE 200,024,103609,Lomakin; Vitaliy,9999,0,9999,0
1668467814691,ECE 200,025,103610,Mercier; Patrick Philip,9999,0,9999,0
1668467814691,ECE 200,026,103611,Meyer; Florian,9999,0,9999,0
1668467814691,ECE 200,027,103612,Milstein; Laurence B.,9999,0,9999,0
1668467814691,ECE 200,028,103613,Mir Arabbaygi; Siavash,9999,0,9999,0
1668467814691,ECE 200,029,103614,Mookherjea; Shayan,9999,0,9999,0
1668467814691,ECE 200,030,103615,Morris; Karcher William,9999,0,9999,0
1668467814691,ECE 200,031,103616,Ng; Tse Nga,9999,0,9999,0
1668467814691,ECE 200,032,103617,Nguyen; Truong Quang,9999,0,9999,0
1668467814691,ECE 200,033,103618,Nomura; Kenji,9999,0,9999,0
1668467814691,ECE 200,034,103619,Orlitsky; Alon,9999,0,9999,0
1668467814691,ECE 200,035,103620,Pal; Piya,9999,0,9999,0
1668467814691,ECE 200,036,103621,Papen; George C.,9999,0,9999,0
1668467814691,ECE 200,037,103622,Radic; Stojan,9999,0,9999,0
1668467814691,ECE 200,038,103623,Rao; Bhaskar D.,9999,0,9999,0
1668467814691,ECE 200,039,103624,Rao; Ramesh R,9999,0,9999,0
1668467814691,ECE 200,040,103625,Rebeiz; Gabriel,9999,0,9999,0
1668467814691,ECE 200,041,103626,Sanford; John R,9999,0,9999,0
1668467814691,ECE 200,042,103627,Siegel; Paul H.,9999,0,9999,0
1668467814691,ECE 200,043,103628,Sievenpiper; Daniel F.,9999,0,9999,0
1668467814691,ECE 200,044,103629,Sworder; David D.,9999,0,9999,0
1668467814691,ECE 200,045,103630,Taur; Yuan,9999,0,9999,0
1668467814691,ECE 200,046,103631,Touri; Behrouz,9999,0,9999,0
1668467814691,ECE 200,047,103632,Trivedi; Mohan M.,9999,0,9999,0
1668467814691,ECE 200,048,103633,Vasconcelos; Nuno,9999,0,9999,0
1668467814691,ECE 200,049,103634,Wang; Xiaolong,9999,0,9999,0
1668467814691,ECE 200,050,103635,Xie; Pengtao,9999,0,9999,0
1668467814691,ECE 200,051,103636,Yip; Michael,9999,0,9999,0
1668467814691,ECE 200,052,103637,Zeger; Kenneth A.,999,0,999,0
1668467814691,ECE 200,053,103638,Zhang; Xinyu,9999,0,9999,0
1668467814691,ECE 200,054,103639,Turakhia; Yatish Girish,9999,0,9999,0
1668467814691,ECE 200,055,103640,Kang; Mingu,9999,0,9999,0
1668467814691,ECE 200,056,103641,Shi; Yuanyuan,9999,0,9999,0
1668467814691,ECE 200,057,103642,Wang; Edward Jay,9999,0,9999,0
1668467814691,ECE 200,058,103643,Zheng; Yang,9999,0,9999,0
1668467815114,ECE 202,A00,103644,Kuzum; Duygu,0,39,0,0
1668467815543,ECE 212BN,A00,103646,Ng; Tse Nga,0,7,0,0
1668467815966,ECE 221,A00,111493,Staff,0,0,0,0
1668467816395,ECE 222B,A00,103647,Lomakin; Vitaliy,0,14,0,0
1668467816820,ECE 230B,A00,103648,Taur; Yuan,0,2,0,0
1668467817253,ECE 238B,A00,103649,Garay; Javier,0,0,0,0
1668467817680,ECE 240B,A00,112900,Fainman; Yeshaiahu,0,5,0,0
1668467818107,ECE 247A,A00,103650,Jokerst; Jesse Vincent,0,5,0,0
1668467818547,ECE 247B,A00,103651,Wang; Joseph,0,10,0,0
1668467818977,ECE 250,A00,103652,Siegel; Paul H.,0,76,0,0
1668467819493,ECE 251A,A00,103654,Rao; Bhaskar D.,0,60,0,0
1668467819948,ECE 257B,A00,103655,Bharadia; Dinesh,0,30,0,0
1668467820370,ECE 258A,A00,103656,Milstein; Laurence B.,0,27,0,0
1668467820796,ECE 260B,A00,103658,Kang; Mingu,0,117,0,0
1668467821227,ECE 264A,A00,103659,Galton; Ian A,0,64,0,0
1668467821651,ECE 265A,A00,103661,Gudem; Prasad S.S.,0,51,0,0
1668467822074,ECE 265D,A00,103662,Gudem; Prasad S.S.,0,22,0,0
1668467822497,ECE 268,A00,103663,Koushanfar; Farinaz,0,41,0,0
1668467822928,ECE 269,A01,103665,Pal; Piya,0,194,0,0
1668467823356,ECE 271B,A00,103666,Vasconcelos; Manuela,0,68,0,0
1668467823782,ECE 276A,A00,103667,Atanasov; Nikolay A.,0,114,0,0
1668467824215,ECE 277,A00,103668,An; Cheolhong,0,137,0,0
1668467824651,ECE 279,A00,117947,Hall; Drew A.,0,21,0,0
1668467825502,ECE 283,A00,103670,Hsueh; Tzu-Chien,0,49,0,0
1668467825924,ECE 284,A00,103671,Turakhia; Yatish Girish,0,39,0,0
1668467826347,ECE 285,A00,103672,Zheng; Yang,0,36,0,0
1668467826347,ECE 285,B00,103673,Sworder; David D.,0,53,0,0
1668467826771,ECE 287,A00,103676,Javidi; Tara,0,8,0,0
1668467827198,MATH 200B,A00,098023,Salehi Golsefidy; Alireza,12,0,15,3
1668467827621,MATH 202B,A00,098024,Rhoades; Brendon Patrick,9,0,15,6
1668467828068,MATH 203B,A00,098025,Oprea; Dragos N.,10,0,15,5
1668467828497,MATH 204B,A00,098026,Sorensen; Claus M,13,0,15,2
1668467828928,MATH 208,A00,098027,Izadi; Elham,7,0,10,3
1668467829355,MATH 209,A00,098028,Pollack; Aaron,10,0,10,0
1668467829780,MATH 211A,A00,112919,Rogalski; Daniel,9,0,10,1
1668467830214,MATH 211B,A00,112920,Seward; Brandon M.,9,0,10,1
1668467830647,MATH 218,A00,098029,Li; Bo,10,0,10,0
1668467831073,MATH 220B,A00,098030,Novak; Jonathan I,11,0,15,4
1668467831499,MATH 221A,A00,098031,Ebenfelt; Peter F,13,0,15,2
1668467831921,MATH 231B,A00,098032,Zlatos; Andrej,11,0,15,4
1668467832349,MATH 240B,A00,098033,Ni; Lei,9,0,15,6
1668467832787,MATH 243,A00,098034,Jekel; David Andrew,10,0,10,0
1668467833220,MATH 245A,A00,098035,Nie; Jiawang,0,2,15,16
1668467833646,MATH 248,A00,098036,Bejenaru; Ioan,10,0,10,0
1668467834072,MATH 250B,A00,098037,Spolaor; Luca,14,0,15,1
1668467834496,MATH 258,A00,098038,Ni; Lei,9,0,10,1
1668467834925,MATH 264B,A00,098041,Rhoades; Brendon Patrick,9,0,15,6
1668467835360,MATH 268,A00,098042,Buss; Samuel R,10,0,10,0
1668467835789,MATH 269,A00,098043,Rhoades; Brendon Patrick,10,0,10,0
1668467836225,MATH 270B,A00,098044,Li; Bo,10,0,15,5
1668467836650,MATH 272B,A00,098045,Holst; Michael J,13,0,15,2
1668467837090,MATH 273A,A00,098046,Tian; Xiaochuan,10,0,15,5
1668467837523,MATH 275,A01,098048,Tian; Xiaochuan,6,0,10,4
1668467837964,MATH 278A,A00,098049,Holst; Michael J,8,0,10,2
1668467838389,MATH 278B,A00,098050,Cloninger; Alexander,10,0,10,0
1668467838818,MATH 278C,A00,098051,Nie; Jiawang,6,0,10,4
1668467839271,MATH 280B,A00,098052,Zheng; Tianyi,7,0,15,8
1668467839712,MATH 281B,A00,098053,Bradic; Jelena,0,2,15,15
1668467840146,MATH 282B,A00,098054,Arias-Castro; Ery,0,0,15,15
1668467840569,MATH 285,A00,098055,Fitzsimmons; Patrick J,0,2,15,17
1668467840993,MATH 287B,A00,098056,Arias-Castro; Ery,2,0,15,13
1668467841434,MATH 288,A00,098057,Agarwal; Pooja,9,0,10,1
1668467841434,MATH 288,B00,098058,Zhang; Danna,8,0,10,2
1668467841434,MATH 288,C00,098059,Williams; Ruth J,9,0,10,1
1668467841864,MATH 290B,A00,098060,Roberts; Justin Deritter,13,0,15,2
1668467842306,MATH 292,A00,098061,Belmont; Eva Kinoshita,10,0,10,0
1668467842733,MATH 295,A00,098062,Suk; Andrew Hoon,48,0,50,2
1668467843156,MATH 296,A00,098063,Novak; Jonathan I,20,0,20,0
1668467843593,MATH 297,001,098064,Gamst; Anthony Collins,9997,0,9999,2
1668468347234,COGS 205,A00,101395,Chiba; Andrea,19,0,20,1
1668468347658,COGS 210B,001,101404,Greene; Deanna Jacquelyn,9998,0,9999,1
1668468347658,COGS 210B,002,101417,Xia; Haijun,9999,0,9999,0
1668468347658,COGS 210B,003,101422,Nitz; Douglas A.,9999,0,9999,0
1668468347658,COGS 210B,004,101423,Hollan; James D.,9998,0,9999,1
1668468347658,COGS 210B,005,101424,Deak; Gedeon O.,9998,0,9999,1
1668468347658,COGS 210B,006,101425,Rossano; Federico,9999,0,9999,0
1668468348088,COGS 211B,A00,101427,Coulson; Seana M,9996,0,9999,3
1668468348511,COGS 220,A00,101428,Hollan; James D.,1,9,25,24
1668468348935,COGS 229,A00,101429,Dow; Steven P,17,0,25,8
1668468349359,COGS 230,A00,101430,Klemmer; Scott R,8,0,17,9
1668468349781,COGS 234,A00,101431,Xia; Haijun,2,0,25,23
1668468350208,COGS 260,A00,101432,Kiyonaga; Anastasia,21,0,25,4
1668468350208,COGS 260,B00,101433,Kirsh; David Joel,15,0,25,10
1668468350633,CSE 202,A00,102371,Impagliazzo; Russell,0,58,0,0
1668468351057,CSE 203B,A01,102373,Cheng; Chung Kuan,0,49,0,0
1668468351484,CSE 208,A00,102374,Micciancio; Daniele,0,4,0,0
1668468351920,CSE 209A,A00,112895,Impagliazzo; Russell,0,12,15,15
1668468352347,CSE 209B,A00,108005,Bellare; Mihir,0,6,0,0
1668468352774,CSE 210,A00,113163,Coblenz; Michael J,0,76,0,0
1668468353210,CSE 219,A00,106111,Dow; Steven P,0,6,20,20
1668468353637,CSE 221,A00,102376,Voelker; Geoffrey M.,0,64,0,0
1668468354070,CSE 224,A01,102378,Porter; George M,0,154,0,0
1668468354502,CSE 229A,A00,102379,Savage; Stefan,0,9,0,0
1668468354926,CSE 229C,A00,102380,Munyaka; Imani N. S.,0,8,0,0
1668468355359,CSE 232B,A00,102382,Deutsch; Alin Bernard,0,29,0,0
1668468355796,CSE 234,A01,112904,Kumar; Arun Kumar,0,0,0,0
1668468356218,CSE 237A,A00,102383,Rosing; Tajana Simunic,0,47,0,0
1668468356645,CSE 239A,A00,102384,Deutsch; Alin Bernard,0,12,0,0
1668468357090,CSE 239B,A00,102385,Polikarpova; Nadezhda,0,10,0,0
1668468357515,CSE 240A,A00,102386,Pannuto; Patrick William,0,43,0,0
1668468357942,CSE 240B,A00,102387,Zhao; Jishen,0,40,0,0
1668468358378,CSE 241A,A00,106406,Kang; Mingu,0,6,0,0
1668468358814,CSE 249B,A00,102388,Kahng; Andrew Byun,0,5,8,8
1668468359261,CSE 251B,A01,102392,Cottrell; Garrison W,0,39,0,0
1668468359261,CSE 251B,A02,102393,Cottrell; Garrison W,0,32,0,0
1668468359690,CSE 252B,A00,102394,Ochoa; Benjamin Lawrence,0,51,0,0
1668468360119,CSE 257,A01,102396,Gao; Sicun,0,126,0,0
1668468360546,CSE 272,A00,102397,Li; Tzumao,0,17,0,0
1668468360977,CSE 274,A00,111323,Chern; Albert Ren-Haur,0,11,0,0
1668468361408,CSE 282,A00,102398,Pevzner; Pavel Arkadjevich,0,0,0,0
1668468361837,CSE 284,A00,114175,Gymrek; Melissa Ann,0,17,0,0
1668468362265,CSE 290,A00,102399,Chandraker; Manmohan Krishna,0,10,0,0
1668468362265,CSE 290,B00,102400,Vaccaro; Kristen Marie,0,7,25,25
1668468362265,CSE 290,C00,102414,Pannuto; Patrick William,0,1,25,25
1668468362265,CSE 290,D00,102427,Pevzner; Pavel Arkadjevich,0,0,0,0
1668468362265,CSE 290,E00,102429,Zhao; Jishen,0,4,0,0
1668468362265,CSE 290,F00,102436,Tullsen; Dean Michael,0,5,0,0
1668468362265,CSE 290,G00,102440,Christensen; Henrik I,0,6,20,20
1668468362694,CSE 291,A00,102443,Su; Hao,0,0,0,0
1668468362694,CSE 291,B00,102448,Polikarpova; Nadezhda,0,0,0,0
1668468362694,CSE 291,C00,102453,Vaccaro; Kristen Marie,0,0,0,0
1668468362694,CSE 291,D00,111343,Savage; Stefan,0,0,0,0
1668468362694,CSE 291,E00,116474,Claffy; Kimberly Claire,0,0,0,0
1668468362694,CSE 291,F00,116479,Pasquale; Joseph,0,0,0,0
1668468363123,CSE 293,001,119111,Bafna; Vineet,9999,0,9999,0
1668468363123,CSE 293,002,119118,Bellare; Mihir,9999,0,9999,0
1668468363123,CSE 293,003,119122,Berg-Kirkpatrick; Taylor D,9999,0,9999,0
1668468363123,CSE 293,004,119135,Christensen; Henrik I,9999,0,9999,0
1668468363123,CSE 293,005,119142,Cottrell; Garrison W,9999,0,9999,0
1668468363123,CSE 293,006,119146,Deutsch; Alin Bernard,9999,0,9999,0
1668468363123,CSE 293,007,119159,Esmaeilzadeh; Hadi,9999,0,9999,0
1668468363123,CSE 293,008,119166,Freund; Yoav,9999,0,9999,0
1668468363123,CSE 293,009,119170,Griswold; William G.,9999,0,9999,0
1668468363123,CSE 293,010,119183,Gymrek; Melissa Ann,9999,0,9999,0
1668468363123,CSE 293,011,119190,Heninger; Nadia A,9999,0,9999,0
1668468363123,CSE 293,012,119230,Impagliazzo; Russell,9999,0,9999,0
1668468363123,CSE 293,013,119232,Jhala; Ranjit,9999,0,9999,0
1668468363123,CSE 293,014,119233,Kahng; Andrew Byun,9999,0,9999,0
1668468363123,CSE 293,015,119298,Kane; Daniel Mertz,9999,0,9999,0
1668468363123,CSE 293,016,119299,Kriegman; David J,9999,0,9999,0
1668468363123,CSE 293,017,119300,Kumar; Arun Kumar,9999,0,9999,0
1668468363123,CSE 293,018,119301,Lerner; Sorin,9999,0,9999,0
1668468363123,CSE 293,019,119302,Lovett; Shachar,9999,0,9999,0
1668468363123,CSE 293,020,119303,McAuley; Julian John,9999,0,9999,0
1668468363123,CSE 293,021,119304,Micciancio; Daniele,9999,0,9999,0
1668468363123,CSE 293,022,119367,Orailoglu; Alex,9999,0,9999,0
1668468363123,CSE 293,023,119382,Paturi; Ramamohan,9999,0,9999,0
1668468363123,CSE 293,024,119404,Polikarpova; Nadezhda,9999,0,9999,0
1668468363123,CSE 293,025,119406,Politz; Joseph Gibbs,9999,0,9999,0
1668468363123,CSE 293,026,119411,Porter; George M,9999,0,9999,0
1668468363123,CSE 293,027,119414,Porter; Leonard Emerson,9999,0,9999,0
1668468363123,CSE 293,028,119416,Ramamoorthi; Ravi,9999,0,9999,0
1668468363123,CSE 293,029,119417,Sahoo; Debashis,9999,0,9999,0
1668468363123,CSE 293,030,119420,Saul; Lawrence,9999,0,9999,0
1668468363123,CSE 293,031,119421,Savage; Stefan,9999,0,9999,0
1668468363123,CSE 293,032,119425,Schulze; Jurgen P.,9999,0,9999,0
1668468363123,CSE 293,033,119426,Snoeren; Alex C.,9999,0,9999,0
1668468363123,CSE 293,034,119428,Shang; Jingbo,9999,0,9999,0
1668468363123,CSE 293,035,119430,Stefan; Deian,9999,0,9999,0
1668468363123,CSE 293,036,119431,Su; Hao,9999,0,9999,0
1668468363123,CSE 293,037,119433,Swanson; Steven James,9999,0,9999,0
1668468363123,CSE 293,038,119435,Tullsen; Dean Michael,9999,0,9999,0
1668468363123,CSE 293,039,119483,Voelker; Geoffrey M.,9999,0,9999,0
1668468363123,CSE 293,040,119537,Zhao; Jishen,9999,0,9999,0
1668468363123,CSE 293,041,119538,Zhou; Yuan-Yuan,9999,0,9999,0
1668468363123,CSE 293,042,119539,Gao; Sicun,9999,0,9999,0
1668468363123,CSE 293,043,119540,Weibel; Nadir,9999,0,9999,0
1668468363123,CSE 293,044,119541,Gupta; Rajesh K.,9999,0,9999,0
1668468363123,CSE 293,045,126410,Vaccaro; Kristen Marie,9999,0,9999,0
1668468363123,CSE 293,046,126411,Klemke; Richard,9999,0,9999,0
1668468363549,CSE 294,A00,102459,Voelker; Geoffrey M.,0,2,0,0
1668468363549,CSE 294,B00,111322,Orailoglu; Alex,0,1,0,0
1668468363979,DSE 201,A00,096914,Deutsch; Alin Bernard,30,0,30,0
1668468364417,DSE 210,A00,096915,Dasgupta; Sanjoy,30,0,30,0
1668468364841,DSE 260A,A00,096916,Altintas De Callaf; Ilkay,30,0,30,0
1668468365271,ECE 200,001,103586,Antipa; Nicholas A,9999,0,9999,0
1668468365271,ECE 200,002,103587,Atanasov; Nikolay A.,9999,0,9999,0
1668468365271,ECE 200,003,103588,Bharadia; Dinesh,9999,0,9999,0
1668468365271,ECE 200,004,103589,Cheng; Chung Kuan,9999,0,9999,0
1668468365271,ECE 200,005,103590,Cosman; Pamela C.,9999,0,9999,0
1668468365271,ECE 200,006,103591,Dayeh; Shadi Ahmad,9999,0,9999,0
1668468365271,ECE 200,007,103592,Fainman; Yeshaiahu,9999,0,9999,0
1668468365271,ECE 200,008,103593,Ford; Joseph Earl,9999,0,9999,0
1668468365271,ECE 200,009,103594,Franceschetti; Massimo,9999,0,9999,0
1668468365271,ECE 200,010,103595,Fullerton; Eric E,9999,0,9999,0
1668468365271,ECE 200,011,103596,Galton; Ian A,9999,0,9999,0
1668468365271,ECE 200,012,103597,Gilja; Vikash,9999,0,9999,0
1668468365271,ECE 200,013,103598,Hall; Drew A.,9999,0,9999,0
1668468365271,ECE 200,014,103599,Hsueh; Tzu-Chien,9999,0,9999,0
1668468365271,ECE 200,015,103600,Javidi; Tara,9999,0,9999,0
1668468365271,ECE 200,016,103601,Kahng; Andrew Byun,9999,0,9999,0
1668468365271,ECE 200,017,103602,Kim; Young-Han,9999,0,9999,0
1668468365271,ECE 200,018,103603,Koushanfar; Farinaz,9999,0,9999,0
1668468365271,ECE 200,019,103604,Kuzum; Duygu,9999,0,9999,0
1668468365271,ECE 200,020,103605,Le; Hanh-Phuc,9999,0,9999,0
1668468365271,ECE 200,021,103606,Lin; Bill,9999,0,9999,0
1668468365271,ECE 200,022,103607,Liu; Zhaowei,9998,0,9999,1
1668468365271,ECE 200,023,103608,Lo; Yu-Hwa,9999,0,9999,0
1668468365271,ECE 200,024,103609,Lomakin; Vitaliy,9999,0,9999,0
1668468365271,ECE 200,025,103610,Mercier; Patrick Philip,9999,0,9999,0
1668468365271,ECE 200,026,103611,Meyer; Florian,9999,0,9999,0
1668468365271,ECE 200,027,103612,Milstein; Laurence B.,9999,0,9999,0
1668468365271,ECE 200,028,103613,Mir Arabbaygi; Siavash,9999,0,9999,0
1668468365271,ECE 200,029,103614,Mookherjea; Shayan,9999,0,9999,0
1668468365271,ECE 200,030,103615,Morris; Karcher William,9999,0,9999,0
1668468365271,ECE 200,031,103616,Ng; Tse Nga,9999,0,9999,0
1668468365271,ECE 200,032,103617,Nguyen; Truong Quang,9999,0,9999,0
1668468365271,ECE 200,033,103618,Nomura; Kenji,9999,0,9999,0
1668468365271,ECE 200,034,103619,Orlitsky; Alon,9999,0,9999,0
1668468365271,ECE 200,035,103620,Pal; Piya,9999,0,9999,0
1668468365271,ECE 200,036,103621,Papen; George C.,9999,0,9999,0
1668468365271,ECE 200,037,103622,Radic; Stojan,9999,0,9999,0
1668468365271,ECE 200,038,103623,Rao; Bhaskar D.,9999,0,9999,0
1668468365271,ECE 200,039,103624,Rao; Ramesh R,9999,0,9999,0
1668468365271,ECE 200,040,103625,Rebeiz; Gabriel,9999,0,9999,0
1668468365271,ECE 200,041,103626,Sanford; John R,9999,0,9999,0
1668468365271,ECE 200,042,103627,Siegel; Paul H.,9999,0,9999,0
1668468365271,ECE 200,043,103628,Sievenpiper; Daniel F.,9999,0,9999,0
1668468365271,ECE 200,044,103629,Sworder; David D.,9999,0,9999,0
1668468365271,ECE 200,045,103630,Taur; Yuan,9999,0,9999,0
1668468365271,ECE 200,046,103631,Touri; Behrouz,9999,0,9999,0
1668468365271,ECE 200,047,103632,Trivedi; Mohan M.,9999,0,9999,0
1668468365271,ECE 200,048,103633,Vasconcelos; Nuno,9999,0,9999,0
1668468365271,ECE 200,049,103634,Wang; Xiaolong,9999,0,9999,0
1668468365271,ECE 200,050,103635,Xie; Pengtao,9999,0,9999,0
1668468365271,ECE 200,051,103636,Yip; Michael,9999,0,9999,0
1668468365271,ECE 200,052,103637,Zeger; Kenneth A.,999,0,999,0
1668468365271,ECE 200,053,103638,Zhang; Xinyu,9999,0,9999,0
1668468365271,ECE 200,054,103639,Turakhia; Yatish Girish,9999,0,9999,0
1668468365271,ECE 200,055,103640,Kang; Mingu,9999,0,9999,0
1668468365271,ECE 200,056,103641,Shi; Yuanyuan,9999,0,9999,0
1668468365271,ECE 200,057,103642,Wang; Edward Jay,9999,0,9999,0
1668468365271,ECE 200,058,103643,Zheng; Yang,9999,0,9999,0
1668468365694,ECE 202,A00,103644,Kuzum; Duygu,0,39,0,0
1668468366117,ECE 212BN,A00,103646,Ng; Tse Nga,0,7,0,0
1668468366541,ECE 221,A00,111493,Staff,0,0,0,0
1668468366965,ECE 222B,A00,103647,Lomakin; Vitaliy,0,14,0,0
1668468367388,ECE 230B,A00,103648,Taur; Yuan,0,2,0,0
1668468367814,ECE 238B,A00,103649,Garay; Javier,0,0,0,0
1668468368237,ECE 240B,A00,112900,Fainman; Yeshaiahu,0,5,0,0
1668468368671,ECE 247A,A00,103650,Jokerst; Jesse Vincent,0,5,0,0
1668468369099,ECE 247B,A00,103651,Wang; Joseph,0,11,0,0
1668468369532,ECE 250,A00,103652,Siegel; Paul H.,0,76,0,0
1668468369955,ECE 251A,A00,103654,Rao; Bhaskar D.,0,59,0,0
1668468370380,ECE 257B,A00,103655,Bharadia; Dinesh,0,30,0,0
1668468370810,ECE 258A,A00,103656,Milstein; Laurence B.,0,29,0,0
1668468371244,ECE 260B,A00,103658,Kang; Mingu,0,119,0,0
1668468371671,ECE 264A,A00,103659,Galton; Ian A,0,64,0,0
1668468372095,ECE 265A,A00,103661,Gudem; Prasad S.S.,0,57,0,0
1668468372519,ECE 265D,A00,103662,Gudem; Prasad S.S.,0,24,0,0
1668468372948,ECE 268,A00,103663,Koushanfar; Farinaz,0,41,0,0
1668468373376,ECE 269,A01,103665,Pal; Piya,0,196,0,0
1668468373814,ECE 271B,A00,103666,Vasconcelos; Manuela,0,68,0,0
1668468374240,ECE 276A,A00,103667,Atanasov; Nikolay A.,0,117,0,0
1668468374669,ECE 277,A00,103668,An; Cheolhong,0,139,0,0
1668468375093,ECE 279,A00,117947,Hall; Drew A.,0,22,0,0
1668468375955,ECE 283,A00,103670,Hsueh; Tzu-Chien,0,51,0,0
1668468376379,ECE 284,A00,103671,Turakhia; Yatish Girish,0,39,0,0
1668468376814,ECE 285,A00,103672,Zheng; Yang,0,36,0,0
1668468376814,ECE 285,B00,103673,Sworder; David D.,0,54,0,0
1668468377242,ECE 287,A00,103676,Javidi; Tara,0,8,0,0
1668468377666,MATH 200B,A00,098023,Salehi Golsefidy; Alireza,12,0,15,3
1668468378092,MATH 202B,A00,098024,Rhoades; Brendon Patrick,9,0,15,6
1668468378527,MATH 203B,A00,098025,Oprea; Dragos N.,10,0,15,5
1668468378953,MATH 204B,A00,098026,Sorensen; Claus M,13,0,15,2
1668468379379,MATH 208,A00,098027,Izadi; Elham,7,0,10,3
1668468379802,MATH 209,A00,098028,Pollack; Aaron,10,0,10,0
1668468380230,MATH 211A,A00,112919,Rogalski; Daniel,9,0,10,1
1668468380653,MATH 211B,A00,112920,Seward; Brandon M.,9,0,10,1
1668468381075,MATH 218,A00,098029,Li; Bo,10,0,10,0
1668468381510,MATH 220B,A00,098030,Novak; Jonathan I,11,0,15,4
1668468381933,MATH 221A,A00,098031,Ebenfelt; Peter F,13,0,15,2
1668468382374,MATH 231B,A00,098032,Zlatos; Andrej,11,0,15,4
1668468382802,MATH 240B,A00,098033,Ni; Lei,9,0,15,6
1668468383226,MATH 243,A00,098034,Jekel; David Andrew,10,0,10,0
1668468383653,MATH 245A,A00,098035,Nie; Jiawang,0,2,15,16
1668468384080,MATH 248,A00,098036,Bejenaru; Ioan,10,0,10,0
1668468384505,MATH 250B,A00,098037,Spolaor; Luca,14,0,15,1
1668468384930,MATH 258,A00,098038,Ni; Lei,9,0,10,1
1668468385454,MATH 264B,A00,098041,Rhoades; Brendon Patrick,9,0,15,6
1668468385881,MATH 268,A00,098042,Buss; Samuel R,10,0,10,0
1668468386307,MATH 269,A00,098043,Rhoades; Brendon Patrick,10,0,10,0
1668468386731,MATH 270B,A00,098044,Li; Bo,10,0,15,5
1668468387158,MATH 272B,A00,098045,Holst; Michael J,13,0,15,2
1668468387588,MATH 273A,A00,098046,Tian; Xiaochuan,10,0,15,5
1668468388011,MATH 275,A01,098048,Tian; Xiaochuan,6,0,10,4
1668468388442,MATH 278A,A00,098049,Holst; Michael J,8,0,10,2
1668468388866,MATH 278B,A00,098050,Cloninger; Alexander,10,0,10,0
1668468389289,MATH 278C,A00,098051,Nie; Jiawang,6,0,10,4
1668468389726,MATH 280B,A00,098052,Zheng; Tianyi,7,0,15,8
1668468390149,MATH 281B,A00,098053,Bradic; Jelena,0,2,15,15
1668468390574,MATH 282B,A00,098054,Arias-Castro; Ery,0,0,15,15
1668468391003,MATH 285,A00,098055,Fitzsimmons; Patrick J,0,2,15,17
1668468391430,MATH 287B,A00,098056,Arias-Castro; Ery,2,0,15,13
1668468391868,MATH 288,A00,098057,Agarwal; Pooja,9,0,10,1
1668468391868,MATH 288,B00,098058,Zhang; Danna,8,0,10,2
1668468391868,MATH 288,C00,098059,Williams; Ruth J,9,0,10,1
1668468392296,MATH 290B,A00,098060,Roberts; Justin Deritter,13,0,15,2
1668468392726,MATH 292,A00,098061,Belmont; Eva Kinoshita,10,0,10,0
1668468393151,MATH 295,A00,098062,Suk; Andrew Hoon,48,0,50,2
1668468393576,MATH 296,A00,098063,Novak; Jonathan I,20,0,20,0
1668468394001,MATH 297,001,098064,Gamst; Anthony Collins,9997,0,9999,2
1668468897123,COGS 205,A00,101395,Chiba; Andrea,19,0,20,1
1668468897546,COGS 210B,001,101404,Greene; Deanna Jacquelyn,9998,0,9999,1
1668468897546,COGS 210B,002,101417,Xia; Haijun,9999,0,9999,0
1668468897546,COGS 210B,003,101422,Nitz; Douglas A.,9999,0,9999,0
1668468897546,COGS 210B,004,101423,Hollan; James D.,9998,0,9999,1
1668468897546,COGS 210B,005,101424,Deak; Gedeon O.,9998,0,9999,1
1668468897546,COGS 210B,006,101425,Rossano; Federico,9999,0,9999,0
1668468897973,COGS 211B,A00,101427,Coulson; Seana M,9996,0,9999,3
1668468898400,COGS 220,A00,101428,Hollan; James D.,1,9,25,24
1668468898824,COGS 229,A00,101429,Dow; Steven P,17,0,25,8
1668468899250,COGS 230,A00,101430,Klemmer; Scott R,8,0,17,9
1668468899675,COGS 234,A00,101431,Xia; Haijun,2,0,25,23
1668468900117,COGS 260,A00,101432,Kiyonaga; Anastasia,21,0,25,4
1668468900117,COGS 260,B00,101433,Kirsh; David Joel,15,0,25,10
1668468900542,CSE 202,A00,102371,Impagliazzo; Russell,0,58,0,0
1668468900973,CSE 203B,A01,102373,Cheng; Chung Kuan,0,49,0,0
1668468901404,CSE 208,A00,102374,Micciancio; Daniele,0,4,0,0
1668468901833,CSE 209A,A00,112895,Impagliazzo; Russell,0,12,15,15
1668468902260,CSE 209B,A00,108005,Bellare; Mihir,0,6,0,0
1668468902688,CSE 210,A00,113163,Coblenz; Michael J,0,77,0,0
1668468903122,CSE 219,A00,106111,Dow; Steven P,0,6,20,20
1668468903549,CSE 221,A00,102376,Voelker; Geoffrey M.,0,64,0,0
1668468903979,CSE 224,A01,102378,Porter; George M,0,154,0,0
1668468904407,CSE 229A,A00,102379,Savage; Stefan,0,9,0,0
1668468904833,CSE 229C,A00,102380,Munyaka; Imani N. S.,0,8,0,0
1668468905273,CSE 232B,A00,102382,Deutsch; Alin Bernard,0,29,0,0
1668468905699,CSE 234,A01,112904,Kumar; Arun Kumar,0,0,0,0
1668468906127,CSE 237A,A00,102383,Rosing; Tajana Simunic,0,47,0,0
1668468906555,CSE 239A,A00,102384,Deutsch; Alin Bernard,0,12,0,0
1668468906985,CSE 239B,A00,102385,Polikarpova; Nadezhda,0,10,0,0
1668468907497,CSE 240A,A00,102386,Pannuto; Patrick William,0,43,0,0
1668468907921,CSE 240B,A00,102387,Zhao; Jishen,0,40,0,0
1668468908347,CSE 241A,A00,106406,Kang; Mingu,0,6,0,0
1668468908770,CSE 249B,A00,102388,Kahng; Andrew Byun,0,5,8,8
1668468909197,CSE 251B,A01,102392,Cottrell; Garrison W,0,39,0,0
1668468909197,CSE 251B,A02,102393,Cottrell; Garrison W,0,32,0,0
1668468909622,CSE 252B,A00,102394,Ochoa; Benjamin Lawrence,0,53,0,0
1668468910048,CSE 257,A01,102396,Gao; Sicun,0,127,0,0
1668468910478,CSE 272,A00,102397,Li; Tzumao,0,17,0,0
1668468910904,CSE 274,A00,111323,Chern; Albert Ren-Haur,0,11,0,0
1668468911334,CSE 282,A00,102398,Pevzner; Pavel Arkadjevich,0,0,0,0
1668468911764,CSE 284,A00,114175,Gymrek; Melissa Ann,0,17,0,0
1668468912196,CSE 290,A00,102399,Chandraker; Manmohan Krishna,0,10,0,0
1668468912196,CSE 290,B00,102400,Vaccaro; Kristen Marie,0,7,25,25
1668468912196,CSE 290,C00,102414,Pannuto; Patrick William,0,1,25,25
1668468912196,CSE 290,D00,102427,Pevzner; Pavel Arkadjevich,0,0,0,0
1668468912196,CSE 290,E00,102429,Zhao; Jishen,0,4,0,0
1668468912196,CSE 290,F00,102436,Tullsen; Dean Michael,0,5,0,0
1668468912196,CSE 290,G00,102440,Christensen; Henrik I,0,6,20,20
1668468912635,CSE 291,A00,102443,Su; Hao,0,0,0,0
1668468912635,CSE 291,B00,102448,Polikarpova; Nadezhda,0,0,0,0
1668468912635,CSE 291,C00,102453,Vaccaro; Kristen Marie,0,0,0,0
1668468912635,CSE 291,D00,111343,Savage; Stefan,0,0,0,0
1668468912635,CSE 291,E00,116474,Claffy; Kimberly Claire,0,0,0,0
1668468912635,CSE 291,F00,116479,Pasquale; Joseph,0,0,0,0
1668468913064,CSE 293,001,119111,Bafna; Vineet,9999,0,9999,0
1668468913064,CSE 293,002,119118,Bellare; Mihir,9999,0,9999,0
1668468913064,CSE 293,003,119122,Berg-Kirkpatrick; Taylor D,9999,0,9999,0
1668468913064,CSE 293,004,119135,Christensen; Henrik I,9999,0,9999,0
1668468913064,CSE 293,005,119142,Cottrell; Garrison W,9999,0,9999,0
1668468913064,CSE 293,006,119146,Deutsch; Alin Bernard,9999,0,9999,0
1668468913064,CSE 293,007,119159,Esmaeilzadeh; Hadi,9999,0,9999,0
1668468913064,CSE 293,008,119166,Freund; Yoav,9999,0,9999,0
1668468913064,CSE 293,009,119170,Griswold; William G.,9999,0,9999,0
1668468913064,CSE 293,010,119183,Gymrek; Melissa Ann,9999,0,9999,0
1668468913064,CSE 293,011,119190,Heninger; Nadia A,9999,0,9999,0
1668468913064,CSE 293,012,119230,Impagliazzo; Russell,9999,0,9999,0
1668468913064,CSE 293,013,119232,Jhala; Ranjit,9999,0,9999,0
1668468913064,CSE 293,014,119233,Kahng; Andrew Byun,9999,0,9999,0
1668468913064,CSE 293,015,119298,Kane; Daniel Mertz,9999,0,9999,0
1668468913064,CSE 293,016,119299,Kriegman; David J,9999,0,9999,0
1668468913064,CSE 293,017,119300,Kumar; Arun Kumar,9999,0,9999,0
1668468913064,CSE 293,018,119301,Lerner; Sorin,9999,0,9999,0
1668468913064,CSE 293,019,119302,Lovett; Shachar,9999,0,9999,0
1668468913064,CSE 293,020,119303,McAuley; Julian John,9999,0,9999,0
1668468913064,CSE 293,021,119304,Micciancio; Daniele,9999,0,9999,0
1668468913064,CSE 293,022,119367,Orailoglu; Alex,9999,0,9999,0
1668468913064,CSE 293,023,119382,Paturi; Ramamohan,9999,0,9999,0
1668468913064,CSE 293,024,119404,Polikarpova; Nadezhda,9999,0,9999,0
1668468913064,CSE 293,025,119406,Politz; Joseph Gibbs,9999,0,9999,0
1668468913064,CSE 293,026,119411,Porter; George M,9999,0,9999,0
1668468913064,CSE 293,027,119414,Porter; Leonard Emerson,9999,0,9999,0
1668468913064,CSE 293,028,119416,Ramamoorthi; Ravi,9999,0,9999,0
1668468913064,CSE 293,029,119417,Sahoo; Debashis,9999,0,9999,0
1668468913064,CSE 293,030,119420,Saul; Lawrence,9999,0,9999,0
1668468913064,CSE 293,031,119421,Savage; Stefan,9999,0,9999,0
1668468913064,CSE 293,032,119425,Schulze; Jurgen P.,9999,0,9999,0
1668468913064,CSE 293,033,119426,Snoeren; Alex C.,9999,0,9999,0
1668468913064,CSE 293,034,119428,Shang; Jingbo,9999,0,9999,0
1668468913064,CSE 293,035,119430,Stefan; Deian,9999,0,9999,0
1668468913064,CSE 293,036,119431,Su; Hao,9999,0,9999,0
1668468913064,CSE 293,037,119433,Swanson; Steven James,9999,0,9999,0
1668468913064,CSE 293,038,119435,Tullsen; Dean Michael,9999,0,9999,0
1668468913064,CSE 293,039,119483,Voelker; Geoffrey M.,9999,0,9999,0
1668468913064,CSE 293,040,119537,Zhao; Jishen,9999,0,9999,0
1668468913064,CSE 293,041,119538,Zhou; Yuan-Yuan,9999,0,9999,0
1668468913064,CSE 293,042,119539,Gao; Sicun,9999,0,9999,0
1668468913064,CSE 293,043,119540,Weibel; Nadir,9999,0,9999,0
1668468913064,CSE 293,044,119541,Gupta; Rajesh K.,9999,0,9999,0
1668468913064,CSE 293,045,126410,Vaccaro; Kristen Marie,9999,0,9999,0
1668468913064,CSE 293,046,126411,Klemke; Richard,9999,0,9999,0
1668468913490,CSE 294,A00,102459,Voelker; Geoffrey M.,0,2,0,0
1668468913490,CSE 294,B00,111322,Orailoglu; Alex,0,1,0,0
1668468913914,DSE 201,A00,096914,Deutsch; Alin Bernard,30,0,30,0
1668468914337,DSE 210,A00,096915,Dasgupta; Sanjoy,30,0,30,0
1668468914762,DSE 260A,A00,096916,Altintas De Callaf; Ilkay,30,0,30,0
1668468915203,ECE 200,001,103586,Antipa; Nicholas A,9999,0,9999,0
1668468915203,ECE 200,002,103587,Atanasov; Nikolay A.,9999,0,9999,0
1668468915203,ECE 200,003,103588,Bharadia; Dinesh,9999,0,9999,0
1668468915203,ECE 200,004,103589,Cheng; Chung Kuan,9999,0,9999,0
1668468915203,ECE 200,005,103590,Cosman; Pamela C.,9999,0,9999,0
1668468915203,ECE 200,006,103591,Dayeh; Shadi Ahmad,9999,0,9999,0
1668468915203,ECE 200,007,103592,Fainman; Yeshaiahu,9999,0,9999,0
1668468915203,ECE 200,008,103593,Ford; Joseph Earl,9999,0,9999,0
1668468915203,ECE 200,009,103594,Franceschetti; Massimo,9999,0,9999,0
1668468915203,ECE 200,010,103595,Fullerton; Eric E,9999,0,9999,0
1668468915203,ECE 200,011,103596,Galton; Ian A,9999,0,9999,0
1668468915203,ECE 200,012,103597,Gilja; Vikash,9999,0,9999,0
1668468915203,ECE 200,013,103598,Hall; Drew A.,9999,0,9999,0
1668468915203,ECE 200,014,103599,Hsueh; Tzu-Chien,9999,0,9999,0
1668468915203,ECE 200,015,103600,Javidi; Tara,9999,0,9999,0
1668468915203,ECE 200,016,103601,Kahng; Andrew Byun,9999,0,9999,0
1668468915203,ECE 200,017,103602,Kim; Young-Han,9999,0,9999,0
1668468915203,ECE 200,018,103603,Koushanfar; Farinaz,9999,0,9999,0
1668468915203,ECE 200,019,103604,Kuzum; Duygu,9999,0,9999,0
1668468915203,ECE 200,020,103605,Le; Hanh-Phuc,9999,0,9999,0
1668468915203,ECE 200,021,103606,Lin; Bill,9999,0,9999,0
1668468915203,ECE 200,022,103607,Liu; Zhaowei,9998,0,9999,1
1668468915203,ECE 200,023,103608,Lo; Yu-Hwa,9999,0,9999,0
1668468915203,ECE 200,024,103609,Lomakin; Vitaliy,9999,0,9999,0
1668468915203,ECE 200,025,103610,Mercier; Patrick Philip,9999,0,9999,0
1668468915203,ECE 200,026,103611,Meyer; Florian,9999,0,9999,0
1668468915203,ECE 200,027,103612,Milstein; Laurence B.,9999,0,9999,0
1668468915203,ECE 200,028,103613,Mir Arabbaygi; Siavash,9999,0,9999,0
1668468915203,ECE 200,029,103614,Mookherjea; Shayan,9999,0,9999,0
1668468915203,ECE 200,030,103615,Morris; Karcher William,9999,0,9999,0
1668468915203,ECE 200,031,103616,Ng; Tse Nga,9999,0,9999,0
1668468915203,ECE 200,032,103617,Nguyen; Truong Quang,9999,0,9999,0
1668468915203,ECE 200,033,103618,Nomura; Kenji,9999,0,9999,0
1668468915203,ECE 200,034,103619,Orlitsky; Alon,9999,0,9999,0
1668468915203,ECE 200,035,103620,Pal; Piya,9999,0,9999,0
1668468915203,ECE 200,036,103621,Papen; George C.,9999,0,9999,0
1668468915203,ECE 200,037,103622,Radic; Stojan,9999,0,9999,0
1668468915203,ECE 200,038,103623,Rao; Bhaskar D.,9999,0,9999,0
1668468915203,ECE 200,039,103624,Rao; Ramesh R,9999,0,9999,0
1668468915203,ECE 200,040,103625,Rebeiz; Gabriel,9999,0,9999,0
1668468915203,ECE 200,041,103626,Sanford; John R,9999,0,9999,0
1668468915203,ECE 200,042,103627,Siegel; Paul H.,9999,0,9999,0
1668468915203,ECE 200,043,103628,Sievenpiper; Daniel F.,9999,0,9999,0
1668468915203,ECE 200,044,103629,Sworder; David D.,9999,0,9999,0
1668468915203,ECE 200,045,103630,Taur; Yuan,9999,0,9999,0
1668468915203,ECE 200,046,103631,Touri; Behrouz,9999,0,9999,0
1668468915203,ECE 200,047,103632,Trivedi; Mohan M.,9999,0,9999,0
1668468915203,ECE 200,048,103633,Vasconcelos; Nuno,9999,0,9999,0
1668468915203,ECE 200,049,103634,Wang; Xiaolong,9999,0,9999,0
1668468915203,ECE 200,050,103635,Xie; Pengtao,9999,0,9999,0
1668468915203,ECE 200,051,103636,Yip; Michael,9999,0,9999,0
1668468915203,ECE 200,052,103637,Zeger; Kenneth A.,999,0,999,0
1668468915203,ECE 200,053,103638,Zhang; Xinyu,9999,0,9999,0
1668468915203,ECE 200,054,103639,Turakhia; Yatish Girish,9999,0,9999,0
1668468915203,ECE 200,055,103640,Kang; Mingu,9999,0,9999,0
1668468915203,ECE 200,056,103641,Shi; Yuanyuan,9999,0,9999,0
1668468915203,ECE 200,057,103642,Wang; Edward Jay,9999,0,9999,0
1668468915203,ECE 200,058,103643,Zheng; Yang,9999,0,9999,0
1668468915630,ECE 202,A00,103644,Kuzum; Duygu,0,39,0,0
1668468916056,ECE 212BN,A00,103646,Ng; Tse Nga,0,7,0,0
1668468916479,ECE 221,A00,111493,Staff,0,0,0,0
1668468916918,ECE 222B,A00,103647,Lomakin; Vitaliy,0,14,0,0
1668468917342,ECE 230B,A00,103648,Taur; Yuan,0,2,0,0
1668468917773,ECE 238B,A00,103649,Garay; Javier,0,0,0,0
1668468918199,ECE 240B,A00,112900,Fainman; Yeshaiahu,0,5,0,0
1668468918628,ECE 247A,A00,103650,Jokerst; Jesse Vincent,0,5,0,0
1668468919052,ECE 247B,A00,103651,Wang; Joseph,0,11,0,0
1668468919477,ECE 250,A00,103652,Siegel; Paul H.,0,76,0,0
1668468919899,ECE 251A,A00,103654,Rao; Bhaskar D.,0,59,0,0
1668468920326,ECE 257B,A00,103655,Bharadia; Dinesh,0,30,0,0
1668468920750,ECE 258A,A00,103656,Milstein; Laurence B.,0,29,0,0
1668468921177,ECE 260B,A00,103658,Kang; Mingu,0,119,0,0
1668468921610,ECE 264A,A00,103659,Galton; Ian A,0,64,0,0
1668468922034,ECE 265A,A00,103661,Gudem; Prasad S.S.,0,59,0,0
1668468922458,ECE 265D,A00,103662,Gudem; Prasad S.S.,0,24,0,0
1668468922887,ECE 268,A00,103663,Koushanfar; Farinaz,0,41,0,0
1668468923313,ECE 269,A01,103665,Pal; Piya,0,197,0,0
1668468923736,ECE 271B,A00,103666,Vasconcelos; Manuela,0,68,0,0
1668468924160,ECE 276A,A00,103667,Atanasov; Nikolay A.,0,118,0,0
1668468924584,ECE 277,A00,103668,An; Cheolhong,0,139,0,0
1668468925021,ECE 279,A00,117947,Hall; Drew A.,0,22,0,0
1668468925872,ECE 283,A00,103670,Hsueh; Tzu-Chien,0,51,0,0
1668468926297,ECE 284,A00,103671,Turakhia; Yatish Girish,0,39,0,0
1668468926728,ECE 285,A00,103672,Zheng; Yang,0,36,0,0
1668468926728,ECE 285,B00,103673,Sworder; David D.,0,54,0,0
1668468927157,ECE 287,A00,103676,Javidi; Tara,0,8,0,0
1668468927580,MATH 200B,A00,098023,Salehi Golsefidy; Alireza,12,0,15,3
1668468928006,MATH 202B,A00,098024,Rhoades; Brendon Patrick,9,0,15,6
1668468928438,MATH 203B,A00,098025,Oprea; Dragos N.,10,0,15,5
1668468928868,MATH 204B,A00,098026,Sorensen; Claus M,13,0,15,2
1668468929294,MATH 208,A00,098027,Izadi; Elham,7,0,10,3
1668468929718,MATH 209,A00,098028,Pollack; Aaron,10,0,10,0
1668468930152,MATH 211A,A00,112919,Rogalski; Daniel,9,0,10,1
1668468930574,MATH 211B,A00,112920,Seward; Brandon M.,9,0,10,1
1668468931000,MATH 218,A00,098029,Li; Bo,10,0,10,0
1668468931425,MATH 220B,A00,098030,Novak; Jonathan I,11,0,15,4
1668468931854,MATH 221A,A00,098031,Ebenfelt; Peter F,13,0,15,2
1668468932282,MATH 231B,A00,098032,Zlatos; Andrej,11,0,15,4
1668468932710,MATH 240B,A00,098033,Ni; Lei,9,0,15,6
1668468933140,MATH 243,A00,098034,Jekel; David Andrew,10,0,10,0
1668468933576,MATH 245A,A00,098035,Nie; Jiawang,0,2,15,16
1668468933999,MATH 248,A00,098036,Bejenaru; Ioan,10,0,10,0
1668468934422,MATH 250B,A00,098037,Spolaor; Luca,14,0,15,1
1668468934847,MATH 258,A00,098038,Ni; Lei,9,0,10,1
1668468935270,MATH 264B,A00,098041,Rhoades; Brendon Patrick,9,0,15,6
1668468935697,MATH 268,A00,098042,Buss; Samuel R,10,0,10,0
1668468936120,MATH 269,A00,098043,Rhoades; Brendon Patrick,10,0,10,0
1668468936555,MATH 270B,A00,098044,Li; Bo,9,0,15,6
1668468936979,MATH 272B,A00,098045,Holst; Michael J,13,0,15,2
1668468937403,MATH 273A,A00,098046,Tian; Xiaochuan,10,0,15,5
1668468937833,MATH 275,A01,098048,Tian; Xiaochuan,6,0,10,4
1668468938263,MATH 278A,A00,098049,Holst; Michael J,8,0,10,2
1668468938689,MATH 278B,A00,098050,Cloninger; Alexander,10,0,10,0
1668468939116,MATH 278C,A00,098051,Nie; Jiawang,6,0,10,4
1668468939543,MATH 280B,A00,098052,Zheng; Tianyi,7,0,15,8
1668468939969,MATH 281B,A00,098053,Bradic; Jelena,0,2,15,15
1668468940401,MATH 282B,A00,098054,Arias-Castro; Ery,0,0,15,15
1668468940827,MATH 285,A00,098055,Fitzsimmons; Patrick J,0,2,15,17
1668468941261,MATH 287B,A00,098056,Arias-Castro; Ery,2,0,15,13
1668468941698,MATH 288,A00,098057,Agarwal; Pooja,9,0,10,1
1668468941698,MATH 288,B00,098058,Zhang; Danna,8,0,10,2
1668468941698,MATH 288,C00,098059,Williams; Ruth J,9,0,10,1
1668468942133,MATH 290B,A00,098060,Roberts; Justin Deritter,13,0,15,2
1668468942558,MATH 292,A00,098061,Belmont; Eva Kinoshita,10,0,10,0
1668468942988,MATH 295,A00,098062,Suk; Andrew Hoon,48,0,50,2
1668468943415,MATH 296,A00,098063,Novak; Jonathan I,20,0,20,0
1668468943844,MATH 297,001,098064,Gamst; Anthony Collins,9997,0,9999,2
1668469458140,COGS 205,A00,101395,Chiba; Andrea,19,0,20,1
1668469458569,COGS 210B,001,101404,Greene; Deanna Jacquelyn,9998,0,9999,1
1668469458569,COGS 210B,002,101417,Xia; Haijun,9999,0,9999,0
1668469458569,COGS 210B,003,101422,Nitz; Douglas A.,9999,0,9999,0
1668469458569,COGS 210B,004,101423,Hollan; James D.,9998,0,9999,1
1668469458569,COGS 210B,005,101424,Deak; Gedeon O.,9998,0,9999,1
1668469458569,COGS 210B,006,101425,Rossano; Federico,9999,0,9999,0
1668469459004,COGS 211B,A00,101427,Coulson; Seana M,9996,0,9999,3
1668469459431,COGS 220,A00,101428,Hollan; James D.,1,9,25,24
1668469459854,COGS 229,A00,101429,Dow; Steven P,17,0,25,8
1668469460281,COGS 230,A00,101430,Klemmer; Scott R,8,0,17,9
1668469460710,COGS 234,A00,101431,Xia; Haijun,2,0,25,23
1668469461136,COGS 260,A00,101432,Kiyonaga; Anastasia,21,0,25,4
1668469461136,COGS 260,B00,101433,Kirsh; David Joel,15,0,25,10
1668469461577,CSE 202,A00,102371,Impagliazzo; Russell,0,58,0,0
1668469462012,CSE 203B,A01,102373,Cheng; Chung Kuan,0,50,0,0
1668469462451,CSE 208,A00,102374,Micciancio; Daniele,0,4,0,0
1668469462874,CSE 209A,A00,112895,Impagliazzo; Russell,0,12,15,15
1668469463304,CSE 209B,A00,108005,Bellare; Mihir,0,6,0,0
1668469463739,CSE 210,A00,113163,Coblenz; Michael J,0,77,0,0
1668469464165,CSE 219,A00,106111,Dow; Steven P,0,6,20,20
1668469464589,CSE 221,A00,102376,Voelker; Geoffrey M.,0,64,0,0
1668469465032,CSE 224,A01,102378,Porter; George M,0,156,0,0
1668469465463,CSE 229A,A00,102379,Savage; Stefan,0,9,0,0
1668469465908,CSE 229C,A00,102380,Munyaka; Imani N. S.,0,8,0,0
1668469466334,CSE 232B,A00,102382,Deutsch; Alin Bernard,0,29,0,0
1668469466761,CSE 234,A01,112904,Kumar; Arun Kumar,0,0,0,0
1668469467185,CSE 237A,A00,102383,Rosing; Tajana Simunic,0,47,0,0
1668469467613,CSE 239A,A00,102384,Deutsch; Alin Bernard,0,12,0,0
1668469468041,CSE 239B,A00,102385,Polikarpova; Nadezhda,0,10,0,0
1668469468471,CSE 240A,A00,102386,Pannuto; Patrick William,0,43,0,0
1668469468912,CSE 240B,A00,102387,Zhao; Jishen,0,40,0,0
1668469469338,CSE 241A,A00,106406,Kang; Mingu,0,6,0,0
1668469469768,CSE 249B,A00,102388,Kahng; Andrew Byun,0,5,8,8
1668469470196,CSE 251B,A01,102392,Cottrell; Garrison W,0,39,0,0
1668469470196,CSE 251B,A02,102393,Cottrell; Garrison W,0,32,0,0
1668469470640,CSE 252B,A00,102394,Ochoa; Benjamin Lawrence,0,53,0,0
1668469471063,CSE 257,A01,102396,Gao; Sicun,0,127,0,0
1668469471495,CSE 272,A00,102397,Li; Tzumao,0,17,0,0
1668469471928,CSE 274,A00,111323,Chern; Albert Ren-Haur,0,11,0,0
1668469472353,CSE 282,A00,102398,Pevzner; Pavel Arkadjevich,0,0,0,0
1668469472776,CSE 284,A00,114175,Gymrek; Melissa Ann,0,17,0,0
1668469473199,CSE 290,A00,102399,Chandraker; Manmohan Krishna,0,10,0,0
1668469473199,CSE 290,B00,102400,Vaccaro; Kristen Marie,0,7,25,25
1668469473199,CSE 290,C00,102414,Pannuto; Patrick William,0,1,25,25
1668469473199,CSE 290,D00,102427,Pevzner; Pavel Arkadjevich,0,0,0,0
1668469473199,CSE 290,E00,102429,Zhao; Jishen,0,4,0,0
1668469473199,CSE 290,F00,102436,Tullsen; Dean Michael,0,5,0,0
1668469473199,CSE 290,G00,102440,Christensen; Henrik I,0,6,20,20
1668469473627,CSE 291,A00,102443,Su; Hao,0,0,0,0
1668469473627,CSE 291,B00,102448,Polikarpova; Nadezhda,0,0,0,0
1668469473627,CSE 291,C00,102453,Vaccaro; Kristen Marie,0,0,0,0
1668469473627,CSE 291,D00,111343,Savage; Stefan,0,0,0,0
1668469473627,CSE 291,E00,116474,Claffy; Kimberly Claire,0,0,0,0
1668469473627,CSE 291,F00,116479,Pasquale; Joseph,0,0,0,0
1668469474057,CSE 293,001,119111,Bafna; Vineet,9999,0,9999,0
1668469474057,CSE 293,002,119118,Bellare; Mihir,9999,0,9999,0
1668469474057,CSE 293,003,119122,Berg-Kirkpatrick; Taylor D,9999,0,9999,0
1668469474057,CSE 293,004,119135,Christensen; Henrik I,9999,0,9999,0
1668469474057,CSE 293,005,119142,Cottrell; Garrison W,9999,0,9999,0
1668469474057,CSE 293,006,119146,Deutsch; Alin Bernard,9999,0,9999,0
1668469474057,CSE 293,007,119159,Esmaeilzadeh; Hadi,9999,0,9999,0
1668469474057,CSE 293,008,119166,Freund; Yoav,9999,0,9999,0
1668469474057,CSE 293,009,119170,Griswold; William G.,9999,0,9999,0
1668469474057,CSE 293,010,119183,Gymrek; Melissa Ann,9999,0,9999,0
1668469474057,CSE 293,011,119190,Heninger; Nadia A,9999,0,9999,0
1668469474057,CSE 293,012,119230,Impagliazzo; Russell,9999,0,9999,0
1668469474057,CSE 293,013,119232,Jhala; Ranjit,9999,0,9999,0
1668469474057,CSE 293,014,119233,Kahng; Andrew Byun,9999,0,9999,0
1668469474057,CSE 293,015,119298,Kane; Daniel Mertz,9999,0,9999,0
1668469474057,CSE 293,016,119299,Kriegman; David J,9999,0,9999,0
1668469474057,CSE 293,017,119300,Kumar; Arun Kumar,9999,0,9999,0
1668469474057,CSE 293,018,119301,Lerner; Sorin,9999,0,9999,0
1668469474057,CSE 293,019,119302,Lovett; Shachar,9999,0,9999,0
1668469474057,CSE 293,020,119303,McAuley; Julian John,9999,0,9999,0
1668469474057,CSE 293,021,119304,Micciancio; Daniele,9999,0,9999,0
1668469474057,CSE 293,022,119367,Orailoglu; Alex,9999,0,9999,0
1668469474057,CSE 293,023,119382,Paturi; Ramamohan,9999,0,9999,0
1668469474057,CSE 293,024,119404,Polikarpova; Nadezhda,9999,0,9999,0
1668469474057,CSE 293,025,119406,Politz; Joseph Gibbs,9999,0,9999,0
1668469474057,CSE 293,026,119411,Porter; George M,9999,0,9999,0
1668469474057,CSE 293,027,119414,Porter; Leonard Emerson,9999,0,9999,0
1668469474057,CSE 293,028,119416,Ramamoorthi; Ravi,9999,0,9999,0
1668469474057,CSE 293,029,119417,Sahoo; Debashis,9999,0,9999,0
1668469474057,CSE 293,030,119420,Saul; Lawrence,9999,0,9999,0
1668469474057,CSE 293,031,119421,Savage; Stefan,9999,0,9999,0
1668469474057,CSE 293,032,119425,Schulze; Jurgen P.,9999,0,9999,0
1668469474057,CSE 293,033,119426,Snoeren; Alex C.,9999,0,9999,0
1668469474057,CSE 293,034,119428,Shang; Jingbo,9999,0,9999,0
1668469474057,CSE 293,035,119430,Stefan; Deian,9999,0,9999,0
1668469474057,CSE 293,036,119431,Su; Hao,9999,0,9999,0
1668469474057,CSE 293,037,119433,Swanson; Steven James,9999,0,9999,0
1668469474057,CSE 293,038,119435,Tullsen; Dean Michael,9999,0,9999,0
1668469474057,CSE 293,039,119483,Voelker; Geoffrey M.,9999,0,9999,0
1668469474057,CSE 293,040,119537,Zhao; Jishen,9999,0,9999,0
1668469474057,CSE 293,041,119538,Zhou; Yuan-Yuan,9999,0,9999,0
1668469474057,CSE 293,042,119539,Gao; Sicun,9999,0,9999,0
1668469474057,CSE 293,043,119540,Weibel; Nadir,9999,0,9999,0
1668469474057,CSE 293,044,119541,Gupta; Rajesh K.,9999,0,9999,0
1668469474057,CSE 293,045,126410,Vaccaro; Kristen Marie,9999,0,9999,0
1668469474057,CSE 293,046,126411,Klemke; Richard,9999,0,9999,0
1668469474482,CSE 294,A00,102459,Voelker; Geoffrey M.,0,2,0,0
1668469474482,CSE 294,B00,111322,Orailoglu; Alex,0,1,0,0
1668469474908,DSE 201,A00,096914,Deutsch; Alin Bernard,30,0,30,0
1668469475330,DSE 210,A00,096915,Dasgupta; Sanjoy,30,0,30,0
1668469475758,DSE 260A,A00,096916,Altintas De Callaf; Ilkay,30,0,30,0
1668469476225,ECE 200,001,103586,Antipa; Nicholas A,9999,0,9999,0
1668469476225,ECE 200,002,103587,Atanasov; Nikolay A.,9999,0,9999,0
1668469476225,ECE 200,003,103588,Bharadia; Dinesh,9999,0,9999,0
1668469476225,ECE 200,004,103589,Cheng; Chung Kuan,9999,0,9999,0
1668469476225,ECE 200,005,103590,Cosman; Pamela C.,9999,0,9999,0
1668469476225,ECE 200,006,103591,Dayeh; Shadi Ahmad,9999,0,9999,0
1668469476225,ECE 200,007,103592,Fainman; Yeshaiahu,9999,0,9999,0
1668469476225,ECE 200,008,103593,Ford; Joseph Earl,9999,0,9999,0
1668469476225,ECE 200,009,103594,Franceschetti; Massimo,9999,0,9999,0
1668469476225,ECE 200,010,103595,Fullerton; Eric E,9999,0,9999,0
1668469476225,ECE 200,011,103596,Galton; Ian A,9999,0,9999,0
1668469476225,ECE 200,012,103597,Gilja; Vikash,9999,0,9999,0
1668469476225,ECE 200,013,103598,Hall; Drew A.,9999,0,9999,0
1668469476225,ECE 200,014,103599,Hsueh; Tzu-Chien,9999,0,9999,0
1668469476225,ECE 200,015,103600,Javidi; Tara,9999,0,9999,0
1668469476225,ECE 200,016,103601,Kahng; Andrew Byun,9999,0,9999,0
1668469476225,ECE 200,017,103602,Kim; Young-Han,9999,0,9999,0
1668469476225,ECE 200,018,103603,Koushanfar; Farinaz,9999,0,9999,0
1668469476225,ECE 200,019,103604,Kuzum; Duygu,9999,0,9999,0
1668469476225,ECE 200,020,103605,Le; Hanh-Phuc,9999,0,9999,0
1668469476225,ECE 200,021,103606,Lin; Bill,9999,0,9999,0
1668469476225,ECE 200,022,103607,Liu; Zhaowei,9998,0,9999,1
1668469476225,ECE 200,023,103608,Lo; Yu-Hwa,9999,0,9999,0
1668469476225,ECE 200,024,103609,Lomakin; Vitaliy,9999,0,9999,0
1668469476225,ECE 200,025,103610,Mercier; Patrick Philip,9999,0,9999,0
1668469476225,ECE 200,026,103611,Meyer; Florian,9999,0,9999,0
1668469476225,ECE 200,027,103612,Milstein; Laurence B.,9999,0,9999,0
1668469476225,ECE 200,028,103613,Mir Arabbaygi; Siavash,9999,0,9999,0
1668469476225,ECE 200,029,103614,Mookherjea; Shayan,9999,0,9999,0
1668469476225,ECE 200,030,103615,Morris; Karcher William,9999,0,9999,0
1668469476225,ECE 200,031,103616,Ng; Tse Nga,9999,0,9999,0
1668469476225,ECE 200,032,103617,Nguyen; Truong Quang,9999,0,9999,0
1668469476225,ECE 200,033,103618,Nomura; Kenji,9999,0,9999,0
1668469476225,ECE 200,034,103619,Orlitsky; Alon,9999,0,9999,0
1668469476225,ECE 200,035,103620,Pal; Piya,9999,0,9999,0
1668469476225,ECE 200,036,103621,Papen; George C.,9999,0,9999,0
1668469476225,ECE 200,037,103622,Radic; Stojan,9999,0,9999,0
1668469476225,ECE 200,038,103623,Rao; Bhaskar D.,9999,0,9999,0
1668469476225,ECE 200,039,103624,Rao; Ramesh R,9999,0,9999,0
1668469476225,ECE 200,040,103625,Rebeiz; Gabriel,9999,0,9999,0
1668469476225,ECE 200,041,103626,Sanford; John R,9999,0,9999,0
1668469476225,ECE 200,042,103627,Siegel; Paul H.,9999,0,9999,0
1668469476225,ECE 200,043,103628,Sievenpiper; Daniel F.,9999,0,9999,0
1668469476225,ECE 200,044,103629,Sworder; David D.,9999,0,9999,0
1668469476225,ECE 200,045,103630,Taur; Yuan,9999,0,9999,0
1668469476225,ECE 200,046,103631,Touri; Behrouz,9999,0,9999,0
1668469476225,ECE 200,047,103632,Trivedi; Mohan M.,9999,0,9999,0
1668469476225,ECE 200,048,103633,Vasconcelos; Nuno,9999,0,9999,0
1668469476225,ECE 200,049,103634,Wang; Xiaolong,9999,0,9999,0
1668469476225,ECE 200,050,103635,Xie; Pengtao,9999,0,9999,0
1668469476225,ECE 200,051,103636,Yip; Michael,9999,0,9999,0
1668469476225,ECE 200,052,103637,Zeger; Kenneth A.,999,0,999,0
1668469476225,ECE 200,053,103638,Zhang; Xinyu,9999,0,9999,0
1668469476225,ECE 200,054,103639,Turakhia; Yatish Girish,9999,0,9999,0
1668469476225,ECE 200,055,103640,Kang; Mingu,9999,0,9999,0
1668469476225,ECE 200,056,103641,Shi; Yuanyuan,9999,0,9999,0
1668469476225,ECE 200,057,103642,Wang; Edward Jay,9999,0,9999,0
1668469476225,ECE 200,058,103643,Zheng; Yang,9999,0,9999,0
1668469476668,ECE 202,A00,103644,Kuzum; Duygu,0,39,0,0
1668469477096,ECE 212BN,A00,103646,Ng; Tse Nga,0,7,0,0
1668469477520,ECE 221,A00,111493,Staff,0,0,0,0
1668469477947,ECE 222B,A00,103647,Lomakin; Vitaliy,0,14,0,0
1668469478386,ECE 230B,A00,103648,Taur; Yuan,0,2,0,0
1668469478809,ECE 238B,A00,103649,Garay; Javier,0,0,0,0
1668469479239,ECE 240B,A00,112900,Fainman; Yeshaiahu,0,5,0,0
1668469479672,ECE 247A,A00,103650,Jokerst; Jesse Vincent,0,5,0,0
1668469480099,ECE 247B,A00,103651,Wang; Joseph,0,11,0,0
1668469480525,ECE 250,A00,103652,Siegel; Paul H.,0,77,0,0
1668469480953,ECE 251A,A00,103654,Rao; Bhaskar D.,0,59,0,0
1668469481389,ECE 257B,A00,103655,Bharadia; Dinesh,0,30,0,0
1668469481811,ECE 258A,A00,103656,Milstein; Laurence B.,0,29,0,0
1668469482236,ECE 260B,A00,103658,Kang; Mingu,0,119,0,0
1668469482671,ECE 264A,A00,103659,Galton; Ian A,0,64,0,0
1668469483107,ECE 265A,A00,103661,Gudem; Prasad S.S.,0,59,0,0
1668469483531,ECE 265D,A00,103662,Gudem; Prasad S.S.,0,24,0,0
1668469484061,ECE 268,A00,103663,Koushanfar; Farinaz,0,41,0,0
1668469484484,ECE 269,A01,103665,Pal; Piya,0,197,0,0
1668469484908,ECE 271B,A00,103666,Vasconcelos; Manuela,0,68,0,0
1668469485336,ECE 276A,A00,103667,Atanasov; Nikolay A.,0,118,0,0
1668469485767,ECE 277,A00,103668,An; Cheolhong,0,139,0,0
1668469486192,ECE 279,A00,117947,Hall; Drew A.,0,22,0,0
1668469487045,ECE 283,A00,103670,Hsueh; Tzu-Chien,0,51,0,0
1668469487479,ECE 284,A00,103671,Turakhia; Yatish Girish,0,39,0,0
1668469487904,ECE 285,A00,103672,Zheng; Yang,0,36,0,0
1668469487904,ECE 285,B00,103673,Sworder; David D.,0,54,0,0
1668469488332,ECE 287,A00,103676,Javidi; Tara,0,8,0,0
1668469488761,MATH 200B,A00,098023,Salehi Golsefidy; Alireza,12,0,15,3
1668469489185,MATH 202B,A00,098024,Rhoades; Brendon Patrick,9,0,15,6
1668469489612,MATH 203B,A00,098025,Oprea; Dragos N.,10,0,15,5
1668469490036,MATH 204B,A00,098026,Sorensen; Claus M,13,0,15,2
1668469490464,MATH 208,A00,098027,Izadi; Elham,7,0,10,3
1668469490887,MATH 209,A00,098028,Pollack; Aaron,10,0,10,0
1668469491312,MATH 211A,A00,112919,Rogalski; Daniel,9,0,10,1
1668469491742,MATH 211B,A00,112920,Seward; Brandon M.,9,0,10,1
1668469492167,MATH 218,A00,098029,Li; Bo,10,0,10,0
1668469492595,MATH 220B,A00,098030,Novak; Jonathan I,11,0,15,4
1668469493023,MATH 221A,A00,098031,Ebenfelt; Peter F,13,0,15,2
1668469493454,MATH 231B,A00,098032,Zlatos; Andrej,11,0,15,4
1668469493885,MATH 240B,A00,098033,Ni; Lei,9,0,15,6
1668469494309,MATH 243,A00,098034,Jekel; David Andrew,10,0,10,0
1668469494734,MATH 245A,A00,098035,Nie; Jiawang,0,2,15,16
1668469495167,MATH 248,A00,098036,Bejenaru; Ioan,10,0,10,0
1668469495590,MATH 250B,A00,098037,Spolaor; Luca,14,0,15,1
1668469496014,MATH 258,A00,098038,Ni; Lei,9,0,10,1
1668469496441,MATH 264B,A00,098041,Rhoades; Brendon Patrick,9,0,15,6
1668469496869,MATH 268,A00,098042,Buss; Samuel R,10,0,10,0
1668469497293,MATH 269,A00,098043,Rhoades; Brendon Patrick,10,0,10,0
1668469497716,MATH 270B,A00,098044,Li; Bo,9,0,15,6
1668469498242,MATH 272B,A00,098045,Holst; Michael J,13,0,15,2
1668469498675,MATH 273A,A00,098046,Tian; Xiaochuan,10,0,15,5
1668469499102,MATH 275,A01,098048,Tian; Xiaochuan,6,0,10,4
1668469499527,MATH 278A,A00,098049,Holst; Michael J,8,0,10,2
1668469499970,MATH 278B,A00,098050,Cloninger; Alexander,10,0,10,0
1668469500397,MATH 278C,A00,098051,Nie; Jiawang,6,0,10,4
1668469500836,MATH 280B,A00,098052,Zheng; Tianyi,7,0,15,8
1668469501261,MATH 281B,A00,098053,Bradic; Jelena,0,2,15,15
1668469501695,MATH 282B,A00,098054,Arias-Castro; Ery,0,0,15,15
1668469502118,MATH 285,A00,098055,Fitzsimmons; Patrick J,0,2,15,17
1668469502541,MATH 287B,A00,098056,Arias-Castro; Ery,2,0,15,13
1668469502974,MATH 288,A00,098057,Agarwal; Pooja,9,0,10,1
1668469502974,MATH 288,B00,098058,Zhang; Danna,8,0,10,2
1668469502974,MATH 288,C00,098059,Williams; Ruth J,9,0,10,1
1668469503399,MATH 290B,A00,098060,Roberts; Justin Deritter,13,0,15,2
1668469503824,MATH 292,A00,098061,Belmont; Eva Kinoshita,10,0,10,0
1668469504246,MATH 295,A00,098062,Suk; Andrew Hoon,48,0,50,2
1668469504677,MATH 296,A00,098063,Novak; Jonathan I,20,0,20,0
1668469505115,MATH 297,001,098064,Gamst; Anthony Collins,9997,0,9999,2
1668470008541,COGS 205,A00,101395,Chiba; Andrea,19,0,20,1
1668470008969,COGS 210B,001,101404,Greene; Deanna Jacquelyn,9998,0,9999,1
1668470008969,COGS 210B,002,101417,Xia; Haijun,9999,0,9999,0
1668470008969,COGS 210B,003,101422,Nitz; Douglas A.,9999,0,9999,0
1668470008969,COGS 210B,004,101423,Hollan; James D.,9998,0,9999,1
1668470008969,COGS 210B,005,101424,Deak; Gedeon O.,9998,0,9999,1
1668470008969,COGS 210B,006,101425,Rossano; Federico,9999,0,9999,0
1668470009395,COGS 211B,A00,101427,Coulson; Seana M,9996,0,9999,3
1668470009831,COGS 220,A00,101428,Hollan; James D.,1,9,25,24
1668470010261,COGS 229,A00,101429,Dow; Steven P,17,0,25,8
1668470010689,COGS 230,A00,101430,Klemmer; Scott R,8,0,17,9
1668470011112,COGS 234,A00,101431,Xia; Haijun,2,0,25,23
1668470011536,COGS 260,A00,101432,Kiyonaga; Anastasia,21,0,25,4
1668470011536,COGS 260,B00,101433,Kirsh; David Joel,15,0,25,10
1668470011962,CSE 202,A00,102371,Impagliazzo; Russell,0,59,0,0
1668470012386,CSE 203B,A01,102373,Cheng; Chung Kuan,0,50,0,0
1668470012812,CSE 208,A00,102374,Micciancio; Daniele,0,4,0,0
1668470013235,CSE 209A,A00,112895,Impagliazzo; Russell,0,12,15,15
1668470013659,CSE 209B,A00,108005,Bellare; Mihir,0,6,0,0
1668470014082,CSE 210,A00,113163,Coblenz; Michael J,0,79,0,0
1668470014511,CSE 219,A00,106111,Dow; Steven P,0,6,20,20
1668470014937,CSE 221,A00,102376,Voelker; Geoffrey M.,0,64,0,0
1668470015367,CSE 224,A01,102378,Porter; George M,0,158,0,0
1668470015794,CSE 229A,A00,102379,Savage; Stefan,0,9,0,0
1668470016218,CSE 229C,A00,102380,Munyaka; Imani N. S.,0,8,0,0
1668470016647,CSE 232B,A00,102382,Deutsch; Alin Bernard,0,29,0,0
1668470017076,CSE 234,A01,112904,Kumar; Arun Kumar,0,0,0,0
1668470017511,CSE 237A,A00,102383,Rosing; Tajana Simunic,0,47,0,0
1668470017934,CSE 239A,A00,102384,Deutsch; Alin Bernard,0,12,0,0
1668470018364,CSE 239B,A00,102385,Polikarpova; Nadezhda,0,10,0,0
1668470018798,CSE 240A,A00,102386,Pannuto; Patrick William,0,43,0,0
1668470019245,CSE 240B,A00,102387,Zhao; Jishen,0,40,0,0
1668470019677,CSE 241A,A00,106406,Kang; Mingu,0,6,0,0
1668470020100,CSE 249B,A00,102388,Kahng; Andrew Byun,0,5,8,8
1668470020527,CSE 251B,A01,102392,Cottrell; Garrison W,0,39,0,0
1668470020527,CSE 251B,A02,102393,Cottrell; Garrison W,0,32,0,0
1668470020952,CSE 252B,A00,102394,Ochoa; Benjamin Lawrence,0,53,0,0
1668470021378,CSE 257,A01,102396,Gao; Sicun,0,127,0,0
1668470021814,CSE 272,A00,102397,Li; Tzumao,0,17,0,0
1668470022238,CSE 274,A00,111323,Chern; Albert Ren-Haur,0,12,0,0
1668470022670,CSE 282,A00,102398,Pevzner; Pavel Arkadjevich,0,0,0,0
1668470023098,CSE 284,A00,114175,Gymrek; Melissa Ann,0,17,0,0
1668470023524,CSE 290,A00,102399,Chandraker; Manmohan Krishna,0,10,0,0
1668470023524,CSE 290,B00,102400,Vaccaro; Kristen Marie,0,7,25,25
1668470023524,CSE 290,C00,102414,Pannuto; Patrick William,0,1,25,25
1668470023524,CSE 290,D00,102427,Pevzner; Pavel Arkadjevich,0,0,0,0
1668470023524,CSE 290,E00,102429,Zhao; Jishen,0,4,0,0
1668470023524,CSE 290,F00,102436,Tullsen; Dean Michael,0,5,0,0
1668470023524,CSE 290,G00,102440,Christensen; Henrik I,0,6,20,20
1668470023963,CSE 291,A00,102443,Su; Hao,0,0,0,0
1668470023963,CSE 291,B00,102448,Polikarpova; Nadezhda,0,0,0,0
1668470023963,CSE 291,C00,102453,Vaccaro; Kristen Marie,0,0,0,0
1668470023963,CSE 291,D00,111343,Savage; Stefan,0,0,0,0
1668470023963,CSE 291,E00,116474,Claffy; Kimberly Claire,0,0,0,0
1668470023963,CSE 291,F00,116479,Pasquale; Joseph,0,0,0,0
1668470024415,CSE 293,001,119111,Bafna; Vineet,9999,0,9999,0
1668470024415,CSE 293,002,119118,Bellare; Mihir,9999,0,9999,0
1668470024415,CSE 293,003,119122,Berg-Kirkpatrick; Taylor D,9999,0,9999,0
1668470024415,CSE 293,004,119135,Christensen; Henrik I,9999,0,9999,0
1668470024415,CSE 293,005,119142,Cottrell; Garrison W,9999,0,9999,0
1668470024415,CSE 293,006,119146,Deutsch; Alin Bernard,9999,0,9999,0
1668470024415,CSE 293,007,119159,Esmaeilzadeh; Hadi,9999,0,9999,0
1668470024415,CSE 293,008,119166,Freund; Yoav,9999,0,9999,0
1668470024415,CSE 293,009,119170,Griswold; William G.,9999,0,9999,0
1668470024415,CSE 293,010,119183,Gymrek; Melissa Ann,9999,0,9999,0
1668470024415,CSE 293,011,119190,Heninger; Nadia A,9999,0,9999,0
1668470024415,CSE 293,012,119230,Impagliazzo; Russell,9999,0,9999,0
1668470024415,CSE 293,013,119232,Jhala; Ranjit,9999,0,9999,0
1668470024415,CSE 293,014,119233,Kahng; Andrew Byun,9999,0,9999,0
1668470024415,CSE 293,015,119298,Kane; Daniel Mertz,9999,0,9999,0
1668470024415,CSE 293,016,119299,Kriegman; David J,9999,0,9999,0
1668470024415,CSE 293,017,119300,Kumar; Arun Kumar,9999,0,9999,0
1668470024415,CSE 293,018,119301,Lerner; Sorin,9999,0,9999,0
1668470024415,CSE 293,019,119302,Lovett; Shachar,9999,0,9999,0
1668470024415,CSE 293,020,119303,McAuley; Julian John,9999,0,9999,0
1668470024415,CSE 293,021,119304,Micciancio; Daniele,9999,0,9999,0
1668470024415,CSE 293,022,119367,Orailoglu; Alex,9999,0,9999,0
1668470024415,CSE 293,023,119382,Paturi; Ramamohan,9999,0,9999,0
1668470024415,CSE 293,024,119404,Polikarpova; Nadezhda,9999,0,9999,0
1668470024415,CSE 293,025,119406,Politz; Joseph Gibbs,9999,0,9999,0
1668470024415,CSE 293,026,119411,Porter; George M,9999,0,9999,0
1668470024415,CSE 293,027,119414,Porter; Leonard Emerson,9999,0,9999,0
1668470024415,CSE 293,028,119416,Ramamoorthi; Ravi,9999,0,9999,0
1668470024415,CSE 293,029,119417,Sahoo; Debashis,9999,0,9999,0
1668470024415,CSE 293,030,119420,Saul; Lawrence,9999,0,9999,0
1668470024415,CSE 293,031,119421,Savage; Stefan,9999,0,9999,0
1668470024415,CSE 293,032,119425,Schulze; Jurgen P.,9999,0,9999,0
1668470024415,CSE 293,033,119426,Snoeren; Alex C.,9999,0,9999,0
1668470024415,CSE 293,034,119428,Shang; Jingbo,9999,0,9999,0
1668470024415,CSE 293,035,119430,Stefan; Deian,9999,0,9999,0
1668470024415,CSE 293,036,119431,Su; Hao,9999,0,9999,0
1668470024415,CSE 293,037,119433,Swanson; Steven James,9999,0,9999,0
1668470024415,CSE 293,038,119435,Tullsen; Dean Michael,9999,0,9999,0
1668470024415,CSE 293,039,119483,Voelker; Geoffrey M.,9999,0,9999,0
1668470024415,CSE 293,040,119537,Zhao; Jishen,9999,0,9999,0
1668470024415,CSE 293,041,119538,Zhou; Yuan-Yuan,9999,0,9999,0
1668470024415,CSE 293,042,119539,Gao; Sicun,9999,0,9999,0
1668470024415,CSE 293,043,119540,Weibel; Nadir,9999,0,9999,0
1668470024415,CSE 293,044,119541,Gupta; Rajesh K.,9999,0,9999,0
1668470024415,CSE 293,045,126410,Vaccaro; Kristen Marie,9999,0,9999,0
1668470024415,CSE 293,046,126411,Klemke; Richard,9999,0,9999,0
1668470024843,CSE 294,A00,102459,Voelker; Geoffrey M.,0,2,0,0
1668470024843,CSE 294,B00,111322,Orailoglu; Alex,0,2,0,0
1668470025267,DSE 201,A00,096914,Deutsch; Alin Bernard,30,0,30,0
1668470025702,DSE 210,A00,096915,Dasgupta; Sanjoy,30,0,30,0
1668470026127,DSE 260A,A00,096916,Altintas De Callaf; Ilkay,30,0,30,0
1668470026553,ECE 200,001,103586,Antipa; Nicholas A,9999,0,9999,0
1668470026553,ECE 200,002,103587,Atanasov; Nikolay A.,9999,0,9999,0
1668470026553,ECE 200,003,103588,Bharadia; Dinesh,9999,0,9999,0
1668470026553,ECE 200,004,103589,Cheng; Chung Kuan,9999,0,9999,0
1668470026553,ECE 200,005,103590,Cosman; Pamela C.,9999,0,9999,0
1668470026553,ECE 200,006,103591,Dayeh; Shadi Ahmad,9999,0,9999,0
1668470026553,ECE 200,007,103592,Fainman; Yeshaiahu,9999,0,9999,0
1668470026553,ECE 200,008,103593,Ford; Joseph Earl,9999,0,9999,0
1668470026553,ECE 200,009,103594,Franceschetti; Massimo,9999,0,9999,0
1668470026553,ECE 200,010,103595,Fullerton; Eric E,9999,0,9999,0
1668470026553,ECE 200,011,103596,Galton; Ian A,9999,0,9999,0
1668470026553,ECE 200,012,103597,Gilja; Vikash,9999,0,9999,0
1668470026553,ECE 200,013,103598,Hall; Drew A.,9999,0,9999,0
1668470026553,ECE 200,014,103599,Hsueh; Tzu-Chien,9999,0,9999,0
1668470026553,ECE 200,015,103600,Javidi; Tara,9999,0,9999,0
1668470026553,ECE 200,016,103601,Kahng; Andrew Byun,9999,0,9999,0
1668470026553,ECE 200,017,103602,Kim; Young-Han,9999,0,9999,0
1668470026553,ECE 200,018,103603,Koushanfar; Farinaz,9999,0,9999,0
1668470026553,ECE 200,019,103604,Kuzum; Duygu,9999,0,9999,0
1668470026553,ECE 200,020,103605,Le; Hanh-Phuc,9999,0,9999,0
1668470026553,ECE 200,021,103606,Lin; Bill,9999,0,9999,0
1668470026553,ECE 200,022,103607,Liu; Zhaowei,9998,0,9999,1
1668470026553,ECE 200,023,103608,Lo; Yu-Hwa,9999,0,9999,0
1668470026553,ECE 200,024,103609,Lomakin; Vitaliy,9999,0,9999,0
1668470026553,ECE 200,025,103610,Mercier; Patrick Philip,9999,0,9999,0
1668470026553,ECE 200,026,103611,Meyer; Florian,9999,0,9999,0
1668470026553,ECE 200,027,103612,Milstein; Laurence B.,9999,0,9999,0
1668470026553,ECE 200,028,103613,Mir Arabbaygi; Siavash,9999,0,9999,0
1668470026553,ECE 200,029,103614,Mookherjea; Shayan,9999,0,9999,0
1668470026553,ECE 200,030,103615,Morris; Karcher William,9999,0,9999,0
1668470026553,ECE 200,031,103616,Ng; Tse Nga,9999,0,9999,0
1668470026553,ECE 200,032,103617,Nguyen; Truong Quang,9999,0,9999,0
1668470026553,ECE 200,033,103618,Nomura; Kenji,9999,0,9999,0
1668470026553,ECE 200,034,103619,Orlitsky; Alon,9999,0,9999,0
1668470026553,ECE 200,035,103620,Pal; Piya,9999,0,9999,0
1668470026553,ECE 200,036,103621,Papen; George C.,9999,0,9999,0
1668470026553,ECE 200,037,103622,Radic; Stojan,9999,0,9999,0
1668470026553,ECE 200,038,103623,Rao; Bhaskar D.,9999,0,9999,0
1668470026553,ECE 200,039,103624,Rao; Ramesh R,9999,0,9999,0
1668470026553,ECE 200,040,103625,Rebeiz; Gabriel,9999,0,9999,0
1668470026553,ECE 200,041,103626,Sanford; John R,9999,0,9999,0
1668470026553,ECE 200,042,103627,Siegel; Paul H.,9999,0,9999,0
1668470026553,ECE 200,043,103628,Sievenpiper; Daniel F.,9999,0,9999,0
1668470026553,ECE 200,044,103629,Sworder; David D.,9999,0,9999,0
1668470026553,ECE 200,045,103630,Taur; Yuan,9999,0,9999,0
1668470026553,ECE 200,046,103631,Touri; Behrouz,9999,0,9999,0
1668470026553,ECE 200,047,103632,Trivedi; Mohan M.,9999,0,9999,0
1668470026553,ECE 200,048,103633,Vasconcelos; Nuno,9999,0,9999,0
1668470026553,ECE 200,049,103634,Wang; Xiaolong,9999,0,9999,0
1668470026553,ECE 200,050,103635,Xie; Pengtao,9999,0,9999,0
1668470026553,ECE 200,051,103636,Yip; Michael,9999,0,9999,0
1668470026553,ECE 200,052,103637,Zeger; Kenneth A.,999,0,999,0
1668470026553,ECE 200,053,103638,Zhang; Xinyu,9999,0,9999,0
1668470026553,ECE 200,054,103639,Turakhia; Yatish Girish,9999,0,9999,0
1668470026553,ECE 200,055,103640,Kang; Mingu,9999,0,9999,0
1668470026553,ECE 200,056,103641,Shi; Yuanyuan,9999,0,9999,0
1668470026553,ECE 200,057,103642,Wang; Edward Jay,9999,0,9999,0
1668470026553,ECE 200,058,103643,Zheng; Yang,9999,0,9999,0
1668470026977,ECE 202,A00,103644,Kuzum; Duygu,0,39,0,0
1668470027412,ECE 212BN,A00,103646,Ng; Tse Nga,0,7,0,0
1668470027836,ECE 221,A00,111493,Staff,0,0,0,0
1668470028270,ECE 222B,A00,103647,Lomakin; Vitaliy,0,14,0,0
1668470028705,ECE 230B,A00,103648,Taur; Yuan,0,2,0,0
1668470029131,ECE 238B,A00,103649,Garay; Javier,0,0,0,0
1668470029554,ECE 240B,A00,112900,Fainman; Yeshaiahu,0,5,0,0
1668470029977,ECE 247A,A00,103650,Jokerst; Jesse Vincent,0,5,0,0
1668470030402,ECE 247B,A00,103651,Wang; Joseph,0,11,0,0
1668470030824,ECE 250,A00,103652,Siegel; Paul H.,0,77,0,0
1668470031247,ECE 251A,A00,103654,Rao; Bhaskar D.,0,60,0,0
1668470031677,ECE 257B,A00,103655,Bharadia; Dinesh,0,30,0,0
1668470032103,ECE 258A,A00,103656,Milstein; Laurence B.,0,29,0,0
1668470032526,ECE 260B,A00,103658,Kang; Mingu,0,119,0,0
1668470032953,ECE 264A,A00,103659,Galton; Ian A,0,65,0,0
1668470033380,ECE 265A,A00,103661,Gudem; Prasad S.S.,0,60,0,0
1668470033803,ECE 265D,A00,103662,Gudem; Prasad S.S.,0,24,0,0
1668470034230,ECE 268,A00,103663,Koushanfar; Farinaz,0,41,0,0
1668470034655,ECE 269,A01,103665,Pal; Piya,0,198,0,0
1668470035088,ECE 271B,A00,103666,Vasconcelos; Manuela,0,68,0,0
1668470035523,ECE 276A,A00,103667,Atanasov; Nikolay A.,0,118,0,0
1668470035948,ECE 277,A00,103668,An; Cheolhong,0,139,0,0
1668470036379,ECE 279,A00,117947,Hall; Drew A.,0,22,0,0
1668470037231,ECE 283,A00,103670,Hsueh; Tzu-Chien,0,51,0,0
1668470037658,ECE 284,A00,103671,Turakhia; Yatish Girish,0,39,0,0
1668470038082,ECE 285,A00,103672,Zheng; Yang,0,36,0,0
1668470038082,ECE 285,B00,103673,Sworder; David D.,0,55,0,0
1668470038509,ECE 287,A00,103676,Javidi; Tara,0,8,0,0
1668470038944,MATH 200B,A00,098023,Salehi Golsefidy; Alireza,12,0,15,3
1668470039370,MATH 202B,A00,098024,Rhoades; Brendon Patrick,8,0,15,7
1668470039795,MATH 203B,A00,098025,Oprea; Dragos N.,10,0,15,5
1668470040226,MATH 204B,A00,098026,Sorensen; Claus M,13,0,15,2
1668470040666,MATH 208,A00,098027,Izadi; Elham,7,0,10,3
1668470041090,MATH 209,A00,098028,Pollack; Aaron,10,0,10,0
1668470041522,MATH 211A,A00,112919,Rogalski; Daniel,9,0,10,1
1668470041943,MATH 211B,A00,112920,Seward; Brandon M.,9,0,10,1
1668470042368,MATH 218,A00,098029,Li; Bo,10,0,10,0
1668470042792,MATH 220B,A00,098030,Novak; Jonathan I,11,0,15,4
1668470043214,MATH 221A,A00,098031,Ebenfelt; Peter F,13,0,15,2
1668470043643,MATH 231B,A00,098032,Zlatos; Andrej,11,0,15,4
1668470044066,MATH 240B,A00,098033,Ni; Lei,8,0,15,7
1668470044491,MATH 243,A00,098034,Jekel; David Andrew,10,0,10,0
1668470044923,MATH 245A,A00,098035,Nie; Jiawang,0,2,15,17
1668470045367,MATH 248,A00,098036,Bejenaru; Ioan,10,0,10,0
1668470045797,MATH 250B,A00,098037,Spolaor; Luca,14,0,15,1
1668470046228,MATH 258,A00,098038,Ni; Lei,9,0,10,1
1668470046652,MATH 264B,A00,098041,Rhoades; Brendon Patrick,9,0,15,6
1668470047078,MATH 268,A00,098042,Buss; Samuel R,10,0,10,0
1668470047511,MATH 269,A00,098043,Rhoades; Brendon Patrick,10,0,10,0
1668470047946,MATH 270B,A00,098044,Li; Bo,8,0,15,7
1668470048380,MATH 272B,A00,098045,Holst; Michael J,13,0,15,2
1668470048807,MATH 273A,A00,098046,Tian; Xiaochuan,10,0,15,5
1668470049238,MATH 275,A01,098048,Tian; Xiaochuan,6,0,10,4
1668470049768,MATH 278A,A00,098049,Holst; Michael J,8,0,10,2
1668470050207,MATH 278B,A00,098050,Cloninger; Alexander,10,0,10,0
1668470050632,MATH 278C,A00,098051,Nie; Jiawang,6,0,10,4
1668470051055,MATH 280B,A00,098052,Zheng; Tianyi,7,0,15,8
1668470051480,MATH 281B,A00,098053,Bradic; Jelena,0,2,15,15
1668470051912,MATH 282B,A00,098054,Arias-Castro; Ery,0,0,15,15
1668470052337,MATH 285,A00,098055,Fitzsimmons; Patrick J,0,2,15,17
1668470052760,MATH 287B,A00,098056,Arias-Castro; Ery,2,0,15,13
1668470053184,MATH 288,A00,098057,Agarwal; Pooja,9,0,10,1
1668470053184,MATH 288,B00,098058,Zhang; Danna,8,0,10,2
1668470053184,MATH 288,C00,098059,Williams; Ruth J,9,0,10,1
1668470053607,MATH 290B,A00,098060,Roberts; Justin Deritter,13,0,15,2
1668470054032,MATH 292,A00,098061,Belmont; Eva Kinoshita,10,0,10,0
1668470054457,MATH 295,A00,098062,Suk; Andrew Hoon,48,0,50,2
1668470054880,MATH 296,A00,098063,Novak; Jonathan I,20,0,20,0
1668470055306,MATH 297,001,098064,Gamst; Anthony Collins,9997,0,9999,2
1668470558409,COGS 205,A00,101395,Chiba; Andrea,19,0,20,1
1668470558837,COGS 210B,001,101404,Greene; Deanna Jacquelyn,9998,0,9999,1
1668470558837,COGS 210B,002,101417,Xia; Haijun,9999,0,9999,0
1668470558837,COGS 210B,003,101422,Nitz; Douglas A.,9999,0,9999,0
1668470558837,COGS 210B,004,101423,Hollan; James D.,9998,0,9999,1
1668470558837,COGS 210B,005,101424,Deak; Gedeon O.,9998,0,9999,1
1668470558837,COGS 210B,006,101425,Rossano; Federico,9999,0,9999,0
1668470559271,COGS 211B,A00,101427,Coulson; Seana M,9996,0,9999,3
1668470559703,COGS 220,A00,101428,Hollan; James D.,1,9,25,24
1668470560130,COGS 229,A00,101429,Dow; Steven P,17,0,25,8
1668470560561,COGS 230,A00,101430,Klemmer; Scott R,8,0,17,9
1668470560985,COGS 234,A00,101431,Xia; Haijun,2,0,25,23
1668470561409,COGS 260,A00,101432,Kiyonaga; Anastasia,21,0,25,4
1668470561409,COGS 260,B00,101433,Kirsh; David Joel,15,0,25,10
1668470561833,CSE 202,A00,102371,Impagliazzo; Russell,0,59,0,0
1668470562259,CSE 203B,A01,102373,Cheng; Chung Kuan,0,50,0,0
1668470562683,CSE 208,A00,102374,Micciancio; Daniele,0,4,0,0
1668470563111,CSE 209A,A00,112895,Impagliazzo; Russell,0,12,15,15
1668470563538,CSE 209B,A00,108005,Bellare; Mihir,0,6,0,0
1668470563977,CSE 210,A00,113163,Coblenz; Michael J,0,79,0,0
1668470564402,CSE 219,A00,106111,Dow; Steven P,0,6,20,20
1668470564829,CSE 221,A00,102376,Voelker; Geoffrey M.,0,64,0,0
1668470565325,CSE 224,A01,102378,Porter; George M,0,159,0,0
1668470565750,CSE 229A,A00,102379,Savage; Stefan,0,9,0,0
1668470566186,CSE 229C,A00,102380,Munyaka; Imani N. S.,0,8,0,0
1668470566610,CSE 232B,A00,102382,Deutsch; Alin Bernard,0,29,0,0
1668470567046,CSE 234,A01,112904,Kumar; Arun Kumar,0,0,0,0
1668470567472,CSE 237A,A00,102383,Rosing; Tajana Simunic,0,47,0,0
1668470567903,CSE 239A,A00,102384,Deutsch; Alin Bernard,0,12,0,0
1668470568336,CSE 239B,A00,102385,Polikarpova; Nadezhda,0,10,0,0
1668470568759,CSE 240A,A00,102386,Pannuto; Patrick William,0,43,0,0
1668470569182,CSE 240B,A00,102387,Zhao; Jishen,0,40,0,0
1668470569603,CSE 241A,A00,106406,Kang; Mingu,0,6,0,0
1668470570037,CSE 249B,A00,102388,Kahng; Andrew Byun,0,5,8,8
1668470570461,CSE 251B,A01,102392,Cottrell; Garrison W,0,41,0,0
1668470570461,CSE 251B,A02,102393,Cottrell; Garrison W,0,32,0,0
1668470570886,CSE 252B,A00,102394,Ochoa; Benjamin Lawrence,0,53,0,0
1668470571310,CSE 257,A01,102396,Gao; Sicun,0,127,0,0
1668470571825,CSE 272,A00,102397,Li; Tzumao,0,17,0,0
1668470572247,CSE 274,A00,111323,Chern; Albert Ren-Haur,0,12,0,0
1668470572671,CSE 282,A00,102398,Pevzner; Pavel Arkadjevich,0,0,0,0
1668470573093,CSE 284,A00,114175,Gymrek; Melissa Ann,0,18,0,0
1668470573523,CSE 290,A00,102399,Chandraker; Manmohan Krishna,0,10,0,0
1668470573523,CSE 290,B00,102400,Vaccaro; Kristen Marie,0,7,25,25
1668470573523,CSE 290,C00,102414,Pannuto; Patrick William,0,1,25,25
1668470573523,CSE 290,D00,102427,Pevzner; Pavel Arkadjevich,0,0,0,0
1668470573523,CSE 290,E00,102429,Zhao; Jishen,0,4,0,0
1668470573523,CSE 290,F00,102436,Tullsen; Dean Michael,0,5,0,0
1668470573523,CSE 290,G00,102440,Christensen; Henrik I,0,6,20,20
1668470573946,CSE 291,A00,102443,Su; Hao,0,0,0,0
1668470573946,CSE 291,B00,102448,Polikarpova; Nadezhda,0,0,0,0
1668470573946,CSE 291,C00,102453,Vaccaro; Kristen Marie,0,0,0,0
1668470573946,CSE 291,D00,111343,Savage; Stefan,0,0,0,0
1668470573946,CSE 291,E00,116474,Claffy; Kimberly Claire,0,0,0,0
1668470573946,CSE 291,F00,116479,Pasquale; Joseph,0,0,0,0
1668470574381,CSE 293,001,119111,Bafna; Vineet,9999,0,9999,0
1668470574381,CSE 293,002,119118,Bellare; Mihir,9999,0,9999,0
1668470574381,CSE 293,003,119122,Berg-Kirkpatrick; Taylor D,9999,0,9999,0
1668470574381,CSE 293,004,119135,Christensen; Henrik I,9999,0,9999,0
1668470574381,CSE 293,005,119142,Cottrell; Garrison W,9999,0,9999,0
1668470574381,CSE 293,006,119146,Deutsch; Alin Bernard,9999,0,9999,0
1668470574381,CSE 293,007,119159,Esmaeilzadeh; Hadi,9999,0,9999,0
1668470574381,CSE 293,008,119166,Freund; Yoav,9999,0,9999,0
1668470574381,CSE 293,009,119170,Griswold; William G.,9999,0,9999,0
1668470574381,CSE 293,010,119183,Gymrek; Melissa Ann,9999,0,9999,0
1668470574381,CSE 293,011,119190,Heninger; Nadia A,9999,0,9999,0
1668470574381,CSE 293,012,119230,Impagliazzo; Russell,9999,0,9999,0
1668470574381,CSE 293,013,119232,Jhala; Ranjit,9999,0,9999,0
1668470574381,CSE 293,014,119233,Kahng; Andrew Byun,9999,0,9999,0
1668470574381,CSE 293,015,119298,Kane; Daniel Mertz,9999,0,9999,0
1668470574381,CSE 293,016,119299,Kriegman; David J,9999,0,9999,0
1668470574381,CSE 293,017,119300,Kumar; Arun Kumar,9999,0,9999,0
1668470574381,CSE 293,018,119301,Lerner; Sorin,9999,0,9999,0
1668470574381,CSE 293,019,119302,Lovett; Shachar,9999,0,9999,0
1668470574381,CSE 293,020,119303,McAuley; Julian John,9999,0,9999,0
1668470574381,CSE 293,021,119304,Micciancio; Daniele,9999,0,9999,0
1668470574381,CSE 293,022,119367,Orailoglu; Alex,9999,0,9999,0
1668470574381,CSE 293,023,119382,Paturi; Ramamohan,9999,0,9999,0
1668470574381,CSE 293,024,119404,Polikarpova; Nadezhda,9999,0,9999,0
1668470574381,CSE 293,025,119406,Politz; Joseph Gibbs,9999,0,9999,0
1668470574381,CSE 293,026,119411,Porter; George M,9999,0,9999,0
1668470574381,CSE 293,027,119414,Porter; Leonard Emerson,9999,0,9999,0
1668470574381,CSE 293,028,119416,Ramamoorthi; Ravi,9999,0,9999,0
1668470574381,CSE 293,029,119417,Sahoo; Debashis,9999,0,9999,0
1668470574381,CSE 293,030,119420,Saul; Lawrence,9999,0,9999,0
1668470574381,CSE 293,031,119421,Savage; Stefan,9999,0,9999,0
1668470574381,CSE 293,032,119425,Schulze; Jurgen P.,9999,0,9999,0
1668470574381,CSE 293,033,119426,Snoeren; Alex C.,9999,0,9999,0
1668470574381,CSE 293,034,119428,Shang; Jingbo,9999,0,9999,0
1668470574381,CSE 293,035,119430,Stefan; Deian,9999,0,9999,0
1668470574381,CSE 293,036,119431,Su; Hao,9999,0,9999,0
1668470574381,CSE 293,037,119433,Swanson; Steven James,9999,0,9999,0
1668470574381,CSE 293,038,119435,Tullsen; Dean Michael,9999,0,9999,0
1668470574381,CSE 293,039,119483,Voelker; Geoffrey M.,9999,0,9999,0
1668470574381,CSE 293,040,119537,Zhao; Jishen,9999,0,9999,0
1668470574381,CSE 293,041,119538,Zhou; Yuan-Yuan,9999,0,9999,0
1668470574381,CSE 293,042,119539,Gao; Sicun,9999,0,9999,0
1668470574381,CSE 293,043,119540,Weibel; Nadir,9999,0,9999,0
1668470574381,CSE 293,044,119541,Gupta; Rajesh K.,9999,0,9999,0
1668470574381,CSE 293,045,126410,Vaccaro; Kristen Marie,9999,0,9999,0
1668470574381,CSE 293,046,126411,Klemke; Richard,9999,0,9999,0
1668470574808,CSE 294,A00,102459,Voelker; Geoffrey M.,0,2,0,0
1668470574808,CSE 294,B00,111322,Orailoglu; Alex,0,2,0,0
1668470575232,DSE 201,A00,096914,Deutsch; Alin Bernard,30,0,30,0
1668470575671,DSE 210,A00,096915,Dasgupta; Sanjoy,30,0,30,0
1668470576094,DSE 260A,A00,096916,Altintas De Callaf; Ilkay,30,0,30,0
1668470576559,ECE 200,001,103586,Antipa; Nicholas A,9999,0,9999,0
1668470576559,ECE 200,002,103587,Atanasov; Nikolay A.,9999,0,9999,0
1668470576559,ECE 200,003,103588,Bharadia; Dinesh,9999,0,9999,0
1668470576559,ECE 200,004,103589,Cheng; Chung Kuan,9999,0,9999,0
1668470576559,ECE 200,005,103590,Cosman; Pamela C.,9999,0,9999,0
1668470576559,ECE 200,006,103591,Dayeh; Shadi Ahmad,9999,0,9999,0
1668470576559,ECE 200,007,103592,Fainman; Yeshaiahu,9999,0,9999,0
1668470576559,ECE 200,008,103593,Ford; Joseph Earl,9999,0,9999,0
1668470576559,ECE 200,009,103594,Franceschetti; Massimo,9999,0,9999,0
1668470576559,ECE 200,010,103595,Fullerton; Eric E,9999,0,9999,0
1668470576559,ECE 200,011,103596,Galton; Ian A,9999,0,9999,0
1668470576559,ECE 200,012,103597,Gilja; Vikash,9999,0,9999,0
1668470576559,ECE 200,013,103598,Hall; Drew A.,9999,0,9999,0
1668470576559,ECE 200,014,103599,Hsueh; Tzu-Chien,9999,0,9999,0
1668470576559,ECE 200,015,103600,Javidi; Tara,9999,0,9999,0
1668470576559,ECE 200,016,103601,Kahng; Andrew Byun,9999,0,9999,0
1668470576559,ECE 200,017,103602,Kim; Young-Han,9999,0,9999,0
1668470576559,ECE 200,018,103603,Koushanfar; Farinaz,9999,0,9999,0
1668470576559,ECE 200,019,103604,Kuzum; Duygu,9999,0,9999,0
1668470576559,ECE 200,020,103605,Le; Hanh-Phuc,9999,0,9999,0
1668470576559,ECE 200,021,103606,Lin; Bill,9999,0,9999,0
1668470576559,ECE 200,022,103607,Liu; Zhaowei,9998,0,9999,1
1668470576559,ECE 200,023,103608,Lo; Yu-Hwa,9999,0,9999,0
1668470576559,ECE 200,024,103609,Lomakin; Vitaliy,9999,0,9999,0
1668470576559,ECE 200,025,103610,Mercier; Patrick Philip,9999,0,9999,0
1668470576559,ECE 200,026,103611,Meyer; Florian,9999,0,9999,0
1668470576559,ECE 200,027,103612,Milstein; Laurence B.,9999,0,9999,0
1668470576559,ECE 200,028,103613,Mir Arabbaygi; Siavash,9999,0,9999,0
1668470576559,ECE 200,029,103614,Mookherjea; Shayan,9999,0,9999,0
1668470576559,ECE 200,030,103615,Morris; Karcher William,9999,0,9999,0
1668470576559,ECE 200,031,103616,Ng; Tse Nga,9999,0,9999,0
1668470576559,ECE 200,032,103617,Nguyen; Truong Quang,9999,0,9999,0
1668470576559,ECE 200,033,103618,Nomura; Kenji,9999,0,9999,0
1668470576559,ECE 200,034,103619,Orlitsky; Alon,9999,0,9999,0
1668470576559,ECE 200,035,103620,Pal; Piya,9999,0,9999,0
1668470576559,ECE 200,036,103621,Papen; George C.,9999,0,9999,0
1668470576559,ECE 200,037,103622,Radic; Stojan,9999,0,9999,0
1668470576559,ECE 200,038,103623,Rao; Bhaskar D.,9999,0,9999,0
1668470576559,ECE 200,039,103624,Rao; Ramesh R,9999,0,9999,0
1668470576559,ECE 200,040,103625,Rebeiz; Gabriel,9999,0,9999,0
1668470576559,ECE 200,041,103626,Sanford; John R,9999,0,9999,0
1668470576559,ECE 200,042,103627,Siegel; Paul H.,9999,0,9999,0
1668470576559,ECE 200,043,103628,Sievenpiper; Daniel F.,9999,0,9999,0
1668470576559,ECE 200,044,103629,Sworder; David D.,9999,0,9999,0
1668470576559,ECE 200,045,103630,Taur; Yuan,9999,0,9999,0
1668470576559,ECE 200,046,103631,Touri; Behrouz,9999,0,9999,0
1668470576559,ECE 200,047,103632,Trivedi; Mohan M.,9999,0,9999,0
1668470576559,ECE 200,048,103633,Vasconcelos; Nuno,9999,0,9999,0
1668470576559,ECE 200,049,103634,Wang; Xiaolong,9999,0,9999,0
1668470576559,ECE 200,050,103635,Xie; Pengtao,9999,0,9999,0
1668470576559,ECE 200,051,103636,Yip; Michael,9999,0,9999,0
1668470576559,ECE 200,052,103637,Zeger; Kenneth A.,999,0,999,0
1668470576559,ECE 200,053,103638,Zhang; Xinyu,9999,0,9999,0
1668470576559,ECE 200,054,103639,Turakhia; Yatish Girish,9999,0,9999,0
1668470576559,ECE 200,055,103640,Kang; Mingu,9999,0,9999,0
1668470576559,ECE 200,056,103641,Shi; Yuanyuan,9999,0,9999,0
1668470576559,ECE 200,057,103642,Wang; Edward Jay,9999,0,9999,0
1668470576559,ECE 200,058,103643,Zheng; Yang,9999,0,9999,0
1668470576987,ECE 202,A00,103644,Kuzum; Duygu,0,39,0,0
1668470577421,ECE 212BN,A00,103646,Ng; Tse Nga,0,8,0,0
1668470577850,ECE 221,A00,111493,Staff,0,0,0,0
1668470578277,ECE 222B,A00,103647,Lomakin; Vitaliy,0,14,0,0
1668470578705,ECE 230B,A00,103648,Taur; Yuan,0,2,0,0
1668470579128,ECE 238B,A00,103649,Garay; Javier,0,0,0,0
1668470579550,ECE 240B,A00,112900,Fainman; Yeshaiahu,0,6,0,0
1668470579982,ECE 247A,A00,103650,Jokerst; Jesse Vincent,0,5,0,0
1668470580410,ECE 247B,A00,103651,Wang; Joseph,0,11,0,0
1668470580840,ECE 250,A00,103652,Siegel; Paul H.,0,77,0,0
1668470581272,ECE 251A,A00,103654,Rao; Bhaskar D.,0,60,0,0
1668470581696,ECE 257B,A00,103655,Bharadia; Dinesh,0,30,0,0
1668470582125,ECE 258A,A00,103656,Milstein; Laurence B.,0,29,0,0
1668470582549,ECE 260B,A00,103658,Kang; Mingu,0,119,0,0
1668470582978,ECE 264A,A00,103659,Galton; Ian A,0,65,0,0
1668470583406,ECE 265A,A00,103661,Gudem; Prasad S.S.,0,60,0,0
1668470583830,ECE 265D,A00,103662,Gudem; Prasad S.S.,0,24,0,0
1668470584261,ECE 268,A00,103663,Koushanfar; Farinaz,0,41,0,0
1668470584684,ECE 269,A01,103665,Pal; Piya,0,199,0,0
1668470585109,ECE 271B,A00,103666,Vasconcelos; Manuela,0,68,0,0
1668470585534,ECE 276A,A00,103667,Atanasov; Nikolay A.,0,118,0,0
1668470585957,ECE 277,A00,103668,An; Cheolhong,0,140,0,0
1668470586383,ECE 279,A00,117947,Hall; Drew A.,0,22,0,0
1668470587236,ECE 283,A00,103670,Hsueh; Tzu-Chien,0,51,0,0
1668470587664,ECE 284,A00,103671,Turakhia; Yatish Girish,0,39,0,0
1668470588095,ECE 285,A00,103672,Zheng; Yang,0,36,0,0
1668470588095,ECE 285,B00,103673,Sworder; David D.,0,55,0,0
1668470588522,ECE 287,A00,103676,Javidi; Tara,0,8,0,0
1668470588951,MATH 200B,A00,098023,Salehi Golsefidy; Alireza,12,0,15,3
1668470589375,MATH 202B,A00,098024,Rhoades; Brendon Patrick,8,0,15,7
1668470589807,MATH 203B,A00,098025,Oprea; Dragos N.,10,0,15,5
1668470590231,MATH 204B,A00,098026,Sorensen; Claus M,13,0,15,2
1668470590654,MATH 208,A00,098027,Izadi; Elham,7,0,10,3
1668470591078,MATH 209,A00,098028,Pollack; Aaron,10,0,10,0
1668470591518,MATH 211A,A00,112919,Rogalski; Daniel,9,0,10,1
1668470591940,MATH 211B,A00,112920,Seward; Brandon M.,9,0,10,1
1668470592362,MATH 218,A00,098029,Li; Bo,10,0,10,0
1668470592786,MATH 220B,A00,098030,Novak; Jonathan I,11,0,15,4
1668470593215,MATH 221A,A00,098031,Ebenfelt; Peter F,13,0,15,2
1668470593636,MATH 231B,A00,098032,Zlatos; Andrej,11,0,15,4
1668470594060,MATH 240B,A00,098033,Ni; Lei,8,0,15,7
1668470594484,MATH 243,A00,098034,Jekel; David Andrew,10,0,10,0
1668470594910,MATH 245A,A00,098035,Nie; Jiawang,0,3,15,17
1668470595333,MATH 248,A00,098036,Bejenaru; Ioan,10,0,10,0
1668470595757,MATH 250B,A00,098037,Spolaor; Luca,14,0,15,1
1668470596182,MATH 258,A00,098038,Ni; Lei,9,0,10,1
1668470596605,MATH 264B,A00,098041,Rhoades; Brendon Patrick,9,0,15,6
1668470597029,MATH 268,A00,098042,Buss; Samuel R,10,0,10,0
1668470597454,MATH 269,A00,098043,Rhoades; Brendon Patrick,10,0,10,0
1668470597879,MATH 270B,A00,098044,Li; Bo,8,0,15,7
1668470598311,MATH 272B,A00,098045,Holst; Michael J,13,0,15,2
1668470598745,MATH 273A,A00,098046,Tian; Xiaochuan,10,0,15,5
1668470599174,MATH 275,A01,098048,Tian; Xiaochuan,6,0,10,4
1668470599598,MATH 278A,A00,098049,Holst; Michael J,8,0,10,2
1668470600027,MATH 278B,A00,098050,Cloninger; Alexander,10,0,10,0
1668470600454,MATH 278C,A00,098051,Nie; Jiawang,6,0,10,4
1668470600895,MATH 280B,A00,098052,Zheng; Tianyi,7,0,15,8
1668470601320,MATH 281B,A00,098053,Bradic; Jelena,0,2,15,15
1668470601746,MATH 282B,A00,098054,Arias-Castro; Ery,0,0,15,15
1668470602170,MATH 285,A00,098055,Fitzsimmons; Patrick J,0,2,15,17
1668470602595,MATH 287B,A00,098056,Arias-Castro; Ery,2,0,15,13
1668470603018,MATH 288,A00,098057,Agarwal; Pooja,9,0,10,1
1668470603018,MATH 288,B00,098058,Zhang; Danna,8,0,10,2
1668470603018,MATH 288,C00,098059,Williams; Ruth J,9,0,10,1
1668470603441,MATH 290B,A00,098060,Roberts; Justin Deritter,13,0,15,2
1668470603867,MATH 292,A00,098061,Belmont; Eva Kinoshita,10,0,10,0
1668470604292,MATH 295,A00,098062,Suk; Andrew Hoon,48,0,50,2
1668470604718,MATH 296,A00,098063,Novak; Jonathan I,20,0,20,0
1668470605144,MATH 297,001,098064,Gamst; Anthony Collins,9997,0,9999,2
1668471108414,COGS 205,A00,101395,Chiba; Andrea,19,0,20,1
1668471108845,COGS 210B,001,101404,Greene; Deanna Jacquelyn,9998,0,9999,1
1668471108845,COGS 210B,002,101417,Xia; Haijun,9999,0,9999,0
1668471108845,COGS 210B,003,101422,Nitz; Douglas A.,9999,0,9999,0
1668471108845,COGS 210B,004,101423,Hollan; James D.,9998,0,9999,1
1668471108845,COGS 210B,005,101424,Deak; Gedeon O.,9998,0,9999,1
1668471108845,COGS 210B,006,101425,Rossano; Federico,9999,0,9999,0
1668471109267,COGS 211B,A00,101427,Coulson; Seana M,9996,0,9999,3
1668471109692,COGS 220,A00,101428,Hollan; James D.,1,9,25,24
1668471110116,COGS 229,A00,101429,Dow; Steven P,17,0,25,8
1668471110542,COGS 230,A00,101430,Klemmer; Scott R,8,0,17,9
1668471110965,COGS 234,A00,101431,Xia; Haijun,2,0,25,23
1668471111388,COGS 260,A00,101432,Kiyonaga; Anastasia,21,0,25,4
1668471111388,COGS 260,B00,101433,Kirsh; David Joel,15,0,25,10
1668471111817,CSE 202,A00,102371,Impagliazzo; Russell,0,59,0,0
1668471112239,CSE 203B,A01,102373,Cheng; Chung Kuan,0,50,0,0
1668471112667,CSE 208,A00,102374,Micciancio; Daniele,0,4,0,0
1668471113091,CSE 209A,A00,112895,Impagliazzo; Russell,0,12,15,15
1668471113518,CSE 209B,A00,108005,Bellare; Mihir,0,6,0,0
1668471113940,CSE 210,A00,113163,Coblenz; Michael J,0,79,0,0
1668471114367,CSE 219,A00,106111,Dow; Steven P,0,6,20,20
1668471114799,CSE 221,A00,102376,Voelker; Geoffrey M.,0,64,0,0
1668471115230,CSE 224,A01,102378,Porter; George M,0,159,0,0
1668471115655,CSE 229A,A00,102379,Savage; Stefan,0,9,0,0
1668471116079,CSE 229C,A00,102380,Munyaka; Imani N. S.,0,8,0,0
1668471116502,CSE 232B,A00,102382,Deutsch; Alin Bernard,0,29,0,0
1668471116926,CSE 234,A01,112904,Kumar; Arun Kumar,0,0,0,0
1668471117355,CSE 237A,A00,102383,Rosing; Tajana Simunic,0,47,0,0
1668471117778,CSE 239A,A00,102384,Deutsch; Alin Bernard,0,12,0,0
1668471118204,CSE 239B,A00,102385,Polikarpova; Nadezhda,0,10,0,0
1668471118631,CSE 240A,A00,102386,Pannuto; Patrick William,0,43,0,0
1668471119058,CSE 240B,A00,102387,Zhao; Jishen,0,40,0,0
1668471119481,CSE 241A,A00,106406,Kang; Mingu,0,6,0,0
1668471119909,CSE 249B,A00,102388,Kahng; Andrew Byun,0,5,8,8
1668471120341,CSE 251B,A01,102392,Cottrell; Garrison W,0,41,0,0
1668471120341,CSE 251B,A02,102393,Cottrell; Garrison W,0,32,0,0
1668471120764,CSE 252B,A00,102394,Ochoa; Benjamin Lawrence,0,53,0,0
1668471121207,CSE 257,A01,102396,Gao; Sicun,0,127,0,0
1668471121629,CSE 272,A00,102397,Li; Tzumao,0,17,0,0
1668471122063,CSE 274,A00,111323,Chern; Albert Ren-Haur,0,13,0,0
1668471122489,CSE 282,A00,102398,Pevzner; Pavel Arkadjevich,0,0,0,0
1668471122917,CSE 284,A00,114175,Gymrek; Melissa Ann,0,18,0,0
1668471123354,CSE 290,A00,102399,Chandraker; Manmohan Krishna,0,11,0,0
1668471123354,CSE 290,B00,102400,Vaccaro; Kristen Marie,0,7,25,25
1668471123354,CSE 290,C00,102414,Pannuto; Patrick William,0,1,25,25
1668471123354,CSE 290,D00,102427,Pevzner; Pavel Arkadjevich,0,0,0,0
1668471123354,CSE 290,E00,102429,Zhao; Jishen,0,4,0,0
1668471123354,CSE 290,F00,102436,Tullsen; Dean Michael,0,5,0,0
1668471123354,CSE 290,G00,102440,Christensen; Henrik I,0,6,20,20
1668471123778,CSE 291,A00,102443,Su; Hao,0,0,0,0
1668471123778,CSE 291,B00,102448,Polikarpova; Nadezhda,0,0,0,0
1668471123778,CSE 291,C00,102453,Vaccaro; Kristen Marie,0,0,0,0
1668471123778,CSE 291,D00,111343,Savage; Stefan,0,0,0,0
1668471123778,CSE 291,E00,116474,Claffy; Kimberly Claire,0,0,0,0
1668471123778,CSE 291,F00,116479,Pasquale; Joseph,0,0,0,0
1668471124253,CSE 293,001,119111,Bafna; Vineet,9999,0,9999,0
1668471124253,CSE 293,002,119118,Bellare; Mihir,9999,0,9999,0
1668471124253,CSE 293,003,119122,Berg-Kirkpatrick; Taylor D,9999,0,9999,0
1668471124253,CSE 293,004,119135,Christensen; Henrik I,9999,0,9999,0
1668471124253,CSE 293,005,119142,Cottrell; Garrison W,9999,0,9999,0
1668471124253,CSE 293,006,119146,Deutsch; Alin Bernard,9999,0,9999,0
1668471124253,CSE 293,007,119159,Esmaeilzadeh; Hadi,9999,0,9999,0
1668471124253,CSE 293,008,119166,Freund; Yoav,9999,0,9999,0
1668471124253,CSE 293,009,119170,Griswold; William G.,9999,0,9999,0
1668471124253,CSE 293,010,119183,Gymrek; Melissa Ann,9999,0,9999,0
1668471124253,CSE 293,011,119190,Heninger; Nadia A,9999,0,9999,0
1668471124253,CSE 293,012,119230,Impagliazzo; Russell,9999,0,9999,0
1668471124253,CSE 293,013,119232,Jhala; Ranjit,9999,0,9999,0
1668471124253,CSE 293,014,119233,Kahng; Andrew Byun,9999,0,9999,0
1668471124253,CSE 293,015,119298,Kane; Daniel Mertz,9999,0,9999,0
1668471124253,CSE 293,016,119299,Kriegman; David J,9999,0,9999,0
1668471124253,CSE 293,017,119300,Kumar; Arun Kumar,9999,0,9999,0
1668471124253,CSE 293,018,119301,Lerner; Sorin,9999,0,9999,0
1668471124253,CSE 293,019,119302,Lovett; Shachar,9999,0,9999,0
1668471124253,CSE 293,020,119303,McAuley; Julian John,9999,0,9999,0
1668471124253,CSE 293,021,119304,Micciancio; Daniele,9999,0,9999,0
1668471124253,CSE 293,022,119367,Orailoglu; Alex,9999,0,9999,0
1668471124253,CSE 293,023,119382,Paturi; Ramamohan,9999,0,9999,0
1668471124253,CSE 293,024,119404,Polikarpova; Nadezhda,9999,0,9999,0
1668471124253,CSE 293,025,119406,Politz; Joseph Gibbs,9999,0,9999,0
1668471124253,CSE 293,026,119411,Porter; George M,9999,0,9999,0
1668471124253,CSE 293,027,119414,Porter; Leonard Emerson,9999,0,9999,0
1668471124253,CSE 293,028,119416,Ramamoorthi; Ravi,9999,0,9999,0
1668471124253,CSE 293,029,119417,Sahoo; Debashis,9999,0,9999,0
1668471124253,CSE 293,030,119420,Saul; Lawrence,9999,0,9999,0
1668471124253,CSE 293,031,119421,Savage; Stefan,9999,0,9999,0
1668471124253,CSE 293,032,119425,Schulze; Jurgen P.,9999,0,9999,0
1668471124253,CSE 293,033,119426,Snoeren; Alex C.,9999,0,9999,0
1668471124253,CSE 293,034,119428,Shang; Jingbo,9999,0,9999,0
1668471124253,CSE 293,035,119430,Stefan; Deian,9999,0,9999,0
1668471124253,CSE 293,036,119431,Su; Hao,9999,0,9999,0
1668471124253,CSE 293,037,119433,Swanson; Steven James,9999,0,9999,0
1668471124253,CSE 293,038,119435,Tullsen; Dean Michael,9999,0,9999,0
1668471124253,CSE 293,039,119483,Voelker; Geoffrey M.,9999,0,9999,0
1668471124253,CSE 293,040,119537,Zhao; Jishen,9999,0,9999,0
1668471124253,CSE 293,041,119538,Zhou; Yuan-Yuan,9999,0,9999,0
1668471124253,CSE 293,042,119539,Gao; Sicun,9999,0,9999,0
1668471124253,CSE 293,043,119540,Weibel; Nadir,9999,0,9999,0
1668471124253,CSE 293,044,119541,Gupta; Rajesh K.,9999,0,9999,0
1668471124253,CSE 293,045,126410,Vaccaro; Kristen Marie,9999,0,9999,0
1668471124253,CSE 293,046,126411,Klemke; Richard,9999,0,9999,0
1668471124683,CSE 294,A00,102459,Voelker; Geoffrey M.,0,2,0,0
1668471124683,CSE 294,B00,111322,Orailoglu; Alex,0,2,0,0
1668471125106,DSE 201,A00,096914,Deutsch; Alin Bernard,30,0,30,0
1668471125531,DSE 210,A00,096915,Dasgupta; Sanjoy,30,0,30,0
1668471125958,DSE 260A,A00,096916,Altintas De Callaf; Ilkay,30,0,30,0
1668471126417,ECE 200,001,103586,Antipa; Nicholas A,9999,0,9999,0
1668471126417,ECE 200,002,103587,Atanasov; Nikolay A.,9999,0,9999,0
1668471126417,ECE 200,003,103588,Bharadia; Dinesh,9999,0,9999,0
1668471126417,ECE 200,004,103589,Cheng; Chung Kuan,9999,0,9999,0
1668471126417,ECE 200,005,103590,Cosman; Pamela C.,9999,0,9999,0
1668471126417,ECE 200,006,103591,Dayeh; Shadi Ahmad,9999,0,9999,0
1668471126417,ECE 200,007,103592,Fainman; Yeshaiahu,9999,0,9999,0
1668471126417,ECE 200,008,103593,Ford; Joseph Earl,9999,0,9999,0
1668471126417,ECE 200,009,103594,Franceschetti; Massimo,9999,0,9999,0
1668471126417,ECE 200,010,103595,Fullerton; Eric E,9999,0,9999,0
1668471126417,ECE 200,011,103596,Galton; Ian A,9999,0,9999,0
1668471126417,ECE 200,012,103597,Gilja; Vikash,9999,0,9999,0
1668471126417,ECE 200,013,103598,Hall; Drew A.,9999,0,9999,0
1668471126417,ECE 200,014,103599,Hsueh; Tzu-Chien,9999,0,9999,0
1668471126417,ECE 200,015,103600,Javidi; Tara,9999,0,9999,0
1668471126417,ECE 200,016,103601,Kahng; Andrew Byun,9999,0,9999,0
1668471126417,ECE 200,017,103602,Kim; Young-Han,9999,0,9999,0
1668471126417,ECE 200,018,103603,Koushanfar; Farinaz,9999,0,9999,0
1668471126417,ECE 200,019,103604,Kuzum; Duygu,9999,0,9999,0
1668471126417,ECE 200,020,103605,Le; Hanh-Phuc,9999,0,9999,0
1668471126417,ECE 200,021,103606,Lin; Bill,9999,0,9999,0
1668471126417,ECE 200,022,103607,Liu; Zhaowei,9998,0,9999,1
1668471126417,ECE 200,023,103608,Lo; Yu-Hwa,9999,0,9999,0
1668471126417,ECE 200,024,103609,Lomakin; Vitaliy,9999,0,9999,0
1668471126417,ECE 200,025,103610,Mercier; Patrick Philip,9999,0,9999,0
1668471126417,ECE 200,026,103611,Meyer; Florian,9999,0,9999,0
1668471126417,ECE 200,027,103612,Milstein; Laurence B.,9999,0,9999,0
1668471126417,ECE 200,028,103613,Mir Arabbaygi; Siavash,9999,0,9999,0
1668471126417,ECE 200,029,103614,Mookherjea; Shayan,9999,0,9999,0
1668471126417,ECE 200,030,103615,Morris; Karcher William,9999,0,9999,0
1668471126417,ECE 200,031,103616,Ng; Tse Nga,9999,0,9999,0
1668471126417,ECE 200,032,103617,Nguyen; Truong Quang,9999,0,9999,0
1668471126417,ECE 200,033,103618,Nomura; Kenji,9999,0,9999,0
1668471126417,ECE 200,034,103619,Orlitsky; Alon,9999,0,9999,0
1668471126417,ECE 200,035,103620,Pal; Piya,9999,0,9999,0
1668471126417,ECE 200,036,103621,Papen; George C.,9999,0,9999,0
1668471126417,ECE 200,037,103622,Radic; Stojan,9999,0,9999,0
1668471126417,ECE 200,038,103623,Rao; Bhaskar D.,9999,0,9999,0
1668471126417,ECE 200,039,103624,Rao; Ramesh R,9999,0,9999,0
1668471126417,ECE 200,040,103625,Rebeiz; Gabriel,9999,0,9999,0
1668471126417,ECE 200,041,103626,Sanford; John R,9999,0,9999,0
1668471126417,ECE 200,042,103627,Siegel; Paul H.,9999,0,9999,0
1668471126417,ECE 200,043,103628,Sievenpiper; Daniel F.,9999,0,9999,0
1668471126417,ECE 200,044,103629,Sworder; David D.,9999,0,9999,0
1668471126417,ECE 200,045,103630,Taur; Yuan,9999,0,9999,0
1668471126417,ECE 200,046,103631,Touri; Behrouz,9999,0,9999,0
1668471126417,ECE 200,047,103632,Trivedi; Mohan M.,9999,0,9999,0
1668471126417,ECE 200,048,103633,Vasconcelos; Nuno,9999,0,9999,0
1668471126417,ECE 200,049,103634,Wang; Xiaolong,9999,0,9999,0
1668471126417,ECE 200,050,103635,Xie; Pengtao,9999,0,9999,0
1668471126417,ECE 200,051,103636,Yip; Michael,9999,0,9999,0
1668471126417,ECE 200,052,103637,Zeger; Kenneth A.,999,0,999,0
1668471126417,ECE 200,053,103638,Zhang; Xinyu,9999,0,9999,0
1668471126417,ECE 200,054,103639,Turakhia; Yatish Girish,9999,0,9999,0
1668471126417,ECE 200,055,103640,Kang; Mingu,9999,0,9999,0
1668471126417,ECE 200,056,103641,Shi; Yuanyuan,9999,0,9999,0
1668471126417,ECE 200,057,103642,Wang; Edward Jay,9999,0,9999,0
1668471126417,ECE 200,058,103643,Zheng; Yang,9999,0,9999,0
1668471126840,ECE 202,A00,103644,Kuzum; Duygu,0,40,0,0
1668471127274,ECE 212BN,A00,103646,Ng; Tse Nga,0,8,0,0
1668471127700,ECE 221,A00,111493,Staff,0,0,0,0
1668471128124,ECE 222B,A00,103647,Lomakin; Vitaliy,0,14,0,0
1668471128551,ECE 230B,A00,103648,Taur; Yuan,0,2,0,0
1668471128977,ECE 238B,A00,103649,Garay; Javier,0,0,0,0
1668471129404,ECE 240B,A00,112900,Fainman; Yeshaiahu,0,6,0,0
1668471129829,ECE 247A,A00,103650,Jokerst; Jesse Vincent,0,5,0,0
1668471130253,ECE 247B,A00,103651,Wang; Joseph,0,11,0,0
1668471130686,ECE 250,A00,103652,Siegel; Paul H.,0,77,0,0
1668471131109,ECE 251A,A00,103654,Rao; Bhaskar D.,0,60,0,0
1668471131541,ECE 257B,A00,103655,Bharadia; Dinesh,0,30,0,0
1668471131964,ECE 258A,A00,103656,Milstein; Laurence B.,0,29,0,0
1668471132388,ECE 260B,A00,103658,Kang; Mingu,0,119,0,0
1668471132813,ECE 264A,A00,103659,Galton; Ian A,0,65,0,0
1668471133240,ECE 265A,A00,103661,Gudem; Prasad S.S.,0,60,0,0
1668471133664,ECE 265D,A00,103662,Gudem; Prasad S.S.,0,24,0,0
1668471134092,ECE 268,A00,103663,Koushanfar; Farinaz,0,41,0,0
1668471134517,ECE 269,A01,103665,Pal; Piya,0,200,0,0
1668471134938,ECE 271B,A00,103666,Vasconcelos; Manuela,0,68,0,0
1668471135363,ECE 276A,A00,103667,Atanasov; Nikolay A.,0,118,0,0
1668471135786,ECE 277,A00,103668,An; Cheolhong,0,140,0,0
1668471136214,ECE 279,A00,117947,Hall; Drew A.,0,22,0,0
1668471137175,ECE 283,A00,103670,Hsueh; Tzu-Chien,0,51,0,0
1668471137605,ECE 284,A00,103671,Turakhia; Yatish Girish,0,39,0,0
1668471138044,ECE 285,A00,103672,Zheng; Yang,0,37,0,0
1668471138044,ECE 285,B00,103673,Sworder; David D.,0,55,0,0
1668471138473,ECE 287,A00,103676,Javidi; Tara,0,8,0,0
1668471138900,MATH 200B,A00,098023,Salehi Golsefidy; Alireza,11,0,15,4
1668471139323,MATH 202B,A00,098024,Rhoades; Brendon Patrick,8,0,15,7
1668471139751,MATH 203B,A00,098025,Oprea; Dragos N.,10,0,15,5
1668471140194,MATH 204B,A00,098026,Sorensen; Claus M,13,0,15,2
1668471140619,MATH 208,A00,098027,Izadi; Elham,7,0,10,3
1668471141041,MATH 209,A00,098028,Pollack; Aaron,10,0,10,0
1668471141464,MATH 211A,A00,112919,Rogalski; Daniel,8,0,10,2
1668471141888,MATH 211B,A00,112920,Seward; Brandon M.,9,0,10,1
1668471142316,MATH 218,A00,098029,Li; Bo,10,0,10,0
1668471142740,MATH 220B,A00,098030,Novak; Jonathan I,11,0,15,4
1668471143173,MATH 221A,A00,098031,Ebenfelt; Peter F,13,0,15,2
1668471143604,MATH 231B,A00,098032,Zlatos; Andrej,11,0,15,4
1668471144029,MATH 240B,A00,098033,Ni; Lei,8,0,15,7
1668471144454,MATH 243,A00,098034,Jekel; David Andrew,10,0,10,0
1668471144889,MATH 245A,A00,098035,Nie; Jiawang,0,3,15,17
1668471145315,MATH 248,A00,098036,Bejenaru; Ioan,10,0,10,0
1668471145742,MATH 250B,A00,098037,Spolaor; Luca,14,0,15,1
1668471146181,MATH 258,A00,098038,Ni; Lei,9,0,10,1
1668471146608,MATH 264B,A00,098041,Rhoades; Brendon Patrick,8,0,15,7
1668471147034,MATH 268,A00,098042,Buss; Samuel R,10,0,10,0
1668471147456,MATH 269,A00,098043,Rhoades; Brendon Patrick,10,0,10,0
1668471147882,MATH 270B,A00,098044,Li; Bo,7,0,15,8
1668471148307,MATH 272B,A00,098045,Holst; Michael J,13,0,15,2
1668471148732,MATH 273A,A00,098046,Tian; Xiaochuan,10,0,15,5
1668471149159,MATH 275,A01,098048,Tian; Xiaochuan,6,0,10,4
1668471149590,MATH 278A,A00,098049,Holst; Michael J,8,0,10,2
1668471150017,MATH 278B,A00,098050,Cloninger; Alexander,10,0,10,0
1668471150447,MATH 278C,A00,098051,Nie; Jiawang,6,0,10,4
1668471150870,MATH 280B,A00,098052,Zheng; Tianyi,7,0,15,8
1668471151297,MATH 281B,A00,098053,Bradic; Jelena,0,2,15,15
1668471151729,MATH 282B,A00,098054,Arias-Castro; Ery,0,0,15,15
1668471152153,MATH 285,A00,098055,Fitzsimmons; Patrick J,0,2,15,17
1668471152576,MATH 287B,A00,098056,Arias-Castro; Ery,2,0,15,13
1668471153010,MATH 288,A00,098057,Agarwal; Pooja,9,0,10,1
1668471153010,MATH 288,B00,098058,Zhang; Danna,8,0,10,2
1668471153010,MATH 288,C00,098059,Williams; Ruth J,9,0,10,1
1668471153435,MATH 290B,A00,098060,Roberts; Justin Deritter,12,0,15,3
1668471153861,MATH 292,A00,098061,Belmont; Eva Kinoshita,10,0,10,0
1668471154285,MATH 295,A00,098062,Suk; Andrew Hoon,47,0,50,3
1668471154724,MATH 296,A00,098063,Novak; Jonathan I,20,0,20,0
1668471155147,MATH 297,001,098064,Gamst; Anthony Collins,9997,0,9999,2
1668471657634,COGS 205,A00,101395,Chiba; Andrea,19,0,20,1
1668471658059,COGS 210B,001,101404,Greene; Deanna Jacquelyn,9998,0,9999,1
1668471658059,COGS 210B,002,101417,Xia; Haijun,9999,0,9999,0
1668471658059,COGS 210B,003,101422,Nitz; Douglas A.,9999,0,9999,0
1668471658059,COGS 210B,004,101423,Hollan; James D.,9998,0,9999,1
1668471658059,COGS 210B,005,101424,Deak; Gedeon O.,9998,0,9999,1
1668471658059,COGS 210B,006,101425,Rossano; Federico,9999,0,9999,0
1668471658585,COGS 211B,A00,101427,Coulson; Seana M,9996,0,9999,3
1668471659009,COGS 220,A00,101428,Hollan; James D.,1,9,25,24
1668471659438,COGS 229,A00,101429,Dow; Steven P,17,0,25,8
1668471659865,COGS 230,A00,101430,Klemmer; Scott R,8,0,17,9
1668471660288,COGS 234,A00,101431,Xia; Haijun,2,0,25,23
1668471660713,COGS 260,A00,101432,Kiyonaga; Anastasia,21,0,25,4
1668471660713,COGS 260,B00,101433,Kirsh; David Joel,15,0,25,10
1668471661137,CSE 202,A00,102371,Impagliazzo; Russell,0,59,0,0
1668471661564,CSE 203B,A01,102373,Cheng; Chung Kuan,0,50,0,0
1668471661990,CSE 208,A00,102374,Micciancio; Daniele,0,4,0,0
1668471662437,CSE 209A,A00,112895,Impagliazzo; Russell,0,12,15,15
1668471662864,CSE 209B,A00,108005,Bellare; Mihir,0,6,0,0
1668471663291,CSE 210,A00,113163,Coblenz; Michael J,0,79,0,0
1668471663715,CSE 219,A00,106111,Dow; Steven P,0,6,20,20
1668471664149,CSE 221,A00,102376,Voelker; Geoffrey M.,0,64,0,0
1668471664573,CSE 224,A01,102378,Porter; George M,0,159,0,0
1668471665006,CSE 229A,A00,102379,Savage; Stefan,0,9,0,0
1668471665435,CSE 229C,A00,102380,Munyaka; Imani N. S.,0,8,0,0
1668471665862,CSE 232B,A00,102382,Deutsch; Alin Bernard,0,29,0,0
1668471666293,CSE 234,A01,112904,Kumar; Arun Kumar,0,0,0,0
1668471666719,CSE 237A,A00,102383,Rosing; Tajana Simunic,0,47,0,0
1668471667151,CSE 239A,A00,102384,Deutsch; Alin Bernard,0,12,0,0
1668471667584,CSE 239B,A00,102385,Polikarpova; Nadezhda,0,10,0,0
1668471668007,CSE 240A,A00,102386,Pannuto; Patrick William,0,43,0,0
1668471668434,CSE 240B,A00,102387,Zhao; Jishen,0,40,0,0
1668471668857,CSE 241A,A00,106406,Kang; Mingu,0,6,0,0
1668471669282,CSE 249B,A00,102388,Kahng; Andrew Byun,0,5,8,8
1668471669709,CSE 251B,A01,102392,Cottrell; Garrison W,0,41,0,0
1668471669709,CSE 251B,A02,102393,Cottrell; Garrison W,0,32,0,0
1668471670136,CSE 252B,A00,102394,Ochoa; Benjamin Lawrence,0,53,0,0
1668471670566,CSE 257,A01,102396,Gao; Sicun,0,128,0,0
1668471671002,CSE 272,A00,102397,Li; Tzumao,0,17,0,0
1668471671425,CSE 274,A00,111323,Chern; Albert Ren-Haur,0,13,0,0
1668471671861,CSE 282,A00,102398,Pevzner; Pavel Arkadjevich,0,0,0,0
1668471672299,CSE 284,A00,114175,Gymrek; Melissa Ann,0,18,0,0
1668471672722,CSE 290,A00,102399,Chandraker; Manmohan Krishna,0,11,0,0
1668471672722,CSE 290,B00,102400,Vaccaro; Kristen Marie,0,7,25,25
1668471672722,CSE 290,C00,102414,Pannuto; Patrick William,0,1,25,25
1668471672722,CSE 290,D00,102427,Pevzner; Pavel Arkadjevich,0,0,0,0
1668471672722,CSE 290,E00,102429,Zhao; Jishen,0,4,0,0
1668471672722,CSE 290,F00,102436,Tullsen; Dean Michael,0,5,0,0
1668471672722,CSE 290,G00,102440,Christensen; Henrik I,0,6,20,20
1668471673154,CSE 291,A00,102443,Su; Hao,0,0,0,0
1668471673154,CSE 291,B00,102448,Polikarpova; Nadezhda,0,0,0,0
1668471673154,CSE 291,C00,102453,Vaccaro; Kristen Marie,0,0,0,0
1668471673154,CSE 291,D00,111343,Savage; Stefan,0,0,0,0
1668471673154,CSE 291,E00,116474,Claffy; Kimberly Claire,0,0,0,0
1668471673154,CSE 291,F00,116479,Pasquale; Joseph,0,0,0,0
1668471673595,CSE 293,001,119111,Bafna; Vineet,9999,0,9999,0
1668471673595,CSE 293,002,119118,Bellare; Mihir,9999,0,9999,0
1668471673595,CSE 293,003,119122,Berg-Kirkpatrick; Taylor D,9999,0,9999,0
1668471673595,CSE 293,004,119135,Christensen; Henrik I,9999,0,9999,0
1668471673595,CSE 293,005,119142,Cottrell; Garrison W,9999,0,9999,0
1668471673595,CSE 293,006,119146,Deutsch; Alin Bernard,9999,0,9999,0
1668471673595,CSE 293,007,119159,Esmaeilzadeh; Hadi,9999,0,9999,0
1668471673595,CSE 293,008,119166,Freund; Yoav,9999,0,9999,0
1668471673595,CSE 293,009,119170,Griswold; William G.,9999,0,9999,0
1668471673595,CSE 293,010,119183,Gymrek; Melissa Ann,9999,0,9999,0
1668471673595,CSE 293,011,119190,Heninger; Nadia A,9999,0,9999,0
1668471673595,CSE 293,012,119230,Impagliazzo; Russell,9999,0,9999,0
1668471673595,CSE 293,013,119232,Jhala; Ranjit,9999,0,9999,0
1668471673595,CSE 293,014,119233,Kahng; Andrew Byun,9999,0,9999,0
1668471673595,CSE 293,015,119298,Kane; Daniel Mertz,9999,0,9999,0
1668471673595,CSE 293,016,119299,Kriegman; David J,9999,0,9999,0
1668471673595,CSE 293,017,119300,Kumar; Arun Kumar,9999,0,9999,0
1668471673595,CSE 293,018,119301,Lerner; Sorin,9999,0,9999,0
1668471673595,CSE 293,019,119302,Lovett; Shachar,9999,0,9999,0
1668471673595,CSE 293,020,119303,McAuley; Julian John,9999,0,9999,0
1668471673595,CSE 293,021,119304,Micciancio; Daniele,9999,0,9999,0
1668471673595,CSE 293,022,119367,Orailoglu; Alex,9999,0,9999,0
1668471673595,CSE 293,023,119382,Paturi; Ramamohan,9999,0,9999,0
1668471673595,CSE 293,024,119404,Polikarpova; Nadezhda,9999,0,9999,0
1668471673595,CSE 293,025,119406,Politz; Joseph Gibbs,9999,0,9999,0
1668471673595,CSE 293,026,119411,Porter; George M,9999,0,9999,0
1668471673595,CSE 293,027,119414,Porter; Leonard Emerson,9999,0,9999,0
1668471673595,CSE 293,028,119416,Ramamoorthi; Ravi,9999,0,9999,0
1668471673595,CSE 293,029,119417,Sahoo; Debashis,9999,0,9999,0
1668471673595,CSE 293,030,119420,Saul; Lawrence,9999,0,9999,0
1668471673595,CSE 293,031,119421,Savage; Stefan,9999,0,9999,0
1668471673595,CSE 293,032,119425,Schulze; Jurgen P.,9999,0,9999,0
1668471673595,CSE 293,033,119426,Snoeren; Alex C.,9999,0,9999,0
1668471673595,CSE 293,034,119428,Shang; Jingbo,9999,0,9999,0
1668471673595,CSE 293,035,119430,Stefan; Deian,9999,0,9999,0
1668471673595,CSE 293,036,119431,Su; Hao,9999,0,9999,0
1668471673595,CSE 293,037,119433,Swanson; Steven James,9999,0,9999,0
1668471673595,CSE 293,038,119435,Tullsen; Dean Michael,9999,0,9999,0
1668471673595,CSE 293,039,119483,Voelker; Geoffrey M.,9999,0,9999,0
1668471673595,CSE 293,040,119537,Zhao; Jishen,9999,0,9999,0
1668471673595,CSE 293,041,119538,Zhou; Yuan-Yuan,9999,0,9999,0
1668471673595,CSE 293,042,119539,Gao; Sicun,9999,0,9999,0
1668471673595,CSE 293,043,119540,Weibel; Nadir,9999,0,9999,0
1668471673595,CSE 293,044,119541,Gupta; Rajesh K.,9999,0,9999,0
1668471673595,CSE 293,045,126410,Vaccaro; Kristen Marie,9999,0,9999,0
1668471673595,CSE 293,046,126411,Klemke; Richard,9999,0,9999,0
1668471674019,CSE 294,A00,102459,Voelker; Geoffrey M.,0,2,0,0
1668471674019,CSE 294,B00,111322,Orailoglu; Alex,0,2,0,0
1668471674449,DSE 201,A00,096914,Deutsch; Alin Bernard,30,0,30,0
1668471674872,DSE 210,A00,096915,Dasgupta; Sanjoy,30,0,30,0
1668471675298,DSE 260A,A00,096916,Altintas De Callaf; Ilkay,30,0,30,0
1668471675734,ECE 200,001,103586,Antipa; Nicholas A,9999,0,9999,0
1668471675734,ECE 200,002,103587,Atanasov; Nikolay A.,9999,0,9999,0
1668471675734,ECE 200,003,103588,Bharadia; Dinesh,9999,0,9999,0
1668471675734,ECE 200,004,103589,Cheng; Chung Kuan,9999,0,9999,0
1668471675734,ECE 200,005,103590,Cosman; Pamela C.,9999,0,9999,0
1668471675734,ECE 200,006,103591,Dayeh; Shadi Ahmad,9999,0,9999,0
1668471675734,ECE 200,007,103592,Fainman; Yeshaiahu,9999,0,9999,0
1668471675734,ECE 200,008,103593,Ford; Joseph Earl,9999,0,9999,0
1668471675734,ECE 200,009,103594,Franceschetti; Massimo,9999,0,9999,0
1668471675734,ECE 200,010,103595,Fullerton; Eric E,9999,0,9999,0
1668471675734,ECE 200,011,103596,Galton; Ian A,9999,0,9999,0
1668471675734,ECE 200,012,103597,Gilja; Vikash,9999,0,9999,0
1668471675734,ECE 200,013,103598,Hall; Drew A.,9999,0,9999,0
1668471675734,ECE 200,014,103599,Hsueh; Tzu-Chien,9999,0,9999,0
1668471675734,ECE 200,015,103600,Javidi; Tara,9999,0,9999,0
1668471675734,ECE 200,016,103601,Kahng; Andrew Byun,9999,0,9999,0
1668471675734,ECE 200,017,103602,Kim; Young-Han,9999,0,9999,0
1668471675734,ECE 200,018,103603,Koushanfar; Farinaz,9999,0,9999,0
1668471675734,ECE 200,019,103604,Kuzum; Duygu,9999,0,9999,0
1668471675734,ECE 200,020,103605,Le; Hanh-Phuc,9999,0,9999,0
1668471675734,ECE 200,021,103606,Lin; Bill,9999,0,9999,0
1668471675734,ECE 200,022,103607,Liu; Zhaowei,9998,0,9999,1
1668471675734,ECE 200,023,103608,Lo; Yu-Hwa,9999,0,9999,0
1668471675734,ECE 200,024,103609,Lomakin; Vitaliy,9999,0,9999,0
1668471675734,ECE 200,025,103610,Mercier; Patrick Philip,9999,0,9999,0
1668471675734,ECE 200,026,103611,Meyer; Florian,9999,0,9999,0
1668471675734,ECE 200,027,103612,Milstein; Laurence B.,9999,0,9999,0
1668471675734,ECE 200,028,103613,Mir Arabbaygi; Siavash,9999,0,9999,0
1668471675734,ECE 200,029,103614,Mookherjea; Shayan,9999,0,9999,0
1668471675734,ECE 200,030,103615,Morris; Karcher William,9999,0,9999,0
1668471675734,ECE 200,031,103616,Ng; Tse Nga,9999,0,9999,0
1668471675734,ECE 200,032,103617,Nguyen; Truong Quang,9999,0,9999,0
1668471675734,ECE 200,033,103618,Nomura; Kenji,9999,0,9999,0
1668471675734,ECE 200,034,103619,Orlitsky; Alon,9999,0,9999,0
1668471675734,ECE 200,035,103620,Pal; Piya,9999,0,9999,0
1668471675734,ECE 200,036,103621,Papen; George C.,9999,0,9999,0
1668471675734,ECE 200,037,103622,Radic; Stojan,9999,0,9999,0
1668471675734,ECE 200,038,103623,Rao; Bhaskar D.,9999,0,9999,0
1668471675734,ECE 200,039,103624,Rao; Ramesh R,9999,0,9999,0
1668471675734,ECE 200,040,103625,Rebeiz; Gabriel,9999,0,9999,0
1668471675734,ECE 200,041,103626,Sanford; John R,9999,0,9999,0
1668471675734,ECE 200,042,103627,Siegel; Paul H.,9999,0,9999,0
1668471675734,ECE 200,043,103628,Sievenpiper; Daniel F.,9999,0,9999,0
1668471675734,ECE 200,044,103629,Sworder; David D.,9999,0,9999,0
1668471675734,ECE 200,045,103630,Taur; Yuan,9999,0,9999,0
1668471675734,ECE 200,046,103631,Touri; Behrouz,9999,0,9999,0
1668471675734,ECE 200,047,103632,Trivedi; Mohan M.,9999,0,9999,0
1668471675734,ECE 200,048,103633,Vasconcelos; Nuno,9999,0,9999,0
1668471675734,ECE 200,049,103634,Wang; Xiaolong,9999,0,9999,0
1668471675734,ECE 200,050,103635,Xie; Pengtao,9999,0,9999,0
1668471675734,ECE 200,051,103636,Yip; Michael,9999,0,9999,0
1668471675734,ECE 200,052,103637,Zeger; Kenneth A.,999,0,999,0
1668471675734,ECE 200,053,103638,Zhang; Xinyu,9999,0,9999,0
1668471675734,ECE 200,054,103639,Turakhia; Yatish Girish,9999,0,9999,0
1668471675734,ECE 200,055,103640,Kang; Mingu,9999,0,9999,0
1668471675734,ECE 200,056,103641,Shi; Yuanyuan,9999,0,9999,0
1668471675734,ECE 200,057,103642,Wang; Edward Jay,9999,0,9999,0
1668471675734,ECE 200,058,103643,Zheng; Yang,9999,0,9999,0
1668471676158,ECE 202,A00,103644,Kuzum; Duygu,0,40,0,0
1668471676584,ECE 212BN,A00,103646,Ng; Tse Nga,0,8,0,0
1668471677007,ECE 221,A00,111493,Staff,0,0,0,0
1668471677435,ECE 222B,A00,103647,Lomakin; Vitaliy,0,14,0,0
1668471677907,ECE 230B,A00,103648,Taur; Yuan,0,2,0,0
1668471678330,ECE 238B,A00,103649,Garay; Javier,0,0,0,0
1668471678767,ECE 240B,A00,112900,Fainman; Yeshaiahu,0,6,0,0
1668471679200,ECE 247A,A00,103650,Jokerst; Jesse Vincent,0,5,0,0
1668471679632,ECE 247B,A00,103651,Wang; Joseph,0,11,0,0
1668471680067,ECE 250,A00,103652,Siegel; Paul H.,0,77,0,0
1668471680492,ECE 251A,A00,103654,Rao; Bhaskar D.,0,60,0,0
1668471680917,ECE 257B,A00,103655,Bharadia; Dinesh,0,30,0,0
1668471681352,ECE 258A,A00,103656,Milstein; Laurence B.,0,29,0,0
1668471681779,ECE 260B,A00,103658,Kang; Mingu,0,119,0,0
1668471682213,ECE 264A,A00,103659,Galton; Ian A,0,65,0,0
1668471682639,ECE 265A,A00,103661,Gudem; Prasad S.S.,0,61,0,0
1668471683065,ECE 265D,A00,103662,Gudem; Prasad S.S.,0,24,0,0
1668471683497,ECE 268,A00,103663,Koushanfar; Farinaz,0,41,0,0
1668471683921,ECE 269,A01,103665,Pal; Piya,0,200,0,0
1668471684352,ECE 271B,A00,103666,Vasconcelos; Manuela,0,68,0,0
1668471684786,ECE 276A,A00,103667,Atanasov; Nikolay A.,0,118,0,0
1668471685214,ECE 277,A00,103668,An; Cheolhong,0,140,0,0
1668471685652,ECE 279,A00,117947,Hall; Drew A.,0,22,0,0
1668471686509,ECE 283,A00,103670,Hsueh; Tzu-Chien,0,51,0,0
1668471686935,ECE 284,A00,103671,Turakhia; Yatish Girish,0,39,0,0
1668471687363,ECE 285,A00,103672,Zheng; Yang,0,37,0,0
1668471687363,ECE 285,B00,103673,Sworder; David D.,0,55,0,0
1668471687794,ECE 287,A00,103676,Javidi; Tara,0,8,0,0
1668471688218,MATH 200B,A00,098023,Salehi Golsefidy; Alireza,11,0,15,4
1668471688650,MATH 202B,A00,098024,Rhoades; Brendon Patrick,8,0,15,7
1668471689087,MATH 203B,A00,098025,Oprea; Dragos N.,10,0,15,5
1668471689520,MATH 204B,A00,098026,Sorensen; Claus M,13,0,15,2
1668471689946,MATH 208,A00,098027,Izadi; Elham,7,0,10,3
1668471690371,MATH 209,A00,098028,Pollack; Aaron,10,0,10,0
1668471690795,MATH 211A,A00,112919,Rogalski; Daniel,8,0,10,2
1668471691221,MATH 211B,A00,112920,Seward; Brandon M.,9,0,10,1
1668471691655,MATH 218,A00,098029,Li; Bo,10,0,10,0
1668471692083,MATH 220B,A00,098030,Novak; Jonathan I,11,0,15,4
1668471692511,MATH 221A,A00,098031,Ebenfelt; Peter F,13,0,15,2
1668471692948,MATH 231B,A00,098032,Zlatos; Andrej,11,0,15,4
1668471693375,MATH 240B,A00,098033,Ni; Lei,8,0,15,7
1668471693799,MATH 243,A00,098034,Jekel; David Andrew,10,0,10,0
1668471694226,MATH 245A,A00,098035,Nie; Jiawang,0,3,15,17
1668471694648,MATH 248,A00,098036,Bejenaru; Ioan,10,0,10,0
1668471695076,MATH 250B,A00,098037,Spolaor; Luca,14,0,15,1
1668471695499,MATH 258,A00,098038,Ni; Lei,9,0,10,1
1668471695922,MATH 264B,A00,098041,Rhoades; Brendon Patrick,8,0,15,7
1668471696353,MATH 268,A00,098042,Buss; Samuel R,10,0,10,0
1668471696787,MATH 269,A00,098043,Rhoades; Brendon Patrick,10,0,10,0
1668471697210,MATH 270B,A00,098044,Li; Bo,7,0,15,8
1668471697633,MATH 272B,A00,098045,Holst; Michael J,13,0,15,2
1668471698061,MATH 273A,A00,098046,Tian; Xiaochuan,10,0,15,5
1668471698486,MATH 275,A01,098048,Tian; Xiaochuan,6,0,10,4
1668471698910,MATH 278A,A00,098049,Holst; Michael J,8,0,10,2
1668471699341,MATH 278B,A00,098050,Cloninger; Alexander,10,0,10,0
1668471699766,MATH 278C,A00,098051,Nie; Jiawang,6,0,10,4
1668471700190,MATH 280B,A00,098052,Zheng; Tianyi,7,0,15,8
1668471700615,MATH 281B,A00,098053,Bradic; Jelena,0,2,15,15
1668471701038,MATH 282B,A00,098054,Arias-Castro; Ery,0,0,15,15
1668471701469,MATH 285,A00,098055,Fitzsimmons; Patrick J,0,2,15,17
1668471701994,MATH 287B,A00,098056,Arias-Castro; Ery,2,0,15,13
1668471702424,MATH 288,A00,098057,Agarwal; Pooja,9,0,10,1
1668471702424,MATH 288,B00,098058,Zhang; Danna,8,0,10,2
1668471702424,MATH 288,C00,098059,Williams; Ruth J,9,0,10,1
1668471702848,MATH 290B,A00,098060,Roberts; Justin Deritter,12,0,15,3
1668471703271,MATH 292,A00,098061,Belmont; Eva Kinoshita,10,0,10,0
1668471703696,MATH 295,A00,098062,Suk; Andrew Hoon,47,0,50,3
1668471704123,MATH 296,A00,098063,Novak; Jonathan I,20,0,20,0
1668471704545,MATH 297,001,098064,Gamst; Anthony Collins,9997,0,9999,2
1668472207633,COGS 205,A00,101395,Chiba; Andrea,19,0,20,1
1668472208063,COGS 210B,001,101404,Greene; Deanna Jacquelyn,9998,0,9999,1
1668472208063,COGS 210B,002,101417,Xia; Haijun,9999,0,9999,0
1668472208063,COGS 210B,003,101422,Nitz; Douglas A.,9999,0,9999,0
1668472208063,COGS 210B,004,101423,Hollan; James D.,9998,0,9999,1
1668472208063,COGS 210B,005,101424,Deak; Gedeon O.,9998,0,9999,1
1668472208063,COGS 210B,006,101425,Rossano; Federico,9999,0,9999,0
1668472208485,COGS 211B,A00,101427,Coulson; Seana M,9996,0,9999,3
1668472208920,COGS 220,A00,101428,Hollan; James D.,1,9,25,24
1668472209353,COGS 229,A00,101429,Dow; Steven P,17,0,25,8
1668472209780,COGS 230,A00,101430,Klemmer; Scott R,8,0,17,9
1668472210211,COGS 234,A00,101431,Xia; Haijun,2,0,25,23
1668472210635,COGS 260,A00,101432,Kiyonaga; Anastasia,21,0,25,4
1668472210635,COGS 260,B00,101433,Kirsh; David Joel,15,0,25,10
1668472211073,CSE 202,A00,102371,Impagliazzo; Russell,0,59,0,0
1668472211500,CSE 203B,A01,102373,Cheng; Chung Kuan,0,50,0,0
1668472211929,CSE 208,A00,102374,Micciancio; Daniele,0,4,0,0
1668472212356,CSE 209A,A00,112895,Impagliazzo; Russell,0,12,15,15
1668472212783,CSE 209B,A00,108005,Bellare; Mihir,0,6,0,0
1668472213218,CSE 210,A00,113163,Coblenz; Michael J,0,79,0,0
1668472213643,CSE 219,A00,106111,Dow; Steven P,0,6,20,20
1668472214071,CSE 221,A00,102376,Voelker; Geoffrey M.,0,64,0,0
1668472214505,CSE 224,A01,102378,Porter; George M,0,159,0,0
1668472214932,CSE 229A,A00,102379,Savage; Stefan,0,9,0,0
1668472215357,CSE 229C,A00,102380,Munyaka; Imani N. S.,0,8,0,0
1668472215781,CSE 232B,A00,102382,Deutsch; Alin Bernard,0,29,0,0
1668472216213,CSE 234,A01,112904,Kumar; Arun Kumar,0,0,0,0
1668472216646,CSE 237A,A00,102383,Rosing; Tajana Simunic,0,47,0,0
1668472217070,CSE 239A,A00,102384,Deutsch; Alin Bernard,0,12,0,0
1668472217503,CSE 239B,A00,102385,Polikarpova; Nadezhda,0,10,0,0
1668472217932,CSE 240A,A00,102386,Pannuto; Patrick William,0,44,0,0
1668472218361,CSE 240B,A00,102387,Zhao; Jishen,0,41,0,0
1668472218795,CSE 241A,A00,106406,Kang; Mingu,0,6,0,0
1668472219217,CSE 249B,A00,102388,Kahng; Andrew Byun,0,5,8,8
1668472219643,CSE 251B,A01,102392,Cottrell; Garrison W,0,42,0,0
1668472219643,CSE 251B,A02,102393,Cottrell; Garrison W,0,32,0,0
1668472220067,CSE 252B,A00,102394,Ochoa; Benjamin Lawrence,0,53,0,0
1668472220500,CSE 257,A01,102396,Gao; Sicun,0,128,0,0
1668472220927,CSE 272,A00,102397,Li; Tzumao,0,17,0,0
1668472221355,CSE 274,A00,111323,Chern; Albert Ren-Haur,0,13,0,0
1668472221785,CSE 282,A00,102398,Pevzner; Pavel Arkadjevich,0,0,0,0
1668472222209,CSE 284,A00,114175,Gymrek; Melissa Ann,0,18,0,0
1668472222646,CSE 290,A00,102399,Chandraker; Manmohan Krishna,0,11,0,0
1668472222646,CSE 290,B00,102400,Vaccaro; Kristen Marie,0,7,25,25
1668472222646,CSE 290,C00,102414,Pannuto; Patrick William,0,1,25,25
1668472222646,CSE 290,D00,102427,Pevzner; Pavel Arkadjevich,0,0,0,0
1668472222646,CSE 290,E00,102429,Zhao; Jishen,0,4,0,0
1668472222646,CSE 290,F00,102436,Tullsen; Dean Michael,0,5,0,0
1668472222646,CSE 290,G00,102440,Christensen; Henrik I,0,6,20,20
1668472223075,CSE 291,A00,102443,Su; Hao,0,0,0,0
1668472223075,CSE 291,B00,102448,Polikarpova; Nadezhda,0,0,0,0
1668472223075,CSE 291,C00,102453,Vaccaro; Kristen Marie,0,0,0,0
1668472223075,CSE 291,D00,111343,Savage; Stefan,0,0,0,0
1668472223075,CSE 291,E00,116474,Claffy; Kimberly Claire,0,0,0,0
1668472223075,CSE 291,F00,116479,Pasquale; Joseph,0,0,0,0
1668472223525,CSE 293,001,119111,Bafna; Vineet,9999,0,9999,0
1668472223525,CSE 293,002,119118,Bellare; Mihir,9999,0,9999,0
1668472223525,CSE 293,003,119122,Berg-Kirkpatrick; Taylor D,9999,0,9999,0
1668472223525,CSE 293,004,119135,Christensen; Henrik I,9999,0,9999,0
1668472223525,CSE 293,005,119142,Cottrell; Garrison W,9999,0,9999,0
1668472223525,CSE 293,006,119146,Deutsch; Alin Bernard,9999,0,9999,0
1668472223525,CSE 293,007,119159,Esmaeilzadeh; Hadi,9999,0,9999,0
1668472223525,CSE 293,008,119166,Freund; Yoav,9999,0,9999,0
1668472223525,CSE 293,009,119170,Griswold; William G.,9999,0,9999,0
1668472223525,CSE 293,010,119183,Gymrek; Melissa Ann,9999,0,9999,0
1668472223525,CSE 293,011,119190,Heninger; Nadia A,9999,0,9999,0
1668472223525,CSE 293,012,119230,Impagliazzo; Russell,9999,0,9999,0
1668472223525,CSE 293,013,119232,Jhala; Ranjit,9999,0,9999,0
1668472223525,CSE 293,014,119233,Kahng; Andrew Byun,9999,0,9999,0
1668472223525,CSE 293,015,119298,Kane; Daniel Mertz,9999,0,9999,0
1668472223525,CSE 293,016,119299,Kriegman; David J,9999,0,9999,0
1668472223525,CSE 293,017,119300,Kumar; Arun Kumar,9999,0,9999,0
1668472223525,CSE 293,018,119301,Lerner; Sorin,9999,0,9999,0
1668472223525,CSE 293,019,119302,Lovett; Shachar,9999,0,9999,0
1668472223525,CSE 293,020,119303,McAuley; Julian John,9999,0,9999,0
1668472223525,CSE 293,021,119304,Micciancio; Daniele,9999,0,9999,0
1668472223525,CSE 293,022,119367,Orailoglu; Alex,9999,0,9999,0
1668472223525,CSE 293,023,119382,Paturi; Ramamohan,9999,0,9999,0
1668472223525,CSE 293,024,119404,Polikarpova; Nadezhda,9999,0,9999,0
1668472223525,CSE 293,025,119406,Politz; Joseph Gibbs,9999,0,9999,0
1668472223525,CSE 293,026,119411,Porter; George M,9999,0,9999,0
1668472223525,CSE 293,027,119414,Porter; Leonard Emerson,9999,0,9999,0
1668472223525,CSE 293,028,119416,Ramamoorthi; Ravi,9999,0,9999,0
1668472223525,CSE 293,029,119417,Sahoo; Debashis,9999,0,9999,0
1668472223525,CSE 293,030,119420,Saul; Lawrence,9999,0,9999,0
1668472223525,CSE 293,031,119421,Savage; Stefan,9999,0,9999,0
1668472223525,CSE 293,032,119425,Schulze; Jurgen P.,9999,0,9999,0
1668472223525,CSE 293,033,119426,Snoeren; Alex C.,9999,0,9999,0
1668472223525,CSE 293,034,119428,Shang; Jingbo,9999,0,9999,0
1668472223525,CSE 293,035,119430,Stefan; Deian,9999,0,9999,0
1668472223525,CSE 293,036,119431,Su; Hao,9999,0,9999,0
1668472223525,CSE 293,037,119433,Swanson; Steven James,9999,0,9999,0
1668472223525,CSE 293,038,119435,Tullsen; Dean Michael,9999,0,9999,0
1668472223525,CSE 293,039,119483,Voelker; Geoffrey M.,9999,0,9999,0
1668472223525,CSE 293,040,119537,Zhao; Jishen,9999,0,9999,0
1668472223525,CSE 293,041,119538,Zhou; Yuan-Yuan,9999,0,9999,0
1668472223525,CSE 293,042,119539,Gao; Sicun,9999,0,9999,0
1668472223525,CSE 293,043,119540,Weibel; Nadir,9999,0,9999,0
1668472223525,CSE 293,044,119541,Gupta; Rajesh K.,9999,0,9999,0
1668472223525,CSE 293,045,126410,Vaccaro; Kristen Marie,9999,0,9999,0
1668472223525,CSE 293,046,126411,Klemke; Richard,9999,0,9999,0
1668472224031,CSE 294,A00,102459,Voelker; Geoffrey M.,0,2,0,0
1668472224031,CSE 294,B00,111322,Orailoglu; Alex,0,2,0,0
1668472224456,DSE 201,A00,096914,Deutsch; Alin Bernard,30,0,30,0
1668472224883,DSE 210,A00,096915,Dasgupta; Sanjoy,30,0,30,0
1668472225307,DSE 260A,A00,096916,Altintas De Callaf; Ilkay,30,0,30,0
1668472225770,ECE 200,001,103586,Antipa; Nicholas A,9999,0,9999,0
1668472225770,ECE 200,002,103587,Atanasov; Nikolay A.,9999,0,9999,0
1668472225770,ECE 200,003,103588,Bharadia; Dinesh,9999,0,9999,0
1668472225770,ECE 200,004,103589,Cheng; Chung Kuan,9999,0,9999,0
1668472225770,ECE 200,005,103590,Cosman; Pamela C.,9999,0,9999,0
1668472225770,ECE 200,006,103591,Dayeh; Shadi Ahmad,9999,0,9999,0
1668472225770,ECE 200,007,103592,Fainman; Yeshaiahu,9999,0,9999,0
1668472225770,ECE 200,008,103593,Ford; Joseph Earl,9999,0,9999,0
1668472225770,ECE 200,009,103594,Franceschetti; Massimo,9999,0,9999,0
1668472225770,ECE 200,010,103595,Fullerton; Eric E,9999,0,9999,0
1668472225770,ECE 200,011,103596,Galton; Ian A,9999,0,9999,0
1668472225770,ECE 200,012,103597,Gilja; Vikash,9999,0,9999,0
1668472225770,ECE 200,013,103598,Hall; Drew A.,9999,0,9999,0
1668472225770,ECE 200,014,103599,Hsueh; Tzu-Chien,9999,0,9999,0
1668472225770,ECE 200,015,103600,Javidi; Tara,9999,0,9999,0
1668472225770,ECE 200,016,103601,Kahng; Andrew Byun,9999,0,9999,0
1668472225770,ECE 200,017,103602,Kim; Young-Han,9999,0,9999,0
1668472225770,ECE 200,018,103603,Koushanfar; Farinaz,9999,0,9999,0
1668472225770,ECE 200,019,103604,Kuzum; Duygu,9999,0,9999,0
1668472225770,ECE 200,020,103605,Le; Hanh-Phuc,9999,0,9999,0
1668472225770,ECE 200,021,103606,Lin; Bill,9999,0,9999,0
1668472225770,ECE 200,022,103607,Liu; Zhaowei,9998,0,9999,1
1668472225770,ECE 200,023,103608,Lo; Yu-Hwa,9999,0,9999,0
1668472225770,ECE 200,024,103609,Lomakin; Vitaliy,9999,0,9999,0
1668472225770,ECE 200,025,103610,Mercier; Patrick Philip,9999,0,9999,0
1668472225770,ECE 200,026,103611,Meyer; Florian,9999,0,9999,0
1668472225770,ECE 200,027,103612,Milstein; Laurence B.,9999,0,9999,0
1668472225770,ECE 200,028,103613,Mir Arabbaygi; Siavash,9999,0,9999,0
1668472225770,ECE 200,029,103614,Mookherjea; Shayan,9999,0,9999,0
1668472225770,ECE 200,030,103615,Morris; Karcher William,9999,0,9999,0
1668472225770,ECE 200,031,103616,Ng; Tse Nga,9999,0,9999,0
1668472225770,ECE 200,032,103617,Nguyen; Truong Quang,9999,0,9999,0
1668472225770,ECE 200,033,103618,Nomura; Kenji,9999,0,9999,0
1668472225770,ECE 200,034,103619,Orlitsky; Alon,9999,0,9999,0
1668472225770,ECE 200,035,103620,Pal; Piya,9999,0,9999,0
1668472225770,ECE 200,036,103621,Papen; George C.,9999,0,9999,0
1668472225770,ECE 200,037,103622,Radic; Stojan,9999,0,9999,0
1668472225770,ECE 200,038,103623,Rao; Bhaskar D.,9999,0,9999,0
1668472225770,ECE 200,039,103624,Rao; Ramesh R,9999,0,9999,0
1668472225770,ECE 200,040,103625,Rebeiz; Gabriel,9999,0,9999,0
1668472225770,ECE 200,041,103626,Sanford; John R,9999,0,9999,0
1668472225770,ECE 200,042,103627,Siegel; Paul H.,9999,0,9999,0
1668472225770,ECE 200,043,103628,Sievenpiper; Daniel F.,9999,0,9999,0
1668472225770,ECE 200,044,103629,Sworder; David D.,9999,0,9999,0
1668472225770,ECE 200,045,103630,Taur; Yuan,9999,0,9999,0
1668472225770,ECE 200,046,103631,Touri; Behrouz,9999,0,9999,0
1668472225770,ECE 200,047,103632,Trivedi; Mohan M.,9999,0,9999,0
1668472225770,ECE 200,048,103633,Vasconcelos; Nuno,9999,0,9999,0
1668472225770,ECE 200,049,103634,Wang; Xiaolong,9999,0,9999,0
1668472225770,ECE 200,050,103635,Xie; Pengtao,9999,0,9999,0
1668472225770,ECE 200,051,103636,Yip; Michael,9999,0,9999,0
1668472225770,ECE 200,052,103637,Zeger; Kenneth A.,999,0,999,0
1668472225770,ECE 200,053,103638,Zhang; Xinyu,9999,0,9999,0
1668472225770,ECE 200,054,103639,Turakhia; Yatish Girish,9999,0,9999,0
1668472225770,ECE 200,055,103640,Kang; Mingu,9999,0,9999,0
1668472225770,ECE 200,056,103641,Shi; Yuanyuan,9999,0,9999,0
1668472225770,ECE 200,057,103642,Wang; Edward Jay,9999,0,9999,0
1668472225770,ECE 200,058,103643,Zheng; Yang,9999,0,9999,0
1668472226193,ECE 202,A00,103644,Kuzum; Duygu,0,40,0,0
1668472226616,ECE 212BN,A00,103646,Ng; Tse Nga,0,8,0,0
1668472227044,ECE 221,A00,111493,Staff,0,0,0,0
1668472227470,ECE 222B,A00,103647,Lomakin; Vitaliy,0,14,0,0
1668472227895,ECE 230B,A00,103648,Taur; Yuan,0,2,0,0
1668472228331,ECE 238B,A00,103649,Garay; Javier,0,0,0,0
1668472228760,ECE 240B,A00,112900,Fainman; Yeshaiahu,0,6,0,0
1668472229185,ECE 247A,A00,103650,Jokerst; Jesse Vincent,0,5,0,0
1668472229615,ECE 247B,A00,103651,Wang; Joseph,0,11,0,0
1668472230038,ECE 250,A00,103652,Siegel; Paul H.,0,78,0,0
1668472230463,ECE 251A,A00,103654,Rao; Bhaskar D.,0,61,0,0
1668472230888,ECE 257B,A00,103655,Bharadia; Dinesh,0,30,0,0
1668472231313,ECE 258A,A00,103656,Milstein; Laurence B.,0,29,0,0
1668472231736,ECE 260B,A00,103658,Kang; Mingu,0,119,0,0
1668472232161,ECE 264A,A00,103659,Galton; Ian A,0,65,0,0
1668472232585,ECE 265A,A00,103661,Gudem; Prasad S.S.,0,61,0,0
1668472233012,ECE 265D,A00,103662,Gudem; Prasad S.S.,0,24,0,0
1668472233452,ECE 268,A00,103663,Koushanfar; Farinaz,0,41,0,0
1668472233880,ECE 269,A01,103665,Pal; Piya,0,200,0,0
1668472234308,ECE 271B,A00,103666,Vasconcelos; Manuela,0,69,0,0
1668472234740,ECE 276A,A00,103667,Atanasov; Nikolay A.,0,118,0,0
1668472235166,ECE 277,A00,103668,An; Cheolhong,0,140,0,0
1668472235591,ECE 279,A00,117947,Hall; Drew A.,0,22,0,0
1668472236443,ECE 283,A00,103670,Hsueh; Tzu-Chien,0,51,0,0
1668472236873,ECE 284,A00,103671,Turakhia; Yatish Girish,0,39,0,0
1668472237301,ECE 285,A00,103672,Zheng; Yang,0,38,0,0
1668472237301,ECE 285,B00,103673,Sworder; David D.,0,55,0,0
1668472237726,ECE 287,A00,103676,Javidi; Tara,0,8,0,0
1668472238151,MATH 200B,A00,098023,Salehi Golsefidy; Alireza,11,0,15,4
1668472238579,MATH 202B,A00,098024,Rhoades; Brendon Patrick,8,0,15,7
1668472239010,MATH 203B,A00,098025,Oprea; Dragos N.,10,0,15,5
1668472239446,MATH 204B,A00,098026,Sorensen; Claus M,13,0,15,2
1668472239869,MATH 208,A00,098027,Izadi; Elham,7,0,10,3
1668472240293,MATH 209,A00,098028,Pollack; Aaron,10,0,10,0
1668472240716,MATH 211A,A00,112919,Rogalski; Daniel,8,0,10,2
1668472241140,MATH 211B,A00,112920,Seward; Brandon M.,9,0,10,1
1668472241583,MATH 218,A00,098029,Li; Bo,10,0,10,0
1668472242005,MATH 220B,A00,098030,Novak; Jonathan I,11,0,15,4
1668472242429,MATH 221A,A00,098031,Ebenfelt; Peter F,13,0,15,2
1668472242853,MATH 231B,A00,098032,Zlatos; Andrej,11,0,15,4
1668472243277,MATH 240B,A00,098033,Ni; Lei,8,0,15,7
1668472243704,MATH 243,A00,098034,Jekel; David Andrew,10,0,10,0
1668472244127,MATH 245A,A00,098035,Nie; Jiawang,0,3,15,17
1668472244551,MATH 248,A00,098036,Bejenaru; Ioan,10,0,10,0
1668472244974,MATH 250B,A00,098037,Spolaor; Luca,14,0,15,1
1668472245399,MATH 258,A00,098038,Ni; Lei,9,0,10,1
1668472245827,MATH 264B,A00,098041,Rhoades; Brendon Patrick,8,0,15,7
1668472246250,MATH 268,A00,098042,Buss; Samuel R,10,0,10,0
1668472246682,MATH 269,A00,098043,Rhoades; Brendon Patrick,10,0,10,0
1668472247105,MATH 270B,A00,098044,Li; Bo,7,0,15,8
1668472247535,MATH 272B,A00,098045,Holst; Michael J,13,0,15,2
1668472247960,MATH 273A,A00,098046,Tian; Xiaochuan,10,0,15,5
1668472248387,MATH 275,A01,098048,Tian; Xiaochuan,6,0,10,4
1668472248813,MATH 278A,A00,098049,Holst; Michael J,8,0,10,2
1668472249240,MATH 278B,A00,098050,Cloninger; Alexander,10,0,10,0
1668472249668,MATH 278C,A00,098051,Nie; Jiawang,6,0,10,4
1668472250094,MATH 280B,A00,098052,Zheng; Tianyi,7,0,15,8
1668472250517,MATH 281B,A00,098053,Bradic; Jelena,0,2,15,15
1668472250959,MATH 282B,A00,098054,Arias-Castro; Ery,0,0,15,15
1668472251389,MATH 285,A00,098055,Fitzsimmons; Patrick J,0,2,15,17
1668472251822,MATH 287B,A00,098056,Arias-Castro; Ery,2,0,15,13
1668472252248,MATH 288,A00,098057,Agarwal; Pooja,9,0,10,1
1668472252248,MATH 288,B00,098058,Zhang; Danna,8,0,10,2
1668472252248,MATH 288,C00,098059,Williams; Ruth J,9,0,10,1
1668472252673,MATH 290B,A00,098060,Roberts; Justin Deritter,12,0,15,3
1668472253106,MATH 292,A00,098061,Belmont; Eva Kinoshita,10,0,10,0
1668472253537,MATH 295,A00,098062,Suk; Andrew Hoon,47,0,50,3
1668472253960,MATH 296,A00,098063,Novak; Jonathan I,20,0,20,0
1668472254386,MATH 297,001,098064,Gamst; Anthony Collins,9997,0,9999,2
1668472767561,COGS 205,A00,101395,Chiba; Andrea,19,0,20,1
1668472767985,COGS 210B,001,101404,Greene; Deanna Jacquelyn,9998,0,9999,1
1668472767985,COGS 210B,002,101417,Xia; Haijun,9999,0,9999,0
1668472767985,COGS 210B,003,101422,Nitz; Douglas A.,9999,0,9999,0
1668472767985,COGS 210B,004,101423,Hollan; James D.,9998,0,9999,1
1668472767985,COGS 210B,005,101424,Deak; Gedeon O.,9998,0,9999,1
1668472767985,COGS 210B,006,101425,Rossano; Federico,9999,0,9999,0
1668472768410,COGS 211B,A00,101427,Coulson; Seana M,9996,0,9999,3
1668472768834,COGS 220,A00,101428,Hollan; James D.,1,9,25,24
1668472769266,COGS 229,A00,101429,Dow; Steven P,17,0,25,8
1668472769694,COGS 230,A00,101430,Klemmer; Scott R,8,0,17,9
1668472770125,COGS 234,A00,101431,Xia; Haijun,2,0,25,23
1668472770552,COGS 260,A00,101432,Kiyonaga; Anastasia,21,0,25,4
1668472770552,COGS 260,B00,101433,Kirsh; David Joel,15,0,25,10
1668472770979,CSE 202,A00,102371,Impagliazzo; Russell,0,59,0,0
1668472771403,CSE 203B,A01,102373,Cheng; Chung Kuan,0,50,0,0
1668472771836,CSE 208,A00,102374,Micciancio; Daniele,0,4,0,0
1668472772262,CSE 209A,A00,112895,Impagliazzo; Russell,0,12,15,15
1668472772689,CSE 209B,A00,108005,Bellare; Mihir,0,6,0,0
1668472773112,CSE 210,A00,113163,Coblenz; Michael J,0,80,0,0
1668472773536,CSE 219,A00,106111,Dow; Steven P,0,6,20,20
1668472773963,CSE 221,A00,102376,Voelker; Geoffrey M.,0,65,0,0
1668472774386,CSE 224,A01,102378,Porter; George M,0,158,0,0
1668472774812,CSE 229A,A00,102379,Savage; Stefan,0,10,0,0
1668472775235,CSE 229C,A00,102380,Munyaka; Imani N. S.,0,9,0,0
1668472775660,CSE 232B,A00,102382,Deutsch; Alin Bernard,0,28,0,0
1668472776086,CSE 234,A01,112904,Kumar; Arun Kumar,0,0,0,0
1668472776517,CSE 237A,A00,102383,Rosing; Tajana Simunic,0,47,0,0
1668472776940,CSE 239A,A00,102384,Deutsch; Alin Bernard,0,12,0,0
1668472777365,CSE 239B,A00,102385,Polikarpova; Nadezhda,0,10,0,0
1668472777794,CSE 240A,A00,102386,Pannuto; Patrick William,0,43,0,0
1668472778219,CSE 240B,A00,102387,Zhao; Jishen,0,41,0,0
1668472778642,CSE 241A,A00,106406,Kang; Mingu,0,6,0,0
1668472779065,CSE 249B,A00,102388,Kahng; Andrew Byun,0,5,8,8
1668472779493,CSE 251B,A01,102392,Cottrell; Garrison W,0,42,0,0
1668472779493,CSE 251B,A02,102393,Cottrell; Garrison W,0,32,0,0
1668472779919,CSE 252B,A00,102394,Ochoa; Benjamin Lawrence,0,53,0,0
1668472780350,CSE 257,A01,102396,Gao; Sicun,0,128,0,0
1668472780780,CSE 272,A00,102397,Li; Tzumao,0,17,0,0
1668472781206,CSE 274,A00,111323,Chern; Albert Ren-Haur,0,13,0,0
1668472781632,CSE 282,A00,102398,Pevzner; Pavel Arkadjevich,0,0,0,0
1668472782060,CSE 284,A00,114175,Gymrek; Melissa Ann,0,18,0,0
1668472782486,CSE 290,A00,102399,Chandraker; Manmohan Krishna,0,11,0,0
1668472782486,CSE 290,B00,102400,Vaccaro; Kristen Marie,0,7,25,25
1668472782486,CSE 290,C00,102414,Pannuto; Patrick William,0,1,25,25
1668472782486,CSE 290,D00,102427,Pevzner; Pavel Arkadjevich,0,0,0,0
1668472782486,CSE 290,E00,102429,Zhao; Jishen,0,4,0,0
1668472782486,CSE 290,F00,102436,Tullsen; Dean Michael,0,5,0,0
1668472782486,CSE 290,G00,102440,Christensen; Henrik I,0,6,20,20
1668472782917,CSE 291,A00,102443,Su; Hao,0,0,0,0
1668472782917,CSE 291,B00,102448,Polikarpova; Nadezhda,0,0,0,0
1668472782917,CSE 291,C00,102453,Vaccaro; Kristen Marie,0,0,0,0
1668472782917,CSE 291,D00,111343,Savage; Stefan,0,0,0,0
1668472782917,CSE 291,E00,116474,Claffy; Kimberly Claire,0,0,0,0
1668472782917,CSE 291,F00,116479,Pasquale; Joseph,0,0,0,0
1668472783347,CSE 293,001,119111,Bafna; Vineet,9999,0,9999,0
1668472783347,CSE 293,002,119118,Bellare; Mihir,9999,0,9999,0
1668472783347,CSE 293,003,119122,Berg-Kirkpatrick; Taylor D,9999,0,9999,0
1668472783347,CSE 293,004,119135,Christensen; Henrik I,9999,0,9999,0
1668472783347,CSE 293,005,119142,Cottrell; Garrison W,9999,0,9999,0
1668472783347,CSE 293,006,119146,Deutsch; Alin Bernard,9999,0,9999,0
1668472783347,CSE 293,007,119159,Esmaeilzadeh; Hadi,9999,0,9999,0
1668472783347,CSE 293,008,119166,Freund; Yoav,9999,0,9999,0
1668472783347,CSE 293,009,119170,Griswold; William G.,9999,0,9999,0
1668472783347,CSE 293,010,119183,Gymrek; Melissa Ann,9999,0,9999,0
1668472783347,CSE 293,011,119190,Heninger; Nadia A,9999,0,9999,0
1668472783347,CSE 293,012,119230,Impagliazzo; Russell,9999,0,9999,0
1668472783347,CSE 293,013,119232,Jhala; Ranjit,9999,0,9999,0
1668472783347,CSE 293,014,119233,Kahng; Andrew Byun,9999,0,9999,0
1668472783347,CSE 293,015,119298,Kane; Daniel Mertz,9999,0,9999,0
1668472783347,CSE 293,016,119299,Kriegman; David J,9999,0,9999,0
1668472783347,CSE 293,017,119300,Kumar; Arun Kumar,9999,0,9999,0
1668472783347,CSE 293,018,119301,Lerner; Sorin,9999,0,9999,0
1668472783347,CSE 293,019,119302,Lovett; Shachar,9999,0,9999,0
1668472783347,CSE 293,020,119303,McAuley; Julian John,9999,0,9999,0
1668472783347,CSE 293,021,119304,Micciancio; Daniele,9999,0,9999,0
1668472783347,CSE 293,022,119367,Orailoglu; Alex,9999,0,9999,0
1668472783347,CSE 293,023,119382,Paturi; Ramamohan,9999,0,9999,0
1668472783347,CSE 293,024,119404,Polikarpova; Nadezhda,9999,0,9999,0
1668472783347,CSE 293,025,119406,Politz; Joseph Gibbs,9999,0,9999,0
1668472783347,CSE 293,026,119411,Porter; George M,9999,0,9999,0
1668472783347,CSE 293,027,119414,Porter; Leonard Emerson,9999,0,9999,0
1668472783347,CSE 293,028,119416,Ramamoorthi; Ravi,9999,0,9999,0
1668472783347,CSE 293,029,119417,Sahoo; Debashis,9999,0,9999,0
1668472783347,CSE 293,030,119420,Saul; Lawrence,9999,0,9999,0
1668472783347,CSE 293,031,119421,Savage; Stefan,9999,0,9999,0
1668472783347,CSE 293,032,119425,Schulze; Jurgen P.,9999,0,9999,0
1668472783347,CSE 293,033,119426,Snoeren; Alex C.,9999,0,9999,0
1668472783347,CSE 293,034,119428,Shang; Jingbo,9999,0,9999,0
1668472783347,CSE 293,035,119430,Stefan; Deian,9999,0,9999,0
1668472783347,CSE 293,036,119431,Su; Hao,9999,0,9999,0
1668472783347,CSE 293,037,119433,Swanson; Steven James,9999,0,9999,0
1668472783347,CSE 293,038,119435,Tullsen; Dean Michael,9999,0,9999,0
1668472783347,CSE 293,039,119483,Voelker; Geoffrey M.,9999,0,9999,0
1668472783347,CSE 293,040,119537,Zhao; Jishen,9999,0,9999,0
1668472783347,CSE 293,041,119538,Zhou; Yuan-Yuan,9999,0,9999,0
1668472783347,CSE 293,042,119539,Gao; Sicun,9999,0,9999,0
1668472783347,CSE 293,043,119540,Weibel; Nadir,9999,0,9999,0
1668472783347,CSE 293,044,119541,Gupta; Rajesh K.,9999,0,9999,0
1668472783347,CSE 293,045,126410,Vaccaro; Kristen Marie,9999,0,9999,0
1668472783347,CSE 293,046,126411,Klemke; Richard,9999,0,9999,0
1668472783775,CSE 294,A00,102459,Voelker; Geoffrey M.,0,2,0,0
1668472783775,CSE 294,B00,111322,Orailoglu; Alex,0,2,0,0
1668472784199,DSE 201,A00,096914,Deutsch; Alin Bernard,30,0,30,0
1668472784632,DSE 210,A00,096915,Dasgupta; Sanjoy,30,0,30,0
1668472785060,DSE 260A,A00,096916,Altintas De Callaf; Ilkay,30,0,30,0
1668472785489,ECE 200,001,103586,Antipa; Nicholas A,9999,0,9999,0
1668472785489,ECE 200,002,103587,Atanasov; Nikolay A.,9999,0,9999,0
1668472785489,ECE 200,003,103588,Bharadia; Dinesh,9999,0,9999,0
1668472785489,ECE 200,004,103589,Cheng; Chung Kuan,9999,0,9999,0
1668472785489,ECE 200,005,103590,Cosman; Pamela C.,9999,0,9999,0
1668472785489,ECE 200,006,103591,Dayeh; Shadi Ahmad,9999,0,9999,0
1668472785489,ECE 200,007,103592,Fainman; Yeshaiahu,9999,0,9999,0
1668472785489,ECE 200,008,103593,Ford; Joseph Earl,9999,0,9999,0
1668472785489,ECE 200,009,103594,Franceschetti; Massimo,9999,0,9999,0
1668472785489,ECE 200,010,103595,Fullerton; Eric E,9999,0,9999,0
1668472785489,ECE 200,011,103596,Galton; Ian A,9999,0,9999,0
1668472785489,ECE 200,012,103597,Gilja; Vikash,9999,0,9999,0
1668472785489,ECE 200,013,103598,Hall; Drew A.,9999,0,9999,0
1668472785489,ECE 200,014,103599,Hsueh; Tzu-Chien,9999,0,9999,0
1668472785489,ECE 200,015,103600,Javidi; Tara,9999,0,9999,0
1668472785489,ECE 200,016,103601,Kahng; Andrew Byun,9999,0,9999,0
1668472785489,ECE 200,017,103602,Kim; Young-Han,9999,0,9999,0
1668472785489,ECE 200,018,103603,Koushanfar; Farinaz,9999,0,9999,0
1668472785489,ECE 200,019,103604,Kuzum; Duygu,9999,0,9999,0
1668472785489,ECE 200,020,103605,Le; Hanh-Phuc,9999,0,9999,0
1668472785489,ECE 200,021,103606,Lin; Bill,9999,0,9999,0
1668472785489,ECE 200,022,103607,Liu; Zhaowei,9998,0,9999,1
1668472785489,ECE 200,023,103608,Lo; Yu-Hwa,9999,0,9999,0
1668472785489,ECE 200,024,103609,Lomakin; Vitaliy,9999,0,9999,0
1668472785489,ECE 200,025,103610,Mercier; Patrick Philip,9999,0,9999,0
1668472785489,ECE 200,026,103611,Meyer; Florian,9999,0,9999,0
1668472785489,ECE 200,027,103612,Milstein; Laurence B.,9999,0,9999,0
1668472785489,ECE 200,028,103613,Mir Arabbaygi; Siavash,9999,0,9999,0
1668472785489,ECE 200,029,103614,Mookherjea; Shayan,9999,0,9999,0
1668472785489,ECE 200,030,103615,Morris; Karcher William,9999,0,9999,0
1668472785489,ECE 200,031,103616,Ng; Tse Nga,9999,0,9999,0
1668472785489,ECE 200,032,103617,Nguyen; Truong Quang,9999,0,9999,0
1668472785489,ECE 200,033,103618,Nomura; Kenji,9999,0,9999,0
1668472785489,ECE 200,034,103619,Orlitsky; Alon,9999,0,9999,0
1668472785489,ECE 200,035,103620,Pal; Piya,9999,0,9999,0
1668472785489,ECE 200,036,103621,Papen; George C.,9999,0,9999,0
1668472785489,ECE 200,037,103622,Radic; Stojan,9999,0,9999,0
1668472785489,ECE 200,038,103623,Rao; Bhaskar D.,9999,0,9999,0
1668472785489,ECE 200,039,103624,Rao; Ramesh R,9999,0,9999,0
1668472785489,ECE 200,040,103625,Rebeiz; Gabriel,9999,0,9999,0
1668472785489,ECE 200,041,103626,Sanford; John R,9999,0,9999,0
1668472785489,ECE 200,042,103627,Siegel; Paul H.,9999,0,9999,0
1668472785489,ECE 200,043,103628,Sievenpiper; Daniel F.,9999,0,9999,0
1668472785489,ECE 200,044,103629,Sworder; David D.,9999,0,9999,0
1668472785489,ECE 200,045,103630,Taur; Yuan,9999,0,9999,0
1668472785489,ECE 200,046,103631,Touri; Behrouz,9999,0,9999,0
1668472785489,ECE 200,047,103632,Trivedi; Mohan M.,9999,0,9999,0
1668472785489,ECE 200,048,103633,Vasconcelos; Nuno,9999,0,9999,0
1668472785489,ECE 200,049,103634,Wang; Xiaolong,9999,0,9999,0
1668472785489,ECE 200,050,103635,Xie; Pengtao,9999,0,9999,0
1668472785489,ECE 200,051,103636,Yip; Michael,9999,0,9999,0
1668472785489,ECE 200,052,103637,Zeger; Kenneth A.,999,0,999,0
1668472785489,ECE 200,053,103638,Zhang; Xinyu,9999,0,9999,0
1668472785489,ECE 200,054,103639,Turakhia; Yatish Girish,9999,0,9999,0
1668472785489,ECE 200,055,103640,Kang; Mingu,9999,0,9999,0
1668472785489,ECE 200,056,103641,Shi; Yuanyuan,9999,0,9999,0
1668472785489,ECE 200,057,103642,Wang; Edward Jay,9999,0,9999,0
1668472785489,ECE 200,058,103643,Zheng; Yang,9999,0,9999,0
1668472785916,ECE 202,A00,103644,Kuzum; Duygu,0,41,0,0
1668472786340,ECE 212BN,A00,103646,Ng; Tse Nga,0,8,0,0
1668472786763,ECE 221,A00,111493,Staff,0,0,0,0
1668472787186,ECE 222B,A00,103647,Lomakin; Vitaliy,0,15,0,0
1668472787613,ECE 230B,A00,103648,Taur; Yuan,0,2,0,0
1668472788040,ECE 238B,A00,103649,Garay; Javier,0,0,0,0
1668472788479,ECE 240B,A00,112900,Fainman; Yeshaiahu,0,6,0,0
1668472788901,ECE 247A,A00,103650,Jokerst; Jesse Vincent,0,5,0,0
1668472789358,ECE 247B,A00,103651,Wang; Joseph,0,11,0,0
1668472789781,ECE 250,A00,103652,Siegel; Paul H.,0,78,0,0
1668472790204,ECE 251A,A00,103654,Rao; Bhaskar D.,0,61,0,0
1668472790627,ECE 257B,A00,103655,Bharadia; Dinesh,0,32,0,0
1668472791067,ECE 258A,A00,103656,Milstein; Laurence B.,0,28,0,0
1668472791502,ECE 260B,A00,103658,Kang; Mingu,0,119,0,0
1668472791926,ECE 264A,A00,103659,Galton; Ian A,0,65,0,0
1668472792353,ECE 265A,A00,103661,Gudem; Prasad S.S.,0,62,0,0
1668472792780,ECE 265D,A00,103662,Gudem; Prasad S.S.,0,24,0,0
1668472793208,ECE 268,A00,103663,Koushanfar; Farinaz,0,41,0,0
1668472793633,ECE 269,A01,103665,Pal; Piya,0,200,0,0
1668472794056,ECE 271B,A00,103666,Vasconcelos; Manuela,0,69,0,0
1668472794483,ECE 276A,A00,103667,Atanasov; Nikolay A.,0,118,0,0
1668472794910,ECE 277,A00,103668,An; Cheolhong,0,141,0,0
1668472795342,ECE 279,A00,117947,Hall; Drew A.,0,22,0,0
1668472796203,ECE 283,A00,103670,Hsueh; Tzu-Chien,0,51,0,0
1668472796641,ECE 284,A00,103671,Turakhia; Yatish Girish,0,38,0,0
1668472797074,ECE 285,A00,103672,Zheng; Yang,0,37,0,0
1668472797074,ECE 285,B00,103673,Sworder; David D.,0,55,0,0
1668472797499,ECE 287,A00,103676,Javidi; Tara,0,8,0,0
1668472797930,MATH 200B,A00,098023,Salehi Golsefidy; Alireza,11,0,15,4
1668472798354,MATH 202B,A00,098024,Rhoades; Brendon Patrick,8,0,15,7
1668472798794,MATH 203B,A00,098025,Oprea; Dragos N.,10,0,15,5
1668472799299,MATH 204B,A00,098026,Sorensen; Claus M,13,0,15,2
1668472799730,MATH 208,A00,098027,Izadi; Elham,7,0,10,3
1668472800163,MATH 209,A00,098028,Pollack; Aaron,10,0,10,0
1668472800587,MATH 211A,A00,112919,Rogalski; Daniel,8,0,10,2
1668472801011,MATH 211B,A00,112920,Seward; Brandon M.,9,0,10,1
1668472801438,MATH 218,A00,098029,Li; Bo,10,0,10,0
1668472801871,MATH 220B,A00,098030,Novak; Jonathan I,11,0,15,4
1668472802302,MATH 221A,A00,098031,Ebenfelt; Peter F,13,0,15,2
1668472802733,MATH 231B,A00,098032,Zlatos; Andrej,11,0,15,4
1668472803165,MATH 240B,A00,098033,Ni; Lei,8,0,15,7
1668472803590,MATH 243,A00,098034,Jekel; David Andrew,10,0,10,0
1668472804013,MATH 245A,A00,098035,Nie; Jiawang,0,3,15,17
1668472804438,MATH 248,A00,098036,Bejenaru; Ioan,10,0,10,0
1668472804865,MATH 250B,A00,098037,Spolaor; Luca,14,0,15,1
1668472805291,MATH 258,A00,098038,Ni; Lei,9,0,10,1
1668472805718,MATH 264B,A00,098041,Rhoades; Brendon Patrick,8,0,15,7
1668472806140,MATH 268,A00,098042,Buss; Samuel R,10,0,10,0
1668472806569,MATH 269,A00,098043,Rhoades; Brendon Patrick,10,0,10,0
1668472806994,MATH 270B,A00,098044,Li; Bo,7,0,15,8
1668472807419,MATH 272B,A00,098045,Holst; Michael J,13,0,15,2
1668472807849,MATH 273A,A00,098046,Tian; Xiaochuan,10,0,15,5
1668472808277,MATH 275,A01,098048,Tian; Xiaochuan,6,0,10,4
1668472808704,MATH 278A,A00,098049,Holst; Michael J,8,0,10,2
1668472809128,MATH 278B,A00,098050,Cloninger; Alexander,10,0,10,0
1668472809553,MATH 278C,A00,098051,Nie; Jiawang,6,0,10,4
1668472809980,MATH 280B,A00,098052,Zheng; Tianyi,7,0,15,8
1668472810412,MATH 281B,A00,098053,Bradic; Jelena,0,2,15,15
1668472810838,MATH 282B,A00,098054,Arias-Castro; Ery,0,0,15,15
1668472811262,MATH 285,A00,098055,Fitzsimmons; Patrick J,0,2,15,17
1668472811685,MATH 287B,A00,098056,Arias-Castro; Ery,2,0,15,13
1668472812114,MATH 288,A00,098057,Agarwal; Pooja,9,0,10,1
1668472812114,MATH 288,B00,098058,Zhang; Danna,8,0,10,2
1668472812114,MATH 288,C00,098059,Williams; Ruth J,9,0,10,1
1668472812540,MATH 290B,A00,098060,Roberts; Justin Deritter,12,0,15,3
1668472812964,MATH 292,A00,098061,Belmont; Eva Kinoshita,10,0,10,0
1668472813388,MATH 295,A00,098062,Suk; Andrew Hoon,47,0,50,3
1668472813816,MATH 296,A00,098063,Novak; Jonathan I,20,0,20,0
1668472814240,MATH 297,001,098064,Gamst; Anthony Collins,9997,0,9999,2
1668473316973,COGS 205,A00,101395,Chiba; Andrea,19,0,20,1
1668473317404,COGS 210B,001,101404,Greene; Deanna Jacquelyn,9998,0,9999,1
1668473317404,COGS 210B,002,101417,Xia; Haijun,9999,0,9999,0
1668473317404,COGS 210B,003,101422,Nitz; Douglas A.,9999,0,9999,0
1668473317404,COGS 210B,004,101423,Hollan; James D.,9998,0,9999,1
1668473317404,COGS 210B,005,101424,Deak; Gedeon O.,9998,0,9999,1
1668473317404,COGS 210B,006,101425,Rossano; Federico,9999,0,9999,0
1668473317829,COGS 211B,A00,101427,Coulson; Seana M,9996,0,9999,3
1668473318267,COGS 220,A00,101428,Hollan; James D.,1,9,25,24
1668473318690,COGS 229,A00,101429,Dow; Steven P,17,0,25,8
1668473319113,COGS 230,A00,101430,Klemmer; Scott R,8,0,17,9
1668473319670,COGS 234,A00,101431,Xia; Haijun,2,0,25,23
1668473320103,COGS 260,A00,101432,Kiyonaga; Anastasia,21,0,25,4
1668473320103,COGS 260,B00,101433,Kirsh; David Joel,15,0,25,10
1668473320531,CSE 202,A00,102371,Impagliazzo; Russell,0,59,0,0
1668473321075,CSE 203B,A01,102373,Cheng; Chung Kuan,0,50,0,0
1668473321501,CSE 208,A00,102374,Micciancio; Daniele,0,4,0,0
1668473321925,CSE 209A,A00,112895,Impagliazzo; Russell,0,12,15,15
1668473322349,CSE 209B,A00,108005,Bellare; Mihir,0,6,0,0
1668473322779,CSE 210,A00,113163,Coblenz; Michael J,0,80,0,0
1668473323202,CSE 219,A00,106111,Dow; Steven P,0,6,20,20
1668473323626,CSE 221,A00,102376,Voelker; Geoffrey M.,0,65,0,0
1668473324058,CSE 224,A01,102378,Porter; George M,0,158,0,0
1668473324493,CSE 229A,A00,102379,Savage; Stefan,0,10,0,0
1668473324915,CSE 229C,A00,102380,Munyaka; Imani N. S.,0,9,0,0
1668473325339,CSE 232B,A00,102382,Deutsch; Alin Bernard,0,28,0,0
1668473325766,CSE 234,A01,112904,Kumar; Arun Kumar,0,0,0,0
1668473326189,CSE 237A,A00,102383,Rosing; Tajana Simunic,0,47,0,0
1668473326619,CSE 239A,A00,102384,Deutsch; Alin Bernard,0,12,0,0
1668473327048,CSE 239B,A00,102385,Polikarpova; Nadezhda,0,10,0,0
1668473327471,CSE 240A,A00,102386,Pannuto; Patrick William,0,43,0,0
1668473327896,CSE 240B,A00,102387,Zhao; Jishen,0,41,0,0
1668473328320,CSE 241A,A00,106406,Kang; Mingu,0,6,0,0
1668473328750,CSE 249B,A00,102388,Kahng; Andrew Byun,0,5,8,8
1668473329178,CSE 251B,A01,102392,Cottrell; Garrison W,0,42,0,0
1668473329178,CSE 251B,A02,102393,Cottrell; Garrison W,0,32,0,0
1668473329603,CSE 252B,A00,102394,Ochoa; Benjamin Lawrence,0,53,0,0
1668473330027,CSE 257,A01,102396,Gao; Sicun,0,128,0,0
1668473330451,CSE 272,A00,102397,Li; Tzumao,0,17,0,0
1668473330879,CSE 274,A00,111323,Chern; Albert Ren-Haur,0,13,0,0
1668473331306,CSE 282,A00,102398,Pevzner; Pavel Arkadjevich,0,0,0,0
1668473331733,CSE 284,A00,114175,Gymrek; Melissa Ann,0,18,0,0
1668473332162,CSE 290,A00,102399,Chandraker; Manmohan Krishna,0,11,0,0
1668473332162,CSE 290,B00,102400,Vaccaro; Kristen Marie,0,7,25,25
1668473332162,CSE 290,C00,102414,Pannuto; Patrick William,0,1,25,25
1668473332162,CSE 290,D00,102427,Pevzner; Pavel Arkadjevich,0,0,0,0
1668473332162,CSE 290,E00,102429,Zhao; Jishen,0,4,0,0
1668473332162,CSE 290,F00,102436,Tullsen; Dean Michael,0,5,0,0
1668473332162,CSE 290,G00,102440,Christensen; Henrik I,0,6,20,20
1668473332590,CSE 291,A00,102443,Su; Hao,0,0,0,0
1668473332590,CSE 291,B00,102448,Polikarpova; Nadezhda,0,0,0,0
1668473332590,CSE 291,C00,102453,Vaccaro; Kristen Marie,0,0,0,0
1668473332590,CSE 291,D00,111343,Savage; Stefan,0,0,0,0
1668473332590,CSE 291,E00,116474,Claffy; Kimberly Claire,0,0,0,0
1668473332590,CSE 291,F00,116479,Pasquale; Joseph,0,0,0,0
1668473333027,CSE 293,001,119111,Bafna; Vineet,9999,0,9999,0
1668473333027,CSE 293,002,119118,Bellare; Mihir,9999,0,9999,0
1668473333027,CSE 293,003,119122,Berg-Kirkpatrick; Taylor D,9999,0,9999,0
1668473333027,CSE 293,004,119135,Christensen; Henrik I,9999,0,9999,0
1668473333027,CSE 293,005,119142,Cottrell; Garrison W,9999,0,9999,0
1668473333027,CSE 293,006,119146,Deutsch; Alin Bernard,9999,0,9999,0
1668473333027,CSE 293,007,119159,Esmaeilzadeh; Hadi,9999,0,9999,0
1668473333027,CSE 293,008,119166,Freund; Yoav,9999,0,9999,0
1668473333027,CSE 293,009,119170,Griswold; William G.,9999,0,9999,0
1668473333027,CSE 293,010,119183,Gymrek; Melissa Ann,9999,0,9999,0
1668473333027,CSE 293,011,119190,Heninger; Nadia A,9999,0,9999,0
1668473333027,CSE 293,012,119230,Impagliazzo; Russell,9999,0,9999,0
1668473333027,CSE 293,013,119232,Jhala; Ranjit,9999,0,9999,0
1668473333027,CSE 293,014,119233,Kahng; Andrew Byun,9999,0,9999,0
1668473333027,CSE 293,015,119298,Kane; Daniel Mertz,9999,0,9999,0
1668473333027,CSE 293,016,119299,Kriegman; David J,9999,0,9999,0
1668473333027,CSE 293,017,119300,Kumar; Arun Kumar,9999,0,9999,0
1668473333027,CSE 293,018,119301,Lerner; Sorin,9999,0,9999,0
1668473333027,CSE 293,019,119302,Lovett; Shachar,9999,0,9999,0
1668473333027,CSE 293,020,119303,McAuley; Julian John,9999,0,9999,0
1668473333027,CSE 293,021,119304,Micciancio; Daniele,9999,0,9999,0
1668473333027,CSE 293,022,119367,Orailoglu; Alex,9999,0,9999,0
1668473333027,CSE 293,023,119382,Paturi; Ramamohan,9999,0,9999,0
1668473333027,CSE 293,024,119404,Polikarpova; Nadezhda,9999,0,9999,0
1668473333027,CSE 293,025,119406,Politz; Joseph Gibbs,9999,0,9999,0
1668473333027,CSE 293,026,119411,Porter; George M,9999,0,9999,0
1668473333027,CSE 293,027,119414,Porter; Leonard Emerson,9999,0,9999,0
1668473333027,CSE 293,028,119416,Ramamoorthi; Ravi,9999,0,9999,0
1668473333027,CSE 293,029,119417,Sahoo; Debashis,9999,0,9999,0
1668473333027,CSE 293,030,119420,Saul; Lawrence,9999,0,9999,0
1668473333027,CSE 293,031,119421,Savage; Stefan,9999,0,9999,0
1668473333027,CSE 293,032,119425,Schulze; Jurgen P.,9999,0,9999,0
1668473333027,CSE 293,033,119426,Snoeren; Alex C.,9999,0,9999,0
1668473333027,CSE 293,034,119428,Shang; Jingbo,9999,0,9999,0
1668473333027,CSE 293,035,119430,Stefan; Deian,9999,0,9999,0
1668473333027,CSE 293,036,119431,Su; Hao,9999,0,9999,0
1668473333027,CSE 293,037,119433,Swanson; Steven James,9999,0,9999,0
1668473333027,CSE 293,038,119435,Tullsen; Dean Michael,9999,0,9999,0
1668473333027,CSE 293,039,119483,Voelker; Geoffrey M.,9999,0,9999,0
1668473333027,CSE 293,040,119537,Zhao; Jishen,9999,0,9999,0
1668473333027,CSE 293,041,119538,Zhou; Yuan-Yuan,9999,0,9999,0
1668473333027,CSE 293,042,119539,Gao; Sicun,9999,0,9999,0
1668473333027,CSE 293,043,119540,Weibel; Nadir,9999,0,9999,0
1668473333027,CSE 293,044,119541,Gupta; Rajesh K.,9999,0,9999,0
1668473333027,CSE 293,045,126410,Vaccaro; Kristen Marie,9999,0,9999,0
1668473333027,CSE 293,046,126411,Klemke; Richard,9999,0,9999,0
1668473333452,CSE 294,A00,102459,Voelker; Geoffrey M.,0,2,0,0
1668473333452,CSE 294,B00,111322,Orailoglu; Alex,0,2,0,0
1668473333882,DSE 201,A00,096914,Deutsch; Alin Bernard,30,0,30,0
1668473334317,DSE 210,A00,096915,Dasgupta; Sanjoy,30,0,30,0
1668473334742,DSE 260A,A00,096916,Altintas De Callaf; Ilkay,30,0,30,0
1668473335172,ECE 200,001,103586,Antipa; Nicholas A,9999,0,9999,0
1668473335172,ECE 200,002,103587,Atanasov; Nikolay A.,9999,0,9999,0
1668473335172,ECE 200,003,103588,Bharadia; Dinesh,9999,0,9999,0
1668473335172,ECE 200,004,103589,Cheng; Chung Kuan,9999,0,9999,0
1668473335172,ECE 200,005,103590,Cosman; Pamela C.,9999,0,9999,0
1668473335172,ECE 200,006,103591,Dayeh; Shadi Ahmad,9999,0,9999,0
1668473335172,ECE 200,007,103592,Fainman; Yeshaiahu,9999,0,9999,0
1668473335172,ECE 200,008,103593,Ford; Joseph Earl,9999,0,9999,0
1668473335172,ECE 200,009,103594,Franceschetti; Massimo,9999,0,9999,0
1668473335172,ECE 200,010,103595,Fullerton; Eric E,9999,0,9999,0
1668473335172,ECE 200,011,103596,Galton; Ian A,9999,0,9999,0
1668473335172,ECE 200,012,103597,Gilja; Vikash,9999,0,9999,0
1668473335172,ECE 200,013,103598,Hall; Drew A.,9999,0,9999,0
1668473335172,ECE 200,014,103599,Hsueh; Tzu-Chien,9999,0,9999,0
1668473335172,ECE 200,015,103600,Javidi; Tara,9999,0,9999,0
1668473335172,ECE 200,016,103601,Kahng; Andrew Byun,9999,0,9999,0
1668473335172,ECE 200,017,103602,Kim; Young-Han,9999,0,9999,0
1668473335172,ECE 200,018,103603,Koushanfar; Farinaz,9999,0,9999,0
1668473335172,ECE 200,019,103604,Kuzum; Duygu,9999,0,9999,0
1668473335172,ECE 200,020,103605,Le; Hanh-Phuc,9999,0,9999,0
1668473335172,ECE 200,021,103606,Lin; Bill,9999,0,9999,0
1668473335172,ECE 200,022,103607,Liu; Zhaowei,9998,0,9999,1
1668473335172,ECE 200,023,103608,Lo; Yu-Hwa,9999,0,9999,0
1668473335172,ECE 200,024,103609,Lomakin; Vitaliy,9999,0,9999,0
1668473335172,ECE 200,025,103610,Mercier; Patrick Philip,9999,0,9999,0
1668473335172,ECE 200,026,103611,Meyer; Florian,9999,0,9999,0
1668473335172,ECE 200,027,103612,Milstein; Laurence B.,9999,0,9999,0
1668473335172,ECE 200,028,103613,Mir Arabbaygi; Siavash,9999,0,9999,0
1668473335172,ECE 200,029,103614,Mookherjea; Shayan,9999,0,9999,0
1668473335172,ECE 200,030,103615,Morris; Karcher William,9999,0,9999,0
1668473335172,ECE 200,031,103616,Ng; Tse Nga,9999,0,9999,0
1668473335172,ECE 200,032,103617,Nguyen; Truong Quang,9999,0,9999,0
1668473335172,ECE 200,033,103618,Nomura; Kenji,9999,0,9999,0
1668473335172,ECE 200,034,103619,Orlitsky; Alon,9999,0,9999,0
1668473335172,ECE 200,035,103620,Pal; Piya,9999,0,9999,0
1668473335172,ECE 200,036,103621,Papen; George C.,9999,0,9999,0
1668473335172,ECE 200,037,103622,Radic; Stojan,9999,0,9999,0
1668473335172,ECE 200,038,103623,Rao; Bhaskar D.,9999,0,9999,0
1668473335172,ECE 200,039,103624,Rao; Ramesh R,9999,0,9999,0
1668473335172,ECE 200,040,103625,Rebeiz; Gabriel,9999,0,9999,0
1668473335172,ECE 200,041,103626,Sanford; John R,9999,0,9999,0
1668473335172,ECE 200,042,103627,Siegel; Paul H.,9999,0,9999,0
1668473335172,ECE 200,043,103628,Sievenpiper; Daniel F.,9999,0,9999,0
1668473335172,ECE 200,044,103629,Sworder; David D.,9999,0,9999,0
1668473335172,ECE 200,045,103630,Taur; Yuan,9999,0,9999,0
1668473335172,ECE 200,046,103631,Touri; Behrouz,9999,0,9999,0
1668473335172,ECE 200,047,103632,Trivedi; Mohan M.,9999,0,9999,0
1668473335172,ECE 200,048,103633,Vasconcelos; Nuno,9999,0,9999,0
1668473335172,ECE 200,049,103634,Wang; Xiaolong,9999,0,9999,0
1668473335172,ECE 200,050,103635,Xie; Pengtao,9999,0,9999,0
1668473335172,ECE 200,051,103636,Yip; Michael,9999,0,9999,0
1668473335172,ECE 200,052,103637,Zeger; Kenneth A.,999,0,999,0
1668473335172,ECE 200,053,103638,Zhang; Xinyu,9999,0,9999,0
1668473335172,ECE 200,054,103639,Turakhia; Yatish Girish,9999,0,9999,0
1668473335172,ECE 200,055,103640,Kang; Mingu,9999,0,9999,0
1668473335172,ECE 200,056,103641,Shi; Yuanyuan,9999,0,9999,0
1668473335172,ECE 200,057,103642,Wang; Edward Jay,9999,0,9999,0
1668473335172,ECE 200,058,103643,Zheng; Yang,9999,0,9999,0
1668473335611,ECE 202,A00,103644,Kuzum; Duygu,0,41,0,0
1668473336035,ECE 212BN,A00,103646,Ng; Tse Nga,0,8,0,0
1668473336459,ECE 221,A00,111493,Staff,0,0,0,0
1668473336880,ECE 222B,A00,103647,Lomakin; Vitaliy,0,16,0,0
1668473337305,ECE 230B,A00,103648,Taur; Yuan,0,2,0,0
1668473337727,ECE 238B,A00,103649,Garay; Javier,0,0,0,0
1668473338152,ECE 240B,A00,112900,Fainman; Yeshaiahu,0,6,0,0
1668473338580,ECE 247A,A00,103650,Jokerst; Jesse Vincent,0,5,0,0
1668473339005,ECE 247B,A00,103651,Wang; Joseph,0,11,0,0
1668473339433,ECE 250,A00,103652,Siegel; Paul H.,0,78,0,0
1668473339860,ECE 251A,A00,103654,Rao; Bhaskar D.,0,61,0,0
1668473340287,ECE 257B,A00,103655,Bharadia; Dinesh,0,32,0,0
1668473340715,ECE 258A,A00,103656,Milstein; Laurence B.,0,28,0,0
1668473341139,ECE 260B,A00,103658,Kang; Mingu,0,119,0,0
1668473341567,ECE 264A,A00,103659,Galton; Ian A,0,65,0,0
1668473341991,ECE 265A,A00,103661,Gudem; Prasad S.S.,0,63,0,0
1668473342414,ECE 265D,A00,103662,Gudem; Prasad S.S.,0,24,0,0
1668473342838,ECE 268,A00,103663,Koushanfar; Farinaz,0,41,0,0
1668473343263,ECE 269,A01,103665,Pal; Piya,0,202,0,0
1668473343690,ECE 271B,A00,103666,Vasconcelos; Manuela,0,69,0,0
1668473344125,ECE 276A,A00,103667,Atanasov; Nikolay A.,0,118,0,0
1668473344551,ECE 277,A00,103668,An; Cheolhong,0,141,0,0
1668473344975,ECE 279,A00,117947,Hall; Drew A.,0,22,0,0
1668473345829,ECE 283,A00,103670,Hsueh; Tzu-Chien,0,51,0,0
1668473346262,ECE 284,A00,103671,Turakhia; Yatish Girish,0,39,0,0
1668473346692,ECE 285,A00,103672,Zheng; Yang,0,37,0,0
1668473346692,ECE 285,B00,103673,Sworder; David D.,0,55,0,0
1668473347122,ECE 287,A00,103676,Javidi; Tara,0,8,0,0
1668473347545,MATH 200B,A00,098023,Salehi Golsefidy; Alireza,11,0,15,4
1668473347972,MATH 202B,A00,098024,Rhoades; Brendon Patrick,7,0,15,8
1668473348398,MATH 203B,A00,098025,Oprea; Dragos N.,10,0,15,5
1668473348832,MATH 204B,A00,098026,Sorensen; Claus M,13,0,15,2
1668473349257,MATH 208,A00,098027,Izadi; Elham,7,0,10,3
1668473349683,MATH 209,A00,098028,Pollack; Aaron,10,0,10,0
1668473350117,MATH 211A,A00,112919,Rogalski; Daniel,8,0,10,2
1668473350544,MATH 211B,A00,112920,Seward; Brandon M.,9,0,10,1
1668473350969,MATH 218,A00,098029,Li; Bo,10,0,10,0
1668473351393,MATH 220B,A00,098030,Novak; Jonathan I,11,0,15,4
1668473351816,MATH 221A,A00,098031,Ebenfelt; Peter F,13,0,15,2
1668473352240,MATH 231B,A00,098032,Zlatos; Andrej,11,0,15,4
1668473352664,MATH 240B,A00,098033,Ni; Lei,7,0,15,8
1668473353090,MATH 243,A00,098034,Jekel; David Andrew,10,0,10,0
1668473353523,MATH 245A,A00,098035,Nie; Jiawang,0,3,15,18
1668473353953,MATH 248,A00,098036,Bejenaru; Ioan,10,0,10,0
1668473354377,MATH 250B,A00,098037,Spolaor; Luca,14,0,15,1
1668473354800,MATH 258,A00,098038,Ni; Lei,9,0,10,1
1668473355240,MATH 264B,A00,098041,Rhoades; Brendon Patrick,8,0,15,7
1668473355674,MATH 268,A00,098042,Buss; Samuel R,10,0,10,0
1668473356098,MATH 269,A00,098043,Rhoades; Brendon Patrick,10,0,10,0
1668473356521,MATH 270B,A00,098044,Li; Bo,6,0,15,9
1668473356949,MATH 272B,A00,098045,Holst; Michael J,13,0,15,2
1668473357373,MATH 273A,A00,098046,Tian; Xiaochuan,10,0,15,5
1668473357798,MATH 275,A01,098048,Tian; Xiaochuan,6,0,10,4
1668473358224,MATH 278A,A00,098049,Holst; Michael J,7,0,10,3
1668473358661,MATH 278B,A00,098050,Cloninger; Alexander,10,0,10,0
1668473359085,MATH 278C,A00,098051,Nie; Jiawang,5,0,10,5
1668473359512,MATH 280B,A00,098052,Zheng; Tianyi,7,0,15,8
1668473359943,MATH 281B,A00,098053,Bradic; Jelena,0,2,15,15
1668473360366,MATH 282B,A00,098054,Arias-Castro; Ery,0,0,15,15
1668473360789,MATH 285,A00,098055,Fitzsimmons; Patrick J,0,2,15,17
1668473361217,MATH 287B,A00,098056,Arias-Castro; Ery,2,0,15,13
1668473361642,MATH 288,A00,098057,Agarwal; Pooja,9,0,10,1
1668473361642,MATH 288,B00,098058,Zhang; Danna,8,0,10,2
1668473361642,MATH 288,C00,098059,Williams; Ruth J,9,0,10,1
1668473362065,MATH 290B,A00,098060,Roberts; Justin Deritter,12,0,15,3
1668473362488,MATH 292,A00,098061,Belmont; Eva Kinoshita,10,0,10,0
1668473362912,MATH 295,A00,098062,Suk; Andrew Hoon,47,0,50,3
1668473363336,MATH 296,A00,098063,Novak; Jonathan I,20,0,20,0
1668473363761,MATH 297,001,098064,Gamst; Anthony Collins,9997,0,9999,2
1668473865747,COGS 205,A00,101395,Chiba; Andrea,19,0,20,1
1668473866179,COGS 210B,001,101404,Greene; Deanna Jacquelyn,9998,0,9999,1
1668473866179,COGS 210B,002,101417,Xia; Haijun,9999,0,9999,0
1668473866179,COGS 210B,003,101422,Nitz; Douglas A.,9999,0,9999,0
1668473866179,COGS 210B,004,101423,Hollan; James D.,9998,0,9999,1
1668473866179,COGS 210B,005,101424,Deak; Gedeon O.,9998,0,9999,1
1668473866179,COGS 210B,006,101425,Rossano; Federico,9999,0,9999,0
1668473866606,COGS 211B,A00,101427,Coulson; Seana M,9996,0,9999,3
1668473867036,COGS 220,A00,101428,Hollan; James D.,1,9,25,24
1668473867463,COGS 229,A00,101429,Dow; Steven P,17,0,25,8
1668473867893,COGS 230,A00,101430,Klemmer; Scott R,8,0,17,9
1668473868321,COGS 234,A00,101431,Xia; Haijun,2,0,25,23
1668473868750,COGS 260,A00,101432,Kiyonaga; Anastasia,21,0,25,4
1668473868750,COGS 260,B00,101433,Kirsh; David Joel,15,0,25,10
1668473869181,CSE 202,A00,102371,Impagliazzo; Russell,0,59,0,0
1668473869619,CSE 203B,A01,102373,Cheng; Chung Kuan,0,50,0,0
1668473870048,CSE 208,A00,102374,Micciancio; Daniele,0,4,0,0
1668473870470,CSE 209A,A00,112895,Impagliazzo; Russell,0,12,15,15
1668473870903,CSE 209B,A00,108005,Bellare; Mihir,0,6,0,0
1668473871339,CSE 210,A00,113163,Coblenz; Michael J,0,80,0,0
1668473871770,CSE 219,A00,106111,Dow; Steven P,0,6,20,20
1668473872204,CSE 221,A00,102376,Voelker; Geoffrey M.,0,66,0,0
1668473872635,CSE 224,A01,102378,Porter; George M,0,158,0,0
1668473873062,CSE 229A,A00,102379,Savage; Stefan,0,10,0,0
1668473873491,CSE 229C,A00,102380,Munyaka; Imani N. S.,0,9,0,0
1668473873920,CSE 232B,A00,102382,Deutsch; Alin Bernard,0,28,0,0
1668473874345,CSE 234,A01,112904,Kumar; Arun Kumar,0,0,0,0
1668473874774,CSE 237A,A00,102383,Rosing; Tajana Simunic,0,47,0,0
1668473875196,CSE 239A,A00,102384,Deutsch; Alin Bernard,0,12,0,0
1668473875621,CSE 239B,A00,102385,Polikarpova; Nadezhda,0,10,0,0
1668473876044,CSE 240A,A00,102386,Pannuto; Patrick William,0,43,0,0
1668473876471,CSE 240B,A00,102387,Zhao; Jishen,0,41,0,0
1668473876895,CSE 241A,A00,106406,Kang; Mingu,0,6,0,0
1668473877320,CSE 249B,A00,102388,Kahng; Andrew Byun,0,5,8,8
1668473877752,CSE 251B,A01,102392,Cottrell; Garrison W,0,42,0,0
1668473877752,CSE 251B,A02,102393,Cottrell; Garrison W,0,32,0,0
1668473878176,CSE 252B,A00,102394,Ochoa; Benjamin Lawrence,0,53,0,0
1668473878601,CSE 257,A01,102396,Gao; Sicun,0,128,0,0
1668473879033,CSE 272,A00,102397,Li; Tzumao,0,17,0,0
1668473879457,CSE 274,A00,111323,Chern; Albert Ren-Haur,0,14,0,0
1668473879884,CSE 282,A00,102398,Pevzner; Pavel Arkadjevich,0,0,0,0
1668473880307,CSE 284,A00,114175,Gymrek; Melissa Ann,0,18,0,0
1668473880733,CSE 290,A00,102399,Chandraker; Manmohan Krishna,0,11,0,0
1668473880733,CSE 290,B00,102400,Vaccaro; Kristen Marie,0,7,25,25
1668473880733,CSE 290,C00,102414,Pannuto; Patrick William,0,1,25,25
1668473880733,CSE 290,D00,102427,Pevzner; Pavel Arkadjevich,0,0,0,0
1668473880733,CSE 290,E00,102429,Zhao; Jishen,0,4,0,0
1668473880733,CSE 290,F00,102436,Tullsen; Dean Michael,0,5,0,0
1668473880733,CSE 290,G00,102440,Christensen; Henrik I,0,6,20,20
1668473881157,CSE 291,A00,102443,Su; Hao,0,0,0,0
1668473881157,CSE 291,B00,102448,Polikarpova; Nadezhda,0,0,0,0
1668473881157,CSE 291,C00,102453,Vaccaro; Kristen Marie,0,0,0,0
1668473881157,CSE 291,D00,111343,Savage; Stefan,0,0,0,0
1668473881157,CSE 291,E00,116474,Claffy; Kimberly Claire,0,0,0,0
1668473881157,CSE 291,F00,116479,Pasquale; Joseph,0,0,0,0
1668473881591,CSE 293,001,119111,Bafna; Vineet,9999,0,9999,0
1668473881591,CSE 293,002,119118,Bellare; Mihir,9999,0,9999,0
1668473881591,CSE 293,003,119122,Berg-Kirkpatrick; Taylor D,9999,0,9999,0
1668473881591,CSE 293,004,119135,Christensen; Henrik I,9999,0,9999,0
1668473881591,CSE 293,005,119142,Cottrell; Garrison W,9999,0,9999,0
1668473881591,CSE 293,006,119146,Deutsch; Alin Bernard,9999,0,9999,0
1668473881591,CSE 293,007,119159,Esmaeilzadeh; Hadi,9999,0,9999,0
1668473881591,CSE 293,008,119166,Freund; Yoav,9999,0,9999,0
1668473881591,CSE 293,009,119170,Griswold; William G.,9999,0,9999,0
1668473881591,CSE 293,010,119183,Gymrek; Melissa Ann,9999,0,9999,0
1668473881591,CSE 293,011,119190,Heninger; Nadia A,9999,0,9999,0
1668473881591,CSE 293,012,119230,Impagliazzo; Russell,9999,0,9999,0
1668473881591,CSE 293,013,119232,Jhala; Ranjit,9999,0,9999,0
1668473881591,CSE 293,014,119233,Kahng; Andrew Byun,9999,0,9999,0
1668473881591,CSE 293,015,119298,Kane; Daniel Mertz,9999,0,9999,0
1668473881591,CSE 293,016,119299,Kriegman; David J,9999,0,9999,0
1668473881591,CSE 293,017,119300,Kumar; Arun Kumar,9999,0,9999,0
1668473881591,CSE 293,018,119301,Lerner; Sorin,9999,0,9999,0
1668473881591,CSE 293,019,119302,Lovett; Shachar,9999,0,9999,0
1668473881591,CSE 293,020,119303,McAuley; Julian John,9999,0,9999,0
1668473881591,CSE 293,021,119304,Micciancio; Daniele,9999,0,9999,0
1668473881591,CSE 293,022,119367,Orailoglu; Alex,9999,0,9999,0
1668473881591,CSE 293,023,119382,Paturi; Ramamohan,9999,0,9999,0
1668473881591,CSE 293,024,119404,Polikarpova; Nadezhda,9999,0,9999,0
1668473881591,CSE 293,025,119406,Politz; Joseph Gibbs,9999,0,9999,0
1668473881591,CSE 293,026,119411,Porter; George M,9999,0,9999,0
1668473881591,CSE 293,027,119414,Porter; Leonard Emerson,9999,0,9999,0
1668473881591,CSE 293,028,119416,Ramamoorthi; Ravi,9999,0,9999,0
1668473881591,CSE 293,029,119417,Sahoo; Debashis,9999,0,9999,0
1668473881591,CSE 293,030,119420,Saul; Lawrence,9999,0,9999,0
1668473881591,CSE 293,031,119421,Savage; Stefan,9999,0,9999,0
1668473881591,CSE 293,032,119425,Schulze; Jurgen P.,9999,0,9999,0
1668473881591,CSE 293,033,119426,Snoeren; Alex C.,9999,0,9999,0
1668473881591,CSE 293,034,119428,Shang; Jingbo,9999,0,9999,0
1668473881591,CSE 293,035,119430,Stefan; Deian,9999,0,9999,0
1668473881591,CSE 293,036,119431,Su; Hao,9999,0,9999,0
1668473881591,CSE 293,037,119433,Swanson; Steven James,9999,0,9999,0
1668473881591,CSE 293,038,119435,Tullsen; Dean Michael,9999,0,9999,0
1668473881591,CSE 293,039,119483,Voelker; Geoffrey M.,9999,0,9999,0
1668473881591,CSE 293,040,119537,Zhao; Jishen,9999,0,9999,0
1668473881591,CSE 293,041,119538,Zhou; Yuan-Yuan,9999,0,9999,0
1668473881591,CSE 293,042,119539,Gao; Sicun,9999,0,9999,0
1668473881591,CSE 293,043,119540,Weibel; Nadir,9999,0,9999,0
1668473881591,CSE 293,044,119541,Gupta; Rajesh K.,9999,0,9999,0
1668473881591,CSE 293,045,126410,Vaccaro; Kristen Marie,9999,0,9999,0
1668473881591,CSE 293,046,126411,Klemke; Richard,9999,0,9999,0
1668473882015,CSE 294,A00,102459,Voelker; Geoffrey M.,0,2,0,0
1668473882015,CSE 294,B00,111322,Orailoglu; Alex,0,2,0,0
1668473882439,DSE 201,A00,096914,Deutsch; Alin Bernard,30,0,30,0
1668473882864,DSE 210,A00,096915,Dasgupta; Sanjoy,30,0,30,0
1668473883289,DSE 260A,A00,096916,Altintas De Callaf; Ilkay,30,0,30,0
1668473883747,ECE 200,001,103586,Antipa; Nicholas A,9999,0,9999,0
1668473883747,ECE 200,002,103587,Atanasov; Nikolay A.,9999,0,9999,0
1668473883747,ECE 200,003,103588,Bharadia; Dinesh,9999,0,9999,0
1668473883747,ECE 200,004,103589,Cheng; Chung Kuan,9999,0,9999,0
1668473883747,ECE 200,005,103590,Cosman; Pamela C.,9999,0,9999,0
1668473883747,ECE 200,006,103591,Dayeh; Shadi Ahmad,9999,0,9999,0
1668473883747,ECE 200,007,103592,Fainman; Yeshaiahu,9999,0,9999,0
1668473883747,ECE 200,008,103593,Ford; Joseph Earl,9999,0,9999,0
1668473883747,ECE 200,009,103594,Franceschetti; Massimo,9999,0,9999,0
1668473883747,ECE 200,010,103595,Fullerton; Eric E,9999,0,9999,0
1668473883747,ECE 200,011,103596,Galton; Ian A,9999,0,9999,0
1668473883747,ECE 200,012,103597,Gilja; Vikash,9999,0,9999,0
1668473883747,ECE 200,013,103598,Hall; Drew A.,9999,0,9999,0
1668473883747,ECE 200,014,103599,Hsueh; Tzu-Chien,9999,0,9999,0
1668473883747,ECE 200,015,103600,Javidi; Tara,9999,0,9999,0
1668473883747,ECE 200,016,103601,Kahng; Andrew Byun,9999,0,9999,0
1668473883747,ECE 200,017,103602,Kim; Young-Han,9999,0,9999,0
1668473883747,ECE 200,018,103603,Koushanfar; Farinaz,9999,0,9999,0
1668473883747,ECE 200,019,103604,Kuzum; Duygu,9999,0,9999,0
1668473883747,ECE 200,020,103605,Le; Hanh-Phuc,9999,0,9999,0
1668473883747,ECE 200,021,103606,Lin; Bill,9999,0,9999,0
1668473883747,ECE 200,022,103607,Liu; Zhaowei,9998,0,9999,1
1668473883747,ECE 200,023,103608,Lo; Yu-Hwa,9999,0,9999,0
1668473883747,ECE 200,024,103609,Lomakin; Vitaliy,9999,0,9999,0
1668473883747,ECE 200,025,103610,Mercier; Patrick Philip,9999,0,9999,0
1668473883747,ECE 200,026,103611,Meyer; Florian,9999,0,9999,0
1668473883747,ECE 200,027,103612,Milstein; Laurence B.,9999,0,9999,0
1668473883747,ECE 200,028,103613,Mir Arabbaygi; Siavash,9999,0,9999,0
1668473883747,ECE 200,029,103614,Mookherjea; Shayan,9999,0,9999,0
1668473883747,ECE 200,030,103615,Morris; Karcher William,9999,0,9999,0
1668473883747,ECE 200,031,103616,Ng; Tse Nga,9999,0,9999,0
1668473883747,ECE 200,032,103617,Nguyen; Truong Quang,9999,0,9999,0
1668473883747,ECE 200,033,103618,Nomura; Kenji,9999,0,9999,0
1668473883747,ECE 200,034,103619,Orlitsky; Alon,9999,0,9999,0
1668473883747,ECE 200,035,103620,Pal; Piya,9999,0,9999,0
1668473883747,ECE 200,036,103621,Papen; George C.,9999,0,9999,0
1668473883747,ECE 200,037,103622,Radic; Stojan,9999,0,9999,0
1668473883747,ECE 200,038,103623,Rao; Bhaskar D.,9999,0,9999,0
1668473883747,ECE 200,039,103624,Rao; Ramesh R,9999,0,9999,0
1668473883747,ECE 200,040,103625,Rebeiz; Gabriel,9999,0,9999,0
1668473883747,ECE 200,041,103626,Sanford; John R,9999,0,9999,0
1668473883747,ECE 200,042,103627,Siegel; Paul H.,9999,0,9999,0
1668473883747,ECE 200,043,103628,Sievenpiper; Daniel F.,9999,0,9999,0
1668473883747,ECE 200,044,103629,Sworder; David D.,9999,0,9999,0
1668473883747,ECE 200,045,103630,Taur; Yuan,9999,0,9999,0
1668473883747,ECE 200,046,103631,Touri; Behrouz,9999,0,9999,0
1668473883747,ECE 200,047,103632,Trivedi; Mohan M.,9999,0,9999,0
1668473883747,ECE 200,048,103633,Vasconcelos; Nuno,9999,0,9999,0
1668473883747,ECE 200,049,103634,Wang; Xiaolong,9999,0,9999,0
1668473883747,ECE 200,050,103635,Xie; Pengtao,9999,0,9999,0
1668473883747,ECE 200,051,103636,Yip; Michael,9999,0,9999,0
1668473883747,ECE 200,052,103637,Zeger; Kenneth A.,999,0,999,0
1668473883747,ECE 200,053,103638,Zhang; Xinyu,9999,0,9999,0
1668473883747,ECE 200,054,103639,Turakhia; Yatish Girish,9999,0,9999,0
1668473883747,ECE 200,055,103640,Kang; Mingu,9999,0,9999,0
1668473883747,ECE 200,056,103641,Shi; Yuanyuan,9999,0,9999,0
1668473883747,ECE 200,057,103642,Wang; Edward Jay,9999,0,9999,0
1668473883747,ECE 200,058,103643,Zheng; Yang,9999,0,9999,0
1668473884173,ECE 202,A00,103644,Kuzum; Duygu,0,41,0,0
1668473884598,ECE 212BN,A00,103646,Ng; Tse Nga,0,8,0,0
1668473885125,ECE 221,A00,111493,Staff,0,0,0,0
1668473885553,ECE 222B,A00,103647,Lomakin; Vitaliy,0,16,0,0
1668473885993,ECE 230B,A00,103648,Taur; Yuan,0,2,0,0
1668473886416,ECE 238B,A00,103649,Garay; Javier,0,0,0,0
1668473886839,ECE 240B,A00,112900,Fainman; Yeshaiahu,0,6,0,0
1668473887265,ECE 247A,A00,103650,Jokerst; Jesse Vincent,0,5,0,0
1668473887695,ECE 247B,A00,103651,Wang; Joseph,0,11,0,0
1668473888122,ECE 250,A00,103652,Siegel; Paul H.,0,79,0,0
1668473888545,ECE 251A,A00,103654,Rao; Bhaskar D.,0,61,0,0
1668473888970,ECE 257B,A00,103655,Bharadia; Dinesh,0,32,0,0
1668473889399,ECE 258A,A00,103656,Milstein; Laurence B.,0,28,0,0
1668473889822,ECE 260B,A00,103658,Kang; Mingu,0,119,0,0
1668473890250,ECE 264A,A00,103659,Galton; Ian A,0,65,0,0
1668473890673,ECE 265A,A00,103661,Gudem; Prasad S.S.,0,64,0,0
1668473891109,ECE 265D,A00,103662,Gudem; Prasad S.S.,0,24,0,0
1668473891536,ECE 268,A00,103663,Koushanfar; Farinaz,0,41,0,0
1668473891973,ECE 269,A01,103665,Pal; Piya,0,203,0,0
1668473892400,ECE 271B,A00,103666,Vasconcelos; Manuela,0,70,0,0
1668473892830,ECE 276A,A00,103667,Atanasov; Nikolay A.,0,118,0,0
1668473893254,ECE 277,A00,103668,An; Cheolhong,0,141,0,0
1668473893676,ECE 279,A00,117947,Hall; Drew A.,0,22,0,0
1668473894522,ECE 283,A00,103670,Hsueh; Tzu-Chien,0,51,0,0
1668473894955,ECE 284,A00,103671,Turakhia; Yatish Girish,0,39,0,0
1668473895393,ECE 285,A00,103672,Zheng; Yang,0,38,0,0
1668473895393,ECE 285,B00,103673,Sworder; David D.,0,55,0,0
1668473895817,ECE 287,A00,103676,Javidi; Tara,0,8,0,0
1668473896241,MATH 200B,A00,098023,Salehi Golsefidy; Alireza,11,0,15,4
1668473896671,MATH 202B,A00,098024,Rhoades; Brendon Patrick,7,0,15,8
1668473897104,MATH 203B,A00,098025,Oprea; Dragos N.,10,0,15,5
1668473897538,MATH 204B,A00,098026,Sorensen; Claus M,13,0,15,2
1668473897960,MATH 208,A00,098027,Izadi; Elham,7,0,10,3
1668473898384,MATH 209,A00,098028,Pollack; Aaron,10,0,10,0
1668473898812,MATH 211A,A00,112919,Rogalski; Daniel,8,0,10,2
1668473899243,MATH 211B,A00,112920,Seward; Brandon M.,9,0,10,1
1668473899665,MATH 218,A00,098029,Li; Bo,10,0,10,0
1668473900092,MATH 220B,A00,098030,Novak; Jonathan I,11,0,15,4
1668473900519,MATH 221A,A00,098031,Ebenfelt; Peter F,13,0,15,2
1668473900948,MATH 231B,A00,098032,Zlatos; Andrej,11,0,15,4
1668473901371,MATH 240B,A00,098033,Ni; Lei,7,0,15,8
1668473901802,MATH 243,A00,098034,Jekel; David Andrew,10,0,10,0
1668473902229,MATH 245A,A00,098035,Nie; Jiawang,0,4,15,18
1668473902653,MATH 248,A00,098036,Bejenaru; Ioan,10,0,10,0
1668473903081,MATH 250B,A00,098037,Spolaor; Luca,14,0,15,1
1668473903503,MATH 258,A00,098038,Ni; Lei,9,0,10,1
1668473903927,MATH 264B,A00,098041,Rhoades; Brendon Patrick,8,0,15,7
1668473904352,MATH 268,A00,098042,Buss; Samuel R,10,0,10,0
1668473904776,MATH 269,A00,098043,Rhoades; Brendon Patrick,10,0,10,0
1668473905207,MATH 270B,A00,098044,Li; Bo,6,0,15,9
1668473905638,MATH 272B,A00,098045,Holst; Michael J,13,0,15,2
1668473906069,MATH 273A,A00,098046,Tian; Xiaochuan,10,0,15,5
1668473906493,MATH 275,A01,098048,Tian; Xiaochuan,6,0,10,4
1668473906918,MATH 278A,A00,098049,Holst; Michael J,7,0,10,3
1668473907345,MATH 278B,A00,098050,Cloninger; Alexander,10,0,10,0
1668473907774,MATH 278C,A00,098051,Nie; Jiawang,5,0,10,5
1668473908206,MATH 280B,A00,098052,Zheng; Tianyi,7,0,15,8
1668473908627,MATH 281B,A00,098053,Bradic; Jelena,0,2,15,15
1668473909063,MATH 282B,A00,098054,Arias-Castro; Ery,0,0,15,15
1668473909496,MATH 285,A00,098055,Fitzsimmons; Patrick J,0,2,15,17
1668473909918,MATH 287B,A00,098056,Arias-Castro; Ery,2,0,15,13
1668473910344,MATH 288,A00,098057,Agarwal; Pooja,9,0,10,1
1668473910344,MATH 288,B00,098058,Zhang; Danna,8,0,10,2
1668473910344,MATH 288,C00,098059,Williams; Ruth J,9,0,10,1
1668473910769,MATH 290B,A00,098060,Roberts; Justin Deritter,12,0,15,3
1668473911195,MATH 292,A00,098061,Belmont; Eva Kinoshita,10,0,10,0
1668473911622,MATH 295,A00,098062,Suk; Andrew Hoon,47,0,50,3
1668473912049,MATH 296,A00,098063,Novak; Jonathan I,20,0,20,0
1668473912473,MATH 297,001,098064,Gamst; Anthony Collins,9997,0,9999,2
1668474415568,COGS 205,A00,101395,Chiba; Andrea,19,0,20,1
1668474415998,COGS 210B,001,101404,Greene; Deanna Jacquelyn,9998,0,9999,1
1668474415998,COGS 210B,002,101417,Xia; Haijun,9999,0,9999,0
1668474415998,COGS 210B,003,101422,Nitz; Douglas A.,9999,0,9999,0
1668474415998,COGS 210B,004,101423,Hollan; James D.,9998,0,9999,1
1668474415998,COGS 210B,005,101424,Deak; Gedeon O.,9998,0,9999,1
1668474415998,COGS 210B,006,101425,Rossano; Federico,9999,0,9999,0
1668474416422,COGS 211B,A00,101427,Coulson; Seana M,9996,0,9999,3
1668474416849,COGS 220,A00,101428,Hollan; James D.,1,9,25,24
1668474417277,COGS 229,A00,101429,Dow; Steven P,17,0,25,8
1668474417707,COGS 230,A00,101430,Klemmer; Scott R,8,0,17,9
1668474418131,COGS 234,A00,101431,Xia; Haijun,2,0,25,23
1668474418558,COGS 260,A00,101432,Kiyonaga; Anastasia,21,0,25,4
1668474418558,COGS 260,B00,101433,Kirsh; David Joel,15,0,25,10
1668474418986,CSE 202,A00,102371,Impagliazzo; Russell,0,59,0,0
1668474419410,CSE 203B,A01,102373,Cheng; Chung Kuan,0,50,0,0
1668474419834,CSE 208,A00,102374,Micciancio; Daniele,0,4,0,0
1668474420258,CSE 209A,A00,112895,Impagliazzo; Russell,0,12,15,15
1668474420683,CSE 209B,A00,108005,Bellare; Mihir,0,6,0,0
1668474421109,CSE 210,A00,113163,Coblenz; Michael J,0,80,0,0
1668474421532,CSE 219,A00,106111,Dow; Steven P,0,6,20,20
1668474421959,CSE 221,A00,102376,Voelker; Geoffrey M.,0,66,0,0
1668474422392,CSE 224,A01,102378,Porter; George M,0,158,0,0
1668474422817,CSE 229A,A00,102379,Savage; Stefan,0,10,0,0
1668474423240,CSE 229C,A00,102380,Munyaka; Imani N. S.,0,9,0,0
1668474423680,CSE 232B,A00,102382,Deutsch; Alin Bernard,0,28,0,0
1668474424105,CSE 234,A01,112904,Kumar; Arun Kumar,0,0,0,0
1668474424533,CSE 237A,A00,102383,Rosing; Tajana Simunic,0,47,0,0
1668474424969,CSE 239A,A00,102384,Deutsch; Alin Bernard,0,12,0,0
1668474425395,CSE 239B,A00,102385,Polikarpova; Nadezhda,0,10,0,0
1668474425818,CSE 240A,A00,102386,Pannuto; Patrick William,0,43,0,0
1668474426242,CSE 240B,A00,102387,Zhao; Jishen,0,41,0,0
1668474426680,CSE 241A,A00,106406,Kang; Mingu,0,6,0,0
1668474427105,CSE 249B,A00,102388,Kahng; Andrew Byun,0,5,8,8
1668474427529,CSE 251B,A01,102392,Cottrell; Garrison W,0,43,0,0
1668474427529,CSE 251B,A02,102393,Cottrell; Garrison W,0,32,0,0
1668474427968,CSE 252B,A00,102394,Ochoa; Benjamin Lawrence,0,55,0,0
1668474428396,CSE 257,A01,102396,Gao; Sicun,0,128,0,0
1668474428829,CSE 272,A00,102397,Li; Tzumao,0,17,0,0
1668474429256,CSE 274,A00,111323,Chern; Albert Ren-Haur,0,14,0,0
1668474429699,CSE 282,A00,102398,Pevzner; Pavel Arkadjevich,0,0,0,0
1668474430127,CSE 284,A00,114175,Gymrek; Melissa Ann,0,18,0,0
1668474430558,CSE 290,A00,102399,Chandraker; Manmohan Krishna,0,11,0,0
1668474430558,CSE 290,B00,102400,Vaccaro; Kristen Marie,0,7,25,25
1668474430558,CSE 290,C00,102414,Pannuto; Patrick William,0,1,25,25
1668474430558,CSE 290,D00,102427,Pevzner; Pavel Arkadjevich,0,0,0,0
1668474430558,CSE 290,E00,102429,Zhao; Jishen,0,4,0,0
1668474430558,CSE 290,F00,102436,Tullsen; Dean Michael,0,5,0,0
1668474430558,CSE 290,G00,102440,Christensen; Henrik I,0,6,20,20
1668474430984,CSE 291,A00,102443,Su; Hao,0,0,0,0
1668474430984,CSE 291,B00,102448,Polikarpova; Nadezhda,0,0,0,0
1668474430984,CSE 291,C00,102453,Vaccaro; Kristen Marie,0,0,0,0
1668474430984,CSE 291,D00,111343,Savage; Stefan,0,0,0,0
1668474430984,CSE 291,E00,116474,Claffy; Kimberly Claire,0,0,0,0
1668474430984,CSE 291,F00,116479,Pasquale; Joseph,0,0,0,0
1668474431424,CSE 293,001,119111,Bafna; Vineet,9999,0,9999,0
1668474431424,CSE 293,002,119118,Bellare; Mihir,9999,0,9999,0
1668474431424,CSE 293,003,119122,Berg-Kirkpatrick; Taylor D,9999,0,9999,0
1668474431424,CSE 293,004,119135,Christensen; Henrik I,9999,0,9999,0
1668474431424,CSE 293,005,119142,Cottrell; Garrison W,9999,0,9999,0
1668474431424,CSE 293,006,119146,Deutsch; Alin Bernard,9999,0,9999,0
1668474431424,CSE 293,007,119159,Esmaeilzadeh; Hadi,9999,0,9999,0
1668474431424,CSE 293,008,119166,Freund; Yoav,9999,0,9999,0
1668474431424,CSE 293,009,119170,Griswold; William G.,9999,0,9999,0
1668474431424,CSE 293,010,119183,Gymrek; Melissa Ann,9999,0,9999,0
1668474431424,CSE 293,011,119190,Heninger; Nadia A,9999,0,9999,0
1668474431424,CSE 293,012,119230,Impagliazzo; Russell,9999,0,9999,0
1668474431424,CSE 293,013,119232,Jhala; Ranjit,9999,0,9999,0
1668474431424,CSE 293,014,119233,Kahng; Andrew Byun,9999,0,9999,0
1668474431424,CSE 293,015,119298,Kane; Daniel Mertz,9999,0,9999,0
1668474431424,CSE 293,016,119299,Kriegman; David J,9999,0,9999,0
1668474431424,CSE 293,017,119300,Kumar; Arun Kumar,9999,0,9999,0
1668474431424,CSE 293,018,119301,Lerner; Sorin,9999,0,9999,0
1668474431424,CSE 293,019,119302,Lovett; Shachar,9999,0,9999,0
1668474431424,CSE 293,020,119303,McAuley; Julian John,9999,0,9999,0
1668474431424,CSE 293,021,119304,Micciancio; Daniele,9999,0,9999,0
1668474431424,CSE 293,022,119367,Orailoglu; Alex,9999,0,9999,0
1668474431424,CSE 293,023,119382,Paturi; Ramamohan,9999,0,9999,0
1668474431424,CSE 293,024,119404,Polikarpova; Nadezhda,9999,0,9999,0
1668474431424,CSE 293,025,119406,Politz; Joseph Gibbs,9999,0,9999,0
1668474431424,CSE 293,026,119411,Porter; George M,9999,0,9999,0
1668474431424,CSE 293,027,119414,Porter; Leonard Emerson,9999,0,9999,0
1668474431424,CSE 293,028,119416,Ramamoorthi; Ravi,9999,0,9999,0
1668474431424,CSE 293,029,119417,Sahoo; Debashis,9999,0,9999,0
1668474431424,CSE 293,030,119420,Saul; Lawrence,9999,0,9999,0
1668474431424,CSE 293,031,119421,Savage; Stefan,9999,0,9999,0
1668474431424,CSE 293,032,119425,Schulze; Jurgen P.,9999,0,9999,0
1668474431424,CSE 293,033,119426,Snoeren; Alex C.,9999,0,9999,0
1668474431424,CSE 293,034,119428,Shang; Jingbo,9999,0,9999,0
1668474431424,CSE 293,035,119430,Stefan; Deian,9999,0,9999,0
1668474431424,CSE 293,036,119431,Su; Hao,9999,0,9999,0
1668474431424,CSE 293,037,119433,Swanson; Steven James,9999,0,9999,0
1668474431424,CSE 293,038,119435,Tullsen; Dean Michael,9999,0,9999,0
1668474431424,CSE 293,039,119483,Voelker; Geoffrey M.,9999,0,9999,0
1668474431424,CSE 293,040,119537,Zhao; Jishen,9999,0,9999,0
1668474431424,CSE 293,041,119538,Zhou; Yuan-Yuan,9999,0,9999,0
1668474431424,CSE 293,042,119539,Gao; Sicun,9999,0,9999,0
1668474431424,CSE 293,043,119540,Weibel; Nadir,9999,0,9999,0
1668474431424,CSE 293,044,119541,Gupta; Rajesh K.,9999,0,9999,0
1668474431424,CSE 293,045,126410,Vaccaro; Kristen Marie,9999,0,9999,0
1668474431424,CSE 293,046,126411,Klemke; Richard,9999,0,9999,0
1668474431851,CSE 294,A00,102459,Voelker; Geoffrey M.,0,2,0,0
1668474431851,CSE 294,B00,111322,Orailoglu; Alex,0,2,0,0
1668474432276,DSE 201,A00,096914,Deutsch; Alin Bernard,30,0,30,0
1668474432701,DSE 210,A00,096915,Dasgupta; Sanjoy,30,0,30,0
1668474433128,DSE 260A,A00,096916,Altintas De Callaf; Ilkay,30,0,30,0
1668474433561,ECE 200,001,103586,Antipa; Nicholas A,9999,0,9999,0
1668474433561,ECE 200,002,103587,Atanasov; Nikolay A.,9999,0,9999,0
1668474433561,ECE 200,003,103588,Bharadia; Dinesh,9999,0,9999,0
1668474433561,ECE 200,004,103589,Cheng; Chung Kuan,9999,0,9999,0
1668474433561,ECE 200,005,103590,Cosman; Pamela C.,9999,0,9999,0
1668474433561,ECE 200,006,103591,Dayeh; Shadi Ahmad,9999,0,9999,0
1668474433561,ECE 200,007,103592,Fainman; Yeshaiahu,9999,0,9999,0
1668474433561,ECE 200,008,103593,Ford; Joseph Earl,9999,0,9999,0
1668474433561,ECE 200,009,103594,Franceschetti; Massimo,9999,0,9999,0
1668474433561,ECE 200,010,103595,Fullerton; Eric E,9999,0,9999,0
1668474433561,ECE 200,011,103596,Galton; Ian A,9999,0,9999,0
1668474433561,ECE 200,012,103597,Gilja; Vikash,9999,0,9999,0
1668474433561,ECE 200,013,103598,Hall; Drew A.,9999,0,9999,0
1668474433561,ECE 200,014,103599,Hsueh; Tzu-Chien,9999,0,9999,0
1668474433561,ECE 200,015,103600,Javidi; Tara,9999,0,9999,0
1668474433561,ECE 200,016,103601,Kahng; Andrew Byun,9999,0,9999,0
1668474433561,ECE 200,017,103602,Kim; Young-Han,9999,0,9999,0
1668474433561,ECE 200,018,103603,Koushanfar; Farinaz,9999,0,9999,0
1668474433561,ECE 200,019,103604,Kuzum; Duygu,9999,0,9999,0
1668474433561,ECE 200,020,103605,Le; Hanh-Phuc,9999,0,9999,0
1668474433561,ECE 200,021,103606,Lin; Bill,9999,0,9999,0
1668474433561,ECE 200,022,103607,Liu; Zhaowei,9998,0,9999,1
1668474433561,ECE 200,023,103608,Lo; Yu-Hwa,9999,0,9999,0
1668474433561,ECE 200,024,103609,Lomakin; Vitaliy,9999,0,9999,0
1668474433561,ECE 200,025,103610,Mercier; Patrick Philip,9999,0,9999,0
1668474433561,ECE 200,026,103611,Meyer; Florian,9999,0,9999,0
1668474433561,ECE 200,027,103612,Milstein; Laurence B.,9999,0,9999,0
1668474433561,ECE 200,028,103613,Mir Arabbaygi; Siavash,9999,0,9999,0
1668474433561,ECE 200,029,103614,Mookherjea; Shayan,9999,0,9999,0
1668474433561,ECE 200,030,103615,Morris; Karcher William,9999,0,9999,0
1668474433561,ECE 200,031,103616,Ng; Tse Nga,9999,0,9999,0
1668474433561,ECE 200,032,103617,Nguyen; Truong Quang,9999,0,9999,0
1668474433561,ECE 200,033,103618,Nomura; Kenji,9999,0,9999,0
1668474433561,ECE 200,034,103619,Orlitsky; Alon,9999,0,9999,0
1668474433561,ECE 200,035,103620,Pal; Piya,9999,0,9999,0
1668474433561,ECE 200,036,103621,Papen; George C.,9999,0,9999,0
1668474433561,ECE 200,037,103622,Radic; Stojan,9999,0,9999,0
1668474433561,ECE 200,038,103623,Rao; Bhaskar D.,9999,0,9999,0
1668474433561,ECE 200,039,103624,Rao; Ramesh R,9999,0,9999,0
1668474433561,ECE 200,040,103625,Rebeiz; Gabriel,9999,0,9999,0
1668474433561,ECE 200,041,103626,Sanford; John R,9999,0,9999,0
1668474433561,ECE 200,042,103627,Siegel; Paul H.,9999,0,9999,0
1668474433561,ECE 200,043,103628,Sievenpiper; Daniel F.,9999,0,9999,0
1668474433561,ECE 200,044,103629,Sworder; David D.,9999,0,9999,0
1668474433561,ECE 200,045,103630,Taur; Yuan,9999,0,9999,0
1668474433561,ECE 200,046,103631,Touri; Behrouz,9999,0,9999,0
1668474433561,ECE 200,047,103632,Trivedi; Mohan M.,9999,0,9999,0
1668474433561,ECE 200,048,103633,Vasconcelos; Nuno,9999,0,9999,0
1668474433561,ECE 200,049,103634,Wang; Xiaolong,9999,0,9999,0
1668474433561,ECE 200,050,103635,Xie; Pengtao,9999,0,9999,0
1668474433561,ECE 200,051,103636,Yip; Michael,9999,0,9999,0
1668474433561,ECE 200,052,103637,Zeger; Kenneth A.,999,0,999,0
1668474433561,ECE 200,053,103638,Zhang; Xinyu,9999,0,9999,0
1668474433561,ECE 200,054,103639,Turakhia; Yatish Girish,9999,0,9999,0
1668474433561,ECE 200,055,103640,Kang; Mingu,9999,0,9999,0
1668474433561,ECE 200,056,103641,Shi; Yuanyuan,9999,0,9999,0
1668474433561,ECE 200,057,103642,Wang; Edward Jay,9999,0,9999,0
1668474433561,ECE 200,058,103643,Zheng; Yang,9999,0,9999,0
1668474433990,ECE 202,A00,103644,Kuzum; Duygu,0,41,0,0
1668474434419,ECE 212BN,A00,103646,Ng; Tse Nga,0,8,0,0
1668474434842,ECE 221,A00,111493,Staff,0,0,0,0
1668474435266,ECE 222B,A00,103647,Lomakin; Vitaliy,0,16,0,0
1668474435691,ECE 230B,A00,103648,Taur; Yuan,0,2,0,0
1668474436119,ECE 238B,A00,103649,Garay; Javier,0,0,0,0
1668474436555,ECE 240B,A00,112900,Fainman; Yeshaiahu,0,6,0,0
1668474436979,ECE 247A,A00,103650,Jokerst; Jesse Vincent,0,5,0,0
1668474437408,ECE 247B,A00,103651,Wang; Joseph,0,11,0,0
1668474437838,ECE 250,A00,103652,Siegel; Paul H.,0,79,0,0
1668474438268,ECE 251A,A00,103654,Rao; Bhaskar D.,0,61,0,0
1668474438693,ECE 257B,A00,103655,Bharadia; Dinesh,0,32,0,0
1668474439118,ECE 258A,A00,103656,Milstein; Laurence B.,0,28,0,0
1668474439553,ECE 260B,A00,103658,Kang; Mingu,0,119,0,0
1668474439982,ECE 264A,A00,103659,Galton; Ian A,0,65,0,0
1668474440417,ECE 265A,A00,103661,Gudem; Prasad S.S.,0,64,0,0
1668474440861,ECE 265D,A00,103662,Gudem; Prasad S.S.,0,24,0,0
1668474441288,ECE 268,A00,103663,Koushanfar; Farinaz,0,41,0,0
1668474441716,ECE 269,A01,103665,Pal; Piya,0,203,0,0
1668474442154,ECE 271B,A00,103666,Vasconcelos; Manuela,0,71,0,0
1668474442595,ECE 276A,A00,103667,Atanasov; Nikolay A.,0,118,0,0
1668474443022,ECE 277,A00,103668,An; Cheolhong,0,141,0,0
1668474443446,ECE 279,A00,117947,Hall; Drew A.,0,22,0,0
1668474444302,ECE 283,A00,103670,Hsueh; Tzu-Chien,0,51,0,0
1668474444734,ECE 284,A00,103671,Turakhia; Yatish Girish,0,39,0,0
1668474445162,ECE 285,A00,103672,Zheng; Yang,0,38,0,0
1668474445162,ECE 285,B00,103673,Sworder; David D.,0,55,0,0
1668474445585,ECE 287,A00,103676,Javidi; Tara,0,8,0,0
1668474446009,MATH 200B,A00,098023,Salehi Golsefidy; Alireza,11,0,15,4
1668474446436,MATH 202B,A00,098024,Rhoades; Brendon Patrick,7,0,15,8
1668474446876,MATH 203B,A00,098025,Oprea; Dragos N.,10,0,15,5
1668474447302,MATH 204B,A00,098026,Sorensen; Claus M,13,0,15,2
1668474447726,MATH 208,A00,098027,Izadi; Elham,7,0,10,3
1668474448150,MATH 209,A00,098028,Pollack; Aaron,10,0,10,0
1668474448577,MATH 211A,A00,112919,Rogalski; Daniel,8,0,10,2
1668474449001,MATH 211B,A00,112920,Seward; Brandon M.,9,0,10,1
1668474449439,MATH 218,A00,098029,Li; Bo,10,0,10,0
1668474449864,MATH 220B,A00,098030,Novak; Jonathan I,11,0,15,4
1668474450368,MATH 221A,A00,098031,Ebenfelt; Peter F,13,0,15,2
1668474450806,MATH 231B,A00,098032,Zlatos; Andrej,11,0,15,4
1668474451230,MATH 240B,A00,098033,Ni; Lei,7,0,15,8
1668474451654,MATH 243,A00,098034,Jekel; David Andrew,10,0,10,0
1668474452077,MATH 245A,A00,098035,Nie; Jiawang,0,4,15,18
1668474452504,MATH 248,A00,098036,Bejenaru; Ioan,10,0,10,0
1668474452929,MATH 250B,A00,098037,Spolaor; Luca,14,0,15,1
1668474453352,MATH 258,A00,098038,Ni; Lei,9,0,10,1
1668474453777,MATH 264B,A00,098041,Rhoades; Brendon Patrick,8,0,15,7
1668474454201,MATH 268,A00,098042,Buss; Samuel R,10,0,10,0
1668474454624,MATH 269,A00,098043,Rhoades; Brendon Patrick,10,0,10,0
1668474455054,MATH 270B,A00,098044,Li; Bo,6,0,15,9
1668474455477,MATH 272B,A00,098045,Holst; Michael J,13,0,15,2
1668474455902,MATH 273A,A00,098046,Tian; Xiaochuan,10,0,15,5
1668474456327,MATH 275,A01,098048,Tian; Xiaochuan,6,0,10,4
1668474456755,MATH 278A,A00,098049,Holst; Michael J,7,0,10,3
1668474457181,MATH 278B,A00,098050,Cloninger; Alexander,10,0,10,0
1668474457613,MATH 278C,A00,098051,Nie; Jiawang,5,0,10,5
1668474458044,MATH 280B,A00,098052,Zheng; Tianyi,7,0,15,8
1668474458468,MATH 281B,A00,098053,Bradic; Jelena,0,2,15,15
1668474458891,MATH 282B,A00,098054,Arias-Castro; Ery,0,1,15,15
1668474459316,MATH 285,A00,098055,Fitzsimmons; Patrick J,0,2,15,17
1668474459739,MATH 287B,A00,098056,Arias-Castro; Ery,2,0,15,13
1668474460167,MATH 288,A00,098057,Agarwal; Pooja,9,0,10,1
1668474460167,MATH 288,B00,098058,Zhang; Danna,8,0,10,2
1668474460167,MATH 288,C00,098059,Williams; Ruth J,9,0,10,1
1668474460589,MATH 290B,A00,098060,Roberts; Justin Deritter,12,0,15,3
1668474461020,MATH 292,A00,098061,Belmont; Eva Kinoshita,10,0,10,0
1668474461446,MATH 295,A00,098062,Suk; Andrew Hoon,47,0,50,3
1668474461873,MATH 296,A00,098063,Novak; Jonathan I,20,0,20,0
1668474462299,MATH 297,001,098064,Gamst; Anthony Collins,9997,0,9999,2
1668474965017,COGS 205,A00,101395,Chiba; Andrea,19,0,20,1
1668474965442,COGS 210B,001,101404,Greene; Deanna Jacquelyn,9998,0,9999,1
1668474965442,COGS 210B,002,101417,Xia; Haijun,9999,0,9999,0
1668474965442,COGS 210B,003,101422,Nitz; Douglas A.,9999,0,9999,0
1668474965442,COGS 210B,004,101423,Hollan; James D.,9998,0,9999,1
1668474965442,COGS 210B,005,101424,Deak; Gedeon O.,9998,0,9999,1
1668474965442,COGS 210B,006,101425,Rossano; Federico,9999,0,9999,0
1668474965886,COGS 211B,A00,101427,Coulson; Seana M,9996,0,9999,3
1668474966309,COGS 220,A00,101428,Hollan; James D.,1,9,25,24
1668474966735,COGS 229,A00,101429,Dow; Steven P,17,0,25,8
1668474967168,COGS 230,A00,101430,Klemmer; Scott R,8,0,17,9
1668474967598,COGS 234,A00,101431,Xia; Haijun,2,0,25,23
1668474968026,COGS 260,A00,101432,Kiyonaga; Anastasia,21,0,25,4
1668474968026,COGS 260,B00,101433,Kirsh; David Joel,15,0,25,10
1668474968451,CSE 202,A00,102371,Impagliazzo; Russell,0,59,0,0
1668474968876,CSE 203B,A01,102373,Cheng; Chung Kuan,0,50,0,0
1668474969300,CSE 208,A00,102374,Micciancio; Daniele,0,4,0,0
1668474969736,CSE 209A,A00,112895,Impagliazzo; Russell,0,12,15,15
1668474970158,CSE 209B,A00,108005,Bellare; Mihir,0,6,0,0
1668474970583,CSE 210,A00,113163,Coblenz; Michael J,0,80,0,0
1668474971008,CSE 219,A00,106111,Dow; Steven P,0,6,20,20
1668474971444,CSE 221,A00,102376,Voelker; Geoffrey M.,0,66,0,0
1668474971963,CSE 224,A01,102378,Porter; George M,0,158,0,0
1668474972388,CSE 229A,A00,102379,Savage; Stefan,0,10,0,0
1668474972812,CSE 229C,A00,102380,Munyaka; Imani N. S.,0,9,0,0
1668474973238,CSE 232B,A00,102382,Deutsch; Alin Bernard,0,28,0,0
1668474973667,CSE 234,A01,112904,Kumar; Arun Kumar,0,0,0,0
1668474974089,CSE 237A,A00,102383,Rosing; Tajana Simunic,0,47,0,0
1668474974513,CSE 239A,A00,102384,Deutsch; Alin Bernard,0,12,0,0
1668474974936,CSE 239B,A00,102385,Polikarpova; Nadezhda,0,10,0,0
1668474975362,CSE 240A,A00,102386,Pannuto; Patrick William,0,43,0,0
1668474975787,CSE 240B,A00,102387,Zhao; Jishen,0,41,0,0
1668474976212,CSE 241A,A00,106406,Kang; Mingu,0,6,0,0
1668474976636,CSE 249B,A00,102388,Kahng; Andrew Byun,0,5,8,8
1668474977062,CSE 251B,A01,102392,Cottrell; Garrison W,0,44,0,0
1668474977062,CSE 251B,A02,102393,Cottrell; Garrison W,0,32,0,0
1668474977488,CSE 252B,A00,102394,Ochoa; Benjamin Lawrence,0,55,0,0
1668474977930,CSE 257,A01,102396,Gao; Sicun,0,128,0,0
1668474978358,CSE 272,A00,102397,Li; Tzumao,0,17,0,0
1668474978799,CSE 274,A00,111323,Chern; Albert Ren-Haur,0,14,0,0
1668474979223,CSE 282,A00,102398,Pevzner; Pavel Arkadjevich,0,0,0,0
1668474979661,CSE 284,A00,114175,Gymrek; Melissa Ann,0,19,0,0
1668474980088,CSE 290,A00,102399,Chandraker; Manmohan Krishna,0,11,0,0
1668474980088,CSE 290,B00,102400,Vaccaro; Kristen Marie,0,7,25,25
1668474980088,CSE 290,C00,102414,Pannuto; Patrick William,0,1,25,25
1668474980088,CSE 290,D00,102427,Pevzner; Pavel Arkadjevich,0,0,0,0
1668474980088,CSE 290,E00,102429,Zhao; Jishen,0,4,0,0
1668474980088,CSE 290,F00,102436,Tullsen; Dean Michael,0,5,0,0
1668474980088,CSE 290,G00,102440,Christensen; Henrik I,0,6,20,20
1668474980516,CSE 291,A00,102443,Su; Hao,0,0,0,0
1668474980516,CSE 291,B00,102448,Polikarpova; Nadezhda,0,0,0,0
1668474980516,CSE 291,C00,102453,Vaccaro; Kristen Marie,0,0,0,0
1668474980516,CSE 291,D00,111343,Savage; Stefan,0,0,0,0
1668474980516,CSE 291,E00,116474,Claffy; Kimberly Claire,0,0,0,0
1668474980516,CSE 291,F00,116479,Pasquale; Joseph,0,0,0,0
1668474980941,CSE 293,001,119111,Bafna; Vineet,9999,0,9999,0
1668474980941,CSE 293,002,119118,Bellare; Mihir,9999,0,9999,0
1668474980941,CSE 293,003,119122,Berg-Kirkpatrick; Taylor D,9999,0,9999,0
1668474980941,CSE 293,004,119135,Christensen; Henrik I,9999,0,9999,0
1668474980941,CSE 293,005,119142,Cottrell; Garrison W,9999,0,9999,0
1668474980941,CSE 293,006,119146,Deutsch; Alin Bernard,9999,0,9999,0
1668474980941,CSE 293,007,119159,Esmaeilzadeh; Hadi,9999,0,9999,0
1668474980941,CSE 293,008,119166,Freund; Yoav,9999,0,9999,0
1668474980941,CSE 293,009,119170,Griswold; William G.,9999,0,9999,0
1668474980941,CSE 293,010,119183,Gymrek; Melissa Ann,9999,0,9999,0
1668474980941,CSE 293,011,119190,Heninger; Nadia A,9999,0,9999,0
1668474980941,CSE 293,012,119230,Impagliazzo; Russell,9999,0,9999,0
1668474980941,CSE 293,013,119232,Jhala; Ranjit,9999,0,9999,0
1668474980941,CSE 293,014,119233,Kahng; Andrew Byun,9999,0,9999,0
1668474980941,CSE 293,015,119298,Kane; Daniel Mertz,9999,0,9999,0
1668474980941,CSE 293,016,119299,Kriegman; David J,9999,0,9999,0
1668474980941,CSE 293,017,119300,Kumar; Arun Kumar,9999,0,9999,0
1668474980941,CSE 293,018,119301,Lerner; Sorin,9999,0,9999,0
1668474980941,CSE 293,019,119302,Lovett; Shachar,9999,0,9999,0
1668474980941,CSE 293,020,119303,McAuley; Julian John,9999,0,9999,0
1668474980941,CSE 293,021,119304,Micciancio; Daniele,9999,0,9999,0
1668474980941,CSE 293,022,119367,Orailoglu; Alex,9999,0,9999,0
1668474980941,CSE 293,023,119382,Paturi; Ramamohan,9999,0,9999,0
1668474980941,CSE 293,024,119404,Polikarpova; Nadezhda,9999,0,9999,0
1668474980941,CSE 293,025,119406,Politz; Joseph Gibbs,9999,0,9999,0
1668474980941,CSE 293,026,119411,Porter; George M,9999,0,9999,0
1668474980941,CSE 293,027,119414,Porter; Leonard Emerson,9999,0,9999,0
1668474980941,CSE 293,028,119416,Ramamoorthi; Ravi,9999,0,9999,0
1668474980941,CSE 293,029,119417,Sahoo; Debashis,9999,0,9999,0
1668474980941,CSE 293,030,119420,Saul; Lawrence,9999,0,9999,0
1668474980941,CSE 293,031,119421,Savage; Stefan,9999,0,9999,0
1668474980941,CSE 293,032,119425,Schulze; Jurgen P.,9999,0,9999,0
1668474980941,CSE 293,033,119426,Snoeren; Alex C.,9999,0,9999,0
1668474980941,CSE 293,034,119428,Shang; Jingbo,9999,0,9999,0
1668474980941,CSE 293,035,119430,Stefan; Deian,9999,0,9999,0
1668474980941,CSE 293,036,119431,Su; Hao,9999,0,9999,0
1668474980941,CSE 293,037,119433,Swanson; Steven James,9999,0,9999,0
1668474980941,CSE 293,038,119435,Tullsen; Dean Michael,9999,0,9999,0
1668474980941,CSE 293,039,119483,Voelker; Geoffrey M.,9999,0,9999,0
1668474980941,CSE 293,040,119537,Zhao; Jishen,9999,0,9999,0
1668474980941,CSE 293,041,119538,Zhou; Yuan-Yuan,9999,0,9999,0
1668474980941,CSE 293,042,119539,Gao; Sicun,9999,0,9999,0
1668474980941,CSE 293,043,119540,Weibel; Nadir,9999,0,9999,0
1668474980941,CSE 293,044,119541,Gupta; Rajesh K.,9999,0,9999,0
1668474980941,CSE 293,045,126410,Vaccaro; Kristen Marie,9999,0,9999,0
1668474980941,CSE 293,046,126411,Klemke; Richard,9999,0,9999,0
1668474981370,CSE 294,A00,102459,Voelker; Geoffrey M.,0,2,0,0
1668474981370,CSE 294,B00,111322,Orailoglu; Alex,0,2,0,0
1668474981797,DSE 201,A00,096914,Deutsch; Alin Bernard,30,0,30,0
1668474982225,DSE 210,A00,096915,Dasgupta; Sanjoy,30,0,30,0
1668474982651,DSE 260A,A00,096916,Altintas De Callaf; Ilkay,30,0,30,0
1668474983102,ECE 200,001,103586,Antipa; Nicholas A,9999,0,9999,0
1668474983102,ECE 200,002,103587,Atanasov; Nikolay A.,9999,0,9999,0
1668474983102,ECE 200,003,103588,Bharadia; Dinesh,9999,0,9999,0
1668474983102,ECE 200,004,103589,Cheng; Chung Kuan,9999,0,9999,0
1668474983102,ECE 200,005,103590,Cosman; Pamela C.,9999,0,9999,0
1668474983102,ECE 200,006,103591,Dayeh; Shadi Ahmad,9999,0,9999,0
1668474983102,ECE 200,007,103592,Fainman; Yeshaiahu,9999,0,9999,0
1668474983102,ECE 200,008,103593,Ford; Joseph Earl,9999,0,9999,0
1668474983102,ECE 200,009,103594,Franceschetti; Massimo,9999,0,9999,0
1668474983102,ECE 200,010,103595,Fullerton; Eric E,9999,0,9999,0
1668474983102,ECE 200,011,103596,Galton; Ian A,9999,0,9999,0
1668474983102,ECE 200,012,103597,Gilja; Vikash,9999,0,9999,0
1668474983102,ECE 200,013,103598,Hall; Drew A.,9999,0,9999,0
1668474983102,ECE 200,014,103599,Hsueh; Tzu-Chien,9999,0,9999,0
1668474983102,ECE 200,015,103600,Javidi; Tara,9999,0,9999,0
1668474983102,ECE 200,016,103601,Kahng; Andrew Byun,9999,0,9999,0
1668474983102,ECE 200,017,103602,Kim; Young-Han,9999,0,9999,0
1668474983102,ECE 200,018,103603,Koushanfar; Farinaz,9999,0,9999,0
1668474983102,ECE 200,019,103604,Kuzum; Duygu,9999,0,9999,0
1668474983102,ECE 200,020,103605,Le; Hanh-Phuc,9999,0,9999,0
1668474983102,ECE 200,021,103606,Lin; Bill,9999,0,9999,0
1668474983102,ECE 200,022,103607,Liu; Zhaowei,9998,0,9999,1
1668474983102,ECE 200,023,103608,Lo; Yu-Hwa,9999,0,9999,0
1668474983102,ECE 200,024,103609,Lomakin; Vitaliy,9999,0,9999,0
1668474983102,ECE 200,025,103610,Mercier; Patrick Philip,9999,0,9999,0
1668474983102,ECE 200,026,103611,Meyer; Florian,9999,0,9999,0
1668474983102,ECE 200,027,103612,Milstein; Laurence B.,9999,0,9999,0
1668474983102,ECE 200,028,103613,Mir Arabbaygi; Siavash,9999,0,9999,0
1668474983102,ECE 200,029,103614,Mookherjea; Shayan,9999,0,9999,0
1668474983102,ECE 200,030,103615,Morris; Karcher William,9999,0,9999,0
1668474983102,ECE 200,031,103616,Ng; Tse Nga,9999,0,9999,0
1668474983102,ECE 200,032,103617,Nguyen; Truong Quang,9999,0,9999,0
1668474983102,ECE 200,033,103618,Nomura; Kenji,9999,0,9999,0
1668474983102,ECE 200,034,103619,Orlitsky; Alon,9999,0,9999,0
1668474983102,ECE 200,035,103620,Pal; Piya,9999,0,9999,0
1668474983102,ECE 200,036,103621,Papen; George C.,9999,0,9999,0
1668474983102,ECE 200,037,103622,Radic; Stojan,9999,0,9999,0
1668474983102,ECE 200,038,103623,Rao; Bhaskar D.,9999,0,9999,0
1668474983102,ECE 200,039,103624,Rao; Ramesh R,9999,0,9999,0
1668474983102,ECE 200,040,103625,Rebeiz; Gabriel,9999,0,9999,0
1668474983102,ECE 200,041,103626,Sanford; John R,9999,0,9999,0
1668474983102,ECE 200,042,103627,Siegel; Paul H.,9999,0,9999,0
1668474983102,ECE 200,043,103628,Sievenpiper; Daniel F.,9999,0,9999,0
1668474983102,ECE 200,044,103629,Sworder; David D.,9999,0,9999,0
1668474983102,ECE 200,045,103630,Taur; Yuan,9999,0,9999,0
1668474983102,ECE 200,046,103631,Touri; Behrouz,9999,0,9999,0
1668474983102,ECE 200,047,103632,Trivedi; Mohan M.,9999,0,9999,0
1668474983102,ECE 200,048,103633,Vasconcelos; Nuno,9999,0,9999,0
1668474983102,ECE 200,049,103634,Wang; Xiaolong,9999,0,9999,0
1668474983102,ECE 200,050,103635,Xie; Pengtao,9999,0,9999,0
1668474983102,ECE 200,051,103636,Yip; Michael,9999,0,9999,0
1668474983102,ECE 200,052,103637,Zeger; Kenneth A.,999,0,999,0
1668474983102,ECE 200,053,103638,Zhang; Xinyu,9999,0,9999,0
1668474983102,ECE 200,054,103639,Turakhia; Yatish Girish,9999,0,9999,0
1668474983102,ECE 200,055,103640,Kang; Mingu,9999,0,9999,0
1668474983102,ECE 200,056,103641,Shi; Yuanyuan,9999,0,9999,0
1668474983102,ECE 200,057,103642,Wang; Edward Jay,9999,0,9999,0
1668474983102,ECE 200,058,103643,Zheng; Yang,9999,0,9999,0
1668474983529,ECE 202,A00,103644,Kuzum; Duygu,0,41,0,0
1668474983964,ECE 212BN,A00,103646,Ng; Tse Nga,0,8,0,0
1668474984389,ECE 221,A00,111493,Staff,0,0,0,0
1668474984814,ECE 222B,A00,103647,Lomakin; Vitaliy,0,16,0,0
1668474985242,ECE 230B,A00,103648,Taur; Yuan,0,2,0,0
1668474985666,ECE 238B,A00,103649,Garay; Javier,0,0,0,0
1668474986090,ECE 240B,A00,112900,Fainman; Yeshaiahu,0,6,0,0
1668474986518,ECE 247A,A00,103650,Jokerst; Jesse Vincent,0,5,0,0
1668474986944,ECE 247B,A00,103651,Wang; Joseph,0,11,0,0
1668474987367,ECE 250,A00,103652,Siegel; Paul H.,0,79,0,0
1668474987800,ECE 251A,A00,103654,Rao; Bhaskar D.,0,61,0,0
1668474988224,ECE 257B,A00,103655,Bharadia; Dinesh,0,32,0,0
1668474988648,ECE 258A,A00,103656,Milstein; Laurence B.,0,28,0,0
1668474989072,ECE 260B,A00,103658,Kang; Mingu,0,119,0,0
1668474989497,ECE 264A,A00,103659,Galton; Ian A,0,65,0,0
1668474989923,ECE 265A,A00,103661,Gudem; Prasad S.S.,0,64,0,0
1668474990354,ECE 265D,A00,103662,Gudem; Prasad S.S.,0,24,0,0
1668474990778,ECE 268,A00,103663,Koushanfar; Farinaz,0,41,0,0
1668474991204,ECE 269,A01,103665,Pal; Piya,0,205,0,0
1668474991628,ECE 271B,A00,103666,Vasconcelos; Manuela,0,72,0,0
1668474992055,ECE 276A,A00,103667,Atanasov; Nikolay A.,0,118,0,0
1668474992480,ECE 277,A00,103668,An; Cheolhong,0,142,0,0
1668474992902,ECE 279,A00,117947,Hall; Drew A.,0,22,0,0
1668474993751,ECE 283,A00,103670,Hsueh; Tzu-Chien,0,51,0,0
1668474994177,ECE 284,A00,103671,Turakhia; Yatish Girish,0,39,0,0
1668474994600,ECE 285,A00,103672,Zheng; Yang,0,38,0,0
1668474994600,ECE 285,B00,103673,Sworder; David D.,0,55,0,0
1668474995039,ECE 287,A00,103676,Javidi; Tara,0,8,0,0
1668474995468,MATH 200B,A00,098023,Salehi Golsefidy; Alireza,11,0,15,4
1668474995891,MATH 202B,A00,098024,Rhoades; Brendon Patrick,7,0,15,8
1668474996314,MATH 203B,A00,098025,Oprea; Dragos N.,10,0,15,5
1668474996737,MATH 204B,A00,098026,Sorensen; Claus M,13,0,15,2
1668474997168,MATH 208,A00,098027,Izadi; Elham,7,0,10,3
1668474997591,MATH 209,A00,098028,Pollack; Aaron,10,0,10,0
1668474998017,MATH 211A,A00,112919,Rogalski; Daniel,8,0,10,2
1668474998441,MATH 211B,A00,112920,Seward; Brandon M.,9,0,10,1
1668474998874,MATH 218,A00,098029,Li; Bo,10,0,10,0
1668474999297,MATH 220B,A00,098030,Novak; Jonathan I,11,0,15,4
1668474999721,MATH 221A,A00,098031,Ebenfelt; Peter F,13,0,15,2
1668475000152,MATH 231B,A00,098032,Zlatos; Andrej,11,0,15,4
1668475000576,MATH 240B,A00,098033,Ni; Lei,7,0,15,8
1668475001009,MATH 243,A00,098034,Jekel; David Andrew,10,0,10,0
1668475001432,MATH 245A,A00,098035,Nie; Jiawang,0,4,15,18
1668475001856,MATH 248,A00,098036,Bejenaru; Ioan,10,0,10,0
1668475002282,MATH 250B,A00,098037,Spolaor; Luca,14,0,15,1
1668475002706,MATH 258,A00,098038,Ni; Lei,9,0,10,1
1668475003128,MATH 264B,A00,098041,Rhoades; Brendon Patrick,8,0,15,7
1668475003554,MATH 268,A00,098042,Buss; Samuel R,10,0,10,0
1668475003982,MATH 269,A00,098043,Rhoades; Brendon Patrick,10,0,10,0
1668475004405,MATH 270B,A00,098044,Li; Bo,6,0,15,9
1668475004831,MATH 272B,A00,098045,Holst; Michael J,13,0,15,2
1668475005258,MATH 273A,A00,098046,Tian; Xiaochuan,10,0,15,5
1668475005685,MATH 275,A01,098048,Tian; Xiaochuan,6,0,10,4
1668475006112,MATH 278A,A00,098049,Holst; Michael J,7,0,10,3
1668475006537,MATH 278B,A00,098050,Cloninger; Alexander,10,0,10,0
1668475006972,MATH 278C,A00,098051,Nie; Jiawang,5,0,10,5
1668475007398,MATH 280B,A00,098052,Zheng; Tianyi,7,0,15,8
1668475007823,MATH 281B,A00,098053,Bradic; Jelena,0,2,15,15
1668475008249,MATH 282B,A00,098054,Arias-Castro; Ery,0,1,15,15
1668475008696,MATH 285,A00,098055,Fitzsimmons; Patrick J,0,2,15,17
1668475009118,MATH 287B,A00,098056,Arias-Castro; Ery,2,0,15,13
1668475009542,MATH 288,A00,098057,Agarwal; Pooja,9,0,10,1
1668475009542,MATH 288,B00,098058,Zhang; Danna,8,0,10,2
1668475009542,MATH 288,C00,098059,Williams; Ruth J,9,0,10,1
1668475009975,MATH 290B,A00,098060,Roberts; Justin Deritter,12,0,15,3
1668475010397,MATH 292,A00,098061,Belmont; Eva Kinoshita,10,0,10,0
1668475010829,MATH 295,A00,098062,Suk; Andrew Hoon,47,0,50,3
1668475011257,MATH 296,A00,098063,Novak; Jonathan I,20,0,20,0
1668475011683,MATH 297,001,098064,Gamst; Anthony Collins,9997,0,9999,2
1668475524121,COGS 205,A00,101395,Chiba; Andrea,19,0,20,1
1668475524545,COGS 210B,001,101404,Greene; Deanna Jacquelyn,9998,0,9999,1
1668475524545,COGS 210B,002,101417,Xia; Haijun,9999,0,9999,0
1668475524545,COGS 210B,003,101422,Nitz; Douglas A.,9999,0,9999,0
1668475524545,COGS 210B,004,101423,Hollan; James D.,9998,0,9999,1
1668475524545,COGS 210B,005,101424,Deak; Gedeon O.,9998,0,9999,1
1668475524545,COGS 210B,006,101425,Rossano; Federico,9999,0,9999,0
1668475524968,COGS 211B,A00,101427,Coulson; Seana M,9996,0,9999,3
1668475525392,COGS 220,A00,101428,Hollan; James D.,1,9,25,24
1668475525818,COGS 229,A00,101429,Dow; Steven P,17,0,25,8
1668475526242,COGS 230,A00,101430,Klemmer; Scott R,8,0,17,9
1668475526666,COGS 234,A00,101431,Xia; Haijun,2,0,25,23
1668475527100,COGS 260,A00,101432,Kiyonaga; Anastasia,21,0,25,4
1668475527100,COGS 260,B00,101433,Kirsh; David Joel,15,0,25,10
1668475527528,CSE 202,A00,102371,Impagliazzo; Russell,0,59,0,0
1668475528032,CSE 203B,A01,102373,Cheng; Chung Kuan,0,50,0,0
1668475528454,CSE 208,A00,102374,Micciancio; Daniele,0,4,0,0
1668475528879,CSE 209A,A00,112895,Impagliazzo; Russell,0,12,15,15
1668475529308,CSE 209B,A00,108005,Bellare; Mihir,0,6,0,0
1668475529736,CSE 210,A00,113163,Coblenz; Michael J,0,80,0,0
1668475530159,CSE 219,A00,106111,Dow; Steven P,0,6,20,20
1668475530584,CSE 221,A00,102376,Voelker; Geoffrey M.,0,66,0,0
1668475531009,CSE 224,A01,102378,Porter; George M,0,159,0,0
1668475531432,CSE 229A,A00,102379,Savage; Stefan,0,10,0,0
1668475531853,CSE 229C,A00,102380,Munyaka; Imani N. S.,0,9,0,0
1668475532276,CSE 232B,A00,102382,Deutsch; Alin Bernard,0,29,0,0
1668475532702,CSE 234,A01,112904,Kumar; Arun Kumar,0,0,0,0
1668475533130,CSE 237A,A00,102383,Rosing; Tajana Simunic,0,47,0,0
1668475533559,CSE 239A,A00,102384,Deutsch; Alin Bernard,0,12,0,0
1668475533982,CSE 239B,A00,102385,Polikarpova; Nadezhda,0,10,0,0
1668475534406,CSE 240A,A00,102386,Pannuto; Patrick William,0,43,0,0
1668475534831,CSE 240B,A00,102387,Zhao; Jishen,0,41,0,0
1668475535255,CSE 241A,A00,106406,Kang; Mingu,0,6,0,0
1668475535683,CSE 249B,A00,102388,Kahng; Andrew Byun,0,5,8,8
1668475536118,CSE 251B,A01,102392,Cottrell; Garrison W,0,44,0,0
1668475536118,CSE 251B,A02,102393,Cottrell; Garrison W,0,33,0,0
1668475536547,CSE 252B,A00,102394,Ochoa; Benjamin Lawrence,0,55,0,0
1668475536974,CSE 257,A01,102396,Gao; Sicun,0,128,0,0
1668475537398,CSE 272,A00,102397,Li; Tzumao,0,17,0,0
1668475537820,CSE 274,A00,111323,Chern; Albert Ren-Haur,0,14,0,0
1668475538247,CSE 282,A00,102398,Pevzner; Pavel Arkadjevich,0,0,0,0
1668475538679,CSE 284,A00,114175,Gymrek; Melissa Ann,0,19,0,0
1668475539109,CSE 290,A00,102399,Chandraker; Manmohan Krishna,0,11,0,0
1668475539109,CSE 290,B00,102400,Vaccaro; Kristen Marie,0,7,25,25
1668475539109,CSE 290,C00,102414,Pannuto; Patrick William,0,1,25,25
1668475539109,CSE 290,D00,102427,Pevzner; Pavel Arkadjevich,0,0,0,0
1668475539109,CSE 290,E00,102429,Zhao; Jishen,0,4,0,0
1668475539109,CSE 290,F00,102436,Tullsen; Dean Michael,0,5,0,0
1668475539109,CSE 290,G00,102440,Christensen; Henrik I,0,6,20,20
1668475539537,CSE 291,A00,102443,Su; Hao,0,0,0,0
1668475539537,CSE 291,B00,102448,Polikarpova; Nadezhda,0,0,0,0
1668475539537,CSE 291,C00,102453,Vaccaro; Kristen Marie,0,0,0,0
1668475539537,CSE 291,D00,111343,Savage; Stefan,0,0,0,0
1668475539537,CSE 291,E00,116474,Claffy; Kimberly Claire,0,0,0,0
1668475539537,CSE 291,F00,116479,Pasquale; Joseph,0,0,0,0
1668475539975,CSE 293,001,119111,Bafna; Vineet,9999,0,9999,0
1668475539975,CSE 293,002,119118,Bellare; Mihir,9999,0,9999,0
1668475539975,CSE 293,003,119122,Berg-Kirkpatrick; Taylor D,9999,0,9999,0
1668475539975,CSE 293,004,119135,Christensen; Henrik I,9999,0,9999,0
1668475539975,CSE 293,005,119142,Cottrell; Garrison W,9999,0,9999,0
1668475539975,CSE 293,006,119146,Deutsch; Alin Bernard,9999,0,9999,0
1668475539975,CSE 293,007,119159,Esmaeilzadeh; Hadi,9999,0,9999,0
1668475539975,CSE 293,008,119166,Freund; Yoav,9999,0,9999,0
1668475539975,CSE 293,009,119170,Griswold; William G.,9999,0,9999,0
1668475539975,CSE 293,010,119183,Gymrek; Melissa Ann,9999,0,9999,0
1668475539975,CSE 293,011,119190,Heninger; Nadia A,9999,0,9999,0
1668475539975,CSE 293,012,119230,Impagliazzo; Russell,9999,0,9999,0
1668475539975,CSE 293,013,119232,Jhala; Ranjit,9999,0,9999,0
1668475539975,CSE 293,014,119233,Kahng; Andrew Byun,9999,0,9999,0
1668475539975,CSE 293,015,119298,Kane; Daniel Mertz,9999,0,9999,0
1668475539975,CSE 293,016,119299,Kriegman; David J,9999,0,9999,0
1668475539975,CSE 293,017,119300,Kumar; Arun Kumar,9999,0,9999,0
1668475539975,CSE 293,018,119301,Lerner; Sorin,9999,0,9999,0
1668475539975,CSE 293,019,119302,Lovett; Shachar,9999,0,9999,0
1668475539975,CSE 293,020,119303,McAuley; Julian John,9999,0,9999,0
1668475539975,CSE 293,021,119304,Micciancio; Daniele,9999,0,9999,0
1668475539975,CSE 293,022,119367,Orailoglu; Alex,9999,0,9999,0
1668475539975,CSE 293,023,119382,Paturi; Ramamohan,9999,0,9999,0
1668475539975,CSE 293,024,119404,Polikarpova; Nadezhda,9999,0,9999,0
1668475539975,CSE 293,025,119406,Politz; Joseph Gibbs,9999,0,9999,0
1668475539975,CSE 293,026,119411,Porter; George M,9999,0,9999,0
1668475539975,CSE 293,027,119414,Porter; Leonard Emerson,9999,0,9999,0
1668475539975,CSE 293,028,119416,Ramamoorthi; Ravi,9999,0,9999,0
1668475539975,CSE 293,029,119417,Sahoo; Debashis,9999,0,9999,0
1668475539975,CSE 293,030,119420,Saul; Lawrence,9999,0,9999,0
1668475539975,CSE 293,031,119421,Savage; Stefan,9999,0,9999,0
1668475539975,CSE 293,032,119425,Schulze; Jurgen P.,9999,0,9999,0
1668475539975,CSE 293,033,119426,Snoeren; Alex C.,9999,0,9999,0
1668475539975,CSE 293,034,119428,Shang; Jingbo,9999,0,9999,0
1668475539975,CSE 293,035,119430,Stefan; Deian,9999,0,9999,0
1668475539975,CSE 293,036,119431,Su; Hao,9999,0,9999,0
1668475539975,CSE 293,037,119433,Swanson; Steven James,9999,0,9999,0
1668475539975,CSE 293,038,119435,Tullsen; Dean Michael,9999,0,9999,0
1668475539975,CSE 293,039,119483,Voelker; Geoffrey M.,9999,0,9999,0
1668475539975,CSE 293,040,119537,Zhao; Jishen,9999,0,9999,0
1668475539975,CSE 293,041,119538,Zhou; Yuan-Yuan,9999,0,9999,0
1668475539975,CSE 293,042,119539,Gao; Sicun,9999,0,9999,0
1668475539975,CSE 293,043,119540,Weibel; Nadir,9999,0,9999,0
1668475539975,CSE 293,044,119541,Gupta; Rajesh K.,9999,0,9999,0
1668475539975,CSE 293,045,126410,Vaccaro; Kristen Marie,9999,0,9999,0
1668475539975,CSE 293,046,126411,Klemke; Richard,9999,0,9999,0
1668475540401,CSE 294,A00,102459,Voelker; Geoffrey M.,0,2,0,0
1668475540401,CSE 294,B00,111322,Orailoglu; Alex,0,2,0,0
1668475540829,DSE 201,A00,096914,Deutsch; Alin Bernard,30,0,30,0
1668475541262,DSE 210,A00,096915,Dasgupta; Sanjoy,30,0,30,0
1668475541690,DSE 260A,A00,096916,Altintas De Callaf; Ilkay,30,0,30,0
1668475542120,ECE 200,001,103586,Antipa; Nicholas A,9999,0,9999,0
1668475542120,ECE 200,002,103587,Atanasov; Nikolay A.,9999,0,9999,0
1668475542120,ECE 200,003,103588,Bharadia; Dinesh,9999,0,9999,0
1668475542120,ECE 200,004,103589,Cheng; Chung Kuan,9999,0,9999,0
1668475542120,ECE 200,005,103590,Cosman; Pamela C.,9999,0,9999,0
1668475542120,ECE 200,006,103591,Dayeh; Shadi Ahmad,9999,0,9999,0
1668475542120,ECE 200,007,103592,Fainman; Yeshaiahu,9999,0,9999,0
1668475542120,ECE 200,008,103593,Ford; Joseph Earl,9999,0,9999,0
1668475542120,ECE 200,009,103594,Franceschetti; Massimo,9999,0,9999,0
1668475542120,ECE 200,010,103595,Fullerton; Eric E,9999,0,9999,0
1668475542120,ECE 200,011,103596,Galton; Ian A,9999,0,9999,0
1668475542120,ECE 200,012,103597,Gilja; Vikash,9999,0,9999,0
1668475542120,ECE 200,013,103598,Hall; Drew A.,9999,0,9999,0
1668475542120,ECE 200,014,103599,Hsueh; Tzu-Chien,9999,0,9999,0
1668475542120,ECE 200,015,103600,Javidi; Tara,9999,0,9999,0
1668475542120,ECE 200,016,103601,Kahng; Andrew Byun,9999,0,9999,0
1668475542120,ECE 200,017,103602,Kim; Young-Han,9999,0,9999,0
1668475542120,ECE 200,018,103603,Koushanfar; Farinaz,9999,0,9999,0
1668475542120,ECE 200,019,103604,Kuzum; Duygu,9999,0,9999,0
1668475542120,ECE 200,020,103605,Le; Hanh-Phuc,9999,0,9999,0
1668475542120,ECE 200,021,103606,Lin; Bill,9999,0,9999,0
1668475542120,ECE 200,022,103607,Liu; Zhaowei,9998,0,9999,1
1668475542120,ECE 200,023,103608,Lo; Yu-Hwa,9999,0,9999,0
1668475542120,ECE 200,024,103609,Lomakin; Vitaliy,9999,0,9999,0
1668475542120,ECE 200,025,103610,Mercier; Patrick Philip,9999,0,9999,0
1668475542120,ECE 200,026,103611,Meyer; Florian,9999,0,9999,0
1668475542120,ECE 200,027,103612,Milstein; Laurence B.,9999,0,9999,0
1668475542120,ECE 200,028,103613,Mir Arabbaygi; Siavash,9999,0,9999,0
1668475542120,ECE 200,029,103614,Mookherjea; Shayan,9999,0,9999,0
1668475542120,ECE 200,030,103615,Morris; Karcher William,9999,0,9999,0
1668475542120,ECE 200,031,103616,Ng; Tse Nga,9999,0,9999,0
1668475542120,ECE 200,032,103617,Nguyen; Truong Quang,9999,0,9999,0
1668475542120,ECE 200,033,103618,Nomura; Kenji,9999,0,9999,0
1668475542120,ECE 200,034,103619,Orlitsky; Alon,9999,0,9999,0
1668475542120,ECE 200,035,103620,Pal; Piya,9999,0,9999,0
1668475542120,ECE 200,036,103621,Papen; George C.,9999,0,9999,0
1668475542120,ECE 200,037,103622,Radic; Stojan,9999,0,9999,0
1668475542120,ECE 200,038,103623,Rao; Bhaskar D.,9999,0,9999,0
1668475542120,ECE 200,039,103624,Rao; Ramesh R,9999,0,9999,0
1668475542120,ECE 200,040,103625,Rebeiz; Gabriel,9999,0,9999,0
1668475542120,ECE 200,041,103626,Sanford; John R,9999,0,9999,0
1668475542120,ECE 200,042,103627,Siegel; Paul H.,9999,0,9999,0
1668475542120,ECE 200,043,103628,Sievenpiper; Daniel F.,9999,0,9999,0
1668475542120,ECE 200,044,103629,Sworder; David D.,9999,0,9999,0
1668475542120,ECE 200,045,103630,Taur; Yuan,9999,0,9999,0
1668475542120,ECE 200,046,103631,Touri; Behrouz,9999,0,9999,0
1668475542120,ECE 200,047,103632,Trivedi; Mohan M.,9999,0,9999,0
1668475542120,ECE 200,048,103633,Vasconcelos; Nuno,9999,0,9999,0
1668475542120,ECE 200,049,103634,Wang; Xiaolong,9999,0,9999,0
1668475542120,ECE 200,050,103635,Xie; Pengtao,9999,0,9999,0
1668475542120,ECE 200,051,103636,Yip; Michael,9999,0,9999,0
1668475542120,ECE 200,052,103637,Zeger; Kenneth A.,999,0,999,0
1668475542120,ECE 200,053,103638,Zhang; Xinyu,9999,0,9999,0
1668475542120,ECE 200,054,103639,Turakhia; Yatish Girish,9999,0,9999,0
1668475542120,ECE 200,055,103640,Kang; Mingu,9999,0,9999,0
1668475542120,ECE 200,056,103641,Shi; Yuanyuan,9999,0,9999,0
1668475542120,ECE 200,057,103642,Wang; Edward Jay,9999,0,9999,0
1668475542120,ECE 200,058,103643,Zheng; Yang,9999,0,9999,0
1668475542545,ECE 202,A00,103644,Kuzum; Duygu,0,41,0,0
1668475542972,ECE 212BN,A00,103646,Ng; Tse Nga,0,8,0,0
1668475543404,ECE 221,A00,111493,Staff,0,0,0,0
1668475543834,ECE 222B,A00,103647,Lomakin; Vitaliy,0,16,0,0
1668475544258,ECE 230B,A00,103648,Taur; Yuan,0,2,0,0
1668475544683,ECE 238B,A00,103649,Garay; Javier,0,0,0,0
1668475545106,ECE 240B,A00,112900,Fainman; Yeshaiahu,0,6,0,0
1668475545536,ECE 247A,A00,103650,Jokerst; Jesse Vincent,0,5,0,0
1668475545964,ECE 247B,A00,103651,Wang; Joseph,0,11,0,0
1668475546468,ECE 250,A00,103652,Siegel; Paul H.,0,79,0,0
1668475546892,ECE 251A,A00,103654,Rao; Bhaskar D.,0,61,0,0
1668475547320,ECE 257B,A00,103655,Bharadia; Dinesh,0,32,0,0
1668475547744,ECE 258A,A00,103656,Milstein; Laurence B.,0,28,0,0
1668475548168,ECE 260B,A00,103658,Kang; Mingu,0,119,0,0
1668475548600,ECE 264A,A00,103659,Galton; Ian A,0,65,0,0
1668475549024,ECE 265A,A00,103661,Gudem; Prasad S.S.,0,64,0,0
1668475549451,ECE 265D,A00,103662,Gudem; Prasad S.S.,0,24,0,0
1668475549874,ECE 268,A00,103663,Koushanfar; Farinaz,0,41,0,0
1668475550301,ECE 269,A01,103665,Pal; Piya,0,205,0,0
1668475550728,ECE 271B,A00,103666,Vasconcelos; Manuela,0,72,0,0
1668475551166,ECE 276A,A00,103667,Atanasov; Nikolay A.,0,118,0,0
1668475551590,ECE 277,A00,103668,An; Cheolhong,0,142,0,0
1668475552016,ECE 279,A00,117947,Hall; Drew A.,0,22,0,0
1668475552866,ECE 283,A00,103670,Hsueh; Tzu-Chien,0,51,0,0
1668475553288,ECE 284,A00,103671,Turakhia; Yatish Girish,0,39,0,0
1668475553716,ECE 285,A00,103672,Zheng; Yang,0,38,0,0
1668475553716,ECE 285,B00,103673,Sworder; David D.,0,55,0,0
1668475554139,ECE 287,A00,103676,Javidi; Tara,0,8,0,0
1668475554577,MATH 200B,A00,098023,Salehi Golsefidy; Alireza,11,0,15,4
1668475555000,MATH 202B,A00,098024,Rhoades; Brendon Patrick,7,0,15,8
1668475555427,MATH 203B,A00,098025,Oprea; Dragos N.,10,0,15,5
1668475555856,MATH 204B,A00,098026,Sorensen; Claus M,13,0,15,2
1668475556280,MATH 208,A00,098027,Izadi; Elham,7,0,10,3
1668475556708,MATH 209,A00,098028,Pollack; Aaron,10,0,10,0
1668475557133,MATH 211A,A00,112919,Rogalski; Daniel,8,0,10,2
1668475557562,MATH 211B,A00,112920,Seward; Brandon M.,9,0,10,1
1668475557989,MATH 218,A00,098029,Li; Bo,10,0,10,0
1668475558414,MATH 220B,A00,098030,Novak; Jonathan I,11,0,15,4
1668475558850,MATH 221A,A00,098031,Ebenfelt; Peter F,13,0,15,2
1668475559281,MATH 231B,A00,098032,Zlatos; Andrej,11,0,15,4
1668475559703,MATH 240B,A00,098033,Ni; Lei,7,0,15,8
1668475560127,MATH 243,A00,098034,Jekel; David Andrew,10,0,10,0
1668475560556,MATH 245A,A00,098035,Nie; Jiawang,0,4,15,18
1668475560982,MATH 248,A00,098036,Bejenaru; Ioan,10,0,10,0
1668475561410,MATH 250B,A00,098037,Spolaor; Luca,14,0,15,1
1668475561842,MATH 258,A00,098038,Ni; Lei,9,0,10,1
1668475562266,MATH 264B,A00,098041,Rhoades; Brendon Patrick,8,0,15,7
1668475562698,MATH 268,A00,098042,Buss; Samuel R,10,0,10,0
1668475563131,MATH 269,A00,098043,Rhoades; Brendon Patrick,10,0,10,0
1668475563558,MATH 270B,A00,098044,Li; Bo,6,0,15,9
1668475563986,MATH 272B,A00,098045,Holst; Michael J,13,0,15,2
1668475564413,MATH 273A,A00,098046,Tian; Xiaochuan,10,0,15,5
1668475564843,MATH 275,A01,098048,Tian; Xiaochuan,6,0,10,4
1668475565270,MATH 278A,A00,098049,Holst; Michael J,7,0,10,3
1668475565697,MATH 278B,A00,098050,Cloninger; Alexander,10,0,10,0
1668475566122,MATH 278C,A00,098051,Nie; Jiawang,5,0,10,5
1668475566547,MATH 280B,A00,098052,Zheng; Tianyi,7,0,15,8
1668475566980,MATH 281B,A00,098053,Bradic; Jelena,0,2,15,15
1668475567405,MATH 282B,A00,098054,Arias-Castro; Ery,0,1,15,15
1668475567828,MATH 285,A00,098055,Fitzsimmons; Patrick J,0,2,15,17
1668475568254,MATH 287B,A00,098056,Arias-Castro; Ery,2,0,15,13
1668475568679,MATH 288,A00,098057,Agarwal; Pooja,9,0,10,1
1668475568679,MATH 288,B00,098058,Zhang; Danna,8,0,10,2
1668475568679,MATH 288,C00,098059,Williams; Ruth J,9,0,10,1
1668475569101,MATH 290B,A00,098060,Roberts; Justin Deritter,12,0,15,3
1668475569531,MATH 292,A00,098061,Belmont; Eva Kinoshita,10,0,10,0
1668475569954,MATH 295,A00,098062,Suk; Andrew Hoon,47,0,50,3
1668475570385,MATH 296,A00,098063,Novak; Jonathan I,20,0,20,0
1668475570810,MATH 297,001,098064,Gamst; Anthony Collins,9997,0,9999,2
1668476073214,COGS 205,A00,101395,Chiba; Andrea,19,0,20,1
1668476073642,COGS 210B,001,101404,Greene; Deanna Jacquelyn,9998,0,9999,1
1668476073642,COGS 210B,002,101417,Xia; Haijun,9999,0,9999,0
1668476073642,COGS 210B,003,101422,Nitz; Douglas A.,9999,0,9999,0
1668476073642,COGS 210B,004,101423,Hollan; James D.,9998,0,9999,1
1668476073642,COGS 210B,005,101424,Deak; Gedeon O.,9998,0,9999,1
1668476073642,COGS 210B,006,101425,Rossano; Federico,9999,0,9999,0
1668476074065,COGS 211B,A00,101427,Coulson; Seana M,9996,0,9999,3
1668476074490,COGS 220,A00,101428,Hollan; James D.,1,9,25,24
1668476074927,COGS 229,A00,101429,Dow; Steven P,17,0,25,8
1668476075351,COGS 230,A00,101430,Klemmer; Scott R,8,0,17,9
1668476075775,COGS 234,A00,101431,Xia; Haijun,2,0,25,23
1668476076214,COGS 260,A00,101432,Kiyonaga; Anastasia,21,0,25,4
1668476076214,COGS 260,B00,101433,Kirsh; David Joel,15,0,25,10
1668476076641,CSE 202,A00,102371,Impagliazzo; Russell,0,59,0,0
1668476077066,CSE 203B,A01,102373,Cheng; Chung Kuan,0,50,0,0
1668476077492,CSE 208,A00,102374,Micciancio; Daniele,0,4,0,0
1668476077915,CSE 209A,A00,112895,Impagliazzo; Russell,0,12,15,15
1668476078341,CSE 209B,A00,108005,Bellare; Mihir,0,6,0,0
1668476078763,CSE 210,A00,113163,Coblenz; Michael J,0,80,0,0
1668476079203,CSE 219,A00,106111,Dow; Steven P,0,6,20,20
1668476079627,CSE 221,A00,102376,Voelker; Geoffrey M.,0,67,0,0
1668476080051,CSE 224,A01,102378,Porter; George M,0,159,0,0
1668476080482,CSE 229A,A00,102379,Savage; Stefan,0,10,0,0
1668476080908,CSE 229C,A00,102380,Munyaka; Imani N. S.,0,9,0,0
1668476081335,CSE 232B,A00,102382,Deutsch; Alin Bernard,0,29,0,0
1668476081760,CSE 234,A01,112904,Kumar; Arun Kumar,0,0,0,0
1668476082190,CSE 237A,A00,102383,Rosing; Tajana Simunic,0,47,0,0
1668476082624,CSE 239A,A00,102384,Deutsch; Alin Bernard,0,12,0,0
1668476083047,CSE 239B,A00,102385,Polikarpova; Nadezhda,0,10,0,0
1668476083470,CSE 240A,A00,102386,Pannuto; Patrick William,0,43,0,0
1668476083899,CSE 240B,A00,102387,Zhao; Jishen,0,41,0,0
1668476084327,CSE 241A,A00,106406,Kang; Mingu,0,6,0,0
1668476084753,CSE 249B,A00,102388,Kahng; Andrew Byun,0,5,8,8
1668476085179,CSE 251B,A01,102392,Cottrell; Garrison W,0,44,0,0
1668476085179,CSE 251B,A02,102393,Cottrell; Garrison W,0,33,0,0
1668476085603,CSE 252B,A00,102394,Ochoa; Benjamin Lawrence,0,55,0,0
1668476086029,CSE 257,A01,102396,Gao; Sicun,0,128,0,0
1668476086454,CSE 272,A00,102397,Li; Tzumao,0,17,0,0
1668476086878,CSE 274,A00,111323,Chern; Albert Ren-Haur,0,14,0,0
1668476087302,CSE 282,A00,102398,Pevzner; Pavel Arkadjevich,0,0,0,0
1668476087728,CSE 284,A00,114175,Gymrek; Melissa Ann,0,19,0,0
1668476088151,CSE 290,A00,102399,Chandraker; Manmohan Krishna,0,11,0,0
1668476088151,CSE 290,B00,102400,Vaccaro; Kristen Marie,0,7,25,25
1668476088151,CSE 290,C00,102414,Pannuto; Patrick William,0,1,25,25
1668476088151,CSE 290,D00,102427,Pevzner; Pavel Arkadjevich,0,0,0,0
1668476088151,CSE 290,E00,102429,Zhao; Jishen,0,4,0,0
1668476088151,CSE 290,F00,102436,Tullsen; Dean Michael,0,5,0,0
1668476088151,CSE 290,G00,102440,Christensen; Henrik I,0,6,20,20
1668476088579,CSE 291,A00,102443,Su; Hao,0,0,0,0
1668476088579,CSE 291,B00,102448,Polikarpova; Nadezhda,0,0,0,0
1668476088579,CSE 291,C00,102453,Vaccaro; Kristen Marie,0,0,0,0
1668476088579,CSE 291,D00,111343,Savage; Stefan,0,0,0,0
1668476088579,CSE 291,E00,116474,Claffy; Kimberly Claire,0,0,0,0
1668476088579,CSE 291,F00,116479,Pasquale; Joseph,0,0,0,0
1668476089007,CSE 293,001,119111,Bafna; Vineet,9999,0,9999,0
1668476089007,CSE 293,002,119118,Bellare; Mihir,9999,0,9999,0
1668476089007,CSE 293,003,119122,Berg-Kirkpatrick; Taylor D,9999,0,9999,0
1668476089007,CSE 293,004,119135,Christensen; Henrik I,9999,0,9999,0
1668476089007,CSE 293,005,119142,Cottrell; Garrison W,9999,0,9999,0
1668476089007,CSE 293,006,119146,Deutsch; Alin Bernard,9999,0,9999,0
1668476089007,CSE 293,007,119159,Esmaeilzadeh; Hadi,9999,0,9999,0
1668476089007,CSE 293,008,119166,Freund; Yoav,9999,0,9999,0
1668476089007,CSE 293,009,119170,Griswold; William G.,9999,0,9999,0
1668476089007,CSE 293,010,119183,Gymrek; Melissa Ann,9999,0,9999,0
1668476089007,CSE 293,011,119190,Heninger; Nadia A,9999,0,9999,0
1668476089007,CSE 293,012,119230,Impagliazzo; Russell,9999,0,9999,0
1668476089007,CSE 293,013,119232,Jhala; Ranjit,9999,0,9999,0
1668476089007,CSE 293,014,119233,Kahng; Andrew Byun,9999,0,9999,0
1668476089007,CSE 293,015,119298,Kane; Daniel Mertz,9999,0,9999,0
1668476089007,CSE 293,016,119299,Kriegman; David J,9999,0,9999,0
1668476089007,CSE 293,017,119300,Kumar; Arun Kumar,9999,0,9999,0
1668476089007,CSE 293,018,119301,Lerner; Sorin,9999,0,9999,0
1668476089007,CSE 293,019,119302,Lovett; Shachar,9999,0,9999,0
1668476089007,CSE 293,020,119303,McAuley; Julian John,9999,0,9999,0
1668476089007,CSE 293,021,119304,Micciancio; Daniele,9999,0,9999,0
1668476089007,CSE 293,022,119367,Orailoglu; Alex,9999,0,9999,0
1668476089007,CSE 293,023,119382,Paturi; Ramamohan,9999,0,9999,0
1668476089007,CSE 293,024,119404,Polikarpova; Nadezhda,9999,0,9999,0
1668476089007,CSE 293,025,119406,Politz; Joseph Gibbs,9999,0,9999,0
1668476089007,CSE 293,026,119411,Porter; George M,9999,0,9999,0
1668476089007,CSE 293,027,119414,Porter; Leonard Emerson,9999,0,9999,0
1668476089007,CSE 293,028,119416,Ramamoorthi; Ravi,9999,0,9999,0
1668476089007,CSE 293,029,119417,Sahoo; Debashis,9999,0,9999,0
1668476089007,CSE 293,030,119420,Saul; Lawrence,9999,0,9999,0
1668476089007,CSE 293,031,119421,Savage; Stefan,9999,0,9999,0
1668476089007,CSE 293,032,119425,Schulze; Jurgen P.,9999,0,9999,0
1668476089007,CSE 293,033,119426,Snoeren; Alex C.,9999,0,9999,0
1668476089007,CSE 293,034,119428,Shang; Jingbo,9999,0,9999,0
1668476089007,CSE 293,035,119430,Stefan; Deian,9999,0,9999,0
1668476089007,CSE 293,036,119431,Su; Hao,9999,0,9999,0
1668476089007,CSE 293,037,119433,Swanson; Steven James,9999,0,9999,0
1668476089007,CSE 293,038,119435,Tullsen; Dean Michael,9999,0,9999,0
1668476089007,CSE 293,039,119483,Voelker; Geoffrey M.,9999,0,9999,0
1668476089007,CSE 293,040,119537,Zhao; Jishen,9999,0,9999,0
1668476089007,CSE 293,041,119538,Zhou; Yuan-Yuan,9999,0,9999,0
1668476089007,CSE 293,042,119539,Gao; Sicun,9999,0,9999,0
1668476089007,CSE 293,043,119540,Weibel; Nadir,9999,0,9999,0
1668476089007,CSE 293,044,119541,Gupta; Rajesh K.,9999,0,9999,0
1668476089007,CSE 293,045,126410,Vaccaro; Kristen Marie,9999,0,9999,0
1668476089007,CSE 293,046,126411,Klemke; Richard,9999,0,9999,0
1668476089433,CSE 294,A00,102459,Voelker; Geoffrey M.,0,2,0,0
1668476089433,CSE 294,B00,111322,Orailoglu; Alex,0,2,0,0
1668476089859,DSE 201,A00,096914,Deutsch; Alin Bernard,30,0,30,0
1668476090285,DSE 210,A00,096915,Dasgupta; Sanjoy,30,0,30,0
1668476090718,DSE 260A,A00,096916,Altintas De Callaf; Ilkay,30,0,30,0
1668476091160,ECE 200,001,103586,Antipa; Nicholas A,9999,0,9999,0
1668476091160,ECE 200,002,103587,Atanasov; Nikolay A.,9999,0,9999,0
1668476091160,ECE 200,003,103588,Bharadia; Dinesh,9999,0,9999,0
1668476091160,ECE 200,004,103589,Cheng; Chung Kuan,9999,0,9999,0
1668476091160,ECE 200,005,103590,Cosman; Pamela C.,9999,0,9999,0
1668476091160,ECE 200,006,103591,Dayeh; Shadi Ahmad,9999,0,9999,0
1668476091160,ECE 200,007,103592,Fainman; Yeshaiahu,9999,0,9999,0
1668476091160,ECE 200,008,103593,Ford; Joseph Earl,9999,0,9999,0
1668476091160,ECE 200,009,103594,Franceschetti; Massimo,9999,0,9999,0
1668476091160,ECE 200,010,103595,Fullerton; Eric E,9999,0,9999,0
1668476091160,ECE 200,011,103596,Galton; Ian A,9999,0,9999,0
1668476091160,ECE 200,012,103597,Gilja; Vikash,9999,0,9999,0
1668476091160,ECE 200,013,103598,Hall; Drew A.,9999,0,9999,0
1668476091160,ECE 200,014,103599,Hsueh; Tzu-Chien,9999,0,9999,0
1668476091160,ECE 200,015,103600,Javidi; Tara,9999,0,9999,0
1668476091160,ECE 200,016,103601,Kahng; Andrew Byun,9999,0,9999,0
1668476091160,ECE 200,017,103602,Kim; Young-Han,9999,0,9999,0
1668476091160,ECE 200,018,103603,Koushanfar; Farinaz,9999,0,9999,0
1668476091160,ECE 200,019,103604,Kuzum; Duygu,9999,0,9999,0
1668476091160,ECE 200,020,103605,Le; Hanh-Phuc,9999,0,9999,0
1668476091160,ECE 200,021,103606,Lin; Bill,9999,0,9999,0
1668476091160,ECE 200,022,103607,Liu; Zhaowei,9998,0,9999,1
1668476091160,ECE 200,023,103608,Lo; Yu-Hwa,9999,0,9999,0
1668476091160,ECE 200,024,103609,Lomakin; Vitaliy,9999,0,9999,0
1668476091160,ECE 200,025,103610,Mercier; Patrick Philip,9999,0,9999,0
1668476091160,ECE 200,026,103611,Meyer; Florian,9999,0,9999,0
1668476091160,ECE 200,027,103612,Milstein; Laurence B.,9999,0,9999,0
1668476091160,ECE 200,028,103613,Mir Arabbaygi; Siavash,9999,0,9999,0
1668476091160,ECE 200,029,103614,Mookherjea; Shayan,9999,0,9999,0
1668476091160,ECE 200,030,103615,Morris; Karcher William,9999,0,9999,0
1668476091160,ECE 200,031,103616,Ng; Tse Nga,9999,0,9999,0
1668476091160,ECE 200,032,103617,Nguyen; Truong Quang,9999,0,9999,0
1668476091160,ECE 200,033,103618,Nomura; Kenji,9999,0,9999,0
1668476091160,ECE 200,034,103619,Orlitsky; Alon,9999,0,9999,0
1668476091160,ECE 200,035,103620,Pal; Piya,9999,0,9999,0
1668476091160,ECE 200,036,103621,Papen; George C.,9999,0,9999,0
1668476091160,ECE 200,037,103622,Radic; Stojan,9999,0,9999,0
1668476091160,ECE 200,038,103623,Rao; Bhaskar D.,9999,0,9999,0
1668476091160,ECE 200,039,103624,Rao; Ramesh R,9999,0,9999,0
1668476091160,ECE 200,040,103625,Rebeiz; Gabriel,9999,0,9999,0
1668476091160,ECE 200,041,103626,Sanford; John R,9999,0,9999,0
1668476091160,ECE 200,042,103627,Siegel; Paul H.,9999,0,9999,0
1668476091160,ECE 200,043,103628,Sievenpiper; Daniel F.,9999,0,9999,0
1668476091160,ECE 200,044,103629,Sworder; David D.,9999,0,9999,0
1668476091160,ECE 200,045,103630,Taur; Yuan,9999,0,9999,0
1668476091160,ECE 200,046,103631,Touri; Behrouz,9999,0,9999,0
1668476091160,ECE 200,047,103632,Trivedi; Mohan M.,9999,0,9999,0
1668476091160,ECE 200,048,103633,Vasconcelos; Nuno,9999,0,9999,0
1668476091160,ECE 200,049,103634,Wang; Xiaolong,9999,0,9999,0
1668476091160,ECE 200,050,103635,Xie; Pengtao,9999,0,9999,0
1668476091160,ECE 200,051,103636,Yip; Michael,9999,0,9999,0
1668476091160,ECE 200,052,103637,Zeger; Kenneth A.,999,0,999,0
1668476091160,ECE 200,053,103638,Zhang; Xinyu,9999,0,9999,0
1668476091160,ECE 200,054,103639,Turakhia; Yatish Girish,9999,0,9999,0
1668476091160,ECE 200,055,103640,Kang; Mingu,9999,0,9999,0
1668476091160,ECE 200,056,103641,Shi; Yuanyuan,9999,0,9999,0
1668476091160,ECE 200,057,103642,Wang; Edward Jay,9999,0,9999,0
1668476091160,ECE 200,058,103643,Zheng; Yang,9999,0,9999,0
1668476091591,ECE 202,A00,103644,Kuzum; Duygu,0,41,0,0
1668476092019,ECE 212BN,A00,103646,Ng; Tse Nga,0,8,0,0
1668476092444,ECE 221,A00,111493,Staff,0,0,0,0
1668476092871,ECE 222B,A00,103647,Lomakin; Vitaliy,0,17,0,0
1668476093294,ECE 230B,A00,103648,Taur; Yuan,0,2,0,0
1668476093719,ECE 238B,A00,103649,Garay; Javier,0,0,0,0
1668476094145,ECE 240B,A00,112900,Fainman; Yeshaiahu,0,6,0,0
1668476094569,ECE 247A,A00,103650,Jokerst; Jesse Vincent,0,5,0,0
1668476094993,ECE 247B,A00,103651,Wang; Joseph,0,11,0,0
1668476095422,ECE 250,A00,103652,Siegel; Paul H.,0,79,0,0
1668476095850,ECE 251A,A00,103654,Rao; Bhaskar D.,0,61,0,0
1668476096283,ECE 257B,A00,103655,Bharadia; Dinesh,0,32,0,0
1668476096709,ECE 258A,A00,103656,Milstein; Laurence B.,0,28,0,0
1668476097132,ECE 260B,A00,103658,Kang; Mingu,0,119,0,0
1668476097555,ECE 264A,A00,103659,Galton; Ian A,0,65,0,0
1668476097985,ECE 265A,A00,103661,Gudem; Prasad S.S.,0,64,0,0
1668476098412,ECE 265D,A00,103662,Gudem; Prasad S.S.,0,24,0,0
1668476098841,ECE 268,A00,103663,Koushanfar; Farinaz,0,42,0,0
1668476099264,ECE 269,A01,103665,Pal; Piya,0,206,0,0
1668476099687,ECE 271B,A00,103666,Vasconcelos; Manuela,0,73,0,0
1668476100110,ECE 276A,A00,103667,Atanasov; Nikolay A.,0,119,0,0
1668476100539,ECE 277,A00,103668,An; Cheolhong,0,142,0,0
1668476100961,ECE 279,A00,117947,Hall; Drew A.,0,22,0,0
1668476101811,ECE 283,A00,103670,Hsueh; Tzu-Chien,0,51,0,0
1668476102235,ECE 284,A00,103671,Turakhia; Yatish Girish,0,39,0,0
1668476102663,ECE 285,A00,103672,Zheng; Yang,0,39,0,0
1668476102663,ECE 285,B00,103673,Sworder; David D.,0,55,0,0
1668476103087,ECE 287,A00,103676,Javidi; Tara,0,8,0,0
1668476103512,MATH 200B,A00,098023,Salehi Golsefidy; Alireza,11,0,15,4
1668476103963,MATH 202B,A00,098024,Rhoades; Brendon Patrick,7,0,15,8
1668476104389,MATH 203B,A00,098025,Oprea; Dragos N.,10,0,15,5
1668476104816,MATH 204B,A00,098026,Sorensen; Claus M,13,0,15,2
1668476105246,MATH 208,A00,098027,Izadi; Elham,7,0,10,3
1668476105675,MATH 209,A00,098028,Pollack; Aaron,10,0,10,0
1668476106103,MATH 211A,A00,112919,Rogalski; Daniel,8,0,10,2
1668476106534,MATH 211B,A00,112920,Seward; Brandon M.,9,0,10,1
1668476106960,MATH 218,A00,098029,Li; Bo,10,0,10,0
1668476107396,MATH 220B,A00,098030,Novak; Jonathan I,11,0,15,4
1668476107825,MATH 221A,A00,098031,Ebenfelt; Peter F,13,0,15,2
1668476108249,MATH 231B,A00,098032,Zlatos; Andrej,11,0,15,4
1668476108677,MATH 240B,A00,098033,Ni; Lei,7,0,15,8
1668476109105,MATH 243,A00,098034,Jekel; David Andrew,10,0,10,0
1668476109534,MATH 245A,A00,098035,Nie; Jiawang,0,4,15,18
1668476109960,MATH 248,A00,098036,Bejenaru; Ioan,10,0,10,0
1668476110386,MATH 250B,A00,098037,Spolaor; Luca,14,0,15,1
1668476110888,MATH 258,A00,098038,Ni; Lei,9,0,10,1
1668476111314,MATH 264B,A00,098041,Rhoades; Brendon Patrick,8,0,15,7
1668476111739,MATH 268,A00,098042,Buss; Samuel R,10,0,10,0
1668476112162,MATH 269,A00,098043,Rhoades; Brendon Patrick,10,0,10,0
1668476112587,MATH 270B,A00,098044,Li; Bo,6,0,15,9
1668476113015,MATH 272B,A00,098045,Holst; Michael J,13,0,15,2
1668476113446,MATH 273A,A00,098046,Tian; Xiaochuan,10,0,15,5
1668476113878,MATH 275,A01,098048,Tian; Xiaochuan,6,0,10,4
1668476114309,MATH 278A,A00,098049,Holst; Michael J,7,0,10,3
1668476114747,MATH 278B,A00,098050,Cloninger; Alexander,10,0,10,0
1668476115186,MATH 278C,A00,098051,Nie; Jiawang,5,0,10,5
1668476115620,MATH 280B,A00,098052,Zheng; Tianyi,7,0,15,8
1668476116052,MATH 281B,A00,098053,Bradic; Jelena,0,2,15,15
1668476116476,MATH 282B,A00,098054,Arias-Castro; Ery,0,1,15,15
1668476116903,MATH 285,A00,098055,Fitzsimmons; Patrick J,0,2,15,17
1668476117326,MATH 287B,A00,098056,Arias-Castro; Ery,2,0,15,13
1668476117753,MATH 288,A00,098057,Agarwal; Pooja,9,0,10,1
1668476117753,MATH 288,B00,098058,Zhang; Danna,8,0,10,2
1668476117753,MATH 288,C00,098059,Williams; Ruth J,9,0,10,1
1668476118177,MATH 290B,A00,098060,Roberts; Justin Deritter,12,0,15,3
1668476118610,MATH 292,A00,098061,Belmont; Eva Kinoshita,10,0,10,0
1668476119036,MATH 295,A00,098062,Suk; Andrew Hoon,47,0,50,3
1668476119464,MATH 296,A00,098063,Novak; Jonathan I,20,0,20,0
1668476119887,MATH 297,001,098064,Gamst; Anthony Collins,9997,0,9999,2
1668476621720,COGS 205,A00,101395,Chiba; Andrea,19,0,20,1
1668476622149,COGS 210B,001,101404,Greene; Deanna Jacquelyn,9998,0,9999,1
1668476622149,COGS 210B,002,101417,Xia; Haijun,9999,0,9999,0
1668476622149,COGS 210B,003,101422,Nitz; Douglas A.,9999,0,9999,0
1668476622149,COGS 210B,004,101423,Hollan; James D.,9998,0,9999,1
1668476622149,COGS 210B,005,101424,Deak; Gedeon O.,9998,0,9999,1
1668476622149,COGS 210B,006,101425,Rossano; Federico,9999,0,9999,0
1668476622572,COGS 211B,A00,101427,Coulson; Seana M,9996,0,9999,3
1668476622996,COGS 220,A00,101428,Hollan; James D.,1,9,25,24
1668476623422,COGS 229,A00,101429,Dow; Steven P,17,0,25,8
1668476623847,COGS 230,A00,101430,Klemmer; Scott R,8,0,17,9
1668476624277,COGS 234,A00,101431,Xia; Haijun,2,0,25,23
1668476624699,COGS 260,A00,101432,Kiyonaga; Anastasia,21,0,25,4
1668476624699,COGS 260,B00,101433,Kirsh; David Joel,15,0,25,10
1668476625126,CSE 202,A00,102371,Impagliazzo; Russell,0,59,0,0
1668476625551,CSE 203B,A01,102373,Cheng; Chung Kuan,0,50,0,0
1668476625975,CSE 208,A00,102374,Micciancio; Daniele,0,4,0,0
1668476626406,CSE 209A,A00,112895,Impagliazzo; Russell,0,12,15,15
1668476626832,CSE 209B,A00,108005,Bellare; Mihir,0,6,0,0
1668476627258,CSE 210,A00,113163,Coblenz; Michael J,0,80,0,0
1668476627682,CSE 219,A00,106111,Dow; Steven P,0,6,20,20
1668476628106,CSE 221,A00,102376,Voelker; Geoffrey M.,0,67,0,0
1668476628531,CSE 224,A01,102378,Porter; George M,0,159,0,0
1668476628954,CSE 229A,A00,102379,Savage; Stefan,0,10,0,0
1668476629380,CSE 229C,A00,102380,Munyaka; Imani N. S.,0,9,0,0
1668476629803,CSE 232B,A00,102382,Deutsch; Alin Bernard,0,30,0,0
1668476630240,CSE 234,A01,112904,Kumar; Arun Kumar,0,0,0,0
1668476630666,CSE 237A,A00,102383,Rosing; Tajana Simunic,0,47,0,0
1668476631088,CSE 239A,A00,102384,Deutsch; Alin Bernard,0,12,0,0
1668476631600,CSE 239B,A00,102385,Polikarpova; Nadezhda,0,10,0,0
1668476632027,CSE 240A,A00,102386,Pannuto; Patrick William,0,43,0,0
1668476632454,CSE 240B,A00,102387,Zhao; Jishen,0,42,0,0
1668476632884,CSE 241A,A00,106406,Kang; Mingu,0,6,0,0
1668476633307,CSE 249B,A00,102388,Kahng; Andrew Byun,0,5,8,8
1668476633732,CSE 251B,A01,102392,Cottrell; Garrison W,0,44,0,0
1668476633732,CSE 251B,A02,102393,Cottrell; Garrison W,0,33,0,0
1668476634156,CSE 252B,A00,102394,Ochoa; Benjamin Lawrence,0,55,0,0
1668476634582,CSE 257,A01,102396,Gao; Sicun,0,129,0,0
1668476635005,CSE 272,A00,102397,Li; Tzumao,0,17,0,0
1668476635433,CSE 274,A00,111323,Chern; Albert Ren-Haur,0,14,0,0
1668476635858,CSE 282,A00,102398,Pevzner; Pavel Arkadjevich,0,0,0,0
1668476636281,CSE 284,A00,114175,Gymrek; Melissa Ann,0,19,0,0
1668476636703,CSE 290,A00,102399,Chandraker; Manmohan Krishna,0,11,0,0
1668476636703,CSE 290,B00,102400,Vaccaro; Kristen Marie,0,7,25,25
1668476636703,CSE 290,C00,102414,Pannuto; Patrick William,0,1,25,25
1668476636703,CSE 290,D00,102427,Pevzner; Pavel Arkadjevich,0,0,0,0
1668476636703,CSE 290,E00,102429,Zhao; Jishen,0,4,0,0
1668476636703,CSE 290,F00,102436,Tullsen; Dean Michael,0,5,0,0
1668476636703,CSE 290,G00,102440,Christensen; Henrik I,0,6,20,20
1668476637128,CSE 291,A00,102443,Su; Hao,0,0,0,0
1668476637128,CSE 291,B00,102448,Polikarpova; Nadezhda,0,0,0,0
1668476637128,CSE 291,C00,102453,Vaccaro; Kristen Marie,0,0,0,0
1668476637128,CSE 291,D00,111343,Savage; Stefan,0,0,0,0
1668476637128,CSE 291,E00,116474,Claffy; Kimberly Claire,0,0,0,0
1668476637128,CSE 291,F00,116479,Pasquale; Joseph,0,0,0,0
1668476637563,CSE 293,001,119111,Bafna; Vineet,9999,0,9999,0
1668476637563,CSE 293,002,119118,Bellare; Mihir,9999,0,9999,0
1668476637563,CSE 293,003,119122,Berg-Kirkpatrick; Taylor D,9999,0,9999,0
1668476637563,CSE 293,004,119135,Christensen; Henrik I,9999,0,9999,0
1668476637563,CSE 293,005,119142,Cottrell; Garrison W,9999,0,9999,0
1668476637563,CSE 293,006,119146,Deutsch; Alin Bernard,9999,0,9999,0
1668476637563,CSE 293,007,119159,Esmaeilzadeh; Hadi,9999,0,9999,0
1668476637563,CSE 293,008,119166,Freund; Yoav,9999,0,9999,0
1668476637563,CSE 293,009,119170,Griswold; William G.,9999,0,9999,0
1668476637563,CSE 293,010,119183,Gymrek; Melissa Ann,9999,0,9999,0
1668476637563,CSE 293,011,119190,Heninger; Nadia A,9999,0,9999,0
1668476637563,CSE 293,012,119230,Impagliazzo; Russell,9999,0,9999,0
1668476637563,CSE 293,013,119232,Jhala; Ranjit,9999,0,9999,0
1668476637563,CSE 293,014,119233,Kahng; Andrew Byun,9999,0,9999,0
1668476637563,CSE 293,015,119298,Kane; Daniel Mertz,9999,0,9999,0
1668476637563,CSE 293,016,119299,Kriegman; David J,9999,0,9999,0
1668476637563,CSE 293,017,119300,Kumar; Arun Kumar,9999,0,9999,0
1668476637563,CSE 293,018,119301,Lerner; Sorin,9999,0,9999,0
1668476637563,CSE 293,019,119302,Lovett; Shachar,9999,0,9999,0
1668476637563,CSE 293,020,119303,McAuley; Julian John,9999,0,9999,0
1668476637563,CSE 293,021,119304,Micciancio; Daniele,9999,0,9999,0
1668476637563,CSE 293,022,119367,Orailoglu; Alex,9999,0,9999,0
1668476637563,CSE 293,023,119382,Paturi; Ramamohan,9999,0,9999,0
1668476637563,CSE 293,024,119404,Polikarpova; Nadezhda,9999,0,9999,0
1668476637563,CSE 293,025,119406,Politz; Joseph Gibbs,9999,0,9999,0
1668476637563,CSE 293,026,119411,Porter; George M,9999,0,9999,0
1668476637563,CSE 293,027,119414,Porter; Leonard Emerson,9999,0,9999,0
1668476637563,CSE 293,028,119416,Ramamoorthi; Ravi,9999,0,9999,0
1668476637563,CSE 293,029,119417,Sahoo; Debashis,9999,0,9999,0
1668476637563,CSE 293,030,119420,Saul; Lawrence,9999,0,9999,0
1668476637563,CSE 293,031,119421,Savage; Stefan,9999,0,9999,0
1668476637563,CSE 293,032,119425,Schulze; Jurgen P.,9999,0,9999,0
1668476637563,CSE 293,033,119426,Snoeren; Alex C.,9999,0,9999,0
1668476637563,CSE 293,034,119428,Shang; Jingbo,9999,0,9999,0
1668476637563,CSE 293,035,119430,Stefan; Deian,9999,0,9999,0
1668476637563,CSE 293,036,119431,Su; Hao,9999,0,9999,0
1668476637563,CSE 293,037,119433,Swanson; Steven James,9999,0,9999,0
1668476637563,CSE 293,038,119435,Tullsen; Dean Michael,9999,0,9999,0
1668476637563,CSE 293,039,119483,Voelker; Geoffrey M.,9999,0,9999,0
1668476637563,CSE 293,040,119537,Zhao; Jishen,9999,0,9999,0
1668476637563,CSE 293,041,119538,Zhou; Yuan-Yuan,9999,0,9999,0
1668476637563,CSE 293,042,119539,Gao; Sicun,9999,0,9999,0
1668476637563,CSE 293,043,119540,Weibel; Nadir,9999,0,9999,0
1668476637563,CSE 293,044,119541,Gupta; Rajesh K.,9999,0,9999,0
1668476637563,CSE 293,045,126410,Vaccaro; Kristen Marie,9999,0,9999,0
1668476637563,CSE 293,046,126411,Klemke; Richard,9999,0,9999,0
1668476637988,CSE 294,A00,102459,Voelker; Geoffrey M.,0,2,0,0
1668476637988,CSE 294,B00,111322,Orailoglu; Alex,0,2,0,0
1668476638414,DSE 201,A00,096914,Deutsch; Alin Bernard,30,0,30,0
1668476638845,DSE 210,A00,096915,Dasgupta; Sanjoy,30,0,30,0
1668476639267,DSE 260A,A00,096916,Altintas De Callaf; Ilkay,30,0,30,0
1668476639697,ECE 200,001,103586,Antipa; Nicholas A,9999,0,9999,0
1668476639697,ECE 200,002,103587,Atanasov; Nikolay A.,9999,0,9999,0
1668476639697,ECE 200,003,103588,Bharadia; Dinesh,9999,0,9999,0
1668476639697,ECE 200,004,103589,Cheng; Chung Kuan,9999,0,9999,0
1668476639697,ECE 200,005,103590,Cosman; Pamela C.,9999,0,9999,0
1668476639697,ECE 200,006,103591,Dayeh; Shadi Ahmad,9999,0,9999,0
1668476639697,ECE 200,007,103592,Fainman; Yeshaiahu,9999,0,9999,0
1668476639697,ECE 200,008,103593,Ford; Joseph Earl,9999,0,9999,0
1668476639697,ECE 200,009,103594,Franceschetti; Massimo,9999,0,9999,0
1668476639697,ECE 200,010,103595,Fullerton; Eric E,9999,0,9999,0
1668476639697,ECE 200,011,103596,Galton; Ian A,9999,0,9999,0
1668476639697,ECE 200,012,103597,Gilja; Vikash,9999,0,9999,0
1668476639697,ECE 200,013,103598,Hall; Drew A.,9999,0,9999,0
1668476639697,ECE 200,014,103599,Hsueh; Tzu-Chien,9999,0,9999,0
1668476639697,ECE 200,015,103600,Javidi; Tara,9999,0,9999,0
1668476639697,ECE 200,016,103601,Kahng; Andrew Byun,9999,0,9999,0
1668476639697,ECE 200,017,103602,Kim; Young-Han,9999,0,9999,0
1668476639697,ECE 200,018,103603,Koushanfar; Farinaz,9999,0,9999,0
1668476639697,ECE 200,019,103604,Kuzum; Duygu,9999,0,9999,0
1668476639697,ECE 200,020,103605,Le; Hanh-Phuc,9999,0,9999,0
1668476639697,ECE 200,021,103606,Lin; Bill,9999,0,9999,0
1668476639697,ECE 200,022,103607,Liu; Zhaowei,9998,0,9999,1
1668476639697,ECE 200,023,103608,Lo; Yu-Hwa,9999,0,9999,0
1668476639697,ECE 200,024,103609,Lomakin; Vitaliy,9999,0,9999,0
1668476639697,ECE 200,025,103610,Mercier; Patrick Philip,9999,0,9999,0
1668476639697,ECE 200,026,103611,Meyer; Florian,9999,0,9999,0
1668476639697,ECE 200,027,103612,Milstein; Laurence B.,9999,0,9999,0
1668476639697,ECE 200,028,103613,Mir Arabbaygi; Siavash,9999,0,9999,0
1668476639697,ECE 200,029,103614,Mookherjea; Shayan,9999,0,9999,0
1668476639697,ECE 200,030,103615,Morris; Karcher William,9999,0,9999,0
1668476639697,ECE 200,031,103616,Ng; Tse Nga,9999,0,9999,0
1668476639697,ECE 200,032,103617,Nguyen; Truong Quang,9999,0,9999,0
1668476639697,ECE 200,033,103618,Nomura; Kenji,9999,0,9999,0
1668476639697,ECE 200,034,103619,Orlitsky; Alon,9999,0,9999,0
1668476639697,ECE 200,035,103620,Pal; Piya,9999,0,9999,0
1668476639697,ECE 200,036,103621,Papen; George C.,9999,0,9999,0
1668476639697,ECE 200,037,103622,Radic; Stojan,9999,0,9999,0
1668476639697,ECE 200,038,103623,Rao; Bhaskar D.,9999,0,9999,0
1668476639697,ECE 200,039,103624,Rao; Ramesh R,9999,0,9999,0
1668476639697,ECE 200,040,103625,Rebeiz; Gabriel,9999,0,9999,0
1668476639697,ECE 200,041,103626,Sanford; John R,9999,0,9999,0
1668476639697,ECE 200,042,103627,Siegel; Paul H.,9999,0,9999,0
1668476639697,ECE 200,043,103628,Sievenpiper; Daniel F.,9999,0,9999,0
1668476639697,ECE 200,044,103629,Sworder; David D.,9999,0,9999,0
1668476639697,ECE 200,045,103630,Taur; Yuan,9999,0,9999,0
1668476639697,ECE 200,046,103631,Touri; Behrouz,9999,0,9999,0
1668476639697,ECE 200,047,103632,Trivedi; Mohan M.,9999,0,9999,0
1668476639697,ECE 200,048,103633,Vasconcelos; Nuno,9999,0,9999,0
1668476639697,ECE 200,049,103634,Wang; Xiaolong,9999,0,9999,0
1668476639697,ECE 200,050,103635,Xie; Pengtao,9999,0,9999,0
1668476639697,ECE 200,051,103636,Yip; Michael,9999,0,9999,0
1668476639697,ECE 200,052,103637,Zeger; Kenneth A.,999,0,999,0
1668476639697,ECE 200,053,103638,Zhang; Xinyu,9999,0,9999,0
1668476639697,ECE 200,054,103639,Turakhia; Yatish Girish,9999,0,9999,0
1668476639697,ECE 200,055,103640,Kang; Mingu,9999,0,9999,0
1668476639697,ECE 200,056,103641,Shi; Yuanyuan,9999,0,9999,0
1668476639697,ECE 200,057,103642,Wang; Edward Jay,9999,0,9999,0
1668476639697,ECE 200,058,103643,Zheng; Yang,9999,0,9999,0
1668476640121,ECE 202,A00,103644,Kuzum; Duygu,0,41,0,0
1668476640551,ECE 212BN,A00,103646,Ng; Tse Nga,0,9,0,0
1668476640973,ECE 221,A00,111493,Staff,0,0,0,0
1668476641407,ECE 222B,A00,103647,Lomakin; Vitaliy,0,17,0,0
1668476641832,ECE 230B,A00,103648,Taur; Yuan,0,2,0,0
1668476642255,ECE 238B,A00,103649,Garay; Javier,0,0,0,0
1668476642680,ECE 240B,A00,112900,Fainman; Yeshaiahu,0,6,0,0
1668476643102,ECE 247A,A00,103650,Jokerst; Jesse Vincent,0,5,0,0
1668476643526,ECE 247B,A00,103651,Wang; Joseph,0,11,0,0
1668476643949,ECE 250,A00,103652,Siegel; Paul H.,0,79,0,0
1668476644386,ECE 251A,A00,103654,Rao; Bhaskar D.,0,61,0,0
1668476644814,ECE 257B,A00,103655,Bharadia; Dinesh,0,32,0,0
1668476645251,ECE 258A,A00,103656,Milstein; Laurence B.,0,28,0,0
1668476645679,ECE 260B,A00,103658,Kang; Mingu,0,119,0,0
1668476646103,ECE 264A,A00,103659,Galton; Ian A,0,65,0,0
1668476646526,ECE 265A,A00,103661,Gudem; Prasad S.S.,0,64,0,0
1668476646962,ECE 265D,A00,103662,Gudem; Prasad S.S.,0,24,0,0
1668476647388,ECE 268,A00,103663,Koushanfar; Farinaz,0,42,0,0
1668476647825,ECE 269,A01,103665,Pal; Piya,0,206,0,0
1668476648249,ECE 271B,A00,103666,Vasconcelos; Manuela,0,73,0,0
1668476648674,ECE 276A,A00,103667,Atanasov; Nikolay A.,0,119,0,0
1668476649100,ECE 277,A00,103668,An; Cheolhong,0,142,0,0
1668476649527,ECE 279,A00,117947,Hall; Drew A.,0,22,0,0
1668476650374,ECE 283,A00,103670,Hsueh; Tzu-Chien,0,51,0,0
1668476650813,ECE 284,A00,103671,Turakhia; Yatish Girish,0,39,0,0
1668476651240,ECE 285,A00,103672,Zheng; Yang,0,39,0,0
1668476651240,ECE 285,B00,103673,Sworder; David D.,0,55,0,0
1668476651666,ECE 287,A00,103676,Javidi; Tara,0,8,0,0
1668476652089,MATH 200B,A00,098023,Salehi Golsefidy; Alireza,11,0,15,4
1668476652515,MATH 202B,A00,098024,Rhoades; Brendon Patrick,7,0,15,8
1668476652940,MATH 203B,A00,098025,Oprea; Dragos N.,10,0,15,5
1668476653367,MATH 204B,A00,098026,Sorensen; Claus M,13,0,15,2
1668476653793,MATH 208,A00,098027,Izadi; Elham,7,0,10,3
1668476654218,MATH 209,A00,098028,Pollack; Aaron,10,0,10,0
1668476654641,MATH 211A,A00,112919,Rogalski; Daniel,8,0,10,2
1668476655064,MATH 211B,A00,112920,Seward; Brandon M.,9,0,10,1
1668476655486,MATH 218,A00,098029,Li; Bo,10,0,10,0
1668476655914,MATH 220B,A00,098030,Novak; Jonathan I,11,0,15,4
1668476656341,MATH 221A,A00,098031,Ebenfelt; Peter F,13,0,15,2
1668476656765,MATH 231B,A00,098032,Zlatos; Andrej,11,0,15,4
1668476657189,MATH 240B,A00,098033,Ni; Lei,7,0,15,8
1668476657610,MATH 243,A00,098034,Jekel; David Andrew,10,0,10,0
1668476658035,MATH 245A,A00,098035,Nie; Jiawang,0,4,15,18
1668476658464,MATH 248,A00,098036,Bejenaru; Ioan,10,0,10,0
1668476658888,MATH 250B,A00,098037,Spolaor; Luca,14,0,15,1
1668476659311,MATH 258,A00,098038,Ni; Lei,9,0,10,1
1668476659743,MATH 264B,A00,098041,Rhoades; Brendon Patrick,8,0,15,7
1668476660167,MATH 268,A00,098042,Buss; Samuel R,10,0,10,0
1668476660592,MATH 269,A00,098043,Rhoades; Brendon Patrick,10,0,10,0
1668476661017,MATH 270B,A00,098044,Li; Bo,6,0,15,9
1668476661440,MATH 272B,A00,098045,Holst; Michael J,13,0,15,2
1668476661865,MATH 273A,A00,098046,Tian; Xiaochuan,10,0,15,5
1668476662288,MATH 275,A01,098048,Tian; Xiaochuan,6,0,10,4
1668476662724,MATH 278A,A00,098049,Holst; Michael J,7,0,10,3
1668476663148,MATH 278B,A00,098050,Cloninger; Alexander,10,0,10,0
1668476663571,MATH 278C,A00,098051,Nie; Jiawang,5,0,10,5
1668476663995,MATH 280B,A00,098052,Zheng; Tianyi,7,0,15,8
1668476664426,MATH 281B,A00,098053,Bradic; Jelena,0,2,15,15
1668476664854,MATH 282B,A00,098054,Arias-Castro; Ery,0,1,15,15
1668476665277,MATH 285,A00,098055,Fitzsimmons; Patrick J,0,2,15,17
1668476665699,MATH 287B,A00,098056,Arias-Castro; Ery,2,0,15,13
1668476666124,MATH 288,A00,098057,Agarwal; Pooja,9,0,10,1
1668476666124,MATH 288,B00,098058,Zhang; Danna,8,0,10,2
1668476666124,MATH 288,C00,098059,Williams; Ruth J,9,0,10,1
1668476666553,MATH 290B,A00,098060,Roberts; Justin Deritter,12,0,15,3
1668476666978,MATH 292,A00,098061,Belmont; Eva Kinoshita,10,0,10,0
1668476667409,MATH 295,A00,098062,Suk; Andrew Hoon,47,0,50,3
1668476667833,MATH 296,A00,098063,Novak; Jonathan I,20,0,20,0
1668476668268,MATH 297,001,098064,Gamst; Anthony Collins,9997,0,9999,2
1668477169303,COGS 205,A00,101395,Chiba; Andrea,19,0,20,1
1668477169739,COGS 210B,001,101404,Greene; Deanna Jacquelyn,9998,0,9999,1
1668477169739,COGS 210B,002,101417,Xia; Haijun,9999,0,9999,0
1668477169739,COGS 210B,003,101422,Nitz; Douglas A.,9999,0,9999,0
1668477169739,COGS 210B,004,101423,Hollan; James D.,9998,0,9999,1
1668477169739,COGS 210B,005,101424,Deak; Gedeon O.,9998,0,9999,1
1668477169739,COGS 210B,006,101425,Rossano; Federico,9999,0,9999,0
1668477170163,COGS 211B,A00,101427,Coulson; Seana M,9996,0,9999,3
1668477170592,COGS 220,A00,101428,Hollan; James D.,1,9,25,24
1668477171017,COGS 229,A00,101429,Dow; Steven P,17,0,25,8
1668477171442,COGS 230,A00,101430,Klemmer; Scott R,8,0,17,9
1668477171878,COGS 234,A00,101431,Xia; Haijun,2,0,25,23
1668477172299,COGS 260,A00,101432,Kiyonaga; Anastasia,21,0,25,4
1668477172299,COGS 260,B00,101433,Kirsh; David Joel,15,0,25,10
1668477172733,CSE 202,A00,102371,Impagliazzo; Russell,0,59,0,0
1668477173160,CSE 203B,A01,102373,Cheng; Chung Kuan,0,50,0,0
1668477173582,CSE 208,A00,102374,Micciancio; Daniele,0,4,0,0
1668477174010,CSE 209A,A00,112895,Impagliazzo; Russell,0,12,15,15
1668477174442,CSE 209B,A00,108005,Bellare; Mihir,0,6,0,0
1668477174872,CSE 210,A00,113163,Coblenz; Michael J,0,80,0,0
1668477175305,CSE 219,A00,106111,Dow; Steven P,0,6,20,20
1668477175728,CSE 221,A00,102376,Voelker; Geoffrey M.,0,67,0,0
1668477176155,CSE 224,A01,102378,Porter; George M,0,159,0,0
1668477176582,CSE 229A,A00,102379,Savage; Stefan,0,10,0,0
1668477177005,CSE 229C,A00,102380,Munyaka; Imani N. S.,0,9,0,0
1668477177429,CSE 232B,A00,102382,Deutsch; Alin Bernard,0,30,0,0
1668477177858,CSE 234,A01,112904,Kumar; Arun Kumar,0,0,0,0
1668477178285,CSE 237A,A00,102383,Rosing; Tajana Simunic,0,47,0,0
1668477178711,CSE 239A,A00,102384,Deutsch; Alin Bernard,0,12,0,0
1668477179138,CSE 239B,A00,102385,Polikarpova; Nadezhda,0,10,0,0
1668477179567,CSE 240A,A00,102386,Pannuto; Patrick William,0,43,0,0
1668477179993,CSE 240B,A00,102387,Zhao; Jishen,0,42,0,0
1668477180417,CSE 241A,A00,106406,Kang; Mingu,0,6,0,0
1668477180842,CSE 249B,A00,102388,Kahng; Andrew Byun,0,5,8,8
1668477181265,CSE 251B,A01,102392,Cottrell; Garrison W,0,44,0,0
1668477181265,CSE 251B,A02,102393,Cottrell; Garrison W,0,33,0,0
1668477181692,CSE 252B,A00,102394,Ochoa; Benjamin Lawrence,0,55,0,0
1668477182125,CSE 257,A01,102396,Gao; Sicun,0,129,0,0
1668477182552,CSE 272,A00,102397,Li; Tzumao,0,17,0,0
1668477182986,CSE 274,A00,111323,Chern; Albert Ren-Haur,0,14,0,0
1668477183418,CSE 282,A00,102398,Pevzner; Pavel Arkadjevich,0,0,0,0
1668477183850,CSE 284,A00,114175,Gymrek; Melissa Ann,0,19,0,0
1668477184276,CSE 290,A00,102399,Chandraker; Manmohan Krishna,0,11,0,0
1668477184276,CSE 290,B00,102400,Vaccaro; Kristen Marie,0,7,25,25
1668477184276,CSE 290,C00,102414,Pannuto; Patrick William,0,1,25,25
1668477184276,CSE 290,D00,102427,Pevzner; Pavel Arkadjevich,0,0,0,0
1668477184276,CSE 290,E00,102429,Zhao; Jishen,0,4,0,0
1668477184276,CSE 290,F00,102436,Tullsen; Dean Michael,0,5,0,0
1668477184276,CSE 290,G00,102440,Christensen; Henrik I,0,6,20,20
1668477184700,CSE 291,A00,102443,Su; Hao,0,0,0,0
1668477184700,CSE 291,B00,102448,Polikarpova; Nadezhda,0,0,0,0
1668477184700,CSE 291,C00,102453,Vaccaro; Kristen Marie,0,0,0,0
1668477184700,CSE 291,D00,111343,Savage; Stefan,0,0,0,0
1668477184700,CSE 291,E00,116474,Claffy; Kimberly Claire,0,0,0,0
1668477184700,CSE 291,F00,116479,Pasquale; Joseph,0,0,0,0
1668477185127,CSE 293,001,119111,Bafna; Vineet,9999,0,9999,0
1668477185127,CSE 293,002,119118,Bellare; Mihir,9999,0,9999,0
1668477185127,CSE 293,003,119122,Berg-Kirkpatrick; Taylor D,9999,0,9999,0
1668477185127,CSE 293,004,119135,Christensen; Henrik I,9999,0,9999,0
1668477185127,CSE 293,005,119142,Cottrell; Garrison W,9999,0,9999,0
1668477185127,CSE 293,006,119146,Deutsch; Alin Bernard,9999,0,9999,0
1668477185127,CSE 293,007,119159,Esmaeilzadeh; Hadi,9999,0,9999,0
1668477185127,CSE 293,008,119166,Freund; Yoav,9999,0,9999,0
1668477185127,CSE 293,009,119170,Griswold; William G.,9999,0,9999,0
1668477185127,CSE 293,010,119183,Gymrek; Melissa Ann,9999,0,9999,0
1668477185127,CSE 293,011,119190,Heninger; Nadia A,9999,0,9999,0
1668477185127,CSE 293,012,119230,Impagliazzo; Russell,9999,0,9999,0
1668477185127,CSE 293,013,119232,Jhala; Ranjit,9999,0,9999,0
1668477185127,CSE 293,014,119233,Kahng; Andrew Byun,9999,0,9999,0
1668477185127,CSE 293,015,119298,Kane; Daniel Mertz,9999,0,9999,0
1668477185127,CSE 293,016,119299,Kriegman; David J,9999,0,9999,0
1668477185127,CSE 293,017,119300,Kumar; Arun Kumar,9999,0,9999,0
1668477185127,CSE 293,018,119301,Lerner; Sorin,9999,0,9999,0
1668477185127,CSE 293,019,119302,Lovett; Shachar,9999,0,9999,0
1668477185127,CSE 293,020,119303,McAuley; Julian John,9999,0,9999,0
1668477185127,CSE 293,021,119304,Micciancio; Daniele,9999,0,9999,0
1668477185127,CSE 293,022,119367,Orailoglu; Alex,9999,0,9999,0
1668477185127,CSE 293,023,119382,Paturi; Ramamohan,9999,0,9999,0
1668477185127,CSE 293,024,119404,Polikarpova; Nadezhda,9999,0,9999,0
1668477185127,CSE 293,025,119406,Politz; Joseph Gibbs,9999,0,9999,0
1668477185127,CSE 293,026,119411,Porter; George M,9999,0,9999,0
1668477185127,CSE 293,027,119414,Porter; Leonard Emerson,9999,0,9999,0
1668477185127,CSE 293,028,119416,Ramamoorthi; Ravi,9999,0,9999,0
1668477185127,CSE 293,029,119417,Sahoo; Debashis,9999,0,9999,0
1668477185127,CSE 293,030,119420,Saul; Lawrence,9999,0,9999,0
1668477185127,CSE 293,031,119421,Savage; Stefan,9999,0,9999,0
1668477185127,CSE 293,032,119425,Schulze; Jurgen P.,9999,0,9999,0
1668477185127,CSE 293,033,119426,Snoeren; Alex C.,9999,0,9999,0
1668477185127,CSE 293,034,119428,Shang; Jingbo,9999,0,9999,0
1668477185127,CSE 293,035,119430,Stefan; Deian,9999,0,9999,0
1668477185127,CSE 293,036,119431,Su; Hao,9999,0,9999,0
1668477185127,CSE 293,037,119433,Swanson; Steven James,9999,0,9999,0
1668477185127,CSE 293,038,119435,Tullsen; Dean Michael,9999,0,9999,0
1668477185127,CSE 293,039,119483,Voelker; Geoffrey M.,9999,0,9999,0
1668477185127,CSE 293,040,119537,Zhao; Jishen,9999,0,9999,0
1668477185127,CSE 293,041,119538,Zhou; Yuan-Yuan,9999,0,9999,0
1668477185127,CSE 293,042,119539,Gao; Sicun,9999,0,9999,0
1668477185127,CSE 293,043,119540,Weibel; Nadir,9999,0,9999,0
1668477185127,CSE 293,044,119541,Gupta; Rajesh K.,9999,0,9999,0
1668477185127,CSE 293,045,126410,Vaccaro; Kristen Marie,9999,0,9999,0
1668477185127,CSE 293,046,126411,Klemke; Richard,9999,0,9999,0
1668477185559,CSE 294,A00,102459,Voelker; Geoffrey M.,0,2,0,0
1668477185559,CSE 294,B00,111322,Orailoglu; Alex,0,2,0,0
1668477185989,DSE 201,A00,096914,Deutsch; Alin Bernard,30,0,30,0
1668477186416,DSE 210,A00,096915,Dasgupta; Sanjoy,30,0,30,0
1668477186840,DSE 260A,A00,096916,Altintas De Callaf; Ilkay,30,0,30,0
1668477187273,ECE 200,001,103586,Antipa; Nicholas A,9999,0,9999,0
1668477187273,ECE 200,002,103587,Atanasov; Nikolay A.,9999,0,9999,0
1668477187273,ECE 200,003,103588,Bharadia; Dinesh,9999,0,9999,0
1668477187273,ECE 200,004,103589,Cheng; Chung Kuan,9999,0,9999,0
1668477187273,ECE 200,005,103590,Cosman; Pamela C.,9999,0,9999,0
1668477187273,ECE 200,006,103591,Dayeh; Shadi Ahmad,9999,0,9999,0
1668477187273,ECE 200,007,103592,Fainman; Yeshaiahu,9999,0,9999,0
1668477187273,ECE 200,008,103593,Ford; Joseph Earl,9999,0,9999,0
1668477187273,ECE 200,009,103594,Franceschetti; Massimo,9999,0,9999,0
1668477187273,ECE 200,010,103595,Fullerton; Eric E,9999,0,9999,0
1668477187273,ECE 200,011,103596,Galton; Ian A,9999,0,9999,0
1668477187273,ECE 200,012,103597,Gilja; Vikash,9999,0,9999,0
1668477187273,ECE 200,013,103598,Hall; Drew A.,9999,0,9999,0
1668477187273,ECE 200,014,103599,Hsueh; Tzu-Chien,9999,0,9999,0
1668477187273,ECE 200,015,103600,Javidi; Tara,9999,0,9999,0
1668477187273,ECE 200,016,103601,Kahng; Andrew Byun,9999,0,9999,0
1668477187273,ECE 200,017,103602,Kim; Young-Han,9999,0,9999,0
1668477187273,ECE 200,018,103603,Koushanfar; Farinaz,9999,0,9999,0
1668477187273,ECE 200,019,103604,Kuzum; Duygu,9999,0,9999,0
1668477187273,ECE 200,020,103605,Le; Hanh-Phuc,9999,0,9999,0
1668477187273,ECE 200,021,103606,Lin; Bill,9999,0,9999,0
1668477187273,ECE 200,022,103607,Liu; Zhaowei,9998,0,9999,1
1668477187273,ECE 200,023,103608,Lo; Yu-Hwa,9999,0,9999,0
1668477187273,ECE 200,024,103609,Lomakin; Vitaliy,9999,0,9999,0
1668477187273,ECE 200,025,103610,Mercier; Patrick Philip,9999,0,9999,0
1668477187273,ECE 200,026,103611,Meyer; Florian,9999,0,9999,0
1668477187273,ECE 200,027,103612,Milstein; Laurence B.,9999,0,9999,0
1668477187273,ECE 200,028,103613,Mir Arabbaygi; Siavash,9999,0,9999,0
1668477187273,ECE 200,029,103614,Mookherjea; Shayan,9999,0,9999,0
1668477187273,ECE 200,030,103615,Morris; Karcher William,9999,0,9999,0
1668477187273,ECE 200,031,103616,Ng; Tse Nga,9999,0,9999,0
1668477187273,ECE 200,032,103617,Nguyen; Truong Quang,9999,0,9999,0
1668477187273,ECE 200,033,103618,Nomura; Kenji,9999,0,9999,0
1668477187273,ECE 200,034,103619,Orlitsky; Alon,9999,0,9999,0
1668477187273,ECE 200,035,103620,Pal; Piya,9999,0,9999,0
1668477187273,ECE 200,036,103621,Papen; George C.,9999,0,9999,0
1668477187273,ECE 200,037,103622,Radic; Stojan,9999,0,9999,0
1668477187273,ECE 200,038,103623,Rao; Bhaskar D.,9999,0,9999,0
1668477187273,ECE 200,039,103624,Rao; Ramesh R,9999,0,9999,0
1668477187273,ECE 200,040,103625,Rebeiz; Gabriel,9999,0,9999,0
1668477187273,ECE 200,041,103626,Sanford; John R,9999,0,9999,0
1668477187273,ECE 200,042,103627,Siegel; Paul H.,9999,0,9999,0
1668477187273,ECE 200,043,103628,Sievenpiper; Daniel F.,9999,0,9999,0
1668477187273,ECE 200,044,103629,Sworder; David D.,9999,0,9999,0
1668477187273,ECE 200,045,103630,Taur; Yuan,9999,0,9999,0
1668477187273,ECE 200,046,103631,Touri; Behrouz,9999,0,9999,0
1668477187273,ECE 200,047,103632,Trivedi; Mohan M.,9999,0,9999,0
1668477187273,ECE 200,048,103633,Vasconcelos; Nuno,9999,0,9999,0
1668477187273,ECE 200,049,103634,Wang; Xiaolong,9999,0,9999,0
1668477187273,ECE 200,050,103635,Xie; Pengtao,9999,0,9999,0
1668477187273,ECE 200,051,103636,Yip; Michael,9999,0,9999,0
1668477187273,ECE 200,052,103637,Zeger; Kenneth A.,999,0,999,0
1668477187273,ECE 200,053,103638,Zhang; Xinyu,9999,0,9999,0
1668477187273,ECE 200,054,103639,Turakhia; Yatish Girish,9999,0,9999,0
1668477187273,ECE 200,055,103640,Kang; Mingu,9999,0,9999,0
1668477187273,ECE 200,056,103641,Shi; Yuanyuan,9999,0,9999,0
1668477187273,ECE 200,057,103642,Wang; Edward Jay,9999,0,9999,0
1668477187273,ECE 200,058,103643,Zheng; Yang,9999,0,9999,0
1668477187695,ECE 202,A00,103644,Kuzum; Duygu,0,41,0,0
1668477188119,ECE 212BN,A00,103646,Ng; Tse Nga,0,9,0,0
1668477188557,ECE 221,A00,111493,Staff,0,0,0,0
1668477188991,ECE 222B,A00,103647,Lomakin; Vitaliy,0,17,0,0
1668477189416,ECE 230B,A00,103648,Taur; Yuan,0,2,0,0
1668477189856,ECE 238B,A00,103649,Garay; Javier,0,0,0,0
1668477190285,ECE 240B,A00,112900,Fainman; Yeshaiahu,0,6,0,0
1668477190709,ECE 247A,A00,103650,Jokerst; Jesse Vincent,0,5,0,0
1668477191133,ECE 247B,A00,103651,Wang; Joseph,0,11,0,0
1668477191560,ECE 250,A00,103652,Siegel; Paul H.,0,79,0,0
1668477191987,ECE 251A,A00,103654,Rao; Bhaskar D.,0,61,0,0
1668477192409,ECE 257B,A00,103655,Bharadia; Dinesh,0,32,0,0
1668477192832,ECE 258A,A00,103656,Milstein; Laurence B.,0,28,0,0
1668477193256,ECE 260B,A00,103658,Kang; Mingu,0,119,0,0
1668477193683,ECE 264A,A00,103659,Galton; Ian A,0,65,0,0
1668477194107,ECE 265A,A00,103661,Gudem; Prasad S.S.,0,64,0,0
1668477194625,ECE 265D,A00,103662,Gudem; Prasad S.S.,0,24,0,0
1668477195052,ECE 268,A00,103663,Koushanfar; Farinaz,0,42,0,0
1668477195479,ECE 269,A01,103665,Pal; Piya,0,206,0,0
1668477195905,ECE 271B,A00,103666,Vasconcelos; Manuela,0,73,0,0
1668477196327,ECE 276A,A00,103667,Atanasov; Nikolay A.,0,119,0,0
1668477196753,ECE 277,A00,103668,An; Cheolhong,0,142,0,0
1668477197176,ECE 279,A00,117947,Hall; Drew A.,0,22,0,0
1668477198027,ECE 283,A00,103670,Hsueh; Tzu-Chien,0,51,0,0
1668477198450,ECE 284,A00,103671,Turakhia; Yatish Girish,0,39,0,0
1668477198879,ECE 285,A00,103672,Zheng; Yang,0,39,0,0
1668477198879,ECE 285,B00,103673,Sworder; David D.,0,55,0,0
1668477199304,ECE 287,A00,103676,Javidi; Tara,0,8,0,0
1668477199734,MATH 200B,A00,098023,Salehi Golsefidy; Alireza,11,0,15,4
1668477200158,MATH 202B,A00,098024,Rhoades; Brendon Patrick,7,0,15,8
1668477200583,MATH 203B,A00,098025,Oprea; Dragos N.,10,0,15,5
1668477201007,MATH 204B,A00,098026,Sorensen; Claus M,13,0,15,2
1668477201434,MATH 208,A00,098027,Izadi; Elham,7,0,10,3
1668477201858,MATH 209,A00,098028,Pollack; Aaron,10,0,10,0
1668477202283,MATH 211A,A00,112919,Rogalski; Daniel,8,0,10,2
1668477202712,MATH 211B,A00,112920,Seward; Brandon M.,9,0,10,1
1668477203145,MATH 218,A00,098029,Li; Bo,10,0,10,0
1668477203570,MATH 220B,A00,098030,Novak; Jonathan I,11,0,15,4
1668477203994,MATH 221A,A00,098031,Ebenfelt; Peter F,13,0,15,2
1668477204422,MATH 231B,A00,098032,Zlatos; Andrej,11,0,15,4
1668477204847,MATH 240B,A00,098033,Ni; Lei,7,0,15,8
1668477205271,MATH 243,A00,098034,Jekel; David Andrew,10,0,10,0
1668477205693,MATH 245A,A00,098035,Nie; Jiawang,0,4,15,18
1668477206119,MATH 248,A00,098036,Bejenaru; Ioan,10,0,10,0
1668477206545,MATH 250B,A00,098037,Spolaor; Luca,14,0,15,1
1668477206974,MATH 258,A00,098038,Ni; Lei,9,0,10,1
1668477207400,MATH 264B,A00,098041,Rhoades; Brendon Patrick,8,0,15,7
1668477207826,MATH 268,A00,098042,Buss; Samuel R,10,0,10,0
1668477208250,MATH 269,A00,098043,Rhoades; Brendon Patrick,10,0,10,0
1668477208673,MATH 270B,A00,098044,Li; Bo,6,0,15,9
1668477209095,MATH 272B,A00,098045,Holst; Michael J,13,0,15,2
1668477209521,MATH 273A,A00,098046,Tian; Xiaochuan,10,0,15,5
1668477209949,MATH 275,A01,098048,Tian; Xiaochuan,6,0,10,4
1668477210372,MATH 278A,A00,098049,Holst; Michael J,7,0,10,3
1668477210794,MATH 278B,A00,098050,Cloninger; Alexander,10,0,10,0
1668477211222,MATH 278C,A00,098051,Nie; Jiawang,5,0,10,5
1668477211646,MATH 280B,A00,098052,Zheng; Tianyi,7,0,15,8
1668477212070,MATH 281B,A00,098053,Bradic; Jelena,0,2,15,15
1668477212499,MATH 282B,A00,098054,Arias-Castro; Ery,0,1,15,15
1668477212932,MATH 285,A00,098055,Fitzsimmons; Patrick J,0,2,15,17
1668477213356,MATH 287B,A00,098056,Arias-Castro; Ery,2,0,15,13
1668477213783,MATH 288,A00,098057,Agarwal; Pooja,9,0,10,1
1668477213783,MATH 288,B00,098058,Zhang; Danna,8,0,10,2
1668477213783,MATH 288,C00,098059,Williams; Ruth J,9,0,10,1
1668477214211,MATH 290B,A00,098060,Roberts; Justin Deritter,12,0,15,3
1668477214635,MATH 292,A00,098061,Belmont; Eva Kinoshita,10,0,10,0
1668477215061,MATH 295,A00,098062,Suk; Andrew Hoon,47,0,50,3
1668477215486,MATH 296,A00,098063,Novak; Jonathan I,20,0,20,0
1668477215908,MATH 297,001,098064,Gamst; Anthony Collins,9997,0,9999,2
1668477718407,COGS 205,A00,101395,Chiba; Andrea,19,0,20,1
1668477718832,COGS 210B,001,101404,Greene; Deanna Jacquelyn,9998,0,9999,1
1668477718832,COGS 210B,002,101417,Xia; Haijun,9999,0,9999,0
1668477718832,COGS 210B,003,101422,Nitz; Douglas A.,9999,0,9999,0
1668477718832,COGS 210B,004,101423,Hollan; James D.,9998,0,9999,1
1668477718832,COGS 210B,005,101424,Deak; Gedeon O.,9998,0,9999,1
1668477718832,COGS 210B,006,101425,Rossano; Federico,9999,0,9999,0
1668477719255,COGS 211B,A00,101427,Coulson; Seana M,9996,0,9999,3
1668477719685,COGS 220,A00,101428,Hollan; James D.,1,9,25,24
1668477720127,COGS 229,A00,101429,Dow; Steven P,17,0,25,8
1668477720550,COGS 230,A00,101430,Klemmer; Scott R,8,0,17,9
1668477720979,COGS 234,A00,101431,Xia; Haijun,2,0,25,23
1668477721404,COGS 260,A00,101432,Kiyonaga; Anastasia,21,0,25,4
1668477721404,COGS 260,B00,101433,Kirsh; David Joel,15,0,25,10
1668477721828,CSE 202,A00,102371,Impagliazzo; Russell,0,59,0,0
1668477722251,CSE 203B,A01,102373,Cheng; Chung Kuan,0,51,0,0
1668477722681,CSE 208,A00,102374,Micciancio; Daniele,0,4,0,0
1668477723114,CSE 209A,A00,112895,Impagliazzo; Russell,0,12,15,15
1668477723536,CSE 209B,A00,108005,Bellare; Mihir,0,6,0,0
1668477724014,CSE 210,A00,113163,Coblenz; Michael J,0,79,0,0
1668477724442,CSE 219,A00,106111,Dow; Steven P,0,6,20,20
1668477724870,CSE 221,A00,102376,Voelker; Geoffrey M.,0,67,0,0
1668477725294,CSE 224,A01,102378,Porter; George M,0,159,0,0
1668477725718,CSE 229A,A00,102379,Savage; Stefan,0,10,0,0
1668477726142,CSE 229C,A00,102380,Munyaka; Imani N. S.,0,9,0,0
1668477726567,CSE 232B,A00,102382,Deutsch; Alin Bernard,0,30,0,0
1668477726994,CSE 234,A01,112904,Kumar; Arun Kumar,0,0,0,0
1668477727417,CSE 237A,A00,102383,Rosing; Tajana Simunic,0,47,0,0
1668477727841,CSE 239A,A00,102384,Deutsch; Alin Bernard,0,12,0,0
1668477728266,CSE 239B,A00,102385,Polikarpova; Nadezhda,0,10,0,0
1668477728691,CSE 240A,A00,102386,Pannuto; Patrick William,0,43,0,0
1668477729127,CSE 240B,A00,102387,Zhao; Jishen,0,42,0,0
1668477729561,CSE 241A,A00,106406,Kang; Mingu,0,6,0,0
1668477729987,CSE 249B,A00,102388,Kahng; Andrew Byun,0,5,8,8
1668477730412,CSE 251B,A01,102392,Cottrell; Garrison W,0,44,0,0
1668477730412,CSE 251B,A02,102393,Cottrell; Garrison W,0,33,0,0
1668477730837,CSE 252B,A00,102394,Ochoa; Benjamin Lawrence,0,55,0,0
1668477731262,CSE 257,A01,102396,Gao; Sicun,0,129,0,0
1668477731686,CSE 272,A00,102397,Li; Tzumao,0,17,0,0
1668477732110,CSE 274,A00,111323,Chern; Albert Ren-Haur,0,14,0,0
1668477732534,CSE 282,A00,102398,Pevzner; Pavel Arkadjevich,0,0,0,0
1668477732958,CSE 284,A00,114175,Gymrek; Melissa Ann,0,19,0,0
1668477733385,CSE 290,A00,102399,Chandraker; Manmohan Krishna,0,11,0,0
1668477733385,CSE 290,B00,102400,Vaccaro; Kristen Marie,0,7,25,25
1668477733385,CSE 290,C00,102414,Pannuto; Patrick William,0,1,25,25
1668477733385,CSE 290,D00,102427,Pevzner; Pavel Arkadjevich,0,0,0,0
1668477733385,CSE 290,E00,102429,Zhao; Jishen,0,4,0,0
1668477733385,CSE 290,F00,102436,Tullsen; Dean Michael,0,5,0,0
1668477733385,CSE 290,G00,102440,Christensen; Henrik I,0,6,20,20
1668477733808,CSE 291,A00,102443,Su; Hao,0,0,0,0
1668477733808,CSE 291,B00,102448,Polikarpova; Nadezhda,0,0,0,0
1668477733808,CSE 291,C00,102453,Vaccaro; Kristen Marie,0,0,0,0
1668477733808,CSE 291,D00,111343,Savage; Stefan,0,0,0,0
1668477733808,CSE 291,E00,116474,Claffy; Kimberly Claire,0,0,0,0
1668477733808,CSE 291,F00,116479,Pasquale; Joseph,0,0,0,0
1668477734239,CSE 293,001,119111,Bafna; Vineet,9999,0,9999,0
1668477734239,CSE 293,002,119118,Bellare; Mihir,9999,0,9999,0
1668477734239,CSE 293,003,119122,Berg-Kirkpatrick; Taylor D,9999,0,9999,0
1668477734239,CSE 293,004,119135,Christensen; Henrik I,9999,0,9999,0
1668477734239,CSE 293,005,119142,Cottrell; Garrison W,9999,0,9999,0
1668477734239,CSE 293,006,119146,Deutsch; Alin Bernard,9999,0,9999,0
1668477734239,CSE 293,007,119159,Esmaeilzadeh; Hadi,9999,0,9999,0
1668477734239,CSE 293,008,119166,Freund; Yoav,9999,0,9999,0
1668477734239,CSE 293,009,119170,Griswold; William G.,9999,0,9999,0
1668477734239,CSE 293,010,119183,Gymrek; Melissa Ann,9999,0,9999,0
1668477734239,CSE 293,011,119190,Heninger; Nadia A,9999,0,9999,0
1668477734239,CSE 293,012,119230,Impagliazzo; Russell,9999,0,9999,0
1668477734239,CSE 293,013,119232,Jhala; Ranjit,9999,0,9999,0
1668477734239,CSE 293,014,119233,Kahng; Andrew Byun,9999,0,9999,0
1668477734239,CSE 293,015,119298,Kane; Daniel Mertz,9999,0,9999,0
1668477734239,CSE 293,016,119299,Kriegman; David J,9999,0,9999,0
1668477734239,CSE 293,017,119300,Kumar; Arun Kumar,9999,0,9999,0
1668477734239,CSE 293,018,119301,Lerner; Sorin,9999,0,9999,0
1668477734239,CSE 293,019,119302,Lovett; Shachar,9999,0,9999,0
1668477734239,CSE 293,020,119303,McAuley; Julian John,9999,0,9999,0
1668477734239,CSE 293,021,119304,Micciancio; Daniele,9999,0,9999,0
1668477734239,CSE 293,022,119367,Orailoglu; Alex,9999,0,9999,0
1668477734239,CSE 293,023,119382,Paturi; Ramamohan,9999,0,9999,0
1668477734239,CSE 293,024,119404,Polikarpova; Nadezhda,9999,0,9999,0
1668477734239,CSE 293,025,119406,Politz; Joseph Gibbs,9999,0,9999,0
1668477734239,CSE 293,026,119411,Porter; George M,9999,0,9999,0
1668477734239,CSE 293,027,119414,Porter; Leonard Emerson,9999,0,9999,0
1668477734239,CSE 293,028,119416,Ramamoorthi; Ravi,9999,0,9999,0
1668477734239,CSE 293,029,119417,Sahoo; Debashis,9999,0,9999,0
1668477734239,CSE 293,030,119420,Saul; Lawrence,9999,0,9999,0
1668477734239,CSE 293,031,119421,Savage; Stefan,9999,0,9999,0
1668477734239,CSE 293,032,119425,Schulze; Jurgen P.,9999,0,9999,0
1668477734239,CSE 293,033,119426,Snoeren; Alex C.,9999,0,9999,0
1668477734239,CSE 293,034,119428,Shang; Jingbo,9999,0,9999,0
1668477734239,CSE 293,035,119430,Stefan; Deian,9999,0,9999,0
1668477734239,CSE 293,036,119431,Su; Hao,9999,0,9999,0
1668477734239,CSE 293,037,119433,Swanson; Steven James,9999,0,9999,0
1668477734239,CSE 293,038,119435,Tullsen; Dean Michael,9999,0,9999,0
1668477734239,CSE 293,039,119483,Voelker; Geoffrey M.,9999,0,9999,0
1668477734239,CSE 293,040,119537,Zhao; Jishen,9999,0,9999,0
1668477734239,CSE 293,041,119538,Zhou; Yuan-Yuan,9999,0,9999,0
1668477734239,CSE 293,042,119539,Gao; Sicun,9999,0,9999,0
1668477734239,CSE 293,043,119540,Weibel; Nadir,9999,0,9999,0
1668477734239,CSE 293,044,119541,Gupta; Rajesh K.,9999,0,9999,0
1668477734239,CSE 293,045,126410,Vaccaro; Kristen Marie,9999,0,9999,0
1668477734239,CSE 293,046,126411,Klemke; Richard,9999,0,9999,0
1668477734662,CSE 294,A00,102459,Voelker; Geoffrey M.,0,2,0,0
1668477734662,CSE 294,B00,111322,Orailoglu; Alex,0,2,0,0
1668477735086,DSE 201,A00,096914,Deutsch; Alin Bernard,30,0,30,0
1668477735517,DSE 210,A00,096915,Dasgupta; Sanjoy,30,0,30,0
1668477735941,DSE 260A,A00,096916,Altintas De Callaf; Ilkay,30,0,30,0
1668477736398,ECE 200,001,103586,Antipa; Nicholas A,9999,0,9999,0
1668477736398,ECE 200,002,103587,Atanasov; Nikolay A.,9999,0,9999,0
1668477736398,ECE 200,003,103588,Bharadia; Dinesh,9999,0,9999,0
1668477736398,ECE 200,004,103589,Cheng; Chung Kuan,9999,0,9999,0
1668477736398,ECE 200,005,103590,Cosman; Pamela C.,9999,0,9999,0
1668477736398,ECE 200,006,103591,Dayeh; Shadi Ahmad,9999,0,9999,0
1668477736398,ECE 200,007,103592,Fainman; Yeshaiahu,9999,0,9999,0
1668477736398,ECE 200,008,103593,Ford; Joseph Earl,9999,0,9999,0
1668477736398,ECE 200,009,103594,Franceschetti; Massimo,9999,0,9999,0
1668477736398,ECE 200,010,103595,Fullerton; Eric E,9999,0,9999,0
1668477736398,ECE 200,011,103596,Galton; Ian A,9999,0,9999,0
1668477736398,ECE 200,012,103597,Gilja; Vikash,9999,0,9999,0
1668477736398,ECE 200,013,103598,Hall; Drew A.,9999,0,9999,0
1668477736398,ECE 200,014,103599,Hsueh; Tzu-Chien,9999,0,9999,0
1668477736398,ECE 200,015,103600,Javidi; Tara,9999,0,9999,0
1668477736398,ECE 200,016,103601,Kahng; Andrew Byun,9999,0,9999,0
1668477736398,ECE 200,017,103602,Kim; Young-Han,9999,0,9999,0
1668477736398,ECE 200,018,103603,Koushanfar; Farinaz,9999,0,9999,0
1668477736398,ECE 200,019,103604,Kuzum; Duygu,9999,0,9999,0
1668477736398,ECE 200,020,103605,Le; Hanh-Phuc,9999,0,9999,0
1668477736398,ECE 200,021,103606,Lin; Bill,9999,0,9999,0
1668477736398,ECE 200,022,103607,Liu; Zhaowei,9998,0,9999,1
1668477736398,ECE 200,023,103608,Lo; Yu-Hwa,9999,0,9999,0
1668477736398,ECE 200,024,103609,Lomakin; Vitaliy,9999,0,9999,0
1668477736398,ECE 200,025,103610,Mercier; Patrick Philip,9999,0,9999,0
1668477736398,ECE 200,026,103611,Meyer; Florian,9999,0,9999,0
1668477736398,ECE 200,027,103612,Milstein; Laurence B.,9999,0,9999,0
1668477736398,ECE 200,028,103613,Mir Arabbaygi; Siavash,9999,0,9999,0
1668477736398,ECE 200,029,103614,Mookherjea; Shayan,9999,0,9999,0
1668477736398,ECE 200,030,103615,Morris; Karcher William,9999,0,9999,0
1668477736398,ECE 200,031,103616,Ng; Tse Nga,9999,0,9999,0
1668477736398,ECE 200,032,103617,Nguyen; Truong Quang,9999,0,9999,0
1668477736398,ECE 200,033,103618,Nomura; Kenji,9999,0,9999,0
1668477736398,ECE 200,034,103619,Orlitsky; Alon,9999,0,9999,0
1668477736398,ECE 200,035,103620,Pal; Piya,9999,0,9999,0
1668477736398,ECE 200,036,103621,Papen; George C.,9999,0,9999,0
1668477736398,ECE 200,037,103622,Radic; Stojan,9999,0,9999,0
1668477736398,ECE 200,038,103623,Rao; Bhaskar D.,9999,0,9999,0
1668477736398,ECE 200,039,103624,Rao; Ramesh R,9999,0,9999,0
1668477736398,ECE 200,040,103625,Rebeiz; Gabriel,9999,0,9999,0
1668477736398,ECE 200,041,103626,Sanford; John R,9999,0,9999,0
1668477736398,ECE 200,042,103627,Siegel; Paul H.,9999,0,9999,0
1668477736398,ECE 200,043,103628,Sievenpiper; Daniel F.,9999,0,9999,0
1668477736398,ECE 200,044,103629,Sworder; David D.,9999,0,9999,0
1668477736398,ECE 200,045,103630,Taur; Yuan,9999,0,9999,0
1668477736398,ECE 200,046,103631,Touri; Behrouz,9999,0,9999,0
1668477736398,ECE 200,047,103632,Trivedi; Mohan M.,9999,0,9999,0
1668477736398,ECE 200,048,103633,Vasconcelos; Nuno,9999,0,9999,0
1668477736398,ECE 200,049,103634,Wang; Xiaolong,9999,0,9999,0
1668477736398,ECE 200,050,103635,Xie; Pengtao,9999,0,9999,0
1668477736398,ECE 200,051,103636,Yip; Michael,9999,0,9999,0
1668477736398,ECE 200,052,103637,Zeger; Kenneth A.,999,0,999,0
1668477736398,ECE 200,053,103638,Zhang; Xinyu,9999,0,9999,0
1668477736398,ECE 200,054,103639,Turakhia; Yatish Girish,9999,0,9999,0
1668477736398,ECE 200,055,103640,Kang; Mingu,9999,0,9999,0
1668477736398,ECE 200,056,103641,Shi; Yuanyuan,9999,0,9999,0
1668477736398,ECE 200,057,103642,Wang; Edward Jay,9999,0,9999,0
1668477736398,ECE 200,058,103643,Zheng; Yang,9999,0,9999,0
1668477736822,ECE 202,A00,103644,Kuzum; Duygu,0,41,0,0
1668477737245,ECE 212BN,A00,103646,Ng; Tse Nga,0,9,0,0
1668477737670,ECE 221,A00,111493,Staff,0,0,0,0
1668477738099,ECE 222B,A00,103647,Lomakin; Vitaliy,0,17,0,0
1668477738529,ECE 230B,A00,103648,Taur; Yuan,0,2,0,0
1668477738954,ECE 238B,A00,103649,Garay; Javier,0,0,0,0
1668477739378,ECE 240B,A00,112900,Fainman; Yeshaiahu,0,6,0,0
1668477739804,ECE 247A,A00,103650,Jokerst; Jesse Vincent,0,5,0,0
1668477740238,ECE 247B,A00,103651,Wang; Joseph,0,11,0,0
1668477740666,ECE 250,A00,103652,Siegel; Paul H.,0,79,0,0
1668477741091,ECE 251A,A00,103654,Rao; Bhaskar D.,0,61,0,0
1668477741518,ECE 257B,A00,103655,Bharadia; Dinesh,0,32,0,0
1668477741941,ECE 258A,A00,103656,Milstein; Laurence B.,0,28,0,0
1668477742367,ECE 260B,A00,103658,Kang; Mingu,0,119,0,0
1668477742796,ECE 264A,A00,103659,Galton; Ian A,0,65,0,0
1668477743224,ECE 265A,A00,103661,Gudem; Prasad S.S.,0,64,0,0
1668477743651,ECE 265D,A00,103662,Gudem; Prasad S.S.,0,24,0,0
1668477744076,ECE 268,A00,103663,Koushanfar; Farinaz,0,42,0,0
1668477744504,ECE 269,A01,103665,Pal; Piya,0,207,0,0
1668477744940,ECE 271B,A00,103666,Vasconcelos; Manuela,0,73,0,0
1668477745367,ECE 276A,A00,103667,Atanasov; Nikolay A.,0,120,0,0
1668477745796,ECE 277,A00,103668,An; Cheolhong,0,143,0,0
1668477746228,ECE 279,A00,117947,Hall; Drew A.,0,22,0,0
1668477747079,ECE 283,A00,103670,Hsueh; Tzu-Chien,0,51,0,0
1668477747507,ECE 284,A00,103671,Turakhia; Yatish Girish,0,39,0,0
1668477747931,ECE 285,A00,103672,Zheng; Yang,0,39,0,0
1668477747931,ECE 285,B00,103673,Sworder; David D.,0,55,0,0
1668477748359,ECE 287,A00,103676,Javidi; Tara,0,8,0,0
1668477748794,MATH 200B,A00,098023,Salehi Golsefidy; Alireza,11,0,15,4
1668477749220,MATH 202B,A00,098024,Rhoades; Brendon Patrick,7,0,15,8
1668477749643,MATH 203B,A00,098025,Oprea; Dragos N.,10,0,15,5
1668477750065,MATH 204B,A00,098026,Sorensen; Claus M,13,0,15,2
1668477750499,MATH 208,A00,098027,Izadi; Elham,7,0,10,3
1668477750928,MATH 209,A00,098028,Pollack; Aaron,10,0,10,0
1668477751351,MATH 211A,A00,112919,Rogalski; Daniel,8,0,10,2
1668477751777,MATH 211B,A00,112920,Seward; Brandon M.,9,0,10,1
1668477752210,MATH 218,A00,098029,Li; Bo,10,0,10,0
1668477752650,MATH 220B,A00,098030,Novak; Jonathan I,11,0,15,4
1668477753076,MATH 221A,A00,098031,Ebenfelt; Peter F,13,0,15,2
1668477753499,MATH 231B,A00,098032,Zlatos; Andrej,11,0,15,4
1668477753927,MATH 240B,A00,098033,Ni; Lei,7,0,15,8
1668477754351,MATH 243,A00,098034,Jekel; David Andrew,10,0,10,0
1668477754783,MATH 245A,A00,098035,Nie; Jiawang,0,4,15,18
1668477755211,MATH 248,A00,098036,Bejenaru; Ioan,10,0,10,0
1668477755644,MATH 250B,A00,098037,Spolaor; Luca,14,0,15,1
1668477756089,MATH 258,A00,098038,Ni; Lei,9,0,10,1
1668477756512,MATH 264B,A00,098041,Rhoades; Brendon Patrick,8,0,15,7
1668477756936,MATH 268,A00,098042,Buss; Samuel R,10,0,10,0
1668477757362,MATH 269,A00,098043,Rhoades; Brendon Patrick,10,0,10,0
1668477757797,MATH 270B,A00,098044,Li; Bo,6,0,15,9
1668477758222,MATH 272B,A00,098045,Holst; Michael J,13,0,15,2
1668477758646,MATH 273A,A00,098046,Tian; Xiaochuan,10,0,15,5
1668477759154,MATH 275,A01,098048,Tian; Xiaochuan,6,0,10,4
1668477759579,MATH 278A,A00,098049,Holst; Michael J,7,0,10,3
1668477760005,MATH 278B,A00,098050,Cloninger; Alexander,10,0,10,0
1668477760432,MATH 278C,A00,098051,Nie; Jiawang,5,0,10,5
1668477760855,MATH 280B,A00,098052,Zheng; Tianyi,7,0,15,8
1668477761281,MATH 281B,A00,098053,Bradic; Jelena,0,2,15,15
1668477761707,MATH 282B,A00,098054,Arias-Castro; Ery,0,1,15,15
1668477762131,MATH 285,A00,098055,Fitzsimmons; Patrick J,0,2,15,17
1668477762557,MATH 287B,A00,098056,Arias-Castro; Ery,2,0,15,13
1668477762983,MATH 288,A00,098057,Agarwal; Pooja,9,0,10,1
1668477762983,MATH 288,B00,098058,Zhang; Danna,8,0,10,2
1668477762983,MATH 288,C00,098059,Williams; Ruth J,9,0,10,1
1668477763416,MATH 290B,A00,098060,Roberts; Justin Deritter,12,0,15,3
1668477763838,MATH 292,A00,098061,Belmont; Eva Kinoshita,10,0,10,0
1668477764266,MATH 295,A00,098062,Suk; Andrew Hoon,47,0,50,3
1668477764690,MATH 296,A00,098063,Novak; Jonathan I,20,0,20,0
1668477765117,MATH 297,001,098064,Gamst; Anthony Collins,9997,0,9999,2
1668478267115,COGS 205,A00,101395,Chiba; Andrea,19,0,20,1
1668478267542,COGS 210B,001,101404,Greene; Deanna Jacquelyn,9998,0,9999,1
1668478267542,COGS 210B,002,101417,Xia; Haijun,9999,0,9999,0
1668478267542,COGS 210B,003,101422,Nitz; Douglas A.,9999,0,9999,0
1668478267542,COGS 210B,004,101423,Hollan; James D.,9998,0,9999,1
1668478267542,COGS 210B,005,101424,Deak; Gedeon O.,9998,0,9999,1
1668478267542,COGS 210B,006,101425,Rossano; Federico,9999,0,9999,0
1668478267970,COGS 211B,A00,101427,Coulson; Seana M,9996,0,9999,3
1668478268398,COGS 220,A00,101428,Hollan; James D.,1,9,25,24
1668478268825,COGS 229,A00,101429,Dow; Steven P,17,0,25,8
1668478269250,COGS 230,A00,101430,Klemmer; Scott R,8,0,17,9
1668478269679,COGS 234,A00,101431,Xia; Haijun,2,0,25,23
1668478270105,COGS 260,A00,101432,Kiyonaga; Anastasia,21,0,25,4
1668478270105,COGS 260,B00,101433,Kirsh; David Joel,15,0,25,10
1668478270531,CSE 202,A00,102371,Impagliazzo; Russell,0,59,0,0
1668478270956,CSE 203B,A01,102373,Cheng; Chung Kuan,0,51,0,0
1668478271379,CSE 208,A00,102374,Micciancio; Daniele,0,4,0,0
1668478271813,CSE 209A,A00,112895,Impagliazzo; Russell,0,12,15,15
1668478272238,CSE 209B,A00,108005,Bellare; Mihir,0,6,0,0
1668478272664,CSE 210,A00,113163,Coblenz; Michael J,0,79,0,0
1668478273090,CSE 219,A00,106111,Dow; Steven P,0,6,20,20
1668478273517,CSE 221,A00,102376,Voelker; Geoffrey M.,0,67,0,0
1668478273939,CSE 224,A01,102378,Porter; George M,0,159,0,0
1668478274363,CSE 229A,A00,102379,Savage; Stefan,0,10,0,0
1668478274789,CSE 229C,A00,102380,Munyaka; Imani N. S.,0,9,0,0
1668478275214,CSE 232B,A00,102382,Deutsch; Alin Bernard,0,30,0,0
1668478275641,CSE 234,A01,112904,Kumar; Arun Kumar,0,0,0,0
1668478276066,CSE 237A,A00,102383,Rosing; Tajana Simunic,0,47,0,0
1668478276492,CSE 239A,A00,102384,Deutsch; Alin Bernard,0,12,0,0
1668478276917,CSE 239B,A00,102385,Polikarpova; Nadezhda,0,10,0,0
1668478277342,CSE 240A,A00,102386,Pannuto; Patrick William,0,43,0,0
1668478277774,CSE 240B,A00,102387,Zhao; Jishen,0,42,0,0
1668478278198,CSE 241A,A00,106406,Kang; Mingu,0,6,0,0
1668478278633,CSE 249B,A00,102388,Kahng; Andrew Byun,0,5,8,8
1668478279061,CSE 251B,A01,102392,Cottrell; Garrison W,0,44,0,0
1668478279061,CSE 251B,A02,102393,Cottrell; Garrison W,0,33,0,0
1668478279487,CSE 252B,A00,102394,Ochoa; Benjamin Lawrence,0,55,0,0
1668478280002,CSE 257,A01,102396,Gao; Sicun,0,129,0,0
1668478280425,CSE 272,A00,102397,Li; Tzumao,0,17,0,0
1668478280848,CSE 274,A00,111323,Chern; Albert Ren-Haur,0,14,0,0
1668478281274,CSE 282,A00,102398,Pevzner; Pavel Arkadjevich,0,0,0,0
1668478281706,CSE 284,A00,114175,Gymrek; Melissa Ann,0,19,0,0
1668478282132,CSE 290,A00,102399,Chandraker; Manmohan Krishna,0,11,0,0
1668478282132,CSE 290,B00,102400,Vaccaro; Kristen Marie,0,7,25,25
1668478282132,CSE 290,C00,102414,Pannuto; Patrick William,0,1,25,25
1668478282132,CSE 290,D00,102427,Pevzner; Pavel Arkadjevich,0,0,0,0
1668478282132,CSE 290,E00,102429,Zhao; Jishen,0,4,0,0
1668478282132,CSE 290,F00,102436,Tullsen; Dean Michael,0,5,0,0
1668478282132,CSE 290,G00,102440,Christensen; Henrik I,0,6,20,20
1668478282573,CSE 291,A00,102443,Su; Hao,0,0,0,0
1668478282573,CSE 291,B00,102448,Polikarpova; Nadezhda,0,0,0,0
1668478282573,CSE 291,C00,102453,Vaccaro; Kristen Marie,0,0,0,0
1668478282573,CSE 291,D00,111343,Savage; Stefan,0,0,0,0
1668478282573,CSE 291,E00,116474,Claffy; Kimberly Claire,0,0,0,0
1668478282573,CSE 291,F00,116479,Pasquale; Joseph,0,0,0,0
1668478283014,CSE 293,001,119111,Bafna; Vineet,9999,0,9999,0
1668478283014,CSE 293,002,119118,Bellare; Mihir,9999,0,9999,0
1668478283014,CSE 293,003,119122,Berg-Kirkpatrick; Taylor D,9999,0,9999,0
1668478283014,CSE 293,004,119135,Christensen; Henrik I,9999,0,9999,0
1668478283014,CSE 293,005,119142,Cottrell; Garrison W,9999,0,9999,0
1668478283014,CSE 293,006,119146,Deutsch; Alin Bernard,9999,0,9999,0
1668478283014,CSE 293,007,119159,Esmaeilzadeh; Hadi,9999,0,9999,0
1668478283014,CSE 293,008,119166,Freund; Yoav,9999,0,9999,0
1668478283014,CSE 293,009,119170,Griswold; William G.,9999,0,9999,0
1668478283014,CSE 293,010,119183,Gymrek; Melissa Ann,9999,0,9999,0
1668478283014,CSE 293,011,119190,Heninger; Nadia A,9999,0,9999,0
1668478283014,CSE 293,012,119230,Impagliazzo; Russell,9999,0,9999,0
1668478283014,CSE 293,013,119232,Jhala; Ranjit,9999,0,9999,0
1668478283014,CSE 293,014,119233,Kahng; Andrew Byun,9999,0,9999,0
1668478283014,CSE 293,015,119298,Kane; Daniel Mertz,9999,0,9999,0
1668478283014,CSE 293,016,119299,Kriegman; David J,9999,0,9999,0
1668478283014,CSE 293,017,119300,Kumar; Arun Kumar,9999,0,9999,0
1668478283014,CSE 293,018,119301,Lerner; Sorin,9999,0,9999,0
1668478283014,CSE 293,019,119302,Lovett; Shachar,9999,0,9999,0
1668478283014,CSE 293,020,119303,McAuley; Julian John,9999,0,9999,0
1668478283014,CSE 293,021,119304,Micciancio; Daniele,9999,0,9999,0
1668478283014,CSE 293,022,119367,Orailoglu; Alex,9999,0,9999,0
1668478283014,CSE 293,023,119382,Paturi; Ramamohan,9999,0,9999,0
1668478283014,CSE 293,024,119404,Polikarpova; Nadezhda,9999,0,9999,0
1668478283014,CSE 293,025,119406,Politz; Joseph Gibbs,9999,0,9999,0
1668478283014,CSE 293,026,119411,Porter; George M,9999,0,9999,0
1668478283014,CSE 293,027,119414,Porter; Leonard Emerson,9999,0,9999,0
1668478283014,CSE 293,028,119416,Ramamoorthi; Ravi,9999,0,9999,0
1668478283014,CSE 293,029,119417,Sahoo; Debashis,9999,0,9999,0
1668478283014,CSE 293,030,119420,Saul; Lawrence,9999,0,9999,0
1668478283014,CSE 293,031,119421,Savage; Stefan,9999,0,9999,0
1668478283014,CSE 293,032,119425,Schulze; Jurgen P.,9999,0,9999,0
1668478283014,CSE 293,033,119426,Snoeren; Alex C.,9999,0,9999,0
1668478283014,CSE 293,034,119428,Shang; Jingbo,9999,0,9999,0
1668478283014,CSE 293,035,119430,Stefan; Deian,9999,0,9999,0
1668478283014,CSE 293,036,119431,Su; Hao,9999,0,9999,0
1668478283014,CSE 293,037,119433,Swanson; Steven James,9999,0,9999,0
1668478283014,CSE 293,038,119435,Tullsen; Dean Michael,9999,0,9999,0
1668478283014,CSE 293,039,119483,Voelker; Geoffrey M.,9999,0,9999,0
1668478283014,CSE 293,040,119537,Zhao; Jishen,9999,0,9999,0
1668478283014,CSE 293,041,119538,Zhou; Yuan-Yuan,9999,0,9999,0
1668478283014,CSE 293,042,119539,Gao; Sicun,9999,0,9999,0
1668478283014,CSE 293,043,119540,Weibel; Nadir,9999,0,9999,0
1668478283014,CSE 293,044,119541,Gupta; Rajesh K.,9999,0,9999,0
1668478283014,CSE 293,045,126410,Vaccaro; Kristen Marie,9999,0,9999,0
1668478283014,CSE 293,046,126411,Klemke; Richard,9999,0,9999,0
1668478283438,CSE 294,A00,102459,Voelker; Geoffrey M.,0,2,0,0
1668478283438,CSE 294,B00,111322,Orailoglu; Alex,0,2,0,0
1668478283864,DSE 201,A00,096914,Deutsch; Alin Bernard,30,0,30,0
1668478284288,DSE 210,A00,096915,Dasgupta; Sanjoy,30,0,30,0
1668478284716,DSE 260A,A00,096916,Altintas De Callaf; Ilkay,30,0,30,0
1668478285144,ECE 200,001,103586,Antipa; Nicholas A,9999,0,9999,0
1668478285144,ECE 200,002,103587,Atanasov; Nikolay A.,9999,0,9999,0
1668478285144,ECE 200,003,103588,Bharadia; Dinesh,9999,0,9999,0
1668478285144,ECE 200,004,103589,Cheng; Chung Kuan,9999,0,9999,0
1668478285144,ECE 200,005,103590,Cosman; Pamela C.,9999,0,9999,0
1668478285144,ECE 200,006,103591,Dayeh; Shadi Ahmad,9999,0,9999,0
1668478285144,ECE 200,007,103592,Fainman; Yeshaiahu,9999,0,9999,0
1668478285144,ECE 200,008,103593,Ford; Joseph Earl,9999,0,9999,0
1668478285144,ECE 200,009,103594,Franceschetti; Massimo,9999,0,9999,0
1668478285144,ECE 200,010,103595,Fullerton; Eric E,9999,0,9999,0
1668478285144,ECE 200,011,103596,Galton; Ian A,9999,0,9999,0
1668478285144,ECE 200,012,103597,Gilja; Vikash,9999,0,9999,0
1668478285144,ECE 200,013,103598,Hall; Drew A.,9999,0,9999,0
1668478285144,ECE 200,014,103599,Hsueh; Tzu-Chien,9999,0,9999,0
1668478285144,ECE 200,015,103600,Javidi; Tara,9999,0,9999,0
1668478285144,ECE 200,016,103601,Kahng; Andrew Byun,9999,0,9999,0
1668478285144,ECE 200,017,103602,Kim; Young-Han,9999,0,9999,0
1668478285144,ECE 200,018,103603,Koushanfar; Farinaz,9999,0,9999,0
1668478285144,ECE 200,019,103604,Kuzum; Duygu,9999,0,9999,0
1668478285144,ECE 200,020,103605,Le; Hanh-Phuc,9999,0,9999,0
1668478285144,ECE 200,021,103606,Lin; Bill,9999,0,9999,0
1668478285144,ECE 200,022,103607,Liu; Zhaowei,9998,0,9999,1
1668478285144,ECE 200,023,103608,Lo; Yu-Hwa,9999,0,9999,0
1668478285144,ECE 200,024,103609,Lomakin; Vitaliy,9999,0,9999,0
1668478285144,ECE 200,025,103610,Mercier; Patrick Philip,9999,0,9999,0
1668478285144,ECE 200,026,103611,Meyer; Florian,9999,0,9999,0
1668478285144,ECE 200,027,103612,Milstein; Laurence B.,9999,0,9999,0
1668478285144,ECE 200,028,103613,Mir Arabbaygi; Siavash,9999,0,9999,0
1668478285144,ECE 200,029,103614,Mookherjea; Shayan,9999,0,9999,0
1668478285144,ECE 200,030,103615,Morris; Karcher William,9999,0,9999,0
1668478285144,ECE 200,031,103616,Ng; Tse Nga,9999,0,9999,0
1668478285144,ECE 200,032,103617,Nguyen; Truong Quang,9999,0,9999,0
1668478285144,ECE 200,033,103618,Nomura; Kenji,9999,0,9999,0
1668478285144,ECE 200,034,103619,Orlitsky; Alon,9999,0,9999,0
1668478285144,ECE 200,035,103620,Pal; Piya,9999,0,9999,0
1668478285144,ECE 200,036,103621,Papen; George C.,9999,0,9999,0
1668478285144,ECE 200,037,103622,Radic; Stojan,9999,0,9999,0
1668478285144,ECE 200,038,103623,Rao; Bhaskar D.,9999,0,9999,0
1668478285144,ECE 200,039,103624,Rao; Ramesh R,9999,0,9999,0
1668478285144,ECE 200,040,103625,Rebeiz; Gabriel,9999,0,9999,0
1668478285144,ECE 200,041,103626,Sanford; John R,9999,0,9999,0
1668478285144,ECE 200,042,103627,Siegel; Paul H.,9999,0,9999,0
1668478285144,ECE 200,043,103628,Sievenpiper; Daniel F.,9999,0,9999,0
1668478285144,ECE 200,044,103629,Sworder; David D.,9999,0,9999,0
1668478285144,ECE 200,045,103630,Taur; Yuan,9999,0,9999,0
1668478285144,ECE 200,046,103631,Touri; Behrouz,9999,0,9999,0
1668478285144,ECE 200,047,103632,Trivedi; Mohan M.,9999,0,9999,0
1668478285144,ECE 200,048,103633,Vasconcelos; Nuno,9999,0,9999,0
1668478285144,ECE 200,049,103634,Wang; Xiaolong,9999,0,9999,0
1668478285144,ECE 200,050,103635,Xie; Pengtao,9999,0,9999,0
1668478285144,ECE 200,051,103636,Yip; Michael,9999,0,9999,0
1668478285144,ECE 200,052,103637,Zeger; Kenneth A.,999,0,999,0
1668478285144,ECE 200,053,103638,Zhang; Xinyu,9999,0,9999,0
1668478285144,ECE 200,054,103639,Turakhia; Yatish Girish,9999,0,9999,0
1668478285144,ECE 200,055,103640,Kang; Mingu,9999,0,9999,0
1668478285144,ECE 200,056,103641,Shi; Yuanyuan,9999,0,9999,0
1668478285144,ECE 200,057,103642,Wang; Edward Jay,9999,0,9999,0
1668478285144,ECE 200,058,103643,Zheng; Yang,9999,0,9999,0
1668478285571,ECE 202,A00,103644,Kuzum; Duygu,0,41,0,0
1668478285993,ECE 212BN,A00,103646,Ng; Tse Nga,0,9,0,0
1668478286419,ECE 221,A00,111493,Staff,0,0,0,0
1668478286844,ECE 222B,A00,103647,Lomakin; Vitaliy,0,18,0,0
1668478287268,ECE 230B,A00,103648,Taur; Yuan,0,2,0,0
1668478287692,ECE 238B,A00,103649,Garay; Javier,0,0,0,0
1668478288118,ECE 240B,A00,112900,Fainman; Yeshaiahu,0,6,0,0
1668478288544,ECE 247A,A00,103650,Jokerst; Jesse Vincent,0,5,0,0
1668478288968,ECE 247B,A00,103651,Wang; Joseph,0,11,0,0
1668478289393,ECE 250,A00,103652,Siegel; Paul H.,0,80,0,0
1668478289828,ECE 251A,A00,103654,Rao; Bhaskar D.,0,61,0,0
1668478290254,ECE 257B,A00,103655,Bharadia; Dinesh,0,32,0,0
1668478290678,ECE 258A,A00,103656,Milstein; Laurence B.,0,28,0,0
1668478291106,ECE 260B,A00,103658,Kang; Mingu,0,119,0,0
1668478291529,ECE 264A,A00,103659,Galton; Ian A,0,66,0,0
1668478291960,ECE 265A,A00,103661,Gudem; Prasad S.S.,0,65,0,0
1668478292387,ECE 265D,A00,103662,Gudem; Prasad S.S.,0,24,0,0
1668478292821,ECE 268,A00,103663,Koushanfar; Farinaz,0,42,0,0
1668478293247,ECE 269,A01,103665,Pal; Piya,0,208,0,0
1668478293670,ECE 271B,A00,103666,Vasconcelos; Manuela,0,73,0,0
1668478294094,ECE 276A,A00,103667,Atanasov; Nikolay A.,0,121,0,0
1668478294528,ECE 277,A00,103668,An; Cheolhong,0,143,0,0
1668478294970,ECE 279,A00,117947,Hall; Drew A.,0,22,0,0
1668478295818,ECE 283,A00,103670,Hsueh; Tzu-Chien,0,51,0,0
1668478296242,ECE 284,A00,103671,Turakhia; Yatish Girish,0,39,0,0
1668478296672,ECE 285,A00,103672,Zheng; Yang,0,39,0,0
1668478296672,ECE 285,B00,103673,Sworder; David D.,0,55,0,0
1668478297103,ECE 287,A00,103676,Javidi; Tara,0,8,0,0
1668478297527,MATH 200B,A00,098023,Salehi Golsefidy; Alireza,11,0,15,4
1668478297952,MATH 202B,A00,098024,Rhoades; Brendon Patrick,7,0,15,8
1668478298385,MATH 203B,A00,098025,Oprea; Dragos N.,10,0,15,5
1668478298809,MATH 204B,A00,098026,Sorensen; Claus M,13,0,15,2
1668478299233,MATH 208,A00,098027,Izadi; Elham,7,0,10,3
1668478299668,MATH 209,A00,098028,Pollack; Aaron,10,0,10,0
1668478300091,MATH 211A,A00,112919,Rogalski; Daniel,8,0,10,2
1668478300513,MATH 211B,A00,112920,Seward; Brandon M.,9,0,10,1
1668478300943,MATH 218,A00,098029,Li; Bo,10,0,10,0
1668478301382,MATH 220B,A00,098030,Novak; Jonathan I,11,0,15,4
1668478301809,MATH 221A,A00,098031,Ebenfelt; Peter F,13,0,15,2
1668478302244,MATH 231B,A00,098032,Zlatos; Andrej,11,0,15,4
1668478302669,MATH 240B,A00,098033,Ni; Lei,7,0,15,8
1668478303092,MATH 243,A00,098034,Jekel; David Andrew,10,0,10,0
1668478303516,MATH 245A,A00,098035,Nie; Jiawang,0,4,15,18
1668478303939,MATH 248,A00,098036,Bejenaru; Ioan,10,0,10,0
1668478304363,MATH 250B,A00,098037,Spolaor; Luca,14,0,15,1
1668478304785,MATH 258,A00,098038,Ni; Lei,9,0,10,1
1668478305215,MATH 264B,A00,098041,Rhoades; Brendon Patrick,8,0,15,7
1668478305645,MATH 268,A00,098042,Buss; Samuel R,10,0,10,0
1668478306084,MATH 269,A00,098043,Rhoades; Brendon Patrick,10,0,10,0
1668478306518,MATH 270B,A00,098044,Li; Bo,6,0,15,9
1668478306942,MATH 272B,A00,098045,Holst; Michael J,13,0,15,2
1668478307366,MATH 273A,A00,098046,Tian; Xiaochuan,10,0,15,5
1668478307796,MATH 275,A01,098048,Tian; Xiaochuan,6,0,10,4
1668478308223,MATH 278A,A00,098049,Holst; Michael J,7,0,10,3
1668478308646,MATH 278B,A00,098050,Cloninger; Alexander,10,0,10,0
1668478309069,MATH 278C,A00,098051,Nie; Jiawang,5,0,10,5
1668478309492,MATH 280B,A00,098052,Zheng; Tianyi,7,0,15,8
1668478309922,MATH 281B,A00,098053,Bradic; Jelena,0,2,15,15
1668478310349,MATH 282B,A00,098054,Arias-Castro; Ery,0,1,15,15
1668478310773,MATH 285,A00,098055,Fitzsimmons; Patrick J,0,2,15,17
1668478311199,MATH 287B,A00,098056,Arias-Castro; Ery,2,0,15,13
1668478311626,MATH 288,A00,098057,Agarwal; Pooja,9,0,10,1
1668478311626,MATH 288,B00,098058,Zhang; Danna,8,0,10,2
1668478311626,MATH 288,C00,098059,Williams; Ruth J,9,0,10,1
1668478312059,MATH 290B,A00,098060,Roberts; Justin Deritter,12,0,15,3
1668478312482,MATH 292,A00,098061,Belmont; Eva Kinoshita,10,0,10,0
1668478312905,MATH 295,A00,098062,Suk; Andrew Hoon,47,0,50,3
1668478313328,MATH 296,A00,098063,Novak; Jonathan I,20,0,20,0
1668478313763,MATH 297,001,098064,Gamst; Anthony Collins,9997,0,9999,2
1668478826344,COGS 205,A00,101395,Chiba; Andrea,19,0,20,1
1668478826768,COGS 210B,001,101404,Greene; Deanna Jacquelyn,9998,0,9999,1
1668478826768,COGS 210B,002,101417,Xia; Haijun,9999,0,9999,0
1668478826768,COGS 210B,003,101422,Nitz; Douglas A.,9999,0,9999,0
1668478826768,COGS 210B,004,101423,Hollan; James D.,9998,0,9999,1
1668478826768,COGS 210B,005,101424,Deak; Gedeon O.,9998,0,9999,1
1668478826768,COGS 210B,006,101425,Rossano; Federico,9999,0,9999,0
1668478827195,COGS 211B,A00,101427,Coulson; Seana M,9996,0,9999,3
1668478827621,COGS 220,A00,101428,Hollan; James D.,1,9,25,24
1668478828047,COGS 229,A00,101429,Dow; Steven P,17,0,25,8
1668478828475,COGS 230,A00,101430,Klemmer; Scott R,8,0,17,9
1668478828898,COGS 234,A00,101431,Xia; Haijun,2,0,25,23
1668478829333,COGS 260,A00,101432,Kiyonaga; Anastasia,21,0,25,4
1668478829333,COGS 260,B00,101433,Kirsh; David Joel,15,0,25,10
1668478829756,CSE 202,A00,102371,Impagliazzo; Russell,0,59,0,0
1668478830178,CSE 203B,A01,102373,Cheng; Chung Kuan,0,51,0,0
1668478830602,CSE 208,A00,102374,Micciancio; Daniele,0,5,0,0
1668478831026,CSE 209A,A00,112895,Impagliazzo; Russell,0,12,15,15
1668478831453,CSE 209B,A00,108005,Bellare; Mihir,0,6,0,0
1668478831875,CSE 210,A00,113163,Coblenz; Michael J,0,79,0,0
1668478832297,CSE 219,A00,106111,Dow; Steven P,0,6,20,20
1668478832721,CSE 221,A00,102376,Voelker; Geoffrey M.,0,67,0,0
1668478833143,CSE 224,A01,102378,Porter; George M,0,159,0,0
1668478833578,CSE 229A,A00,102379,Savage; Stefan,0,10,0,0
1668478834005,CSE 229C,A00,102380,Munyaka; Imani N. S.,0,9,0,0
1668478834436,CSE 232B,A00,102382,Deutsch; Alin Bernard,0,30,0,0
1668478834859,CSE 234,A01,112904,Kumar; Arun Kumar,0,0,0,0
1668478835280,CSE 237A,A00,102383,Rosing; Tajana Simunic,0,47,0,0
1668478835715,CSE 239A,A00,102384,Deutsch; Alin Bernard,0,12,0,0
1668478836139,CSE 239B,A00,102385,Polikarpova; Nadezhda,0,10,0,0
1668478836564,CSE 240A,A00,102386,Pannuto; Patrick William,0,43,0,0
1668478836988,CSE 240B,A00,102387,Zhao; Jishen,0,42,0,0
1668478837415,CSE 241A,A00,106406,Kang; Mingu,0,6,0,0
1668478837838,CSE 249B,A00,102388,Kahng; Andrew Byun,0,5,8,8
1668478838277,CSE 251B,A01,102392,Cottrell; Garrison W,0,44,0,0
1668478838277,CSE 251B,A02,102393,Cottrell; Garrison W,0,33,0,0
1668478838704,CSE 252B,A00,102394,Ochoa; Benjamin Lawrence,0,55,0,0
1668478839131,CSE 257,A01,102396,Gao; Sicun,0,129,0,0
1668478839556,CSE 272,A00,102397,Li; Tzumao,0,17,0,0
1668478839982,CSE 274,A00,111323,Chern; Albert Ren-Haur,0,15,0,0
1668478840407,CSE 282,A00,102398,Pevzner; Pavel Arkadjevich,0,0,0,0
1668478840835,CSE 284,A00,114175,Gymrek; Melissa Ann,0,19,0,0
1668478841262,CSE 290,A00,102399,Chandraker; Manmohan Krishna,0,11,0,0
1668478841262,CSE 290,B00,102400,Vaccaro; Kristen Marie,0,7,25,25
1668478841262,CSE 290,C00,102414,Pannuto; Patrick William,0,1,25,25
1668478841262,CSE 290,D00,102427,Pevzner; Pavel Arkadjevich,0,0,0,0
1668478841262,CSE 290,E00,102429,Zhao; Jishen,0,4,0,0
1668478841262,CSE 290,F00,102436,Tullsen; Dean Michael,0,5,0,0
1668478841262,CSE 290,G00,102440,Christensen; Henrik I,0,6,20,20
1668478841691,CSE 291,A00,102443,Su; Hao,0,0,0,0
1668478841691,CSE 291,B00,102448,Polikarpova; Nadezhda,0,0,0,0
1668478841691,CSE 291,C00,102453,Vaccaro; Kristen Marie,0,0,0,0
1668478841691,CSE 291,D00,111343,Savage; Stefan,0,0,0,0
1668478841691,CSE 291,E00,116474,Claffy; Kimberly Claire,0,0,0,0
1668478841691,CSE 291,F00,116479,Pasquale; Joseph,0,0,0,0
1668478842120,CSE 293,001,119111,Bafna; Vineet,9999,0,9999,0
1668478842120,CSE 293,002,119118,Bellare; Mihir,9999,0,9999,0
1668478842120,CSE 293,003,119122,Berg-Kirkpatrick; Taylor D,9999,0,9999,0
1668478842120,CSE 293,004,119135,Christensen; Henrik I,9999,0,9999,0
1668478842120,CSE 293,005,119142,Cottrell; Garrison W,9999,0,9999,0
1668478842120,CSE 293,006,119146,Deutsch; Alin Bernard,9999,0,9999,0
1668478842120,CSE 293,007,119159,Esmaeilzadeh; Hadi,9999,0,9999,0
1668478842120,CSE 293,008,119166,Freund; Yoav,9999,0,9999,0
1668478842120,CSE 293,009,119170,Griswold; William G.,9999,0,9999,0
1668478842120,CSE 293,010,119183,Gymrek; Melissa Ann,9999,0,9999,0
1668478842120,CSE 293,011,119190,Heninger; Nadia A,9999,0,9999,0
1668478842120,CSE 293,012,119230,Impagliazzo; Russell,9999,0,9999,0
1668478842120,CSE 293,013,119232,Jhala; Ranjit,9999,0,9999,0
1668478842120,CSE 293,014,119233,Kahng; Andrew Byun,9999,0,9999,0
1668478842120,CSE 293,015,119298,Kane; Daniel Mertz,9999,0,9999,0
1668478842120,CSE 293,016,119299,Kriegman; David J,9999,0,9999,0
1668478842120,CSE 293,017,119300,Kumar; Arun Kumar,9999,0,9999,0
1668478842120,CSE 293,018,119301,Lerner; Sorin,9999,0,9999,0
1668478842120,CSE 293,019,119302,Lovett; Shachar,9999,0,9999,0
1668478842120,CSE 293,020,119303,McAuley; Julian John,9999,0,9999,0
1668478842120,CSE 293,021,119304,Micciancio; Daniele,9999,0,9999,0
1668478842120,CSE 293,022,119367,Orailoglu; Alex,9999,0,9999,0
1668478842120,CSE 293,023,119382,Paturi; Ramamohan,9999,0,9999,0
1668478842120,CSE 293,024,119404,Polikarpova; Nadezhda,9999,0,9999,0
1668478842120,CSE 293,025,119406,Politz; Joseph Gibbs,9999,0,9999,0
1668478842120,CSE 293,026,119411,Porter; George M,9999,0,9999,0
1668478842120,CSE 293,027,119414,Porter; Leonard Emerson,9999,0,9999,0
1668478842120,CSE 293,028,119416,Ramamoorthi; Ravi,9999,0,9999,0
1668478842120,CSE 293,029,119417,Sahoo; Debashis,9999,0,9999,0
1668478842120,CSE 293,030,119420,Saul; Lawrence,9999,0,9999,0
1668478842120,CSE 293,031,119421,Savage; Stefan,9999,0,9999,0
1668478842120,CSE 293,032,119425,Schulze; Jurgen P.,9999,0,9999,0
1668478842120,CSE 293,033,119426,Snoeren; Alex C.,9999,0,9999,0
1668478842120,CSE 293,034,119428,Shang; Jingbo,9999,0,9999,0
1668478842120,CSE 293,035,119430,Stefan; Deian,9999,0,9999,0
1668478842120,CSE 293,036,119431,Su; Hao,9999,0,9999,0
1668478842120,CSE 293,037,119433,Swanson; Steven James,9999,0,9999,0
1668478842120,CSE 293,038,119435,Tullsen; Dean Michael,9999,0,9999,0
1668478842120,CSE 293,039,119483,Voelker; Geoffrey M.,9999,0,9999,0
1668478842120,CSE 293,040,119537,Zhao; Jishen,9999,0,9999,0
1668478842120,CSE 293,041,119538,Zhou; Yuan-Yuan,9999,0,9999,0
1668478842120,CSE 293,042,119539,Gao; Sicun,9999,0,9999,0
1668478842120,CSE 293,043,119540,Weibel; Nadir,9999,0,9999,0
1668478842120,CSE 293,044,119541,Gupta; Rajesh K.,9999,0,9999,0
1668478842120,CSE 293,045,126410,Vaccaro; Kristen Marie,9999,0,9999,0
1668478842120,CSE 293,046,126411,Klemke; Richard,9999,0,9999,0
1668478842544,CSE 294,A00,102459,Voelker; Geoffrey M.,0,2,0,0
1668478842544,CSE 294,B00,111322,Orailoglu; Alex,0,2,0,0
1668478842978,DSE 201,A00,096914,Deutsch; Alin Bernard,30,0,30,0
1668478843402,DSE 210,A00,096915,Dasgupta; Sanjoy,30,0,30,0
1668478843834,DSE 260A,A00,096916,Altintas De Callaf; Ilkay,30,0,30,0
1668478844279,ECE 200,001,103586,Antipa; Nicholas A,9999,0,9999,0
1668478844279,ECE 200,002,103587,Atanasov; Nikolay A.,9999,0,9999,0
1668478844279,ECE 200,003,103588,Bharadia; Dinesh,9999,0,9999,0
1668478844279,ECE 200,004,103589,Cheng; Chung Kuan,9999,0,9999,0
1668478844279,ECE 200,005,103590,Cosman; Pamela C.,9999,0,9999,0
1668478844279,ECE 200,006,103591,Dayeh; Shadi Ahmad,9999,0,9999,0
1668478844279,ECE 200,007,103592,Fainman; Yeshaiahu,9999,0,9999,0
1668478844279,ECE 200,008,103593,Ford; Joseph Earl,9999,0,9999,0
1668478844279,ECE 200,009,103594,Franceschetti; Massimo,9999,0,9999,0
1668478844279,ECE 200,010,103595,Fullerton; Eric E,9999,0,9999,0
1668478844279,ECE 200,011,103596,Galton; Ian A,9999,0,9999,0
1668478844279,ECE 200,012,103597,Gilja; Vikash,9999,0,9999,0
1668478844279,ECE 200,013,103598,Hall; Drew A.,9999,0,9999,0
1668478844279,ECE 200,014,103599,Hsueh; Tzu-Chien,9999,0,9999,0
1668478844279,ECE 200,015,103600,Javidi; Tara,9999,0,9999,0
1668478844279,ECE 200,016,103601,Kahng; Andrew Byun,9999,0,9999,0
1668478844279,ECE 200,017,103602,Kim; Young-Han,9999,0,9999,0
1668478844279,ECE 200,018,103603,Koushanfar; Farinaz,9999,0,9999,0
1668478844279,ECE 200,019,103604,Kuzum; Duygu,9999,0,9999,0
1668478844279,ECE 200,020,103605,Le; Hanh-Phuc,9999,0,9999,0
1668478844279,ECE 200,021,103606,Lin; Bill,9999,0,9999,0
1668478844279,ECE 200,022,103607,Liu; Zhaowei,9998,0,9999,1
1668478844279,ECE 200,023,103608,Lo; Yu-Hwa,9999,0,9999,0
1668478844279,ECE 200,024,103609,Lomakin; Vitaliy,9999,0,9999,0
1668478844279,ECE 200,025,103610,Mercier; Patrick Philip,9999,0,9999,0
1668478844279,ECE 200,026,103611,Meyer; Florian,9999,0,9999,0
1668478844279,ECE 200,027,103612,Milstein; Laurence B.,9999,0,9999,0
1668478844279,ECE 200,028,103613,Mir Arabbaygi; Siavash,9999,0,9999,0
1668478844279,ECE 200,029,103614,Mookherjea; Shayan,9999,0,9999,0
1668478844279,ECE 200,030,103615,Morris; Karcher William,9999,0,9999,0
1668478844279,ECE 200,031,103616,Ng; Tse Nga,9999,0,9999,0
1668478844279,ECE 200,032,103617,Nguyen; Truong Quang,9999,0,9999,0
1668478844279,ECE 200,033,103618,Nomura; Kenji,9999,0,9999,0
1668478844279,ECE 200,034,103619,Orlitsky; Alon,9999,0,9999,0
1668478844279,ECE 200,035,103620,Pal; Piya,9999,0,9999,0
1668478844279,ECE 200,036,103621,Papen; George C.,9999,0,9999,0
1668478844279,ECE 200,037,103622,Radic; Stojan,9999,0,9999,0
1668478844279,ECE 200,038,103623,Rao; Bhaskar D.,9999,0,9999,0
1668478844279,ECE 200,039,103624,Rao; Ramesh R,9999,0,9999,0
1668478844279,ECE 200,040,103625,Rebeiz; Gabriel,9999,0,9999,0
1668478844279,ECE 200,041,103626,Sanford; John R,9999,0,9999,0
1668478844279,ECE 200,042,103627,Siegel; Paul H.,9999,0,9999,0
1668478844279,ECE 200,043,103628,Sievenpiper; Daniel F.,9999,0,9999,0
1668478844279,ECE 200,044,103629,Sworder; David D.,9999,0,9999,0
1668478844279,ECE 200,045,103630,Taur; Yuan,9999,0,9999,0
1668478844279,ECE 200,046,103631,Touri; Behrouz,9999,0,9999,0
1668478844279,ECE 200,047,103632,Trivedi; Mohan M.,9999,0,9999,0
1668478844279,ECE 200,048,103633,Vasconcelos; Nuno,9999,0,9999,0
1668478844279,ECE 200,049,103634,Wang; Xiaolong,9999,0,9999,0
1668478844279,ECE 200,050,103635,Xie; Pengtao,9999,0,9999,0
1668478844279,ECE 200,051,103636,Yip; Michael,9999,0,9999,0
1668478844279,ECE 200,052,103637,Zeger; Kenneth A.,999,0,999,0
1668478844279,ECE 200,053,103638,Zhang; Xinyu,9999,0,9999,0
1668478844279,ECE 200,054,103639,Turakhia; Yatish Girish,9999,0,9999,0
1668478844279,ECE 200,055,103640,Kang; Mingu,9999,0,9999,0
1668478844279,ECE 200,056,103641,Shi; Yuanyuan,9999,0,9999,0
1668478844279,ECE 200,057,103642,Wang; Edward Jay,9999,0,9999,0
1668478844279,ECE 200,058,103643,Zheng; Yang,9999,0,9999,0
1668478844709,ECE 202,A00,103644,Kuzum; Duygu,0,41,0,0
1668478845142,ECE 212BN,A00,103646,Ng; Tse Nga,0,9,0,0
1668478845575,ECE 221,A00,111493,Staff,0,0,0,0
1668478846002,ECE 222B,A00,103647,Lomakin; Vitaliy,0,18,0,0
1668478846426,ECE 230B,A00,103648,Taur; Yuan,0,2,0,0
1668478846850,ECE 238B,A00,103649,Garay; Javier,0,0,0,0
1668478847277,ECE 240B,A00,112900,Fainman; Yeshaiahu,0,6,0,0
1668478847712,ECE 247A,A00,103650,Jokerst; Jesse Vincent,0,5,0,0
1668478848142,ECE 247B,A00,103651,Wang; Joseph,0,11,0,0
1668478848564,ECE 250,A00,103652,Siegel; Paul H.,0,80,0,0
1668478848988,ECE 251A,A00,103654,Rao; Bhaskar D.,0,61,0,0
1668478849412,ECE 257B,A00,103655,Bharadia; Dinesh,0,32,0,0
1668478849841,ECE 258A,A00,103656,Milstein; Laurence B.,0,28,0,0
1668478850269,ECE 260B,A00,103658,Kang; Mingu,0,119,0,0
1668478850696,ECE 264A,A00,103659,Galton; Ian A,0,66,0,0
1668478851123,ECE 265A,A00,103661,Gudem; Prasad S.S.,0,65,0,0
1668478851548,ECE 265D,A00,103662,Gudem; Prasad S.S.,0,24,0,0
1668478851979,ECE 268,A00,103663,Koushanfar; Farinaz,0,42,0,0
1668478852403,ECE 269,A01,103665,Pal; Piya,0,208,0,0
1668478852830,ECE 271B,A00,103666,Vasconcelos; Manuela,0,73,0,0
1668478853254,ECE 276A,A00,103667,Atanasov; Nikolay A.,0,121,0,0
1668478853681,ECE 277,A00,103668,An; Cheolhong,0,143,0,0
1668478854104,ECE 279,A00,117947,Hall; Drew A.,0,22,0,0
1668478855060,ECE 283,A00,103670,Hsueh; Tzu-Chien,0,51,0,0
1668478855485,ECE 284,A00,103671,Turakhia; Yatish Girish,0,39,0,0
1668478855913,ECE 285,A00,103672,Zheng; Yang,0,39,0,0
1668478855913,ECE 285,B00,103673,Sworder; David D.,0,55,0,0
1668478856337,ECE 287,A00,103676,Javidi; Tara,0,8,0,0
1668478856762,MATH 200B,A00,098023,Salehi Golsefidy; Alireza,11,0,15,4
1668478857196,MATH 202B,A00,098024,Rhoades; Brendon Patrick,7,0,15,8
1668478857623,MATH 203B,A00,098025,Oprea; Dragos N.,10,0,15,5
1668478858053,MATH 204B,A00,098026,Sorensen; Claus M,13,0,15,2
1668478858477,MATH 208,A00,098027,Izadi; Elham,7,0,10,3
1668478858901,MATH 209,A00,098028,Pollack; Aaron,10,0,10,0
1668478859328,MATH 211A,A00,112919,Rogalski; Daniel,8,0,10,2
1668478859751,MATH 211B,A00,112920,Seward; Brandon M.,9,0,10,1
1668478860175,MATH 218,A00,098029,Li; Bo,10,0,10,0
1668478860601,MATH 220B,A00,098030,Novak; Jonathan I,11,0,15,4
1668478861026,MATH 221A,A00,098031,Ebenfelt; Peter F,13,0,15,2
1668478861456,MATH 231B,A00,098032,Zlatos; Andrej,11,0,15,4
1668478861879,MATH 240B,A00,098033,Ni; Lei,7,0,15,8
1668478862303,MATH 243,A00,098034,Jekel; David Andrew,10,0,10,0
1668478862727,MATH 245A,A00,098035,Nie; Jiawang,0,4,15,18
1668478863286,MATH 248,A00,098036,Bejenaru; Ioan,10,0,10,0
1668478863711,MATH 250B,A00,098037,Spolaor; Luca,14,0,15,1
1668478864136,MATH 258,A00,098038,Ni; Lei,9,0,10,1
1668478864565,MATH 264B,A00,098041,Rhoades; Brendon Patrick,8,0,15,7
1668478864993,MATH 268,A00,098042,Buss; Samuel R,10,0,10,0
1668478865416,MATH 269,A00,098043,Rhoades; Brendon Patrick,10,0,10,0
1668478865839,MATH 270B,A00,098044,Li; Bo,6,0,15,9
1668478866267,MATH 272B,A00,098045,Holst; Michael J,13,0,15,2
1668478866690,MATH 273A,A00,098046,Tian; Xiaochuan,10,0,15,5
1668478867115,MATH 275,A01,098048,Tian; Xiaochuan,6,0,10,4
1668478867539,MATH 278A,A00,098049,Holst; Michael J,7,0,10,3
1668478867965,MATH 278B,A00,098050,Cloninger; Alexander,10,0,10,0
1668478868391,MATH 278C,A00,098051,Nie; Jiawang,5,0,10,5
1668478868814,MATH 280B,A00,098052,Zheng; Tianyi,7,0,15,8
1668478869244,MATH 281B,A00,098053,Bradic; Jelena,0,2,15,15
1668478869668,MATH 282B,A00,098054,Arias-Castro; Ery,0,1,15,15
1668478870097,MATH 285,A00,098055,Fitzsimmons; Patrick J,0,2,15,17
1668478870524,MATH 287B,A00,098056,Arias-Castro; Ery,2,0,15,13
1668478870950,MATH 288,A00,098057,Agarwal; Pooja,9,0,10,1
1668478870950,MATH 288,B00,098058,Zhang; Danna,8,0,10,2
1668478870950,MATH 288,C00,098059,Williams; Ruth J,9,0,10,1
1668478871375,MATH 290B,A00,098060,Roberts; Justin Deritter,12,0,15,3
1668478871815,MATH 292,A00,098061,Belmont; Eva Kinoshita,10,0,10,0
1668478872238,MATH 295,A00,098062,Suk; Andrew Hoon,47,0,50,3
1668478872663,MATH 296,A00,098063,Novak; Jonathan I,20,0,20,0
1668478873086,MATH 297,001,098064,Gamst; Anthony Collins,9997,0,9999,2
1668479374694,COGS 205,A00,101395,Chiba; Andrea,19,0,20,1
1668479375221,COGS 210B,001,101404,Greene; Deanna Jacquelyn,9998,0,9999,1
1668479375221,COGS 210B,002,101417,Xia; Haijun,9999,0,9999,0
1668479375221,COGS 210B,003,101422,Nitz; Douglas A.,9999,0,9999,0
1668479375221,COGS 210B,004,101423,Hollan; James D.,9998,0,9999,1
1668479375221,COGS 210B,005,101424,Deak; Gedeon O.,9998,0,9999,1
1668479375221,COGS 210B,006,101425,Rossano; Federico,9999,0,9999,0
1668479375648,COGS 211B,A00,101427,Coulson; Seana M,9996,0,9999,3
1668479376075,COGS 220,A00,101428,Hollan; James D.,1,9,25,24
1668479376502,COGS 229,A00,101429,Dow; Steven P,17,0,25,8
1668479376926,COGS 230,A00,101430,Klemmer; Scott R,8,0,17,9
1668479377354,COGS 234,A00,101431,Xia; Haijun,2,0,25,23
1668479377778,COGS 260,A00,101432,Kiyonaga; Anastasia,21,0,25,4
1668479377778,COGS 260,B00,101433,Kirsh; David Joel,15,0,25,10
1668479378202,CSE 202,A00,102371,Impagliazzo; Russell,0,60,0,0
1668479378626,CSE 203B,A01,102373,Cheng; Chung Kuan,0,52,0,0
1668479379048,CSE 208,A00,102374,Micciancio; Daniele,0,5,0,0
1668479379474,CSE 209A,A00,112895,Impagliazzo; Russell,0,12,15,15
1668479379900,CSE 209B,A00,108005,Bellare; Mihir,0,6,0,0
1668479380329,CSE 210,A00,113163,Coblenz; Michael J,0,80,0,0
1668479380758,CSE 219,A00,106111,Dow; Steven P,0,6,20,20
1668479381186,CSE 221,A00,102376,Voelker; Geoffrey M.,0,68,0,0
1668479381608,CSE 224,A01,102378,Porter; George M,0,159,0,0
1668479382031,CSE 229A,A00,102379,Savage; Stefan,0,10,0,0
1668479382457,CSE 229C,A00,102380,Munyaka; Imani N. S.,0,9,0,0
1668479382881,CSE 232B,A00,102382,Deutsch; Alin Bernard,0,30,0,0
1668479383304,CSE 234,A01,112904,Kumar; Arun Kumar,0,0,0,0
1668479383728,CSE 237A,A00,102383,Rosing; Tajana Simunic,0,48,0,0
1668479384155,CSE 239A,A00,102384,Deutsch; Alin Bernard,0,12,0,0
1668479384593,CSE 239B,A00,102385,Polikarpova; Nadezhda,0,10,0,0
1668479385027,CSE 240A,A00,102386,Pannuto; Patrick William,0,44,0,0
1668479385452,CSE 240B,A00,102387,Zhao; Jishen,0,42,0,0
1668479385875,CSE 241A,A00,106406,Kang; Mingu,0,6,0,0
1668479386299,CSE 249B,A00,102388,Kahng; Andrew Byun,0,5,8,8
1668479386727,CSE 251B,A01,102392,Cottrell; Garrison W,0,45,0,0
1668479386727,CSE 251B,A02,102393,Cottrell; Garrison W,0,33,0,0
1668479387153,CSE 252B,A00,102394,Ochoa; Benjamin Lawrence,0,56,0,0
1668479387577,CSE 257,A01,102396,Gao; Sicun,0,129,0,0
1668479388005,CSE 272,A00,102397,Li; Tzumao,0,17,0,0
1668479388428,CSE 274,A00,111323,Chern; Albert Ren-Haur,0,15,0,0
1668479388855,CSE 282,A00,102398,Pevzner; Pavel Arkadjevich,0,0,0,0
1668479389283,CSE 284,A00,114175,Gymrek; Melissa Ann,0,20,0,0
1668479389708,CSE 290,A00,102399,Chandraker; Manmohan Krishna,0,11,0,0
1668479389708,CSE 290,B00,102400,Vaccaro; Kristen Marie,0,7,25,25
1668479389708,CSE 290,C00,102414,Pannuto; Patrick William,0,1,25,25
1668479389708,CSE 290,D00,102427,Pevzner; Pavel Arkadjevich,0,0,0,0
1668479389708,CSE 290,E00,102429,Zhao; Jishen,0,4,0,0
1668479389708,CSE 290,F00,102436,Tullsen; Dean Michael,0,5,0,0
1668479389708,CSE 290,G00,102440,Christensen; Henrik I,0,6,20,20
1668479390131,CSE 291,A00,102443,Su; Hao,0,0,0,0
1668479390131,CSE 291,B00,102448,Polikarpova; Nadezhda,0,0,0,0
1668479390131,CSE 291,C00,102453,Vaccaro; Kristen Marie,0,0,0,0
1668479390131,CSE 291,D00,111343,Savage; Stefan,0,0,0,0
1668479390131,CSE 291,E00,116474,Claffy; Kimberly Claire,0,0,0,0
1668479390131,CSE 291,F00,116479,Pasquale; Joseph,0,0,0,0
1668479390583,CSE 293,001,119111,Bafna; Vineet,9999,0,9999,0
1668479390583,CSE 293,002,119118,Bellare; Mihir,9999,0,9999,0
1668479390583,CSE 293,003,119122,Berg-Kirkpatrick; Taylor D,9999,0,9999,0
1668479390583,CSE 293,004,119135,Christensen; Henrik I,9999,0,9999,0
1668479390583,CSE 293,005,119142,Cottrell; Garrison W,9999,0,9999,0
1668479390583,CSE 293,006,119146,Deutsch; Alin Bernard,9999,0,9999,0
1668479390583,CSE 293,007,119159,Esmaeilzadeh; Hadi,9999,0,9999,0
1668479390583,CSE 293,008,119166,Freund; Yoav,9999,0,9999,0
1668479390583,CSE 293,009,119170,Griswold; William G.,9999,0,9999,0
1668479390583,CSE 293,010,119183,Gymrek; Melissa Ann,9999,0,9999,0
1668479390583,CSE 293,011,119190,Heninger; Nadia A,9999,0,9999,0
1668479390583,CSE 293,012,119230,Impagliazzo; Russell,9999,0,9999,0
1668479390583,CSE 293,013,119232,Jhala; Ranjit,9999,0,9999,0
1668479390583,CSE 293,014,119233,Kahng; Andrew Byun,9999,0,9999,0
1668479390583,CSE 293,015,119298,Kane; Daniel Mertz,9999,0,9999,0
1668479390583,CSE 293,016,119299,Kriegman; David J,9999,0,9999,0
1668479390583,CSE 293,017,119300,Kumar; Arun Kumar,9999,0,9999,0
1668479390583,CSE 293,018,119301,Lerner; Sorin,9999,0,9999,0
1668479390583,CSE 293,019,119302,Lovett; Shachar,9999,0,9999,0
1668479390583,CSE 293,020,119303,McAuley; Julian John,9999,0,9999,0
1668479390583,CSE 293,021,119304,Micciancio; Daniele,9999,0,9999,0
1668479390583,CSE 293,022,119367,Orailoglu; Alex,9999,0,9999,0
1668479390583,CSE 293,023,119382,Paturi; Ramamohan,9999,0,9999,0
1668479390583,CSE 293,024,119404,Polikarpova; Nadezhda,9999,0,9999,0
1668479390583,CSE 293,025,119406,Politz; Joseph Gibbs,9999,0,9999,0
1668479390583,CSE 293,026,119411,Porter; George M,9999,0,9999,0
1668479390583,CSE 293,027,119414,Porter; Leonard Emerson,9999,0,9999,0
1668479390583,CSE 293,028,119416,Ramamoorthi; Ravi,9999,0,9999,0
1668479390583,CSE 293,029,119417,Sahoo; Debashis,9999,0,9999,0
1668479390583,CSE 293,030,119420,Saul; Lawrence,9999,0,9999,0
1668479390583,CSE 293,031,119421,Savage; Stefan,9999,0,9999,0
1668479390583,CSE 293,032,119425,Schulze; Jurgen P.,9999,0,9999,0
1668479390583,CSE 293,033,119426,Snoeren; Alex C.,9999,0,9999,0
1668479390583,CSE 293,034,119428,Shang; Jingbo,9999,0,9999,0
1668479390583,CSE 293,035,119430,Stefan; Deian,9999,0,9999,0
1668479390583,CSE 293,036,119431,Su; Hao,9999,0,9999,0
1668479390583,CSE 293,037,119433,Swanson; Steven James,9999,0,9999,0
1668479390583,CSE 293,038,119435,Tullsen; Dean Michael,9999,0,9999,0
1668479390583,CSE 293,039,119483,Voelker; Geoffrey M.,9999,0,9999,0
1668479390583,CSE 293,040,119537,Zhao; Jishen,9999,0,9999,0
1668479390583,CSE 293,041,119538,Zhou; Yuan-Yuan,9999,0,9999,0
1668479390583,CSE 293,042,119539,Gao; Sicun,9999,0,9999,0
1668479390583,CSE 293,043,119540,Weibel; Nadir,9999,0,9999,0
1668479390583,CSE 293,044,119541,Gupta; Rajesh K.,9999,0,9999,0
1668479390583,CSE 293,045,126410,Vaccaro; Kristen Marie,9999,0,9999,0
1668479390583,CSE 293,046,126411,Klemke; Richard,9999,0,9999,0
1668479391014,CSE 294,A00,102459,Voelker; Geoffrey M.,0,2,0,0
1668479391014,CSE 294,B00,111322,Orailoglu; Alex,0,2,0,0
1668479391437,DSE 201,A00,096914,Deutsch; Alin Bernard,30,0,30,0
1668479391862,DSE 210,A00,096915,Dasgupta; Sanjoy,30,0,30,0
1668479392294,DSE 260A,A00,096916,Altintas De Callaf; Ilkay,30,0,30,0
1668479392730,ECE 200,001,103586,Antipa; Nicholas A,9999,0,9999,0
1668479392730,ECE 200,002,103587,Atanasov; Nikolay A.,9999,0,9999,0
1668479392730,ECE 200,003,103588,Bharadia; Dinesh,9999,0,9999,0
1668479392730,ECE 200,004,103589,Cheng; Chung Kuan,9999,0,9999,0
1668479392730,ECE 200,005,103590,Cosman; Pamela C.,9999,0,9999,0
1668479392730,ECE 200,006,103591,Dayeh; Shadi Ahmad,9999,0,9999,0
1668479392730,ECE 200,007,103592,Fainman; Yeshaiahu,9999,0,9999,0
1668479392730,ECE 200,008,103593,Ford; Joseph Earl,9999,0,9999,0
1668479392730,ECE 200,009,103594,Franceschetti; Massimo,9999,0,9999,0
1668479392730,ECE 200,010,103595,Fullerton; Eric E,9999,0,9999,0
1668479392730,ECE 200,011,103596,Galton; Ian A,9999,0,9999,0
1668479392730,ECE 200,012,103597,Gilja; Vikash,9999,0,9999,0
1668479392730,ECE 200,013,103598,Hall; Drew A.,9999,0,9999,0
1668479392730,ECE 200,014,103599,Hsueh; Tzu-Chien,9999,0,9999,0
1668479392730,ECE 200,015,103600,Javidi; Tara,9999,0,9999,0
1668479392730,ECE 200,016,103601,Kahng; Andrew Byun,9999,0,9999,0
1668479392730,ECE 200,017,103602,Kim; Young-Han,9999,0,9999,0
1668479392730,ECE 200,018,103603,Koushanfar; Farinaz,9999,0,9999,0
1668479392730,ECE 200,019,103604,Kuzum; Duygu,9999,0,9999,0
1668479392730,ECE 200,020,103605,Le; Hanh-Phuc,9999,0,9999,0
1668479392730,ECE 200,021,103606,Lin; Bill,9999,0,9999,0
1668479392730,ECE 200,022,103607,Liu; Zhaowei,9998,0,9999,1
1668479392730,ECE 200,023,103608,Lo; Yu-Hwa,9999,0,9999,0
1668479392730,ECE 200,024,103609,Lomakin; Vitaliy,9999,0,9999,0
1668479392730,ECE 200,025,103610,Mercier; Patrick Philip,9999,0,9999,0
1668479392730,ECE 200,026,103611,Meyer; Florian,9999,0,9999,0
1668479392730,ECE 200,027,103612,Milstein; Laurence B.,9999,0,9999,0
1668479392730,ECE 200,028,103613,Mir Arabbaygi; Siavash,9999,0,9999,0
1668479392730,ECE 200,029,103614,Mookherjea; Shayan,9999,0,9999,0
1668479392730,ECE 200,030,103615,Morris; Karcher William,9999,0,9999,0
1668479392730,ECE 200,031,103616,Ng; Tse Nga,9999,0,9999,0
1668479392730,ECE 200,032,103617,Nguyen; Truong Quang,9999,0,9999,0
1668479392730,ECE 200,033,103618,Nomura; Kenji,9999,0,9999,0
1668479392730,ECE 200,034,103619,Orlitsky; Alon,9999,0,9999,0
1668479392730,ECE 200,035,103620,Pal; Piya,9999,0,9999,0
1668479392730,ECE 200,036,103621,Papen; George C.,9999,0,9999,0
1668479392730,ECE 200,037,103622,Radic; Stojan,9999,0,9999,0
1668479392730,ECE 200,038,103623,Rao; Bhaskar D.,9999,0,9999,0
1668479392730,ECE 200,039,103624,Rao; Ramesh R,9999,0,9999,0
1668479392730,ECE 200,040,103625,Rebeiz; Gabriel,9999,0,9999,0
1668479392730,ECE 200,041,103626,Sanford; John R,9999,0,9999,0
1668479392730,ECE 200,042,103627,Siegel; Paul H.,9999,0,9999,0
1668479392730,ECE 200,043,103628,Sievenpiper; Daniel F.,9999,0,9999,0
1668479392730,ECE 200,044,103629,Sworder; David D.,9999,0,9999,0
1668479392730,ECE 200,045,103630,Taur; Yuan,9999,0,9999,0
1668479392730,ECE 200,046,103631,Touri; Behrouz,9999,0,9999,0
1668479392730,ECE 200,047,103632,Trivedi; Mohan M.,9999,0,9999,0
1668479392730,ECE 200,048,103633,Vasconcelos; Nuno,9999,0,9999,0
1668479392730,ECE 200,049,103634,Wang; Xiaolong,9999,0,9999,0
1668479392730,ECE 200,050,103635,Xie; Pengtao,9999,0,9999,0
1668479392730,ECE 200,051,103636,Yip; Michael,9999,0,9999,0
1668479392730,ECE 200,052,103637,Zeger; Kenneth A.,999,0,999,0
1668479392730,ECE 200,053,103638,Zhang; Xinyu,9999,0,9999,0
1668479392730,ECE 200,054,103639,Turakhia; Yatish Girish,9999,0,9999,0
1668479392730,ECE 200,055,103640,Kang; Mingu,9999,0,9999,0
1668479392730,ECE 200,056,103641,Shi; Yuanyuan,9999,0,9999,0
1668479392730,ECE 200,057,103642,Wang; Edward Jay,9999,0,9999,0
1668479392730,ECE 200,058,103643,Zheng; Yang,9999,0,9999,0
1668479393160,ECE 202,A00,103644,Kuzum; Duygu,0,41,0,0
1668479393599,ECE 212BN,A00,103646,Ng; Tse Nga,0,9,0,0
1668479394026,ECE 221,A00,111493,Staff,0,0,0,0
1668479394453,ECE 222B,A00,103647,Lomakin; Vitaliy,0,18,0,0
1668479394876,ECE 230B,A00,103648,Taur; Yuan,0,2,0,0
1668479395300,ECE 238B,A00,103649,Garay; Javier,0,0,0,0
1668479395723,ECE 240B,A00,112900,Fainman; Yeshaiahu,0,6,0,0
1668479396146,ECE 247A,A00,103650,Jokerst; Jesse Vincent,0,5,0,0
1668479396570,ECE 247B,A00,103651,Wang; Joseph,0,11,0,0
1668479396994,ECE 250,A00,103652,Siegel; Paul H.,0,80,0,0
1668479397416,ECE 251A,A00,103654,Rao; Bhaskar D.,0,61,0,0
1668479397847,ECE 257B,A00,103655,Bharadia; Dinesh,0,32,0,0
1668479398273,ECE 258A,A00,103656,Milstein; Laurence B.,0,28,0,0
1668479398698,ECE 260B,A00,103658,Kang; Mingu,0,119,0,0
1668479399125,ECE 264A,A00,103659,Galton; Ian A,0,66,0,0
1668479399550,ECE 265A,A00,103661,Gudem; Prasad S.S.,0,65,0,0
1668479399975,ECE 265D,A00,103662,Gudem; Prasad S.S.,0,24,0,0
1668479400403,ECE 268,A00,103663,Koushanfar; Farinaz,0,42,0,0
1668479400830,ECE 269,A01,103665,Pal; Piya,0,208,0,0
1668479401255,ECE 271B,A00,103666,Vasconcelos; Manuela,0,73,0,0
1668479401680,ECE 276A,A00,103667,Atanasov; Nikolay A.,0,121,0,0
1668479402103,ECE 277,A00,103668,An; Cheolhong,0,143,0,0
1668479402540,ECE 279,A00,117947,Hall; Drew A.,0,22,0,0
1668479403392,ECE 283,A00,103670,Hsueh; Tzu-Chien,0,51,0,0
1668479403824,ECE 284,A00,103671,Turakhia; Yatish Girish,0,39,0,0
1668479404252,ECE 285,A00,103672,Zheng; Yang,0,39,0,0
1668479404252,ECE 285,B00,103673,Sworder; David D.,0,55,0,0
1668479404686,ECE 287,A00,103676,Javidi; Tara,0,8,0,0
1668479405109,MATH 200B,A00,098023,Salehi Golsefidy; Alireza,11,0,15,4
1668479405531,MATH 202B,A00,098024,Rhoades; Brendon Patrick,7,0,15,8
1668479405955,MATH 203B,A00,098025,Oprea; Dragos N.,9,0,15,6
1668479406380,MATH 204B,A00,098026,Sorensen; Claus M,13,0,15,2
1668479406807,MATH 208,A00,098027,Izadi; Elham,7,0,10,3
1668479407234,MATH 209,A00,098028,Pollack; Aaron,10,0,10,0
1668479407657,MATH 211A,A00,112919,Rogalski; Daniel,8,0,10,2
1668479408080,MATH 211B,A00,112920,Seward; Brandon M.,9,0,10,1
1668479408511,MATH 218,A00,098029,Li; Bo,10,0,10,0
1668479408935,MATH 220B,A00,098030,Novak; Jonathan I,11,0,15,4
1668479409359,MATH 221A,A00,098031,Ebenfelt; Peter F,13,0,15,2
1668479409794,MATH 231B,A00,098032,Zlatos; Andrej,11,0,15,4
1668479410222,MATH 240B,A00,098033,Ni; Lei,7,0,15,8
1668479410645,MATH 243,A00,098034,Jekel; David Andrew,10,0,10,0
1668479411069,MATH 245A,A00,098035,Nie; Jiawang,0,4,15,18
1668479411493,MATH 248,A00,098036,Bejenaru; Ioan,10,0,10,0
1668479411927,MATH 250B,A00,098037,Spolaor; Luca,14,0,15,1
1668479412360,MATH 258,A00,098038,Ni; Lei,9,0,10,1
1668479412785,MATH 264B,A00,098041,Rhoades; Brendon Patrick,8,0,15,7
1668479413211,MATH 268,A00,098042,Buss; Samuel R,10,0,10,0
1668479413637,MATH 269,A00,098043,Rhoades; Brendon Patrick,10,0,10,0
1668479414062,MATH 270B,A00,098044,Li; Bo,6,0,15,9
1668479414483,MATH 272B,A00,098045,Holst; Michael J,13,0,15,2
1668479414905,MATH 273A,A00,098046,Tian; Xiaochuan,10,0,15,5
1668479415329,MATH 275,A01,098048,Tian; Xiaochuan,6,0,10,4
1668479415753,MATH 278A,A00,098049,Holst; Michael J,7,0,10,3
1668479416176,MATH 278B,A00,098050,Cloninger; Alexander,10,0,10,0
1668479416600,MATH 278C,A00,098051,Nie; Jiawang,5,0,10,5
1668479417026,MATH 280B,A00,098052,Zheng; Tianyi,7,0,15,8
1668479417449,MATH 281B,A00,098053,Bradic; Jelena,0,2,15,15
1668479417878,MATH 282B,A00,098054,Arias-Castro; Ery,0,1,15,15
1668479418393,MATH 285,A00,098055,Fitzsimmons; Patrick J,0,2,15,17
1668479418823,MATH 287B,A00,098056,Arias-Castro; Ery,1,0,15,14
1668479419248,MATH 288,A00,098057,Agarwal; Pooja,9,0,10,1
1668479419248,MATH 288,B00,098058,Zhang; Danna,8,0,10,2
1668479419248,MATH 288,C00,098059,Williams; Ruth J,9,0,10,1
1668479419677,MATH 290B,A00,098060,Roberts; Justin Deritter,12,0,15,3
1668479420101,MATH 292,A00,098061,Belmont; Eva Kinoshita,10,0,10,0
1668479420530,MATH 295,A00,098062,Suk; Andrew Hoon,47,0,50,3
1668479420953,MATH 296,A00,098063,Novak; Jonathan I,20,0,20,0
1668479421379,MATH 297,001,098064,Gamst; Anthony Collins,9997,0,9999,2
1668479923168,COGS 205,A00,101395,Chiba; Andrea,19,0,20,1
1668479923594,COGS 210B,001,101404,Greene; Deanna Jacquelyn,9998,0,9999,1
1668479923594,COGS 210B,002,101417,Xia; Haijun,9999,0,9999,0
1668479923594,COGS 210B,003,101422,Nitz; Douglas A.,9999,0,9999,0
1668479923594,COGS 210B,004,101423,Hollan; James D.,9998,0,9999,1
1668479923594,COGS 210B,005,101424,Deak; Gedeon O.,9998,0,9999,1
1668479923594,COGS 210B,006,101425,Rossano; Federico,9999,0,9999,0
1668479924034,COGS 211B,A00,101427,Coulson; Seana M,9996,0,9999,3
1668479924458,COGS 220,A00,101428,Hollan; James D.,1,9,25,24
1668479924882,COGS 229,A00,101429,Dow; Steven P,17,0,25,8
1668479925307,COGS 230,A00,101430,Klemmer; Scott R,8,0,17,9
1668479925730,COGS 234,A00,101431,Xia; Haijun,2,0,25,23
1668479926162,COGS 260,A00,101432,Kiyonaga; Anastasia,21,0,25,4
1668479926162,COGS 260,B00,101433,Kirsh; David Joel,15,0,25,10
1668479926586,CSE 202,A00,102371,Impagliazzo; Russell,0,60,0,0
1668479927010,CSE 203B,A01,102373,Cheng; Chung Kuan,0,52,0,0
1668479927434,CSE 208,A00,102374,Micciancio; Daniele,0,5,0,0
1668479927861,CSE 209A,A00,112895,Impagliazzo; Russell,0,12,15,15
1668479928284,CSE 209B,A00,108005,Bellare; Mihir,0,6,0,0
1668479928714,CSE 210,A00,113163,Coblenz; Michael J,0,80,0,0
1668479929140,CSE 219,A00,106111,Dow; Steven P,0,6,20,20
1668479929563,CSE 221,A00,102376,Voelker; Geoffrey M.,0,68,0,0
1668479929989,CSE 224,A01,102378,Porter; George M,0,159,0,0
1668479930417,CSE 229A,A00,102379,Savage; Stefan,0,10,0,0
1668479930852,CSE 229C,A00,102380,Munyaka; Imani N. S.,0,9,0,0
1668479931275,CSE 232B,A00,102382,Deutsch; Alin Bernard,0,30,0,0
1668479931702,CSE 234,A01,112904,Kumar; Arun Kumar,0,0,0,0
1668479932123,CSE 237A,A00,102383,Rosing; Tajana Simunic,0,48,0,0
1668479932549,CSE 239A,A00,102384,Deutsch; Alin Bernard,0,12,0,0
1668479932974,CSE 239B,A00,102385,Polikarpova; Nadezhda,0,10,0,0
1668479933399,CSE 240A,A00,102386,Pannuto; Patrick William,0,44,0,0
1668479933823,CSE 240B,A00,102387,Zhao; Jishen,0,42,0,0
1668479934258,CSE 241A,A00,106406,Kang; Mingu,0,6,0,0
1668479934684,CSE 249B,A00,102388,Kahng; Andrew Byun,0,5,8,8
1668479935109,CSE 251B,A01,102392,Cottrell; Garrison W,0,45,0,0
1668479935109,CSE 251B,A02,102393,Cottrell; Garrison W,0,33,0,0
1668479935533,CSE 252B,A00,102394,Ochoa; Benjamin Lawrence,0,56,0,0
1668479935954,CSE 257,A01,102396,Gao; Sicun,0,129,0,0
1668479936388,CSE 272,A00,102397,Li; Tzumao,0,17,0,0
1668479936810,CSE 274,A00,111323,Chern; Albert Ren-Haur,0,15,0,0
1668479937234,CSE 282,A00,102398,Pevzner; Pavel Arkadjevich,0,0,0,0
1668479937659,CSE 284,A00,114175,Gymrek; Melissa Ann,0,20,0,0
1668479938084,CSE 290,A00,102399,Chandraker; Manmohan Krishna,0,11,0,0
1668479938084,CSE 290,B00,102400,Vaccaro; Kristen Marie,0,7,25,25
1668479938084,CSE 290,C00,102414,Pannuto; Patrick William,0,1,25,25
1668479938084,CSE 290,D00,102427,Pevzner; Pavel Arkadjevich,0,0,0,0
1668479938084,CSE 290,E00,102429,Zhao; Jishen,0,4,0,0
1668479938084,CSE 290,F00,102436,Tullsen; Dean Michael,0,5,0,0
1668479938084,CSE 290,G00,102440,Christensen; Henrik I,0,6,20,20
1668479938508,CSE 291,A00,102443,Su; Hao,0,0,0,0
1668479938508,CSE 291,B00,102448,Polikarpova; Nadezhda,0,0,0,0
1668479938508,CSE 291,C00,102453,Vaccaro; Kristen Marie,0,0,0,0
1668479938508,CSE 291,D00,111343,Savage; Stefan,0,0,0,0
1668479938508,CSE 291,E00,116474,Claffy; Kimberly Claire,0,0,0,0
1668479938508,CSE 291,F00,116479,Pasquale; Joseph,0,0,0,0
1668479939031,CSE 293,001,119111,Bafna; Vineet,9999,0,9999,0
1668479939031,CSE 293,002,119118,Bellare; Mihir,9999,0,9999,0
1668479939031,CSE 293,003,119122,Berg-Kirkpatrick; Taylor D,9999,0,9999,0
1668479939031,CSE 293,004,119135,Christensen; Henrik I,9999,0,9999,0
1668479939031,CSE 293,005,119142,Cottrell; Garrison W,9999,0,9999,0
1668479939031,CSE 293,006,119146,Deutsch; Alin Bernard,9999,0,9999,0
1668479939031,CSE 293,007,119159,Esmaeilzadeh; Hadi,9999,0,9999,0
1668479939031,CSE 293,008,119166,Freund; Yoav,9999,0,9999,0
1668479939031,CSE 293,009,119170,Griswold; William G.,9999,0,9999,0
1668479939031,CSE 293,010,119183,Gymrek; Melissa Ann,9999,0,9999,0
1668479939031,CSE 293,011,119190,Heninger; Nadia A,9999,0,9999,0
1668479939031,CSE 293,012,119230,Impagliazzo; Russell,9999,0,9999,0
1668479939031,CSE 293,013,119232,Jhala; Ranjit,9999,0,9999,0
1668479939031,CSE 293,014,119233,Kahng; Andrew Byun,9999,0,9999,0
1668479939031,CSE 293,015,119298,Kane; Daniel Mertz,9999,0,9999,0
1668479939031,CSE 293,016,119299,Kriegman; David J,9999,0,9999,0
1668479939031,CSE 293,017,119300,Kumar; Arun Kumar,9999,0,9999,0
1668479939031,CSE 293,018,119301,Lerner; Sorin,9999,0,9999,0
1668479939031,CSE 293,019,119302,Lovett; Shachar,9999,0,9999,0
1668479939031,CSE 293,020,119303,McAuley; Julian John,9999,0,9999,0
1668479939031,CSE 293,021,119304,Micciancio; Daniele,9999,0,9999,0
1668479939031,CSE 293,022,119367,Orailoglu; Alex,9999,0,9999,0
1668479939031,CSE 293,023,119382,Paturi; Ramamohan,9999,0,9999,0
1668479939031,CSE 293,024,119404,Polikarpova; Nadezhda,9999,0,9999,0
1668479939031,CSE 293,025,119406,Politz; Joseph Gibbs,9999,0,9999,0
1668479939031,CSE 293,026,119411,Porter; George M,9999,0,9999,0
1668479939031,CSE 293,027,119414,Porter; Leonard Emerson,9999,0,9999,0
1668479939031,CSE 293,028,119416,Ramamoorthi; Ravi,9999,0,9999,0
1668479939031,CSE 293,029,119417,Sahoo; Debashis,9999,0,9999,0
1668479939031,CSE 293,030,119420,Saul; Lawrence,9999,0,9999,0
1668479939031,CSE 293,031,119421,Savage; Stefan,9999,0,9999,0
1668479939031,CSE 293,032,119425,Schulze; Jurgen P.,9999,0,9999,0
1668479939031,CSE 293,033,119426,Snoeren; Alex C.,9999,0,9999,0
1668479939031,CSE 293,034,119428,Shang; Jingbo,9999,0,9999,0
1668479939031,CSE 293,035,119430,Stefan; Deian,9999,0,9999,0
1668479939031,CSE 293,036,119431,Su; Hao,9999,0,9999,0
1668479939031,CSE 293,037,119433,Swanson; Steven James,9999,0,9999,0
1668479939031,CSE 293,038,119435,Tullsen; Dean Michael,9999,0,9999,0
1668479939031,CSE 293,039,119483,Voelker; Geoffrey M.,9999,0,9999,0
1668479939031,CSE 293,040,119537,Zhao; Jishen,9999,0,9999,0
1668479939031,CSE 293,041,119538,Zhou; Yuan-Yuan,9999,0,9999,0
1668479939031,CSE 293,042,119539,Gao; Sicun,9999,0,9999,0
1668479939031,CSE 293,043,119540,Weibel; Nadir,9999,0,9999,0
1668479939031,CSE 293,044,119541,Gupta; Rajesh K.,9999,0,9999,0
1668479939031,CSE 293,045,126410,Vaccaro; Kristen Marie,9999,0,9999,0
1668479939031,CSE 293,046,126411,Klemke; Richard,9999,0,9999,0
1668479939456,CSE 294,A00,102459,Voelker; Geoffrey M.,0,2,0,0
1668479939456,CSE 294,B00,111322,Orailoglu; Alex,0,2,0,0
1668479939882,DSE 201,A00,096914,Deutsch; Alin Bernard,30,0,30,0
1668479940307,DSE 210,A00,096915,Dasgupta; Sanjoy,30,0,30,0
1668479940731,DSE 260A,A00,096916,Altintas De Callaf; Ilkay,30,0,30,0
1668479941184,ECE 200,001,103586,Antipa; Nicholas A,9999,0,9999,0
1668479941184,ECE 200,002,103587,Atanasov; Nikolay A.,9999,0,9999,0
1668479941184,ECE 200,003,103588,Bharadia; Dinesh,9999,0,9999,0
1668479941184,ECE 200,004,103589,Cheng; Chung Kuan,9999,0,9999,0
1668479941184,ECE 200,005,103590,Cosman; Pamela C.,9999,0,9999,0
1668479941184,ECE 200,006,103591,Dayeh; Shadi Ahmad,9999,0,9999,0
1668479941184,ECE 200,007,103592,Fainman; Yeshaiahu,9999,0,9999,0
1668479941184,ECE 200,008,103593,Ford; Joseph Earl,9999,0,9999,0
1668479941184,ECE 200,009,103594,Franceschetti; Massimo,9999,0,9999,0
1668479941184,ECE 200,010,103595,Fullerton; Eric E,9999,0,9999,0
1668479941184,ECE 200,011,103596,Galton; Ian A,9999,0,9999,0
1668479941184,ECE 200,012,103597,Gilja; Vikash,9999,0,9999,0
1668479941184,ECE 200,013,103598,Hall; Drew A.,9999,0,9999,0
1668479941184,ECE 200,014,103599,Hsueh; Tzu-Chien,9999,0,9999,0
1668479941184,ECE 200,015,103600,Javidi; Tara,9999,0,9999,0
1668479941184,ECE 200,016,103601,Kahng; Andrew Byun,9999,0,9999,0
1668479941184,ECE 200,017,103602,Kim; Young-Han,9999,0,9999,0
1668479941184,ECE 200,018,103603,Koushanfar; Farinaz,9999,0,9999,0
1668479941184,ECE 200,019,103604,Kuzum; Duygu,9999,0,9999,0
1668479941184,ECE 200,020,103605,Le; Hanh-Phuc,9999,0,9999,0
1668479941184,ECE 200,021,103606,Lin; Bill,9999,0,9999,0
1668479941184,ECE 200,022,103607,Liu; Zhaowei,9998,0,9999,1
1668479941184,ECE 200,023,103608,Lo; Yu-Hwa,9999,0,9999,0
1668479941184,ECE 200,024,103609,Lomakin; Vitaliy,9999,0,9999,0
1668479941184,ECE 200,025,103610,Mercier; Patrick Philip,9999,0,9999,0
1668479941184,ECE 200,026,103611,Meyer; Florian,9999,0,9999,0
1668479941184,ECE 200,027,103612,Milstein; Laurence B.,9999,0,9999,0
1668479941184,ECE 200,028,103613,Mir Arabbaygi; Siavash,9999,0,9999,0
1668479941184,ECE 200,029,103614,Mookherjea; Shayan,9999,0,9999,0
1668479941184,ECE 200,030,103615,Morris; Karcher William,9999,0,9999,0
1668479941184,ECE 200,031,103616,Ng; Tse Nga,9999,0,9999,0
1668479941184,ECE 200,032,103617,Nguyen; Truong Quang,9999,0,9999,0
1668479941184,ECE 200,033,103618,Nomura; Kenji,9999,0,9999,0
1668479941184,ECE 200,034,103619,Orlitsky; Alon,9999,0,9999,0
1668479941184,ECE 200,035,103620,Pal; Piya,9999,0,9999,0
1668479941184,ECE 200,036,103621,Papen; George C.,9999,0,9999,0
1668479941184,ECE 200,037,103622,Radic; Stojan,9999,0,9999,0
1668479941184,ECE 200,038,103623,Rao; Bhaskar D.,9999,0,9999,0
1668479941184,ECE 200,039,103624,Rao; Ramesh R,9999,0,9999,0
1668479941184,ECE 200,040,103625,Rebeiz; Gabriel,9999,0,9999,0
1668479941184,ECE 200,041,103626,Sanford; John R,9999,0,9999,0
1668479941184,ECE 200,042,103627,Siegel; Paul H.,9999,0,9999,0
1668479941184,ECE 200,043,103628,Sievenpiper; Daniel F.,9999,0,9999,0
1668479941184,ECE 200,044,103629,Sworder; David D.,9999,0,9999,0
1668479941184,ECE 200,045,103630,Taur; Yuan,9999,0,9999,0
1668479941184,ECE 200,046,103631,Touri; Behrouz,9999,0,9999,0
1668479941184,ECE 200,047,103632,Trivedi; Mohan M.,9999,0,9999,0
1668479941184,ECE 200,048,103633,Vasconcelos; Nuno,9999,0,9999,0
1668479941184,ECE 200,049,103634,Wang; Xiaolong,9999,0,9999,0
1668479941184,ECE 200,050,103635,Xie; Pengtao,9999,0,9999,0
1668479941184,ECE 200,051,103636,Yip; Michael,9999,0,9999,0
1668479941184,ECE 200,052,103637,Zeger; Kenneth A.,999,0,999,0
1668479941184,ECE 200,053,103638,Zhang; Xinyu,9999,0,9999,0
1668479941184,ECE 200,054,103639,Turakhia; Yatish Girish,9999,0,9999,0
1668479941184,ECE 200,055,103640,Kang; Mingu,9999,0,9999,0
1668479941184,ECE 200,056,103641,Shi; Yuanyuan,9999,0,9999,0
1668479941184,ECE 200,057,103642,Wang; Edward Jay,9999,0,9999,0
1668479941184,ECE 200,058,103643,Zheng; Yang,9999,0,9999,0
1668479941611,ECE 202,A00,103644,Kuzum; Duygu,0,41,0,0
1668479942038,ECE 212BN,A00,103646,Ng; Tse Nga,0,9,0,0
1668479942463,ECE 221,A00,111493,Staff,0,0,0,0
1668479942887,ECE 222B,A00,103647,Lomakin; Vitaliy,0,18,0,0
1668479943313,ECE 230B,A00,103648,Taur; Yuan,0,2,0,0
1668479943737,ECE 238B,A00,103649,Garay; Javier,0,0,0,0
1668479944160,ECE 240B,A00,112900,Fainman; Yeshaiahu,0,6,0,0
1668479944602,ECE 247A,A00,103650,Jokerst; Jesse Vincent,0,5,0,0
1668479945032,ECE 247B,A00,103651,Wang; Joseph,0,11,0,0
1668479945462,ECE 250,A00,103652,Siegel; Paul H.,0,80,0,0
1668479945887,ECE 251A,A00,103654,Rao; Bhaskar D.,0,61,0,0
1668479946311,ECE 257B,A00,103655,Bharadia; Dinesh,0,32,0,0
1668479946738,ECE 258A,A00,103656,Milstein; Laurence B.,0,28,0,0
1668479947160,ECE 260B,A00,103658,Kang; Mingu,0,119,0,0
1668479947586,ECE 264A,A00,103659,Galton; Ian A,0,66,0,0
1668479948014,ECE 265A,A00,103661,Gudem; Prasad S.S.,0,65,0,0
1668479948435,ECE 265D,A00,103662,Gudem; Prasad S.S.,0,24,0,0
1668479948858,ECE 268,A00,103663,Koushanfar; Farinaz,0,42,0,0
1668479949288,ECE 269,A01,103665,Pal; Piya,0,208,0,0
1668479949714,ECE 271B,A00,103666,Vasconcelos; Manuela,0,73,0,0
1668479950144,ECE 276A,A00,103667,Atanasov; Nikolay A.,0,121,0,0
1668479950570,ECE 277,A00,103668,An; Cheolhong,0,143,0,0
1668479950992,ECE 279,A00,117947,Hall; Drew A.,0,22,0,0
1668479951851,ECE 283,A00,103670,Hsueh; Tzu-Chien,0,51,0,0
1668479952275,ECE 284,A00,103671,Turakhia; Yatish Girish,0,39,0,0
1668479952703,ECE 285,A00,103672,Zheng; Yang,0,39,0,0
1668479952703,ECE 285,B00,103673,Sworder; David D.,0,55,0,0
1668479953129,ECE 287,A00,103676,Javidi; Tara,0,8,0,0
1668479953553,MATH 200B,A00,098023,Salehi Golsefidy; Alireza,10,0,15,5
1668479953976,MATH 202B,A00,098024,Rhoades; Brendon Patrick,7,0,15,8
1668479954401,MATH 203B,A00,098025,Oprea; Dragos N.,9,0,15,6
1668479954824,MATH 204B,A00,098026,Sorensen; Claus M,13,0,15,2
1668479955248,MATH 208,A00,098027,Izadi; Elham,7,0,10,3
1668479955670,MATH 209,A00,098028,Pollack; Aaron,10,0,10,0
1668479956109,MATH 211A,A00,112919,Rogalski; Daniel,8,0,10,2
1668479956542,MATH 211B,A00,112920,Seward; Brandon M.,9,0,10,1
1668479956967,MATH 218,A00,098029,Li; Bo,10,0,10,0
1668479957394,MATH 220B,A00,098030,Novak; Jonathan I,11,0,15,4
1668479957818,MATH 221A,A00,098031,Ebenfelt; Peter F,12,0,15,3
1668479958248,MATH 231B,A00,098032,Zlatos; Andrej,11,0,15,4
1668479958670,MATH 240B,A00,098033,Ni; Lei,7,0,15,8
1668479959097,MATH 243,A00,098034,Jekel; David Andrew,10,0,10,0
1668479959523,MATH 245A,A00,098035,Nie; Jiawang,0,4,15,18
1668479959946,MATH 248,A00,098036,Bejenaru; Ioan,10,0,10,0
1668479960372,MATH 250B,A00,098037,Spolaor; Luca,14,0,15,1
1668479960806,MATH 258,A00,098038,Ni; Lei,9,0,10,1
1668479961236,MATH 264B,A00,098041,Rhoades; Brendon Patrick,8,0,15,7
1668479961658,MATH 268,A00,098042,Buss; Samuel R,10,0,10,0
1668479962096,MATH 269,A00,098043,Rhoades; Brendon Patrick,10,0,10,0
1668479962524,MATH 270B,A00,098044,Li; Bo,6,0,15,9
1668479962951,MATH 272B,A00,098045,Holst; Michael J,13,0,15,2
1668479963383,MATH 273A,A00,098046,Tian; Xiaochuan,10,0,15,5
1668479963815,MATH 275,A01,098048,Tian; Xiaochuan,6,0,10,4
1668479964238,MATH 278A,A00,098049,Holst; Michael J,7,0,10,3
1668479964672,MATH 278B,A00,098050,Cloninger; Alexander,10,0,10,0
1668479965106,MATH 278C,A00,098051,Nie; Jiawang,5,0,10,5
1668479965529,MATH 280B,A00,098052,Zheng; Tianyi,7,0,15,8
1668479965956,MATH 281B,A00,098053,Bradic; Jelena,0,2,15,15
1668479966383,MATH 282B,A00,098054,Arias-Castro; Ery,0,1,15,15
1668479966806,MATH 285,A00,098055,Fitzsimmons; Patrick J,0,2,15,17
1668479967230,MATH 287B,A00,098056,Arias-Castro; Ery,1,0,15,14
1668479967655,MATH 288,A00,098057,Agarwal; Pooja,9,0,10,1
1668479967655,MATH 288,B00,098058,Zhang; Danna,8,0,10,2
1668479967655,MATH 288,C00,098059,Williams; Ruth J,9,0,10,1
1668479968084,MATH 290B,A00,098060,Roberts; Justin Deritter,12,0,15,3
1668479968508,MATH 292,A00,098061,Belmont; Eva Kinoshita,10,0,10,0
1668479968932,MATH 295,A00,098062,Suk; Andrew Hoon,47,0,50,3
1668479969356,MATH 296,A00,098063,Novak; Jonathan I,20,0,20,0
1668479969778,MATH 297,001,098064,Gamst; Anthony Collins,9997,0,9999,2
1668480471827,COGS 205,A00,101395,Chiba; Andrea,19,0,20,1
1668480472257,COGS 210B,001,101404,Greene; Deanna Jacquelyn,9998,0,9999,1
1668480472257,COGS 210B,002,101417,Xia; Haijun,9999,0,9999,0
1668480472257,COGS 210B,003,101422,Nitz; Douglas A.,9999,0,9999,0
1668480472257,COGS 210B,004,101423,Hollan; James D.,9998,0,9999,1
1668480472257,COGS 210B,005,101424,Deak; Gedeon O.,9998,0,9999,1
1668480472257,COGS 210B,006,101425,Rossano; Federico,9999,0,9999,0
1668480472679,COGS 211B,A00,101427,Coulson; Seana M,9996,0,9999,3
1668480473104,COGS 220,A00,101428,Hollan; James D.,1,9,25,24
1668480473528,COGS 229,A00,101429,Dow; Steven P,17,0,25,8
1668480473950,COGS 230,A00,101430,Klemmer; Scott R,8,0,17,9
1668480474374,COGS 234,A00,101431,Xia; Haijun,2,0,25,23
1668480474801,COGS 260,A00,101432,Kiyonaga; Anastasia,21,0,25,4
1668480474801,COGS 260,B00,101433,Kirsh; David Joel,15,0,25,10
1668480475225,CSE 202,A00,102371,Impagliazzo; Russell,0,61,0,0
1668480475649,CSE 203B,A01,102373,Cheng; Chung Kuan,0,52,0,0
1668480476073,CSE 208,A00,102374,Micciancio; Daniele,0,5,0,0
1668480476505,CSE 209A,A00,112895,Impagliazzo; Russell,0,12,15,15
1668480476926,CSE 209B,A00,108005,Bellare; Mihir,0,6,0,0
1668480477359,CSE 210,A00,113163,Coblenz; Michael J,0,80,0,0
1668480477784,CSE 219,A00,106111,Dow; Steven P,0,6,20,20
1668480478206,CSE 221,A00,102376,Voelker; Geoffrey M.,0,68,0,0
1668480478631,CSE 224,A01,102378,Porter; George M,0,159,0,0
1668480479059,CSE 229A,A00,102379,Savage; Stefan,0,10,0,0
1668480479491,CSE 229C,A00,102380,Munyaka; Imani N. S.,0,9,0,0
1668480479916,CSE 232B,A00,102382,Deutsch; Alin Bernard,0,30,0,0
1668480480340,CSE 234,A01,112904,Kumar; Arun Kumar,0,0,0,0
1668480480763,CSE 237A,A00,102383,Rosing; Tajana Simunic,0,49,0,0
1668480481186,CSE 239A,A00,102384,Deutsch; Alin Bernard,0,13,0,0
1668480481615,CSE 239B,A00,102385,Polikarpova; Nadezhda,0,10,0,0
1668480482045,CSE 240A,A00,102386,Pannuto; Patrick William,0,44,0,0
1668480482473,CSE 240B,A00,102387,Zhao; Jishen,0,42,0,0
1668480482894,CSE 241A,A00,106406,Kang; Mingu,0,6,0,0
1668480483326,CSE 249B,A00,102388,Kahng; Andrew Byun,0,5,8,8
1668480483752,CSE 251B,A01,102392,Cottrell; Garrison W,0,45,0,0
1668480483752,CSE 251B,A02,102393,Cottrell; Garrison W,0,33,0,0
1668480484176,CSE 252B,A00,102394,Ochoa; Benjamin Lawrence,0,56,0,0
1668480484609,CSE 257,A01,102396,Gao; Sicun,0,131,0,0
1668480485035,CSE 272,A00,102397,Li; Tzumao,0,17,0,0
1668480485460,CSE 274,A00,111323,Chern; Albert Ren-Haur,0,15,0,0
1668480485881,CSE 282,A00,102398,Pevzner; Pavel Arkadjevich,0,0,0,0
1668480486307,CSE 284,A00,114175,Gymrek; Melissa Ann,0,20,0,0
1668480486733,CSE 290,A00,102399,Chandraker; Manmohan Krishna,0,11,0,0
1668480486733,CSE 290,B00,102400,Vaccaro; Kristen Marie,0,7,25,25
1668480486733,CSE 290,C00,102414,Pannuto; Patrick William,0,1,25,25
1668480486733,CSE 290,D00,102427,Pevzner; Pavel Arkadjevich,0,0,0,0
1668480486733,CSE 290,E00,102429,Zhao; Jishen,0,4,0,0
1668480486733,CSE 290,F00,102436,Tullsen; Dean Michael,0,5,0,0
1668480486733,CSE 290,G00,102440,Christensen; Henrik I,0,6,20,20
1668480487166,CSE 291,A00,102443,Su; Hao,0,0,0,0
1668480487166,CSE 291,B00,102448,Polikarpova; Nadezhda,0,0,0,0
1668480487166,CSE 291,C00,102453,Vaccaro; Kristen Marie,0,0,0,0
1668480487166,CSE 291,D00,111343,Savage; Stefan,0,0,0,0
1668480487166,CSE 291,E00,116474,Claffy; Kimberly Claire,0,0,0,0
1668480487166,CSE 291,F00,116479,Pasquale; Joseph,0,0,0,0
1668480487603,CSE 293,001,119111,Bafna; Vineet,9999,0,9999,0
1668480487603,CSE 293,002,119118,Bellare; Mihir,9999,0,9999,0
1668480487603,CSE 293,003,119122,Berg-Kirkpatrick; Taylor D,9999,0,9999,0
1668480487603,CSE 293,004,119135,Christensen; Henrik I,9999,0,9999,0
1668480487603,CSE 293,005,119142,Cottrell; Garrison W,9999,0,9999,0
1668480487603,CSE 293,006,119146,Deutsch; Alin Bernard,9999,0,9999,0
1668480487603,CSE 293,007,119159,Esmaeilzadeh; Hadi,9999,0,9999,0
1668480487603,CSE 293,008,119166,Freund; Yoav,9999,0,9999,0
1668480487603,CSE 293,009,119170,Griswold; William G.,9999,0,9999,0
1668480487603,CSE 293,010,119183,Gymrek; Melissa Ann,9999,0,9999,0
1668480487603,CSE 293,011,119190,Heninger; Nadia A,9999,0,9999,0
1668480487603,CSE 293,012,119230,Impagliazzo; Russell,9999,0,9999,0
1668480487603,CSE 293,013,119232,Jhala; Ranjit,9999,0,9999,0
1668480487603,CSE 293,014,119233,Kahng; Andrew Byun,9999,0,9999,0
1668480487603,CSE 293,015,119298,Kane; Daniel Mertz,9999,0,9999,0
1668480487603,CSE 293,016,119299,Kriegman; David J,9999,0,9999,0
1668480487603,CSE 293,017,119300,Kumar; Arun Kumar,9999,0,9999,0
1668480487603,CSE 293,018,119301,Lerner; Sorin,9999,0,9999,0
1668480487603,CSE 293,019,119302,Lovett; Shachar,9999,0,9999,0
1668480487603,CSE 293,020,119303,McAuley; Julian John,9999,0,9999,0
1668480487603,CSE 293,021,119304,Micciancio; Daniele,9999,0,9999,0
1668480487603,CSE 293,022,119367,Orailoglu; Alex,9999,0,9999,0
1668480487603,CSE 293,023,119382,Paturi; Ramamohan,9999,0,9999,0
1668480487603,CSE 293,024,119404,Polikarpova; Nadezhda,9999,0,9999,0
1668480487603,CSE 293,025,119406,Politz; Joseph Gibbs,9999,0,9999,0
1668480487603,CSE 293,026,119411,Porter; George M,9999,0,9999,0
1668480487603,CSE 293,027,119414,Porter; Leonard Emerson,9999,0,9999,0
1668480487603,CSE 293,028,119416,Ramamoorthi; Ravi,9999,0,9999,0
1668480487603,CSE 293,029,119417,Sahoo; Debashis,9999,0,9999,0
1668480487603,CSE 293,030,119420,Saul; Lawrence,9999,0,9999,0
1668480487603,CSE 293,031,119421,Savage; Stefan,9999,0,9999,0
1668480487603,CSE 293,032,119425,Schulze; Jurgen P.,9999,0,9999,0
1668480487603,CSE 293,033,119426,Snoeren; Alex C.,9999,0,9999,0
1668480487603,CSE 293,034,119428,Shang; Jingbo,9999,0,9999,0
1668480487603,CSE 293,035,119430,Stefan; Deian,9999,0,9999,0
1668480487603,CSE 293,036,119431,Su; Hao,9999,0,9999,0
1668480487603,CSE 293,037,119433,Swanson; Steven James,9999,0,9999,0
1668480487603,CSE 293,038,119435,Tullsen; Dean Michael,9999,0,9999,0
1668480487603,CSE 293,039,119483,Voelker; Geoffrey M.,9999,0,9999,0
1668480487603,CSE 293,040,119537,Zhao; Jishen,9999,0,9999,0
1668480487603,CSE 293,041,119538,Zhou; Yuan-Yuan,9999,0,9999,0
1668480487603,CSE 293,042,119539,Gao; Sicun,9999,0,9999,0
1668480487603,CSE 293,043,119540,Weibel; Nadir,9999,0,9999,0
1668480487603,CSE 293,044,119541,Gupta; Rajesh K.,9999,0,9999,0
1668480487603,CSE 293,045,126410,Vaccaro; Kristen Marie,9999,0,9999,0
1668480487603,CSE 293,046,126411,Klemke; Richard,9999,0,9999,0
1668480488027,CSE 294,A00,102459,Voelker; Geoffrey M.,0,2,0,0
1668480488027,CSE 294,B00,111322,Orailoglu; Alex,0,2,0,0
1668480488450,DSE 201,A00,096914,Deutsch; Alin Bernard,30,0,30,0
1668480488875,DSE 210,A00,096915,Dasgupta; Sanjoy,30,0,30,0
1668480489299,DSE 260A,A00,096916,Altintas De Callaf; Ilkay,30,0,30,0
1668480489749,ECE 200,001,103586,Antipa; Nicholas A,9999,0,9999,0
1668480489749,ECE 200,002,103587,Atanasov; Nikolay A.,9999,0,9999,0
1668480489749,ECE 200,003,103588,Bharadia; Dinesh,9999,0,9999,0
1668480489749,ECE 200,004,103589,Cheng; Chung Kuan,9999,0,9999,0
1668480489749,ECE 200,005,103590,Cosman; Pamela C.,9999,0,9999,0
1668480489749,ECE 200,006,103591,Dayeh; Shadi Ahmad,9999,0,9999,0
1668480489749,ECE 200,007,103592,Fainman; Yeshaiahu,9999,0,9999,0
1668480489749,ECE 200,008,103593,Ford; Joseph Earl,9999,0,9999,0
1668480489749,ECE 200,009,103594,Franceschetti; Massimo,9999,0,9999,0
1668480489749,ECE 200,010,103595,Fullerton; Eric E,9999,0,9999,0
1668480489749,ECE 200,011,103596,Galton; Ian A,9999,0,9999,0
1668480489749,ECE 200,012,103597,Gilja; Vikash,9999,0,9999,0
1668480489749,ECE 200,013,103598,Hall; Drew A.,9999,0,9999,0
1668480489749,ECE 200,014,103599,Hsueh; Tzu-Chien,9999,0,9999,0
1668480489749,ECE 200,015,103600,Javidi; Tara,9999,0,9999,0
1668480489749,ECE 200,016,103601,Kahng; Andrew Byun,9999,0,9999,0
1668480489749,ECE 200,017,103602,Kim; Young-Han,9999,0,9999,0
1668480489749,ECE 200,018,103603,Koushanfar; Farinaz,9999,0,9999,0
1668480489749,ECE 200,019,103604,Kuzum; Duygu,9999,0,9999,0
1668480489749,ECE 200,020,103605,Le; Hanh-Phuc,9999,0,9999,0
1668480489749,ECE 200,021,103606,Lin; Bill,9999,0,9999,0
1668480489749,ECE 200,022,103607,Liu; Zhaowei,9998,0,9999,1
1668480489749,ECE 200,023,103608,Lo; Yu-Hwa,9999,0,9999,0
1668480489749,ECE 200,024,103609,Lomakin; Vitaliy,9999,0,9999,0
1668480489749,ECE 200,025,103610,Mercier; Patrick Philip,9999,0,9999,0
1668480489749,ECE 200,026,103611,Meyer; Florian,9999,0,9999,0
1668480489749,ECE 200,027,103612,Milstein; Laurence B.,9999,0,9999,0
1668480489749,ECE 200,028,103613,Mir Arabbaygi; Siavash,9999,0,9999,0
1668480489749,ECE 200,029,103614,Mookherjea; Shayan,9999,0,9999,0
1668480489749,ECE 200,030,103615,Morris; Karcher William,9999,0,9999,0
1668480489749,ECE 200,031,103616,Ng; Tse Nga,9999,0,9999,0
1668480489749,ECE 200,032,103617,Nguyen; Truong Quang,9999,0,9999,0
1668480489749,ECE 200,033,103618,Nomura; Kenji,9999,0,9999,0
1668480489749,ECE 200,034,103619,Orlitsky; Alon,9999,0,9999,0
1668480489749,ECE 200,035,103620,Pal; Piya,9999,0,9999,0
1668480489749,ECE 200,036,103621,Papen; George C.,9999,0,9999,0
1668480489749,ECE 200,037,103622,Radic; Stojan,9999,0,9999,0
1668480489749,ECE 200,038,103623,Rao; Bhaskar D.,9999,0,9999,0
1668480489749,ECE 200,039,103624,Rao; Ramesh R,9999,0,9999,0
1668480489749,ECE 200,040,103625,Rebeiz; Gabriel,9999,0,9999,0
1668480489749,ECE 200,041,103626,Sanford; John R,9999,0,9999,0
1668480489749,ECE 200,042,103627,Siegel; Paul H.,9999,0,9999,0
1668480489749,ECE 200,043,103628,Sievenpiper; Daniel F.,9999,0,9999,0
1668480489749,ECE 200,044,103629,Sworder; David D.,9999,0,9999,0
1668480489749,ECE 200,045,103630,Taur; Yuan,9999,0,9999,0
1668480489749,ECE 200,046,103631,Touri; Behrouz,9999,0,9999,0
1668480489749,ECE 200,047,103632,Trivedi; Mohan M.,9999,0,9999,0
1668480489749,ECE 200,048,103633,Vasconcelos; Nuno,9999,0,9999,0
1668480489749,ECE 200,049,103634,Wang; Xiaolong,9999,0,9999,0
1668480489749,ECE 200,050,103635,Xie; Pengtao,9999,0,9999,0
1668480489749,ECE 200,051,103636,Yip; Michael,9999,0,9999,0
1668480489749,ECE 200,052,103637,Zeger; Kenneth A.,999,0,999,0
1668480489749,ECE 200,053,103638,Zhang; Xinyu,9999,0,9999,0
1668480489749,ECE 200,054,103639,Turakhia; Yatish Girish,9999,0,9999,0
1668480489749,ECE 200,055,103640,Kang; Mingu,9999,0,9999,0
1668480489749,ECE 200,056,103641,Shi; Yuanyuan,9999,0,9999,0
1668480489749,ECE 200,057,103642,Wang; Edward Jay,9999,0,9999,0
1668480489749,ECE 200,058,103643,Zheng; Yang,9999,0,9999,0
1668480490175,ECE 202,A00,103644,Kuzum; Duygu,0,41,0,0
1668480490600,ECE 212BN,A00,103646,Ng; Tse Nga,0,9,0,0
1668480491023,ECE 221,A00,111493,Staff,0,0,0,0
1668480491453,ECE 222B,A00,103647,Lomakin; Vitaliy,0,18,0,0
1668480491877,ECE 230B,A00,103648,Taur; Yuan,0,2,0,0
1668480492300,ECE 238B,A00,103649,Garay; Javier,0,0,0,0
1668480492724,ECE 240B,A00,112900,Fainman; Yeshaiahu,0,6,0,0
1668480493147,ECE 247A,A00,103650,Jokerst; Jesse Vincent,0,5,0,0
1668480493570,ECE 247B,A00,103651,Wang; Joseph,0,11,0,0
1668480493996,ECE 250,A00,103652,Siegel; Paul H.,0,81,0,0
1668480494424,ECE 251A,A00,103654,Rao; Bhaskar D.,0,61,0,0
1668480494848,ECE 257B,A00,103655,Bharadia; Dinesh,0,32,0,0
1668480495270,ECE 258A,A00,103656,Milstein; Laurence B.,0,28,0,0
1668480495697,ECE 260B,A00,103658,Kang; Mingu,0,119,0,0
1668480496124,ECE 264A,A00,103659,Galton; Ian A,0,66,0,0
1668480496554,ECE 265A,A00,103661,Gudem; Prasad S.S.,0,65,0,0
1668480496978,ECE 265D,A00,103662,Gudem; Prasad S.S.,0,24,0,0
1668480497401,ECE 268,A00,103663,Koushanfar; Farinaz,0,42,0,0
1668480497828,ECE 269,A01,103665,Pal; Piya,0,209,0,0
1668480498252,ECE 271B,A00,103666,Vasconcelos; Manuela,0,73,0,0
1668480498676,ECE 276A,A00,103667,Atanasov; Nikolay A.,0,122,0,0
1668480499105,ECE 277,A00,103668,An; Cheolhong,0,143,0,0
1668480499528,ECE 279,A00,117947,Hall; Drew A.,0,22,0,0
1668480500381,ECE 283,A00,103670,Hsueh; Tzu-Chien,0,51,0,0
1668480500804,ECE 284,A00,103671,Turakhia; Yatish Girish,0,39,0,0
1668480501229,ECE 285,A00,103672,Zheng; Yang,0,39,0,0
1668480501229,ECE 285,B00,103673,Sworder; David D.,0,55,0,0
1668480501653,ECE 287,A00,103676,Javidi; Tara,0,8,0,0
1668480502077,MATH 200B,A00,098023,Salehi Golsefidy; Alireza,10,0,15,5
1668480502502,MATH 202B,A00,098024,Rhoades; Brendon Patrick,7,0,15,8
1668480503020,MATH 203B,A00,098025,Oprea; Dragos N.,9,0,15,6
1668480503443,MATH 204B,A00,098026,Sorensen; Claus M,13,0,15,2
1668480503868,MATH 208,A00,098027,Izadi; Elham,7,0,10,3
1668480504292,MATH 209,A00,098028,Pollack; Aaron,10,0,10,0
1668480504718,MATH 211A,A00,112919,Rogalski; Daniel,8,0,10,2
1668480505142,MATH 211B,A00,112920,Seward; Brandon M.,9,0,10,1
1668480505566,MATH 218,A00,098029,Li; Bo,10,0,10,0
1668480505990,MATH 220B,A00,098030,Novak; Jonathan I,11,0,15,4
1668480506414,MATH 221A,A00,098031,Ebenfelt; Peter F,12,0,15,3
1668480506837,MATH 231B,A00,098032,Zlatos; Andrej,11,0,15,4
1668480507261,MATH 240B,A00,098033,Ni; Lei,7,0,15,8
1668480507685,MATH 243,A00,098034,Jekel; David Andrew,10,0,10,0
1668480508112,MATH 245A,A00,098035,Nie; Jiawang,0,4,15,18
1668480508537,MATH 248,A00,098036,Bejenaru; Ioan,10,0,10,0
1668480508961,MATH 250B,A00,098037,Spolaor; Luca,14,0,15,1
1668480509383,MATH 258,A00,098038,Ni; Lei,9,0,10,1
1668480509807,MATH 264B,A00,098041,Rhoades; Brendon Patrick,8,0,15,7
1668480510231,MATH 268,A00,098042,Buss; Samuel R,10,0,10,0
1668480510656,MATH 269,A00,098043,Rhoades; Brendon Patrick,10,0,10,0
1668480511088,MATH 270B,A00,098044,Li; Bo,6,0,15,9
1668480511514,MATH 272B,A00,098045,Holst; Michael J,13,0,15,2
1668480511940,MATH 273A,A00,098046,Tian; Xiaochuan,10,0,15,5
1668480512373,MATH 275,A01,098048,Tian; Xiaochuan,6,0,10,4
1668480512803,MATH 278A,A00,098049,Holst; Michael J,7,0,10,3
1668480513229,MATH 278B,A00,098050,Cloninger; Alexander,10,0,10,0
1668480513653,MATH 278C,A00,098051,Nie; Jiawang,5,0,10,5
1668480514076,MATH 280B,A00,098052,Zheng; Tianyi,7,0,15,8
1668480514518,MATH 281B,A00,098053,Bradic; Jelena,0,2,15,15
1668480514943,MATH 282B,A00,098054,Arias-Castro; Ery,0,1,15,15
1668480515371,MATH 285,A00,098055,Fitzsimmons; Patrick J,0,2,15,17
1668480515800,MATH 287B,A00,098056,Arias-Castro; Ery,1,0,15,14
1668480516225,MATH 288,A00,098057,Agarwal; Pooja,9,0,10,1
1668480516225,MATH 288,B00,098058,Zhang; Danna,8,0,10,2
1668480516225,MATH 288,C00,098059,Williams; Ruth J,9,0,10,1
1668480516656,MATH 290B,A00,098060,Roberts; Justin Deritter,12,0,15,3
1668480517086,MATH 292,A00,098061,Belmont; Eva Kinoshita,10,0,10,0
1668480517510,MATH 295,A00,098062,Suk; Andrew Hoon,47,0,50,3
1668480517932,MATH 296,A00,098063,Novak; Jonathan I,20,0,20,0
1668480518359,MATH 297,001,098064,Gamst; Anthony Collins,9997,0,9999,2
1668481020497,COGS 205,A00,101395,Chiba; Andrea,19,0,20,1
1668481020919,COGS 210B,001,101404,Greene; Deanna Jacquelyn,9998,0,9999,1
1668481020919,COGS 210B,002,101417,Xia; Haijun,9999,0,9999,0
1668481020919,COGS 210B,003,101422,Nitz; Douglas A.,9999,0,9999,0
1668481020919,COGS 210B,004,101423,Hollan; James D.,9998,0,9999,1
1668481020919,COGS 210B,005,101424,Deak; Gedeon O.,9998,0,9999,1
1668481020919,COGS 210B,006,101425,Rossano; Federico,9999,0,9999,0
1668481021345,COGS 211B,A00,101427,Coulson; Seana M,9996,0,9999,3
1668481021770,COGS 220,A00,101428,Hollan; James D.,1,9,25,24
1668481022202,COGS 229,A00,101429,Dow; Steven P,17,0,25,8
1668481022639,COGS 230,A00,101430,Klemmer; Scott R,8,0,17,9
1668481023063,COGS 234,A00,101431,Xia; Haijun,2,0,25,23
1668481023486,COGS 260,A00,101432,Kiyonaga; Anastasia,21,0,25,4
1668481023486,COGS 260,B00,101433,Kirsh; David Joel,15,0,25,10
1668481024005,CSE 202,A00,102371,Impagliazzo; Russell,0,61,0,0
1668481024431,CSE 203B,A01,102373,Cheng; Chung Kuan,0,52,0,0
1668481024852,CSE 208,A00,102374,Micciancio; Daniele,0,5,0,0
1668481025275,CSE 209A,A00,112895,Impagliazzo; Russell,0,12,15,15
1668481025699,CSE 209B,A00,108005,Bellare; Mihir,0,6,0,0
1668481026127,CSE 210,A00,113163,Coblenz; Michael J,0,80,0,0
1668481026553,CSE 219,A00,106111,Dow; Steven P,0,6,20,20
1668481026979,CSE 221,A00,102376,Voelker; Geoffrey M.,0,68,0,0
1668481027408,CSE 224,A01,102378,Porter; George M,0,159,0,0
1668481027840,CSE 229A,A00,102379,Savage; Stefan,0,10,0,0
1668481028266,CSE 229C,A00,102380,Munyaka; Imani N. S.,0,9,0,0
1668481028691,CSE 232B,A00,102382,Deutsch; Alin Bernard,0,30,0,0
1668481029114,CSE 234,A01,112904,Kumar; Arun Kumar,0,0,0,0
1668481029542,CSE 237A,A00,102383,Rosing; Tajana Simunic,0,49,0,0
1668481029965,CSE 239A,A00,102384,Deutsch; Alin Bernard,0,13,0,0
1668481030393,CSE 239B,A00,102385,Polikarpova; Nadezhda,0,10,0,0
1668481030818,CSE 240A,A00,102386,Pannuto; Patrick William,0,44,0,0
1668481031241,CSE 240B,A00,102387,Zhao; Jishen,0,42,0,0
1668481031668,CSE 241A,A00,106406,Kang; Mingu,0,6,0,0
1668481032094,CSE 249B,A00,102388,Kahng; Andrew Byun,0,5,8,8
1668481032519,CSE 251B,A01,102392,Cottrell; Garrison W,0,45,0,0
1668481032519,CSE 251B,A02,102393,Cottrell; Garrison W,0,33,0,0
1668481032953,CSE 252B,A00,102394,Ochoa; Benjamin Lawrence,0,56,0,0
1668481033376,CSE 257,A01,102396,Gao; Sicun,0,131,0,0
1668481033803,CSE 272,A00,102397,Li; Tzumao,0,17,0,0
1668481034228,CSE 274,A00,111323,Chern; Albert Ren-Haur,0,15,0,0
1668481034652,CSE 282,A00,102398,Pevzner; Pavel Arkadjevich,0,0,0,0
1668481035079,CSE 284,A00,114175,Gymrek; Melissa Ann,0,20,0,0
1668481035523,CSE 290,A00,102399,Chandraker; Manmohan Krishna,0,11,0,0
1668481035523,CSE 290,B00,102400,Vaccaro; Kristen Marie,0,7,25,25
1668481035523,CSE 290,C00,102414,Pannuto; Patrick William,0,1,25,25
1668481035523,CSE 290,D00,102427,Pevzner; Pavel Arkadjevich,0,0,0,0
1668481035523,CSE 290,E00,102429,Zhao; Jishen,0,4,0,0
1668481035523,CSE 290,F00,102436,Tullsen; Dean Michael,0,5,0,0
1668481035523,CSE 290,G00,102440,Christensen; Henrik I,0,6,20,20
1668481035957,CSE 291,A00,102443,Su; Hao,0,0,0,0
1668481035957,CSE 291,B00,102448,Polikarpova; Nadezhda,0,0,0,0
1668481035957,CSE 291,C00,102453,Vaccaro; Kristen Marie,0,0,0,0
1668481035957,CSE 291,D00,111343,Savage; Stefan,0,0,0,0
1668481035957,CSE 291,E00,116474,Claffy; Kimberly Claire,0,0,0,0
1668481035957,CSE 291,F00,116479,Pasquale; Joseph,0,0,0,0
1668481036386,CSE 293,001,119111,Bafna; Vineet,9999,0,9999,0
1668481036386,CSE 293,002,119118,Bellare; Mihir,9999,0,9999,0
1668481036386,CSE 293,003,119122,Berg-Kirkpatrick; Taylor D,9999,0,9999,0
1668481036386,CSE 293,004,119135,Christensen; Henrik I,9999,0,9999,0
1668481036386,CSE 293,005,119142,Cottrell; Garrison W,9999,0,9999,0
1668481036386,CSE 293,006,119146,Deutsch; Alin Bernard,9999,0,9999,0
1668481036386,CSE 293,007,119159,Esmaeilzadeh; Hadi,9999,0,9999,0
1668481036386,CSE 293,008,119166,Freund; Yoav,9999,0,9999,0
1668481036386,CSE 293,009,119170,Griswold; William G.,9999,0,9999,0
1668481036386,CSE 293,010,119183,Gymrek; Melissa Ann,9999,0,9999,0
1668481036386,CSE 293,011,119190,Heninger; Nadia A,9999,0,9999,0
1668481036386,CSE 293,012,119230,Impagliazzo; Russell,9999,0,9999,0
1668481036386,CSE 293,013,119232,Jhala; Ranjit,9999,0,9999,0
1668481036386,CSE 293,014,119233,Kahng; Andrew Byun,9999,0,9999,0
1668481036386,CSE 293,015,119298,Kane; Daniel Mertz,9999,0,9999,0
1668481036386,CSE 293,016,119299,Kriegman; David J,9999,0,9999,0
1668481036386,CSE 293,017,119300,Kumar; Arun Kumar,9999,0,9999,0
1668481036386,CSE 293,018,119301,Lerner; Sorin,9999,0,9999,0
1668481036386,CSE 293,019,119302,Lovett; Shachar,9999,0,9999,0
1668481036386,CSE 293,020,119303,McAuley; Julian John,9999,0,9999,0
1668481036386,CSE 293,021,119304,Micciancio; Daniele,9999,0,9999,0
1668481036386,CSE 293,022,119367,Orailoglu; Alex,9999,0,9999,0
1668481036386,CSE 293,023,119382,Paturi; Ramamohan,9999,0,9999,0
1668481036386,CSE 293,024,119404,Polikarpova; Nadezhda,9999,0,9999,0
1668481036386,CSE 293,025,119406,Politz; Joseph Gibbs,9999,0,9999,0
1668481036386,CSE 293,026,119411,Porter; George M,9999,0,9999,0
1668481036386,CSE 293,027,119414,Porter; Leonard Emerson,9999,0,9999,0
1668481036386,CSE 293,028,119416,Ramamoorthi; Ravi,9999,0,9999,0
1668481036386,CSE 293,029,119417,Sahoo; Debashis,9999,0,9999,0
1668481036386,CSE 293,030,119420,Saul; Lawrence,9999,0,9999,0
1668481036386,CSE 293,031,119421,Savage; Stefan,9999,0,9999,0
1668481036386,CSE 293,032,119425,Schulze; Jurgen P.,9999,0,9999,0
1668481036386,CSE 293,033,119426,Snoeren; Alex C.,9999,0,9999,0
1668481036386,CSE 293,034,119428,Shang; Jingbo,9999,0,9999,0
1668481036386,CSE 293,035,119430,Stefan; Deian,9999,0,9999,0
1668481036386,CSE 293,036,119431,Su; Hao,9999,0,9999,0
1668481036386,CSE 293,037,119433,Swanson; Steven James,9999,0,9999,0
1668481036386,CSE 293,038,119435,Tullsen; Dean Michael,9999,0,9999,0
1668481036386,CSE 293,039,119483,Voelker; Geoffrey M.,9999,0,9999,0
1668481036386,CSE 293,040,119537,Zhao; Jishen,9999,0,9999,0
1668481036386,CSE 293,041,119538,Zhou; Yuan-Yuan,9999,0,9999,0
1668481036386,CSE 293,042,119539,Gao; Sicun,9999,0,9999,0
1668481036386,CSE 293,043,119540,Weibel; Nadir,9999,0,9999,0
1668481036386,CSE 293,044,119541,Gupta; Rajesh K.,9999,0,9999,0
1668481036386,CSE 293,045,126410,Vaccaro; Kristen Marie,9999,0,9999,0
1668481036386,CSE 293,046,126411,Klemke; Richard,9999,0,9999,0
1668481036810,CSE 294,A00,102459,Voelker; Geoffrey M.,0,2,0,0
1668481036810,CSE 294,B00,111322,Orailoglu; Alex,0,2,0,0
1668481037243,DSE 201,A00,096914,Deutsch; Alin Bernard,30,0,30,0
1668481037677,DSE 210,A00,096915,Dasgupta; Sanjoy,30,0,30,0
1668481038112,DSE 260A,A00,096916,Altintas De Callaf; Ilkay,30,0,30,0
1668481038576,ECE 200,001,103586,Antipa; Nicholas A,9999,0,9999,0
1668481038576,ECE 200,002,103587,Atanasov; Nikolay A.,9999,0,9999,0
1668481038576,ECE 200,003,103588,Bharadia; Dinesh,9999,0,9999,0
1668481038576,ECE 200,004,103589,Cheng; Chung Kuan,9999,0,9999,0
1668481038576,ECE 200,005,103590,Cosman; Pamela C.,9999,0,9999,0
1668481038576,ECE 200,006,103591,Dayeh; Shadi Ahmad,9999,0,9999,0
1668481038576,ECE 200,007,103592,Fainman; Yeshaiahu,9999,0,9999,0
1668481038576,ECE 200,008,103593,Ford; Joseph Earl,9999,0,9999,0
1668481038576,ECE 200,009,103594,Franceschetti; Massimo,9999,0,9999,0
1668481038576,ECE 200,010,103595,Fullerton; Eric E,9999,0,9999,0
1668481038576,ECE 200,011,103596,Galton; Ian A,9999,0,9999,0
1668481038576,ECE 200,012,103597,Gilja; Vikash,9999,0,9999,0
1668481038576,ECE 200,013,103598,Hall; Drew A.,9999,0,9999,0
1668481038576,ECE 200,014,103599,Hsueh; Tzu-Chien,9999,0,9999,0
1668481038576,ECE 200,015,103600,Javidi; Tara,9999,0,9999,0
1668481038576,ECE 200,016,103601,Kahng; Andrew Byun,9999,0,9999,0
1668481038576,ECE 200,017,103602,Kim; Young-Han,9999,0,9999,0
1668481038576,ECE 200,018,103603,Koushanfar; Farinaz,9999,0,9999,0
1668481038576,ECE 200,019,103604,Kuzum; Duygu,9999,0,9999,0
1668481038576,ECE 200,020,103605,Le; Hanh-Phuc,9999,0,9999,0
1668481038576,ECE 200,021,103606,Lin; Bill,9999,0,9999,0
1668481038576,ECE 200,022,103607,Liu; Zhaowei,9998,0,9999,1
1668481038576,ECE 200,023,103608,Lo; Yu-Hwa,9999,0,9999,0
1668481038576,ECE 200,024,103609,Lomakin; Vitaliy,9999,0,9999,0
1668481038576,ECE 200,025,103610,Mercier; Patrick Philip,9999,0,9999,0
1668481038576,ECE 200,026,103611,Meyer; Florian,9999,0,9999,0
1668481038576,ECE 200,027,103612,Milstein; Laurence B.,9999,0,9999,0
1668481038576,ECE 200,028,103613,Mir Arabbaygi; Siavash,9999,0,9999,0
1668481038576,ECE 200,029,103614,Mookherjea; Shayan,9999,0,9999,0
1668481038576,ECE 200,030,103615,Morris; Karcher William,9999,0,9999,0
1668481038576,ECE 200,031,103616,Ng; Tse Nga,9999,0,9999,0
1668481038576,ECE 200,032,103617,Nguyen; Truong Quang,9999,0,9999,0
1668481038576,ECE 200,033,103618,Nomura; Kenji,9999,0,9999,0
1668481038576,ECE 200,034,103619,Orlitsky; Alon,9999,0,9999,0
1668481038576,ECE 200,035,103620,Pal; Piya,9999,0,9999,0
1668481038576,ECE 200,036,103621,Papen; George C.,9999,0,9999,0
1668481038576,ECE 200,037,103622,Radic; Stojan,9999,0,9999,0
1668481038576,ECE 200,038,103623,Rao; Bhaskar D.,9999,0,9999,0
1668481038576,ECE 200,039,103624,Rao; Ramesh R,9999,0,9999,0
1668481038576,ECE 200,040,103625,Rebeiz; Gabriel,9999,0,9999,0
1668481038576,ECE 200,041,103626,Sanford; John R,9999,0,9999,0
1668481038576,ECE 200,042,103627,Siegel; Paul H.,9999,0,9999,0
1668481038576,ECE 200,043,103628,Sievenpiper; Daniel F.,9999,0,9999,0
1668481038576,ECE 200,044,103629,Sworder; David D.,9999,0,9999,0
1668481038576,ECE 200,045,103630,Taur; Yuan,9999,0,9999,0
1668481038576,ECE 200,046,103631,Touri; Behrouz,9999,0,9999,0
1668481038576,ECE 200,047,103632,Trivedi; Mohan M.,9999,0,9999,0
1668481038576,ECE 200,048,103633,Vasconcelos; Nuno,9999,0,9999,0
1668481038576,ECE 200,049,103634,Wang; Xiaolong,9999,0,9999,0
1668481038576,ECE 200,050,103635,Xie; Pengtao,9999,0,9999,0
1668481038576,ECE 200,051,103636,Yip; Michael,9999,0,9999,0
1668481038576,ECE 200,052,103637,Zeger; Kenneth A.,999,0,999,0
1668481038576,ECE 200,053,103638,Zhang; Xinyu,9999,0,9999,0
1668481038576,ECE 200,054,103639,Turakhia; Yatish Girish,9999,0,9999,0
1668481038576,ECE 200,055,103640,Kang; Mingu,9999,0,9999,0
1668481038576,ECE 200,056,103641,Shi; Yuanyuan,9999,0,9999,0
1668481038576,ECE 200,057,103642,Wang; Edward Jay,9999,0,9999,0
1668481038576,ECE 200,058,103643,Zheng; Yang,9999,0,9999,0
1668481039007,ECE 202,A00,103644,Kuzum; Duygu,0,42,0,0
1668481039434,ECE 212BN,A00,103646,Ng; Tse Nga,0,9,0,0
1668481039861,ECE 221,A00,111493,Staff,0,0,0,0
1668481040285,ECE 222B,A00,103647,Lomakin; Vitaliy,0,18,0,0
1668481040712,ECE 230B,A00,103648,Taur; Yuan,0,2,0,0
1668481041138,ECE 238B,A00,103649,Garay; Javier,0,0,0,0
1668481041564,ECE 240B,A00,112900,Fainman; Yeshaiahu,0,6,0,0
1668481042000,ECE 247A,A00,103650,Jokerst; Jesse Vincent,0,5,0,0
1668481042423,ECE 247B,A00,103651,Wang; Joseph,0,11,0,0
1668481042861,ECE 250,A00,103652,Siegel; Paul H.,0,81,0,0
1668481043287,ECE 251A,A00,103654,Rao; Bhaskar D.,0,61,0,0
1668481043714,ECE 257B,A00,103655,Bharadia; Dinesh,0,32,0,0
1668481044138,ECE 258A,A00,103656,Milstein; Laurence B.,0,28,0,0
1668481044565,ECE 260B,A00,103658,Kang; Mingu,0,119,0,0
1668481044992,ECE 264A,A00,103659,Galton; Ian A,0,66,0,0
1668481045415,ECE 265A,A00,103661,Gudem; Prasad S.S.,0,65,0,0
1668481045839,ECE 265D,A00,103662,Gudem; Prasad S.S.,0,24,0,0
1668481046263,ECE 268,A00,103663,Koushanfar; Farinaz,0,42,0,0
1668481046690,ECE 269,A01,103665,Pal; Piya,0,210,0,0
1668481047117,ECE 271B,A00,103666,Vasconcelos; Manuela,0,74,0,0
1668481047548,ECE 276A,A00,103667,Atanasov; Nikolay A.,0,122,0,0
1668481047970,ECE 277,A00,103668,An; Cheolhong,0,144,0,0
1668481048402,ECE 279,A00,117947,Hall; Drew A.,0,22,0,0
1668481049255,ECE 283,A00,103670,Hsueh; Tzu-Chien,0,51,0,0
1668481049679,ECE 284,A00,103671,Turakhia; Yatish Girish,0,39,0,0
1668481050111,ECE 285,A00,103672,Zheng; Yang,0,39,0,0
1668481050111,ECE 285,B00,103673,Sworder; David D.,0,55,0,0
1668481050538,ECE 287,A00,103676,Javidi; Tara,0,8,0,0
1668481050965,MATH 200B,A00,098023,Salehi Golsefidy; Alireza,10,0,15,5
1668481051389,MATH 202B,A00,098024,Rhoades; Brendon Patrick,7,0,15,8
1668481051812,MATH 203B,A00,098025,Oprea; Dragos N.,9,0,15,6
1668481052238,MATH 204B,A00,098026,Sorensen; Claus M,13,0,15,2
1668481052663,MATH 208,A00,098027,Izadi; Elham,7,0,10,3
1668481053086,MATH 209,A00,098028,Pollack; Aaron,10,0,10,0
1668481053514,MATH 211A,A00,112919,Rogalski; Daniel,8,0,10,2
1668481053944,MATH 211B,A00,112920,Seward; Brandon M.,9,0,10,1
1668481054366,MATH 218,A00,098029,Li; Bo,10,0,10,0
1668481054790,MATH 220B,A00,098030,Novak; Jonathan I,11,0,15,4
1668481055213,MATH 221A,A00,098031,Ebenfelt; Peter F,12,0,15,3
1668481055636,MATH 231B,A00,098032,Zlatos; Andrej,11,0,15,4
1668481056059,MATH 240B,A00,098033,Ni; Lei,7,0,15,8
1668481056484,MATH 243,A00,098034,Jekel; David Andrew,10,0,10,0
1668481056915,MATH 245A,A00,098035,Nie; Jiawang,0,4,15,18
1668481057341,MATH 248,A00,098036,Bejenaru; Ioan,10,0,10,0
1668481057768,MATH 250B,A00,098037,Spolaor; Luca,14,0,15,1
1668481058192,MATH 258,A00,098038,Ni; Lei,9,0,10,1
1668481058617,MATH 264B,A00,098041,Rhoades; Brendon Patrick,8,0,15,7
1668481059046,MATH 268,A00,098042,Buss; Samuel R,10,0,10,0
1668481059470,MATH 269,A00,098043,Rhoades; Brendon Patrick,10,0,10,0
1668481059896,MATH 270B,A00,098044,Li; Bo,6,0,15,9
1668481060321,MATH 272B,A00,098045,Holst; Michael J,13,0,15,2
1668481060748,MATH 273A,A00,098046,Tian; Xiaochuan,10,0,15,5
1668481061173,MATH 275,A01,098048,Tian; Xiaochuan,6,0,10,4
1668481061601,MATH 278A,A00,098049,Holst; Michael J,7,0,10,3
1668481062044,MATH 278B,A00,098050,Cloninger; Alexander,10,0,10,0
1668481062470,MATH 278C,A00,098051,Nie; Jiawang,5,0,10,5
1668481062901,MATH 280B,A00,098052,Zheng; Tianyi,7,0,15,8
1668481063331,MATH 281B,A00,098053,Bradic; Jelena,0,2,15,15
1668481063753,MATH 282B,A00,098054,Arias-Castro; Ery,0,1,15,15
1668481064178,MATH 285,A00,098055,Fitzsimmons; Patrick J,0,2,15,17
1668481064601,MATH 287B,A00,098056,Arias-Castro; Ery,1,0,15,14
1668481065037,MATH 288,A00,098057,Agarwal; Pooja,9,0,10,1
1668481065037,MATH 288,B00,098058,Zhang; Danna,8,0,10,2
1668481065037,MATH 288,C00,098059,Williams; Ruth J,9,0,10,1
1668481065461,MATH 290B,A00,098060,Roberts; Justin Deritter,12,0,15,3
1668481065887,MATH 292,A00,098061,Belmont; Eva Kinoshita,10,0,10,0
1668481066310,MATH 295,A00,098062,Suk; Andrew Hoon,47,0,50,3
1668481066734,MATH 296,A00,098063,Novak; Jonathan I,20,0,20,0
1668481067238,MATH 297,001,098064,Gamst; Anthony Collins,9997,0,9999,2
1668481569548,COGS 205,A00,101395,Chiba; Andrea,19,0,20,1
1668481569982,COGS 210B,001,101404,Greene; Deanna Jacquelyn,9998,0,9999,1
1668481569982,COGS 210B,002,101417,Xia; Haijun,9999,0,9999,0
1668481569982,COGS 210B,003,101422,Nitz; Douglas A.,9999,0,9999,0
1668481569982,COGS 210B,004,101423,Hollan; James D.,9998,0,9999,1
1668481569982,COGS 210B,005,101424,Deak; Gedeon O.,9998,0,9999,1
1668481569982,COGS 210B,006,101425,Rossano; Federico,9999,0,9999,0
1668481570406,COGS 211B,A00,101427,Coulson; Seana M,9996,0,9999,3
1668481570830,COGS 220,A00,101428,Hollan; James D.,1,9,25,24
1668481571255,COGS 229,A00,101429,Dow; Steven P,17,0,25,8
1668481571679,COGS 230,A00,101430,Klemmer; Scott R,8,0,17,9
1668481572102,COGS 234,A00,101431,Xia; Haijun,2,0,25,23
1668481572534,COGS 260,A00,101432,Kiyonaga; Anastasia,21,0,25,4
1668481572534,COGS 260,B00,101433,Kirsh; David Joel,15,0,25,10
1668481572960,CSE 202,A00,102371,Impagliazzo; Russell,0,61,0,0
1668481573398,CSE 203B,A01,102373,Cheng; Chung Kuan,0,52,0,0
1668481573821,CSE 208,A00,102374,Micciancio; Daniele,0,5,0,0
1668481574245,CSE 209A,A00,112895,Impagliazzo; Russell,0,12,15,15
1668481574670,CSE 209B,A00,108005,Bellare; Mihir,0,6,0,0
1668481575097,CSE 210,A00,113163,Coblenz; Michael J,0,80,0,0
1668481575522,CSE 219,A00,106111,Dow; Steven P,0,6,20,20
1668481575946,CSE 221,A00,102376,Voelker; Geoffrey M.,0,68,0,0
1668481576372,CSE 224,A01,102378,Porter; George M,0,159,0,0
1668481576804,CSE 229A,A00,102379,Savage; Stefan,0,10,0,0
1668481577238,CSE 229C,A00,102380,Munyaka; Imani N. S.,0,9,0,0
1668481577671,CSE 232B,A00,102382,Deutsch; Alin Bernard,0,30,0,0
1668481578102,CSE 234,A01,112904,Kumar; Arun Kumar,0,0,0,0
1668481578536,CSE 237A,A00,102383,Rosing; Tajana Simunic,0,49,0,0
1668481578959,CSE 239A,A00,102384,Deutsch; Alin Bernard,0,13,0,0
1668481579382,CSE 239B,A00,102385,Polikarpova; Nadezhda,0,10,0,0
1668481579805,CSE 240A,A00,102386,Pannuto; Patrick William,0,44,0,0
1668481580241,CSE 240B,A00,102387,Zhao; Jishen,0,42,0,0
1668481580667,CSE 241A,A00,106406,Kang; Mingu,0,6,0,0
1668481581092,CSE 249B,A00,102388,Kahng; Andrew Byun,0,5,8,8
1668481581515,CSE 251B,A01,102392,Cottrell; Garrison W,0,46,0,0
1668481581515,CSE 251B,A02,102393,Cottrell; Garrison W,0,33,0,0
1668481581937,CSE 252B,A00,102394,Ochoa; Benjamin Lawrence,0,56,0,0
1668481582362,CSE 257,A01,102396,Gao; Sicun,0,131,0,0
1668481582785,CSE 272,A00,102397,Li; Tzumao,0,17,0,0
1668481583218,CSE 274,A00,111323,Chern; Albert Ren-Haur,0,15,0,0
1668481583641,CSE 282,A00,102398,Pevzner; Pavel Arkadjevich,0,0,0,0
1668481584069,CSE 284,A00,114175,Gymrek; Melissa Ann,0,20,0,0
1668481584494,CSE 290,A00,102399,Chandraker; Manmohan Krishna,0,11,0,0
1668481584494,CSE 290,B00,102400,Vaccaro; Kristen Marie,0,7,25,25
1668481584494,CSE 290,C00,102414,Pannuto; Patrick William,0,1,25,25
1668481584494,CSE 290,D00,102427,Pevzner; Pavel Arkadjevich,0,0,0,0
1668481584494,CSE 290,E00,102429,Zhao; Jishen,0,4,0,0
1668481584494,CSE 290,F00,102436,Tullsen; Dean Michael,0,5,0,0
1668481584494,CSE 290,G00,102440,Christensen; Henrik I,0,6,20,20
1668481584919,CSE 291,A00,102443,Su; Hao,0,0,0,0
1668481584919,CSE 291,B00,102448,Polikarpova; Nadezhda,0,0,0,0
1668481584919,CSE 291,C00,102453,Vaccaro; Kristen Marie,0,0,0,0
1668481584919,CSE 291,D00,111343,Savage; Stefan,0,0,0,0
1668481584919,CSE 291,E00,116474,Claffy; Kimberly Claire,0,0,0,0
1668481584919,CSE 291,F00,116479,Pasquale; Joseph,0,0,0,0
1668481585351,CSE 293,001,119111,Bafna; Vineet,9999,0,9999,0
1668481585351,CSE 293,002,119118,Bellare; Mihir,9999,0,9999,0
1668481585351,CSE 293,003,119122,Berg-Kirkpatrick; Taylor D,9999,0,9999,0
1668481585351,CSE 293,004,119135,Christensen; Henrik I,9999,0,9999,0
1668481585351,CSE 293,005,119142,Cottrell; Garrison W,9999,0,9999,0
1668481585351,CSE 293,006,119146,Deutsch; Alin Bernard,9999,0,9999,0
1668481585351,CSE 293,007,119159,Esmaeilzadeh; Hadi,9999,0,9999,0
1668481585351,CSE 293,008,119166,Freund; Yoav,9999,0,9999,0
1668481585351,CSE 293,009,119170,Griswold; William G.,9999,0,9999,0
1668481585351,CSE 293,010,119183,Gymrek; Melissa Ann,9999,0,9999,0
1668481585351,CSE 293,011,119190,Heninger; Nadia A,9999,0,9999,0
1668481585351,CSE 293,012,119230,Impagliazzo; Russell,9999,0,9999,0
1668481585351,CSE 293,013,119232,Jhala; Ranjit,9999,0,9999,0
1668481585351,CSE 293,014,119233,Kahng; Andrew Byun,9999,0,9999,0
1668481585351,CSE 293,015,119298,Kane; Daniel Mertz,9999,0,9999,0
1668481585351,CSE 293,016,119299,Kriegman; David J,9999,0,9999,0
1668481585351,CSE 293,017,119300,Kumar; Arun Kumar,9999,0,9999,0
1668481585351,CSE 293,018,119301,Lerner; Sorin,9999,0,9999,0
1668481585351,CSE 293,019,119302,Lovett; Shachar,9999,0,9999,0
1668481585351,CSE 293,020,119303,McAuley; Julian John,9999,0,9999,0
1668481585351,CSE 293,021,119304,Micciancio; Daniele,9999,0,9999,0
1668481585351,CSE 293,022,119367,Orailoglu; Alex,9999,0,9999,0
1668481585351,CSE 293,023,119382,Paturi; Ramamohan,9999,0,9999,0
1668481585351,CSE 293,024,119404,Polikarpova; Nadezhda,9999,0,9999,0
1668481585351,CSE 293,025,119406,Politz; Joseph Gibbs,9999,0,9999,0
1668481585351,CSE 293,026,119411,Porter; George M,9999,0,9999,0
1668481585351,CSE 293,027,119414,Porter; Leonard Emerson,9999,0,9999,0
1668481585351,CSE 293,028,119416,Ramamoorthi; Ravi,9999,0,9999,0
1668481585351,CSE 293,029,119417,Sahoo; Debashis,9999,0,9999,0
1668481585351,CSE 293,030,119420,Saul; Lawrence,9999,0,9999,0
1668481585351,CSE 293,031,119421,Savage; Stefan,9999,0,9999,0
1668481585351,CSE 293,032,119425,Schulze; Jurgen P.,9999,0,9999,0
1668481585351,CSE 293,033,119426,Snoeren; Alex C.,9999,0,9999,0
1668481585351,CSE 293,034,119428,Shang; Jingbo,9999,0,9999,0
1668481585351,CSE 293,035,119430,Stefan; Deian,9999,0,9999,0
1668481585351,CSE 293,036,119431,Su; Hao,9999,0,9999,0
1668481585351,CSE 293,037,119433,Swanson; Steven James,9999,0,9999,0
1668481585351,CSE 293,038,119435,Tullsen; Dean Michael,9999,0,9999,0
1668481585351,CSE 293,039,119483,Voelker; Geoffrey M.,9999,0,9999,0
1668481585351,CSE 293,040,119537,Zhao; Jishen,9999,0,9999,0
1668481585351,CSE 293,041,119538,Zhou; Yuan-Yuan,9999,0,9999,0
1668481585351,CSE 293,042,119539,Gao; Sicun,9999,0,9999,0
1668481585351,CSE 293,043,119540,Weibel; Nadir,9999,0,9999,0
1668481585351,CSE 293,044,119541,Gupta; Rajesh K.,9999,0,9999,0
1668481585351,CSE 293,045,126410,Vaccaro; Kristen Marie,9999,0,9999,0
1668481585351,CSE 293,046,126411,Klemke; Richard,9999,0,9999,0
1668481585784,CSE 294,A00,102459,Voelker; Geoffrey M.,0,2,0,0
1668481585784,CSE 294,B00,111322,Orailoglu; Alex,0,2,0,0
1668481586208,DSE 201,A00,096914,Deutsch; Alin Bernard,30,0,30,0
1668481586636,DSE 210,A00,096915,Dasgupta; Sanjoy,30,0,30,0
1668481587061,DSE 260A,A00,096916,Altintas De Callaf; Ilkay,30,0,30,0
1668481587499,ECE 200,001,103586,Antipa; Nicholas A,9999,0,9999,0
1668481587499,ECE 200,002,103587,Atanasov; Nikolay A.,9999,0,9999,0
1668481587499,ECE 200,003,103588,Bharadia; Dinesh,9999,0,9999,0
1668481587499,ECE 200,004,103589,Cheng; Chung Kuan,9999,0,9999,0
1668481587499,ECE 200,005,103590,Cosman; Pamela C.,9999,0,9999,0
1668481587499,ECE 200,006,103591,Dayeh; Shadi Ahmad,9999,0,9999,0
1668481587499,ECE 200,007,103592,Fainman; Yeshaiahu,9999,0,9999,0
1668481587499,ECE 200,008,103593,Ford; Joseph Earl,9999,0,9999,0
1668481587499,ECE 200,009,103594,Franceschetti; Massimo,9999,0,9999,0
1668481587499,ECE 200,010,103595,Fullerton; Eric E,9999,0,9999,0
1668481587499,ECE 200,011,103596,Galton; Ian A,9999,0,9999,0
1668481587499,ECE 200,012,103597,Gilja; Vikash,9999,0,9999,0
1668481587499,ECE 200,013,103598,Hall; Drew A.,9999,0,9999,0
1668481587499,ECE 200,014,103599,Hsueh; Tzu-Chien,9999,0,9999,0
1668481587499,ECE 200,015,103600,Javidi; Tara,9999,0,9999,0
1668481587499,ECE 200,016,103601,Kahng; Andrew Byun,9999,0,9999,0
1668481587499,ECE 200,017,103602,Kim; Young-Han,9999,0,9999,0
1668481587499,ECE 200,018,103603,Koushanfar; Farinaz,9999,0,9999,0
1668481587499,ECE 200,019,103604,Kuzum; Duygu,9999,0,9999,0
1668481587499,ECE 200,020,103605,Le; Hanh-Phuc,9999,0,9999,0
1668481587499,ECE 200,021,103606,Lin; Bill,9999,0,9999,0
1668481587499,ECE 200,022,103607,Liu; Zhaowei,9998,0,9999,1
1668481587499,ECE 200,023,103608,Lo; Yu-Hwa,9999,0,9999,0
1668481587499,ECE 200,024,103609,Lomakin; Vitaliy,9999,0,9999,0
1668481587499,ECE 200,025,103610,Mercier; Patrick Philip,9999,0,9999,0
1668481587499,ECE 200,026,103611,Meyer; Florian,9999,0,9999,0
1668481587499,ECE 200,027,103612,Milstein; Laurence B.,9999,0,9999,0
1668481587499,ECE 200,028,103613,Mir Arabbaygi; Siavash,9999,0,9999,0
1668481587499,ECE 200,029,103614,Mookherjea; Shayan,9999,0,9999,0
1668481587499,ECE 200,030,103615,Morris; Karcher William,9999,0,9999,0
1668481587499,ECE 200,031,103616,Ng; Tse Nga,9999,0,9999,0
1668481587499,ECE 200,032,103617,Nguyen; Truong Quang,9999,0,9999,0
1668481587499,ECE 200,033,103618,Nomura; Kenji,9999,0,9999,0
1668481587499,ECE 200,034,103619,Orlitsky; Alon,9999,0,9999,0
1668481587499,ECE 200,035,103620,Pal; Piya,9999,0,9999,0
1668481587499,ECE 200,036,103621,Papen; George C.,9999,0,9999,0
1668481587499,ECE 200,037,103622,Radic; Stojan,9999,0,9999,0
1668481587499,ECE 200,038,103623,Rao; Bhaskar D.,9999,0,9999,0
1668481587499,ECE 200,039,103624,Rao; Ramesh R,9999,0,9999,0
1668481587499,ECE 200,040,103625,Rebeiz; Gabriel,9999,0,9999,0
1668481587499,ECE 200,041,103626,Sanford; John R,9999,0,9999,0
1668481587499,ECE 200,042,103627,Siegel; Paul H.,9999,0,9999,0
1668481587499,ECE 200,043,103628,Sievenpiper; Daniel F.,9999,0,9999,0
1668481587499,ECE 200,044,103629,Sworder; David D.,9999,0,9999,0
1668481587499,ECE 200,045,103630,Taur; Yuan,9999,0,9999,0
1668481587499,ECE 200,046,103631,Touri; Behrouz,9999,0,9999,0
1668481587499,ECE 200,047,103632,Trivedi; Mohan M.,9999,0,9999,0
1668481587499,ECE 200,048,103633,Vasconcelos; Nuno,9999,0,9999,0
1668481587499,ECE 200,049,103634,Wang; Xiaolong,9999,0,9999,0
1668481587499,ECE 200,050,103635,Xie; Pengtao,9999,0,9999,0
1668481587499,ECE 200,051,103636,Yip; Michael,9999,0,9999,0
1668481587499,ECE 200,052,103637,Zeger; Kenneth A.,999,0,999,0
1668481587499,ECE 200,053,103638,Zhang; Xinyu,9999,0,9999,0
1668481587499,ECE 200,054,103639,Turakhia; Yatish Girish,9999,0,9999,0
1668481587499,ECE 200,055,103640,Kang; Mingu,9999,0,9999,0
1668481587499,ECE 200,056,103641,Shi; Yuanyuan,9999,0,9999,0
1668481587499,ECE 200,057,103642,Wang; Edward Jay,9999,0,9999,0
1668481587499,ECE 200,058,103643,Zheng; Yang,9999,0,9999,0
1668481587924,ECE 202,A00,103644,Kuzum; Duygu,0,42,0,0
1668481588444,ECE 212BN,A00,103646,Ng; Tse Nga,0,9,0,0
1668481588869,ECE 221,A00,111493,Staff,0,0,0,0
1668481589295,ECE 222B,A00,103647,Lomakin; Vitaliy,0,18,0,0
1668481589722,ECE 230B,A00,103648,Taur; Yuan,0,2,0,0
1668481590148,ECE 238B,A00,103649,Garay; Javier,0,0,0,0
1668481590573,ECE 240B,A00,112900,Fainman; Yeshaiahu,0,6,0,0
1668481591000,ECE 247A,A00,103650,Jokerst; Jesse Vincent,0,5,0,0
1668481591423,ECE 247B,A00,103651,Wang; Joseph,0,11,0,0
1668481591850,ECE 250,A00,103652,Siegel; Paul H.,0,82,0,0
1668481592280,ECE 251A,A00,103654,Rao; Bhaskar D.,0,61,0,0
1668481592702,ECE 257B,A00,103655,Bharadia; Dinesh,0,32,0,0
1668481593132,ECE 258A,A00,103656,Milstein; Laurence B.,0,28,0,0
1668481593555,ECE 260B,A00,103658,Kang; Mingu,0,119,0,0
1668481593981,ECE 264A,A00,103659,Galton; Ian A,0,66,0,0
1668481594405,ECE 265A,A00,103661,Gudem; Prasad S.S.,0,65,0,0
1668481594828,ECE 265D,A00,103662,Gudem; Prasad S.S.,0,24,0,0
1668481595261,ECE 268,A00,103663,Koushanfar; Farinaz,0,42,0,0
1668481595685,ECE 269,A01,103665,Pal; Piya,0,210,0,0
1668481596116,ECE 271B,A00,103666,Vasconcelos; Manuela,0,74,0,0
1668481596540,ECE 276A,A00,103667,Atanasov; Nikolay A.,0,122,0,0
1668481596977,ECE 277,A00,103668,An; Cheolhong,0,144,0,0
1668481597408,ECE 279,A00,117947,Hall; Drew A.,0,22,0,0
1668481598260,ECE 283,A00,103670,Hsueh; Tzu-Chien,0,51,0,0
1668481598687,ECE 284,A00,103671,Turakhia; Yatish Girish,0,39,0,0
1668481599111,ECE 285,A00,103672,Zheng; Yang,0,39,0,0
1668481599111,ECE 285,B00,103673,Sworder; David D.,0,55,0,0
1668481599534,ECE 287,A00,103676,Javidi; Tara,0,8,0,0
1668481599966,MATH 200B,A00,098023,Salehi Golsefidy; Alireza,10,0,15,5
1668481600395,MATH 202B,A00,098024,Rhoades; Brendon Patrick,7,0,15,8
1668481600822,MATH 203B,A00,098025,Oprea; Dragos N.,9,0,15,6
1668481601246,MATH 204B,A00,098026,Sorensen; Claus M,13,0,15,2
1668481601670,MATH 208,A00,098027,Izadi; Elham,7,0,10,3
1668481602093,MATH 209,A00,098028,Pollack; Aaron,10,0,10,0
1668481602519,MATH 211A,A00,112919,Rogalski; Daniel,8,0,10,2
1668481602945,MATH 211B,A00,112920,Seward; Brandon M.,9,0,10,1
1668481603369,MATH 218,A00,098029,Li; Bo,10,0,10,0
1668481603792,MATH 220B,A00,098030,Novak; Jonathan I,11,0,15,4
1668481604226,MATH 221A,A00,098031,Ebenfelt; Peter F,12,0,15,3
1668481604653,MATH 231B,A00,098032,Zlatos; Andrej,11,0,15,4
1668481605076,MATH 240B,A00,098033,Ni; Lei,7,0,15,8
1668481605501,MATH 243,A00,098034,Jekel; David Andrew,10,0,10,0
1668481605924,MATH 245A,A00,098035,Nie; Jiawang,0,4,15,18
1668481606347,MATH 248,A00,098036,Bejenaru; Ioan,10,0,10,0
1668481606772,MATH 250B,A00,098037,Spolaor; Luca,14,0,15,1
1668481607198,MATH 258,A00,098038,Ni; Lei,9,0,10,1
1668481607632,MATH 264B,A00,098041,Rhoades; Brendon Patrick,8,0,15,7
1668481608056,MATH 268,A00,098042,Buss; Samuel R,10,0,10,0
1668481608493,MATH 269,A00,098043,Rhoades; Brendon Patrick,10,0,10,0
1668481608918,MATH 270B,A00,098044,Li; Bo,6,0,15,9
1668481609348,MATH 272B,A00,098045,Holst; Michael J,13,0,15,2
1668481609787,MATH 273A,A00,098046,Tian; Xiaochuan,10,0,15,5
1668481610212,MATH 275,A01,098048,Tian; Xiaochuan,6,0,10,4
1668481610636,MATH 278A,A00,098049,Holst; Michael J,7,0,10,3
1668481611075,MATH 278B,A00,098050,Cloninger; Alexander,10,0,10,0
1668481611498,MATH 278C,A00,098051,Nie; Jiawang,5,0,10,5
1668481611925,MATH 280B,A00,098052,Zheng; Tianyi,7,0,15,8
1668481612350,MATH 281B,A00,098053,Bradic; Jelena,0,2,15,15
1668481612775,MATH 282B,A00,098054,Arias-Castro; Ery,0,1,15,15
1668481613202,MATH 285,A00,098055,Fitzsimmons; Patrick J,0,2,15,17
1668481613625,MATH 287B,A00,098056,Arias-Castro; Ery,1,0,15,14
1668481614051,MATH 288,A00,098057,Agarwal; Pooja,9,0,10,1
1668481614051,MATH 288,B00,098058,Zhang; Danna,8,0,10,2
1668481614051,MATH 288,C00,098059,Williams; Ruth J,9,0,10,1
1668481614478,MATH 290B,A00,098060,Roberts; Justin Deritter,12,0,15,3
1668481614903,MATH 292,A00,098061,Belmont; Eva Kinoshita,10,0,10,0
1668481615332,MATH 295,A00,098062,Suk; Andrew Hoon,47,0,50,3
1668481615753,MATH 296,A00,098063,Novak; Jonathan I,20,0,20,0
1668481616176,MATH 297,001,098064,Gamst; Anthony Collins,9997,0,9999,2
1668482127595,COGS 205,A00,101395,Chiba; Andrea,19,0,20,1
1668482128023,COGS 210B,001,101404,Greene; Deanna Jacquelyn,9998,0,9999,1
1668482128023,COGS 210B,002,101417,Xia; Haijun,9999,0,9999,0
1668482128023,COGS 210B,003,101422,Nitz; Douglas A.,9999,0,9999,0
1668482128023,COGS 210B,004,101423,Hollan; James D.,9998,0,9999,1
1668482128023,COGS 210B,005,101424,Deak; Gedeon O.,9998,0,9999,1
1668482128023,COGS 210B,006,101425,Rossano; Federico,9999,0,9999,0
1668482128447,COGS 211B,A00,101427,Coulson; Seana M,9996,0,9999,3
1668482128872,COGS 220,A00,101428,Hollan; James D.,1,9,25,24
1668482129298,COGS 229,A00,101429,Dow; Steven P,17,0,25,8
1668482129727,COGS 230,A00,101430,Klemmer; Scott R,8,0,17,9
1668482130148,COGS 234,A00,101431,Xia; Haijun,2,0,25,23
1668482130581,COGS 260,A00,101432,Kiyonaga; Anastasia,21,0,25,4
1668482130581,COGS 260,B00,101433,Kirsh; David Joel,15,0,25,10
1668482131005,CSE 202,A00,102371,Impagliazzo; Russell,0,61,0,0
1668482131434,CSE 203B,A01,102373,Cheng; Chung Kuan,0,52,0,0
1668482131860,CSE 208,A00,102374,Micciancio; Daniele,0,5,0,0
1668482132291,CSE 209A,A00,112895,Impagliazzo; Russell,0,12,15,15
1668482132724,CSE 209B,A00,108005,Bellare; Mihir,0,6,0,0
1668482133148,CSE 210,A00,113163,Coblenz; Michael J,0,80,0,0
1668482133572,CSE 219,A00,106111,Dow; Steven P,0,6,20,20
1668482134011,CSE 221,A00,102376,Voelker; Geoffrey M.,0,68,0,0
1668482134435,CSE 224,A01,102378,Porter; George M,0,159,0,0
1668482134861,CSE 229A,A00,102379,Savage; Stefan,0,10,0,0
1668482135287,CSE 229C,A00,102380,Munyaka; Imani N. S.,0,10,0,0
1668482135711,CSE 232B,A00,102382,Deutsch; Alin Bernard,0,30,0,0
1668482136135,CSE 234,A01,112904,Kumar; Arun Kumar,0,0,0,0
1668482136560,CSE 237A,A00,102383,Rosing; Tajana Simunic,0,49,0,0
1668482136995,CSE 239A,A00,102384,Deutsch; Alin Bernard,0,13,0,0
1668482137419,CSE 239B,A00,102385,Polikarpova; Nadezhda,0,10,0,0
1668482137842,CSE 240A,A00,102386,Pannuto; Patrick William,0,44,0,0
1668482138273,CSE 240B,A00,102387,Zhao; Jishen,0,42,0,0
1668482138701,CSE 241A,A00,106406,Kang; Mingu,0,7,0,0
1668482139123,CSE 249B,A00,102388,Kahng; Andrew Byun,0,5,8,8
1668482139551,CSE 251B,A01,102392,Cottrell; Garrison W,0,46,0,0
1668482139551,CSE 251B,A02,102393,Cottrell; Garrison W,0,33,0,0
1668482139977,CSE 252B,A00,102394,Ochoa; Benjamin Lawrence,0,56,0,0
1668482140399,CSE 257,A01,102396,Gao; Sicun,0,131,0,0
1668482140826,CSE 272,A00,102397,Li; Tzumao,0,17,0,0
1668482141249,CSE 274,A00,111323,Chern; Albert Ren-Haur,0,15,0,0
1668482141676,CSE 282,A00,102398,Pevzner; Pavel Arkadjevich,0,0,0,0
1668482142103,CSE 284,A00,114175,Gymrek; Melissa Ann,0,20,0,0
1668482142532,CSE 290,A00,102399,Chandraker; Manmohan Krishna,0,11,0,0
1668482142532,CSE 290,B00,102400,Vaccaro; Kristen Marie,0,7,25,25
1668482142532,CSE 290,C00,102414,Pannuto; Patrick William,0,1,25,25
1668482142532,CSE 290,D00,102427,Pevzner; Pavel Arkadjevich,0,0,0,0
1668482142532,CSE 290,E00,102429,Zhao; Jishen,0,4,0,0
1668482142532,CSE 290,F00,102436,Tullsen; Dean Michael,0,5,0,0
1668482142532,CSE 290,G00,102440,Christensen; Henrik I,0,6,20,20
1668482142958,CSE 291,A00,102443,Su; Hao,0,0,0,0
1668482142958,CSE 291,B00,102448,Polikarpova; Nadezhda,0,0,0,0
1668482142958,CSE 291,C00,102453,Vaccaro; Kristen Marie,0,0,0,0
1668482142958,CSE 291,D00,111343,Savage; Stefan,0,0,0,0
1668482142958,CSE 291,E00,116474,Claffy; Kimberly Claire,0,0,0,0
1668482142958,CSE 291,F00,116479,Pasquale; Joseph,0,0,0,0
1668482143399,CSE 293,001,119111,Bafna; Vineet,9999,0,9999,0
1668482143399,CSE 293,002,119118,Bellare; Mihir,9999,0,9999,0
1668482143399,CSE 293,003,119122,Berg-Kirkpatrick; Taylor D,9999,0,9999,0
1668482143399,CSE 293,004,119135,Christensen; Henrik I,9999,0,9999,0
1668482143399,CSE 293,005,119142,Cottrell; Garrison W,9999,0,9999,0
1668482143399,CSE 293,006,119146,Deutsch; Alin Bernard,9999,0,9999,0
1668482143399,CSE 293,007,119159,Esmaeilzadeh; Hadi,9999,0,9999,0
1668482143399,CSE 293,008,119166,Freund; Yoav,9999,0,9999,0
1668482143399,CSE 293,009,119170,Griswold; William G.,9999,0,9999,0
1668482143399,CSE 293,010,119183,Gymrek; Melissa Ann,9999,0,9999,0
1668482143399,CSE 293,011,119190,Heninger; Nadia A,9999,0,9999,0
1668482143399,CSE 293,012,119230,Impagliazzo; Russell,9999,0,9999,0
1668482143399,CSE 293,013,119232,Jhala; Ranjit,9999,0,9999,0
1668482143399,CSE 293,014,119233,Kahng; Andrew Byun,9999,0,9999,0
1668482143399,CSE 293,015,119298,Kane; Daniel Mertz,9999,0,9999,0
1668482143399,CSE 293,016,119299,Kriegman; David J,9999,0,9999,0
1668482143399,CSE 293,017,119300,Kumar; Arun Kumar,9999,0,9999,0
1668482143399,CSE 293,018,119301,Lerner; Sorin,9999,0,9999,0
1668482143399,CSE 293,019,119302,Lovett; Shachar,9999,0,9999,0
1668482143399,CSE 293,020,119303,McAuley; Julian John,9999,0,9999,0
1668482143399,CSE 293,021,119304,Micciancio; Daniele,9999,0,9999,0
1668482143399,CSE 293,022,119367,Orailoglu; Alex,9999,0,9999,0
1668482143399,CSE 293,023,119382,Paturi; Ramamohan,9999,0,9999,0
1668482143399,CSE 293,024,119404,Polikarpova; Nadezhda,9999,0,9999,0
1668482143399,CSE 293,025,119406,Politz; Joseph Gibbs,9999,0,9999,0
1668482143399,CSE 293,026,119411,Porter; George M,9999,0,9999,0
1668482143399,CSE 293,027,119414,Porter; Leonard Emerson,9999,0,9999,0
1668482143399,CSE 293,028,119416,Ramamoorthi; Ravi,9999,0,9999,0
1668482143399,CSE 293,029,119417,Sahoo; Debashis,9999,0,9999,0
1668482143399,CSE 293,030,119420,Saul; Lawrence,9999,0,9999,0
1668482143399,CSE 293,031,119421,Savage; Stefan,9999,0,9999,0
1668482143399,CSE 293,032,119425,Schulze; Jurgen P.,9999,0,9999,0
1668482143399,CSE 293,033,119426,Snoeren; Alex C.,9999,0,9999,0
1668482143399,CSE 293,034,119428,Shang; Jingbo,9999,0,9999,0
1668482143399,CSE 293,035,119430,Stefan; Deian,9999,0,9999,0
1668482143399,CSE 293,036,119431,Su; Hao,9999,0,9999,0
1668482143399,CSE 293,037,119433,Swanson; Steven James,9999,0,9999,0
1668482143399,CSE 293,038,119435,Tullsen; Dean Michael,9999,0,9999,0
1668482143399,CSE 293,039,119483,Voelker; Geoffrey M.,9999,0,9999,0
1668482143399,CSE 293,040,119537,Zhao; Jishen,9999,0,9999,0
1668482143399,CSE 293,041,119538,Zhou; Yuan-Yuan,9999,0,9999,0
1668482143399,CSE 293,042,119539,Gao; Sicun,9999,0,9999,0
1668482143399,CSE 293,043,119540,Weibel; Nadir,9999,0,9999,0
1668482143399,CSE 293,044,119541,Gupta; Rajesh K.,9999,0,9999,0
1668482143399,CSE 293,045,126410,Vaccaro; Kristen Marie,9999,0,9999,0
1668482143399,CSE 293,046,126411,Klemke; Richard,9999,0,9999,0
1668482143826,CSE 294,A00,102459,Voelker; Geoffrey M.,0,2,0,0
1668482143826,CSE 294,B00,111322,Orailoglu; Alex,0,2,0,0
1668482144250,DSE 201,A00,096914,Deutsch; Alin Bernard,30,0,30,0
1668482144673,DSE 210,A00,096915,Dasgupta; Sanjoy,30,0,30,0
1668482145105,DSE 260A,A00,096916,Altintas De Callaf; Ilkay,30,0,30,0
1668482145539,ECE 200,001,103586,Antipa; Nicholas A,9999,0,9999,0
1668482145539,ECE 200,002,103587,Atanasov; Nikolay A.,9999,0,9999,0
1668482145539,ECE 200,003,103588,Bharadia; Dinesh,9999,0,9999,0
1668482145539,ECE 200,004,103589,Cheng; Chung Kuan,9999,0,9999,0
1668482145539,ECE 200,005,103590,Cosman; Pamela C.,9999,0,9999,0
1668482145539,ECE 200,006,103591,Dayeh; Shadi Ahmad,9999,0,9999,0
1668482145539,ECE 200,007,103592,Fainman; Yeshaiahu,9999,0,9999,0
1668482145539,ECE 200,008,103593,Ford; Joseph Earl,9999,0,9999,0
1668482145539,ECE 200,009,103594,Franceschetti; Massimo,9999,0,9999,0
1668482145539,ECE 200,010,103595,Fullerton; Eric E,9999,0,9999,0
1668482145539,ECE 200,011,103596,Galton; Ian A,9999,0,9999,0
1668482145539,ECE 200,012,103597,Gilja; Vikash,9999,0,9999,0
1668482145539,ECE 200,013,103598,Hall; Drew A.,9999,0,9999,0
1668482145539,ECE 200,014,103599,Hsueh; Tzu-Chien,9999,0,9999,0
1668482145539,ECE 200,015,103600,Javidi; Tara,9999,0,9999,0
1668482145539,ECE 200,016,103601,Kahng; Andrew Byun,9999,0,9999,0
1668482145539,ECE 200,017,103602,Kim; Young-Han,9999,0,9999,0
1668482145539,ECE 200,018,103603,Koushanfar; Farinaz,9999,0,9999,0
1668482145539,ECE 200,019,103604,Kuzum; Duygu,9999,0,9999,0
1668482145539,ECE 200,020,103605,Le; Hanh-Phuc,9999,0,9999,0
1668482145539,ECE 200,021,103606,Lin; Bill,9999,0,9999,0
1668482145539,ECE 200,022,103607,Liu; Zhaowei,9998,0,9999,1
1668482145539,ECE 200,023,103608,Lo; Yu-Hwa,9999,0,9999,0
1668482145539,ECE 200,024,103609,Lomakin; Vitaliy,9999,0,9999,0
1668482145539,ECE 200,025,103610,Mercier; Patrick Philip,9999,0,9999,0
1668482145539,ECE 200,026,103611,Meyer; Florian,9999,0,9999,0
1668482145539,ECE 200,027,103612,Milstein; Laurence B.,9999,0,9999,0
1668482145539,ECE 200,028,103613,Mir Arabbaygi; Siavash,9999,0,9999,0
1668482145539,ECE 200,029,103614,Mookherjea; Shayan,9999,0,9999,0
1668482145539,ECE 200,030,103615,Morris; Karcher William,9999,0,9999,0
1668482145539,ECE 200,031,103616,Ng; Tse Nga,9999,0,9999,0
1668482145539,ECE 200,032,103617,Nguyen; Truong Quang,9999,0,9999,0
1668482145539,ECE 200,033,103618,Nomura; Kenji,9999,0,9999,0
1668482145539,ECE 200,034,103619,Orlitsky; Alon,9999,0,9999,0
1668482145539,ECE 200,035,103620,Pal; Piya,9999,0,9999,0
1668482145539,ECE 200,036,103621,Papen; George C.,9999,0,9999,0
1668482145539,ECE 200,037,103622,Radic; Stojan,9999,0,9999,0
1668482145539,ECE 200,038,103623,Rao; Bhaskar D.,9999,0,9999,0
1668482145539,ECE 200,039,103624,Rao; Ramesh R,9999,0,9999,0
1668482145539,ECE 200,040,103625,Rebeiz; Gabriel,9999,0,9999,0
1668482145539,ECE 200,041,103626,Sanford; John R,9999,0,9999,0
1668482145539,ECE 200,042,103627,Siegel; Paul H.,9999,0,9999,0
1668482145539,ECE 200,043,103628,Sievenpiper; Daniel F.,9999,0,9999,0
1668482145539,ECE 200,044,103629,Sworder; David D.,9999,0,9999,0
1668482145539,ECE 200,045,103630,Taur; Yuan,9999,0,9999,0
1668482145539,ECE 200,046,103631,Touri; Behrouz,9999,0,9999,0
1668482145539,ECE 200,047,103632,Trivedi; Mohan M.,9999,0,9999,0
1668482145539,ECE 200,048,103633,Vasconcelos; Nuno,9999,0,9999,0
1668482145539,ECE 200,049,103634,Wang; Xiaolong,9999,0,9999,0
1668482145539,ECE 200,050,103635,Xie; Pengtao,9999,0,9999,0
1668482145539,ECE 200,051,103636,Yip; Michael,9999,0,9999,0
1668482145539,ECE 200,052,103637,Zeger; Kenneth A.,999,0,999,0
1668482145539,ECE 200,053,103638,Zhang; Xinyu,9999,0,9999,0
1668482145539,ECE 200,054,103639,Turakhia; Yatish Girish,9999,0,9999,0
1668482145539,ECE 200,055,103640,Kang; Mingu,9999,0,9999,0
1668482145539,ECE 200,056,103641,Shi; Yuanyuan,9999,0,9999,0
1668482145539,ECE 200,057,103642,Wang; Edward Jay,9999,0,9999,0
1668482145539,ECE 200,058,103643,Zheng; Yang,9999,0,9999,0
1668482145964,ECE 202,A00,103644,Kuzum; Duygu,0,42,0,0
1668482146398,ECE 212BN,A00,103646,Ng; Tse Nga,0,9,0,0
1668482146821,ECE 221,A00,111493,Staff,0,0,0,0
1668482147246,ECE 222B,A00,103647,Lomakin; Vitaliy,0,18,0,0
1668482147672,ECE 230B,A00,103648,Taur; Yuan,0,2,0,0
1668482148095,ECE 238B,A00,103649,Garay; Javier,0,0,0,0
1668482148522,ECE 240B,A00,112900,Fainman; Yeshaiahu,0,6,0,0
1668482148948,ECE 247A,A00,103650,Jokerst; Jesse Vincent,0,5,0,0
1668482149381,ECE 247B,A00,103651,Wang; Joseph,0,11,0,0
1668482149805,ECE 250,A00,103652,Siegel; Paul H.,0,82,0,0
1668482150243,ECE 251A,A00,103654,Rao; Bhaskar D.,0,61,0,0
1668482150665,ECE 257B,A00,103655,Bharadia; Dinesh,0,32,0,0
1668482151096,ECE 258A,A00,103656,Milstein; Laurence B.,0,28,0,0
1668482151526,ECE 260B,A00,103658,Kang; Mingu,0,119,0,0
1668482151950,ECE 264A,A00,103659,Galton; Ian A,0,66,0,0
1668482152373,ECE 265A,A00,103661,Gudem; Prasad S.S.,0,65,0,0
1668482152796,ECE 265D,A00,103662,Gudem; Prasad S.S.,0,24,0,0
1668482153219,ECE 268,A00,103663,Koushanfar; Farinaz,0,42,0,0
1668482153648,ECE 269,A01,103665,Pal; Piya,0,211,0,0
1668482154077,ECE 271B,A00,103666,Vasconcelos; Manuela,0,74,0,0
1668482154500,ECE 276A,A00,103667,Atanasov; Nikolay A.,0,122,0,0
1668482154923,ECE 277,A00,103668,An; Cheolhong,0,144,0,0
1668482155345,ECE 279,A00,117947,Hall; Drew A.,0,22,0,0
1668482156192,ECE 283,A00,103670,Hsueh; Tzu-Chien,0,51,0,0
1668482156617,ECE 284,A00,103671,Turakhia; Yatish Girish,0,39,0,0
1668482157039,ECE 285,A00,103672,Zheng; Yang,0,39,0,0
1668482157039,ECE 285,B00,103673,Sworder; David D.,0,55,0,0
1668482157466,ECE 287,A00,103676,Javidi; Tara,0,8,0,0
1668482157892,MATH 200B,A00,098023,Salehi Golsefidy; Alireza,10,0,15,5
1668482158319,MATH 202B,A00,098024,Rhoades; Brendon Patrick,7,0,15,8
1668482158742,MATH 203B,A00,098025,Oprea; Dragos N.,9,0,15,6
1668482159167,MATH 204B,A00,098026,Sorensen; Claus M,13,0,15,2
1668482159594,MATH 208,A00,098027,Izadi; Elham,7,0,10,3
1668482160017,MATH 209,A00,098028,Pollack; Aaron,10,0,10,0
1668482160445,MATH 211A,A00,112919,Rogalski; Daniel,8,0,10,2
1668482160871,MATH 211B,A00,112920,Seward; Brandon M.,9,0,10,1
1668482161295,MATH 218,A00,098029,Li; Bo,10,0,10,0
1668482161812,MATH 220B,A00,098030,Novak; Jonathan I,11,0,15,4
1668482162240,MATH 221A,A00,098031,Ebenfelt; Peter F,12,0,15,3
1668482162664,MATH 231B,A00,098032,Zlatos; Andrej,11,0,15,4
1668482163093,MATH 240B,A00,098033,Ni; Lei,7,0,15,8
1668482163524,MATH 243,A00,098034,Jekel; David Andrew,10,0,10,0
1668482163951,MATH 245A,A00,098035,Nie; Jiawang,0,4,15,18
1668482164383,MATH 248,A00,098036,Bejenaru; Ioan,10,0,10,0
1668482164811,MATH 250B,A00,098037,Spolaor; Luca,14,0,15,1
1668482165237,MATH 258,A00,098038,Ni; Lei,9,0,10,1
1668482165662,MATH 264B,A00,098041,Rhoades; Brendon Patrick,8,0,15,7
1668482166084,MATH 268,A00,098042,Buss; Samuel R,10,0,10,0
1668482166513,MATH 269,A00,098043,Rhoades; Brendon Patrick,10,0,10,0
1668482166936,MATH 270B,A00,098044,Li; Bo,6,0,15,9
1668482167363,MATH 272B,A00,098045,Holst; Michael J,13,0,15,2
1668482167785,MATH 273A,A00,098046,Tian; Xiaochuan,10,0,15,5
1668482168211,MATH 275,A01,098048,Tian; Xiaochuan,6,0,10,4
1668482168634,MATH 278A,A00,098049,Holst; Michael J,7,0,10,3
1668482169063,MATH 278B,A00,098050,Cloninger; Alexander,10,0,10,0
1668482169488,MATH 278C,A00,098051,Nie; Jiawang,5,0,10,5
1668482169914,MATH 280B,A00,098052,Zheng; Tianyi,7,0,15,8
1668482170340,MATH 281B,A00,098053,Bradic; Jelena,0,2,15,15
1668482170780,MATH 282B,A00,098054,Arias-Castro; Ery,0,1,15,15
1668482171202,MATH 285,A00,098055,Fitzsimmons; Patrick J,0,2,15,17
1668482171627,MATH 287B,A00,098056,Arias-Castro; Ery,1,0,15,14
1668482172056,MATH 288,A00,098057,Agarwal; Pooja,9,0,10,1
1668482172056,MATH 288,B00,098058,Zhang; Danna,8,0,10,2
1668482172056,MATH 288,C00,098059,Williams; Ruth J,9,0,10,1
1668482172479,MATH 290B,A00,098060,Roberts; Justin Deritter,12,0,15,3
1668482172906,MATH 292,A00,098061,Belmont; Eva Kinoshita,10,0,10,0
1668482173337,MATH 295,A00,098062,Suk; Andrew Hoon,47,0,50,3
1668482173759,MATH 296,A00,098063,Novak; Jonathan I,20,0,20,0
1668482174190,MATH 297,001,098064,Gamst; Anthony Collins,9997,0,9999,2
1668482676054,COGS 205,A00,101395,Chiba; Andrea,19,0,20,1
1668482676483,COGS 210B,001,101404,Greene; Deanna Jacquelyn,9998,0,9999,1
1668482676483,COGS 210B,002,101417,Xia; Haijun,9999,0,9999,0
1668482676483,COGS 210B,003,101422,Nitz; Douglas A.,9999,0,9999,0
1668482676483,COGS 210B,004,101423,Hollan; James D.,9998,0,9999,1
1668482676483,COGS 210B,005,101424,Deak; Gedeon O.,9998,0,9999,1
1668482676483,COGS 210B,006,101425,Rossano; Federico,9999,0,9999,0
1668482676910,COGS 211B,A00,101427,Coulson; Seana M,9996,0,9999,3
1668482677337,COGS 220,A00,101428,Hollan; James D.,1,9,25,24
1668482677769,COGS 229,A00,101429,Dow; Steven P,17,0,25,8
1668482678193,COGS 230,A00,101430,Klemmer; Scott R,8,0,17,9
1668482678625,COGS 234,A00,101431,Xia; Haijun,2,0,25,23
1668482679050,COGS 260,A00,101432,Kiyonaga; Anastasia,21,0,25,4
1668482679050,COGS 260,B00,101433,Kirsh; David Joel,15,0,25,10
1668482679472,CSE 202,A00,102371,Impagliazzo; Russell,0,61,0,0
1668482679900,CSE 203B,A01,102373,Cheng; Chung Kuan,0,52,0,0
1668482680324,CSE 208,A00,102374,Micciancio; Daniele,0,5,0,0
1668482680748,CSE 209A,A00,112895,Impagliazzo; Russell,0,12,15,15
1668482681193,CSE 209B,A00,108005,Bellare; Mihir,0,6,0,0
1668482681617,CSE 210,A00,113163,Coblenz; Michael J,0,80,0,0
1668482682045,CSE 219,A00,106111,Dow; Steven P,0,6,20,20
1668482682601,CSE 221,A00,102376,Voelker; Geoffrey M.,0,68,0,0
1668482683031,CSE 224,A01,102378,Porter; George M,0,159,0,0
1668482683455,CSE 229A,A00,102379,Savage; Stefan,0,10,0,0
1668482683882,CSE 229C,A00,102380,Munyaka; Imani N. S.,0,10,0,0
1668482684310,CSE 232B,A00,102382,Deutsch; Alin Bernard,0,30,0,0
1668482684737,CSE 234,A01,112904,Kumar; Arun Kumar,0,0,0,0
1668482685161,CSE 237A,A00,102383,Rosing; Tajana Simunic,0,49,0,0
1668482685587,CSE 239A,A00,102384,Deutsch; Alin Bernard,0,13,0,0
1668482686013,CSE 239B,A00,102385,Polikarpova; Nadezhda,0,10,0,0
1668482686436,CSE 240A,A00,102386,Pannuto; Patrick William,0,44,0,0
1668482686861,CSE 240B,A00,102387,Zhao; Jishen,0,42,0,0
1668482687287,CSE 241A,A00,106406,Kang; Mingu,0,7,0,0
1668482687710,CSE 249B,A00,102388,Kahng; Andrew Byun,0,5,8,8
1668482688134,CSE 251B,A01,102392,Cottrell; Garrison W,0,46,0,0
1668482688134,CSE 251B,A02,102393,Cottrell; Garrison W,0,33,0,0
1668482688567,CSE 252B,A00,102394,Ochoa; Benjamin Lawrence,0,56,0,0
1668482689002,CSE 257,A01,102396,Gao; Sicun,0,132,0,0
1668482689441,CSE 272,A00,102397,Li; Tzumao,0,17,0,0
1668482689867,CSE 274,A00,111323,Chern; Albert Ren-Haur,0,15,0,0
1668482690293,CSE 282,A00,102398,Pevzner; Pavel Arkadjevich,0,0,0,0
1668482690719,CSE 284,A00,114175,Gymrek; Melissa Ann,0,21,0,0
1668482691143,CSE 290,A00,102399,Chandraker; Manmohan Krishna,0,11,0,0
1668482691143,CSE 290,B00,102400,Vaccaro; Kristen Marie,0,7,25,25
1668482691143,CSE 290,C00,102414,Pannuto; Patrick William,0,1,25,25
1668482691143,CSE 290,D00,102427,Pevzner; Pavel Arkadjevich,0,0,0,0
1668482691143,CSE 290,E00,102429,Zhao; Jishen,0,4,0,0
1668482691143,CSE 290,F00,102436,Tullsen; Dean Michael,0,5,0,0
1668482691143,CSE 290,G00,102440,Christensen; Henrik I,0,6,20,20
1668482691574,CSE 291,A00,102443,Su; Hao,0,0,0,0
1668482691574,CSE 291,B00,102448,Polikarpova; Nadezhda,0,0,0,0
1668482691574,CSE 291,C00,102453,Vaccaro; Kristen Marie,0,0,0,0
1668482691574,CSE 291,D00,111343,Savage; Stefan,0,0,0,0
1668482691574,CSE 291,E00,116474,Claffy; Kimberly Claire,0,0,0,0
1668482691574,CSE 291,F00,116479,Pasquale; Joseph,0,0,0,0
1668482692013,CSE 293,001,119111,Bafna; Vineet,9999,0,9999,0
1668482692013,CSE 293,002,119118,Bellare; Mihir,9999,0,9999,0
1668482692013,CSE 293,003,119122,Berg-Kirkpatrick; Taylor D,9999,0,9999,0
1668482692013,CSE 293,004,119135,Christensen; Henrik I,9999,0,9999,0
1668482692013,CSE 293,005,119142,Cottrell; Garrison W,9999,0,9999,0
1668482692013,CSE 293,006,119146,Deutsch; Alin Bernard,9999,0,9999,0
1668482692013,CSE 293,007,119159,Esmaeilzadeh; Hadi,9999,0,9999,0
1668482692013,CSE 293,008,119166,Freund; Yoav,9999,0,9999,0
1668482692013,CSE 293,009,119170,Griswold; William G.,9999,0,9999,0
1668482692013,CSE 293,010,119183,Gymrek; Melissa Ann,9999,0,9999,0
1668482692013,CSE 293,011,119190,Heninger; Nadia A,9999,0,9999,0
1668482692013,CSE 293,012,119230,Impagliazzo; Russell,9999,0,9999,0
1668482692013,CSE 293,013,119232,Jhala; Ranjit,9999,0,9999,0
1668482692013,CSE 293,014,119233,Kahng; Andrew Byun,9999,0,9999,0
1668482692013,CSE 293,015,119298,Kane; Daniel Mertz,9999,0,9999,0
1668482692013,CSE 293,016,119299,Kriegman; David J,9999,0,9999,0
1668482692013,CSE 293,017,119300,Kumar; Arun Kumar,9999,0,9999,0
1668482692013,CSE 293,018,119301,Lerner; Sorin,9999,0,9999,0
1668482692013,CSE 293,019,119302,Lovett; Shachar,9999,0,9999,0
1668482692013,CSE 293,020,119303,McAuley; Julian John,9999,0,9999,0
1668482692013,CSE 293,021,119304,Micciancio; Daniele,9999,0,9999,0
1668482692013,CSE 293,022,119367,Orailoglu; Alex,9999,0,9999,0
1668482692013,CSE 293,023,119382,Paturi; Ramamohan,9999,0,9999,0
1668482692013,CSE 293,024,119404,Polikarpova; Nadezhda,9999,0,9999,0
1668482692013,CSE 293,025,119406,Politz; Joseph Gibbs,9999,0,9999,0
1668482692013,CSE 293,026,119411,Porter; George M,9999,0,9999,0
1668482692013,CSE 293,027,119414,Porter; Leonard Emerson,9999,0,9999,0
1668482692013,CSE 293,028,119416,Ramamoorthi; Ravi,9999,0,9999,0
1668482692013,CSE 293,029,119417,Sahoo; Debashis,9999,0,9999,0
1668482692013,CSE 293,030,119420,Saul; Lawrence,9999,0,9999,0
1668482692013,CSE 293,031,119421,Savage; Stefan,9999,0,9999,0
1668482692013,CSE 293,032,119425,Schulze; Jurgen P.,9999,0,9999,0
1668482692013,CSE 293,033,119426,Snoeren; Alex C.,9999,0,9999,0
1668482692013,CSE 293,034,119428,Shang; Jingbo,9999,0,9999,0
1668482692013,CSE 293,035,119430,Stefan; Deian,9999,0,9999,0
1668482692013,CSE 293,036,119431,Su; Hao,9999,0,9999,0
1668482692013,CSE 293,037,119433,Swanson; Steven James,9999,0,9999,0
1668482692013,CSE 293,038,119435,Tullsen; Dean Michael,9999,0,9999,0
1668482692013,CSE 293,039,119483,Voelker; Geoffrey M.,9999,0,9999,0
1668482692013,CSE 293,040,119537,Zhao; Jishen,9999,0,9999,0
1668482692013,CSE 293,041,119538,Zhou; Yuan-Yuan,9999,0,9999,0
1668482692013,CSE 293,042,119539,Gao; Sicun,9999,0,9999,0
1668482692013,CSE 293,043,119540,Weibel; Nadir,9999,0,9999,0
1668482692013,CSE 293,044,119541,Gupta; Rajesh K.,9999,0,9999,0
1668482692013,CSE 293,045,126410,Vaccaro; Kristen Marie,9999,0,9999,0
1668482692013,CSE 293,046,126411,Klemke; Richard,9999,0,9999,0
1668482692450,CSE 294,A00,102459,Voelker; Geoffrey M.,0,2,0,0
1668482692450,CSE 294,B00,111322,Orailoglu; Alex,0,2,0,0
1668482692875,DSE 201,A00,096914,Deutsch; Alin Bernard,30,0,30,0
1668482693299,DSE 210,A00,096915,Dasgupta; Sanjoy,30,0,30,0
1668482693722,DSE 260A,A00,096916,Altintas De Callaf; Ilkay,30,0,30,0
1668482694152,ECE 200,001,103586,Antipa; Nicholas A,9999,0,9999,0
1668482694152,ECE 200,002,103587,Atanasov; Nikolay A.,9999,0,9999,0
1668482694152,ECE 200,003,103588,Bharadia; Dinesh,9999,0,9999,0
1668482694152,ECE 200,004,103589,Cheng; Chung Kuan,9999,0,9999,0
1668482694152,ECE 200,005,103590,Cosman; Pamela C.,9999,0,9999,0
1668482694152,ECE 200,006,103591,Dayeh; Shadi Ahmad,9999,0,9999,0
1668482694152,ECE 200,007,103592,Fainman; Yeshaiahu,9999,0,9999,0
1668482694152,ECE 200,008,103593,Ford; Joseph Earl,9999,0,9999,0
1668482694152,ECE 200,009,103594,Franceschetti; Massimo,9999,0,9999,0
1668482694152,ECE 200,010,103595,Fullerton; Eric E,9999,0,9999,0
1668482694152,ECE 200,011,103596,Galton; Ian A,9999,0,9999,0
1668482694152,ECE 200,012,103597,Gilja; Vikash,9999,0,9999,0
1668482694152,ECE 200,013,103598,Hall; Drew A.,9999,0,9999,0
1668482694152,ECE 200,014,103599,Hsueh; Tzu-Chien,9999,0,9999,0
1668482694152,ECE 200,015,103600,Javidi; Tara,9999,0,9999,0
1668482694152,ECE 200,016,103601,Kahng; Andrew Byun,9999,0,9999,0
1668482694152,ECE 200,017,103602,Kim; Young-Han,9999,0,9999,0
1668482694152,ECE 200,018,103603,Koushanfar; Farinaz,9999,0,9999,0
1668482694152,ECE 200,019,103604,Kuzum; Duygu,9999,0,9999,0
1668482694152,ECE 200,020,103605,Le; Hanh-Phuc,9999,0,9999,0
1668482694152,ECE 200,021,103606,Lin; Bill,9999,0,9999,0
1668482694152,ECE 200,022,103607,Liu; Zhaowei,9998,0,9999,1
1668482694152,ECE 200,023,103608,Lo; Yu-Hwa,9999,0,9999,0
1668482694152,ECE 200,024,103609,Lomakin; Vitaliy,9999,0,9999,0
1668482694152,ECE 200,025,103610,Mercier; Patrick Philip,9999,0,9999,0
1668482694152,ECE 200,026,103611,Meyer; Florian,9999,0,9999,0
1668482694152,ECE 200,027,103612,Milstein; Laurence B.,9999,0,9999,0
1668482694152,ECE 200,028,103613,Mir Arabbaygi; Siavash,9999,0,9999,0
1668482694152,ECE 200,029,103614,Mookherjea; Shayan,9999,0,9999,0
1668482694152,ECE 200,030,103615,Morris; Karcher William,9999,0,9999,0
1668482694152,ECE 200,031,103616,Ng; Tse Nga,9999,0,9999,0
1668482694152,ECE 200,032,103617,Nguyen; Truong Quang,9999,0,9999,0
1668482694152,ECE 200,033,103618,Nomura; Kenji,9999,0,9999,0
1668482694152,ECE 200,034,103619,Orlitsky; Alon,9999,0,9999,0
1668482694152,ECE 200,035,103620,Pal; Piya,9999,0,9999,0
1668482694152,ECE 200,036,103621,Papen; George C.,9999,0,9999,0
1668482694152,ECE 200,037,103622,Radic; Stojan,9999,0,9999,0
1668482694152,ECE 200,038,103623,Rao; Bhaskar D.,9999,0,9999,0
1668482694152,ECE 200,039,103624,Rao; Ramesh R,9999,0,9999,0
1668482694152,ECE 200,040,103625,Rebeiz; Gabriel,9999,0,9999,0
1668482694152,ECE 200,041,103626,Sanford; John R,9999,0,9999,0
1668482694152,ECE 200,042,103627,Siegel; Paul H.,9999,0,9999,0
1668482694152,ECE 200,043,103628,Sievenpiper; Daniel F.,9999,0,9999,0
1668482694152,ECE 200,044,103629,Sworder; David D.,9999,0,9999,0
1668482694152,ECE 200,045,103630,Taur; Yuan,9999,0,9999,0
1668482694152,ECE 200,046,103631,Touri; Behrouz,9999,0,9999,0
1668482694152,ECE 200,047,103632,Trivedi; Mohan M.,9999,0,9999,0
1668482694152,ECE 200,048,103633,Vasconcelos; Nuno,9999,0,9999,0
1668482694152,ECE 200,049,103634,Wang; Xiaolong,9999,0,9999,0
1668482694152,ECE 200,050,103635,Xie; Pengtao,9999,0,9999,0
1668482694152,ECE 200,051,103636,Yip; Michael,9999,0,9999,0
1668482694152,ECE 200,052,103637,Zeger; Kenneth A.,999,0,999,0
1668482694152,ECE 200,053,103638,Zhang; Xinyu,9999,0,9999,0
1668482694152,ECE 200,054,103639,Turakhia; Yatish Girish,9999,0,9999,0
1668482694152,ECE 200,055,103640,Kang; Mingu,9999,0,9999,0
1668482694152,ECE 200,056,103641,Shi; Yuanyuan,9999,0,9999,0
1668482694152,ECE 200,057,103642,Wang; Edward Jay,9999,0,9999,0
1668482694152,ECE 200,058,103643,Zheng; Yang,9999,0,9999,0
1668482694583,ECE 202,A00,103644,Kuzum; Duygu,0,42,0,0
1668482695007,ECE 212BN,A00,103646,Ng; Tse Nga,0,9,0,0
1668482695437,ECE 221,A00,111493,Staff,0,0,0,0
1668482695861,ECE 222B,A00,103647,Lomakin; Vitaliy,0,18,0,0
1668482696290,ECE 230B,A00,103648,Taur; Yuan,0,2,0,0
1668482696714,ECE 238B,A00,103649,Garay; Javier,0,0,0,0
1668482697163,ECE 240B,A00,112900,Fainman; Yeshaiahu,0,6,0,0
1668482697587,ECE 247A,A00,103650,Jokerst; Jesse Vincent,0,5,0,0
1668482698012,ECE 247B,A00,103651,Wang; Joseph,0,11,0,0
1668482698441,ECE 250,A00,103652,Siegel; Paul H.,0,82,0,0
1668482698869,ECE 251A,A00,103654,Rao; Bhaskar D.,0,61,0,0
1668482699295,ECE 257B,A00,103655,Bharadia; Dinesh,0,32,0,0
1668482699721,ECE 258A,A00,103656,Milstein; Laurence B.,0,28,0,0
1668482700145,ECE 260B,A00,103658,Kang; Mingu,0,119,0,0
1668482700573,ECE 264A,A00,103659,Galton; Ian A,0,66,0,0
1668482701008,ECE 265A,A00,103661,Gudem; Prasad S.S.,0,65,0,0
1668482701436,ECE 265D,A00,103662,Gudem; Prasad S.S.,0,24,0,0
1668482701861,ECE 268,A00,103663,Koushanfar; Farinaz,0,42,0,0
1668482702284,ECE 269,A01,103665,Pal; Piya,0,211,0,0
1668482702712,ECE 271B,A00,103666,Vasconcelos; Manuela,0,74,0,0
1668482703142,ECE 276A,A00,103667,Atanasov; Nikolay A.,0,122,0,0
1668482703569,ECE 277,A00,103668,An; Cheolhong,0,144,0,0
1668482703993,ECE 279,A00,117947,Hall; Drew A.,0,22,0,0
1668482704843,ECE 283,A00,103670,Hsueh; Tzu-Chien,0,51,0,0
1668482705267,ECE 284,A00,103671,Turakhia; Yatish Girish,0,39,0,0
1668482705704,ECE 285,A00,103672,Zheng; Yang,0,39,0,0
1668482705704,ECE 285,B00,103673,Sworder; David D.,0,55,0,0
1668482706130,ECE 287,A00,103676,Javidi; Tara,0,8,0,0
1668482706561,MATH 200B,A00,098023,Salehi Golsefidy; Alireza,10,0,15,5
1668482706988,MATH 202B,A00,098024,Rhoades; Brendon Patrick,7,0,15,8
1668482707421,MATH 203B,A00,098025,Oprea; Dragos N.,9,0,15,6
1668482707845,MATH 204B,A00,098026,Sorensen; Claus M,13,0,15,2
1668482708273,MATH 208,A00,098027,Izadi; Elham,7,0,10,3
1668482708698,MATH 209,A00,098028,Pollack; Aaron,10,0,10,0
1668482709122,MATH 211A,A00,112919,Rogalski; Daniel,8,0,10,2
1668482709545,MATH 211B,A00,112920,Seward; Brandon M.,9,0,10,1
1668482709969,MATH 218,A00,098029,Li; Bo,10,0,10,0
1668482710397,MATH 220B,A00,098030,Novak; Jonathan I,11,0,15,4
1668482710826,MATH 221A,A00,098031,Ebenfelt; Peter F,12,0,15,3
1668482711250,MATH 231B,A00,098032,Zlatos; Andrej,11,0,15,4
1668482711673,MATH 240B,A00,098033,Ni; Lei,7,0,15,8
1668482712099,MATH 243,A00,098034,Jekel; David Andrew,10,0,10,0
1668482712526,MATH 245A,A00,098035,Nie; Jiawang,0,4,15,18
1668482712951,MATH 248,A00,098036,Bejenaru; Ioan,10,0,10,0
1668482713377,MATH 250B,A00,098037,Spolaor; Luca,14,0,15,1
1668482713801,MATH 258,A00,098038,Ni; Lei,9,0,10,1
1668482714227,MATH 264B,A00,098041,Rhoades; Brendon Patrick,8,0,15,7
1668482714653,MATH 268,A00,098042,Buss; Samuel R,10,0,10,0
1668482715086,MATH 269,A00,098043,Rhoades; Brendon Patrick,10,0,10,0
1668482715513,MATH 270B,A00,098044,Li; Bo,6,0,15,9
1668482715952,MATH 272B,A00,098045,Holst; Michael J,13,0,15,2
1668482716376,MATH 273A,A00,098046,Tian; Xiaochuan,10,0,15,5
1668482716805,MATH 275,A01,098048,Tian; Xiaochuan,6,0,10,4
1668482717230,MATH 278A,A00,098049,Holst; Michael J,7,0,10,3
1668482717653,MATH 278B,A00,098050,Cloninger; Alexander,10,0,10,0
1668482718075,MATH 278C,A00,098051,Nie; Jiawang,5,0,10,5
1668482718505,MATH 280B,A00,098052,Zheng; Tianyi,7,0,15,8
1668482718931,MATH 281B,A00,098053,Bradic; Jelena,0,2,15,15
1668482719360,MATH 282B,A00,098054,Arias-Castro; Ery,0,1,15,15
1668482719782,MATH 285,A00,098055,Fitzsimmons; Patrick J,0,2,15,17
1668482720209,MATH 287B,A00,098056,Arias-Castro; Ery,1,0,15,14
1668482720634,MATH 288,A00,098057,Agarwal; Pooja,9,0,10,1
1668482720634,MATH 288,B00,098058,Zhang; Danna,8,0,10,2
1668482720634,MATH 288,C00,098059,Williams; Ruth J,9,0,10,1
1668482721059,MATH 290B,A00,098060,Roberts; Justin Deritter,12,0,15,3
1668482721484,MATH 292,A00,098061,Belmont; Eva Kinoshita,10,0,10,0
1668482721936,MATH 295,A00,098062,Suk; Andrew Hoon,47,0,50,3
1668482722366,MATH 296,A00,098063,Novak; Jonathan I,20,0,20,0
1668482722795,MATH 297,001,098064,Gamst; Anthony Collins,9997,0,9999,2
1668483224468,COGS 205,A00,101395,Chiba; Andrea,19,0,20,1
1668483224899,COGS 210B,001,101404,Greene; Deanna Jacquelyn,9998,0,9999,1
1668483224899,COGS 210B,002,101417,Xia; Haijun,9999,0,9999,0
1668483224899,COGS 210B,003,101422,Nitz; Douglas A.,9999,0,9999,0
1668483224899,COGS 210B,004,101423,Hollan; James D.,9998,0,9999,1
1668483224899,COGS 210B,005,101424,Deak; Gedeon O.,9998,0,9999,1
1668483224899,COGS 210B,006,101425,Rossano; Federico,9999,0,9999,0
1668483225330,COGS 211B,A00,101427,Coulson; Seana M,9996,0,9999,3
1668483225753,COGS 220,A00,101428,Hollan; James D.,1,9,25,24
1668483226179,COGS 229,A00,101429,Dow; Steven P,17,0,25,8
1668483226607,COGS 230,A00,101430,Klemmer; Scott R,8,0,17,9
1668483227041,COGS 234,A00,101431,Xia; Haijun,2,0,25,23
1668483227471,COGS 260,A00,101432,Kiyonaga; Anastasia,21,0,25,4
1668483227471,COGS 260,B00,101433,Kirsh; David Joel,15,0,25,10
1668483227899,CSE 202,A00,102371,Impagliazzo; Russell,0,61,0,0
1668483228336,CSE 203B,A01,102373,Cheng; Chung Kuan,0,52,0,0
1668483228782,CSE 208,A00,102374,Micciancio; Daniele,0,5,0,0
1668483229205,CSE 209A,A00,112895,Impagliazzo; Russell,0,12,15,15
1668483229628,CSE 209B,A00,108005,Bellare; Mihir,0,6,0,0
1668483230053,CSE 210,A00,113163,Coblenz; Michael J,0,80,0,0
1668483230478,CSE 219,A00,106111,Dow; Steven P,0,6,20,20
1668483230900,CSE 221,A00,102376,Voelker; Geoffrey M.,0,68,0,0
1668483231327,CSE 224,A01,102378,Porter; George M,0,159,0,0
1668483231752,CSE 229A,A00,102379,Savage; Stefan,0,10,0,0
1668483232180,CSE 229C,A00,102380,Munyaka; Imani N. S.,0,10,0,0
1668483232604,CSE 232B,A00,102382,Deutsch; Alin Bernard,0,30,0,0
1668483233029,CSE 234,A01,112904,Kumar; Arun Kumar,0,0,0,0
1668483233452,CSE 237A,A00,102383,Rosing; Tajana Simunic,0,49,0,0
1668483233877,CSE 239A,A00,102384,Deutsch; Alin Bernard,0,13,0,0
1668483234310,CSE 239B,A00,102385,Polikarpova; Nadezhda,0,10,0,0
1668483234743,CSE 240A,A00,102386,Pannuto; Patrick William,0,44,0,0
1668483235165,CSE 240B,A00,102387,Zhao; Jishen,0,42,0,0
1668483235591,CSE 241A,A00,106406,Kang; Mingu,0,7,0,0
1668483236015,CSE 249B,A00,102388,Kahng; Andrew Byun,0,5,8,8
1668483236442,CSE 251B,A01,102392,Cottrell; Garrison W,0,46,0,0
1668483236442,CSE 251B,A02,102393,Cottrell; Garrison W,0,33,0,0
1668483236873,CSE 252B,A00,102394,Ochoa; Benjamin Lawrence,0,56,0,0
1668483237297,CSE 257,A01,102396,Gao; Sicun,0,132,0,0
1668483237725,CSE 272,A00,102397,Li; Tzumao,0,17,0,0
1668483238150,CSE 274,A00,111323,Chern; Albert Ren-Haur,0,15,0,0
1668483238574,CSE 282,A00,102398,Pevzner; Pavel Arkadjevich,0,0,0,0
1668483239005,CSE 284,A00,114175,Gymrek; Melissa Ann,0,21,0,0
1668483239430,CSE 290,A00,102399,Chandraker; Manmohan Krishna,0,11,0,0
1668483239430,CSE 290,B00,102400,Vaccaro; Kristen Marie,0,7,25,25
1668483239430,CSE 290,C00,102414,Pannuto; Patrick William,0,1,25,25
1668483239430,CSE 290,D00,102427,Pevzner; Pavel Arkadjevich,0,0,0,0
1668483239430,CSE 290,E00,102429,Zhao; Jishen,0,4,0,0
1668483239430,CSE 290,F00,102436,Tullsen; Dean Michael,0,5,0,0
1668483239430,CSE 290,G00,102440,Christensen; Henrik I,0,6,20,20
1668483239856,CSE 291,A00,102443,Su; Hao,0,0,0,0
1668483239856,CSE 291,B00,102448,Polikarpova; Nadezhda,0,0,0,0
1668483239856,CSE 291,C00,102453,Vaccaro; Kristen Marie,0,0,0,0
1668483239856,CSE 291,D00,111343,Savage; Stefan,0,0,0,0
1668483239856,CSE 291,E00,116474,Claffy; Kimberly Claire,0,0,0,0
1668483239856,CSE 291,F00,116479,Pasquale; Joseph,0,0,0,0
1668483240290,CSE 293,001,119111,Bafna; Vineet,9999,0,9999,0
1668483240290,CSE 293,002,119118,Bellare; Mihir,9999,0,9999,0
1668483240290,CSE 293,003,119122,Berg-Kirkpatrick; Taylor D,9999,0,9999,0
1668483240290,CSE 293,004,119135,Christensen; Henrik I,9999,0,9999,0
1668483240290,CSE 293,005,119142,Cottrell; Garrison W,9999,0,9999,0
1668483240290,CSE 293,006,119146,Deutsch; Alin Bernard,9999,0,9999,0
1668483240290,CSE 293,007,119159,Esmaeilzadeh; Hadi,9999,0,9999,0
1668483240290,CSE 293,008,119166,Freund; Yoav,9999,0,9999,0
1668483240290,CSE 293,009,119170,Griswold; William G.,9999,0,9999,0
1668483240290,CSE 293,010,119183,Gymrek; Melissa Ann,9999,0,9999,0
1668483240290,CSE 293,011,119190,Heninger; Nadia A,9999,0,9999,0
1668483240290,CSE 293,012,119230,Impagliazzo; Russell,9999,0,9999,0
1668483240290,CSE 293,013,119232,Jhala; Ranjit,9999,0,9999,0
1668483240290,CSE 293,014,119233,Kahng; Andrew Byun,9999,0,9999,0
1668483240290,CSE 293,015,119298,Kane; Daniel Mertz,9999,0,9999,0
1668483240290,CSE 293,016,119299,Kriegman; David J,9999,0,9999,0
1668483240290,CSE 293,017,119300,Kumar; Arun Kumar,9999,0,9999,0
1668483240290,CSE 293,018,119301,Lerner; Sorin,9999,0,9999,0
1668483240290,CSE 293,019,119302,Lovett; Shachar,9999,0,9999,0
1668483240290,CSE 293,020,119303,McAuley; Julian John,9999,0,9999,0
1668483240290,CSE 293,021,119304,Micciancio; Daniele,9999,0,9999,0
1668483240290,CSE 293,022,119367,Orailoglu; Alex,9999,0,9999,0
1668483240290,CSE 293,023,119382,Paturi; Ramamohan,9999,0,9999,0
1668483240290,CSE 293,024,119404,Polikarpova; Nadezhda,9999,0,9999,0
1668483240290,CSE 293,025,119406,Politz; Joseph Gibbs,9999,0,9999,0
1668483240290,CSE 293,026,119411,Porter; George M,9999,0,9999,0
1668483240290,CSE 293,027,119414,Porter; Leonard Emerson,9999,0,9999,0
1668483240290,CSE 293,028,119416,Ramamoorthi; Ravi,9999,0,9999,0
1668483240290,CSE 293,029,119417,Sahoo; Debashis,9999,0,9999,0
1668483240290,CSE 293,030,119420,Saul; Lawrence,9999,0,9999,0
1668483240290,CSE 293,031,119421,Savage; Stefan,9999,0,9999,0
1668483240290,CSE 293,032,119425,Schulze; Jurgen P.,9999,0,9999,0
1668483240290,CSE 293,033,119426,Snoeren; Alex C.,9999,0,9999,0
1668483240290,CSE 293,034,119428,Shang; Jingbo,9999,0,9999,0
1668483240290,CSE 293,035,119430,Stefan; Deian,9999,0,9999,0
1668483240290,CSE 293,036,119431,Su; Hao,9999,0,9999,0
1668483240290,CSE 293,037,119433,Swanson; Steven James,9999,0,9999,0
1668483240290,CSE 293,038,119435,Tullsen; Dean Michael,9999,0,9999,0
1668483240290,CSE 293,039,119483,Voelker; Geoffrey M.,9999,0,9999,0
1668483240290,CSE 293,040,119537,Zhao; Jishen,9999,0,9999,0
1668483240290,CSE 293,041,119538,Zhou; Yuan-Yuan,9999,0,9999,0
1668483240290,CSE 293,042,119539,Gao; Sicun,9999,0,9999,0
1668483240290,CSE 293,043,119540,Weibel; Nadir,9999,0,9999,0
1668483240290,CSE 293,044,119541,Gupta; Rajesh K.,9999,0,9999,0
1668483240290,CSE 293,045,126410,Vaccaro; Kristen Marie,9999,0,9999,0
1668483240290,CSE 293,046,126411,Klemke; Richard,9999,0,9999,0
1668483240713,CSE 294,A00,102459,Voelker; Geoffrey M.,0,2,0,0
1668483240713,CSE 294,B00,111322,Orailoglu; Alex,0,2,0,0
1668483241136,DSE 201,A00,096914,Deutsch; Alin Bernard,30,0,30,0
1668483241561,DSE 210,A00,096915,Dasgupta; Sanjoy,30,0,30,0
1668483241986,DSE 260A,A00,096916,Altintas De Callaf; Ilkay,30,0,30,0
1668483242461,ECE 200,001,103586,Antipa; Nicholas A,9999,0,9999,0
1668483242461,ECE 200,002,103587,Atanasov; Nikolay A.,9999,0,9999,0
1668483242461,ECE 200,003,103588,Bharadia; Dinesh,9999,0,9999,0
1668483242461,ECE 200,004,103589,Cheng; Chung Kuan,9999,0,9999,0
1668483242461,ECE 200,005,103590,Cosman; Pamela C.,9999,0,9999,0
1668483242461,ECE 200,006,103591,Dayeh; Shadi Ahmad,9999,0,9999,0
1668483242461,ECE 200,007,103592,Fainman; Yeshaiahu,9999,0,9999,0
1668483242461,ECE 200,008,103593,Ford; Joseph Earl,9999,0,9999,0
1668483242461,ECE 200,009,103594,Franceschetti; Massimo,9999,0,9999,0
1668483242461,ECE 200,010,103595,Fullerton; Eric E,9999,0,9999,0
1668483242461,ECE 200,011,103596,Galton; Ian A,9999,0,9999,0
1668483242461,ECE 200,012,103597,Gilja; Vikash,9999,0,9999,0
1668483242461,ECE 200,013,103598,Hall; Drew A.,9999,0,9999,0
1668483242461,ECE 200,014,103599,Hsueh; Tzu-Chien,9999,0,9999,0
1668483242461,ECE 200,015,103600,Javidi; Tara,9999,0,9999,0
1668483242461,ECE 200,016,103601,Kahng; Andrew Byun,9999,0,9999,0
1668483242461,ECE 200,017,103602,Kim; Young-Han,9999,0,9999,0
1668483242461,ECE 200,018,103603,Koushanfar; Farinaz,9999,0,9999,0
1668483242461,ECE 200,019,103604,Kuzum; Duygu,9999,0,9999,0
1668483242461,ECE 200,020,103605,Le; Hanh-Phuc,9999,0,9999,0
1668483242461,ECE 200,021,103606,Lin; Bill,9999,0,9999,0
1668483242461,ECE 200,022,103607,Liu; Zhaowei,9998,0,9999,1
1668483242461,ECE 200,023,103608,Lo; Yu-Hwa,9999,0,9999,0
1668483242461,ECE 200,024,103609,Lomakin; Vitaliy,9999,0,9999,0
1668483242461,ECE 200,025,103610,Mercier; Patrick Philip,9999,0,9999,0
1668483242461,ECE 200,026,103611,Meyer; Florian,9999,0,9999,0
1668483242461,ECE 200,027,103612,Milstein; Laurence B.,9999,0,9999,0
1668483242461,ECE 200,028,103613,Mir Arabbaygi; Siavash,9999,0,9999,0
1668483242461,ECE 200,029,103614,Mookherjea; Shayan,9999,0,9999,0
1668483242461,ECE 200,030,103615,Morris; Karcher William,9999,0,9999,0
1668483242461,ECE 200,031,103616,Ng; Tse Nga,9999,0,9999,0
1668483242461,ECE 200,032,103617,Nguyen; Truong Quang,9999,0,9999,0
1668483242461,ECE 200,033,103618,Nomura; Kenji,9999,0,9999,0
1668483242461,ECE 200,034,103619,Orlitsky; Alon,9999,0,9999,0
1668483242461,ECE 200,035,103620,Pal; Piya,9999,0,9999,0
1668483242461,ECE 200,036,103621,Papen; George C.,9999,0,9999,0
1668483242461,ECE 200,037,103622,Radic; Stojan,9999,0,9999,0
1668483242461,ECE 200,038,103623,Rao; Bhaskar D.,9999,0,9999,0
1668483242461,ECE 200,039,103624,Rao; Ramesh R,9999,0,9999,0
1668483242461,ECE 200,040,103625,Rebeiz; Gabriel,9999,0,9999,0
1668483242461,ECE 200,041,103626,Sanford; John R,9999,0,9999,0
1668483242461,ECE 200,042,103627,Siegel; Paul H.,9999,0,9999,0
1668483242461,ECE 200,043,103628,Sievenpiper; Daniel F.,9999,0,9999,0
1668483242461,ECE 200,044,103629,Sworder; David D.,9999,0,9999,0
1668483242461,ECE 200,045,103630,Taur; Yuan,9999,0,9999,0
1668483242461,ECE 200,046,103631,Touri; Behrouz,9999,0,9999,0
1668483242461,ECE 200,047,103632,Trivedi; Mohan M.,9999,0,9999,0
1668483242461,ECE 200,048,103633,Vasconcelos; Nuno,9999,0,9999,0
1668483242461,ECE 200,049,103634,Wang; Xiaolong,9999,0,9999,0
1668483242461,ECE 200,050,103635,Xie; Pengtao,9999,0,9999,0
1668483242461,ECE 200,051,103636,Yip; Michael,9999,0,9999,0
1668483242461,ECE 200,052,103637,Zeger; Kenneth A.,999,0,999,0
1668483242461,ECE 200,053,103638,Zhang; Xinyu,9999,0,9999,0
1668483242461,ECE 200,054,103639,Turakhia; Yatish Girish,9999,0,9999,0
1668483242461,ECE 200,055,103640,Kang; Mingu,9999,0,9999,0
1668483242461,ECE 200,056,103641,Shi; Yuanyuan,9999,0,9999,0
1668483242461,ECE 200,057,103642,Wang; Edward Jay,9999,0,9999,0
1668483242461,ECE 200,058,103643,Zheng; Yang,9999,0,9999,0
1668483242889,ECE 202,A00,103644,Kuzum; Duygu,0,42,0,0
1668483243319,ECE 212BN,A00,103646,Ng; Tse Nga,0,9,0,0
1668483243743,ECE 221,A00,111493,Staff,0,0,0,0
1668483244168,ECE 222B,A00,103647,Lomakin; Vitaliy,0,18,0,0
1668483244592,ECE 230B,A00,103648,Taur; Yuan,0,2,0,0
1668483245032,ECE 238B,A00,103649,Garay; Javier,0,0,0,0
1668483245461,ECE 240B,A00,112900,Fainman; Yeshaiahu,0,6,0,0
1668483245886,ECE 247A,A00,103650,Jokerst; Jesse Vincent,0,6,0,0
1668483246410,ECE 247B,A00,103651,Wang; Joseph,0,12,0,0
1668483246835,ECE 250,A00,103652,Siegel; Paul H.,0,82,0,0
1668483247262,ECE 251A,A00,103654,Rao; Bhaskar D.,0,61,0,0
1668483247686,ECE 257B,A00,103655,Bharadia; Dinesh,0,32,0,0
1668483248112,ECE 258A,A00,103656,Milstein; Laurence B.,0,28,0,0
1668483248544,ECE 260B,A00,103658,Kang; Mingu,0,119,0,0
1668483248976,ECE 264A,A00,103659,Galton; Ian A,0,66,0,0
1668483249399,ECE 265A,A00,103661,Gudem; Prasad S.S.,0,65,0,0
1668483249826,ECE 265D,A00,103662,Gudem; Prasad S.S.,0,24,0,0
1668483250250,ECE 268,A00,103663,Koushanfar; Farinaz,0,42,0,0
1668483250675,ECE 269,A01,103665,Pal; Piya,0,211,0,0
1668483251102,ECE 271B,A00,103666,Vasconcelos; Manuela,0,74,0,0
1668483251533,ECE 276A,A00,103667,Atanasov; Nikolay A.,0,122,0,0
1668483251957,ECE 277,A00,103668,An; Cheolhong,0,144,0,0
1668483252385,ECE 279,A00,117947,Hall; Drew A.,0,22,0,0
1668483253233,ECE 283,A00,103670,Hsueh; Tzu-Chien,0,51,0,0
1668483253661,ECE 284,A00,103671,Turakhia; Yatish Girish,0,39,0,0
1668483254084,ECE 285,A00,103672,Zheng; Yang,0,39,0,0
1668483254084,ECE 285,B00,103673,Sworder; David D.,0,55,0,0
1668483254507,ECE 287,A00,103676,Javidi; Tara,0,8,0,0
1668483254932,MATH 200B,A00,098023,Salehi Golsefidy; Alireza,10,0,15,5
1668483255364,MATH 202B,A00,098024,Rhoades; Brendon Patrick,7,0,15,8
1668483255787,MATH 203B,A00,098025,Oprea; Dragos N.,9,0,15,6
1668483256220,MATH 204B,A00,098026,Sorensen; Claus M,13,0,15,2
1668483256648,MATH 208,A00,098027,Izadi; Elham,7,0,10,3
1668483257072,MATH 209,A00,098028,Pollack; Aaron,10,0,10,0
1668483257496,MATH 211A,A00,112919,Rogalski; Daniel,8,0,10,2
1668483257919,MATH 211B,A00,112920,Seward; Brandon M.,9,0,10,1
1668483258346,MATH 218,A00,098029,Li; Bo,10,0,10,0
1668483258772,MATH 220B,A00,098030,Novak; Jonathan I,11,0,15,4
1668483259197,MATH 221A,A00,098031,Ebenfelt; Peter F,12,0,15,3
1668483259618,MATH 231B,A00,098032,Zlatos; Andrej,11,0,15,4
1668483260042,MATH 240B,A00,098033,Ni; Lei,7,0,15,8
1668483260468,MATH 243,A00,098034,Jekel; David Andrew,10,0,10,0
1668483260894,MATH 245A,A00,098035,Nie; Jiawang,0,4,15,18
1668483261318,MATH 248,A00,098036,Bejenaru; Ioan,10,0,10,0
1668483261749,MATH 250B,A00,098037,Spolaor; Luca,14,0,15,1
1668483262177,MATH 258,A00,098038,Ni; Lei,9,0,10,1
1668483262601,MATH 264B,A00,098041,Rhoades; Brendon Patrick,8,0,15,7
1668483263030,MATH 268,A00,098042,Buss; Samuel R,10,0,10,0
1668483263455,MATH 269,A00,098043,Rhoades; Brendon Patrick,10,0,10,0
1668483263879,MATH 270B,A00,098044,Li; Bo,6,0,15,9
1668483264306,MATH 272B,A00,098045,Holst; Michael J,13,0,15,2
1668483264733,MATH 273A,A00,098046,Tian; Xiaochuan,10,0,15,5
1668483265158,MATH 275,A01,098048,Tian; Xiaochuan,6,0,10,4
1668483265586,MATH 278A,A00,098049,Holst; Michael J,7,0,10,3
1668483266010,MATH 278B,A00,098050,Cloninger; Alexander,10,0,10,0
1668483266435,MATH 278C,A00,098051,Nie; Jiawang,5,0,10,5
1668483266858,MATH 280B,A00,098052,Zheng; Tianyi,7,0,15,8
1668483267291,MATH 281B,A00,098053,Bradic; Jelena,0,2,15,15
1668483267713,MATH 282B,A00,098054,Arias-Castro; Ery,0,1,15,15
1668483268136,MATH 285,A00,098055,Fitzsimmons; Patrick J,0,2,15,17
1668483268562,MATH 287B,A00,098056,Arias-Castro; Ery,1,0,15,14
1668483268987,MATH 288,A00,098057,Agarwal; Pooja,9,0,10,1
1668483268987,MATH 288,B00,098058,Zhang; Danna,8,0,10,2
1668483268987,MATH 288,C00,098059,Williams; Ruth J,9,0,10,1
1668483269411,MATH 290B,A00,098060,Roberts; Justin Deritter,12,0,15,3
1668483269836,MATH 292,A00,098061,Belmont; Eva Kinoshita,10,0,10,0
1668483270265,MATH 295,A00,098062,Suk; Andrew Hoon,47,0,50,3
1668483270689,MATH 296,A00,098063,Novak; Jonathan I,20,0,20,0
1668483271117,MATH 297,001,098064,Gamst; Anthony Collins,9997,0,9999,2
1668483773195,COGS 205,A00,101395,Chiba; Andrea,19,0,20,1
1668483773618,COGS 210B,001,101404,Greene; Deanna Jacquelyn,9998,0,9999,1
1668483773618,COGS 210B,002,101417,Xia; Haijun,9999,0,9999,0
1668483773618,COGS 210B,003,101422,Nitz; Douglas A.,9999,0,9999,0
1668483773618,COGS 210B,004,101423,Hollan; James D.,9998,0,9999,1
1668483773618,COGS 210B,005,101424,Deak; Gedeon O.,9998,0,9999,1
1668483773618,COGS 210B,006,101425,Rossano; Federico,9999,0,9999,0
1668483774043,COGS 211B,A00,101427,Coulson; Seana M,9996,0,9999,3
1668483774467,COGS 220,A00,101428,Hollan; James D.,1,9,25,24
1668483774903,COGS 229,A00,101429,Dow; Steven P,17,0,25,8
1668483775339,COGS 230,A00,101430,Klemmer; Scott R,8,0,17,9
1668483775762,COGS 234,A00,101431,Xia; Haijun,2,0,25,23
1668483776193,COGS 260,A00,101432,Kiyonaga; Anastasia,21,0,25,4
1668483776193,COGS 260,B00,101433,Kirsh; David Joel,15,0,25,10
1668483776623,CSE 202,A00,102371,Impagliazzo; Russell,0,61,0,0
1668483777050,CSE 203B,A01,102373,Cheng; Chung Kuan,0,52,0,0
1668483777477,CSE 208,A00,102374,Micciancio; Daniele,0,5,0,0
1668483777909,CSE 209A,A00,112895,Impagliazzo; Russell,0,12,15,15
1668483778336,CSE 209B,A00,108005,Bellare; Mihir,0,6,0,0
1668483778761,CSE 210,A00,113163,Coblenz; Michael J,0,80,0,0
1668483779183,CSE 219,A00,106111,Dow; Steven P,0,6,20,20
1668483779608,CSE 221,A00,102376,Voelker; Geoffrey M.,0,68,0,0
1668483780037,CSE 224,A01,102378,Porter; George M,0,159,0,0
1668483780465,CSE 229A,A00,102379,Savage; Stefan,0,10,0,0
1668483780889,CSE 229C,A00,102380,Munyaka; Imani N. S.,0,10,0,0
1668483781313,CSE 232B,A00,102382,Deutsch; Alin Bernard,0,30,0,0
1668483781735,CSE 234,A01,112904,Kumar; Arun Kumar,0,0,0,0
1668483782160,CSE 237A,A00,102383,Rosing; Tajana Simunic,0,49,0,0
1668483782586,CSE 239A,A00,102384,Deutsch; Alin Bernard,0,13,0,0
1668483783011,CSE 239B,A00,102385,Polikarpova; Nadezhda,0,10,0,0
1668483783442,CSE 240A,A00,102386,Pannuto; Patrick William,0,44,0,0
1668483783873,CSE 240B,A00,102387,Zhao; Jishen,0,42,0,0
1668483784299,CSE 241A,A00,106406,Kang; Mingu,0,7,0,0
1668483784726,CSE 249B,A00,102388,Kahng; Andrew Byun,0,5,8,8
1668483785159,CSE 251B,A01,102392,Cottrell; Garrison W,0,46,0,0
1668483785159,CSE 251B,A02,102393,Cottrell; Garrison W,0,33,0,0
1668483785581,CSE 252B,A00,102394,Ochoa; Benjamin Lawrence,0,56,0,0
1668483786003,CSE 257,A01,102396,Gao; Sicun,0,132,0,0
1668483786426,CSE 272,A00,102397,Li; Tzumao,0,17,0,0
1668483786851,CSE 274,A00,111323,Chern; Albert Ren-Haur,0,15,0,0
1668483787276,CSE 282,A00,102398,Pevzner; Pavel Arkadjevich,0,0,0,0
1668483787701,CSE 284,A00,114175,Gymrek; Melissa Ann,0,21,0,0
1668483788124,CSE 290,A00,102399,Chandraker; Manmohan Krishna,0,11,0,0
1668483788124,CSE 290,B00,102400,Vaccaro; Kristen Marie,0,7,25,25
1668483788124,CSE 290,C00,102414,Pannuto; Patrick William,0,1,25,25
1668483788124,CSE 290,D00,102427,Pevzner; Pavel Arkadjevich,0,0,0,0
1668483788124,CSE 290,E00,102429,Zhao; Jishen,0,4,0,0
1668483788124,CSE 290,F00,102436,Tullsen; Dean Michael,0,5,0,0
1668483788124,CSE 290,G00,102440,Christensen; Henrik I,0,6,20,20
1668483788549,CSE 291,A00,102443,Su; Hao,0,0,0,0
1668483788549,CSE 291,B00,102448,Polikarpova; Nadezhda,0,0,0,0
1668483788549,CSE 291,C00,102453,Vaccaro; Kristen Marie,0,0,0,0
1668483788549,CSE 291,D00,111343,Savage; Stefan,0,0,0,0
1668483788549,CSE 291,E00,116474,Claffy; Kimberly Claire,0,0,0,0
1668483788549,CSE 291,F00,116479,Pasquale; Joseph,0,0,0,0
1668483788977,CSE 293,001,119111,Bafna; Vineet,9999,0,9999,0
1668483788977,CSE 293,002,119118,Bellare; Mihir,9999,0,9999,0
1668483788977,CSE 293,003,119122,Berg-Kirkpatrick; Taylor D,9999,0,9999,0
1668483788977,CSE 293,004,119135,Christensen; Henrik I,9999,0,9999,0
1668483788977,CSE 293,005,119142,Cottrell; Garrison W,9999,0,9999,0
1668483788977,CSE 293,006,119146,Deutsch; Alin Bernard,9999,0,9999,0
1668483788977,CSE 293,007,119159,Esmaeilzadeh; Hadi,9999,0,9999,0
1668483788977,CSE 293,008,119166,Freund; Yoav,9999,0,9999,0
1668483788977,CSE 293,009,119170,Griswold; William G.,9999,0,9999,0
1668483788977,CSE 293,010,119183,Gymrek; Melissa Ann,9999,0,9999,0
1668483788977,CSE 293,011,119190,Heninger; Nadia A,9999,0,9999,0
1668483788977,CSE 293,012,119230,Impagliazzo; Russell,9999,0,9999,0
1668483788977,CSE 293,013,119232,Jhala; Ranjit,9999,0,9999,0
1668483788977,CSE 293,014,119233,Kahng; Andrew Byun,9999,0,9999,0
1668483788977,CSE 293,015,119298,Kane; Daniel Mertz,9999,0,9999,0
1668483788977,CSE 293,016,119299,Kriegman; David J,9999,0,9999,0
1668483788977,CSE 293,017,119300,Kumar; Arun Kumar,9999,0,9999,0
1668483788977,CSE 293,018,119301,Lerner; Sorin,9999,0,9999,0
1668483788977,CSE 293,019,119302,Lovett; Shachar,9999,0,9999,0
1668483788977,CSE 293,020,119303,McAuley; Julian John,9999,0,9999,0
1668483788977,CSE 293,021,119304,Micciancio; Daniele,9999,0,9999,0
1668483788977,CSE 293,022,119367,Orailoglu; Alex,9999,0,9999,0
1668483788977,CSE 293,023,119382,Paturi; Ramamohan,9999,0,9999,0
1668483788977,CSE 293,024,119404,Polikarpova; Nadezhda,9999,0,9999,0
1668483788977,CSE 293,025,119406,Politz; Joseph Gibbs,9999,0,9999,0
1668483788977,CSE 293,026,119411,Porter; George M,9999,0,9999,0
1668483788977,CSE 293,027,119414,Porter; Leonard Emerson,9999,0,9999,0
1668483788977,CSE 293,028,119416,Ramamoorthi; Ravi,9999,0,9999,0
1668483788977,CSE 293,029,119417,Sahoo; Debashis,9999,0,9999,0
1668483788977,CSE 293,030,119420,Saul; Lawrence,9999,0,9999,0
1668483788977,CSE 293,031,119421,Savage; Stefan,9999,0,9999,0
1668483788977,CSE 293,032,119425,Schulze; Jurgen P.,9999,0,9999,0
1668483788977,CSE 293,033,119426,Snoeren; Alex C.,9999,0,9999,0
1668483788977,CSE 293,034,119428,Shang; Jingbo,9999,0,9999,0
1668483788977,CSE 293,035,119430,Stefan; Deian,9999,0,9999,0
1668483788977,CSE 293,036,119431,Su; Hao,9999,0,9999,0
1668483788977,CSE 293,037,119433,Swanson; Steven James,9999,0,9999,0
1668483788977,CSE 293,038,119435,Tullsen; Dean Michael,9999,0,9999,0
1668483788977,CSE 293,039,119483,Voelker; Geoffrey M.,9999,0,9999,0
1668483788977,CSE 293,040,119537,Zhao; Jishen,9999,0,9999,0
1668483788977,CSE 293,041,119538,Zhou; Yuan-Yuan,9999,0,9999,0
1668483788977,CSE 293,042,119539,Gao; Sicun,9999,0,9999,0
1668483788977,CSE 293,043,119540,Weibel; Nadir,9999,0,9999,0
1668483788977,CSE 293,044,119541,Gupta; Rajesh K.,9999,0,9999,0
1668483788977,CSE 293,045,126410,Vaccaro; Kristen Marie,9999,0,9999,0
1668483788977,CSE 293,046,126411,Klemke; Richard,9999,0,9999,0
1668483789406,CSE 294,A00,102459,Voelker; Geoffrey M.,0,2,0,0
1668483789406,CSE 294,B00,111322,Orailoglu; Alex,0,2,0,0
1668483789828,DSE 201,A00,096914,Deutsch; Alin Bernard,30,0,30,0
1668483790259,DSE 210,A00,096915,Dasgupta; Sanjoy,30,0,30,0
1668483790684,DSE 260A,A00,096916,Altintas De Callaf; Ilkay,30,0,30,0
1668483791126,ECE 200,001,103586,Antipa; Nicholas A,9999,0,9999,0
1668483791126,ECE 200,002,103587,Atanasov; Nikolay A.,9999,0,9999,0
1668483791126,ECE 200,003,103588,Bharadia; Dinesh,9999,0,9999,0
1668483791126,ECE 200,004,103589,Cheng; Chung Kuan,9999,0,9999,0
1668483791126,ECE 200,005,103590,Cosman; Pamela C.,9999,0,9999,0
1668483791126,ECE 200,006,103591,Dayeh; Shadi Ahmad,9999,0,9999,0
1668483791126,ECE 200,007,103592,Fainman; Yeshaiahu,9999,0,9999,0
1668483791126,ECE 200,008,103593,Ford; Joseph Earl,9999,0,9999,0
1668483791126,ECE 200,009,103594,Franceschetti; Massimo,9999,0,9999,0
1668483791126,ECE 200,010,103595,Fullerton; Eric E,9999,0,9999,0
1668483791126,ECE 200,011,103596,Galton; Ian A,9999,0,9999,0
1668483791126,ECE 200,012,103597,Gilja; Vikash,9999,0,9999,0
1668483791126,ECE 200,013,103598,Hall; Drew A.,9999,0,9999,0
1668483791126,ECE 200,014,103599,Hsueh; Tzu-Chien,9999,0,9999,0
1668483791126,ECE 200,015,103600,Javidi; Tara,9999,0,9999,0
1668483791126,ECE 200,016,103601,Kahng; Andrew Byun,9999,0,9999,0
1668483791126,ECE 200,017,103602,Kim; Young-Han,9999,0,9999,0
1668483791126,ECE 200,018,103603,Koushanfar; Farinaz,9999,0,9999,0
1668483791126,ECE 200,019,103604,Kuzum; Duygu,9999,0,9999,0
1668483791126,ECE 200,020,103605,Le; Hanh-Phuc,9999,0,9999,0
1668483791126,ECE 200,021,103606,Lin; Bill,9999,0,9999,0
1668483791126,ECE 200,022,103607,Liu; Zhaowei,9998,0,9999,1
1668483791126,ECE 200,023,103608,Lo; Yu-Hwa,9999,0,9999,0
1668483791126,ECE 200,024,103609,Lomakin; Vitaliy,9999,0,9999,0
1668483791126,ECE 200,025,103610,Mercier; Patrick Philip,9999,0,9999,0
1668483791126,ECE 200,026,103611,Meyer; Florian,9999,0,9999,0
1668483791126,ECE 200,027,103612,Milstein; Laurence B.,9999,0,9999,0
1668483791126,ECE 200,028,103613,Mir Arabbaygi; Siavash,9999,0,9999,0
1668483791126,ECE 200,029,103614,Mookherjea; Shayan,9999,0,9999,0
1668483791126,ECE 200,030,103615,Morris; Karcher William,9999,0,9999,0
1668483791126,ECE 200,031,103616,Ng; Tse Nga,9999,0,9999,0
1668483791126,ECE 200,032,103617,Nguyen; Truong Quang,9999,0,9999,0
1668483791126,ECE 200,033,103618,Nomura; Kenji,9999,0,9999,0
1668483791126,ECE 200,034,103619,Orlitsky; Alon,9999,0,9999,0
1668483791126,ECE 200,035,103620,Pal; Piya,9999,0,9999,0
1668483791126,ECE 200,036,103621,Papen; George C.,9999,0,9999,0
1668483791126,ECE 200,037,103622,Radic; Stojan,9999,0,9999,0
1668483791126,ECE 200,038,103623,Rao; Bhaskar D.,9999,0,9999,0
1668483791126,ECE 200,039,103624,Rao; Ramesh R,9999,0,9999,0
1668483791126,ECE 200,040,103625,Rebeiz; Gabriel,9999,0,9999,0
1668483791126,ECE 200,041,103626,Sanford; John R,9999,0,9999,0
1668483791126,ECE 200,042,103627,Siegel; Paul H.,9999,0,9999,0
1668483791126,ECE 200,043,103628,Sievenpiper; Daniel F.,9999,0,9999,0
1668483791126,ECE 200,044,103629,Sworder; David D.,9999,0,9999,0
1668483791126,ECE 200,045,103630,Taur; Yuan,9999,0,9999,0
1668483791126,ECE 200,046,103631,Touri; Behrouz,9999,0,9999,0
1668483791126,ECE 200,047,103632,Trivedi; Mohan M.,9999,0,9999,0
1668483791126,ECE 200,048,103633,Vasconcelos; Nuno,9999,0,9999,0
1668483791126,ECE 200,049,103634,Wang; Xiaolong,9999,0,9999,0
1668483791126,ECE 200,050,103635,Xie; Pengtao,9999,0,9999,0
1668483791126,ECE 200,051,103636,Yip; Michael,9999,0,9999,0
1668483791126,ECE 200,052,103637,Zeger; Kenneth A.,999,0,999,0
1668483791126,ECE 200,053,103638,Zhang; Xinyu,9999,0,9999,0
1668483791126,ECE 200,054,103639,Turakhia; Yatish Girish,9999,0,9999,0
1668483791126,ECE 200,055,103640,Kang; Mingu,9999,0,9999,0
1668483791126,ECE 200,056,103641,Shi; Yuanyuan,9999,0,9999,0
1668483791126,ECE 200,057,103642,Wang; Edward Jay,9999,0,9999,0
1668483791126,ECE 200,058,103643,Zheng; Yang,9999,0,9999,0
1668483791552,ECE 202,A00,103644,Kuzum; Duygu,0,42,0,0
1668483791974,ECE 212BN,A00,103646,Ng; Tse Nga,0,9,0,0
1668483792399,ECE 221,A00,111493,Staff,0,0,0,0
1668483792826,ECE 222B,A00,103647,Lomakin; Vitaliy,0,18,0,0
1668483793252,ECE 230B,A00,103648,Taur; Yuan,0,2,0,0
1668483793675,ECE 238B,A00,103649,Garay; Javier,0,0,0,0
1668483794097,ECE 240B,A00,112900,Fainman; Yeshaiahu,0,7,0,0
1668483794728,ECE 247A,A00,103650,Jokerst; Jesse Vincent,0,6,0,0
1668483795153,ECE 247B,A00,103651,Wang; Joseph,0,12,0,0
1668483795581,ECE 250,A00,103652,Siegel; Paul H.,0,82,0,0
1668483796017,ECE 251A,A00,103654,Rao; Bhaskar D.,0,61,0,0
1668483796445,ECE 257B,A00,103655,Bharadia; Dinesh,0,32,0,0
1668483796869,ECE 258A,A00,103656,Milstein; Laurence B.,0,28,0,0
1668483797294,ECE 260B,A00,103658,Kang; Mingu,0,119,0,0
1668483797722,ECE 264A,A00,103659,Galton; Ian A,0,66,0,0
1668483798287,ECE 265A,A00,103661,Gudem; Prasad S.S.,0,65,0,0
1668483798713,ECE 265D,A00,103662,Gudem; Prasad S.S.,0,24,0,0
1668483799137,ECE 268,A00,103663,Koushanfar; Farinaz,0,42,0,0
1668483799565,ECE 269,A01,103665,Pal; Piya,0,211,0,0
1668483799993,ECE 271B,A00,103666,Vasconcelos; Manuela,0,74,0,0
1668483800425,ECE 276A,A00,103667,Atanasov; Nikolay A.,0,123,0,0
1668483800867,ECE 277,A00,103668,An; Cheolhong,0,145,0,0
1668483801291,ECE 279,A00,117947,Hall; Drew A.,0,22,0,0
1668483802161,ECE 283,A00,103670,Hsueh; Tzu-Chien,0,51,0,0
1668483802586,ECE 284,A00,103671,Turakhia; Yatish Girish,0,39,0,0
1668483803013,ECE 285,A00,103672,Zheng; Yang,0,39,0,0
1668483803013,ECE 285,B00,103673,Sworder; David D.,0,56,0,0
1668483803435,ECE 287,A00,103676,Javidi; Tara,0,8,0,0
1668483803859,MATH 200B,A00,098023,Salehi Golsefidy; Alireza,10,0,15,5
1668483804284,MATH 202B,A00,098024,Rhoades; Brendon Patrick,7,0,15,8
1668483804716,MATH 203B,A00,098025,Oprea; Dragos N.,9,0,15,6
1668483805140,MATH 204B,A00,098026,Sorensen; Claus M,13,0,15,2
1668483805563,MATH 208,A00,098027,Izadi; Elham,7,0,10,3
1668483805990,MATH 209,A00,098028,Pollack; Aaron,10,0,10,0
1668483806413,MATH 211A,A00,112919,Rogalski; Daniel,8,0,10,2
1668483806838,MATH 211B,A00,112920,Seward; Brandon M.,9,0,10,1
1668483807264,MATH 218,A00,098029,Li; Bo,10,0,10,0
1668483807698,MATH 220B,A00,098030,Novak; Jonathan I,11,0,15,4
1668483808123,MATH 221A,A00,098031,Ebenfelt; Peter F,12,0,15,3
1668483808549,MATH 231B,A00,098032,Zlatos; Andrej,11,0,15,4
1668483808971,MATH 240B,A00,098033,Ni; Lei,7,0,15,8
1668483809399,MATH 243,A00,098034,Jekel; David Andrew,10,0,10,0
1668483809823,MATH 245A,A00,098035,Nie; Jiawang,0,4,15,18
1668483810249,MATH 248,A00,098036,Bejenaru; Ioan,10,0,10,0
1668483810755,MATH 250B,A00,098037,Spolaor; Luca,14,0,15,1
1668483811178,MATH 258,A00,098038,Ni; Lei,9,0,10,1
1668483811607,MATH 264B,A00,098041,Rhoades; Brendon Patrick,8,0,15,7
1668483812033,MATH 268,A00,098042,Buss; Samuel R,10,0,10,0
1668483812469,MATH 269,A00,098043,Rhoades; Brendon Patrick,10,0,10,0
1668483812891,MATH 270B,A00,098044,Li; Bo,6,0,15,9
1668483813314,MATH 272B,A00,098045,Holst; Michael J,13,0,15,2
1668483813741,MATH 273A,A00,098046,Tian; Xiaochuan,10,0,15,5
1668483814171,MATH 275,A01,098048,Tian; Xiaochuan,6,0,10,4
1668483814602,MATH 278A,A00,098049,Holst; Michael J,7,0,10,3
1668483815025,MATH 278B,A00,098050,Cloninger; Alexander,10,0,10,0
1668483815450,MATH 278C,A00,098051,Nie; Jiawang,5,0,10,5
1668483815878,MATH 280B,A00,098052,Zheng; Tianyi,7,0,15,8
1668483816301,MATH 281B,A00,098053,Bradic; Jelena,0,2,15,15
1668483816729,MATH 282B,A00,098054,Arias-Castro; Ery,0,1,15,15
1668483817156,MATH 285,A00,098055,Fitzsimmons; Patrick J,0,2,15,17
1668483817580,MATH 287B,A00,098056,Arias-Castro; Ery,1,0,15,14
1668483818027,MATH 288,A00,098057,Agarwal; Pooja,9,0,10,1
1668483818027,MATH 288,B00,098058,Zhang; Danna,8,0,10,2
1668483818027,MATH 288,C00,098059,Williams; Ruth J,9,0,10,1
1668483818451,MATH 290B,A00,098060,Roberts; Justin Deritter,12,0,15,3
1668483818874,MATH 292,A00,098061,Belmont; Eva Kinoshita,10,0,10,0
1668483819300,MATH 295,A00,098062,Suk; Andrew Hoon,47,0,50,3
1668483819731,MATH 296,A00,098063,Novak; Jonathan I,20,0,20,0
1668483820175,MATH 297,001,098064,Gamst; Anthony Collins,9997,0,9999,2
1668484321537,COGS 205,A00,101395,Chiba; Andrea,19,0,20,1
1668484321968,COGS 210B,001,101404,Greene; Deanna Jacquelyn,9998,0,9999,1
1668484321968,COGS 210B,002,101417,Xia; Haijun,9999,0,9999,0
1668484321968,COGS 210B,003,101422,Nitz; Douglas A.,9999,0,9999,0
1668484321968,COGS 210B,004,101423,Hollan; James D.,9998,0,9999,1
1668484321968,COGS 210B,005,101424,Deak; Gedeon O.,9998,0,9999,1
1668484321968,COGS 210B,006,101425,Rossano; Federico,9999,0,9999,0
1668484322391,COGS 211B,A00,101427,Coulson; Seana M,9996,0,9999,3
1668484322812,COGS 220,A00,101428,Hollan; James D.,1,9,25,24
1668484323236,COGS 229,A00,101429,Dow; Steven P,17,0,25,8
1668484323665,COGS 230,A00,101430,Klemmer; Scott R,8,0,17,9
1668484324090,COGS 234,A00,101431,Xia; Haijun,2,0,25,23
1668484324513,COGS 260,A00,101432,Kiyonaga; Anastasia,21,0,25,4
1668484324513,COGS 260,B00,101433,Kirsh; David Joel,15,0,25,10
1668484324935,CSE 202,A00,102371,Impagliazzo; Russell,0,61,0,0
1668484325360,CSE 203B,A01,102373,Cheng; Chung Kuan,0,52,0,0
1668484325788,CSE 208,A00,102374,Micciancio; Daniele,0,5,0,0
1668484326222,CSE 209A,A00,112895,Impagliazzo; Russell,0,12,15,15
1668484326649,CSE 209B,A00,108005,Bellare; Mihir,0,6,0,0
1668484327076,CSE 210,A00,113163,Coblenz; Michael J,0,80,0,0
1668484327504,CSE 219,A00,106111,Dow; Steven P,0,6,20,20
1668484327938,CSE 221,A00,102376,Voelker; Geoffrey M.,0,68,0,0
1668484328361,CSE 224,A01,102378,Porter; George M,0,159,0,0
1668484328784,CSE 229A,A00,102379,Savage; Stefan,0,10,0,0
1668484329211,CSE 229C,A00,102380,Munyaka; Imani N. S.,0,10,0,0
1668484329635,CSE 232B,A00,102382,Deutsch; Alin Bernard,0,30,0,0
1668484330060,CSE 234,A01,112904,Kumar; Arun Kumar,0,0,0,0
1668484330485,CSE 237A,A00,102383,Rosing; Tajana Simunic,0,50,0,0
1668484331021,CSE 239A,A00,102384,Deutsch; Alin Bernard,0,13,0,0
1668484331457,CSE 239B,A00,102385,Polikarpova; Nadezhda,0,10,0,0
1668484331882,CSE 240A,A00,102386,Pannuto; Patrick William,0,44,0,0
1668484332306,CSE 240B,A00,102387,Zhao; Jishen,0,42,0,0
1668484332733,CSE 241A,A00,106406,Kang; Mingu,0,7,0,0
1668484333160,CSE 249B,A00,102388,Kahng; Andrew Byun,0,5,8,8
1668484333588,CSE 251B,A01,102392,Cottrell; Garrison W,0,46,0,0
1668484333588,CSE 251B,A02,102393,Cottrell; Garrison W,0,33,0,0
1668484334015,CSE 252B,A00,102394,Ochoa; Benjamin Lawrence,0,57,0,0
1668484334441,CSE 257,A01,102396,Gao; Sicun,0,132,0,0
1668484334867,CSE 272,A00,102397,Li; Tzumao,0,17,0,0
1668484335296,CSE 274,A00,111323,Chern; Albert Ren-Haur,0,15,0,0
1668484335719,CSE 282,A00,102398,Pevzner; Pavel Arkadjevich,0,0,0,0
1668484336149,CSE 284,A00,114175,Gymrek; Melissa Ann,0,21,0,0
1668484336584,CSE 290,A00,102399,Chandraker; Manmohan Krishna,0,11,0,0
1668484336584,CSE 290,B00,102400,Vaccaro; Kristen Marie,0,7,25,25
1668484336584,CSE 290,C00,102414,Pannuto; Patrick William,0,1,25,25
1668484336584,CSE 290,D00,102427,Pevzner; Pavel Arkadjevich,0,0,0,0
1668484336584,CSE 290,E00,102429,Zhao; Jishen,0,4,0,0
1668484336584,CSE 290,F00,102436,Tullsen; Dean Michael,0,5,0,0
1668484336584,CSE 290,G00,102440,Christensen; Henrik I,0,6,20,20
1668484337011,CSE 291,A00,102443,Su; Hao,0,0,0,0
1668484337011,CSE 291,B00,102448,Polikarpova; Nadezhda,0,0,0,0
1668484337011,CSE 291,C00,102453,Vaccaro; Kristen Marie,0,0,0,0
1668484337011,CSE 291,D00,111343,Savage; Stefan,0,0,0,0
1668484337011,CSE 291,E00,116474,Claffy; Kimberly Claire,0,0,0,0
1668484337011,CSE 291,F00,116479,Pasquale; Joseph,0,0,0,0
1668484337448,CSE 293,001,119111,Bafna; Vineet,9999,0,9999,0
1668484337448,CSE 293,002,119118,Bellare; Mihir,9999,0,9999,0
1668484337448,CSE 293,003,119122,Berg-Kirkpatrick; Taylor D,9999,0,9999,0
1668484337448,CSE 293,004,119135,Christensen; Henrik I,9999,0,9999,0
1668484337448,CSE 293,005,119142,Cottrell; Garrison W,9999,0,9999,0
1668484337448,CSE 293,006,119146,Deutsch; Alin Bernard,9999,0,9999,0
1668484337448,CSE 293,007,119159,Esmaeilzadeh; Hadi,9999,0,9999,0
1668484337448,CSE 293,008,119166,Freund; Yoav,9999,0,9999,0
1668484337448,CSE 293,009,119170,Griswold; William G.,9999,0,9999,0
1668484337448,CSE 293,010,119183,Gymrek; Melissa Ann,9999,0,9999,0
1668484337448,CSE 293,011,119190,Heninger; Nadia A,9999,0,9999,0
1668484337448,CSE 293,012,119230,Impagliazzo; Russell,9999,0,9999,0
1668484337448,CSE 293,013,119232,Jhala; Ranjit,9999,0,9999,0
1668484337448,CSE 293,014,119233,Kahng; Andrew Byun,9999,0,9999,0
1668484337448,CSE 293,015,119298,Kane; Daniel Mertz,9999,0,9999,0
1668484337448,CSE 293,016,119299,Kriegman; David J,9999,0,9999,0
1668484337448,CSE 293,017,119300,Kumar; Arun Kumar,9999,0,9999,0
1668484337448,CSE 293,018,119301,Lerner; Sorin,9999,0,9999,0
1668484337448,CSE 293,019,119302,Lovett; Shachar,9999,0,9999,0
1668484337448,CSE 293,020,119303,McAuley; Julian John,9999,0,9999,0
1668484337448,CSE 293,021,119304,Micciancio; Daniele,9999,0,9999,0
1668484337448,CSE 293,022,119367,Orailoglu; Alex,9999,0,9999,0
1668484337448,CSE 293,023,119382,Paturi; Ramamohan,9999,0,9999,0
1668484337448,CSE 293,024,119404,Polikarpova; Nadezhda,9999,0,9999,0
1668484337448,CSE 293,025,119406,Politz; Joseph Gibbs,9999,0,9999,0
1668484337448,CSE 293,026,119411,Porter; George M,9999,0,9999,0
1668484337448,CSE 293,027,119414,Porter; Leonard Emerson,9999,0,9999,0
1668484337448,CSE 293,028,119416,Ramamoorthi; Ravi,9999,0,9999,0
1668484337448,CSE 293,029,119417,Sahoo; Debashis,9999,0,9999,0
1668484337448,CSE 293,030,119420,Saul; Lawrence,9999,0,9999,0
1668484337448,CSE 293,031,119421,Savage; Stefan,9999,0,9999,0
1668484337448,CSE 293,032,119425,Schulze; Jurgen P.,9999,0,9999,0
1668484337448,CSE 293,033,119426,Snoeren; Alex C.,9999,0,9999,0
1668484337448,CSE 293,034,119428,Shang; Jingbo,9999,0,9999,0
1668484337448,CSE 293,035,119430,Stefan; Deian,9999,0,9999,0
1668484337448,CSE 293,036,119431,Su; Hao,9999,0,9999,0
1668484337448,CSE 293,037,119433,Swanson; Steven James,9999,0,9999,0
1668484337448,CSE 293,038,119435,Tullsen; Dean Michael,9999,0,9999,0
1668484337448,CSE 293,039,119483,Voelker; Geoffrey M.,9999,0,9999,0
1668484337448,CSE 293,040,119537,Zhao; Jishen,9999,0,9999,0
1668484337448,CSE 293,041,119538,Zhou; Yuan-Yuan,9999,0,9999,0
1668484337448,CSE 293,042,119539,Gao; Sicun,9999,0,9999,0
1668484337448,CSE 293,043,119540,Weibel; Nadir,9999,0,9999,0
1668484337448,CSE 293,044,119541,Gupta; Rajesh K.,9999,0,9999,0
1668484337448,CSE 293,045,126410,Vaccaro; Kristen Marie,9999,0,9999,0
1668484337448,CSE 293,046,126411,Klemke; Richard,9999,0,9999,0
1668484337879,CSE 294,A00,102459,Voelker; Geoffrey M.,0,2,0,0
1668484337879,CSE 294,B00,111322,Orailoglu; Alex,0,2,0,0
1668484338307,DSE 201,A00,096914,Deutsch; Alin Bernard,30,0,30,0
1668484338736,DSE 210,A00,096915,Dasgupta; Sanjoy,30,0,30,0
1668484339160,DSE 260A,A00,096916,Altintas De Callaf; Ilkay,30,0,30,0
1668484339590,ECE 200,001,103586,Antipa; Nicholas A,9999,0,9999,0
1668484339590,ECE 200,002,103587,Atanasov; Nikolay A.,9999,0,9999,0
1668484339590,ECE 200,003,103588,Bharadia; Dinesh,9999,0,9999,0
1668484339590,ECE 200,004,103589,Cheng; Chung Kuan,9999,0,9999,0
1668484339590,ECE 200,005,103590,Cosman; Pamela C.,9999,0,9999,0
1668484339590,ECE 200,006,103591,Dayeh; Shadi Ahmad,9999,0,9999,0
1668484339590,ECE 200,007,103592,Fainman; Yeshaiahu,9999,0,9999,0
1668484339590,ECE 200,008,103593,Ford; Joseph Earl,9999,0,9999,0
1668484339590,ECE 200,009,103594,Franceschetti; Massimo,9999,0,9999,0
1668484339590,ECE 200,010,103595,Fullerton; Eric E,9999,0,9999,0
1668484339590,ECE 200,011,103596,Galton; Ian A,9999,0,9999,0
1668484339590,ECE 200,012,103597,Gilja; Vikash,9999,0,9999,0
1668484339590,ECE 200,013,103598,Hall; Drew A.,9999,0,9999,0
1668484339590,ECE 200,014,103599,Hsueh; Tzu-Chien,9999,0,9999,0
1668484339590,ECE 200,015,103600,Javidi; Tara,9999,0,9999,0
1668484339590,ECE 200,016,103601,Kahng; Andrew Byun,9999,0,9999,0
1668484339590,ECE 200,017,103602,Kim; Young-Han,9999,0,9999,0
1668484339590,ECE 200,018,103603,Koushanfar; Farinaz,9999,0,9999,0
1668484339590,ECE 200,019,103604,Kuzum; Duygu,9999,0,9999,0
1668484339590,ECE 200,020,103605,Le; Hanh-Phuc,9999,0,9999,0
1668484339590,ECE 200,021,103606,Lin; Bill,9999,0,9999,0
1668484339590,ECE 200,022,103607,Liu; Zhaowei,9998,0,9999,1
1668484339590,ECE 200,023,103608,Lo; Yu-Hwa,9999,0,9999,0
1668484339590,ECE 200,024,103609,Lomakin; Vitaliy,9999,0,9999,0
1668484339590,ECE 200,025,103610,Mercier; Patrick Philip,9999,0,9999,0
1668484339590,ECE 200,026,103611,Meyer; Florian,9999,0,9999,0
1668484339590,ECE 200,027,103612,Milstein; Laurence B.,9999,0,9999,0
1668484339590,ECE 200,028,103613,Mir Arabbaygi; Siavash,9999,0,9999,0
1668484339590,ECE 200,029,103614,Mookherjea; Shayan,9999,0,9999,0
1668484339590,ECE 200,030,103615,Morris; Karcher William,9999,0,9999,0
1668484339590,ECE 200,031,103616,Ng; Tse Nga,9999,0,9999,0
1668484339590,ECE 200,032,103617,Nguyen; Truong Quang,9999,0,9999,0
1668484339590,ECE 200,033,103618,Nomura; Kenji,9999,0,9999,0
1668484339590,ECE 200,034,103619,Orlitsky; Alon,9999,0,9999,0
1668484339590,ECE 200,035,103620,Pal; Piya,9999,0,9999,0
1668484339590,ECE 200,036,103621,Papen; George C.,9999,0,9999,0
1668484339590,ECE 200,037,103622,Radic; Stojan,9999,0,9999,0
1668484339590,ECE 200,038,103623,Rao; Bhaskar D.,9999,0,9999,0
1668484339590,ECE 200,039,103624,Rao; Ramesh R,9999,0,9999,0
1668484339590,ECE 200,040,103625,Rebeiz; Gabriel,9999,0,9999,0
1668484339590,ECE 200,041,103626,Sanford; John R,9999,0,9999,0
1668484339590,ECE 200,042,103627,Siegel; Paul H.,9999,0,9999,0
1668484339590,ECE 200,043,103628,Sievenpiper; Daniel F.,9999,0,9999,0
1668484339590,ECE 200,044,103629,Sworder; David D.,9999,0,9999,0
1668484339590,ECE 200,045,103630,Taur; Yuan,9999,0,9999,0
1668484339590,ECE 200,046,103631,Touri; Behrouz,9999,0,9999,0
1668484339590,ECE 200,047,103632,Trivedi; Mohan M.,9999,0,9999,0
1668484339590,ECE 200,048,103633,Vasconcelos; Nuno,9999,0,9999,0
1668484339590,ECE 200,049,103634,Wang; Xiaolong,9999,0,9999,0
1668484339590,ECE 200,050,103635,Xie; Pengtao,9999,0,9999,0
1668484339590,ECE 200,051,103636,Yip; Michael,9999,0,9999,0
1668484339590,ECE 200,052,103637,Zeger; Kenneth A.,999,0,999,0
1668484339590,ECE 200,053,103638,Zhang; Xinyu,9999,0,9999,0
1668484339590,ECE 200,054,103639,Turakhia; Yatish Girish,9999,0,9999,0
1668484339590,ECE 200,055,103640,Kang; Mingu,9999,0,9999,0
1668484339590,ECE 200,056,103641,Shi; Yuanyuan,9999,0,9999,0
1668484339590,ECE 200,057,103642,Wang; Edward Jay,9999,0,9999,0
1668484339590,ECE 200,058,103643,Zheng; Yang,9999,0,9999,0
1668484340013,ECE 202,A00,103644,Kuzum; Duygu,0,43,0,0
1668484340438,ECE 212BN,A00,103646,Ng; Tse Nga,0,9,0,0
1668484340866,ECE 221,A00,111493,Staff,0,0,0,0
1668484341289,ECE 222B,A00,103647,Lomakin; Vitaliy,0,18,0,0
1668484341712,ECE 230B,A00,103648,Taur; Yuan,0,2,0,0
1668484342140,ECE 238B,A00,103649,Garay; Javier,0,0,0,0
1668484342565,ECE 240B,A00,112900,Fainman; Yeshaiahu,0,7,0,0
1668484342989,ECE 247A,A00,103650,Jokerst; Jesse Vincent,0,6,0,0
1668484343420,ECE 247B,A00,103651,Wang; Joseph,0,12,0,0
1668484343848,ECE 250,A00,103652,Siegel; Paul H.,0,82,0,0
1668484344273,ECE 251A,A00,103654,Rao; Bhaskar D.,0,61,0,0
1668484344716,ECE 257B,A00,103655,Bharadia; Dinesh,0,32,0,0
1668484345157,ECE 258A,A00,103656,Milstein; Laurence B.,0,28,0,0
1668484345584,ECE 260B,A00,103658,Kang; Mingu,0,119,0,0
1668484346013,ECE 264A,A00,103659,Galton; Ian A,0,66,0,0
1668484346438,ECE 265A,A00,103661,Gudem; Prasad S.S.,0,65,0,0
1668484346861,ECE 265D,A00,103662,Gudem; Prasad S.S.,0,24,0,0
1668484347286,ECE 268,A00,103663,Koushanfar; Farinaz,0,42,0,0
1668484347714,ECE 269,A01,103665,Pal; Piya,0,211,0,0
1668484348140,ECE 271B,A00,103666,Vasconcelos; Manuela,0,74,0,0
1668484348572,ECE 276A,A00,103667,Atanasov; Nikolay A.,0,123,0,0
1668484348994,ECE 277,A00,103668,An; Cheolhong,0,145,0,0
1668484349418,ECE 279,A00,117947,Hall; Drew A.,0,22,0,0
1668484350266,ECE 283,A00,103670,Hsueh; Tzu-Chien,0,51,0,0
1668484350696,ECE 284,A00,103671,Turakhia; Yatish Girish,0,39,0,0
1668484351123,ECE 285,A00,103672,Zheng; Yang,0,39,0,0
1668484351123,ECE 285,B00,103673,Sworder; David D.,0,56,0,0
1668484351550,ECE 287,A00,103676,Javidi; Tara,0,8,0,0
1668484351983,MATH 200B,A00,098023,Salehi Golsefidy; Alireza,10,0,15,5
1668484352418,MATH 202B,A00,098024,Rhoades; Brendon Patrick,7,0,15,8
1668484352839,MATH 203B,A00,098025,Oprea; Dragos N.,9,0,15,6
1668484353272,MATH 204B,A00,098026,Sorensen; Claus M,13,0,15,2
1668484353700,MATH 208,A00,098027,Izadi; Elham,7,0,10,3
1668484354127,MATH 209,A00,098028,Pollack; Aaron,10,0,10,0
1668484354552,MATH 211A,A00,112919,Rogalski; Daniel,8,0,10,2
1668484354974,MATH 211B,A00,112920,Seward; Brandon M.,9,0,10,1
1668484355397,MATH 218,A00,098029,Li; Bo,10,0,10,0
1668484355823,MATH 220B,A00,098030,Novak; Jonathan I,11,0,15,4
1668484356260,MATH 221A,A00,098031,Ebenfelt; Peter F,12,0,15,3
1668484356686,MATH 231B,A00,098032,Zlatos; Andrej,11,0,15,4
1668484357131,MATH 240B,A00,098033,Ni; Lei,7,0,15,8
1668484357560,MATH 243,A00,098034,Jekel; David Andrew,10,0,10,0
1668484357991,MATH 245A,A00,098035,Nie; Jiawang,0,4,15,18
1668484358413,MATH 248,A00,098036,Bejenaru; Ioan,10,0,10,0
1668484358844,MATH 250B,A00,098037,Spolaor; Luca,14,0,15,1
1668484359273,MATH 258,A00,098038,Ni; Lei,9,0,10,1
1668484359702,MATH 264B,A00,098041,Rhoades; Brendon Patrick,8,0,15,7
1668484360125,MATH 268,A00,098042,Buss; Samuel R,10,0,10,0
1668484360550,MATH 269,A00,098043,Rhoades; Brendon Patrick,10,0,10,0
1668484360977,MATH 270B,A00,098044,Li; Bo,6,0,15,9
1668484361409,MATH 272B,A00,098045,Holst; Michael J,13,0,15,2
1668484361833,MATH 273A,A00,098046,Tian; Xiaochuan,10,0,15,5
1668484362257,MATH 275,A01,098048,Tian; Xiaochuan,6,0,10,4
1668484362684,MATH 278A,A00,098049,Holst; Michael J,7,0,10,3
1668484363110,MATH 278B,A00,098050,Cloninger; Alexander,10,0,10,0
1668484363552,MATH 278C,A00,098051,Nie; Jiawang,5,0,10,5
1668484363979,MATH 280B,A00,098052,Zheng; Tianyi,7,0,15,8
1668484364409,MATH 281B,A00,098053,Bradic; Jelena,0,2,15,15
1668484364833,MATH 282B,A00,098054,Arias-Castro; Ery,0,1,15,15
1668484365256,MATH 285,A00,098055,Fitzsimmons; Patrick J,0,2,15,17
1668484365683,MATH 287B,A00,098056,Arias-Castro; Ery,1,0,15,14
1668484366106,MATH 288,A00,098057,Agarwal; Pooja,9,0,10,1
1668484366106,MATH 288,B00,098058,Zhang; Danna,8,0,10,2
1668484366106,MATH 288,C00,098059,Williams; Ruth J,9,0,10,1
1668484366528,MATH 290B,A00,098060,Roberts; Justin Deritter,12,0,15,3
1668484366965,MATH 292,A00,098061,Belmont; Eva Kinoshita,10,0,10,0
1668484367392,MATH 295,A00,098062,Suk; Andrew Hoon,47,0,50,3
1668484367828,MATH 296,A00,098063,Novak; Jonathan I,20,0,20,0
1668484368253,MATH 297,001,098064,Gamst; Anthony Collins,9997,0,9999,2
1668484869808,COGS 205,A00,101395,Chiba; Andrea,19,0,20,1
1668484870237,COGS 210B,001,101404,Greene; Deanna Jacquelyn,9998,0,9999,1
1668484870237,COGS 210B,002,101417,Xia; Haijun,9999,0,9999,0
1668484870237,COGS 210B,003,101422,Nitz; Douglas A.,9999,0,9999,0
1668484870237,COGS 210B,004,101423,Hollan; James D.,9998,0,9999,1
1668484870237,COGS 210B,005,101424,Deak; Gedeon O.,9998,0,9999,1
1668484870237,COGS 210B,006,101425,Rossano; Federico,9999,0,9999,0
1668484870682,COGS 211B,A00,101427,Coulson; Seana M,9996,0,9999,3
1668484871107,COGS 220,A00,101428,Hollan; James D.,1,9,25,24
1668484871530,COGS 229,A00,101429,Dow; Steven P,17,0,25,8
1668484871952,COGS 230,A00,101430,Klemmer; Scott R,8,0,17,9
1668484872376,COGS 234,A00,101431,Xia; Haijun,2,0,25,23
1668484872800,COGS 260,A00,101432,Kiyonaga; Anastasia,21,0,25,4
1668484872800,COGS 260,B00,101433,Kirsh; David Joel,15,0,25,10
1668484873227,CSE 202,A00,102371,Impagliazzo; Russell,0,62,0,0
1668484873651,CSE 203B,A01,102373,Cheng; Chung Kuan,0,52,0,0
1668484874075,CSE 208,A00,102374,Micciancio; Daniele,0,5,0,0
1668484874502,CSE 209A,A00,112895,Impagliazzo; Russell,0,12,15,15
1668484874926,CSE 209B,A00,108005,Bellare; Mihir,0,6,0,0
1668484875353,CSE 210,A00,113163,Coblenz; Michael J,0,80,0,0
1668484875776,CSE 219,A00,106111,Dow; Steven P,0,6,20,20
1668484876200,CSE 221,A00,102376,Voelker; Geoffrey M.,0,69,0,0
1668484876634,CSE 224,A01,102378,Porter; George M,0,159,0,0
1668484877060,CSE 229A,A00,102379,Savage; Stefan,0,10,0,0
1668484877484,CSE 229C,A00,102380,Munyaka; Imani N. S.,0,10,0,0
1668484877930,CSE 232B,A00,102382,Deutsch; Alin Bernard,0,30,0,0
1668484878356,CSE 234,A01,112904,Kumar; Arun Kumar,0,0,0,0
1668484878791,CSE 237A,A00,102383,Rosing; Tajana Simunic,0,50,0,0
1668484879214,CSE 239A,A00,102384,Deutsch; Alin Bernard,0,13,0,0
1668484879640,CSE 239B,A00,102385,Polikarpova; Nadezhda,0,10,0,0
1668484880064,CSE 240A,A00,102386,Pannuto; Patrick William,0,44,0,0
1668484880503,CSE 240B,A00,102387,Zhao; Jishen,0,42,0,0
1668484880926,CSE 241A,A00,106406,Kang; Mingu,0,7,0,0
1668484881349,CSE 249B,A00,102388,Kahng; Andrew Byun,0,5,8,8
1668484881776,CSE 251B,A01,102392,Cottrell; Garrison W,0,46,0,0
1668484881776,CSE 251B,A02,102393,Cottrell; Garrison W,0,33,0,0
1668484882205,CSE 252B,A00,102394,Ochoa; Benjamin Lawrence,0,57,0,0
1668484882629,CSE 257,A01,102396,Gao; Sicun,0,132,0,0
1668484883056,CSE 272,A00,102397,Li; Tzumao,0,17,0,0
1668484883482,CSE 274,A00,111323,Chern; Albert Ren-Haur,0,15,0,0
1668484883907,CSE 282,A00,102398,Pevzner; Pavel Arkadjevich,0,0,0,0
1668484884333,CSE 284,A00,114175,Gymrek; Melissa Ann,0,21,0,0
1668484884757,CSE 290,A00,102399,Chandraker; Manmohan Krishna,0,11,0,0
1668484884757,CSE 290,B00,102400,Vaccaro; Kristen Marie,0,7,25,25
1668484884757,CSE 290,C00,102414,Pannuto; Patrick William,0,1,25,25
1668484884757,CSE 290,D00,102427,Pevzner; Pavel Arkadjevich,0,0,0,0
1668484884757,CSE 290,E00,102429,Zhao; Jishen,0,4,0,0
1668484884757,CSE 290,F00,102436,Tullsen; Dean Michael,0,5,0,0
1668484884757,CSE 290,G00,102440,Christensen; Henrik I,0,6,20,20
1668484885186,CSE 291,A00,102443,Su; Hao,0,0,0,0
1668484885186,CSE 291,B00,102448,Polikarpova; Nadezhda,0,0,0,0
1668484885186,CSE 291,C00,102453,Vaccaro; Kristen Marie,0,0,0,0
1668484885186,CSE 291,D00,111343,Savage; Stefan,0,0,0,0
1668484885186,CSE 291,E00,116474,Claffy; Kimberly Claire,0,0,0,0
1668484885186,CSE 291,F00,116479,Pasquale; Joseph,0,0,0,0
1668484885627,CSE 293,001,119111,Bafna; Vineet,9999,0,9999,0
1668484885627,CSE 293,002,119118,Bellare; Mihir,9999,0,9999,0
1668484885627,CSE 293,003,119122,Berg-Kirkpatrick; Taylor D,9999,0,9999,0
1668484885627,CSE 293,004,119135,Christensen; Henrik I,9999,0,9999,0
1668484885627,CSE 293,005,119142,Cottrell; Garrison W,9999,0,9999,0
1668484885627,CSE 293,006,119146,Deutsch; Alin Bernard,9999,0,9999,0
1668484885627,CSE 293,007,119159,Esmaeilzadeh; Hadi,9999,0,9999,0
1668484885627,CSE 293,008,119166,Freund; Yoav,9999,0,9999,0
1668484885627,CSE 293,009,119170,Griswold; William G.,9999,0,9999,0
1668484885627,CSE 293,010,119183,Gymrek; Melissa Ann,9999,0,9999,0
1668484885627,CSE 293,011,119190,Heninger; Nadia A,9999,0,9999,0
1668484885627,CSE 293,012,119230,Impagliazzo; Russell,9999,0,9999,0
1668484885627,CSE 293,013,119232,Jhala; Ranjit,9999,0,9999,0
1668484885627,CSE 293,014,119233,Kahng; Andrew Byun,9999,0,9999,0
1668484885627,CSE 293,015,119298,Kane; Daniel Mertz,9999,0,9999,0
1668484885627,CSE 293,016,119299,Kriegman; David J,9999,0,9999,0
1668484885627,CSE 293,017,119300,Kumar; Arun Kumar,9999,0,9999,0
1668484885627,CSE 293,018,119301,Lerner; Sorin,9999,0,9999,0
1668484885627,CSE 293,019,119302,Lovett; Shachar,9999,0,9999,0
1668484885627,CSE 293,020,119303,McAuley; Julian John,9999,0,9999,0
1668484885627,CSE 293,021,119304,Micciancio; Daniele,9999,0,9999,0
1668484885627,CSE 293,022,119367,Orailoglu; Alex,9999,0,9999,0
1668484885627,CSE 293,023,119382,Paturi; Ramamohan,9999,0,9999,0
1668484885627,CSE 293,024,119404,Polikarpova; Nadezhda,9999,0,9999,0
1668484885627,CSE 293,025,119406,Politz; Joseph Gibbs,9999,0,9999,0
1668484885627,CSE 293,026,119411,Porter; George M,9999,0,9999,0
1668484885627,CSE 293,027,119414,Porter; Leonard Emerson,9999,0,9999,0
1668484885627,CSE 293,028,119416,Ramamoorthi; Ravi,9999,0,9999,0
1668484885627,CSE 293,029,119417,Sahoo; Debashis,9999,0,9999,0
1668484885627,CSE 293,030,119420,Saul; Lawrence,9999,0,9999,0
1668484885627,CSE 293,031,119421,Savage; Stefan,9999,0,9999,0
1668484885627,CSE 293,032,119425,Schulze; Jurgen P.,9999,0,9999,0
1668484885627,CSE 293,033,119426,Snoeren; Alex C.,9999,0,9999,0
1668484885627,CSE 293,034,119428,Shang; Jingbo,9999,0,9999,0
1668484885627,CSE 293,035,119430,Stefan; Deian,9999,0,9999,0
1668484885627,CSE 293,036,119431,Su; Hao,9999,0,9999,0
1668484885627,CSE 293,037,119433,Swanson; Steven James,9999,0,9999,0
1668484885627,CSE 293,038,119435,Tullsen; Dean Michael,9999,0,9999,0
1668484885627,CSE 293,039,119483,Voelker; Geoffrey M.,9999,0,9999,0
1668484885627,CSE 293,040,119537,Zhao; Jishen,9999,0,9999,0
1668484885627,CSE 293,041,119538,Zhou; Yuan-Yuan,9999,0,9999,0
1668484885627,CSE 293,042,119539,Gao; Sicun,9999,0,9999,0
1668484885627,CSE 293,043,119540,Weibel; Nadir,9999,0,9999,0
1668484885627,CSE 293,044,119541,Gupta; Rajesh K.,9999,0,9999,0
1668484885627,CSE 293,045,126410,Vaccaro; Kristen Marie,9999,0,9999,0
1668484885627,CSE 293,046,126411,Klemke; Richard,9999,0,9999,0
1668484886051,CSE 294,A00,102459,Voelker; Geoffrey M.,0,2,0,0
1668484886051,CSE 294,B00,111322,Orailoglu; Alex,0,2,0,0
1668484886472,DSE 201,A00,096914,Deutsch; Alin Bernard,30,0,30,0
1668484886897,DSE 210,A00,096915,Dasgupta; Sanjoy,30,0,30,0
1668484887319,DSE 260A,A00,096916,Altintas De Callaf; Ilkay,30,0,30,0
1668484887756,ECE 200,001,103586,Antipa; Nicholas A,9999,0,9999,0
1668484887756,ECE 200,002,103587,Atanasov; Nikolay A.,9999,0,9999,0
1668484887756,ECE 200,003,103588,Bharadia; Dinesh,9999,0,9999,0
1668484887756,ECE 200,004,103589,Cheng; Chung Kuan,9999,0,9999,0
1668484887756,ECE 200,005,103590,Cosman; Pamela C.,9999,0,9999,0
1668484887756,ECE 200,006,103591,Dayeh; Shadi Ahmad,9999,0,9999,0
1668484887756,ECE 200,007,103592,Fainman; Yeshaiahu,9999,0,9999,0
1668484887756,ECE 200,008,103593,Ford; Joseph Earl,9999,0,9999,0
1668484887756,ECE 200,009,103594,Franceschetti; Massimo,9999,0,9999,0
1668484887756,ECE 200,010,103595,Fullerton; Eric E,9999,0,9999,0
1668484887756,ECE 200,011,103596,Galton; Ian A,9999,0,9999,0
1668484887756,ECE 200,012,103597,Gilja; Vikash,9999,0,9999,0
1668484887756,ECE 200,013,103598,Hall; Drew A.,9999,0,9999,0
1668484887756,ECE 200,014,103599,Hsueh; Tzu-Chien,9999,0,9999,0
1668484887756,ECE 200,015,103600,Javidi; Tara,9999,0,9999,0
1668484887756,ECE 200,016,103601,Kahng; Andrew Byun,9999,0,9999,0
1668484887756,ECE 200,017,103602,Kim; Young-Han,9999,0,9999,0
1668484887756,ECE 200,018,103603,Koushanfar; Farinaz,9999,0,9999,0
1668484887756,ECE 200,019,103604,Kuzum; Duygu,9999,0,9999,0
1668484887756,ECE 200,020,103605,Le; Hanh-Phuc,9999,0,9999,0
1668484887756,ECE 200,021,103606,Lin; Bill,9999,0,9999,0
1668484887756,ECE 200,022,103607,Liu; Zhaowei,9998,0,9999,1
1668484887756,ECE 200,023,103608,Lo; Yu-Hwa,9999,0,9999,0
1668484887756,ECE 200,024,103609,Lomakin; Vitaliy,9999,0,9999,0
1668484887756,ECE 200,025,103610,Mercier; Patrick Philip,9999,0,9999,0
1668484887756,ECE 200,026,103611,Meyer; Florian,9999,0,9999,0
1668484887756,ECE 200,027,103612,Milstein; Laurence B.,9999,0,9999,0
1668484887756,ECE 200,028,103613,Mir Arabbaygi; Siavash,9999,0,9999,0
1668484887756,ECE 200,029,103614,Mookherjea; Shayan,9999,0,9999,0
1668484887756,ECE 200,030,103615,Morris; Karcher William,9999,0,9999,0
1668484887756,ECE 200,031,103616,Ng; Tse Nga,9999,0,9999,0
1668484887756,ECE 200,032,103617,Nguyen; Truong Quang,9999,0,9999,0
1668484887756,ECE 200,033,103618,Nomura; Kenji,9999,0,9999,0
1668484887756,ECE 200,034,103619,Orlitsky; Alon,9999,0,9999,0
1668484887756,ECE 200,035,103620,Pal; Piya,9999,0,9999,0
1668484887756,ECE 200,036,103621,Papen; George C.,9999,0,9999,0
1668484887756,ECE 200,037,103622,Radic; Stojan,9999,0,9999,0
1668484887756,ECE 200,038,103623,Rao; Bhaskar D.,9999,0,9999,0
1668484887756,ECE 200,039,103624,Rao; Ramesh R,9999,0,9999,0
1668484887756,ECE 200,040,103625,Rebeiz; Gabriel,9999,0,9999,0
1668484887756,ECE 200,041,103626,Sanford; John R,9999,0,9999,0
1668484887756,ECE 200,042,103627,Siegel; Paul H.,9999,0,9999,0
1668484887756,ECE 200,043,103628,Sievenpiper; Daniel F.,9999,0,9999,0
1668484887756,ECE 200,044,103629,Sworder; David D.,9999,0,9999,0
1668484887756,ECE 200,045,103630,Taur; Yuan,9999,0,9999,0
1668484887756,ECE 200,046,103631,Touri; Behrouz,9999,0,9999,0
1668484887756,ECE 200,047,103632,Trivedi; Mohan M.,9999,0,9999,0
1668484887756,ECE 200,048,103633,Vasconcelos; Nuno,9999,0,9999,0
1668484887756,ECE 200,049,103634,Wang; Xiaolong,9999,0,9999,0
1668484887756,ECE 200,050,103635,Xie; Pengtao,9999,0,9999,0
1668484887756,ECE 200,051,103636,Yip; Michael,9999,0,9999,0
1668484887756,ECE 200,052,103637,Zeger; Kenneth A.,999,0,999,0
1668484887756,ECE 200,053,103638,Zhang; Xinyu,9999,0,9999,0
1668484887756,ECE 200,054,103639,Turakhia; Yatish Girish,9999,0,9999,0
1668484887756,ECE 200,055,103640,Kang; Mingu,9999,0,9999,0
1668484887756,ECE 200,056,103641,Shi; Yuanyuan,9999,0,9999,0
1668484887756,ECE 200,057,103642,Wang; Edward Jay,9999,0,9999,0
1668484887756,ECE 200,058,103643,Zheng; Yang,9999,0,9999,0
1668484888179,ECE 202,A00,103644,Kuzum; Duygu,0,43,0,0
1668484888605,ECE 212BN,A00,103646,Ng; Tse Nga,0,9,0,0
1668484889033,ECE 221,A00,111493,Staff,0,0,0,0
1668484889458,ECE 222B,A00,103647,Lomakin; Vitaliy,0,18,0,0
1668484889880,ECE 230B,A00,103648,Taur; Yuan,0,2,0,0
1668484890315,ECE 238B,A00,103649,Garay; Javier,0,0,0,0
1668484890746,ECE 240B,A00,112900,Fainman; Yeshaiahu,0,7,0,0
1668484891171,ECE 247A,A00,103650,Jokerst; Jesse Vincent,0,6,0,0
1668484891597,ECE 247B,A00,103651,Wang; Joseph,0,12,0,0
1668484892021,ECE 250,A00,103652,Siegel; Paul H.,0,82,0,0
1668484892448,ECE 251A,A00,103654,Rao; Bhaskar D.,0,61,0,0
1668484892871,ECE 257B,A00,103655,Bharadia; Dinesh,0,32,0,0
1668484893295,ECE 258A,A00,103656,Milstein; Laurence B.,0,28,0,0
1668484893722,ECE 260B,A00,103658,Kang; Mingu,0,119,0,0
1668484894146,ECE 264A,A00,103659,Galton; Ian A,0,66,0,0
1668484894681,ECE 265A,A00,103661,Gudem; Prasad S.S.,0,65,0,0
1668484895104,ECE 265D,A00,103662,Gudem; Prasad S.S.,0,24,0,0
1668484895535,ECE 268,A00,103663,Koushanfar; Farinaz,0,42,0,0
1668484895959,ECE 269,A01,103665,Pal; Piya,0,211,0,0
1668484896385,ECE 271B,A00,103666,Vasconcelos; Manuela,0,74,0,0
1668484896808,ECE 276A,A00,103667,Atanasov; Nikolay A.,0,123,0,0
1668484897235,ECE 277,A00,103668,An; Cheolhong,0,145,0,0
1668484897659,ECE 279,A00,117947,Hall; Drew A.,0,22,0,0
1668484898514,ECE 283,A00,103670,Hsueh; Tzu-Chien,0,51,0,0
1668484898940,ECE 284,A00,103671,Turakhia; Yatish Girish,0,39,0,0
1668484899364,ECE 285,A00,103672,Zheng; Yang,0,39,0,0
1668484899364,ECE 285,B00,103673,Sworder; David D.,0,56,0,0
1668484899788,ECE 287,A00,103676,Javidi; Tara,0,8,0,0
1668484900213,MATH 200B,A00,098023,Salehi Golsefidy; Alireza,10,0,15,5
1668484900641,MATH 202B,A00,098024,Rhoades; Brendon Patrick,7,0,15,8
1668484901068,MATH 203B,A00,098025,Oprea; Dragos N.,9,0,15,6
1668484901493,MATH 204B,A00,098026,Sorensen; Claus M,13,0,15,2
1668484901914,MATH 208,A00,098027,Izadi; Elham,7,0,10,3
1668484902338,MATH 209,A00,098028,Pollack; Aaron,10,0,10,0
1668484902763,MATH 211A,A00,112919,Rogalski; Daniel,8,0,10,2
1668484903190,MATH 211B,A00,112920,Seward; Brandon M.,9,0,10,1
1668484903612,MATH 218,A00,098029,Li; Bo,10,0,10,0
1668484904038,MATH 220B,A00,098030,Novak; Jonathan I,11,0,15,4
1668484904465,MATH 221A,A00,098031,Ebenfelt; Peter F,12,0,15,3
1668484904891,MATH 231B,A00,098032,Zlatos; Andrej,11,0,15,4
1668484905314,MATH 240B,A00,098033,Ni; Lei,7,0,15,8
1668484905739,MATH 243,A00,098034,Jekel; David Andrew,10,0,10,0
1668484906163,MATH 245A,A00,098035,Nie; Jiawang,0,4,15,18
1668484906587,MATH 248,A00,098036,Bejenaru; Ioan,10,0,10,0
1668484907014,MATH 250B,A00,098037,Spolaor; Luca,14,0,15,1
1668484907437,MATH 258,A00,098038,Ni; Lei,9,0,10,1
1668484907868,MATH 264B,A00,098041,Rhoades; Brendon Patrick,8,0,15,7
1668484908293,MATH 268,A00,098042,Buss; Samuel R,10,0,10,0
1668484908719,MATH 269,A00,098043,Rhoades; Brendon Patrick,10,0,10,0
1668484909145,MATH 270B,A00,098044,Li; Bo,6,0,15,9
1668484909568,MATH 272B,A00,098045,Holst; Michael J,13,0,15,2
1668484909993,MATH 273A,A00,098046,Tian; Xiaochuan,10,0,15,5
1668484910415,MATH 275,A01,098048,Tian; Xiaochuan,6,0,10,4
1668484910844,MATH 278A,A00,098049,Holst; Michael J,7,0,10,3
1668484911267,MATH 278B,A00,098050,Cloninger; Alexander,10,0,10,0
1668484911691,MATH 278C,A00,098051,Nie; Jiawang,5,0,10,5
1668484912114,MATH 280B,A00,098052,Zheng; Tianyi,7,0,15,8
1668484912549,MATH 281B,A00,098053,Bradic; Jelena,0,2,15,15
1668484912973,MATH 282B,A00,098054,Arias-Castro; Ery,0,1,15,15
1668484913401,MATH 285,A00,098055,Fitzsimmons; Patrick J,0,2,15,17
1668484913826,MATH 287B,A00,098056,Arias-Castro; Ery,1,0,15,14
1668484914253,MATH 288,A00,098057,Agarwal; Pooja,9,0,10,1
1668484914253,MATH 288,B00,098058,Zhang; Danna,8,0,10,2
1668484914253,MATH 288,C00,098059,Williams; Ruth J,9,0,10,1
1668484914678,MATH 290B,A00,098060,Roberts; Justin Deritter,12,0,15,3
1668484915102,MATH 292,A00,098061,Belmont; Eva Kinoshita,10,0,10,0
1668484915533,MATH 295,A00,098062,Suk; Andrew Hoon,47,0,50,3
1668484915961,MATH 296,A00,098063,Novak; Jonathan I,20,0,20,0
1668484916388,MATH 297,001,098064,Gamst; Anthony Collins,9997,0,9999,2
1668485417611,COGS 205,A00,101395,Chiba; Andrea,19,0,20,1
1668485418040,COGS 210B,001,101404,Greene; Deanna Jacquelyn,9998,0,9999,1
1668485418040,COGS 210B,002,101417,Xia; Haijun,9999,0,9999,0
1668485418040,COGS 210B,003,101422,Nitz; Douglas A.,9999,0,9999,0
1668485418040,COGS 210B,004,101423,Hollan; James D.,9998,0,9999,1
1668485418040,COGS 210B,005,101424,Deak; Gedeon O.,9998,0,9999,1
1668485418040,COGS 210B,006,101425,Rossano; Federico,9999,0,9999,0
1668485418463,COGS 211B,A00,101427,Coulson; Seana M,9996,0,9999,3
1668485418886,COGS 220,A00,101428,Hollan; James D.,1,10,25,24
1668485419317,COGS 229,A00,101429,Dow; Steven P,17,0,25,8
1668485419739,COGS 230,A00,101430,Klemmer; Scott R,8,0,17,9
1668485420164,COGS 234,A00,101431,Xia; Haijun,2,0,25,23
1668485420590,COGS 260,A00,101432,Kiyonaga; Anastasia,21,0,25,4
1668485420590,COGS 260,B00,101433,Kirsh; David Joel,15,0,25,10
1668485421022,CSE 202,A00,102371,Impagliazzo; Russell,0,62,0,0
1668485421446,CSE 203B,A01,102373,Cheng; Chung Kuan,0,52,0,0
1668485421876,CSE 208,A00,102374,Micciancio; Daniele,0,5,0,0
1668485422301,CSE 209A,A00,112895,Impagliazzo; Russell,0,12,15,15
1668485422727,CSE 209B,A00,108005,Bellare; Mihir,0,6,0,0
1668485423162,CSE 210,A00,113163,Coblenz; Michael J,0,80,0,0
1668485423586,CSE 219,A00,106111,Dow; Steven P,0,6,20,20
1668485424010,CSE 221,A00,102376,Voelker; Geoffrey M.,0,69,0,0
1668485424433,CSE 224,A01,102378,Porter; George M,0,160,0,0
1668485424858,CSE 229A,A00,102379,Savage; Stefan,0,10,0,0
1668485425283,CSE 229C,A00,102380,Munyaka; Imani N. S.,0,10,0,0
1668485425710,CSE 232B,A00,102382,Deutsch; Alin Bernard,0,31,0,0
1668485426143,CSE 234,A01,112904,Kumar; Arun Kumar,0,0,0,0
1668485426568,CSE 237A,A00,102383,Rosing; Tajana Simunic,0,50,0,0
1668485426992,CSE 239A,A00,102384,Deutsch; Alin Bernard,0,13,0,0
1668485427416,CSE 239B,A00,102385,Polikarpova; Nadezhda,0,10,0,0
1668485427838,CSE 240A,A00,102386,Pannuto; Patrick William,0,44,0,0
1668485428272,CSE 240B,A00,102387,Zhao; Jishen,0,42,0,0
1668485428697,CSE 241A,A00,106406,Kang; Mingu,0,7,0,0
1668485429120,CSE 249B,A00,102388,Kahng; Andrew Byun,0,5,8,8
1668485429552,CSE 251B,A01,102392,Cottrell; Garrison W,0,46,0,0
1668485429552,CSE 251B,A02,102393,Cottrell; Garrison W,0,33,0,0
1668485429977,CSE 252B,A00,102394,Ochoa; Benjamin Lawrence,0,57,0,0
1668485430411,CSE 257,A01,102396,Gao; Sicun,0,132,0,0
1668485430841,CSE 272,A00,102397,Li; Tzumao,0,17,0,0
1668485431265,CSE 274,A00,111323,Chern; Albert Ren-Haur,0,15,0,0
1668485431697,CSE 282,A00,102398,Pevzner; Pavel Arkadjevich,0,0,0,0
1668485432123,CSE 284,A00,114175,Gymrek; Melissa Ann,0,21,0,0
1668485432548,CSE 290,A00,102399,Chandraker; Manmohan Krishna,0,11,0,0
1668485432548,CSE 290,B00,102400,Vaccaro; Kristen Marie,0,7,25,25
1668485432548,CSE 290,C00,102414,Pannuto; Patrick William,0,1,25,25
1668485432548,CSE 290,D00,102427,Pevzner; Pavel Arkadjevich,0,0,0,0
1668485432548,CSE 290,E00,102429,Zhao; Jishen,0,4,0,0
1668485432548,CSE 290,F00,102436,Tullsen; Dean Michael,0,5,0,0
1668485432548,CSE 290,G00,102440,Christensen; Henrik I,0,6,20,20
1668485432976,CSE 291,A00,102443,Su; Hao,0,0,0,0
1668485432976,CSE 291,B00,102448,Polikarpova; Nadezhda,0,0,0,0
1668485432976,CSE 291,C00,102453,Vaccaro; Kristen Marie,0,0,0,0
1668485432976,CSE 291,D00,111343,Savage; Stefan,0,0,0,0
1668485432976,CSE 291,E00,116474,Claffy; Kimberly Claire,0,0,0,0
1668485432976,CSE 291,F00,116479,Pasquale; Joseph,0,0,0,0
1668485433416,CSE 293,001,119111,Bafna; Vineet,9999,0,9999,0
1668485433416,CSE 293,002,119118,Bellare; Mihir,9999,0,9999,0
1668485433416,CSE 293,003,119122,Berg-Kirkpatrick; Taylor D,9999,0,9999,0
1668485433416,CSE 293,004,119135,Christensen; Henrik I,9999,0,9999,0
1668485433416,CSE 293,005,119142,Cottrell; Garrison W,9999,0,9999,0
1668485433416,CSE 293,006,119146,Deutsch; Alin Bernard,9999,0,9999,0
1668485433416,CSE 293,007,119159,Esmaeilzadeh; Hadi,9999,0,9999,0
1668485433416,CSE 293,008,119166,Freund; Yoav,9999,0,9999,0
1668485433416,CSE 293,009,119170,Griswold; William G.,9999,0,9999,0
1668485433416,CSE 293,010,119183,Gymrek; Melissa Ann,9999,0,9999,0
1668485433416,CSE 293,011,119190,Heninger; Nadia A,9999,0,9999,0
1668485433416,CSE 293,012,119230,Impagliazzo; Russell,9999,0,9999,0
1668485433416,CSE 293,013,119232,Jhala; Ranjit,9999,0,9999,0
1668485433416,CSE 293,014,119233,Kahng; Andrew Byun,9999,0,9999,0
1668485433416,CSE 293,015,119298,Kane; Daniel Mertz,9999,0,9999,0
1668485433416,CSE 293,016,119299,Kriegman; David J,9999,0,9999,0
1668485433416,CSE 293,017,119300,Kumar; Arun Kumar,9999,0,9999,0
1668485433416,CSE 293,018,119301,Lerner; Sorin,9999,0,9999,0
1668485433416,CSE 293,019,119302,Lovett; Shachar,9999,0,9999,0
1668485433416,CSE 293,020,119303,McAuley; Julian John,9999,0,9999,0
1668485433416,CSE 293,021,119304,Micciancio; Daniele,9999,0,9999,0
1668485433416,CSE 293,022,119367,Orailoglu; Alex,9999,0,9999,0
1668485433416,CSE 293,023,119382,Paturi; Ramamohan,9999,0,9999,0
1668485433416,CSE 293,024,119404,Polikarpova; Nadezhda,9999,0,9999,0
1668485433416,CSE 293,025,119406,Politz; Joseph Gibbs,9999,0,9999,0
1668485433416,CSE 293,026,119411,Porter; George M,9999,0,9999,0
1668485433416,CSE 293,027,119414,Porter; Leonard Emerson,9999,0,9999,0
1668485433416,CSE 293,028,119416,Ramamoorthi; Ravi,9999,0,9999,0
1668485433416,CSE 293,029,119417,Sahoo; Debashis,9999,0,9999,0
1668485433416,CSE 293,030,119420,Saul; Lawrence,9999,0,9999,0
1668485433416,CSE 293,031,119421,Savage; Stefan,9999,0,9999,0
1668485433416,CSE 293,032,119425,Schulze; Jurgen P.,9999,0,9999,0
1668485433416,CSE 293,033,119426,Snoeren; Alex C.,9999,0,9999,0
1668485433416,CSE 293,034,119428,Shang; Jingbo,9999,0,9999,0
1668485433416,CSE 293,035,119430,Stefan; Deian,9999,0,9999,0
1668485433416,CSE 293,036,119431,Su; Hao,9999,0,9999,0
1668485433416,CSE 293,037,119433,Swanson; Steven James,9999,0,9999,0
1668485433416,CSE 293,038,119435,Tullsen; Dean Michael,9999,0,9999,0
1668485433416,CSE 293,039,119483,Voelker; Geoffrey M.,9999,0,9999,0
1668485433416,CSE 293,040,119537,Zhao; Jishen,9999,0,9999,0
1668485433416,CSE 293,041,119538,Zhou; Yuan-Yuan,9999,0,9999,0
1668485433416,CSE 293,042,119539,Gao; Sicun,9999,0,9999,0
1668485433416,CSE 293,043,119540,Weibel; Nadir,9999,0,9999,0
1668485433416,CSE 293,044,119541,Gupta; Rajesh K.,9999,0,9999,0
1668485433416,CSE 293,045,126410,Vaccaro; Kristen Marie,9999,0,9999,0
1668485433416,CSE 293,046,126411,Klemke; Richard,9999,0,9999,0
1668485433839,CSE 294,A00,102459,Voelker; Geoffrey M.,0,2,0,0
1668485433839,CSE 294,B00,111322,Orailoglu; Alex,0,2,0,0
1668485434262,DSE 201,A00,096914,Deutsch; Alin Bernard,30,0,30,0
1668485434686,DSE 210,A00,096915,Dasgupta; Sanjoy,30,0,30,0
1668485435113,DSE 260A,A00,096916,Altintas De Callaf; Ilkay,30,0,30,0
1668485435547,ECE 200,001,103586,Antipa; Nicholas A,9999,0,9999,0
1668485435547,ECE 200,002,103587,Atanasov; Nikolay A.,9999,0,9999,0
1668485435547,ECE 200,003,103588,Bharadia; Dinesh,9999,0,9999,0
1668485435547,ECE 200,004,103589,Cheng; Chung Kuan,9999,0,9999,0
1668485435547,ECE 200,005,103590,Cosman; Pamela C.,9999,0,9999,0
1668485435547,ECE 200,006,103591,Dayeh; Shadi Ahmad,9999,0,9999,0
1668485435547,ECE 200,007,103592,Fainman; Yeshaiahu,9999,0,9999,0
1668485435547,ECE 200,008,103593,Ford; Joseph Earl,9999,0,9999,0
1668485435547,ECE 200,009,103594,Franceschetti; Massimo,9999,0,9999,0
1668485435547,ECE 200,010,103595,Fullerton; Eric E,9999,0,9999,0
1668485435547,ECE 200,011,103596,Galton; Ian A,9999,0,9999,0
1668485435547,ECE 200,012,103597,Gilja; Vikash,9999,0,9999,0
1668485435547,ECE 200,013,103598,Hall; Drew A.,9999,0,9999,0
1668485435547,ECE 200,014,103599,Hsueh; Tzu-Chien,9999,0,9999,0
1668485435547,ECE 200,015,103600,Javidi; Tara,9999,0,9999,0
1668485435547,ECE 200,016,103601,Kahng; Andrew Byun,9999,0,9999,0
1668485435547,ECE 200,017,103602,Kim; Young-Han,9999,0,9999,0
1668485435547,ECE 200,018,103603,Koushanfar; Farinaz,9999,0,9999,0
1668485435547,ECE 200,019,103604,Kuzum; Duygu,9999,0,9999,0
1668485435547,ECE 200,020,103605,Le; Hanh-Phuc,9999,0,9999,0
1668485435547,ECE 200,021,103606,Lin; Bill,9999,0,9999,0
1668485435547,ECE 200,022,103607,Liu; Zhaowei,9998,0,9999,1
1668485435547,ECE 200,023,103608,Lo; Yu-Hwa,9999,0,9999,0
1668485435547,ECE 200,024,103609,Lomakin; Vitaliy,9999,0,9999,0
1668485435547,ECE 200,025,103610,Mercier; Patrick Philip,9999,0,9999,0
1668485435547,ECE 200,026,103611,Meyer; Florian,9999,0,9999,0
1668485435547,ECE 200,027,103612,Milstein; Laurence B.,9999,0,9999,0
1668485435547,ECE 200,028,103613,Mir Arabbaygi; Siavash,9999,0,9999,0
1668485435547,ECE 200,029,103614,Mookherjea; Shayan,9999,0,9999,0
1668485435547,ECE 200,030,103615,Morris; Karcher William,9999,0,9999,0
1668485435547,ECE 200,031,103616,Ng; Tse Nga,9999,0,9999,0
1668485435547,ECE 200,032,103617,Nguyen; Truong Quang,9999,0,9999,0
1668485435547,ECE 200,033,103618,Nomura; Kenji,9999,0,9999,0
1668485435547,ECE 200,034,103619,Orlitsky; Alon,9999,0,9999,0
1668485435547,ECE 200,035,103620,Pal; Piya,9999,0,9999,0
1668485435547,ECE 200,036,103621,Papen; George C.,9999,0,9999,0
1668485435547,ECE 200,037,103622,Radic; Stojan,9999,0,9999,0
1668485435547,ECE 200,038,103623,Rao; Bhaskar D.,9999,0,9999,0
1668485435547,ECE 200,039,103624,Rao; Ramesh R,9999,0,9999,0
1668485435547,ECE 200,040,103625,Rebeiz; Gabriel,9999,0,9999,0
1668485435547,ECE 200,041,103626,Sanford; John R,9999,0,9999,0
1668485435547,ECE 200,042,103627,Siegel; Paul H.,9999,0,9999,0
1668485435547,ECE 200,043,103628,Sievenpiper; Daniel F.,9999,0,9999,0
1668485435547,ECE 200,044,103629,Sworder; David D.,9999,0,9999,0
1668485435547,ECE 200,045,103630,Taur; Yuan,9999,0,9999,0
1668485435547,ECE 200,046,103631,Touri; Behrouz,9999,0,9999,0
1668485435547,ECE 200,047,103632,Trivedi; Mohan M.,9999,0,9999,0
1668485435547,ECE 200,048,103633,Vasconcelos; Nuno,9999,0,9999,0
1668485435547,ECE 200,049,103634,Wang; Xiaolong,9999,0,9999,0
1668485435547,ECE 200,050,103635,Xie; Pengtao,9999,0,9999,0
1668485435547,ECE 200,051,103636,Yip; Michael,9999,0,9999,0
1668485435547,ECE 200,052,103637,Zeger; Kenneth A.,999,0,999,0
1668485435547,ECE 200,053,103638,Zhang; Xinyu,9999,0,9999,0
1668485435547,ECE 200,054,103639,Turakhia; Yatish Girish,9999,0,9999,0
1668485435547,ECE 200,055,103640,Kang; Mingu,9999,0,9999,0
1668485435547,ECE 200,056,103641,Shi; Yuanyuan,9999,0,9999,0
1668485435547,ECE 200,057,103642,Wang; Edward Jay,9999,0,9999,0
1668485435547,ECE 200,058,103643,Zheng; Yang,9999,0,9999,0
1668485435975,ECE 202,A00,103644,Kuzum; Duygu,0,43,0,0
1668485436400,ECE 212BN,A00,103646,Ng; Tse Nga,0,9,0,0
1668485436826,ECE 221,A00,111493,Staff,0,0,0,0
1668485437248,ECE 222B,A00,103647,Lomakin; Vitaliy,0,18,0,0
1668485437677,ECE 230B,A00,103648,Taur; Yuan,0,2,0,0
1668485438101,ECE 238B,A00,103649,Garay; Javier,0,0,0,0
1668485438525,ECE 240B,A00,112900,Fainman; Yeshaiahu,0,7,0,0
1668485438950,ECE 247A,A00,103650,Jokerst; Jesse Vincent,0,6,0,0
1668485439374,ECE 247B,A00,103651,Wang; Joseph,0,12,0,0
1668485439797,ECE 250,A00,103652,Siegel; Paul H.,0,82,0,0
1668485440220,ECE 251A,A00,103654,Rao; Bhaskar D.,0,61,0,0
1668485440646,ECE 257B,A00,103655,Bharadia; Dinesh,0,32,0,0
1668485441076,ECE 258A,A00,103656,Milstein; Laurence B.,0,28,0,0
1668485441514,ECE 260B,A00,103658,Kang; Mingu,0,119,0,0
1668485441937,ECE 264A,A00,103659,Galton; Ian A,0,66,0,0
1668485442364,ECE 265A,A00,103661,Gudem; Prasad S.S.,0,65,0,0
1668485442792,ECE 265D,A00,103662,Gudem; Prasad S.S.,0,24,0,0
1668485443222,ECE 268,A00,103663,Koushanfar; Farinaz,0,42,0,0
1668485443663,ECE 269,A01,103665,Pal; Piya,0,211,0,0
1668485444087,ECE 271B,A00,103666,Vasconcelos; Manuela,0,74,0,0
1668485444512,ECE 276A,A00,103667,Atanasov; Nikolay A.,0,123,0,0
1668485444945,ECE 277,A00,103668,An; Cheolhong,0,145,0,0
1668485445380,ECE 279,A00,117947,Hall; Drew A.,0,22,0,0
1668485446233,ECE 283,A00,103670,Hsueh; Tzu-Chien,0,51,0,0
1668485446677,ECE 284,A00,103671,Turakhia; Yatish Girish,0,39,0,0
1668485447108,ECE 285,A00,103672,Zheng; Yang,0,39,0,0
1668485447108,ECE 285,B00,103673,Sworder; David D.,0,56,0,0
1668485447535,ECE 287,A00,103676,Javidi; Tara,0,8,0,0
1668485447968,MATH 200B,A00,098023,Salehi Golsefidy; Alireza,10,0,15,5
1668485448391,MATH 202B,A00,098024,Rhoades; Brendon Patrick,7,0,15,8
1668485448826,MATH 203B,A00,098025,Oprea; Dragos N.,9,0,15,6
1668485449252,MATH 204B,A00,098026,Sorensen; Claus M,13,0,15,2
1668485449676,MATH 208,A00,098027,Izadi; Elham,7,0,10,3
1668485450101,MATH 209,A00,098028,Pollack; Aaron,10,0,10,0
1668485450525,MATH 211A,A00,112919,Rogalski; Daniel,8,0,10,2
1668485450950,MATH 211B,A00,112920,Seward; Brandon M.,9,0,10,1
1668485451374,MATH 218,A00,098029,Li; Bo,10,0,10,0
1668485451799,MATH 220B,A00,098030,Novak; Jonathan I,11,0,15,4
1668485452222,MATH 221A,A00,098031,Ebenfelt; Peter F,12,0,15,3
1668485452646,MATH 231B,A00,098032,Zlatos; Andrej,11,0,15,4
1668485453070,MATH 240B,A00,098033,Ni; Lei,7,0,15,8
1668485453492,MATH 243,A00,098034,Jekel; David Andrew,10,0,10,0
1668485453914,MATH 245A,A00,098035,Nie; Jiawang,0,4,15,18
1668485454338,MATH 248,A00,098036,Bejenaru; Ioan,10,0,10,0
1668485454762,MATH 250B,A00,098037,Spolaor; Luca,14,0,15,1
1668485455186,MATH 258,A00,098038,Ni; Lei,9,0,10,1
1668485455615,MATH 264B,A00,098041,Rhoades; Brendon Patrick,8,0,15,7
1668485456040,MATH 268,A00,098042,Buss; Samuel R,10,0,10,0
1668485456468,MATH 269,A00,098043,Rhoades; Brendon Patrick,10,0,10,0
1668485456893,MATH 270B,A00,098044,Li; Bo,6,0,15,9
1668485457319,MATH 272B,A00,098045,Holst; Michael J,13,0,15,2
1668485457820,MATH 273A,A00,098046,Tian; Xiaochuan,10,0,15,5
1668485458252,MATH 275,A01,098048,Tian; Xiaochuan,6,0,10,4
1668485458675,MATH 278A,A00,098049,Holst; Michael J,7,0,10,3
1668485459103,MATH 278B,A00,098050,Cloninger; Alexander,10,0,10,0
1668485459528,MATH 278C,A00,098051,Nie; Jiawang,5,0,10,5
1668485459950,MATH 280B,A00,098052,Zheng; Tianyi,7,0,15,8
1668485460378,MATH 281B,A00,098053,Bradic; Jelena,0,2,15,15
1668485460815,MATH 282B,A00,098054,Arias-Castro; Ery,0,1,15,15
1668485461247,MATH 285,A00,098055,Fitzsimmons; Patrick J,0,2,15,17
1668485461673,MATH 287B,A00,098056,Arias-Castro; Ery,1,0,15,14
1668485462099,MATH 288,A00,098057,Agarwal; Pooja,9,0,10,1
1668485462099,MATH 288,B00,098058,Zhang; Danna,8,0,10,2
1668485462099,MATH 288,C00,098059,Williams; Ruth J,9,0,10,1
1668485462525,MATH 290B,A00,098060,Roberts; Justin Deritter,12,0,15,3
1668485462949,MATH 292,A00,098061,Belmont; Eva Kinoshita,10,0,10,0
1668485463376,MATH 295,A00,098062,Suk; Andrew Hoon,47,0,50,3
1668485463801,MATH 296,A00,098063,Novak; Jonathan I,20,0,20,0
1668485464228,MATH 297,001,098064,Gamst; Anthony Collins,9997,0,9999,2
1668485975764,COGS 205,A00,101395,Chiba; Andrea,19,0,20,1
1668485976189,COGS 210B,001,101404,Greene; Deanna Jacquelyn,9998,0,9999,1
1668485976189,COGS 210B,002,101417,Xia; Haijun,9999,0,9999,0
1668485976189,COGS 210B,003,101422,Nitz; Douglas A.,9999,0,9999,0
1668485976189,COGS 210B,004,101423,Hollan; James D.,9998,0,9999,1
1668485976189,COGS 210B,005,101424,Deak; Gedeon O.,9998,0,9999,1
1668485976189,COGS 210B,006,101425,Rossano; Federico,9999,0,9999,0
1668485976629,COGS 211B,A00,101427,Coulson; Seana M,9996,0,9999,3
1668485977058,COGS 220,A00,101428,Hollan; James D.,1,11,25,24
1668485977480,COGS 229,A00,101429,Dow; Steven P,17,0,25,8
1668485977909,COGS 230,A00,101430,Klemmer; Scott R,8,0,17,9
1668485978336,COGS 234,A00,101431,Xia; Haijun,2,0,25,23
1668485978763,COGS 260,A00,101432,Kiyonaga; Anastasia,21,0,25,4
1668485978763,COGS 260,B00,101433,Kirsh; David Joel,15,0,25,10
1668485979188,CSE 202,A00,102371,Impagliazzo; Russell,0,62,0,0
1668485979626,CSE 203B,A01,102373,Cheng; Chung Kuan,0,52,0,0
1668485980059,CSE 208,A00,102374,Micciancio; Daniele,0,5,0,0
1668485980481,CSE 209A,A00,112895,Impagliazzo; Russell,0,12,15,15
1668485980904,CSE 209B,A00,108005,Bellare; Mihir,0,6,0,0
1668485981326,CSE 210,A00,113163,Coblenz; Michael J,0,80,0,0
1668485981750,CSE 219,A00,106111,Dow; Steven P,0,6,20,20
1668485982176,CSE 221,A00,102376,Voelker; Geoffrey M.,0,70,0,0
1668485982618,CSE 224,A01,102378,Porter; George M,0,160,0,0
1668485983043,CSE 229A,A00,102379,Savage; Stefan,0,10,0,0
1668485983468,CSE 229C,A00,102380,Munyaka; Imani N. S.,0,10,0,0
1668485983896,CSE 232B,A00,102382,Deutsch; Alin Bernard,0,31,0,0
1668485984319,CSE 234,A01,112904,Kumar; Arun Kumar,0,0,0,0
1668485984748,CSE 237A,A00,102383,Rosing; Tajana Simunic,0,50,0,0
1668485985171,CSE 239A,A00,102384,Deutsch; Alin Bernard,0,13,0,0
1668485985594,CSE 239B,A00,102385,Polikarpova; Nadezhda,0,10,0,0
1668485986017,CSE 240A,A00,102386,Pannuto; Patrick William,0,44,0,0
1668485986445,CSE 240B,A00,102387,Zhao; Jishen,0,42,0,0
1668485986874,CSE 241A,A00,106406,Kang; Mingu,0,7,0,0
1668485987303,CSE 249B,A00,102388,Kahng; Andrew Byun,0,5,8,8
1668485987727,CSE 251B,A01,102392,Cottrell; Garrison W,0,46,0,0
1668485987727,CSE 251B,A02,102393,Cottrell; Garrison W,0,33,0,0
1668485988239,CSE 252B,A00,102394,Ochoa; Benjamin Lawrence,0,57,0,0
1668485988667,CSE 257,A01,102396,Gao; Sicun,0,132,0,0
1668485989104,CSE 272,A00,102397,Li; Tzumao,0,17,0,0
1668485989527,CSE 274,A00,111323,Chern; Albert Ren-Haur,0,15,0,0
1668485989959,CSE 282,A00,102398,Pevzner; Pavel Arkadjevich,0,0,0,0
1668485990384,CSE 284,A00,114175,Gymrek; Melissa Ann,0,21,0,0
1668485990806,CSE 290,A00,102399,Chandraker; Manmohan Krishna,0,11,0,0
1668485990806,CSE 290,B00,102400,Vaccaro; Kristen Marie,0,7,25,25
1668485990806,CSE 290,C00,102414,Pannuto; Patrick William,0,1,25,25
1668485990806,CSE 290,D00,102427,Pevzner; Pavel Arkadjevich,0,0,0,0
1668485990806,CSE 290,E00,102429,Zhao; Jishen,0,4,0,0
1668485990806,CSE 290,F00,102436,Tullsen; Dean Michael,0,5,0,0
1668485990806,CSE 290,G00,102440,Christensen; Henrik I,0,6,20,20
1668485991235,CSE 291,A00,102443,Su; Hao,0,0,0,0
1668485991235,CSE 291,B00,102448,Polikarpova; Nadezhda,0,0,0,0
1668485991235,CSE 291,C00,102453,Vaccaro; Kristen Marie,0,0,0,0
1668485991235,CSE 291,D00,111343,Savage; Stefan,0,0,0,0
1668485991235,CSE 291,E00,116474,Claffy; Kimberly Claire,0,0,0,0
1668485991235,CSE 291,F00,116479,Pasquale; Joseph,0,0,0,0
1668485991667,CSE 293,001,119111,Bafna; Vineet,9999,0,9999,0
1668485991667,CSE 293,002,119118,Bellare; Mihir,9999,0,9999,0
1668485991667,CSE 293,003,119122,Berg-Kirkpatrick; Taylor D,9999,0,9999,0
1668485991667,CSE 293,004,119135,Christensen; Henrik I,9999,0,9999,0
1668485991667,CSE 293,005,119142,Cottrell; Garrison W,9999,0,9999,0
1668485991667,CSE 293,006,119146,Deutsch; Alin Bernard,9999,0,9999,0
1668485991667,CSE 293,007,119159,Esmaeilzadeh; Hadi,9999,0,9999,0
1668485991667,CSE 293,008,119166,Freund; Yoav,9999,0,9999,0
1668485991667,CSE 293,009,119170,Griswold; William G.,9999,0,9999,0
1668485991667,CSE 293,010,119183,Gymrek; Melissa Ann,9999,0,9999,0
1668485991667,CSE 293,011,119190,Heninger; Nadia A,9999,0,9999,0
1668485991667,CSE 293,012,119230,Impagliazzo; Russell,9999,0,9999,0
1668485991667,CSE 293,013,119232,Jhala; Ranjit,9999,0,9999,0
1668485991667,CSE 293,014,119233,Kahng; Andrew Byun,9999,0,9999,0
1668485991667,CSE 293,015,119298,Kane; Daniel Mertz,9999,0,9999,0
1668485991667,CSE 293,016,119299,Kriegman; David J,9999,0,9999,0
1668485991667,CSE 293,017,119300,Kumar; Arun Kumar,9999,0,9999,0
1668485991667,CSE 293,018,119301,Lerner; Sorin,9999,0,9999,0
1668485991667,CSE 293,019,119302,Lovett; Shachar,9999,0,9999,0
1668485991667,CSE 293,020,119303,McAuley; Julian John,9999,0,9999,0
1668485991667,CSE 293,021,119304,Micciancio; Daniele,9999,0,9999,0
1668485991667,CSE 293,022,119367,Orailoglu; Alex,9999,0,9999,0
1668485991667,CSE 293,023,119382,Paturi; Ramamohan,9999,0,9999,0
1668485991667,CSE 293,024,119404,Polikarpova; Nadezhda,9999,0,9999,0
1668485991667,CSE 293,025,119406,Politz; Joseph Gibbs,9999,0,9999,0
1668485991667,CSE 293,026,119411,Porter; George M,9999,0,9999,0
1668485991667,CSE 293,027,119414,Porter; Leonard Emerson,9999,0,9999,0
1668485991667,CSE 293,028,119416,Ramamoorthi; Ravi,9999,0,9999,0
1668485991667,CSE 293,029,119417,Sahoo; Debashis,9999,0,9999,0
1668485991667,CSE 293,030,119420,Saul; Lawrence,9999,0,9999,0
1668485991667,CSE 293,031,119421,Savage; Stefan,9999,0,9999,0
1668485991667,CSE 293,032,119425,Schulze; Jurgen P.,9999,0,9999,0
1668485991667,CSE 293,033,119426,Snoeren; Alex C.,9999,0,9999,0
1668485991667,CSE 293,034,119428,Shang; Jingbo,9999,0,9999,0
1668485991667,CSE 293,035,119430,Stefan; Deian,9999,0,9999,0
1668485991667,CSE 293,036,119431,Su; Hao,9999,0,9999,0
1668485991667,CSE 293,037,119433,Swanson; Steven James,9999,0,9999,0
1668485991667,CSE 293,038,119435,Tullsen; Dean Michael,9999,0,9999,0
1668485991667,CSE 293,039,119483,Voelker; Geoffrey M.,9999,0,9999,0
1668485991667,CSE 293,040,119537,Zhao; Jishen,9999,0,9999,0
1668485991667,CSE 293,041,119538,Zhou; Yuan-Yuan,9999,0,9999,0
1668485991667,CSE 293,042,119539,Gao; Sicun,9999,0,9999,0
1668485991667,CSE 293,043,119540,Weibel; Nadir,9999,0,9999,0
1668485991667,CSE 293,044,119541,Gupta; Rajesh K.,9999,0,9999,0
1668485991667,CSE 293,045,126410,Vaccaro; Kristen Marie,9999,0,9999,0
1668485991667,CSE 293,046,126411,Klemke; Richard,9999,0,9999,0
1668485992095,CSE 294,A00,102459,Voelker; Geoffrey M.,0,2,0,0
1668485992095,CSE 294,B00,111322,Orailoglu; Alex,0,2,0,0
1668485992527,DSE 201,A00,096914,Deutsch; Alin Bernard,30,0,30,0
1668485992962,DSE 210,A00,096915,Dasgupta; Sanjoy,30,0,30,0
1668485993386,DSE 260A,A00,096916,Altintas De Callaf; Ilkay,30,0,30,0
1668485993814,ECE 200,001,103586,Antipa; Nicholas A,9999,0,9999,0
1668485993814,ECE 200,002,103587,Atanasov; Nikolay A.,9999,0,9999,0
1668485993814,ECE 200,003,103588,Bharadia; Dinesh,9999,0,9999,0
1668485993814,ECE 200,004,103589,Cheng; Chung Kuan,9999,0,9999,0
1668485993814,ECE 200,005,103590,Cosman; Pamela C.,9999,0,9999,0
1668485993814,ECE 200,006,103591,Dayeh; Shadi Ahmad,9999,0,9999,0
1668485993814,ECE 200,007,103592,Fainman; Yeshaiahu,9999,0,9999,0
1668485993814,ECE 200,008,103593,Ford; Joseph Earl,9999,0,9999,0
1668485993814,ECE 200,009,103594,Franceschetti; Massimo,9999,0,9999,0
1668485993814,ECE 200,010,103595,Fullerton; Eric E,9999,0,9999,0
1668485993814,ECE 200,011,103596,Galton; Ian A,9999,0,9999,0
1668485993814,ECE 200,012,103597,Gilja; Vikash,9999,0,9999,0
1668485993814,ECE 200,013,103598,Hall; Drew A.,9999,0,9999,0
1668485993814,ECE 200,014,103599,Hsueh; Tzu-Chien,9999,0,9999,0
1668485993814,ECE 200,015,103600,Javidi; Tara,9999,0,9999,0
1668485993814,ECE 200,016,103601,Kahng; Andrew Byun,9999,0,9999,0
1668485993814,ECE 200,017,103602,Kim; Young-Han,9999,0,9999,0
1668485993814,ECE 200,018,103603,Koushanfar; Farinaz,9999,0,9999,0
1668485993814,ECE 200,019,103604,Kuzum; Duygu,9999,0,9999,0
1668485993814,ECE 200,020,103605,Le; Hanh-Phuc,9999,0,9999,0
1668485993814,ECE 200,021,103606,Lin; Bill,9999,0,9999,0
1668485993814,ECE 200,022,103607,Liu; Zhaowei,9998,0,9999,1
1668485993814,ECE 200,023,103608,Lo; Yu-Hwa,9999,0,9999,0
1668485993814,ECE 200,024,103609,Lomakin; Vitaliy,9999,0,9999,0
1668485993814,ECE 200,025,103610,Mercier; Patrick Philip,9999,0,9999,0
1668485993814,ECE 200,026,103611,Meyer; Florian,9999,0,9999,0
1668485993814,ECE 200,027,103612,Milstein; Laurence B.,9999,0,9999,0
1668485993814,ECE 200,028,103613,Mir Arabbaygi; Siavash,9999,0,9999,0
1668485993814,ECE 200,029,103614,Mookherjea; Shayan,9999,0,9999,0
1668485993814,ECE 200,030,103615,Morris; Karcher William,9999,0,9999,0
1668485993814,ECE 200,031,103616,Ng; Tse Nga,9999,0,9999,0
1668485993814,ECE 200,032,103617,Nguyen; Truong Quang,9999,0,9999,0
1668485993814,ECE 200,033,103618,Nomura; Kenji,9999,0,9999,0
1668485993814,ECE 200,034,103619,Orlitsky; Alon,9999,0,9999,0
1668485993814,ECE 200,035,103620,Pal; Piya,9999,0,9999,0
1668485993814,ECE 200,036,103621,Papen; George C.,9999,0,9999,0
1668485993814,ECE 200,037,103622,Radic; Stojan,9999,0,9999,0
1668485993814,ECE 200,038,103623,Rao; Bhaskar D.,9999,0,9999,0
1668485993814,ECE 200,039,103624,Rao; Ramesh R,9999,0,9999,0
1668485993814,ECE 200,040,103625,Rebeiz; Gabriel,9999,0,9999,0
1668485993814,ECE 200,041,103626,Sanford; John R,9999,0,9999,0
1668485993814,ECE 200,042,103627,Siegel; Paul H.,9999,0,9999,0
1668485993814,ECE 200,043,103628,Sievenpiper; Daniel F.,9999,0,9999,0
1668485993814,ECE 200,044,103629,Sworder; David D.,9999,0,9999,0
1668485993814,ECE 200,045,103630,Taur; Yuan,9999,0,9999,0
1668485993814,ECE 200,046,103631,Touri; Behrouz,9999,0,9999,0
1668485993814,ECE 200,047,103632,Trivedi; Mohan M.,9999,0,9999,0
1668485993814,ECE 200,048,103633,Vasconcelos; Nuno,9999,0,9999,0
1668485993814,ECE 200,049,103634,Wang; Xiaolong,9999,0,9999,0
1668485993814,ECE 200,050,103635,Xie; Pengtao,9999,0,9999,0
1668485993814,ECE 200,051,103636,Yip; Michael,9999,0,9999,0
1668485993814,ECE 200,052,103637,Zeger; Kenneth A.,999,0,999,0
1668485993814,ECE 200,053,103638,Zhang; Xinyu,9999,0,9999,0
1668485993814,ECE 200,054,103639,Turakhia; Yatish Girish,9999,0,9999,0
1668485993814,ECE 200,055,103640,Kang; Mingu,9999,0,9999,0
1668485993814,ECE 200,056,103641,Shi; Yuanyuan,9999,0,9999,0
1668485993814,ECE 200,057,103642,Wang; Edward Jay,9999,0,9999,0
1668485993814,ECE 200,058,103643,Zheng; Yang,9999,0,9999,0
1668485994240,ECE 202,A00,103644,Kuzum; Duygu,0,43,0,0
1668485994672,ECE 212BN,A00,103646,Ng; Tse Nga,0,9,0,0
1668485995101,ECE 221,A00,111493,Staff,0,0,0,0
1668485995525,ECE 222B,A00,103647,Lomakin; Vitaliy,0,18,0,0
1668485995957,ECE 230B,A00,103648,Taur; Yuan,0,2,0,0
1668485996381,ECE 238B,A00,103649,Garay; Javier,0,0,0,0
1668485996807,ECE 240B,A00,112900,Fainman; Yeshaiahu,0,7,0,0
1668485997239,ECE 247A,A00,103650,Jokerst; Jesse Vincent,0,6,0,0
1668485997663,ECE 247B,A00,103651,Wang; Joseph,0,13,0,0
1668485998090,ECE 250,A00,103652,Siegel; Paul H.,0,82,0,0
1668485998522,ECE 251A,A00,103654,Rao; Bhaskar D.,0,61,0,0
1668485998944,ECE 257B,A00,103655,Bharadia; Dinesh,0,32,0,0
1668485999382,ECE 258A,A00,103656,Milstein; Laurence B.,0,28,0,0
1668485999813,ECE 260B,A00,103658,Kang; Mingu,0,119,0,0
1668486000248,ECE 264A,A00,103659,Galton; Ian A,0,66,0,0
1668486000671,ECE 265A,A00,103661,Gudem; Prasad S.S.,0,66,0,0
1668486001098,ECE 265D,A00,103662,Gudem; Prasad S.S.,0,24,0,0
1668486001524,ECE 268,A00,103663,Koushanfar; Farinaz,0,42,0,0
1668486001948,ECE 269,A01,103665,Pal; Piya,0,211,0,0
1668486002377,ECE 271B,A00,103666,Vasconcelos; Manuela,0,74,0,0
1668486002802,ECE 276A,A00,103667,Atanasov; Nikolay A.,0,123,0,0
1668486003228,ECE 277,A00,103668,An; Cheolhong,0,145,0,0
1668486003654,ECE 279,A00,117947,Hall; Drew A.,0,22,0,0
1668486004508,ECE 283,A00,103670,Hsueh; Tzu-Chien,0,51,0,0
1668486004948,ECE 284,A00,103671,Turakhia; Yatish Girish,0,39,0,0
1668486005380,ECE 285,A00,103672,Zheng; Yang,0,39,0,0
1668486005380,ECE 285,B00,103673,Sworder; David D.,0,56,0,0
1668486005808,ECE 287,A00,103676,Javidi; Tara,0,8,0,0
1668486006235,MATH 200B,A00,098023,Salehi Golsefidy; Alireza,10,0,15,5
1668486006668,MATH 202B,A00,098024,Rhoades; Brendon Patrick,7,0,15,8
1668486007091,MATH 203B,A00,098025,Oprea; Dragos N.,9,0,15,6
1668486007514,MATH 204B,A00,098026,Sorensen; Claus M,13,0,15,2
1668486007940,MATH 208,A00,098027,Izadi; Elham,7,0,10,3
1668486008363,MATH 209,A00,098028,Pollack; Aaron,10,0,10,0
1668486008806,MATH 211A,A00,112919,Rogalski; Daniel,8,0,10,2
1668486009230,MATH 211B,A00,112920,Seward; Brandon M.,9,0,10,1
1668486009655,MATH 218,A00,098029,Li; Bo,10,0,10,0
1668486010081,MATH 220B,A00,098030,Novak; Jonathan I,11,0,15,4
1668486010505,MATH 221A,A00,098031,Ebenfelt; Peter F,12,0,15,3
1668486010929,MATH 231B,A00,098032,Zlatos; Andrej,11,0,15,4
1668486011361,MATH 240B,A00,098033,Ni; Lei,7,0,15,8
1668486011785,MATH 243,A00,098034,Jekel; David Andrew,10,0,10,0
1668486012216,MATH 245A,A00,098035,Nie; Jiawang,0,4,15,18
1668486012644,MATH 248,A00,098036,Bejenaru; Ioan,10,0,10,0
1668486013070,MATH 250B,A00,098037,Spolaor; Luca,14,0,15,1
1668486013501,MATH 258,A00,098038,Ni; Lei,9,0,10,1
1668486013928,MATH 264B,A00,098041,Rhoades; Brendon Patrick,8,0,15,7
1668486014351,MATH 268,A00,098042,Buss; Samuel R,10,0,10,0
1668486014779,MATH 269,A00,098043,Rhoades; Brendon Patrick,10,0,10,0
1668486015202,MATH 270B,A00,098044,Li; Bo,6,0,15,9
1668486015629,MATH 272B,A00,098045,Holst; Michael J,13,0,15,2
1668486016053,MATH 273A,A00,098046,Tian; Xiaochuan,10,0,15,5
1668486016482,MATH 275,A01,098048,Tian; Xiaochuan,6,0,10,4
1668486016905,MATH 278A,A00,098049,Holst; Michael J,7,0,10,3
1668486017331,MATH 278B,A00,098050,Cloninger; Alexander,10,0,10,0
1668486017757,MATH 278C,A00,098051,Nie; Jiawang,5,0,10,5
1668486018178,MATH 280B,A00,098052,Zheng; Tianyi,7,0,15,8
1668486018603,MATH 281B,A00,098053,Bradic; Jelena,0,2,15,15
1668486019033,MATH 282B,A00,098054,Arias-Castro; Ery,0,1,15,15
1668486019457,MATH 285,A00,098055,Fitzsimmons; Patrick J,0,2,15,17
1668486019882,MATH 287B,A00,098056,Arias-Castro; Ery,1,0,15,14
1668486020310,MATH 288,A00,098057,Agarwal; Pooja,9,0,10,1
1668486020310,MATH 288,B00,098058,Zhang; Danna,8,0,10,2
1668486020310,MATH 288,C00,098059,Williams; Ruth J,9,0,10,1
1668486020731,MATH 290B,A00,098060,Roberts; Justin Deritter,12,0,15,3
1668486021157,MATH 292,A00,098061,Belmont; Eva Kinoshita,10,0,10,0
1668486021581,MATH 295,A00,098062,Suk; Andrew Hoon,47,0,50,3
1668486022009,MATH 296,A00,098063,Novak; Jonathan I,20,0,20,0
1668486022435,MATH 297,001,098064,Gamst; Anthony Collins,9997,0,9999,2
1668486524023,COGS 205,A00,101395,Chiba; Andrea,19,0,20,1
1668486524447,COGS 210B,001,101404,Greene; Deanna Jacquelyn,9998,0,9999,1
1668486524447,COGS 210B,002,101417,Xia; Haijun,9999,0,9999,0
1668486524447,COGS 210B,003,101422,Nitz; Douglas A.,9999,0,9999,0
1668486524447,COGS 210B,004,101423,Hollan; James D.,9998,0,9999,1
1668486524447,COGS 210B,005,101424,Deak; Gedeon O.,9998,0,9999,1
1668486524447,COGS 210B,006,101425,Rossano; Federico,9999,0,9999,0
1668486524872,COGS 211B,A00,101427,Coulson; Seana M,9996,0,9999,3
1668486525298,COGS 220,A00,101428,Hollan; James D.,1,11,25,24
1668486525722,COGS 229,A00,101429,Dow; Steven P,17,0,25,8
1668486526155,COGS 230,A00,101430,Klemmer; Scott R,8,0,17,9
1668486526578,COGS 234,A00,101431,Xia; Haijun,2,0,25,23
1668486527008,COGS 260,A00,101432,Kiyonaga; Anastasia,21,0,25,4
1668486527008,COGS 260,B00,101433,Kirsh; David Joel,15,0,25,10
1668486527430,CSE 202,A00,102371,Impagliazzo; Russell,0,63,0,0
1668486527861,CSE 203B,A01,102373,Cheng; Chung Kuan,0,52,0,0
1668486528297,CSE 208,A00,102374,Micciancio; Daniele,0,5,0,0
1668486528724,CSE 209A,A00,112895,Impagliazzo; Russell,0,12,15,15
1668486529146,CSE 209B,A00,108005,Bellare; Mihir,0,6,0,0
1668486529573,CSE 210,A00,113163,Coblenz; Michael J,0,80,0,0
1668486530002,CSE 219,A00,106111,Dow; Steven P,0,6,20,20
1668486530429,CSE 221,A00,102376,Voelker; Geoffrey M.,0,70,0,0
1668486530853,CSE 224,A01,102378,Porter; George M,0,160,0,0
1668486531277,CSE 229A,A00,102379,Savage; Stefan,0,10,0,0
1668486531709,CSE 229C,A00,102380,Munyaka; Imani N. S.,0,10,0,0
1668486532134,CSE 232B,A00,102382,Deutsch; Alin Bernard,0,31,0,0
1668486532568,CSE 234,A01,112904,Kumar; Arun Kumar,0,0,0,0
1668486532993,CSE 237A,A00,102383,Rosing; Tajana Simunic,0,50,0,0
1668486533419,CSE 239A,A00,102384,Deutsch; Alin Bernard,0,13,0,0
1668486533841,CSE 239B,A00,102385,Polikarpova; Nadezhda,0,10,0,0
1668486534274,CSE 240A,A00,102386,Pannuto; Patrick William,0,44,0,0
1668486534697,CSE 240B,A00,102387,Zhao; Jishen,0,42,0,0
1668486535137,CSE 241A,A00,106406,Kang; Mingu,0,7,0,0
1668486535559,CSE 249B,A00,102388,Kahng; Andrew Byun,0,5,8,8
1668486535985,CSE 251B,A01,102392,Cottrell; Garrison W,0,46,0,0
1668486535985,CSE 251B,A02,102393,Cottrell; Garrison W,0,33,0,0
1668486536408,CSE 252B,A00,102394,Ochoa; Benjamin Lawrence,0,58,0,0
1668486536839,CSE 257,A01,102396,Gao; Sicun,0,132,0,0
1668486537266,CSE 272,A00,102397,Li; Tzumao,0,17,0,0
1668486537691,CSE 274,A00,111323,Chern; Albert Ren-Haur,0,15,0,0
1668486538114,CSE 282,A00,102398,Pevzner; Pavel Arkadjevich,0,0,0,0
1668486538537,CSE 284,A00,114175,Gymrek; Melissa Ann,0,22,0,0
1668486538962,CSE 290,A00,102399,Chandraker; Manmohan Krishna,0,11,0,0
1668486538962,CSE 290,B00,102400,Vaccaro; Kristen Marie,0,7,25,25
1668486538962,CSE 290,C00,102414,Pannuto; Patrick William,0,1,25,25
1668486538962,CSE 290,D00,102427,Pevzner; Pavel Arkadjevich,0,0,0,0
1668486538962,CSE 290,E00,102429,Zhao; Jishen,0,4,0,0
1668486538962,CSE 290,F00,102436,Tullsen; Dean Michael,0,5,0,0
1668486538962,CSE 290,G00,102440,Christensen; Henrik I,0,6,20,20
1668486539385,CSE 291,A00,102443,Su; Hao,0,0,0,0
1668486539385,CSE 291,B00,102448,Polikarpova; Nadezhda,0,0,0,0
1668486539385,CSE 291,C00,102453,Vaccaro; Kristen Marie,0,0,0,0
1668486539385,CSE 291,D00,111343,Savage; Stefan,0,0,0,0
1668486539385,CSE 291,E00,116474,Claffy; Kimberly Claire,0,0,0,0
1668486539385,CSE 291,F00,116479,Pasquale; Joseph,0,0,0,0
1668486539839,CSE 293,001,119111,Bafna; Vineet,9999,0,9999,0
1668486539839,CSE 293,002,119118,Bellare; Mihir,9999,0,9999,0
1668486539839,CSE 293,003,119122,Berg-Kirkpatrick; Taylor D,9999,0,9999,0
1668486539839,CSE 293,004,119135,Christensen; Henrik I,9999,0,9999,0
1668486539839,CSE 293,005,119142,Cottrell; Garrison W,9999,0,9999,0
1668486539839,CSE 293,006,119146,Deutsch; Alin Bernard,9999,0,9999,0
1668486539839,CSE 293,007,119159,Esmaeilzadeh; Hadi,9999,0,9999,0
1668486539839,CSE 293,008,119166,Freund; Yoav,9999,0,9999,0
1668486539839,CSE 293,009,119170,Griswold; William G.,9999,0,9999,0
1668486539839,CSE 293,010,119183,Gymrek; Melissa Ann,9999,0,9999,0
1668486539839,CSE 293,011,119190,Heninger; Nadia A,9999,0,9999,0
1668486539839,CSE 293,012,119230,Impagliazzo; Russell,9999,0,9999,0
1668486539839,CSE 293,013,119232,Jhala; Ranjit,9999,0,9999,0
1668486539839,CSE 293,014,119233,Kahng; Andrew Byun,9999,0,9999,0
1668486539839,CSE 293,015,119298,Kane; Daniel Mertz,9999,0,9999,0
1668486539839,CSE 293,016,119299,Kriegman; David J,9999,0,9999,0
1668486539839,CSE 293,017,119300,Kumar; Arun Kumar,9999,0,9999,0
1668486539839,CSE 293,018,119301,Lerner; Sorin,9999,0,9999,0
1668486539839,CSE 293,019,119302,Lovett; Shachar,9999,0,9999,0
1668486539839,CSE 293,020,119303,McAuley; Julian John,9999,0,9999,0
1668486539839,CSE 293,021,119304,Micciancio; Daniele,9999,0,9999,0
1668486539839,CSE 293,022,119367,Orailoglu; Alex,9999,0,9999,0
1668486539839,CSE 293,023,119382,Paturi; Ramamohan,9999,0,9999,0
1668486539839,CSE 293,024,119404,Polikarpova; Nadezhda,9999,0,9999,0
1668486539839,CSE 293,025,119406,Politz; Joseph Gibbs,9999,0,9999,0
1668486539839,CSE 293,026,119411,Porter; George M,9999,0,9999,0
1668486539839,CSE 293,027,119414,Porter; Leonard Emerson,9999,0,9999,0
1668486539839,CSE 293,028,119416,Ramamoorthi; Ravi,9999,0,9999,0
1668486539839,CSE 293,029,119417,Sahoo; Debashis,9999,0,9999,0
1668486539839,CSE 293,030,119420,Saul; Lawrence,9999,0,9999,0
1668486539839,CSE 293,031,119421,Savage; Stefan,9999,0,9999,0
1668486539839,CSE 293,032,119425,Schulze; Jurgen P.,9999,0,9999,0
1668486539839,CSE 293,033,119426,Snoeren; Alex C.,9999,0,9999,0
1668486539839,CSE 293,034,119428,Shang; Jingbo,9999,0,9999,0
1668486539839,CSE 293,035,119430,Stefan; Deian,9999,0,9999,0
1668486539839,CSE 293,036,119431,Su; Hao,9999,0,9999,0
1668486539839,CSE 293,037,119433,Swanson; Steven James,9999,0,9999,0
1668486539839,CSE 293,038,119435,Tullsen; Dean Michael,9999,0,9999,0
1668486539839,CSE 293,039,119483,Voelker; Geoffrey M.,9999,0,9999,0
1668486539839,CSE 293,040,119537,Zhao; Jishen,9999,0,9999,0
1668486539839,CSE 293,041,119538,Zhou; Yuan-Yuan,9999,0,9999,0
1668486539839,CSE 293,042,119539,Gao; Sicun,9999,0,9999,0
1668486539839,CSE 293,043,119540,Weibel; Nadir,9999,0,9999,0
1668486539839,CSE 293,044,119541,Gupta; Rajesh K.,9999,0,9999,0
1668486539839,CSE 293,045,126410,Vaccaro; Kristen Marie,9999,0,9999,0
1668486539839,CSE 293,046,126411,Klemke; Richard,9999,0,9999,0
1668486540269,CSE 294,A00,102459,Voelker; Geoffrey M.,0,2,0,0
1668486540269,CSE 294,B00,111322,Orailoglu; Alex,0,2,0,0
1668486540692,DSE 201,A00,096914,Deutsch; Alin Bernard,30,0,30,0
1668486541117,DSE 210,A00,096915,Dasgupta; Sanjoy,30,0,30,0
1668486541546,DSE 260A,A00,096916,Altintas De Callaf; Ilkay,30,0,30,0
1668486541995,ECE 200,001,103586,Antipa; Nicholas A,9999,0,9999,0
1668486541995,ECE 200,002,103587,Atanasov; Nikolay A.,9999,0,9999,0
1668486541995,ECE 200,003,103588,Bharadia; Dinesh,9999,0,9999,0
1668486541995,ECE 200,004,103589,Cheng; Chung Kuan,9999,0,9999,0
1668486541995,ECE 200,005,103590,Cosman; Pamela C.,9999,0,9999,0
1668486541995,ECE 200,006,103591,Dayeh; Shadi Ahmad,9999,0,9999,0
1668486541995,ECE 200,007,103592,Fainman; Yeshaiahu,9999,0,9999,0
1668486541995,ECE 200,008,103593,Ford; Joseph Earl,9999,0,9999,0
1668486541995,ECE 200,009,103594,Franceschetti; Massimo,9999,0,9999,0
1668486541995,ECE 200,010,103595,Fullerton; Eric E,9999,0,9999,0
1668486541995,ECE 200,011,103596,Galton; Ian A,9999,0,9999,0
1668486541995,ECE 200,012,103597,Gilja; Vikash,9999,0,9999,0
1668486541995,ECE 200,013,103598,Hall; Drew A.,9999,0,9999,0
1668486541995,ECE 200,014,103599,Hsueh; Tzu-Chien,9999,0,9999,0
1668486541995,ECE 200,015,103600,Javidi; Tara,9999,0,9999,0
1668486541995,ECE 200,016,103601,Kahng; Andrew Byun,9999,0,9999,0
1668486541995,ECE 200,017,103602,Kim; Young-Han,9999,0,9999,0
1668486541995,ECE 200,018,103603,Koushanfar; Farinaz,9999,0,9999,0
1668486541995,ECE 200,019,103604,Kuzum; Duygu,9999,0,9999,0
1668486541995,ECE 200,020,103605,Le; Hanh-Phuc,9999,0,9999,0
1668486541995,ECE 200,021,103606,Lin; Bill,9999,0,9999,0
1668486541995,ECE 200,022,103607,Liu; Zhaowei,9998,0,9999,1
1668486541995,ECE 200,023,103608,Lo; Yu-Hwa,9999,0,9999,0
1668486541995,ECE 200,024,103609,Lomakin; Vitaliy,9999,0,9999,0
1668486541995,ECE 200,025,103610,Mercier; Patrick Philip,9999,0,9999,0
1668486541995,ECE 200,026,103611,Meyer; Florian,9999,0,9999,0
1668486541995,ECE 200,027,103612,Milstein; Laurence B.,9999,0,9999,0
1668486541995,ECE 200,028,103613,Mir Arabbaygi; Siavash,9999,0,9999,0
1668486541995,ECE 200,029,103614,Mookherjea; Shayan,9999,0,9999,0
1668486541995,ECE 200,030,103615,Morris; Karcher William,9999,0,9999,0
1668486541995,ECE 200,031,103616,Ng; Tse Nga,9999,0,9999,0
1668486541995,ECE 200,032,103617,Nguyen; Truong Quang,9999,0,9999,0
1668486541995,ECE 200,033,103618,Nomura; Kenji,9999,0,9999,0
1668486541995,ECE 200,034,103619,Orlitsky; Alon,9999,0,9999,0
1668486541995,ECE 200,035,103620,Pal; Piya,9999,0,9999,0
1668486541995,ECE 200,036,103621,Papen; George C.,9999,0,9999,0
1668486541995,ECE 200,037,103622,Radic; Stojan,9999,0,9999,0
1668486541995,ECE 200,038,103623,Rao; Bhaskar D.,9999,0,9999,0
1668486541995,ECE 200,039,103624,Rao; Ramesh R,9999,0,9999,0
1668486541995,ECE 200,040,103625,Rebeiz; Gabriel,9999,0,9999,0
1668486541995,ECE 200,041,103626,Sanford; John R,9999,0,9999,0
1668486541995,ECE 200,042,103627,Siegel; Paul H.,9999,0,9999,0
1668486541995,ECE 200,043,103628,Sievenpiper; Daniel F.,9999,0,9999,0
1668486541995,ECE 200,044,103629,Sworder; David D.,9999,0,9999,0
1668486541995,ECE 200,045,103630,Taur; Yuan,9999,0,9999,0
1668486541995,ECE 200,046,103631,Touri; Behrouz,9999,0,9999,0
1668486541995,ECE 200,047,103632,Trivedi; Mohan M.,9999,0,9999,0
1668486541995,ECE 200,048,103633,Vasconcelos; Nuno,9999,0,9999,0
1668486541995,ECE 200,049,103634,Wang; Xiaolong,9999,0,9999,0
1668486541995,ECE 200,050,103635,Xie; Pengtao,9999,0,9999,0
1668486541995,ECE 200,051,103636,Yip; Michael,9999,0,9999,0
1668486541995,ECE 200,052,103637,Zeger; Kenneth A.,999,0,999,0
1668486541995,ECE 200,053,103638,Zhang; Xinyu,9999,0,9999,0
1668486541995,ECE 200,054,103639,Turakhia; Yatish Girish,9999,0,9999,0
1668486541995,ECE 200,055,103640,Kang; Mingu,9999,0,9999,0
1668486541995,ECE 200,056,103641,Shi; Yuanyuan,9999,0,9999,0
1668486541995,ECE 200,057,103642,Wang; Edward Jay,9999,0,9999,0
1668486541995,ECE 200,058,103643,Zheng; Yang,9999,0,9999,0
1668486542418,ECE 202,A00,103644,Kuzum; Duygu,0,43,0,0
1668486542851,ECE 212BN,A00,103646,Ng; Tse Nga,0,9,0,0
1668486543285,ECE 221,A00,111493,Staff,0,0,0,0
1668486543709,ECE 222B,A00,103647,Lomakin; Vitaliy,0,18,0,0
1668486544135,ECE 230B,A00,103648,Taur; Yuan,0,2,0,0
1668486544559,ECE 238B,A00,103649,Garay; Javier,0,0,0,0
1668486544989,ECE 240B,A00,112900,Fainman; Yeshaiahu,0,7,0,0
1668486545413,ECE 247A,A00,103650,Jokerst; Jesse Vincent,0,6,0,0
1668486545839,ECE 247B,A00,103651,Wang; Joseph,0,13,0,0
1668486546270,ECE 250,A00,103652,Siegel; Paul H.,0,82,0,0
1668486546704,ECE 251A,A00,103654,Rao; Bhaskar D.,0,61,0,0
1668486547129,ECE 257B,A00,103655,Bharadia; Dinesh,0,32,0,0
1668486547554,ECE 258A,A00,103656,Milstein; Laurence B.,0,28,0,0
1668486547977,ECE 260B,A00,103658,Kang; Mingu,0,119,0,0
1668486548401,ECE 264A,A00,103659,Galton; Ian A,0,66,0,0
1668486548827,ECE 265A,A00,103661,Gudem; Prasad S.S.,0,66,0,0
1668486549255,ECE 265D,A00,103662,Gudem; Prasad S.S.,0,24,0,0
1668486549679,ECE 268,A00,103663,Koushanfar; Farinaz,0,42,0,0
1668486550105,ECE 269,A01,103665,Pal; Piya,0,211,0,0
1668486550539,ECE 271B,A00,103666,Vasconcelos; Manuela,0,74,0,0
1668486550961,ECE 276A,A00,103667,Atanasov; Nikolay A.,0,123,0,0
1668486551388,ECE 277,A00,103668,An; Cheolhong,0,145,0,0
1668486551892,ECE 279,A00,117947,Hall; Drew A.,0,22,0,0
1668486552742,ECE 283,A00,103670,Hsueh; Tzu-Chien,0,51,0,0
1668486553167,ECE 284,A00,103671,Turakhia; Yatish Girish,0,39,0,0
1668486553592,ECE 285,A00,103672,Zheng; Yang,0,39,0,0
1668486553592,ECE 285,B00,103673,Sworder; David D.,0,56,0,0
1668486554016,ECE 287,A00,103676,Javidi; Tara,0,8,0,0
1668486554439,MATH 200B,A00,098023,Salehi Golsefidy; Alireza,10,0,15,5
1668486554862,MATH 202B,A00,098024,Rhoades; Brendon Patrick,7,0,15,8
1668486555295,MATH 203B,A00,098025,Oprea; Dragos N.,9,0,15,6
1668486555729,MATH 204B,A00,098026,Sorensen; Claus M,13,0,15,2
1668486556154,MATH 208,A00,098027,Izadi; Elham,7,0,10,3
1668486556584,MATH 209,A00,098028,Pollack; Aaron,10,0,10,0
1668486557009,MATH 211A,A00,112919,Rogalski; Daniel,8,0,10,2
1668486557437,MATH 211B,A00,112920,Seward; Brandon M.,9,0,10,1
1668486557865,MATH 218,A00,098029,Li; Bo,10,0,10,0
1668486558312,MATH 220B,A00,098030,Novak; Jonathan I,11,0,15,4
1668486558735,MATH 221A,A00,098031,Ebenfelt; Peter F,12,0,15,3
1668486559162,MATH 231B,A00,098032,Zlatos; Andrej,11,0,15,4
1668486559586,MATH 240B,A00,098033,Ni; Lei,7,0,15,8
1668486560017,MATH 243,A00,098034,Jekel; David Andrew,10,0,10,0
1668486560446,MATH 245A,A00,098035,Nie; Jiawang,0,4,15,18
1668486560870,MATH 248,A00,098036,Bejenaru; Ioan,10,0,10,0
1668486561301,MATH 250B,A00,098037,Spolaor; Luca,14,0,15,1
1668486561726,MATH 258,A00,098038,Ni; Lei,9,0,10,1
1668486562151,MATH 264B,A00,098041,Rhoades; Brendon Patrick,8,0,15,7
1668486562577,MATH 268,A00,098042,Buss; Samuel R,10,0,10,0
1668486563005,MATH 269,A00,098043,Rhoades; Brendon Patrick,10,0,10,0
1668486563429,MATH 270B,A00,098044,Li; Bo,6,0,15,9
1668486563851,MATH 272B,A00,098045,Holst; Michael J,13,0,15,2
1668486564275,MATH 273A,A00,098046,Tian; Xiaochuan,10,0,15,5
1668486564701,MATH 275,A01,098048,Tian; Xiaochuan,6,0,10,4
1668486565129,MATH 278A,A00,098049,Holst; Michael J,7,0,10,3
1668486565555,MATH 278B,A00,098050,Cloninger; Alexander,10,0,10,0
1668486565979,MATH 278C,A00,098051,Nie; Jiawang,5,0,10,5
1668486566402,MATH 280B,A00,098052,Zheng; Tianyi,7,0,15,8
1668486566834,MATH 281B,A00,098053,Bradic; Jelena,0,2,15,15
1668486567269,MATH 282B,A00,098054,Arias-Castro; Ery,0,1,15,15
1668486567696,MATH 285,A00,098055,Fitzsimmons; Patrick J,0,2,15,17
1668486568120,MATH 287B,A00,098056,Arias-Castro; Ery,1,0,15,14
1668486568548,MATH 288,A00,098057,Agarwal; Pooja,9,0,10,1
1668486568548,MATH 288,B00,098058,Zhang; Danna,8,0,10,2
1668486568548,MATH 288,C00,098059,Williams; Ruth J,9,0,10,1
1668486568977,MATH 290B,A00,098060,Roberts; Justin Deritter,12,0,15,3
1668486569399,MATH 292,A00,098061,Belmont; Eva Kinoshita,10,0,10,0
1668486569829,MATH 295,A00,098062,Suk; Andrew Hoon,47,0,50,3
1668486570259,MATH 296,A00,098063,Novak; Jonathan I,20,0,20,0
1668486570685,MATH 297,001,098064,Gamst; Anthony Collins,9997,0,9999,2
1668487071537,COGS 205,A00,101395,Chiba; Andrea,19,0,20,1
1668487071961,COGS 210B,001,101404,Greene; Deanna Jacquelyn,9998,0,9999,1
1668487071961,COGS 210B,002,101417,Xia; Haijun,9999,0,9999,0
1668487071961,COGS 210B,003,101422,Nitz; Douglas A.,9999,0,9999,0
1668487071961,COGS 210B,004,101423,Hollan; James D.,9998,0,9999,1
1668487071961,COGS 210B,005,101424,Deak; Gedeon O.,9998,0,9999,1
1668487071961,COGS 210B,006,101425,Rossano; Federico,9999,0,9999,0
1668487072382,COGS 211B,A00,101427,Coulson; Seana M,9996,0,9999,3
1668487072804,COGS 220,A00,101428,Hollan; James D.,1,11,25,24
1668487073231,COGS 229,A00,101429,Dow; Steven P,17,0,25,8
1668487073654,COGS 230,A00,101430,Klemmer; Scott R,8,0,17,9
1668487074081,COGS 234,A00,101431,Xia; Haijun,2,0,25,23
1668487074512,COGS 260,A00,101432,Kiyonaga; Anastasia,21,0,25,4
1668487074512,COGS 260,B00,101433,Kirsh; David Joel,15,0,25,10
1668487074936,CSE 202,A00,102371,Impagliazzo; Russell,0,63,0,0
1668487075362,CSE 203B,A01,102373,Cheng; Chung Kuan,0,52,0,0
1668487075787,CSE 208,A00,102374,Micciancio; Daniele,0,5,0,0
1668487076212,CSE 209A,A00,112895,Impagliazzo; Russell,0,12,15,15
1668487076644,CSE 209B,A00,108005,Bellare; Mihir,0,6,0,0
1668487077074,CSE 210,A00,113163,Coblenz; Michael J,0,80,0,0
1668487077497,CSE 219,A00,106111,Dow; Steven P,0,6,20,20
1668487077922,CSE 221,A00,102376,Voelker; Geoffrey M.,0,70,0,0
1668487078345,CSE 224,A01,102378,Porter; George M,0,160,0,0
1668487078769,CSE 229A,A00,102379,Savage; Stefan,0,10,0,0
1668487079194,CSE 229C,A00,102380,Munyaka; Imani N. S.,0,10,0,0
1668487079617,CSE 232B,A00,102382,Deutsch; Alin Bernard,0,31,0,0
1668487080043,CSE 234,A01,112904,Kumar; Arun Kumar,0,0,0,0
1668487080472,CSE 237A,A00,102383,Rosing; Tajana Simunic,0,50,0,0
1668487080906,CSE 239A,A00,102384,Deutsch; Alin Bernard,0,13,0,0
1668487081329,CSE 239B,A00,102385,Polikarpova; Nadezhda,0,10,0,0
1668487081760,CSE 240A,A00,102386,Pannuto; Patrick William,0,44,0,0
1668487082193,CSE 240B,A00,102387,Zhao; Jishen,0,42,0,0
1668487082616,CSE 241A,A00,106406,Kang; Mingu,0,7,0,0
1668487083046,CSE 249B,A00,102388,Kahng; Andrew Byun,0,5,8,8
1668487083475,CSE 251B,A01,102392,Cottrell; Garrison W,0,46,0,0
1668487083475,CSE 251B,A02,102393,Cottrell; Garrison W,0,33,0,0
1668487083901,CSE 252B,A00,102394,Ochoa; Benjamin Lawrence,0,58,0,0
1668487084324,CSE 257,A01,102396,Gao; Sicun,0,132,0,0
1668487084750,CSE 272,A00,102397,Li; Tzumao,0,17,0,0
1668487085173,CSE 274,A00,111323,Chern; Albert Ren-Haur,0,15,0,0
1668487085597,CSE 282,A00,102398,Pevzner; Pavel Arkadjevich,0,0,0,0
1668487086031,CSE 284,A00,114175,Gymrek; Melissa Ann,0,22,0,0
1668487086460,CSE 290,A00,102399,Chandraker; Manmohan Krishna,0,11,0,0
1668487086460,CSE 290,B00,102400,Vaccaro; Kristen Marie,0,7,25,25
1668487086460,CSE 290,C00,102414,Pannuto; Patrick William,0,1,25,25
1668487086460,CSE 290,D00,102427,Pevzner; Pavel Arkadjevich,0,0,0,0
1668487086460,CSE 290,E00,102429,Zhao; Jishen,0,4,0,0
1668487086460,CSE 290,F00,102436,Tullsen; Dean Michael,0,5,0,0
1668487086460,CSE 290,G00,102440,Christensen; Henrik I,0,6,20,20
1668487086890,CSE 291,A00,102443,Su; Hao,0,0,0,0
1668487086890,CSE 291,B00,102448,Polikarpova; Nadezhda,0,0,0,0
1668487086890,CSE 291,C00,102453,Vaccaro; Kristen Marie,0,0,0,0
1668487086890,CSE 291,D00,111343,Savage; Stefan,0,0,0,0
1668487086890,CSE 291,E00,116474,Claffy; Kimberly Claire,0,0,0,0
1668487086890,CSE 291,F00,116479,Pasquale; Joseph,0,0,0,0
1668487087319,CSE 293,001,119111,Bafna; Vineet,9999,0,9999,0
1668487087319,CSE 293,002,119118,Bellare; Mihir,9999,0,9999,0
1668487087319,CSE 293,003,119122,Berg-Kirkpatrick; Taylor D,9999,0,9999,0
1668487087319,CSE 293,004,119135,Christensen; Henrik I,9999,0,9999,0
1668487087319,CSE 293,005,119142,Cottrell; Garrison W,9999,0,9999,0
1668487087319,CSE 293,006,119146,Deutsch; Alin Bernard,9999,0,9999,0
1668487087319,CSE 293,007,119159,Esmaeilzadeh; Hadi,9999,0,9999,0
1668487087319,CSE 293,008,119166,Freund; Yoav,9999,0,9999,0
1668487087319,CSE 293,009,119170,Griswold; William G.,9999,0,9999,0
1668487087319,CSE 293,010,119183,Gymrek; Melissa Ann,9999,0,9999,0
1668487087319,CSE 293,011,119190,Heninger; Nadia A,9999,0,9999,0
1668487087319,CSE 293,012,119230,Impagliazzo; Russell,9999,0,9999,0
1668487087319,CSE 293,013,119232,Jhala; Ranjit,9999,0,9999,0
1668487087319,CSE 293,014,119233,Kahng; Andrew Byun,9999,0,9999,0
1668487087319,CSE 293,015,119298,Kane; Daniel Mertz,9999,0,9999,0
1668487087319,CSE 293,016,119299,Kriegman; David J,9999,0,9999,0
1668487087319,CSE 293,017,119300,Kumar; Arun Kumar,9999,0,9999,0
1668487087319,CSE 293,018,119301,Lerner; Sorin,9999,0,9999,0
1668487087319,CSE 293,019,119302,Lovett; Shachar,9999,0,9999,0
1668487087319,CSE 293,020,119303,McAuley; Julian John,9999,0,9999,0
1668487087319,CSE 293,021,119304,Micciancio; Daniele,9999,0,9999,0
1668487087319,CSE 293,022,119367,Orailoglu; Alex,9999,0,9999,0
1668487087319,CSE 293,023,119382,Paturi; Ramamohan,9999,0,9999,0
1668487087319,CSE 293,024,119404,Polikarpova; Nadezhda,9999,0,9999,0
1668487087319,CSE 293,025,119406,Politz; Joseph Gibbs,9999,0,9999,0
1668487087319,CSE 293,026,119411,Porter; George M,9999,0,9999,0
1668487087319,CSE 293,027,119414,Porter; Leonard Emerson,9999,0,9999,0
1668487087319,CSE 293,028,119416,Ramamoorthi; Ravi,9999,0,9999,0
1668487087319,CSE 293,029,119417,Sahoo; Debashis,9999,0,9999,0
1668487087319,CSE 293,030,119420,Saul; Lawrence,9999,0,9999,0
1668487087319,CSE 293,031,119421,Savage; Stefan,9999,0,9999,0
1668487087319,CSE 293,032,119425,Schulze; Jurgen P.,9999,0,9999,0
1668487087319,CSE 293,033,119426,Snoeren; Alex C.,9999,0,9999,0
1668487087319,CSE 293,034,119428,Shang; Jingbo,9999,0,9999,0
1668487087319,CSE 293,035,119430,Stefan; Deian,9999,0,9999,0
1668487087319,CSE 293,036,119431,Su; Hao,9999,0,9999,0
1668487087319,CSE 293,037,119433,Swanson; Steven James,9999,0,9999,0
1668487087319,CSE 293,038,119435,Tullsen; Dean Michael,9999,0,9999,0
1668487087319,CSE 293,039,119483,Voelker; Geoffrey M.,9999,0,9999,0
1668487087319,CSE 293,040,119537,Zhao; Jishen,9999,0,9999,0
1668487087319,CSE 293,041,119538,Zhou; Yuan-Yuan,9999,0,9999,0
1668487087319,CSE 293,042,119539,Gao; Sicun,9999,0,9999,0
1668487087319,CSE 293,043,119540,Weibel; Nadir,9999,0,9999,0
1668487087319,CSE 293,044,119541,Gupta; Rajesh K.,9999,0,9999,0
1668487087319,CSE 293,045,126410,Vaccaro; Kristen Marie,9999,0,9999,0
1668487087319,CSE 293,046,126411,Klemke; Richard,9999,0,9999,0
1668487087749,CSE 294,A00,102459,Voelker; Geoffrey M.,0,2,0,0
1668487087749,CSE 294,B00,111322,Orailoglu; Alex,0,2,0,0
1668487088175,DSE 201,A00,096914,Deutsch; Alin Bernard,30,0,30,0
1668487088618,DSE 210,A00,096915,Dasgupta; Sanjoy,30,0,30,0
1668487089041,DSE 260A,A00,096916,Altintas De Callaf; Ilkay,30,0,30,0
1668487089469,ECE 200,001,103586,Antipa; Nicholas A,9999,0,9999,0
1668487089469,ECE 200,002,103587,Atanasov; Nikolay A.,9999,0,9999,0
1668487089469,ECE 200,003,103588,Bharadia; Dinesh,9999,0,9999,0
1668487089469,ECE 200,004,103589,Cheng; Chung Kuan,9999,0,9999,0
1668487089469,ECE 200,005,103590,Cosman; Pamela C.,9999,0,9999,0
1668487089469,ECE 200,006,103591,Dayeh; Shadi Ahmad,9999,0,9999,0
1668487089469,ECE 200,007,103592,Fainman; Yeshaiahu,9999,0,9999,0
1668487089469,ECE 200,008,103593,Ford; Joseph Earl,9999,0,9999,0
1668487089469,ECE 200,009,103594,Franceschetti; Massimo,9999,0,9999,0
1668487089469,ECE 200,010,103595,Fullerton; Eric E,9999,0,9999,0
1668487089469,ECE 200,011,103596,Galton; Ian A,9999,0,9999,0
1668487089469,ECE 200,012,103597,Gilja; Vikash,9999,0,9999,0
1668487089469,ECE 200,013,103598,Hall; Drew A.,9999,0,9999,0
1668487089469,ECE 200,014,103599,Hsueh; Tzu-Chien,9999,0,9999,0
1668487089469,ECE 200,015,103600,Javidi; Tara,9999,0,9999,0
1668487089469,ECE 200,016,103601,Kahng; Andrew Byun,9999,0,9999,0
1668487089469,ECE 200,017,103602,Kim; Young-Han,9999,0,9999,0
1668487089469,ECE 200,018,103603,Koushanfar; Farinaz,9999,0,9999,0
1668487089469,ECE 200,019,103604,Kuzum; Duygu,9999,0,9999,0
1668487089469,ECE 200,020,103605,Le; Hanh-Phuc,9999,0,9999,0
1668487089469,ECE 200,021,103606,Lin; Bill,9999,0,9999,0
1668487089469,ECE 200,022,103607,Liu; Zhaowei,9998,0,9999,1
1668487089469,ECE 200,023,103608,Lo; Yu-Hwa,9999,0,9999,0
1668487089469,ECE 200,024,103609,Lomakin; Vitaliy,9999,0,9999,0
1668487089469,ECE 200,025,103610,Mercier; Patrick Philip,9999,0,9999,0
1668487089469,ECE 200,026,103611,Meyer; Florian,9999,0,9999,0
1668487089469,ECE 200,027,103612,Milstein; Laurence B.,9999,0,9999,0
1668487089469,ECE 200,028,103613,Mir Arabbaygi; Siavash,9999,0,9999,0
1668487089469,ECE 200,029,103614,Mookherjea; Shayan,9999,0,9999,0
1668487089469,ECE 200,030,103615,Morris; Karcher William,9999,0,9999,0
1668487089469,ECE 200,031,103616,Ng; Tse Nga,9999,0,9999,0
1668487089469,ECE 200,032,103617,Nguyen; Truong Quang,9999,0,9999,0
1668487089469,ECE 200,033,103618,Nomura; Kenji,9999,0,9999,0
1668487089469,ECE 200,034,103619,Orlitsky; Alon,9999,0,9999,0
1668487089469,ECE 200,035,103620,Pal; Piya,9999,0,9999,0
1668487089469,ECE 200,036,103621,Papen; George C.,9999,0,9999,0
1668487089469,ECE 200,037,103622,Radic; Stojan,9999,0,9999,0
1668487089469,ECE 200,038,103623,Rao; Bhaskar D.,9999,0,9999,0
1668487089469,ECE 200,039,103624,Rao; Ramesh R,9999,0,9999,0
1668487089469,ECE 200,040,103625,Rebeiz; Gabriel,9999,0,9999,0
1668487089469,ECE 200,041,103626,Sanford; John R,9999,0,9999,0
1668487089469,ECE 200,042,103627,Siegel; Paul H.,9999,0,9999,0
1668487089469,ECE 200,043,103628,Sievenpiper; Daniel F.,9999,0,9999,0
1668487089469,ECE 200,044,103629,Sworder; David D.,9999,0,9999,0
1668487089469,ECE 200,045,103630,Taur; Yuan,9999,0,9999,0
1668487089469,ECE 200,046,103631,Touri; Behrouz,9999,0,9999,0
1668487089469,ECE 200,047,103632,Trivedi; Mohan M.,9999,0,9999,0
1668487089469,ECE 200,048,103633,Vasconcelos; Nuno,9999,0,9999,0
1668487089469,ECE 200,049,103634,Wang; Xiaolong,9999,0,9999,0
1668487089469,ECE 200,050,103635,Xie; Pengtao,9999,0,9999,0
1668487089469,ECE 200,051,103636,Yip; Michael,9999,0,9999,0
1668487089469,ECE 200,052,103637,Zeger; Kenneth A.,999,0,999,0
1668487089469,ECE 200,053,103638,Zhang; Xinyu,9999,0,9999,0
1668487089469,ECE 200,054,103639,Turakhia; Yatish Girish,9999,0,9999,0
1668487089469,ECE 200,055,103640,Kang; Mingu,9999,0,9999,0
1668487089469,ECE 200,056,103641,Shi; Yuanyuan,9999,0,9999,0
1668487089469,ECE 200,057,103642,Wang; Edward Jay,9999,0,9999,0
1668487089469,ECE 200,058,103643,Zheng; Yang,9999,0,9999,0
1668487089892,ECE 202,A00,103644,Kuzum; Duygu,0,43,0,0
1668487090332,ECE 212BN,A00,103646,Ng; Tse Nga,0,9,0,0
1668487090758,ECE 221,A00,111493,Staff,0,0,0,0
1668487091182,ECE 222B,A00,103647,Lomakin; Vitaliy,0,18,0,0
1668487091619,ECE 230B,A00,103648,Taur; Yuan,0,2,0,0
1668487092053,ECE 238B,A00,103649,Garay; Javier,0,0,0,0
1668487092478,ECE 240B,A00,112900,Fainman; Yeshaiahu,0,7,0,0
1668487092906,ECE 247A,A00,103650,Jokerst; Jesse Vincent,0,6,0,0
1668487093332,ECE 247B,A00,103651,Wang; Joseph,0,13,0,0
1668487093756,ECE 250,A00,103652,Siegel; Paul H.,0,82,0,0
1668487094178,ECE 251A,A00,103654,Rao; Bhaskar D.,0,61,0,0
1668487094605,ECE 257B,A00,103655,Bharadia; Dinesh,0,32,0,0
1668487095040,ECE 258A,A00,103656,Milstein; Laurence B.,0,28,0,0
1668487095469,ECE 260B,A00,103658,Kang; Mingu,0,119,0,0
1668487095896,ECE 264A,A00,103659,Galton; Ian A,0,66,0,0
1668487096319,ECE 265A,A00,103661,Gudem; Prasad S.S.,0,66,0,0
1668487096751,ECE 265D,A00,103662,Gudem; Prasad S.S.,0,24,0,0
1668487097174,ECE 268,A00,103663,Koushanfar; Farinaz,0,42,0,0
1668487097598,ECE 269,A01,103665,Pal; Piya,0,211,0,0
1668487098026,ECE 271B,A00,103666,Vasconcelos; Manuela,0,74,0,0
1668487098455,ECE 276A,A00,103667,Atanasov; Nikolay A.,0,123,0,0
1668487098882,ECE 277,A00,103668,An; Cheolhong,0,145,0,0
1668487099314,ECE 279,A00,117947,Hall; Drew A.,0,22,0,0
1668487100169,ECE 283,A00,103670,Hsueh; Tzu-Chien,0,51,0,0
1668487100599,ECE 284,A00,103671,Turakhia; Yatish Girish,0,39,0,0
1668487101023,ECE 285,A00,103672,Zheng; Yang,0,39,0,0
1668487101023,ECE 285,B00,103673,Sworder; David D.,0,56,0,0
1668487101447,ECE 287,A00,103676,Javidi; Tara,0,8,0,0
1668487101874,MATH 200B,A00,098023,Salehi Golsefidy; Alireza,10,0,15,5
1668487102298,MATH 202B,A00,098024,Rhoades; Brendon Patrick,7,0,15,8
1668487102721,MATH 203B,A00,098025,Oprea; Dragos N.,9,0,15,6
1668487103148,MATH 204B,A00,098026,Sorensen; Claus M,13,0,15,2
1668487103572,MATH 208,A00,098027,Izadi; Elham,7,0,10,3
1668487103997,MATH 209,A00,098028,Pollack; Aaron,10,0,10,0
1668487104421,MATH 211A,A00,112919,Rogalski; Daniel,8,0,10,2
1668487104853,MATH 211B,A00,112920,Seward; Brandon M.,9,0,10,1
1668487105275,MATH 218,A00,098029,Li; Bo,10,0,10,0
1668487105703,MATH 220B,A00,098030,Novak; Jonathan I,11,0,15,4
1668487106129,MATH 221A,A00,098031,Ebenfelt; Peter F,12,0,15,3
1668487106551,MATH 231B,A00,098032,Zlatos; Andrej,11,0,15,4
1668487106978,MATH 240B,A00,098033,Ni; Lei,7,0,15,8
1668487107417,MATH 243,A00,098034,Jekel; David Andrew,10,0,10,0
1668487107845,MATH 245A,A00,098035,Nie; Jiawang,0,4,15,18
1668487108277,MATH 248,A00,098036,Bejenaru; Ioan,10,0,10,0
1668487108700,MATH 250B,A00,098037,Spolaor; Luca,14,0,15,1
1668487109124,MATH 258,A00,098038,Ni; Lei,9,0,10,1
1668487109548,MATH 264B,A00,098041,Rhoades; Brendon Patrick,8,0,15,7
1668487109974,MATH 268,A00,098042,Buss; Samuel R,10,0,10,0
1668487110399,MATH 269,A00,098043,Rhoades; Brendon Patrick,10,0,10,0
1668487110826,MATH 270B,A00,098044,Li; Bo,6,0,15,9
1668487111249,MATH 272B,A00,098045,Holst; Michael J,13,0,15,2
1668487111672,MATH 273A,A00,098046,Tian; Xiaochuan,10,0,15,5
1668487112094,MATH 275,A01,098048,Tian; Xiaochuan,6,0,10,4
1668487112523,MATH 278A,A00,098049,Holst; Michael J,7,0,10,3
1668487112966,MATH 278B,A00,098050,Cloninger; Alexander,10,0,10,0
1668487113398,MATH 278C,A00,098051,Nie; Jiawang,5,0,10,5
1668487113831,MATH 280B,A00,098052,Zheng; Tianyi,7,0,15,8
1668487114257,MATH 281B,A00,098053,Bradic; Jelena,0,2,15,15
1668487114778,MATH 282B,A00,098054,Arias-Castro; Ery,0,1,15,15
1668487115207,MATH 285,A00,098055,Fitzsimmons; Patrick J,0,2,15,17
1668487115631,MATH 287B,A00,098056,Arias-Castro; Ery,1,0,15,14
1668487116060,MATH 288,A00,098057,Agarwal; Pooja,9,0,10,1
1668487116060,MATH 288,B00,098058,Zhang; Danna,8,0,10,2
1668487116060,MATH 288,C00,098059,Williams; Ruth J,9,0,10,1
1668487116492,MATH 290B,A00,098060,Roberts; Justin Deritter,12,0,15,3
1668487116926,MATH 292,A00,098061,Belmont; Eva Kinoshita,10,0,10,0
1668487117360,MATH 295,A00,098062,Suk; Andrew Hoon,47,0,50,3
1668487117784,MATH 296,A00,098063,Novak; Jonathan I,20,0,20,0
1668487118210,MATH 297,001,098064,Gamst; Anthony Collins,9997,0,9999,2
1668487619043,COGS 205,A00,101395,Chiba; Andrea,19,0,20,1
1668487619467,COGS 210B,001,101404,Greene; Deanna Jacquelyn,9998,0,9999,1
1668487619467,COGS 210B,002,101417,Xia; Haijun,9999,0,9999,0
1668487619467,COGS 210B,003,101422,Nitz; Douglas A.,9999,0,9999,0
1668487619467,COGS 210B,004,101423,Hollan; James D.,9998,0,9999,1
1668487619467,COGS 210B,005,101424,Deak; Gedeon O.,9998,0,9999,1
1668487619467,COGS 210B,006,101425,Rossano; Federico,9999,0,9999,0
1668487619894,COGS 211B,A00,101427,Coulson; Seana M,9996,0,9999,3
1668487620327,COGS 220,A00,101428,Hollan; James D.,1,11,25,24
1668487620753,COGS 229,A00,101429,Dow; Steven P,17,0,25,8
1668487621177,COGS 230,A00,101430,Klemmer; Scott R,8,0,17,9
1668487621608,COGS 234,A00,101431,Xia; Haijun,2,0,25,23
1668487622034,COGS 260,A00,101432,Kiyonaga; Anastasia,21,0,25,4
1668487622034,COGS 260,B00,101433,Kirsh; David Joel,15,0,25,10
1668487622466,CSE 202,A00,102371,Impagliazzo; Russell,0,63,0,0
1668487622892,CSE 203B,A01,102373,Cheng; Chung Kuan,0,52,0,0
1668487623318,CSE 208,A00,102374,Micciancio; Daniele,0,5,0,0
1668487623740,CSE 209A,A00,112895,Impagliazzo; Russell,0,12,15,15
1668487624169,CSE 209B,A00,108005,Bellare; Mihir,0,6,0,0
1668487624597,CSE 210,A00,113163,Coblenz; Michael J,0,80,0,0
1668487625030,CSE 219,A00,106111,Dow; Steven P,0,6,20,20
1668487625455,CSE 221,A00,102376,Voelker; Geoffrey M.,0,70,0,0
1668487625879,CSE 224,A01,102378,Porter; George M,0,160,0,0
1668487626305,CSE 229A,A00,102379,Savage; Stefan,0,10,0,0
1668487626729,CSE 229C,A00,102380,Munyaka; Imani N. S.,0,10,0,0
1668487627151,CSE 232B,A00,102382,Deutsch; Alin Bernard,0,31,0,0
1668487627575,CSE 234,A01,112904,Kumar; Arun Kumar,0,0,0,0
1668487628008,CSE 237A,A00,102383,Rosing; Tajana Simunic,0,50,0,0
1668487628435,CSE 239A,A00,102384,Deutsch; Alin Bernard,0,13,0,0
1668487628857,CSE 239B,A00,102385,Polikarpova; Nadezhda,0,10,0,0
1668487629283,CSE 240A,A00,102386,Pannuto; Patrick William,0,44,0,0
1668487629706,CSE 240B,A00,102387,Zhao; Jishen,0,42,0,0
1668487630130,CSE 241A,A00,106406,Kang; Mingu,0,7,0,0
1668487630554,CSE 249B,A00,102388,Kahng; Andrew Byun,0,5,8,8
1668487630978,CSE 251B,A01,102392,Cottrell; Garrison W,0,46,0,0
1668487630978,CSE 251B,A02,102393,Cottrell; Garrison W,0,34,0,0
1668487631405,CSE 252B,A00,102394,Ochoa; Benjamin Lawrence,0,58,0,0
1668487631833,CSE 257,A01,102396,Gao; Sicun,0,133,0,0
1668487632261,CSE 272,A00,102397,Li; Tzumao,0,17,0,0
1668487632685,CSE 274,A00,111323,Chern; Albert Ren-Haur,0,15,0,0
1668487633115,CSE 282,A00,102398,Pevzner; Pavel Arkadjevich,0,0,0,0
1668487633538,CSE 284,A00,114175,Gymrek; Melissa Ann,0,22,0,0
1668487633967,CSE 290,A00,102399,Chandraker; Manmohan Krishna,0,11,0,0
1668487633967,CSE 290,B00,102400,Vaccaro; Kristen Marie,0,7,25,25
1668487633967,CSE 290,C00,102414,Pannuto; Patrick William,0,1,25,25
1668487633967,CSE 290,D00,102427,Pevzner; Pavel Arkadjevich,0,0,0,0
1668487633967,CSE 290,E00,102429,Zhao; Jishen,0,4,0,0
1668487633967,CSE 290,F00,102436,Tullsen; Dean Michael,0,5,0,0
1668487633967,CSE 290,G00,102440,Christensen; Henrik I,0,6,20,20
1668487634482,CSE 291,A00,102443,Su; Hao,0,0,0,0
1668487634482,CSE 291,B00,102448,Polikarpova; Nadezhda,0,0,0,0
1668487634482,CSE 291,C00,102453,Vaccaro; Kristen Marie,0,0,0,0
1668487634482,CSE 291,D00,111343,Savage; Stefan,0,0,0,0
1668487634482,CSE 291,E00,116474,Claffy; Kimberly Claire,0,0,0,0
1668487634482,CSE 291,F00,116479,Pasquale; Joseph,0,0,0,0
1668487634924,CSE 293,001,119111,Bafna; Vineet,9999,0,9999,0
1668487634924,CSE 293,002,119118,Bellare; Mihir,9999,0,9999,0
1668487634924,CSE 293,003,119122,Berg-Kirkpatrick; Taylor D,9999,0,9999,0
1668487634924,CSE 293,004,119135,Christensen; Henrik I,9999,0,9999,0
1668487634924,CSE 293,005,119142,Cottrell; Garrison W,9999,0,9999,0
1668487634924,CSE 293,006,119146,Deutsch; Alin Bernard,9999,0,9999,0
1668487634924,CSE 293,007,119159,Esmaeilzadeh; Hadi,9999,0,9999,0
1668487634924,CSE 293,008,119166,Freund; Yoav,9999,0,9999,0
1668487634924,CSE 293,009,119170,Griswold; William G.,9999,0,9999,0
1668487634924,CSE 293,010,119183,Gymrek; Melissa Ann,9999,0,9999,0
1668487634924,CSE 293,011,119190,Heninger; Nadia A,9999,0,9999,0
1668487634924,CSE 293,012,119230,Impagliazzo; Russell,9999,0,9999,0
1668487634924,CSE 293,013,119232,Jhala; Ranjit,9999,0,9999,0
1668487634924,CSE 293,014,119233,Kahng; Andrew Byun,9999,0,9999,0
1668487634924,CSE 293,015,119298,Kane; Daniel Mertz,9999,0,9999,0
1668487634924,CSE 293,016,119299,Kriegman; David J,9999,0,9999,0
1668487634924,CSE 293,017,119300,Kumar; Arun Kumar,9999,0,9999,0
1668487634924,CSE 293,018,119301,Lerner; Sorin,9999,0,9999,0
1668487634924,CSE 293,019,119302,Lovett; Shachar,9999,0,9999,0
1668487634924,CSE 293,020,119303,McAuley; Julian John,9999,0,9999,0
1668487634924,CSE 293,021,119304,Micciancio; Daniele,9999,0,9999,0
1668487634924,CSE 293,022,119367,Orailoglu; Alex,9999,0,9999,0
1668487634924,CSE 293,023,119382,Paturi; Ramamohan,9999,0,9999,0
1668487634924,CSE 293,024,119404,Polikarpova; Nadezhda,9999,0,9999,0
1668487634924,CSE 293,025,119406,Politz; Joseph Gibbs,9999,0,9999,0
1668487634924,CSE 293,026,119411,Porter; George M,9999,0,9999,0
1668487634924,CSE 293,027,119414,Porter; Leonard Emerson,9999,0,9999,0
1668487634924,CSE 293,028,119416,Ramamoorthi; Ravi,9999,0,9999,0
1668487634924,CSE 293,029,119417,Sahoo; Debashis,9999,0,9999,0
1668487634924,CSE 293,030,119420,Saul; Lawrence,9999,0,9999,0
1668487634924,CSE 293,031,119421,Savage; Stefan,9999,0,9999,0
1668487634924,CSE 293,032,119425,Schulze; Jurgen P.,9999,0,9999,0
1668487634924,CSE 293,033,119426,Snoeren; Alex C.,9999,0,9999,0
1668487634924,CSE 293,034,119428,Shang; Jingbo,9999,0,9999,0
1668487634924,CSE 293,035,119430,Stefan; Deian,9999,0,9999,0
1668487634924,CSE 293,036,119431,Su; Hao,9999,0,9999,0
1668487634924,CSE 293,037,119433,Swanson; Steven James,9999,0,9999,0
1668487634924,CSE 293,038,119435,Tullsen; Dean Michael,9999,0,9999,0
1668487634924,CSE 293,039,119483,Voelker; Geoffrey M.,9999,0,9999,0
1668487634924,CSE 293,040,119537,Zhao; Jishen,9999,0,9999,0
1668487634924,CSE 293,041,119538,Zhou; Yuan-Yuan,9999,0,9999,0
1668487634924,CSE 293,042,119539,Gao; Sicun,9999,0,9999,0
1668487634924,CSE 293,043,119540,Weibel; Nadir,9999,0,9999,0
1668487634924,CSE 293,044,119541,Gupta; Rajesh K.,9999,0,9999,0
1668487634924,CSE 293,045,126410,Vaccaro; Kristen Marie,9999,0,9999,0
1668487634924,CSE 293,046,126411,Klemke; Richard,9999,0,9999,0
1668487635348,CSE 294,A00,102459,Voelker; Geoffrey M.,0,2,0,0
1668487635348,CSE 294,B00,111322,Orailoglu; Alex,0,2,0,0
1668487635770,DSE 201,A00,096914,Deutsch; Alin Bernard,30,0,30,0
1668487636195,DSE 210,A00,096915,Dasgupta; Sanjoy,30,0,30,0
1668487636621,DSE 260A,A00,096916,Altintas De Callaf; Ilkay,30,0,30,0
1668487637057,ECE 200,001,103586,Antipa; Nicholas A,9999,0,9999,0
1668487637057,ECE 200,002,103587,Atanasov; Nikolay A.,9999,0,9999,0
1668487637057,ECE 200,003,103588,Bharadia; Dinesh,9999,0,9999,0
1668487637057,ECE 200,004,103589,Cheng; Chung Kuan,9999,0,9999,0
1668487637057,ECE 200,005,103590,Cosman; Pamela C.,9999,0,9999,0
1668487637057,ECE 200,006,103591,Dayeh; Shadi Ahmad,9999,0,9999,0
1668487637057,ECE 200,007,103592,Fainman; Yeshaiahu,9999,0,9999,0
1668487637057,ECE 200,008,103593,Ford; Joseph Earl,9999,0,9999,0
1668487637057,ECE 200,009,103594,Franceschetti; Massimo,9999,0,9999,0
1668487637057,ECE 200,010,103595,Fullerton; Eric E,9999,0,9999,0
1668487637057,ECE 200,011,103596,Galton; Ian A,9999,0,9999,0
1668487637057,ECE 200,012,103597,Gilja; Vikash,9999,0,9999,0
1668487637057,ECE 200,013,103598,Hall; Drew A.,9999,0,9999,0
1668487637057,ECE 200,014,103599,Hsueh; Tzu-Chien,9999,0,9999,0
1668487637057,ECE 200,015,103600,Javidi; Tara,9999,0,9999,0
1668487637057,ECE 200,016,103601,Kahng; Andrew Byun,9999,0,9999,0
1668487637057,ECE 200,017,103602,Kim; Young-Han,9999,0,9999,0
1668487637057,ECE 200,018,103603,Koushanfar; Farinaz,9999,0,9999,0
1668487637057,ECE 200,019,103604,Kuzum; Duygu,9999,0,9999,0
1668487637057,ECE 200,020,103605,Le; Hanh-Phuc,9999,0,9999,0
1668487637057,ECE 200,021,103606,Lin; Bill,9999,0,9999,0
1668487637057,ECE 200,022,103607,Liu; Zhaowei,9998,0,9999,1
1668487637057,ECE 200,023,103608,Lo; Yu-Hwa,9999,0,9999,0
1668487637057,ECE 200,024,103609,Lomakin; Vitaliy,9999,0,9999,0
1668487637057,ECE 200,025,103610,Mercier; Patrick Philip,9999,0,9999,0
1668487637057,ECE 200,026,103611,Meyer; Florian,9999,0,9999,0
1668487637057,ECE 200,027,103612,Milstein; Laurence B.,9999,0,9999,0
1668487637057,ECE 200,028,103613,Mir Arabbaygi; Siavash,9999,0,9999,0
1668487637057,ECE 200,029,103614,Mookherjea; Shayan,9999,0,9999,0
1668487637057,ECE 200,030,103615,Morris; Karcher William,9999,0,9999,0
1668487637057,ECE 200,031,103616,Ng; Tse Nga,9999,0,9999,0
1668487637057,ECE 200,032,103617,Nguyen; Truong Quang,9999,0,9999,0
1668487637057,ECE 200,033,103618,Nomura; Kenji,9999,0,9999,0
1668487637057,ECE 200,034,103619,Orlitsky; Alon,9999,0,9999,0
1668487637057,ECE 200,035,103620,Pal; Piya,9999,0,9999,0
1668487637057,ECE 200,036,103621,Papen; George C.,9999,0,9999,0
1668487637057,ECE 200,037,103622,Radic; Stojan,9999,0,9999,0
1668487637057,ECE 200,038,103623,Rao; Bhaskar D.,9999,0,9999,0
1668487637057,ECE 200,039,103624,Rao; Ramesh R,9999,0,9999,0
1668487637057,ECE 200,040,103625,Rebeiz; Gabriel,9999,0,9999,0
1668487637057,ECE 200,041,103626,Sanford; John R,9999,0,9999,0
1668487637057,ECE 200,042,103627,Siegel; Paul H.,9999,0,9999,0
1668487637057,ECE 200,043,103628,Sievenpiper; Daniel F.,9999,0,9999,0
1668487637057,ECE 200,044,103629,Sworder; David D.,9999,0,9999,0
1668487637057,ECE 200,045,103630,Taur; Yuan,9999,0,9999,0
1668487637057,ECE 200,046,103631,Touri; Behrouz,9999,0,9999,0
1668487637057,ECE 200,047,103632,Trivedi; Mohan M.,9999,0,9999,0
1668487637057,ECE 200,048,103633,Vasconcelos; Nuno,9999,0,9999,0
1668487637057,ECE 200,049,103634,Wang; Xiaolong,9999,0,9999,0
1668487637057,ECE 200,050,103635,Xie; Pengtao,9999,0,9999,0
1668487637057,ECE 200,051,103636,Yip; Michael,9999,0,9999,0
1668487637057,ECE 200,052,103637,Zeger; Kenneth A.,999,0,999,0
1668487637057,ECE 200,053,103638,Zhang; Xinyu,9999,0,9999,0
1668487637057,ECE 200,054,103639,Turakhia; Yatish Girish,9999,0,9999,0
1668487637057,ECE 200,055,103640,Kang; Mingu,9999,0,9999,0
1668487637057,ECE 200,056,103641,Shi; Yuanyuan,9999,0,9999,0
1668487637057,ECE 200,057,103642,Wang; Edward Jay,9999,0,9999,0
1668487637057,ECE 200,058,103643,Zheng; Yang,9999,0,9999,0
1668487637480,ECE 202,A00,103644,Kuzum; Duygu,0,43,0,0
1668487637903,ECE 212BN,A00,103646,Ng; Tse Nga,0,9,0,0
1668487638335,ECE 221,A00,111493,Staff,0,0,0,0
1668487638768,ECE 222B,A00,103647,Lomakin; Vitaliy,0,18,0,0
1668487639191,ECE 230B,A00,103648,Taur; Yuan,0,2,0,0
1668487639614,ECE 238B,A00,103649,Garay; Javier,0,0,0,0
1668487640036,ECE 240B,A00,112900,Fainman; Yeshaiahu,0,7,0,0
1668487640461,ECE 247A,A00,103650,Jokerst; Jesse Vincent,0,6,0,0
1668487640884,ECE 247B,A00,103651,Wang; Joseph,0,13,0,0
1668487641307,ECE 250,A00,103652,Siegel; Paul H.,0,82,0,0
1668487641730,ECE 251A,A00,103654,Rao; Bhaskar D.,0,61,0,0
1668487642156,ECE 257B,A00,103655,Bharadia; Dinesh,0,32,0,0
1668487642582,ECE 258A,A00,103656,Milstein; Laurence B.,0,28,0,0
1668487643009,ECE 260B,A00,103658,Kang; Mingu,0,119,0,0
1668487643434,ECE 264A,A00,103659,Galton; Ian A,0,66,0,0
1668487643861,ECE 265A,A00,103661,Gudem; Prasad S.S.,0,67,0,0
1668487644284,ECE 265D,A00,103662,Gudem; Prasad S.S.,0,24,0,0
1668487644708,ECE 268,A00,103663,Koushanfar; Farinaz,0,42,0,0
1668487645132,ECE 269,A01,103665,Pal; Piya,0,211,0,0
1668487645560,ECE 271B,A00,103666,Vasconcelos; Manuela,0,74,0,0
1668487645990,ECE 276A,A00,103667,Atanasov; Nikolay A.,0,123,0,0
1668487646428,ECE 277,A00,103668,An; Cheolhong,0,145,0,0
1668487646853,ECE 279,A00,117947,Hall; Drew A.,0,22,0,0
1668487647710,ECE 283,A00,103670,Hsueh; Tzu-Chien,0,51,0,0
1668487648137,ECE 284,A00,103671,Turakhia; Yatish Girish,0,39,0,0
1668487648564,ECE 285,A00,103672,Zheng; Yang,0,39,0,0
1668487648564,ECE 285,B00,103673,Sworder; David D.,0,56,0,0
1668487648989,ECE 287,A00,103676,Javidi; Tara,0,8,0,0
1668487649416,MATH 200B,A00,098023,Salehi Golsefidy; Alireza,10,0,15,5
1668487649839,MATH 202B,A00,098024,Rhoades; Brendon Patrick,7,0,15,8
1668487650264,MATH 203B,A00,098025,Oprea; Dragos N.,9,0,15,6
1668487650686,MATH 204B,A00,098026,Sorensen; Claus M,13,0,15,2
1668487651118,MATH 208,A00,098027,Izadi; Elham,7,0,10,3
1668487651540,MATH 209,A00,098028,Pollack; Aaron,10,0,10,0
1668487651965,MATH 211A,A00,112919,Rogalski; Daniel,8,0,10,2
1668487652388,MATH 211B,A00,112920,Seward; Brandon M.,9,0,10,1
1668487652814,MATH 218,A00,098029,Li; Bo,10,0,10,0
1668487653241,MATH 220B,A00,098030,Novak; Jonathan I,11,0,15,4
1668487653665,MATH 221A,A00,098031,Ebenfelt; Peter F,12,0,15,3
1668487654088,MATH 231B,A00,098032,Zlatos; Andrej,11,0,15,4
1668487654516,MATH 240B,A00,098033,Ni; Lei,7,0,15,8
1668487654939,MATH 243,A00,098034,Jekel; David Andrew,10,0,10,0
1668487655365,MATH 245A,A00,098035,Nie; Jiawang,0,4,15,18
1668487655787,MATH 248,A00,098036,Bejenaru; Ioan,10,0,10,0
1668487656213,MATH 250B,A00,098037,Spolaor; Luca,14,0,15,1
1668487656640,MATH 258,A00,098038,Ni; Lei,9,0,10,1
1668487657063,MATH 264B,A00,098041,Rhoades; Brendon Patrick,8,0,15,7
1668487657488,MATH 268,A00,098042,Buss; Samuel R,10,0,10,0
1668487657913,MATH 269,A00,098043,Rhoades; Brendon Patrick,10,0,10,0
1668487658340,MATH 270B,A00,098044,Li; Bo,6,0,15,9
1668487658763,MATH 272B,A00,098045,Holst; Michael J,13,0,15,2
1668487659188,MATH 273A,A00,098046,Tian; Xiaochuan,10,0,15,5
1668487659612,MATH 275,A01,098048,Tian; Xiaochuan,6,0,10,4
1668487660048,MATH 278A,A00,098049,Holst; Michael J,7,0,10,3
1668487660473,MATH 278B,A00,098050,Cloninger; Alexander,10,0,10,0
1668487660899,MATH 278C,A00,098051,Nie; Jiawang,5,0,10,5
1668487661322,MATH 280B,A00,098052,Zheng; Tianyi,7,0,15,8
1668487661748,MATH 281B,A00,098053,Bradic; Jelena,0,2,15,15
1668487662181,MATH 282B,A00,098054,Arias-Castro; Ery,0,1,15,15
1668487662613,MATH 285,A00,098055,Fitzsimmons; Patrick J,0,2,15,17
1668487663037,MATH 287B,A00,098056,Arias-Castro; Ery,1,0,15,14
1668487663472,MATH 288,A00,098057,Agarwal; Pooja,9,0,10,1
1668487663472,MATH 288,B00,098058,Zhang; Danna,8,0,10,2
1668487663472,MATH 288,C00,098059,Williams; Ruth J,9,0,10,1
1668487663896,MATH 290B,A00,098060,Roberts; Justin Deritter,12,0,15,3
1668487664321,MATH 292,A00,098061,Belmont; Eva Kinoshita,10,0,10,0
1668487664747,MATH 295,A00,098062,Suk; Andrew Hoon,47,0,50,3
1668487665169,MATH 296,A00,098063,Novak; Jonathan I,20,0,20,0
1668487665597,MATH 297,001,098064,Gamst; Anthony Collins,9997,0,9999,2
1668488166477,COGS 205,A00,101395,Chiba; Andrea,19,0,20,1
1668488166904,COGS 210B,001,101404,Greene; Deanna Jacquelyn,9998,0,9999,1
1668488166904,COGS 210B,002,101417,Xia; Haijun,9999,0,9999,0
1668488166904,COGS 210B,003,101422,Nitz; Douglas A.,9999,0,9999,0
1668488166904,COGS 210B,004,101423,Hollan; James D.,9998,0,9999,1
1668488166904,COGS 210B,005,101424,Deak; Gedeon O.,9998,0,9999,1
1668488166904,COGS 210B,006,101425,Rossano; Federico,9999,0,9999,0
1668488167328,COGS 211B,A00,101427,Coulson; Seana M,9996,0,9999,3
1668488167754,COGS 220,A00,101428,Hollan; James D.,1,11,25,24
1668488168180,COGS 229,A00,101429,Dow; Steven P,17,0,25,8
1668488168603,COGS 230,A00,101430,Klemmer; Scott R,8,0,17,9
1668488169033,COGS 234,A00,101431,Xia; Haijun,2,0,25,23
1668488169460,COGS 260,A00,101432,Kiyonaga; Anastasia,21,0,25,4
1668488169460,COGS 260,B00,101433,Kirsh; David Joel,15,0,25,10
1668488169883,CSE 202,A00,102371,Impagliazzo; Russell,0,63,0,0
1668488170310,CSE 203B,A01,102373,Cheng; Chung Kuan,0,52,0,0
1668488170740,CSE 208,A00,102374,Micciancio; Daniele,0,5,0,0
1668488171164,CSE 209A,A00,112895,Impagliazzo; Russell,0,12,15,15
1668488171589,CSE 209B,A00,108005,Bellare; Mihir,0,6,0,0
1668488172013,CSE 210,A00,113163,Coblenz; Michael J,0,80,0,0
1668488172440,CSE 219,A00,106111,Dow; Steven P,0,6,20,20
1668488172866,CSE 221,A00,102376,Voelker; Geoffrey M.,0,70,0,0
1668488173290,CSE 224,A01,102378,Porter; George M,0,160,0,0
1668488173717,CSE 229A,A00,102379,Savage; Stefan,0,10,0,0
1668488174140,CSE 229C,A00,102380,Munyaka; Imani N. S.,0,10,0,0
1668488174566,CSE 232B,A00,102382,Deutsch; Alin Bernard,0,31,0,0
1668488174990,CSE 234,A01,112904,Kumar; Arun Kumar,0,0,0,0
1668488175416,CSE 237A,A00,102383,Rosing; Tajana Simunic,0,50,0,0
1668488175838,CSE 239A,A00,102384,Deutsch; Alin Bernard,0,13,0,0
1668488176275,CSE 239B,A00,102385,Polikarpova; Nadezhda,0,10,0,0
1668488176701,CSE 240A,A00,102386,Pannuto; Patrick William,0,44,0,0
1668488177124,CSE 240B,A00,102387,Zhao; Jishen,0,42,0,0
1668488177561,CSE 241A,A00,106406,Kang; Mingu,0,7,0,0
1668488177990,CSE 249B,A00,102388,Kahng; Andrew Byun,0,5,8,8
1668488178414,CSE 251B,A01,102392,Cottrell; Garrison W,0,46,0,0
1668488178414,CSE 251B,A02,102393,Cottrell; Garrison W,0,34,0,0
1668488178836,CSE 252B,A00,102394,Ochoa; Benjamin Lawrence,0,58,0,0
1668488179263,CSE 257,A01,102396,Gao; Sicun,0,133,0,0
1668488179689,CSE 272,A00,102397,Li; Tzumao,0,17,0,0
1668488180120,CSE 274,A00,111323,Chern; Albert Ren-Haur,0,15,0,0
1668488180542,CSE 282,A00,102398,Pevzner; Pavel Arkadjevich,0,0,0,0
1668488180965,CSE 284,A00,114175,Gymrek; Melissa Ann,0,22,0,0
1668488181394,CSE 290,A00,102399,Chandraker; Manmohan Krishna,0,11,0,0
1668488181394,CSE 290,B00,102400,Vaccaro; Kristen Marie,0,7,25,25
1668488181394,CSE 290,C00,102414,Pannuto; Patrick William,0,1,25,25
1668488181394,CSE 290,D00,102427,Pevzner; Pavel Arkadjevich,0,0,0,0
1668488181394,CSE 290,E00,102429,Zhao; Jishen,0,4,0,0
1668488181394,CSE 290,F00,102436,Tullsen; Dean Michael,0,5,0,0
1668488181394,CSE 290,G00,102440,Christensen; Henrik I,0,6,20,20
1668488181828,CSE 291,A00,102443,Su; Hao,0,0,0,0
1668488181828,CSE 291,B00,102448,Polikarpova; Nadezhda,0,0,0,0
1668488181828,CSE 291,C00,102453,Vaccaro; Kristen Marie,0,0,0,0
1668488181828,CSE 291,D00,111343,Savage; Stefan,0,0,0,0
1668488181828,CSE 291,E00,116474,Claffy; Kimberly Claire,0,0,0,0
1668488181828,CSE 291,F00,116479,Pasquale; Joseph,0,0,0,0
1668488182254,CSE 293,001,119111,Bafna; Vineet,9999,0,9999,0
1668488182254,CSE 293,002,119118,Bellare; Mihir,9999,0,9999,0
1668488182254,CSE 293,003,119122,Berg-Kirkpatrick; Taylor D,9999,0,9999,0
1668488182254,CSE 293,004,119135,Christensen; Henrik I,9999,0,9999,0
1668488182254,CSE 293,005,119142,Cottrell; Garrison W,9999,0,9999,0
1668488182254,CSE 293,006,119146,Deutsch; Alin Bernard,9999,0,9999,0
1668488182254,CSE 293,007,119159,Esmaeilzadeh; Hadi,9999,0,9999,0
1668488182254,CSE 293,008,119166,Freund; Yoav,9999,0,9999,0
1668488182254,CSE 293,009,119170,Griswold; William G.,9999,0,9999,0
1668488182254,CSE 293,010,119183,Gymrek; Melissa Ann,9999,0,9999,0
1668488182254,CSE 293,011,119190,Heninger; Nadia A,9999,0,9999,0
1668488182254,CSE 293,012,119230,Impagliazzo; Russell,9999,0,9999,0
1668488182254,CSE 293,013,119232,Jhala; Ranjit,9999,0,9999,0
1668488182254,CSE 293,014,119233,Kahng; Andrew Byun,9999,0,9999,0
1668488182254,CSE 293,015,119298,Kane; Daniel Mertz,9999,0,9999,0
1668488182254,CSE 293,016,119299,Kriegman; David J,9999,0,9999,0
1668488182254,CSE 293,017,119300,Kumar; Arun Kumar,9999,0,9999,0
1668488182254,CSE 293,018,119301,Lerner; Sorin,9999,0,9999,0
1668488182254,CSE 293,019,119302,Lovett; Shachar,9999,0,9999,0
1668488182254,CSE 293,020,119303,McAuley; Julian John,9999,0,9999,0
1668488182254,CSE 293,021,119304,Micciancio; Daniele,9999,0,9999,0
1668488182254,CSE 293,022,119367,Orailoglu; Alex,9999,0,9999,0
1668488182254,CSE 293,023,119382,Paturi; Ramamohan,9999,0,9999,0
1668488182254,CSE 293,024,119404,Polikarpova; Nadezhda,9999,0,9999,0
1668488182254,CSE 293,025,119406,Politz; Joseph Gibbs,9999,0,9999,0
1668488182254,CSE 293,026,119411,Porter; George M,9999,0,9999,0
1668488182254,CSE 293,027,119414,Porter; Leonard Emerson,9999,0,9999,0
1668488182254,CSE 293,028,119416,Ramamoorthi; Ravi,9999,0,9999,0
1668488182254,CSE 293,029,119417,Sahoo; Debashis,9999,0,9999,0
1668488182254,CSE 293,030,119420,Saul; Lawrence,9999,0,9999,0
1668488182254,CSE 293,031,119421,Savage; Stefan,9999,0,9999,0
1668488182254,CSE 293,032,119425,Schulze; Jurgen P.,9999,0,9999,0
1668488182254,CSE 293,033,119426,Snoeren; Alex C.,9999,0,9999,0
1668488182254,CSE 293,034,119428,Shang; Jingbo,9999,0,9999,0
1668488182254,CSE 293,035,119430,Stefan; Deian,9999,0,9999,0
1668488182254,CSE 293,036,119431,Su; Hao,9999,0,9999,0
1668488182254,CSE 293,037,119433,Swanson; Steven James,9999,0,9999,0
1668488182254,CSE 293,038,119435,Tullsen; Dean Michael,9999,0,9999,0
1668488182254,CSE 293,039,119483,Voelker; Geoffrey M.,9999,0,9999,0
1668488182254,CSE 293,040,119537,Zhao; Jishen,9999,0,9999,0
1668488182254,CSE 293,041,119538,Zhou; Yuan-Yuan,9999,0,9999,0
1668488182254,CSE 293,042,119539,Gao; Sicun,9999,0,9999,0
1668488182254,CSE 293,043,119540,Weibel; Nadir,9999,0,9999,0
1668488182254,CSE 293,044,119541,Gupta; Rajesh K.,9999,0,9999,0
1668488182254,CSE 293,045,126410,Vaccaro; Kristen Marie,9999,0,9999,0
1668488182254,CSE 293,046,126411,Klemke; Richard,9999,0,9999,0
1668488182681,CSE 294,A00,102459,Voelker; Geoffrey M.,0,2,0,0
1668488182681,CSE 294,B00,111322,Orailoglu; Alex,0,2,0,0
1668488183106,DSE 201,A00,096914,Deutsch; Alin Bernard,30,0,30,0
1668488183533,DSE 210,A00,096915,Dasgupta; Sanjoy,30,0,30,0
1668488183961,DSE 260A,A00,096916,Altintas De Callaf; Ilkay,30,0,30,0
1668488184412,ECE 200,001,103586,Antipa; Nicholas A,9999,0,9999,0
1668488184412,ECE 200,002,103587,Atanasov; Nikolay A.,9999,0,9999,0
1668488184412,ECE 200,003,103588,Bharadia; Dinesh,9999,0,9999,0
1668488184412,ECE 200,004,103589,Cheng; Chung Kuan,9999,0,9999,0
1668488184412,ECE 200,005,103590,Cosman; Pamela C.,9999,0,9999,0
1668488184412,ECE 200,006,103591,Dayeh; Shadi Ahmad,9999,0,9999,0
1668488184412,ECE 200,007,103592,Fainman; Yeshaiahu,9999,0,9999,0
1668488184412,ECE 200,008,103593,Ford; Joseph Earl,9999,0,9999,0
1668488184412,ECE 200,009,103594,Franceschetti; Massimo,9999,0,9999,0
1668488184412,ECE 200,010,103595,Fullerton; Eric E,9999,0,9999,0
1668488184412,ECE 200,011,103596,Galton; Ian A,9999,0,9999,0
1668488184412,ECE 200,012,103597,Gilja; Vikash,9999,0,9999,0
1668488184412,ECE 200,013,103598,Hall; Drew A.,9999,0,9999,0
1668488184412,ECE 200,014,103599,Hsueh; Tzu-Chien,9999,0,9999,0
1668488184412,ECE 200,015,103600,Javidi; Tara,9999,0,9999,0
1668488184412,ECE 200,016,103601,Kahng; Andrew Byun,9999,0,9999,0
1668488184412,ECE 200,017,103602,Kim; Young-Han,9999,0,9999,0
1668488184412,ECE 200,018,103603,Koushanfar; Farinaz,9999,0,9999,0
1668488184412,ECE 200,019,103604,Kuzum; Duygu,9999,0,9999,0
1668488184412,ECE 200,020,103605,Le; Hanh-Phuc,9999,0,9999,0
1668488184412,ECE 200,021,103606,Lin; Bill,9999,0,9999,0
1668488184412,ECE 200,022,103607,Liu; Zhaowei,9998,0,9999,1
1668488184412,ECE 200,023,103608,Lo; Yu-Hwa,9999,0,9999,0
1668488184412,ECE 200,024,103609,Lomakin; Vitaliy,9999,0,9999,0
1668488184412,ECE 200,025,103610,Mercier; Patrick Philip,9999,0,9999,0
1668488184412,ECE 200,026,103611,Meyer; Florian,9999,0,9999,0
1668488184412,ECE 200,027,103612,Milstein; Laurence B.,9999,0,9999,0
1668488184412,ECE 200,028,103613,Mir Arabbaygi; Siavash,9999,0,9999,0
1668488184412,ECE 200,029,103614,Mookherjea; Shayan,9999,0,9999,0
1668488184412,ECE 200,030,103615,Morris; Karcher William,9999,0,9999,0
1668488184412,ECE 200,031,103616,Ng; Tse Nga,9999,0,9999,0
1668488184412,ECE 200,032,103617,Nguyen; Truong Quang,9999,0,9999,0
1668488184412,ECE 200,033,103618,Nomura; Kenji,9999,0,9999,0
1668488184412,ECE 200,034,103619,Orlitsky; Alon,9999,0,9999,0
1668488184412,ECE 200,035,103620,Pal; Piya,9999,0,9999,0
1668488184412,ECE 200,036,103621,Papen; George C.,9999,0,9999,0
1668488184412,ECE 200,037,103622,Radic; Stojan,9999,0,9999,0
1668488184412,ECE 200,038,103623,Rao; Bhaskar D.,9999,0,9999,0
1668488184412,ECE 200,039,103624,Rao; Ramesh R,9999,0,9999,0
1668488184412,ECE 200,040,103625,Rebeiz; Gabriel,9999,0,9999,0
1668488184412,ECE 200,041,103626,Sanford; John R,9999,0,9999,0
1668488184412,ECE 200,042,103627,Siegel; Paul H.,9999,0,9999,0
1668488184412,ECE 200,043,103628,Sievenpiper; Daniel F.,9999,0,9999,0
1668488184412,ECE 200,044,103629,Sworder; David D.,9999,0,9999,0
1668488184412,ECE 200,045,103630,Taur; Yuan,9999,0,9999,0
1668488184412,ECE 200,046,103631,Touri; Behrouz,9999,0,9999,0
1668488184412,ECE 200,047,103632,Trivedi; Mohan M.,9999,0,9999,0
1668488184412,ECE 200,048,103633,Vasconcelos; Nuno,9999,0,9999,0
1668488184412,ECE 200,049,103634,Wang; Xiaolong,9999,0,9999,0
1668488184412,ECE 200,050,103635,Xie; Pengtao,9999,0,9999,0
1668488184412,ECE 200,051,103636,Yip; Michael,9999,0,9999,0
1668488184412,ECE 200,052,103637,Zeger; Kenneth A.,999,0,999,0
1668488184412,ECE 200,053,103638,Zhang; Xinyu,9999,0,9999,0
1668488184412,ECE 200,054,103639,Turakhia; Yatish Girish,9999,0,9999,0
1668488184412,ECE 200,055,103640,Kang; Mingu,9999,0,9999,0
1668488184412,ECE 200,056,103641,Shi; Yuanyuan,9999,0,9999,0
1668488184412,ECE 200,057,103642,Wang; Edward Jay,9999,0,9999,0
1668488184412,ECE 200,058,103643,Zheng; Yang,9999,0,9999,0
1668488184848,ECE 202,A00,103644,Kuzum; Duygu,0,43,0,0
1668488185272,ECE 212BN,A00,103646,Ng; Tse Nga,0,9,0,0
1668488185697,ECE 221,A00,111493,Staff,0,0,0,0
1668488186122,ECE 222B,A00,103647,Lomakin; Vitaliy,0,18,0,0
1668488186548,ECE 230B,A00,103648,Taur; Yuan,0,2,0,0
1668488186974,ECE 238B,A00,103649,Garay; Javier,0,0,0,0
1668488187401,ECE 240B,A00,112900,Fainman; Yeshaiahu,0,7,0,0
1668488187823,ECE 247A,A00,103650,Jokerst; Jesse Vincent,0,6,0,0
1668488188252,ECE 247B,A00,103651,Wang; Joseph,0,13,0,0
1668488188676,ECE 250,A00,103652,Siegel; Paul H.,0,82,0,0
1668488189112,ECE 251A,A00,103654,Rao; Bhaskar D.,0,61,0,0
1668488189534,ECE 257B,A00,103655,Bharadia; Dinesh,0,32,0,0
1668488189957,ECE 258A,A00,103656,Milstein; Laurence B.,0,28,0,0
1668488190385,ECE 260B,A00,103658,Kang; Mingu,0,119,0,0
1668488190807,ECE 264A,A00,103659,Galton; Ian A,0,66,0,0
1668488191230,ECE 265A,A00,103661,Gudem; Prasad S.S.,0,67,0,0
1668488191656,ECE 265D,A00,103662,Gudem; Prasad S.S.,0,24,0,0
1668488192083,ECE 268,A00,103663,Koushanfar; Farinaz,0,42,0,0
1668488192506,ECE 269,A01,103665,Pal; Piya,0,212,0,0
1668488192940,ECE 271B,A00,103666,Vasconcelos; Manuela,0,74,0,0
1668488193363,ECE 276A,A00,103667,Atanasov; Nikolay A.,0,123,0,0
1668488193789,ECE 277,A00,103668,An; Cheolhong,0,146,0,0
1668488194215,ECE 279,A00,117947,Hall; Drew A.,0,22,0,0
1668488195066,ECE 283,A00,103670,Hsueh; Tzu-Chien,0,51,0,0
1668488195493,ECE 284,A00,103671,Turakhia; Yatish Girish,0,39,0,0
1668488195914,ECE 285,A00,103672,Zheng; Yang,0,39,0,0
1668488195914,ECE 285,B00,103673,Sworder; David D.,0,56,0,0
1668488196339,ECE 287,A00,103676,Javidi; Tara,0,8,0,0
1668488196762,MATH 200B,A00,098023,Salehi Golsefidy; Alireza,10,0,15,5
1668488197268,MATH 202B,A00,098024,Rhoades; Brendon Patrick,7,0,15,8
1668488197692,MATH 203B,A00,098025,Oprea; Dragos N.,9,0,15,6
1668488198115,MATH 204B,A00,098026,Sorensen; Claus M,13,0,15,2
1668488198539,MATH 208,A00,098027,Izadi; Elham,7,0,10,3
1668488198965,MATH 209,A00,098028,Pollack; Aaron,10,0,10,0
1668488199390,MATH 211A,A00,112919,Rogalski; Daniel,8,0,10,2
1668488199813,MATH 211B,A00,112920,Seward; Brandon M.,9,0,10,1
1668488200239,MATH 218,A00,098029,Li; Bo,10,0,10,0
1668488200666,MATH 220B,A00,098030,Novak; Jonathan I,11,0,15,4
1668488201091,MATH 221A,A00,098031,Ebenfelt; Peter F,12,0,15,3
1668488201513,MATH 231B,A00,098032,Zlatos; Andrej,11,0,15,4
1668488201936,MATH 240B,A00,098033,Ni; Lei,7,0,15,8
1668488202360,MATH 243,A00,098034,Jekel; David Andrew,10,0,10,0
1668488202783,MATH 245A,A00,098035,Nie; Jiawang,0,4,15,18
1668488203207,MATH 248,A00,098036,Bejenaru; Ioan,10,0,10,0
1668488203633,MATH 250B,A00,098037,Spolaor; Luca,14,0,15,1
1668488204071,MATH 258,A00,098038,Ni; Lei,9,0,10,1
1668488204495,MATH 264B,A00,098041,Rhoades; Brendon Patrick,8,0,15,7
1668488204919,MATH 268,A00,098042,Buss; Samuel R,10,0,10,0
1668488205350,MATH 269,A00,098043,Rhoades; Brendon Patrick,10,0,10,0
1668488205777,MATH 270B,A00,098044,Li; Bo,6,0,15,9
1668488206204,MATH 272B,A00,098045,Holst; Michael J,13,0,15,2
1668488206637,MATH 273A,A00,098046,Tian; Xiaochuan,10,0,15,5
1668488207063,MATH 275,A01,098048,Tian; Xiaochuan,6,0,10,4
1668488207490,MATH 278A,A00,098049,Holst; Michael J,7,0,10,3
1668488207918,MATH 278B,A00,098050,Cloninger; Alexander,10,0,10,0
1668488208344,MATH 278C,A00,098051,Nie; Jiawang,5,0,10,5
1668488208785,MATH 280B,A00,098052,Zheng; Tianyi,7,0,15,8
1668488209212,MATH 281B,A00,098053,Bradic; Jelena,0,2,15,15
1668488209639,MATH 282B,A00,098054,Arias-Castro; Ery,0,1,15,15
1668488210065,MATH 285,A00,098055,Fitzsimmons; Patrick J,0,2,15,17
1668488210488,MATH 287B,A00,098056,Arias-Castro; Ery,1,0,15,14
1668488210912,MATH 288,A00,098057,Agarwal; Pooja,9,0,10,1
1668488210912,MATH 288,B00,098058,Zhang; Danna,8,0,10,2
1668488210912,MATH 288,C00,098059,Williams; Ruth J,9,0,10,1
1668488211337,MATH 290B,A00,098060,Roberts; Justin Deritter,12,0,15,3
1668488211765,MATH 292,A00,098061,Belmont; Eva Kinoshita,10,0,10,0
1668488212190,MATH 295,A00,098062,Suk; Andrew Hoon,47,0,50,3
1668488212615,MATH 296,A00,098063,Novak; Jonathan I,20,0,20,0
1668488213038,MATH 297,001,098064,Gamst; Anthony Collins,9997,0,9999,2
1668488714059,COGS 205,A00,101395,Chiba; Andrea,19,0,20,1
1668488714483,COGS 210B,001,101404,Greene; Deanna Jacquelyn,9998,0,9999,1
1668488714483,COGS 210B,002,101417,Xia; Haijun,9999,0,9999,0
1668488714483,COGS 210B,003,101422,Nitz; Douglas A.,9999,0,9999,0
1668488714483,COGS 210B,004,101423,Hollan; James D.,9998,0,9999,1
1668488714483,COGS 210B,005,101424,Deak; Gedeon O.,9998,0,9999,1
1668488714483,COGS 210B,006,101425,Rossano; Federico,9999,0,9999,0
1668488714907,COGS 211B,A00,101427,Coulson; Seana M,9996,0,9999,3
1668488715333,COGS 220,A00,101428,Hollan; James D.,1,11,25,24
1668488715756,COGS 229,A00,101429,Dow; Steven P,17,0,25,8
1668488716185,COGS 230,A00,101430,Klemmer; Scott R,8,0,17,9
1668488716619,COGS 234,A00,101431,Xia; Haijun,2,0,25,23
1668488717127,COGS 260,A00,101432,Kiyonaga; Anastasia,21,0,25,4
1668488717127,COGS 260,B00,101433,Kirsh; David Joel,15,0,25,10
1668488717554,CSE 202,A00,102371,Impagliazzo; Russell,0,63,0,0
1668488717983,CSE 203B,A01,102373,Cheng; Chung Kuan,0,52,0,0
1668488718407,CSE 208,A00,102374,Micciancio; Daniele,0,5,0,0
1668488718832,CSE 209A,A00,112895,Impagliazzo; Russell,0,12,15,15
1668488719255,CSE 209B,A00,108005,Bellare; Mihir,0,6,0,0
1668488719683,CSE 210,A00,113163,Coblenz; Michael J,0,80,0,0
1668488720109,CSE 219,A00,106111,Dow; Steven P,0,6,20,20
1668488720540,CSE 221,A00,102376,Voelker; Geoffrey M.,0,70,0,0
1668488720974,CSE 224,A01,102378,Porter; George M,0,160,0,0
1668488721401,CSE 229A,A00,102379,Savage; Stefan,0,10,0,0
1668488721824,CSE 229C,A00,102380,Munyaka; Imani N. S.,0,10,0,0
1668488722252,CSE 232B,A00,102382,Deutsch; Alin Bernard,0,31,0,0
1668488722676,CSE 234,A01,112904,Kumar; Arun Kumar,0,0,0,0
1668488723124,CSE 237A,A00,102383,Rosing; Tajana Simunic,0,50,0,0
1668488723552,CSE 239A,A00,102384,Deutsch; Alin Bernard,0,13,0,0
1668488723975,CSE 239B,A00,102385,Polikarpova; Nadezhda,0,10,0,0
1668488724398,CSE 240A,A00,102386,Pannuto; Patrick William,0,44,0,0
1668488724821,CSE 240B,A00,102387,Zhao; Jishen,0,42,0,0
1668488725245,CSE 241A,A00,106406,Kang; Mingu,0,7,0,0
1668488725668,CSE 249B,A00,102388,Kahng; Andrew Byun,0,5,8,8
1668488726096,CSE 251B,A01,102392,Cottrell; Garrison W,0,46,0,0
1668488726096,CSE 251B,A02,102393,Cottrell; Garrison W,0,34,0,0
1668488726519,CSE 252B,A00,102394,Ochoa; Benjamin Lawrence,0,58,0,0
1668488726959,CSE 257,A01,102396,Gao; Sicun,0,133,0,0
1668488727383,CSE 272,A00,102397,Li; Tzumao,0,17,0,0
1668488727813,CSE 274,A00,111323,Chern; Albert Ren-Haur,0,15,0,0
1668488728236,CSE 282,A00,102398,Pevzner; Pavel Arkadjevich,0,0,0,0
1668488728660,CSE 284,A00,114175,Gymrek; Melissa Ann,0,22,0,0
1668488729094,CSE 290,A00,102399,Chandraker; Manmohan Krishna,0,11,0,0
1668488729094,CSE 290,B00,102400,Vaccaro; Kristen Marie,0,7,25,25
1668488729094,CSE 290,C00,102414,Pannuto; Patrick William,0,1,25,25
1668488729094,CSE 290,D00,102427,Pevzner; Pavel Arkadjevich,0,0,0,0
1668488729094,CSE 290,E00,102429,Zhao; Jishen,0,4,0,0
1668488729094,CSE 290,F00,102436,Tullsen; Dean Michael,0,5,0,0
1668488729094,CSE 290,G00,102440,Christensen; Henrik I,0,6,20,20
1668488729532,CSE 291,A00,102443,Su; Hao,0,0,0,0
1668488729532,CSE 291,B00,102448,Polikarpova; Nadezhda,0,0,0,0
1668488729532,CSE 291,C00,102453,Vaccaro; Kristen Marie,0,0,0,0
1668488729532,CSE 291,D00,111343,Savage; Stefan,0,0,0,0
1668488729532,CSE 291,E00,116474,Claffy; Kimberly Claire,0,0,0,0
1668488729532,CSE 291,F00,116479,Pasquale; Joseph,0,0,0,0
1668488730002,CSE 293,001,119111,Bafna; Vineet,9999,0,9999,0
1668488730002,CSE 293,002,119118,Bellare; Mihir,9999,0,9999,0
1668488730002,CSE 293,003,119122,Berg-Kirkpatrick; Taylor D,9999,0,9999,0
1668488730002,CSE 293,004,119135,Christensen; Henrik I,9999,0,9999,0
1668488730002,CSE 293,005,119142,Cottrell; Garrison W,9999,0,9999,0
1668488730002,CSE 293,006,119146,Deutsch; Alin Bernard,9999,0,9999,0
1668488730002,CSE 293,007,119159,Esmaeilzadeh; Hadi,9999,0,9999,0
1668488730002,CSE 293,008,119166,Freund; Yoav,9999,0,9999,0
1668488730002,CSE 293,009,119170,Griswold; William G.,9999,0,9999,0
1668488730002,CSE 293,010,119183,Gymrek; Melissa Ann,9999,0,9999,0
1668488730002,CSE 293,011,119190,Heninger; Nadia A,9999,0,9999,0
1668488730002,CSE 293,012,119230,Impagliazzo; Russell,9999,0,9999,0
1668488730002,CSE 293,013,119232,Jhala; Ranjit,9999,0,9999,0
1668488730002,CSE 293,014,119233,Kahng; Andrew Byun,9999,0,9999,0
1668488730002,CSE 293,015,119298,Kane; Daniel Mertz,9999,0,9999,0
1668488730002,CSE 293,016,119299,Kriegman; David J,9999,0,9999,0
1668488730002,CSE 293,017,119300,Kumar; Arun Kumar,9999,0,9999,0
1668488730002,CSE 293,018,119301,Lerner; Sorin,9999,0,9999,0
1668488730002,CSE 293,019,119302,Lovett; Shachar,9999,0,9999,0
1668488730002,CSE 293,020,119303,McAuley; Julian John,9999,0,9999,0
1668488730002,CSE 293,021,119304,Micciancio; Daniele,9999,0,9999,0
1668488730002,CSE 293,022,119367,Orailoglu; Alex,9999,0,9999,0
1668488730002,CSE 293,023,119382,Paturi; Ramamohan,9999,0,9999,0
1668488730002,CSE 293,024,119404,Polikarpova; Nadezhda,9999,0,9999,0
1668488730002,CSE 293,025,119406,Politz; Joseph Gibbs,9999,0,9999,0
1668488730002,CSE 293,026,119411,Porter; George M,9999,0,9999,0
1668488730002,CSE 293,027,119414,Porter; Leonard Emerson,9999,0,9999,0
1668488730002,CSE 293,028,119416,Ramamoorthi; Ravi,9999,0,9999,0
1668488730002,CSE 293,029,119417,Sahoo; Debashis,9999,0,9999,0
1668488730002,CSE 293,030,119420,Saul; Lawrence,9999,0,9999,0
1668488730002,CSE 293,031,119421,Savage; Stefan,9999,0,9999,0
1668488730002,CSE 293,032,119425,Schulze; Jurgen P.,9999,0,9999,0
1668488730002,CSE 293,033,119426,Snoeren; Alex C.,9999,0,9999,0
1668488730002,CSE 293,034,119428,Shang; Jingbo,9999,0,9999,0
1668488730002,CSE 293,035,119430,Stefan; Deian,9999,0,9999,0
1668488730002,CSE 293,036,119431,Su; Hao,9999,0,9999,0
1668488730002,CSE 293,037,119433,Swanson; Steven James,9999,0,9999,0
1668488730002,CSE 293,038,119435,Tullsen; Dean Michael,9999,0,9999,0
1668488730002,CSE 293,039,119483,Voelker; Geoffrey M.,9999,0,9999,0
1668488730002,CSE 293,040,119537,Zhao; Jishen,9999,0,9999,0
1668488730002,CSE 293,041,119538,Zhou; Yuan-Yuan,9999,0,9999,0
1668488730002,CSE 293,042,119539,Gao; Sicun,9999,0,9999,0
1668488730002,CSE 293,043,119540,Weibel; Nadir,9999,0,9999,0
1668488730002,CSE 293,044,119541,Gupta; Rajesh K.,9999,0,9999,0
1668488730002,CSE 293,045,126410,Vaccaro; Kristen Marie,9999,0,9999,0
1668488730002,CSE 293,046,126411,Klemke; Richard,9999,0,9999,0
1668488730435,CSE 294,A00,102459,Voelker; Geoffrey M.,0,2,0,0
1668488730435,CSE 294,B00,111322,Orailoglu; Alex,0,2,0,0
1668488730860,DSE 201,A00,096914,Deutsch; Alin Bernard,30,0,30,0
1668488731283,DSE 210,A00,096915,Dasgupta; Sanjoy,30,0,30,0
1668488731725,DSE 260A,A00,096916,Altintas De Callaf; Ilkay,30,0,30,0
1668488732175,ECE 200,001,103586,Antipa; Nicholas A,9999,0,9999,0
1668488732175,ECE 200,002,103587,Atanasov; Nikolay A.,9999,0,9999,0
1668488732175,ECE 200,003,103588,Bharadia; Dinesh,9999,0,9999,0
1668488732175,ECE 200,004,103589,Cheng; Chung Kuan,9999,0,9999,0
1668488732175,ECE 200,005,103590,Cosman; Pamela C.,9999,0,9999,0
1668488732175,ECE 200,006,103591,Dayeh; Shadi Ahmad,9999,0,9999,0
1668488732175,ECE 200,007,103592,Fainman; Yeshaiahu,9999,0,9999,0
1668488732175,ECE 200,008,103593,Ford; Joseph Earl,9999,0,9999,0
1668488732175,ECE 200,009,103594,Franceschetti; Massimo,9999,0,9999,0
1668488732175,ECE 200,010,103595,Fullerton; Eric E,9999,0,9999,0
1668488732175,ECE 200,011,103596,Galton; Ian A,9999,0,9999,0
1668488732175,ECE 200,012,103597,Gilja; Vikash,9999,0,9999,0
1668488732175,ECE 200,013,103598,Hall; Drew A.,9999,0,9999,0
1668488732175,ECE 200,014,103599,Hsueh; Tzu-Chien,9999,0,9999,0
1668488732175,ECE 200,015,103600,Javidi; Tara,9999,0,9999,0
1668488732175,ECE 200,016,103601,Kahng; Andrew Byun,9999,0,9999,0
1668488732175,ECE 200,017,103602,Kim; Young-Han,9999,0,9999,0
1668488732175,ECE 200,018,103603,Koushanfar; Farinaz,9999,0,9999,0
1668488732175,ECE 200,019,103604,Kuzum; Duygu,9999,0,9999,0
1668488732175,ECE 200,020,103605,Le; Hanh-Phuc,9999,0,9999,0
1668488732175,ECE 200,021,103606,Lin; Bill,9999,0,9999,0
1668488732175,ECE 200,022,103607,Liu; Zhaowei,9998,0,9999,1
1668488732175,ECE 200,023,103608,Lo; Yu-Hwa,9999,0,9999,0
1668488732175,ECE 200,024,103609,Lomakin; Vitaliy,9999,0,9999,0
1668488732175,ECE 200,025,103610,Mercier; Patrick Philip,9999,0,9999,0
1668488732175,ECE 200,026,103611,Meyer; Florian,9999,0,9999,0
1668488732175,ECE 200,027,103612,Milstein; Laurence B.,9999,0,9999,0
1668488732175,ECE 200,028,103613,Mir Arabbaygi; Siavash,9999,0,9999,0
1668488732175,ECE 200,029,103614,Mookherjea; Shayan,9999,0,9999,0
1668488732175,ECE 200,030,103615,Morris; Karcher William,9999,0,9999,0
1668488732175,ECE 200,031,103616,Ng; Tse Nga,9999,0,9999,0
1668488732175,ECE 200,032,103617,Nguyen; Truong Quang,9999,0,9999,0
1668488732175,ECE 200,033,103618,Nomura; Kenji,9999,0,9999,0
1668488732175,ECE 200,034,103619,Orlitsky; Alon,9999,0,9999,0
1668488732175,ECE 200,035,103620,Pal; Piya,9999,0,9999,0
1668488732175,ECE 200,036,103621,Papen; George C.,9999,0,9999,0
1668488732175,ECE 200,037,103622,Radic; Stojan,9999,0,9999,0
1668488732175,ECE 200,038,103623,Rao; Bhaskar D.,9999,0,9999,0
1668488732175,ECE 200,039,103624,Rao; Ramesh R,9999,0,9999,0
1668488732175,ECE 200,040,103625,Rebeiz; Gabriel,9999,0,9999,0
1668488732175,ECE 200,041,103626,Sanford; John R,9999,0,9999,0
1668488732175,ECE 200,042,103627,Siegel; Paul H.,9999,0,9999,0
1668488732175,ECE 200,043,103628,Sievenpiper; Daniel F.,9999,0,9999,0
1668488732175,ECE 200,044,103629,Sworder; David D.,9999,0,9999,0
1668488732175,ECE 200,045,103630,Taur; Yuan,9999,0,9999,0
1668488732175,ECE 200,046,103631,Touri; Behrouz,9999,0,9999,0
1668488732175,ECE 200,047,103632,Trivedi; Mohan M.,9999,0,9999,0
1668488732175,ECE 200,048,103633,Vasconcelos; Nuno,9999,0,9999,0
1668488732175,ECE 200,049,103634,Wang; Xiaolong,9999,0,9999,0
1668488732175,ECE 200,050,103635,Xie; Pengtao,9999,0,9999,0
1668488732175,ECE 200,051,103636,Yip; Michael,9999,0,9999,0
1668488732175,ECE 200,052,103637,Zeger; Kenneth A.,999,0,999,0
1668488732175,ECE 200,053,103638,Zhang; Xinyu,9999,0,9999,0
1668488732175,ECE 200,054,103639,Turakhia; Yatish Girish,9999,0,9999,0
1668488732175,ECE 200,055,103640,Kang; Mingu,9999,0,9999,0
1668488732175,ECE 200,056,103641,Shi; Yuanyuan,9999,0,9999,0
1668488732175,ECE 200,057,103642,Wang; Edward Jay,9999,0,9999,0
1668488732175,ECE 200,058,103643,Zheng; Yang,9999,0,9999,0
1668488732601,ECE 202,A00,103644,Kuzum; Duygu,0,43,0,0
1668488733024,ECE 212BN,A00,103646,Ng; Tse Nga,0,9,0,0
1668488733458,ECE 221,A00,111493,Staff,0,0,0,0
1668488733882,ECE 222B,A00,103647,Lomakin; Vitaliy,0,18,0,0
1668488734311,ECE 230B,A00,103648,Taur; Yuan,0,2,0,0
1668488734735,ECE 238B,A00,103649,Garay; Javier,0,0,0,0
1668488735158,ECE 240B,A00,112900,Fainman; Yeshaiahu,0,7,0,0
1668488735585,ECE 247A,A00,103650,Jokerst; Jesse Vincent,0,6,0,0
1668488736008,ECE 247B,A00,103651,Wang; Joseph,0,13,0,0
1668488736435,ECE 250,A00,103652,Siegel; Paul H.,0,82,0,0
1668488736859,ECE 251A,A00,103654,Rao; Bhaskar D.,0,61,0,0
1668488737286,ECE 257B,A00,103655,Bharadia; Dinesh,0,32,0,0
1668488737712,ECE 258A,A00,103656,Milstein; Laurence B.,0,28,0,0
1668488738135,ECE 260B,A00,103658,Kang; Mingu,0,119,0,0
1668488738568,ECE 264A,A00,103659,Galton; Ian A,0,66,0,0
1668488738995,ECE 265A,A00,103661,Gudem; Prasad S.S.,0,67,0,0
1668488739419,ECE 265D,A00,103662,Gudem; Prasad S.S.,0,24,0,0
1668488739849,ECE 268,A00,103663,Koushanfar; Farinaz,0,42,0,0
1668488740279,ECE 269,A01,103665,Pal; Piya,0,212,0,0
1668488740704,ECE 271B,A00,103666,Vasconcelos; Manuela,0,74,0,0
1668488741139,ECE 276A,A00,103667,Atanasov; Nikolay A.,0,123,0,0
1668488741562,ECE 277,A00,103668,An; Cheolhong,0,146,0,0
1668488741985,ECE 279,A00,117947,Hall; Drew A.,0,22,0,0
1668488742846,ECE 283,A00,103670,Hsueh; Tzu-Chien,0,51,0,0
1668488743269,ECE 284,A00,103671,Turakhia; Yatish Girish,0,39,0,0
1668488743699,ECE 285,A00,103672,Zheng; Yang,0,39,0,0
1668488743699,ECE 285,B00,103673,Sworder; David D.,0,56,0,0
1668488744124,ECE 287,A00,103676,Javidi; Tara,0,8,0,0
1668488744547,MATH 200B,A00,098023,Salehi Golsefidy; Alireza,10,0,15,5
1668488744973,MATH 202B,A00,098024,Rhoades; Brendon Patrick,7,0,15,8
1668488745400,MATH 203B,A00,098025,Oprea; Dragos N.,9,0,15,6
1668488745826,MATH 204B,A00,098026,Sorensen; Claus M,13,0,15,2
1668488746254,MATH 208,A00,098027,Izadi; Elham,7,0,10,3
1668488746680,MATH 209,A00,098028,Pollack; Aaron,10,0,10,0
1668488747107,MATH 211A,A00,112919,Rogalski; Daniel,8,0,10,2
1668488747530,MATH 211B,A00,112920,Seward; Brandon M.,9,0,10,1
1668488747952,MATH 218,A00,098029,Li; Bo,10,0,10,0
1668488748379,MATH 220B,A00,098030,Novak; Jonathan I,11,0,15,4
1668488748803,MATH 221A,A00,098031,Ebenfelt; Peter F,12,0,15,3
1668488749230,MATH 231B,A00,098032,Zlatos; Andrej,11,0,15,4
1668488749662,MATH 240B,A00,098033,Ni; Lei,7,0,15,8
1668488750086,MATH 243,A00,098034,Jekel; David Andrew,10,0,10,0
1668488750510,MATH 245A,A00,098035,Nie; Jiawang,0,4,15,18
1668488750935,MATH 248,A00,098036,Bejenaru; Ioan,10,0,10,0
1668488751368,MATH 250B,A00,098037,Spolaor; Luca,14,0,15,1
1668488751794,MATH 258,A00,098038,Ni; Lei,9,0,10,1
1668488752216,MATH 264B,A00,098041,Rhoades; Brendon Patrick,8,0,15,7
1668488752639,MATH 268,A00,098042,Buss; Samuel R,10,0,10,0
1668488753072,MATH 269,A00,098043,Rhoades; Brendon Patrick,10,0,10,0
1668488753495,MATH 270B,A00,098044,Li; Bo,6,0,15,9
1668488753919,MATH 272B,A00,098045,Holst; Michael J,13,0,15,2
1668488754345,MATH 273A,A00,098046,Tian; Xiaochuan,10,0,15,5
1668488754774,MATH 275,A01,098048,Tian; Xiaochuan,6,0,10,4
1668488755198,MATH 278A,A00,098049,Holst; Michael J,7,0,10,3
1668488755623,MATH 278B,A00,098050,Cloninger; Alexander,10,0,10,0
1668488756049,MATH 278C,A00,098051,Nie; Jiawang,5,0,10,5
1668488756477,MATH 280B,A00,098052,Zheng; Tianyi,7,0,15,8
1668488756900,MATH 281B,A00,098053,Bradic; Jelena,0,2,15,15
1668488757324,MATH 282B,A00,098054,Arias-Castro; Ery,0,1,15,15
1668488757754,MATH 285,A00,098055,Fitzsimmons; Patrick J,0,2,15,17
1668488758181,MATH 287B,A00,098056,Arias-Castro; Ery,1,0,15,14
1668488758605,MATH 288,A00,098057,Agarwal; Pooja,9,0,10,1
1668488758605,MATH 288,B00,098058,Zhang; Danna,8,0,10,2
1668488758605,MATH 288,C00,098059,Williams; Ruth J,9,0,10,1
1668488759030,MATH 290B,A00,098060,Roberts; Justin Deritter,12,0,15,3
1668488759456,MATH 292,A00,098061,Belmont; Eva Kinoshita,10,0,10,0
1668488759882,MATH 295,A00,098062,Suk; Andrew Hoon,47,0,50,3
1668488760404,MATH 296,A00,098063,Novak; Jonathan I,20,0,20,0
1668488760831,MATH 297,001,098064,Gamst; Anthony Collins,9997,0,9999,2
1668489262082,COGS 205,A00,101395,Chiba; Andrea,19,0,20,1
1668489262509,COGS 210B,001,101404,Greene; Deanna Jacquelyn,9998,0,9999,1
1668489262509,COGS 210B,002,101417,Xia; Haijun,9999,0,9999,0
1668489262509,COGS 210B,003,101422,Nitz; Douglas A.,9999,0,9999,0
1668489262509,COGS 210B,004,101423,Hollan; James D.,9998,0,9999,1
1668489262509,COGS 210B,005,101424,Deak; Gedeon O.,9998,0,9999,1
1668489262509,COGS 210B,006,101425,Rossano; Federico,9999,0,9999,0
1668489262933,COGS 211B,A00,101427,Coulson; Seana M,9996,0,9999,3
1668489263355,COGS 220,A00,101428,Hollan; James D.,1,11,25,24
1668489263779,COGS 229,A00,101429,Dow; Steven P,17,0,25,8
1668489264208,COGS 230,A00,101430,Klemmer; Scott R,8,0,17,9
1668489264630,COGS 234,A00,101431,Xia; Haijun,2,0,25,23
1668489265053,COGS 260,A00,101432,Kiyonaga; Anastasia,21,0,25,4
1668489265053,COGS 260,B00,101433,Kirsh; David Joel,15,0,25,10
1668489265478,CSE 202,A00,102371,Impagliazzo; Russell,0,63,0,0
1668489265903,CSE 203B,A01,102373,Cheng; Chung Kuan,0,52,0,0
1668489266325,CSE 208,A00,102374,Micciancio; Daniele,0,5,0,0
1668489266748,CSE 209A,A00,112895,Impagliazzo; Russell,0,12,15,15
1668489267177,CSE 209B,A00,108005,Bellare; Mihir,0,7,0,0
1668489267601,CSE 210,A00,113163,Coblenz; Michael J,0,80,0,0
1668489268035,CSE 219,A00,106111,Dow; Steven P,0,6,20,20
1668489268458,CSE 221,A00,102376,Voelker; Geoffrey M.,0,70,0,0
1668489268887,CSE 224,A01,102378,Porter; George M,0,160,0,0
1668489269312,CSE 229A,A00,102379,Savage; Stefan,0,10,0,0
1668489269734,CSE 229C,A00,102380,Munyaka; Imani N. S.,0,10,0,0
1668489270161,CSE 232B,A00,102382,Deutsch; Alin Bernard,0,31,0,0
1668489270585,CSE 234,A01,112904,Kumar; Arun Kumar,0,0,0,0
1668489271007,CSE 237A,A00,102383,Rosing; Tajana Simunic,0,50,0,0
1668489271429,CSE 239A,A00,102384,Deutsch; Alin Bernard,0,14,0,0
1668489271852,CSE 239B,A00,102385,Polikarpova; Nadezhda,0,10,0,0
1668489272278,CSE 240A,A00,102386,Pannuto; Patrick William,0,44,0,0
1668489272705,CSE 240B,A00,102387,Zhao; Jishen,0,42,0,0
1668489273134,CSE 241A,A00,106406,Kang; Mingu,0,7,0,0
1668489273556,CSE 249B,A00,102388,Kahng; Andrew Byun,0,5,8,8
1668489273981,CSE 251B,A01,102392,Cottrell; Garrison W,0,46,0,0
1668489273981,CSE 251B,A02,102393,Cottrell; Garrison W,0,34,0,0
1668489274407,CSE 252B,A00,102394,Ochoa; Benjamin Lawrence,0,58,0,0
1668489274834,CSE 257,A01,102396,Gao; Sicun,0,133,0,0
1668489275269,CSE 272,A00,102397,Li; Tzumao,0,17,0,0
1668489275695,CSE 274,A00,111323,Chern; Albert Ren-Haur,0,15,0,0
1668489276129,CSE 282,A00,102398,Pevzner; Pavel Arkadjevich,0,0,0,0
1668489276552,CSE 284,A00,114175,Gymrek; Melissa Ann,0,22,0,0
1668489276975,CSE 290,A00,102399,Chandraker; Manmohan Krishna,0,11,0,0
1668489276975,CSE 290,B00,102400,Vaccaro; Kristen Marie,0,7,25,25
1668489276975,CSE 290,C00,102414,Pannuto; Patrick William,0,1,25,25
1668489276975,CSE 290,D00,102427,Pevzner; Pavel Arkadjevich,0,0,0,0
1668489276975,CSE 290,E00,102429,Zhao; Jishen,0,4,0,0
1668489276975,CSE 290,F00,102436,Tullsen; Dean Michael,0,5,0,0
1668489276975,CSE 290,G00,102440,Christensen; Henrik I,0,6,20,20
1668489277404,CSE 291,A00,102443,Su; Hao,0,0,0,0
1668489277404,CSE 291,B00,102448,Polikarpova; Nadezhda,0,0,0,0
1668489277404,CSE 291,C00,102453,Vaccaro; Kristen Marie,0,0,0,0
1668489277404,CSE 291,D00,111343,Savage; Stefan,0,0,0,0
1668489277404,CSE 291,E00,116474,Claffy; Kimberly Claire,0,0,0,0
1668489277404,CSE 291,F00,116479,Pasquale; Joseph,0,0,0,0
1668489277847,CSE 293,001,119111,Bafna; Vineet,9999,0,9999,0
1668489277847,CSE 293,002,119118,Bellare; Mihir,9999,0,9999,0
1668489277847,CSE 293,003,119122,Berg-Kirkpatrick; Taylor D,9999,0,9999,0
1668489277847,CSE 293,004,119135,Christensen; Henrik I,9999,0,9999,0
1668489277847,CSE 293,005,119142,Cottrell; Garrison W,9999,0,9999,0
1668489277847,CSE 293,006,119146,Deutsch; Alin Bernard,9999,0,9999,0
1668489277847,CSE 293,007,119159,Esmaeilzadeh; Hadi,9999,0,9999,0
1668489277847,CSE 293,008,119166,Freund; Yoav,9999,0,9999,0
1668489277847,CSE 293,009,119170,Griswold; William G.,9999,0,9999,0
1668489277847,CSE 293,010,119183,Gymrek; Melissa Ann,9999,0,9999,0
1668489277847,CSE 293,011,119190,Heninger; Nadia A,9999,0,9999,0
1668489277847,CSE 293,012,119230,Impagliazzo; Russell,9999,0,9999,0
1668489277847,CSE 293,013,119232,Jhala; Ranjit,9999,0,9999,0
1668489277847,CSE 293,014,119233,Kahng; Andrew Byun,9999,0,9999,0
1668489277847,CSE 293,015,119298,Kane; Daniel Mertz,9999,0,9999,0
1668489277847,CSE 293,016,119299,Kriegman; David J,9999,0,9999,0
1668489277847,CSE 293,017,119300,Kumar; Arun Kumar,9999,0,9999,0
1668489277847,CSE 293,018,119301,Lerner; Sorin,9999,0,9999,0
1668489277847,CSE 293,019,119302,Lovett; Shachar,9999,0,9999,0
1668489277847,CSE 293,020,119303,McAuley; Julian John,9999,0,9999,0
1668489277847,CSE 293,021,119304,Micciancio; Daniele,9999,0,9999,0
1668489277847,CSE 293,022,119367,Orailoglu; Alex,9999,0,9999,0
1668489277847,CSE 293,023,119382,Paturi; Ramamohan,9999,0,9999,0
1668489277847,CSE 293,024,119404,Polikarpova; Nadezhda,9999,0,9999,0
1668489277847,CSE 293,025,119406,Politz; Joseph Gibbs,9999,0,9999,0
1668489277847,CSE 293,026,119411,Porter; George M,9999,0,9999,0
1668489277847,CSE 293,027,119414,Porter; Leonard Emerson,9999,0,9999,0
1668489277847,CSE 293,028,119416,Ramamoorthi; Ravi,9999,0,9999,0
1668489277847,CSE 293,029,119417,Sahoo; Debashis,9999,0,9999,0
1668489277847,CSE 293,030,119420,Saul; Lawrence,9999,0,9999,0
1668489277847,CSE 293,031,119421,Savage; Stefan,9999,0,9999,0
1668489277847,CSE 293,032,119425,Schulze; Jurgen P.,9999,0,9999,0
1668489277847,CSE 293,033,119426,Snoeren; Alex C.,9999,0,9999,0
1668489277847,CSE 293,034,119428,Shang; Jingbo,9999,0,9999,0
1668489277847,CSE 293,035,119430,Stefan; Deian,9999,0,9999,0
1668489277847,CSE 293,036,119431,Su; Hao,9999,0,9999,0
1668489277847,CSE 293,037,119433,Swanson; Steven James,9999,0,9999,0
1668489277847,CSE 293,038,119435,Tullsen; Dean Michael,9999,0,9999,0
1668489277847,CSE 293,039,119483,Voelker; Geoffrey M.,9999,0,9999,0
1668489277847,CSE 293,040,119537,Zhao; Jishen,9999,0,9999,0
1668489277847,CSE 293,041,119538,Zhou; Yuan-Yuan,9999,0,9999,0
1668489277847,CSE 293,042,119539,Gao; Sicun,9999,0,9999,0
1668489277847,CSE 293,043,119540,Weibel; Nadir,9999,0,9999,0
1668489277847,CSE 293,044,119541,Gupta; Rajesh K.,9999,0,9999,0
1668489277847,CSE 293,045,126410,Vaccaro; Kristen Marie,9999,0,9999,0
1668489277847,CSE 293,046,126411,Klemke; Richard,9999,0,9999,0
1668489278276,CSE 294,A00,102459,Voelker; Geoffrey M.,0,2,0,0
1668489278276,CSE 294,B00,111322,Orailoglu; Alex,0,2,0,0
1668489278698,DSE 201,A00,096914,Deutsch; Alin Bernard,30,0,30,0
1668489279121,DSE 210,A00,096915,Dasgupta; Sanjoy,30,0,30,0
1668489279544,DSE 260A,A00,096916,Altintas De Callaf; Ilkay,30,0,30,0
1668489279976,ECE 200,001,103586,Antipa; Nicholas A,9999,0,9999,0
1668489279976,ECE 200,002,103587,Atanasov; Nikolay A.,9999,0,9999,0
1668489279976,ECE 200,003,103588,Bharadia; Dinesh,9999,0,9999,0
1668489279976,ECE 200,004,103589,Cheng; Chung Kuan,9999,0,9999,0
1668489279976,ECE 200,005,103590,Cosman; Pamela C.,9999,0,9999,0
1668489279976,ECE 200,006,103591,Dayeh; Shadi Ahmad,9999,0,9999,0
1668489279976,ECE 200,007,103592,Fainman; Yeshaiahu,9999,0,9999,0
1668489279976,ECE 200,008,103593,Ford; Joseph Earl,9999,0,9999,0
1668489279976,ECE 200,009,103594,Franceschetti; Massimo,9999,0,9999,0
1668489279976,ECE 200,010,103595,Fullerton; Eric E,9999,0,9999,0
1668489279976,ECE 200,011,103596,Galton; Ian A,9999,0,9999,0
1668489279976,ECE 200,012,103597,Gilja; Vikash,9999,0,9999,0
1668489279976,ECE 200,013,103598,Hall; Drew A.,9999,0,9999,0
1668489279976,ECE 200,014,103599,Hsueh; Tzu-Chien,9999,0,9999,0
1668489279976,ECE 200,015,103600,Javidi; Tara,9999,0,9999,0
1668489279976,ECE 200,016,103601,Kahng; Andrew Byun,9999,0,9999,0
1668489279976,ECE 200,017,103602,Kim; Young-Han,9999,0,9999,0
1668489279976,ECE 200,018,103603,Koushanfar; Farinaz,9999,0,9999,0
1668489279976,ECE 200,019,103604,Kuzum; Duygu,9999,0,9999,0
1668489279976,ECE 200,020,103605,Le; Hanh-Phuc,9999,0,9999,0
1668489279976,ECE 200,021,103606,Lin; Bill,9999,0,9999,0
1668489279976,ECE 200,022,103607,Liu; Zhaowei,9998,0,9999,1
1668489279976,ECE 200,023,103608,Lo; Yu-Hwa,9999,0,9999,0
1668489279976,ECE 200,024,103609,Lomakin; Vitaliy,9999,0,9999,0
1668489279976,ECE 200,025,103610,Mercier; Patrick Philip,9999,0,9999,0
1668489279976,ECE 200,026,103611,Meyer; Florian,9999,0,9999,0
1668489279976,ECE 200,027,103612,Milstein; Laurence B.,9999,0,9999,0
1668489279976,ECE 200,028,103613,Mir Arabbaygi; Siavash,9999,0,9999,0
1668489279976,ECE 200,029,103614,Mookherjea; Shayan,9999,0,9999,0
1668489279976,ECE 200,030,103615,Morris; Karcher William,9999,0,9999,0
1668489279976,ECE 200,031,103616,Ng; Tse Nga,9999,0,9999,0
1668489279976,ECE 200,032,103617,Nguyen; Truong Quang,9999,0,9999,0
1668489279976,ECE 200,033,103618,Nomura; Kenji,9999,0,9999,0
1668489279976,ECE 200,034,103619,Orlitsky; Alon,9999,0,9999,0
1668489279976,ECE 200,035,103620,Pal; Piya,9999,0,9999,0
1668489279976,ECE 200,036,103621,Papen; George C.,9999,0,9999,0
1668489279976,ECE 200,037,103622,Radic; Stojan,9999,0,9999,0
1668489279976,ECE 200,038,103623,Rao; Bhaskar D.,9999,0,9999,0
1668489279976,ECE 200,039,103624,Rao; Ramesh R,9999,0,9999,0
1668489279976,ECE 200,040,103625,Rebeiz; Gabriel,9999,0,9999,0
1668489279976,ECE 200,041,103626,Sanford; John R,9999,0,9999,0
1668489279976,ECE 200,042,103627,Siegel; Paul H.,9999,0,9999,0
1668489279976,ECE 200,043,103628,Sievenpiper; Daniel F.,9999,0,9999,0
1668489279976,ECE 200,044,103629,Sworder; David D.,9999,0,9999,0
1668489279976,ECE 200,045,103630,Taur; Yuan,9999,0,9999,0
1668489279976,ECE 200,046,103631,Touri; Behrouz,9999,0,9999,0
1668489279976,ECE 200,047,103632,Trivedi; Mohan M.,9999,0,9999,0
1668489279976,ECE 200,048,103633,Vasconcelos; Nuno,9999,0,9999,0
1668489279976,ECE 200,049,103634,Wang; Xiaolong,9999,0,9999,0
1668489279976,ECE 200,050,103635,Xie; Pengtao,9999,0,9999,0
1668489279976,ECE 200,051,103636,Yip; Michael,9999,0,9999,0
1668489279976,ECE 200,052,103637,Zeger; Kenneth A.,999,0,999,0
1668489279976,ECE 200,053,103638,Zhang; Xinyu,9999,0,9999,0
1668489279976,ECE 200,054,103639,Turakhia; Yatish Girish,9999,0,9999,0
1668489279976,ECE 200,055,103640,Kang; Mingu,9999,0,9999,0
1668489279976,ECE 200,056,103641,Shi; Yuanyuan,9999,0,9999,0
1668489279976,ECE 200,057,103642,Wang; Edward Jay,9999,0,9999,0
1668489279976,ECE 200,058,103643,Zheng; Yang,9999,0,9999,0
1668489280493,ECE 202,A00,103644,Kuzum; Duygu,0,43,0,0
1668489280919,ECE 212BN,A00,103646,Ng; Tse Nga,0,9,0,0
1668489281350,ECE 221,A00,111493,Staff,0,0,0,0
1668489281775,ECE 222B,A00,103647,Lomakin; Vitaliy,0,18,0,0
1668489282197,ECE 230B,A00,103648,Taur; Yuan,0,2,0,0
1668489282620,ECE 238B,A00,103649,Garay; Javier,0,0,0,0
1668489283046,ECE 240B,A00,112900,Fainman; Yeshaiahu,0,7,0,0
1668489283473,ECE 247A,A00,103650,Jokerst; Jesse Vincent,0,6,0,0
1668489283898,ECE 247B,A00,103651,Wang; Joseph,0,13,0,0
1668489284321,ECE 250,A00,103652,Siegel; Paul H.,0,82,0,0
1668489284745,ECE 251A,A00,103654,Rao; Bhaskar D.,0,61,0,0
1668489285167,ECE 257B,A00,103655,Bharadia; Dinesh,0,32,0,0
1668489285594,ECE 258A,A00,103656,Milstein; Laurence B.,0,28,0,0
1668489286016,ECE 260B,A00,103658,Kang; Mingu,0,119,0,0
1668489286448,ECE 264A,A00,103659,Galton; Ian A,0,66,0,0
1668489286881,ECE 265A,A00,103661,Gudem; Prasad S.S.,0,67,0,0
1668489287319,ECE 265D,A00,103662,Gudem; Prasad S.S.,0,24,0,0
1668489287744,ECE 268,A00,103663,Koushanfar; Farinaz,0,41,0,0
1668489288167,ECE 269,A01,103665,Pal; Piya,0,212,0,0
1668489288597,ECE 271B,A00,103666,Vasconcelos; Manuela,0,74,0,0
1668489289027,ECE 276A,A00,103667,Atanasov; Nikolay A.,0,123,0,0
1668489289453,ECE 277,A00,103668,An; Cheolhong,0,147,0,0
1668489289877,ECE 279,A00,117947,Hall; Drew A.,0,22,0,0
1668489290725,ECE 283,A00,103670,Hsueh; Tzu-Chien,0,51,0,0
1668489291153,ECE 284,A00,103671,Turakhia; Yatish Girish,0,39,0,0
1668489291589,ECE 285,A00,103672,Zheng; Yang,0,39,0,0
1668489291589,ECE 285,B00,103673,Sworder; David D.,0,56,0,0
1668489292012,ECE 287,A00,103676,Javidi; Tara,0,8,0,0
1668489292436,MATH 200B,A00,098023,Salehi Golsefidy; Alireza,10,0,15,5
1668489292861,MATH 202B,A00,098024,Rhoades; Brendon Patrick,7,0,15,8
1668489293287,MATH 203B,A00,098025,Oprea; Dragos N.,9,0,15,6
1668489293713,MATH 204B,A00,098026,Sorensen; Claus M,13,0,15,2
1668489294139,MATH 208,A00,098027,Izadi; Elham,7,0,10,3
1668489294561,MATH 209,A00,098028,Pollack; Aaron,10,0,10,0
1668489294991,MATH 211A,A00,112919,Rogalski; Daniel,8,0,10,2
1668489295416,MATH 211B,A00,112920,Seward; Brandon M.,9,0,10,1
1668489295840,MATH 218,A00,098029,Li; Bo,10,0,10,0
1668489296269,MATH 220B,A00,098030,Novak; Jonathan I,11,0,15,4
1668489296694,MATH 221A,A00,098031,Ebenfelt; Peter F,12,0,15,3
1668489297119,MATH 231B,A00,098032,Zlatos; Andrej,11,0,15,4
1668489297544,MATH 240B,A00,098033,Ni; Lei,7,0,15,8
1668489297969,MATH 243,A00,098034,Jekel; David Andrew,10,0,10,0
1668489298395,MATH 245A,A00,098035,Nie; Jiawang,0,4,15,18
1668489298821,MATH 248,A00,098036,Bejenaru; Ioan,10,0,10,0
1668489299248,MATH 250B,A00,098037,Spolaor; Luca,14,0,15,1
1668489299673,MATH 258,A00,098038,Ni; Lei,9,0,10,1
1668489300100,MATH 264B,A00,098041,Rhoades; Brendon Patrick,8,0,15,7
1668489300522,MATH 268,A00,098042,Buss; Samuel R,10,0,10,0
1668489300945,MATH 269,A00,098043,Rhoades; Brendon Patrick,10,0,10,0
1668489301372,MATH 270B,A00,098044,Li; Bo,6,0,15,9
1668489301798,MATH 272B,A00,098045,Holst; Michael J,13,0,15,2
1668489302225,MATH 273A,A00,098046,Tian; Xiaochuan,10,0,15,5
1668489302657,MATH 275,A01,098048,Tian; Xiaochuan,6,0,10,4
1668489303082,MATH 278A,A00,098049,Holst; Michael J,7,0,10,3
1668489303516,MATH 278B,A00,098050,Cloninger; Alexander,10,0,10,0
1668489303941,MATH 278C,A00,098051,Nie; Jiawang,5,0,10,5
1668489304366,MATH 280B,A00,098052,Zheng; Tianyi,7,0,15,8
1668489304789,MATH 281B,A00,098053,Bradic; Jelena,0,2,15,15
1668489305213,MATH 282B,A00,098054,Arias-Castro; Ery,0,1,15,15
1668489305647,MATH 285,A00,098055,Fitzsimmons; Patrick J,0,2,15,17
1668489306072,MATH 287B,A00,098056,Arias-Castro; Ery,1,0,15,14
1668489306498,MATH 288,A00,098057,Agarwal; Pooja,9,0,10,1
1668489306498,MATH 288,B00,098058,Zhang; Danna,8,0,10,2
1668489306498,MATH 288,C00,098059,Williams; Ruth J,9,0,10,1
1668489306926,MATH 290B,A00,098060,Roberts; Justin Deritter,12,0,15,3
1668489307350,MATH 292,A00,098061,Belmont; Eva Kinoshita,10,0,10,0
1668489307776,MATH 295,A00,098062,Suk; Andrew Hoon,47,0,50,3
1668489308204,MATH 296,A00,098063,Novak; Jonathan I,20,0,20,0
1668489308628,MATH 297,001,098064,Gamst; Anthony Collins,9997,0,9999,2
1668489820086,COGS 205,A00,101395,Chiba; Andrea,19,0,20,1
1668489820510,COGS 210B,001,101404,Greene; Deanna Jacquelyn,9998,0,9999,1
1668489820510,COGS 210B,002,101417,Xia; Haijun,9999,0,9999,0
1668489820510,COGS 210B,003,101422,Nitz; Douglas A.,9999,0,9999,0
1668489820510,COGS 210B,004,101423,Hollan; James D.,9998,0,9999,1
1668489820510,COGS 210B,005,101424,Deak; Gedeon O.,9998,0,9999,1
1668489820510,COGS 210B,006,101425,Rossano; Federico,9999,0,9999,0
1668489820946,COGS 211B,A00,101427,Coulson; Seana M,9996,0,9999,3
1668489821372,COGS 220,A00,101428,Hollan; James D.,1,11,25,24
1668489821799,COGS 229,A00,101429,Dow; Steven P,17,0,25,8
1668489822226,COGS 230,A00,101430,Klemmer; Scott R,8,0,17,9
1668489822650,COGS 234,A00,101431,Xia; Haijun,2,0,25,23
1668489823077,COGS 260,A00,101432,Kiyonaga; Anastasia,21,0,25,4
1668489823077,COGS 260,B00,101433,Kirsh; David Joel,15,0,25,10
1668489823503,CSE 202,A00,102371,Impagliazzo; Russell,0,63,0,0
1668489823928,CSE 203B,A01,102373,Cheng; Chung Kuan,0,52,0,0
1668489824354,CSE 208,A00,102374,Micciancio; Daniele,0,5,0,0
1668489824777,CSE 209A,A00,112895,Impagliazzo; Russell,0,12,15,15
1668489825201,CSE 209B,A00,108005,Bellare; Mihir,0,7,0,0
1668489825625,CSE 210,A00,113163,Coblenz; Michael J,0,80,0,0
1668489826050,CSE 219,A00,106111,Dow; Steven P,0,6,20,20
1668489826478,CSE 221,A00,102376,Voelker; Geoffrey M.,0,70,0,0
1668489826902,CSE 224,A01,102378,Porter; George M,0,160,0,0
1668489827329,CSE 229A,A00,102379,Savage; Stefan,0,10,0,0
1668489827753,CSE 229C,A00,102380,Munyaka; Imani N. S.,0,10,0,0
1668489828177,CSE 232B,A00,102382,Deutsch; Alin Bernard,0,31,0,0
1668489828602,CSE 234,A01,112904,Kumar; Arun Kumar,0,0,0,0
1668489829025,CSE 237A,A00,102383,Rosing; Tajana Simunic,0,50,0,0
1668489829449,CSE 239A,A00,102384,Deutsch; Alin Bernard,0,14,0,0
1668489829873,CSE 239B,A00,102385,Polikarpova; Nadezhda,0,10,0,0
1668489830298,CSE 240A,A00,102386,Pannuto; Patrick William,0,44,0,0
1668489830730,CSE 240B,A00,102387,Zhao; Jishen,0,42,0,0
1668489831153,CSE 241A,A00,106406,Kang; Mingu,0,7,0,0
1668489831577,CSE 249B,A00,102388,Kahng; Andrew Byun,0,5,8,8
1668489832005,CSE 251B,A01,102392,Cottrell; Garrison W,0,46,0,0
1668489832005,CSE 251B,A02,102393,Cottrell; Garrison W,0,34,0,0
1668489832436,CSE 252B,A00,102394,Ochoa; Benjamin Lawrence,0,58,0,0
1668489832861,CSE 257,A01,102396,Gao; Sicun,0,133,0,0
1668489833284,CSE 272,A00,102397,Li; Tzumao,0,17,0,0
1668489833715,CSE 274,A00,111323,Chern; Albert Ren-Haur,0,15,0,0
1668489834138,CSE 282,A00,102398,Pevzner; Pavel Arkadjevich,0,0,0,0
1668489834564,CSE 284,A00,114175,Gymrek; Melissa Ann,0,22,0,0
1668489834990,CSE 290,A00,102399,Chandraker; Manmohan Krishna,0,11,0,0
1668489834990,CSE 290,B00,102400,Vaccaro; Kristen Marie,0,7,25,25
1668489834990,CSE 290,C00,102414,Pannuto; Patrick William,0,1,25,25
1668489834990,CSE 290,D00,102427,Pevzner; Pavel Arkadjevich,0,0,0,0
1668489834990,CSE 290,E00,102429,Zhao; Jishen,0,4,0,0
1668489834990,CSE 290,F00,102436,Tullsen; Dean Michael,0,5,0,0
1668489834990,CSE 290,G00,102440,Christensen; Henrik I,0,6,20,20
1668489835431,CSE 291,A00,102443,Su; Hao,0,0,0,0
1668489835431,CSE 291,B00,102448,Polikarpova; Nadezhda,0,0,0,0
1668489835431,CSE 291,C00,102453,Vaccaro; Kristen Marie,0,0,0,0
1668489835431,CSE 291,D00,111343,Savage; Stefan,0,0,0,0
1668489835431,CSE 291,E00,116474,Claffy; Kimberly Claire,0,0,0,0
1668489835431,CSE 291,F00,116479,Pasquale; Joseph,0,0,0,0
1668489835857,CSE 293,001,119111,Bafna; Vineet,9999,0,9999,0
1668489835857,CSE 293,002,119118,Bellare; Mihir,9999,0,9999,0
1668489835857,CSE 293,003,119122,Berg-Kirkpatrick; Taylor D,9999,0,9999,0
1668489835857,CSE 293,004,119135,Christensen; Henrik I,9999,0,9999,0
1668489835857,CSE 293,005,119142,Cottrell; Garrison W,9999,0,9999,0
1668489835857,CSE 293,006,119146,Deutsch; Alin Bernard,9999,0,9999,0
1668489835857,CSE 293,007,119159,Esmaeilzadeh; Hadi,9999,0,9999,0
1668489835857,CSE 293,008,119166,Freund; Yoav,9999,0,9999,0
1668489835857,CSE 293,009,119170,Griswold; William G.,9999,0,9999,0
1668489835857,CSE 293,010,119183,Gymrek; Melissa Ann,9999,0,9999,0
1668489835857,CSE 293,011,119190,Heninger; Nadia A,9999,0,9999,0
1668489835857,CSE 293,012,119230,Impagliazzo; Russell,9999,0,9999,0
1668489835857,CSE 293,013,119232,Jhala; Ranjit,9999,0,9999,0
1668489835857,CSE 293,014,119233,Kahng; Andrew Byun,9999,0,9999,0
1668489835857,CSE 293,015,119298,Kane; Daniel Mertz,9999,0,9999,0
1668489835857,CSE 293,016,119299,Kriegman; David J,9999,0,9999,0
1668489835857,CSE 293,017,119300,Kumar; Arun Kumar,9999,0,9999,0
1668489835857,CSE 293,018,119301,Lerner; Sorin,9999,0,9999,0
1668489835857,CSE 293,019,119302,Lovett; Shachar,9999,0,9999,0
1668489835857,CSE 293,020,119303,McAuley; Julian John,9999,0,9999,0
1668489835857,CSE 293,021,119304,Micciancio; Daniele,9999,0,9999,0
1668489835857,CSE 293,022,119367,Orailoglu; Alex,9999,0,9999,0
1668489835857,CSE 293,023,119382,Paturi; Ramamohan,9999,0,9999,0
1668489835857,CSE 293,024,119404,Polikarpova; Nadezhda,9999,0,9999,0
1668489835857,CSE 293,025,119406,Politz; Joseph Gibbs,9999,0,9999,0
1668489835857,CSE 293,026,119411,Porter; George M,9999,0,9999,0
1668489835857,CSE 293,027,119414,Porter; Leonard Emerson,9999,0,9999,0
1668489835857,CSE 293,028,119416,Ramamoorthi; Ravi,9999,0,9999,0
1668489835857,CSE 293,029,119417,Sahoo; Debashis,9999,0,9999,0
1668489835857,CSE 293,030,119420,Saul; Lawrence,9999,0,9999,0
1668489835857,CSE 293,031,119421,Savage; Stefan,9999,0,9999,0
1668489835857,CSE 293,032,119425,Schulze; Jurgen P.,9999,0,9999,0
1668489835857,CSE 293,033,119426,Snoeren; Alex C.,9999,0,9999,0
1668489835857,CSE 293,034,119428,Shang; Jingbo,9999,0,9999,0
1668489835857,CSE 293,035,119430,Stefan; Deian,9999,0,9999,0
1668489835857,CSE 293,036,119431,Su; Hao,9999,0,9999,0
1668489835857,CSE 293,037,119433,Swanson; Steven James,9999,0,9999,0
1668489835857,CSE 293,038,119435,Tullsen; Dean Michael,9999,0,9999,0
1668489835857,CSE 293,039,119483,Voelker; Geoffrey M.,9999,0,9999,0
1668489835857,CSE 293,040,119537,Zhao; Jishen,9999,0,9999,0
1668489835857,CSE 293,041,119538,Zhou; Yuan-Yuan,9999,0,9999,0
1668489835857,CSE 293,042,119539,Gao; Sicun,9999,0,9999,0
1668489835857,CSE 293,043,119540,Weibel; Nadir,9999,0,9999,0
1668489835857,CSE 293,044,119541,Gupta; Rajesh K.,9999,0,9999,0
1668489835857,CSE 293,045,126410,Vaccaro; Kristen Marie,9999,0,9999,0
1668489835857,CSE 293,046,126411,Klemke; Richard,9999,0,9999,0
1668489836290,CSE 294,A00,102459,Voelker; Geoffrey M.,0,2,0,0
1668489836290,CSE 294,B00,111322,Orailoglu; Alex,0,2,0,0
1668489836713,DSE 201,A00,096914,Deutsch; Alin Bernard,30,0,30,0
1668489837139,DSE 210,A00,096915,Dasgupta; Sanjoy,30,0,30,0
1668489837566,DSE 260A,A00,096916,Altintas De Callaf; Ilkay,30,0,30,0
1668489838002,ECE 200,001,103586,Antipa; Nicholas A,9999,0,9999,0
1668489838002,ECE 200,002,103587,Atanasov; Nikolay A.,9999,0,9999,0
1668489838002,ECE 200,003,103588,Bharadia; Dinesh,9999,0,9999,0
1668489838002,ECE 200,004,103589,Cheng; Chung Kuan,9999,0,9999,0
1668489838002,ECE 200,005,103590,Cosman; Pamela C.,9999,0,9999,0
1668489838002,ECE 200,006,103591,Dayeh; Shadi Ahmad,9999,0,9999,0
1668489838002,ECE 200,007,103592,Fainman; Yeshaiahu,9999,0,9999,0
1668489838002,ECE 200,008,103593,Ford; Joseph Earl,9999,0,9999,0
1668489838002,ECE 200,009,103594,Franceschetti; Massimo,9999,0,9999,0
1668489838002,ECE 200,010,103595,Fullerton; Eric E,9999,0,9999,0
1668489838002,ECE 200,011,103596,Galton; Ian A,9999,0,9999,0
1668489838002,ECE 200,012,103597,Gilja; Vikash,9999,0,9999,0
1668489838002,ECE 200,013,103598,Hall; Drew A.,9999,0,9999,0
1668489838002,ECE 200,014,103599,Hsueh; Tzu-Chien,9999,0,9999,0
1668489838002,ECE 200,015,103600,Javidi; Tara,9999,0,9999,0
1668489838002,ECE 200,016,103601,Kahng; Andrew Byun,9999,0,9999,0
1668489838002,ECE 200,017,103602,Kim; Young-Han,9999,0,9999,0
1668489838002,ECE 200,018,103603,Koushanfar; Farinaz,9999,0,9999,0
1668489838002,ECE 200,019,103604,Kuzum; Duygu,9999,0,9999,0
1668489838002,ECE 200,020,103605,Le; Hanh-Phuc,9999,0,9999,0
1668489838002,ECE 200,021,103606,Lin; Bill,9999,0,9999,0
1668489838002,ECE 200,022,103607,Liu; Zhaowei,9998,0,9999,1
1668489838002,ECE 200,023,103608,Lo; Yu-Hwa,9999,0,9999,0
1668489838002,ECE 200,024,103609,Lomakin; Vitaliy,9999,0,9999,0
1668489838002,ECE 200,025,103610,Mercier; Patrick Philip,9999,0,9999,0
1668489838002,ECE 200,026,103611,Meyer; Florian,9999,0,9999,0
1668489838002,ECE 200,027,103612,Milstein; Laurence B.,9999,0,9999,0
1668489838002,ECE 200,028,103613,Mir Arabbaygi; Siavash,9999,0,9999,0
1668489838002,ECE 200,029,103614,Mookherjea; Shayan,9999,0,9999,0
1668489838002,ECE 200,030,103615,Morris; Karcher William,9999,0,9999,0
1668489838002,ECE 200,031,103616,Ng; Tse Nga,9999,0,9999,0
1668489838002,ECE 200,032,103617,Nguyen; Truong Quang,9999,0,9999,0
1668489838002,ECE 200,033,103618,Nomura; Kenji,9999,0,9999,0
1668489838002,ECE 200,034,103619,Orlitsky; Alon,9999,0,9999,0
1668489838002,ECE 200,035,103620,Pal; Piya,9999,0,9999,0
1668489838002,ECE 200,036,103621,Papen; George C.,9999,0,9999,0
1668489838002,ECE 200,037,103622,Radic; Stojan,9999,0,9999,0
1668489838002,ECE 200,038,103623,Rao; Bhaskar D.,9999,0,9999,0
1668489838002,ECE 200,039,103624,Rao; Ramesh R,9999,0,9999,0
1668489838002,ECE 200,040,103625,Rebeiz; Gabriel,9999,0,9999,0
1668489838002,ECE 200,041,103626,Sanford; John R,9999,0,9999,0
1668489838002,ECE 200,042,103627,Siegel; Paul H.,9999,0,9999,0
1668489838002,ECE 200,043,103628,Sievenpiper; Daniel F.,9999,0,9999,0
1668489838002,ECE 200,044,103629,Sworder; David D.,9999,0,9999,0
1668489838002,ECE 200,045,103630,Taur; Yuan,9999,0,9999,0
1668489838002,ECE 200,046,103631,Touri; Behrouz,9999,0,9999,0
1668489838002,ECE 200,047,103632,Trivedi; Mohan M.,9999,0,9999,0
1668489838002,ECE 200,048,103633,Vasconcelos; Nuno,9999,0,9999,0
1668489838002,ECE 200,049,103634,Wang; Xiaolong,9999,0,9999,0
1668489838002,ECE 200,050,103635,Xie; Pengtao,9999,0,9999,0
1668489838002,ECE 200,051,103636,Yip; Michael,9999,0,9999,0
1668489838002,ECE 200,052,103637,Zeger; Kenneth A.,999,0,999,0
1668489838002,ECE 200,053,103638,Zhang; Xinyu,9999,0,9999,0
1668489838002,ECE 200,054,103639,Turakhia; Yatish Girish,9999,0,9999,0
1668489838002,ECE 200,055,103640,Kang; Mingu,9999,0,9999,0
1668489838002,ECE 200,056,103641,Shi; Yuanyuan,9999,0,9999,0
1668489838002,ECE 200,057,103642,Wang; Edward Jay,9999,0,9999,0
1668489838002,ECE 200,058,103643,Zheng; Yang,9999,0,9999,0
1668489838425,ECE 202,A00,103644,Kuzum; Duygu,0,43,0,0
1668489838849,ECE 212BN,A00,103646,Ng; Tse Nga,0,9,0,0
1668489839273,ECE 221,A00,111493,Staff,0,0,0,0
1668489839698,ECE 222B,A00,103647,Lomakin; Vitaliy,0,18,0,0
1668489840125,ECE 230B,A00,103648,Taur; Yuan,0,2,0,0
1668489840569,ECE 238B,A00,103649,Garay; Javier,0,0,0,0
1668489841000,ECE 240B,A00,112900,Fainman; Yeshaiahu,0,7,0,0
1668489841422,ECE 247A,A00,103650,Jokerst; Jesse Vincent,0,6,0,0
1668489841846,ECE 247B,A00,103651,Wang; Joseph,0,13,0,0
1668489842274,ECE 250,A00,103652,Siegel; Paul H.,0,82,0,0
1668489842701,ECE 251A,A00,103654,Rao; Bhaskar D.,0,61,0,0
1668489843125,ECE 257B,A00,103655,Bharadia; Dinesh,0,32,0,0
1668489843549,ECE 258A,A00,103656,Milstein; Laurence B.,0,28,0,0
1668489843975,ECE 260B,A00,103658,Kang; Mingu,0,119,0,0
1668489844401,ECE 264A,A00,103659,Galton; Ian A,0,66,0,0
1668489844834,ECE 265A,A00,103661,Gudem; Prasad S.S.,0,68,0,0
1668489845260,ECE 265D,A00,103662,Gudem; Prasad S.S.,0,24,0,0
1668489845683,ECE 268,A00,103663,Koushanfar; Farinaz,0,41,0,0
1668489846110,ECE 269,A01,103665,Pal; Piya,0,212,0,0
1668489846539,ECE 271B,A00,103666,Vasconcelos; Manuela,0,74,0,0
1668489846964,ECE 276A,A00,103667,Atanasov; Nikolay A.,0,123,0,0
1668489847388,ECE 277,A00,103668,An; Cheolhong,0,147,0,0
1668489847820,ECE 279,A00,117947,Hall; Drew A.,0,22,0,0
1668489848678,ECE 283,A00,103670,Hsueh; Tzu-Chien,0,51,0,0
1668489849101,ECE 284,A00,103671,Turakhia; Yatish Girish,0,39,0,0
1668489849529,ECE 285,A00,103672,Zheng; Yang,0,39,0,0
1668489849529,ECE 285,B00,103673,Sworder; David D.,0,56,0,0
1668489849953,ECE 287,A00,103676,Javidi; Tara,0,8,0,0
1668489850383,MATH 200B,A00,098023,Salehi Golsefidy; Alireza,10,0,15,5
1668489850808,MATH 202B,A00,098024,Rhoades; Brendon Patrick,7,0,15,8
1668489851231,MATH 203B,A00,098025,Oprea; Dragos N.,9,0,15,6
1668489851659,MATH 204B,A00,098026,Sorensen; Claus M,13,0,15,2
1668489852087,MATH 208,A00,098027,Izadi; Elham,7,0,10,3
1668489852511,MATH 209,A00,098028,Pollack; Aaron,10,0,10,0
1668489852937,MATH 211A,A00,112919,Rogalski; Daniel,8,0,10,2
1668489853359,MATH 211B,A00,112920,Seward; Brandon M.,9,0,10,1
1668489853876,MATH 218,A00,098029,Li; Bo,10,0,10,0
1668489854300,MATH 220B,A00,098030,Novak; Jonathan I,11,0,15,4
1668489854731,MATH 221A,A00,098031,Ebenfelt; Peter F,12,0,15,3
1668489855156,MATH 231B,A00,098032,Zlatos; Andrej,11,0,15,4
1668489855582,MATH 240B,A00,098033,Ni; Lei,7,0,15,8
1668489856009,MATH 243,A00,098034,Jekel; David Andrew,10,0,10,0
1668489856432,MATH 245A,A00,098035,Nie; Jiawang,0,4,15,18
1668489856857,MATH 248,A00,098036,Bejenaru; Ioan,10,0,10,0
1668489857282,MATH 250B,A00,098037,Spolaor; Luca,14,0,15,1
1668489857707,MATH 258,A00,098038,Ni; Lei,9,0,10,1
1668489858133,MATH 264B,A00,098041,Rhoades; Brendon Patrick,8,0,15,7
1668489858560,MATH 268,A00,098042,Buss; Samuel R,10,0,10,0
1668489858992,MATH 269,A00,098043,Rhoades; Brendon Patrick,10,0,10,0
1668489859417,MATH 270B,A00,098044,Li; Bo,6,0,15,9
1668489859840,MATH 272B,A00,098045,Holst; Michael J,13,0,15,2
1668489860268,MATH 273A,A00,098046,Tian; Xiaochuan,10,0,15,5
1668489860692,MATH 275,A01,098048,Tian; Xiaochuan,6,0,10,4
1668489861116,MATH 278A,A00,098049,Holst; Michael J,7,0,10,3
1668489861549,MATH 278B,A00,098050,Cloninger; Alexander,10,0,10,0
1668489861972,MATH 278C,A00,098051,Nie; Jiawang,5,0,10,5
1668489862398,MATH 280B,A00,098052,Zheng; Tianyi,7,0,15,8
1668489862822,MATH 281B,A00,098053,Bradic; Jelena,0,2,15,15
1668489863248,MATH 282B,A00,098054,Arias-Castro; Ery,0,1,15,15
1668489863676,MATH 285,A00,098055,Fitzsimmons; Patrick J,0,2,15,17
1668489864099,MATH 287B,A00,098056,Arias-Castro; Ery,1,0,15,14
1668489864524,MATH 288,A00,098057,Agarwal; Pooja,9,0,10,1
1668489864524,MATH 288,B00,098058,Zhang; Danna,8,0,10,2
1668489864524,MATH 288,C00,098059,Williams; Ruth J,9,0,10,1
1668489864951,MATH 290B,A00,098060,Roberts; Justin Deritter,12,0,15,3
1668489865375,MATH 292,A00,098061,Belmont; Eva Kinoshita,10,0,10,0
1668489865798,MATH 295,A00,098062,Suk; Andrew Hoon,47,0,50,3
1668489866221,MATH 296,A00,098063,Novak; Jonathan I,20,0,20,0
1668489866649,MATH 297,001,098064,Gamst; Anthony Collins,9997,0,9999,2
1668490368208,COGS 205,A00,101395,Chiba; Andrea,19,0,20,1
1668490368632,COGS 210B,001,101404,Greene; Deanna Jacquelyn,9998,0,9999,1
1668490368632,COGS 210B,002,101417,Xia; Haijun,9999,0,9999,0
1668490368632,COGS 210B,003,101422,Nitz; Douglas A.,9999,0,9999,0
1668490368632,COGS 210B,004,101423,Hollan; James D.,9998,0,9999,1
1668490368632,COGS 210B,005,101424,Deak; Gedeon O.,9998,0,9999,1
1668490368632,COGS 210B,006,101425,Rossano; Federico,9999,0,9999,0
1668490369057,COGS 211B,A00,101427,Coulson; Seana M,9996,0,9999,3
1668490369481,COGS 220,A00,101428,Hollan; James D.,1,11,25,24
1668490369904,COGS 229,A00,101429,Dow; Steven P,17,0,25,8
1668490370328,COGS 230,A00,101430,Klemmer; Scott R,8,0,17,9
1668490370751,COGS 234,A00,101431,Xia; Haijun,2,0,25,23
1668490371176,COGS 260,A00,101432,Kiyonaga; Anastasia,21,0,25,4
1668490371176,COGS 260,B00,101433,Kirsh; David Joel,15,0,25,10
1668490371598,CSE 202,A00,102371,Impagliazzo; Russell,0,64,0,0
1668490372024,CSE 203B,A01,102373,Cheng; Chung Kuan,0,53,0,0
1668490372451,CSE 208,A00,102374,Micciancio; Daniele,0,5,0,0
1668490372877,CSE 209A,A00,112895,Impagliazzo; Russell,0,12,15,15
1668490373308,CSE 209B,A00,108005,Bellare; Mihir,0,7,0,0
1668490373731,CSE 210,A00,113163,Coblenz; Michael J,0,80,0,0
1668490374261,CSE 219,A00,106111,Dow; Steven P,0,6,20,20
1668490374688,CSE 221,A00,102376,Voelker; Geoffrey M.,0,70,0,0
1668490375112,CSE 224,A01,102378,Porter; George M,0,160,0,0
1668490375538,CSE 229A,A00,102379,Savage; Stefan,0,10,0,0
1668490375965,CSE 229C,A00,102380,Munyaka; Imani N. S.,0,10,0,0
1668490376396,CSE 232B,A00,102382,Deutsch; Alin Bernard,0,31,0,0
1668490376821,CSE 234,A01,112904,Kumar; Arun Kumar,0,0,0,0
1668490377244,CSE 237A,A00,102383,Rosing; Tajana Simunic,0,50,0,0
1668490377667,CSE 239A,A00,102384,Deutsch; Alin Bernard,0,14,0,0
1668490378090,CSE 239B,A00,102385,Polikarpova; Nadezhda,0,10,0,0
1668490378514,CSE 240A,A00,102386,Pannuto; Patrick William,0,44,0,0
1668490378952,CSE 240B,A00,102387,Zhao; Jishen,0,43,0,0
1668490379378,CSE 241A,A00,106406,Kang; Mingu,0,7,0,0
1668490379815,CSE 249B,A00,102388,Kahng; Andrew Byun,0,5,8,8
1668490380241,CSE 251B,A01,102392,Cottrell; Garrison W,0,46,0,0
1668490380241,CSE 251B,A02,102393,Cottrell; Garrison W,0,34,0,0
1668490380667,CSE 252B,A00,102394,Ochoa; Benjamin Lawrence,0,58,0,0
1668490381093,CSE 257,A01,102396,Gao; Sicun,0,133,0,0
1668490381521,CSE 272,A00,102397,Li; Tzumao,0,17,0,0
1668490381942,CSE 274,A00,111323,Chern; Albert Ren-Haur,0,15,0,0
1668490382366,CSE 282,A00,102398,Pevzner; Pavel Arkadjevich,0,0,0,0
1668490382792,CSE 284,A00,114175,Gymrek; Melissa Ann,0,22,0,0
1668490383223,CSE 290,A00,102399,Chandraker; Manmohan Krishna,0,11,0,0
1668490383223,CSE 290,B00,102400,Vaccaro; Kristen Marie,0,7,25,25
1668490383223,CSE 290,C00,102414,Pannuto; Patrick William,0,1,25,25
1668490383223,CSE 290,D00,102427,Pevzner; Pavel Arkadjevich,0,0,0,0
1668490383223,CSE 290,E00,102429,Zhao; Jishen,0,4,0,0
1668490383223,CSE 290,F00,102436,Tullsen; Dean Michael,0,5,0,0
1668490383223,CSE 290,G00,102440,Christensen; Henrik I,0,6,20,20
1668490383648,CSE 291,A00,102443,Su; Hao,0,0,0,0
1668490383648,CSE 291,B00,102448,Polikarpova; Nadezhda,0,0,0,0
1668490383648,CSE 291,C00,102453,Vaccaro; Kristen Marie,0,0,0,0
1668490383648,CSE 291,D00,111343,Savage; Stefan,0,0,0,0
1668490383648,CSE 291,E00,116474,Claffy; Kimberly Claire,0,0,0,0
1668490383648,CSE 291,F00,116479,Pasquale; Joseph,0,0,0,0
1668490384080,CSE 293,001,119111,Bafna; Vineet,9999,0,9999,0
1668490384080,CSE 293,002,119118,Bellare; Mihir,9999,0,9999,0
1668490384080,CSE 293,003,119122,Berg-Kirkpatrick; Taylor D,9999,0,9999,0
1668490384080,CSE 293,004,119135,Christensen; Henrik I,9999,0,9999,0
1668490384080,CSE 293,005,119142,Cottrell; Garrison W,9999,0,9999,0
1668490384080,CSE 293,006,119146,Deutsch; Alin Bernard,9999,0,9999,0
1668490384080,CSE 293,007,119159,Esmaeilzadeh; Hadi,9999,0,9999,0
1668490384080,CSE 293,008,119166,Freund; Yoav,9999,0,9999,0
1668490384080,CSE 293,009,119170,Griswold; William G.,9999,0,9999,0
1668490384080,CSE 293,010,119183,Gymrek; Melissa Ann,9999,0,9999,0
1668490384080,CSE 293,011,119190,Heninger; Nadia A,9999,0,9999,0
1668490384080,CSE 293,012,119230,Impagliazzo; Russell,9999,0,9999,0
1668490384080,CSE 293,013,119232,Jhala; Ranjit,9999,0,9999,0
1668490384080,CSE 293,014,119233,Kahng; Andrew Byun,9999,0,9999,0
1668490384080,CSE 293,015,119298,Kane; Daniel Mertz,9999,0,9999,0
1668490384080,CSE 293,016,119299,Kriegman; David J,9999,0,9999,0
1668490384080,CSE 293,017,119300,Kumar; Arun Kumar,9999,0,9999,0
1668490384080,CSE 293,018,119301,Lerner; Sorin,9999,0,9999,0
1668490384080,CSE 293,019,119302,Lovett; Shachar,9999,0,9999,0
1668490384080,CSE 293,020,119303,McAuley; Julian John,9999,0,9999,0
1668490384080,CSE 293,021,119304,Micciancio; Daniele,9999,0,9999,0
1668490384080,CSE 293,022,119367,Orailoglu; Alex,9999,0,9999,0
1668490384080,CSE 293,023,119382,Paturi; Ramamohan,9999,0,9999,0
1668490384080,CSE 293,024,119404,Polikarpova; Nadezhda,9999,0,9999,0
1668490384080,CSE 293,025,119406,Politz; Joseph Gibbs,9999,0,9999,0
1668490384080,CSE 293,026,119411,Porter; George M,9999,0,9999,0
1668490384080,CSE 293,027,119414,Porter; Leonard Emerson,9999,0,9999,0
1668490384080,CSE 293,028,119416,Ramamoorthi; Ravi,9999,0,9999,0
1668490384080,CSE 293,029,119417,Sahoo; Debashis,9999,0,9999,0
1668490384080,CSE 293,030,119420,Saul; Lawrence,9999,0,9999,0
1668490384080,CSE 293,031,119421,Savage; Stefan,9999,0,9999,0
1668490384080,CSE 293,032,119425,Schulze; Jurgen P.,9999,0,9999,0
1668490384080,CSE 293,033,119426,Snoeren; Alex C.,9999,0,9999,0
1668490384080,CSE 293,034,119428,Shang; Jingbo,9999,0,9999,0
1668490384080,CSE 293,035,119430,Stefan; Deian,9999,0,9999,0
1668490384080,CSE 293,036,119431,Su; Hao,9999,0,9999,0
1668490384080,CSE 293,037,119433,Swanson; Steven James,9999,0,9999,0
1668490384080,CSE 293,038,119435,Tullsen; Dean Michael,9999,0,9999,0
1668490384080,CSE 293,039,119483,Voelker; Geoffrey M.,9999,0,9999,0
1668490384080,CSE 293,040,119537,Zhao; Jishen,9999,0,9999,0
1668490384080,CSE 293,041,119538,Zhou; Yuan-Yuan,9999,0,9999,0
1668490384080,CSE 293,042,119539,Gao; Sicun,9999,0,9999,0
1668490384080,CSE 293,043,119540,Weibel; Nadir,9999,0,9999,0
1668490384080,CSE 293,044,119541,Gupta; Rajesh K.,9999,0,9999,0
1668490384080,CSE 293,045,126410,Vaccaro; Kristen Marie,9999,0,9999,0
1668490384080,CSE 293,046,126411,Klemke; Richard,9999,0,9999,0
1668490384508,CSE 294,A00,102459,Voelker; Geoffrey M.,0,2,0,0
1668490384508,CSE 294,B00,111322,Orailoglu; Alex,0,2,0,0
1668490384932,DSE 201,A00,096914,Deutsch; Alin Bernard,30,0,30,0
1668490385360,DSE 210,A00,096915,Dasgupta; Sanjoy,30,0,30,0
1668490385783,DSE 260A,A00,096916,Altintas De Callaf; Ilkay,30,0,30,0
1668490386229,ECE 200,001,103586,Antipa; Nicholas A,9999,0,9999,0
1668490386229,ECE 200,002,103587,Atanasov; Nikolay A.,9999,0,9999,0
1668490386229,ECE 200,003,103588,Bharadia; Dinesh,9999,0,9999,0
1668490386229,ECE 200,004,103589,Cheng; Chung Kuan,9999,0,9999,0
1668490386229,ECE 200,005,103590,Cosman; Pamela C.,9999,0,9999,0
1668490386229,ECE 200,006,103591,Dayeh; Shadi Ahmad,9999,0,9999,0
1668490386229,ECE 200,007,103592,Fainman; Yeshaiahu,9999,0,9999,0
1668490386229,ECE 200,008,103593,Ford; Joseph Earl,9999,0,9999,0
1668490386229,ECE 200,009,103594,Franceschetti; Massimo,9999,0,9999,0
1668490386229,ECE 200,010,103595,Fullerton; Eric E,9999,0,9999,0
1668490386229,ECE 200,011,103596,Galton; Ian A,9999,0,9999,0
1668490386229,ECE 200,012,103597,Gilja; Vikash,9999,0,9999,0
1668490386229,ECE 200,013,103598,Hall; Drew A.,9999,0,9999,0
1668490386229,ECE 200,014,103599,Hsueh; Tzu-Chien,9999,0,9999,0
1668490386229,ECE 200,015,103600,Javidi; Tara,9999,0,9999,0
1668490386229,ECE 200,016,103601,Kahng; Andrew Byun,9999,0,9999,0
1668490386229,ECE 200,017,103602,Kim; Young-Han,9999,0,9999,0
1668490386229,ECE 200,018,103603,Koushanfar; Farinaz,9999,0,9999,0
1668490386229,ECE 200,019,103604,Kuzum; Duygu,9999,0,9999,0
1668490386229,ECE 200,020,103605,Le; Hanh-Phuc,9999,0,9999,0
1668490386229,ECE 200,021,103606,Lin; Bill,9999,0,9999,0
1668490386229,ECE 200,022,103607,Liu; Zhaowei,9998,0,9999,1
1668490386229,ECE 200,023,103608,Lo; Yu-Hwa,9999,0,9999,0
1668490386229,ECE 200,024,103609,Lomakin; Vitaliy,9999,0,9999,0
1668490386229,ECE 200,025,103610,Mercier; Patrick Philip,9999,0,9999,0
1668490386229,ECE 200,026,103611,Meyer; Florian,9999,0,9999,0
1668490386229,ECE 200,027,103612,Milstein; Laurence B.,9999,0,9999,0
1668490386229,ECE 200,028,103613,Mir Arabbaygi; Siavash,9999,0,9999,0
1668490386229,ECE 200,029,103614,Mookherjea; Shayan,9999,0,9999,0
1668490386229,ECE 200,030,103615,Morris; Karcher William,9999,0,9999,0
1668490386229,ECE 200,031,103616,Ng; Tse Nga,9999,0,9999,0
1668490386229,ECE 200,032,103617,Nguyen; Truong Quang,9999,0,9999,0
1668490386229,ECE 200,033,103618,Nomura; Kenji,9999,0,9999,0
1668490386229,ECE 200,034,103619,Orlitsky; Alon,9999,0,9999,0
1668490386229,ECE 200,035,103620,Pal; Piya,9999,0,9999,0
1668490386229,ECE 200,036,103621,Papen; George C.,9999,0,9999,0
1668490386229,ECE 200,037,103622,Radic; Stojan,9999,0,9999,0
1668490386229,ECE 200,038,103623,Rao; Bhaskar D.,9999,0,9999,0
1668490386229,ECE 200,039,103624,Rao; Ramesh R,9999,0,9999,0
1668490386229,ECE 200,040,103625,Rebeiz; Gabriel,9999,0,9999,0
1668490386229,ECE 200,041,103626,Sanford; John R,9999,0,9999,0
1668490386229,ECE 200,042,103627,Siegel; Paul H.,9999,0,9999,0
1668490386229,ECE 200,043,103628,Sievenpiper; Daniel F.,9999,0,9999,0
1668490386229,ECE 200,044,103629,Sworder; David D.,9999,0,9999,0
1668490386229,ECE 200,045,103630,Taur; Yuan,9999,0,9999,0
1668490386229,ECE 200,046,103631,Touri; Behrouz,9999,0,9999,0
1668490386229,ECE 200,047,103632,Trivedi; Mohan M.,9999,0,9999,0
1668490386229,ECE 200,048,103633,Vasconcelos; Nuno,9999,0,9999,0
1668490386229,ECE 200,049,103634,Wang; Xiaolong,9999,0,9999,0
1668490386229,ECE 200,050,103635,Xie; Pengtao,9999,0,9999,0
1668490386229,ECE 200,051,103636,Yip; Michael,9999,0,9999,0
1668490386229,ECE 200,052,103637,Zeger; Kenneth A.,999,0,999,0
1668490386229,ECE 200,053,103638,Zhang; Xinyu,9999,0,9999,0
1668490386229,ECE 200,054,103639,Turakhia; Yatish Girish,9999,0,9999,0
1668490386229,ECE 200,055,103640,Kang; Mingu,9999,0,9999,0
1668490386229,ECE 200,056,103641,Shi; Yuanyuan,9999,0,9999,0
1668490386229,ECE 200,057,103642,Wang; Edward Jay,9999,0,9999,0
1668490386229,ECE 200,058,103643,Zheng; Yang,9999,0,9999,0
1668490386654,ECE 202,A00,103644,Kuzum; Duygu,0,43,0,0
1668490387077,ECE 212BN,A00,103646,Ng; Tse Nga,0,9,0,0
1668490387504,ECE 221,A00,111493,Staff,0,0,0,0
1668490387933,ECE 222B,A00,103647,Lomakin; Vitaliy,0,18,0,0
1668490388357,ECE 230B,A00,103648,Taur; Yuan,0,2,0,0
1668490388782,ECE 238B,A00,103649,Garay; Javier,0,0,0,0
1668490389208,ECE 240B,A00,112900,Fainman; Yeshaiahu,0,7,0,0
1668490389632,ECE 247A,A00,103650,Jokerst; Jesse Vincent,0,6,0,0
1668490390060,ECE 247B,A00,103651,Wang; Joseph,0,13,0,0
1668490390487,ECE 250,A00,103652,Siegel; Paul H.,0,82,0,0
1668490390916,ECE 251A,A00,103654,Rao; Bhaskar D.,0,61,0,0
1668490391341,ECE 257B,A00,103655,Bharadia; Dinesh,0,32,0,0
1668490391765,ECE 258A,A00,103656,Milstein; Laurence B.,0,28,0,0
1668490392192,ECE 260B,A00,103658,Kang; Mingu,0,119,0,0
1668490392616,ECE 264A,A00,103659,Galton; Ian A,0,65,0,0
1668490393050,ECE 265A,A00,103661,Gudem; Prasad S.S.,0,69,0,0
1668490393477,ECE 265D,A00,103662,Gudem; Prasad S.S.,0,24,0,0
1668490393903,ECE 268,A00,103663,Koushanfar; Farinaz,0,41,0,0
1668490394335,ECE 269,A01,103665,Pal; Piya,0,212,0,0
1668490394758,ECE 271B,A00,103666,Vasconcelos; Manuela,0,74,0,0
1668490395182,ECE 276A,A00,103667,Atanasov; Nikolay A.,0,123,0,0
1668490395605,ECE 277,A00,103668,An; Cheolhong,0,147,0,0
1668490396036,ECE 279,A00,117947,Hall; Drew A.,0,22,0,0
1668490396886,ECE 283,A00,103670,Hsueh; Tzu-Chien,0,51,0,0
1668490397309,ECE 284,A00,103671,Turakhia; Yatish Girish,0,39,0,0
1668490397733,ECE 285,A00,103672,Zheng; Yang,0,39,0,0
1668490397733,ECE 285,B00,103673,Sworder; David D.,0,56,0,0
1668490398156,ECE 287,A00,103676,Javidi; Tara,0,8,0,0
1668490398582,MATH 200B,A00,098023,Salehi Golsefidy; Alireza,10,0,15,5
1668490399005,MATH 202B,A00,098024,Rhoades; Brendon Patrick,7,0,15,8
1668490399432,MATH 203B,A00,098025,Oprea; Dragos N.,9,0,15,6
1668490399854,MATH 204B,A00,098026,Sorensen; Claus M,13,0,15,2
1668490400278,MATH 208,A00,098027,Izadi; Elham,7,0,10,3
1668490400705,MATH 209,A00,098028,Pollack; Aaron,10,0,10,0
1668490401131,MATH 211A,A00,112919,Rogalski; Daniel,8,0,10,2
1668490401555,MATH 211B,A00,112920,Seward; Brandon M.,9,0,10,1
1668490401983,MATH 218,A00,098029,Li; Bo,10,0,10,0
1668490402408,MATH 220B,A00,098030,Novak; Jonathan I,11,0,15,4
1668490402829,MATH 221A,A00,098031,Ebenfelt; Peter F,12,0,15,3
1668490403251,MATH 231B,A00,098032,Zlatos; Andrej,11,0,15,4
1668490403674,MATH 240B,A00,098033,Ni; Lei,7,0,15,8
1668490404103,MATH 243,A00,098034,Jekel; David Andrew,10,0,10,0
1668490404525,MATH 245A,A00,098035,Nie; Jiawang,0,4,15,18
1668490404963,MATH 248,A00,098036,Bejenaru; Ioan,10,0,10,0
1668490405403,MATH 250B,A00,098037,Spolaor; Luca,14,0,15,1
1668490405825,MATH 258,A00,098038,Ni; Lei,9,0,10,1
1668490406254,MATH 264B,A00,098041,Rhoades; Brendon Patrick,8,0,15,7
1668490406677,MATH 268,A00,098042,Buss; Samuel R,10,0,10,0
1668490407101,MATH 269,A00,098043,Rhoades; Brendon Patrick,10,0,10,0
1668490407524,MATH 270B,A00,098044,Li; Bo,6,0,15,9
1668490407957,MATH 272B,A00,098045,Holst; Michael J,13,0,15,2
1668490408398,MATH 273A,A00,098046,Tian; Xiaochuan,10,0,15,5
1668490408823,MATH 275,A01,098048,Tian; Xiaochuan,6,0,10,4
1668490409251,MATH 278A,A00,098049,Holst; Michael J,7,0,10,3
1668490409675,MATH 278B,A00,098050,Cloninger; Alexander,10,0,10,0
1668490410099,MATH 278C,A00,098051,Nie; Jiawang,5,0,10,5
1668490410523,MATH 280B,A00,098052,Zheng; Tianyi,7,0,15,8
1668490410952,MATH 281B,A00,098053,Bradic; Jelena,0,2,15,15
1668490411377,MATH 282B,A00,098054,Arias-Castro; Ery,0,1,15,15
1668490411803,MATH 285,A00,098055,Fitzsimmons; Patrick J,0,3,15,17
1668490412232,MATH 287B,A00,098056,Arias-Castro; Ery,1,0,15,14
1668490412657,MATH 288,A00,098057,Agarwal; Pooja,9,0,10,1
1668490412657,MATH 288,B00,098058,Zhang; Danna,8,0,10,2
1668490412657,MATH 288,C00,098059,Williams; Ruth J,9,0,10,1
1668490413080,MATH 290B,A00,098060,Roberts; Justin Deritter,12,0,15,3
1668490413504,MATH 292,A00,098061,Belmont; Eva Kinoshita,10,0,10,0
1668490413929,MATH 295,A00,098062,Suk; Andrew Hoon,47,0,50,3
1668490414354,MATH 296,A00,098063,Novak; Jonathan I,20,0,20,0
1668490414780,MATH 297,001,098064,Gamst; Anthony Collins,9997,0,9999,2
1668490916027,COGS 205,A00,101395,Chiba; Andrea,19,0,20,1
1668490916464,COGS 210B,001,101404,Greene; Deanna Jacquelyn,9998,0,9999,1
1668490916464,COGS 210B,002,101417,Xia; Haijun,9999,0,9999,0
1668490916464,COGS 210B,003,101422,Nitz; Douglas A.,9999,0,9999,0
1668490916464,COGS 210B,004,101423,Hollan; James D.,9998,0,9999,1
1668490916464,COGS 210B,005,101424,Deak; Gedeon O.,9998,0,9999,1
1668490916464,COGS 210B,006,101425,Rossano; Federico,9999,0,9999,0
1668490916886,COGS 211B,A00,101427,Coulson; Seana M,9996,0,9999,3
1668490917309,COGS 220,A00,101428,Hollan; James D.,1,11,25,24
1668490917733,COGS 229,A00,101429,Dow; Steven P,17,0,25,8
1668490918159,COGS 230,A00,101430,Klemmer; Scott R,8,0,17,9
1668490918583,COGS 234,A00,101431,Xia; Haijun,2,0,25,23
1668490919011,COGS 260,A00,101432,Kiyonaga; Anastasia,21,0,25,4
1668490919011,COGS 260,B00,101433,Kirsh; David Joel,15,0,25,10
1668490919434,CSE 202,A00,102371,Impagliazzo; Russell,0,65,0,0
1668490919863,CSE 203B,A01,102373,Cheng; Chung Kuan,0,53,0,0
1668490920287,CSE 208,A00,102374,Micciancio; Daniele,0,5,0,0
1668490920710,CSE 209A,A00,112895,Impagliazzo; Russell,0,12,15,15
1668490921138,CSE 209B,A00,108005,Bellare; Mihir,0,7,0,0
1668490921561,CSE 210,A00,113163,Coblenz; Michael J,0,81,0,0
1668490921983,CSE 219,A00,106111,Dow; Steven P,0,6,20,20
1668490922412,CSE 221,A00,102376,Voelker; Geoffrey M.,0,70,0,0
1668490922835,CSE 224,A01,102378,Porter; George M,0,160,0,0
1668490923259,CSE 229A,A00,102379,Savage; Stefan,0,10,0,0
1668490923683,CSE 229C,A00,102380,Munyaka; Imani N. S.,0,10,0,0
1668490924108,CSE 232B,A00,102382,Deutsch; Alin Bernard,0,31,0,0
1668490924532,CSE 234,A01,112904,Kumar; Arun Kumar,0,0,0,0
1668490924953,CSE 237A,A00,102383,Rosing; Tajana Simunic,0,50,0,0
1668490925378,CSE 239A,A00,102384,Deutsch; Alin Bernard,0,14,0,0
1668490925801,CSE 239B,A00,102385,Polikarpova; Nadezhda,0,10,0,0
1668490926223,CSE 240A,A00,102386,Pannuto; Patrick William,0,45,0,0
1668490926647,CSE 240B,A00,102387,Zhao; Jishen,0,43,0,0
1668490927077,CSE 241A,A00,106406,Kang; Mingu,0,7,0,0
1668490927501,CSE 249B,A00,102388,Kahng; Andrew Byun,0,5,8,8
1668490927924,CSE 251B,A01,102392,Cottrell; Garrison W,0,46,0,0
1668490927924,CSE 251B,A02,102393,Cottrell; Garrison W,0,34,0,0
1668490928364,CSE 252B,A00,102394,Ochoa; Benjamin Lawrence,0,58,0,0
1668490928786,CSE 257,A01,102396,Gao; Sicun,0,133,0,0
1668490929210,CSE 272,A00,102397,Li; Tzumao,0,17,0,0
1668490929637,CSE 274,A00,111323,Chern; Albert Ren-Haur,0,15,0,0
1668490930061,CSE 282,A00,102398,Pevzner; Pavel Arkadjevich,0,0,0,0
1668490930484,CSE 284,A00,114175,Gymrek; Melissa Ann,0,22,0,0
1668490930913,CSE 290,A00,102399,Chandraker; Manmohan Krishna,0,11,0,0
1668490930913,CSE 290,B00,102400,Vaccaro; Kristen Marie,0,7,25,25
1668490930913,CSE 290,C00,102414,Pannuto; Patrick William,0,1,25,25
1668490930913,CSE 290,D00,102427,Pevzner; Pavel Arkadjevich,0,0,0,0
1668490930913,CSE 290,E00,102429,Zhao; Jishen,0,4,0,0
1668490930913,CSE 290,F00,102436,Tullsen; Dean Michael,0,5,0,0
1668490930913,CSE 290,G00,102440,Christensen; Henrik I,0,6,20,20
1668490931336,CSE 291,A00,102443,Su; Hao,0,0,0,0
1668490931336,CSE 291,B00,102448,Polikarpova; Nadezhda,0,0,0,0
1668490931336,CSE 291,C00,102453,Vaccaro; Kristen Marie,0,0,0,0
1668490931336,CSE 291,D00,111343,Savage; Stefan,0,0,0,0
1668490931336,CSE 291,E00,116474,Claffy; Kimberly Claire,0,0,0,0
1668490931336,CSE 291,F00,116479,Pasquale; Joseph,0,0,0,0
1668490931773,CSE 293,001,119111,Bafna; Vineet,9999,0,9999,0
1668490931773,CSE 293,002,119118,Bellare; Mihir,9999,0,9999,0
1668490931773,CSE 293,003,119122,Berg-Kirkpatrick; Taylor D,9999,0,9999,0
1668490931773,CSE 293,004,119135,Christensen; Henrik I,9999,0,9999,0
1668490931773,CSE 293,005,119142,Cottrell; Garrison W,9999,0,9999,0
1668490931773,CSE 293,006,119146,Deutsch; Alin Bernard,9999,0,9999,0
1668490931773,CSE 293,007,119159,Esmaeilzadeh; Hadi,9999,0,9999,0
1668490931773,CSE 293,008,119166,Freund; Yoav,9999,0,9999,0
1668490931773,CSE 293,009,119170,Griswold; William G.,9999,0,9999,0
1668490931773,CSE 293,010,119183,Gymrek; Melissa Ann,9999,0,9999,0
1668490931773,CSE 293,011,119190,Heninger; Nadia A,9999,0,9999,0
1668490931773,CSE 293,012,119230,Impagliazzo; Russell,9999,0,9999,0
1668490931773,CSE 293,013,119232,Jhala; Ranjit,9999,0,9999,0
1668490931773,CSE 293,014,119233,Kahng; Andrew Byun,9999,0,9999,0
1668490931773,CSE 293,015,119298,Kane; Daniel Mertz,9999,0,9999,0
1668490931773,CSE 293,016,119299,Kriegman; David J,9999,0,9999,0
1668490931773,CSE 293,017,119300,Kumar; Arun Kumar,9999,0,9999,0
1668490931773,CSE 293,018,119301,Lerner; Sorin,9999,0,9999,0
1668490931773,CSE 293,019,119302,Lovett; Shachar,9999,0,9999,0
1668490931773,CSE 293,020,119303,McAuley; Julian John,9999,0,9999,0
1668490931773,CSE 293,021,119304,Micciancio; Daniele,9999,0,9999,0
1668490931773,CSE 293,022,119367,Orailoglu; Alex,9999,0,9999,0
1668490931773,CSE 293,023,119382,Paturi; Ramamohan,9999,0,9999,0
1668490931773,CSE 293,024,119404,Polikarpova; Nadezhda,9999,0,9999,0
1668490931773,CSE 293,025,119406,Politz; Joseph Gibbs,9999,0,9999,0
1668490931773,CSE 293,026,119411,Porter; George M,9999,0,9999,0
1668490931773,CSE 293,027,119414,Porter; Leonard Emerson,9999,0,9999,0
1668490931773,CSE 293,028,119416,Ramamoorthi; Ravi,9999,0,9999,0
1668490931773,CSE 293,029,119417,Sahoo; Debashis,9999,0,9999,0
1668490931773,CSE 293,030,119420,Saul; Lawrence,9999,0,9999,0
1668490931773,CSE 293,031,119421,Savage; Stefan,9999,0,9999,0
1668490931773,CSE 293,032,119425,Schulze; Jurgen P.,9999,0,9999,0
1668490931773,CSE 293,033,119426,Snoeren; Alex C.,9999,0,9999,0
1668490931773,CSE 293,034,119428,Shang; Jingbo,9999,0,9999,0
1668490931773,CSE 293,035,119430,Stefan; Deian,9999,0,9999,0
1668490931773,CSE 293,036,119431,Su; Hao,9999,0,9999,0
1668490931773,CSE 293,037,119433,Swanson; Steven James,9999,0,9999,0
1668490931773,CSE 293,038,119435,Tullsen; Dean Michael,9999,0,9999,0
1668490931773,CSE 293,039,119483,Voelker; Geoffrey M.,9999,0,9999,0
1668490931773,CSE 293,040,119537,Zhao; Jishen,9999,0,9999,0
1668490931773,CSE 293,041,119538,Zhou; Yuan-Yuan,9999,0,9999,0
1668490931773,CSE 293,042,119539,Gao; Sicun,9999,0,9999,0
1668490931773,CSE 293,043,119540,Weibel; Nadir,9999,0,9999,0
1668490931773,CSE 293,044,119541,Gupta; Rajesh K.,9999,0,9999,0
1668490931773,CSE 293,045,126410,Vaccaro; Kristen Marie,9999,0,9999,0
1668490931773,CSE 293,046,126411,Klemke; Richard,9999,0,9999,0
1668490932198,CSE 294,A00,102459,Voelker; Geoffrey M.,0,2,0,0
1668490932198,CSE 294,B00,111322,Orailoglu; Alex,0,2,0,0
1668490932623,DSE 201,A00,096914,Deutsch; Alin Bernard,30,0,30,0
1668490933047,DSE 210,A00,096915,Dasgupta; Sanjoy,30,0,30,0
1668490933469,DSE 260A,A00,096916,Altintas De Callaf; Ilkay,30,0,30,0
1668490933898,ECE 200,001,103586,Antipa; Nicholas A,9999,0,9999,0
1668490933898,ECE 200,002,103587,Atanasov; Nikolay A.,9999,0,9999,0
1668490933898,ECE 200,003,103588,Bharadia; Dinesh,9999,0,9999,0
1668490933898,ECE 200,004,103589,Cheng; Chung Kuan,9999,0,9999,0
1668490933898,ECE 200,005,103590,Cosman; Pamela C.,9999,0,9999,0
1668490933898,ECE 200,006,103591,Dayeh; Shadi Ahmad,9999,0,9999,0
1668490933898,ECE 200,007,103592,Fainman; Yeshaiahu,9999,0,9999,0
1668490933898,ECE 200,008,103593,Ford; Joseph Earl,9999,0,9999,0
1668490933898,ECE 200,009,103594,Franceschetti; Massimo,9999,0,9999,0
1668490933898,ECE 200,010,103595,Fullerton; Eric E,9999,0,9999,0
1668490933898,ECE 200,011,103596,Galton; Ian A,9999,0,9999,0
1668490933898,ECE 200,012,103597,Gilja; Vikash,9999,0,9999,0
1668490933898,ECE 200,013,103598,Hall; Drew A.,9999,0,9999,0
1668490933898,ECE 200,014,103599,Hsueh; Tzu-Chien,9999,0,9999,0
1668490933898,ECE 200,015,103600,Javidi; Tara,9999,0,9999,0
1668490933898,ECE 200,016,103601,Kahng; Andrew Byun,9999,0,9999,0
1668490933898,ECE 200,017,103602,Kim; Young-Han,9999,0,9999,0
1668490933898,ECE 200,018,103603,Koushanfar; Farinaz,9999,0,9999,0
1668490933898,ECE 200,019,103604,Kuzum; Duygu,9999,0,9999,0
1668490933898,ECE 200,020,103605,Le; Hanh-Phuc,9999,0,9999,0
1668490933898,ECE 200,021,103606,Lin; Bill,9999,0,9999,0
1668490933898,ECE 200,022,103607,Liu; Zhaowei,9998,0,9999,1
1668490933898,ECE 200,023,103608,Lo; Yu-Hwa,9999,0,9999,0
1668490933898,ECE 200,024,103609,Lomakin; Vitaliy,9999,0,9999,0
1668490933898,ECE 200,025,103610,Mercier; Patrick Philip,9999,0,9999,0
1668490933898,ECE 200,026,103611,Meyer; Florian,9999,0,9999,0
1668490933898,ECE 200,027,103612,Milstein; Laurence B.,9999,0,9999,0
1668490933898,ECE 200,028,103613,Mir Arabbaygi; Siavash,9999,0,9999,0
1668490933898,ECE 200,029,103614,Mookherjea; Shayan,9999,0,9999,0
1668490933898,ECE 200,030,103615,Morris; Karcher William,9999,0,9999,0
1668490933898,ECE 200,031,103616,Ng; Tse Nga,9999,0,9999,0
1668490933898,ECE 200,032,103617,Nguyen; Truong Quang,9999,0,9999,0
1668490933898,ECE 200,033,103618,Nomura; Kenji,9999,0,9999,0
1668490933898,ECE 200,034,103619,Orlitsky; Alon,9999,0,9999,0
1668490933898,ECE 200,035,103620,Pal; Piya,9999,0,9999,0
1668490933898,ECE 200,036,103621,Papen; George C.,9999,0,9999,0
1668490933898,ECE 200,037,103622,Radic; Stojan,9999,0,9999,0
1668490933898,ECE 200,038,103623,Rao; Bhaskar D.,9999,0,9999,0
1668490933898,ECE 200,039,103624,Rao; Ramesh R,9999,0,9999,0
1668490933898,ECE 200,040,103625,Rebeiz; Gabriel,9999,0,9999,0
1668490933898,ECE 200,041,103626,Sanford; John R,9999,0,9999,0
1668490933898,ECE 200,042,103627,Siegel; Paul H.,9999,0,9999,0
1668490933898,ECE 200,043,103628,Sievenpiper; Daniel F.,9999,0,9999,0
1668490933898,ECE 200,044,103629,Sworder; David D.,9999,0,9999,0
1668490933898,ECE 200,045,103630,Taur; Yuan,9999,0,9999,0
1668490933898,ECE 200,046,103631,Touri; Behrouz,9999,0,9999,0
1668490933898,ECE 200,047,103632,Trivedi; Mohan M.,9999,0,9999,0
1668490933898,ECE 200,048,103633,Vasconcelos; Nuno,9999,0,9999,0
1668490933898,ECE 200,049,103634,Wang; Xiaolong,9999,0,9999,0
1668490933898,ECE 200,050,103635,Xie; Pengtao,9999,0,9999,0
1668490933898,ECE 200,051,103636,Yip; Michael,9999,0,9999,0
1668490933898,ECE 200,052,103637,Zeger; Kenneth A.,999,0,999,0
1668490933898,ECE 200,053,103638,Zhang; Xinyu,9999,0,9999,0
1668490933898,ECE 200,054,103639,Turakhia; Yatish Girish,9999,0,9999,0
1668490933898,ECE 200,055,103640,Kang; Mingu,9999,0,9999,0
1668490933898,ECE 200,056,103641,Shi; Yuanyuan,9999,0,9999,0
1668490933898,ECE 200,057,103642,Wang; Edward Jay,9999,0,9999,0
1668490933898,ECE 200,058,103643,Zheng; Yang,9999,0,9999,0
1668490934323,ECE 202,A00,103644,Kuzum; Duygu,0,43,0,0
1668490934745,ECE 212BN,A00,103646,Ng; Tse Nga,0,9,0,0
1668490935171,ECE 221,A00,111493,Staff,0,0,0,0
1668490935593,ECE 222B,A00,103647,Lomakin; Vitaliy,0,18,0,0
1668490936030,ECE 230B,A00,103648,Taur; Yuan,0,2,0,0
1668490936461,ECE 238B,A00,103649,Garay; Javier,0,0,0,0
1668490936884,ECE 240B,A00,112900,Fainman; Yeshaiahu,0,7,0,0
1668490937396,ECE 247A,A00,103650,Jokerst; Jesse Vincent,0,6,0,0
1668490937820,ECE 247B,A00,103651,Wang; Joseph,0,13,0,0
1668490938246,ECE 250,A00,103652,Siegel; Paul H.,0,82,0,0
1668490938671,ECE 251A,A00,103654,Rao; Bhaskar D.,0,61,0,0
1668490939095,ECE 257B,A00,103655,Bharadia; Dinesh,0,32,0,0
1668490939518,ECE 258A,A00,103656,Milstein; Laurence B.,0,28,0,0
1668490939942,ECE 260B,A00,103658,Kang; Mingu,0,119,0,0
1668490940370,ECE 264A,A00,103659,Galton; Ian A,0,65,0,0
1668490940794,ECE 265A,A00,103661,Gudem; Prasad S.S.,0,69,0,0
1668490941226,ECE 265D,A00,103662,Gudem; Prasad S.S.,0,24,0,0
1668490941650,ECE 268,A00,103663,Koushanfar; Farinaz,0,42,0,0
1668490942073,ECE 269,A01,103665,Pal; Piya,0,212,0,0
1668490942501,ECE 271B,A00,103666,Vasconcelos; Manuela,0,75,0,0
1668490942927,ECE 276A,A00,103667,Atanasov; Nikolay A.,0,124,0,0
1668490943355,ECE 277,A00,103668,An; Cheolhong,0,147,0,0
1668490943780,ECE 279,A00,117947,Hall; Drew A.,0,22,0,0
1668490944631,ECE 283,A00,103670,Hsueh; Tzu-Chien,0,51,0,0
1668490945056,ECE 284,A00,103671,Turakhia; Yatish Girish,0,39,0,0
1668490945481,ECE 285,A00,103672,Zheng; Yang,0,39,0,0
1668490945481,ECE 285,B00,103673,Sworder; David D.,0,56,0,0
1668490945906,ECE 287,A00,103676,Javidi; Tara,0,8,0,0
1668490946334,MATH 200B,A00,098023,Salehi Golsefidy; Alireza,10,0,15,5
1668490946759,MATH 202B,A00,098024,Rhoades; Brendon Patrick,7,0,15,8
1668490947183,MATH 203B,A00,098025,Oprea; Dragos N.,9,0,15,6
1668490947609,MATH 204B,A00,098026,Sorensen; Claus M,13,0,15,2
1668490948031,MATH 208,A00,098027,Izadi; Elham,7,0,10,3
1668490948455,MATH 209,A00,098028,Pollack; Aaron,10,0,10,0
1668490948882,MATH 211A,A00,112919,Rogalski; Daniel,8,0,10,2
1668490949307,MATH 211B,A00,112920,Seward; Brandon M.,9,0,10,1
1668490949742,MATH 218,A00,098029,Li; Bo,10,0,10,0
1668490950169,MATH 220B,A00,098030,Novak; Jonathan I,11,0,15,4
1668490950592,MATH 221A,A00,098031,Ebenfelt; Peter F,12,0,15,3
1668490951024,MATH 231B,A00,098032,Zlatos; Andrej,11,0,15,4
1668490951449,MATH 240B,A00,098033,Ni; Lei,7,0,15,8
1668490951873,MATH 243,A00,098034,Jekel; David Andrew,10,0,10,0
1668490952297,MATH 245A,A00,098035,Nie; Jiawang,0,4,15,18
1668490952721,MATH 248,A00,098036,Bejenaru; Ioan,10,0,10,0
1668490953151,MATH 250B,A00,098037,Spolaor; Luca,14,0,15,1
1668490953575,MATH 258,A00,098038,Ni; Lei,9,0,10,1
1668490953998,MATH 264B,A00,098041,Rhoades; Brendon Patrick,8,0,15,7
1668490954420,MATH 268,A00,098042,Buss; Samuel R,10,0,10,0
1668490954857,MATH 269,A00,098043,Rhoades; Brendon Patrick,10,0,10,0
1668490955280,MATH 270B,A00,098044,Li; Bo,6,0,15,9
1668490955706,MATH 272B,A00,098045,Holst; Michael J,13,0,15,2
1668490956128,MATH 273A,A00,098046,Tian; Xiaochuan,10,0,15,5
1668490956554,MATH 275,A01,098048,Tian; Xiaochuan,6,0,10,4
1668490956989,MATH 278A,A00,098049,Holst; Michael J,7,0,10,3
1668490957412,MATH 278B,A00,098050,Cloninger; Alexander,10,0,10,0
1668490957857,MATH 278C,A00,098051,Nie; Jiawang,5,0,10,5
1668490958296,MATH 280B,A00,098052,Zheng; Tianyi,7,0,15,8
1668490958723,MATH 281B,A00,098053,Bradic; Jelena,0,2,15,15
1668490959145,MATH 282B,A00,098054,Arias-Castro; Ery,0,1,15,15
1668490959569,MATH 285,A00,098055,Fitzsimmons; Patrick J,0,3,15,17
1668490959993,MATH 287B,A00,098056,Arias-Castro; Ery,1,0,15,14
1668490960416,MATH 288,A00,098057,Agarwal; Pooja,9,0,10,1
1668490960416,MATH 288,B00,098058,Zhang; Danna,8,0,10,2
1668490960416,MATH 288,C00,098059,Williams; Ruth J,9,0,10,1
1668490960842,MATH 290B,A00,098060,Roberts; Justin Deritter,12,0,15,3
1668490961273,MATH 292,A00,098061,Belmont; Eva Kinoshita,10,0,10,0
1668490961698,MATH 295,A00,098062,Suk; Andrew Hoon,47,0,50,3
1668490962123,MATH 296,A00,098063,Novak; Jonathan I,20,0,20,0
1668490962547,MATH 297,001,098064,Gamst; Anthony Collins,9997,0,9999,2
1668491464060,COGS 205,A00,101395,Chiba; Andrea,19,0,20,1
1668491464484,COGS 210B,001,101404,Greene; Deanna Jacquelyn,9998,0,9999,1
1668491464484,COGS 210B,002,101417,Xia; Haijun,9999,0,9999,0
1668491464484,COGS 210B,003,101422,Nitz; Douglas A.,9999,0,9999,0
1668491464484,COGS 210B,004,101423,Hollan; James D.,9998,0,9999,1
1668491464484,COGS 210B,005,101424,Deak; Gedeon O.,9998,0,9999,1
1668491464484,COGS 210B,006,101425,Rossano; Federico,9999,0,9999,0
1668491464911,COGS 211B,A00,101427,Coulson; Seana M,9996,0,9999,3
1668491465337,COGS 220,A00,101428,Hollan; James D.,1,11,25,24
1668491465763,COGS 229,A00,101429,Dow; Steven P,17,0,25,8
1668491466192,COGS 230,A00,101430,Klemmer; Scott R,8,0,17,9
1668491466614,COGS 234,A00,101431,Xia; Haijun,2,0,25,23
1668491467037,COGS 260,A00,101432,Kiyonaga; Anastasia,21,0,25,4
1668491467037,COGS 260,B00,101433,Kirsh; David Joel,15,0,25,10
1668491467465,CSE 202,A00,102371,Impagliazzo; Russell,0,65,0,0
1668491467892,CSE 203B,A01,102373,Cheng; Chung Kuan,0,53,0,0
1668491468319,CSE 208,A00,102374,Micciancio; Daniele,0,5,0,0
1668491468751,CSE 209A,A00,112895,Impagliazzo; Russell,0,12,15,15
1668491469179,CSE 209B,A00,108005,Bellare; Mihir,0,7,0,0
1668491469618,CSE 210,A00,113163,Coblenz; Michael J,0,82,0,0
1668491470043,CSE 219,A00,106111,Dow; Steven P,0,6,20,20
1668491470470,CSE 221,A00,102376,Voelker; Geoffrey M.,0,70,0,0
1668491470894,CSE 224,A01,102378,Porter; George M,0,160,0,0
1668491471321,CSE 229A,A00,102379,Savage; Stefan,0,10,0,0
1668491471749,CSE 229C,A00,102380,Munyaka; Imani N. S.,0,10,0,0
1668491472185,CSE 232B,A00,102382,Deutsch; Alin Bernard,0,31,0,0
1668491472609,CSE 234,A01,112904,Kumar; Arun Kumar,0,0,0,0
1668491473037,CSE 237A,A00,102383,Rosing; Tajana Simunic,0,51,0,0
1668491473460,CSE 239A,A00,102384,Deutsch; Alin Bernard,0,14,0,0
1668491473884,CSE 239B,A00,102385,Polikarpova; Nadezhda,0,10,0,0
1668491474308,CSE 240A,A00,102386,Pannuto; Patrick William,0,45,0,0
1668491474736,CSE 240B,A00,102387,Zhao; Jishen,0,43,0,0
1668491475170,CSE 241A,A00,106406,Kang; Mingu,0,7,0,0
1668491475594,CSE 249B,A00,102388,Kahng; Andrew Byun,0,5,8,8
1668491476023,CSE 251B,A01,102392,Cottrell; Garrison W,0,46,0,0
1668491476023,CSE 251B,A02,102393,Cottrell; Garrison W,0,34,0,0
1668491476447,CSE 252B,A00,102394,Ochoa; Benjamin Lawrence,0,58,0,0
1668491476870,CSE 257,A01,102396,Gao; Sicun,0,133,0,0
1668491477293,CSE 272,A00,102397,Li; Tzumao,0,17,0,0
1668491477721,CSE 274,A00,111323,Chern; Albert Ren-Haur,0,15,0,0
1668491478147,CSE 282,A00,102398,Pevzner; Pavel Arkadjevich,0,0,0,0
1668491478571,CSE 284,A00,114175,Gymrek; Melissa Ann,0,22,0,0
1668491478998,CSE 290,A00,102399,Chandraker; Manmohan Krishna,0,11,0,0
1668491478998,CSE 290,B00,102400,Vaccaro; Kristen Marie,0,7,25,25
1668491478998,CSE 290,C00,102414,Pannuto; Patrick William,0,1,25,25
1668491478998,CSE 290,D00,102427,Pevzner; Pavel Arkadjevich,0,0,0,0
1668491478998,CSE 290,E00,102429,Zhao; Jishen,0,4,0,0
1668491478998,CSE 290,F00,102436,Tullsen; Dean Michael,0,5,0,0
1668491478998,CSE 290,G00,102440,Christensen; Henrik I,0,6,20,20
1668491479423,CSE 291,A00,102443,Su; Hao,0,0,0,0
1668491479423,CSE 291,B00,102448,Polikarpova; Nadezhda,0,0,0,0
1668491479423,CSE 291,C00,102453,Vaccaro; Kristen Marie,0,0,0,0
1668491479423,CSE 291,D00,111343,Savage; Stefan,0,0,0,0
1668491479423,CSE 291,E00,116474,Claffy; Kimberly Claire,0,0,0,0
1668491479423,CSE 291,F00,116479,Pasquale; Joseph,0,0,0,0
1668491479853,CSE 293,001,119111,Bafna; Vineet,9999,0,9999,0
1668491479853,CSE 293,002,119118,Bellare; Mihir,9999,0,9999,0
1668491479853,CSE 293,003,119122,Berg-Kirkpatrick; Taylor D,9999,0,9999,0
1668491479853,CSE 293,004,119135,Christensen; Henrik I,9999,0,9999,0
1668491479853,CSE 293,005,119142,Cottrell; Garrison W,9999,0,9999,0
1668491479853,CSE 293,006,119146,Deutsch; Alin Bernard,9999,0,9999,0
1668491479853,CSE 293,007,119159,Esmaeilzadeh; Hadi,9999,0,9999,0
1668491479853,CSE 293,008,119166,Freund; Yoav,9999,0,9999,0
1668491479853,CSE 293,009,119170,Griswold; William G.,9999,0,9999,0
1668491479853,CSE 293,010,119183,Gymrek; Melissa Ann,9999,0,9999,0
1668491479853,CSE 293,011,119190,Heninger; Nadia A,9999,0,9999,0
1668491479853,CSE 293,012,119230,Impagliazzo; Russell,9999,0,9999,0
1668491479853,CSE 293,013,119232,Jhala; Ranjit,9999,0,9999,0
1668491479853,CSE 293,014,119233,Kahng; Andrew Byun,9999,0,9999,0
1668491479853,CSE 293,015,119298,Kane; Daniel Mertz,9999,0,9999,0
1668491479853,CSE 293,016,119299,Kriegman; David J,9999,0,9999,0
1668491479853,CSE 293,017,119300,Kumar; Arun Kumar,9999,0,9999,0
1668491479853,CSE 293,018,119301,Lerner; Sorin,9999,0,9999,0
1668491479853,CSE 293,019,119302,Lovett; Shachar,9999,0,9999,0
1668491479853,CSE 293,020,119303,McAuley; Julian John,9999,0,9999,0
1668491479853,CSE 293,021,119304,Micciancio; Daniele,9999,0,9999,0
1668491479853,CSE 293,022,119367,Orailoglu; Alex,9999,0,9999,0
1668491479853,CSE 293,023,119382,Paturi; Ramamohan,9999,0,9999,0
1668491479853,CSE 293,024,119404,Polikarpova; Nadezhda,9999,0,9999,0
1668491479853,CSE 293,025,119406,Politz; Joseph Gibbs,9999,0,9999,0
1668491479853,CSE 293,026,119411,Porter; George M,9999,0,9999,0
1668491479853,CSE 293,027,119414,Porter; Leonard Emerson,9999,0,9999,0
1668491479853,CSE 293,028,119416,Ramamoorthi; Ravi,9999,0,9999,0
1668491479853,CSE 293,029,119417,Sahoo; Debashis,9999,0,9999,0
1668491479853,CSE 293,030,119420,Saul; Lawrence,9999,0,9999,0
1668491479853,CSE 293,031,119421,Savage; Stefan,9999,0,9999,0
1668491479853,CSE 293,032,119425,Schulze; Jurgen P.,9999,0,9999,0
1668491479853,CSE 293,033,119426,Snoeren; Alex C.,9999,0,9999,0
1668491479853,CSE 293,034,119428,Shang; Jingbo,9999,0,9999,0
1668491479853,CSE 293,035,119430,Stefan; Deian,9999,0,9999,0
1668491479853,CSE 293,036,119431,Su; Hao,9999,0,9999,0
1668491479853,CSE 293,037,119433,Swanson; Steven James,9999,0,9999,0
1668491479853,CSE 293,038,119435,Tullsen; Dean Michael,9999,0,9999,0
1668491479853,CSE 293,039,119483,Voelker; Geoffrey M.,9999,0,9999,0
1668491479853,CSE 293,040,119537,Zhao; Jishen,9999,0,9999,0
1668491479853,CSE 293,041,119538,Zhou; Yuan-Yuan,9999,0,9999,0
1668491479853,CSE 293,042,119539,Gao; Sicun,9999,0,9999,0
1668491479853,CSE 293,043,119540,Weibel; Nadir,9999,0,9999,0
1668491479853,CSE 293,044,119541,Gupta; Rajesh K.,9999,0,9999,0
1668491479853,CSE 293,045,126410,Vaccaro; Kristen Marie,9999,0,9999,0
1668491479853,CSE 293,046,126411,Klemke; Richard,9999,0,9999,0
1668491480278,CSE 294,A00,102459,Voelker; Geoffrey M.,0,2,0,0
1668491480278,CSE 294,B00,111322,Orailoglu; Alex,0,2,0,0
1668491480703,DSE 201,A00,096914,Deutsch; Alin Bernard,30,0,30,0
1668491481132,DSE 210,A00,096915,Dasgupta; Sanjoy,30,0,30,0
1668491481559,DSE 260A,A00,096916,Altintas De Callaf; Ilkay,30,0,30,0
1668491481988,ECE 200,001,103586,Antipa; Nicholas A,9999,0,9999,0
1668491481988,ECE 200,002,103587,Atanasov; Nikolay A.,9999,0,9999,0
1668491481988,ECE 200,003,103588,Bharadia; Dinesh,9999,0,9999,0
1668491481988,ECE 200,004,103589,Cheng; Chung Kuan,9999,0,9999,0
1668491481988,ECE 200,005,103590,Cosman; Pamela C.,9999,0,9999,0
1668491481988,ECE 200,006,103591,Dayeh; Shadi Ahmad,9999,0,9999,0
1668491481988,ECE 200,007,103592,Fainman; Yeshaiahu,9999,0,9999,0
1668491481988,ECE 200,008,103593,Ford; Joseph Earl,9999,0,9999,0
1668491481988,ECE 200,009,103594,Franceschetti; Massimo,9999,0,9999,0
1668491481988,ECE 200,010,103595,Fullerton; Eric E,9999,0,9999,0
1668491481988,ECE 200,011,103596,Galton; Ian A,9999,0,9999,0
1668491481988,ECE 200,012,103597,Gilja; Vikash,9999,0,9999,0
1668491481988,ECE 200,013,103598,Hall; Drew A.,9999,0,9999,0
1668491481988,ECE 200,014,103599,Hsueh; Tzu-Chien,9999,0,9999,0
1668491481988,ECE 200,015,103600,Javidi; Tara,9999,0,9999,0
1668491481988,ECE 200,016,103601,Kahng; Andrew Byun,9999,0,9999,0
1668491481988,ECE 200,017,103602,Kim; Young-Han,9999,0,9999,0
1668491481988,ECE 200,018,103603,Koushanfar; Farinaz,9999,0,9999,0
1668491481988,ECE 200,019,103604,Kuzum; Duygu,9999,0,9999,0
1668491481988,ECE 200,020,103605,Le; Hanh-Phuc,9999,0,9999,0
1668491481988,ECE 200,021,103606,Lin; Bill,9999,0,9999,0
1668491481988,ECE 200,022,103607,Liu; Zhaowei,9998,0,9999,1
1668491481988,ECE 200,023,103608,Lo; Yu-Hwa,9999,0,9999,0
1668491481988,ECE 200,024,103609,Lomakin; Vitaliy,9999,0,9999,0
1668491481988,ECE 200,025,103610,Mercier; Patrick Philip,9999,0,9999,0
1668491481988,ECE 200,026,103611,Meyer; Florian,9999,0,9999,0
1668491481988,ECE 200,027,103612,Milstein; Laurence B.,9999,0,9999,0
1668491481988,ECE 200,028,103613,Mir Arabbaygi; Siavash,9999,0,9999,0
1668491481988,ECE 200,029,103614,Mookherjea; Shayan,9999,0,9999,0
1668491481988,ECE 200,030,103615,Morris; Karcher William,9999,0,9999,0
1668491481988,ECE 200,031,103616,Ng; Tse Nga,9999,0,9999,0
1668491481988,ECE 200,032,103617,Nguyen; Truong Quang,9999,0,9999,0
1668491481988,ECE 200,033,103618,Nomura; Kenji,9999,0,9999,0
1668491481988,ECE 200,034,103619,Orlitsky; Alon,9999,0,9999,0
1668491481988,ECE 200,035,103620,Pal; Piya,9999,0,9999,0
1668491481988,ECE 200,036,103621,Papen; George C.,9999,0,9999,0
1668491481988,ECE 200,037,103622,Radic; Stojan,9999,0,9999,0
1668491481988,ECE 200,038,103623,Rao; Bhaskar D.,9999,0,9999,0
1668491481988,ECE 200,039,103624,Rao; Ramesh R,9999,0,9999,0
1668491481988,ECE 200,040,103625,Rebeiz; Gabriel,9999,0,9999,0
1668491481988,ECE 200,041,103626,Sanford; John R,9999,0,9999,0
1668491481988,ECE 200,042,103627,Siegel; Paul H.,9999,0,9999,0
1668491481988,ECE 200,043,103628,Sievenpiper; Daniel F.,9999,0,9999,0
1668491481988,ECE 200,044,103629,Sworder; David D.,9999,0,9999,0
1668491481988,ECE 200,045,103630,Taur; Yuan,9999,0,9999,0
1668491481988,ECE 200,046,103631,Touri; Behrouz,9999,0,9999,0
1668491481988,ECE 200,047,103632,Trivedi; Mohan M.,9999,0,9999,0
1668491481988,ECE 200,048,103633,Vasconcelos; Nuno,9999,0,9999,0
1668491481988,ECE 200,049,103634,Wang; Xiaolong,9999,0,9999,0
1668491481988,ECE 200,050,103635,Xie; Pengtao,9999,0,9999,0
1668491481988,ECE 200,051,103636,Yip; Michael,9999,0,9999,0
1668491481988,ECE 200,052,103637,Zeger; Kenneth A.,999,0,999,0
1668491481988,ECE 200,053,103638,Zhang; Xinyu,9999,0,9999,0
1668491481988,ECE 200,054,103639,Turakhia; Yatish Girish,9999,0,9999,0
1668491481988,ECE 200,055,103640,Kang; Mingu,9999,0,9999,0
1668491481988,ECE 200,056,103641,Shi; Yuanyuan,9999,0,9999,0
1668491481988,ECE 200,057,103642,Wang; Edward Jay,9999,0,9999,0
1668491481988,ECE 200,058,103643,Zheng; Yang,9999,0,9999,0
1668491482411,ECE 202,A00,103644,Kuzum; Duygu,0,43,0,0
1668491482836,ECE 212BN,A00,103646,Ng; Tse Nga,0,9,0,0
1668491483260,ECE 221,A00,111493,Staff,0,0,0,0
1668491483686,ECE 222B,A00,103647,Lomakin; Vitaliy,0,18,0,0
1668491484126,ECE 230B,A00,103648,Taur; Yuan,0,2,0,0
1668491484558,ECE 238B,A00,103649,Garay; Javier,0,0,0,0
1668491484982,ECE 240B,A00,112900,Fainman; Yeshaiahu,0,7,0,0
1668491485412,ECE 247A,A00,103650,Jokerst; Jesse Vincent,0,6,0,0
1668491485838,ECE 247B,A00,103651,Wang; Joseph,0,13,0,0
1668491486263,ECE 250,A00,103652,Siegel; Paul H.,0,82,0,0
1668491486701,ECE 251A,A00,103654,Rao; Bhaskar D.,0,61,0,0
1668491487124,ECE 257B,A00,103655,Bharadia; Dinesh,0,32,0,0
1668491487550,ECE 258A,A00,103656,Milstein; Laurence B.,0,28,0,0
1668491487977,ECE 260B,A00,103658,Kang; Mingu,0,119,0,0
1668491488405,ECE 264A,A00,103659,Galton; Ian A,0,65,0,0
1668491488832,ECE 265A,A00,103661,Gudem; Prasad S.S.,0,69,0,0
1668491489257,ECE 265D,A00,103662,Gudem; Prasad S.S.,0,24,0,0
1668491489681,ECE 268,A00,103663,Koushanfar; Farinaz,0,42,0,0
1668491490107,ECE 269,A01,103665,Pal; Piya,0,212,0,0
1668491490533,ECE 271B,A00,103666,Vasconcelos; Manuela,0,75,0,0
1668491490957,ECE 276A,A00,103667,Atanasov; Nikolay A.,0,124,0,0
1668491491389,ECE 277,A00,103668,An; Cheolhong,0,147,0,0
1668491491815,ECE 279,A00,117947,Hall; Drew A.,0,22,0,0
1668491492665,ECE 283,A00,103670,Hsueh; Tzu-Chien,0,51,0,0
1668491493090,ECE 284,A00,103671,Turakhia; Yatish Girish,0,39,0,0
1668491493514,ECE 285,A00,103672,Zheng; Yang,0,39,0,0
1668491493514,ECE 285,B00,103673,Sworder; David D.,0,56,0,0
1668491493941,ECE 287,A00,103676,Javidi; Tara,0,8,0,0
1668491494365,MATH 200B,A00,098023,Salehi Golsefidy; Alireza,10,0,15,5
1668491494788,MATH 202B,A00,098024,Rhoades; Brendon Patrick,7,0,15,8
1668491495212,MATH 203B,A00,098025,Oprea; Dragos N.,9,0,15,6
1668491495636,MATH 204B,A00,098026,Sorensen; Claus M,13,0,15,2
1668491496060,MATH 208,A00,098027,Izadi; Elham,7,0,10,3
1668491496484,MATH 209,A00,098028,Pollack; Aaron,10,0,10,0
1668491496909,MATH 211A,A00,112919,Rogalski; Daniel,8,0,10,2
1668491497332,MATH 211B,A00,112920,Seward; Brandon M.,9,0,10,1
1668491497756,MATH 218,A00,098029,Li; Bo,10,0,10,0
1668491498192,MATH 220B,A00,098030,Novak; Jonathan I,11,0,15,4
1668491498622,MATH 221A,A00,098031,Ebenfelt; Peter F,12,0,15,3
1668491499046,MATH 231B,A00,098032,Zlatos; Andrej,11,0,15,4
1668491499472,MATH 240B,A00,098033,Ni; Lei,7,0,15,8
1668491499897,MATH 243,A00,098034,Jekel; David Andrew,10,0,10,0
1668491500320,MATH 245A,A00,098035,Nie; Jiawang,0,4,15,18
1668491500838,MATH 248,A00,098036,Bejenaru; Ioan,10,0,10,0
1668491501261,MATH 250B,A00,098037,Spolaor; Luca,14,0,15,1
1668491501688,MATH 258,A00,098038,Ni; Lei,9,0,10,1
1668491502112,MATH 264B,A00,098041,Rhoades; Brendon Patrick,8,0,15,7
1668491502539,MATH 268,A00,098042,Buss; Samuel R,10,0,10,0
1668491502962,MATH 269,A00,098043,Rhoades; Brendon Patrick,10,0,10,0
1668491503389,MATH 270B,A00,098044,Li; Bo,6,0,15,9
1668491503814,MATH 272B,A00,098045,Holst; Michael J,13,0,15,2
1668491504240,MATH 273A,A00,098046,Tian; Xiaochuan,10,0,15,5
1668491504673,MATH 275,A01,098048,Tian; Xiaochuan,6,0,10,4
1668491505103,MATH 278A,A00,098049,Holst; Michael J,7,0,10,3
1668491505527,MATH 278B,A00,098050,Cloninger; Alexander,10,0,10,0
1668491505962,MATH 278C,A00,098051,Nie; Jiawang,5,0,10,5
1668491506390,MATH 280B,A00,098052,Zheng; Tianyi,7,0,15,8
1668491506816,MATH 281B,A00,098053,Bradic; Jelena,0,2,15,15
1668491507241,MATH 282B,A00,098054,Arias-Castro; Ery,0,1,15,15
1668491507668,MATH 285,A00,098055,Fitzsimmons; Patrick J,0,3,15,17
1668491508094,MATH 287B,A00,098056,Arias-Castro; Ery,1,0,15,14
1668491508519,MATH 288,A00,098057,Agarwal; Pooja,9,0,10,1
1668491508519,MATH 288,B00,098058,Zhang; Danna,8,0,10,2
1668491508519,MATH 288,C00,098059,Williams; Ruth J,9,0,10,1
1668491508944,MATH 290B,A00,098060,Roberts; Justin Deritter,12,0,15,3
1668491509377,MATH 292,A00,098061,Belmont; Eva Kinoshita,10,0,10,0
1668491509803,MATH 295,A00,098062,Suk; Andrew Hoon,47,0,50,3
1668491510226,MATH 296,A00,098063,Novak; Jonathan I,20,0,20,0
1668491510652,MATH 297,001,098064,Gamst; Anthony Collins,9997,0,9999,2
1668492011619,COGS 205,A00,101395,Chiba; Andrea,19,0,20,1
1668492012044,COGS 210B,001,101404,Greene; Deanna Jacquelyn,9998,0,9999,1
1668492012044,COGS 210B,002,101417,Xia; Haijun,9999,0,9999,0
1668492012044,COGS 210B,003,101422,Nitz; Douglas A.,9999,0,9999,0
1668492012044,COGS 210B,004,101423,Hollan; James D.,9998,0,9999,1
1668492012044,COGS 210B,005,101424,Deak; Gedeon O.,9998,0,9999,1
1668492012044,COGS 210B,006,101425,Rossano; Federico,9999,0,9999,0
1668492012468,COGS 211B,A00,101427,Coulson; Seana M,9996,0,9999,3
1668492012900,COGS 220,A00,101428,Hollan; James D.,1,11,25,24
1668492013328,COGS 229,A00,101429,Dow; Steven P,17,0,25,8
1668492013752,COGS 230,A00,101430,Klemmer; Scott R,8,0,17,9
1668492014179,COGS 234,A00,101431,Xia; Haijun,2,0,25,23
1668492014610,COGS 260,A00,101432,Kiyonaga; Anastasia,21,0,25,4
1668492014610,COGS 260,B00,101433,Kirsh; David Joel,15,0,25,10
1668492015047,CSE 202,A00,102371,Impagliazzo; Russell,0,65,0,0
1668492015471,CSE 203B,A01,102373,Cheng; Chung Kuan,0,53,0,0
1668492015895,CSE 208,A00,102374,Micciancio; Daniele,0,5,0,0
1668492016319,CSE 209A,A00,112895,Impagliazzo; Russell,0,12,15,15
1668492016746,CSE 209B,A00,108005,Bellare; Mihir,0,7,0,0
1668492017172,CSE 210,A00,113163,Coblenz; Michael J,0,82,0,0
1668492017594,CSE 219,A00,106111,Dow; Steven P,0,6,20,20
1668492018023,CSE 221,A00,102376,Voelker; Geoffrey M.,0,70,0,0
1668492018446,CSE 224,A01,102378,Porter; George M,0,160,0,0
1668492018871,CSE 229A,A00,102379,Savage; Stefan,0,10,0,0
1668492019300,CSE 229C,A00,102380,Munyaka; Imani N. S.,0,10,0,0
1668492019730,CSE 232B,A00,102382,Deutsch; Alin Bernard,0,31,0,0
1668492020168,CSE 234,A01,112904,Kumar; Arun Kumar,0,0,0,0
1668492020688,CSE 237A,A00,102383,Rosing; Tajana Simunic,0,51,0,0
1668492021118,CSE 239A,A00,102384,Deutsch; Alin Bernard,0,14,0,0
1668492021542,CSE 239B,A00,102385,Polikarpova; Nadezhda,0,10,0,0
1668492021968,CSE 240A,A00,102386,Pannuto; Patrick William,0,45,0,0
1668492022392,CSE 240B,A00,102387,Zhao; Jishen,0,43,0,0
1668492022824,CSE 241A,A00,106406,Kang; Mingu,0,7,0,0
1668492023250,CSE 249B,A00,102388,Kahng; Andrew Byun,0,5,8,8
1668492023673,CSE 251B,A01,102392,Cottrell; Garrison W,0,46,0,0
1668492023673,CSE 251B,A02,102393,Cottrell; Garrison W,0,34,0,0
1668492024097,CSE 252B,A00,102394,Ochoa; Benjamin Lawrence,0,58,0,0
1668492024524,CSE 257,A01,102396,Gao; Sicun,0,133,0,0
1668492024957,CSE 272,A00,102397,Li; Tzumao,0,17,0,0
1668492025381,CSE 274,A00,111323,Chern; Albert Ren-Haur,0,15,0,0
1668492025806,CSE 282,A00,102398,Pevzner; Pavel Arkadjevich,0,0,0,0
1668492026233,CSE 284,A00,114175,Gymrek; Melissa Ann,0,22,0,0
1668492026656,CSE 290,A00,102399,Chandraker; Manmohan Krishna,0,11,0,0
1668492026656,CSE 290,B00,102400,Vaccaro; Kristen Marie,0,7,25,25
1668492026656,CSE 290,C00,102414,Pannuto; Patrick William,0,1,25,25
1668492026656,CSE 290,D00,102427,Pevzner; Pavel Arkadjevich,0,0,0,0
1668492026656,CSE 290,E00,102429,Zhao; Jishen,0,4,0,0
1668492026656,CSE 290,F00,102436,Tullsen; Dean Michael,0,5,0,0
1668492026656,CSE 290,G00,102440,Christensen; Henrik I,0,6,20,20
1668492027086,CSE 291,A00,102443,Su; Hao,0,0,0,0
1668492027086,CSE 291,B00,102448,Polikarpova; Nadezhda,0,0,0,0
1668492027086,CSE 291,C00,102453,Vaccaro; Kristen Marie,0,0,0,0
1668492027086,CSE 291,D00,111343,Savage; Stefan,0,0,0,0
1668492027086,CSE 291,E00,116474,Claffy; Kimberly Claire,0,0,0,0
1668492027086,CSE 291,F00,116479,Pasquale; Joseph,0,0,0,0
1668492027518,CSE 293,001,119111,Bafna; Vineet,9999,0,9999,0
1668492027518,CSE 293,002,119118,Bellare; Mihir,9999,0,9999,0
1668492027518,CSE 293,003,119122,Berg-Kirkpatrick; Taylor D,9999,0,9999,0
1668492027518,CSE 293,004,119135,Christensen; Henrik I,9999,0,9999,0
1668492027518,CSE 293,005,119142,Cottrell; Garrison W,9999,0,9999,0
1668492027518,CSE 293,006,119146,Deutsch; Alin Bernard,9999,0,9999,0
1668492027518,CSE 293,007,119159,Esmaeilzadeh; Hadi,9999,0,9999,0
1668492027518,CSE 293,008,119166,Freund; Yoav,9999,0,9999,0
1668492027518,CSE 293,009,119170,Griswold; William G.,9999,0,9999,0
1668492027518,CSE 293,010,119183,Gymrek; Melissa Ann,9999,0,9999,0
1668492027518,CSE 293,011,119190,Heninger; Nadia A,9999,0,9999,0
1668492027518,CSE 293,012,119230,Impagliazzo; Russell,9999,0,9999,0
1668492027518,CSE 293,013,119232,Jhala; Ranjit,9999,0,9999,0
1668492027518,CSE 293,014,119233,Kahng; Andrew Byun,9999,0,9999,0
1668492027518,CSE 293,015,119298,Kane; Daniel Mertz,9999,0,9999,0
1668492027518,CSE 293,016,119299,Kriegman; David J,9999,0,9999,0
1668492027518,CSE 293,017,119300,Kumar; Arun Kumar,9999,0,9999,0
1668492027518,CSE 293,018,119301,Lerner; Sorin,9999,0,9999,0
1668492027518,CSE 293,019,119302,Lovett; Shachar,9999,0,9999,0
1668492027518,CSE 293,020,119303,McAuley; Julian John,9999,0,9999,0
1668492027518,CSE 293,021,119304,Micciancio; Daniele,9999,0,9999,0
1668492027518,CSE 293,022,119367,Orailoglu; Alex,9999,0,9999,0
1668492027518,CSE 293,023,119382,Paturi; Ramamohan,9999,0,9999,0
1668492027518,CSE 293,024,119404,Polikarpova; Nadezhda,9999,0,9999,0
1668492027518,CSE 293,025,119406,Politz; Joseph Gibbs,9999,0,9999,0
1668492027518,CSE 293,026,119411,Porter; George M,9999,0,9999,0
1668492027518,CSE 293,027,119414,Porter; Leonard Emerson,9999,0,9999,0
1668492027518,CSE 293,028,119416,Ramamoorthi; Ravi,9999,0,9999,0
1668492027518,CSE 293,029,119417,Sahoo; Debashis,9999,0,9999,0
1668492027518,CSE 293,030,119420,Saul; Lawrence,9999,0,9999,0
1668492027518,CSE 293,031,119421,Savage; Stefan,9999,0,9999,0
1668492027518,CSE 293,032,119425,Schulze; Jurgen P.,9999,0,9999,0
1668492027518,CSE 293,033,119426,Snoeren; Alex C.,9999,0,9999,0
1668492027518,CSE 293,034,119428,Shang; Jingbo,9999,0,9999,0
1668492027518,CSE 293,035,119430,Stefan; Deian,9999,0,9999,0
1668492027518,CSE 293,036,119431,Su; Hao,9999,0,9999,0
1668492027518,CSE 293,037,119433,Swanson; Steven James,9999,0,9999,0
1668492027518,CSE 293,038,119435,Tullsen; Dean Michael,9999,0,9999,0
1668492027518,CSE 293,039,119483,Voelker; Geoffrey M.,9999,0,9999,0
1668492027518,CSE 293,040,119537,Zhao; Jishen,9999,0,9999,0
1668492027518,CSE 293,041,119538,Zhou; Yuan-Yuan,9999,0,9999,0
1668492027518,CSE 293,042,119539,Gao; Sicun,9999,0,9999,0
1668492027518,CSE 293,043,119540,Weibel; Nadir,9999,0,9999,0
1668492027518,CSE 293,044,119541,Gupta; Rajesh K.,9999,0,9999,0
1668492027518,CSE 293,045,126410,Vaccaro; Kristen Marie,9999,0,9999,0
1668492027518,CSE 293,046,126411,Klemke; Richard,9999,0,9999,0
1668492027944,CSE 294,A00,102459,Voelker; Geoffrey M.,0,2,0,0
1668492027944,CSE 294,B00,111322,Orailoglu; Alex,0,2,0,0
1668492028368,DSE 201,A00,096914,Deutsch; Alin Bernard,30,0,30,0
1668492028791,DSE 210,A00,096915,Dasgupta; Sanjoy,30,0,30,0
1668492029238,DSE 260A,A00,096916,Altintas De Callaf; Ilkay,30,0,30,0
1668492029699,ECE 200,001,103586,Antipa; Nicholas A,9999,0,9999,0
1668492029699,ECE 200,002,103587,Atanasov; Nikolay A.,9999,0,9999,0
1668492029699,ECE 200,003,103588,Bharadia; Dinesh,9999,0,9999,0
1668492029699,ECE 200,004,103589,Cheng; Chung Kuan,9999,0,9999,0
1668492029699,ECE 200,005,103590,Cosman; Pamela C.,9999,0,9999,0
1668492029699,ECE 200,006,103591,Dayeh; Shadi Ahmad,9999,0,9999,0
1668492029699,ECE 200,007,103592,Fainman; Yeshaiahu,9999,0,9999,0
1668492029699,ECE 200,008,103593,Ford; Joseph Earl,9999,0,9999,0
1668492029699,ECE 200,009,103594,Franceschetti; Massimo,9999,0,9999,0
1668492029699,ECE 200,010,103595,Fullerton; Eric E,9999,0,9999,0
1668492029699,ECE 200,011,103596,Galton; Ian A,9999,0,9999,0
1668492029699,ECE 200,012,103597,Gilja; Vikash,9999,0,9999,0
1668492029699,ECE 200,013,103598,Hall; Drew A.,9999,0,9999,0
1668492029699,ECE 200,014,103599,Hsueh; Tzu-Chien,9999,0,9999,0
1668492029699,ECE 200,015,103600,Javidi; Tara,9999,0,9999,0
1668492029699,ECE 200,016,103601,Kahng; Andrew Byun,9999,0,9999,0
1668492029699,ECE 200,017,103602,Kim; Young-Han,9999,0,9999,0
1668492029699,ECE 200,018,103603,Koushanfar; Farinaz,9999,0,9999,0
1668492029699,ECE 200,019,103604,Kuzum; Duygu,9999,0,9999,0
1668492029699,ECE 200,020,103605,Le; Hanh-Phuc,9999,0,9999,0
1668492029699,ECE 200,021,103606,Lin; Bill,9999,0,9999,0
1668492029699,ECE 200,022,103607,Liu; Zhaowei,9998,0,9999,1
1668492029699,ECE 200,023,103608,Lo; Yu-Hwa,9999,0,9999,0
1668492029699,ECE 200,024,103609,Lomakin; Vitaliy,9999,0,9999,0
1668492029699,ECE 200,025,103610,Mercier; Patrick Philip,9999,0,9999,0
1668492029699,ECE 200,026,103611,Meyer; Florian,9999,0,9999,0
1668492029699,ECE 200,027,103612,Milstein; Laurence B.,9999,0,9999,0
1668492029699,ECE 200,028,103613,Mir Arabbaygi; Siavash,9999,0,9999,0
1668492029699,ECE 200,029,103614,Mookherjea; Shayan,9999,0,9999,0
1668492029699,ECE 200,030,103615,Morris; Karcher William,9999,0,9999,0
1668492029699,ECE 200,031,103616,Ng; Tse Nga,9999,0,9999,0
1668492029699,ECE 200,032,103617,Nguyen; Truong Quang,9999,0,9999,0
1668492029699,ECE 200,033,103618,Nomura; Kenji,9999,0,9999,0
1668492029699,ECE 200,034,103619,Orlitsky; Alon,9999,0,9999,0
1668492029699,ECE 200,035,103620,Pal; Piya,9999,0,9999,0
1668492029699,ECE 200,036,103621,Papen; George C.,9999,0,9999,0
1668492029699,ECE 200,037,103622,Radic; Stojan,9999,0,9999,0
1668492029699,ECE 200,038,103623,Rao; Bhaskar D.,9999,0,9999,0
1668492029699,ECE 200,039,103624,Rao; Ramesh R,9999,0,9999,0
1668492029699,ECE 200,040,103625,Rebeiz; Gabriel,9999,0,9999,0
1668492029699,ECE 200,041,103626,Sanford; John R,9999,0,9999,0
1668492029699,ECE 200,042,103627,Siegel; Paul H.,9999,0,9999,0
1668492029699,ECE 200,043,103628,Sievenpiper; Daniel F.,9999,0,9999,0
1668492029699,ECE 200,044,103629,Sworder; David D.,9999,0,9999,0
1668492029699,ECE 200,045,103630,Taur; Yuan,9999,0,9999,0
1668492029699,ECE 200,046,103631,Touri; Behrouz,9999,0,9999,0
1668492029699,ECE 200,047,103632,Trivedi; Mohan M.,9999,0,9999,0
1668492029699,ECE 200,048,103633,Vasconcelos; Nuno,9999,0,9999,0
1668492029699,ECE 200,049,103634,Wang; Xiaolong,9999,0,9999,0
1668492029699,ECE 200,050,103635,Xie; Pengtao,9999,0,9999,0
1668492029699,ECE 200,051,103636,Yip; Michael,9999,0,9999,0
1668492029699,ECE 200,052,103637,Zeger; Kenneth A.,999,0,999,0
1668492029699,ECE 200,053,103638,Zhang; Xinyu,9999,0,9999,0
1668492029699,ECE 200,054,103639,Turakhia; Yatish Girish,9999,0,9999,0
1668492029699,ECE 200,055,103640,Kang; Mingu,9999,0,9999,0
1668492029699,ECE 200,056,103641,Shi; Yuanyuan,9999,0,9999,0
1668492029699,ECE 200,057,103642,Wang; Edward Jay,9999,0,9999,0
1668492029699,ECE 200,058,103643,Zheng; Yang,9999,0,9999,0
1668492030134,ECE 202,A00,103644,Kuzum; Duygu,0,43,0,0
1668492030560,ECE 212BN,A00,103646,Ng; Tse Nga,0,9,0,0
1668492030992,ECE 221,A00,111493,Staff,0,0,0,0
1668492031418,ECE 222B,A00,103647,Lomakin; Vitaliy,0,18,0,0
1668492031846,ECE 230B,A00,103648,Taur; Yuan,0,3,0,0
1668492032269,ECE 238B,A00,103649,Garay; Javier,0,0,0,0
1668492032693,ECE 240B,A00,112900,Fainman; Yeshaiahu,0,7,0,0
1668492033127,ECE 247A,A00,103650,Jokerst; Jesse Vincent,0,6,0,0
1668492033550,ECE 247B,A00,103651,Wang; Joseph,0,13,0,0
1668492033983,ECE 250,A00,103652,Siegel; Paul H.,0,82,0,0
1668492034407,ECE 251A,A00,103654,Rao; Bhaskar D.,0,61,0,0
1668492034830,ECE 257B,A00,103655,Bharadia; Dinesh,0,32,0,0
1668492035254,ECE 258A,A00,103656,Milstein; Laurence B.,0,28,0,0
1668492035677,ECE 260B,A00,103658,Kang; Mingu,0,119,0,0
1668492036100,ECE 264A,A00,103659,Galton; Ian A,0,65,0,0
1668492036524,ECE 265A,A00,103661,Gudem; Prasad S.S.,0,69,0,0
1668492036947,ECE 265D,A00,103662,Gudem; Prasad S.S.,0,24,0,0
1668492037377,ECE 268,A00,103663,Koushanfar; Farinaz,0,42,0,0
1668492037802,ECE 269,A01,103665,Pal; Piya,0,213,0,0
1668492038233,ECE 271B,A00,103666,Vasconcelos; Manuela,0,75,0,0
1668492038656,ECE 276A,A00,103667,Atanasov; Nikolay A.,0,125,0,0
1668492039085,ECE 277,A00,103668,An; Cheolhong,0,147,0,0
1668492039517,ECE 279,A00,117947,Hall; Drew A.,0,22,0,0
1668492040368,ECE 283,A00,103670,Hsueh; Tzu-Chien,0,51,0,0
1668492040805,ECE 284,A00,103671,Turakhia; Yatish Girish,0,39,0,0
1668492041243,ECE 285,A00,103672,Zheng; Yang,0,39,0,0
1668492041243,ECE 285,B00,103673,Sworder; David D.,0,56,0,0
1668492041667,ECE 287,A00,103676,Javidi; Tara,0,8,0,0
1668492042101,MATH 200B,A00,098023,Salehi Golsefidy; Alireza,10,0,15,5
1668492042524,MATH 202B,A00,098024,Rhoades; Brendon Patrick,7,0,15,8
1668492042960,MATH 203B,A00,098025,Oprea; Dragos N.,9,0,15,6
1668492043392,MATH 204B,A00,098026,Sorensen; Claus M,13,0,15,2
1668492043818,MATH 208,A00,098027,Izadi; Elham,7,0,10,3
1668492044245,MATH 209,A00,098028,Pollack; Aaron,10,0,10,0
1668492044670,MATH 211A,A00,112919,Rogalski; Daniel,8,0,10,2
1668492045097,MATH 211B,A00,112920,Seward; Brandon M.,9,0,10,1
1668492045520,MATH 218,A00,098029,Li; Bo,10,0,10,0
1668492045944,MATH 220B,A00,098030,Novak; Jonathan I,11,0,15,4
1668492046366,MATH 221A,A00,098031,Ebenfelt; Peter F,12,0,15,3
1668492046793,MATH 231B,A00,098032,Zlatos; Andrej,11,0,15,4
1668492047216,MATH 240B,A00,098033,Ni; Lei,7,0,15,8
1668492047640,MATH 243,A00,098034,Jekel; David Andrew,10,0,10,0
1668492048072,MATH 245A,A00,098035,Nie; Jiawang,0,4,15,18
1668492048499,MATH 248,A00,098036,Bejenaru; Ioan,10,0,10,0
1668492048923,MATH 250B,A00,098037,Spolaor; Luca,14,0,15,1
1668492049358,MATH 258,A00,098038,Ni; Lei,9,0,10,1
1668492049788,MATH 264B,A00,098041,Rhoades; Brendon Patrick,8,0,15,7
1668492050219,MATH 268,A00,098042,Buss; Samuel R,10,0,10,0
1668492050643,MATH 269,A00,098043,Rhoades; Brendon Patrick,10,0,10,0
1668492051069,MATH 270B,A00,098044,Li; Bo,6,0,15,9
1668492051498,MATH 272B,A00,098045,Holst; Michael J,13,0,15,2
1668492051922,MATH 273A,A00,098046,Tian; Xiaochuan,10,0,15,5
1668492052349,MATH 275,A01,098048,Tian; Xiaochuan,6,0,10,4
1668492052775,MATH 278A,A00,098049,Holst; Michael J,7,0,10,3
1668492053198,MATH 278B,A00,098050,Cloninger; Alexander,10,0,10,0
1668492053621,MATH 278C,A00,098051,Nie; Jiawang,5,0,10,5
1668492054048,MATH 280B,A00,098052,Zheng; Tianyi,7,0,15,8
1668492054470,MATH 281B,A00,098053,Bradic; Jelena,0,2,15,15
1668492054911,MATH 282B,A00,098054,Arias-Castro; Ery,0,1,15,15
1668492055340,MATH 285,A00,098055,Fitzsimmons; Patrick J,0,3,15,17
1668492055774,MATH 287B,A00,098056,Arias-Castro; Ery,1,0,15,14
1668492056199,MATH 288,A00,098057,Agarwal; Pooja,9,0,10,1
1668492056199,MATH 288,B00,098058,Zhang; Danna,8,0,10,2
1668492056199,MATH 288,C00,098059,Williams; Ruth J,9,0,10,1
1668492056626,MATH 290B,A00,098060,Roberts; Justin Deritter,12,0,15,3
1668492057053,MATH 292,A00,098061,Belmont; Eva Kinoshita,10,0,10,0
1668492057481,MATH 295,A00,098062,Suk; Andrew Hoon,47,0,50,3
1668492057904,MATH 296,A00,098063,Novak; Jonathan I,20,0,20,0
1668492058334,MATH 297,001,098064,Gamst; Anthony Collins,9997,0,9999,2
1668492559660,COGS 205,A00,101395,Chiba; Andrea,19,0,20,1
1668492560086,COGS 210B,001,101404,Greene; Deanna Jacquelyn,9998,0,9999,1
1668492560086,COGS 210B,002,101417,Xia; Haijun,9999,0,9999,0
1668492560086,COGS 210B,003,101422,Nitz; Douglas A.,9999,0,9999,0
1668492560086,COGS 210B,004,101423,Hollan; James D.,9998,0,9999,1
1668492560086,COGS 210B,005,101424,Deak; Gedeon O.,9998,0,9999,1
1668492560086,COGS 210B,006,101425,Rossano; Federico,9999,0,9999,0
1668492560510,COGS 211B,A00,101427,Coulson; Seana M,9996,0,9999,3
1668492560933,COGS 220,A00,101428,Hollan; James D.,1,11,25,24
1668492561360,COGS 229,A00,101429,Dow; Steven P,17,0,25,8
1668492561783,COGS 230,A00,101430,Klemmer; Scott R,8,0,17,9
1668492562207,COGS 234,A00,101431,Xia; Haijun,2,0,25,23
1668492562632,COGS 260,A00,101432,Kiyonaga; Anastasia,21,0,25,4
1668492562632,COGS 260,B00,101433,Kirsh; David Joel,15,0,25,10
1668492563055,CSE 202,A00,102371,Impagliazzo; Russell,0,65,0,0
1668492563479,CSE 203B,A01,102373,Cheng; Chung Kuan,0,53,0,0
1668492563914,CSE 208,A00,102374,Micciancio; Daniele,0,5,0,0
1668492564340,CSE 209A,A00,112895,Impagliazzo; Russell,0,12,15,15
1668492564767,CSE 209B,A00,108005,Bellare; Mihir,0,7,0,0
1668492565193,CSE 210,A00,113163,Coblenz; Michael J,0,82,0,0
1668492565619,CSE 219,A00,106111,Dow; Steven P,0,6,20,20
1668492566050,CSE 221,A00,102376,Voelker; Geoffrey M.,0,70,0,0
1668492566477,CSE 224,A01,102378,Porter; George M,0,161,0,0
1668492566901,CSE 229A,A00,102379,Savage; Stefan,0,10,0,0
1668492567325,CSE 229C,A00,102380,Munyaka; Imani N. S.,0,10,0,0
1668492567749,CSE 232B,A00,102382,Deutsch; Alin Bernard,0,31,0,0
1668492568174,CSE 234,A01,112904,Kumar; Arun Kumar,0,0,0,0
1668492568596,CSE 237A,A00,102383,Rosing; Tajana Simunic,0,51,0,0
1668492569021,CSE 239A,A00,102384,Deutsch; Alin Bernard,0,14,0,0
1668492569444,CSE 239B,A00,102385,Polikarpova; Nadezhda,0,10,0,0
1668492569868,CSE 240A,A00,102386,Pannuto; Patrick William,0,45,0,0
1668492570291,CSE 240B,A00,102387,Zhao; Jishen,0,43,0,0
1668492570715,CSE 241A,A00,106406,Kang; Mingu,0,7,0,0
1668492571154,CSE 249B,A00,102388,Kahng; Andrew Byun,0,5,8,8
1668492571580,CSE 251B,A01,102392,Cottrell; Garrison W,0,46,0,0
1668492571580,CSE 251B,A02,102393,Cottrell; Garrison W,0,34,0,0
1668492572004,CSE 252B,A00,102394,Ochoa; Benjamin Lawrence,0,58,0,0
1668492572447,CSE 257,A01,102396,Gao; Sicun,0,133,0,0
1668492572873,CSE 272,A00,102397,Li; Tzumao,0,17,0,0
1668492573297,CSE 274,A00,111323,Chern; Albert Ren-Haur,0,15,0,0
1668492573720,CSE 282,A00,102398,Pevzner; Pavel Arkadjevich,0,0,0,0
1668492574147,CSE 284,A00,114175,Gymrek; Melissa Ann,0,22,0,0
1668492574579,CSE 290,A00,102399,Chandraker; Manmohan Krishna,0,11,0,0
1668492574579,CSE 290,B00,102400,Vaccaro; Kristen Marie,0,7,25,25
1668492574579,CSE 290,C00,102414,Pannuto; Patrick William,0,1,25,25
1668492574579,CSE 290,D00,102427,Pevzner; Pavel Arkadjevich,0,0,0,0
1668492574579,CSE 290,E00,102429,Zhao; Jishen,0,4,0,0
1668492574579,CSE 290,F00,102436,Tullsen; Dean Michael,0,5,0,0
1668492574579,CSE 290,G00,102440,Christensen; Henrik I,0,6,20,20
1668492575008,CSE 291,A00,102443,Su; Hao,0,0,0,0
1668492575008,CSE 291,B00,102448,Polikarpova; Nadezhda,0,0,0,0
1668492575008,CSE 291,C00,102453,Vaccaro; Kristen Marie,0,0,0,0
1668492575008,CSE 291,D00,111343,Savage; Stefan,0,0,0,0
1668492575008,CSE 291,E00,116474,Claffy; Kimberly Claire,0,0,0,0
1668492575008,CSE 291,F00,116479,Pasquale; Joseph,0,0,0,0
1668492575460,CSE 293,001,119111,Bafna; Vineet,9999,0,9999,0
1668492575460,CSE 293,002,119118,Bellare; Mihir,9999,0,9999,0
1668492575460,CSE 293,003,119122,Berg-Kirkpatrick; Taylor D,9999,0,9999,0
1668492575460,CSE 293,004,119135,Christensen; Henrik I,9999,0,9999,0
1668492575460,CSE 293,005,119142,Cottrell; Garrison W,9999,0,9999,0
1668492575460,CSE 293,006,119146,Deutsch; Alin Bernard,9999,0,9999,0
1668492575460,CSE 293,007,119159,Esmaeilzadeh; Hadi,9999,0,9999,0
1668492575460,CSE 293,008,119166,Freund; Yoav,9999,0,9999,0
1668492575460,CSE 293,009,119170,Griswold; William G.,9999,0,9999,0
1668492575460,CSE 293,010,119183,Gymrek; Melissa Ann,9999,0,9999,0
1668492575460,CSE 293,011,119190,Heninger; Nadia A,9999,0,9999,0
1668492575460,CSE 293,012,119230,Impagliazzo; Russell,9999,0,9999,0
1668492575460,CSE 293,013,119232,Jhala; Ranjit,9999,0,9999,0
1668492575460,CSE 293,014,119233,Kahng; Andrew Byun,9999,0,9999,0
1668492575460,CSE 293,015,119298,Kane; Daniel Mertz,9999,0,9999,0
1668492575460,CSE 293,016,119299,Kriegman; David J,9999,0,9999,0
1668492575460,CSE 293,017,119300,Kumar; Arun Kumar,9999,0,9999,0
1668492575460,CSE 293,018,119301,Lerner; Sorin,9999,0,9999,0
1668492575460,CSE 293,019,119302,Lovett; Shachar,9999,0,9999,0
1668492575460,CSE 293,020,119303,McAuley; Julian John,9999,0,9999,0
1668492575460,CSE 293,021,119304,Micciancio; Daniele,9999,0,9999,0
1668492575460,CSE 293,022,119367,Orailoglu; Alex,9999,0,9999,0
1668492575460,CSE 293,023,119382,Paturi; Ramamohan,9999,0,9999,0
1668492575460,CSE 293,024,119404,Polikarpova; Nadezhda,9999,0,9999,0
1668492575460,CSE 293,025,119406,Politz; Joseph Gibbs,9999,0,9999,0
1668492575460,CSE 293,026,119411,Porter; George M,9999,0,9999,0
1668492575460,CSE 293,027,119414,Porter; Leonard Emerson,9999,0,9999,0
1668492575460,CSE 293,028,119416,Ramamoorthi; Ravi,9999,0,9999,0
1668492575460,CSE 293,029,119417,Sahoo; Debashis,9999,0,9999,0
1668492575460,CSE 293,030,119420,Saul; Lawrence,9999,0,9999,0
1668492575460,CSE 293,031,119421,Savage; Stefan,9999,0,9999,0
1668492575460,CSE 293,032,119425,Schulze; Jurgen P.,9999,0,9999,0
1668492575460,CSE 293,033,119426,Snoeren; Alex C.,9999,0,9999,0
1668492575460,CSE 293,034,119428,Shang; Jingbo,9999,0,9999,0
1668492575460,CSE 293,035,119430,Stefan; Deian,9999,0,9999,0
1668492575460,CSE 293,036,119431,Su; Hao,9999,0,9999,0
1668492575460,CSE 293,037,119433,Swanson; Steven James,9999,0,9999,0
1668492575460,CSE 293,038,119435,Tullsen; Dean Michael,9999,0,9999,0
1668492575460,CSE 293,039,119483,Voelker; Geoffrey M.,9999,0,9999,0
1668492575460,CSE 293,040,119537,Zhao; Jishen,9999,0,9999,0
1668492575460,CSE 293,041,119538,Zhou; Yuan-Yuan,9999,0,9999,0
1668492575460,CSE 293,042,119539,Gao; Sicun,9999,0,9999,0
1668492575460,CSE 293,043,119540,Weibel; Nadir,9999,0,9999,0
1668492575460,CSE 293,044,119541,Gupta; Rajesh K.,9999,0,9999,0
1668492575460,CSE 293,045,126410,Vaccaro; Kristen Marie,9999,0,9999,0
1668492575460,CSE 293,046,126411,Klemke; Richard,9999,0,9999,0
1668492575882,CSE 294,A00,102459,Voelker; Geoffrey M.,0,2,0,0
1668492575882,CSE 294,B00,111322,Orailoglu; Alex,0,2,0,0
1668492576306,DSE 201,A00,096914,Deutsch; Alin Bernard,30,0,30,0
1668492576743,DSE 210,A00,096915,Dasgupta; Sanjoy,30,0,30,0
1668492577164,DSE 260A,A00,096916,Altintas De Callaf; Ilkay,30,0,30,0
1668492577624,ECE 200,001,103586,Antipa; Nicholas A,9999,0,9999,0
1668492577624,ECE 200,002,103587,Atanasov; Nikolay A.,9999,0,9999,0
1668492577624,ECE 200,003,103588,Bharadia; Dinesh,9999,0,9999,0
1668492577624,ECE 200,004,103589,Cheng; Chung Kuan,9999,0,9999,0
1668492577624,ECE 200,005,103590,Cosman; Pamela C.,9999,0,9999,0
1668492577624,ECE 200,006,103591,Dayeh; Shadi Ahmad,9999,0,9999,0
1668492577624,ECE 200,007,103592,Fainman; Yeshaiahu,9999,0,9999,0
1668492577624,ECE 200,008,103593,Ford; Joseph Earl,9999,0,9999,0
1668492577624,ECE 200,009,103594,Franceschetti; Massimo,9999,0,9999,0
1668492577624,ECE 200,010,103595,Fullerton; Eric E,9999,0,9999,0
1668492577624,ECE 200,011,103596,Galton; Ian A,9999,0,9999,0
1668492577624,ECE 200,012,103597,Gilja; Vikash,9999,0,9999,0
1668492577624,ECE 200,013,103598,Hall; Drew A.,9999,0,9999,0
1668492577624,ECE 200,014,103599,Hsueh; Tzu-Chien,9999,0,9999,0
1668492577624,ECE 200,015,103600,Javidi; Tara,9999,0,9999,0
1668492577624,ECE 200,016,103601,Kahng; Andrew Byun,9999,0,9999,0
1668492577624,ECE 200,017,103602,Kim; Young-Han,9999,0,9999,0
1668492577624,ECE 200,018,103603,Koushanfar; Farinaz,9999,0,9999,0
1668492577624,ECE 200,019,103604,Kuzum; Duygu,9999,0,9999,0
1668492577624,ECE 200,020,103605,Le; Hanh-Phuc,9999,0,9999,0
1668492577624,ECE 200,021,103606,Lin; Bill,9999,0,9999,0
1668492577624,ECE 200,022,103607,Liu; Zhaowei,9998,0,9999,1
1668492577624,ECE 200,023,103608,Lo; Yu-Hwa,9999,0,9999,0
1668492577624,ECE 200,024,103609,Lomakin; Vitaliy,9999,0,9999,0
1668492577624,ECE 200,025,103610,Mercier; Patrick Philip,9999,0,9999,0
1668492577624,ECE 200,026,103611,Meyer; Florian,9999,0,9999,0
1668492577624,ECE 200,027,103612,Milstein; Laurence B.,9999,0,9999,0
1668492577624,ECE 200,028,103613,Mir Arabbaygi; Siavash,9999,0,9999,0
1668492577624,ECE 200,029,103614,Mookherjea; Shayan,9999,0,9999,0
1668492577624,ECE 200,030,103615,Morris; Karcher William,9999,0,9999,0
1668492577624,ECE 200,031,103616,Ng; Tse Nga,9999,0,9999,0
1668492577624,ECE 200,032,103617,Nguyen; Truong Quang,9999,0,9999,0
1668492577624,ECE 200,033,103618,Nomura; Kenji,9999,0,9999,0
1668492577624,ECE 200,034,103619,Orlitsky; Alon,9999,0,9999,0
1668492577624,ECE 200,035,103620,Pal; Piya,9999,0,9999,0
1668492577624,ECE 200,036,103621,Papen; George C.,9999,0,9999,0
1668492577624,ECE 200,037,103622,Radic; Stojan,9999,0,9999,0
1668492577624,ECE 200,038,103623,Rao; Bhaskar D.,9999,0,9999,0
1668492577624,ECE 200,039,103624,Rao; Ramesh R,9999,0,9999,0
1668492577624,ECE 200,040,103625,Rebeiz; Gabriel,9999,0,9999,0
1668492577624,ECE 200,041,103626,Sanford; John R,9999,0,9999,0
1668492577624,ECE 200,042,103627,Siegel; Paul H.,9999,0,9999,0
1668492577624,ECE 200,043,103628,Sievenpiper; Daniel F.,9999,0,9999,0
1668492577624,ECE 200,044,103629,Sworder; David D.,9999,0,9999,0
1668492577624,ECE 200,045,103630,Taur; Yuan,9999,0,9999,0
1668492577624,ECE 200,046,103631,Touri; Behrouz,9999,0,9999,0
1668492577624,ECE 200,047,103632,Trivedi; Mohan M.,9999,0,9999,0
1668492577624,ECE 200,048,103633,Vasconcelos; Nuno,9999,0,9999,0
1668492577624,ECE 200,049,103634,Wang; Xiaolong,9999,0,9999,0
1668492577624,ECE 200,050,103635,Xie; Pengtao,9999,0,9999,0
1668492577624,ECE 200,051,103636,Yip; Michael,9999,0,9999,0
1668492577624,ECE 200,052,103637,Zeger; Kenneth A.,999,0,999,0
1668492577624,ECE 200,053,103638,Zhang; Xinyu,9999,0,9999,0
1668492577624,ECE 200,054,103639,Turakhia; Yatish Girish,9999,0,9999,0
1668492577624,ECE 200,055,103640,Kang; Mingu,9999,0,9999,0
1668492577624,ECE 200,056,103641,Shi; Yuanyuan,9999,0,9999,0
1668492577624,ECE 200,057,103642,Wang; Edward Jay,9999,0,9999,0
1668492577624,ECE 200,058,103643,Zheng; Yang,9999,0,9999,0
1668492578053,ECE 202,A00,103644,Kuzum; Duygu,0,43,0,0
1668492578480,ECE 212BN,A00,103646,Ng; Tse Nga,0,9,0,0
1668492578903,ECE 221,A00,111493,Staff,0,0,0,0
1668492579326,ECE 222B,A00,103647,Lomakin; Vitaliy,0,18,0,0
1668492579748,ECE 230B,A00,103648,Taur; Yuan,0,3,0,0
1668492580180,ECE 238B,A00,103649,Garay; Javier,0,0,0,0
1668492580609,ECE 240B,A00,112900,Fainman; Yeshaiahu,0,7,0,0
1668492581041,ECE 247A,A00,103650,Jokerst; Jesse Vincent,0,6,0,0
1668492581467,ECE 247B,A00,103651,Wang; Joseph,0,13,0,0
1668492581894,ECE 250,A00,103652,Siegel; Paul H.,0,82,0,0
1668492582326,ECE 251A,A00,103654,Rao; Bhaskar D.,0,61,0,0
1668492582750,ECE 257B,A00,103655,Bharadia; Dinesh,0,32,0,0
1668492583174,ECE 258A,A00,103656,Milstein; Laurence B.,0,28,0,0
1668492583598,ECE 260B,A00,103658,Kang; Mingu,0,119,0,0
1668492584110,ECE 264A,A00,103659,Galton; Ian A,0,65,0,0
1668492584537,ECE 265A,A00,103661,Gudem; Prasad S.S.,0,69,0,0
1668492584960,ECE 265D,A00,103662,Gudem; Prasad S.S.,0,24,0,0
1668492585383,ECE 268,A00,103663,Koushanfar; Farinaz,0,42,0,0
1668492585807,ECE 269,A01,103665,Pal; Piya,0,213,0,0
1668492586234,ECE 271B,A00,103666,Vasconcelos; Manuela,0,75,0,0
1668492586658,ECE 276A,A00,103667,Atanasov; Nikolay A.,0,125,0,0
1668492587083,ECE 277,A00,103668,An; Cheolhong,0,147,0,0
1668492587507,ECE 279,A00,117947,Hall; Drew A.,0,22,0,0
1668492588354,ECE 283,A00,103670,Hsueh; Tzu-Chien,0,51,0,0
1668492588778,ECE 284,A00,103671,Turakhia; Yatish Girish,0,39,0,0
1668492589202,ECE 285,A00,103672,Zheng; Yang,0,39,0,0
1668492589202,ECE 285,B00,103673,Sworder; David D.,0,56,0,0
1668492589626,ECE 287,A00,103676,Javidi; Tara,0,8,0,0
1668492590053,MATH 200B,A00,098023,Salehi Golsefidy; Alireza,10,0,15,5
1668492590486,MATH 202B,A00,098024,Rhoades; Brendon Patrick,7,0,15,8
1668492590908,MATH 203B,A00,098025,Oprea; Dragos N.,9,0,15,6
1668492591332,MATH 204B,A00,098026,Sorensen; Claus M,13,0,15,2
1668492591756,MATH 208,A00,098027,Izadi; Elham,7,0,10,3
1668492592184,MATH 209,A00,098028,Pollack; Aaron,10,0,10,0
1668492592611,MATH 211A,A00,112919,Rogalski; Daniel,8,0,10,2
1668492593039,MATH 211B,A00,112920,Seward; Brandon M.,9,0,10,1
1668492593463,MATH 218,A00,098029,Li; Bo,10,0,10,0
1668492593889,MATH 220B,A00,098030,Novak; Jonathan I,11,0,15,4
1668492594316,MATH 221A,A00,098031,Ebenfelt; Peter F,12,0,15,3
1668492594743,MATH 231B,A00,098032,Zlatos; Andrej,11,0,15,4
1668492595174,MATH 240B,A00,098033,Ni; Lei,7,0,15,8
1668492595597,MATH 243,A00,098034,Jekel; David Andrew,10,0,10,0
1668492596031,MATH 245A,A00,098035,Nie; Jiawang,0,4,15,18
1668492596456,MATH 248,A00,098036,Bejenaru; Ioan,10,0,10,0
1668492596881,MATH 250B,A00,098037,Spolaor; Luca,14,0,15,1
1668492597313,MATH 258,A00,098038,Ni; Lei,9,0,10,1
1668492597738,MATH 264B,A00,098041,Rhoades; Brendon Patrick,8,0,15,7
1668492598162,MATH 268,A00,098042,Buss; Samuel R,10,0,10,0
1668492598599,MATH 269,A00,098043,Rhoades; Brendon Patrick,10,0,10,0
1668492599028,MATH 270B,A00,098044,Li; Bo,6,0,15,9
1668492599459,MATH 272B,A00,098045,Holst; Michael J,13,0,15,2
1668492599882,MATH 273A,A00,098046,Tian; Xiaochuan,10,0,15,5
1668492600306,MATH 275,A01,098048,Tian; Xiaochuan,6,0,10,4
1668492600729,MATH 278A,A00,098049,Holst; Michael J,7,0,10,3
1668492601152,MATH 278B,A00,098050,Cloninger; Alexander,10,0,10,0
1668492601577,MATH 278C,A00,098051,Nie; Jiawang,5,0,10,5
1668492602000,MATH 280B,A00,098052,Zheng; Tianyi,7,0,15,8
1668492602422,MATH 281B,A00,098053,Bradic; Jelena,0,2,15,15
1668492602844,MATH 282B,A00,098054,Arias-Castro; Ery,0,1,15,15
1668492603268,MATH 285,A00,098055,Fitzsimmons; Patrick J,0,3,15,17
1668492603696,MATH 287B,A00,098056,Arias-Castro; Ery,1,0,15,14
1668492604122,MATH 288,A00,098057,Agarwal; Pooja,9,0,10,1
1668492604122,MATH 288,B00,098058,Zhang; Danna,8,0,10,2
1668492604122,MATH 288,C00,098059,Williams; Ruth J,9,0,10,1
1668492604546,MATH 290B,A00,098060,Roberts; Justin Deritter,12,0,15,3
1668492604971,MATH 292,A00,098061,Belmont; Eva Kinoshita,10,0,10,0
1668492605395,MATH 295,A00,098062,Suk; Andrew Hoon,47,0,50,3
1668492605830,MATH 296,A00,098063,Novak; Jonathan I,20,0,20,0
1668492606255,MATH 297,001,098064,Gamst; Anthony Collins,9997,0,9999,2
1668493107732,COGS 205,A00,101395,Chiba; Andrea,19,0,20,1
1668493108160,COGS 210B,001,101404,Greene; Deanna Jacquelyn,9998,0,9999,1
1668493108160,COGS 210B,002,101417,Xia; Haijun,9999,0,9999,0
1668493108160,COGS 210B,003,101422,Nitz; Douglas A.,9999,0,9999,0
1668493108160,COGS 210B,004,101423,Hollan; James D.,9998,0,9999,1
1668493108160,COGS 210B,005,101424,Deak; Gedeon O.,9998,0,9999,1
1668493108160,COGS 210B,006,101425,Rossano; Federico,9999,0,9999,0
1668493108588,COGS 211B,A00,101427,Coulson; Seana M,9996,0,9999,3
1668493109012,COGS 220,A00,101428,Hollan; James D.,1,11,25,24
1668493109437,COGS 229,A00,101429,Dow; Steven P,17,0,25,8
1668493109864,COGS 230,A00,101430,Klemmer; Scott R,8,0,17,9
1668493110288,COGS 234,A00,101431,Xia; Haijun,2,0,25,23
1668493110712,COGS 260,A00,101432,Kiyonaga; Anastasia,21,0,25,4
1668493110712,COGS 260,B00,101433,Kirsh; David Joel,15,0,25,10
1668493111137,CSE 202,A00,102371,Impagliazzo; Russell,0,65,0,0
1668493111562,CSE 203B,A01,102373,Cheng; Chung Kuan,0,53,0,0
1668493111986,CSE 208,A00,102374,Micciancio; Daniele,0,5,0,0
1668493112411,CSE 209A,A00,112895,Impagliazzo; Russell,0,12,15,15
1668493112834,CSE 209B,A00,108005,Bellare; Mihir,0,7,0,0
1668493113258,CSE 210,A00,113163,Coblenz; Michael J,0,82,0,0
1668493113683,CSE 219,A00,106111,Dow; Steven P,0,6,20,20
1668493114109,CSE 221,A00,102376,Voelker; Geoffrey M.,0,70,0,0
1668493114533,CSE 224,A01,102378,Porter; George M,0,161,0,0
1668493114956,CSE 229A,A00,102379,Savage; Stefan,0,10,0,0
1668493115380,CSE 229C,A00,102380,Munyaka; Imani N. S.,0,10,0,0
1668493115808,CSE 232B,A00,102382,Deutsch; Alin Bernard,0,31,0,0
1668493116234,CSE 234,A01,112904,Kumar; Arun Kumar,0,0,0,0
1668493116657,CSE 237A,A00,102383,Rosing; Tajana Simunic,0,51,0,0
1668493117091,CSE 239A,A00,102384,Deutsch; Alin Bernard,0,14,0,0
1668493117519,CSE 239B,A00,102385,Polikarpova; Nadezhda,0,10,0,0
1668493117942,CSE 240A,A00,102386,Pannuto; Patrick William,0,45,0,0
1668493118378,CSE 240B,A00,102387,Zhao; Jishen,0,43,0,0
1668493118801,CSE 241A,A00,106406,Kang; Mingu,0,7,0,0
1668493119233,CSE 249B,A00,102388,Kahng; Andrew Byun,0,5,8,8
1668493119656,CSE 251B,A01,102392,Cottrell; Garrison W,0,46,0,0
1668493119656,CSE 251B,A02,102393,Cottrell; Garrison W,0,34,0,0
1668493120084,CSE 252B,A00,102394,Ochoa; Benjamin Lawrence,0,58,0,0
1668493120506,CSE 257,A01,102396,Gao; Sicun,0,133,0,0
1668493120929,CSE 272,A00,102397,Li; Tzumao,0,17,0,0
1668493121352,CSE 274,A00,111323,Chern; Albert Ren-Haur,0,15,0,0
1668493121787,CSE 282,A00,102398,Pevzner; Pavel Arkadjevich,0,0,0,0
1668493122224,CSE 284,A00,114175,Gymrek; Melissa Ann,0,22,0,0
1668493122649,CSE 290,A00,102399,Chandraker; Manmohan Krishna,0,11,0,0
1668493122649,CSE 290,B00,102400,Vaccaro; Kristen Marie,0,7,25,25
1668493122649,CSE 290,C00,102414,Pannuto; Patrick William,0,1,25,25
1668493122649,CSE 290,D00,102427,Pevzner; Pavel Arkadjevich,0,0,0,0
1668493122649,CSE 290,E00,102429,Zhao; Jishen,0,4,0,0
1668493122649,CSE 290,F00,102436,Tullsen; Dean Michael,0,5,0,0
1668493122649,CSE 290,G00,102440,Christensen; Henrik I,0,6,20,20
1668493123073,CSE 291,A00,102443,Su; Hao,0,0,0,0
1668493123073,CSE 291,B00,102448,Polikarpova; Nadezhda,0,0,0,0
1668493123073,CSE 291,C00,102453,Vaccaro; Kristen Marie,0,0,0,0
1668493123073,CSE 291,D00,111343,Savage; Stefan,0,0,0,0
1668493123073,CSE 291,E00,116474,Claffy; Kimberly Claire,0,0,0,0
1668493123073,CSE 291,F00,116479,Pasquale; Joseph,0,0,0,0
1668493123506,CSE 293,001,119111,Bafna; Vineet,9999,0,9999,0
1668493123506,CSE 293,002,119118,Bellare; Mihir,9999,0,9999,0
1668493123506,CSE 293,003,119122,Berg-Kirkpatrick; Taylor D,9999,0,9999,0
1668493123506,CSE 293,004,119135,Christensen; Henrik I,9999,0,9999,0
1668493123506,CSE 293,005,119142,Cottrell; Garrison W,9999,0,9999,0
1668493123506,CSE 293,006,119146,Deutsch; Alin Bernard,9999,0,9999,0
1668493123506,CSE 293,007,119159,Esmaeilzadeh; Hadi,9999,0,9999,0
1668493123506,CSE 293,008,119166,Freund; Yoav,9999,0,9999,0
1668493123506,CSE 293,009,119170,Griswold; William G.,9999,0,9999,0
1668493123506,CSE 293,010,119183,Gymrek; Melissa Ann,9999,0,9999,0
1668493123506,CSE 293,011,119190,Heninger; Nadia A,9999,0,9999,0
1668493123506,CSE 293,012,119230,Impagliazzo; Russell,9999,0,9999,0
1668493123506,CSE 293,013,119232,Jhala; Ranjit,9999,0,9999,0
1668493123506,CSE 293,014,119233,Kahng; Andrew Byun,9999,0,9999,0
1668493123506,CSE 293,015,119298,Kane; Daniel Mertz,9999,0,9999,0
1668493123506,CSE 293,016,119299,Kriegman; David J,9999,0,9999,0
1668493123506,CSE 293,017,119300,Kumar; Arun Kumar,9999,0,9999,0
1668493123506,CSE 293,018,119301,Lerner; Sorin,9999,0,9999,0
1668493123506,CSE 293,019,119302,Lovett; Shachar,9999,0,9999,0
1668493123506,CSE 293,020,119303,McAuley; Julian John,9999,0,9999,0
1668493123506,CSE 293,021,119304,Micciancio; Daniele,9999,0,9999,0
1668493123506,CSE 293,022,119367,Orailoglu; Alex,9999,0,9999,0
1668493123506,CSE 293,023,119382,Paturi; Ramamohan,9999,0,9999,0
1668493123506,CSE 293,024,119404,Polikarpova; Nadezhda,9999,0,9999,0
1668493123506,CSE 293,025,119406,Politz; Joseph Gibbs,9999,0,9999,0
1668493123506,CSE 293,026,119411,Porter; George M,9999,0,9999,0
1668493123506,CSE 293,027,119414,Porter; Leonard Emerson,9999,0,9999,0
1668493123506,CSE 293,028,119416,Ramamoorthi; Ravi,9999,0,9999,0
1668493123506,CSE 293,029,119417,Sahoo; Debashis,9999,0,9999,0
1668493123506,CSE 293,030,119420,Saul; Lawrence,9999,0,9999,0
1668493123506,CSE 293,031,119421,Savage; Stefan,9999,0,9999,0
1668493123506,CSE 293,032,119425,Schulze; Jurgen P.,9999,0,9999,0
1668493123506,CSE 293,033,119426,Snoeren; Alex C.,9999,0,9999,0
1668493123506,CSE 293,034,119428,Shang; Jingbo,9999,0,9999,0
1668493123506,CSE 293,035,119430,Stefan; Deian,9999,0,9999,0
1668493123506,CSE 293,036,119431,Su; Hao,9999,0,9999,0
1668493123506,CSE 293,037,119433,Swanson; Steven James,9999,0,9999,0
1668493123506,CSE 293,038,119435,Tullsen; Dean Michael,9999,0,9999,0
1668493123506,CSE 293,039,119483,Voelker; Geoffrey M.,9999,0,9999,0
1668493123506,CSE 293,040,119537,Zhao; Jishen,9999,0,9999,0
1668493123506,CSE 293,041,119538,Zhou; Yuan-Yuan,9999,0,9999,0
1668493123506,CSE 293,042,119539,Gao; Sicun,9999,0,9999,0
1668493123506,CSE 293,043,119540,Weibel; Nadir,9999,0,9999,0
1668493123506,CSE 293,044,119541,Gupta; Rajesh K.,9999,0,9999,0
1668493123506,CSE 293,045,126410,Vaccaro; Kristen Marie,9999,0,9999,0
1668493123506,CSE 293,046,126411,Klemke; Richard,9999,0,9999,0
1668493123931,CSE 294,A00,102459,Voelker; Geoffrey M.,0,2,0,0
1668493123931,CSE 294,B00,111322,Orailoglu; Alex,0,2,0,0
1668493124361,DSE 201,A00,096914,Deutsch; Alin Bernard,30,0,30,0
1668493124783,DSE 210,A00,096915,Dasgupta; Sanjoy,30,0,30,0
1668493125206,DSE 260A,A00,096916,Altintas De Callaf; Ilkay,30,0,30,0
1668493125643,ECE 200,001,103586,Antipa; Nicholas A,9999,0,9999,0
1668493125643,ECE 200,002,103587,Atanasov; Nikolay A.,9999,0,9999,0
1668493125643,ECE 200,003,103588,Bharadia; Dinesh,9999,0,9999,0
1668493125643,ECE 200,004,103589,Cheng; Chung Kuan,9999,0,9999,0
1668493125643,ECE 200,005,103590,Cosman; Pamela C.,9999,0,9999,0
1668493125643,ECE 200,006,103591,Dayeh; Shadi Ahmad,9999,0,9999,0
1668493125643,ECE 200,007,103592,Fainman; Yeshaiahu,9999,0,9999,0
1668493125643,ECE 200,008,103593,Ford; Joseph Earl,9999,0,9999,0
1668493125643,ECE 200,009,103594,Franceschetti; Massimo,9999,0,9999,0
1668493125643,ECE 200,010,103595,Fullerton; Eric E,9999,0,9999,0
1668493125643,ECE 200,011,103596,Galton; Ian A,9999,0,9999,0
1668493125643,ECE 200,012,103597,Gilja; Vikash,9999,0,9999,0
1668493125643,ECE 200,013,103598,Hall; Drew A.,9999,0,9999,0
1668493125643,ECE 200,014,103599,Hsueh; Tzu-Chien,9999,0,9999,0
1668493125643,ECE 200,015,103600,Javidi; Tara,9999,0,9999,0
1668493125643,ECE 200,016,103601,Kahng; Andrew Byun,9999,0,9999,0
1668493125643,ECE 200,017,103602,Kim; Young-Han,9999,0,9999,0
1668493125643,ECE 200,018,103603,Koushanfar; Farinaz,9999,0,9999,0
1668493125643,ECE 200,019,103604,Kuzum; Duygu,9999,0,9999,0
1668493125643,ECE 200,020,103605,Le; Hanh-Phuc,9999,0,9999,0
1668493125643,ECE 200,021,103606,Lin; Bill,9999,0,9999,0
1668493125643,ECE 200,022,103607,Liu; Zhaowei,9998,0,9999,1
1668493125643,ECE 200,023,103608,Lo; Yu-Hwa,9999,0,9999,0
1668493125643,ECE 200,024,103609,Lomakin; Vitaliy,9999,0,9999,0
1668493125643,ECE 200,025,103610,Mercier; Patrick Philip,9999,0,9999,0
1668493125643,ECE 200,026,103611,Meyer; Florian,9999,0,9999,0
1668493125643,ECE 200,027,103612,Milstein; Laurence B.,9999,0,9999,0
1668493125643,ECE 200,028,103613,Mir Arabbaygi; Siavash,9999,0,9999,0
1668493125643,ECE 200,029,103614,Mookherjea; Shayan,9999,0,9999,0
1668493125643,ECE 200,030,103615,Morris; Karcher William,9999,0,9999,0
1668493125643,ECE 200,031,103616,Ng; Tse Nga,9999,0,9999,0
1668493125643,ECE 200,032,103617,Nguyen; Truong Quang,9999,0,9999,0
1668493125643,ECE 200,033,103618,Nomura; Kenji,9999,0,9999,0
1668493125643,ECE 200,034,103619,Orlitsky; Alon,9999,0,9999,0
1668493125643,ECE 200,035,103620,Pal; Piya,9999,0,9999,0
1668493125643,ECE 200,036,103621,Papen; George C.,9999,0,9999,0
1668493125643,ECE 200,037,103622,Radic; Stojan,9999,0,9999,0
1668493125643,ECE 200,038,103623,Rao; Bhaskar D.,9999,0,9999,0
1668493125643,ECE 200,039,103624,Rao; Ramesh R,9999,0,9999,0
1668493125643,ECE 200,040,103625,Rebeiz; Gabriel,9999,0,9999,0
1668493125643,ECE 200,041,103626,Sanford; John R,9999,0,9999,0
1668493125643,ECE 200,042,103627,Siegel; Paul H.,9999,0,9999,0
1668493125643,ECE 200,043,103628,Sievenpiper; Daniel F.,9999,0,9999,0
1668493125643,ECE 200,044,103629,Sworder; David D.,9999,0,9999,0
1668493125643,ECE 200,045,103630,Taur; Yuan,9999,0,9999,0
1668493125643,ECE 200,046,103631,Touri; Behrouz,9999,0,9999,0
1668493125643,ECE 200,047,103632,Trivedi; Mohan M.,9999,0,9999,0
1668493125643,ECE 200,048,103633,Vasconcelos; Nuno,9999,0,9999,0
1668493125643,ECE 200,049,103634,Wang; Xiaolong,9999,0,9999,0
1668493125643,ECE 200,050,103635,Xie; Pengtao,9999,0,9999,0
1668493125643,ECE 200,051,103636,Yip; Michael,9999,0,9999,0
1668493125643,ECE 200,052,103637,Zeger; Kenneth A.,999,0,999,0
1668493125643,ECE 200,053,103638,Zhang; Xinyu,9999,0,9999,0
1668493125643,ECE 200,054,103639,Turakhia; Yatish Girish,9999,0,9999,0
1668493125643,ECE 200,055,103640,Kang; Mingu,9999,0,9999,0
1668493125643,ECE 200,056,103641,Shi; Yuanyuan,9999,0,9999,0
1668493125643,ECE 200,057,103642,Wang; Edward Jay,9999,0,9999,0
1668493125643,ECE 200,058,103643,Zheng; Yang,9999,0,9999,0
1668493126066,ECE 202,A00,103644,Kuzum; Duygu,0,43,0,0
1668493126499,ECE 212BN,A00,103646,Ng; Tse Nga,0,9,0,0
1668493126923,ECE 221,A00,111493,Staff,0,0,0,0
1668493127360,ECE 222B,A00,103647,Lomakin; Vitaliy,0,18,0,0
1668493127787,ECE 230B,A00,103648,Taur; Yuan,0,3,0,0
1668493128212,ECE 238B,A00,103649,Garay; Javier,0,0,0,0
1668493128636,ECE 240B,A00,112900,Fainman; Yeshaiahu,0,7,0,0
1668493129069,ECE 247A,A00,103650,Jokerst; Jesse Vincent,0,6,0,0
1668493129492,ECE 247B,A00,103651,Wang; Joseph,0,13,0,0
1668493129919,ECE 250,A00,103652,Siegel; Paul H.,0,82,0,0
1668493130345,ECE 251A,A00,103654,Rao; Bhaskar D.,0,61,0,0
1668493130767,ECE 257B,A00,103655,Bharadia; Dinesh,0,32,0,0
1668493131192,ECE 258A,A00,103656,Milstein; Laurence B.,0,28,0,0
1668493131615,ECE 260B,A00,103658,Kang; Mingu,0,119,0,0
1668493132039,ECE 264A,A00,103659,Galton; Ian A,0,65,0,0
1668493132468,ECE 265A,A00,103661,Gudem; Prasad S.S.,0,69,0,0
1668493132892,ECE 265D,A00,103662,Gudem; Prasad S.S.,0,24,0,0
1668493133316,ECE 268,A00,103663,Koushanfar; Farinaz,0,42,0,0
1668493133739,ECE 269,A01,103665,Pal; Piya,0,213,0,0
1668493134169,ECE 271B,A00,103666,Vasconcelos; Manuela,0,75,0,0
1668493134599,ECE 276A,A00,103667,Atanasov; Nikolay A.,0,125,0,0
1668493135026,ECE 277,A00,103668,An; Cheolhong,0,147,0,0
1668493135454,ECE 279,A00,117947,Hall; Drew A.,0,22,0,0
1668493136304,ECE 283,A00,103670,Hsueh; Tzu-Chien,0,51,0,0
1668493136734,ECE 284,A00,103671,Turakhia; Yatish Girish,0,39,0,0
1668493137158,ECE 285,A00,103672,Zheng; Yang,0,39,0,0
1668493137158,ECE 285,B00,103673,Sworder; David D.,0,56,0,0
1668493137582,ECE 287,A00,103676,Javidi; Tara,0,8,0,0
1668493138004,MATH 200B,A00,098023,Salehi Golsefidy; Alireza,10,0,15,5
1668493138430,MATH 202B,A00,098024,Rhoades; Brendon Patrick,7,0,15,8
1668493138855,MATH 203B,A00,098025,Oprea; Dragos N.,9,0,15,6
1668493139279,MATH 204B,A00,098026,Sorensen; Claus M,13,0,15,2
1668493139702,MATH 208,A00,098027,Izadi; Elham,7,0,10,3
1668493140125,MATH 209,A00,098028,Pollack; Aaron,10,0,10,0
1668493140556,MATH 211A,A00,112919,Rogalski; Daniel,8,0,10,2
1668493140981,MATH 211B,A00,112920,Seward; Brandon M.,9,0,10,1
1668493141403,MATH 218,A00,098029,Li; Bo,10,0,10,0
1668493141844,MATH 220B,A00,098030,Novak; Jonathan I,11,0,15,4
1668493142275,MATH 221A,A00,098031,Ebenfelt; Peter F,12,0,15,3
1668493142709,MATH 231B,A00,098032,Zlatos; Andrej,11,0,15,4
1668493143144,MATH 240B,A00,098033,Ni; Lei,7,0,15,8
1668493143566,MATH 243,A00,098034,Jekel; David Andrew,10,0,10,0
1668493143992,MATH 245A,A00,098035,Nie; Jiawang,0,4,15,18
1668493144416,MATH 248,A00,098036,Bejenaru; Ioan,10,0,10,0
1668493144842,MATH 250B,A00,098037,Spolaor; Luca,14,0,15,1
1668493145268,MATH 258,A00,098038,Ni; Lei,9,0,10,1
1668493145692,MATH 264B,A00,098041,Rhoades; Brendon Patrick,8,0,15,7
1668493146115,MATH 268,A00,098042,Buss; Samuel R,10,0,10,0
1668493146542,MATH 269,A00,098043,Rhoades; Brendon Patrick,10,0,10,0
1668493146970,MATH 270B,A00,098044,Li; Bo,6,0,15,9
1668493147490,MATH 272B,A00,098045,Holst; Michael J,13,0,15,2
1668493147915,MATH 273A,A00,098046,Tian; Xiaochuan,10,0,15,5
1668493148339,MATH 275,A01,098048,Tian; Xiaochuan,6,0,10,4
1668493148770,MATH 278A,A00,098049,Holst; Michael J,7,0,10,3
1668493149200,MATH 278B,A00,098050,Cloninger; Alexander,10,0,10,0
1668493149623,MATH 278C,A00,098051,Nie; Jiawang,5,0,10,5
1668493150047,MATH 280B,A00,098052,Zheng; Tianyi,7,0,15,8
1668493150474,MATH 281B,A00,098053,Bradic; Jelena,0,2,15,15
1668493150903,MATH 282B,A00,098054,Arias-Castro; Ery,0,1,15,15
1668493151329,MATH 285,A00,098055,Fitzsimmons; Patrick J,0,3,15,17
1668493151754,MATH 287B,A00,098056,Arias-Castro; Ery,1,0,15,14
1668493152180,MATH 288,A00,098057,Agarwal; Pooja,9,0,10,1
1668493152180,MATH 288,B00,098058,Zhang; Danna,8,0,10,2
1668493152180,MATH 288,C00,098059,Williams; Ruth J,9,0,10,1
1668493152608,MATH 290B,A00,098060,Roberts; Justin Deritter,12,0,15,3
1668493153033,MATH 292,A00,098061,Belmont; Eva Kinoshita,10,0,10,0
1668493153458,MATH 295,A00,098062,Suk; Andrew Hoon,47,0,50,3
1668493153892,MATH 296,A00,098063,Novak; Jonathan I,20,0,20,0
1668493154317,MATH 297,001,098064,Gamst; Anthony Collins,9997,0,9999,2
1668493655024,COGS 205,A00,101395,Chiba; Andrea,19,0,20,1
1668493655446,COGS 210B,001,101404,Greene; Deanna Jacquelyn,9998,0,9999,1
1668493655446,COGS 210B,002,101417,Xia; Haijun,9999,0,9999,0
1668493655446,COGS 210B,003,101422,Nitz; Douglas A.,9999,0,9999,0
1668493655446,COGS 210B,004,101423,Hollan; James D.,9998,0,9999,1
1668493655446,COGS 210B,005,101424,Deak; Gedeon O.,9998,0,9999,1
1668493655446,COGS 210B,006,101425,Rossano; Federico,9999,0,9999,0
1668493655868,COGS 211B,A00,101427,Coulson; Seana M,9996,0,9999,3
1668493656294,COGS 220,A00,101428,Hollan; James D.,0,10,25,25
1668493656718,COGS 229,A00,101429,Dow; Steven P,17,0,25,8
1668493657141,COGS 230,A00,101430,Klemmer; Scott R,8,0,17,9
1668493657568,COGS 234,A00,101431,Xia; Haijun,2,0,25,23
1668493657991,COGS 260,A00,101432,Kiyonaga; Anastasia,21,0,25,4
1668493657991,COGS 260,B00,101433,Kirsh; David Joel,15,0,25,10
1668493658417,CSE 202,A00,102371,Impagliazzo; Russell,0,65,0,0
1668493658846,CSE 203B,A01,102373,Cheng; Chung Kuan,0,54,0,0
1668493659269,CSE 208,A00,102374,Micciancio; Daniele,0,5,0,0
1668493659694,CSE 209A,A00,112895,Impagliazzo; Russell,0,12,15,15
1668493660121,CSE 209B,A00,108005,Bellare; Mihir,0,7,0,0
1668493660545,CSE 210,A00,113163,Coblenz; Michael J,0,82,0,0
1668493660971,CSE 219,A00,106111,Dow; Steven P,0,6,20,20
1668493661395,CSE 221,A00,102376,Voelker; Geoffrey M.,0,70,0,0
1668493661828,CSE 224,A01,102378,Porter; George M,0,161,0,0
1668493662254,CSE 229A,A00,102379,Savage; Stefan,0,10,0,0
1668493662681,CSE 229C,A00,102380,Munyaka; Imani N. S.,0,10,0,0
1668493663103,CSE 232B,A00,102382,Deutsch; Alin Bernard,0,31,0,0
1668493663527,CSE 234,A01,112904,Kumar; Arun Kumar,0,0,0,0
1668493663953,CSE 237A,A00,102383,Rosing; Tajana Simunic,0,51,0,0
1668493664381,CSE 239A,A00,102384,Deutsch; Alin Bernard,0,14,0,0
1668493664810,CSE 239B,A00,102385,Polikarpova; Nadezhda,0,10,0,0
1668493665237,CSE 240A,A00,102386,Pannuto; Patrick William,0,45,0,0
1668493665663,CSE 240B,A00,102387,Zhao; Jishen,0,44,0,0
1668493666085,CSE 241A,A00,106406,Kang; Mingu,0,7,0,0
1668493666508,CSE 249B,A00,102388,Kahng; Andrew Byun,0,5,8,8
1668493667027,CSE 251B,A01,102392,Cottrell; Garrison W,0,46,0,0
1668493667027,CSE 251B,A02,102393,Cottrell; Garrison W,0,34,0,0
1668493667454,CSE 252B,A00,102394,Ochoa; Benjamin Lawrence,0,58,0,0
1668493667875,CSE 257,A01,102396,Gao; Sicun,0,133,0,0
1668493668300,CSE 272,A00,102397,Li; Tzumao,0,17,0,0
1668493668726,CSE 274,A00,111323,Chern; Albert Ren-Haur,0,15,0,0
1668493669152,CSE 282,A00,102398,Pevzner; Pavel Arkadjevich,0,0,0,0
1668493669578,CSE 284,A00,114175,Gymrek; Melissa Ann,0,22,0,0
1668493670005,CSE 290,A00,102399,Chandraker; Manmohan Krishna,0,11,0,0
1668493670005,CSE 290,B00,102400,Vaccaro; Kristen Marie,0,7,25,25
1668493670005,CSE 290,C00,102414,Pannuto; Patrick William,0,1,25,25
1668493670005,CSE 290,D00,102427,Pevzner; Pavel Arkadjevich,0,0,0,0
1668493670005,CSE 290,E00,102429,Zhao; Jishen,0,4,0,0
1668493670005,CSE 290,F00,102436,Tullsen; Dean Michael,0,5,0,0
1668493670005,CSE 290,G00,102440,Christensen; Henrik I,0,6,20,20
1668493670433,CSE 291,A00,102443,Su; Hao,0,0,0,0
1668493670433,CSE 291,B00,102448,Polikarpova; Nadezhda,0,0,0,0
1668493670433,CSE 291,C00,102453,Vaccaro; Kristen Marie,0,0,0,0
1668493670433,CSE 291,D00,111343,Savage; Stefan,0,0,0,0
1668493670433,CSE 291,E00,116474,Claffy; Kimberly Claire,0,0,0,0
1668493670433,CSE 291,F00,116479,Pasquale; Joseph,0,0,0,0
1668493670865,CSE 293,001,119111,Bafna; Vineet,9999,0,9999,0
1668493670865,CSE 293,002,119118,Bellare; Mihir,9999,0,9999,0
1668493670865,CSE 293,003,119122,Berg-Kirkpatrick; Taylor D,9999,0,9999,0
1668493670865,CSE 293,004,119135,Christensen; Henrik I,9999,0,9999,0
1668493670865,CSE 293,005,119142,Cottrell; Garrison W,9999,0,9999,0
1668493670865,CSE 293,006,119146,Deutsch; Alin Bernard,9999,0,9999,0
1668493670865,CSE 293,007,119159,Esmaeilzadeh; Hadi,9999,0,9999,0
1668493670865,CSE 293,008,119166,Freund; Yoav,9999,0,9999,0
1668493670865,CSE 293,009,119170,Griswold; William G.,9999,0,9999,0
1668493670865,CSE 293,010,119183,Gymrek; Melissa Ann,9999,0,9999,0
1668493670865,CSE 293,011,119190,Heninger; Nadia A,9999,0,9999,0
1668493670865,CSE 293,012,119230,Impagliazzo; Russell,9999,0,9999,0
1668493670865,CSE 293,013,119232,Jhala; Ranjit,9999,0,9999,0
1668493670865,CSE 293,014,119233,Kahng; Andrew Byun,9999,0,9999,0
1668493670865,CSE 293,015,119298,Kane; Daniel Mertz,9999,0,9999,0
1668493670865,CSE 293,016,119299,Kriegman; David J,9999,0,9999,0
1668493670865,CSE 293,017,119300,Kumar; Arun Kumar,9999,0,9999,0
1668493670865,CSE 293,018,119301,Lerner; Sorin,9999,0,9999,0
1668493670865,CSE 293,019,119302,Lovett; Shachar,9999,0,9999,0
1668493670865,CSE 293,020,119303,McAuley; Julian John,9999,0,9999,0
1668493670865,CSE 293,021,119304,Micciancio; Daniele,9999,0,9999,0
1668493670865,CSE 293,022,119367,Orailoglu; Alex,9999,0,9999,0
1668493670865,CSE 293,023,119382,Paturi; Ramamohan,9999,0,9999,0
1668493670865,CSE 293,024,119404,Polikarpova; Nadezhda,9999,0,9999,0
1668493670865,CSE 293,025,119406,Politz; Joseph Gibbs,9999,0,9999,0
1668493670865,CSE 293,026,119411,Porter; George M,9999,0,9999,0
1668493670865,CSE 293,027,119414,Porter; Leonard Emerson,9999,0,9999,0
1668493670865,CSE 293,028,119416,Ramamoorthi; Ravi,9999,0,9999,0
1668493670865,CSE 293,029,119417,Sahoo; Debashis,9999,0,9999,0
1668493670865,CSE 293,030,119420,Saul; Lawrence,9999,0,9999,0
1668493670865,CSE 293,031,119421,Savage; Stefan,9999,0,9999,0
1668493670865,CSE 293,032,119425,Schulze; Jurgen P.,9999,0,9999,0
1668493670865,CSE 293,033,119426,Snoeren; Alex C.,9999,0,9999,0
1668493670865,CSE 293,034,119428,Shang; Jingbo,9999,0,9999,0
1668493670865,CSE 293,035,119430,Stefan; Deian,9999,0,9999,0
1668493670865,CSE 293,036,119431,Su; Hao,9999,0,9999,0
1668493670865,CSE 293,037,119433,Swanson; Steven James,9999,0,9999,0
1668493670865,CSE 293,038,119435,Tullsen; Dean Michael,9999,0,9999,0
1668493670865,CSE 293,039,119483,Voelker; Geoffrey M.,9999,0,9999,0
1668493670865,CSE 293,040,119537,Zhao; Jishen,9999,0,9999,0
1668493670865,CSE 293,041,119538,Zhou; Yuan-Yuan,9999,0,9999,0
1668493670865,CSE 293,042,119539,Gao; Sicun,9999,0,9999,0
1668493670865,CSE 293,043,119540,Weibel; Nadir,9999,0,9999,0
1668493670865,CSE 293,044,119541,Gupta; Rajesh K.,9999,0,9999,0
1668493670865,CSE 293,045,126410,Vaccaro; Kristen Marie,9999,0,9999,0
1668493670865,CSE 293,046,126411,Klemke; Richard,9999,0,9999,0
1668493671289,CSE 294,A00,102459,Voelker; Geoffrey M.,0,2,0,0
1668493671289,CSE 294,B00,111322,Orailoglu; Alex,0,2,0,0
1668493671714,DSE 201,A00,096914,Deutsch; Alin Bernard,30,0,30,0
1668493672137,DSE 210,A00,096915,Dasgupta; Sanjoy,30,0,30,0
1668493672570,DSE 260A,A00,096916,Altintas De Callaf; Ilkay,30,0,30,0
1668493672997,ECE 200,001,103586,Antipa; Nicholas A,9999,0,9999,0
1668493672997,ECE 200,002,103587,Atanasov; Nikolay A.,9999,0,9999,0
1668493672997,ECE 200,003,103588,Bharadia; Dinesh,9999,0,9999,0
1668493672997,ECE 200,004,103589,Cheng; Chung Kuan,9999,0,9999,0
1668493672997,ECE 200,005,103590,Cosman; Pamela C.,9999,0,9999,0
1668493672997,ECE 200,006,103591,Dayeh; Shadi Ahmad,9999,0,9999,0
1668493672997,ECE 200,007,103592,Fainman; Yeshaiahu,9999,0,9999,0
1668493672997,ECE 200,008,103593,Ford; Joseph Earl,9999,0,9999,0
1668493672997,ECE 200,009,103594,Franceschetti; Massimo,9999,0,9999,0
1668493672997,ECE 200,010,103595,Fullerton; Eric E,9999,0,9999,0
1668493672997,ECE 200,011,103596,Galton; Ian A,9999,0,9999,0
1668493672997,ECE 200,012,103597,Gilja; Vikash,9999,0,9999,0
1668493672997,ECE 200,013,103598,Hall; Drew A.,9999,0,9999,0
1668493672997,ECE 200,014,103599,Hsueh; Tzu-Chien,9999,0,9999,0
1668493672997,ECE 200,015,103600,Javidi; Tara,9999,0,9999,0
1668493672997,ECE 200,016,103601,Kahng; Andrew Byun,9999,0,9999,0
1668493672997,ECE 200,017,103602,Kim; Young-Han,9999,0,9999,0
1668493672997,ECE 200,018,103603,Koushanfar; Farinaz,9999,0,9999,0
1668493672997,ECE 200,019,103604,Kuzum; Duygu,9999,0,9999,0
1668493672997,ECE 200,020,103605,Le; Hanh-Phuc,9999,0,9999,0
1668493672997,ECE 200,021,103606,Lin; Bill,9999,0,9999,0
1668493672997,ECE 200,022,103607,Liu; Zhaowei,9998,0,9999,1
1668493672997,ECE 200,023,103608,Lo; Yu-Hwa,9999,0,9999,0
1668493672997,ECE 200,024,103609,Lomakin; Vitaliy,9999,0,9999,0
1668493672997,ECE 200,025,103610,Mercier; Patrick Philip,9999,0,9999,0
1668493672997,ECE 200,026,103611,Meyer; Florian,9999,0,9999,0
1668493672997,ECE 200,027,103612,Milstein; Laurence B.,9999,0,9999,0
1668493672997,ECE 200,028,103613,Mir Arabbaygi; Siavash,9999,0,9999,0
1668493672997,ECE 200,029,103614,Mookherjea; Shayan,9999,0,9999,0
1668493672997,ECE 200,030,103615,Morris; Karcher William,9999,0,9999,0
1668493672997,ECE 200,031,103616,Ng; Tse Nga,9999,0,9999,0
1668493672997,ECE 200,032,103617,Nguyen; Truong Quang,9999,0,9999,0
1668493672997,ECE 200,033,103618,Nomura; Kenji,9999,0,9999,0
1668493672997,ECE 200,034,103619,Orlitsky; Alon,9999,0,9999,0
1668493672997,ECE 200,035,103620,Pal; Piya,9999,0,9999,0
1668493672997,ECE 200,036,103621,Papen; George C.,9999,0,9999,0
1668493672997,ECE 200,037,103622,Radic; Stojan,9999,0,9999,0
1668493672997,ECE 200,038,103623,Rao; Bhaskar D.,9999,0,9999,0
1668493672997,ECE 200,039,103624,Rao; Ramesh R,9999,0,9999,0
1668493672997,ECE 200,040,103625,Rebeiz; Gabriel,9999,0,9999,0
1668493672997,ECE 200,041,103626,Sanford; John R,9999,0,9999,0
1668493672997,ECE 200,042,103627,Siegel; Paul H.,9999,0,9999,0
1668493672997,ECE 200,043,103628,Sievenpiper; Daniel F.,9999,0,9999,0
1668493672997,ECE 200,044,103629,Sworder; David D.,9999,0,9999,0
1668493672997,ECE 200,045,103630,Taur; Yuan,9999,0,9999,0
1668493672997,ECE 200,046,103631,Touri; Behrouz,9999,0,9999,0
1668493672997,ECE 200,047,103632,Trivedi; Mohan M.,9999,0,9999,0
1668493672997,ECE 200,048,103633,Vasconcelos; Nuno,9999,0,9999,0
1668493672997,ECE 200,049,103634,Wang; Xiaolong,9999,0,9999,0
1668493672997,ECE 200,050,103635,Xie; Pengtao,9999,0,9999,0
1668493672997,ECE 200,051,103636,Yip; Michael,9999,0,9999,0
1668493672997,ECE 200,052,103637,Zeger; Kenneth A.,999,0,999,0
1668493672997,ECE 200,053,103638,Zhang; Xinyu,9999,0,9999,0
1668493672997,ECE 200,054,103639,Turakhia; Yatish Girish,9999,0,9999,0
1668493672997,ECE 200,055,103640,Kang; Mingu,9999,0,9999,0
1668493672997,ECE 200,056,103641,Shi; Yuanyuan,9999,0,9999,0
1668493672997,ECE 200,057,103642,Wang; Edward Jay,9999,0,9999,0
1668493672997,ECE 200,058,103643,Zheng; Yang,9999,0,9999,0
1668493673421,ECE 202,A00,103644,Kuzum; Duygu,0,43,0,0
1668493673848,ECE 212BN,A00,103646,Ng; Tse Nga,0,9,0,0
1668493674273,ECE 221,A00,111493,Staff,0,0,0,0
1668493674700,ECE 222B,A00,103647,Lomakin; Vitaliy,0,18,0,0
1668493675126,ECE 230B,A00,103648,Taur; Yuan,0,3,0,0
1668493675552,ECE 238B,A00,103649,Garay; Javier,0,0,0,0
1668493675989,ECE 240B,A00,112900,Fainman; Yeshaiahu,0,7,0,0
1668493676421,ECE 247A,A00,103650,Jokerst; Jesse Vincent,0,6,0,0
1668493676863,ECE 247B,A00,103651,Wang; Joseph,0,13,0,0
1668493677297,ECE 250,A00,103652,Siegel; Paul H.,0,82,0,0
1668493677728,ECE 251A,A00,103654,Rao; Bhaskar D.,0,61,0,0
1668493678156,ECE 257B,A00,103655,Bharadia; Dinesh,0,32,0,0
1668493678579,ECE 258A,A00,103656,Milstein; Laurence B.,0,28,0,0
1668493679006,ECE 260B,A00,103658,Kang; Mingu,0,119,0,0
1668493679433,ECE 264A,A00,103659,Galton; Ian A,0,65,0,0
1668493679859,ECE 265A,A00,103661,Gudem; Prasad S.S.,0,69,0,0
1668493680283,ECE 265D,A00,103662,Gudem; Prasad S.S.,0,24,0,0
1668493680707,ECE 268,A00,103663,Koushanfar; Farinaz,0,42,0,0
1668493681134,ECE 269,A01,103665,Pal; Piya,0,213,0,0
1668493681561,ECE 271B,A00,103666,Vasconcelos; Manuela,0,75,0,0
1668493681994,ECE 276A,A00,103667,Atanasov; Nikolay A.,0,125,0,0
1668493682420,ECE 277,A00,103668,An; Cheolhong,0,147,0,0
1668493682849,ECE 279,A00,117947,Hall; Drew A.,0,22,0,0
1668493683697,ECE 283,A00,103670,Hsueh; Tzu-Chien,0,51,0,0
1668493684131,ECE 284,A00,103671,Turakhia; Yatish Girish,0,39,0,0
1668493684559,ECE 285,A00,103672,Zheng; Yang,0,39,0,0
1668493684559,ECE 285,B00,103673,Sworder; David D.,0,56,0,0
1668493684983,ECE 287,A00,103676,Javidi; Tara,0,8,0,0
1668493685406,MATH 200B,A00,098023,Salehi Golsefidy; Alireza,10,0,15,5
1668493685829,MATH 202B,A00,098024,Rhoades; Brendon Patrick,7,0,15,8
1668493686254,MATH 203B,A00,098025,Oprea; Dragos N.,9,0,15,6
1668493686682,MATH 204B,A00,098026,Sorensen; Claus M,13,0,15,2
1668493687119,MATH 208,A00,098027,Izadi; Elham,7,0,10,3
1668493687546,MATH 209,A00,098028,Pollack; Aaron,10,0,10,0
1668493687968,MATH 211A,A00,112919,Rogalski; Daniel,8,0,10,2
1668493688394,MATH 211B,A00,112920,Seward; Brandon M.,9,0,10,1
1668493688819,MATH 218,A00,098029,Li; Bo,10,0,10,0
1668493689243,MATH 220B,A00,098030,Novak; Jonathan I,11,0,15,4
1668493689668,MATH 221A,A00,098031,Ebenfelt; Peter F,12,0,15,3
1668493690095,MATH 231B,A00,098032,Zlatos; Andrej,11,0,15,4
1668493690517,MATH 240B,A00,098033,Ni; Lei,7,0,15,8
1668493690941,MATH 243,A00,098034,Jekel; David Andrew,10,0,10,0
1668493691369,MATH 245A,A00,098035,Nie; Jiawang,0,4,15,18
1668493691801,MATH 248,A00,098036,Bejenaru; Ioan,10,0,10,0
1668493692227,MATH 250B,A00,098037,Spolaor; Luca,14,0,15,1
1668493692661,MATH 258,A00,098038,Ni; Lei,9,0,10,1
1668493693100,MATH 264B,A00,098041,Rhoades; Brendon Patrick,8,0,15,7
1668493693523,MATH 268,A00,098042,Buss; Samuel R,10,0,10,0
1668493693946,MATH 269,A00,098043,Rhoades; Brendon Patrick,10,0,10,0
1668493694368,MATH 270B,A00,098044,Li; Bo,6,0,15,9
1668493694795,MATH 272B,A00,098045,Holst; Michael J,13,0,15,2
1668493695216,MATH 273A,A00,098046,Tian; Xiaochuan,10,0,15,5
1668493695644,MATH 275,A01,098048,Tian; Xiaochuan,6,0,10,4
1668493696068,MATH 278A,A00,098049,Holst; Michael J,7,0,10,3
1668493696492,MATH 278B,A00,098050,Cloninger; Alexander,10,0,10,0
1668493696915,MATH 278C,A00,098051,Nie; Jiawang,5,0,10,5
1668493697340,MATH 280B,A00,098052,Zheng; Tianyi,7,0,15,8
1668493697773,MATH 281B,A00,098053,Bradic; Jelena,0,2,15,15
1668493698201,MATH 282B,A00,098054,Arias-Castro; Ery,0,1,15,15
1668493698630,MATH 285,A00,098055,Fitzsimmons; Patrick J,0,3,15,17
1668493699076,MATH 287B,A00,098056,Arias-Castro; Ery,1,0,15,14
1668493699503,MATH 288,A00,098057,Agarwal; Pooja,9,0,10,1
1668493699503,MATH 288,B00,098058,Zhang; Danna,8,0,10,2
1668493699503,MATH 288,C00,098059,Williams; Ruth J,9,0,10,1
1668493699927,MATH 290B,A00,098060,Roberts; Justin Deritter,12,0,15,3
1668493700359,MATH 292,A00,098061,Belmont; Eva Kinoshita,10,0,10,0
1668493700784,MATH 295,A00,098062,Suk; Andrew Hoon,47,0,50,3
1668493701209,MATH 296,A00,098063,Novak; Jonathan I,20,0,20,0
1668493701638,MATH 297,001,098064,Gamst; Anthony Collins,9997,0,9999,2
1668494213185,COGS 205,A00,101395,Chiba; Andrea,19,0,20,1
1668494213623,COGS 210B,001,101404,Greene; Deanna Jacquelyn,9998,0,9999,1
1668494213623,COGS 210B,002,101417,Xia; Haijun,9999,0,9999,0
1668494213623,COGS 210B,003,101422,Nitz; Douglas A.,9999,0,9999,0
1668494213623,COGS 210B,004,101423,Hollan; James D.,9998,0,9999,1
1668494213623,COGS 210B,005,101424,Deak; Gedeon O.,9998,0,9999,1
1668494213623,COGS 210B,006,101425,Rossano; Federico,9999,0,9999,0
1668494214045,COGS 211B,A00,101427,Coulson; Seana M,9996,0,9999,3
1668494214480,COGS 220,A00,101428,Hollan; James D.,0,10,25,25
1668494214903,COGS 229,A00,101429,Dow; Steven P,17,0,25,8
1668494215329,COGS 230,A00,101430,Klemmer; Scott R,8,0,17,9
1668494215751,COGS 234,A00,101431,Xia; Haijun,2,0,25,23
1668494216175,COGS 260,A00,101432,Kiyonaga; Anastasia,21,0,25,4
1668494216175,COGS 260,B00,101433,Kirsh; David Joel,15,0,25,10
1668494216613,CSE 202,A00,102371,Impagliazzo; Russell,0,65,0,0
1668494217036,CSE 203B,A01,102373,Cheng; Chung Kuan,0,54,0,0
1668494217460,CSE 208,A00,102374,Micciancio; Daniele,0,5,0,0
1668494217883,CSE 209A,A00,112895,Impagliazzo; Russell,0,12,15,15
1668494218307,CSE 209B,A00,108005,Bellare; Mihir,0,7,0,0
1668494218731,CSE 210,A00,113163,Coblenz; Michael J,0,82,0,0
1668494219162,CSE 219,A00,106111,Dow; Steven P,0,6,20,20
1668494219586,CSE 221,A00,102376,Voelker; Geoffrey M.,0,70,0,0
1668494220009,CSE 224,A01,102378,Porter; George M,0,161,0,0
1668494220434,CSE 229A,A00,102379,Savage; Stefan,0,10,0,0
1668494220858,CSE 229C,A00,102380,Munyaka; Imani N. S.,0,10,0,0
1668494221289,CSE 232B,A00,102382,Deutsch; Alin Bernard,0,31,0,0
1668494221716,CSE 234,A01,112904,Kumar; Arun Kumar,0,0,0,0
1668494222137,CSE 237A,A00,102383,Rosing; Tajana Simunic,0,51,0,0
1668494222559,CSE 239A,A00,102384,Deutsch; Alin Bernard,0,14,0,0
1668494222999,CSE 239B,A00,102385,Polikarpova; Nadezhda,0,10,0,0
1668494223425,CSE 240A,A00,102386,Pannuto; Patrick William,0,45,0,0
1668494223846,CSE 240B,A00,102387,Zhao; Jishen,0,44,0,0
1668494224269,CSE 241A,A00,106406,Kang; Mingu,0,7,0,0
1668494224700,CSE 249B,A00,102388,Kahng; Andrew Byun,0,5,8,8
1668494225124,CSE 251B,A01,102392,Cottrell; Garrison W,0,46,0,0
1668494225124,CSE 251B,A02,102393,Cottrell; Garrison W,0,34,0,0
1668494225548,CSE 252B,A00,102394,Ochoa; Benjamin Lawrence,0,58,0,0
1668494225975,CSE 257,A01,102396,Gao; Sicun,0,133,0,0
1668494226398,CSE 272,A00,102397,Li; Tzumao,0,17,0,0
1668494226828,CSE 274,A00,111323,Chern; Albert Ren-Haur,0,15,0,0
1668494227261,CSE 282,A00,102398,Pevzner; Pavel Arkadjevich,0,0,0,0
1668494227684,CSE 284,A00,114175,Gymrek; Melissa Ann,0,22,0,0
1668494228107,CSE 290,A00,102399,Chandraker; Manmohan Krishna,0,11,0,0
1668494228107,CSE 290,B00,102400,Vaccaro; Kristen Marie,0,7,25,25
1668494228107,CSE 290,C00,102414,Pannuto; Patrick William,0,1,25,25
1668494228107,CSE 290,D00,102427,Pevzner; Pavel Arkadjevich,0,0,0,0
1668494228107,CSE 290,E00,102429,Zhao; Jishen,0,4,0,0
1668494228107,CSE 290,F00,102436,Tullsen; Dean Michael,0,5,0,0
1668494228107,CSE 290,G00,102440,Christensen; Henrik I,0,6,20,20
1668494228531,CSE 291,A00,102443,Su; Hao,0,0,0,0
1668494228531,CSE 291,B00,102448,Polikarpova; Nadezhda,0,0,0,0
1668494228531,CSE 291,C00,102453,Vaccaro; Kristen Marie,0,0,0,0
1668494228531,CSE 291,D00,111343,Savage; Stefan,0,0,0,0
1668494228531,CSE 291,E00,116474,Claffy; Kimberly Claire,0,0,0,0
1668494228531,CSE 291,F00,116479,Pasquale; Joseph,0,0,0,0
1668494228966,CSE 293,001,119111,Bafna; Vineet,9999,0,9999,0
1668494228966,CSE 293,002,119118,Bellare; Mihir,9999,0,9999,0
1668494228966,CSE 293,003,119122,Berg-Kirkpatrick; Taylor D,9999,0,9999,0
1668494228966,CSE 293,004,119135,Christensen; Henrik I,9999,0,9999,0
1668494228966,CSE 293,005,119142,Cottrell; Garrison W,9999,0,9999,0
1668494228966,CSE 293,006,119146,Deutsch; Alin Bernard,9999,0,9999,0
1668494228966,CSE 293,007,119159,Esmaeilzadeh; Hadi,9999,0,9999,0
1668494228966,CSE 293,008,119166,Freund; Yoav,9999,0,9999,0
1668494228966,CSE 293,009,119170,Griswold; William G.,9999,0,9999,0
1668494228966,CSE 293,010,119183,Gymrek; Melissa Ann,9999,0,9999,0
1668494228966,CSE 293,011,119190,Heninger; Nadia A,9999,0,9999,0
1668494228966,CSE 293,012,119230,Impagliazzo; Russell,9999,0,9999,0
1668494228966,CSE 293,013,119232,Jhala; Ranjit,9999,0,9999,0
1668494228966,CSE 293,014,119233,Kahng; Andrew Byun,9999,0,9999,0
1668494228966,CSE 293,015,119298,Kane; Daniel Mertz,9999,0,9999,0
1668494228966,CSE 293,016,119299,Kriegman; David J,9999,0,9999,0
1668494228966,CSE 293,017,119300,Kumar; Arun Kumar,9999,0,9999,0
1668494228966,CSE 293,018,119301,Lerner; Sorin,9999,0,9999,0
1668494228966,CSE 293,019,119302,Lovett; Shachar,9999,0,9999,0
1668494228966,CSE 293,020,119303,McAuley; Julian John,9999,0,9999,0
1668494228966,CSE 293,021,119304,Micciancio; Daniele,9999,0,9999,0
1668494228966,CSE 293,022,119367,Orailoglu; Alex,9999,0,9999,0
1668494228966,CSE 293,023,119382,Paturi; Ramamohan,9999,0,9999,0
1668494228966,CSE 293,024,119404,Polikarpova; Nadezhda,9999,0,9999,0
1668494228966,CSE 293,025,119406,Politz; Joseph Gibbs,9999,0,9999,0
1668494228966,CSE 293,026,119411,Porter; George M,9999,0,9999,0
1668494228966,CSE 293,027,119414,Porter; Leonard Emerson,9999,0,9999,0
1668494228966,CSE 293,028,119416,Ramamoorthi; Ravi,9999,0,9999,0
1668494228966,CSE 293,029,119417,Sahoo; Debashis,9999,0,9999,0
1668494228966,CSE 293,030,119420,Saul; Lawrence,9999,0,9999,0
1668494228966,CSE 293,031,119421,Savage; Stefan,9999,0,9999,0
1668494228966,CSE 293,032,119425,Schulze; Jurgen P.,9999,0,9999,0
1668494228966,CSE 293,033,119426,Snoeren; Alex C.,9999,0,9999,0
1668494228966,CSE 293,034,119428,Shang; Jingbo,9999,0,9999,0
1668494228966,CSE 293,035,119430,Stefan; Deian,9999,0,9999,0
1668494228966,CSE 293,036,119431,Su; Hao,9999,0,9999,0
1668494228966,CSE 293,037,119433,Swanson; Steven James,9999,0,9999,0
1668494228966,CSE 293,038,119435,Tullsen; Dean Michael,9999,0,9999,0
1668494228966,CSE 293,039,119483,Voelker; Geoffrey M.,9999,0,9999,0
1668494228966,CSE 293,040,119537,Zhao; Jishen,9999,0,9999,0
1668494228966,CSE 293,041,119538,Zhou; Yuan-Yuan,9999,0,9999,0
1668494228966,CSE 293,042,119539,Gao; Sicun,9999,0,9999,0
1668494228966,CSE 293,043,119540,Weibel; Nadir,9999,0,9999,0
1668494228966,CSE 293,044,119541,Gupta; Rajesh K.,9999,0,9999,0
1668494228966,CSE 293,045,126410,Vaccaro; Kristen Marie,9999,0,9999,0
1668494228966,CSE 293,046,126411,Klemke; Richard,9999,0,9999,0
1668494229389,CSE 294,A00,102459,Voelker; Geoffrey M.,0,2,0,0
1668494229389,CSE 294,B00,111322,Orailoglu; Alex,0,2,0,0
1668494229822,DSE 201,A00,096914,Deutsch; Alin Bernard,30,0,30,0
1668494230244,DSE 210,A00,096915,Dasgupta; Sanjoy,30,0,30,0
1668494230668,DSE 260A,A00,096916,Altintas De Callaf; Ilkay,30,0,30,0
1668494231109,ECE 200,001,103586,Antipa; Nicholas A,9999,0,9999,0
1668494231109,ECE 200,002,103587,Atanasov; Nikolay A.,9999,0,9999,0
1668494231109,ECE 200,003,103588,Bharadia; Dinesh,9999,0,9999,0
1668494231109,ECE 200,004,103589,Cheng; Chung Kuan,9999,0,9999,0
1668494231109,ECE 200,005,103590,Cosman; Pamela C.,9999,0,9999,0
1668494231109,ECE 200,006,103591,Dayeh; Shadi Ahmad,9999,0,9999,0
1668494231109,ECE 200,007,103592,Fainman; Yeshaiahu,9999,0,9999,0
1668494231109,ECE 200,008,103593,Ford; Joseph Earl,9999,0,9999,0
1668494231109,ECE 200,009,103594,Franceschetti; Massimo,9999,0,9999,0
1668494231109,ECE 200,010,103595,Fullerton; Eric E,9999,0,9999,0
1668494231109,ECE 200,011,103596,Galton; Ian A,9999,0,9999,0
1668494231109,ECE 200,012,103597,Gilja; Vikash,9999,0,9999,0
1668494231109,ECE 200,013,103598,Hall; Drew A.,9999,0,9999,0
1668494231109,ECE 200,014,103599,Hsueh; Tzu-Chien,9999,0,9999,0
1668494231109,ECE 200,015,103600,Javidi; Tara,9999,0,9999,0
1668494231109,ECE 200,016,103601,Kahng; Andrew Byun,9999,0,9999,0
1668494231109,ECE 200,017,103602,Kim; Young-Han,9999,0,9999,0
1668494231109,ECE 200,018,103603,Koushanfar; Farinaz,9999,0,9999,0
1668494231109,ECE 200,019,103604,Kuzum; Duygu,9999,0,9999,0
1668494231109,ECE 200,020,103605,Le; Hanh-Phuc,9999,0,9999,0
1668494231109,ECE 200,021,103606,Lin; Bill,9999,0,9999,0
1668494231109,ECE 200,022,103607,Liu; Zhaowei,9998,0,9999,1
1668494231109,ECE 200,023,103608,Lo; Yu-Hwa,9999,0,9999,0
1668494231109,ECE 200,024,103609,Lomakin; Vitaliy,9999,0,9999,0
1668494231109,ECE 200,025,103610,Mercier; Patrick Philip,9999,0,9999,0
1668494231109,ECE 200,026,103611,Meyer; Florian,9999,0,9999,0
1668494231109,ECE 200,027,103612,Milstein; Laurence B.,9999,0,9999,0
1668494231109,ECE 200,028,103613,Mir Arabbaygi; Siavash,9999,0,9999,0
1668494231109,ECE 200,029,103614,Mookherjea; Shayan,9999,0,9999,0
1668494231109,ECE 200,030,103615,Morris; Karcher William,9999,0,9999,0
1668494231109,ECE 200,031,103616,Ng; Tse Nga,9999,0,9999,0
1668494231109,ECE 200,032,103617,Nguyen; Truong Quang,9999,0,9999,0
1668494231109,ECE 200,033,103618,Nomura; Kenji,9999,0,9999,0
1668494231109,ECE 200,034,103619,Orlitsky; Alon,9999,0,9999,0
1668494231109,ECE 200,035,103620,Pal; Piya,9999,0,9999,0
1668494231109,ECE 200,036,103621,Papen; George C.,9999,0,9999,0
1668494231109,ECE 200,037,103622,Radic; Stojan,9999,0,9999,0
1668494231109,ECE 200,038,103623,Rao; Bhaskar D.,9999,0,9999,0
1668494231109,ECE 200,039,103624,Rao; Ramesh R,9999,0,9999,0
1668494231109,ECE 200,040,103625,Rebeiz; Gabriel,9999,0,9999,0
1668494231109,ECE 200,041,103626,Sanford; John R,9999,0,9999,0
1668494231109,ECE 200,042,103627,Siegel; Paul H.,9999,0,9999,0
1668494231109,ECE 200,043,103628,Sievenpiper; Daniel F.,9999,0,9999,0
1668494231109,ECE 200,044,103629,Sworder; David D.,9999,0,9999,0
1668494231109,ECE 200,045,103630,Taur; Yuan,9999,0,9999,0
1668494231109,ECE 200,046,103631,Touri; Behrouz,9999,0,9999,0
1668494231109,ECE 200,047,103632,Trivedi; Mohan M.,9999,0,9999,0
1668494231109,ECE 200,048,103633,Vasconcelos; Nuno,9999,0,9999,0
1668494231109,ECE 200,049,103634,Wang; Xiaolong,9999,0,9999,0
1668494231109,ECE 200,050,103635,Xie; Pengtao,9999,0,9999,0
1668494231109,ECE 200,051,103636,Yip; Michael,9999,0,9999,0
1668494231109,ECE 200,052,103637,Zeger; Kenneth A.,999,0,999,0
1668494231109,ECE 200,053,103638,Zhang; Xinyu,9999,0,9999,0
1668494231109,ECE 200,054,103639,Turakhia; Yatish Girish,9999,0,9999,0
1668494231109,ECE 200,055,103640,Kang; Mingu,9999,0,9999,0
1668494231109,ECE 200,056,103641,Shi; Yuanyuan,9999,0,9999,0
1668494231109,ECE 200,057,103642,Wang; Edward Jay,9999,0,9999,0
1668494231109,ECE 200,058,103643,Zheng; Yang,9999,0,9999,0
1668494231533,ECE 202,A00,103644,Kuzum; Duygu,0,43,0,0
1668494231968,ECE 212BN,A00,103646,Ng; Tse Nga,0,9,0,0
1668494232393,ECE 221,A00,111493,Staff,0,0,0,0
1668494232815,ECE 222B,A00,103647,Lomakin; Vitaliy,0,18,0,0
1668494233239,ECE 230B,A00,103648,Taur; Yuan,0,3,0,0
1668494233663,ECE 238B,A00,103649,Garay; Javier,0,0,0,0
1668494234087,ECE 240B,A00,112900,Fainman; Yeshaiahu,0,7,0,0
1668494234514,ECE 247A,A00,103650,Jokerst; Jesse Vincent,0,6,0,0
1668494234941,ECE 247B,A00,103651,Wang; Joseph,0,13,0,0
1668494235364,ECE 250,A00,103652,Siegel; Paul H.,0,82,0,0
1668494235789,ECE 251A,A00,103654,Rao; Bhaskar D.,0,61,0,0
1668494236214,ECE 257B,A00,103655,Bharadia; Dinesh,0,32,0,0
1668494236651,ECE 258A,A00,103656,Milstein; Laurence B.,0,29,0,0
1668494237074,ECE 260B,A00,103658,Kang; Mingu,0,119,0,0
1668494237514,ECE 264A,A00,103659,Galton; Ian A,0,65,0,0
1668494237937,ECE 265A,A00,103661,Gudem; Prasad S.S.,0,69,0,0
1668494238359,ECE 265D,A00,103662,Gudem; Prasad S.S.,0,24,0,0
1668494238782,ECE 268,A00,103663,Koushanfar; Farinaz,0,42,0,0
1668494239207,ECE 269,A01,103665,Pal; Piya,0,214,0,0
1668494239631,ECE 271B,A00,103666,Vasconcelos; Manuela,0,75,0,0
1668494240056,ECE 276A,A00,103667,Atanasov; Nikolay A.,0,125,0,0
1668494240581,ECE 277,A00,103668,An; Cheolhong,0,147,0,0
1668494241007,ECE 279,A00,117947,Hall; Drew A.,0,22,0,0
1668494241858,ECE 283,A00,103670,Hsueh; Tzu-Chien,0,51,0,0
1668494242295,ECE 284,A00,103671,Turakhia; Yatish Girish,0,39,0,0
1668494242720,ECE 285,A00,103672,Zheng; Yang,0,39,0,0
1668494242720,ECE 285,B00,103673,Sworder; David D.,0,56,0,0
1668494243148,ECE 287,A00,103676,Javidi; Tara,0,8,0,0
1668494243581,MATH 200B,A00,098023,Salehi Golsefidy; Alireza,10,0,15,5
1668494244005,MATH 202B,A00,098024,Rhoades; Brendon Patrick,7,0,15,8
1668494244437,MATH 203B,A00,098025,Oprea; Dragos N.,9,0,15,6
1668494244860,MATH 204B,A00,098026,Sorensen; Claus M,13,0,15,2
1668494245292,MATH 208,A00,098027,Izadi; Elham,7,0,10,3
1668494245715,MATH 209,A00,098028,Pollack; Aaron,10,0,10,0
1668494246140,MATH 211A,A00,112919,Rogalski; Daniel,8,0,10,2
1668494246565,MATH 211B,A00,112920,Seward; Brandon M.,9,0,10,1
1668494246989,MATH 218,A00,098029,Li; Bo,10,0,10,0
1668494247412,MATH 220B,A00,098030,Novak; Jonathan I,11,0,15,4
1668494247835,MATH 221A,A00,098031,Ebenfelt; Peter F,12,0,15,3
1668494248259,MATH 231B,A00,098032,Zlatos; Andrej,11,0,15,4
1668494248686,MATH 240B,A00,098033,Ni; Lei,7,0,15,8
1668494249109,MATH 243,A00,098034,Jekel; David Andrew,10,0,10,0
1668494249536,MATH 245A,A00,098035,Nie; Jiawang,0,4,15,18
1668494249959,MATH 248,A00,098036,Bejenaru; Ioan,10,0,10,0
1668494250384,MATH 250B,A00,098037,Spolaor; Luca,14,0,15,1
1668494250819,MATH 258,A00,098038,Ni; Lei,9,0,10,1
1668494251246,MATH 264B,A00,098041,Rhoades; Brendon Patrick,8,0,15,7
1668494251671,MATH 268,A00,098042,Buss; Samuel R,10,0,10,0
1668494252108,MATH 269,A00,098043,Rhoades; Brendon Patrick,10,0,10,0
1668494252532,MATH 270B,A00,098044,Li; Bo,6,0,15,9
1668494252955,MATH 272B,A00,098045,Holst; Michael J,13,0,15,2
1668494253378,MATH 273A,A00,098046,Tian; Xiaochuan,10,0,15,5
1668494253810,MATH 275,A01,098048,Tian; Xiaochuan,6,0,10,4
1668494254232,MATH 278A,A00,098049,Holst; Michael J,7,0,10,3
1668494254661,MATH 278B,A00,098050,Cloninger; Alexander,10,0,10,0
1668494255085,MATH 278C,A00,098051,Nie; Jiawang,5,0,10,5
1668494255510,MATH 280B,A00,098052,Zheng; Tianyi,7,0,15,8
1668494255933,MATH 281B,A00,098053,Bradic; Jelena,0,2,15,15
1668494256360,MATH 282B,A00,098054,Arias-Castro; Ery,0,1,15,15
1668494256784,MATH 285,A00,098055,Fitzsimmons; Patrick J,0,3,15,17
1668494257207,MATH 287B,A00,098056,Arias-Castro; Ery,1,0,15,14
1668494257635,MATH 288,A00,098057,Agarwal; Pooja,9,0,10,1
1668494257635,MATH 288,B00,098058,Zhang; Danna,8,0,10,2
1668494257635,MATH 288,C00,098059,Williams; Ruth J,9,0,10,1
1668494258058,MATH 290B,A00,098060,Roberts; Justin Deritter,12,0,15,3
1668494258488,MATH 292,A00,098061,Belmont; Eva Kinoshita,10,0,10,0
1668494258917,MATH 295,A00,098062,Suk; Andrew Hoon,47,0,50,3
1668494259339,MATH 296,A00,098063,Novak; Jonathan I,20,0,20,0
1668494259763,MATH 297,001,098064,Gamst; Anthony Collins,9997,0,9999,2
1668494760878,COGS 205,A00,101395,Chiba; Andrea,19,0,20,1
1668494761304,COGS 210B,001,101404,Greene; Deanna Jacquelyn,9998,0,9999,1
1668494761304,COGS 210B,002,101417,Xia; Haijun,9999,0,9999,0
1668494761304,COGS 210B,003,101422,Nitz; Douglas A.,9999,0,9999,0
1668494761304,COGS 210B,004,101423,Hollan; James D.,9998,0,9999,1
1668494761304,COGS 210B,005,101424,Deak; Gedeon O.,9998,0,9999,1
1668494761304,COGS 210B,006,101425,Rossano; Federico,9999,0,9999,0
1668494761731,COGS 211B,A00,101427,Coulson; Seana M,9996,0,9999,3
1668494762156,COGS 220,A00,101428,Hollan; James D.,0,10,25,25
1668494762581,COGS 229,A00,101429,Dow; Steven P,17,0,25,8
1668494763006,COGS 230,A00,101430,Klemmer; Scott R,8,0,17,9
1668494763430,COGS 234,A00,101431,Xia; Haijun,2,0,25,23
1668494763852,COGS 260,A00,101432,Kiyonaga; Anastasia,21,0,25,4
1668494763852,COGS 260,B00,101433,Kirsh; David Joel,15,0,25,10
1668494764276,CSE 202,A00,102371,Impagliazzo; Russell,0,65,0,0
1668494764700,CSE 203B,A01,102373,Cheng; Chung Kuan,0,54,0,0
1668494765126,CSE 208,A00,102374,Micciancio; Daniele,0,5,0,0
1668494765550,CSE 209A,A00,112895,Impagliazzo; Russell,0,12,15,15
1668494765971,CSE 209B,A00,108005,Bellare; Mihir,0,7,0,0
1668494766398,CSE 210,A00,113163,Coblenz; Michael J,0,82,0,0
1668494766821,CSE 219,A00,106111,Dow; Steven P,0,6,20,20
1668494767249,CSE 221,A00,102376,Voelker; Geoffrey M.,0,70,0,0
1668494767672,CSE 224,A01,102378,Porter; George M,0,162,0,0
1668494768099,CSE 229A,A00,102379,Savage; Stefan,0,10,0,0
1668494768524,CSE 229C,A00,102380,Munyaka; Imani N. S.,0,10,0,0
1668494768946,CSE 232B,A00,102382,Deutsch; Alin Bernard,0,31,0,0
1668494769369,CSE 234,A01,112904,Kumar; Arun Kumar,0,0,0,0
1668494769793,CSE 237A,A00,102383,Rosing; Tajana Simunic,0,51,0,0
1668494770216,CSE 239A,A00,102384,Deutsch; Alin Bernard,0,14,0,0
1668494770640,CSE 239B,A00,102385,Polikarpova; Nadezhda,0,10,0,0
1668494771067,CSE 240A,A00,102386,Pannuto; Patrick William,0,45,0,0
1668494771490,CSE 240B,A00,102387,Zhao; Jishen,0,44,0,0
1668494771921,CSE 241A,A00,106406,Kang; Mingu,0,7,0,0
1668494772346,CSE 249B,A00,102388,Kahng; Andrew Byun,0,5,8,8
1668494772770,CSE 251B,A01,102392,Cottrell; Garrison W,0,46,0,0
1668494772770,CSE 251B,A02,102393,Cottrell; Garrison W,0,34,0,0
1668494773196,CSE 252B,A00,102394,Ochoa; Benjamin Lawrence,0,58,0,0
1668494773620,CSE 257,A01,102396,Gao; Sicun,0,133,0,0
1668494774047,CSE 272,A00,102397,Li; Tzumao,0,17,0,0
1668494774472,CSE 274,A00,111323,Chern; Albert Ren-Haur,0,15,0,0
1668494774897,CSE 282,A00,102398,Pevzner; Pavel Arkadjevich,0,0,0,0
1668494775329,CSE 284,A00,114175,Gymrek; Melissa Ann,0,22,0,0
1668494775755,CSE 290,A00,102399,Chandraker; Manmohan Krishna,0,11,0,0
1668494775755,CSE 290,B00,102400,Vaccaro; Kristen Marie,0,7,25,25
1668494775755,CSE 290,C00,102414,Pannuto; Patrick William,0,1,25,25
1668494775755,CSE 290,D00,102427,Pevzner; Pavel Arkadjevich,0,0,0,0
1668494775755,CSE 290,E00,102429,Zhao; Jishen,0,4,0,0
1668494775755,CSE 290,F00,102436,Tullsen; Dean Michael,0,5,0,0
1668494775755,CSE 290,G00,102440,Christensen; Henrik I,0,6,20,20
1668494776183,CSE 291,A00,102443,Su; Hao,0,0,0,0
1668494776183,CSE 291,B00,102448,Polikarpova; Nadezhda,0,0,0,0
1668494776183,CSE 291,C00,102453,Vaccaro; Kristen Marie,0,0,0,0
1668494776183,CSE 291,D00,111343,Savage; Stefan,0,0,0,0
1668494776183,CSE 291,E00,116474,Claffy; Kimberly Claire,0,0,0,0
1668494776183,CSE 291,F00,116479,Pasquale; Joseph,0,0,0,0
1668494776611,CSE 293,001,119111,Bafna; Vineet,9999,0,9999,0
1668494776611,CSE 293,002,119118,Bellare; Mihir,9999,0,9999,0
1668494776611,CSE 293,003,119122,Berg-Kirkpatrick; Taylor D,9999,0,9999,0
1668494776611,CSE 293,004,119135,Christensen; Henrik I,9999,0,9999,0
1668494776611,CSE 293,005,119142,Cottrell; Garrison W,9999,0,9999,0
1668494776611,CSE 293,006,119146,Deutsch; Alin Bernard,9999,0,9999,0
1668494776611,CSE 293,007,119159,Esmaeilzadeh; Hadi,9999,0,9999,0
1668494776611,CSE 293,008,119166,Freund; Yoav,9999,0,9999,0
1668494776611,CSE 293,009,119170,Griswold; William G.,9999,0,9999,0
1668494776611,CSE 293,010,119183,Gymrek; Melissa Ann,9999,0,9999,0
1668494776611,CSE 293,011,119190,Heninger; Nadia A,9999,0,9999,0
1668494776611,CSE 293,012,119230,Impagliazzo; Russell,9999,0,9999,0
1668494776611,CSE 293,013,119232,Jhala; Ranjit,9999,0,9999,0
1668494776611,CSE 293,014,119233,Kahng; Andrew Byun,9999,0,9999,0
1668494776611,CSE 293,015,119298,Kane; Daniel Mertz,9999,0,9999,0
1668494776611,CSE 293,016,119299,Kriegman; David J,9999,0,9999,0
1668494776611,CSE 293,017,119300,Kumar; Arun Kumar,9999,0,9999,0
1668494776611,CSE 293,018,119301,Lerner; Sorin,9999,0,9999,0
1668494776611,CSE 293,019,119302,Lovett; Shachar,9999,0,9999,0
1668494776611,CSE 293,020,119303,McAuley; Julian John,9999,0,9999,0
1668494776611,CSE 293,021,119304,Micciancio; Daniele,9999,0,9999,0
1668494776611,CSE 293,022,119367,Orailoglu; Alex,9999,0,9999,0
1668494776611,CSE 293,023,119382,Paturi; Ramamohan,9999,0,9999,0
1668494776611,CSE 293,024,119404,Polikarpova; Nadezhda,9999,0,9999,0
1668494776611,CSE 293,025,119406,Politz; Joseph Gibbs,9999,0,9999,0
1668494776611,CSE 293,026,119411,Porter; George M,9999,0,9999,0
1668494776611,CSE 293,027,119414,Porter; Leonard Emerson,9999,0,9999,0
1668494776611,CSE 293,028,119416,Ramamoorthi; Ravi,9999,0,9999,0
1668494776611,CSE 293,029,119417,Sahoo; Debashis,9999,0,9999,0
1668494776611,CSE 293,030,119420,Saul; Lawrence,9999,0,9999,0
1668494776611,CSE 293,031,119421,Savage; Stefan,9999,0,9999,0
1668494776611,CSE 293,032,119425,Schulze; Jurgen P.,9999,0,9999,0
1668494776611,CSE 293,033,119426,Snoeren; Alex C.,9999,0,9999,0
1668494776611,CSE 293,034,119428,Shang; Jingbo,9999,0,9999,0
1668494776611,CSE 293,035,119430,Stefan; Deian,9999,0,9999,0
1668494776611,CSE 293,036,119431,Su; Hao,9999,0,9999,0
1668494776611,CSE 293,037,119433,Swanson; Steven James,9999,0,9999,0
1668494776611,CSE 293,038,119435,Tullsen; Dean Michael,9999,0,9999,0
1668494776611,CSE 293,039,119483,Voelker; Geoffrey M.,9999,0,9999,0
1668494776611,CSE 293,040,119537,Zhao; Jishen,9999,0,9999,0
1668494776611,CSE 293,041,119538,Zhou; Yuan-Yuan,9999,0,9999,0
1668494776611,CSE 293,042,119539,Gao; Sicun,9999,0,9999,0
1668494776611,CSE 293,043,119540,Weibel; Nadir,9999,0,9999,0
1668494776611,CSE 293,044,119541,Gupta; Rajesh K.,9999,0,9999,0
1668494776611,CSE 293,045,126410,Vaccaro; Kristen Marie,9999,0,9999,0
1668494776611,CSE 293,046,126411,Klemke; Richard,9999,0,9999,0
1668494777039,CSE 294,A00,102459,Voelker; Geoffrey M.,0,2,0,0
1668494777039,CSE 294,B00,111322,Orailoglu; Alex,0,2,0,0
1668494777465,DSE 201,A00,096914,Deutsch; Alin Bernard,30,0,30,0
1668494777893,DSE 210,A00,096915,Dasgupta; Sanjoy,30,0,30,0
1668494778321,DSE 260A,A00,096916,Altintas De Callaf; Ilkay,30,0,30,0
1668494778765,ECE 200,001,103586,Antipa; Nicholas A,9999,0,9999,0
1668494778765,ECE 200,002,103587,Atanasov; Nikolay A.,9999,0,9999,0
1668494778765,ECE 200,003,103588,Bharadia; Dinesh,9999,0,9999,0
1668494778765,ECE 200,004,103589,Cheng; Chung Kuan,9999,0,9999,0
1668494778765,ECE 200,005,103590,Cosman; Pamela C.,9999,0,9999,0
1668494778765,ECE 200,006,103591,Dayeh; Shadi Ahmad,9999,0,9999,0
1668494778765,ECE 200,007,103592,Fainman; Yeshaiahu,9999,0,9999,0
1668494778765,ECE 200,008,103593,Ford; Joseph Earl,9999,0,9999,0
1668494778765,ECE 200,009,103594,Franceschetti; Massimo,9999,0,9999,0
1668494778765,ECE 200,010,103595,Fullerton; Eric E,9999,0,9999,0
1668494778765,ECE 200,011,103596,Galton; Ian A,9999,0,9999,0
1668494778765,ECE 200,012,103597,Gilja; Vikash,9999,0,9999,0
1668494778765,ECE 200,013,103598,Hall; Drew A.,9999,0,9999,0
1668494778765,ECE 200,014,103599,Hsueh; Tzu-Chien,9999,0,9999,0
1668494778765,ECE 200,015,103600,Javidi; Tara,9999,0,9999,0
1668494778765,ECE 200,016,103601,Kahng; Andrew Byun,9999,0,9999,0
1668494778765,ECE 200,017,103602,Kim; Young-Han,9999,0,9999,0
1668494778765,ECE 200,018,103603,Koushanfar; Farinaz,9999,0,9999,0
1668494778765,ECE 200,019,103604,Kuzum; Duygu,9999,0,9999,0
1668494778765,ECE 200,020,103605,Le; Hanh-Phuc,9999,0,9999,0
1668494778765,ECE 200,021,103606,Lin; Bill,9999,0,9999,0
1668494778765,ECE 200,022,103607,Liu; Zhaowei,9998,0,9999,1
1668494778765,ECE 200,023,103608,Lo; Yu-Hwa,9999,0,9999,0
1668494778765,ECE 200,024,103609,Lomakin; Vitaliy,9999,0,9999,0
1668494778765,ECE 200,025,103610,Mercier; Patrick Philip,9999,0,9999,0
1668494778765,ECE 200,026,103611,Meyer; Florian,9999,0,9999,0
1668494778765,ECE 200,027,103612,Milstein; Laurence B.,9999,0,9999,0
1668494778765,ECE 200,028,103613,Mir Arabbaygi; Siavash,9999,0,9999,0
1668494778765,ECE 200,029,103614,Mookherjea; Shayan,9999,0,9999,0
1668494778765,ECE 200,030,103615,Morris; Karcher William,9999,0,9999,0
1668494778765,ECE 200,031,103616,Ng; Tse Nga,9999,0,9999,0
1668494778765,ECE 200,032,103617,Nguyen; Truong Quang,9999,0,9999,0
1668494778765,ECE 200,033,103618,Nomura; Kenji,9999,0,9999,0
1668494778765,ECE 200,034,103619,Orlitsky; Alon,9999,0,9999,0
1668494778765,ECE 200,035,103620,Pal; Piya,9999,0,9999,0
1668494778765,ECE 200,036,103621,Papen; George C.,9999,0,9999,0
1668494778765,ECE 200,037,103622,Radic; Stojan,9999,0,9999,0
1668494778765,ECE 200,038,103623,Rao; Bhaskar D.,9999,0,9999,0
1668494778765,ECE 200,039,103624,Rao; Ramesh R,9999,0,9999,0
1668494778765,ECE 200,040,103625,Rebeiz; Gabriel,9999,0,9999,0
1668494778765,ECE 200,041,103626,Sanford; John R,9999,0,9999,0
1668494778765,ECE 200,042,103627,Siegel; Paul H.,9999,0,9999,0
1668494778765,ECE 200,043,103628,Sievenpiper; Daniel F.,9999,0,9999,0
1668494778765,ECE 200,044,103629,Sworder; David D.,9999,0,9999,0
1668494778765,ECE 200,045,103630,Taur; Yuan,9999,0,9999,0
1668494778765,ECE 200,046,103631,Touri; Behrouz,9999,0,9999,0
1668494778765,ECE 200,047,103632,Trivedi; Mohan M.,9999,0,9999,0
1668494778765,ECE 200,048,103633,Vasconcelos; Nuno,9999,0,9999,0
1668494778765,ECE 200,049,103634,Wang; Xiaolong,9999,0,9999,0
1668494778765,ECE 200,050,103635,Xie; Pengtao,9999,0,9999,0
1668494778765,ECE 200,051,103636,Yip; Michael,9999,0,9999,0
1668494778765,ECE 200,052,103637,Zeger; Kenneth A.,999,0,999,0
1668494778765,ECE 200,053,103638,Zhang; Xinyu,9999,0,9999,0
1668494778765,ECE 200,054,103639,Turakhia; Yatish Girish,9999,0,9999,0
1668494778765,ECE 200,055,103640,Kang; Mingu,9999,0,9999,0
1668494778765,ECE 200,056,103641,Shi; Yuanyuan,9999,0,9999,0
1668494778765,ECE 200,057,103642,Wang; Edward Jay,9999,0,9999,0
1668494778765,ECE 200,058,103643,Zheng; Yang,9999,0,9999,0
1668494779190,ECE 202,A00,103644,Kuzum; Duygu,0,44,0,0
1668494779612,ECE 212BN,A00,103646,Ng; Tse Nga,0,9,0,0
1668494780036,ECE 221,A00,111493,Staff,0,0,0,0
1668494780460,ECE 222B,A00,103647,Lomakin; Vitaliy,0,18,0,0
1668494780885,ECE 230B,A00,103648,Taur; Yuan,0,3,0,0
1668494781318,ECE 238B,A00,103649,Garay; Javier,0,0,0,0
1668494781749,ECE 240B,A00,112900,Fainman; Yeshaiahu,0,7,0,0
1668494782173,ECE 247A,A00,103650,Jokerst; Jesse Vincent,0,6,0,0
1668494782595,ECE 247B,A00,103651,Wang; Joseph,0,14,0,0
1668494783024,ECE 250,A00,103652,Siegel; Paul H.,0,82,0,0
1668494783453,ECE 251A,A00,103654,Rao; Bhaskar D.,0,61,0,0
1668494783875,ECE 257B,A00,103655,Bharadia; Dinesh,0,32,0,0
1668494784300,ECE 258A,A00,103656,Milstein; Laurence B.,0,29,0,0
1668494784729,ECE 260B,A00,103658,Kang; Mingu,0,119,0,0
1668494785161,ECE 264A,A00,103659,Galton; Ian A,0,65,0,0
1668494785588,ECE 265A,A00,103661,Gudem; Prasad S.S.,0,69,0,0
1668494786015,ECE 265D,A00,103662,Gudem; Prasad S.S.,0,24,0,0
1668494786445,ECE 268,A00,103663,Koushanfar; Farinaz,0,42,0,0
1668494786869,ECE 269,A01,103665,Pal; Piya,0,214,0,0
1668494787297,ECE 271B,A00,103666,Vasconcelos; Manuela,0,75,0,0
1668494787722,ECE 276A,A00,103667,Atanasov; Nikolay A.,0,125,0,0
1668494788146,ECE 277,A00,103668,An; Cheolhong,0,147,0,0
1668494788574,ECE 279,A00,117947,Hall; Drew A.,0,22,0,0
1668494789425,ECE 283,A00,103670,Hsueh; Tzu-Chien,0,51,0,0
1668494789852,ECE 284,A00,103671,Turakhia; Yatish Girish,0,39,0,0
1668494790280,ECE 285,A00,103672,Zheng; Yang,0,39,0,0
1668494790280,ECE 285,B00,103673,Sworder; David D.,0,56,0,0
1668494790707,ECE 287,A00,103676,Javidi; Tara,0,8,0,0
1668494791131,MATH 200B,A00,098023,Salehi Golsefidy; Alireza,10,0,15,5
1668494791556,MATH 202B,A00,098024,Rhoades; Brendon Patrick,7,0,15,8
1668494791986,MATH 203B,A00,098025,Oprea; Dragos N.,9,0,15,6
1668494792411,MATH 204B,A00,098026,Sorensen; Claus M,13,0,15,2
1668494792838,MATH 208,A00,098027,Izadi; Elham,7,0,10,3
1668494793262,MATH 209,A00,098028,Pollack; Aaron,10,0,10,0
1668494793687,MATH 211A,A00,112919,Rogalski; Daniel,8,0,10,2
1668494794113,MATH 211B,A00,112920,Seward; Brandon M.,9,0,10,1
1668494794535,MATH 218,A00,098029,Li; Bo,10,0,10,0
1668494794961,MATH 220B,A00,098030,Novak; Jonathan I,11,0,15,4
1668494795384,MATH 221A,A00,098031,Ebenfelt; Peter F,12,0,15,3
1668494795806,MATH 231B,A00,098032,Zlatos; Andrej,11,0,15,4
1668494796238,MATH 240B,A00,098033,Ni; Lei,7,0,15,8
1668494796664,MATH 243,A00,098034,Jekel; David Andrew,10,0,10,0
1668494797086,MATH 245A,A00,098035,Nie; Jiawang,0,4,15,18
1668494797512,MATH 248,A00,098036,Bejenaru; Ioan,10,0,10,0
1668494797936,MATH 250B,A00,098037,Spolaor; Luca,14,0,15,1
1668494798361,MATH 258,A00,098038,Ni; Lei,9,0,10,1
1668494798785,MATH 264B,A00,098041,Rhoades; Brendon Patrick,8,0,15,7
1668494799208,MATH 268,A00,098042,Buss; Samuel R,10,0,10,0
1668494799634,MATH 269,A00,098043,Rhoades; Brendon Patrick,10,0,10,0
1668494800059,MATH 270B,A00,098044,Li; Bo,6,0,15,9
1668494800483,MATH 272B,A00,098045,Holst; Michael J,13,0,15,2
1668494800906,MATH 273A,A00,098046,Tian; Xiaochuan,10,0,15,5
1668494801330,MATH 275,A01,098048,Tian; Xiaochuan,6,0,10,4
1668494801754,MATH 278A,A00,098049,Holst; Michael J,7,0,10,3
1668494802180,MATH 278B,A00,098050,Cloninger; Alexander,10,0,10,0
1668494802605,MATH 278C,A00,098051,Nie; Jiawang,5,0,10,5
1668494803033,MATH 280B,A00,098052,Zheng; Tianyi,7,0,15,8
1668494803530,MATH 281B,A00,098053,Bradic; Jelena,0,2,15,15
1668494803956,MATH 282B,A00,098054,Arias-Castro; Ery,0,1,15,15
1668494804382,MATH 285,A00,098055,Fitzsimmons; Patrick J,0,3,15,17
1668494804804,MATH 287B,A00,098056,Arias-Castro; Ery,1,0,15,14
1668494805240,MATH 288,A00,098057,Agarwal; Pooja,9,0,10,1
1668494805240,MATH 288,B00,098058,Zhang; Danna,8,0,10,2
1668494805240,MATH 288,C00,098059,Williams; Ruth J,9,0,10,1
1668494805672,MATH 290B,A00,098060,Roberts; Justin Deritter,12,0,15,3
1668494806094,MATH 292,A00,098061,Belmont; Eva Kinoshita,10,0,10,0
1668494806519,MATH 295,A00,098062,Suk; Andrew Hoon,47,0,50,3
1668494806948,MATH 296,A00,098063,Novak; Jonathan I,20,0,20,0
1668494807370,MATH 297,001,098064,Gamst; Anthony Collins,9997,0,9999,2
1668495308366,COGS 205,A00,101395,Chiba; Andrea,19,0,20,1
1668495308792,COGS 210B,001,101404,Greene; Deanna Jacquelyn,9998,0,9999,1
1668495308792,COGS 210B,002,101417,Xia; Haijun,9999,0,9999,0
1668495308792,COGS 210B,003,101422,Nitz; Douglas A.,9999,0,9999,0
1668495308792,COGS 210B,004,101423,Hollan; James D.,9998,0,9999,1
1668495308792,COGS 210B,005,101424,Deak; Gedeon O.,9998,0,9999,1
1668495308792,COGS 210B,006,101425,Rossano; Federico,9999,0,9999,0
1668495309214,COGS 211B,A00,101427,Coulson; Seana M,9996,0,9999,3
1668495309639,COGS 220,A00,101428,Hollan; James D.,0,10,25,25
1668495310064,COGS 229,A00,101429,Dow; Steven P,17,0,25,8
1668495310487,COGS 230,A00,101430,Klemmer; Scott R,8,0,17,9
1668495310910,COGS 234,A00,101431,Xia; Haijun,2,0,25,23
1668495311337,COGS 260,A00,101432,Kiyonaga; Anastasia,21,0,25,4
1668495311337,COGS 260,B00,101433,Kirsh; David Joel,15,0,25,10
1668495311762,CSE 202,A00,102371,Impagliazzo; Russell,0,65,0,0
1668495312186,CSE 203B,A01,102373,Cheng; Chung Kuan,0,55,0,0
1668495312610,CSE 208,A00,102374,Micciancio; Daniele,0,5,0,0
1668495313037,CSE 209A,A00,112895,Impagliazzo; Russell,0,12,15,15
1668495313461,CSE 209B,A00,108005,Bellare; Mihir,0,7,0,0
1668495313885,CSE 210,A00,113163,Coblenz; Michael J,0,82,0,0
1668495314313,CSE 219,A00,106111,Dow; Steven P,0,6,20,20
1668495314742,CSE 221,A00,102376,Voelker; Geoffrey M.,0,70,0,0
1668495315169,CSE 224,A01,102378,Porter; George M,0,162,0,0
1668495315592,CSE 229A,A00,102379,Savage; Stefan,0,10,0,0
1668495316018,CSE 229C,A00,102380,Munyaka; Imani N. S.,0,10,0,0
1668495316442,CSE 232B,A00,102382,Deutsch; Alin Bernard,0,31,0,0
1668495316866,CSE 234,A01,112904,Kumar; Arun Kumar,0,0,0,0
1668495317292,CSE 237A,A00,102383,Rosing; Tajana Simunic,0,52,0,0
1668495317720,CSE 239A,A00,102384,Deutsch; Alin Bernard,0,14,0,0
1668495318144,CSE 239B,A00,102385,Polikarpova; Nadezhda,0,10,0,0
1668495318575,CSE 240A,A00,102386,Pannuto; Patrick William,0,45,0,0
1668495319015,CSE 240B,A00,102387,Zhao; Jishen,0,45,0,0
1668495319441,CSE 241A,A00,106406,Kang; Mingu,0,8,0,0
1668495319863,CSE 249B,A00,102388,Kahng; Andrew Byun,0,5,8,8
1668495320290,CSE 251B,A01,102392,Cottrell; Garrison W,0,47,0,0
1668495320290,CSE 251B,A02,102393,Cottrell; Garrison W,0,34,0,0
1668495320712,CSE 252B,A00,102394,Ochoa; Benjamin Lawrence,0,58,0,0
1668495321141,CSE 257,A01,102396,Gao; Sicun,0,134,0,0
1668495321563,CSE 272,A00,102397,Li; Tzumao,0,18,0,0
1668495321985,CSE 274,A00,111323,Chern; Albert Ren-Haur,0,15,0,0
1668495322407,CSE 282,A00,102398,Pevzner; Pavel Arkadjevich,0,0,0,0
1668495322829,CSE 284,A00,114175,Gymrek; Melissa Ann,0,22,0,0
1668495323328,CSE 290,A00,102399,Chandraker; Manmohan Krishna,0,11,0,0
1668495323328,CSE 290,B00,102400,Vaccaro; Kristen Marie,0,7,25,25
1668495323328,CSE 290,C00,102414,Pannuto; Patrick William,0,1,25,25
1668495323328,CSE 290,D00,102427,Pevzner; Pavel Arkadjevich,0,0,0,0
1668495323328,CSE 290,E00,102429,Zhao; Jishen,0,4,0,0
1668495323328,CSE 290,F00,102436,Tullsen; Dean Michael,0,5,0,0
1668495323328,CSE 290,G00,102440,Christensen; Henrik I,0,6,20,20
1668495323751,CSE 291,A00,102443,Su; Hao,0,0,0,0
1668495323751,CSE 291,B00,102448,Polikarpova; Nadezhda,0,0,0,0
1668495323751,CSE 291,C00,102453,Vaccaro; Kristen Marie,0,0,0,0
1668495323751,CSE 291,D00,111343,Savage; Stefan,0,0,0,0
1668495323751,CSE 291,E00,116474,Claffy; Kimberly Claire,0,0,0,0
1668495323751,CSE 291,F00,116479,Pasquale; Joseph,0,0,0,0
1668495324178,CSE 293,001,119111,Bafna; Vineet,9999,0,9999,0
1668495324178,CSE 293,002,119118,Bellare; Mihir,9999,0,9999,0
1668495324178,CSE 293,003,119122,Berg-Kirkpatrick; Taylor D,9999,0,9999,0
1668495324178,CSE 293,004,119135,Christensen; Henrik I,9999,0,9999,0
1668495324178,CSE 293,005,119142,Cottrell; Garrison W,9999,0,9999,0
1668495324178,CSE 293,006,119146,Deutsch; Alin Bernard,9999,0,9999,0
1668495324178,CSE 293,007,119159,Esmaeilzadeh; Hadi,9999,0,9999,0
1668495324178,CSE 293,008,119166,Freund; Yoav,9999,0,9999,0
1668495324178,CSE 293,009,119170,Griswold; William G.,9999,0,9999,0
1668495324178,CSE 293,010,119183,Gymrek; Melissa Ann,9999,0,9999,0
1668495324178,CSE 293,011,119190,Heninger; Nadia A,9999,0,9999,0
1668495324178,CSE 293,012,119230,Impagliazzo; Russell,9999,0,9999,0
1668495324178,CSE 293,013,119232,Jhala; Ranjit,9999,0,9999,0
1668495324178,CSE 293,014,119233,Kahng; Andrew Byun,9999,0,9999,0
1668495324178,CSE 293,015,119298,Kane; Daniel Mertz,9999,0,9999,0
1668495324178,CSE 293,016,119299,Kriegman; David J,9999,0,9999,0
1668495324178,CSE 293,017,119300,Kumar; Arun Kumar,9999,0,9999,0
1668495324178,CSE 293,018,119301,Lerner; Sorin,9999,0,9999,0
1668495324178,CSE 293,019,119302,Lovett; Shachar,9999,0,9999,0
1668495324178,CSE 293,020,119303,McAuley; Julian John,9999,0,9999,0
1668495324178,CSE 293,021,119304,Micciancio; Daniele,9999,0,9999,0
1668495324178,CSE 293,022,119367,Orailoglu; Alex,9999,0,9999,0
1668495324178,CSE 293,023,119382,Paturi; Ramamohan,9999,0,9999,0
1668495324178,CSE 293,024,119404,Polikarpova; Nadezhda,9999,0,9999,0
1668495324178,CSE 293,025,119406,Politz; Joseph Gibbs,9999,0,9999,0
1668495324178,CSE 293,026,119411,Porter; George M,9999,0,9999,0
1668495324178,CSE 293,027,119414,Porter; Leonard Emerson,9999,0,9999,0
1668495324178,CSE 293,028,119416,Ramamoorthi; Ravi,9999,0,9999,0
1668495324178,CSE 293,029,119417,Sahoo; Debashis,9999,0,9999,0
1668495324178,CSE 293,030,119420,Saul; Lawrence,9999,0,9999,0
1668495324178,CSE 293,031,119421,Savage; Stefan,9999,0,9999,0
1668495324178,CSE 293,032,119425,Schulze; Jurgen P.,9999,0,9999,0
1668495324178,CSE 293,033,119426,Snoeren; Alex C.,9999,0,9999,0
1668495324178,CSE 293,034,119428,Shang; Jingbo,9999,0,9999,0
1668495324178,CSE 293,035,119430,Stefan; Deian,9999,0,9999,0
1668495324178,CSE 293,036,119431,Su; Hao,9999,0,9999,0
1668495324178,CSE 293,037,119433,Swanson; Steven James,9999,0,9999,0
1668495324178,CSE 293,038,119435,Tullsen; Dean Michael,9999,0,9999,0
1668495324178,CSE 293,039,119483,Voelker; Geoffrey M.,9999,0,9999,0
1668495324178,CSE 293,040,119537,Zhao; Jishen,9999,0,9999,0
1668495324178,CSE 293,041,119538,Zhou; Yuan-Yuan,9999,0,9999,0
1668495324178,CSE 293,042,119539,Gao; Sicun,9999,0,9999,0
1668495324178,CSE 293,043,119540,Weibel; Nadir,9999,0,9999,0
1668495324178,CSE 293,044,119541,Gupta; Rajesh K.,9999,0,9999,0
1668495324178,CSE 293,045,126410,Vaccaro; Kristen Marie,9999,0,9999,0
1668495324178,CSE 293,046,126411,Klemke; Richard,9999,0,9999,0
1668495324600,CSE 294,A00,102459,Voelker; Geoffrey M.,0,2,0,0
1668495324600,CSE 294,B00,111322,Orailoglu; Alex,0,2,0,0
1668495325031,DSE 201,A00,096914,Deutsch; Alin Bernard,30,0,30,0
1668495325456,DSE 210,A00,096915,Dasgupta; Sanjoy,30,0,30,0
1668495325881,DSE 260A,A00,096916,Altintas De Callaf; Ilkay,30,0,30,0
1668495326333,ECE 200,001,103586,Antipa; Nicholas A,9999,0,9999,0
1668495326333,ECE 200,002,103587,Atanasov; Nikolay A.,9999,0,9999,0
1668495326333,ECE 200,003,103588,Bharadia; Dinesh,9999,0,9999,0
1668495326333,ECE 200,004,103589,Cheng; Chung Kuan,9999,0,9999,0
1668495326333,ECE 200,005,103590,Cosman; Pamela C.,9999,0,9999,0
1668495326333,ECE 200,006,103591,Dayeh; Shadi Ahmad,9999,0,9999,0
1668495326333,ECE 200,007,103592,Fainman; Yeshaiahu,9999,0,9999,0
1668495326333,ECE 200,008,103593,Ford; Joseph Earl,9999,0,9999,0
1668495326333,ECE 200,009,103594,Franceschetti; Massimo,9999,0,9999,0
1668495326333,ECE 200,010,103595,Fullerton; Eric E,9999,0,9999,0
1668495326333,ECE 200,011,103596,Galton; Ian A,9999,0,9999,0
1668495326333,ECE 200,012,103597,Gilja; Vikash,9999,0,9999,0
1668495326333,ECE 200,013,103598,Hall; Drew A.,9999,0,9999,0
1668495326333,ECE 200,014,103599,Hsueh; Tzu-Chien,9999,0,9999,0
1668495326333,ECE 200,015,103600,Javidi; Tara,9999,0,9999,0
1668495326333,ECE 200,016,103601,Kahng; Andrew Byun,9999,0,9999,0
1668495326333,ECE 200,017,103602,Kim; Young-Han,9999,0,9999,0
1668495326333,ECE 200,018,103603,Koushanfar; Farinaz,9999,0,9999,0
1668495326333,ECE 200,019,103604,Kuzum; Duygu,9999,0,9999,0
1668495326333,ECE 200,020,103605,Le; Hanh-Phuc,9999,0,9999,0
1668495326333,ECE 200,021,103606,Lin; Bill,9999,0,9999,0
1668495326333,ECE 200,022,103607,Liu; Zhaowei,9998,0,9999,1
1668495326333,ECE 200,023,103608,Lo; Yu-Hwa,9999,0,9999,0
1668495326333,ECE 200,024,103609,Lomakin; Vitaliy,9999,0,9999,0
1668495326333,ECE 200,025,103610,Mercier; Patrick Philip,9999,0,9999,0
1668495326333,ECE 200,026,103611,Meyer; Florian,9999,0,9999,0
1668495326333,ECE 200,027,103612,Milstein; Laurence B.,9999,0,9999,0
1668495326333,ECE 200,028,103613,Mir Arabbaygi; Siavash,9999,0,9999,0
1668495326333,ECE 200,029,103614,Mookherjea; Shayan,9999,0,9999,0
1668495326333,ECE 200,030,103615,Morris; Karcher William,9999,0,9999,0
1668495326333,ECE 200,031,103616,Ng; Tse Nga,9999,0,9999,0
1668495326333,ECE 200,032,103617,Nguyen; Truong Quang,9999,0,9999,0
1668495326333,ECE 200,033,103618,Nomura; Kenji,9999,0,9999,0
1668495326333,ECE 200,034,103619,Orlitsky; Alon,9999,0,9999,0
1668495326333,ECE 200,035,103620,Pal; Piya,9999,0,9999,0
1668495326333,ECE 200,036,103621,Papen; George C.,9999,0,9999,0
1668495326333,ECE 200,037,103622,Radic; Stojan,9999,0,9999,0
1668495326333,ECE 200,038,103623,Rao; Bhaskar D.,9999,0,9999,0
1668495326333,ECE 200,039,103624,Rao; Ramesh R,9999,0,9999,0
1668495326333,ECE 200,040,103625,Rebeiz; Gabriel,9999,0,9999,0
1668495326333,ECE 200,041,103626,Sanford; John R,9999,0,9999,0
1668495326333,ECE 200,042,103627,Siegel; Paul H.,9999,0,9999,0
1668495326333,ECE 200,043,103628,Sievenpiper; Daniel F.,9999,0,9999,0
1668495326333,ECE 200,044,103629,Sworder; David D.,9999,0,9999,0
1668495326333,ECE 200,045,103630,Taur; Yuan,9999,0,9999,0
1668495326333,ECE 200,046,103631,Touri; Behrouz,9999,0,9999,0
1668495326333,ECE 200,047,103632,Trivedi; Mohan M.,9999,0,9999,0
1668495326333,ECE 200,048,103633,Vasconcelos; Nuno,9999,0,9999,0
1668495326333,ECE 200,049,103634,Wang; Xiaolong,9999,0,9999,0
1668495326333,ECE 200,050,103635,Xie; Pengtao,9999,0,9999,0
1668495326333,ECE 200,051,103636,Yip; Michael,9999,0,9999,0
1668495326333,ECE 200,052,103637,Zeger; Kenneth A.,999,0,999,0
1668495326333,ECE 200,053,103638,Zhang; Xinyu,9999,0,9999,0
1668495326333,ECE 200,054,103639,Turakhia; Yatish Girish,9999,0,9999,0
1668495326333,ECE 200,055,103640,Kang; Mingu,9999,0,9999,0
1668495326333,ECE 200,056,103641,Shi; Yuanyuan,9999,0,9999,0
1668495326333,ECE 200,057,103642,Wang; Edward Jay,9999,0,9999,0
1668495326333,ECE 200,058,103643,Zheng; Yang,9999,0,9999,0
1668495326757,ECE 202,A00,103644,Kuzum; Duygu,0,44,0,0
1668495327180,ECE 212BN,A00,103646,Ng; Tse Nga,0,9,0,0
1668495327615,ECE 221,A00,111493,Staff,0,0,0,0
1668495328040,ECE 222B,A00,103647,Lomakin; Vitaliy,0,18,0,0
1668495328466,ECE 230B,A00,103648,Taur; Yuan,0,3,0,0
1668495328894,ECE 238B,A00,103649,Garay; Javier,0,0,0,0
1668495329319,ECE 240B,A00,112900,Fainman; Yeshaiahu,0,7,0,0
1668495329744,ECE 247A,A00,103650,Jokerst; Jesse Vincent,0,6,0,0
1668495330167,ECE 247B,A00,103651,Wang; Joseph,0,14,0,0
1668495330591,ECE 250,A00,103652,Siegel; Paul H.,0,82,0,0
1668495331017,ECE 251A,A00,103654,Rao; Bhaskar D.,0,61,0,0
1668495331445,ECE 257B,A00,103655,Bharadia; Dinesh,0,32,0,0
1668495331868,ECE 258A,A00,103656,Milstein; Laurence B.,0,29,0,0
1668495332295,ECE 260B,A00,103658,Kang; Mingu,0,119,0,0
1668495332725,ECE 264A,A00,103659,Galton; Ian A,0,65,0,0
1668495333148,ECE 265A,A00,103661,Gudem; Prasad S.S.,0,69,0,0
1668495333574,ECE 265D,A00,103662,Gudem; Prasad S.S.,0,24,0,0
1668495334006,ECE 268,A00,103663,Koushanfar; Farinaz,0,42,0,0
1668495334429,ECE 269,A01,103665,Pal; Piya,0,215,0,0
1668495334852,ECE 271B,A00,103666,Vasconcelos; Manuela,0,76,0,0
1668495335279,ECE 276A,A00,103667,Atanasov; Nikolay A.,0,125,0,0
1668495335702,ECE 277,A00,103668,An; Cheolhong,0,148,0,0
1668495336127,ECE 279,A00,117947,Hall; Drew A.,0,22,0,0
1668495336975,ECE 283,A00,103670,Hsueh; Tzu-Chien,0,51,0,0
1668495337403,ECE 284,A00,103671,Turakhia; Yatish Girish,0,39,0,0
1668495337827,ECE 285,A00,103672,Zheng; Yang,0,39,0,0
1668495337827,ECE 285,B00,103673,Sworder; David D.,0,56,0,0
1668495338251,ECE 287,A00,103676,Javidi; Tara,0,8,0,0
1668495338685,MATH 200B,A00,098023,Salehi Golsefidy; Alireza,10,0,15,5
1668495339108,MATH 202B,A00,098024,Rhoades; Brendon Patrick,7,0,15,8
1668495339533,MATH 203B,A00,098025,Oprea; Dragos N.,9,0,15,6
1668495339958,MATH 204B,A00,098026,Sorensen; Claus M,13,0,15,2
1668495340382,MATH 208,A00,098027,Izadi; Elham,7,0,10,3
1668495340806,MATH 209,A00,098028,Pollack; Aaron,10,0,10,0
1668495341238,MATH 211A,A00,112919,Rogalski; Daniel,8,0,10,2
1668495341660,MATH 211B,A00,112920,Seward; Brandon M.,9,0,10,1
1668495342084,MATH 218,A00,098029,Li; Bo,10,0,10,0
1668495342511,MATH 220B,A00,098030,Novak; Jonathan I,11,0,15,4
1668495342934,MATH 221A,A00,098031,Ebenfelt; Peter F,12,0,15,3
1668495343358,MATH 231B,A00,098032,Zlatos; Andrej,11,0,15,4
1668495343783,MATH 240B,A00,098033,Ni; Lei,7,0,15,8
1668495344205,MATH 243,A00,098034,Jekel; David Andrew,10,0,10,0
1668495344632,MATH 245A,A00,098035,Nie; Jiawang,0,4,15,18
1668495345056,MATH 248,A00,098036,Bejenaru; Ioan,10,0,10,0
1668495345481,MATH 250B,A00,098037,Spolaor; Luca,14,0,15,1
1668495345909,MATH 258,A00,098038,Ni; Lei,9,0,10,1
1668495346338,MATH 264B,A00,098041,Rhoades; Brendon Patrick,8,0,15,7
1668495346762,MATH 268,A00,098042,Buss; Samuel R,10,0,10,0
1668495347186,MATH 269,A00,098043,Rhoades; Brendon Patrick,10,0,10,0
1668495347609,MATH 270B,A00,098044,Li; Bo,6,0,15,9
1668495348033,MATH 272B,A00,098045,Holst; Michael J,13,0,15,2
1668495348459,MATH 273A,A00,098046,Tian; Xiaochuan,10,0,15,5
1668495348884,MATH 275,A01,098048,Tian; Xiaochuan,6,0,10,4
1668495349309,MATH 278A,A00,098049,Holst; Michael J,7,0,10,3
1668495349736,MATH 278B,A00,098050,Cloninger; Alexander,10,0,10,0
1668495350165,MATH 278C,A00,098051,Nie; Jiawang,5,0,10,5
1668495350594,MATH 280B,A00,098052,Zheng; Tianyi,7,0,15,8
1668495351018,MATH 281B,A00,098053,Bradic; Jelena,0,2,15,15
1668495351441,MATH 282B,A00,098054,Arias-Castro; Ery,0,1,15,15
1668495351868,MATH 285,A00,098055,Fitzsimmons; Patrick J,0,3,15,17
1668495352292,MATH 287B,A00,098056,Arias-Castro; Ery,1,0,15,14
1668495352715,MATH 288,A00,098057,Agarwal; Pooja,9,0,10,1
1668495352715,MATH 288,B00,098058,Zhang; Danna,8,0,10,2
1668495352715,MATH 288,C00,098059,Williams; Ruth J,9,0,10,1
1668495353141,MATH 290B,A00,098060,Roberts; Justin Deritter,12,0,15,3
1668495353566,MATH 292,A00,098061,Belmont; Eva Kinoshita,10,0,10,0
1668495353991,MATH 295,A00,098062,Suk; Andrew Hoon,47,0,50,3
1668495354415,MATH 296,A00,098063,Novak; Jonathan I,20,0,20,0
1668495354839,MATH 297,001,098064,Gamst; Anthony Collins,9997,0,9999,2
1668495856340,COGS 205,A00,101395,Chiba; Andrea,19,0,20,1
1668495856776,COGS 210B,001,101404,Greene; Deanna Jacquelyn,9998,0,9999,1
1668495856776,COGS 210B,002,101417,Xia; Haijun,9999,0,9999,0
1668495856776,COGS 210B,003,101422,Nitz; Douglas A.,9999,0,9999,0
1668495856776,COGS 210B,004,101423,Hollan; James D.,9998,0,9999,1
1668495856776,COGS 210B,005,101424,Deak; Gedeon O.,9998,0,9999,1
1668495856776,COGS 210B,006,101425,Rossano; Federico,9999,0,9999,0
1668495857200,COGS 211B,A00,101427,Coulson; Seana M,9996,0,9999,3
1668495857628,COGS 220,A00,101428,Hollan; James D.,0,10,25,25
1668495858052,COGS 229,A00,101429,Dow; Steven P,17,0,25,8
1668495858477,COGS 230,A00,101430,Klemmer; Scott R,8,0,17,9
1668495858902,COGS 234,A00,101431,Xia; Haijun,2,0,25,23
1668495859326,COGS 260,A00,101432,Kiyonaga; Anastasia,21,0,25,4
1668495859326,COGS 260,B00,101433,Kirsh; David Joel,15,0,25,10
1668495859748,CSE 202,A00,102371,Impagliazzo; Russell,0,65,0,0
1668495860173,CSE 203B,A01,102373,Cheng; Chung Kuan,0,55,0,0
1668495860600,CSE 208,A00,102374,Micciancio; Daniele,0,5,0,0
1668495861025,CSE 209A,A00,112895,Impagliazzo; Russell,0,12,15,15
1668495861448,CSE 209B,A00,108005,Bellare; Mihir,0,7,0,0
1668495861876,CSE 210,A00,113163,Coblenz; Michael J,0,82,0,0
1668495862311,CSE 219,A00,106111,Dow; Steven P,0,6,20,20
1668495862737,CSE 221,A00,102376,Voelker; Geoffrey M.,0,70,0,0
1668495863162,CSE 224,A01,102378,Porter; George M,0,162,0,0
1668495863593,CSE 229A,A00,102379,Savage; Stefan,0,10,0,0
1668495864017,CSE 229C,A00,102380,Munyaka; Imani N. S.,0,10,0,0
1668495864445,CSE 232B,A00,102382,Deutsch; Alin Bernard,0,31,0,0
1668495864871,CSE 234,A01,112904,Kumar; Arun Kumar,0,0,0,0
1668495865299,CSE 237A,A00,102383,Rosing; Tajana Simunic,0,52,0,0
1668495865729,CSE 239A,A00,102384,Deutsch; Alin Bernard,0,14,0,0
1668495866159,CSE 239B,A00,102385,Polikarpova; Nadezhda,0,10,0,0
1668495866597,CSE 240A,A00,102386,Pannuto; Patrick William,0,46,0,0
1668495867021,CSE 240B,A00,102387,Zhao; Jishen,0,45,0,0
1668495867450,CSE 241A,A00,106406,Kang; Mingu,0,8,0,0
1668495867875,CSE 249B,A00,102388,Kahng; Andrew Byun,0,5,8,8
1668495868309,CSE 251B,A01,102392,Cottrell; Garrison W,0,48,0,0
1668495868309,CSE 251B,A02,102393,Cottrell; Garrison W,0,34,0,0
1668495868739,CSE 252B,A00,102394,Ochoa; Benjamin Lawrence,0,58,0,0
1668495869167,CSE 257,A01,102396,Gao; Sicun,0,134,0,0
1668495869594,CSE 272,A00,102397,Li; Tzumao,0,18,0,0
1668495870020,CSE 274,A00,111323,Chern; Albert Ren-Haur,0,15,0,0
1668495870448,CSE 282,A00,102398,Pevzner; Pavel Arkadjevich,0,0,0,0
1668495870875,CSE 284,A00,114175,Gymrek; Melissa Ann,0,22,0,0
1668495871309,CSE 290,A00,102399,Chandraker; Manmohan Krishna,0,11,0,0
1668495871309,CSE 290,B00,102400,Vaccaro; Kristen Marie,0,7,25,25
1668495871309,CSE 290,C00,102414,Pannuto; Patrick William,0,1,25,25
1668495871309,CSE 290,D00,102427,Pevzner; Pavel Arkadjevich,0,0,0,0
1668495871309,CSE 290,E00,102429,Zhao; Jishen,0,4,0,0
1668495871309,CSE 290,F00,102436,Tullsen; Dean Michael,0,5,0,0
1668495871309,CSE 290,G00,102440,Christensen; Henrik I,0,6,20,20
1668495871751,CSE 291,A00,102443,Su; Hao,0,0,0,0
1668495871751,CSE 291,B00,102448,Polikarpova; Nadezhda,0,0,0,0
1668495871751,CSE 291,C00,102453,Vaccaro; Kristen Marie,0,0,0,0
1668495871751,CSE 291,D00,111343,Savage; Stefan,0,0,0,0
1668495871751,CSE 291,E00,116474,Claffy; Kimberly Claire,0,0,0,0
1668495871751,CSE 291,F00,116479,Pasquale; Joseph,0,0,0,0
1668495872214,CSE 293,001,119111,Bafna; Vineet,9999,0,9999,0
1668495872214,CSE 293,002,119118,Bellare; Mihir,9999,0,9999,0
1668495872214,CSE 293,003,119122,Berg-Kirkpatrick; Taylor D,9999,0,9999,0
1668495872214,CSE 293,004,119135,Christensen; Henrik I,9999,0,9999,0
1668495872214,CSE 293,005,119142,Cottrell; Garrison W,9999,0,9999,0
1668495872214,CSE 293,006,119146,Deutsch; Alin Bernard,9999,0,9999,0
1668495872214,CSE 293,007,119159,Esmaeilzadeh; Hadi,9999,0,9999,0
1668495872214,CSE 293,008,119166,Freund; Yoav,9999,0,9999,0
1668495872214,CSE 293,009,119170,Griswold; William G.,9999,0,9999,0
1668495872214,CSE 293,010,119183,Gymrek; Melissa Ann,9999,0,9999,0
1668495872214,CSE 293,011,119190,Heninger; Nadia A,9999,0,9999,0
1668495872214,CSE 293,012,119230,Impagliazzo; Russell,9999,0,9999,0
1668495872214,CSE 293,013,119232,Jhala; Ranjit,9999,0,9999,0
1668495872214,CSE 293,014,119233,Kahng; Andrew Byun,9999,0,9999,0
1668495872214,CSE 293,015,119298,Kane; Daniel Mertz,9999,0,9999,0
1668495872214,CSE 293,016,119299,Kriegman; David J,9999,0,9999,0
1668495872214,CSE 293,017,119300,Kumar; Arun Kumar,9999,0,9999,0
1668495872214,CSE 293,018,119301,Lerner; Sorin,9999,0,9999,0
1668495872214,CSE 293,019,119302,Lovett; Shachar,9999,0,9999,0
1668495872214,CSE 293,020,119303,McAuley; Julian John,9999,0,9999,0
1668495872214,CSE 293,021,119304,Micciancio; Daniele,9999,0,9999,0
1668495872214,CSE 293,022,119367,Orailoglu; Alex,9999,0,9999,0
1668495872214,CSE 293,023,119382,Paturi; Ramamohan,9999,0,9999,0
1668495872214,CSE 293,024,119404,Polikarpova; Nadezhda,9999,0,9999,0
1668495872214,CSE 293,025,119406,Politz; Joseph Gibbs,9999,0,9999,0
1668495872214,CSE 293,026,119411,Porter; George M,9999,0,9999,0
1668495872214,CSE 293,027,119414,Porter; Leonard Emerson,9999,0,9999,0
1668495872214,CSE 293,028,119416,Ramamoorthi; Ravi,9999,0,9999,0
1668495872214,CSE 293,029,119417,Sahoo; Debashis,9999,0,9999,0
1668495872214,CSE 293,030,119420,Saul; Lawrence,9999,0,9999,0
1668495872214,CSE 293,031,119421,Savage; Stefan,9999,0,9999,0
1668495872214,CSE 293,032,119425,Schulze; Jurgen P.,9999,0,9999,0
1668495872214,CSE 293,033,119426,Snoeren; Alex C.,9999,0,9999,0
1668495872214,CSE 293,034,119428,Shang; Jingbo,9999,0,9999,0
1668495872214,CSE 293,035,119430,Stefan; Deian,9999,0,9999,0
1668495872214,CSE 293,036,119431,Su; Hao,9999,0,9999,0
1668495872214,CSE 293,037,119433,Swanson; Steven James,9999,0,9999,0
1668495872214,CSE 293,038,119435,Tullsen; Dean Michael,9999,0,9999,0
1668495872214,CSE 293,039,119483,Voelker; Geoffrey M.,9999,0,9999,0
1668495872214,CSE 293,040,119537,Zhao; Jishen,9999,0,9999,0
1668495872214,CSE 293,041,119538,Zhou; Yuan-Yuan,9999,0,9999,0
1668495872214,CSE 293,042,119539,Gao; Sicun,9999,0,9999,0
1668495872214,CSE 293,043,119540,Weibel; Nadir,9999,0,9999,0
1668495872214,CSE 293,044,119541,Gupta; Rajesh K.,9999,0,9999,0
1668495872214,CSE 293,045,126410,Vaccaro; Kristen Marie,9999,0,9999,0
1668495872214,CSE 293,046,126411,Klemke; Richard,9999,0,9999,0
1668495872644,CSE 294,A00,102459,Voelker; Geoffrey M.,0,2,0,0
1668495872644,CSE 294,B00,111322,Orailoglu; Alex,0,2,0,0
1668495873069,DSE 201,A00,096914,Deutsch; Alin Bernard,30,0,30,0
1668495873493,DSE 210,A00,096915,Dasgupta; Sanjoy,30,0,30,0
1668495873918,DSE 260A,A00,096916,Altintas De Callaf; Ilkay,30,0,30,0
1668495874370,ECE 200,001,103586,Antipa; Nicholas A,9999,0,9999,0
1668495874370,ECE 200,002,103587,Atanasov; Nikolay A.,9999,0,9999,0
1668495874370,ECE 200,003,103588,Bharadia; Dinesh,9999,0,9999,0
1668495874370,ECE 200,004,103589,Cheng; Chung Kuan,9999,0,9999,0
1668495874370,ECE 200,005,103590,Cosman; Pamela C.,9999,0,9999,0
1668495874370,ECE 200,006,103591,Dayeh; Shadi Ahmad,9999,0,9999,0
1668495874370,ECE 200,007,103592,Fainman; Yeshaiahu,9999,0,9999,0
1668495874370,ECE 200,008,103593,Ford; Joseph Earl,9999,0,9999,0
1668495874370,ECE 200,009,103594,Franceschetti; Massimo,9999,0,9999,0
1668495874370,ECE 200,010,103595,Fullerton; Eric E,9999,0,9999,0
1668495874370,ECE 200,011,103596,Galton; Ian A,9999,0,9999,0
1668495874370,ECE 200,012,103597,Gilja; Vikash,9999,0,9999,0
1668495874370,ECE 200,013,103598,Hall; Drew A.,9999,0,9999,0
1668495874370,ECE 200,014,103599,Hsueh; Tzu-Chien,9999,0,9999,0
1668495874370,ECE 200,015,103600,Javidi; Tara,9999,0,9999,0
1668495874370,ECE 200,016,103601,Kahng; Andrew Byun,9999,0,9999,0
1668495874370,ECE 200,017,103602,Kim; Young-Han,9999,0,9999,0
1668495874370,ECE 200,018,103603,Koushanfar; Farinaz,9999,0,9999,0
1668495874370,ECE 200,019,103604,Kuzum; Duygu,9999,0,9999,0
1668495874370,ECE 200,020,103605,Le; Hanh-Phuc,9999,0,9999,0
1668495874370,ECE 200,021,103606,Lin; Bill,9999,0,9999,0
1668495874370,ECE 200,022,103607,Liu; Zhaowei,9998,0,9999,1
1668495874370,ECE 200,023,103608,Lo; Yu-Hwa,9999,0,9999,0
1668495874370,ECE 200,024,103609,Lomakin; Vitaliy,9999,0,9999,0
1668495874370,ECE 200,025,103610,Mercier; Patrick Philip,9999,0,9999,0
1668495874370,ECE 200,026,103611,Meyer; Florian,9999,0,9999,0
1668495874370,ECE 200,027,103612,Milstein; Laurence B.,9999,0,9999,0
1668495874370,ECE 200,028,103613,Mir Arabbaygi; Siavash,9999,0,9999,0
1668495874370,ECE 200,029,103614,Mookherjea; Shayan,9999,0,9999,0
1668495874370,ECE 200,030,103615,Morris; Karcher William,9999,0,9999,0
1668495874370,ECE 200,031,103616,Ng; Tse Nga,9999,0,9999,0
1668495874370,ECE 200,032,103617,Nguyen; Truong Quang,9999,0,9999,0
1668495874370,ECE 200,033,103618,Nomura; Kenji,9999,0,9999,0
1668495874370,ECE 200,034,103619,Orlitsky; Alon,9999,0,9999,0
1668495874370,ECE 200,035,103620,Pal; Piya,9999,0,9999,0
1668495874370,ECE 200,036,103621,Papen; George C.,9999,0,9999,0
1668495874370,ECE 200,037,103622,Radic; Stojan,9999,0,9999,0
1668495874370,ECE 200,038,103623,Rao; Bhaskar D.,9999,0,9999,0
1668495874370,ECE 200,039,103624,Rao; Ramesh R,9999,0,9999,0
1668495874370,ECE 200,040,103625,Rebeiz; Gabriel,9999,0,9999,0
1668495874370,ECE 200,041,103626,Sanford; John R,9999,0,9999,0
1668495874370,ECE 200,042,103627,Siegel; Paul H.,9999,0,9999,0
1668495874370,ECE 200,043,103628,Sievenpiper; Daniel F.,9999,0,9999,0
1668495874370,ECE 200,044,103629,Sworder; David D.,9999,0,9999,0
1668495874370,ECE 200,045,103630,Taur; Yuan,9999,0,9999,0
1668495874370,ECE 200,046,103631,Touri; Behrouz,9999,0,9999,0
1668495874370,ECE 200,047,103632,Trivedi; Mohan M.,9999,0,9999,0
1668495874370,ECE 200,048,103633,Vasconcelos; Nuno,9999,0,9999,0
1668495874370,ECE 200,049,103634,Wang; Xiaolong,9999,0,9999,0
1668495874370,ECE 200,050,103635,Xie; Pengtao,9999,0,9999,0
1668495874370,ECE 200,051,103636,Yip; Michael,9999,0,9999,0
1668495874370,ECE 200,052,103637,Zeger; Kenneth A.,999,0,999,0
1668495874370,ECE 200,053,103638,Zhang; Xinyu,9999,0,9999,0
1668495874370,ECE 200,054,103639,Turakhia; Yatish Girish,9999,0,9999,0
1668495874370,ECE 200,055,103640,Kang; Mingu,9999,0,9999,0
1668495874370,ECE 200,056,103641,Shi; Yuanyuan,9999,0,9999,0
1668495874370,ECE 200,057,103642,Wang; Edward Jay,9999,0,9999,0
1668495874370,ECE 200,058,103643,Zheng; Yang,9999,0,9999,0
1668495874796,ECE 202,A00,103644,Kuzum; Duygu,0,44,0,0
1668495875224,ECE 212BN,A00,103646,Ng; Tse Nga,0,9,0,0
1668495875649,ECE 221,A00,111493,Staff,0,0,0,0
1668495876073,ECE 222B,A00,103647,Lomakin; Vitaliy,0,18,0,0
1668495876501,ECE 230B,A00,103648,Taur; Yuan,0,3,0,0
1668495876929,ECE 238B,A00,103649,Garay; Javier,0,0,0,0
1668495877351,ECE 240B,A00,112900,Fainman; Yeshaiahu,0,7,0,0
1668495877778,ECE 247A,A00,103650,Jokerst; Jesse Vincent,0,6,0,0
1668495878202,ECE 247B,A00,103651,Wang; Joseph,0,14,0,0
1668495878629,ECE 250,A00,103652,Siegel; Paul H.,0,82,0,0
1668495879050,ECE 251A,A00,103654,Rao; Bhaskar D.,0,61,0,0
1668495879474,ECE 257B,A00,103655,Bharadia; Dinesh,0,32,0,0
1668495879897,ECE 258A,A00,103656,Milstein; Laurence B.,0,29,0,0
1668495880321,ECE 260B,A00,103658,Kang; Mingu,0,119,0,0
1668495880745,ECE 264A,A00,103659,Galton; Ian A,0,65,0,0
1668495881169,ECE 265A,A00,103661,Gudem; Prasad S.S.,0,70,0,0
1668495881595,ECE 265D,A00,103662,Gudem; Prasad S.S.,0,25,0,0
1668495882026,ECE 268,A00,103663,Koushanfar; Farinaz,0,42,0,0
1668495882450,ECE 269,A01,103665,Pal; Piya,0,215,0,0
1668495882875,ECE 271B,A00,103666,Vasconcelos; Manuela,0,76,0,0
1668495883305,ECE 276A,A00,103667,Atanasov; Nikolay A.,0,125,0,0
1668495883741,ECE 277,A00,103668,An; Cheolhong,0,148,0,0
1668495884172,ECE 279,A00,117947,Hall; Drew A.,0,22,0,0
1668495885018,ECE 283,A00,103670,Hsueh; Tzu-Chien,0,52,0,0
1668495885446,ECE 284,A00,103671,Turakhia; Yatish Girish,0,39,0,0
1668495885871,ECE 285,A00,103672,Zheng; Yang,0,39,0,0
1668495885871,ECE 285,B00,103673,Sworder; David D.,0,56,0,0
1668495886296,ECE 287,A00,103676,Javidi; Tara,0,8,0,0
1668495886818,MATH 200B,A00,098023,Salehi Golsefidy; Alireza,10,0,15,5
1668495887241,MATH 202B,A00,098024,Rhoades; Brendon Patrick,7,0,15,8
1668495887666,MATH 203B,A00,098025,Oprea; Dragos N.,9,0,15,6
1668495888091,MATH 204B,A00,098026,Sorensen; Claus M,13,0,15,2
1668495888514,MATH 208,A00,098027,Izadi; Elham,7,0,10,3
1668495888941,MATH 209,A00,098028,Pollack; Aaron,10,0,10,0
1668495889369,MATH 211A,A00,112919,Rogalski; Daniel,8,0,10,2
1668495889796,MATH 211B,A00,112920,Seward; Brandon M.,9,0,10,1
1668495890220,MATH 218,A00,098029,Li; Bo,10,0,10,0
1668495890649,MATH 220B,A00,098030,Novak; Jonathan I,11,0,15,4
1668495891073,MATH 221A,A00,098031,Ebenfelt; Peter F,12,0,15,3
1668495891500,MATH 231B,A00,098032,Zlatos; Andrej,11,0,15,4
1668495891931,MATH 240B,A00,098033,Ni; Lei,7,0,15,8
1668495892363,MATH 243,A00,098034,Jekel; David Andrew,10,0,10,0
1668495892807,MATH 245A,A00,098035,Nie; Jiawang,0,4,15,18
1668495893239,MATH 248,A00,098036,Bejenaru; Ioan,10,0,10,0
1668495893663,MATH 250B,A00,098037,Spolaor; Luca,14,0,15,1
1668495894093,MATH 258,A00,098038,Ni; Lei,9,0,10,1
1668495894519,MATH 264B,A00,098041,Rhoades; Brendon Patrick,8,0,15,7
1668495894946,MATH 268,A00,098042,Buss; Samuel R,10,0,10,0
1668495895372,MATH 269,A00,098043,Rhoades; Brendon Patrick,10,0,10,0
1668495895797,MATH 270B,A00,098044,Li; Bo,6,0,15,9
1668495896222,MATH 272B,A00,098045,Holst; Michael J,13,0,15,2
1668495896645,MATH 273A,A00,098046,Tian; Xiaochuan,10,0,15,5
1668495897069,MATH 275,A01,098048,Tian; Xiaochuan,6,0,10,4
1668495897493,MATH 278A,A00,098049,Holst; Michael J,7,0,10,3
1668495897915,MATH 278B,A00,098050,Cloninger; Alexander,10,0,10,0
1668495898342,MATH 278C,A00,098051,Nie; Jiawang,5,0,10,5
1668495898766,MATH 280B,A00,098052,Zheng; Tianyi,7,0,15,8
1668495899191,MATH 281B,A00,098053,Bradic; Jelena,0,2,15,15
1668495899618,MATH 282B,A00,098054,Arias-Castro; Ery,0,1,15,15
1668495900047,MATH 285,A00,098055,Fitzsimmons; Patrick J,0,3,15,17
1668495900472,MATH 287B,A00,098056,Arias-Castro; Ery,1,0,15,14
1668495900897,MATH 288,A00,098057,Agarwal; Pooja,9,0,10,1
1668495900897,MATH 288,B00,098058,Zhang; Danna,8,0,10,2
1668495900897,MATH 288,C00,098059,Williams; Ruth J,9,0,10,1
1668495901319,MATH 290B,A00,098060,Roberts; Justin Deritter,12,0,15,3
1668495901746,MATH 292,A00,098061,Belmont; Eva Kinoshita,10,0,10,0
1668495902174,MATH 295,A00,098062,Suk; Andrew Hoon,47,0,50,3
1668495902601,MATH 296,A00,098063,Novak; Jonathan I,20,0,20,0
1668495903024,MATH 297,001,098064,Gamst; Anthony Collins,9997,0,9999,2
1668496404058,COGS 205,A00,101395,Chiba; Andrea,19,0,20,1
1668496404482,COGS 210B,001,101404,Greene; Deanna Jacquelyn,9998,0,9999,1
1668496404482,COGS 210B,002,101417,Xia; Haijun,9999,0,9999,0
1668496404482,COGS 210B,003,101422,Nitz; Douglas A.,9999,0,9999,0
1668496404482,COGS 210B,004,101423,Hollan; James D.,9998,0,9999,1
1668496404482,COGS 210B,005,101424,Deak; Gedeon O.,9998,0,9999,1
1668496404482,COGS 210B,006,101425,Rossano; Federico,9999,0,9999,0
1668496404910,COGS 211B,A00,101427,Coulson; Seana M,9996,0,9999,3
1668496405339,COGS 220,A00,101428,Hollan; James D.,0,10,25,25
1668496405764,COGS 229,A00,101429,Dow; Steven P,17,0,25,8
1668496406192,COGS 230,A00,101430,Klemmer; Scott R,8,0,17,9
1668496406707,COGS 234,A00,101431,Xia; Haijun,2,0,25,23
1668496407133,COGS 260,A00,101432,Kiyonaga; Anastasia,21,0,25,4
1668496407133,COGS 260,B00,101433,Kirsh; David Joel,15,0,25,10
1668496407569,CSE 202,A00,102371,Impagliazzo; Russell,0,65,0,0
1668496407993,CSE 203B,A01,102373,Cheng; Chung Kuan,0,55,0,0
1668496408416,CSE 208,A00,102374,Micciancio; Daniele,0,5,0,0
1668496408838,CSE 209A,A00,112895,Impagliazzo; Russell,0,12,15,15
1668496409265,CSE 209B,A00,108005,Bellare; Mihir,0,7,0,0
1668496409705,CSE 210,A00,113163,Coblenz; Michael J,0,82,0,0
1668496410131,CSE 219,A00,106111,Dow; Steven P,0,6,20,20
1668496410558,CSE 221,A00,102376,Voelker; Geoffrey M.,0,71,0,0
1668496410985,CSE 224,A01,102378,Porter; George M,0,163,0,0
1668496411407,CSE 229A,A00,102379,Savage; Stefan,0,10,0,0
1668496411832,CSE 229C,A00,102380,Munyaka; Imani N. S.,0,10,0,0
1668496412256,CSE 232B,A00,102382,Deutsch; Alin Bernard,0,31,0,0
1668496412687,CSE 234,A01,112904,Kumar; Arun Kumar,0,0,0,0
1668496413112,CSE 237A,A00,102383,Rosing; Tajana Simunic,0,52,0,0
1668496413538,CSE 239A,A00,102384,Deutsch; Alin Bernard,0,14,0,0
1668496413960,CSE 239B,A00,102385,Polikarpova; Nadezhda,0,10,0,0
1668496414385,CSE 240A,A00,102386,Pannuto; Patrick William,0,46,0,0
1668496414808,CSE 240B,A00,102387,Zhao; Jishen,0,45,0,0
1668496415233,CSE 241A,A00,106406,Kang; Mingu,0,8,0,0
1668496415659,CSE 249B,A00,102388,Kahng; Andrew Byun,0,5,8,8
1668496416085,CSE 251B,A01,102392,Cottrell; Garrison W,0,48,0,0
1668496416085,CSE 251B,A02,102393,Cottrell; Garrison W,0,34,0,0
1668496416514,CSE 252B,A00,102394,Ochoa; Benjamin Lawrence,0,58,0,0
1668496416936,CSE 257,A01,102396,Gao; Sicun,0,134,0,0
1668496417359,CSE 272,A00,102397,Li; Tzumao,0,18,0,0
1668496417783,CSE 274,A00,111323,Chern; Albert Ren-Haur,0,15,0,0
1668496418209,CSE 282,A00,102398,Pevzner; Pavel Arkadjevich,0,0,0,0
1668496418636,CSE 284,A00,114175,Gymrek; Melissa Ann,0,22,0,0
1668496419063,CSE 290,A00,102399,Chandraker; Manmohan Krishna,0,11,0,0
1668496419063,CSE 290,B00,102400,Vaccaro; Kristen Marie,0,7,25,25
1668496419063,CSE 290,C00,102414,Pannuto; Patrick William,0,1,25,25
1668496419063,CSE 290,D00,102427,Pevzner; Pavel Arkadjevich,0,0,0,0
1668496419063,CSE 290,E00,102429,Zhao; Jishen,0,4,0,0
1668496419063,CSE 290,F00,102436,Tullsen; Dean Michael,0,5,0,0
1668496419063,CSE 290,G00,102440,Christensen; Henrik I,0,6,20,20
1668496419487,CSE 291,A00,102443,Su; Hao,0,0,0,0
1668496419487,CSE 291,B00,102448,Polikarpova; Nadezhda,0,0,0,0
1668496419487,CSE 291,C00,102453,Vaccaro; Kristen Marie,0,0,0,0
1668496419487,CSE 291,D00,111343,Savage; Stefan,0,0,0,0
1668496419487,CSE 291,E00,116474,Claffy; Kimberly Claire,0,0,0,0
1668496419487,CSE 291,F00,116479,Pasquale; Joseph,0,0,0,0
1668496419915,CSE 293,001,119111,Bafna; Vineet,9999,0,9999,0
1668496419915,CSE 293,002,119118,Bellare; Mihir,9999,0,9999,0
1668496419915,CSE 293,003,119122,Berg-Kirkpatrick; Taylor D,9999,0,9999,0
1668496419915,CSE 293,004,119135,Christensen; Henrik I,9999,0,9999,0
1668496419915,CSE 293,005,119142,Cottrell; Garrison W,9999,0,9999,0
1668496419915,CSE 293,006,119146,Deutsch; Alin Bernard,9999,0,9999,0
1668496419915,CSE 293,007,119159,Esmaeilzadeh; Hadi,9999,0,9999,0
1668496419915,CSE 293,008,119166,Freund; Yoav,9999,0,9999,0
1668496419915,CSE 293,009,119170,Griswold; William G.,9999,0,9999,0
1668496419915,CSE 293,010,119183,Gymrek; Melissa Ann,9999,0,9999,0
1668496419915,CSE 293,011,119190,Heninger; Nadia A,9999,0,9999,0
1668496419915,CSE 293,012,119230,Impagliazzo; Russell,9999,0,9999,0
1668496419915,CSE 293,013,119232,Jhala; Ranjit,9999,0,9999,0
1668496419915,CSE 293,014,119233,Kahng; Andrew Byun,9999,0,9999,0
1668496419915,CSE 293,015,119298,Kane; Daniel Mertz,9999,0,9999,0
1668496419915,CSE 293,016,119299,Kriegman; David J,9999,0,9999,0
1668496419915,CSE 293,017,119300,Kumar; Arun Kumar,9999,0,9999,0
1668496419915,CSE 293,018,119301,Lerner; Sorin,9999,0,9999,0
1668496419915,CSE 293,019,119302,Lovett; Shachar,9999,0,9999,0
1668496419915,CSE 293,020,119303,McAuley; Julian John,9999,0,9999,0
1668496419915,CSE 293,021,119304,Micciancio; Daniele,9999,0,9999,0
1668496419915,CSE 293,022,119367,Orailoglu; Alex,9999,0,9999,0
1668496419915,CSE 293,023,119382,Paturi; Ramamohan,9999,0,9999,0
1668496419915,CSE 293,024,119404,Polikarpova; Nadezhda,9999,0,9999,0
1668496419915,CSE 293,025,119406,Politz; Joseph Gibbs,9999,0,9999,0
1668496419915,CSE 293,026,119411,Porter; George M,9999,0,9999,0
1668496419915,CSE 293,027,119414,Porter; Leonard Emerson,9999,0,9999,0
1668496419915,CSE 293,028,119416,Ramamoorthi; Ravi,9999,0,9999,0
1668496419915,CSE 293,029,119417,Sahoo; Debashis,9999,0,9999,0
1668496419915,CSE 293,030,119420,Saul; Lawrence,9999,0,9999,0
1668496419915,CSE 293,031,119421,Savage; Stefan,9999,0,9999,0
1668496419915,CSE 293,032,119425,Schulze; Jurgen P.,9999,0,9999,0
1668496419915,CSE 293,033,119426,Snoeren; Alex C.,9999,0,9999,0
1668496419915,CSE 293,034,119428,Shang; Jingbo,9999,0,9999,0
1668496419915,CSE 293,035,119430,Stefan; Deian,9999,0,9999,0
1668496419915,CSE 293,036,119431,Su; Hao,9999,0,9999,0
1668496419915,CSE 293,037,119433,Swanson; Steven James,9999,0,9999,0
1668496419915,CSE 293,038,119435,Tullsen; Dean Michael,9999,0,9999,0
1668496419915,CSE 293,039,119483,Voelker; Geoffrey M.,9999,0,9999,0
1668496419915,CSE 293,040,119537,Zhao; Jishen,9999,0,9999,0
1668496419915,CSE 293,041,119538,Zhou; Yuan-Yuan,9999,0,9999,0
1668496419915,CSE 293,042,119539,Gao; Sicun,9999,0,9999,0
1668496419915,CSE 293,043,119540,Weibel; Nadir,9999,0,9999,0
1668496419915,CSE 293,044,119541,Gupta; Rajesh K.,9999,0,9999,0
1668496419915,CSE 293,045,126410,Vaccaro; Kristen Marie,9999,0,9999,0
1668496419915,CSE 293,046,126411,Klemke; Richard,9999,0,9999,0
1668496420338,CSE 294,A00,102459,Voelker; Geoffrey M.,0,2,0,0
1668496420338,CSE 294,B00,111322,Orailoglu; Alex,0,2,0,0
1668496420763,DSE 201,A00,096914,Deutsch; Alin Bernard,30,0,30,0
1668496421187,DSE 210,A00,096915,Dasgupta; Sanjoy,30,0,30,0
1668496421610,DSE 260A,A00,096916,Altintas De Callaf; Ilkay,30,0,30,0
1668496422047,ECE 200,001,103586,Antipa; Nicholas A,9999,0,9999,0
1668496422047,ECE 200,002,103587,Atanasov; Nikolay A.,9999,0,9999,0
1668496422047,ECE 200,003,103588,Bharadia; Dinesh,9999,0,9999,0
1668496422047,ECE 200,004,103589,Cheng; Chung Kuan,9999,0,9999,0
1668496422047,ECE 200,005,103590,Cosman; Pamela C.,9999,0,9999,0
1668496422047,ECE 200,006,103591,Dayeh; Shadi Ahmad,9999,0,9999,0
1668496422047,ECE 200,007,103592,Fainman; Yeshaiahu,9999,0,9999,0
1668496422047,ECE 200,008,103593,Ford; Joseph Earl,9999,0,9999,0
1668496422047,ECE 200,009,103594,Franceschetti; Massimo,9999,0,9999,0
1668496422047,ECE 200,010,103595,Fullerton; Eric E,9999,0,9999,0
1668496422047,ECE 200,011,103596,Galton; Ian A,9999,0,9999,0
1668496422047,ECE 200,012,103597,Gilja; Vikash,9999,0,9999,0
1668496422047,ECE 200,013,103598,Hall; Drew A.,9999,0,9999,0
1668496422047,ECE 200,014,103599,Hsueh; Tzu-Chien,9999,0,9999,0
1668496422047,ECE 200,015,103600,Javidi; Tara,9999,0,9999,0
1668496422047,ECE 200,016,103601,Kahng; Andrew Byun,9999,0,9999,0
1668496422047,ECE 200,017,103602,Kim; Young-Han,9999,0,9999,0
1668496422047,ECE 200,018,103603,Koushanfar; Farinaz,9999,0,9999,0
1668496422047,ECE 200,019,103604,Kuzum; Duygu,9999,0,9999,0
1668496422047,ECE 200,020,103605,Le; Hanh-Phuc,9999,0,9999,0
1668496422047,ECE 200,021,103606,Lin; Bill,9999,0,9999,0
1668496422047,ECE 200,022,103607,Liu; Zhaowei,9998,0,9999,1
1668496422047,ECE 200,023,103608,Lo; Yu-Hwa,9999,0,9999,0
1668496422047,ECE 200,024,103609,Lomakin; Vitaliy,9999,0,9999,0
1668496422047,ECE 200,025,103610,Mercier; Patrick Philip,9999,0,9999,0
1668496422047,ECE 200,026,103611,Meyer; Florian,9999,0,9999,0
1668496422047,ECE 200,027,103612,Milstein; Laurence B.,9999,0,9999,0
1668496422047,ECE 200,028,103613,Mir Arabbaygi; Siavash,9999,0,9999,0
1668496422047,ECE 200,029,103614,Mookherjea; Shayan,9999,0,9999,0
1668496422047,ECE 200,030,103615,Morris; Karcher William,9999,0,9999,0
1668496422047,ECE 200,031,103616,Ng; Tse Nga,9999,0,9999,0
1668496422047,ECE 200,032,103617,Nguyen; Truong Quang,9999,0,9999,0
1668496422047,ECE 200,033,103618,Nomura; Kenji,9999,0,9999,0
1668496422047,ECE 200,034,103619,Orlitsky; Alon,9999,0,9999,0
1668496422047,ECE 200,035,103620,Pal; Piya,9999,0,9999,0
1668496422047,ECE 200,036,103621,Papen; George C.,9999,0,9999,0
1668496422047,ECE 200,037,103622,Radic; Stojan,9999,0,9999,0
1668496422047,ECE 200,038,103623,Rao; Bhaskar D.,9999,0,9999,0
1668496422047,ECE 200,039,103624,Rao; Ramesh R,9999,0,9999,0
1668496422047,ECE 200,040,103625,Rebeiz; Gabriel,9999,0,9999,0
1668496422047,ECE 200,041,103626,Sanford; John R,9999,0,9999,0
1668496422047,ECE 200,042,103627,Siegel; Paul H.,9999,0,9999,0
1668496422047,ECE 200,043,103628,Sievenpiper; Daniel F.,9999,0,9999,0
1668496422047,ECE 200,044,103629,Sworder; David D.,9999,0,9999,0
1668496422047,ECE 200,045,103630,Taur; Yuan,9999,0,9999,0
1668496422047,ECE 200,046,103631,Touri; Behrouz,9999,0,9999,0
1668496422047,ECE 200,047,103632,Trivedi; Mohan M.,9999,0,9999,0
1668496422047,ECE 200,048,103633,Vasconcelos; Nuno,9999,0,9999,0
1668496422047,ECE 200,049,103634,Wang; Xiaolong,9999,0,9999,0
1668496422047,ECE 200,050,103635,Xie; Pengtao,9999,0,9999,0
1668496422047,ECE 200,051,103636,Yip; Michael,9999,0,9999,0
1668496422047,ECE 200,052,103637,Zeger; Kenneth A.,999,0,999,0
1668496422047,ECE 200,053,103638,Zhang; Xinyu,9999,0,9999,0
1668496422047,ECE 200,054,103639,Turakhia; Yatish Girish,9999,0,9999,0
1668496422047,ECE 200,055,103640,Kang; Mingu,9999,0,9999,0
1668496422047,ECE 200,056,103641,Shi; Yuanyuan,9999,0,9999,0
1668496422047,ECE 200,057,103642,Wang; Edward Jay,9999,0,9999,0
1668496422047,ECE 200,058,103643,Zheng; Yang,9999,0,9999,0
1668496422472,ECE 202,A00,103644,Kuzum; Duygu,0,44,0,0
1668496422898,ECE 212BN,A00,103646,Ng; Tse Nga,0,9,0,0
1668496423321,ECE 221,A00,111493,Staff,0,0,0,0
1668496423747,ECE 222B,A00,103647,Lomakin; Vitaliy,0,18,0,0
1668496424171,ECE 230B,A00,103648,Taur; Yuan,0,3,0,0
1668496424594,ECE 238B,A00,103649,Garay; Javier,0,0,0,0
1668496425018,ECE 240B,A00,112900,Fainman; Yeshaiahu,0,7,0,0
1668496425441,ECE 247A,A00,103650,Jokerst; Jesse Vincent,0,6,0,0
1668496425864,ECE 247B,A00,103651,Wang; Joseph,0,14,0,0
1668496426293,ECE 250,A00,103652,Siegel; Paul H.,0,82,0,0
1668496426730,ECE 251A,A00,103654,Rao; Bhaskar D.,0,61,0,0
1668496427157,ECE 257B,A00,103655,Bharadia; Dinesh,0,32,0,0
1668496427582,ECE 258A,A00,103656,Milstein; Laurence B.,0,29,0,0
1668496428006,ECE 260B,A00,103658,Kang; Mingu,0,119,0,0
1668496428431,ECE 264A,A00,103659,Galton; Ian A,0,65,0,0
1668496428859,ECE 265A,A00,103661,Gudem; Prasad S.S.,0,70,0,0
1668496429286,ECE 265D,A00,103662,Gudem; Prasad S.S.,0,25,0,0
1668496429714,ECE 268,A00,103663,Koushanfar; Farinaz,0,42,0,0
1668496430152,ECE 269,A01,103665,Pal; Piya,0,215,0,0
1668496430575,ECE 271B,A00,103666,Vasconcelos; Manuela,0,76,0,0
1668496431002,ECE 276A,A00,103667,Atanasov; Nikolay A.,0,125,0,0
1668496431429,ECE 277,A00,103668,An; Cheolhong,0,148,0,0
1668496431851,ECE 279,A00,117947,Hall; Drew A.,0,22,0,0
1668496432722,ECE 283,A00,103670,Hsueh; Tzu-Chien,0,52,0,0
1668496433157,ECE 284,A00,103671,Turakhia; Yatish Girish,0,39,0,0
1668496433581,ECE 285,A00,103672,Zheng; Yang,0,39,0,0
1668496433581,ECE 285,B00,103673,Sworder; David D.,0,56,0,0
1668496434004,ECE 287,A00,103676,Javidi; Tara,0,8,0,0
1668496434435,MATH 200B,A00,098023,Salehi Golsefidy; Alireza,10,0,15,5
1668496434857,MATH 202B,A00,098024,Rhoades; Brendon Patrick,7,0,15,8
1668496435290,MATH 203B,A00,098025,Oprea; Dragos N.,9,0,15,6
1668496435717,MATH 204B,A00,098026,Sorensen; Claus M,13,0,15,2
1668496436149,MATH 208,A00,098027,Izadi; Elham,7,0,10,3
1668496436571,MATH 209,A00,098028,Pollack; Aaron,10,0,10,0
1668496436996,MATH 211A,A00,112919,Rogalski; Daniel,8,0,10,2
1668496437419,MATH 211B,A00,112920,Seward; Brandon M.,9,0,10,1
1668496437845,MATH 218,A00,098029,Li; Bo,10,0,10,0
1668496438278,MATH 220B,A00,098030,Novak; Jonathan I,11,0,15,4
1668496438700,MATH 221A,A00,098031,Ebenfelt; Peter F,12,0,15,3
1668496439126,MATH 231B,A00,098032,Zlatos; Andrej,11,0,15,4
1668496439553,MATH 240B,A00,098033,Ni; Lei,7,0,15,8
1668496439979,MATH 243,A00,098034,Jekel; David Andrew,10,0,10,0
1668496440403,MATH 245A,A00,098035,Nie; Jiawang,0,4,15,18
1668496440826,MATH 248,A00,098036,Bejenaru; Ioan,10,0,10,0
1668496441263,MATH 250B,A00,098037,Spolaor; Luca,14,0,15,1
1668496441688,MATH 258,A00,098038,Ni; Lei,9,0,10,1
1668496442114,MATH 264B,A00,098041,Rhoades; Brendon Patrick,8,0,15,7
1668496442540,MATH 268,A00,098042,Buss; Samuel R,10,0,10,0
1668496442964,MATH 269,A00,098043,Rhoades; Brendon Patrick,10,0,10,0
1668496443391,MATH 270B,A00,098044,Li; Bo,6,0,15,9
1668496443816,MATH 272B,A00,098045,Holst; Michael J,13,0,15,2
1668496444240,MATH 273A,A00,098046,Tian; Xiaochuan,10,0,15,5
1668496444669,MATH 275,A01,098048,Tian; Xiaochuan,6,0,10,4
1668496445095,MATH 278A,A00,098049,Holst; Michael J,7,0,10,3
1668496445520,MATH 278B,A00,098050,Cloninger; Alexander,10,0,10,0
1668496445944,MATH 278C,A00,098051,Nie; Jiawang,5,0,10,5
1668496446368,MATH 280B,A00,098052,Zheng; Tianyi,7,0,15,8
1668496446795,MATH 281B,A00,098053,Bradic; Jelena,0,2,15,15
1668496447219,MATH 282B,A00,098054,Arias-Castro; Ery,0,1,15,15
1668496447651,MATH 285,A00,098055,Fitzsimmons; Patrick J,0,3,15,17
1668496448075,MATH 287B,A00,098056,Arias-Castro; Ery,1,0,15,14
1668496448511,MATH 288,A00,098057,Agarwal; Pooja,9,0,10,1
1668496448511,MATH 288,B00,098058,Zhang; Danna,8,0,10,2
1668496448511,MATH 288,C00,098059,Williams; Ruth J,9,0,10,1
1668496448936,MATH 290B,A00,098060,Roberts; Justin Deritter,12,0,15,3
1668496449360,MATH 292,A00,098061,Belmont; Eva Kinoshita,10,0,10,0
1668496449860,MATH 295,A00,098062,Suk; Andrew Hoon,47,0,50,3
1668496450283,MATH 296,A00,098063,Novak; Jonathan I,20,0,20,0
1668496450711,MATH 297,001,098064,Gamst; Anthony Collins,9997,0,9999,2
1668496951338,COGS 205,A00,101395,Chiba; Andrea,19,0,20,1
1668496951766,COGS 210B,001,101404,Greene; Deanna Jacquelyn,9998,0,9999,1
1668496951766,COGS 210B,002,101417,Xia; Haijun,9999,0,9999,0
1668496951766,COGS 210B,003,101422,Nitz; Douglas A.,9999,0,9999,0
1668496951766,COGS 210B,004,101423,Hollan; James D.,9998,0,9999,1
1668496951766,COGS 210B,005,101424,Deak; Gedeon O.,9998,0,9999,1
1668496951766,COGS 210B,006,101425,Rossano; Federico,9999,0,9999,0
1668496952188,COGS 211B,A00,101427,Coulson; Seana M,9996,0,9999,3
1668496952612,COGS 220,A00,101428,Hollan; James D.,0,10,25,25
1668496953036,COGS 229,A00,101429,Dow; Steven P,17,0,25,8
1668496953460,COGS 230,A00,101430,Klemmer; Scott R,8,0,17,9
1668496953885,COGS 234,A00,101431,Xia; Haijun,2,0,25,23
1668496954308,COGS 260,A00,101432,Kiyonaga; Anastasia,21,0,25,4
1668496954308,COGS 260,B00,101433,Kirsh; David Joel,15,0,25,10
1668496954732,CSE 202,A00,102371,Impagliazzo; Russell,0,65,0,0
1668496955157,CSE 203B,A01,102373,Cheng; Chung Kuan,0,55,0,0
1668496955580,CSE 208,A00,102374,Micciancio; Daniele,0,5,0,0
1668496956003,CSE 209A,A00,112895,Impagliazzo; Russell,0,12,15,15
1668496956428,CSE 209B,A00,108005,Bellare; Mihir,0,7,0,0
1668496956856,CSE 210,A00,113163,Coblenz; Michael J,0,82,0,0
1668496957283,CSE 219,A00,106111,Dow; Steven P,0,6,20,20
1668496957709,CSE 221,A00,102376,Voelker; Geoffrey M.,0,71,0,0
1668496958134,CSE 224,A01,102378,Porter; George M,0,163,0,0
1668496958558,CSE 229A,A00,102379,Savage; Stefan,0,10,0,0
1668496958995,CSE 229C,A00,102380,Munyaka; Imani N. S.,0,10,0,0
1668496959420,CSE 232B,A00,102382,Deutsch; Alin Bernard,0,31,0,0
1668496959847,CSE 234,A01,112904,Kumar; Arun Kumar,0,0,0,0
1668496960274,CSE 237A,A00,102383,Rosing; Tajana Simunic,0,53,0,0
1668496960705,CSE 239A,A00,102384,Deutsch; Alin Bernard,0,14,0,0
1668496961133,CSE 239B,A00,102385,Polikarpova; Nadezhda,0,10,0,0
1668496961556,CSE 240A,A00,102386,Pannuto; Patrick William,0,46,0,0
1668496961982,CSE 240B,A00,102387,Zhao; Jishen,0,45,0,0
1668496962410,CSE 241A,A00,106406,Kang; Mingu,0,9,0,0
1668496962832,CSE 249B,A00,102388,Kahng; Andrew Byun,0,5,8,8
1668496963263,CSE 251B,A01,102392,Cottrell; Garrison W,0,49,0,0
1668496963263,CSE 251B,A02,102393,Cottrell; Garrison W,0,34,0,0
1668496963688,CSE 252B,A00,102394,Ochoa; Benjamin Lawrence,0,58,0,0
1668496964113,CSE 257,A01,102396,Gao; Sicun,0,134,0,0
1668496964536,CSE 272,A00,102397,Li; Tzumao,0,18,0,0
1668496964960,CSE 274,A00,111323,Chern; Albert Ren-Haur,0,15,0,0
1668496965387,CSE 282,A00,102398,Pevzner; Pavel Arkadjevich,0,0,0,0
1668496965817,CSE 284,A00,114175,Gymrek; Melissa Ann,0,22,0,0
1668496966244,CSE 290,A00,102399,Chandraker; Manmohan Krishna,0,11,0,0
1668496966244,CSE 290,B00,102400,Vaccaro; Kristen Marie,0,7,25,25
1668496966244,CSE 290,C00,102414,Pannuto; Patrick William,0,1,25,25
1668496966244,CSE 290,D00,102427,Pevzner; Pavel Arkadjevich,0,0,0,0
1668496966244,CSE 290,E00,102429,Zhao; Jishen,0,4,0,0
1668496966244,CSE 290,F00,102436,Tullsen; Dean Michael,0,5,0,0
1668496966244,CSE 290,G00,102440,Christensen; Henrik I,0,6,20,20
1668496966674,CSE 291,A00,102443,Su; Hao,0,0,0,0
1668496966674,CSE 291,B00,102448,Polikarpova; Nadezhda,0,0,0,0
1668496966674,CSE 291,C00,102453,Vaccaro; Kristen Marie,0,0,0,0
1668496966674,CSE 291,D00,111343,Savage; Stefan,0,0,0,0
1668496966674,CSE 291,E00,116474,Claffy; Kimberly Claire,0,0,0,0
1668496966674,CSE 291,F00,116479,Pasquale; Joseph,0,0,0,0
1668496967104,CSE 293,001,119111,Bafna; Vineet,9999,0,9999,0
1668496967104,CSE 293,002,119118,Bellare; Mihir,9999,0,9999,0
1668496967104,CSE 293,003,119122,Berg-Kirkpatrick; Taylor D,9999,0,9999,0
1668496967104,CSE 293,004,119135,Christensen; Henrik I,9999,0,9999,0
1668496967104,CSE 293,005,119142,Cottrell; Garrison W,9999,0,9999,0
1668496967104,CSE 293,006,119146,Deutsch; Alin Bernard,9999,0,9999,0
1668496967104,CSE 293,007,119159,Esmaeilzadeh; Hadi,9999,0,9999,0
1668496967104,CSE 293,008,119166,Freund; Yoav,9999,0,9999,0
1668496967104,CSE 293,009,119170,Griswold; William G.,9999,0,9999,0
1668496967104,CSE 293,010,119183,Gymrek; Melissa Ann,9999,0,9999,0
1668496967104,CSE 293,011,119190,Heninger; Nadia A,9999,0,9999,0
1668496967104,CSE 293,012,119230,Impagliazzo; Russell,9999,0,9999,0
1668496967104,CSE 293,013,119232,Jhala; Ranjit,9999,0,9999,0
1668496967104,CSE 293,014,119233,Kahng; Andrew Byun,9999,0,9999,0
1668496967104,CSE 293,015,119298,Kane; Daniel Mertz,9999,0,9999,0
1668496967104,CSE 293,016,119299,Kriegman; David J,9999,0,9999,0
1668496967104,CSE 293,017,119300,Kumar; Arun Kumar,9999,0,9999,0
1668496967104,CSE 293,018,119301,Lerner; Sorin,9999,0,9999,0
1668496967104,CSE 293,019,119302,Lovett; Shachar,9999,0,9999,0
1668496967104,CSE 293,020,119303,McAuley; Julian John,9999,0,9999,0
1668496967104,CSE 293,021,119304,Micciancio; Daniele,9999,0,9999,0
1668496967104,CSE 293,022,119367,Orailoglu; Alex,9999,0,9999,0
1668496967104,CSE 293,023,119382,Paturi; Ramamohan,9999,0,9999,0
1668496967104,CSE 293,024,119404,Polikarpova; Nadezhda,9999,0,9999,0
1668496967104,CSE 293,025,119406,Politz; Joseph Gibbs,9999,0,9999,0
1668496967104,CSE 293,026,119411,Porter; George M,9999,0,9999,0
1668496967104,CSE 293,027,119414,Porter; Leonard Emerson,9999,0,9999,0
1668496967104,CSE 293,028,119416,Ramamoorthi; Ravi,9999,0,9999,0
1668496967104,CSE 293,029,119417,Sahoo; Debashis,9999,0,9999,0
1668496967104,CSE 293,030,119420,Saul; Lawrence,9999,0,9999,0
1668496967104,CSE 293,031,119421,Savage; Stefan,9999,0,9999,0
1668496967104,CSE 293,032,119425,Schulze; Jurgen P.,9999,0,9999,0
1668496967104,CSE 293,033,119426,Snoeren; Alex C.,9999,0,9999,0
1668496967104,CSE 293,034,119428,Shang; Jingbo,9999,0,9999,0
1668496967104,CSE 293,035,119430,Stefan; Deian,9999,0,9999,0
1668496967104,CSE 293,036,119431,Su; Hao,9999,0,9999,0
1668496967104,CSE 293,037,119433,Swanson; Steven James,9999,0,9999,0
1668496967104,CSE 293,038,119435,Tullsen; Dean Michael,9999,0,9999,0
1668496967104,CSE 293,039,119483,Voelker; Geoffrey M.,9999,0,9999,0
1668496967104,CSE 293,040,119537,Zhao; Jishen,9999,0,9999,0
1668496967104,CSE 293,041,119538,Zhou; Yuan-Yuan,9999,0,9999,0
1668496967104,CSE 293,042,119539,Gao; Sicun,9999,0,9999,0
1668496967104,CSE 293,043,119540,Weibel; Nadir,9999,0,9999,0
1668496967104,CSE 293,044,119541,Gupta; Rajesh K.,9999,0,9999,0
1668496967104,CSE 293,045,126410,Vaccaro; Kristen Marie,9999,0,9999,0
1668496967104,CSE 293,046,126411,Klemke; Richard,9999,0,9999,0
1668496967530,CSE 294,A00,102459,Voelker; Geoffrey M.,0,2,0,0
1668496967530,CSE 294,B00,111322,Orailoglu; Alex,0,2,0,0
1668496967952,DSE 201,A00,096914,Deutsch; Alin Bernard,30,0,30,0
1668496968376,DSE 210,A00,096915,Dasgupta; Sanjoy,30,0,30,0
1668496968805,DSE 260A,A00,096916,Altintas De Callaf; Ilkay,30,0,30,0
1668496969354,ECE 200,001,103586,Antipa; Nicholas A,9999,0,9999,0
1668496969354,ECE 200,002,103587,Atanasov; Nikolay A.,9999,0,9999,0
1668496969354,ECE 200,003,103588,Bharadia; Dinesh,9999,0,9999,0
1668496969354,ECE 200,004,103589,Cheng; Chung Kuan,9999,0,9999,0
1668496969354,ECE 200,005,103590,Cosman; Pamela C.,9999,0,9999,0
1668496969354,ECE 200,006,103591,Dayeh; Shadi Ahmad,9999,0,9999,0
1668496969354,ECE 200,007,103592,Fainman; Yeshaiahu,9999,0,9999,0
1668496969354,ECE 200,008,103593,Ford; Joseph Earl,9999,0,9999,0
1668496969354,ECE 200,009,103594,Franceschetti; Massimo,9999,0,9999,0
1668496969354,ECE 200,010,103595,Fullerton; Eric E,9999,0,9999,0
1668496969354,ECE 200,011,103596,Galton; Ian A,9999,0,9999,0
1668496969354,ECE 200,012,103597,Gilja; Vikash,9999,0,9999,0
1668496969354,ECE 200,013,103598,Hall; Drew A.,9999,0,9999,0
1668496969354,ECE 200,014,103599,Hsueh; Tzu-Chien,9999,0,9999,0
1668496969354,ECE 200,015,103600,Javidi; Tara,9999,0,9999,0
1668496969354,ECE 200,016,103601,Kahng; Andrew Byun,9999,0,9999,0
1668496969354,ECE 200,017,103602,Kim; Young-Han,9999,0,9999,0
1668496969354,ECE 200,018,103603,Koushanfar; Farinaz,9999,0,9999,0
1668496969354,ECE 200,019,103604,Kuzum; Duygu,9999,0,9999,0
1668496969354,ECE 200,020,103605,Le; Hanh-Phuc,9999,0,9999,0
1668496969354,ECE 200,021,103606,Lin; Bill,9999,0,9999,0
1668496969354,ECE 200,022,103607,Liu; Zhaowei,9998,0,9999,1
1668496969354,ECE 200,023,103608,Lo; Yu-Hwa,9999,0,9999,0
1668496969354,ECE 200,024,103609,Lomakin; Vitaliy,9999,0,9999,0
1668496969354,ECE 200,025,103610,Mercier; Patrick Philip,9999,0,9999,0
1668496969354,ECE 200,026,103611,Meyer; Florian,9999,0,9999,0
1668496969354,ECE 200,027,103612,Milstein; Laurence B.,9999,0,9999,0
1668496969354,ECE 200,028,103613,Mir Arabbaygi; Siavash,9999,0,9999,0
1668496969354,ECE 200,029,103614,Mookherjea; Shayan,9999,0,9999,0
1668496969354,ECE 200,030,103615,Morris; Karcher William,9999,0,9999,0
1668496969354,ECE 200,031,103616,Ng; Tse Nga,9999,0,9999,0
1668496969354,ECE 200,032,103617,Nguyen; Truong Quang,9999,0,9999,0
1668496969354,ECE 200,033,103618,Nomura; Kenji,9999,0,9999,0
1668496969354,ECE 200,034,103619,Orlitsky; Alon,9999,0,9999,0
1668496969354,ECE 200,035,103620,Pal; Piya,9999,0,9999,0
1668496969354,ECE 200,036,103621,Papen; George C.,9999,0,9999,0
1668496969354,ECE 200,037,103622,Radic; Stojan,9999,0,9999,0
1668496969354,ECE 200,038,103623,Rao; Bhaskar D.,9999,0,9999,0
1668496969354,ECE 200,039,103624,Rao; Ramesh R,9999,0,9999,0
1668496969354,ECE 200,040,103625,Rebeiz; Gabriel,9999,0,9999,0
1668496969354,ECE 200,041,103626,Sanford; John R,9999,0,9999,0
1668496969354,ECE 200,042,103627,Siegel; Paul H.,9999,0,9999,0
1668496969354,ECE 200,043,103628,Sievenpiper; Daniel F.,9999,0,9999,0
1668496969354,ECE 200,044,103629,Sworder; David D.,9999,0,9999,0
1668496969354,ECE 200,045,103630,Taur; Yuan,9999,0,9999,0
1668496969354,ECE 200,046,103631,Touri; Behrouz,9999,0,9999,0
1668496969354,ECE 200,047,103632,Trivedi; Mohan M.,9999,0,9999,0
1668496969354,ECE 200,048,103633,Vasconcelos; Nuno,9999,0,9999,0
1668496969354,ECE 200,049,103634,Wang; Xiaolong,9999,0,9999,0
1668496969354,ECE 200,050,103635,Xie; Pengtao,9999,0,9999,0
1668496969354,ECE 200,051,103636,Yip; Michael,9999,0,9999,0
1668496969354,ECE 200,052,103637,Zeger; Kenneth A.,999,0,999,0
1668496969354,ECE 200,053,103638,Zhang; Xinyu,9999,0,9999,0
1668496969354,ECE 200,054,103639,Turakhia; Yatish Girish,9999,0,9999,0
1668496969354,ECE 200,055,103640,Kang; Mingu,9999,0,9999,0
1668496969354,ECE 200,056,103641,Shi; Yuanyuan,9999,0,9999,0
1668496969354,ECE 200,057,103642,Wang; Edward Jay,9999,0,9999,0
1668496969354,ECE 200,058,103643,Zheng; Yang,9999,0,9999,0
1668496969780,ECE 202,A00,103644,Kuzum; Duygu,0,44,0,0
1668496970204,ECE 212BN,A00,103646,Ng; Tse Nga,0,9,0,0
1668496970631,ECE 221,A00,111493,Staff,0,0,0,0
1668496971060,ECE 222B,A00,103647,Lomakin; Vitaliy,0,18,0,0
1668496971483,ECE 230B,A00,103648,Taur; Yuan,0,3,0,0
1668496971907,ECE 238B,A00,103649,Garay; Javier,0,0,0,0
1668496972331,ECE 240B,A00,112900,Fainman; Yeshaiahu,0,7,0,0
1668496972754,ECE 247A,A00,103650,Jokerst; Jesse Vincent,0,6,0,0
1668496973184,ECE 247B,A00,103651,Wang; Joseph,0,14,0,0
1668496973612,ECE 250,A00,103652,Siegel; Paul H.,0,82,0,0
1668496974040,ECE 251A,A00,103654,Rao; Bhaskar D.,0,61,0,0
1668496974466,ECE 257B,A00,103655,Bharadia; Dinesh,0,32,0,0
1668496974897,ECE 258A,A00,103656,Milstein; Laurence B.,0,29,0,0
1668496975324,ECE 260B,A00,103658,Kang; Mingu,0,119,0,0
1668496975755,ECE 264A,A00,103659,Galton; Ian A,0,65,0,0
1668496976184,ECE 265A,A00,103661,Gudem; Prasad S.S.,0,70,0,0
1668496976613,ECE 265D,A00,103662,Gudem; Prasad S.S.,0,25,0,0
1668496977040,ECE 268,A00,103663,Koushanfar; Farinaz,0,42,0,0
1668496977467,ECE 269,A01,103665,Pal; Piya,0,215,0,0
1668496977892,ECE 271B,A00,103666,Vasconcelos; Manuela,0,76,0,0
1668496978318,ECE 276A,A00,103667,Atanasov; Nikolay A.,0,125,0,0
1668496978743,ECE 277,A00,103668,An; Cheolhong,0,148,0,0
1668496979167,ECE 279,A00,117947,Hall; Drew A.,0,22,0,0
1668496980017,ECE 283,A00,103670,Hsueh; Tzu-Chien,0,52,0,0
1668496980445,ECE 284,A00,103671,Turakhia; Yatish Girish,0,39,0,0
1668496980872,ECE 285,A00,103672,Zheng; Yang,0,39,0,0
1668496980872,ECE 285,B00,103673,Sworder; David D.,0,56,0,0
1668496981298,ECE 287,A00,103676,Javidi; Tara,0,8,0,0
1668496981724,MATH 200B,A00,098023,Salehi Golsefidy; Alireza,10,0,15,5
1668496982150,MATH 202B,A00,098024,Rhoades; Brendon Patrick,7,0,15,8
1668496982574,MATH 203B,A00,098025,Oprea; Dragos N.,9,0,15,6
1668496982997,MATH 204B,A00,098026,Sorensen; Claus M,13,0,15,2
1668496983421,MATH 208,A00,098027,Izadi; Elham,7,0,10,3
1668496983849,MATH 209,A00,098028,Pollack; Aaron,10,0,10,0
1668496984278,MATH 211A,A00,112919,Rogalski; Daniel,8,0,10,2
1668496984707,MATH 211B,A00,112920,Seward; Brandon M.,9,0,10,1
1668496985130,MATH 218,A00,098029,Li; Bo,10,0,10,0
1668496985553,MATH 220B,A00,098030,Novak; Jonathan I,11,0,15,4
1668496985975,MATH 221A,A00,098031,Ebenfelt; Peter F,12,0,15,3
1668496986399,MATH 231B,A00,098032,Zlatos; Andrej,11,0,15,4
1668496986826,MATH 240B,A00,098033,Ni; Lei,7,0,15,8
1668496987257,MATH 243,A00,098034,Jekel; David Andrew,10,0,10,0
1668496987692,MATH 245A,A00,098035,Nie; Jiawang,0,4,15,18
1668496988116,MATH 248,A00,098036,Bejenaru; Ioan,10,0,10,0
1668496988543,MATH 250B,A00,098037,Spolaor; Luca,14,0,15,1
1668496988971,MATH 258,A00,098038,Ni; Lei,9,0,10,1
1668496989398,MATH 264B,A00,098041,Rhoades; Brendon Patrick,8,0,15,7
1668496989821,MATH 268,A00,098042,Buss; Samuel R,10,0,10,0
1668496990247,MATH 269,A00,098043,Rhoades; Brendon Patrick,10,0,10,0
1668496990671,MATH 270B,A00,098044,Li; Bo,6,0,15,9
1668496991101,MATH 272B,A00,098045,Holst; Michael J,13,0,15,2
1668496991529,MATH 273A,A00,098046,Tian; Xiaochuan,10,0,15,5
1668496991954,MATH 275,A01,098048,Tian; Xiaochuan,6,0,10,4
1668496992384,MATH 278A,A00,098049,Holst; Michael J,7,0,10,3
1668496992808,MATH 278B,A00,098050,Cloninger; Alexander,10,0,10,0
1668496993233,MATH 278C,A00,098051,Nie; Jiawang,5,0,10,5
1668496993658,MATH 280B,A00,098052,Zheng; Tianyi,7,0,15,8
1668496994084,MATH 281B,A00,098053,Bradic; Jelena,0,2,15,15
1668496994511,MATH 282B,A00,098054,Arias-Castro; Ery,0,1,15,15
1668496994935,MATH 285,A00,098055,Fitzsimmons; Patrick J,0,3,15,17
1668496995361,MATH 287B,A00,098056,Arias-Castro; Ery,1,0,15,14
1668496995785,MATH 288,A00,098057,Agarwal; Pooja,9,0,10,1
1668496995785,MATH 288,B00,098058,Zhang; Danna,8,0,10,2
1668496995785,MATH 288,C00,098059,Williams; Ruth J,9,0,10,1
1668496996212,MATH 290B,A00,098060,Roberts; Justin Deritter,12,0,15,3
1668496996642,MATH 292,A00,098061,Belmont; Eva Kinoshita,10,0,10,0
1668496997072,MATH 295,A00,098062,Suk; Andrew Hoon,47,0,50,3
1668496997495,MATH 296,A00,098063,Novak; Jonathan I,20,0,20,0
1668496997919,MATH 297,001,098064,Gamst; Anthony Collins,9997,0,9999,2
1668497498595,COGS 205,A00,101395,Chiba; Andrea,19,0,20,1
1668497499022,COGS 210B,001,101404,Greene; Deanna Jacquelyn,9998,0,9999,1
1668497499022,COGS 210B,002,101417,Xia; Haijun,9999,0,9999,0
1668497499022,COGS 210B,003,101422,Nitz; Douglas A.,9999,0,9999,0
1668497499022,COGS 210B,004,101423,Hollan; James D.,9998,0,9999,1
1668497499022,COGS 210B,005,101424,Deak; Gedeon O.,9998,0,9999,1
1668497499022,COGS 210B,006,101425,Rossano; Federico,9999,0,9999,0
1668497499444,COGS 211B,A00,101427,Coulson; Seana M,9996,0,9999,3
1668497499875,COGS 220,A00,101428,Hollan; James D.,0,10,25,25
1668497500300,COGS 229,A00,101429,Dow; Steven P,17,0,25,8
1668497500729,COGS 230,A00,101430,Klemmer; Scott R,8,0,17,9
1668497501154,COGS 234,A00,101431,Xia; Haijun,2,0,25,23
1668497501578,COGS 260,A00,101432,Kiyonaga; Anastasia,21,0,25,4
1668497501578,COGS 260,B00,101433,Kirsh; David Joel,15,0,25,10
1668497502006,CSE 202,A00,102371,Impagliazzo; Russell,0,65,0,0
1668497502433,CSE 203B,A01,102373,Cheng; Chung Kuan,0,55,0,0
1668497502859,CSE 208,A00,102374,Micciancio; Daniele,0,5,0,0
1668497503284,CSE 209A,A00,112895,Impagliazzo; Russell,0,12,15,15
1668497503709,CSE 209B,A00,108005,Bellare; Mihir,0,7,0,0
1668497504143,CSE 210,A00,113163,Coblenz; Michael J,0,82,0,0
1668497504571,CSE 219,A00,106111,Dow; Steven P,0,6,20,20
1668497504996,CSE 221,A00,102376,Voelker; Geoffrey M.,0,71,0,0
1668497505420,CSE 224,A01,102378,Porter; George M,0,163,0,0
1668497505855,CSE 229A,A00,102379,Savage; Stefan,0,10,0,0
1668497506280,CSE 229C,A00,102380,Munyaka; Imani N. S.,0,10,0,0
1668497506703,CSE 232B,A00,102382,Deutsch; Alin Bernard,0,31,0,0
1668497507126,CSE 234,A01,112904,Kumar; Arun Kumar,0,0,0,0
1668497507554,CSE 237A,A00,102383,Rosing; Tajana Simunic,0,53,0,0
1668497507978,CSE 239A,A00,102384,Deutsch; Alin Bernard,0,14,0,0
1668497508402,CSE 239B,A00,102385,Polikarpova; Nadezhda,0,10,0,0
1668497508826,CSE 240A,A00,102386,Pannuto; Patrick William,0,46,0,0
1668497509250,CSE 240B,A00,102387,Zhao; Jishen,0,45,0,0
1668497509676,CSE 241A,A00,106406,Kang; Mingu,0,9,0,0
1668497510102,CSE 249B,A00,102388,Kahng; Andrew Byun,0,5,8,8
1668497510527,CSE 251B,A01,102392,Cottrell; Garrison W,0,49,0,0
1668497510527,CSE 251B,A02,102393,Cottrell; Garrison W,0,34,0,0
1668497510956,CSE 252B,A00,102394,Ochoa; Benjamin Lawrence,0,58,0,0
1668497511388,CSE 257,A01,102396,Gao; Sicun,0,134,0,0
1668497511812,CSE 272,A00,102397,Li; Tzumao,0,18,0,0
1668497512238,CSE 274,A00,111323,Chern; Albert Ren-Haur,0,15,0,0
1668497512663,CSE 282,A00,102398,Pevzner; Pavel Arkadjevich,0,0,0,0
1668497513098,CSE 284,A00,114175,Gymrek; Melissa Ann,0,22,0,0
1668497513526,CSE 290,A00,102399,Chandraker; Manmohan Krishna,0,11,0,0
1668497513526,CSE 290,B00,102400,Vaccaro; Kristen Marie,0,7,25,25
1668497513526,CSE 290,C00,102414,Pannuto; Patrick William,0,1,25,25
1668497513526,CSE 290,D00,102427,Pevzner; Pavel Arkadjevich,0,0,0,0
1668497513526,CSE 290,E00,102429,Zhao; Jishen,0,4,0,0
1668497513526,CSE 290,F00,102436,Tullsen; Dean Michael,0,5,0,0
1668497513526,CSE 290,G00,102440,Christensen; Henrik I,0,6,20,20
1668497513951,CSE 291,A00,102443,Su; Hao,0,0,0,0
1668497513951,CSE 291,B00,102448,Polikarpova; Nadezhda,0,0,0,0
1668497513951,CSE 291,C00,102453,Vaccaro; Kristen Marie,0,0,0,0
1668497513951,CSE 291,D00,111343,Savage; Stefan,0,0,0,0
1668497513951,CSE 291,E00,116474,Claffy; Kimberly Claire,0,0,0,0
1668497513951,CSE 291,F00,116479,Pasquale; Joseph,0,0,0,0
1668497514380,CSE 293,001,119111,Bafna; Vineet,9999,0,9999,0
1668497514380,CSE 293,002,119118,Bellare; Mihir,9999,0,9999,0
1668497514380,CSE 293,003,119122,Berg-Kirkpatrick; Taylor D,9999,0,9999,0
1668497514380,CSE 293,004,119135,Christensen; Henrik I,9999,0,9999,0
1668497514380,CSE 293,005,119142,Cottrell; Garrison W,9999,0,9999,0
1668497514380,CSE 293,006,119146,Deutsch; Alin Bernard,9999,0,9999,0
1668497514380,CSE 293,007,119159,Esmaeilzadeh; Hadi,9999,0,9999,0
1668497514380,CSE 293,008,119166,Freund; Yoav,9999,0,9999,0
1668497514380,CSE 293,009,119170,Griswold; William G.,9999,0,9999,0
1668497514380,CSE 293,010,119183,Gymrek; Melissa Ann,9999,0,9999,0
1668497514380,CSE 293,011,119190,Heninger; Nadia A,9999,0,9999,0
1668497514380,CSE 293,012,119230,Impagliazzo; Russell,9999,0,9999,0
1668497514380,CSE 293,013,119232,Jhala; Ranjit,9999,0,9999,0
1668497514380,CSE 293,014,119233,Kahng; Andrew Byun,9999,0,9999,0
1668497514380,CSE 293,015,119298,Kane; Daniel Mertz,9999,0,9999,0
1668497514380,CSE 293,016,119299,Kriegman; David J,9999,0,9999,0
1668497514380,CSE 293,017,119300,Kumar; Arun Kumar,9999,0,9999,0
1668497514380,CSE 293,018,119301,Lerner; Sorin,9999,0,9999,0
1668497514380,CSE 293,019,119302,Lovett; Shachar,9999,0,9999,0
1668497514380,CSE 293,020,119303,McAuley; Julian John,9999,0,9999,0
1668497514380,CSE 293,021,119304,Micciancio; Daniele,9999,0,9999,0
1668497514380,CSE 293,022,119367,Orailoglu; Alex,9999,0,9999,0
1668497514380,CSE 293,023,119382,Paturi; Ramamohan,9999,0,9999,0
1668497514380,CSE 293,024,119404,Polikarpova; Nadezhda,9999,0,9999,0
1668497514380,CSE 293,025,119406,Politz; Joseph Gibbs,9999,0,9999,0
1668497514380,CSE 293,026,119411,Porter; George M,9999,0,9999,0
1668497514380,CSE 293,027,119414,Porter; Leonard Emerson,9999,0,9999,0
1668497514380,CSE 293,028,119416,Ramamoorthi; Ravi,9999,0,9999,0
1668497514380,CSE 293,029,119417,Sahoo; Debashis,9999,0,9999,0
1668497514380,CSE 293,030,119420,Saul; Lawrence,9999,0,9999,0
1668497514380,CSE 293,031,119421,Savage; Stefan,9999,0,9999,0
1668497514380,CSE 293,032,119425,Schulze; Jurgen P.,9999,0,9999,0
1668497514380,CSE 293,033,119426,Snoeren; Alex C.,9999,0,9999,0
1668497514380,CSE 293,034,119428,Shang; Jingbo,9999,0,9999,0
1668497514380,CSE 293,035,119430,Stefan; Deian,9999,0,9999,0
1668497514380,CSE 293,036,119431,Su; Hao,9999,0,9999,0
1668497514380,CSE 293,037,119433,Swanson; Steven James,9999,0,9999,0
1668497514380,CSE 293,038,119435,Tullsen; Dean Michael,9999,0,9999,0
1668497514380,CSE 293,039,119483,Voelker; Geoffrey M.,9999,0,9999,0
1668497514380,CSE 293,040,119537,Zhao; Jishen,9999,0,9999,0
1668497514380,CSE 293,041,119538,Zhou; Yuan-Yuan,9999,0,9999,0
1668497514380,CSE 293,042,119539,Gao; Sicun,9999,0,9999,0
1668497514380,CSE 293,043,119540,Weibel; Nadir,9999,0,9999,0
1668497514380,CSE 293,044,119541,Gupta; Rajesh K.,9999,0,9999,0
1668497514380,CSE 293,045,126410,Vaccaro; Kristen Marie,9999,0,9999,0
1668497514380,CSE 293,046,126411,Klemke; Richard,9999,0,9999,0
1668497514806,CSE 294,A00,102459,Voelker; Geoffrey M.,0,2,0,0
1668497514806,CSE 294,B00,111322,Orailoglu; Alex,0,2,0,0
1668497515228,DSE 201,A00,096914,Deutsch; Alin Bernard,30,0,30,0
1668497515662,DSE 210,A00,096915,Dasgupta; Sanjoy,30,0,30,0
1668497516086,DSE 260A,A00,096916,Altintas De Callaf; Ilkay,30,0,30,0
1668497516516,ECE 200,001,103586,Antipa; Nicholas A,9999,0,9999,0
1668497516516,ECE 200,002,103587,Atanasov; Nikolay A.,9999,0,9999,0
1668497516516,ECE 200,003,103588,Bharadia; Dinesh,9999,0,9999,0
1668497516516,ECE 200,004,103589,Cheng; Chung Kuan,9999,0,9999,0
1668497516516,ECE 200,005,103590,Cosman; Pamela C.,9999,0,9999,0
1668497516516,ECE 200,006,103591,Dayeh; Shadi Ahmad,9999,0,9999,0
1668497516516,ECE 200,007,103592,Fainman; Yeshaiahu,9999,0,9999,0
1668497516516,ECE 200,008,103593,Ford; Joseph Earl,9999,0,9999,0
1668497516516,ECE 200,009,103594,Franceschetti; Massimo,9999,0,9999,0
1668497516516,ECE 200,010,103595,Fullerton; Eric E,9999,0,9999,0
1668497516516,ECE 200,011,103596,Galton; Ian A,9999,0,9999,0
1668497516516,ECE 200,012,103597,Gilja; Vikash,9999,0,9999,0
1668497516516,ECE 200,013,103598,Hall; Drew A.,9999,0,9999,0
1668497516516,ECE 200,014,103599,Hsueh; Tzu-Chien,9999,0,9999,0
1668497516516,ECE 200,015,103600,Javidi; Tara,9999,0,9999,0
1668497516516,ECE 200,016,103601,Kahng; Andrew Byun,9999,0,9999,0
1668497516516,ECE 200,017,103602,Kim; Young-Han,9999,0,9999,0
1668497516516,ECE 200,018,103603,Koushanfar; Farinaz,9999,0,9999,0
1668497516516,ECE 200,019,103604,Kuzum; Duygu,9999,0,9999,0
1668497516516,ECE 200,020,103605,Le; Hanh-Phuc,9999,0,9999,0
1668497516516,ECE 200,021,103606,Lin; Bill,9999,0,9999,0
1668497516516,ECE 200,022,103607,Liu; Zhaowei,9998,0,9999,1
1668497516516,ECE 200,023,103608,Lo; Yu-Hwa,9999,0,9999,0
1668497516516,ECE 200,024,103609,Lomakin; Vitaliy,9999,0,9999,0
1668497516516,ECE 200,025,103610,Mercier; Patrick Philip,9999,0,9999,0
1668497516516,ECE 200,026,103611,Meyer; Florian,9999,0,9999,0
1668497516516,ECE 200,027,103612,Milstein; Laurence B.,9999,0,9999,0
1668497516516,ECE 200,028,103613,Mir Arabbaygi; Siavash,9999,0,9999,0
1668497516516,ECE 200,029,103614,Mookherjea; Shayan,9999,0,9999,0
1668497516516,ECE 200,030,103615,Morris; Karcher William,9999,0,9999,0
1668497516516,ECE 200,031,103616,Ng; Tse Nga,9999,0,9999,0
1668497516516,ECE 200,032,103617,Nguyen; Truong Quang,9999,0,9999,0
1668497516516,ECE 200,033,103618,Nomura; Kenji,9999,0,9999,0
1668497516516,ECE 200,034,103619,Orlitsky; Alon,9999,0,9999,0
1668497516516,ECE 200,035,103620,Pal; Piya,9999,0,9999,0
1668497516516,ECE 200,036,103621,Papen; George C.,9999,0,9999,0
1668497516516,ECE 200,037,103622,Radic; Stojan,9999,0,9999,0
1668497516516,ECE 200,038,103623,Rao; Bhaskar D.,9999,0,9999,0
1668497516516,ECE 200,039,103624,Rao; Ramesh R,9999,0,9999,0
1668497516516,ECE 200,040,103625,Rebeiz; Gabriel,9999,0,9999,0
1668497516516,ECE 200,041,103626,Sanford; John R,9999,0,9999,0
1668497516516,ECE 200,042,103627,Siegel; Paul H.,9999,0,9999,0
1668497516516,ECE 200,043,103628,Sievenpiper; Daniel F.,9999,0,9999,0
1668497516516,ECE 200,044,103629,Sworder; David D.,9999,0,9999,0
1668497516516,ECE 200,045,103630,Taur; Yuan,9999,0,9999,0
1668497516516,ECE 200,046,103631,Touri; Behrouz,9999,0,9999,0
1668497516516,ECE 200,047,103632,Trivedi; Mohan M.,9999,0,9999,0
1668497516516,ECE 200,048,103633,Vasconcelos; Nuno,9999,0,9999,0
1668497516516,ECE 200,049,103634,Wang; Xiaolong,9999,0,9999,0
1668497516516,ECE 200,050,103635,Xie; Pengtao,9999,0,9999,0
1668497516516,ECE 200,051,103636,Yip; Michael,9999,0,9999,0
1668497516516,ECE 200,052,103637,Zeger; Kenneth A.,999,0,999,0
1668497516516,ECE 200,053,103638,Zhang; Xinyu,9999,0,9999,0
1668497516516,ECE 200,054,103639,Turakhia; Yatish Girish,9999,0,9999,0
1668497516516,ECE 200,055,103640,Kang; Mingu,9999,0,9999,0
1668497516516,ECE 200,056,103641,Shi; Yuanyuan,9999,0,9999,0
1668497516516,ECE 200,057,103642,Wang; Edward Jay,9999,0,9999,0
1668497516516,ECE 200,058,103643,Zheng; Yang,9999,0,9999,0
1668497516940,ECE 202,A00,103644,Kuzum; Duygu,0,44,0,0
1668497517369,ECE 212BN,A00,103646,Ng; Tse Nga,0,9,0,0
1668497517795,ECE 221,A00,111493,Staff,0,0,0,0
1668497518218,ECE 222B,A00,103647,Lomakin; Vitaliy,0,18,0,0
1668497518641,ECE 230B,A00,103648,Taur; Yuan,0,3,0,0
1668497519069,ECE 238B,A00,103649,Garay; Javier,0,0,0,0
1668497519493,ECE 240B,A00,112900,Fainman; Yeshaiahu,0,7,0,0
1668497519916,ECE 247A,A00,103650,Jokerst; Jesse Vincent,0,6,0,0
1668497520343,ECE 247B,A00,103651,Wang; Joseph,0,14,0,0
1668497520768,ECE 250,A00,103652,Siegel; Paul H.,0,82,0,0
1668497521206,ECE 251A,A00,103654,Rao; Bhaskar D.,0,61,0,0
1668497521629,ECE 257B,A00,103655,Bharadia; Dinesh,0,32,0,0
1668497522051,ECE 258A,A00,103656,Milstein; Laurence B.,0,29,0,0
1668497522479,ECE 260B,A00,103658,Kang; Mingu,0,119,0,0
1668497522906,ECE 264A,A00,103659,Galton; Ian A,0,65,0,0
1668497523335,ECE 265A,A00,103661,Gudem; Prasad S.S.,0,70,0,0
1668497523758,ECE 265D,A00,103662,Gudem; Prasad S.S.,0,25,0,0
1668497524187,ECE 268,A00,103663,Koushanfar; Farinaz,0,42,0,0
1668497524620,ECE 269,A01,103665,Pal; Piya,0,215,0,0
1668497525048,ECE 271B,A00,103666,Vasconcelos; Manuela,0,76,0,0
1668497525472,ECE 276A,A00,103667,Atanasov; Nikolay A.,0,125,0,0
1668497525898,ECE 277,A00,103668,An; Cheolhong,0,148,0,0
1668497526322,ECE 279,A00,117947,Hall; Drew A.,0,22,0,0
1668497527173,ECE 283,A00,103670,Hsueh; Tzu-Chien,0,52,0,0
1668497527597,ECE 284,A00,103671,Turakhia; Yatish Girish,0,39,0,0
1668497528026,ECE 285,A00,103672,Zheng; Yang,0,39,0,0
1668497528026,ECE 285,B00,103673,Sworder; David D.,0,56,0,0
1668497528449,ECE 287,A00,103676,Javidi; Tara,0,8,0,0
1668497528872,MATH 200B,A00,098023,Salehi Golsefidy; Alireza,10,0,15,5
1668497529300,MATH 202B,A00,098024,Rhoades; Brendon Patrick,7,0,15,8
1668497529729,MATH 203B,A00,098025,Oprea; Dragos N.,9,0,15,6
1668497530155,MATH 204B,A00,098026,Sorensen; Claus M,13,0,15,2
1668497530582,MATH 208,A00,098027,Izadi; Elham,7,0,10,3
1668497531012,MATH 209,A00,098028,Pollack; Aaron,10,0,10,0
1668497531437,MATH 211A,A00,112919,Rogalski; Daniel,8,0,10,2
1668497531952,MATH 211B,A00,112920,Seward; Brandon M.,9,0,10,1
1668497532377,MATH 218,A00,098029,Li; Bo,10,0,10,0
1668497532800,MATH 220B,A00,098030,Novak; Jonathan I,11,0,15,4
1668497533227,MATH 221A,A00,098031,Ebenfelt; Peter F,12,0,15,3
1668497533654,MATH 231B,A00,098032,Zlatos; Andrej,11,0,15,4
1668497534082,MATH 240B,A00,098033,Ni; Lei,7,0,15,8
1668497534506,MATH 243,A00,098034,Jekel; David Andrew,10,0,10,0
1668497534928,MATH 245A,A00,098035,Nie; Jiawang,0,4,15,18
1668497535355,MATH 248,A00,098036,Bejenaru; Ioan,10,0,10,0
1668497535778,MATH 250B,A00,098037,Spolaor; Luca,14,0,15,1
1668497536205,MATH 258,A00,098038,Ni; Lei,9,0,10,1
1668497536638,MATH 264B,A00,098041,Rhoades; Brendon Patrick,8,0,15,7
1668497537062,MATH 268,A00,098042,Buss; Samuel R,10,0,10,0
1668497537487,MATH 269,A00,098043,Rhoades; Brendon Patrick,10,0,10,0
1668497537910,MATH 270B,A00,098044,Li; Bo,6,0,15,9
1668497538340,MATH 272B,A00,098045,Holst; Michael J,13,0,15,2
1668497538768,MATH 273A,A00,098046,Tian; Xiaochuan,10,0,15,5
1668497539193,MATH 275,A01,098048,Tian; Xiaochuan,6,0,10,4
1668497539617,MATH 278A,A00,098049,Holst; Michael J,7,0,10,3
1668497540046,MATH 278B,A00,098050,Cloninger; Alexander,10,0,10,0
1668497540472,MATH 278C,A00,098051,Nie; Jiawang,5,0,10,5
1668497540897,MATH 280B,A00,098052,Zheng; Tianyi,7,0,15,8
1668497541331,MATH 281B,A00,098053,Bradic; Jelena,0,2,15,15
1668497541755,MATH 282B,A00,098054,Arias-Castro; Ery,0,1,15,15
1668497542181,MATH 285,A00,098055,Fitzsimmons; Patrick J,0,3,15,17
1668497542610,MATH 287B,A00,098056,Arias-Castro; Ery,1,0,15,14
1668497543040,MATH 288,A00,098057,Agarwal; Pooja,9,0,10,1
1668497543040,MATH 288,B00,098058,Zhang; Danna,8,0,10,2
1668497543040,MATH 288,C00,098059,Williams; Ruth J,9,0,10,1
1668497543466,MATH 290B,A00,098060,Roberts; Justin Deritter,12,0,15,3
1668497543893,MATH 292,A00,098061,Belmont; Eva Kinoshita,10,0,10,0
1668497544322,MATH 295,A00,098062,Suk; Andrew Hoon,47,0,50,3
1668497544746,MATH 296,A00,098063,Novak; Jonathan I,20,0,20,0
1668497545170,MATH 297,001,098064,Gamst; Anthony Collins,9997,0,9999,2
1668498046035,COGS 205,A00,101395,Chiba; Andrea,19,0,20,1
1668498046459,COGS 210B,001,101404,Greene; Deanna Jacquelyn,9998,0,9999,1
1668498046459,COGS 210B,002,101417,Xia; Haijun,9999,0,9999,0
1668498046459,COGS 210B,003,101422,Nitz; Douglas A.,9999,0,9999,0
1668498046459,COGS 210B,004,101423,Hollan; James D.,9998,0,9999,1
1668498046459,COGS 210B,005,101424,Deak; Gedeon O.,9998,0,9999,1
1668498046459,COGS 210B,006,101425,Rossano; Federico,9999,0,9999,0
1668498046885,COGS 211B,A00,101427,Coulson; Seana M,9996,0,9999,3
1668498047311,COGS 220,A00,101428,Hollan; James D.,0,10,25,25
1668498047735,COGS 229,A00,101429,Dow; Steven P,17,0,25,8
1668498048163,COGS 230,A00,101430,Klemmer; Scott R,8,0,17,9
1668498048585,COGS 234,A00,101431,Xia; Haijun,2,0,25,23
1668498049008,COGS 260,A00,101432,Kiyonaga; Anastasia,21,0,25,4
1668498049008,COGS 260,B00,101433,Kirsh; David Joel,15,0,25,10
1668498049431,CSE 202,A00,102371,Impagliazzo; Russell,0,65,0,0
1668498049858,CSE 203B,A01,102373,Cheng; Chung Kuan,0,56,0,0
1668498050281,CSE 208,A00,102374,Micciancio; Daniele,0,5,0,0
1668498050705,CSE 209A,A00,112895,Impagliazzo; Russell,0,12,15,15
1668498051131,CSE 209B,A00,108005,Bellare; Mihir,0,7,0,0
1668498051666,CSE 210,A00,113163,Coblenz; Michael J,0,83,0,0
1668498052090,CSE 219,A00,106111,Dow; Steven P,0,6,20,20
1668498052520,CSE 221,A00,102376,Voelker; Geoffrey M.,0,71,0,0
1668498052950,CSE 224,A01,102378,Porter; George M,0,163,0,0
1668498053374,CSE 229A,A00,102379,Savage; Stefan,0,10,0,0
1668498053797,CSE 229C,A00,102380,Munyaka; Imani N. S.,0,10,0,0
1668498054221,CSE 232B,A00,102382,Deutsch; Alin Bernard,0,31,0,0
1668498054644,CSE 234,A01,112904,Kumar; Arun Kumar,0,0,0,0
1668498055071,CSE 237A,A00,102383,Rosing; Tajana Simunic,0,53,0,0
1668498055498,CSE 239A,A00,102384,Deutsch; Alin Bernard,0,14,0,0
1668498055923,CSE 239B,A00,102385,Polikarpova; Nadezhda,0,10,0,0
1668498056347,CSE 240A,A00,102386,Pannuto; Patrick William,0,46,0,0
1668498056772,CSE 240B,A00,102387,Zhao; Jishen,0,46,0,0
1668498057197,CSE 241A,A00,106406,Kang; Mingu,0,9,0,0
1668498057619,CSE 249B,A00,102388,Kahng; Andrew Byun,0,5,8,8
1668498058044,CSE 251B,A01,102392,Cottrell; Garrison W,0,49,0,0
1668498058044,CSE 251B,A02,102393,Cottrell; Garrison W,0,34,0,0
1668498058466,CSE 252B,A00,102394,Ochoa; Benjamin Lawrence,0,59,0,0
1668498058896,CSE 257,A01,102396,Gao; Sicun,0,134,0,0
1668498059323,CSE 272,A00,102397,Li; Tzumao,0,19,0,0
1668498059749,CSE 274,A00,111323,Chern; Albert Ren-Haur,0,15,0,0
1668498060172,CSE 282,A00,102398,Pevzner; Pavel Arkadjevich,0,0,0,0
1668498060599,CSE 284,A00,114175,Gymrek; Melissa Ann,0,22,0,0
1668498061024,CSE 290,A00,102399,Chandraker; Manmohan Krishna,0,11,0,0
1668498061024,CSE 290,B00,102400,Vaccaro; Kristen Marie,0,7,25,25
1668498061024,CSE 290,C00,102414,Pannuto; Patrick William,0,1,25,25
1668498061024,CSE 290,D00,102427,Pevzner; Pavel Arkadjevich,0,0,0,0
1668498061024,CSE 290,E00,102429,Zhao; Jishen,0,4,0,0
1668498061024,CSE 290,F00,102436,Tullsen; Dean Michael,0,5,0,0
1668498061024,CSE 290,G00,102440,Christensen; Henrik I,0,6,20,20
1668498061455,CSE 291,A00,102443,Su; Hao,0,0,0,0
1668498061455,CSE 291,B00,102448,Polikarpova; Nadezhda,0,0,0,0
1668498061455,CSE 291,C00,102453,Vaccaro; Kristen Marie,0,0,0,0
1668498061455,CSE 291,D00,111343,Savage; Stefan,0,0,0,0
1668498061455,CSE 291,E00,116474,Claffy; Kimberly Claire,0,0,0,0
1668498061455,CSE 291,F00,116479,Pasquale; Joseph,0,0,0,0
1668498061879,CSE 293,001,119111,Bafna; Vineet,9999,0,9999,0
1668498061879,CSE 293,002,119118,Bellare; Mihir,9999,0,9999,0
1668498061879,CSE 293,003,119122,Berg-Kirkpatrick; Taylor D,9999,0,9999,0
1668498061879,CSE 293,004,119135,Christensen; Henrik I,9999,0,9999,0
1668498061879,CSE 293,005,119142,Cottrell; Garrison W,9999,0,9999,0
1668498061879,CSE 293,006,119146,Deutsch; Alin Bernard,9999,0,9999,0
1668498061879,CSE 293,007,119159,Esmaeilzadeh; Hadi,9999,0,9999,0
1668498061879,CSE 293,008,119166,Freund; Yoav,9999,0,9999,0
1668498061879,CSE 293,009,119170,Griswold; William G.,9999,0,9999,0
1668498061879,CSE 293,010,119183,Gymrek; Melissa Ann,9999,0,9999,0
1668498061879,CSE 293,011,119190,Heninger; Nadia A,9999,0,9999,0
1668498061879,CSE 293,012,119230,Impagliazzo; Russell,9999,0,9999,0
1668498061879,CSE 293,013,119232,Jhala; Ranjit,9999,0,9999,0
1668498061879,CSE 293,014,119233,Kahng; Andrew Byun,9999,0,9999,0
1668498061879,CSE 293,015,119298,Kane; Daniel Mertz,9999,0,9999,0
1668498061879,CSE 293,016,119299,Kriegman; David J,9999,0,9999,0
1668498061879,CSE 293,017,119300,Kumar; Arun Kumar,9999,0,9999,0
1668498061879,CSE 293,018,119301,Lerner; Sorin,9999,0,9999,0
1668498061879,CSE 293,019,119302,Lovett; Shachar,9999,0,9999,0
1668498061879,CSE 293,020,119303,McAuley; Julian John,9999,0,9999,0
1668498061879,CSE 293,021,119304,Micciancio; Daniele,9999,0,9999,0
1668498061879,CSE 293,022,119367,Orailoglu; Alex,9999,0,9999,0
1668498061879,CSE 293,023,119382,Paturi; Ramamohan,9999,0,9999,0
1668498061879,CSE 293,024,119404,Polikarpova; Nadezhda,9999,0,9999,0
1668498061879,CSE 293,025,119406,Politz; Joseph Gibbs,9999,0,9999,0
1668498061879,CSE 293,026,119411,Porter; George M,9999,0,9999,0
1668498061879,CSE 293,027,119414,Porter; Leonard Emerson,9999,0,9999,0
1668498061879,CSE 293,028,119416,Ramamoorthi; Ravi,9999,0,9999,0
1668498061879,CSE 293,029,119417,Sahoo; Debashis,9999,0,9999,0
1668498061879,CSE 293,030,119420,Saul; Lawrence,9999,0,9999,0
1668498061879,CSE 293,031,119421,Savage; Stefan,9999,0,9999,0
1668498061879,CSE 293,032,119425,Schulze; Jurgen P.,9999,0,9999,0
1668498061879,CSE 293,033,119426,Snoeren; Alex C.,9999,0,9999,0
1668498061879,CSE 293,034,119428,Shang; Jingbo,9999,0,9999,0
1668498061879,CSE 293,035,119430,Stefan; Deian,9999,0,9999,0
1668498061879,CSE 293,036,119431,Su; Hao,9999,0,9999,0
1668498061879,CSE 293,037,119433,Swanson; Steven James,9999,0,9999,0
1668498061879,CSE 293,038,119435,Tullsen; Dean Michael,9999,0,9999,0
1668498061879,CSE 293,039,119483,Voelker; Geoffrey M.,9999,0,9999,0
1668498061879,CSE 293,040,119537,Zhao; Jishen,9999,0,9999,0
1668498061879,CSE 293,041,119538,Zhou; Yuan-Yuan,9999,0,9999,0
1668498061879,CSE 293,042,119539,Gao; Sicun,9999,0,9999,0
1668498061879,CSE 293,043,119540,Weibel; Nadir,9999,0,9999,0
1668498061879,CSE 293,044,119541,Gupta; Rajesh K.,9999,0,9999,0
1668498061879,CSE 293,045,126410,Vaccaro; Kristen Marie,9999,0,9999,0
1668498061879,CSE 293,046,126411,Klemke; Richard,9999,0,9999,0
1668498062304,CSE 294,A00,102459,Voelker; Geoffrey M.,0,2,0,0
1668498062304,CSE 294,B00,111322,Orailoglu; Alex,0,2,0,0
1668498062733,DSE 201,A00,096914,Deutsch; Alin Bernard,30,0,30,0
1668498063158,DSE 210,A00,096915,Dasgupta; Sanjoy,30,0,30,0
1668498063585,DSE 260A,A00,096916,Altintas De Callaf; Ilkay,30,0,30,0
1668498064033,ECE 200,001,103586,Antipa; Nicholas A,9999,0,9999,0
1668498064033,ECE 200,002,103587,Atanasov; Nikolay A.,9999,0,9999,0
1668498064033,ECE 200,003,103588,Bharadia; Dinesh,9999,0,9999,0
1668498064033,ECE 200,004,103589,Cheng; Chung Kuan,9999,0,9999,0
1668498064033,ECE 200,005,103590,Cosman; Pamela C.,9999,0,9999,0
1668498064033,ECE 200,006,103591,Dayeh; Shadi Ahmad,9999,0,9999,0
1668498064033,ECE 200,007,103592,Fainman; Yeshaiahu,9999,0,9999,0
1668498064033,ECE 200,008,103593,Ford; Joseph Earl,9999,0,9999,0
1668498064033,ECE 200,009,103594,Franceschetti; Massimo,9999,0,9999,0
1668498064033,ECE 200,010,103595,Fullerton; Eric E,9999,0,9999,0
1668498064033,ECE 200,011,103596,Galton; Ian A,9999,0,9999,0
1668498064033,ECE 200,012,103597,Gilja; Vikash,9999,0,9999,0
1668498064033,ECE 200,013,103598,Hall; Drew A.,9999,0,9999,0
1668498064033,ECE 200,014,103599,Hsueh; Tzu-Chien,9999,0,9999,0
1668498064033,ECE 200,015,103600,Javidi; Tara,9999,0,9999,0
1668498064033,ECE 200,016,103601,Kahng; Andrew Byun,9999,0,9999,0
1668498064033,ECE 200,017,103602,Kim; Young-Han,9999,0,9999,0
1668498064033,ECE 200,018,103603,Koushanfar; Farinaz,9999,0,9999,0
1668498064033,ECE 200,019,103604,Kuzum; Duygu,9999,0,9999,0
1668498064033,ECE 200,020,103605,Le; Hanh-Phuc,9999,0,9999,0
1668498064033,ECE 200,021,103606,Lin; Bill,9999,0,9999,0
1668498064033,ECE 200,022,103607,Liu; Zhaowei,9998,0,9999,1
1668498064033,ECE 200,023,103608,Lo; Yu-Hwa,9999,0,9999,0
1668498064033,ECE 200,024,103609,Lomakin; Vitaliy,9999,0,9999,0
1668498064033,ECE 200,025,103610,Mercier; Patrick Philip,9999,0,9999,0
1668498064033,ECE 200,026,103611,Meyer; Florian,9999,0,9999,0
1668498064033,ECE 200,027,103612,Milstein; Laurence B.,9999,0,9999,0
1668498064033,ECE 200,028,103613,Mir Arabbaygi; Siavash,9999,0,9999,0
1668498064033,ECE 200,029,103614,Mookherjea; Shayan,9999,0,9999,0
1668498064033,ECE 200,030,103615,Morris; Karcher William,9999,0,9999,0
1668498064033,ECE 200,031,103616,Ng; Tse Nga,9999,0,9999,0
1668498064033,ECE 200,032,103617,Nguyen; Truong Quang,9999,0,9999,0
1668498064033,ECE 200,033,103618,Nomura; Kenji,9999,0,9999,0
1668498064033,ECE 200,034,103619,Orlitsky; Alon,9999,0,9999,0
1668498064033,ECE 200,035,103620,Pal; Piya,9999,0,9999,0
1668498064033,ECE 200,036,103621,Papen; George C.,9999,0,9999,0
1668498064033,ECE 200,037,103622,Radic; Stojan,9999,0,9999,0
1668498064033,ECE 200,038,103623,Rao; Bhaskar D.,9999,0,9999,0
1668498064033,ECE 200,039,103624,Rao; Ramesh R,9999,0,9999,0
1668498064033,ECE 200,040,103625,Rebeiz; Gabriel,9999,0,9999,0
1668498064033,ECE 200,041,103626,Sanford; John R,9999,0,9999,0
1668498064033,ECE 200,042,103627,Siegel; Paul H.,9999,0,9999,0
1668498064033,ECE 200,043,103628,Sievenpiper; Daniel F.,9999,0,9999,0
1668498064033,ECE 200,044,103629,Sworder; David D.,9999,0,9999,0
1668498064033,ECE 200,045,103630,Taur; Yuan,9999,0,9999,0
1668498064033,ECE 200,046,103631,Touri; Behrouz,9999,0,9999,0
1668498064033,ECE 200,047,103632,Trivedi; Mohan M.,9999,0,9999,0
1668498064033,ECE 200,048,103633,Vasconcelos; Nuno,9999,0,9999,0
1668498064033,ECE 200,049,103634,Wang; Xiaolong,9999,0,9999,0
1668498064033,ECE 200,050,103635,Xie; Pengtao,9999,0,9999,0
1668498064033,ECE 200,051,103636,Yip; Michael,9999,0,9999,0
1668498064033,ECE 200,052,103637,Zeger; Kenneth A.,999,0,999,0
1668498064033,ECE 200,053,103638,Zhang; Xinyu,9999,0,9999,0
1668498064033,ECE 200,054,103639,Turakhia; Yatish Girish,9999,0,9999,0
1668498064033,ECE 200,055,103640,Kang; Mingu,9999,0,9999,0
1668498064033,ECE 200,056,103641,Shi; Yuanyuan,9999,0,9999,0
1668498064033,ECE 200,057,103642,Wang; Edward Jay,9999,0,9999,0
1668498064033,ECE 200,058,103643,Zheng; Yang,9999,0,9999,0
1668498064460,ECE 202,A00,103644,Kuzum; Duygu,0,44,0,0
1668498064885,ECE 212BN,A00,103646,Ng; Tse Nga,0,9,0,0
1668498065310,ECE 221,A00,111493,Staff,0,0,0,0
1668498065734,ECE 222B,A00,103647,Lomakin; Vitaliy,0,18,0,0
1668498066159,ECE 230B,A00,103648,Taur; Yuan,0,3,0,0
1668498066582,ECE 238B,A00,103649,Garay; Javier,0,0,0,0
1668498067006,ECE 240B,A00,112900,Fainman; Yeshaiahu,0,7,0,0
1668498067430,ECE 247A,A00,103650,Jokerst; Jesse Vincent,0,6,0,0
1668498067853,ECE 247B,A00,103651,Wang; Joseph,0,14,0,0
1668498068280,ECE 250,A00,103652,Siegel; Paul H.,0,82,0,0
1668498068704,ECE 251A,A00,103654,Rao; Bhaskar D.,0,61,0,0
1668498069137,ECE 257B,A00,103655,Bharadia; Dinesh,0,32,0,0
1668498069561,ECE 258A,A00,103656,Milstein; Laurence B.,0,29,0,0
1668498069988,ECE 260B,A00,103658,Kang; Mingu,0,119,0,0
1668498070413,ECE 264A,A00,103659,Galton; Ian A,0,65,0,0
1668498070839,ECE 265A,A00,103661,Gudem; Prasad S.S.,0,70,0,0
1668498071266,ECE 265D,A00,103662,Gudem; Prasad S.S.,0,25,0,0
1668498071696,ECE 268,A00,103663,Koushanfar; Farinaz,0,42,0,0
1668498072121,ECE 269,A01,103665,Pal; Piya,0,215,0,0
1668498072554,ECE 271B,A00,103666,Vasconcelos; Manuela,0,76,0,0
1668498072989,ECE 276A,A00,103667,Atanasov; Nikolay A.,0,125,0,0
1668498073412,ECE 277,A00,103668,An; Cheolhong,0,148,0,0
1668498073844,ECE 279,A00,117947,Hall; Drew A.,0,22,0,0
1668498074694,ECE 283,A00,103670,Hsueh; Tzu-Chien,0,52,0,0
1668498075121,ECE 284,A00,103671,Turakhia; Yatish Girish,0,39,0,0
1668498075545,ECE 285,A00,103672,Zheng; Yang,0,39,0,0
1668498075545,ECE 285,B00,103673,Sworder; David D.,0,56,0,0
1668498075979,ECE 287,A00,103676,Javidi; Tara,0,8,0,0
1668498076406,MATH 200B,A00,098023,Salehi Golsefidy; Alireza,10,0,15,5
1668498076829,MATH 202B,A00,098024,Rhoades; Brendon Patrick,7,0,15,8
1668498077253,MATH 203B,A00,098025,Oprea; Dragos N.,9,0,15,6
1668498077685,MATH 204B,A00,098026,Sorensen; Claus M,13,0,15,2
1668498078107,MATH 208,A00,098027,Izadi; Elham,7,0,10,3
1668498078532,MATH 209,A00,098028,Pollack; Aaron,10,0,10,0
1668498078955,MATH 211A,A00,112919,Rogalski; Daniel,8,0,10,2
1668498079378,MATH 211B,A00,112920,Seward; Brandon M.,9,0,10,1
1668498079801,MATH 218,A00,098029,Li; Bo,10,0,10,0
1668498080233,MATH 220B,A00,098030,Novak; Jonathan I,11,0,15,4
1668498080663,MATH 221A,A00,098031,Ebenfelt; Peter F,12,0,15,3
1668498081089,MATH 231B,A00,098032,Zlatos; Andrej,11,0,15,4
1668498081513,MATH 240B,A00,098033,Ni; Lei,7,0,15,8
1668498081939,MATH 243,A00,098034,Jekel; David Andrew,10,0,10,0
1668498082367,MATH 245A,A00,098035,Nie; Jiawang,0,4,15,18
1668498082790,MATH 248,A00,098036,Bejenaru; Ioan,10,0,10,0
1668498083217,MATH 250B,A00,098037,Spolaor; Luca,14,0,15,1
1668498083643,MATH 258,A00,098038,Ni; Lei,9,0,10,1
1668498084066,MATH 264B,A00,098041,Rhoades; Brendon Patrick,8,0,15,7
1668498084490,MATH 268,A00,098042,Buss; Samuel R,10,0,10,0
1668498084913,MATH 269,A00,098043,Rhoades; Brendon Patrick,10,0,10,0
1668498085346,MATH 270B,A00,098044,Li; Bo,6,0,15,9
1668498085770,MATH 272B,A00,098045,Holst; Michael J,13,0,15,2
1668498086197,MATH 273A,A00,098046,Tian; Xiaochuan,10,0,15,5
1668498086620,MATH 275,A01,098048,Tian; Xiaochuan,6,0,10,4
1668498087043,MATH 278A,A00,098049,Holst; Michael J,7,0,10,3
1668498087467,MATH 278B,A00,098050,Cloninger; Alexander,10,0,10,0
1668498087890,MATH 278C,A00,098051,Nie; Jiawang,5,0,10,5
1668498088314,MATH 280B,A00,098052,Zheng; Tianyi,7,0,15,8
1668498088736,MATH 281B,A00,098053,Bradic; Jelena,0,2,15,15
1668498089162,MATH 282B,A00,098054,Arias-Castro; Ery,0,1,15,15
1668498089585,MATH 285,A00,098055,Fitzsimmons; Patrick J,0,3,15,17
1668498090012,MATH 287B,A00,098056,Arias-Castro; Ery,1,0,15,14
1668498090437,MATH 288,A00,098057,Agarwal; Pooja,9,0,10,1
1668498090437,MATH 288,B00,098058,Zhang; Danna,8,0,10,2
1668498090437,MATH 288,C00,098059,Williams; Ruth J,9,0,10,1
1668498090864,MATH 290B,A00,098060,Roberts; Justin Deritter,12,0,15,3
1668498091287,MATH 292,A00,098061,Belmont; Eva Kinoshita,10,0,10,0
1668498091713,MATH 295,A00,098062,Suk; Andrew Hoon,47,0,50,3
1668498092136,MATH 296,A00,098063,Novak; Jonathan I,20,0,20,0
1668498092562,MATH 297,001,098064,Gamst; Anthony Collins,9997,0,9999,2
1668498604221,COGS 205,A00,101395,Chiba; Andrea,19,0,20,1
1668498604659,COGS 210B,001,101404,Greene; Deanna Jacquelyn,9998,0,9999,1
1668498604659,COGS 210B,002,101417,Xia; Haijun,9999,0,9999,0
1668498604659,COGS 210B,003,101422,Nitz; Douglas A.,9999,0,9999,0
1668498604659,COGS 210B,004,101423,Hollan; James D.,9998,0,9999,1
1668498604659,COGS 210B,005,101424,Deak; Gedeon O.,9998,0,9999,1
1668498604659,COGS 210B,006,101425,Rossano; Federico,9999,0,9999,0
1668498605082,COGS 211B,A00,101427,Coulson; Seana M,9996,0,9999,3
1668498605508,COGS 220,A00,101428,Hollan; James D.,0,10,25,25
1668498605935,COGS 229,A00,101429,Dow; Steven P,17,0,25,8
1668498606358,COGS 230,A00,101430,Klemmer; Scott R,8,0,17,9
1668498606786,COGS 234,A00,101431,Xia; Haijun,2,0,25,23
1668498607211,COGS 260,A00,101432,Kiyonaga; Anastasia,21,0,25,4
1668498607211,COGS 260,B00,101433,Kirsh; David Joel,15,0,25,10
1668498607638,CSE 202,A00,102371,Impagliazzo; Russell,0,65,0,0
1668498608065,CSE 203B,A01,102373,Cheng; Chung Kuan,0,56,0,0
1668498608491,CSE 208,A00,102374,Micciancio; Daniele,0,5,0,0
1668498608916,CSE 209A,A00,112895,Impagliazzo; Russell,0,12,15,15
1668498609342,CSE 209B,A00,108005,Bellare; Mihir,0,7,0,0
1668498609766,CSE 210,A00,113163,Coblenz; Michael J,0,83,0,0
1668498610191,CSE 219,A00,106111,Dow; Steven P,0,6,20,20
1668498610619,CSE 221,A00,102376,Voelker; Geoffrey M.,0,71,0,0
1668498611045,CSE 224,A01,102378,Porter; George M,0,163,0,0
1668498611473,CSE 229A,A00,102379,Savage; Stefan,0,10,0,0
1668498611898,CSE 229C,A00,102380,Munyaka; Imani N. S.,0,10,0,0
1668498612320,CSE 232B,A00,102382,Deutsch; Alin Bernard,0,31,0,0
1668498612745,CSE 234,A01,112904,Kumar; Arun Kumar,0,0,0,0
1668498613168,CSE 237A,A00,102383,Rosing; Tajana Simunic,0,53,0,0
1668498613591,CSE 239A,A00,102384,Deutsch; Alin Bernard,0,14,0,0
1668498614017,CSE 239B,A00,102385,Polikarpova; Nadezhda,0,10,0,0
1668498614451,CSE 240A,A00,102386,Pannuto; Patrick William,0,46,0,0
1668498614873,CSE 240B,A00,102387,Zhao; Jishen,0,46,0,0
1668498615308,CSE 241A,A00,106406,Kang; Mingu,0,9,0,0
1668498615731,CSE 249B,A00,102388,Kahng; Andrew Byun,0,5,8,8
1668498616154,CSE 251B,A01,102392,Cottrell; Garrison W,0,50,0,0
1668498616154,CSE 251B,A02,102393,Cottrell; Garrison W,0,34,0,0
1668498616581,CSE 252B,A00,102394,Ochoa; Benjamin Lawrence,0,59,0,0
1668498617008,CSE 257,A01,102396,Gao; Sicun,0,134,0,0
1668498617434,CSE 272,A00,102397,Li; Tzumao,0,19,0,0
1668498617856,CSE 274,A00,111323,Chern; Albert Ren-Haur,0,15,0,0
1668498618279,CSE 282,A00,102398,Pevzner; Pavel Arkadjevich,0,0,0,0
1668498618702,CSE 284,A00,114175,Gymrek; Melissa Ann,0,22,0,0
1668498619129,CSE 290,A00,102399,Chandraker; Manmohan Krishna,0,11,0,0
1668498619129,CSE 290,B00,102400,Vaccaro; Kristen Marie,0,7,25,25
1668498619129,CSE 290,C00,102414,Pannuto; Patrick William,0,1,25,25
1668498619129,CSE 290,D00,102427,Pevzner; Pavel Arkadjevich,0,0,0,0
1668498619129,CSE 290,E00,102429,Zhao; Jishen,0,4,0,0
1668498619129,CSE 290,F00,102436,Tullsen; Dean Michael,0,5,0,0
1668498619129,CSE 290,G00,102440,Christensen; Henrik I,0,6,20,20
1668498619553,CSE 291,A00,102443,Su; Hao,0,0,0,0
1668498619553,CSE 291,B00,102448,Polikarpova; Nadezhda,0,0,0,0
1668498619553,CSE 291,C00,102453,Vaccaro; Kristen Marie,0,0,0,0
1668498619553,CSE 291,D00,111343,Savage; Stefan,0,0,0,0
1668498619553,CSE 291,E00,116474,Claffy; Kimberly Claire,0,0,0,0
1668498619553,CSE 291,F00,116479,Pasquale; Joseph,0,0,0,0
1668498619986,CSE 293,001,119111,Bafna; Vineet,9999,0,9999,0
1668498619986,CSE 293,002,119118,Bellare; Mihir,9999,0,9999,0
1668498619986,CSE 293,003,119122,Berg-Kirkpatrick; Taylor D,9999,0,9999,0
1668498619986,CSE 293,004,119135,Christensen; Henrik I,9999,0,9999,0
1668498619986,CSE 293,005,119142,Cottrell; Garrison W,9999,0,9999,0
1668498619986,CSE 293,006,119146,Deutsch; Alin Bernard,9999,0,9999,0
1668498619986,CSE 293,007,119159,Esmaeilzadeh; Hadi,9999,0,9999,0
1668498619986,CSE 293,008,119166,Freund; Yoav,9999,0,9999,0
1668498619986,CSE 293,009,119170,Griswold; William G.,9999,0,9999,0
1668498619986,CSE 293,010,119183,Gymrek; Melissa Ann,9999,0,9999,0
1668498619986,CSE 293,011,119190,Heninger; Nadia A,9999,0,9999,0
1668498619986,CSE 293,012,119230,Impagliazzo; Russell,9999,0,9999,0
1668498619986,CSE 293,013,119232,Jhala; Ranjit,9999,0,9999,0
1668498619986,CSE 293,014,119233,Kahng; Andrew Byun,9999,0,9999,0
1668498619986,CSE 293,015,119298,Kane; Daniel Mertz,9999,0,9999,0
1668498619986,CSE 293,016,119299,Kriegman; David J,9999,0,9999,0
1668498619986,CSE 293,017,119300,Kumar; Arun Kumar,9999,0,9999,0
1668498619986,CSE 293,018,119301,Lerner; Sorin,9999,0,9999,0
1668498619986,CSE 293,019,119302,Lovett; Shachar,9999,0,9999,0
1668498619986,CSE 293,020,119303,McAuley; Julian John,9999,0,9999,0
1668498619986,CSE 293,021,119304,Micciancio; Daniele,9999,0,9999,0
1668498619986,CSE 293,022,119367,Orailoglu; Alex,9999,0,9999,0
1668498619986,CSE 293,023,119382,Paturi; Ramamohan,9999,0,9999,0
1668498619986,CSE 293,024,119404,Polikarpova; Nadezhda,9999,0,9999,0
1668498619986,CSE 293,025,119406,Politz; Joseph Gibbs,9999,0,9999,0
1668498619986,CSE 293,026,119411,Porter; George M,9999,0,9999,0
1668498619986,CSE 293,027,119414,Porter; Leonard Emerson,9999,0,9999,0
1668498619986,CSE 293,028,119416,Ramamoorthi; Ravi,9999,0,9999,0
1668498619986,CSE 293,029,119417,Sahoo; Debashis,9999,0,9999,0
1668498619986,CSE 293,030,119420,Saul; Lawrence,9999,0,9999,0
1668498619986,CSE 293,031,119421,Savage; Stefan,9999,0,9999,0
1668498619986,CSE 293,032,119425,Schulze; Jurgen P.,9999,0,9999,0
1668498619986,CSE 293,033,119426,Snoeren; Alex C.,9999,0,9999,0
1668498619986,CSE 293,034,119428,Shang; Jingbo,9999,0,9999,0
1668498619986,CSE 293,035,119430,Stefan; Deian,9999,0,9999,0
1668498619986,CSE 293,036,119431,Su; Hao,9999,0,9999,0
1668498619986,CSE 293,037,119433,Swanson; Steven James,9999,0,9999,0
1668498619986,CSE 293,038,119435,Tullsen; Dean Michael,9999,0,9999,0
1668498619986,CSE 293,039,119483,Voelker; Geoffrey M.,9999,0,9999,0
1668498619986,CSE 293,040,119537,Zhao; Jishen,9999,0,9999,0
1668498619986,CSE 293,041,119538,Zhou; Yuan-Yuan,9999,0,9999,0
1668498619986,CSE 293,042,119539,Gao; Sicun,9999,0,9999,0
1668498619986,CSE 293,043,119540,Weibel; Nadir,9999,0,9999,0
1668498619986,CSE 293,044,119541,Gupta; Rajesh K.,9999,0,9999,0
1668498619986,CSE 293,045,126410,Vaccaro; Kristen Marie,9999,0,9999,0
1668498619986,CSE 293,046,126411,Klemke; Richard,9999,0,9999,0
1668498620411,CSE 294,A00,102459,Voelker; Geoffrey M.,0,2,0,0
1668498620411,CSE 294,B00,111322,Orailoglu; Alex,0,2,0,0
1668498620841,DSE 201,A00,096914,Deutsch; Alin Bernard,30,0,30,0
1668498621265,DSE 210,A00,096915,Dasgupta; Sanjoy,30,0,30,0
1668498621692,DSE 260A,A00,096916,Altintas De Callaf; Ilkay,30,0,30,0
1668498622150,ECE 200,001,103586,Antipa; Nicholas A,9999,0,9999,0
1668498622150,ECE 200,002,103587,Atanasov; Nikolay A.,9999,0,9999,0
1668498622150,ECE 200,003,103588,Bharadia; Dinesh,9999,0,9999,0
1668498622150,ECE 200,004,103589,Cheng; Chung Kuan,9999,0,9999,0
1668498622150,ECE 200,005,103590,Cosman; Pamela C.,9999,0,9999,0
1668498622150,ECE 200,006,103591,Dayeh; Shadi Ahmad,9999,0,9999,0
1668498622150,ECE 200,007,103592,Fainman; Yeshaiahu,9999,0,9999,0
1668498622150,ECE 200,008,103593,Ford; Joseph Earl,9999,0,9999,0
1668498622150,ECE 200,009,103594,Franceschetti; Massimo,9999,0,9999,0
1668498622150,ECE 200,010,103595,Fullerton; Eric E,9999,0,9999,0
1668498622150,ECE 200,011,103596,Galton; Ian A,9999,0,9999,0
1668498622150,ECE 200,012,103597,Gilja; Vikash,9999,0,9999,0
1668498622150,ECE 200,013,103598,Hall; Drew A.,9999,0,9999,0
1668498622150,ECE 200,014,103599,Hsueh; Tzu-Chien,9999,0,9999,0
1668498622150,ECE 200,015,103600,Javidi; Tara,9999,0,9999,0
1668498622150,ECE 200,016,103601,Kahng; Andrew Byun,9999,0,9999,0
1668498622150,ECE 200,017,103602,Kim; Young-Han,9999,0,9999,0
1668498622150,ECE 200,018,103603,Koushanfar; Farinaz,9999,0,9999,0
1668498622150,ECE 200,019,103604,Kuzum; Duygu,9999,0,9999,0
1668498622150,ECE 200,020,103605,Le; Hanh-Phuc,9999,0,9999,0
1668498622150,ECE 200,021,103606,Lin; Bill,9999,0,9999,0
1668498622150,ECE 200,022,103607,Liu; Zhaowei,9998,0,9999,1
1668498622150,ECE 200,023,103608,Lo; Yu-Hwa,9999,0,9999,0
1668498622150,ECE 200,024,103609,Lomakin; Vitaliy,9999,0,9999,0
1668498622150,ECE 200,025,103610,Mercier; Patrick Philip,9999,0,9999,0
1668498622150,ECE 200,026,103611,Meyer; Florian,9999,0,9999,0
1668498622150,ECE 200,027,103612,Milstein; Laurence B.,9999,0,9999,0
1668498622150,ECE 200,028,103613,Mir Arabbaygi; Siavash,9999,0,9999,0
1668498622150,ECE 200,029,103614,Mookherjea; Shayan,9999,0,9999,0
1668498622150,ECE 200,030,103615,Morris; Karcher William,9999,0,9999,0
1668498622150,ECE 200,031,103616,Ng; Tse Nga,9999,0,9999,0
1668498622150,ECE 200,032,103617,Nguyen; Truong Quang,9999,0,9999,0
1668498622150,ECE 200,033,103618,Nomura; Kenji,9999,0,9999,0
1668498622150,ECE 200,034,103619,Orlitsky; Alon,9999,0,9999,0
1668498622150,ECE 200,035,103620,Pal; Piya,9999,0,9999,0
1668498622150,ECE 200,036,103621,Papen; George C.,9999,0,9999,0
1668498622150,ECE 200,037,103622,Radic; Stojan,9999,0,9999,0
1668498622150,ECE 200,038,103623,Rao; Bhaskar D.,9999,0,9999,0
1668498622150,ECE 200,039,103624,Rao; Ramesh R,9999,0,9999,0
1668498622150,ECE 200,040,103625,Rebeiz; Gabriel,9999,0,9999,0
1668498622150,ECE 200,041,103626,Sanford; John R,9999,0,9999,0
1668498622150,ECE 200,042,103627,Siegel; Paul H.,9999,0,9999,0
1668498622150,ECE 200,043,103628,Sievenpiper; Daniel F.,9999,0,9999,0
1668498622150,ECE 200,044,103629,Sworder; David D.,9999,0,9999,0
1668498622150,ECE 200,045,103630,Taur; Yuan,9999,0,9999,0
1668498622150,ECE 200,046,103631,Touri; Behrouz,9999,0,9999,0
1668498622150,ECE 200,047,103632,Trivedi; Mohan M.,9999,0,9999,0
1668498622150,ECE 200,048,103633,Vasconcelos; Nuno,9999,0,9999,0
1668498622150,ECE 200,049,103634,Wang; Xiaolong,9999,0,9999,0
1668498622150,ECE 200,050,103635,Xie; Pengtao,9999,0,9999,0
1668498622150,ECE 200,051,103636,Yip; Michael,9999,0,9999,0
1668498622150,ECE 200,052,103637,Zeger; Kenneth A.,999,0,999,0
1668498622150,ECE 200,053,103638,Zhang; Xinyu,9999,0,9999,0
1668498622150,ECE 200,054,103639,Turakhia; Yatish Girish,9999,0,9999,0
1668498622150,ECE 200,055,103640,Kang; Mingu,9999,0,9999,0
1668498622150,ECE 200,056,103641,Shi; Yuanyuan,9999,0,9999,0
1668498622150,ECE 200,057,103642,Wang; Edward Jay,9999,0,9999,0
1668498622150,ECE 200,058,103643,Zheng; Yang,9999,0,9999,0
1668498622574,ECE 202,A00,103644,Kuzum; Duygu,0,44,0,0
1668498623002,ECE 212BN,A00,103646,Ng; Tse Nga,0,9,0,0
1668498623426,ECE 221,A00,111493,Staff,0,0,0,0
1668498623851,ECE 222B,A00,103647,Lomakin; Vitaliy,0,18,0,0
1668498624276,ECE 230B,A00,103648,Taur; Yuan,0,3,0,0
1668498624699,ECE 238B,A00,103649,Garay; Javier,0,0,0,0
1668498625221,ECE 240B,A00,112900,Fainman; Yeshaiahu,0,7,0,0
1668498625644,ECE 247A,A00,103650,Jokerst; Jesse Vincent,0,6,0,0
1668498626067,ECE 247B,A00,103651,Wang; Joseph,0,14,0,0
1668498626490,ECE 250,A00,103652,Siegel; Paul H.,0,82,0,0
1668498626913,ECE 251A,A00,103654,Rao; Bhaskar D.,0,61,0,0
1668498627335,ECE 257B,A00,103655,Bharadia; Dinesh,0,32,0,0
1668498627758,ECE 258A,A00,103656,Milstein; Laurence B.,0,29,0,0
1668498628183,ECE 260B,A00,103658,Kang; Mingu,0,119,0,0
1668498628607,ECE 264A,A00,103659,Galton; Ian A,0,65,0,0
1668498629033,ECE 265A,A00,103661,Gudem; Prasad S.S.,0,70,0,0
1668498629469,ECE 265D,A00,103662,Gudem; Prasad S.S.,0,25,0,0
1668498629895,ECE 268,A00,103663,Koushanfar; Farinaz,0,42,0,0
1668498630322,ECE 269,A01,103665,Pal; Piya,0,215,0,0
1668498630749,ECE 271B,A00,103666,Vasconcelos; Manuela,0,76,0,0
1668498631172,ECE 276A,A00,103667,Atanasov; Nikolay A.,0,125,0,0
1668498631595,ECE 277,A00,103668,An; Cheolhong,0,148,0,0
1668498632021,ECE 279,A00,117947,Hall; Drew A.,0,22,0,0
1668498632869,ECE 283,A00,103670,Hsueh; Tzu-Chien,0,52,0,0
1668498633302,ECE 284,A00,103671,Turakhia; Yatish Girish,0,39,0,0
1668498633729,ECE 285,A00,103672,Zheng; Yang,0,39,0,0
1668498633729,ECE 285,B00,103673,Sworder; David D.,0,56,0,0
1668498634157,ECE 287,A00,103676,Javidi; Tara,0,9,0,0
1668498634579,MATH 200B,A00,098023,Salehi Golsefidy; Alireza,10,0,15,5
1668498635005,MATH 202B,A00,098024,Rhoades; Brendon Patrick,7,0,15,8
1668498635428,MATH 203B,A00,098025,Oprea; Dragos N.,9,0,15,6
1668498635851,MATH 204B,A00,098026,Sorensen; Claus M,13,0,15,2
1668498636273,MATH 208,A00,098027,Izadi; Elham,7,0,10,3
1668498636701,MATH 209,A00,098028,Pollack; Aaron,10,0,10,0
1668498637124,MATH 211A,A00,112919,Rogalski; Daniel,8,0,10,2
1668498637547,MATH 211B,A00,112920,Seward; Brandon M.,9,0,10,1
1668498637973,MATH 218,A00,098029,Li; Bo,10,0,10,0
1668498638396,MATH 220B,A00,098030,Novak; Jonathan I,11,0,15,4
1668498638822,MATH 221A,A00,098031,Ebenfelt; Peter F,12,0,15,3
1668498639250,MATH 231B,A00,098032,Zlatos; Andrej,11,0,15,4
1668498639672,MATH 240B,A00,098033,Ni; Lei,7,0,15,8
1668498640097,MATH 243,A00,098034,Jekel; David Andrew,10,0,10,0
1668498640524,MATH 245A,A00,098035,Nie; Jiawang,0,4,15,18
1668498640948,MATH 248,A00,098036,Bejenaru; Ioan,10,0,10,0
1668498641374,MATH 250B,A00,098037,Spolaor; Luca,14,0,15,1
1668498641796,MATH 258,A00,098038,Ni; Lei,9,0,10,1
1668498642220,MATH 264B,A00,098041,Rhoades; Brendon Patrick,8,0,15,7
1668498642643,MATH 268,A00,098042,Buss; Samuel R,10,0,10,0
1668498643066,MATH 269,A00,098043,Rhoades; Brendon Patrick,10,0,10,0
1668498643490,MATH 270B,A00,098044,Li; Bo,6,0,15,9
1668498643916,MATH 272B,A00,098045,Holst; Michael J,13,0,15,2
1668498644343,MATH 273A,A00,098046,Tian; Xiaochuan,10,0,15,5
1668498644764,MATH 275,A01,098048,Tian; Xiaochuan,6,0,10,4
1668498645192,MATH 278A,A00,098049,Holst; Michael J,7,0,10,3
1668498645616,MATH 278B,A00,098050,Cloninger; Alexander,10,0,10,0
1668498646041,MATH 278C,A00,098051,Nie; Jiawang,5,0,10,5
1668498646466,MATH 280B,A00,098052,Zheng; Tianyi,7,0,15,8
1668498646890,MATH 281B,A00,098053,Bradic; Jelena,0,2,15,15
1668498647317,MATH 282B,A00,098054,Arias-Castro; Ery,0,1,15,15
1668498647739,MATH 285,A00,098055,Fitzsimmons; Patrick J,0,3,15,17
1668498648161,MATH 287B,A00,098056,Arias-Castro; Ery,1,0,15,14
1668498648588,MATH 288,A00,098057,Agarwal; Pooja,9,0,10,1
1668498648588,MATH 288,B00,098058,Zhang; Danna,8,0,10,2
1668498648588,MATH 288,C00,098059,Williams; Ruth J,9,0,10,1
1668498649015,MATH 290B,A00,098060,Roberts; Justin Deritter,12,0,15,3
1668498649441,MATH 292,A00,098061,Belmont; Eva Kinoshita,10,0,10,0
1668498649864,MATH 295,A00,098062,Suk; Andrew Hoon,47,0,50,3
1668498650288,MATH 296,A00,098063,Novak; Jonathan I,20,0,20,0
1668498650712,MATH 297,001,098064,Gamst; Anthony Collins,9997,0,9999,2
1668499151248,COGS 205,A00,101395,Chiba; Andrea,19,0,20,1
1668499151671,COGS 210B,001,101404,Greene; Deanna Jacquelyn,9998,0,9999,1
1668499151671,COGS 210B,002,101417,Xia; Haijun,9999,0,9999,0
1668499151671,COGS 210B,003,101422,Nitz; Douglas A.,9999,0,9999,0
1668499151671,COGS 210B,004,101423,Hollan; James D.,9998,0,9999,1
1668499151671,COGS 210B,005,101424,Deak; Gedeon O.,9998,0,9999,1
1668499151671,COGS 210B,006,101425,Rossano; Federico,9999,0,9999,0
1668499152096,COGS 211B,A00,101427,Coulson; Seana M,9996,0,9999,3
1668499152531,COGS 220,A00,101428,Hollan; James D.,0,10,25,25
1668499152954,COGS 229,A00,101429,Dow; Steven P,17,0,25,8
1668499153386,COGS 230,A00,101430,Klemmer; Scott R,8,0,17,9
1668499153810,COGS 234,A00,101431,Xia; Haijun,2,0,25,23
1668499154233,COGS 260,A00,101432,Kiyonaga; Anastasia,21,0,25,4
1668499154233,COGS 260,B00,101433,Kirsh; David Joel,15,0,25,10
1668499154661,CSE 202,A00,102371,Impagliazzo; Russell,0,65,0,0
1668499155096,CSE 203B,A01,102373,Cheng; Chung Kuan,0,56,0,0
1668499155520,CSE 208,A00,102374,Micciancio; Daniele,0,5,0,0
1668499155946,CSE 209A,A00,112895,Impagliazzo; Russell,0,12,15,15
1668499156371,CSE 209B,A00,108005,Bellare; Mihir,0,7,0,0
1668499156802,CSE 210,A00,113163,Coblenz; Michael J,0,83,0,0
1668499157225,CSE 219,A00,106111,Dow; Steven P,0,6,20,20
1668499157648,CSE 221,A00,102376,Voelker; Geoffrey M.,0,72,0,0
1668499158074,CSE 224,A01,102378,Porter; George M,0,163,0,0
1668499158501,CSE 229A,A00,102379,Savage; Stefan,0,10,0,0
1668499158926,CSE 229C,A00,102380,Munyaka; Imani N. S.,0,10,0,0
1668499159350,CSE 232B,A00,102382,Deutsch; Alin Bernard,0,32,0,0
1668499159782,CSE 234,A01,112904,Kumar; Arun Kumar,0,0,0,0
1668499160205,CSE 237A,A00,102383,Rosing; Tajana Simunic,0,54,0,0
1668499160628,CSE 239A,A00,102384,Deutsch; Alin Bernard,0,14,0,0
1668499161052,CSE 239B,A00,102385,Polikarpova; Nadezhda,0,10,0,0
1668499161477,CSE 240A,A00,102386,Pannuto; Patrick William,0,46,0,0
1668499161899,CSE 240B,A00,102387,Zhao; Jishen,0,47,0,0
1668499162324,CSE 241A,A00,106406,Kang; Mingu,0,9,0,0
1668499162747,CSE 249B,A00,102388,Kahng; Andrew Byun,0,5,8,8
1668499163170,CSE 251B,A01,102392,Cottrell; Garrison W,0,50,0,0
1668499163170,CSE 251B,A02,102393,Cottrell; Garrison W,0,34,0,0
1668499163597,CSE 252B,A00,102394,Ochoa; Benjamin Lawrence,0,59,0,0
1668499164025,CSE 257,A01,102396,Gao; Sicun,0,134,0,0
1668499164455,CSE 272,A00,102397,Li; Tzumao,0,19,0,0
1668499164880,CSE 274,A00,111323,Chern; Albert Ren-Haur,0,15,0,0
1668499165307,CSE 282,A00,102398,Pevzner; Pavel Arkadjevich,0,0,0,0
1668499165729,CSE 284,A00,114175,Gymrek; Melissa Ann,0,22,0,0
1668499166153,CSE 290,A00,102399,Chandraker; Manmohan Krishna,0,11,0,0
1668499166153,CSE 290,B00,102400,Vaccaro; Kristen Marie,0,7,25,25
1668499166153,CSE 290,C00,102414,Pannuto; Patrick William,0,1,25,25
1668499166153,CSE 290,D00,102427,Pevzner; Pavel Arkadjevich,0,0,0,0
1668499166153,CSE 290,E00,102429,Zhao; Jishen,0,4,0,0
1668499166153,CSE 290,F00,102436,Tullsen; Dean Michael,0,5,0,0
1668499166153,CSE 290,G00,102440,Christensen; Henrik I,0,6,20,20
1668499166578,CSE 291,A00,102443,Su; Hao,0,0,0,0
1668499166578,CSE 291,B00,102448,Polikarpova; Nadezhda,0,0,0,0
1668499166578,CSE 291,C00,102453,Vaccaro; Kristen Marie,0,0,0,0
1668499166578,CSE 291,D00,111343,Savage; Stefan,0,0,0,0
1668499166578,CSE 291,E00,116474,Claffy; Kimberly Claire,0,0,0,0
1668499166578,CSE 291,F00,116479,Pasquale; Joseph,0,0,0,0
1668499167013,CSE 293,001,119111,Bafna; Vineet,9999,0,9999,0
1668499167013,CSE 293,002,119118,Bellare; Mihir,9999,0,9999,0
1668499167013,CSE 293,003,119122,Berg-Kirkpatrick; Taylor D,9999,0,9999,0
1668499167013,CSE 293,004,119135,Christensen; Henrik I,9999,0,9999,0
1668499167013,CSE 293,005,119142,Cottrell; Garrison W,9999,0,9999,0
1668499167013,CSE 293,006,119146,Deutsch; Alin Bernard,9999,0,9999,0
1668499167013,CSE 293,007,119159,Esmaeilzadeh; Hadi,9999,0,9999,0
1668499167013,CSE 293,008,119166,Freund; Yoav,9999,0,9999,0
1668499167013,CSE 293,009,119170,Griswold; William G.,9999,0,9999,0
1668499167013,CSE 293,010,119183,Gymrek; Melissa Ann,9999,0,9999,0
1668499167013,CSE 293,011,119190,Heninger; Nadia A,9999,0,9999,0
1668499167013,CSE 293,012,119230,Impagliazzo; Russell,9999,0,9999,0
1668499167013,CSE 293,013,119232,Jhala; Ranjit,9999,0,9999,0
1668499167013,CSE 293,014,119233,Kahng; Andrew Byun,9999,0,9999,0
1668499167013,CSE 293,015,119298,Kane; Daniel Mertz,9999,0,9999,0
1668499167013,CSE 293,016,119299,Kriegman; David J,9999,0,9999,0
1668499167013,CSE 293,017,119300,Kumar; Arun Kumar,9999,0,9999,0
1668499167013,CSE 293,018,119301,Lerner; Sorin,9999,0,9999,0
1668499167013,CSE 293,019,119302,Lovett; Shachar,9999,0,9999,0
1668499167013,CSE 293,020,119303,McAuley; Julian John,9999,0,9999,0
1668499167013,CSE 293,021,119304,Micciancio; Daniele,9999,0,9999,0
1668499167013,CSE 293,022,119367,Orailoglu; Alex,9999,0,9999,0
1668499167013,CSE 293,023,119382,Paturi; Ramamohan,9999,0,9999,0
1668499167013,CSE 293,024,119404,Polikarpova; Nadezhda,9999,0,9999,0
1668499167013,CSE 293,025,119406,Politz; Joseph Gibbs,9999,0,9999,0
1668499167013,CSE 293,026,119411,Porter; George M,9999,0,9999,0
1668499167013,CSE 293,027,119414,Porter; Leonard Emerson,9999,0,9999,0
1668499167013,CSE 293,028,119416,Ramamoorthi; Ravi,9999,0,9999,0
1668499167013,CSE 293,029,119417,Sahoo; Debashis,9999,0,9999,0
1668499167013,CSE 293,030,119420,Saul; Lawrence,9999,0,9999,0
1668499167013,CSE 293,031,119421,Savage; Stefan,9999,0,9999,0
1668499167013,CSE 293,032,119425,Schulze; Jurgen P.,9999,0,9999,0
1668499167013,CSE 293,033,119426,Snoeren; Alex C.,9999,0,9999,0
1668499167013,CSE 293,034,119428,Shang; Jingbo,9999,0,9999,0
1668499167013,CSE 293,035,119430,Stefan; Deian,9999,0,9999,0
1668499167013,CSE 293,036,119431,Su; Hao,9999,0,9999,0
1668499167013,CSE 293,037,119433,Swanson; Steven James,9999,0,9999,0
1668499167013,CSE 293,038,119435,Tullsen; Dean Michael,9999,0,9999,0
1668499167013,CSE 293,039,119483,Voelker; Geoffrey M.,9999,0,9999,0
1668499167013,CSE 293,040,119537,Zhao; Jishen,9999,0,9999,0
1668499167013,CSE 293,041,119538,Zhou; Yuan-Yuan,9999,0,9999,0
1668499167013,CSE 293,042,119539,Gao; Sicun,9999,0,9999,0
1668499167013,CSE 293,043,119540,Weibel; Nadir,9999,0,9999,0
1668499167013,CSE 293,044,119541,Gupta; Rajesh K.,9999,0,9999,0
1668499167013,CSE 293,045,126410,Vaccaro; Kristen Marie,9999,0,9999,0
1668499167013,CSE 293,046,126411,Klemke; Richard,9999,0,9999,0
1668499167437,CSE 294,A00,102459,Voelker; Geoffrey M.,0,2,0,0
1668499167437,CSE 294,B00,111322,Orailoglu; Alex,0,2,0,0
1668499167860,DSE 201,A00,096914,Deutsch; Alin Bernard,30,0,30,0
1668499168283,DSE 210,A00,096915,Dasgupta; Sanjoy,30,0,30,0
1668499168714,DSE 260A,A00,096916,Altintas De Callaf; Ilkay,30,0,30,0
1668499169167,ECE 200,001,103586,Antipa; Nicholas A,9999,0,9999,0
1668499169167,ECE 200,002,103587,Atanasov; Nikolay A.,9999,0,9999,0
1668499169167,ECE 200,003,103588,Bharadia; Dinesh,9999,0,9999,0
1668499169167,ECE 200,004,103589,Cheng; Chung Kuan,9999,0,9999,0
1668499169167,ECE 200,005,103590,Cosman; Pamela C.,9999,0,9999,0
1668499169167,ECE 200,006,103591,Dayeh; Shadi Ahmad,9999,0,9999,0
1668499169167,ECE 200,007,103592,Fainman; Yeshaiahu,9999,0,9999,0
1668499169167,ECE 200,008,103593,Ford; Joseph Earl,9999,0,9999,0
1668499169167,ECE 200,009,103594,Franceschetti; Massimo,9999,0,9999,0
1668499169167,ECE 200,010,103595,Fullerton; Eric E,9999,0,9999,0
1668499169167,ECE 200,011,103596,Galton; Ian A,9999,0,9999,0
1668499169167,ECE 200,012,103597,Gilja; Vikash,9999,0,9999,0
1668499169167,ECE 200,013,103598,Hall; Drew A.,9999,0,9999,0
1668499169167,ECE 200,014,103599,Hsueh; Tzu-Chien,9999,0,9999,0
1668499169167,ECE 200,015,103600,Javidi; Tara,9999,0,9999,0
1668499169167,ECE 200,016,103601,Kahng; Andrew Byun,9999,0,9999,0
1668499169167,ECE 200,017,103602,Kim; Young-Han,9999,0,9999,0
1668499169167,ECE 200,018,103603,Koushanfar; Farinaz,9999,0,9999,0
1668499169167,ECE 200,019,103604,Kuzum; Duygu,9999,0,9999,0
1668499169167,ECE 200,020,103605,Le; Hanh-Phuc,9999,0,9999,0
1668499169167,ECE 200,021,103606,Lin; Bill,9999,0,9999,0
1668499169167,ECE 200,022,103607,Liu; Zhaowei,9998,0,9999,1
1668499169167,ECE 200,023,103608,Lo; Yu-Hwa,9999,0,9999,0
1668499169167,ECE 200,024,103609,Lomakin; Vitaliy,9999,0,9999,0
1668499169167,ECE 200,025,103610,Mercier; Patrick Philip,9999,0,9999,0
1668499169167,ECE 200,026,103611,Meyer; Florian,9999,0,9999,0
1668499169167,ECE 200,027,103612,Milstein; Laurence B.,9999,0,9999,0
1668499169167,ECE 200,028,103613,Mir Arabbaygi; Siavash,9999,0,9999,0
1668499169167,ECE 200,029,103614,Mookherjea; Shayan,9999,0,9999,0
1668499169167,ECE 200,030,103615,Morris; Karcher William,9999,0,9999,0
1668499169167,ECE 200,031,103616,Ng; Tse Nga,9999,0,9999,0
1668499169167,ECE 200,032,103617,Nguyen; Truong Quang,9999,0,9999,0
1668499169167,ECE 200,033,103618,Nomura; Kenji,9999,0,9999,0
1668499169167,ECE 200,034,103619,Orlitsky; Alon,9999,0,9999,0
1668499169167,ECE 200,035,103620,Pal; Piya,9999,0,9999,0
1668499169167,ECE 200,036,103621,Papen; George C.,9999,0,9999,0
1668499169167,ECE 200,037,103622,Radic; Stojan,9999,0,9999,0
1668499169167,ECE 200,038,103623,Rao; Bhaskar D.,9999,0,9999,0
1668499169167,ECE 200,039,103624,Rao; Ramesh R,9999,0,9999,0
1668499169167,ECE 200,040,103625,Rebeiz; Gabriel,9999,0,9999,0
1668499169167,ECE 200,041,103626,Sanford; John R,9999,0,9999,0
1668499169167,ECE 200,042,103627,Siegel; Paul H.,9999,0,9999,0
1668499169167,ECE 200,043,103628,Sievenpiper; Daniel F.,9999,0,9999,0
1668499169167,ECE 200,044,103629,Sworder; David D.,9999,0,9999,0
1668499169167,ECE 200,045,103630,Taur; Yuan,9999,0,9999,0
1668499169167,ECE 200,046,103631,Touri; Behrouz,9999,0,9999,0
1668499169167,ECE 200,047,103632,Trivedi; Mohan M.,9999,0,9999,0
1668499169167,ECE 200,048,103633,Vasconcelos; Nuno,9999,0,9999,0
1668499169167,ECE 200,049,103634,Wang; Xiaolong,9999,0,9999,0
1668499169167,ECE 200,050,103635,Xie; Pengtao,9999,0,9999,0
1668499169167,ECE 200,051,103636,Yip; Michael,9999,0,9999,0
1668499169167,ECE 200,052,103637,Zeger; Kenneth A.,999,0,999,0
1668499169167,ECE 200,053,103638,Zhang; Xinyu,9999,0,9999,0
1668499169167,ECE 200,054,103639,Turakhia; Yatish Girish,9999,0,9999,0
1668499169167,ECE 200,055,103640,Kang; Mingu,9999,0,9999,0
1668499169167,ECE 200,056,103641,Shi; Yuanyuan,9999,0,9999,0
1668499169167,ECE 200,057,103642,Wang; Edward Jay,9999,0,9999,0
1668499169167,ECE 200,058,103643,Zheng; Yang,9999,0,9999,0
1668499169596,ECE 202,A00,103644,Kuzum; Duygu,0,44,0,0
1668499170027,ECE 212BN,A00,103646,Ng; Tse Nga,0,9,0,0
1668499170484,ECE 221,A00,111493,Staff,0,0,0,0
1668499170908,ECE 222B,A00,103647,Lomakin; Vitaliy,0,18,0,0
1668499171335,ECE 230B,A00,103648,Taur; Yuan,0,3,0,0
1668499171759,ECE 238B,A00,103649,Garay; Javier,0,0,0,0
1668499172182,ECE 240B,A00,112900,Fainman; Yeshaiahu,0,7,0,0
1668499172615,ECE 247A,A00,103650,Jokerst; Jesse Vincent,0,6,0,0
1668499173040,ECE 247B,A00,103651,Wang; Joseph,0,14,0,0
1668499173467,ECE 250,A00,103652,Siegel; Paul H.,0,82,0,0
1668499173895,ECE 251A,A00,103654,Rao; Bhaskar D.,0,61,0,0
1668499174322,ECE 257B,A00,103655,Bharadia; Dinesh,0,32,0,0
1668499174750,ECE 258A,A00,103656,Milstein; Laurence B.,0,29,0,0
1668499175185,ECE 260B,A00,103658,Kang; Mingu,0,119,0,0
1668499175613,ECE 264A,A00,103659,Galton; Ian A,0,65,0,0
1668499176039,ECE 265A,A00,103661,Gudem; Prasad S.S.,0,70,0,0
1668499176462,ECE 265D,A00,103662,Gudem; Prasad S.S.,0,25,0,0
1668499176891,ECE 268,A00,103663,Koushanfar; Farinaz,0,42,0,0
1668499177319,ECE 269,A01,103665,Pal; Piya,0,215,0,0
1668499177751,ECE 271B,A00,103666,Vasconcelos; Manuela,0,76,0,0
1668499178179,ECE 276A,A00,103667,Atanasov; Nikolay A.,0,125,0,0
1668499178603,ECE 277,A00,103668,An; Cheolhong,0,148,0,0
1668499179030,ECE 279,A00,117947,Hall; Drew A.,0,22,0,0
1668499179879,ECE 283,A00,103670,Hsueh; Tzu-Chien,0,52,0,0
1668499180305,ECE 284,A00,103671,Turakhia; Yatish Girish,0,39,0,0
1668499180731,ECE 285,A00,103672,Zheng; Yang,0,39,0,0
1668499180731,ECE 285,B00,103673,Sworder; David D.,0,56,0,0
1668499181157,ECE 287,A00,103676,Javidi; Tara,0,9,0,0
1668499181581,MATH 200B,A00,098023,Salehi Golsefidy; Alireza,10,0,15,5
1668499182003,MATH 202B,A00,098024,Rhoades; Brendon Patrick,7,0,15,8
1668499182429,MATH 203B,A00,098025,Oprea; Dragos N.,9,0,15,6
1668499182853,MATH 204B,A00,098026,Sorensen; Claus M,13,0,15,2
1668499183275,MATH 208,A00,098027,Izadi; Elham,7,0,10,3
1668499183698,MATH 209,A00,098028,Pollack; Aaron,10,0,10,0
1668499184121,MATH 211A,A00,112919,Rogalski; Daniel,8,0,10,2
1668499184545,MATH 211B,A00,112920,Seward; Brandon M.,9,0,10,1
1668499184969,MATH 218,A00,098029,Li; Bo,10,0,10,0
1668499185395,MATH 220B,A00,098030,Novak; Jonathan I,11,0,15,4
1668499185818,MATH 221A,A00,098031,Ebenfelt; Peter F,12,0,15,3
1668499186241,MATH 231B,A00,098032,Zlatos; Andrej,11,0,15,4
1668499186666,MATH 240B,A00,098033,Ni; Lei,7,0,15,8
1668499187093,MATH 243,A00,098034,Jekel; David Andrew,10,0,10,0
1668499187592,MATH 245A,A00,098035,Nie; Jiawang,0,4,15,18
1668499188020,MATH 248,A00,098036,Bejenaru; Ioan,10,0,10,0
1668499188445,MATH 250B,A00,098037,Spolaor; Luca,14,0,15,1
1668499188868,MATH 258,A00,098038,Ni; Lei,9,0,10,1
1668499189292,MATH 264B,A00,098041,Rhoades; Brendon Patrick,8,0,15,7
1668499189714,MATH 268,A00,098042,Buss; Samuel R,10,0,10,0
1668499190141,MATH 269,A00,098043,Rhoades; Brendon Patrick,10,0,10,0
1668499190565,MATH 270B,A00,098044,Li; Bo,6,0,15,9
1668499190989,MATH 272B,A00,098045,Holst; Michael J,13,0,15,2
1668499191418,MATH 273A,A00,098046,Tian; Xiaochuan,10,0,15,5
1668499191842,MATH 275,A01,098048,Tian; Xiaochuan,6,0,10,4
1668499192265,MATH 278A,A00,098049,Holst; Michael J,7,0,10,3
1668499192690,MATH 278B,A00,098050,Cloninger; Alexander,10,0,10,0
1668499193118,MATH 278C,A00,098051,Nie; Jiawang,5,0,10,5
1668499193543,MATH 280B,A00,098052,Zheng; Tianyi,7,0,15,8
1668499193964,MATH 281B,A00,098053,Bradic; Jelena,0,2,15,15
1668499194390,MATH 282B,A00,098054,Arias-Castro; Ery,0,1,15,15
1668499194815,MATH 285,A00,098055,Fitzsimmons; Patrick J,0,3,15,17
1668499195242,MATH 287B,A00,098056,Arias-Castro; Ery,1,0,15,14
1668499195670,MATH 288,A00,098057,Agarwal; Pooja,9,0,10,1
1668499195670,MATH 288,B00,098058,Zhang; Danna,8,0,10,2
1668499195670,MATH 288,C00,098059,Williams; Ruth J,9,0,10,1
1668499196098,MATH 290B,A00,098060,Roberts; Justin Deritter,12,0,15,3
1668499196521,MATH 292,A00,098061,Belmont; Eva Kinoshita,10,0,10,0
1668499196945,MATH 295,A00,098062,Suk; Andrew Hoon,47,0,50,3
1668499197371,MATH 296,A00,098063,Novak; Jonathan I,20,0,20,0
1668499197796,MATH 297,001,098064,Gamst; Anthony Collins,9997,0,9999,2
1668499699776,COGS 205,A00,101395,Chiba; Andrea,19,0,20,1
1668499700199,COGS 210B,001,101404,Greene; Deanna Jacquelyn,9998,0,9999,1
1668499700199,COGS 210B,002,101417,Xia; Haijun,9999,0,9999,0
1668499700199,COGS 210B,003,101422,Nitz; Douglas A.,9999,0,9999,0
1668499700199,COGS 210B,004,101423,Hollan; James D.,9998,0,9999,1
1668499700199,COGS 210B,005,101424,Deak; Gedeon O.,9998,0,9999,1
1668499700199,COGS 210B,006,101425,Rossano; Federico,9999,0,9999,0
1668499700624,COGS 211B,A00,101427,Coulson; Seana M,9996,0,9999,3
1668499701047,COGS 220,A00,101428,Hollan; James D.,0,10,25,25
1668499701471,COGS 229,A00,101429,Dow; Steven P,17,0,25,8
1668499701894,COGS 230,A00,101430,Klemmer; Scott R,8,0,17,9
1668499702329,COGS 234,A00,101431,Xia; Haijun,2,0,25,23
1668499702751,COGS 260,A00,101432,Kiyonaga; Anastasia,21,0,25,4
1668499702751,COGS 260,B00,101433,Kirsh; David Joel,15,0,25,10
1668499703175,CSE 202,A00,102371,Impagliazzo; Russell,0,65,0,0
1668499703603,CSE 203B,A01,102373,Cheng; Chung Kuan,0,57,0,0
1668499704032,CSE 208,A00,102374,Micciancio; Daniele,0,5,0,0
1668499704454,CSE 209A,A00,112895,Impagliazzo; Russell,0,12,15,15
1668499704881,CSE 209B,A00,108005,Bellare; Mihir,0,7,0,0
1668499705309,CSE 210,A00,113163,Coblenz; Michael J,0,83,0,0
1668499705732,CSE 219,A00,106111,Dow; Steven P,0,6,20,20
1668499706163,CSE 221,A00,102376,Voelker; Geoffrey M.,0,72,0,0
1668499706592,CSE 224,A01,102378,Porter; George M,0,163,0,0
1668499707016,CSE 229A,A00,102379,Savage; Stefan,0,10,0,0
1668499707445,CSE 229C,A00,102380,Munyaka; Imani N. S.,0,10,0,0
1668499707869,CSE 232B,A00,102382,Deutsch; Alin Bernard,0,32,0,0
1668499708382,CSE 234,A01,112904,Kumar; Arun Kumar,0,0,0,0
1668499708811,CSE 237A,A00,102383,Rosing; Tajana Simunic,0,55,0,0
1668499709237,CSE 239A,A00,102384,Deutsch; Alin Bernard,0,14,0,0
1668499709671,CSE 239B,A00,102385,Polikarpova; Nadezhda,0,10,0,0
1668499710098,CSE 240A,A00,102386,Pannuto; Patrick William,0,46,0,0
1668499710526,CSE 240B,A00,102387,Zhao; Jishen,0,47,0,0
1668499710952,CSE 241A,A00,106406,Kang; Mingu,0,9,0,0
1668499711386,CSE 249B,A00,102388,Kahng; Andrew Byun,0,5,8,8
1668499711810,CSE 251B,A01,102392,Cottrell; Garrison W,0,51,0,0
1668499711810,CSE 251B,A02,102393,Cottrell; Garrison W,0,34,0,0
1668499712246,CSE 252B,A00,102394,Ochoa; Benjamin Lawrence,0,59,0,0
1668499712674,CSE 257,A01,102396,Gao; Sicun,0,135,0,0
1668499713098,CSE 272,A00,102397,Li; Tzumao,0,19,0,0
1668499713521,CSE 274,A00,111323,Chern; Albert Ren-Haur,0,15,0,0
1668499713946,CSE 282,A00,102398,Pevzner; Pavel Arkadjevich,0,0,0,0
1668499714374,CSE 284,A00,114175,Gymrek; Melissa Ann,0,22,0,0
1668499714800,CSE 290,A00,102399,Chandraker; Manmohan Krishna,0,11,0,0
1668499714800,CSE 290,B00,102400,Vaccaro; Kristen Marie,0,7,25,25
1668499714800,CSE 290,C00,102414,Pannuto; Patrick William,0,1,25,25
1668499714800,CSE 290,D00,102427,Pevzner; Pavel Arkadjevich,0,0,0,0
1668499714800,CSE 290,E00,102429,Zhao; Jishen,0,4,0,0
1668499714800,CSE 290,F00,102436,Tullsen; Dean Michael,0,5,0,0
1668499714800,CSE 290,G00,102440,Christensen; Henrik I,0,6,20,20
1668499715230,CSE 291,A00,102443,Su; Hao,0,0,0,0
1668499715230,CSE 291,B00,102448,Polikarpova; Nadezhda,0,0,0,0
1668499715230,CSE 291,C00,102453,Vaccaro; Kristen Marie,0,0,0,0
1668499715230,CSE 291,D00,111343,Savage; Stefan,0,0,0,0
1668499715230,CSE 291,E00,116474,Claffy; Kimberly Claire,0,0,0,0
1668499715230,CSE 291,F00,116479,Pasquale; Joseph,0,0,0,0
1668499715658,CSE 293,001,119111,Bafna; Vineet,9999,0,9999,0
1668499715658,CSE 293,002,119118,Bellare; Mihir,9999,0,9999,0
1668499715658,CSE 293,003,119122,Berg-Kirkpatrick; Taylor D,9999,0,9999,0
1668499715658,CSE 293,004,119135,Christensen; Henrik I,9999,0,9999,0
1668499715658,CSE 293,005,119142,Cottrell; Garrison W,9999,0,9999,0
1668499715658,CSE 293,006,119146,Deutsch; Alin Bernard,9999,0,9999,0
1668499715658,CSE 293,007,119159,Esmaeilzadeh; Hadi,9999,0,9999,0
1668499715658,CSE 293,008,119166,Freund; Yoav,9999,0,9999,0
1668499715658,CSE 293,009,119170,Griswold; William G.,9999,0,9999,0
1668499715658,CSE 293,010,119183,Gymrek; Melissa Ann,9999,0,9999,0
1668499715658,CSE 293,011,119190,Heninger; Nadia A,9999,0,9999,0
1668499715658,CSE 293,012,119230,Impagliazzo; Russell,9999,0,9999,0
1668499715658,CSE 293,013,119232,Jhala; Ranjit,9999,0,9999,0
1668499715658,CSE 293,014,119233,Kahng; Andrew Byun,9999,0,9999,0
1668499715658,CSE 293,015,119298,Kane; Daniel Mertz,9999,0,9999,0
1668499715658,CSE 293,016,119299,Kriegman; David J,9999,0,9999,0
1668499715658,CSE 293,017,119300,Kumar; Arun Kumar,9999,0,9999,0
1668499715658,CSE 293,018,119301,Lerner; Sorin,9999,0,9999,0
1668499715658,CSE 293,019,119302,Lovett; Shachar,9999,0,9999,0
1668499715658,CSE 293,020,119303,McAuley; Julian John,9999,0,9999,0
1668499715658,CSE 293,021,119304,Micciancio; Daniele,9999,0,9999,0
1668499715658,CSE 293,022,119367,Orailoglu; Alex,9999,0,9999,0
1668499715658,CSE 293,023,119382,Paturi; Ramamohan,9999,0,9999,0
1668499715658,CSE 293,024,119404,Polikarpova; Nadezhda,9999,0,9999,0
1668499715658,CSE 293,025,119406,Politz; Joseph Gibbs,9999,0,9999,0
1668499715658,CSE 293,026,119411,Porter; George M,9999,0,9999,0
1668499715658,CSE 293,027,119414,Porter; Leonard Emerson,9999,0,9999,0
1668499715658,CSE 293,028,119416,Ramamoorthi; Ravi,9999,0,9999,0
1668499715658,CSE 293,029,119417,Sahoo; Debashis,9999,0,9999,0
1668499715658,CSE 293,030,119420,Saul; Lawrence,9999,0,9999,0
1668499715658,CSE 293,031,119421,Savage; Stefan,9999,0,9999,0
1668499715658,CSE 293,032,119425,Schulze; Jurgen P.,9999,0,9999,0
1668499715658,CSE 293,033,119426,Snoeren; Alex C.,9999,0,9999,0
1668499715658,CSE 293,034,119428,Shang; Jingbo,9999,0,9999,0
1668499715658,CSE 293,035,119430,Stefan; Deian,9999,0,9999,0
1668499715658,CSE 293,036,119431,Su; Hao,9999,0,9999,0
1668499715658,CSE 293,037,119433,Swanson; Steven James,9999,0,9999,0
1668499715658,CSE 293,038,119435,Tullsen; Dean Michael,9999,0,9999,0
1668499715658,CSE 293,039,119483,Voelker; Geoffrey M.,9999,0,9999,0
1668499715658,CSE 293,040,119537,Zhao; Jishen,9999,0,9999,0
1668499715658,CSE 293,041,119538,Zhou; Yuan-Yuan,9999,0,9999,0
1668499715658,CSE 293,042,119539,Gao; Sicun,9999,0,9999,0
1668499715658,CSE 293,043,119540,Weibel; Nadir,9999,0,9999,0
1668499715658,CSE 293,044,119541,Gupta; Rajesh K.,9999,0,9999,0
1668499715658,CSE 293,045,126410,Vaccaro; Kristen Marie,9999,0,9999,0
1668499715658,CSE 293,046,126411,Klemke; Richard,9999,0,9999,0
1668499716080,CSE 294,A00,102459,Voelker; Geoffrey M.,0,2,0,0
1668499716080,CSE 294,B00,111322,Orailoglu; Alex,0,2,0,0
1668499716504,DSE 201,A00,096914,Deutsch; Alin Bernard,30,0,30,0
1668499716929,DSE 210,A00,096915,Dasgupta; Sanjoy,30,0,30,0
1668499717352,DSE 260A,A00,096916,Altintas De Callaf; Ilkay,30,0,30,0
1668499717780,ECE 200,001,103586,Antipa; Nicholas A,9999,0,9999,0
1668499717780,ECE 200,002,103587,Atanasov; Nikolay A.,9999,0,9999,0
1668499717780,ECE 200,003,103588,Bharadia; Dinesh,9999,0,9999,0
1668499717780,ECE 200,004,103589,Cheng; Chung Kuan,9999,0,9999,0
1668499717780,ECE 200,005,103590,Cosman; Pamela C.,9999,0,9999,0
1668499717780,ECE 200,006,103591,Dayeh; Shadi Ahmad,9999,0,9999,0
1668499717780,ECE 200,007,103592,Fainman; Yeshaiahu,9999,0,9999,0
1668499717780,ECE 200,008,103593,Ford; Joseph Earl,9999,0,9999,0
1668499717780,ECE 200,009,103594,Franceschetti; Massimo,9999,0,9999,0
1668499717780,ECE 200,010,103595,Fullerton; Eric E,9999,0,9999,0
1668499717780,ECE 200,011,103596,Galton; Ian A,9999,0,9999,0
1668499717780,ECE 200,012,103597,Gilja; Vikash,9999,0,9999,0
1668499717780,ECE 200,013,103598,Hall; Drew A.,9999,0,9999,0
1668499717780,ECE 200,014,103599,Hsueh; Tzu-Chien,9999,0,9999,0
1668499717780,ECE 200,015,103600,Javidi; Tara,9999,0,9999,0
1668499717780,ECE 200,016,103601,Kahng; Andrew Byun,9999,0,9999,0
1668499717780,ECE 200,017,103602,Kim; Young-Han,9999,0,9999,0
1668499717780,ECE 200,018,103603,Koushanfar; Farinaz,9999,0,9999,0
1668499717780,ECE 200,019,103604,Kuzum; Duygu,9999,0,9999,0
1668499717780,ECE 200,020,103605,Le; Hanh-Phuc,9999,0,9999,0
1668499717780,ECE 200,021,103606,Lin; Bill,9999,0,9999,0
1668499717780,ECE 200,022,103607,Liu; Zhaowei,9998,0,9999,1
1668499717780,ECE 200,023,103608,Lo; Yu-Hwa,9999,0,9999,0
1668499717780,ECE 200,024,103609,Lomakin; Vitaliy,9999,0,9999,0
1668499717780,ECE 200,025,103610,Mercier; Patrick Philip,9999,0,9999,0
1668499717780,ECE 200,026,103611,Meyer; Florian,9999,0,9999,0
1668499717780,ECE 200,027,103612,Milstein; Laurence B.,9999,0,9999,0
1668499717780,ECE 200,028,103613,Mir Arabbaygi; Siavash,9999,0,9999,0
1668499717780,ECE 200,029,103614,Mookherjea; Shayan,9999,0,9999,0
1668499717780,ECE 200,030,103615,Morris; Karcher William,9999,0,9999,0
1668499717780,ECE 200,031,103616,Ng; Tse Nga,9999,0,9999,0
1668499717780,ECE 200,032,103617,Nguyen; Truong Quang,9999,0,9999,0
1668499717780,ECE 200,033,103618,Nomura; Kenji,9999,0,9999,0
1668499717780,ECE 200,034,103619,Orlitsky; Alon,9999,0,9999,0
1668499717780,ECE 200,035,103620,Pal; Piya,9999,0,9999,0
1668499717780,ECE 200,036,103621,Papen; George C.,9999,0,9999,0
1668499717780,ECE 200,037,103622,Radic; Stojan,9999,0,9999,0
1668499717780,ECE 200,038,103623,Rao; Bhaskar D.,9999,0,9999,0
1668499717780,ECE 200,039,103624,Rao; Ramesh R,9999,0,9999,0
1668499717780,ECE 200,040,103625,Rebeiz; Gabriel,9999,0,9999,0
1668499717780,ECE 200,041,103626,Sanford; John R,9999,0,9999,0
1668499717780,ECE 200,042,103627,Siegel; Paul H.,9999,0,9999,0
1668499717780,ECE 200,043,103628,Sievenpiper; Daniel F.,9999,0,9999,0
1668499717780,ECE 200,044,103629,Sworder; David D.,9999,0,9999,0
1668499717780,ECE 200,045,103630,Taur; Yuan,9999,0,9999,0
1668499717780,ECE 200,046,103631,Touri; Behrouz,9999,0,9999,0
1668499717780,ECE 200,047,103632,Trivedi; Mohan M.,9999,0,9999,0
1668499717780,ECE 200,048,103633,Vasconcelos; Nuno,9999,0,9999,0
1668499717780,ECE 200,049,103634,Wang; Xiaolong,9999,0,9999,0
1668499717780,ECE 200,050,103635,Xie; Pengtao,9999,0,9999,0
1668499717780,ECE 200,051,103636,Yip; Michael,9999,0,9999,0
1668499717780,ECE 200,052,103637,Zeger; Kenneth A.,999,0,999,0
1668499717780,ECE 200,053,103638,Zhang; Xinyu,9999,0,9999,0
1668499717780,ECE 200,054,103639,Turakhia; Yatish Girish,9999,0,9999,0
1668499717780,ECE 200,055,103640,Kang; Mingu,9999,0,9999,0
1668499717780,ECE 200,056,103641,Shi; Yuanyuan,9999,0,9999,0
1668499717780,ECE 200,057,103642,Wang; Edward Jay,9999,0,9999,0
1668499717780,ECE 200,058,103643,Zheng; Yang,9999,0,9999,0
1668499718204,ECE 202,A00,103644,Kuzum; Duygu,0,44,0,0
1668499718632,ECE 212BN,A00,103646,Ng; Tse Nga,0,9,0,0
1668499719057,ECE 221,A00,111493,Staff,0,0,0,0
1668499719480,ECE 222B,A00,103647,Lomakin; Vitaliy,0,18,0,0
1668499719910,ECE 230B,A00,103648,Taur; Yuan,0,3,0,0
1668499720340,ECE 238B,A00,103649,Garay; Javier,0,0,0,0
1668499720769,ECE 240B,A00,112900,Fainman; Yeshaiahu,0,7,0,0
1668499721192,ECE 247A,A00,103650,Jokerst; Jesse Vincent,0,6,0,0
1668499721617,ECE 247B,A00,103651,Wang; Joseph,0,14,0,0
1668499722045,ECE 250,A00,103652,Siegel; Paul H.,0,82,0,0
1668499722468,ECE 251A,A00,103654,Rao; Bhaskar D.,0,61,0,0
1668499722894,ECE 257B,A00,103655,Bharadia; Dinesh,0,32,0,0
1668499723324,ECE 258A,A00,103656,Milstein; Laurence B.,0,29,0,0
1668499723756,ECE 260B,A00,103658,Kang; Mingu,0,119,0,0
1668499724181,ECE 264A,A00,103659,Galton; Ian A,0,65,0,0
1668499724606,ECE 265A,A00,103661,Gudem; Prasad S.S.,0,70,0,0
1668499725031,ECE 265D,A00,103662,Gudem; Prasad S.S.,0,25,0,0
1668499725458,ECE 268,A00,103663,Koushanfar; Farinaz,0,42,0,0
1668499725890,ECE 269,A01,103665,Pal; Piya,0,215,0,0
1668499726316,ECE 271B,A00,103666,Vasconcelos; Manuela,0,76,0,0
1668499726741,ECE 276A,A00,103667,Atanasov; Nikolay A.,0,125,0,0
1668499727167,ECE 277,A00,103668,An; Cheolhong,0,148,0,0
1668499727592,ECE 279,A00,117947,Hall; Drew A.,0,22,0,0
1668499728445,ECE 283,A00,103670,Hsueh; Tzu-Chien,0,52,0,0
1668499728867,ECE 284,A00,103671,Turakhia; Yatish Girish,0,39,0,0
1668499729304,ECE 285,A00,103672,Zheng; Yang,0,39,0,0
1668499729304,ECE 285,B00,103673,Sworder; David D.,0,57,0,0
1668499729732,ECE 287,A00,103676,Javidi; Tara,0,9,0,0
1668499730159,MATH 200B,A00,098023,Salehi Golsefidy; Alireza,10,0,15,5
1668499730583,MATH 202B,A00,098024,Rhoades; Brendon Patrick,7,0,15,8
1668499731007,MATH 203B,A00,098025,Oprea; Dragos N.,9,0,15,6
1668499731431,MATH 204B,A00,098026,Sorensen; Claus M,13,0,15,2
1668499731853,MATH 208,A00,098027,Izadi; Elham,7,0,10,3
1668499732276,MATH 209,A00,098028,Pollack; Aaron,10,0,10,0
1668499732708,MATH 211A,A00,112919,Rogalski; Daniel,8,0,10,2
1668499733132,MATH 211B,A00,112920,Seward; Brandon M.,9,0,10,1
1668499733555,MATH 218,A00,098029,Li; Bo,10,0,10,0
1668499733987,MATH 220B,A00,098030,Novak; Jonathan I,11,0,15,4
1668499734414,MATH 221A,A00,098031,Ebenfelt; Peter F,12,0,15,3
1668499734844,MATH 231B,A00,098032,Zlatos; Andrej,11,0,15,4
1668499735271,MATH 240B,A00,098033,Ni; Lei,7,0,15,8
1668499735700,MATH 243,A00,098034,Jekel; David Andrew,10,0,10,0
1668499736129,MATH 245A,A00,098035,Nie; Jiawang,0,4,15,18
1668499736552,MATH 248,A00,098036,Bejenaru; Ioan,10,0,10,0
1668499736976,MATH 250B,A00,098037,Spolaor; Luca,14,0,15,1
1668499737409,MATH 258,A00,098038,Ni; Lei,9,0,10,1
1668499737843,MATH 264B,A00,098041,Rhoades; Brendon Patrick,8,0,15,7
1668499738271,MATH 268,A00,098042,Buss; Samuel R,10,0,10,0
1668499738699,MATH 269,A00,098043,Rhoades; Brendon Patrick,10,0,10,0
1668499739125,MATH 270B,A00,098044,Li; Bo,6,0,15,9
1668499739562,MATH 272B,A00,098045,Holst; Michael J,13,0,15,2
1668499739991,MATH 273A,A00,098046,Tian; Xiaochuan,10,0,15,5
1668499740420,MATH 275,A01,098048,Tian; Xiaochuan,6,0,10,4
1668499740843,MATH 278A,A00,098049,Holst; Michael J,7,0,10,3
1668499741267,MATH 278B,A00,098050,Cloninger; Alexander,10,0,10,0
1668499741694,MATH 278C,A00,098051,Nie; Jiawang,5,0,10,5
1668499742118,MATH 280B,A00,098052,Zheng; Tianyi,7,0,15,8
1668499742540,MATH 281B,A00,098053,Bradic; Jelena,0,2,15,15
1668499742962,MATH 282B,A00,098054,Arias-Castro; Ery,0,1,15,15
1668499743390,MATH 285,A00,098055,Fitzsimmons; Patrick J,0,3,15,17
1668499743839,MATH 287B,A00,098056,Arias-Castro; Ery,1,0,15,14
1668499744269,MATH 288,A00,098057,Agarwal; Pooja,9,0,10,1
1668499744269,MATH 288,B00,098058,Zhang; Danna,8,0,10,2
1668499744269,MATH 288,C00,098059,Williams; Ruth J,9,0,10,1
1668499744694,MATH 290B,A00,098060,Roberts; Justin Deritter,12,0,15,3
1668499745118,MATH 292,A00,098061,Belmont; Eva Kinoshita,10,0,10,0
1668499745542,MATH 295,A00,098062,Suk; Andrew Hoon,47,0,50,3
1668499745969,MATH 296,A00,098063,Novak; Jonathan I,20,0,20,0
1668499746400,MATH 297,001,098064,Gamst; Anthony Collins,9997,0,9999,2
1668500251563,COGS 205,A00,101395,Chiba; Andrea,19,0,20,1
1668500251989,COGS 210B,001,101404,Greene; Deanna Jacquelyn,9998,0,9999,1
1668500251989,COGS 210B,002,101417,Xia; Haijun,9999,0,9999,0
1668500251989,COGS 210B,003,101422,Nitz; Douglas A.,9999,0,9999,0
1668500251989,COGS 210B,004,101423,Hollan; James D.,9998,0,9999,1
1668500251989,COGS 210B,005,101424,Deak; Gedeon O.,9998,0,9999,1
1668500251989,COGS 210B,006,101425,Rossano; Federico,9999,0,9999,0
1668500252415,COGS 211B,A00,101427,Coulson; Seana M,9996,0,9999,3
1668500252845,COGS 220,A00,101428,Hollan; James D.,0,10,25,25
1668500253271,COGS 229,A00,101429,Dow; Steven P,17,0,25,8
1668500253709,COGS 230,A00,101430,Klemmer; Scott R,8,0,17,9
1668500254141,COGS 234,A00,101431,Xia; Haijun,2,0,25,23
1668500254571,COGS 260,A00,101432,Kiyonaga; Anastasia,21,0,25,4
1668500254571,COGS 260,B00,101433,Kirsh; David Joel,15,0,25,10
1668500255007,CSE 202,A00,102371,Impagliazzo; Russell,0,65,0,0
1668500255433,CSE 203B,A01,102373,Cheng; Chung Kuan,0,57,0,0
1668500255868,CSE 208,A00,102374,Micciancio; Daniele,0,5,0,0
1668500256307,CSE 209A,A00,112895,Impagliazzo; Russell,0,12,15,15
1668500256735,CSE 209B,A00,108005,Bellare; Mihir,0,7,0,0
1668500257163,CSE 210,A00,113163,Coblenz; Michael J,0,83,0,0
1668500257593,CSE 219,A00,106111,Dow; Steven P,0,6,20,20
1668500258033,CSE 221,A00,102376,Voelker; Geoffrey M.,0,72,0,0
1668500258464,CSE 224,A01,102378,Porter; George M,0,164,0,0
1668500258892,CSE 229A,A00,102379,Savage; Stefan,0,10,0,0
1668500259326,CSE 229C,A00,102380,Munyaka; Imani N. S.,0,10,0,0
1668500259761,CSE 232B,A00,102382,Deutsch; Alin Bernard,0,32,0,0
1668500260187,CSE 234,A01,112904,Kumar; Arun Kumar,0,0,0,0
1668500260611,CSE 237A,A00,102383,Rosing; Tajana Simunic,0,55,0,0
1668500261038,CSE 239A,A00,102384,Deutsch; Alin Bernard,0,14,0,0
1668500261465,CSE 239B,A00,102385,Polikarpova; Nadezhda,0,10,0,0
1668500261890,CSE 240A,A00,102386,Pannuto; Patrick William,0,46,0,0
1668500262320,CSE 240B,A00,102387,Zhao; Jishen,0,47,0,0
1668500262748,CSE 241A,A00,106406,Kang; Mingu,0,9,0,0
1668500263173,CSE 249B,A00,102388,Kahng; Andrew Byun,0,5,8,8
1668500263602,CSE 251B,A01,102392,Cottrell; Garrison W,0,51,0,0
1668500263602,CSE 251B,A02,102393,Cottrell; Garrison W,0,34,0,0
1668500264034,CSE 252B,A00,102394,Ochoa; Benjamin Lawrence,0,59,0,0
1668500264464,CSE 257,A01,102396,Gao; Sicun,0,135,0,0
1668500264894,CSE 272,A00,102397,Li; Tzumao,0,19,0,0
1668500265318,CSE 274,A00,111323,Chern; Albert Ren-Haur,0,15,0,0
1668500265746,CSE 282,A00,102398,Pevzner; Pavel Arkadjevich,0,0,0,0
1668500266171,CSE 284,A00,114175,Gymrek; Melissa Ann,0,22,0,0
1668500266622,CSE 290,A00,102399,Chandraker; Manmohan Krishna,0,11,0,0
1668500266622,CSE 290,B00,102400,Vaccaro; Kristen Marie,0,7,25,25
1668500266622,CSE 290,C00,102414,Pannuto; Patrick William,0,1,25,25
1668500266622,CSE 290,D00,102427,Pevzner; Pavel Arkadjevich,0,0,0,0
1668500266622,CSE 290,E00,102429,Zhao; Jishen,0,4,0,0
1668500266622,CSE 290,F00,102436,Tullsen; Dean Michael,0,5,0,0
1668500266622,CSE 290,G00,102440,Christensen; Henrik I,0,6,20,20
1668500267054,CSE 291,A00,102443,Su; Hao,0,0,0,0
1668500267054,CSE 291,B00,102448,Polikarpova; Nadezhda,0,0,0,0
1668500267054,CSE 291,C00,102453,Vaccaro; Kristen Marie,0,0,0,0
1668500267054,CSE 291,D00,111343,Savage; Stefan,0,0,0,0
1668500267054,CSE 291,E00,116474,Claffy; Kimberly Claire,0,0,0,0
1668500267054,CSE 291,F00,116479,Pasquale; Joseph,0,0,0,0
1668500267510,CSE 293,001,119111,Bafna; Vineet,9999,0,9999,0
1668500267510,CSE 293,002,119118,Bellare; Mihir,9999,0,9999,0
1668500267510,CSE 293,003,119122,Berg-Kirkpatrick; Taylor D,9999,0,9999,0
1668500267510,CSE 293,004,119135,Christensen; Henrik I,9999,0,9999,0
1668500267510,CSE 293,005,119142,Cottrell; Garrison W,9999,0,9999,0
1668500267510,CSE 293,006,119146,Deutsch; Alin Bernard,9999,0,9999,0
1668500267510,CSE 293,007,119159,Esmaeilzadeh; Hadi,9999,0,9999,0
1668500267510,CSE 293,008,119166,Freund; Yoav,9999,0,9999,0
1668500267510,CSE 293,009,119170,Griswold; William G.,9999,0,9999,0
1668500267510,CSE 293,010,119183,Gymrek; Melissa Ann,9999,0,9999,0
1668500267510,CSE 293,011,119190,Heninger; Nadia A,9999,0,9999,0
1668500267510,CSE 293,012,119230,Impagliazzo; Russell,9999,0,9999,0
1668500267510,CSE 293,013,119232,Jhala; Ranjit,9999,0,9999,0
1668500267510,CSE 293,014,119233,Kahng; Andrew Byun,9999,0,9999,0
1668500267510,CSE 293,015,119298,Kane; Daniel Mertz,9999,0,9999,0
1668500267510,CSE 293,016,119299,Kriegman; David J,9999,0,9999,0
1668500267510,CSE 293,017,119300,Kumar; Arun Kumar,9999,0,9999,0
1668500267510,CSE 293,018,119301,Lerner; Sorin,9999,0,9999,0
1668500267510,CSE 293,019,119302,Lovett; Shachar,9999,0,9999,0
1668500267510,CSE 293,020,119303,McAuley; Julian John,9999,0,9999,0
1668500267510,CSE 293,021,119304,Micciancio; Daniele,9999,0,9999,0
1668500267510,CSE 293,022,119367,Orailoglu; Alex,9999,0,9999,0
1668500267510,CSE 293,023,119382,Paturi; Ramamohan,9999,0,9999,0
1668500267510,CSE 293,024,119404,Polikarpova; Nadezhda,9999,0,9999,0
1668500267510,CSE 293,025,119406,Politz; Joseph Gibbs,9999,0,9999,0
1668500267510,CSE 293,026,119411,Porter; George M,9999,0,9999,0
1668500267510,CSE 293,027,119414,Porter; Leonard Emerson,9999,0,9999,0
1668500267510,CSE 293,028,119416,Ramamoorthi; Ravi,9999,0,9999,0
1668500267510,CSE 293,029,119417,Sahoo; Debashis,9999,0,9999,0
1668500267510,CSE 293,030,119420,Saul; Lawrence,9999,0,9999,0
1668500267510,CSE 293,031,119421,Savage; Stefan,9999,0,9999,0
1668500267510,CSE 293,032,119425,Schulze; Jurgen P.,9999,0,9999,0
1668500267510,CSE 293,033,119426,Snoeren; Alex C.,9999,0,9999,0
1668500267510,CSE 293,034,119428,Shang; Jingbo,9999,0,9999,0
1668500267510,CSE 293,035,119430,Stefan; Deian,9999,0,9999,0
1668500267510,CSE 293,036,119431,Su; Hao,9999,0,9999,0
1668500267510,CSE 293,037,119433,Swanson; Steven James,9999,0,9999,0
1668500267510,CSE 293,038,119435,Tullsen; Dean Michael,9999,0,9999,0
1668500267510,CSE 293,039,119483,Voelker; Geoffrey M.,9999,0,9999,0
1668500267510,CSE 293,040,119537,Zhao; Jishen,9999,0,9999,0
1668500267510,CSE 293,041,119538,Zhou; Yuan-Yuan,9999,0,9999,0
1668500267510,CSE 293,042,119539,Gao; Sicun,9999,0,9999,0
1668500267510,CSE 293,043,119540,Weibel; Nadir,9999,0,9999,0
1668500267510,CSE 293,044,119541,Gupta; Rajesh K.,9999,0,9999,0
1668500267510,CSE 293,045,126410,Vaccaro; Kristen Marie,9999,0,9999,0
1668500267510,CSE 293,046,126411,Klemke; Richard,9999,0,9999,0
1668500267939,CSE 294,A00,102459,Voelker; Geoffrey M.,0,2,0,0
1668500267939,CSE 294,B00,111322,Orailoglu; Alex,0,2,0,0
1668500268367,DSE 201,A00,096914,Deutsch; Alin Bernard,30,0,30,0
1668500268802,DSE 210,A00,096915,Dasgupta; Sanjoy,30,0,30,0
1668500269232,DSE 260A,A00,096916,Altintas De Callaf; Ilkay,30,0,30,0
1668500269697,ECE 200,001,103586,Antipa; Nicholas A,9999,0,9999,0
1668500269697,ECE 200,002,103587,Atanasov; Nikolay A.,9999,0,9999,0
1668500269697,ECE 200,003,103588,Bharadia; Dinesh,9999,0,9999,0
1668500269697,ECE 200,004,103589,Cheng; Chung Kuan,9999,0,9999,0
1668500269697,ECE 200,005,103590,Cosman; Pamela C.,9999,0,9999,0
1668500269697,ECE 200,006,103591,Dayeh; Shadi Ahmad,9999,0,9999,0
1668500269697,ECE 200,007,103592,Fainman; Yeshaiahu,9999,0,9999,0
1668500269697,ECE 200,008,103593,Ford; Joseph Earl,9999,0,9999,0
1668500269697,ECE 200,009,103594,Franceschetti; Massimo,9999,0,9999,0
1668500269697,ECE 200,010,103595,Fullerton; Eric E,9999,0,9999,0
1668500269697,ECE 200,011,103596,Galton; Ian A,9999,0,9999,0
1668500269697,ECE 200,012,103597,Gilja; Vikash,9999,0,9999,0
1668500269697,ECE 200,013,103598,Hall; Drew A.,9999,0,9999,0
1668500269697,ECE 200,014,103599,Hsueh; Tzu-Chien,9999,0,9999,0
1668500269697,ECE 200,015,103600,Javidi; Tara,9999,0,9999,0
1668500269697,ECE 200,016,103601,Kahng; Andrew Byun,9999,0,9999,0
1668500269697,ECE 200,017,103602,Kim; Young-Han,9999,0,9999,0
1668500269697,ECE 200,018,103603,Koushanfar; Farinaz,9999,0,9999,0
1668500269697,ECE 200,019,103604,Kuzum; Duygu,9999,0,9999,0
1668500269697,ECE 200,020,103605,Le; Hanh-Phuc,9999,0,9999,0
1668500269697,ECE 200,021,103606,Lin; Bill,9999,0,9999,0
1668500269697,ECE 200,022,103607,Liu; Zhaowei,9998,0,9999,1
1668500269697,ECE 200,023,103608,Lo; Yu-Hwa,9999,0,9999,0
1668500269697,ECE 200,024,103609,Lomakin; Vitaliy,9999,0,9999,0
1668500269697,ECE 200,025,103610,Mercier; Patrick Philip,9999,0,9999,0
1668500269697,ECE 200,026,103611,Meyer; Florian,9999,0,9999,0
1668500269697,ECE 200,027,103612,Milstein; Laurence B.,9999,0,9999,0
1668500269697,ECE 200,028,103613,Mir Arabbaygi; Siavash,9999,0,9999,0
1668500269697,ECE 200,029,103614,Mookherjea; Shayan,9999,0,9999,0
1668500269697,ECE 200,030,103615,Morris; Karcher William,9999,0,9999,0
1668500269697,ECE 200,031,103616,Ng; Tse Nga,9999,0,9999,0
1668500269697,ECE 200,032,103617,Nguyen; Truong Quang,9999,0,9999,0
1668500269697,ECE 200,033,103618,Nomura; Kenji,9999,0,9999,0
1668500269697,ECE 200,034,103619,Orlitsky; Alon,9999,0,9999,0
1668500269697,ECE 200,035,103620,Pal; Piya,9999,0,9999,0
1668500269697,ECE 200,036,103621,Papen; George C.,9999,0,9999,0
1668500269697,ECE 200,037,103622,Radic; Stojan,9999,0,9999,0
1668500269697,ECE 200,038,103623,Rao; Bhaskar D.,9999,0,9999,0
1668500269697,ECE 200,039,103624,Rao; Ramesh R,9999,0,9999,0
1668500269697,ECE 200,040,103625,Rebeiz; Gabriel,9999,0,9999,0
1668500269697,ECE 200,041,103626,Sanford; John R,9999,0,9999,0
1668500269697,ECE 200,042,103627,Siegel; Paul H.,9999,0,9999,0
1668500269697,ECE 200,043,103628,Sievenpiper; Daniel F.,9999,0,9999,0
1668500269697,ECE 200,044,103629,Sworder; David D.,9999,0,9999,0
1668500269697,ECE 200,045,103630,Taur; Yuan,9999,0,9999,0
1668500269697,ECE 200,046,103631,Touri; Behrouz,9999,0,9999,0
1668500269697,ECE 200,047,103632,Trivedi; Mohan M.,9999,0,9999,0
1668500269697,ECE 200,048,103633,Vasconcelos; Nuno,9999,0,9999,0
1668500269697,ECE 200,049,103634,Wang; Xiaolong,9999,0,9999,0
1668500269697,ECE 200,050,103635,Xie; Pengtao,9999,0,9999,0
1668500269697,ECE 200,051,103636,Yip; Michael,9999,0,9999,0
1668500269697,ECE 200,052,103637,Zeger; Kenneth A.,999,0,999,0
1668500269697,ECE 200,053,103638,Zhang; Xinyu,9999,0,9999,0
1668500269697,ECE 200,054,103639,Turakhia; Yatish Girish,9999,0,9999,0
1668500269697,ECE 200,055,103640,Kang; Mingu,9999,0,9999,0
1668500269697,ECE 200,056,103641,Shi; Yuanyuan,9999,0,9999,0
1668500269697,ECE 200,057,103642,Wang; Edward Jay,9999,0,9999,0
1668500269697,ECE 200,058,103643,Zheng; Yang,9999,0,9999,0
1668500270123,ECE 202,A00,103644,Kuzum; Duygu,0,44,0,0
1668500270553,ECE 212BN,A00,103646,Ng; Tse Nga,0,9,0,0
1668500270983,ECE 221,A00,111493,Staff,0,0,0,0
1668500271408,ECE 222B,A00,103647,Lomakin; Vitaliy,0,18,0,0
1668500271835,ECE 230B,A00,103648,Taur; Yuan,0,3,0,0
1668500272262,ECE 238B,A00,103649,Garay; Javier,0,0,0,0
1668500272688,ECE 240B,A00,112900,Fainman; Yeshaiahu,0,7,0,0
1668500273119,ECE 247A,A00,103650,Jokerst; Jesse Vincent,0,6,0,0
1668500273546,ECE 247B,A00,103651,Wang; Joseph,0,14,0,0
1668500273987,ECE 250,A00,103652,Siegel; Paul H.,0,82,0,0
1668500274454,ECE 251A,A00,103654,Rao; Bhaskar D.,0,61,0,0
1668500274895,ECE 257B,A00,103655,Bharadia; Dinesh,0,32,0,0
1668500275324,ECE 258A,A00,103656,Milstein; Laurence B.,0,29,0,0
1668500275848,ECE 260B,A00,103658,Kang; Mingu,0,119,0,0
1668500276287,ECE 264A,A00,103659,Galton; Ian A,0,65,0,0
1668500276714,ECE 265A,A00,103661,Gudem; Prasad S.S.,0,70,0,0
1668500277154,ECE 265D,A00,103662,Gudem; Prasad S.S.,0,25,0,0
1668500277596,ECE 268,A00,103663,Koushanfar; Farinaz,0,42,0,0
1668500278051,ECE 269,A01,103665,Pal; Piya,0,215,0,0
1668500278484,ECE 271B,A00,103666,Vasconcelos; Manuela,0,76,0,0
1668500278915,ECE 276A,A00,103667,Atanasov; Nikolay A.,0,125,0,0
1668500279349,ECE 277,A00,103668,An; Cheolhong,0,148,0,0
1668500279788,ECE 279,A00,117947,Hall; Drew A.,0,22,0,0
1668500280657,ECE 283,A00,103670,Hsueh; Tzu-Chien,0,52,0,0
1668500281096,ECE 284,A00,103671,Turakhia; Yatish Girish,0,39,0,0
1668500281551,ECE 285,A00,103672,Zheng; Yang,0,39,0,0
1668500281551,ECE 285,B00,103673,Sworder; David D.,0,57,0,0
1668500281979,ECE 287,A00,103676,Javidi; Tara,0,9,0,0
1668500282419,MATH 200B,A00,098023,Salehi Golsefidy; Alireza,10,0,15,5
1668500282849,MATH 202B,A00,098024,Rhoades; Brendon Patrick,7,0,15,8
1668500283280,MATH 203B,A00,098025,Oprea; Dragos N.,9,0,15,6
1668500283707,MATH 204B,A00,098026,Sorensen; Claus M,13,0,15,2
1668500284142,MATH 208,A00,098027,Izadi; Elham,7,0,10,3
1668500284569,MATH 209,A00,098028,Pollack; Aaron,10,0,10,0
1668500284999,MATH 211A,A00,112919,Rogalski; Daniel,8,0,10,2
1668500285426,MATH 211B,A00,112920,Seward; Brandon M.,9,0,10,1
1668500285855,MATH 218,A00,098029,Li; Bo,10,0,10,0
1668500286286,MATH 220B,A00,098030,Novak; Jonathan I,11,0,15,4
1668500286719,MATH 221A,A00,098031,Ebenfelt; Peter F,12,0,15,3
1668500287145,MATH 231B,A00,098032,Zlatos; Andrej,11,0,15,4
1668500287580,MATH 240B,A00,098033,Ni; Lei,7,0,15,8
1668500288008,MATH 243,A00,098034,Jekel; David Andrew,10,0,10,0
1668500288438,MATH 245A,A00,098035,Nie; Jiawang,0,4,15,18
1668500288861,MATH 248,A00,098036,Bejenaru; Ioan,10,0,10,0
1668500289285,MATH 250B,A00,098037,Spolaor; Luca,14,0,15,1
1668500289708,MATH 258,A00,098038,Ni; Lei,9,0,10,1
1668500290133,MATH 264B,A00,098041,Rhoades; Brendon Patrick,8,0,15,7
1668500290562,MATH 268,A00,098042,Buss; Samuel R,10,0,10,0
1668500290999,MATH 269,A00,098043,Rhoades; Brendon Patrick,10,0,10,0
1668500291429,MATH 270B,A00,098044,Li; Bo,6,0,15,9
1668500291853,MATH 272B,A00,098045,Holst; Michael J,13,0,15,2
1668500292278,MATH 273A,A00,098046,Tian; Xiaochuan,10,0,15,5
1668500292702,MATH 275,A01,098048,Tian; Xiaochuan,6,0,10,4
1668500293126,MATH 278A,A00,098049,Holst; Michael J,7,0,10,3
1668500293558,MATH 278B,A00,098050,Cloninger; Alexander,10,0,10,0
1668500293996,MATH 278C,A00,098051,Nie; Jiawang,5,0,10,5
1668500294420,MATH 280B,A00,098052,Zheng; Tianyi,7,0,15,8
1668500294844,MATH 281B,A00,098053,Bradic; Jelena,0,2,15,15
1668500295267,MATH 282B,A00,098054,Arias-Castro; Ery,0,1,15,15
1668500295698,MATH 285,A00,098055,Fitzsimmons; Patrick J,0,3,15,17
1668500296129,MATH 287B,A00,098056,Arias-Castro; Ery,1,0,15,14
1668500296557,MATH 288,A00,098057,Agarwal; Pooja,9,0,10,1
1668500296557,MATH 288,B00,098058,Zhang; Danna,8,0,10,2
1668500296557,MATH 288,C00,098059,Williams; Ruth J,9,0,10,1
1668500296985,MATH 290B,A00,098060,Roberts; Justin Deritter,12,0,15,3
1668500297413,MATH 292,A00,098061,Belmont; Eva Kinoshita,10,0,10,0
1668500297837,MATH 295,A00,098062,Suk; Andrew Hoon,47,0,50,3
1668500298272,MATH 296,A00,098063,Novak; Jonathan I,20,0,20,0
1668500298700,MATH 297,001,098064,Gamst; Anthony Collins,9997,0,9999,2
1668500803700,COGS 205,A00,101395,Chiba; Andrea,19,0,20,1
1668500804126,COGS 210B,001,101404,Greene; Deanna Jacquelyn,9998,0,9999,1
1668500804126,COGS 210B,002,101417,Xia; Haijun,9999,0,9999,0
1668500804126,COGS 210B,003,101422,Nitz; Douglas A.,9999,0,9999,0
1668500804126,COGS 210B,004,101423,Hollan; James D.,9998,0,9999,1
1668500804126,COGS 210B,005,101424,Deak; Gedeon O.,9998,0,9999,1
1668500804126,COGS 210B,006,101425,Rossano; Federico,9999,0,9999,0
1668500804549,COGS 211B,A00,101427,Coulson; Seana M,9996,0,9999,3
1668500804975,COGS 220,A00,101428,Hollan; James D.,0,10,25,25
1668500805403,COGS 229,A00,101429,Dow; Steven P,17,0,25,8
1668500805830,COGS 230,A00,101430,Klemmer; Scott R,8,0,17,9
1668500806253,COGS 234,A00,101431,Xia; Haijun,2,0,25,23
1668500806682,COGS 260,A00,101432,Kiyonaga; Anastasia,21,0,25,4
1668500806682,COGS 260,B00,101433,Kirsh; David Joel,15,0,25,10
1668500807110,CSE 202,A00,102371,Impagliazzo; Russell,0,65,0,0
1668500807537,CSE 203B,A01,102373,Cheng; Chung Kuan,0,57,0,0
1668500807963,CSE 208,A00,102374,Micciancio; Daniele,0,5,0,0
1668500808390,CSE 209A,A00,112895,Impagliazzo; Russell,0,12,15,15
1668500808821,CSE 209B,A00,108005,Bellare; Mihir,0,7,0,0
1668500809248,CSE 210,A00,113163,Coblenz; Michael J,0,83,0,0
1668500809684,CSE 219,A00,106111,Dow; Steven P,0,6,20,20
1668500810112,CSE 221,A00,102376,Voelker; Geoffrey M.,0,72,0,0
1668500810537,CSE 224,A01,102378,Porter; George M,0,164,0,0
1668500810965,CSE 229A,A00,102379,Savage; Stefan,0,10,0,0
1668500811392,CSE 229C,A00,102380,Munyaka; Imani N. S.,0,10,0,0
1668500811819,CSE 232B,A00,102382,Deutsch; Alin Bernard,0,32,0,0
1668500812242,CSE 234,A01,112904,Kumar; Arun Kumar,0,0,0,0
1668500812672,CSE 237A,A00,102383,Rosing; Tajana Simunic,0,55,0,0
1668500813103,CSE 239A,A00,102384,Deutsch; Alin Bernard,0,14,0,0
1668500813526,CSE 239B,A00,102385,Polikarpova; Nadezhda,0,10,0,0
1668500813949,CSE 240A,A00,102386,Pannuto; Patrick William,0,46,0,0
1668500814377,CSE 240B,A00,102387,Zhao; Jishen,0,47,0,0
1668500814801,CSE 241A,A00,106406,Kang; Mingu,0,9,0,0
1668500815230,CSE 249B,A00,102388,Kahng; Andrew Byun,0,5,8,8
1668500815655,CSE 251B,A01,102392,Cottrell; Garrison W,0,51,0,0
1668500815655,CSE 251B,A02,102393,Cottrell; Garrison W,0,34,0,0
1668500816080,CSE 252B,A00,102394,Ochoa; Benjamin Lawrence,0,59,0,0
1668500816505,CSE 257,A01,102396,Gao; Sicun,0,137,0,0
1668500816933,CSE 272,A00,102397,Li; Tzumao,0,19,0,0
1668500817358,CSE 274,A00,111323,Chern; Albert Ren-Haur,0,15,0,0
1668500817783,CSE 282,A00,102398,Pevzner; Pavel Arkadjevich,0,0,0,0
1668500818208,CSE 284,A00,114175,Gymrek; Melissa Ann,0,22,0,0
1668500818633,CSE 290,A00,102399,Chandraker; Manmohan Krishna,0,11,0,0
1668500818633,CSE 290,B00,102400,Vaccaro; Kristen Marie,0,7,25,25
1668500818633,CSE 290,C00,102414,Pannuto; Patrick William,0,1,25,25
1668500818633,CSE 290,D00,102427,Pevzner; Pavel Arkadjevich,0,0,0,0
1668500818633,CSE 290,E00,102429,Zhao; Jishen,0,4,0,0
1668500818633,CSE 290,F00,102436,Tullsen; Dean Michael,0,5,0,0
1668500818633,CSE 290,G00,102440,Christensen; Henrik I,0,6,20,20
1668500819065,CSE 291,A00,102443,Su; Hao,0,0,0,0
1668500819065,CSE 291,B00,102448,Polikarpova; Nadezhda,0,0,0,0
1668500819065,CSE 291,C00,102453,Vaccaro; Kristen Marie,0,0,0,0
1668500819065,CSE 291,D00,111343,Savage; Stefan,0,0,0,0
1668500819065,CSE 291,E00,116474,Claffy; Kimberly Claire,0,0,0,0
1668500819065,CSE 291,F00,116479,Pasquale; Joseph,0,0,0,0
1668500819525,CSE 293,001,119111,Bafna; Vineet,9999,0,9999,0
1668500819525,CSE 293,002,119118,Bellare; Mihir,9999,0,9999,0
1668500819525,CSE 293,003,119122,Berg-Kirkpatrick; Taylor D,9999,0,9999,0
1668500819525,CSE 293,004,119135,Christensen; Henrik I,9999,0,9999,0
1668500819525,CSE 293,005,119142,Cottrell; Garrison W,9999,0,9999,0
1668500819525,CSE 293,006,119146,Deutsch; Alin Bernard,9999,0,9999,0
1668500819525,CSE 293,007,119159,Esmaeilzadeh; Hadi,9999,0,9999,0
1668500819525,CSE 293,008,119166,Freund; Yoav,9999,0,9999,0
1668500819525,CSE 293,009,119170,Griswold; William G.,9999,0,9999,0
1668500819525,CSE 293,010,119183,Gymrek; Melissa Ann,9999,0,9999,0
1668500819525,CSE 293,011,119190,Heninger; Nadia A,9999,0,9999,0
1668500819525,CSE 293,012,119230,Impagliazzo; Russell,9999,0,9999,0
1668500819525,CSE 293,013,119232,Jhala; Ranjit,9999,0,9999,0
1668500819525,CSE 293,014,119233,Kahng; Andrew Byun,9999,0,9999,0
1668500819525,CSE 293,015,119298,Kane; Daniel Mertz,9999,0,9999,0
1668500819525,CSE 293,016,119299,Kriegman; David J,9999,0,9999,0
1668500819525,CSE 293,017,119300,Kumar; Arun Kumar,9999,0,9999,0
1668500819525,CSE 293,018,119301,Lerner; Sorin,9999,0,9999,0
1668500819525,CSE 293,019,119302,Lovett; Shachar,9999,0,9999,0
1668500819525,CSE 293,020,119303,McAuley; Julian John,9999,0,9999,0
1668500819525,CSE 293,021,119304,Micciancio; Daniele,9999,0,9999,0
1668500819525,CSE 293,022,119367,Orailoglu; Alex,9999,0,9999,0
1668500819525,CSE 293,023,119382,Paturi; Ramamohan,9999,0,9999,0
1668500819525,CSE 293,024,119404,Polikarpova; Nadezhda,9999,0,9999,0
1668500819525,CSE 293,025,119406,Politz; Joseph Gibbs,9999,0,9999,0
1668500819525,CSE 293,026,119411,Porter; George M,9999,0,9999,0
1668500819525,CSE 293,027,119414,Porter; Leonard Emerson,9999,0,9999,0
1668500819525,CSE 293,028,119416,Ramamoorthi; Ravi,9999,0,9999,0
1668500819525,CSE 293,029,119417,Sahoo; Debashis,9999,0,9999,0
1668500819525,CSE 293,030,119420,Saul; Lawrence,9999,0,9999,0
1668500819525,CSE 293,031,119421,Savage; Stefan,9999,0,9999,0
1668500819525,CSE 293,032,119425,Schulze; Jurgen P.,9999,0,9999,0
1668500819525,CSE 293,033,119426,Snoeren; Alex C.,9999,0,9999,0
1668500819525,CSE 293,034,119428,Shang; Jingbo,9999,0,9999,0
1668500819525,CSE 293,035,119430,Stefan; Deian,9999,0,9999,0
1668500819525,CSE 293,036,119431,Su; Hao,9999,0,9999,0
1668500819525,CSE 293,037,119433,Swanson; Steven James,9999,0,9999,0
1668500819525,CSE 293,038,119435,Tullsen; Dean Michael,9999,0,9999,0
1668500819525,CSE 293,039,119483,Voelker; Geoffrey M.,9999,0,9999,0
1668500819525,CSE 293,040,119537,Zhao; Jishen,9999,0,9999,0
1668500819525,CSE 293,041,119538,Zhou; Yuan-Yuan,9999,0,9999,0
1668500819525,CSE 293,042,119539,Gao; Sicun,9999,0,9999,0
1668500819525,CSE 293,043,119540,Weibel; Nadir,9999,0,9999,0
1668500819525,CSE 293,044,119541,Gupta; Rajesh K.,9999,0,9999,0
1668500819525,CSE 293,045,126410,Vaccaro; Kristen Marie,9999,0,9999,0
1668500819525,CSE 293,046,126411,Klemke; Richard,9999,0,9999,0
1668500819952,CSE 294,A00,102459,Voelker; Geoffrey M.,0,2,0,0
1668500819952,CSE 294,B00,111322,Orailoglu; Alex,0,2,0,0
1668500820379,DSE 201,A00,096914,Deutsch; Alin Bernard,30,0,30,0
1668500820807,DSE 210,A00,096915,Dasgupta; Sanjoy,30,0,30,0
1668500821230,DSE 260A,A00,096916,Altintas De Callaf; Ilkay,30,0,30,0
1668500821705,ECE 200,001,103586,Antipa; Nicholas A,9999,0,9999,0
1668500821705,ECE 200,002,103587,Atanasov; Nikolay A.,9999,0,9999,0
1668500821705,ECE 200,003,103588,Bharadia; Dinesh,9999,0,9999,0
1668500821705,ECE 200,004,103589,Cheng; Chung Kuan,9999,0,9999,0
1668500821705,ECE 200,005,103590,Cosman; Pamela C.,9999,0,9999,0
1668500821705,ECE 200,006,103591,Dayeh; Shadi Ahmad,9999,0,9999,0
1668500821705,ECE 200,007,103592,Fainman; Yeshaiahu,9999,0,9999,0
1668500821705,ECE 200,008,103593,Ford; Joseph Earl,9999,0,9999,0
1668500821705,ECE 200,009,103594,Franceschetti; Massimo,9999,0,9999,0
1668500821705,ECE 200,010,103595,Fullerton; Eric E,9999,0,9999,0
1668500821705,ECE 200,011,103596,Galton; Ian A,9999,0,9999,0
1668500821705,ECE 200,012,103597,Gilja; Vikash,9999,0,9999,0
1668500821705,ECE 200,013,103598,Hall; Drew A.,9999,0,9999,0
1668500821705,ECE 200,014,103599,Hsueh; Tzu-Chien,9999,0,9999,0
1668500821705,ECE 200,015,103600,Javidi; Tara,9999,0,9999,0
1668500821705,ECE 200,016,103601,Kahng; Andrew Byun,9999,0,9999,0
1668500821705,ECE 200,017,103602,Kim; Young-Han,9999,0,9999,0
1668500821705,ECE 200,018,103603,Koushanfar; Farinaz,9999,0,9999,0
1668500821705,ECE 200,019,103604,Kuzum; Duygu,9999,0,9999,0
1668500821705,ECE 200,020,103605,Le; Hanh-Phuc,9999,0,9999,0
1668500821705,ECE 200,021,103606,Lin; Bill,9999,0,9999,0
1668500821705,ECE 200,022,103607,Liu; Zhaowei,9998,0,9999,1
1668500821705,ECE 200,023,103608,Lo; Yu-Hwa,9999,0,9999,0
1668500821705,ECE 200,024,103609,Lomakin; Vitaliy,9999,0,9999,0
1668500821705,ECE 200,025,103610,Mercier; Patrick Philip,9999,0,9999,0
1668500821705,ECE 200,026,103611,Meyer; Florian,9999,0,9999,0
1668500821705,ECE 200,027,103612,Milstein; Laurence B.,9999,0,9999,0
1668500821705,ECE 200,028,103613,Mir Arabbaygi; Siavash,9999,0,9999,0
1668500821705,ECE 200,029,103614,Mookherjea; Shayan,9999,0,9999,0
1668500821705,ECE 200,030,103615,Morris; Karcher William,9999,0,9999,0
1668500821705,ECE 200,031,103616,Ng; Tse Nga,9999,0,9999,0
1668500821705,ECE 200,032,103617,Nguyen; Truong Quang,9999,0,9999,0
1668500821705,ECE 200,033,103618,Nomura; Kenji,9999,0,9999,0
1668500821705,ECE 200,034,103619,Orlitsky; Alon,9999,0,9999,0
1668500821705,ECE 200,035,103620,Pal; Piya,9999,0,9999,0
1668500821705,ECE 200,036,103621,Papen; George C.,9999,0,9999,0
1668500821705,ECE 200,037,103622,Radic; Stojan,9999,0,9999,0
1668500821705,ECE 200,038,103623,Rao; Bhaskar D.,9999,0,9999,0
1668500821705,ECE 200,039,103624,Rao; Ramesh R,9999,0,9999,0
1668500821705,ECE 200,040,103625,Rebeiz; Gabriel,9999,0,9999,0
1668500821705,ECE 200,041,103626,Sanford; John R,9999,0,9999,0
1668500821705,ECE 200,042,103627,Siegel; Paul H.,9999,0,9999,0
1668500821705,ECE 200,043,103628,Sievenpiper; Daniel F.,9999,0,9999,0
1668500821705,ECE 200,044,103629,Sworder; David D.,9999,0,9999,0
1668500821705,ECE 200,045,103630,Taur; Yuan,9999,0,9999,0
1668500821705,ECE 200,046,103631,Touri; Behrouz,9999,0,9999,0
1668500821705,ECE 200,047,103632,Trivedi; Mohan M.,9999,0,9999,0
1668500821705,ECE 200,048,103633,Vasconcelos; Nuno,9999,0,9999,0
1668500821705,ECE 200,049,103634,Wang; Xiaolong,9999,0,9999,0
1668500821705,ECE 200,050,103635,Xie; Pengtao,9999,0,9999,0
1668500821705,ECE 200,051,103636,Yip; Michael,9999,0,9999,0
1668500821705,ECE 200,052,103637,Zeger; Kenneth A.,999,0,999,0
1668500821705,ECE 200,053,103638,Zhang; Xinyu,9999,0,9999,0
1668500821705,ECE 200,054,103639,Turakhia; Yatish Girish,9999,0,9999,0
1668500821705,ECE 200,055,103640,Kang; Mingu,9999,0,9999,0
1668500821705,ECE 200,056,103641,Shi; Yuanyuan,9999,0,9999,0
1668500821705,ECE 200,057,103642,Wang; Edward Jay,9999,0,9999,0
1668500821705,ECE 200,058,103643,Zheng; Yang,9999,0,9999,0
1668500822130,ECE 202,A00,103644,Kuzum; Duygu,0,44,0,0
1668500822559,ECE 212BN,A00,103646,Ng; Tse Nga,0,9,0,0
1668500822986,ECE 221,A00,111493,Staff,0,0,0,0
1668500823417,ECE 222B,A00,103647,Lomakin; Vitaliy,0,19,0,0
1668500823841,ECE 230B,A00,103648,Taur; Yuan,0,3,0,0
1668500824269,ECE 238B,A00,103649,Garay; Javier,0,0,0,0
1668500824696,ECE 240B,A00,112900,Fainman; Yeshaiahu,0,7,0,0
1668500825124,ECE 247A,A00,103650,Jokerst; Jesse Vincent,0,6,0,0
1668500825560,ECE 247B,A00,103651,Wang; Joseph,0,14,0,0
1668500825985,ECE 250,A00,103652,Siegel; Paul H.,0,82,0,0
1668500826416,ECE 251A,A00,103654,Rao; Bhaskar D.,0,61,0,0
1668500826840,ECE 257B,A00,103655,Bharadia; Dinesh,0,32,0,0
1668500827267,ECE 258A,A00,103656,Milstein; Laurence B.,0,29,0,0
1668500827702,ECE 260B,A00,103658,Kang; Mingu,0,119,0,0
1668500828129,ECE 264A,A00,103659,Galton; Ian A,0,65,0,0
1668500828556,ECE 265A,A00,103661,Gudem; Prasad S.S.,0,70,0,0
1668500828982,ECE 265D,A00,103662,Gudem; Prasad S.S.,0,25,0,0
1668500829406,ECE 268,A00,103663,Koushanfar; Farinaz,0,42,0,0
1668500829830,ECE 269,A01,103665,Pal; Piya,0,215,0,0
1668500830270,ECE 271B,A00,103666,Vasconcelos; Manuela,0,76,0,0
1668500830709,ECE 276A,A00,103667,Atanasov; Nikolay A.,0,125,0,0
1668500831133,ECE 277,A00,103668,An; Cheolhong,0,148,0,0
1668500831558,ECE 279,A00,117947,Hall; Drew A.,0,22,0,0
1668500832408,ECE 283,A00,103670,Hsueh; Tzu-Chien,0,52,0,0
1668500832833,ECE 284,A00,103671,Turakhia; Yatish Girish,0,39,0,0
1668500833261,ECE 285,A00,103672,Zheng; Yang,0,39,0,0
1668500833261,ECE 285,B00,103673,Sworder; David D.,0,57,0,0
1668500833685,ECE 287,A00,103676,Javidi; Tara,0,9,0,0
1668500834109,MATH 200B,A00,098023,Salehi Golsefidy; Alireza,10,0,15,5
1668500834537,MATH 202B,A00,098024,Rhoades; Brendon Patrick,7,0,15,8
1668500834960,MATH 203B,A00,098025,Oprea; Dragos N.,9,0,15,6
1668500835390,MATH 204B,A00,098026,Sorensen; Claus M,13,0,15,2
1668500835815,MATH 208,A00,098027,Izadi; Elham,7,0,10,3
1668500836242,MATH 209,A00,098028,Pollack; Aaron,10,0,10,0
1668500836672,MATH 211A,A00,112919,Rogalski; Daniel,8,0,10,2
1668500837095,MATH 211B,A00,112920,Seward; Brandon M.,9,0,10,1
1668500837519,MATH 218,A00,098029,Li; Bo,10,0,10,0
1668500837941,MATH 220B,A00,098030,Novak; Jonathan I,11,0,15,4
1668500838365,MATH 221A,A00,098031,Ebenfelt; Peter F,12,0,15,3
1668500838791,MATH 231B,A00,098032,Zlatos; Andrej,11,0,15,4
1668500839220,MATH 240B,A00,098033,Ni; Lei,7,0,15,8
1668500839648,MATH 243,A00,098034,Jekel; David Andrew,10,0,10,0
1668500840074,MATH 245A,A00,098035,Nie; Jiawang,0,4,15,18
1668500840498,MATH 248,A00,098036,Bejenaru; Ioan,10,0,10,0
1668500840924,MATH 250B,A00,098037,Spolaor; Luca,14,0,15,1
1668500841349,MATH 258,A00,098038,Ni; Lei,9,0,10,1
1668500841777,MATH 264B,A00,098041,Rhoades; Brendon Patrick,8,0,15,7
1668500842206,MATH 268,A00,098042,Buss; Samuel R,10,0,10,0
1668500842631,MATH 269,A00,098043,Rhoades; Brendon Patrick,10,0,10,0
1668500843139,MATH 270B,A00,098044,Li; Bo,6,0,15,9
1668500843565,MATH 272B,A00,098045,Holst; Michael J,13,0,15,2
1668500843996,MATH 273A,A00,098046,Tian; Xiaochuan,10,0,15,5
1668500844423,MATH 275,A01,098048,Tian; Xiaochuan,6,0,10,4
1668500844846,MATH 278A,A00,098049,Holst; Michael J,7,0,10,3
1668500845269,MATH 278B,A00,098050,Cloninger; Alexander,10,0,10,0
1668500845697,MATH 278C,A00,098051,Nie; Jiawang,5,0,10,5
1668500846121,MATH 280B,A00,098052,Zheng; Tianyi,7,0,15,8
1668500846550,MATH 281B,A00,098053,Bradic; Jelena,0,2,15,15
1668500846974,MATH 282B,A00,098054,Arias-Castro; Ery,0,1,15,15
1668500847402,MATH 285,A00,098055,Fitzsimmons; Patrick J,0,3,15,17
1668500847834,MATH 287B,A00,098056,Arias-Castro; Ery,1,0,15,14
1668500848259,MATH 288,A00,098057,Agarwal; Pooja,9,0,10,1
1668500848259,MATH 288,B00,098058,Zhang; Danna,8,0,10,2
1668500848259,MATH 288,C00,098059,Williams; Ruth J,9,0,10,1
1668500848683,MATH 290B,A00,098060,Roberts; Justin Deritter,12,0,15,3
1668500849106,MATH 292,A00,098061,Belmont; Eva Kinoshita,10,0,10,0
1668500849533,MATH 295,A00,098062,Suk; Andrew Hoon,47,0,50,3
1668500849959,MATH 296,A00,098063,Novak; Jonathan I,20,0,20,0
1668500850388,MATH 297,001,098064,Gamst; Anthony Collins,9997,0,9999,2
1668501352279,COGS 205,A00,101395,Chiba; Andrea,19,0,20,1
1668501352705,COGS 210B,001,101404,Greene; Deanna Jacquelyn,9998,0,9999,1
1668501352705,COGS 210B,002,101417,Xia; Haijun,9999,0,9999,0
1668501352705,COGS 210B,003,101422,Nitz; Douglas A.,9999,0,9999,0
1668501352705,COGS 210B,004,101423,Hollan; James D.,9998,0,9999,1
1668501352705,COGS 210B,005,101424,Deak; Gedeon O.,9998,0,9999,1
1668501352705,COGS 210B,006,101425,Rossano; Federico,9999,0,9999,0
1668501353133,COGS 211B,A00,101427,Coulson; Seana M,9996,0,9999,3
1668501353561,COGS 220,A00,101428,Hollan; James D.,0,10,25,25
1668501353992,COGS 229,A00,101429,Dow; Steven P,17,0,25,8
1668501354418,COGS 230,A00,101430,Klemmer; Scott R,7,0,17,10
1668501354842,COGS 234,A00,101431,Xia; Haijun,1,0,25,24
1668501355277,COGS 260,A00,101432,Kiyonaga; Anastasia,21,0,25,4
1668501355277,COGS 260,B00,101433,Kirsh; David Joel,15,0,25,10
1668501355707,CSE 202,A00,102371,Impagliazzo; Russell,0,65,0,0
1668501356134,CSE 203B,A01,102373,Cheng; Chung Kuan,0,57,0,0
1668501356558,CSE 208,A00,102374,Micciancio; Daniele,0,5,0,0
1668501356985,CSE 209A,A00,112895,Impagliazzo; Russell,0,12,15,15
1668501357415,CSE 209B,A00,108005,Bellare; Mihir,0,7,0,0
1668501357843,CSE 210,A00,113163,Coblenz; Michael J,0,83,0,0
1668501358266,CSE 219,A00,106111,Dow; Steven P,0,6,20,20
1668501358704,CSE 221,A00,102376,Voelker; Geoffrey M.,0,72,0,0
1668501359129,CSE 224,A01,102378,Porter; George M,0,164,0,0
1668501359554,CSE 229A,A00,102379,Savage; Stefan,0,10,0,0
1668501359978,CSE 229C,A00,102380,Munyaka; Imani N. S.,0,10,0,0
1668501360412,CSE 232B,A00,102382,Deutsch; Alin Bernard,0,32,0,0
1668501360848,CSE 234,A01,112904,Kumar; Arun Kumar,0,0,0,0
1668501361273,CSE 237A,A00,102383,Rosing; Tajana Simunic,0,55,0,0
1668501361702,CSE 239A,A00,102384,Deutsch; Alin Bernard,0,14,0,0
1668501362126,CSE 239B,A00,102385,Polikarpova; Nadezhda,0,10,0,0
1668501362553,CSE 240A,A00,102386,Pannuto; Patrick William,0,46,0,0
1668501362978,CSE 240B,A00,102387,Zhao; Jishen,0,47,0,0
1668501363410,CSE 241A,A00,106406,Kang; Mingu,0,9,0,0
1668501363930,CSE 249B,A00,102388,Kahng; Andrew Byun,0,5,8,8
1668501364362,CSE 251B,A01,102392,Cottrell; Garrison W,0,51,0,0
1668501364362,CSE 251B,A02,102393,Cottrell; Garrison W,0,34,0,0
1668501364787,CSE 252B,A00,102394,Ochoa; Benjamin Lawrence,0,59,0,0
1668501365215,CSE 257,A01,102396,Gao; Sicun,0,137,0,0
1668501365640,CSE 272,A00,102397,Li; Tzumao,0,19,0,0
1668501366064,CSE 274,A00,111323,Chern; Albert Ren-Haur,0,15,0,0
1668501366489,CSE 282,A00,102398,Pevzner; Pavel Arkadjevich,0,0,0,0
1668501366914,CSE 284,A00,114175,Gymrek; Melissa Ann,0,22,0,0
1668501367342,CSE 290,A00,102399,Chandraker; Manmohan Krishna,0,11,0,0
1668501367342,CSE 290,B00,102400,Vaccaro; Kristen Marie,0,7,25,25
1668501367342,CSE 290,C00,102414,Pannuto; Patrick William,0,1,25,25
1668501367342,CSE 290,D00,102427,Pevzner; Pavel Arkadjevich,0,0,0,0
1668501367342,CSE 290,E00,102429,Zhao; Jishen,0,4,0,0
1668501367342,CSE 290,F00,102436,Tullsen; Dean Michael,0,5,0,0
1668501367342,CSE 290,G00,102440,Christensen; Henrik I,0,6,20,20
1668501367768,CSE 291,A00,102443,Su; Hao,0,0,0,0
1668501367768,CSE 291,B00,102448,Polikarpova; Nadezhda,0,0,0,0
1668501367768,CSE 291,C00,102453,Vaccaro; Kristen Marie,0,0,0,0
1668501367768,CSE 291,D00,111343,Savage; Stefan,0,0,0,0
1668501367768,CSE 291,E00,116474,Claffy; Kimberly Claire,0,0,0,0
1668501367768,CSE 291,F00,116479,Pasquale; Joseph,0,0,0,0
1668501368212,CSE 293,001,119111,Bafna; Vineet,9999,0,9999,0
1668501368212,CSE 293,002,119118,Bellare; Mihir,9999,0,9999,0
1668501368212,CSE 293,003,119122,Berg-Kirkpatrick; Taylor D,9999,0,9999,0
1668501368212,CSE 293,004,119135,Christensen; Henrik I,9999,0,9999,0
1668501368212,CSE 293,005,119142,Cottrell; Garrison W,9999,0,9999,0
1668501368212,CSE 293,006,119146,Deutsch; Alin Bernard,9999,0,9999,0
1668501368212,CSE 293,007,119159,Esmaeilzadeh; Hadi,9999,0,9999,0
1668501368212,CSE 293,008,119166,Freund; Yoav,9999,0,9999,0
1668501368212,CSE 293,009,119170,Griswold; William G.,9999,0,9999,0
1668501368212,CSE 293,010,119183,Gymrek; Melissa Ann,9999,0,9999,0
1668501368212,CSE 293,011,119190,Heninger; Nadia A,9999,0,9999,0
1668501368212,CSE 293,012,119230,Impagliazzo; Russell,9999,0,9999,0
1668501368212,CSE 293,013,119232,Jhala; Ranjit,9999,0,9999,0
1668501368212,CSE 293,014,119233,Kahng; Andrew Byun,9999,0,9999,0
1668501368212,CSE 293,015,119298,Kane; Daniel Mertz,9999,0,9999,0
1668501368212,CSE 293,016,119299,Kriegman; David J,9999,0,9999,0
1668501368212,CSE 293,017,119300,Kumar; Arun Kumar,9999,0,9999,0
1668501368212,CSE 293,018,119301,Lerner; Sorin,9999,0,9999,0
1668501368212,CSE 293,019,119302,Lovett; Shachar,9999,0,9999,0
1668501368212,CSE 293,020,119303,McAuley; Julian John,9999,0,9999,0
1668501368212,CSE 293,021,119304,Micciancio; Daniele,9999,0,9999,0
1668501368212,CSE 293,022,119367,Orailoglu; Alex,9999,0,9999,0
1668501368212,CSE 293,023,119382,Paturi; Ramamohan,9999,0,9999,0
1668501368212,CSE 293,024,119404,Polikarpova; Nadezhda,9999,0,9999,0
1668501368212,CSE 293,025,119406,Politz; Joseph Gibbs,9999,0,9999,0
1668501368212,CSE 293,026,119411,Porter; George M,9999,0,9999,0
1668501368212,CSE 293,027,119414,Porter; Leonard Emerson,9999,0,9999,0
1668501368212,CSE 293,028,119416,Ramamoorthi; Ravi,9999,0,9999,0
1668501368212,CSE 293,029,119417,Sahoo; Debashis,9999,0,9999,0
1668501368212,CSE 293,030,119420,Saul; Lawrence,9999,0,9999,0
1668501368212,CSE 293,031,119421,Savage; Stefan,9999,0,9999,0
1668501368212,CSE 293,032,119425,Schulze; Jurgen P.,9999,0,9999,0
1668501368212,CSE 293,033,119426,Snoeren; Alex C.,9999,0,9999,0
1668501368212,CSE 293,034,119428,Shang; Jingbo,9999,0,9999,0
1668501368212,CSE 293,035,119430,Stefan; Deian,9999,0,9999,0
1668501368212,CSE 293,036,119431,Su; Hao,9999,0,9999,0
1668501368212,CSE 293,037,119433,Swanson; Steven James,9999,0,9999,0
1668501368212,CSE 293,038,119435,Tullsen; Dean Michael,9999,0,9999,0
1668501368212,CSE 293,039,119483,Voelker; Geoffrey M.,9999,0,9999,0
1668501368212,CSE 293,040,119537,Zhao; Jishen,9999,0,9999,0
1668501368212,CSE 293,041,119538,Zhou; Yuan-Yuan,9999,0,9999,0
1668501368212,CSE 293,042,119539,Gao; Sicun,9999,0,9999,0
1668501368212,CSE 293,043,119540,Weibel; Nadir,9999,0,9999,0
1668501368212,CSE 293,044,119541,Gupta; Rajesh K.,9999,0,9999,0
1668501368212,CSE 293,045,126410,Vaccaro; Kristen Marie,9999,0,9999,0
1668501368212,CSE 293,046,126411,Klemke; Richard,9999,0,9999,0
1668501368648,CSE 294,A00,102459,Voelker; Geoffrey M.,0,2,0,0
1668501368648,CSE 294,B00,111322,Orailoglu; Alex,0,2,0,0
1668501369073,DSE 201,A00,096914,Deutsch; Alin Bernard,30,0,30,0
1668501369497,DSE 210,A00,096915,Dasgupta; Sanjoy,30,0,30,0
1668501369934,DSE 260A,A00,096916,Altintas De Callaf; Ilkay,30,0,30,0
1668501370389,ECE 200,001,103586,Antipa; Nicholas A,9999,0,9999,0
1668501370389,ECE 200,002,103587,Atanasov; Nikolay A.,9999,0,9999,0
1668501370389,ECE 200,003,103588,Bharadia; Dinesh,9999,0,9999,0
1668501370389,ECE 200,004,103589,Cheng; Chung Kuan,9999,0,9999,0
1668501370389,ECE 200,005,103590,Cosman; Pamela C.,9999,0,9999,0
1668501370389,ECE 200,006,103591,Dayeh; Shadi Ahmad,9999,0,9999,0
1668501370389,ECE 200,007,103592,Fainman; Yeshaiahu,9999,0,9999,0
1668501370389,ECE 200,008,103593,Ford; Joseph Earl,9999,0,9999,0
1668501370389,ECE 200,009,103594,Franceschetti; Massimo,9999,0,9999,0
1668501370389,ECE 200,010,103595,Fullerton; Eric E,9999,0,9999,0
1668501370389,ECE 200,011,103596,Galton; Ian A,9999,0,9999,0
1668501370389,ECE 200,012,103597,Gilja; Vikash,9999,0,9999,0
1668501370389,ECE 200,013,103598,Hall; Drew A.,9999,0,9999,0
1668501370389,ECE 200,014,103599,Hsueh; Tzu-Chien,9999,0,9999,0
1668501370389,ECE 200,015,103600,Javidi; Tara,9999,0,9999,0
1668501370389,ECE 200,016,103601,Kahng; Andrew Byun,9999,0,9999,0
1668501370389,ECE 200,017,103602,Kim; Young-Han,9999,0,9999,0
1668501370389,ECE 200,018,103603,Koushanfar; Farinaz,9999,0,9999,0
1668501370389,ECE 200,019,103604,Kuzum; Duygu,9999,0,9999,0
1668501370389,ECE 200,020,103605,Le; Hanh-Phuc,9999,0,9999,0
1668501370389,ECE 200,021,103606,Lin; Bill,9999,0,9999,0
1668501370389,ECE 200,022,103607,Liu; Zhaowei,9998,0,9999,1
1668501370389,ECE 200,023,103608,Lo; Yu-Hwa,9999,0,9999,0
1668501370389,ECE 200,024,103609,Lomakin; Vitaliy,9999,0,9999,0
1668501370389,ECE 200,025,103610,Mercier; Patrick Philip,9999,0,9999,0
1668501370389,ECE 200,026,103611,Meyer; Florian,9999,0,9999,0
1668501370389,ECE 200,027,103612,Milstein; Laurence B.,9999,0,9999,0
1668501370389,ECE 200,028,103613,Mir Arabbaygi; Siavash,9999,0,9999,0
1668501370389,ECE 200,029,103614,Mookherjea; Shayan,9999,0,9999,0
1668501370389,ECE 200,030,103615,Morris; Karcher William,9999,0,9999,0
1668501370389,ECE 200,031,103616,Ng; Tse Nga,9999,0,9999,0
1668501370389,ECE 200,032,103617,Nguyen; Truong Quang,9999,0,9999,0
1668501370389,ECE 200,033,103618,Nomura; Kenji,9999,0,9999,0
1668501370389,ECE 200,034,103619,Orlitsky; Alon,9999,0,9999,0
1668501370389,ECE 200,035,103620,Pal; Piya,9999,0,9999,0
1668501370389,ECE 200,036,103621,Papen; George C.,9999,0,9999,0
1668501370389,ECE 200,037,103622,Radic; Stojan,9999,0,9999,0
1668501370389,ECE 200,038,103623,Rao; Bhaskar D.,9999,0,9999,0
1668501370389,ECE 200,039,103624,Rao; Ramesh R,9999,0,9999,0
1668501370389,ECE 200,040,103625,Rebeiz; Gabriel,9999,0,9999,0
1668501370389,ECE 200,041,103626,Sanford; John R,9999,0,9999,0
1668501370389,ECE 200,042,103627,Siegel; Paul H.,9999,0,9999,0
1668501370389,ECE 200,043,103628,Sievenpiper; Daniel F.,9999,0,9999,0
1668501370389,ECE 200,044,103629,Sworder; David D.,9999,0,9999,0
1668501370389,ECE 200,045,103630,Taur; Yuan,9999,0,9999,0
1668501370389,ECE 200,046,103631,Touri; Behrouz,9999,0,9999,0
1668501370389,ECE 200,047,103632,Trivedi; Mohan M.,9999,0,9999,0
1668501370389,ECE 200,048,103633,Vasconcelos; Nuno,9999,0,9999,0
1668501370389,ECE 200,049,103634,Wang; Xiaolong,9999,0,9999,0
1668501370389,ECE 200,050,103635,Xie; Pengtao,9999,0,9999,0
1668501370389,ECE 200,051,103636,Yip; Michael,9999,0,9999,0
1668501370389,ECE 200,052,103637,Zeger; Kenneth A.,999,0,999,0
1668501370389,ECE 200,053,103638,Zhang; Xinyu,9999,0,9999,0
1668501370389,ECE 200,054,103639,Turakhia; Yatish Girish,9999,0,9999,0
1668501370389,ECE 200,055,103640,Kang; Mingu,9999,0,9999,0
1668501370389,ECE 200,056,103641,Shi; Yuanyuan,9999,0,9999,0
1668501370389,ECE 200,057,103642,Wang; Edward Jay,9999,0,9999,0
1668501370389,ECE 200,058,103643,Zheng; Yang,9999,0,9999,0
1668501370819,ECE 202,A00,103644,Kuzum; Duygu,0,44,0,0
1668501371251,ECE 212BN,A00,103646,Ng; Tse Nga,0,9,0,0
1668501371681,ECE 221,A00,111493,Staff,0,0,0,0
1668501372105,ECE 222B,A00,103647,Lomakin; Vitaliy,0,19,0,0
1668501372534,ECE 230B,A00,103648,Taur; Yuan,0,3,0,0
1668501372958,ECE 238B,A00,103649,Garay; Javier,0,0,0,0
1668501373381,ECE 240B,A00,112900,Fainman; Yeshaiahu,0,7,0,0
1668501373809,ECE 247A,A00,103650,Jokerst; Jesse Vincent,0,6,0,0
1668501374240,ECE 247B,A00,103651,Wang; Joseph,0,14,0,0
1668501374672,ECE 250,A00,103652,Siegel; Paul H.,0,82,0,0
1668501375097,ECE 251A,A00,103654,Rao; Bhaskar D.,0,61,0,0
1668501375522,ECE 257B,A00,103655,Bharadia; Dinesh,0,32,0,0
1668501375946,ECE 258A,A00,103656,Milstein; Laurence B.,0,29,0,0
1668501376374,ECE 260B,A00,103658,Kang; Mingu,0,119,0,0
1668501376798,ECE 264A,A00,103659,Galton; Ian A,0,65,0,0
1668501377222,ECE 265A,A00,103661,Gudem; Prasad S.S.,0,70,0,0
1668501377648,ECE 265D,A00,103662,Gudem; Prasad S.S.,0,25,0,0
1668501378074,ECE 268,A00,103663,Koushanfar; Farinaz,0,42,0,0
1668501378498,ECE 269,A01,103665,Pal; Piya,0,215,0,0
1668501378928,ECE 271B,A00,103666,Vasconcelos; Manuela,0,76,0,0
1668501379353,ECE 276A,A00,103667,Atanasov; Nikolay A.,0,125,0,0
1668501379779,ECE 277,A00,103668,An; Cheolhong,0,148,0,0
1668501380209,ECE 279,A00,117947,Hall; Drew A.,0,22,0,0
1668501381071,ECE 283,A00,103670,Hsueh; Tzu-Chien,0,52,0,0
1668501381496,ECE 284,A00,103671,Turakhia; Yatish Girish,0,39,0,0
1668501381922,ECE 285,A00,103672,Zheng; Yang,0,39,0,0
1668501381922,ECE 285,B00,103673,Sworder; David D.,0,57,0,0
1668501382347,ECE 287,A00,103676,Javidi; Tara,0,9,0,0
1668501382776,MATH 200B,A00,098023,Salehi Golsefidy; Alireza,10,0,15,5
1668501383209,MATH 202B,A00,098024,Rhoades; Brendon Patrick,7,0,15,8
1668501383639,MATH 203B,A00,098025,Oprea; Dragos N.,9,0,15,6
1668501384067,MATH 204B,A00,098026,Sorensen; Claus M,13,0,15,2
1668501384498,MATH 208,A00,098027,Izadi; Elham,7,0,10,3
1668501384922,MATH 209,A00,098028,Pollack; Aaron,10,0,10,0
1668501385347,MATH 211A,A00,112919,Rogalski; Daniel,8,0,10,2
1668501385774,MATH 211B,A00,112920,Seward; Brandon M.,9,0,10,1
1668501386200,MATH 218,A00,098029,Li; Bo,10,0,10,0
1668501386623,MATH 220B,A00,098030,Novak; Jonathan I,11,0,15,4
1668501387053,MATH 221A,A00,098031,Ebenfelt; Peter F,12,0,15,3
1668501387479,MATH 231B,A00,098032,Zlatos; Andrej,11,0,15,4
1668501387905,MATH 240B,A00,098033,Ni; Lei,7,0,15,8
1668501388330,MATH 243,A00,098034,Jekel; David Andrew,10,0,10,0
1668501388759,MATH 245A,A00,098035,Nie; Jiawang,0,4,15,18
1668501389187,MATH 248,A00,098036,Bejenaru; Ioan,10,0,10,0
1668501389612,MATH 250B,A00,098037,Spolaor; Luca,14,0,15,1
1668501390038,MATH 258,A00,098038,Ni; Lei,9,0,10,1
1668501390463,MATH 264B,A00,098041,Rhoades; Brendon Patrick,8,0,15,7
1668501390895,MATH 268,A00,098042,Buss; Samuel R,10,0,10,0
1668501391320,MATH 269,A00,098043,Rhoades; Brendon Patrick,10,0,10,0
1668501391761,MATH 270B,A00,098044,Li; Bo,6,0,15,9
1668501392190,MATH 272B,A00,098045,Holst; Michael J,13,0,15,2
1668501392616,MATH 273A,A00,098046,Tian; Xiaochuan,10,0,15,5
1668501393042,MATH 275,A01,098048,Tian; Xiaochuan,6,0,10,4
1668501393466,MATH 278A,A00,098049,Holst; Michael J,7,0,10,3
1668501393891,MATH 278B,A00,098050,Cloninger; Alexander,10,0,10,0
1668501394316,MATH 278C,A00,098051,Nie; Jiawang,5,0,10,5
1668501394743,MATH 280B,A00,098052,Zheng; Tianyi,7,0,15,8
1668501395167,MATH 281B,A00,098053,Bradic; Jelena,0,2,15,15
1668501395596,MATH 282B,A00,098054,Arias-Castro; Ery,0,1,15,15
1668501396021,MATH 285,A00,098055,Fitzsimmons; Patrick J,0,3,15,17
1668501396446,MATH 287B,A00,098056,Arias-Castro; Ery,1,0,15,14
1668501396887,MATH 288,A00,098057,Agarwal; Pooja,9,0,10,1
1668501396887,MATH 288,B00,098058,Zhang; Danna,8,0,10,2
1668501396887,MATH 288,C00,098059,Williams; Ruth J,9,0,10,1
1668501397316,MATH 290B,A00,098060,Roberts; Justin Deritter,12,0,15,3
1668501397741,MATH 292,A00,098061,Belmont; Eva Kinoshita,10,0,10,0
1668501398167,MATH 295,A00,098062,Suk; Andrew Hoon,47,0,50,3
1668501398593,MATH 296,A00,098063,Novak; Jonathan I,20,0,20,0
1668501399018,MATH 297,001,098064,Gamst; Anthony Collins,9997,0,9999,2
1668501901675,COGS 205,A00,101395,Chiba; Andrea,19,0,20,1
1668501902117,COGS 210B,001,101404,Greene; Deanna Jacquelyn,9998,0,9999,1
1668501902117,COGS 210B,002,101417,Xia; Haijun,9999,0,9999,0
1668501902117,COGS 210B,003,101422,Nitz; Douglas A.,9999,0,9999,0
1668501902117,COGS 210B,004,101423,Hollan; James D.,9998,0,9999,1
1668501902117,COGS 210B,005,101424,Deak; Gedeon O.,9998,0,9999,1
1668501902117,COGS 210B,006,101425,Rossano; Federico,9999,0,9999,0
1668501902545,COGS 211B,A00,101427,Coulson; Seana M,9996,0,9999,3
1668501902980,COGS 220,A00,101428,Hollan; James D.,0,10,25,25
1668501903407,COGS 229,A00,101429,Dow; Steven P,17,0,25,8
1668501903833,COGS 230,A00,101430,Klemmer; Scott R,7,0,17,10
1668501904274,COGS 234,A00,101431,Xia; Haijun,1,0,25,24
1668501904702,COGS 260,A00,101432,Kiyonaga; Anastasia,21,0,25,4
1668501904702,COGS 260,B00,101433,Kirsh; David Joel,15,0,25,10
1668501905130,CSE 202,A00,102371,Impagliazzo; Russell,0,65,0,0
1668501905554,CSE 203B,A01,102373,Cheng; Chung Kuan,0,58,0,0
1668501905981,CSE 208,A00,102374,Micciancio; Daniele,0,5,0,0
1668501906412,CSE 209A,A00,112895,Impagliazzo; Russell,0,12,15,15
1668501906839,CSE 209B,A00,108005,Bellare; Mihir,0,7,0,0
1668501907272,CSE 210,A00,113163,Coblenz; Michael J,0,83,0,0
1668501907698,CSE 219,A00,106111,Dow; Steven P,0,6,20,20
1668501908125,CSE 221,A00,102376,Voelker; Geoffrey M.,0,72,0,0
1668501908563,CSE 224,A01,102378,Porter; George M,0,164,0,0
1668501909004,CSE 229A,A00,102379,Savage; Stefan,0,10,0,0
1668501909440,CSE 229C,A00,102380,Munyaka; Imani N. S.,0,10,0,0
1668501909868,CSE 232B,A00,102382,Deutsch; Alin Bernard,0,32,0,0
1668501910293,CSE 234,A01,112904,Kumar; Arun Kumar,0,0,0,0
1668501910724,CSE 237A,A00,102383,Rosing; Tajana Simunic,0,55,0,0
1668501911150,CSE 239A,A00,102384,Deutsch; Alin Bernard,0,14,0,0
1668501911580,CSE 239B,A00,102385,Polikarpova; Nadezhda,0,10,0,0
1668501912006,CSE 240A,A00,102386,Pannuto; Patrick William,0,46,0,0
1668501912433,CSE 240B,A00,102387,Zhao; Jishen,0,47,0,0
1668501912857,CSE 241A,A00,106406,Kang; Mingu,0,9,0,0
1668501913283,CSE 249B,A00,102388,Kahng; Andrew Byun,0,5,8,8
1668501913714,CSE 251B,A01,102392,Cottrell; Garrison W,0,51,0,0
1668501913714,CSE 251B,A02,102393,Cottrell; Garrison W,0,34,0,0
1668501914141,CSE 252B,A00,102394,Ochoa; Benjamin Lawrence,0,59,0,0
1668501914569,CSE 257,A01,102396,Gao; Sicun,0,138,0,0
1668501914995,CSE 272,A00,102397,Li; Tzumao,0,19,0,0
1668501915423,CSE 274,A00,111323,Chern; Albert Ren-Haur,0,15,0,0
1668501915849,CSE 282,A00,102398,Pevzner; Pavel Arkadjevich,0,0,0,0
1668501916274,CSE 284,A00,114175,Gymrek; Melissa Ann,0,22,0,0
1668501916702,CSE 290,A00,102399,Chandraker; Manmohan Krishna,0,11,0,0
1668501916702,CSE 290,B00,102400,Vaccaro; Kristen Marie,0,7,25,25
1668501916702,CSE 290,C00,102414,Pannuto; Patrick William,0,1,25,25
1668501916702,CSE 290,D00,102427,Pevzner; Pavel Arkadjevich,0,0,0,0
1668501916702,CSE 290,E00,102429,Zhao; Jishen,0,4,0,0
1668501916702,CSE 290,F00,102436,Tullsen; Dean Michael,0,5,0,0
1668501916702,CSE 290,G00,102440,Christensen; Henrik I,0,6,20,20
1668501917135,CSE 291,A00,102443,Su; Hao,0,0,0,0
1668501917135,CSE 291,B00,102448,Polikarpova; Nadezhda,0,0,0,0
1668501917135,CSE 291,C00,102453,Vaccaro; Kristen Marie,0,0,0,0
1668501917135,CSE 291,D00,111343,Savage; Stefan,0,0,0,0
1668501917135,CSE 291,E00,116474,Claffy; Kimberly Claire,0,0,0,0
1668501917135,CSE 291,F00,116479,Pasquale; Joseph,0,0,0,0
1668501917579,CSE 293,001,119111,Bafna; Vineet,9999,0,9999,0
1668501917579,CSE 293,002,119118,Bellare; Mihir,9999,0,9999,0
1668501917579,CSE 293,003,119122,Berg-Kirkpatrick; Taylor D,9999,0,9999,0
1668501917579,CSE 293,004,119135,Christensen; Henrik I,9999,0,9999,0
1668501917579,CSE 293,005,119142,Cottrell; Garrison W,9999,0,9999,0
1668501917579,CSE 293,006,119146,Deutsch; Alin Bernard,9999,0,9999,0
1668501917579,CSE 293,007,119159,Esmaeilzadeh; Hadi,9999,0,9999,0
1668501917579,CSE 293,008,119166,Freund; Yoav,9999,0,9999,0
1668501917579,CSE 293,009,119170,Griswold; William G.,9999,0,9999,0
1668501917579,CSE 293,010,119183,Gymrek; Melissa Ann,9999,0,9999,0
1668501917579,CSE 293,011,119190,Heninger; Nadia A,9999,0,9999,0
1668501917579,CSE 293,012,119230,Impagliazzo; Russell,9999,0,9999,0
1668501917579,CSE 293,013,119232,Jhala; Ranjit,9999,0,9999,0
1668501917579,CSE 293,014,119233,Kahng; Andrew Byun,9999,0,9999,0
1668501917579,CSE 293,015,119298,Kane; Daniel Mertz,9999,0,9999,0
1668501917579,CSE 293,016,119299,Kriegman; David J,9999,0,9999,0
1668501917579,CSE 293,017,119300,Kumar; Arun Kumar,9999,0,9999,0
1668501917579,CSE 293,018,119301,Lerner; Sorin,9999,0,9999,0
1668501917579,CSE 293,019,119302,Lovett; Shachar,9999,0,9999,0
1668501917579,CSE 293,020,119303,McAuley; Julian John,9999,0,9999,0
1668501917579,CSE 293,021,119304,Micciancio; Daniele,9999,0,9999,0
1668501917579,CSE 293,022,119367,Orailoglu; Alex,9999,0,9999,0
1668501917579,CSE 293,023,119382,Paturi; Ramamohan,9999,0,9999,0
1668501917579,CSE 293,024,119404,Polikarpova; Nadezhda,9999,0,9999,0
1668501917579,CSE 293,025,119406,Politz; Joseph Gibbs,9999,0,9999,0
1668501917579,CSE 293,026,119411,Porter; George M,9999,0,9999,0
1668501917579,CSE 293,027,119414,Porter; Leonard Emerson,9999,0,9999,0
1668501917579,CSE 293,028,119416,Ramamoorthi; Ravi,9999,0,9999,0
1668501917579,CSE 293,029,119417,Sahoo; Debashis,9999,0,9999,0
1668501917579,CSE 293,030,119420,Saul; Lawrence,9999,0,9999,0
1668501917579,CSE 293,031,119421,Savage; Stefan,9999,0,9999,0
1668501917579,CSE 293,032,119425,Schulze; Jurgen P.,9999,0,9999,0
1668501917579,CSE 293,033,119426,Snoeren; Alex C.,9999,0,9999,0
1668501917579,CSE 293,034,119428,Shang; Jingbo,9999,0,9999,0
1668501917579,CSE 293,035,119430,Stefan; Deian,9999,0,9999,0
1668501917579,CSE 293,036,119431,Su; Hao,9999,0,9999,0
1668501917579,CSE 293,037,119433,Swanson; Steven James,9999,0,9999,0
1668501917579,CSE 293,038,119435,Tullsen; Dean Michael,9999,0,9999,0
1668501917579,CSE 293,039,119483,Voelker; Geoffrey M.,9999,0,9999,0
1668501917579,CSE 293,040,119537,Zhao; Jishen,9999,0,9999,0
1668501917579,CSE 293,041,119538,Zhou; Yuan-Yuan,9999,0,9999,0
1668501917579,CSE 293,042,119539,Gao; Sicun,9999,0,9999,0
1668501917579,CSE 293,043,119540,Weibel; Nadir,9999,0,9999,0
1668501917579,CSE 293,044,119541,Gupta; Rajesh K.,9999,0,9999,0
1668501917579,CSE 293,045,126410,Vaccaro; Kristen Marie,9999,0,9999,0
1668501917579,CSE 293,046,126411,Klemke; Richard,9999,0,9999,0
1668501918006,CSE 294,A00,102459,Voelker; Geoffrey M.,0,2,0,0
1668501918006,CSE 294,B00,111322,Orailoglu; Alex,0,2,0,0
1668501918431,DSE 201,A00,096914,Deutsch; Alin Bernard,30,0,30,0
1668501918855,DSE 210,A00,096915,Dasgupta; Sanjoy,30,0,30,0
1668501919280,DSE 260A,A00,096916,Altintas De Callaf; Ilkay,30,0,30,0
1668501919736,ECE 200,001,103586,Antipa; Nicholas A,9999,0,9999,0
1668501919736,ECE 200,002,103587,Atanasov; Nikolay A.,9999,0,9999,0
1668501919736,ECE 200,003,103588,Bharadia; Dinesh,9999,0,9999,0
1668501919736,ECE 200,004,103589,Cheng; Chung Kuan,9999,0,9999,0
1668501919736,ECE 200,005,103590,Cosman; Pamela C.,9999,0,9999,0
1668501919736,ECE 200,006,103591,Dayeh; Shadi Ahmad,9999,0,9999,0
1668501919736,ECE 200,007,103592,Fainman; Yeshaiahu,9999,0,9999,0
1668501919736,ECE 200,008,103593,Ford; Joseph Earl,9999,0,9999,0
1668501919736,ECE 200,009,103594,Franceschetti; Massimo,9999,0,9999,0
1668501919736,ECE 200,010,103595,Fullerton; Eric E,9999,0,9999,0
1668501919736,ECE 200,011,103596,Galton; Ian A,9999,0,9999,0
1668501919736,ECE 200,012,103597,Gilja; Vikash,9999,0,9999,0
1668501919736,ECE 200,013,103598,Hall; Drew A.,9999,0,9999,0
1668501919736,ECE 200,014,103599,Hsueh; Tzu-Chien,9999,0,9999,0
1668501919736,ECE 200,015,103600,Javidi; Tara,9999,0,9999,0
1668501919736,ECE 200,016,103601,Kahng; Andrew Byun,9999,0,9999,0
1668501919736,ECE 200,017,103602,Kim; Young-Han,9999,0,9999,0
1668501919736,ECE 200,018,103603,Koushanfar; Farinaz,9999,0,9999,0
1668501919736,ECE 200,019,103604,Kuzum; Duygu,9999,0,9999,0
1668501919736,ECE 200,020,103605,Le; Hanh-Phuc,9999,0,9999,0
1668501919736,ECE 200,021,103606,Lin; Bill,9999,0,9999,0
1668501919736,ECE 200,022,103607,Liu; Zhaowei,9998,0,9999,1
1668501919736,ECE 200,023,103608,Lo; Yu-Hwa,9999,0,9999,0
1668501919736,ECE 200,024,103609,Lomakin; Vitaliy,9999,0,9999,0
1668501919736,ECE 200,025,103610,Mercier; Patrick Philip,9999,0,9999,0
1668501919736,ECE 200,026,103611,Meyer; Florian,9999,0,9999,0
1668501919736,ECE 200,027,103612,Milstein; Laurence B.,9999,0,9999,0
1668501919736,ECE 200,028,103613,Mir Arabbaygi; Siavash,9999,0,9999,0
1668501919736,ECE 200,029,103614,Mookherjea; Shayan,9999,0,9999,0
1668501919736,ECE 200,030,103615,Morris; Karcher William,9999,0,9999,0
1668501919736,ECE 200,031,103616,Ng; Tse Nga,9999,0,9999,0
1668501919736,ECE 200,032,103617,Nguyen; Truong Quang,9999,0,9999,0
1668501919736,ECE 200,033,103618,Nomura; Kenji,9999,0,9999,0
1668501919736,ECE 200,034,103619,Orlitsky; Alon,9999,0,9999,0
1668501919736,ECE 200,035,103620,Pal; Piya,9999,0,9999,0
1668501919736,ECE 200,036,103621,Papen; George C.,9999,0,9999,0
1668501919736,ECE 200,037,103622,Radic; Stojan,9999,0,9999,0
1668501919736,ECE 200,038,103623,Rao; Bhaskar D.,9999,0,9999,0
1668501919736,ECE 200,039,103624,Rao; Ramesh R,9999,0,9999,0
1668501919736,ECE 200,040,103625,Rebeiz; Gabriel,9999,0,9999,0
1668501919736,ECE 200,041,103626,Sanford; John R,9999,0,9999,0
1668501919736,ECE 200,042,103627,Siegel; Paul H.,9999,0,9999,0
1668501919736,ECE 200,043,103628,Sievenpiper; Daniel F.,9999,0,9999,0
1668501919736,ECE 200,044,103629,Sworder; David D.,9999,0,9999,0
1668501919736,ECE 200,045,103630,Taur; Yuan,9999,0,9999,0
1668501919736,ECE 200,046,103631,Touri; Behrouz,9999,0,9999,0
1668501919736,ECE 200,047,103632,Trivedi; Mohan M.,9999,0,9999,0
1668501919736,ECE 200,048,103633,Vasconcelos; Nuno,9999,0,9999,0
1668501919736,ECE 200,049,103634,Wang; Xiaolong,9999,0,9999,0
1668501919736,ECE 200,050,103635,Xie; Pengtao,9999,0,9999,0
1668501919736,ECE 200,051,103636,Yip; Michael,9999,0,9999,0
1668501919736,ECE 200,052,103637,Zeger; Kenneth A.,999,0,999,0
1668501919736,ECE 200,053,103638,Zhang; Xinyu,9999,0,9999,0
1668501919736,ECE 200,054,103639,Turakhia; Yatish Girish,9999,0,9999,0
1668501919736,ECE 200,055,103640,Kang; Mingu,9999,0,9999,0
1668501919736,ECE 200,056,103641,Shi; Yuanyuan,9999,0,9999,0
1668501919736,ECE 200,057,103642,Wang; Edward Jay,9999,0,9999,0
1668501919736,ECE 200,058,103643,Zheng; Yang,9999,0,9999,0
1668501920162,ECE 202,A00,103644,Kuzum; Duygu,0,44,0,0
1668501920588,ECE 212BN,A00,103646,Ng; Tse Nga,0,9,0,0
1668501921021,ECE 221,A00,111493,Staff,0,0,0,0
1668501921446,ECE 222B,A00,103647,Lomakin; Vitaliy,0,19,0,0
1668501921872,ECE 230B,A00,103648,Taur; Yuan,0,3,0,0
1668501922313,ECE 238B,A00,103649,Garay; Javier,0,0,0,0
1668501922738,ECE 240B,A00,112900,Fainman; Yeshaiahu,0,7,0,0
1668501923166,ECE 247A,A00,103650,Jokerst; Jesse Vincent,0,6,0,0
1668501923604,ECE 247B,A00,103651,Wang; Joseph,0,14,0,0
1668501924046,ECE 250,A00,103652,Siegel; Paul H.,0,82,0,0
1668501924474,ECE 251A,A00,103654,Rao; Bhaskar D.,0,61,0,0
1668501924902,ECE 257B,A00,103655,Bharadia; Dinesh,0,32,0,0
1668501925335,ECE 258A,A00,103656,Milstein; Laurence B.,0,29,0,0
1668501925772,ECE 260B,A00,103658,Kang; Mingu,0,119,0,0
1668501926198,ECE 264A,A00,103659,Galton; Ian A,0,65,0,0
1668501926622,ECE 265A,A00,103661,Gudem; Prasad S.S.,0,70,0,0
1668501927055,ECE 265D,A00,103662,Gudem; Prasad S.S.,0,25,0,0
1668501927479,ECE 268,A00,103663,Koushanfar; Farinaz,0,42,0,0
1668501927906,ECE 269,A01,103665,Pal; Piya,0,215,0,0
1668501928331,ECE 271B,A00,103666,Vasconcelos; Manuela,0,76,0,0
1668501928862,ECE 276A,A00,103667,Atanasov; Nikolay A.,0,125,0,0
1668501929288,ECE 277,A00,103668,An; Cheolhong,0,148,0,0
1668501929713,ECE 279,A00,117947,Hall; Drew A.,0,22,0,0
1668501930575,ECE 283,A00,103670,Hsueh; Tzu-Chien,0,53,0,0
1668501931003,ECE 284,A00,103671,Turakhia; Yatish Girish,0,39,0,0
1668501931433,ECE 285,A00,103672,Zheng; Yang,0,39,0,0
1668501931433,ECE 285,B00,103673,Sworder; David D.,0,57,0,0
1668501931858,ECE 287,A00,103676,Javidi; Tara,0,9,0,0
1668501932289,MATH 200B,A00,098023,Salehi Golsefidy; Alireza,10,0,15,5
1668501932716,MATH 202B,A00,098024,Rhoades; Brendon Patrick,7,0,15,8
1668501933142,MATH 203B,A00,098025,Oprea; Dragos N.,9,0,15,6
1668501933575,MATH 204B,A00,098026,Sorensen; Claus M,13,0,15,2
1668501934030,MATH 208,A00,098027,Izadi; Elham,7,0,10,3
1668501934455,MATH 209,A00,098028,Pollack; Aaron,10,0,10,0
1668501934887,MATH 211A,A00,112919,Rogalski; Daniel,8,0,10,2
1668501935311,MATH 211B,A00,112920,Seward; Brandon M.,9,0,10,1
1668501935735,MATH 218,A00,098029,Li; Bo,10,0,10,0
1668501936161,MATH 220B,A00,098030,Novak; Jonathan I,11,0,15,4
1668501936589,MATH 221A,A00,098031,Ebenfelt; Peter F,12,0,15,3
1668501937017,MATH 231B,A00,098032,Zlatos; Andrej,11,0,15,4
1668501937448,MATH 240B,A00,098033,Ni; Lei,7,0,15,8
1668501937874,MATH 243,A00,098034,Jekel; David Andrew,10,0,10,0
1668501938303,MATH 245A,A00,098035,Nie; Jiawang,0,4,15,18
1668501938730,MATH 248,A00,098036,Bejenaru; Ioan,10,0,10,0
1668501939160,MATH 250B,A00,098037,Spolaor; Luca,14,0,15,1
1668501939587,MATH 258,A00,098038,Ni; Lei,9,0,10,1
1668501940015,MATH 264B,A00,098041,Rhoades; Brendon Patrick,8,0,15,7
1668501940443,MATH 268,A00,098042,Buss; Samuel R,10,0,10,0
1668501940871,MATH 269,A00,098043,Rhoades; Brendon Patrick,10,0,10,0
1668501941299,MATH 270B,A00,098044,Li; Bo,6,0,15,9
1668501941730,MATH 272B,A00,098045,Holst; Michael J,13,0,15,2
1668501942160,MATH 273A,A00,098046,Tian; Xiaochuan,10,0,15,5
1668501942588,MATH 275,A01,098048,Tian; Xiaochuan,6,0,10,4
1668501943025,MATH 278A,A00,098049,Holst; Michael J,7,0,10,3
1668501943453,MATH 278B,A00,098050,Cloninger; Alexander,10,0,10,0
1668501943882,MATH 278C,A00,098051,Nie; Jiawang,5,0,10,5
1668501944310,MATH 280B,A00,098052,Zheng; Tianyi,7,0,15,8
1668501944735,MATH 281B,A00,098053,Bradic; Jelena,0,2,15,15
1668501945159,MATH 282B,A00,098054,Arias-Castro; Ery,0,1,15,15
1668501945583,MATH 285,A00,098055,Fitzsimmons; Patrick J,0,3,15,17
1668501946010,MATH 287B,A00,098056,Arias-Castro; Ery,1,0,15,14
1668501946442,MATH 288,A00,098057,Agarwal; Pooja,9,0,10,1
1668501946442,MATH 288,B00,098058,Zhang; Danna,8,0,10,2
1668501946442,MATH 288,C00,098059,Williams; Ruth J,9,0,10,1
1668501946869,MATH 290B,A00,098060,Roberts; Justin Deritter,12,0,15,3
1668501947311,MATH 292,A00,098061,Belmont; Eva Kinoshita,10,0,10,0
1668501947738,MATH 295,A00,098062,Suk; Andrew Hoon,47,0,50,3
1668501948164,MATH 296,A00,098063,Novak; Jonathan I,20,0,20,0
1668501948590,MATH 297,001,098064,Gamst; Anthony Collins,9997,0,9999,2
1668502452427,COGS 205,A00,101395,Chiba; Andrea,19,0,20,1
1668502452860,COGS 210B,001,101404,Greene; Deanna Jacquelyn,9998,0,9999,1
1668502452860,COGS 210B,002,101417,Xia; Haijun,9999,0,9999,0
1668502452860,COGS 210B,003,101422,Nitz; Douglas A.,9999,0,9999,0
1668502452860,COGS 210B,004,101423,Hollan; James D.,9998,0,9999,1
1668502452860,COGS 210B,005,101424,Deak; Gedeon O.,9998,0,9999,1
1668502452860,COGS 210B,006,101425,Rossano; Federico,9999,0,9999,0
1668502453287,COGS 211B,A00,101427,Coulson; Seana M,9996,0,9999,3
1668502453715,COGS 220,A00,101428,Hollan; James D.,0,10,25,25
1668502454139,COGS 229,A00,101429,Dow; Steven P,17,0,25,8
1668502454565,COGS 230,A00,101430,Klemmer; Scott R,7,0,17,10
1668502454989,COGS 234,A00,101431,Xia; Haijun,1,0,25,24
1668502455416,COGS 260,A00,101432,Kiyonaga; Anastasia,21,0,25,4
1668502455416,COGS 260,B00,101433,Kirsh; David Joel,15,0,25,10
1668502455841,CSE 202,A00,102371,Impagliazzo; Russell,0,65,0,0
1668502456266,CSE 203B,A01,102373,Cheng; Chung Kuan,0,58,0,0
1668502456691,CSE 208,A00,102374,Micciancio; Daniele,0,5,0,0
1668502457134,CSE 209A,A00,112895,Impagliazzo; Russell,0,12,15,15
1668502457558,CSE 209B,A00,108005,Bellare; Mihir,0,7,0,0
1668502457987,CSE 210,A00,113163,Coblenz; Michael J,0,83,0,0
1668502458414,CSE 219,A00,106111,Dow; Steven P,0,6,20,20
1668502458843,CSE 221,A00,102376,Voelker; Geoffrey M.,0,72,0,0
1668502459268,CSE 224,A01,102378,Porter; George M,0,165,0,0
1668502459695,CSE 229A,A00,102379,Savage; Stefan,0,10,0,0
1668502460121,CSE 229C,A00,102380,Munyaka; Imani N. S.,0,10,0,0
1668502460545,CSE 232B,A00,102382,Deutsch; Alin Bernard,0,32,0,0
1668502460969,CSE 234,A01,112904,Kumar; Arun Kumar,0,0,0,0
1668502461409,CSE 237A,A00,102383,Rosing; Tajana Simunic,0,55,0,0
1668502461834,CSE 239A,A00,102384,Deutsch; Alin Bernard,0,14,0,0
1668502462259,CSE 239B,A00,102385,Polikarpova; Nadezhda,0,10,0,0
1668502462686,CSE 240A,A00,102386,Pannuto; Patrick William,0,46,0,0
1668502463117,CSE 240B,A00,102387,Zhao; Jishen,0,47,0,0
1668502463548,CSE 241A,A00,106406,Kang; Mingu,0,9,0,0
1668502463980,CSE 249B,A00,102388,Kahng; Andrew Byun,0,5,8,8
1668502464406,CSE 251B,A01,102392,Cottrell; Garrison W,0,51,0,0
1668502464406,CSE 251B,A02,102393,Cottrell; Garrison W,0,34,0,0
1668502464830,CSE 252B,A00,102394,Ochoa; Benjamin Lawrence,0,59,0,0
1668502465253,CSE 257,A01,102396,Gao; Sicun,0,138,0,0
1668502465681,CSE 272,A00,102397,Li; Tzumao,0,19,0,0
1668502466107,CSE 274,A00,111323,Chern; Albert Ren-Haur,0,15,0,0
1668502466537,CSE 282,A00,102398,Pevzner; Pavel Arkadjevich,0,0,0,0
1668502466960,CSE 284,A00,114175,Gymrek; Melissa Ann,0,22,0,0
1668502467396,CSE 290,A00,102399,Chandraker; Manmohan Krishna,0,11,0,0
1668502467396,CSE 290,B00,102400,Vaccaro; Kristen Marie,0,7,25,25
1668502467396,CSE 290,C00,102414,Pannuto; Patrick William,0,1,25,25
1668502467396,CSE 290,D00,102427,Pevzner; Pavel Arkadjevich,0,0,0,0
1668502467396,CSE 290,E00,102429,Zhao; Jishen,0,4,0,0
1668502467396,CSE 290,F00,102436,Tullsen; Dean Michael,0,5,0,0
1668502467396,CSE 290,G00,102440,Christensen; Henrik I,0,6,20,20
1668502467822,CSE 291,A00,102443,Su; Hao,0,0,0,0
1668502467822,CSE 291,B00,102448,Polikarpova; Nadezhda,0,0,0,0
1668502467822,CSE 291,C00,102453,Vaccaro; Kristen Marie,0,0,0,0
1668502467822,CSE 291,D00,111343,Savage; Stefan,0,0,0,0
1668502467822,CSE 291,E00,116474,Claffy; Kimberly Claire,0,0,0,0
1668502467822,CSE 291,F00,116479,Pasquale; Joseph,0,0,0,0
1668502468266,CSE 293,001,119111,Bafna; Vineet,9999,0,9999,0
1668502468266,CSE 293,002,119118,Bellare; Mihir,9999,0,9999,0
1668502468266,CSE 293,003,119122,Berg-Kirkpatrick; Taylor D,9999,0,9999,0
1668502468266,CSE 293,004,119135,Christensen; Henrik I,9999,0,9999,0
1668502468266,CSE 293,005,119142,Cottrell; Garrison W,9999,0,9999,0
1668502468266,CSE 293,006,119146,Deutsch; Alin Bernard,9999,0,9999,0
1668502468266,CSE 293,007,119159,Esmaeilzadeh; Hadi,9999,0,9999,0
1668502468266,CSE 293,008,119166,Freund; Yoav,9999,0,9999,0
1668502468266,CSE 293,009,119170,Griswold; William G.,9999,0,9999,0
1668502468266,CSE 293,010,119183,Gymrek; Melissa Ann,9999,0,9999,0
1668502468266,CSE 293,011,119190,Heninger; Nadia A,9999,0,9999,0
1668502468266,CSE 293,012,119230,Impagliazzo; Russell,9999,0,9999,0
1668502468266,CSE 293,013,119232,Jhala; Ranjit,9999,0,9999,0
1668502468266,CSE 293,014,119233,Kahng; Andrew Byun,9999,0,9999,0
1668502468266,CSE 293,015,119298,Kane; Daniel Mertz,9999,0,9999,0
1668502468266,CSE 293,016,119299,Kriegman; David J,9999,0,9999,0
1668502468266,CSE 293,017,119300,Kumar; Arun Kumar,9999,0,9999,0
1668502468266,CSE 293,018,119301,Lerner; Sorin,9999,0,9999,0
1668502468266,CSE 293,019,119302,Lovett; Shachar,9999,0,9999,0
1668502468266,CSE 293,020,119303,McAuley; Julian John,9999,0,9999,0
1668502468266,CSE 293,021,119304,Micciancio; Daniele,9999,0,9999,0
1668502468266,CSE 293,022,119367,Orailoglu; Alex,9999,0,9999,0
1668502468266,CSE 293,023,119382,Paturi; Ramamohan,9999,0,9999,0
1668502468266,CSE 293,024,119404,Polikarpova; Nadezhda,9999,0,9999,0
1668502468266,CSE 293,025,119406,Politz; Joseph Gibbs,9999,0,9999,0
1668502468266,CSE 293,026,119411,Porter; George M,9999,0,9999,0
1668502468266,CSE 293,027,119414,Porter; Leonard Emerson,9999,0,9999,0
1668502468266,CSE 293,028,119416,Ramamoorthi; Ravi,9999,0,9999,0
1668502468266,CSE 293,029,119417,Sahoo; Debashis,9999,0,9999,0
1668502468266,CSE 293,030,119420,Saul; Lawrence,9999,0,9999,0
1668502468266,CSE 293,031,119421,Savage; Stefan,9999,0,9999,0
1668502468266,CSE 293,032,119425,Schulze; Jurgen P.,9999,0,9999,0
1668502468266,CSE 293,033,119426,Snoeren; Alex C.,9999,0,9999,0
1668502468266,CSE 293,034,119428,Shang; Jingbo,9999,0,9999,0
1668502468266,CSE 293,035,119430,Stefan; Deian,9999,0,9999,0
1668502468266,CSE 293,036,119431,Su; Hao,9999,0,9999,0
1668502468266,CSE 293,037,119433,Swanson; Steven James,9999,0,9999,0
1668502468266,CSE 293,038,119435,Tullsen; Dean Michael,9999,0,9999,0
1668502468266,CSE 293,039,119483,Voelker; Geoffrey M.,9999,0,9999,0
1668502468266,CSE 293,040,119537,Zhao; Jishen,9999,0,9999,0
1668502468266,CSE 293,041,119538,Zhou; Yuan-Yuan,9999,0,9999,0
1668502468266,CSE 293,042,119539,Gao; Sicun,9999,0,9999,0
1668502468266,CSE 293,043,119540,Weibel; Nadir,9999,0,9999,0
1668502468266,CSE 293,044,119541,Gupta; Rajesh K.,9999,0,9999,0
1668502468266,CSE 293,045,126410,Vaccaro; Kristen Marie,9999,0,9999,0
1668502468266,CSE 293,046,126411,Klemke; Richard,9999,0,9999,0
1668502468694,CSE 294,A00,102459,Voelker; Geoffrey M.,0,2,0,0
1668502468694,CSE 294,B00,111322,Orailoglu; Alex,0,2,0,0
1668502469119,DSE 201,A00,096914,Deutsch; Alin Bernard,30,0,30,0
1668502469544,DSE 210,A00,096915,Dasgupta; Sanjoy,30,0,30,0
1668502469967,DSE 260A,A00,096916,Altintas De Callaf; Ilkay,30,0,30,0
1668502470414,ECE 200,001,103586,Antipa; Nicholas A,9999,0,9999,0
1668502470414,ECE 200,002,103587,Atanasov; Nikolay A.,9999,0,9999,0
1668502470414,ECE 200,003,103588,Bharadia; Dinesh,9999,0,9999,0
1668502470414,ECE 200,004,103589,Cheng; Chung Kuan,9999,0,9999,0
1668502470414,ECE 200,005,103590,Cosman; Pamela C.,9999,0,9999,0
1668502470414,ECE 200,006,103591,Dayeh; Shadi Ahmad,9999,0,9999,0
1668502470414,ECE 200,007,103592,Fainman; Yeshaiahu,9999,0,9999,0
1668502470414,ECE 200,008,103593,Ford; Joseph Earl,9999,0,9999,0
1668502470414,ECE 200,009,103594,Franceschetti; Massimo,9999,0,9999,0
1668502470414,ECE 200,010,103595,Fullerton; Eric E,9999,0,9999,0
1668502470414,ECE 200,011,103596,Galton; Ian A,9999,0,9999,0
1668502470414,ECE 200,012,103597,Gilja; Vikash,9999,0,9999,0
1668502470414,ECE 200,013,103598,Hall; Drew A.,9999,0,9999,0
1668502470414,ECE 200,014,103599,Hsueh; Tzu-Chien,9999,0,9999,0
1668502470414,ECE 200,015,103600,Javidi; Tara,9999,0,9999,0
1668502470414,ECE 200,016,103601,Kahng; Andrew Byun,9999,0,9999,0
1668502470414,ECE 200,017,103602,Kim; Young-Han,9999,0,9999,0
1668502470414,ECE 200,018,103603,Koushanfar; Farinaz,9999,0,9999,0
1668502470414,ECE 200,019,103604,Kuzum; Duygu,9999,0,9999,0
1668502470414,ECE 200,020,103605,Le; Hanh-Phuc,9999,0,9999,0
1668502470414,ECE 200,021,103606,Lin; Bill,9999,0,9999,0
1668502470414,ECE 200,022,103607,Liu; Zhaowei,9998,0,9999,1
1668502470414,ECE 200,023,103608,Lo; Yu-Hwa,9999,0,9999,0
1668502470414,ECE 200,024,103609,Lomakin; Vitaliy,9999,0,9999,0
1668502470414,ECE 200,025,103610,Mercier; Patrick Philip,9999,0,9999,0
1668502470414,ECE 200,026,103611,Meyer; Florian,9999,0,9999,0
1668502470414,ECE 200,027,103612,Milstein; Laurence B.,9999,0,9999,0
1668502470414,ECE 200,028,103613,Mir Arabbaygi; Siavash,9999,0,9999,0
1668502470414,ECE 200,029,103614,Mookherjea; Shayan,9999,0,9999,0
1668502470414,ECE 200,030,103615,Morris; Karcher William,9999,0,9999,0
1668502470414,ECE 200,031,103616,Ng; Tse Nga,9999,0,9999,0
1668502470414,ECE 200,032,103617,Nguyen; Truong Quang,9999,0,9999,0
1668502470414,ECE 200,033,103618,Nomura; Kenji,9999,0,9999,0
1668502470414,ECE 200,034,103619,Orlitsky; Alon,9999,0,9999,0
1668502470414,ECE 200,035,103620,Pal; Piya,9999,0,9999,0
1668502470414,ECE 200,036,103621,Papen; George C.,9999,0,9999,0
1668502470414,ECE 200,037,103622,Radic; Stojan,9999,0,9999,0
1668502470414,ECE 200,038,103623,Rao; Bhaskar D.,9999,0,9999,0
1668502470414,ECE 200,039,103624,Rao; Ramesh R,9999,0,9999,0
1668502470414,ECE 200,040,103625,Rebeiz; Gabriel,9999,0,9999,0
1668502470414,ECE 200,041,103626,Sanford; John R,9999,0,9999,0
1668502470414,ECE 200,042,103627,Siegel; Paul H.,9999,0,9999,0
1668502470414,ECE 200,043,103628,Sievenpiper; Daniel F.,9999,0,9999,0
1668502470414,ECE 200,044,103629,Sworder; David D.,9999,0,9999,0
1668502470414,ECE 200,045,103630,Taur; Yuan,9999,0,9999,0
1668502470414,ECE 200,046,103631,Touri; Behrouz,9999,0,9999,0
1668502470414,ECE 200,047,103632,Trivedi; Mohan M.,9999,0,9999,0
1668502470414,ECE 200,048,103633,Vasconcelos; Nuno,9999,0,9999,0
1668502470414,ECE 200,049,103634,Wang; Xiaolong,9999,0,9999,0
1668502470414,ECE 200,050,103635,Xie; Pengtao,9999,0,9999,0
1668502470414,ECE 200,051,103636,Yip; Michael,9999,0,9999,0
1668502470414,ECE 200,052,103637,Zeger; Kenneth A.,999,0,999,0
1668502470414,ECE 200,053,103638,Zhang; Xinyu,9999,0,9999,0
1668502470414,ECE 200,054,103639,Turakhia; Yatish Girish,9999,0,9999,0
1668502470414,ECE 200,055,103640,Kang; Mingu,9999,0,9999,0
1668502470414,ECE 200,056,103641,Shi; Yuanyuan,9999,0,9999,0
1668502470414,ECE 200,057,103642,Wang; Edward Jay,9999,0,9999,0
1668502470414,ECE 200,058,103643,Zheng; Yang,9999,0,9999,0
1668502470841,ECE 202,A00,103644,Kuzum; Duygu,0,44,0,0
1668502471269,ECE 212BN,A00,103646,Ng; Tse Nga,0,9,0,0
1668502471692,ECE 221,A00,111493,Staff,0,0,0,0
1668502472120,ECE 222B,A00,103647,Lomakin; Vitaliy,0,19,0,0
1668502472543,ECE 230B,A00,103648,Taur; Yuan,0,3,0,0
1668502472974,ECE 238B,A00,103649,Garay; Javier,0,0,0,0
1668502473401,ECE 240B,A00,112900,Fainman; Yeshaiahu,0,7,0,0
1668502473833,ECE 247A,A00,103650,Jokerst; Jesse Vincent,0,6,0,0
1668502474257,ECE 247B,A00,103651,Wang; Joseph,0,14,0,0
1668502474680,ECE 250,A00,103652,Siegel; Paul H.,0,82,0,0
1668502475103,ECE 251A,A00,103654,Rao; Bhaskar D.,0,61,0,0
1668502475527,ECE 257B,A00,103655,Bharadia; Dinesh,0,32,0,0
1668502475948,ECE 258A,A00,103656,Milstein; Laurence B.,0,29,0,0
1668502476373,ECE 260B,A00,103658,Kang; Mingu,0,119,0,0
1668502476800,ECE 264A,A00,103659,Galton; Ian A,0,65,0,0
1668502477227,ECE 265A,A00,103661,Gudem; Prasad S.S.,0,70,0,0
1668502477652,ECE 265D,A00,103662,Gudem; Prasad S.S.,0,26,0,0
1668502478074,ECE 268,A00,103663,Koushanfar; Farinaz,0,42,0,0
1668502478499,ECE 269,A01,103665,Pal; Piya,0,215,0,0
1668502478922,ECE 271B,A00,103666,Vasconcelos; Manuela,0,76,0,0
1668502479352,ECE 276A,A00,103667,Atanasov; Nikolay A.,0,125,0,0
1668502479775,ECE 277,A00,103668,An; Cheolhong,0,148,0,0
1668502480201,ECE 279,A00,117947,Hall; Drew A.,0,22,0,0
1668502481058,ECE 283,A00,103670,Hsueh; Tzu-Chien,0,53,0,0
1668502481480,ECE 284,A00,103671,Turakhia; Yatish Girish,0,39,0,0
1668502481914,ECE 285,A00,103672,Zheng; Yang,0,39,0,0
1668502481914,ECE 285,B00,103673,Sworder; David D.,0,57,0,0
1668502482339,ECE 287,A00,103676,Javidi; Tara,0,9,0,0
1668502482766,MATH 200B,A00,098023,Salehi Golsefidy; Alireza,10,0,15,5
1668502483189,MATH 202B,A00,098024,Rhoades; Brendon Patrick,7,0,15,8
1668502483620,MATH 203B,A00,098025,Oprea; Dragos N.,9,0,15,6
1668502484047,MATH 204B,A00,098026,Sorensen; Claus M,13,0,15,2
1668502484470,MATH 208,A00,098027,Izadi; Elham,7,0,10,3
1668502484894,MATH 209,A00,098028,Pollack; Aaron,10,0,10,0
1668502485318,MATH 211A,A00,112919,Rogalski; Daniel,8,0,10,2
1668502485741,MATH 211B,A00,112920,Seward; Brandon M.,9,0,10,1
1668502486171,MATH 218,A00,098029,Li; Bo,10,0,10,0
1668502486601,MATH 220B,A00,098030,Novak; Jonathan I,11,0,15,4
1668502487024,MATH 221A,A00,098031,Ebenfelt; Peter F,12,0,15,3
1668502487452,MATH 231B,A00,098032,Zlatos; Andrej,11,0,15,4
1668502487899,MATH 240B,A00,098033,Ni; Lei,7,0,15,8
1668502488326,MATH 243,A00,098034,Jekel; David Andrew,10,0,10,0
1668502488751,MATH 245A,A00,098035,Nie; Jiawang,0,4,15,18
1668502489179,MATH 248,A00,098036,Bejenaru; Ioan,10,0,10,0
1668502489604,MATH 250B,A00,098037,Spolaor; Luca,14,0,15,1
1668502490027,MATH 258,A00,098038,Ni; Lei,9,0,10,1
1668502490456,MATH 264B,A00,098041,Rhoades; Brendon Patrick,8,0,15,7
1668502490881,MATH 268,A00,098042,Buss; Samuel R,10,0,10,0
1668502491304,MATH 269,A00,098043,Rhoades; Brendon Patrick,10,0,10,0
1668502491729,MATH 270B,A00,098044,Li; Bo,6,0,15,9
1668502492154,MATH 272B,A00,098045,Holst; Michael J,13,0,15,2
1668502492582,MATH 273A,A00,098046,Tian; Xiaochuan,10,0,15,5
1668502493007,MATH 275,A01,098048,Tian; Xiaochuan,6,0,10,4
1668502493431,MATH 278A,A00,098049,Holst; Michael J,7,0,10,3
1668502493854,MATH 278B,A00,098050,Cloninger; Alexander,10,0,10,0
1668502494278,MATH 278C,A00,098051,Nie; Jiawang,5,0,10,5
1668502494787,MATH 280B,A00,098052,Zheng; Tianyi,7,0,15,8
1668502495212,MATH 281B,A00,098053,Bradic; Jelena,0,2,15,15
1668502495637,MATH 282B,A00,098054,Arias-Castro; Ery,0,1,15,15
1668502496062,MATH 285,A00,098055,Fitzsimmons; Patrick J,0,3,15,17
1668502496499,MATH 287B,A00,098056,Arias-Castro; Ery,1,0,15,14
1668502496926,MATH 288,A00,098057,Agarwal; Pooja,9,0,10,1
1668502496926,MATH 288,B00,098058,Zhang; Danna,8,0,10,2
1668502496926,MATH 288,C00,098059,Williams; Ruth J,9,0,10,1
1668502497353,MATH 290B,A00,098060,Roberts; Justin Deritter,12,0,15,3
1668502497778,MATH 292,A00,098061,Belmont; Eva Kinoshita,10,0,10,0
1668502498203,MATH 295,A00,098062,Suk; Andrew Hoon,47,0,50,3
1668502498631,MATH 296,A00,098063,Novak; Jonathan I,20,0,20,0
1668502499060,MATH 297,001,098064,Gamst; Anthony Collins,9997,0,9999,2
1668503001525,COGS 205,A00,101395,Chiba; Andrea,19,0,20,1
1668503001956,COGS 210B,001,101404,Greene; Deanna Jacquelyn,9998,0,9999,1
1668503001956,COGS 210B,002,101417,Xia; Haijun,9999,0,9999,0
1668503001956,COGS 210B,003,101422,Nitz; Douglas A.,9999,0,9999,0
1668503001956,COGS 210B,004,101423,Hollan; James D.,9998,0,9999,1
1668503001956,COGS 210B,005,101424,Deak; Gedeon O.,9998,0,9999,1
1668503001956,COGS 210B,006,101425,Rossano; Federico,9999,0,9999,0
1668503002382,COGS 211B,A00,101427,Coulson; Seana M,9996,0,9999,3
1668503002806,COGS 220,A00,101428,Hollan; James D.,0,10,25,25
1668503003230,COGS 229,A00,101429,Dow; Steven P,17,0,25,8
1668503003654,COGS 230,A00,101430,Klemmer; Scott R,7,0,17,10
1668503004081,COGS 234,A00,101431,Xia; Haijun,1,0,25,24
1668503004506,COGS 260,A00,101432,Kiyonaga; Anastasia,21,0,25,4
1668503004506,COGS 260,B00,101433,Kirsh; David Joel,15,0,25,10
1668503004938,CSE 202,A00,102371,Impagliazzo; Russell,0,65,0,0
1668503005362,CSE 203B,A01,102373,Cheng; Chung Kuan,0,58,0,0
1668503005787,CSE 208,A00,102374,Micciancio; Daniele,0,5,0,0
1668503006212,CSE 209A,A00,112895,Impagliazzo; Russell,0,12,15,15
1668503006641,CSE 209B,A00,108005,Bellare; Mihir,0,7,0,0
1668503007067,CSE 210,A00,113163,Coblenz; Michael J,0,83,0,0
1668503007491,CSE 219,A00,106111,Dow; Steven P,0,6,20,20
1668503007916,CSE 221,A00,102376,Voelker; Geoffrey M.,0,72,0,0
1668503008342,CSE 224,A01,102378,Porter; George M,0,165,0,0
1668503008766,CSE 229A,A00,102379,Savage; Stefan,0,10,0,0
1668503009194,CSE 229C,A00,102380,Munyaka; Imani N. S.,0,10,0,0
1668503009627,CSE 232B,A00,102382,Deutsch; Alin Bernard,0,32,0,0
1668503010061,CSE 234,A01,112904,Kumar; Arun Kumar,0,0,0,0
1668503010491,CSE 237A,A00,102383,Rosing; Tajana Simunic,0,55,0,0
1668503010915,CSE 239A,A00,102384,Deutsch; Alin Bernard,0,14,0,0
1668503011343,CSE 239B,A00,102385,Polikarpova; Nadezhda,0,10,0,0
1668503011770,CSE 240A,A00,102386,Pannuto; Patrick William,0,46,0,0
1668503012198,CSE 240B,A00,102387,Zhao; Jishen,0,47,0,0
1668503012624,CSE 241A,A00,106406,Kang; Mingu,0,9,0,0
1668503013052,CSE 249B,A00,102388,Kahng; Andrew Byun,0,5,8,8
1668503013476,CSE 251B,A01,102392,Cottrell; Garrison W,0,51,0,0
1668503013476,CSE 251B,A02,102393,Cottrell; Garrison W,0,34,0,0
1668503013900,CSE 252B,A00,102394,Ochoa; Benjamin Lawrence,0,59,0,0
1668503014328,CSE 257,A01,102396,Gao; Sicun,0,138,0,0
1668503014759,CSE 272,A00,102397,Li; Tzumao,0,19,0,0
1668503015194,CSE 274,A00,111323,Chern; Albert Ren-Haur,0,15,0,0
1668503015617,CSE 282,A00,102398,Pevzner; Pavel Arkadjevich,0,0,0,0
1668503016116,CSE 284,A00,114175,Gymrek; Melissa Ann,0,22,0,0
1668503016543,CSE 290,A00,102399,Chandraker; Manmohan Krishna,0,11,0,0
1668503016543,CSE 290,B00,102400,Vaccaro; Kristen Marie,0,7,25,25
1668503016543,CSE 290,C00,102414,Pannuto; Patrick William,0,1,25,25
1668503016543,CSE 290,D00,102427,Pevzner; Pavel Arkadjevich,0,0,0,0
1668503016543,CSE 290,E00,102429,Zhao; Jishen,0,4,0,0
1668503016543,CSE 290,F00,102436,Tullsen; Dean Michael,0,5,0,0
1668503016543,CSE 290,G00,102440,Christensen; Henrik I,0,6,20,20
1668503016970,CSE 291,A00,102443,Su; Hao,0,0,0,0
1668503016970,CSE 291,B00,102448,Polikarpova; Nadezhda,0,0,0,0
1668503016970,CSE 291,C00,102453,Vaccaro; Kristen Marie,0,0,0,0
1668503016970,CSE 291,D00,111343,Savage; Stefan,0,0,0,0
1668503016970,CSE 291,E00,116474,Claffy; Kimberly Claire,0,0,0,0
1668503016970,CSE 291,F00,116479,Pasquale; Joseph,0,0,0,0
1668503017409,CSE 293,001,119111,Bafna; Vineet,9999,0,9999,0
1668503017409,CSE 293,002,119118,Bellare; Mihir,9999,0,9999,0
1668503017409,CSE 293,003,119122,Berg-Kirkpatrick; Taylor D,9999,0,9999,0
1668503017409,CSE 293,004,119135,Christensen; Henrik I,9999,0,9999,0
1668503017409,CSE 293,005,119142,Cottrell; Garrison W,9999,0,9999,0
1668503017409,CSE 293,006,119146,Deutsch; Alin Bernard,9999,0,9999,0
1668503017409,CSE 293,007,119159,Esmaeilzadeh; Hadi,9999,0,9999,0
1668503017409,CSE 293,008,119166,Freund; Yoav,9999,0,9999,0
1668503017409,CSE 293,009,119170,Griswold; William G.,9999,0,9999,0
1668503017409,CSE 293,010,119183,Gymrek; Melissa Ann,9999,0,9999,0
1668503017409,CSE 293,011,119190,Heninger; Nadia A,9999,0,9999,0
1668503017409,CSE 293,012,119230,Impagliazzo; Russell,9999,0,9999,0
1668503017409,CSE 293,013,119232,Jhala; Ranjit,9999,0,9999,0
1668503017409,CSE 293,014,119233,Kahng; Andrew Byun,9999,0,9999,0
1668503017409,CSE 293,015,119298,Kane; Daniel Mertz,9999,0,9999,0
1668503017409,CSE 293,016,119299,Kriegman; David J,9999,0,9999,0
1668503017409,CSE 293,017,119300,Kumar; Arun Kumar,9999,0,9999,0
1668503017409,CSE 293,018,119301,Lerner; Sorin,9999,0,9999,0
1668503017409,CSE 293,019,119302,Lovett; Shachar,9999,0,9999,0
1668503017409,CSE 293,020,119303,McAuley; Julian John,9999,0,9999,0
1668503017409,CSE 293,021,119304,Micciancio; Daniele,9999,0,9999,0
1668503017409,CSE 293,022,119367,Orailoglu; Alex,9999,0,9999,0
1668503017409,CSE 293,023,119382,Paturi; Ramamohan,9999,0,9999,0
1668503017409,CSE 293,024,119404,Polikarpova; Nadezhda,9999,0,9999,0
1668503017409,CSE 293,025,119406,Politz; Joseph Gibbs,9999,0,9999,0
1668503017409,CSE 293,026,119411,Porter; George M,9999,0,9999,0
1668503017409,CSE 293,027,119414,Porter; Leonard Emerson,9999,0,9999,0
1668503017409,CSE 293,028,119416,Ramamoorthi; Ravi,9999,0,9999,0
1668503017409,CSE 293,029,119417,Sahoo; Debashis,9999,0,9999,0
1668503017409,CSE 293,030,119420,Saul; Lawrence,9999,0,9999,0
1668503017409,CSE 293,031,119421,Savage; Stefan,9999,0,9999,0
1668503017409,CSE 293,032,119425,Schulze; Jurgen P.,9999,0,9999,0
1668503017409,CSE 293,033,119426,Snoeren; Alex C.,9999,0,9999,0
1668503017409,CSE 293,034,119428,Shang; Jingbo,9999,0,9999,0
1668503017409,CSE 293,035,119430,Stefan; Deian,9999,0,9999,0
1668503017409,CSE 293,036,119431,Su; Hao,9999,0,9999,0
1668503017409,CSE 293,037,119433,Swanson; Steven James,9999,0,9999,0
1668503017409,CSE 293,038,119435,Tullsen; Dean Michael,9999,0,9999,0
1668503017409,CSE 293,039,119483,Voelker; Geoffrey M.,9999,0,9999,0
1668503017409,CSE 293,040,119537,Zhao; Jishen,9999,0,9999,0
1668503017409,CSE 293,041,119538,Zhou; Yuan-Yuan,9999,0,9999,0
1668503017409,CSE 293,042,119539,Gao; Sicun,9999,0,9999,0
1668503017409,CSE 293,043,119540,Weibel; Nadir,9999,0,9999,0
1668503017409,CSE 293,044,119541,Gupta; Rajesh K.,9999,0,9999,0
1668503017409,CSE 293,045,126410,Vaccaro; Kristen Marie,9999,0,9999,0
1668503017409,CSE 293,046,126411,Klemke; Richard,9999,0,9999,0
1668503017833,CSE 294,A00,102459,Voelker; Geoffrey M.,0,2,0,0
1668503017833,CSE 294,B00,111322,Orailoglu; Alex,0,2,0,0
1668503018257,DSE 201,A00,096914,Deutsch; Alin Bernard,30,0,30,0
1668503018682,DSE 210,A00,096915,Dasgupta; Sanjoy,30,0,30,0
1668503019107,DSE 260A,A00,096916,Altintas De Callaf; Ilkay,30,0,30,0
1668503019587,ECE 200,001,103586,Antipa; Nicholas A,9999,0,9999,0
1668503019587,ECE 200,002,103587,Atanasov; Nikolay A.,9999,0,9999,0
1668503019587,ECE 200,003,103588,Bharadia; Dinesh,9999,0,9999,0
1668503019587,ECE 200,004,103589,Cheng; Chung Kuan,9999,0,9999,0
1668503019587,ECE 200,005,103590,Cosman; Pamela C.,9999,0,9999,0
1668503019587,ECE 200,006,103591,Dayeh; Shadi Ahmad,9999,0,9999,0
1668503019587,ECE 200,007,103592,Fainman; Yeshaiahu,9999,0,9999,0
1668503019587,ECE 200,008,103593,Ford; Joseph Earl,9999,0,9999,0
1668503019587,ECE 200,009,103594,Franceschetti; Massimo,9999,0,9999,0
1668503019587,ECE 200,010,103595,Fullerton; Eric E,9999,0,9999,0
1668503019587,ECE 200,011,103596,Galton; Ian A,9999,0,9999,0
1668503019587,ECE 200,012,103597,Gilja; Vikash,9999,0,9999,0
1668503019587,ECE 200,013,103598,Hall; Drew A.,9999,0,9999,0
1668503019587,ECE 200,014,103599,Hsueh; Tzu-Chien,9999,0,9999,0
1668503019587,ECE 200,015,103600,Javidi; Tara,9999,0,9999,0
1668503019587,ECE 200,016,103601,Kahng; Andrew Byun,9999,0,9999,0
1668503019587,ECE 200,017,103602,Kim; Young-Han,9999,0,9999,0
1668503019587,ECE 200,018,103603,Koushanfar; Farinaz,9999,0,9999,0
1668503019587,ECE 200,019,103604,Kuzum; Duygu,9999,0,9999,0
1668503019587,ECE 200,020,103605,Le; Hanh-Phuc,9999,0,9999,0
1668503019587,ECE 200,021,103606,Lin; Bill,9999,0,9999,0
1668503019587,ECE 200,022,103607,Liu; Zhaowei,9998,0,9999,1
1668503019587,ECE 200,023,103608,Lo; Yu-Hwa,9999,0,9999,0
1668503019587,ECE 200,024,103609,Lomakin; Vitaliy,9999,0,9999,0
1668503019587,ECE 200,025,103610,Mercier; Patrick Philip,9999,0,9999,0
1668503019587,ECE 200,026,103611,Meyer; Florian,9999,0,9999,0
1668503019587,ECE 200,027,103612,Milstein; Laurence B.,9999,0,9999,0
1668503019587,ECE 200,028,103613,Mir Arabbaygi; Siavash,9999,0,9999,0
1668503019587,ECE 200,029,103614,Mookherjea; Shayan,9999,0,9999,0
1668503019587,ECE 200,030,103615,Morris; Karcher William,9999,0,9999,0
1668503019587,ECE 200,031,103616,Ng; Tse Nga,9999,0,9999,0
1668503019587,ECE 200,032,103617,Nguyen; Truong Quang,9999,0,9999,0
1668503019587,ECE 200,033,103618,Nomura; Kenji,9999,0,9999,0
1668503019587,ECE 200,034,103619,Orlitsky; Alon,9999,0,9999,0
1668503019587,ECE 200,035,103620,Pal; Piya,9999,0,9999,0
1668503019587,ECE 200,036,103621,Papen; George C.,9999,0,9999,0
1668503019587,ECE 200,037,103622,Radic; Stojan,9999,0,9999,0
1668503019587,ECE 200,038,103623,Rao; Bhaskar D.,9999,0,9999,0
1668503019587,ECE 200,039,103624,Rao; Ramesh R,9999,0,9999,0
1668503019587,ECE 200,040,103625,Rebeiz; Gabriel,9999,0,9999,0
1668503019587,ECE 200,041,103626,Sanford; John R,9999,0,9999,0
1668503019587,ECE 200,042,103627,Siegel; Paul H.,9999,0,9999,0
1668503019587,ECE 200,043,103628,Sievenpiper; Daniel F.,9999,0,9999,0
1668503019587,ECE 200,044,103629,Sworder; David D.,9999,0,9999,0
1668503019587,ECE 200,045,103630,Taur; Yuan,9999,0,9999,0
1668503019587,ECE 200,046,103631,Touri; Behrouz,9999,0,9999,0
1668503019587,ECE 200,047,103632,Trivedi; Mohan M.,9999,0,9999,0
1668503019587,ECE 200,048,103633,Vasconcelos; Nuno,9999,0,9999,0
1668503019587,ECE 200,049,103634,Wang; Xiaolong,9999,0,9999,0
1668503019587,ECE 200,050,103635,Xie; Pengtao,9999,0,9999,0
1668503019587,ECE 200,051,103636,Yip; Michael,9999,0,9999,0
1668503019587,ECE 200,052,103637,Zeger; Kenneth A.,999,0,999,0
1668503019587,ECE 200,053,103638,Zhang; Xinyu,9999,0,9999,0
1668503019587,ECE 200,054,103639,Turakhia; Yatish Girish,9999,0,9999,0
1668503019587,ECE 200,055,103640,Kang; Mingu,9999,0,9999,0
1668503019587,ECE 200,056,103641,Shi; Yuanyuan,9999,0,9999,0
1668503019587,ECE 200,057,103642,Wang; Edward Jay,9999,0,9999,0
1668503019587,ECE 200,058,103643,Zheng; Yang,9999,0,9999,0
1668503020014,ECE 202,A00,103644,Kuzum; Duygu,0,44,0,0
1668503020438,ECE 212BN,A00,103646,Ng; Tse Nga,0,9,0,0
1668503020865,ECE 221,A00,111493,Staff,0,0,0,0
1668503021290,ECE 222B,A00,103647,Lomakin; Vitaliy,0,19,0,0
1668503021716,ECE 230B,A00,103648,Taur; Yuan,0,3,0,0
1668503022144,ECE 238B,A00,103649,Garay; Javier,0,0,0,0
1668503022571,ECE 240B,A00,112900,Fainman; Yeshaiahu,0,7,0,0
1668503022998,ECE 247A,A00,103650,Jokerst; Jesse Vincent,0,6,0,0
1668503023426,ECE 247B,A00,103651,Wang; Joseph,0,14,0,0
1668503023851,ECE 250,A00,103652,Siegel; Paul H.,0,82,0,0
1668503024279,ECE 251A,A00,103654,Rao; Bhaskar D.,0,61,0,0
1668503024705,ECE 257B,A00,103655,Bharadia; Dinesh,0,32,0,0
1668503025133,ECE 258A,A00,103656,Milstein; Laurence B.,0,29,0,0
1668503025556,ECE 260B,A00,103658,Kang; Mingu,0,119,0,0
1668503025985,ECE 264A,A00,103659,Galton; Ian A,0,65,0,0
1668503026409,ECE 265A,A00,103661,Gudem; Prasad S.S.,0,70,0,0
1668503026832,ECE 265D,A00,103662,Gudem; Prasad S.S.,0,26,0,0
1668503027257,ECE 268,A00,103663,Koushanfar; Farinaz,0,42,0,0
1668503027683,ECE 269,A01,103665,Pal; Piya,0,215,0,0
1668503028112,ECE 271B,A00,103666,Vasconcelos; Manuela,0,76,0,0
1668503028536,ECE 276A,A00,103667,Atanasov; Nikolay A.,0,125,0,0
1668503028963,ECE 277,A00,103668,An; Cheolhong,0,148,0,0
1668503029389,ECE 279,A00,117947,Hall; Drew A.,0,22,0,0
1668503030254,ECE 283,A00,103670,Hsueh; Tzu-Chien,0,53,0,0
1668503030680,ECE 284,A00,103671,Turakhia; Yatish Girish,0,39,0,0
1668503031103,ECE 285,A00,103672,Zheng; Yang,0,39,0,0
1668503031103,ECE 285,B00,103673,Sworder; David D.,0,57,0,0
1668503031530,ECE 287,A00,103676,Javidi; Tara,0,9,0,0
1668503031954,MATH 200B,A00,098023,Salehi Golsefidy; Alireza,10,0,15,5
1668503032383,MATH 202B,A00,098024,Rhoades; Brendon Patrick,7,0,15,8
1668503032812,MATH 203B,A00,098025,Oprea; Dragos N.,9,0,15,6
1668503033242,MATH 204B,A00,098026,Sorensen; Claus M,13,0,15,2
1668503033665,MATH 208,A00,098027,Izadi; Elham,7,0,10,3
1668503034089,MATH 209,A00,098028,Pollack; Aaron,10,0,10,0
1668503034512,MATH 211A,A00,112919,Rogalski; Daniel,8,0,10,2
1668503034936,MATH 211B,A00,112920,Seward; Brandon M.,9,0,10,1
1668503035360,MATH 218,A00,098029,Li; Bo,10,0,10,0
1668503035783,MATH 220B,A00,098030,Novak; Jonathan I,11,0,15,4
1668503036208,MATH 221A,A00,098031,Ebenfelt; Peter F,12,0,15,3
1668503036636,MATH 231B,A00,098032,Zlatos; Andrej,11,0,15,4
1668503037061,MATH 240B,A00,098033,Ni; Lei,7,0,15,8
1668503037487,MATH 243,A00,098034,Jekel; David Andrew,10,0,10,0
1668503037913,MATH 245A,A00,098035,Nie; Jiawang,0,4,15,18
1668503038337,MATH 248,A00,098036,Bejenaru; Ioan,10,0,10,0
1668503038766,MATH 250B,A00,098037,Spolaor; Luca,14,0,15,1
1668503039191,MATH 258,A00,098038,Ni; Lei,9,0,10,1
1668503039614,MATH 264B,A00,098041,Rhoades; Brendon Patrick,8,0,15,7
1668503040042,MATH 268,A00,098042,Buss; Samuel R,10,0,10,0
1668503040467,MATH 269,A00,098043,Rhoades; Brendon Patrick,10,0,10,0
1668503040892,MATH 270B,A00,098044,Li; Bo,6,0,15,9
1668503041321,MATH 272B,A00,098045,Holst; Michael J,13,0,15,2
1668503041746,MATH 273A,A00,098046,Tian; Xiaochuan,10,0,15,5
1668503042171,MATH 275,A01,098048,Tian; Xiaochuan,6,0,10,4
1668503042597,MATH 278A,A00,098049,Holst; Michael J,7,0,10,3
1668503043023,MATH 278B,A00,098050,Cloninger; Alexander,10,0,10,0
1668503043453,MATH 278C,A00,098051,Nie; Jiawang,5,0,10,5
1668503043881,MATH 280B,A00,098052,Zheng; Tianyi,7,0,15,8
1668503044305,MATH 281B,A00,098053,Bradic; Jelena,0,2,15,15
1668503044734,MATH 282B,A00,098054,Arias-Castro; Ery,0,1,15,15
1668503045159,MATH 285,A00,098055,Fitzsimmons; Patrick J,0,3,15,17
1668503045586,MATH 287B,A00,098056,Arias-Castro; Ery,1,0,15,14
1668503046015,MATH 288,A00,098057,Agarwal; Pooja,9,0,10,1
1668503046015,MATH 288,B00,098058,Zhang; Danna,8,0,10,2
1668503046015,MATH 288,C00,098059,Williams; Ruth J,9,0,10,1
1668503046444,MATH 290B,A00,098060,Roberts; Justin Deritter,12,0,15,3
1668503046869,MATH 292,A00,098061,Belmont; Eva Kinoshita,10,0,10,0
1668503047299,MATH 295,A00,098062,Suk; Andrew Hoon,47,0,50,3
1668503047722,MATH 296,A00,098063,Novak; Jonathan I,20,0,20,0
1668503048146,MATH 297,001,098064,Gamst; Anthony Collins,9997,0,9999,2
1668503550060,COGS 205,A00,101395,Chiba; Andrea,19,0,20,1
1668503550495,COGS 210B,001,101404,Greene; Deanna Jacquelyn,9998,0,9999,1
1668503550495,COGS 210B,002,101417,Xia; Haijun,9999,0,9999,0
1668503550495,COGS 210B,003,101422,Nitz; Douglas A.,9999,0,9999,0
1668503550495,COGS 210B,004,101423,Hollan; James D.,9998,0,9999,1
1668503550495,COGS 210B,005,101424,Deak; Gedeon O.,9998,0,9999,1
1668503550495,COGS 210B,006,101425,Rossano; Federico,9999,0,9999,0
1668503550919,COGS 211B,A00,101427,Coulson; Seana M,9996,0,9999,3
1668503551345,COGS 220,A00,101428,Hollan; James D.,0,10,25,25
1668503551771,COGS 229,A00,101429,Dow; Steven P,17,0,25,8
1668503552197,COGS 230,A00,101430,Klemmer; Scott R,7,0,17,10
1668503552620,COGS 234,A00,101431,Xia; Haijun,1,0,25,24
1668503553051,COGS 260,A00,101432,Kiyonaga; Anastasia,21,0,25,4
1668503553051,COGS 260,B00,101433,Kirsh; David Joel,15,0,25,10
1668503553477,CSE 202,A00,102371,Impagliazzo; Russell,0,65,0,0
1668503553909,CSE 203B,A01,102373,Cheng; Chung Kuan,0,58,0,0
1668503554333,CSE 208,A00,102374,Micciancio; Daniele,0,5,0,0
1668503554763,CSE 209A,A00,112895,Impagliazzo; Russell,0,12,15,15
1668503555188,CSE 209B,A00,108005,Bellare; Mihir,0,7,0,0
1668503555616,CSE 210,A00,113163,Coblenz; Michael J,0,83,0,0
1668503556040,CSE 219,A00,106111,Dow; Steven P,0,6,20,20
1668503556473,CSE 221,A00,102376,Voelker; Geoffrey M.,0,72,0,0
1668503556899,CSE 224,A01,102378,Porter; George M,0,165,0,0
1668503557323,CSE 229A,A00,102379,Savage; Stefan,0,10,0,0
1668503557748,CSE 229C,A00,102380,Munyaka; Imani N. S.,0,10,0,0
1668503558181,CSE 232B,A00,102382,Deutsch; Alin Bernard,0,32,0,0
1668503558617,CSE 234,A01,112904,Kumar; Arun Kumar,0,0,0,0
1668503559041,CSE 237A,A00,102383,Rosing; Tajana Simunic,0,55,0,0
1668503559463,CSE 239A,A00,102384,Deutsch; Alin Bernard,0,14,0,0
1668503559888,CSE 239B,A00,102385,Polikarpova; Nadezhda,0,10,0,0
1668503560316,CSE 240A,A00,102386,Pannuto; Patrick William,0,46,0,0
1668503560744,CSE 240B,A00,102387,Zhao; Jishen,0,47,0,0
1668503561175,CSE 241A,A00,106406,Kang; Mingu,0,9,0,0
1668503561600,CSE 249B,A00,102388,Kahng; Andrew Byun,0,5,8,8
1668503562029,CSE 251B,A01,102392,Cottrell; Garrison W,0,51,0,0
1668503562029,CSE 251B,A02,102393,Cottrell; Garrison W,0,34,0,0
1668503562459,CSE 252B,A00,102394,Ochoa; Benjamin Lawrence,0,59,0,0
1668503562885,CSE 257,A01,102396,Gao; Sicun,0,138,0,0
1668503563314,CSE 272,A00,102397,Li; Tzumao,0,19,0,0
1668503563739,CSE 274,A00,111323,Chern; Albert Ren-Haur,0,15,0,0
1668503564167,CSE 282,A00,102398,Pevzner; Pavel Arkadjevich,0,0,0,0
1668503564596,CSE 284,A00,114175,Gymrek; Melissa Ann,0,22,0,0
1668503565033,CSE 290,A00,102399,Chandraker; Manmohan Krishna,0,11,0,0
1668503565033,CSE 290,B00,102400,Vaccaro; Kristen Marie,0,7,25,25
1668503565033,CSE 290,C00,102414,Pannuto; Patrick William,0,1,25,25
1668503565033,CSE 290,D00,102427,Pevzner; Pavel Arkadjevich,0,0,0,0
1668503565033,CSE 290,E00,102429,Zhao; Jishen,0,4,0,0
1668503565033,CSE 290,F00,102436,Tullsen; Dean Michael,0,5,0,0
1668503565033,CSE 290,G00,102440,Christensen; Henrik I,0,6,20,20
1668503565460,CSE 291,A00,102443,Su; Hao,0,0,0,0
1668503565460,CSE 291,B00,102448,Polikarpova; Nadezhda,0,0,0,0
1668503565460,CSE 291,C00,102453,Vaccaro; Kristen Marie,0,0,0,0
1668503565460,CSE 291,D00,111343,Savage; Stefan,0,0,0,0
1668503565460,CSE 291,E00,116474,Claffy; Kimberly Claire,0,0,0,0
1668503565460,CSE 291,F00,116479,Pasquale; Joseph,0,0,0,0
1668503565902,CSE 293,001,119111,Bafna; Vineet,9999,0,9999,0
1668503565902,CSE 293,002,119118,Bellare; Mihir,9999,0,9999,0
1668503565902,CSE 293,003,119122,Berg-Kirkpatrick; Taylor D,9999,0,9999,0
1668503565902,CSE 293,004,119135,Christensen; Henrik I,9999,0,9999,0
1668503565902,CSE 293,005,119142,Cottrell; Garrison W,9999,0,9999,0
1668503565902,CSE 293,006,119146,Deutsch; Alin Bernard,9999,0,9999,0
1668503565902,CSE 293,007,119159,Esmaeilzadeh; Hadi,9999,0,9999,0
1668503565902,CSE 293,008,119166,Freund; Yoav,9999,0,9999,0
1668503565902,CSE 293,009,119170,Griswold; William G.,9999,0,9999,0
1668503565902,CSE 293,010,119183,Gymrek; Melissa Ann,9999,0,9999,0
1668503565902,CSE 293,011,119190,Heninger; Nadia A,9999,0,9999,0
1668503565902,CSE 293,012,119230,Impagliazzo; Russell,9999,0,9999,0
1668503565902,CSE 293,013,119232,Jhala; Ranjit,9999,0,9999,0
1668503565902,CSE 293,014,119233,Kahng; Andrew Byun,9999,0,9999,0
1668503565902,CSE 293,015,119298,Kane; Daniel Mertz,9999,0,9999,0
1668503565902,CSE 293,016,119299,Kriegman; David J,9999,0,9999,0
1668503565902,CSE 293,017,119300,Kumar; Arun Kumar,9999,0,9999,0
1668503565902,CSE 293,018,119301,Lerner; Sorin,9999,0,9999,0
1668503565902,CSE 293,019,119302,Lovett; Shachar,9999,0,9999,0
1668503565902,CSE 293,020,119303,McAuley; Julian John,9999,0,9999,0
1668503565902,CSE 293,021,119304,Micciancio; Daniele,9999,0,9999,0
1668503565902,CSE 293,022,119367,Orailoglu; Alex,9999,0,9999,0
1668503565902,CSE 293,023,119382,Paturi; Ramamohan,9999,0,9999,0
1668503565902,CSE 293,024,119404,Polikarpova; Nadezhda,9999,0,9999,0
1668503565902,CSE 293,025,119406,Politz; Joseph Gibbs,9999,0,9999,0
1668503565902,CSE 293,026,119411,Porter; George M,9999,0,9999,0
1668503565902,CSE 293,027,119414,Porter; Leonard Emerson,9999,0,9999,0
1668503565902,CSE 293,028,119416,Ramamoorthi; Ravi,9999,0,9999,0
1668503565902,CSE 293,029,119417,Sahoo; Debashis,9999,0,9999,0
1668503565902,CSE 293,030,119420,Saul; Lawrence,9999,0,9999,0
1668503565902,CSE 293,031,119421,Savage; Stefan,9999,0,9999,0
1668503565902,CSE 293,032,119425,Schulze; Jurgen P.,9999,0,9999,0
1668503565902,CSE 293,033,119426,Snoeren; Alex C.,9999,0,9999,0
1668503565902,CSE 293,034,119428,Shang; Jingbo,9999,0,9999,0
1668503565902,CSE 293,035,119430,Stefan; Deian,9999,0,9999,0
1668503565902,CSE 293,036,119431,Su; Hao,9999,0,9999,0
1668503565902,CSE 293,037,119433,Swanson; Steven James,9999,0,9999,0
1668503565902,CSE 293,038,119435,Tullsen; Dean Michael,9999,0,9999,0
1668503565902,CSE 293,039,119483,Voelker; Geoffrey M.,9999,0,9999,0
1668503565902,CSE 293,040,119537,Zhao; Jishen,9999,0,9999,0
1668503565902,CSE 293,041,119538,Zhou; Yuan-Yuan,9999,0,9999,0
1668503565902,CSE 293,042,119539,Gao; Sicun,9999,0,9999,0
1668503565902,CSE 293,043,119540,Weibel; Nadir,9999,0,9999,0
1668503565902,CSE 293,044,119541,Gupta; Rajesh K.,9999,0,9999,0
1668503565902,CSE 293,045,126410,Vaccaro; Kristen Marie,9999,0,9999,0
1668503565902,CSE 293,046,126411,Klemke; Richard,9999,0,9999,0
1668503566325,CSE 294,A00,102459,Voelker; Geoffrey M.,0,2,0,0
1668503566325,CSE 294,B00,111322,Orailoglu; Alex,0,2,0,0
1668503566755,DSE 201,A00,096914,Deutsch; Alin Bernard,30,0,30,0
1668503567187,DSE 210,A00,096915,Dasgupta; Sanjoy,30,0,30,0
1668503567614,DSE 260A,A00,096916,Altintas De Callaf; Ilkay,30,0,30,0
1668503568113,ECE 200,001,103586,Antipa; Nicholas A,9999,0,9999,0
1668503568113,ECE 200,002,103587,Atanasov; Nikolay A.,9999,0,9999,0
1668503568113,ECE 200,003,103588,Bharadia; Dinesh,9999,0,9999,0
1668503568113,ECE 200,004,103589,Cheng; Chung Kuan,9999,0,9999,0
1668503568113,ECE 200,005,103590,Cosman; Pamela C.,9999,0,9999,0
1668503568113,ECE 200,006,103591,Dayeh; Shadi Ahmad,9999,0,9999,0
1668503568113,ECE 200,007,103592,Fainman; Yeshaiahu,9999,0,9999,0
1668503568113,ECE 200,008,103593,Ford; Joseph Earl,9999,0,9999,0
1668503568113,ECE 200,009,103594,Franceschetti; Massimo,9999,0,9999,0
1668503568113,ECE 200,010,103595,Fullerton; Eric E,9999,0,9999,0
1668503568113,ECE 200,011,103596,Galton; Ian A,9999,0,9999,0
1668503568113,ECE 200,012,103597,Gilja; Vikash,9999,0,9999,0
1668503568113,ECE 200,013,103598,Hall; Drew A.,9999,0,9999,0
1668503568113,ECE 200,014,103599,Hsueh; Tzu-Chien,9999,0,9999,0
1668503568113,ECE 200,015,103600,Javidi; Tara,9999,0,9999,0
1668503568113,ECE 200,016,103601,Kahng; Andrew Byun,9999,0,9999,0
1668503568113,ECE 200,017,103602,Kim; Young-Han,9999,0,9999,0
1668503568113,ECE 200,018,103603,Koushanfar; Farinaz,9999,0,9999,0
1668503568113,ECE 200,019,103604,Kuzum; Duygu,9999,0,9999,0
1668503568113,ECE 200,020,103605,Le; Hanh-Phuc,9999,0,9999,0
1668503568113,ECE 200,021,103606,Lin; Bill,9999,0,9999,0
1668503568113,ECE 200,022,103607,Liu; Zhaowei,9998,0,9999,1
1668503568113,ECE 200,023,103608,Lo; Yu-Hwa,9999,0,9999,0
1668503568113,ECE 200,024,103609,Lomakin; Vitaliy,9999,0,9999,0
1668503568113,ECE 200,025,103610,Mercier; Patrick Philip,9999,0,9999,0
1668503568113,ECE 200,026,103611,Meyer; Florian,9999,0,9999,0
1668503568113,ECE 200,027,103612,Milstein; Laurence B.,9999,0,9999,0
1668503568113,ECE 200,028,103613,Mir Arabbaygi; Siavash,9999,0,9999,0
1668503568113,ECE 200,029,103614,Mookherjea; Shayan,9999,0,9999,0
1668503568113,ECE 200,030,103615,Morris; Karcher William,9999,0,9999,0
1668503568113,ECE 200,031,103616,Ng; Tse Nga,9999,0,9999,0
1668503568113,ECE 200,032,103617,Nguyen; Truong Quang,9999,0,9999,0
1668503568113,ECE 200,033,103618,Nomura; Kenji,9999,0,9999,0
1668503568113,ECE 200,034,103619,Orlitsky; Alon,9999,0,9999,0
1668503568113,ECE 200,035,103620,Pal; Piya,9999,0,9999,0
1668503568113,ECE 200,036,103621,Papen; George C.,9999,0,9999,0
1668503568113,ECE 200,037,103622,Radic; Stojan,9999,0,9999,0
1668503568113,ECE 200,038,103623,Rao; Bhaskar D.,9999,0,9999,0
1668503568113,ECE 200,039,103624,Rao; Ramesh R,9999,0,9999,0
1668503568113,ECE 200,040,103625,Rebeiz; Gabriel,9999,0,9999,0
1668503568113,ECE 200,041,103626,Sanford; John R,9999,0,9999,0
1668503568113,ECE 200,042,103627,Siegel; Paul H.,9999,0,9999,0
1668503568113,ECE 200,043,103628,Sievenpiper; Daniel F.,9999,0,9999,0
1668503568113,ECE 200,044,103629,Sworder; David D.,9999,0,9999,0
1668503568113,ECE 200,045,103630,Taur; Yuan,9999,0,9999,0
1668503568113,ECE 200,046,103631,Touri; Behrouz,9999,0,9999,0
1668503568113,ECE 200,047,103632,Trivedi; Mohan M.,9999,0,9999,0
1668503568113,ECE 200,048,103633,Vasconcelos; Nuno,9999,0,9999,0
1668503568113,ECE 200,049,103634,Wang; Xiaolong,9999,0,9999,0
1668503568113,ECE 200,050,103635,Xie; Pengtao,9999,0,9999,0
1668503568113,ECE 200,051,103636,Yip; Michael,9999,0,9999,0
1668503568113,ECE 200,052,103637,Zeger; Kenneth A.,999,0,999,0
1668503568113,ECE 200,053,103638,Zhang; Xinyu,9999,0,9999,0
1668503568113,ECE 200,054,103639,Turakhia; Yatish Girish,9999,0,9999,0
1668503568113,ECE 200,055,103640,Kang; Mingu,9999,0,9999,0
1668503568113,ECE 200,056,103641,Shi; Yuanyuan,9999,0,9999,0
1668503568113,ECE 200,057,103642,Wang; Edward Jay,9999,0,9999,0
1668503568113,ECE 200,058,103643,Zheng; Yang,9999,0,9999,0
1668503568537,ECE 202,A00,103644,Kuzum; Duygu,0,44,0,0
1668503568963,ECE 212BN,A00,103646,Ng; Tse Nga,0,9,0,0
1668503569391,ECE 221,A00,111493,Staff,0,0,0,0
1668503569814,ECE 222B,A00,103647,Lomakin; Vitaliy,0,20,0,0
1668503570238,ECE 230B,A00,103648,Taur; Yuan,0,3,0,0
1668503570668,ECE 238B,A00,103649,Garay; Javier,0,0,0,0
1668503571092,ECE 240B,A00,112900,Fainman; Yeshaiahu,0,7,0,0
1668503571516,ECE 247A,A00,103650,Jokerst; Jesse Vincent,0,6,0,0
1668503571946,ECE 247B,A00,103651,Wang; Joseph,0,14,0,0
1668503572375,ECE 250,A00,103652,Siegel; Paul H.,0,82,0,0
1668503572800,ECE 251A,A00,103654,Rao; Bhaskar D.,0,61,0,0
1668503573222,ECE 257B,A00,103655,Bharadia; Dinesh,0,32,0,0
1668503573649,ECE 258A,A00,103656,Milstein; Laurence B.,0,29,0,0
1668503574076,ECE 260B,A00,103658,Kang; Mingu,0,119,0,0
1668503574501,ECE 264A,A00,103659,Galton; Ian A,0,65,0,0
1668503574933,ECE 265A,A00,103661,Gudem; Prasad S.S.,0,70,0,0
1668503575357,ECE 265D,A00,103662,Gudem; Prasad S.S.,0,26,0,0
1668503575786,ECE 268,A00,103663,Koushanfar; Farinaz,0,43,0,0
1668503576210,ECE 269,A01,103665,Pal; Piya,0,215,0,0
1668503576641,ECE 271B,A00,103666,Vasconcelos; Manuela,0,76,0,0
1668503577069,ECE 276A,A00,103667,Atanasov; Nikolay A.,0,125,0,0
1668503577497,ECE 277,A00,103668,An; Cheolhong,0,148,0,0
1668503577922,ECE 279,A00,117947,Hall; Drew A.,0,22,0,0
1668503578780,ECE 283,A00,103670,Hsueh; Tzu-Chien,0,53,0,0
1668503579206,ECE 284,A00,103671,Turakhia; Yatish Girish,0,39,0,0
1668503579629,ECE 285,A00,103672,Zheng; Yang,0,39,0,0
1668503579629,ECE 285,B00,103673,Sworder; David D.,0,57,0,0
1668503580147,ECE 287,A00,103676,Javidi; Tara,0,9,0,0
1668503580573,MATH 200B,A00,098023,Salehi Golsefidy; Alireza,10,0,15,5
1668503580998,MATH 202B,A00,098024,Rhoades; Brendon Patrick,7,0,15,8
1668503581424,MATH 203B,A00,098025,Oprea; Dragos N.,9,0,15,6
1668503581861,MATH 204B,A00,098026,Sorensen; Claus M,13,0,15,2
1668503582288,MATH 208,A00,098027,Izadi; Elham,7,0,10,3
1668503582713,MATH 209,A00,098028,Pollack; Aaron,10,0,10,0
1668503583140,MATH 211A,A00,112919,Rogalski; Daniel,8,0,10,2
1668503583565,MATH 211B,A00,112920,Seward; Brandon M.,9,0,10,1
1668503583993,MATH 218,A00,098029,Li; Bo,10,0,10,0
1668503584417,MATH 220B,A00,098030,Novak; Jonathan I,11,0,15,4
1668503584855,MATH 221A,A00,098031,Ebenfelt; Peter F,12,0,15,3
1668503585279,MATH 231B,A00,098032,Zlatos; Andrej,11,0,15,4
1668503585713,MATH 240B,A00,098033,Ni; Lei,7,0,15,8
1668503586138,MATH 243,A00,098034,Jekel; David Andrew,10,0,10,0
1668503586562,MATH 245A,A00,098035,Nie; Jiawang,0,4,15,18
1668503586985,MATH 248,A00,098036,Bejenaru; Ioan,10,0,10,0
1668503587414,MATH 250B,A00,098037,Spolaor; Luca,14,0,15,1
1668503587837,MATH 258,A00,098038,Ni; Lei,9,0,10,1
1668503588262,MATH 264B,A00,098041,Rhoades; Brendon Patrick,8,0,15,7
1668503588692,MATH 268,A00,098042,Buss; Samuel R,10,0,10,0
1668503589117,MATH 269,A00,098043,Rhoades; Brendon Patrick,10,0,10,0
1668503589541,MATH 270B,A00,098044,Li; Bo,6,0,15,9
1668503589984,MATH 272B,A00,098045,Holst; Michael J,13,0,15,2
1668503590408,MATH 273A,A00,098046,Tian; Xiaochuan,10,0,15,5
1668503590832,MATH 275,A01,098048,Tian; Xiaochuan,6,0,10,4
1668503591259,MATH 278A,A00,098049,Holst; Michael J,7,0,10,3
1668503591690,MATH 278B,A00,098050,Cloninger; Alexander,10,0,10,0
1668503592113,MATH 278C,A00,098051,Nie; Jiawang,5,0,10,5
1668503592541,MATH 280B,A00,098052,Zheng; Tianyi,7,0,15,8
1668503592978,MATH 281B,A00,098053,Bradic; Jelena,0,2,15,15
1668503593405,MATH 282B,A00,098054,Arias-Castro; Ery,0,1,15,15
1668503593846,MATH 285,A00,098055,Fitzsimmons; Patrick J,0,3,15,17
1668503594271,MATH 287B,A00,098056,Arias-Castro; Ery,1,0,15,14
1668503594701,MATH 288,A00,098057,Agarwal; Pooja,9,0,10,1
1668503594701,MATH 288,B00,098058,Zhang; Danna,8,0,10,2
1668503594701,MATH 288,C00,098059,Williams; Ruth J,9,0,10,1
1668503595134,MATH 290B,A00,098060,Roberts; Justin Deritter,12,0,15,3
1668503595563,MATH 292,A00,098061,Belmont; Eva Kinoshita,10,0,10,0
1668503595986,MATH 295,A00,098062,Suk; Andrew Hoon,47,0,50,3
1668503596411,MATH 296,A00,098063,Novak; Jonathan I,20,0,20,0
1668503596835,MATH 297,001,098064,Gamst; Anthony Collins,9997,0,9999,2
1668504098116,COGS 205,A00,101395,Chiba; Andrea,19,0,20,1
1668504098542,COGS 210B,001,101404,Greene; Deanna Jacquelyn,9998,0,9999,1
1668504098542,COGS 210B,002,101417,Xia; Haijun,9999,0,9999,0
1668504098542,COGS 210B,003,101422,Nitz; Douglas A.,9999,0,9999,0
1668504098542,COGS 210B,004,101423,Hollan; James D.,9998,0,9999,1
1668504098542,COGS 210B,005,101424,Deak; Gedeon O.,9998,0,9999,1
1668504098542,COGS 210B,006,101425,Rossano; Federico,9999,0,9999,0
1668504098968,COGS 211B,A00,101427,Coulson; Seana M,9996,0,9999,3
1668504099392,COGS 220,A00,101428,Hollan; James D.,0,10,25,25
1668504099816,COGS 229,A00,101429,Dow; Steven P,17,0,25,8
1668504100334,COGS 230,A00,101430,Klemmer; Scott R,7,0,17,10
1668504100765,COGS 234,A00,101431,Xia; Haijun,1,0,25,24
1668504101193,COGS 260,A00,101432,Kiyonaga; Anastasia,21,0,25,4
1668504101193,COGS 260,B00,101433,Kirsh; David Joel,15,0,25,10
1668504101622,CSE 202,A00,102371,Impagliazzo; Russell,0,65,0,0
1668504102049,CSE 203B,A01,102373,Cheng; Chung Kuan,0,58,0,0
1668504102477,CSE 208,A00,102374,Micciancio; Daniele,0,5,0,0
1668504102905,CSE 209A,A00,112895,Impagliazzo; Russell,0,12,15,15
1668504103334,CSE 209B,A00,108005,Bellare; Mihir,0,7,0,0
1668504103760,CSE 210,A00,113163,Coblenz; Michael J,0,83,0,0
1668504104191,CSE 219,A00,106111,Dow; Steven P,0,6,20,20
1668504104616,CSE 221,A00,102376,Voelker; Geoffrey M.,0,72,0,0
1668504105041,CSE 224,A01,102378,Porter; George M,0,165,0,0
1668504105465,CSE 229A,A00,102379,Savage; Stefan,0,10,0,0
1668504105890,CSE 229C,A00,102380,Munyaka; Imani N. S.,0,10,0,0
1668504106319,CSE 232B,A00,102382,Deutsch; Alin Bernard,0,32,0,0
1668504106744,CSE 234,A01,112904,Kumar; Arun Kumar,0,0,0,0
1668504107173,CSE 237A,A00,102383,Rosing; Tajana Simunic,0,55,0,0
1668504107599,CSE 239A,A00,102384,Deutsch; Alin Bernard,0,14,0,0
1668504108035,CSE 239B,A00,102385,Polikarpova; Nadezhda,0,10,0,0
1668504108465,CSE 240A,A00,102386,Pannuto; Patrick William,0,46,0,0
1668504108896,CSE 240B,A00,102387,Zhao; Jishen,0,47,0,0
1668504109322,CSE 241A,A00,106406,Kang; Mingu,0,9,0,0
1668504109751,CSE 249B,A00,102388,Kahng; Andrew Byun,0,5,8,8
1668504110182,CSE 251B,A01,102392,Cottrell; Garrison W,0,51,0,0
1668504110182,CSE 251B,A02,102393,Cottrell; Garrison W,0,34,0,0
1668504110611,CSE 252B,A00,102394,Ochoa; Benjamin Lawrence,0,59,0,0
1668504111037,CSE 257,A01,102396,Gao; Sicun,0,138,0,0
1668504111482,CSE 272,A00,102397,Li; Tzumao,0,19,0,0
1668504111906,CSE 274,A00,111323,Chern; Albert Ren-Haur,0,15,0,0
1668504112330,CSE 282,A00,102398,Pevzner; Pavel Arkadjevich,0,0,0,0
1668504112755,CSE 284,A00,114175,Gymrek; Melissa Ann,0,22,0,0
1668504113190,CSE 290,A00,102399,Chandraker; Manmohan Krishna,0,11,0,0
1668504113190,CSE 290,B00,102400,Vaccaro; Kristen Marie,0,7,25,25
1668504113190,CSE 290,C00,102414,Pannuto; Patrick William,0,1,25,25
1668504113190,CSE 290,D00,102427,Pevzner; Pavel Arkadjevich,0,0,0,0
1668504113190,CSE 290,E00,102429,Zhao; Jishen,0,4,0,0
1668504113190,CSE 290,F00,102436,Tullsen; Dean Michael,0,5,0,0
1668504113190,CSE 290,G00,102440,Christensen; Henrik I,0,6,20,20
1668504113626,CSE 291,A00,102443,Su; Hao,0,0,0,0
1668504113626,CSE 291,B00,102448,Polikarpova; Nadezhda,0,0,0,0
1668504113626,CSE 291,C00,102453,Vaccaro; Kristen Marie,0,0,0,0
1668504113626,CSE 291,D00,111343,Savage; Stefan,0,0,0,0
1668504113626,CSE 291,E00,116474,Claffy; Kimberly Claire,0,0,0,0
1668504113626,CSE 291,F00,116479,Pasquale; Joseph,0,0,0,0
1668504114074,CSE 293,001,119111,Bafna; Vineet,9999,0,9999,0
1668504114074,CSE 293,002,119118,Bellare; Mihir,9999,0,9999,0
1668504114074,CSE 293,003,119122,Berg-Kirkpatrick; Taylor D,9999,0,9999,0
1668504114074,CSE 293,004,119135,Christensen; Henrik I,9999,0,9999,0
1668504114074,CSE 293,005,119142,Cottrell; Garrison W,9999,0,9999,0
1668504114074,CSE 293,006,119146,Deutsch; Alin Bernard,9999,0,9999,0
1668504114074,CSE 293,007,119159,Esmaeilzadeh; Hadi,9999,0,9999,0
1668504114074,CSE 293,008,119166,Freund; Yoav,9999,0,9999,0
1668504114074,CSE 293,009,119170,Griswold; William G.,9999,0,9999,0
1668504114074,CSE 293,010,119183,Gymrek; Melissa Ann,9999,0,9999,0
1668504114074,CSE 293,011,119190,Heninger; Nadia A,9999,0,9999,0
1668504114074,CSE 293,012,119230,Impagliazzo; Russell,9999,0,9999,0
1668504114074,CSE 293,013,119232,Jhala; Ranjit,9999,0,9999,0
1668504114074,CSE 293,014,119233,Kahng; Andrew Byun,9999,0,9999,0
1668504114074,CSE 293,015,119298,Kane; Daniel Mertz,9999,0,9999,0
1668504114074,CSE 293,016,119299,Kriegman; David J,9999,0,9999,0
1668504114074,CSE 293,017,119300,Kumar; Arun Kumar,9999,0,9999,0
1668504114074,CSE 293,018,119301,Lerner; Sorin,9999,0,9999,0
1668504114074,CSE 293,019,119302,Lovett; Shachar,9999,0,9999,0
1668504114074,CSE 293,020,119303,McAuley; Julian John,9999,0,9999,0
1668504114074,CSE 293,021,119304,Micciancio; Daniele,9999,0,9999,0
1668504114074,CSE 293,022,119367,Orailoglu; Alex,9999,0,9999,0
1668504114074,CSE 293,023,119382,Paturi; Ramamohan,9999,0,9999,0
1668504114074,CSE 293,024,119404,Polikarpova; Nadezhda,9999,0,9999,0
1668504114074,CSE 293,025,119406,Politz; Joseph Gibbs,9999,0,9999,0
1668504114074,CSE 293,026,119411,Porter; George M,9999,0,9999,0
1668504114074,CSE 293,027,119414,Porter; Leonard Emerson,9999,0,9999,0
1668504114074,CSE 293,028,119416,Ramamoorthi; Ravi,9999,0,9999,0
1668504114074,CSE 293,029,119417,Sahoo; Debashis,9999,0,9999,0
1668504114074,CSE 293,030,119420,Saul; Lawrence,9999,0,9999,0
1668504114074,CSE 293,031,119421,Savage; Stefan,9999,0,9999,0
1668504114074,CSE 293,032,119425,Schulze; Jurgen P.,9999,0,9999,0
1668504114074,CSE 293,033,119426,Snoeren; Alex C.,9999,0,9999,0
1668504114074,CSE 293,034,119428,Shang; Jingbo,9999,0,9999,0
1668504114074,CSE 293,035,119430,Stefan; Deian,9999,0,9999,0
1668504114074,CSE 293,036,119431,Su; Hao,9999,0,9999,0
1668504114074,CSE 293,037,119433,Swanson; Steven James,9999,0,9999,0
1668504114074,CSE 293,038,119435,Tullsen; Dean Michael,9999,0,9999,0
1668504114074,CSE 293,039,119483,Voelker; Geoffrey M.,9999,0,9999,0
1668504114074,CSE 293,040,119537,Zhao; Jishen,9999,0,9999,0
1668504114074,CSE 293,041,119538,Zhou; Yuan-Yuan,9999,0,9999,0
1668504114074,CSE 293,042,119539,Gao; Sicun,9999,0,9999,0
1668504114074,CSE 293,043,119540,Weibel; Nadir,9999,0,9999,0
1668504114074,CSE 293,044,119541,Gupta; Rajesh K.,9999,0,9999,0
1668504114074,CSE 293,045,126410,Vaccaro; Kristen Marie,9999,0,9999,0
1668504114074,CSE 293,046,126411,Klemke; Richard,9999,0,9999,0
1668504114499,CSE 294,A00,102459,Voelker; Geoffrey M.,0,2,0,0
1668504114499,CSE 294,B00,111322,Orailoglu; Alex,0,2,0,0
1668504114925,DSE 201,A00,096914,Deutsch; Alin Bernard,30,0,30,0
1668504115354,DSE 210,A00,096915,Dasgupta; Sanjoy,30,0,30,0
1668504115782,DSE 260A,A00,096916,Altintas De Callaf; Ilkay,30,0,30,0
1668504116237,ECE 200,001,103586,Antipa; Nicholas A,9999,0,9999,0
1668504116237,ECE 200,002,103587,Atanasov; Nikolay A.,9999,0,9999,0
1668504116237,ECE 200,003,103588,Bharadia; Dinesh,9999,0,9999,0
1668504116237,ECE 200,004,103589,Cheng; Chung Kuan,9999,0,9999,0
1668504116237,ECE 200,005,103590,Cosman; Pamela C.,9999,0,9999,0
1668504116237,ECE 200,006,103591,Dayeh; Shadi Ahmad,9999,0,9999,0
1668504116237,ECE 200,007,103592,Fainman; Yeshaiahu,9999,0,9999,0
1668504116237,ECE 200,008,103593,Ford; Joseph Earl,9999,0,9999,0
1668504116237,ECE 200,009,103594,Franceschetti; Massimo,9999,0,9999,0
1668504116237,ECE 200,010,103595,Fullerton; Eric E,9999,0,9999,0
1668504116237,ECE 200,011,103596,Galton; Ian A,9999,0,9999,0
1668504116237,ECE 200,012,103597,Gilja; Vikash,9999,0,9999,0
1668504116237,ECE 200,013,103598,Hall; Drew A.,9999,0,9999,0
1668504116237,ECE 200,014,103599,Hsueh; Tzu-Chien,9999,0,9999,0
1668504116237,ECE 200,015,103600,Javidi; Tara,9999,0,9999,0
1668504116237,ECE 200,016,103601,Kahng; Andrew Byun,9999,0,9999,0
1668504116237,ECE 200,017,103602,Kim; Young-Han,9999,0,9999,0
1668504116237,ECE 200,018,103603,Koushanfar; Farinaz,9999,0,9999,0
1668504116237,ECE 200,019,103604,Kuzum; Duygu,9999,0,9999,0
1668504116237,ECE 200,020,103605,Le; Hanh-Phuc,9999,0,9999,0
1668504116237,ECE 200,021,103606,Lin; Bill,9999,0,9999,0
1668504116237,ECE 200,022,103607,Liu; Zhaowei,9998,0,9999,1
1668504116237,ECE 200,023,103608,Lo; Yu-Hwa,9999,0,9999,0
1668504116237,ECE 200,024,103609,Lomakin; Vitaliy,9999,0,9999,0
1668504116237,ECE 200,025,103610,Mercier; Patrick Philip,9999,0,9999,0
1668504116237,ECE 200,026,103611,Meyer; Florian,9999,0,9999,0
1668504116237,ECE 200,027,103612,Milstein; Laurence B.,9999,0,9999,0
1668504116237,ECE 200,028,103613,Mir Arabbaygi; Siavash,9999,0,9999,0
1668504116237,ECE 200,029,103614,Mookherjea; Shayan,9999,0,9999,0
1668504116237,ECE 200,030,103615,Morris; Karcher William,9999,0,9999,0
1668504116237,ECE 200,031,103616,Ng; Tse Nga,9999,0,9999,0
1668504116237,ECE 200,032,103617,Nguyen; Truong Quang,9999,0,9999,0
1668504116237,ECE 200,033,103618,Nomura; Kenji,9999,0,9999,0
1668504116237,ECE 200,034,103619,Orlitsky; Alon,9999,0,9999,0
1668504116237,ECE 200,035,103620,Pal; Piya,9999,0,9999,0
1668504116237,ECE 200,036,103621,Papen; George C.,9999,0,9999,0
1668504116237,ECE 200,037,103622,Radic; Stojan,9999,0,9999,0
1668504116237,ECE 200,038,103623,Rao; Bhaskar D.,9999,0,9999,0
1668504116237,ECE 200,039,103624,Rao; Ramesh R,9999,0,9999,0
1668504116237,ECE 200,040,103625,Rebeiz; Gabriel,9999,0,9999,0
1668504116237,ECE 200,041,103626,Sanford; John R,9999,0,9999,0
1668504116237,ECE 200,042,103627,Siegel; Paul H.,9999,0,9999,0
1668504116237,ECE 200,043,103628,Sievenpiper; Daniel F.,9999,0,9999,0
1668504116237,ECE 200,044,103629,Sworder; David D.,9999,0,9999,0
1668504116237,ECE 200,045,103630,Taur; Yuan,9999,0,9999,0
1668504116237,ECE 200,046,103631,Touri; Behrouz,9999,0,9999,0
1668504116237,ECE 200,047,103632,Trivedi; Mohan M.,9999,0,9999,0
1668504116237,ECE 200,048,103633,Vasconcelos; Nuno,9999,0,9999,0
1668504116237,ECE 200,049,103634,Wang; Xiaolong,9999,0,9999,0
1668504116237,ECE 200,050,103635,Xie; Pengtao,9999,0,9999,0
1668504116237,ECE 200,051,103636,Yip; Michael,9999,0,9999,0
1668504116237,ECE 200,052,103637,Zeger; Kenneth A.,999,0,999,0
1668504116237,ECE 200,053,103638,Zhang; Xinyu,9999,0,9999,0
1668504116237,ECE 200,054,103639,Turakhia; Yatish Girish,9999,0,9999,0
1668504116237,ECE 200,055,103640,Kang; Mingu,9999,0,9999,0
1668504116237,ECE 200,056,103641,Shi; Yuanyuan,9999,0,9999,0
1668504116237,ECE 200,057,103642,Wang; Edward Jay,9999,0,9999,0
1668504116237,ECE 200,058,103643,Zheng; Yang,9999,0,9999,0
1668504116661,ECE 202,A00,103644,Kuzum; Duygu,0,44,0,0
1668504117086,ECE 212BN,A00,103646,Ng; Tse Nga,0,9,0,0
1668504117514,ECE 221,A00,111493,Staff,0,0,0,0
1668504117944,ECE 222B,A00,103647,Lomakin; Vitaliy,0,20,0,0
1668504118373,ECE 230B,A00,103648,Taur; Yuan,0,3,0,0
1668504118803,ECE 238B,A00,103649,Garay; Javier,0,0,0,0
1668504119230,ECE 240B,A00,112900,Fainman; Yeshaiahu,0,7,0,0
1668504119659,ECE 247A,A00,103650,Jokerst; Jesse Vincent,0,6,0,0
1668504120088,ECE 247B,A00,103651,Wang; Joseph,0,14,0,0
1668504120518,ECE 250,A00,103652,Siegel; Paul H.,0,82,0,0
1668504120943,ECE 251A,A00,103654,Rao; Bhaskar D.,0,61,0,0
1668504121368,ECE 257B,A00,103655,Bharadia; Dinesh,0,32,0,0
1668504121795,ECE 258A,A00,103656,Milstein; Laurence B.,0,29,0,0
1668504122219,ECE 260B,A00,103658,Kang; Mingu,0,119,0,0
1668504122647,ECE 264A,A00,103659,Galton; Ian A,0,65,0,0
1668504123072,ECE 265A,A00,103661,Gudem; Prasad S.S.,0,70,0,0
1668504123499,ECE 265D,A00,103662,Gudem; Prasad S.S.,0,26,0,0
1668504123923,ECE 268,A00,103663,Koushanfar; Farinaz,0,43,0,0
1668504124355,ECE 269,A01,103665,Pal; Piya,0,215,0,0
1668504124790,ECE 271B,A00,103666,Vasconcelos; Manuela,0,76,0,0
1668504125218,ECE 276A,A00,103667,Atanasov; Nikolay A.,0,126,0,0
1668504125658,ECE 277,A00,103668,An; Cheolhong,0,148,0,0
1668504126082,ECE 279,A00,117947,Hall; Drew A.,0,22,0,0
1668504126937,ECE 283,A00,103670,Hsueh; Tzu-Chien,0,53,0,0
1668504127362,ECE 284,A00,103671,Turakhia; Yatish Girish,0,39,0,0
1668504127791,ECE 285,A00,103672,Zheng; Yang,0,39,0,0
1668504127791,ECE 285,B00,103673,Sworder; David D.,0,57,0,0
1668504128217,ECE 287,A00,103676,Javidi; Tara,0,9,0,0
1668504128644,MATH 200B,A00,098023,Salehi Golsefidy; Alireza,10,0,15,5
1668504129069,MATH 202B,A00,098024,Rhoades; Brendon Patrick,7,0,15,8
1668504129494,MATH 203B,A00,098025,Oprea; Dragos N.,9,0,15,6
1668504129918,MATH 204B,A00,098026,Sorensen; Claus M,13,0,15,2
1668504130344,MATH 208,A00,098027,Izadi; Elham,7,0,10,3
1668504130768,MATH 209,A00,098028,Pollack; Aaron,10,0,10,0
1668504131194,MATH 211A,A00,112919,Rogalski; Daniel,8,0,10,2
1668504131617,MATH 211B,A00,112920,Seward; Brandon M.,9,0,10,1
1668504132046,MATH 218,A00,098029,Li; Bo,10,0,10,0
1668504132473,MATH 220B,A00,098030,Novak; Jonathan I,11,0,15,4
1668504132899,MATH 221A,A00,098031,Ebenfelt; Peter F,12,0,15,3
1668504133326,MATH 231B,A00,098032,Zlatos; Andrej,11,0,15,4
1668504133750,MATH 240B,A00,098033,Ni; Lei,7,0,15,8
1668504134178,MATH 243,A00,098034,Jekel; David Andrew,10,0,10,0
1668504134603,MATH 245A,A00,098035,Nie; Jiawang,0,4,15,18
1668504135029,MATH 248,A00,098036,Bejenaru; Ioan,10,0,10,0
1668504135455,MATH 250B,A00,098037,Spolaor; Luca,14,0,15,1
1668504135883,MATH 258,A00,098038,Ni; Lei,9,0,10,1
1668504136306,MATH 264B,A00,098041,Rhoades; Brendon Patrick,8,0,15,7
1668504136731,MATH 268,A00,098042,Buss; Samuel R,10,0,10,0
1668504137156,MATH 269,A00,098043,Rhoades; Brendon Patrick,10,0,10,0
1668504137586,MATH 270B,A00,098044,Li; Bo,6,0,15,9
1668504138014,MATH 272B,A00,098045,Holst; Michael J,13,0,15,2
1668504138440,MATH 273A,A00,098046,Tian; Xiaochuan,10,0,15,5
1668504138873,MATH 275,A01,098048,Tian; Xiaochuan,6,0,10,4
1668504139297,MATH 278A,A00,098049,Holst; Michael J,7,0,10,3
1668504139722,MATH 278B,A00,098050,Cloninger; Alexander,10,0,10,0
1668504140150,MATH 278C,A00,098051,Nie; Jiawang,5,0,10,5
1668504140578,MATH 280B,A00,098052,Zheng; Tianyi,7,0,15,8
1668504141002,MATH 281B,A00,098053,Bradic; Jelena,0,2,15,15
1668504141427,MATH 282B,A00,098054,Arias-Castro; Ery,0,1,15,15
1668504141852,MATH 285,A00,098055,Fitzsimmons; Patrick J,0,3,15,17
1668504142280,MATH 287B,A00,098056,Arias-Castro; Ery,1,0,15,14
1668504142710,MATH 288,A00,098057,Agarwal; Pooja,9,0,10,1
1668504142710,MATH 288,B00,098058,Zhang; Danna,8,0,10,2
1668504142710,MATH 288,C00,098059,Williams; Ruth J,9,0,10,1
1668504143137,MATH 290B,A00,098060,Roberts; Justin Deritter,12,0,15,3
1668504143673,MATH 292,A00,098061,Belmont; Eva Kinoshita,10,0,10,0
1668504144097,MATH 295,A00,098062,Suk; Andrew Hoon,47,0,50,3
1668504144523,MATH 296,A00,098063,Novak; Jonathan I,20,0,20,0
1668504144946,MATH 297,001,098064,Gamst; Anthony Collins,9997,0,9999,2
1668504648072,COGS 205,A00,101395,Chiba; Andrea,19,0,20,1
1668504648497,COGS 210B,001,101404,Greene; Deanna Jacquelyn,9998,0,9999,1
1668504648497,COGS 210B,002,101417,Xia; Haijun,9999,0,9999,0
1668504648497,COGS 210B,003,101422,Nitz; Douglas A.,9999,0,9999,0
1668504648497,COGS 210B,004,101423,Hollan; James D.,9998,0,9999,1
1668504648497,COGS 210B,005,101424,Deak; Gedeon O.,9998,0,9999,1
1668504648497,COGS 210B,006,101425,Rossano; Federico,9999,0,9999,0
1668504648924,COGS 211B,A00,101427,Coulson; Seana M,9996,0,9999,3
1668504649348,COGS 220,A00,101428,Hollan; James D.,0,10,25,25
1668504649777,COGS 229,A00,101429,Dow; Steven P,17,0,25,8
1668504650201,COGS 230,A00,101430,Klemmer; Scott R,7,0,17,10
1668504650626,COGS 234,A00,101431,Xia; Haijun,1,0,25,24
1668504651051,COGS 260,A00,101432,Kiyonaga; Anastasia,21,0,25,4
1668504651051,COGS 260,B00,101433,Kirsh; David Joel,15,0,25,10
1668504651475,CSE 202,A00,102371,Impagliazzo; Russell,0,65,0,0
1668504651899,CSE 203B,A01,102373,Cheng; Chung Kuan,0,58,0,0
1668504652327,CSE 208,A00,102374,Micciancio; Daniele,0,5,0,0
1668504652753,CSE 209A,A00,112895,Impagliazzo; Russell,0,12,15,15
1668504653178,CSE 209B,A00,108005,Bellare; Mihir,0,7,0,0
1668504653603,CSE 210,A00,113163,Coblenz; Michael J,0,83,0,0
1668504654027,CSE 219,A00,106111,Dow; Steven P,0,6,20,20
1668504654456,CSE 221,A00,102376,Voelker; Geoffrey M.,0,72,0,0
1668504654882,CSE 224,A01,102378,Porter; George M,0,165,0,0
1668504655306,CSE 229A,A00,102379,Savage; Stefan,0,10,0,0
1668504655742,CSE 229C,A00,102380,Munyaka; Imani N. S.,0,10,0,0
1668504656168,CSE 232B,A00,102382,Deutsch; Alin Bernard,0,32,0,0
1668504656594,CSE 234,A01,112904,Kumar; Arun Kumar,0,0,0,0
1668504657022,CSE 237A,A00,102383,Rosing; Tajana Simunic,0,55,0,0
1668504657447,CSE 239A,A00,102384,Deutsch; Alin Bernard,0,14,0,0
1668504657879,CSE 239B,A00,102385,Polikarpova; Nadezhda,0,10,0,0
1668504658309,CSE 240A,A00,102386,Pannuto; Patrick William,0,46,0,0
1668504658734,CSE 240B,A00,102387,Zhao; Jishen,0,47,0,0
1668504659158,CSE 241A,A00,106406,Kang; Mingu,0,9,0,0
1668504659583,CSE 249B,A00,102388,Kahng; Andrew Byun,0,5,8,8
1668504660017,CSE 251B,A01,102392,Cottrell; Garrison W,0,51,0,0
1668504660017,CSE 251B,A02,102393,Cottrell; Garrison W,0,34,0,0
1668504660445,CSE 252B,A00,102394,Ochoa; Benjamin Lawrence,0,59,0,0
1668504660874,CSE 257,A01,102396,Gao; Sicun,0,138,0,0
1668504661299,CSE 272,A00,102397,Li; Tzumao,0,19,0,0
1668504661734,CSE 274,A00,111323,Chern; Albert Ren-Haur,0,15,0,0
1668504662159,CSE 282,A00,102398,Pevzner; Pavel Arkadjevich,0,0,0,0
1668504662588,CSE 284,A00,114175,Gymrek; Melissa Ann,0,22,0,0
1668504663021,CSE 290,A00,102399,Chandraker; Manmohan Krishna,0,11,0,0
1668504663021,CSE 290,B00,102400,Vaccaro; Kristen Marie,0,7,25,25
1668504663021,CSE 290,C00,102414,Pannuto; Patrick William,0,1,25,25
1668504663021,CSE 290,D00,102427,Pevzner; Pavel Arkadjevich,0,0,0,0
1668504663021,CSE 290,E00,102429,Zhao; Jishen,0,4,0,0
1668504663021,CSE 290,F00,102436,Tullsen; Dean Michael,0,5,0,0
1668504663021,CSE 290,G00,102440,Christensen; Henrik I,0,6,20,20
1668504663458,CSE 291,A00,102443,Su; Hao,0,0,0,0
1668504663458,CSE 291,B00,102448,Polikarpova; Nadezhda,0,0,0,0
1668504663458,CSE 291,C00,102453,Vaccaro; Kristen Marie,0,0,0,0
1668504663458,CSE 291,D00,111343,Savage; Stefan,0,0,0,0
1668504663458,CSE 291,E00,116474,Claffy; Kimberly Claire,0,0,0,0
1668504663458,CSE 291,F00,116479,Pasquale; Joseph,0,0,0,0
1668504663919,CSE 293,001,119111,Bafna; Vineet,9999,0,9999,0
1668504663919,CSE 293,002,119118,Bellare; Mihir,9999,0,9999,0
1668504663919,CSE 293,003,119122,Berg-Kirkpatrick; Taylor D,9999,0,9999,0
1668504663919,CSE 293,004,119135,Christensen; Henrik I,9999,0,9999,0
1668504663919,CSE 293,005,119142,Cottrell; Garrison W,9999,0,9999,0
1668504663919,CSE 293,006,119146,Deutsch; Alin Bernard,9999,0,9999,0
1668504663919,CSE 293,007,119159,Esmaeilzadeh; Hadi,9999,0,9999,0
1668504663919,CSE 293,008,119166,Freund; Yoav,9999,0,9999,0
1668504663919,CSE 293,009,119170,Griswold; William G.,9999,0,9999,0
1668504663919,CSE 293,010,119183,Gymrek; Melissa Ann,9999,0,9999,0
1668504663919,CSE 293,011,119190,Heninger; Nadia A,9999,0,9999,0
1668504663919,CSE 293,012,119230,Impagliazzo; Russell,9999,0,9999,0
1668504663919,CSE 293,013,119232,Jhala; Ranjit,9999,0,9999,0
1668504663919,CSE 293,014,119233,Kahng; Andrew Byun,9999,0,9999,0
1668504663919,CSE 293,015,119298,Kane; Daniel Mertz,9999,0,9999,0
1668504663919,CSE 293,016,119299,Kriegman; David J,9999,0,9999,0
1668504663919,CSE 293,017,119300,Kumar; Arun Kumar,9999,0,9999,0
1668504663919,CSE 293,018,119301,Lerner; Sorin,9999,0,9999,0
1668504663919,CSE 293,019,119302,Lovett; Shachar,9999,0,9999,0
1668504663919,CSE 293,020,119303,McAuley; Julian John,9999,0,9999,0
1668504663919,CSE 293,021,119304,Micciancio; Daniele,9999,0,9999,0
1668504663919,CSE 293,022,119367,Orailoglu; Alex,9999,0,9999,0
1668504663919,CSE 293,023,119382,Paturi; Ramamohan,9999,0,9999,0
1668504663919,CSE 293,024,119404,Polikarpova; Nadezhda,9999,0,9999,0
1668504663919,CSE 293,025,119406,Politz; Joseph Gibbs,9999,0,9999,0
1668504663919,CSE 293,026,119411,Porter; George M,9999,0,9999,0
1668504663919,CSE 293,027,119414,Porter; Leonard Emerson,9999,0,9999,0
1668504663919,CSE 293,028,119416,Ramamoorthi; Ravi,9999,0,9999,0
1668504663919,CSE 293,029,119417,Sahoo; Debashis,9999,0,9999,0
1668504663919,CSE 293,030,119420,Saul; Lawrence,9999,0,9999,0
1668504663919,CSE 293,031,119421,Savage; Stefan,9999,0,9999,0
1668504663919,CSE 293,032,119425,Schulze; Jurgen P.,9999,0,9999,0
1668504663919,CSE 293,033,119426,Snoeren; Alex C.,9999,0,9999,0
1668504663919,CSE 293,034,119428,Shang; Jingbo,9999,0,9999,0
1668504663919,CSE 293,035,119430,Stefan; Deian,9999,0,9999,0
1668504663919,CSE 293,036,119431,Su; Hao,9999,0,9999,0
1668504663919,CSE 293,037,119433,Swanson; Steven James,9999,0,9999,0
1668504663919,CSE 293,038,119435,Tullsen; Dean Michael,9999,0,9999,0
1668504663919,CSE 293,039,119483,Voelker; Geoffrey M.,9999,0,9999,0
1668504663919,CSE 293,040,119537,Zhao; Jishen,9999,0,9999,0
1668504663919,CSE 293,041,119538,Zhou; Yuan-Yuan,9999,0,9999,0
1668504663919,CSE 293,042,119539,Gao; Sicun,9999,0,9999,0
1668504663919,CSE 293,043,119540,Weibel; Nadir,9999,0,9999,0
1668504663919,CSE 293,044,119541,Gupta; Rajesh K.,9999,0,9999,0
1668504663919,CSE 293,045,126410,Vaccaro; Kristen Marie,9999,0,9999,0
1668504663919,CSE 293,046,126411,Klemke; Richard,9999,0,9999,0
1668504664343,CSE 294,A00,102459,Voelker; Geoffrey M.,0,2,0,0
1668504664343,CSE 294,B00,111322,Orailoglu; Alex,0,2,0,0
1668504664769,DSE 201,A00,096914,Deutsch; Alin Bernard,30,0,30,0
1668504665198,DSE 210,A00,096915,Dasgupta; Sanjoy,30,0,30,0
1668504665714,DSE 260A,A00,096916,Altintas De Callaf; Ilkay,30,0,30,0
1668504666182,ECE 200,001,103586,Antipa; Nicholas A,9999,0,9999,0
1668504666182,ECE 200,002,103587,Atanasov; Nikolay A.,9999,0,9999,0
1668504666182,ECE 200,003,103588,Bharadia; Dinesh,9999,0,9999,0
1668504666182,ECE 200,004,103589,Cheng; Chung Kuan,9999,0,9999,0
1668504666182,ECE 200,005,103590,Cosman; Pamela C.,9999,0,9999,0
1668504666182,ECE 200,006,103591,Dayeh; Shadi Ahmad,9999,0,9999,0
1668504666182,ECE 200,007,103592,Fainman; Yeshaiahu,9999,0,9999,0
1668504666182,ECE 200,008,103593,Ford; Joseph Earl,9999,0,9999,0
1668504666182,ECE 200,009,103594,Franceschetti; Massimo,9999,0,9999,0
1668504666182,ECE 200,010,103595,Fullerton; Eric E,9999,0,9999,0
1668504666182,ECE 200,011,103596,Galton; Ian A,9999,0,9999,0
1668504666182,ECE 200,012,103597,Gilja; Vikash,9999,0,9999,0
1668504666182,ECE 200,013,103598,Hall; Drew A.,9999,0,9999,0
1668504666182,ECE 200,014,103599,Hsueh; Tzu-Chien,9999,0,9999,0
1668504666182,ECE 200,015,103600,Javidi; Tara,9999,0,9999,0
1668504666182,ECE 200,016,103601,Kahng; Andrew Byun,9999,0,9999,0
1668504666182,ECE 200,017,103602,Kim; Young-Han,9999,0,9999,0
1668504666182,ECE 200,018,103603,Koushanfar; Farinaz,9999,0,9999,0
1668504666182,ECE 200,019,103604,Kuzum; Duygu,9999,0,9999,0
1668504666182,ECE 200,020,103605,Le; Hanh-Phuc,9999,0,9999,0
1668504666182,ECE 200,021,103606,Lin; Bill,9999,0,9999,0
1668504666182,ECE 200,022,103607,Liu; Zhaowei,9998,0,9999,1
1668504666182,ECE 200,023,103608,Lo; Yu-Hwa,9999,0,9999,0
1668504666182,ECE 200,024,103609,Lomakin; Vitaliy,9999,0,9999,0
1668504666182,ECE 200,025,103610,Mercier; Patrick Philip,9999,0,9999,0
1668504666182,ECE 200,026,103611,Meyer; Florian,9999,0,9999,0
1668504666182,ECE 200,027,103612,Milstein; Laurence B.,9999,0,9999,0
1668504666182,ECE 200,028,103613,Mir Arabbaygi; Siavash,9999,0,9999,0
1668504666182,ECE 200,029,103614,Mookherjea; Shayan,9999,0,9999,0
1668504666182,ECE 200,030,103615,Morris; Karcher William,9999,0,9999,0
1668504666182,ECE 200,031,103616,Ng; Tse Nga,9999,0,9999,0
1668504666182,ECE 200,032,103617,Nguyen; Truong Quang,9999,0,9999,0
1668504666182,ECE 200,033,103618,Nomura; Kenji,9999,0,9999,0
1668504666182,ECE 200,034,103619,Orlitsky; Alon,9999,0,9999,0
1668504666182,ECE 200,035,103620,Pal; Piya,9999,0,9999,0
1668504666182,ECE 200,036,103621,Papen; George C.,9999,0,9999,0
1668504666182,ECE 200,037,103622,Radic; Stojan,9999,0,9999,0
1668504666182,ECE 200,038,103623,Rao; Bhaskar D.,9999,0,9999,0
1668504666182,ECE 200,039,103624,Rao; Ramesh R,9999,0,9999,0
1668504666182,ECE 200,040,103625,Rebeiz; Gabriel,9999,0,9999,0
1668504666182,ECE 200,041,103626,Sanford; John R,9999,0,9999,0
1668504666182,ECE 200,042,103627,Siegel; Paul H.,9999,0,9999,0
1668504666182,ECE 200,043,103628,Sievenpiper; Daniel F.,9999,0,9999,0
1668504666182,ECE 200,044,103629,Sworder; David D.,9999,0,9999,0
1668504666182,ECE 200,045,103630,Taur; Yuan,9999,0,9999,0
1668504666182,ECE 200,046,103631,Touri; Behrouz,9999,0,9999,0
1668504666182,ECE 200,047,103632,Trivedi; Mohan M.,9999,0,9999,0
1668504666182,ECE 200,048,103633,Vasconcelos; Nuno,9999,0,9999,0
1668504666182,ECE 200,049,103634,Wang; Xiaolong,9999,0,9999,0
1668504666182,ECE 200,050,103635,Xie; Pengtao,9999,0,9999,0
1668504666182,ECE 200,051,103636,Yip; Michael,9999,0,9999,0
1668504666182,ECE 200,052,103637,Zeger; Kenneth A.,999,0,999,0
1668504666182,ECE 200,053,103638,Zhang; Xinyu,9999,0,9999,0
1668504666182,ECE 200,054,103639,Turakhia; Yatish Girish,9999,0,9999,0
1668504666182,ECE 200,055,103640,Kang; Mingu,9999,0,9999,0
1668504666182,ECE 200,056,103641,Shi; Yuanyuan,9999,0,9999,0
1668504666182,ECE 200,057,103642,Wang; Edward Jay,9999,0,9999,0
1668504666182,ECE 200,058,103643,Zheng; Yang,9999,0,9999,0
1668504666616,ECE 202,A00,103644,Kuzum; Duygu,0,44,0,0
1668504667041,ECE 212BN,A00,103646,Ng; Tse Nga,0,9,0,0
1668504667466,ECE 221,A00,111493,Staff,0,0,0,0
1668504667896,ECE 222B,A00,103647,Lomakin; Vitaliy,0,20,0,0
1668504668321,ECE 230B,A00,103648,Taur; Yuan,0,3,0,0
1668504668755,ECE 238B,A00,103649,Garay; Javier,0,0,0,0
1668504669178,ECE 240B,A00,112900,Fainman; Yeshaiahu,0,7,0,0
1668504669607,ECE 247A,A00,103650,Jokerst; Jesse Vincent,0,6,0,0
1668504670033,ECE 247B,A00,103651,Wang; Joseph,0,14,0,0
1668504670463,ECE 250,A00,103652,Siegel; Paul H.,0,82,0,0
1668504670892,ECE 251A,A00,103654,Rao; Bhaskar D.,0,61,0,0
1668504671321,ECE 257B,A00,103655,Bharadia; Dinesh,0,32,0,0
1668504671755,ECE 258A,A00,103656,Milstein; Laurence B.,0,29,0,0
1668504672179,ECE 260B,A00,103658,Kang; Mingu,0,119,0,0
1668504672611,ECE 264A,A00,103659,Galton; Ian A,0,65,0,0
1668504673037,ECE 265A,A00,103661,Gudem; Prasad S.S.,0,70,0,0
1668504673461,ECE 265D,A00,103662,Gudem; Prasad S.S.,0,26,0,0
1668504673885,ECE 268,A00,103663,Koushanfar; Farinaz,0,43,0,0
1668504674316,ECE 269,A01,103665,Pal; Piya,0,215,0,0
1668504674747,ECE 271B,A00,103666,Vasconcelos; Manuela,0,76,0,0
1668504675181,ECE 276A,A00,103667,Atanasov; Nikolay A.,0,126,0,0
1668504675612,ECE 277,A00,103668,An; Cheolhong,0,148,0,0
1668504676037,ECE 279,A00,117947,Hall; Drew A.,0,22,0,0
1668504676896,ECE 283,A00,103670,Hsueh; Tzu-Chien,0,53,0,0
1668504677320,ECE 284,A00,103671,Turakhia; Yatish Girish,0,39,0,0
1668504677753,ECE 285,A00,103672,Zheng; Yang,0,39,0,0
1668504677753,ECE 285,B00,103673,Sworder; David D.,0,57,0,0
1668504678182,ECE 287,A00,103676,Javidi; Tara,0,9,0,0
1668504678609,MATH 200B,A00,098023,Salehi Golsefidy; Alireza,10,0,15,5
1668504679035,MATH 202B,A00,098024,Rhoades; Brendon Patrick,7,0,15,8
1668504679462,MATH 203B,A00,098025,Oprea; Dragos N.,9,0,15,6
1668504679892,MATH 204B,A00,098026,Sorensen; Claus M,13,0,15,2
1668504680317,MATH 208,A00,098027,Izadi; Elham,7,0,10,3
1668504680745,MATH 209,A00,098028,Pollack; Aaron,10,0,10,0
1668504681168,MATH 211A,A00,112919,Rogalski; Daniel,8,0,10,2
1668504681594,MATH 211B,A00,112920,Seward; Brandon M.,9,0,10,1
1668504682020,MATH 218,A00,098029,Li; Bo,10,0,10,0
1668504682446,MATH 220B,A00,098030,Novak; Jonathan I,11,0,15,4
1668504682876,MATH 221A,A00,098031,Ebenfelt; Peter F,12,0,15,3
1668504683302,MATH 231B,A00,098032,Zlatos; Andrej,11,0,15,4
1668504683727,MATH 240B,A00,098033,Ni; Lei,7,0,15,8
1668504684150,MATH 243,A00,098034,Jekel; David Andrew,10,0,10,0
1668504684590,MATH 245A,A00,098035,Nie; Jiawang,0,4,15,18
1668504685014,MATH 248,A00,098036,Bejenaru; Ioan,10,0,10,0
1668504685444,MATH 250B,A00,098037,Spolaor; Luca,14,0,15,1
1668504685871,MATH 258,A00,098038,Ni; Lei,9,0,10,1
1668504686298,MATH 264B,A00,098041,Rhoades; Brendon Patrick,8,0,15,7
1668504686723,MATH 268,A00,098042,Buss; Samuel R,10,0,10,0
1668504687147,MATH 269,A00,098043,Rhoades; Brendon Patrick,10,0,10,0
1668504687573,MATH 270B,A00,098044,Li; Bo,6,0,15,9
1668504687997,MATH 272B,A00,098045,Holst; Michael J,13,0,15,2
1668504688426,MATH 273A,A00,098046,Tian; Xiaochuan,10,0,15,5
1668504688851,MATH 275,A01,098048,Tian; Xiaochuan,6,0,10,4
1668504689275,MATH 278A,A00,098049,Holst; Michael J,7,0,10,3
1668504689703,MATH 278B,A00,098050,Cloninger; Alexander,10,0,10,0
1668504690131,MATH 278C,A00,098051,Nie; Jiawang,5,0,10,5
1668504690556,MATH 280B,A00,098052,Zheng; Tianyi,7,0,15,8
1668504690987,MATH 281B,A00,098053,Bradic; Jelena,0,2,15,15
1668504691411,MATH 282B,A00,098054,Arias-Castro; Ery,0,1,15,15
1668504691840,MATH 285,A00,098055,Fitzsimmons; Patrick J,0,3,15,17
1668504692274,MATH 287B,A00,098056,Arias-Castro; Ery,1,0,15,14
1668504692703,MATH 288,A00,098057,Agarwal; Pooja,9,0,10,1
1668504692703,MATH 288,B00,098058,Zhang; Danna,8,0,10,2
1668504692703,MATH 288,C00,098059,Williams; Ruth J,9,0,10,1
1668504693128,MATH 290B,A00,098060,Roberts; Justin Deritter,12,0,15,3
1668504693555,MATH 292,A00,098061,Belmont; Eva Kinoshita,10,0,10,0
1668504693980,MATH 295,A00,098062,Suk; Andrew Hoon,47,0,50,3
1668504694405,MATH 296,A00,098063,Novak; Jonathan I,20,0,20,0
1668504694833,MATH 297,001,098064,Gamst; Anthony Collins,9997,0,9999,2
1668505197897,COGS 205,A00,101395,Chiba; Andrea,19,0,20,1
1668505198324,COGS 210B,001,101404,Greene; Deanna Jacquelyn,9998,0,9999,1
1668505198324,COGS 210B,002,101417,Xia; Haijun,9999,0,9999,0
1668505198324,COGS 210B,003,101422,Nitz; Douglas A.,9999,0,9999,0
1668505198324,COGS 210B,004,101423,Hollan; James D.,9998,0,9999,1
1668505198324,COGS 210B,005,101424,Deak; Gedeon O.,9998,0,9999,1
1668505198324,COGS 210B,006,101425,Rossano; Federico,9999,0,9999,0
1668505198748,COGS 211B,A00,101427,Coulson; Seana M,9996,0,9999,3
1668505199175,COGS 220,A00,101428,Hollan; James D.,0,10,25,25
1668505199602,COGS 229,A00,101429,Dow; Steven P,17,0,25,8
1668505200031,COGS 230,A00,101430,Klemmer; Scott R,7,0,17,10
1668505200458,COGS 234,A00,101431,Xia; Haijun,1,0,25,24
1668505200893,COGS 260,A00,101432,Kiyonaga; Anastasia,21,0,25,4
1668505200893,COGS 260,B00,101433,Kirsh; David Joel,15,0,25,10
1668505201326,CSE 202,A00,102371,Impagliazzo; Russell,0,65,0,0
1668505201750,CSE 203B,A01,102373,Cheng; Chung Kuan,0,58,0,0
1668505202179,CSE 208,A00,102374,Micciancio; Daniele,0,5,0,0
1668505202606,CSE 209A,A00,112895,Impagliazzo; Russell,0,12,15,15
1668505203035,CSE 209B,A00,108005,Bellare; Mihir,0,7,0,0
1668505203470,CSE 210,A00,113163,Coblenz; Michael J,0,84,0,0
1668505203899,CSE 219,A00,106111,Dow; Steven P,0,6,20,20
1668505204325,CSE 221,A00,102376,Voelker; Geoffrey M.,0,72,0,0
1668505204754,CSE 224,A01,102378,Porter; George M,0,165,0,0
1668505205180,CSE 229A,A00,102379,Savage; Stefan,0,10,0,0
1668505205609,CSE 229C,A00,102380,Munyaka; Imani N. S.,0,10,0,0
1668505206034,CSE 232B,A00,102382,Deutsch; Alin Bernard,0,32,0,0
1668505206459,CSE 234,A01,112904,Kumar; Arun Kumar,0,0,0,0
1668505206883,CSE 237A,A00,102383,Rosing; Tajana Simunic,0,55,0,0
1668505207319,CSE 239A,A00,102384,Deutsch; Alin Bernard,0,14,0,0
1668505207743,CSE 239B,A00,102385,Polikarpova; Nadezhda,0,10,0,0
1668505208169,CSE 240A,A00,102386,Pannuto; Patrick William,0,46,0,0
1668505208596,CSE 240B,A00,102387,Zhao; Jishen,0,47,0,0
1668505209021,CSE 241A,A00,106406,Kang; Mingu,0,9,0,0
1668505209451,CSE 249B,A00,102388,Kahng; Andrew Byun,0,5,8,8
1668505209883,CSE 251B,A01,102392,Cottrell; Garrison W,0,51,0,0
1668505209883,CSE 251B,A02,102393,Cottrell; Garrison W,0,34,0,0
1668505210324,CSE 252B,A00,102394,Ochoa; Benjamin Lawrence,0,59,0,0
1668505210748,CSE 257,A01,102396,Gao; Sicun,0,138,0,0
1668505211177,CSE 272,A00,102397,Li; Tzumao,0,19,0,0
1668505211603,CSE 274,A00,111323,Chern; Albert Ren-Haur,0,15,0,0
1668505212030,CSE 282,A00,102398,Pevzner; Pavel Arkadjevich,0,0,0,0
1668505212456,CSE 284,A00,114175,Gymrek; Melissa Ann,0,22,0,0
1668505212882,CSE 290,A00,102399,Chandraker; Manmohan Krishna,0,11,0,0
1668505212882,CSE 290,B00,102400,Vaccaro; Kristen Marie,0,7,25,25
1668505212882,CSE 290,C00,102414,Pannuto; Patrick William,0,1,25,25
1668505212882,CSE 290,D00,102427,Pevzner; Pavel Arkadjevich,0,0,0,0
1668505212882,CSE 290,E00,102429,Zhao; Jishen,0,4,0,0
1668505212882,CSE 290,F00,102436,Tullsen; Dean Michael,0,5,0,0
1668505212882,CSE 290,G00,102440,Christensen; Henrik I,0,6,20,20
1668505213320,CSE 291,A00,102443,Su; Hao,0,0,0,0
1668505213320,CSE 291,B00,102448,Polikarpova; Nadezhda,0,0,0,0
1668505213320,CSE 291,C00,102453,Vaccaro; Kristen Marie,0,0,0,0
1668505213320,CSE 291,D00,111343,Savage; Stefan,0,0,0,0
1668505213320,CSE 291,E00,116474,Claffy; Kimberly Claire,0,0,0,0
1668505213320,CSE 291,F00,116479,Pasquale; Joseph,0,0,0,0
1668505213789,CSE 293,001,119111,Bafna; Vineet,9999,0,9999,0
1668505213789,CSE 293,002,119118,Bellare; Mihir,9999,0,9999,0
1668505213789,CSE 293,003,119122,Berg-Kirkpatrick; Taylor D,9999,0,9999,0
1668505213789,CSE 293,004,119135,Christensen; Henrik I,9999,0,9999,0
1668505213789,CSE 293,005,119142,Cottrell; Garrison W,9999,0,9999,0
1668505213789,CSE 293,006,119146,Deutsch; Alin Bernard,9999,0,9999,0
1668505213789,CSE 293,007,119159,Esmaeilzadeh; Hadi,9999,0,9999,0
1668505213789,CSE 293,008,119166,Freund; Yoav,9999,0,9999,0
1668505213789,CSE 293,009,119170,Griswold; William G.,9999,0,9999,0
1668505213789,CSE 293,010,119183,Gymrek; Melissa Ann,9999,0,9999,0
1668505213789,CSE 293,011,119190,Heninger; Nadia A,9999,0,9999,0
1668505213789,CSE 293,012,119230,Impagliazzo; Russell,9999,0,9999,0
1668505213789,CSE 293,013,119232,Jhala; Ranjit,9999,0,9999,0
1668505213789,CSE 293,014,119233,Kahng; Andrew Byun,9999,0,9999,0
1668505213789,CSE 293,015,119298,Kane; Daniel Mertz,9999,0,9999,0
1668505213789,CSE 293,016,119299,Kriegman; David J,9999,0,9999,0
1668505213789,CSE 293,017,119300,Kumar; Arun Kumar,9999,0,9999,0
1668505213789,CSE 293,018,119301,Lerner; Sorin,9999,0,9999,0
1668505213789,CSE 293,019,119302,Lovett; Shachar,9999,0,9999,0
1668505213789,CSE 293,020,119303,McAuley; Julian John,9999,0,9999,0
1668505213789,CSE 293,021,119304,Micciancio; Daniele,9999,0,9999,0
1668505213789,CSE 293,022,119367,Orailoglu; Alex,9999,0,9999,0
1668505213789,CSE 293,023,119382,Paturi; Ramamohan,9999,0,9999,0
1668505213789,CSE 293,024,119404,Polikarpova; Nadezhda,9999,0,9999,0
1668505213789,CSE 293,025,119406,Politz; Joseph Gibbs,9999,0,9999,0
1668505213789,CSE 293,026,119411,Porter; George M,9999,0,9999,0
1668505213789,CSE 293,027,119414,Porter; Leonard Emerson,9999,0,9999,0
1668505213789,CSE 293,028,119416,Ramamoorthi; Ravi,9999,0,9999,0
1668505213789,CSE 293,029,119417,Sahoo; Debashis,9999,0,9999,0
1668505213789,CSE 293,030,119420,Saul; Lawrence,9999,0,9999,0
1668505213789,CSE 293,031,119421,Savage; Stefan,9999,0,9999,0
1668505213789,CSE 293,032,119425,Schulze; Jurgen P.,9999,0,9999,0
1668505213789,CSE 293,033,119426,Snoeren; Alex C.,9999,0,9999,0
1668505213789,CSE 293,034,119428,Shang; Jingbo,9999,0,9999,0
1668505213789,CSE 293,035,119430,Stefan; Deian,9999,0,9999,0
1668505213789,CSE 293,036,119431,Su; Hao,9999,0,9999,0
1668505213789,CSE 293,037,119433,Swanson; Steven James,9999,0,9999,0
1668505213789,CSE 293,038,119435,Tullsen; Dean Michael,9999,0,9999,0
1668505213789,CSE 293,039,119483,Voelker; Geoffrey M.,9999,0,9999,0
1668505213789,CSE 293,040,119537,Zhao; Jishen,9999,0,9999,0
1668505213789,CSE 293,041,119538,Zhou; Yuan-Yuan,9999,0,9999,0
1668505213789,CSE 293,042,119539,Gao; Sicun,9999,0,9999,0
1668505213789,CSE 293,043,119540,Weibel; Nadir,9999,0,9999,0
1668505213789,CSE 293,044,119541,Gupta; Rajesh K.,9999,0,9999,0
1668505213789,CSE 293,045,126410,Vaccaro; Kristen Marie,9999,0,9999,0
1668505213789,CSE 293,046,126411,Klemke; Richard,9999,0,9999,0
1668505214218,CSE 294,A00,102459,Voelker; Geoffrey M.,0,2,0,0
1668505214218,CSE 294,B00,111322,Orailoglu; Alex,0,2,0,0
1668505214647,DSE 201,A00,096914,Deutsch; Alin Bernard,30,0,30,0
1668505215075,DSE 210,A00,096915,Dasgupta; Sanjoy,30,0,30,0
1668505215500,DSE 260A,A00,096916,Altintas De Callaf; Ilkay,30,0,30,0
1668505215988,ECE 200,001,103586,Antipa; Nicholas A,9999,0,9999,0
1668505215988,ECE 200,002,103587,Atanasov; Nikolay A.,9999,0,9999,0
1668505215988,ECE 200,003,103588,Bharadia; Dinesh,9999,0,9999,0
1668505215988,ECE 200,004,103589,Cheng; Chung Kuan,9999,0,9999,0
1668505215988,ECE 200,005,103590,Cosman; Pamela C.,9999,0,9999,0
1668505215988,ECE 200,006,103591,Dayeh; Shadi Ahmad,9999,0,9999,0
1668505215988,ECE 200,007,103592,Fainman; Yeshaiahu,9999,0,9999,0
1668505215988,ECE 200,008,103593,Ford; Joseph Earl,9999,0,9999,0
1668505215988,ECE 200,009,103594,Franceschetti; Massimo,9999,0,9999,0
1668505215988,ECE 200,010,103595,Fullerton; Eric E,9999,0,9999,0
1668505215988,ECE 200,011,103596,Galton; Ian A,9999,0,9999,0
1668505215988,ECE 200,012,103597,Gilja; Vikash,9999,0,9999,0
1668505215988,ECE 200,013,103598,Hall; Drew A.,9999,0,9999,0
1668505215988,ECE 200,014,103599,Hsueh; Tzu-Chien,9999,0,9999,0
1668505215988,ECE 200,015,103600,Javidi; Tara,9999,0,9999,0
1668505215988,ECE 200,016,103601,Kahng; Andrew Byun,9999,0,9999,0
1668505215988,ECE 200,017,103602,Kim; Young-Han,9999,0,9999,0
1668505215988,ECE 200,018,103603,Koushanfar; Farinaz,9999,0,9999,0
1668505215988,ECE 200,019,103604,Kuzum; Duygu,9999,0,9999,0
1668505215988,ECE 200,020,103605,Le; Hanh-Phuc,9999,0,9999,0
1668505215988,ECE 200,021,103606,Lin; Bill,9999,0,9999,0
1668505215988,ECE 200,022,103607,Liu; Zhaowei,9998,0,9999,1
1668505215988,ECE 200,023,103608,Lo; Yu-Hwa,9999,0,9999,0
1668505215988,ECE 200,024,103609,Lomakin; Vitaliy,9999,0,9999,0
1668505215988,ECE 200,025,103610,Mercier; Patrick Philip,9999,0,9999,0
1668505215988,ECE 200,026,103611,Meyer; Florian,9999,0,9999,0
1668505215988,ECE 200,027,103612,Milstein; Laurence B.,9999,0,9999,0
1668505215988,ECE 200,028,103613,Mir Arabbaygi; Siavash,9999,0,9999,0
1668505215988,ECE 200,029,103614,Mookherjea; Shayan,9999,0,9999,0
1668505215988,ECE 200,030,103615,Morris; Karcher William,9999,0,9999,0
1668505215988,ECE 200,031,103616,Ng; Tse Nga,9999,0,9999,0
1668505215988,ECE 200,032,103617,Nguyen; Truong Quang,9999,0,9999,0
1668505215988,ECE 200,033,103618,Nomura; Kenji,9999,0,9999,0
1668505215988,ECE 200,034,103619,Orlitsky; Alon,9999,0,9999,0
1668505215988,ECE 200,035,103620,Pal; Piya,9999,0,9999,0
1668505215988,ECE 200,036,103621,Papen; George C.,9999,0,9999,0
1668505215988,ECE 200,037,103622,Radic; Stojan,9999,0,9999,0
1668505215988,ECE 200,038,103623,Rao; Bhaskar D.,9999,0,9999,0
1668505215988,ECE 200,039,103624,Rao; Ramesh R,9999,0,9999,0
1668505215988,ECE 200,040,103625,Rebeiz; Gabriel,9999,0,9999,0
1668505215988,ECE 200,041,103626,Sanford; John R,9999,0,9999,0
1668505215988,ECE 200,042,103627,Siegel; Paul H.,9999,0,9999,0
1668505215988,ECE 200,043,103628,Sievenpiper; Daniel F.,9999,0,9999,0
1668505215988,ECE 200,044,103629,Sworder; David D.,9999,0,9999,0
1668505215988,ECE 200,045,103630,Taur; Yuan,9999,0,9999,0
1668505215988,ECE 200,046,103631,Touri; Behrouz,9999,0,9999,0
1668505215988,ECE 200,047,103632,Trivedi; Mohan M.,9999,0,9999,0
1668505215988,ECE 200,048,103633,Vasconcelos; Nuno,9999,0,9999,0
1668505215988,ECE 200,049,103634,Wang; Xiaolong,9999,0,9999,0
1668505215988,ECE 200,050,103635,Xie; Pengtao,9999,0,9999,0
1668505215988,ECE 200,051,103636,Yip; Michael,9999,0,9999,0
1668505215988,ECE 200,052,103637,Zeger; Kenneth A.,999,0,999,0
1668505215988,ECE 200,053,103638,Zhang; Xinyu,9999,0,9999,0
1668505215988,ECE 200,054,103639,Turakhia; Yatish Girish,9999,0,9999,0
1668505215988,ECE 200,055,103640,Kang; Mingu,9999,0,9999,0
1668505215988,ECE 200,056,103641,Shi; Yuanyuan,9999,0,9999,0
1668505215988,ECE 200,057,103642,Wang; Edward Jay,9999,0,9999,0
1668505215988,ECE 200,058,103643,Zheng; Yang,9999,0,9999,0
1668505216416,ECE 202,A00,103644,Kuzum; Duygu,0,44,0,0
1668505216841,ECE 212BN,A00,103646,Ng; Tse Nga,0,9,0,0
1668505217265,ECE 221,A00,111493,Staff,0,0,0,0
1668505217689,ECE 222B,A00,103647,Lomakin; Vitaliy,0,20,0,0
1668505218120,ECE 230B,A00,103648,Taur; Yuan,0,3,0,0
1668505218562,ECE 238B,A00,103649,Garay; Javier,0,0,0,0
1668505218986,ECE 240B,A00,112900,Fainman; Yeshaiahu,0,7,0,0
1668505219410,ECE 247A,A00,103650,Jokerst; Jesse Vincent,0,6,0,0
1668505219835,ECE 247B,A00,103651,Wang; Joseph,0,14,0,0
1668505220270,ECE 250,A00,103652,Siegel; Paul H.,0,82,0,0
1668505220702,ECE 251A,A00,103654,Rao; Bhaskar D.,0,61,0,0
1668505221127,ECE 257B,A00,103655,Bharadia; Dinesh,0,32,0,0
1668505221555,ECE 258A,A00,103656,Milstein; Laurence B.,0,29,0,0
1668505221985,ECE 260B,A00,103658,Kang; Mingu,0,119,0,0
1668505222412,ECE 264A,A00,103659,Galton; Ian A,0,65,0,0
1668505222840,ECE 265A,A00,103661,Gudem; Prasad S.S.,0,70,0,0
1668505223266,ECE 265D,A00,103662,Gudem; Prasad S.S.,0,26,0,0
1668505223690,ECE 268,A00,103663,Koushanfar; Farinaz,0,43,0,0
1668505224115,ECE 269,A01,103665,Pal; Piya,0,215,0,0
1668505224546,ECE 271B,A00,103666,Vasconcelos; Manuela,0,76,0,0
1668505224973,ECE 276A,A00,103667,Atanasov; Nikolay A.,0,126,0,0
1668505225398,ECE 277,A00,103668,An; Cheolhong,0,148,0,0
1668505225826,ECE 279,A00,117947,Hall; Drew A.,0,22,0,0
1668505226677,ECE 283,A00,103670,Hsueh; Tzu-Chien,0,53,0,0
1668505227109,ECE 284,A00,103671,Turakhia; Yatish Girish,0,39,0,0
1668505227538,ECE 285,A00,103672,Zheng; Yang,0,39,0,0
1668505227538,ECE 285,B00,103673,Sworder; David D.,0,57,0,0
1668505227970,ECE 287,A00,103676,Javidi; Tara,0,9,0,0
1668505228395,MATH 200B,A00,098023,Salehi Golsefidy; Alireza,10,0,15,5
1668505228819,MATH 202B,A00,098024,Rhoades; Brendon Patrick,7,0,15,8
1668505229242,MATH 203B,A00,098025,Oprea; Dragos N.,9,0,15,6
1668505229664,MATH 204B,A00,098026,Sorensen; Claus M,13,0,15,2
1668505230089,MATH 208,A00,098027,Izadi; Elham,7,0,10,3
1668505230514,MATH 209,A00,098028,Pollack; Aaron,10,0,10,0
1668505231046,MATH 211A,A00,112919,Rogalski; Daniel,8,0,10,2
1668505231474,MATH 211B,A00,112920,Seward; Brandon M.,9,0,10,1
1668505231901,MATH 218,A00,098029,Li; Bo,10,0,10,0
1668505232327,MATH 220B,A00,098030,Novak; Jonathan I,11,0,15,4
1668505232750,MATH 221A,A00,098031,Ebenfelt; Peter F,12,0,15,3
1668505233175,MATH 231B,A00,098032,Zlatos; Andrej,11,0,15,4
1668505233606,MATH 240B,A00,098033,Ni; Lei,7,0,15,8
1668505234031,MATH 243,A00,098034,Jekel; David Andrew,10,0,10,0
1668505234455,MATH 245A,A00,098035,Nie; Jiawang,0,4,15,18
1668505234880,MATH 248,A00,098036,Bejenaru; Ioan,10,0,10,0
1668505235314,MATH 250B,A00,098037,Spolaor; Luca,14,0,15,1
1668505235740,MATH 258,A00,098038,Ni; Lei,9,0,10,1
1668505236168,MATH 264B,A00,098041,Rhoades; Brendon Patrick,8,0,15,7
1668505236593,MATH 268,A00,098042,Buss; Samuel R,10,0,10,0
1668505237028,MATH 269,A00,098043,Rhoades; Brendon Patrick,10,0,10,0
1668505237458,MATH 270B,A00,098044,Li; Bo,6,0,15,9
1668505237885,MATH 272B,A00,098045,Holst; Michael J,13,0,15,2
1668505238315,MATH 273A,A00,098046,Tian; Xiaochuan,10,0,15,5
1668505238739,MATH 275,A01,098048,Tian; Xiaochuan,6,0,10,4
1668505239164,MATH 278A,A00,098049,Holst; Michael J,7,0,10,3
1668505239590,MATH 278B,A00,098050,Cloninger; Alexander,10,0,10,0
1668505240015,MATH 278C,A00,098051,Nie; Jiawang,5,0,10,5
1668505240439,MATH 280B,A00,098052,Zheng; Tianyi,7,0,15,8
1668505240863,MATH 281B,A00,098053,Bradic; Jelena,0,2,15,15
1668505241290,MATH 282B,A00,098054,Arias-Castro; Ery,0,1,15,15
1668505241719,MATH 285,A00,098055,Fitzsimmons; Patrick J,0,3,15,17
1668505242147,MATH 287B,A00,098056,Arias-Castro; Ery,1,0,15,14
1668505242573,MATH 288,A00,098057,Agarwal; Pooja,9,0,10,1
1668505242573,MATH 288,B00,098058,Zhang; Danna,8,0,10,2
1668505242573,MATH 288,C00,098059,Williams; Ruth J,9,0,10,1
1668505242998,MATH 290B,A00,098060,Roberts; Justin Deritter,12,0,15,3
1668505243426,MATH 292,A00,098061,Belmont; Eva Kinoshita,10,0,10,0
1668505243859,MATH 295,A00,098062,Suk; Andrew Hoon,47,0,50,3
1668505244295,MATH 296,A00,098063,Novak; Jonathan I,20,0,20,0
1668505244719,MATH 297,001,098064,Gamst; Anthony Collins,9997,0,9999,2
1668505746325,COGS 205,A00,101395,Chiba; Andrea,19,0,20,1
1668505746755,COGS 210B,001,101404,Greene; Deanna Jacquelyn,9998,0,9999,1
1668505746755,COGS 210B,002,101417,Xia; Haijun,9999,0,9999,0
1668505746755,COGS 210B,003,101422,Nitz; Douglas A.,9999,0,9999,0
1668505746755,COGS 210B,004,101423,Hollan; James D.,9998,0,9999,1
1668505746755,COGS 210B,005,101424,Deak; Gedeon O.,9998,0,9999,1
1668505746755,COGS 210B,006,101425,Rossano; Federico,9999,0,9999,0
1668505747182,COGS 211B,A00,101427,Coulson; Seana M,9996,0,9999,3
1668505747612,COGS 220,A00,101428,Hollan; James D.,0,10,25,25
1668505748040,COGS 229,A00,101429,Dow; Steven P,17,0,25,8
1668505748464,COGS 230,A00,101430,Klemmer; Scott R,7,0,17,10
1668505748887,COGS 234,A00,101431,Xia; Haijun,1,0,25,24
1668505749312,COGS 260,A00,101432,Kiyonaga; Anastasia,21,0,25,4
1668505749312,COGS 260,B00,101433,Kirsh; David Joel,15,0,25,10
1668505749736,CSE 202,A00,102371,Impagliazzo; Russell,0,65,0,0
1668505750169,CSE 203B,A01,102373,Cheng; Chung Kuan,0,58,0,0
1668505750596,CSE 208,A00,102374,Micciancio; Daniele,0,5,0,0
1668505751024,CSE 209A,A00,112895,Impagliazzo; Russell,0,12,15,15
1668505751544,CSE 209B,A00,108005,Bellare; Mihir,0,7,0,0
1668505751968,CSE 210,A00,113163,Coblenz; Michael J,0,84,0,0
1668505752392,CSE 219,A00,106111,Dow; Steven P,0,6,20,20
1668505752819,CSE 221,A00,102376,Voelker; Geoffrey M.,0,72,0,0
1668505753249,CSE 224,A01,102378,Porter; George M,0,166,0,0
1668505753679,CSE 229A,A00,102379,Savage; Stefan,0,10,0,0
1668505754107,CSE 229C,A00,102380,Munyaka; Imani N. S.,0,10,0,0
1668505754537,CSE 232B,A00,102382,Deutsch; Alin Bernard,0,32,0,0
1668505754959,CSE 234,A01,112904,Kumar; Arun Kumar,0,0,0,0
1668505755385,CSE 237A,A00,102383,Rosing; Tajana Simunic,0,55,0,0
1668505755806,CSE 239A,A00,102384,Deutsch; Alin Bernard,0,14,0,0
1668505756231,CSE 239B,A00,102385,Polikarpova; Nadezhda,0,10,0,0
1668505756654,CSE 240A,A00,102386,Pannuto; Patrick William,0,46,0,0
1668505757079,CSE 240B,A00,102387,Zhao; Jishen,0,47,0,0
1668505757504,CSE 241A,A00,106406,Kang; Mingu,0,9,0,0
1668505757932,CSE 249B,A00,102388,Kahng; Andrew Byun,0,5,8,8
1668505758362,CSE 251B,A01,102392,Cottrell; Garrison W,0,51,0,0
1668505758362,CSE 251B,A02,102393,Cottrell; Garrison W,0,34,0,0
1668505758786,CSE 252B,A00,102394,Ochoa; Benjamin Lawrence,0,59,0,0
1668505759214,CSE 257,A01,102396,Gao; Sicun,0,138,0,0
1668505759641,CSE 272,A00,102397,Li; Tzumao,0,19,0,0
1668505760065,CSE 274,A00,111323,Chern; Albert Ren-Haur,0,15,0,0
1668505760489,CSE 282,A00,102398,Pevzner; Pavel Arkadjevich,0,0,0,0
1668505760922,CSE 284,A00,114175,Gymrek; Melissa Ann,0,22,0,0
1668505761349,CSE 290,A00,102399,Chandraker; Manmohan Krishna,0,11,0,0
1668505761349,CSE 290,B00,102400,Vaccaro; Kristen Marie,0,7,25,25
1668505761349,CSE 290,C00,102414,Pannuto; Patrick William,0,1,25,25
1668505761349,CSE 290,D00,102427,Pevzner; Pavel Arkadjevich,0,0,0,0
1668505761349,CSE 290,E00,102429,Zhao; Jishen,0,4,0,0
1668505761349,CSE 290,F00,102436,Tullsen; Dean Michael,0,5,0,0
1668505761349,CSE 290,G00,102440,Christensen; Henrik I,0,6,20,20
1668505761775,CSE 291,A00,102443,Su; Hao,0,0,0,0
1668505761775,CSE 291,B00,102448,Polikarpova; Nadezhda,0,0,0,0
1668505761775,CSE 291,C00,102453,Vaccaro; Kristen Marie,0,0,0,0
1668505761775,CSE 291,D00,111343,Savage; Stefan,0,0,0,0
1668505761775,CSE 291,E00,116474,Claffy; Kimberly Claire,0,0,0,0
1668505761775,CSE 291,F00,116479,Pasquale; Joseph,0,0,0,0
1668505762216,CSE 293,001,119111,Bafna; Vineet,9999,0,9999,0
1668505762216,CSE 293,002,119118,Bellare; Mihir,9999,0,9999,0
1668505762216,CSE 293,003,119122,Berg-Kirkpatrick; Taylor D,9999,0,9999,0
1668505762216,CSE 293,004,119135,Christensen; Henrik I,9999,0,9999,0
1668505762216,CSE 293,005,119142,Cottrell; Garrison W,9999,0,9999,0
1668505762216,CSE 293,006,119146,Deutsch; Alin Bernard,9999,0,9999,0
1668505762216,CSE 293,007,119159,Esmaeilzadeh; Hadi,9999,0,9999,0
1668505762216,CSE 293,008,119166,Freund; Yoav,9999,0,9999,0
1668505762216,CSE 293,009,119170,Griswold; William G.,9999,0,9999,0
1668505762216,CSE 293,010,119183,Gymrek; Melissa Ann,9999,0,9999,0
1668505762216,CSE 293,011,119190,Heninger; Nadia A,9999,0,9999,0
1668505762216,CSE 293,012,119230,Impagliazzo; Russell,9999,0,9999,0
1668505762216,CSE 293,013,119232,Jhala; Ranjit,9999,0,9999,0
1668505762216,CSE 293,014,119233,Kahng; Andrew Byun,9999,0,9999,0
1668505762216,CSE 293,015,119298,Kane; Daniel Mertz,9999,0,9999,0
1668505762216,CSE 293,016,119299,Kriegman; David J,9999,0,9999,0
1668505762216,CSE 293,017,119300,Kumar; Arun Kumar,9999,0,9999,0
1668505762216,CSE 293,018,119301,Lerner; Sorin,9999,0,9999,0
1668505762216,CSE 293,019,119302,Lovett; Shachar,9999,0,9999,0
1668505762216,CSE 293,020,119303,McAuley; Julian John,9999,0,9999,0
1668505762216,CSE 293,021,119304,Micciancio; Daniele,9999,0,9999,0
1668505762216,CSE 293,022,119367,Orailoglu; Alex,9999,0,9999,0
1668505762216,CSE 293,023,119382,Paturi; Ramamohan,9999,0,9999,0
1668505762216,CSE 293,024,119404,Polikarpova; Nadezhda,9999,0,9999,0
1668505762216,CSE 293,025,119406,Politz; Joseph Gibbs,9999,0,9999,0
1668505762216,CSE 293,026,119411,Porter; George M,9999,0,9999,0
1668505762216,CSE 293,027,119414,Porter; Leonard Emerson,9999,0,9999,0
1668505762216,CSE 293,028,119416,Ramamoorthi; Ravi,9999,0,9999,0
1668505762216,CSE 293,029,119417,Sahoo; Debashis,9999,0,9999,0
1668505762216,CSE 293,030,119420,Saul; Lawrence,9999,0,9999,0
1668505762216,CSE 293,031,119421,Savage; Stefan,9999,0,9999,0
1668505762216,CSE 293,032,119425,Schulze; Jurgen P.,9999,0,9999,0
1668505762216,CSE 293,033,119426,Snoeren; Alex C.,9999,0,9999,0
1668505762216,CSE 293,034,119428,Shang; Jingbo,9999,0,9999,0
1668505762216,CSE 293,035,119430,Stefan; Deian,9999,0,9999,0
1668505762216,CSE 293,036,119431,Su; Hao,9999,0,9999,0
1668505762216,CSE 293,037,119433,Swanson; Steven James,9999,0,9999,0
1668505762216,CSE 293,038,119435,Tullsen; Dean Michael,9999,0,9999,0
1668505762216,CSE 293,039,119483,Voelker; Geoffrey M.,9999,0,9999,0
1668505762216,CSE 293,040,119537,Zhao; Jishen,9999,0,9999,0
1668505762216,CSE 293,041,119538,Zhou; Yuan-Yuan,9999,0,9999,0
1668505762216,CSE 293,042,119539,Gao; Sicun,9999,0,9999,0
1668505762216,CSE 293,043,119540,Weibel; Nadir,9999,0,9999,0
1668505762216,CSE 293,044,119541,Gupta; Rajesh K.,9999,0,9999,0
1668505762216,CSE 293,045,126410,Vaccaro; Kristen Marie,9999,0,9999,0
1668505762216,CSE 293,046,126411,Klemke; Richard,9999,0,9999,0
1668505762640,CSE 294,A00,102459,Voelker; Geoffrey M.,0,2,0,0
1668505762640,CSE 294,B00,111322,Orailoglu; Alex,0,2,0,0
1668505763070,DSE 201,A00,096914,Deutsch; Alin Bernard,30,0,30,0
1668505763498,DSE 210,A00,096915,Dasgupta; Sanjoy,30,0,30,0
1668505763922,DSE 260A,A00,096916,Altintas De Callaf; Ilkay,30,0,30,0
1668505764396,ECE 200,001,103586,Antipa; Nicholas A,9999,0,9999,0
1668505764396,ECE 200,002,103587,Atanasov; Nikolay A.,9999,0,9999,0
1668505764396,ECE 200,003,103588,Bharadia; Dinesh,9999,0,9999,0
1668505764396,ECE 200,004,103589,Cheng; Chung Kuan,9999,0,9999,0
1668505764396,ECE 200,005,103590,Cosman; Pamela C.,9999,0,9999,0
1668505764396,ECE 200,006,103591,Dayeh; Shadi Ahmad,9999,0,9999,0
1668505764396,ECE 200,007,103592,Fainman; Yeshaiahu,9999,0,9999,0
1668505764396,ECE 200,008,103593,Ford; Joseph Earl,9999,0,9999,0
1668505764396,ECE 200,009,103594,Franceschetti; Massimo,9999,0,9999,0
1668505764396,ECE 200,010,103595,Fullerton; Eric E,9999,0,9999,0
1668505764396,ECE 200,011,103596,Galton; Ian A,9999,0,9999,0
1668505764396,ECE 200,012,103597,Gilja; Vikash,9999,0,9999,0
1668505764396,ECE 200,013,103598,Hall; Drew A.,9999,0,9999,0
1668505764396,ECE 200,014,103599,Hsueh; Tzu-Chien,9999,0,9999,0
1668505764396,ECE 200,015,103600,Javidi; Tara,9999,0,9999,0
1668505764396,ECE 200,016,103601,Kahng; Andrew Byun,9999,0,9999,0
1668505764396,ECE 200,017,103602,Kim; Young-Han,9999,0,9999,0
1668505764396,ECE 200,018,103603,Koushanfar; Farinaz,9999,0,9999,0
1668505764396,ECE 200,019,103604,Kuzum; Duygu,9999,0,9999,0
1668505764396,ECE 200,020,103605,Le; Hanh-Phuc,9999,0,9999,0
1668505764396,ECE 200,021,103606,Lin; Bill,9999,0,9999,0
1668505764396,ECE 200,022,103607,Liu; Zhaowei,9998,0,9999,1
1668505764396,ECE 200,023,103608,Lo; Yu-Hwa,9999,0,9999,0
1668505764396,ECE 200,024,103609,Lomakin; Vitaliy,9999,0,9999,0
1668505764396,ECE 200,025,103610,Mercier; Patrick Philip,9999,0,9999,0
1668505764396,ECE 200,026,103611,Meyer; Florian,9999,0,9999,0
1668505764396,ECE 200,027,103612,Milstein; Laurence B.,9999,0,9999,0
1668505764396,ECE 200,028,103613,Mir Arabbaygi; Siavash,9999,0,9999,0
1668505764396,ECE 200,029,103614,Mookherjea; Shayan,9999,0,9999,0
1668505764396,ECE 200,030,103615,Morris; Karcher William,9999,0,9999,0
1668505764396,ECE 200,031,103616,Ng; Tse Nga,9999,0,9999,0
1668505764396,ECE 200,032,103617,Nguyen; Truong Quang,9999,0,9999,0
1668505764396,ECE 200,033,103618,Nomura; Kenji,9999,0,9999,0
1668505764396,ECE 200,034,103619,Orlitsky; Alon,9999,0,9999,0
1668505764396,ECE 200,035,103620,Pal; Piya,9999,0,9999,0
1668505764396,ECE 200,036,103621,Papen; George C.,9999,0,9999,0
1668505764396,ECE 200,037,103622,Radic; Stojan,9999,0,9999,0
1668505764396,ECE 200,038,103623,Rao; Bhaskar D.,9999,0,9999,0
1668505764396,ECE 200,039,103624,Rao; Ramesh R,9999,0,9999,0
1668505764396,ECE 200,040,103625,Rebeiz; Gabriel,9999,0,9999,0
1668505764396,ECE 200,041,103626,Sanford; John R,9999,0,9999,0
1668505764396,ECE 200,042,103627,Siegel; Paul H.,9999,0,9999,0
1668505764396,ECE 200,043,103628,Sievenpiper; Daniel F.,9999,0,9999,0
1668505764396,ECE 200,044,103629,Sworder; David D.,9999,0,9999,0
1668505764396,ECE 200,045,103630,Taur; Yuan,9999,0,9999,0
1668505764396,ECE 200,046,103631,Touri; Behrouz,9999,0,9999,0
1668505764396,ECE 200,047,103632,Trivedi; Mohan M.,9999,0,9999,0
1668505764396,ECE 200,048,103633,Vasconcelos; Nuno,9999,0,9999,0
1668505764396,ECE 200,049,103634,Wang; Xiaolong,9999,0,9999,0
1668505764396,ECE 200,050,103635,Xie; Pengtao,9999,0,9999,0
1668505764396,ECE 200,051,103636,Yip; Michael,9999,0,9999,0
1668505764396,ECE 200,052,103637,Zeger; Kenneth A.,999,0,999,0
1668505764396,ECE 200,053,103638,Zhang; Xinyu,9999,0,9999,0
1668505764396,ECE 200,054,103639,Turakhia; Yatish Girish,9999,0,9999,0
1668505764396,ECE 200,055,103640,Kang; Mingu,9999,0,9999,0
1668505764396,ECE 200,056,103641,Shi; Yuanyuan,9999,0,9999,0
1668505764396,ECE 200,057,103642,Wang; Edward Jay,9999,0,9999,0
1668505764396,ECE 200,058,103643,Zheng; Yang,9999,0,9999,0
1668505764822,ECE 202,A00,103644,Kuzum; Duygu,0,44,0,0
1668505765246,ECE 212BN,A00,103646,Ng; Tse Nga,0,9,0,0
1668505765670,ECE 221,A00,111493,Staff,0,0,0,0
1668505766106,ECE 222B,A00,103647,Lomakin; Vitaliy,0,20,0,0
1668505766539,ECE 230B,A00,103648,Taur; Yuan,0,3,0,0
1668505766974,ECE 238B,A00,103649,Garay; Javier,0,0,0,0
1668505767401,ECE 240B,A00,112900,Fainman; Yeshaiahu,0,7,0,0
1668505767825,ECE 247A,A00,103650,Jokerst; Jesse Vincent,0,6,0,0
1668505768248,ECE 247B,A00,103651,Wang; Joseph,0,14,0,0
1668505768673,ECE 250,A00,103652,Siegel; Paul H.,0,82,0,0
1668505769100,ECE 251A,A00,103654,Rao; Bhaskar D.,0,61,0,0
1668505769526,ECE 257B,A00,103655,Bharadia; Dinesh,0,32,0,0
1668505769956,ECE 258A,A00,103656,Milstein; Laurence B.,0,29,0,0
1668505770379,ECE 260B,A00,103658,Kang; Mingu,0,119,0,0
1668505770804,ECE 264A,A00,103659,Galton; Ian A,0,65,0,0
1668505771229,ECE 265A,A00,103661,Gudem; Prasad S.S.,0,70,0,0
1668505771653,ECE 265D,A00,103662,Gudem; Prasad S.S.,0,26,0,0
1668505772077,ECE 268,A00,103663,Koushanfar; Farinaz,0,43,0,0
1668505772503,ECE 269,A01,103665,Pal; Piya,0,215,0,0
1668505772928,ECE 271B,A00,103666,Vasconcelos; Manuela,0,76,0,0
1668505773352,ECE 276A,A00,103667,Atanasov; Nikolay A.,0,126,0,0
1668505773782,ECE 277,A00,103668,An; Cheolhong,0,149,0,0
1668505774210,ECE 279,A00,117947,Hall; Drew A.,0,22,0,0
1668505775059,ECE 283,A00,103670,Hsueh; Tzu-Chien,0,53,0,0
1668505775487,ECE 284,A00,103671,Turakhia; Yatish Girish,0,39,0,0
1668505775910,ECE 285,A00,103672,Zheng; Yang,0,39,0,0
1668505775910,ECE 285,B00,103673,Sworder; David D.,0,57,0,0
1668505776334,ECE 287,A00,103676,Javidi; Tara,0,9,0,0
1668505776762,MATH 200B,A00,098023,Salehi Golsefidy; Alireza,10,0,15,5
1668505777189,MATH 202B,A00,098024,Rhoades; Brendon Patrick,7,0,15,8
1668505777615,MATH 203B,A00,098025,Oprea; Dragos N.,9,0,15,6
1668505778040,MATH 204B,A00,098026,Sorensen; Claus M,13,0,15,2
1668505778468,MATH 208,A00,098027,Izadi; Elham,7,0,10,3
1668505778893,MATH 209,A00,098028,Pollack; Aaron,10,0,10,0
1668505779328,MATH 211A,A00,112919,Rogalski; Daniel,8,0,10,2
1668505779752,MATH 211B,A00,112920,Seward; Brandon M.,9,0,10,1
1668505780177,MATH 218,A00,098029,Li; Bo,10,0,10,0
1668505780606,MATH 220B,A00,098030,Novak; Jonathan I,11,0,15,4
1668505781031,MATH 221A,A00,098031,Ebenfelt; Peter F,12,0,15,3
1668505781456,MATH 231B,A00,098032,Zlatos; Andrej,11,0,15,4
1668505781885,MATH 240B,A00,098033,Ni; Lei,7,0,15,8
1668505782310,MATH 243,A00,098034,Jekel; David Andrew,10,0,10,0
1668505782736,MATH 245A,A00,098035,Nie; Jiawang,0,4,15,18
1668505783159,MATH 248,A00,098036,Bejenaru; Ioan,10,0,10,0
1668505783585,MATH 250B,A00,098037,Spolaor; Luca,14,0,15,1
1668505784010,MATH 258,A00,098038,Ni; Lei,9,0,10,1
1668505784435,MATH 264B,A00,098041,Rhoades; Brendon Patrick,8,0,15,7
1668505784858,MATH 268,A00,098042,Buss; Samuel R,10,0,10,0
1668505785283,MATH 269,A00,098043,Rhoades; Brendon Patrick,10,0,10,0
1668505785729,MATH 270B,A00,098044,Li; Bo,6,0,15,9
1668505786155,MATH 272B,A00,098045,Holst; Michael J,13,0,15,2
1668505786581,MATH 273A,A00,098046,Tian; Xiaochuan,10,0,15,5
1668505787010,MATH 275,A01,098048,Tian; Xiaochuan,6,0,10,4
1668505787434,MATH 278A,A00,098049,Holst; Michael J,7,0,10,3
1668505787857,MATH 278B,A00,098050,Cloninger; Alexander,10,0,10,0
1668505788280,MATH 278C,A00,098051,Nie; Jiawang,5,0,10,5
1668505788705,MATH 280B,A00,098052,Zheng; Tianyi,7,0,15,8
1668505789133,MATH 281B,A00,098053,Bradic; Jelena,0,2,15,15
1668505789558,MATH 282B,A00,098054,Arias-Castro; Ery,0,1,15,15
1668505789989,MATH 285,A00,098055,Fitzsimmons; Patrick J,0,3,15,17
1668505790415,MATH 287B,A00,098056,Arias-Castro; Ery,1,0,15,14
1668505790845,MATH 288,A00,098057,Agarwal; Pooja,9,0,10,1
1668505790845,MATH 288,B00,098058,Zhang; Danna,8,0,10,2
1668505790845,MATH 288,C00,098059,Williams; Ruth J,9,0,10,1
1668505791273,MATH 290B,A00,098060,Roberts; Justin Deritter,12,0,15,3
1668505791703,MATH 292,A00,098061,Belmont; Eva Kinoshita,10,0,10,0
1668505792130,MATH 295,A00,098062,Suk; Andrew Hoon,47,0,50,3
1668505792554,MATH 296,A00,098063,Novak; Jonathan I,20,0,20,0
1668505792978,MATH 297,001,098064,Gamst; Anthony Collins,9997,0,9999,2
1668506294333,COGS 205,A00,101395,Chiba; Andrea,19,0,20,1
1668506294760,COGS 210B,001,101404,Greene; Deanna Jacquelyn,9998,0,9999,1
1668506294760,COGS 210B,002,101417,Xia; Haijun,9999,0,9999,0
1668506294760,COGS 210B,003,101422,Nitz; Douglas A.,9999,0,9999,0
1668506294760,COGS 210B,004,101423,Hollan; James D.,9998,0,9999,1
1668506294760,COGS 210B,005,101424,Deak; Gedeon O.,9998,0,9999,1
1668506294760,COGS 210B,006,101425,Rossano; Federico,9999,0,9999,0
1668506295188,COGS 211B,A00,101427,Coulson; Seana M,9996,0,9999,3
1668506295614,COGS 220,A00,101428,Hollan; James D.,0,10,25,25
1668506296037,COGS 229,A00,101429,Dow; Steven P,17,0,25,8
1668506296460,COGS 230,A00,101430,Klemmer; Scott R,7,0,17,10
1668506296886,COGS 234,A00,101431,Xia; Haijun,1,0,25,24
1668506297312,COGS 260,A00,101432,Kiyonaga; Anastasia,21,0,25,4
1668506297312,COGS 260,B00,101433,Kirsh; David Joel,15,0,25,10
1668506297740,CSE 202,A00,102371,Impagliazzo; Russell,0,65,0,0
1668506298168,CSE 203B,A01,102373,Cheng; Chung Kuan,0,58,0,0
1668506298592,CSE 208,A00,102374,Micciancio; Daniele,0,5,0,0
1668506299016,CSE 209A,A00,112895,Impagliazzo; Russell,0,12,15,15
1668506299442,CSE 209B,A00,108005,Bellare; Mihir,0,7,0,0
1668506299866,CSE 210,A00,113163,Coblenz; Michael J,0,84,0,0
1668506300292,CSE 219,A00,106111,Dow; Steven P,0,6,20,20
1668506300715,CSE 221,A00,102376,Voelker; Geoffrey M.,0,72,0,0
1668506301141,CSE 224,A01,102378,Porter; George M,0,166,0,0
1668506301565,CSE 229A,A00,102379,Savage; Stefan,0,10,0,0
1668506301993,CSE 229C,A00,102380,Munyaka; Imani N. S.,0,10,0,0
1668506302418,CSE 232B,A00,102382,Deutsch; Alin Bernard,0,32,0,0
1668506302842,CSE 234,A01,112904,Kumar; Arun Kumar,0,0,0,0
1668506303268,CSE 237A,A00,102383,Rosing; Tajana Simunic,0,55,0,0
1668506303694,CSE 239A,A00,102384,Deutsch; Alin Bernard,0,14,0,0
1668506304117,CSE 239B,A00,102385,Polikarpova; Nadezhda,0,10,0,0
1668506304541,CSE 240A,A00,102386,Pannuto; Patrick William,0,46,0,0
1668506304968,CSE 240B,A00,102387,Zhao; Jishen,0,47,0,0
1668506305394,CSE 241A,A00,106406,Kang; Mingu,0,9,0,0
1668506305816,CSE 249B,A00,102388,Kahng; Andrew Byun,0,5,8,8
1668506306253,CSE 251B,A01,102392,Cottrell; Garrison W,0,51,0,0
1668506306253,CSE 251B,A02,102393,Cottrell; Garrison W,0,34,0,0
1668506306682,CSE 252B,A00,102394,Ochoa; Benjamin Lawrence,0,59,0,0
1668506307107,CSE 257,A01,102396,Gao; Sicun,0,138,0,0
1668506307534,CSE 272,A00,102397,Li; Tzumao,0,19,0,0
1668506307959,CSE 274,A00,111323,Chern; Albert Ren-Haur,0,15,0,0
1668506308388,CSE 282,A00,102398,Pevzner; Pavel Arkadjevich,0,0,0,0
1668506308813,CSE 284,A00,114175,Gymrek; Melissa Ann,0,22,0,0
1668506309238,CSE 290,A00,102399,Chandraker; Manmohan Krishna,0,11,0,0
1668506309238,CSE 290,B00,102400,Vaccaro; Kristen Marie,0,7,25,25
1668506309238,CSE 290,C00,102414,Pannuto; Patrick William,0,1,25,25
1668506309238,CSE 290,D00,102427,Pevzner; Pavel Arkadjevich,0,0,0,0
1668506309238,CSE 290,E00,102429,Zhao; Jishen,0,4,0,0
1668506309238,CSE 290,F00,102436,Tullsen; Dean Michael,0,5,0,0
1668506309238,CSE 290,G00,102440,Christensen; Henrik I,0,6,20,20
1668506309668,CSE 291,A00,102443,Su; Hao,0,0,0,0
1668506309668,CSE 291,B00,102448,Polikarpova; Nadezhda,0,0,0,0
1668506309668,CSE 291,C00,102453,Vaccaro; Kristen Marie,0,0,0,0
1668506309668,CSE 291,D00,111343,Savage; Stefan,0,0,0,0
1668506309668,CSE 291,E00,116474,Claffy; Kimberly Claire,0,0,0,0
1668506309668,CSE 291,F00,116479,Pasquale; Joseph,0,0,0,0
1668506310116,CSE 293,001,119111,Bafna; Vineet,9999,0,9999,0
1668506310116,CSE 293,002,119118,Bellare; Mihir,9999,0,9999,0
1668506310116,CSE 293,003,119122,Berg-Kirkpatrick; Taylor D,9999,0,9999,0
1668506310116,CSE 293,004,119135,Christensen; Henrik I,9999,0,9999,0
1668506310116,CSE 293,005,119142,Cottrell; Garrison W,9999,0,9999,0
1668506310116,CSE 293,006,119146,Deutsch; Alin Bernard,9999,0,9999,0
1668506310116,CSE 293,007,119159,Esmaeilzadeh; Hadi,9999,0,9999,0
1668506310116,CSE 293,008,119166,Freund; Yoav,9999,0,9999,0
1668506310116,CSE 293,009,119170,Griswold; William G.,9999,0,9999,0
1668506310116,CSE 293,010,119183,Gymrek; Melissa Ann,9999,0,9999,0
1668506310116,CSE 293,011,119190,Heninger; Nadia A,9999,0,9999,0
1668506310116,CSE 293,012,119230,Impagliazzo; Russell,9999,0,9999,0
1668506310116,CSE 293,013,119232,Jhala; Ranjit,9999,0,9999,0
1668506310116,CSE 293,014,119233,Kahng; Andrew Byun,9999,0,9999,0
1668506310116,CSE 293,015,119298,Kane; Daniel Mertz,9999,0,9999,0
1668506310116,CSE 293,016,119299,Kriegman; David J,9999,0,9999,0
1668506310116,CSE 293,017,119300,Kumar; Arun Kumar,9999,0,9999,0
1668506310116,CSE 293,018,119301,Lerner; Sorin,9999,0,9999,0
1668506310116,CSE 293,019,119302,Lovett; Shachar,9999,0,9999,0
1668506310116,CSE 293,020,119303,McAuley; Julian John,9999,0,9999,0
1668506310116,CSE 293,021,119304,Micciancio; Daniele,9999,0,9999,0
1668506310116,CSE 293,022,119367,Orailoglu; Alex,9999,0,9999,0
1668506310116,CSE 293,023,119382,Paturi; Ramamohan,9999,0,9999,0
1668506310116,CSE 293,024,119404,Polikarpova; Nadezhda,9999,0,9999,0
1668506310116,CSE 293,025,119406,Politz; Joseph Gibbs,9999,0,9999,0
1668506310116,CSE 293,026,119411,Porter; George M,9999,0,9999,0
1668506310116,CSE 293,027,119414,Porter; Leonard Emerson,9999,0,9999,0
1668506310116,CSE 293,028,119416,Ramamoorthi; Ravi,9999,0,9999,0
1668506310116,CSE 293,029,119417,Sahoo; Debashis,9999,0,9999,0
1668506310116,CSE 293,030,119420,Saul; Lawrence,9999,0,9999,0
1668506310116,CSE 293,031,119421,Savage; Stefan,9999,0,9999,0
1668506310116,CSE 293,032,119425,Schulze; Jurgen P.,9999,0,9999,0
1668506310116,CSE 293,033,119426,Snoeren; Alex C.,9999,0,9999,0
1668506310116,CSE 293,034,119428,Shang; Jingbo,9999,0,9999,0
1668506310116,CSE 293,035,119430,Stefan; Deian,9999,0,9999,0
1668506310116,CSE 293,036,119431,Su; Hao,9999,0,9999,0
1668506310116,CSE 293,037,119433,Swanson; Steven James,9999,0,9999,0
1668506310116,CSE 293,038,119435,Tullsen; Dean Michael,9999,0,9999,0
1668506310116,CSE 293,039,119483,Voelker; Geoffrey M.,9999,0,9999,0
1668506310116,CSE 293,040,119537,Zhao; Jishen,9999,0,9999,0
1668506310116,CSE 293,041,119538,Zhou; Yuan-Yuan,9999,0,9999,0
1668506310116,CSE 293,042,119539,Gao; Sicun,9999,0,9999,0
1668506310116,CSE 293,043,119540,Weibel; Nadir,9999,0,9999,0
1668506310116,CSE 293,044,119541,Gupta; Rajesh K.,9999,0,9999,0
1668506310116,CSE 293,045,126410,Vaccaro; Kristen Marie,9999,0,9999,0
1668506310116,CSE 293,046,126411,Klemke; Richard,9999,0,9999,0
1668506310542,CSE 294,A00,102459,Voelker; Geoffrey M.,0,2,0,0
1668506310542,CSE 294,B00,111322,Orailoglu; Alex,0,2,0,0
1668506310965,DSE 201,A00,096914,Deutsch; Alin Bernard,30,0,30,0
1668506311389,DSE 210,A00,096915,Dasgupta; Sanjoy,30,0,30,0
1668506311822,DSE 260A,A00,096916,Altintas De Callaf; Ilkay,30,0,30,0
1668506312270,ECE 200,001,103586,Antipa; Nicholas A,9999,0,9999,0
1668506312270,ECE 200,002,103587,Atanasov; Nikolay A.,9999,0,9999,0
1668506312270,ECE 200,003,103588,Bharadia; Dinesh,9999,0,9999,0
1668506312270,ECE 200,004,103589,Cheng; Chung Kuan,9999,0,9999,0
1668506312270,ECE 200,005,103590,Cosman; Pamela C.,9999,0,9999,0
1668506312270,ECE 200,006,103591,Dayeh; Shadi Ahmad,9999,0,9999,0
1668506312270,ECE 200,007,103592,Fainman; Yeshaiahu,9999,0,9999,0
1668506312270,ECE 200,008,103593,Ford; Joseph Earl,9999,0,9999,0
1668506312270,ECE 200,009,103594,Franceschetti; Massimo,9999,0,9999,0
1668506312270,ECE 200,010,103595,Fullerton; Eric E,9999,0,9999,0
1668506312270,ECE 200,011,103596,Galton; Ian A,9999,0,9999,0
1668506312270,ECE 200,012,103597,Gilja; Vikash,9999,0,9999,0
1668506312270,ECE 200,013,103598,Hall; Drew A.,9999,0,9999,0
1668506312270,ECE 200,014,103599,Hsueh; Tzu-Chien,9999,0,9999,0
1668506312270,ECE 200,015,103600,Javidi; Tara,9999,0,9999,0
1668506312270,ECE 200,016,103601,Kahng; Andrew Byun,9999,0,9999,0
1668506312270,ECE 200,017,103602,Kim; Young-Han,9999,0,9999,0
1668506312270,ECE 200,018,103603,Koushanfar; Farinaz,9999,0,9999,0
1668506312270,ECE 200,019,103604,Kuzum; Duygu,9999,0,9999,0
1668506312270,ECE 200,020,103605,Le; Hanh-Phuc,9999,0,9999,0
1668506312270,ECE 200,021,103606,Lin; Bill,9999,0,9999,0
1668506312270,ECE 200,022,103607,Liu; Zhaowei,9998,0,9999,1
1668506312270,ECE 200,023,103608,Lo; Yu-Hwa,9999,0,9999,0
1668506312270,ECE 200,024,103609,Lomakin; Vitaliy,9999,0,9999,0
1668506312270,ECE 200,025,103610,Mercier; Patrick Philip,9999,0,9999,0
1668506312270,ECE 200,026,103611,Meyer; Florian,9999,0,9999,0
1668506312270,ECE 200,027,103612,Milstein; Laurence B.,9999,0,9999,0
1668506312270,ECE 200,028,103613,Mir Arabbaygi; Siavash,9999,0,9999,0
1668506312270,ECE 200,029,103614,Mookherjea; Shayan,9999,0,9999,0
1668506312270,ECE 200,030,103615,Morris; Karcher William,9999,0,9999,0
1668506312270,ECE 200,031,103616,Ng; Tse Nga,9999,0,9999,0
1668506312270,ECE 200,032,103617,Nguyen; Truong Quang,9999,0,9999,0
1668506312270,ECE 200,033,103618,Nomura; Kenji,9999,0,9999,0
1668506312270,ECE 200,034,103619,Orlitsky; Alon,9999,0,9999,0
1668506312270,ECE 200,035,103620,Pal; Piya,9999,0,9999,0
1668506312270,ECE 200,036,103621,Papen; George C.,9999,0,9999,0
1668506312270,ECE 200,037,103622,Radic; Stojan,9999,0,9999,0
1668506312270,ECE 200,038,103623,Rao; Bhaskar D.,9999,0,9999,0
1668506312270,ECE 200,039,103624,Rao; Ramesh R,9999,0,9999,0
1668506312270,ECE 200,040,103625,Rebeiz; Gabriel,9999,0,9999,0
1668506312270,ECE 200,041,103626,Sanford; John R,9999,0,9999,0
1668506312270,ECE 200,042,103627,Siegel; Paul H.,9999,0,9999,0
1668506312270,ECE 200,043,103628,Sievenpiper; Daniel F.,9999,0,9999,0
1668506312270,ECE 200,044,103629,Sworder; David D.,9999,0,9999,0
1668506312270,ECE 200,045,103630,Taur; Yuan,9999,0,9999,0
1668506312270,ECE 200,046,103631,Touri; Behrouz,9999,0,9999,0
1668506312270,ECE 200,047,103632,Trivedi; Mohan M.,9999,0,9999,0
1668506312270,ECE 200,048,103633,Vasconcelos; Nuno,9999,0,9999,0
1668506312270,ECE 200,049,103634,Wang; Xiaolong,9999,0,9999,0
1668506312270,ECE 200,050,103635,Xie; Pengtao,9999,0,9999,0
1668506312270,ECE 200,051,103636,Yip; Michael,9999,0,9999,0
1668506312270,ECE 200,052,103637,Zeger; Kenneth A.,999,0,999,0
1668506312270,ECE 200,053,103638,Zhang; Xinyu,9999,0,9999,0
1668506312270,ECE 200,054,103639,Turakhia; Yatish Girish,9999,0,9999,0
1668506312270,ECE 200,055,103640,Kang; Mingu,9999,0,9999,0
1668506312270,ECE 200,056,103641,Shi; Yuanyuan,9999,0,9999,0
1668506312270,ECE 200,057,103642,Wang; Edward Jay,9999,0,9999,0
1668506312270,ECE 200,058,103643,Zheng; Yang,9999,0,9999,0
1668506312698,ECE 202,A00,103644,Kuzum; Duygu,0,44,0,0
1668506313122,ECE 212BN,A00,103646,Ng; Tse Nga,0,9,0,0
1668506313550,ECE 221,A00,111493,Staff,0,0,0,0
1668506313978,ECE 222B,A00,103647,Lomakin; Vitaliy,0,20,0,0
1668506314401,ECE 230B,A00,103648,Taur; Yuan,0,3,0,0
1668506314916,ECE 238B,A00,103649,Garay; Javier,0,0,0,0
1668506315348,ECE 240B,A00,112900,Fainman; Yeshaiahu,0,7,0,0
1668506315774,ECE 247A,A00,103650,Jokerst; Jesse Vincent,0,6,0,0
1668506316196,ECE 247B,A00,103651,Wang; Joseph,0,14,0,0
1668506316620,ECE 250,A00,103652,Siegel; Paul H.,0,82,0,0
1668506317043,ECE 251A,A00,103654,Rao; Bhaskar D.,0,61,0,0
1668506317467,ECE 257B,A00,103655,Bharadia; Dinesh,0,32,0,0
1668506317890,ECE 258A,A00,103656,Milstein; Laurence B.,0,29,0,0
1668506318320,ECE 260B,A00,103658,Kang; Mingu,0,119,0,0
1668506318748,ECE 264A,A00,103659,Galton; Ian A,0,65,0,0
1668506319174,ECE 265A,A00,103661,Gudem; Prasad S.S.,0,70,0,0
1668506319597,ECE 265D,A00,103662,Gudem; Prasad S.S.,0,26,0,0
1668506320024,ECE 268,A00,103663,Koushanfar; Farinaz,0,43,0,0
1668506320448,ECE 269,A01,103665,Pal; Piya,0,215,0,0
1668506320876,ECE 271B,A00,103666,Vasconcelos; Manuela,0,76,0,0
1668506321299,ECE 276A,A00,103667,Atanasov; Nikolay A.,0,126,0,0
1668506321724,ECE 277,A00,103668,An; Cheolhong,0,149,0,0
1668506322151,ECE 279,A00,117947,Hall; Drew A.,0,22,0,0
1668506323002,ECE 283,A00,103670,Hsueh; Tzu-Chien,0,53,0,0
1668506323433,ECE 284,A00,103671,Turakhia; Yatish Girish,0,39,0,0
1668506323856,ECE 285,A00,103672,Zheng; Yang,0,39,0,0
1668506323856,ECE 285,B00,103673,Sworder; David D.,0,57,0,0
1668506324282,ECE 287,A00,103676,Javidi; Tara,0,9,0,0
1668506324711,MATH 200B,A00,098023,Salehi Golsefidy; Alireza,10,0,15,5
1668506325134,MATH 202B,A00,098024,Rhoades; Brendon Patrick,7,0,15,8
1668506325559,MATH 203B,A00,098025,Oprea; Dragos N.,9,0,15,6
1668506325985,MATH 204B,A00,098026,Sorensen; Claus M,13,0,15,2
1668506326410,MATH 208,A00,098027,Izadi; Elham,7,0,10,3
1668506326833,MATH 209,A00,098028,Pollack; Aaron,10,0,10,0
1668506327262,MATH 211A,A00,112919,Rogalski; Daniel,8,0,10,2
1668506327686,MATH 211B,A00,112920,Seward; Brandon M.,9,0,10,1
1668506328112,MATH 218,A00,098029,Li; Bo,10,0,10,0
1668506328545,MATH 220B,A00,098030,Novak; Jonathan I,11,0,15,4
1668506328974,MATH 221A,A00,098031,Ebenfelt; Peter F,12,0,15,3
1668506329398,MATH 231B,A00,098032,Zlatos; Andrej,11,0,15,4
1668506329831,MATH 240B,A00,098033,Ni; Lei,7,0,15,8
1668506330260,MATH 243,A00,098034,Jekel; David Andrew,10,0,10,0
1668506330690,MATH 245A,A00,098035,Nie; Jiawang,0,4,15,18
1668506331114,MATH 248,A00,098036,Bejenaru; Ioan,10,0,10,0
1668506331539,MATH 250B,A00,098037,Spolaor; Luca,14,0,15,1
1668506331964,MATH 258,A00,098038,Ni; Lei,9,0,10,1
1668506332389,MATH 264B,A00,098041,Rhoades; Brendon Patrick,8,0,15,7
1668506332817,MATH 268,A00,098042,Buss; Samuel R,10,0,10,0
1668506333244,MATH 269,A00,098043,Rhoades; Brendon Patrick,10,0,10,0
1668506333675,MATH 270B,A00,098044,Li; Bo,6,0,15,9
1668506334098,MATH 272B,A00,098045,Holst; Michael J,13,0,15,2
1668506334523,MATH 273A,A00,098046,Tian; Xiaochuan,10,0,15,5
1668506334947,MATH 275,A01,098048,Tian; Xiaochuan,6,0,10,4
1668506335371,MATH 278A,A00,098049,Holst; Michael J,7,0,10,3
1668506335795,MATH 278B,A00,098050,Cloninger; Alexander,10,0,10,0
1668506336221,MATH 278C,A00,098051,Nie; Jiawang,5,0,10,5
1668506336647,MATH 280B,A00,098052,Zheng; Tianyi,7,0,15,8
1668506337072,MATH 281B,A00,098053,Bradic; Jelena,0,2,15,15
1668506337496,MATH 282B,A00,098054,Arias-Castro; Ery,0,1,15,15
1668506337922,MATH 285,A00,098055,Fitzsimmons; Patrick J,0,3,15,17
1668506338346,MATH 287B,A00,098056,Arias-Castro; Ery,1,0,15,14
1668506338775,MATH 288,A00,098057,Agarwal; Pooja,9,0,10,1
1668506338775,MATH 288,B00,098058,Zhang; Danna,8,0,10,2
1668506338775,MATH 288,C00,098059,Williams; Ruth J,9,0,10,1
1668506339200,MATH 290B,A00,098060,Roberts; Justin Deritter,12,0,15,3
1668506339627,MATH 292,A00,098061,Belmont; Eva Kinoshita,10,0,10,0
1668506340065,MATH 295,A00,098062,Suk; Andrew Hoon,47,0,50,3
1668506340488,MATH 296,A00,098063,Novak; Jonathan I,20,0,20,0
1668506340916,MATH 297,001,098064,Gamst; Anthony Collins,9997,0,9999,2
1668506852110,COGS 205,A00,101395,Chiba; Andrea,19,0,20,1
1668506852535,COGS 210B,001,101404,Greene; Deanna Jacquelyn,9998,0,9999,1
1668506852535,COGS 210B,002,101417,Xia; Haijun,9999,0,9999,0
1668506852535,COGS 210B,003,101422,Nitz; Douglas A.,9999,0,9999,0
1668506852535,COGS 210B,004,101423,Hollan; James D.,9998,0,9999,1
1668506852535,COGS 210B,005,101424,Deak; Gedeon O.,9998,0,9999,1
1668506852535,COGS 210B,006,101425,Rossano; Federico,9999,0,9999,0
1668506852963,COGS 211B,A00,101427,Coulson; Seana M,9996,0,9999,3
1668506853387,COGS 220,A00,101428,Hollan; James D.,0,10,25,25
1668506853811,COGS 229,A00,101429,Dow; Steven P,17,0,25,8
1668506854234,COGS 230,A00,101430,Klemmer; Scott R,7,0,17,10
1668506854660,COGS 234,A00,101431,Xia; Haijun,1,0,25,24
1668506855085,COGS 260,A00,101432,Kiyonaga; Anastasia,21,0,25,4
1668506855085,COGS 260,B00,101433,Kirsh; David Joel,15,0,25,10
1668506855509,CSE 202,A00,102371,Impagliazzo; Russell,0,65,0,0
1668506855932,CSE 203B,A01,102373,Cheng; Chung Kuan,0,58,0,0
1668506856356,CSE 208,A00,102374,Micciancio; Daniele,0,5,0,0
1668506856780,CSE 209A,A00,112895,Impagliazzo; Russell,0,12,15,15
1668506857207,CSE 209B,A00,108005,Bellare; Mihir,0,7,0,0
1668506857630,CSE 210,A00,113163,Coblenz; Michael J,0,84,0,0
1668506858053,CSE 219,A00,106111,Dow; Steven P,0,6,20,20
1668506858480,CSE 221,A00,102376,Voelker; Geoffrey M.,0,72,0,0
1668506858903,CSE 224,A01,102378,Porter; George M,0,166,0,0
1668506859329,CSE 229A,A00,102379,Savage; Stefan,0,10,0,0
1668506859756,CSE 229C,A00,102380,Munyaka; Imani N. S.,0,10,0,0
1668506860183,CSE 232B,A00,102382,Deutsch; Alin Bernard,0,32,0,0
1668506860611,CSE 234,A01,112904,Kumar; Arun Kumar,0,0,0,0
1668506861039,CSE 237A,A00,102383,Rosing; Tajana Simunic,0,55,0,0
1668506861463,CSE 239A,A00,102384,Deutsch; Alin Bernard,0,14,0,0
1668506861888,CSE 239B,A00,102385,Polikarpova; Nadezhda,0,10,0,0
1668506862314,CSE 240A,A00,102386,Pannuto; Patrick William,0,46,0,0
1668506862738,CSE 240B,A00,102387,Zhao; Jishen,0,47,0,0
1668506863166,CSE 241A,A00,106406,Kang; Mingu,0,9,0,0
1668506863592,CSE 249B,A00,102388,Kahng; Andrew Byun,0,5,8,8
1668506864016,CSE 251B,A01,102392,Cottrell; Garrison W,0,51,0,0
1668506864016,CSE 251B,A02,102393,Cottrell; Garrison W,0,34,0,0
1668506864441,CSE 252B,A00,102394,Ochoa; Benjamin Lawrence,0,59,0,0
1668506864865,CSE 257,A01,102396,Gao; Sicun,0,138,0,0
1668506865292,CSE 272,A00,102397,Li; Tzumao,0,19,0,0
1668506865718,CSE 274,A00,111323,Chern; Albert Ren-Haur,0,15,0,0
1668506866144,CSE 282,A00,102398,Pevzner; Pavel Arkadjevich,0,0,0,0
1668506866570,CSE 284,A00,114175,Gymrek; Melissa Ann,0,22,0,0
1668506866996,CSE 290,A00,102399,Chandraker; Manmohan Krishna,0,11,0,0
1668506866996,CSE 290,B00,102400,Vaccaro; Kristen Marie,0,7,25,25
1668506866996,CSE 290,C00,102414,Pannuto; Patrick William,0,1,25,25
1668506866996,CSE 290,D00,102427,Pevzner; Pavel Arkadjevich,0,0,0,0
1668506866996,CSE 290,E00,102429,Zhao; Jishen,0,4,0,0
1668506866996,CSE 290,F00,102436,Tullsen; Dean Michael,0,5,0,0
1668506866996,CSE 290,G00,102440,Christensen; Henrik I,0,6,20,20
1668506867433,CSE 291,A00,102443,Su; Hao,0,0,0,0
1668506867433,CSE 291,B00,102448,Polikarpova; Nadezhda,0,0,0,0
1668506867433,CSE 291,C00,102453,Vaccaro; Kristen Marie,0,0,0,0
1668506867433,CSE 291,D00,111343,Savage; Stefan,0,0,0,0
1668506867433,CSE 291,E00,116474,Claffy; Kimberly Claire,0,0,0,0
1668506867433,CSE 291,F00,116479,Pasquale; Joseph,0,0,0,0
1668506867872,CSE 293,001,119111,Bafna; Vineet,9999,0,9999,0
1668506867872,CSE 293,002,119118,Bellare; Mihir,9999,0,9999,0
1668506867872,CSE 293,003,119122,Berg-Kirkpatrick; Taylor D,9999,0,9999,0
1668506867872,CSE 293,004,119135,Christensen; Henrik I,9999,0,9999,0
1668506867872,CSE 293,005,119142,Cottrell; Garrison W,9999,0,9999,0
1668506867872,CSE 293,006,119146,Deutsch; Alin Bernard,9999,0,9999,0
1668506867872,CSE 293,007,119159,Esmaeilzadeh; Hadi,9999,0,9999,0
1668506867872,CSE 293,008,119166,Freund; Yoav,9999,0,9999,0
1668506867872,CSE 293,009,119170,Griswold; William G.,9999,0,9999,0
1668506867872,CSE 293,010,119183,Gymrek; Melissa Ann,9999,0,9999,0
1668506867872,CSE 293,011,119190,Heninger; Nadia A,9999,0,9999,0
1668506867872,CSE 293,012,119230,Impagliazzo; Russell,9999,0,9999,0
1668506867872,CSE 293,013,119232,Jhala; Ranjit,9999,0,9999,0
1668506867872,CSE 293,014,119233,Kahng; Andrew Byun,9999,0,9999,0
1668506867872,CSE 293,015,119298,Kane; Daniel Mertz,9999,0,9999,0
1668506867872,CSE 293,016,119299,Kriegman; David J,9999,0,9999,0
1668506867872,CSE 293,017,119300,Kumar; Arun Kumar,9999,0,9999,0
1668506867872,CSE 293,018,119301,Lerner; Sorin,9999,0,9999,0
1668506867872,CSE 293,019,119302,Lovett; Shachar,9999,0,9999,0
1668506867872,CSE 293,020,119303,McAuley; Julian John,9999,0,9999,0
1668506867872,CSE 293,021,119304,Micciancio; Daniele,9999,0,9999,0
1668506867872,CSE 293,022,119367,Orailoglu; Alex,9999,0,9999,0
1668506867872,CSE 293,023,119382,Paturi; Ramamohan,9999,0,9999,0
1668506867872,CSE 293,024,119404,Polikarpova; Nadezhda,9999,0,9999,0
1668506867872,CSE 293,025,119406,Politz; Joseph Gibbs,9999,0,9999,0
1668506867872,CSE 293,026,119411,Porter; George M,9999,0,9999,0
1668506867872,CSE 293,027,119414,Porter; Leonard Emerson,9999,0,9999,0
1668506867872,CSE 293,028,119416,Ramamoorthi; Ravi,9999,0,9999,0
1668506867872,CSE 293,029,119417,Sahoo; Debashis,9999,0,9999,0
1668506867872,CSE 293,030,119420,Saul; Lawrence,9999,0,9999,0
1668506867872,CSE 293,031,119421,Savage; Stefan,9999,0,9999,0
1668506867872,CSE 293,032,119425,Schulze; Jurgen P.,9999,0,9999,0
1668506867872,CSE 293,033,119426,Snoeren; Alex C.,9999,0,9999,0
1668506867872,CSE 293,034,119428,Shang; Jingbo,9999,0,9999,0
1668506867872,CSE 293,035,119430,Stefan; Deian,9999,0,9999,0
1668506867872,CSE 293,036,119431,Su; Hao,9999,0,9999,0
1668506867872,CSE 293,037,119433,Swanson; Steven James,9999,0,9999,0
1668506867872,CSE 293,038,119435,Tullsen; Dean Michael,9999,0,9999,0
1668506867872,CSE 293,039,119483,Voelker; Geoffrey M.,9999,0,9999,0
1668506867872,CSE 293,040,119537,Zhao; Jishen,9999,0,9999,0
1668506867872,CSE 293,041,119538,Zhou; Yuan-Yuan,9999,0,9999,0
1668506867872,CSE 293,042,119539,Gao; Sicun,9999,0,9999,0
1668506867872,CSE 293,043,119540,Weibel; Nadir,9999,0,9999,0
1668506867872,CSE 293,044,119541,Gupta; Rajesh K.,9999,0,9999,0
1668506867872,CSE 293,045,126410,Vaccaro; Kristen Marie,9999,0,9999,0
1668506867872,CSE 293,046,126411,Klemke; Richard,9999,0,9999,0
1668506868295,CSE 294,A00,102459,Voelker; Geoffrey M.,0,2,0,0
1668506868295,CSE 294,B00,111322,Orailoglu; Alex,0,2,0,0
1668506868730,DSE 201,A00,096914,Deutsch; Alin Bernard,30,0,30,0
1668506869159,DSE 210,A00,096915,Dasgupta; Sanjoy,30,0,30,0
1668506869583,DSE 260A,A00,096916,Altintas De Callaf; Ilkay,30,0,30,0
1668506870042,ECE 200,001,103586,Antipa; Nicholas A,9999,0,9999,0
1668506870042,ECE 200,002,103587,Atanasov; Nikolay A.,9999,0,9999,0
1668506870042,ECE 200,003,103588,Bharadia; Dinesh,9999,0,9999,0
1668506870042,ECE 200,004,103589,Cheng; Chung Kuan,9999,0,9999,0
1668506870042,ECE 200,005,103590,Cosman; Pamela C.,9999,0,9999,0
1668506870042,ECE 200,006,103591,Dayeh; Shadi Ahmad,9999,0,9999,0
1668506870042,ECE 200,007,103592,Fainman; Yeshaiahu,9999,0,9999,0
1668506870042,ECE 200,008,103593,Ford; Joseph Earl,9999,0,9999,0
1668506870042,ECE 200,009,103594,Franceschetti; Massimo,9999,0,9999,0
1668506870042,ECE 200,010,103595,Fullerton; Eric E,9999,0,9999,0
1668506870042,ECE 200,011,103596,Galton; Ian A,9999,0,9999,0
1668506870042,ECE 200,012,103597,Gilja; Vikash,9999,0,9999,0
1668506870042,ECE 200,013,103598,Hall; Drew A.,9999,0,9999,0
1668506870042,ECE 200,014,103599,Hsueh; Tzu-Chien,9999,0,9999,0
1668506870042,ECE 200,015,103600,Javidi; Tara,9999,0,9999,0
1668506870042,ECE 200,016,103601,Kahng; Andrew Byun,9999,0,9999,0
1668506870042,ECE 200,017,103602,Kim; Young-Han,9999,0,9999,0
1668506870042,ECE 200,018,103603,Koushanfar; Farinaz,9999,0,9999,0
1668506870042,ECE 200,019,103604,Kuzum; Duygu,9999,0,9999,0
1668506870042,ECE 200,020,103605,Le; Hanh-Phuc,9999,0,9999,0
1668506870042,ECE 200,021,103606,Lin; Bill,9999,0,9999,0
1668506870042,ECE 200,022,103607,Liu; Zhaowei,9998,0,9999,1
1668506870042,ECE 200,023,103608,Lo; Yu-Hwa,9999,0,9999,0
1668506870042,ECE 200,024,103609,Lomakin; Vitaliy,9999,0,9999,0
1668506870042,ECE 200,025,103610,Mercier; Patrick Philip,9999,0,9999,0
1668506870042,ECE 200,026,103611,Meyer; Florian,9999,0,9999,0
1668506870042,ECE 200,027,103612,Milstein; Laurence B.,9999,0,9999,0
1668506870042,ECE 200,028,103613,Mir Arabbaygi; Siavash,9999,0,9999,0
1668506870042,ECE 200,029,103614,Mookherjea; Shayan,9999,0,9999,0
1668506870042,ECE 200,030,103615,Morris; Karcher William,9999,0,9999,0
1668506870042,ECE 200,031,103616,Ng; Tse Nga,9999,0,9999,0
1668506870042,ECE 200,032,103617,Nguyen; Truong Quang,9999,0,9999,0
1668506870042,ECE 200,033,103618,Nomura; Kenji,9999,0,9999,0
1668506870042,ECE 200,034,103619,Orlitsky; Alon,9999,0,9999,0
1668506870042,ECE 200,035,103620,Pal; Piya,9999,0,9999,0
1668506870042,ECE 200,036,103621,Papen; George C.,9999,0,9999,0
1668506870042,ECE 200,037,103622,Radic; Stojan,9999,0,9999,0
1668506870042,ECE 200,038,103623,Rao; Bhaskar D.,9999,0,9999,0
1668506870042,ECE 200,039,103624,Rao; Ramesh R,9999,0,9999,0
1668506870042,ECE 200,040,103625,Rebeiz; Gabriel,9999,0,9999,0
1668506870042,ECE 200,041,103626,Sanford; John R,9999,0,9999,0
1668506870042,ECE 200,042,103627,Siegel; Paul H.,9999,0,9999,0
1668506870042,ECE 200,043,103628,Sievenpiper; Daniel F.,9999,0,9999,0
1668506870042,ECE 200,044,103629,Sworder; David D.,9999,0,9999,0
1668506870042,ECE 200,045,103630,Taur; Yuan,9999,0,9999,0
1668506870042,ECE 200,046,103631,Touri; Behrouz,9999,0,9999,0
1668506870042,ECE 200,047,103632,Trivedi; Mohan M.,9999,0,9999,0
1668506870042,ECE 200,048,103633,Vasconcelos; Nuno,9999,0,9999,0
1668506870042,ECE 200,049,103634,Wang; Xiaolong,9999,0,9999,0
1668506870042,ECE 200,050,103635,Xie; Pengtao,9999,0,9999,0
1668506870042,ECE 200,051,103636,Yip; Michael,9999,0,9999,0
1668506870042,ECE 200,052,103637,Zeger; Kenneth A.,999,0,999,0
1668506870042,ECE 200,053,103638,Zhang; Xinyu,9999,0,9999,0
1668506870042,ECE 200,054,103639,Turakhia; Yatish Girish,9999,0,9999,0
1668506870042,ECE 200,055,103640,Kang; Mingu,9999,0,9999,0
1668506870042,ECE 200,056,103641,Shi; Yuanyuan,9999,0,9999,0
1668506870042,ECE 200,057,103642,Wang; Edward Jay,9999,0,9999,0
1668506870042,ECE 200,058,103643,Zheng; Yang,9999,0,9999,0
1668506870468,ECE 202,A00,103644,Kuzum; Duygu,0,44,0,0
1668506870893,ECE 212BN,A00,103646,Ng; Tse Nga,0,9,0,0
1668506871320,ECE 221,A00,111493,Staff,0,0,0,0
1668506871748,ECE 222B,A00,103647,Lomakin; Vitaliy,0,20,0,0
1668506872174,ECE 230B,A00,103648,Taur; Yuan,0,3,0,0
1668506872599,ECE 238B,A00,103649,Garay; Javier,0,0,0,0
1668506873024,ECE 240B,A00,112900,Fainman; Yeshaiahu,0,7,0,0
1668506873448,ECE 247A,A00,103650,Jokerst; Jesse Vincent,0,6,0,0
1668506873876,ECE 247B,A00,103651,Wang; Joseph,0,14,0,0
1668506874303,ECE 250,A00,103652,Siegel; Paul H.,0,82,0,0
1668506874730,ECE 251A,A00,103654,Rao; Bhaskar D.,0,61,0,0
1668506875155,ECE 257B,A00,103655,Bharadia; Dinesh,0,32,0,0
1668506875576,ECE 258A,A00,103656,Milstein; Laurence B.,0,29,0,0
1668506876004,ECE 260B,A00,103658,Kang; Mingu,0,119,0,0
1668506876429,ECE 264A,A00,103659,Galton; Ian A,0,65,0,0
1668506876852,ECE 265A,A00,103661,Gudem; Prasad S.S.,0,70,0,0
1668506877277,ECE 265D,A00,103662,Gudem; Prasad S.S.,0,26,0,0
1668506877705,ECE 268,A00,103663,Koushanfar; Farinaz,0,43,0,0
1668506878128,ECE 269,A01,103665,Pal; Piya,0,215,0,0
1668506878552,ECE 271B,A00,103666,Vasconcelos; Manuela,0,76,0,0
1668506878976,ECE 276A,A00,103667,Atanasov; Nikolay A.,0,126,0,0
1668506879403,ECE 277,A00,103668,An; Cheolhong,0,149,0,0
1668506879828,ECE 279,A00,117947,Hall; Drew A.,0,22,0,0
1668506880684,ECE 283,A00,103670,Hsueh; Tzu-Chien,0,53,0,0
1668506881111,ECE 284,A00,103671,Turakhia; Yatish Girish,0,39,0,0
1668506881538,ECE 285,A00,103672,Zheng; Yang,0,39,0,0
1668506881538,ECE 285,B00,103673,Sworder; David D.,0,57,0,0
1668506881963,ECE 287,A00,103676,Javidi; Tara,0,9,0,0
1668506882394,MATH 200B,A00,098023,Salehi Golsefidy; Alireza,10,0,15,5
1668506882829,MATH 202B,A00,098024,Rhoades; Brendon Patrick,7,0,15,8
1668506883255,MATH 203B,A00,098025,Oprea; Dragos N.,9,0,15,6
1668506883679,MATH 204B,A00,098026,Sorensen; Claus M,13,0,15,2
1668506884104,MATH 208,A00,098027,Izadi; Elham,7,0,10,3
1668506884531,MATH 209,A00,098028,Pollack; Aaron,10,0,10,0
1668506884957,MATH 211A,A00,112919,Rogalski; Daniel,8,0,10,2
1668506885383,MATH 211B,A00,112920,Seward; Brandon M.,9,0,10,1
1668506885807,MATH 218,A00,098029,Li; Bo,10,0,10,0
1668506886232,MATH 220B,A00,098030,Novak; Jonathan I,11,0,15,4
1668506886656,MATH 221A,A00,098031,Ebenfelt; Peter F,12,0,15,3
1668506887079,MATH 231B,A00,098032,Zlatos; Andrej,11,0,15,4
1668506887504,MATH 240B,A00,098033,Ni; Lei,7,0,15,8
1668506888031,MATH 243,A00,098034,Jekel; David Andrew,10,0,10,0
1668506888456,MATH 245A,A00,098035,Nie; Jiawang,0,4,15,18
1668506888878,MATH 248,A00,098036,Bejenaru; Ioan,10,0,10,0
1668506889301,MATH 250B,A00,098037,Spolaor; Luca,14,0,15,1
1668506889728,MATH 258,A00,098038,Ni; Lei,9,0,10,1
1668506890152,MATH 264B,A00,098041,Rhoades; Brendon Patrick,8,0,15,7
1668506890577,MATH 268,A00,098042,Buss; Samuel R,10,0,10,0
1668506891000,MATH 269,A00,098043,Rhoades; Brendon Patrick,10,0,10,0
1668506891437,MATH 270B,A00,098044,Li; Bo,6,0,15,9
1668506891860,MATH 272B,A00,098045,Holst; Michael J,13,0,15,2
1668506892287,MATH 273A,A00,098046,Tian; Xiaochuan,10,0,15,5
1668506892715,MATH 275,A01,098048,Tian; Xiaochuan,6,0,10,4
1668506893138,MATH 278A,A00,098049,Holst; Michael J,7,0,10,3
1668506893560,MATH 278B,A00,098050,Cloninger; Alexander,10,0,10,0
1668506893984,MATH 278C,A00,098051,Nie; Jiawang,5,0,10,5
1668506894408,MATH 280B,A00,098052,Zheng; Tianyi,7,0,15,8
1668506894830,MATH 281B,A00,098053,Bradic; Jelena,0,2,15,15
1668506895253,MATH 282B,A00,098054,Arias-Castro; Ery,0,1,15,15
1668506895679,MATH 285,A00,098055,Fitzsimmons; Patrick J,0,3,15,17
1668506896101,MATH 287B,A00,098056,Arias-Castro; Ery,1,0,15,14
1668506896525,MATH 288,A00,098057,Agarwal; Pooja,9,0,10,1
1668506896525,MATH 288,B00,098058,Zhang; Danna,8,0,10,2
1668506896525,MATH 288,C00,098059,Williams; Ruth J,9,0,10,1
1668506896949,MATH 290B,A00,098060,Roberts; Justin Deritter,12,0,15,3
1668506897373,MATH 292,A00,098061,Belmont; Eva Kinoshita,10,0,10,0
1668506897805,MATH 295,A00,098062,Suk; Andrew Hoon,47,0,50,3
1668506898232,MATH 296,A00,098063,Novak; Jonathan I,20,0,20,0
1668506898658,MATH 297,001,098064,Gamst; Anthony Collins,9997,0,9999,2
1668507399497,COGS 205,A00,101395,Chiba; Andrea,19,0,20,1
1668507399924,COGS 210B,001,101404,Greene; Deanna Jacquelyn,9998,0,9999,1
1668507399924,COGS 210B,002,101417,Xia; Haijun,9999,0,9999,0
1668507399924,COGS 210B,003,101422,Nitz; Douglas A.,9999,0,9999,0
1668507399924,COGS 210B,004,101423,Hollan; James D.,9998,0,9999,1
1668507399924,COGS 210B,005,101424,Deak; Gedeon O.,9998,0,9999,1
1668507399924,COGS 210B,006,101425,Rossano; Federico,9999,0,9999,0
1668507400347,COGS 211B,A00,101427,Coulson; Seana M,9996,0,9999,3
1668507400771,COGS 220,A00,101428,Hollan; James D.,0,10,25,25
1668507401195,COGS 229,A00,101429,Dow; Steven P,17,0,25,8
1668507401618,COGS 230,A00,101430,Klemmer; Scott R,7,0,17,10
1668507402042,COGS 234,A00,101431,Xia; Haijun,1,0,25,24
1668507402471,COGS 260,A00,101432,Kiyonaga; Anastasia,21,0,25,4
1668507402471,COGS 260,B00,101433,Kirsh; David Joel,15,0,25,10
1668507402898,CSE 202,A00,102371,Impagliazzo; Russell,0,65,0,0
1668507403326,CSE 203B,A01,102373,Cheng; Chung Kuan,0,58,0,0
1668507403751,CSE 208,A00,102374,Micciancio; Daniele,0,5,0,0
1668507404176,CSE 209A,A00,112895,Impagliazzo; Russell,0,12,15,15
1668507404603,CSE 209B,A00,108005,Bellare; Mihir,0,7,0,0
1668507405028,CSE 210,A00,113163,Coblenz; Michael J,0,84,0,0
1668507405453,CSE 219,A00,106111,Dow; Steven P,0,6,20,20
1668507405880,CSE 221,A00,102376,Voelker; Geoffrey M.,0,72,0,0
1668507406305,CSE 224,A01,102378,Porter; George M,0,166,0,0
1668507406729,CSE 229A,A00,102379,Savage; Stefan,0,10,0,0
1668507407156,CSE 229C,A00,102380,Munyaka; Imani N. S.,0,10,0,0
1668507407657,CSE 232B,A00,102382,Deutsch; Alin Bernard,0,32,0,0
1668507408080,CSE 234,A01,112904,Kumar; Arun Kumar,0,0,0,0
1668507408503,CSE 237A,A00,102383,Rosing; Tajana Simunic,0,55,0,0
1668507408929,CSE 239A,A00,102384,Deutsch; Alin Bernard,0,14,0,0
1668507409355,CSE 239B,A00,102385,Polikarpova; Nadezhda,0,10,0,0
1668507409779,CSE 240A,A00,102386,Pannuto; Patrick William,0,46,0,0
1668507410209,CSE 240B,A00,102387,Zhao; Jishen,0,47,0,0
1668507410633,CSE 241A,A00,106406,Kang; Mingu,0,9,0,0
1668507411078,CSE 249B,A00,102388,Kahng; Andrew Byun,0,5,8,8
1668507411504,CSE 251B,A01,102392,Cottrell; Garrison W,0,51,0,0
1668507411504,CSE 251B,A02,102393,Cottrell; Garrison W,0,34,0,0
1668507411931,CSE 252B,A00,102394,Ochoa; Benjamin Lawrence,0,59,0,0
1668507412355,CSE 257,A01,102396,Gao; Sicun,0,138,0,0
1668507412782,CSE 272,A00,102397,Li; Tzumao,0,19,0,0
1668507413206,CSE 274,A00,111323,Chern; Albert Ren-Haur,0,15,0,0
1668507413635,CSE 282,A00,102398,Pevzner; Pavel Arkadjevich,0,0,0,0
1668507414060,CSE 284,A00,114175,Gymrek; Melissa Ann,0,22,0,0
1668507414482,CSE 290,A00,102399,Chandraker; Manmohan Krishna,0,11,0,0
1668507414482,CSE 290,B00,102400,Vaccaro; Kristen Marie,0,7,25,25
1668507414482,CSE 290,C00,102414,Pannuto; Patrick William,0,1,25,25
1668507414482,CSE 290,D00,102427,Pevzner; Pavel Arkadjevich,0,0,0,0
1668507414482,CSE 290,E00,102429,Zhao; Jishen,0,4,0,0
1668507414482,CSE 290,F00,102436,Tullsen; Dean Michael,0,5,0,0
1668507414482,CSE 290,G00,102440,Christensen; Henrik I,0,6,20,20
1668507414907,CSE 291,A00,102443,Su; Hao,0,0,0,0
1668507414907,CSE 291,B00,102448,Polikarpova; Nadezhda,0,0,0,0
1668507414907,CSE 291,C00,102453,Vaccaro; Kristen Marie,0,0,0,0
1668507414907,CSE 291,D00,111343,Savage; Stefan,0,0,0,0
1668507414907,CSE 291,E00,116474,Claffy; Kimberly Claire,0,0,0,0
1668507414907,CSE 291,F00,116479,Pasquale; Joseph,0,0,0,0
1668507415335,CSE 293,001,119111,Bafna; Vineet,9999,0,9999,0
1668507415335,CSE 293,002,119118,Bellare; Mihir,9999,0,9999,0
1668507415335,CSE 293,003,119122,Berg-Kirkpatrick; Taylor D,9999,0,9999,0
1668507415335,CSE 293,004,119135,Christensen; Henrik I,9999,0,9999,0
1668507415335,CSE 293,005,119142,Cottrell; Garrison W,9999,0,9999,0
1668507415335,CSE 293,006,119146,Deutsch; Alin Bernard,9999,0,9999,0
1668507415335,CSE 293,007,119159,Esmaeilzadeh; Hadi,9999,0,9999,0
1668507415335,CSE 293,008,119166,Freund; Yoav,9999,0,9999,0
1668507415335,CSE 293,009,119170,Griswold; William G.,9999,0,9999,0
1668507415335,CSE 293,010,119183,Gymrek; Melissa Ann,9999,0,9999,0
1668507415335,CSE 293,011,119190,Heninger; Nadia A,9999,0,9999,0
1668507415335,CSE 293,012,119230,Impagliazzo; Russell,9999,0,9999,0
1668507415335,CSE 293,013,119232,Jhala; Ranjit,9999,0,9999,0
1668507415335,CSE 293,014,119233,Kahng; Andrew Byun,9999,0,9999,0
1668507415335,CSE 293,015,119298,Kane; Daniel Mertz,9999,0,9999,0
1668507415335,CSE 293,016,119299,Kriegman; David J,9999,0,9999,0
1668507415335,CSE 293,017,119300,Kumar; Arun Kumar,9999,0,9999,0
1668507415335,CSE 293,018,119301,Lerner; Sorin,9999,0,9999,0
1668507415335,CSE 293,019,119302,Lovett; Shachar,9999,0,9999,0
1668507415335,CSE 293,020,119303,McAuley; Julian John,9999,0,9999,0
1668507415335,CSE 293,021,119304,Micciancio; Daniele,9999,0,9999,0
1668507415335,CSE 293,022,119367,Orailoglu; Alex,9999,0,9999,0
1668507415335,CSE 293,023,119382,Paturi; Ramamohan,9999,0,9999,0
1668507415335,CSE 293,024,119404,Polikarpova; Nadezhda,9999,0,9999,0
1668507415335,CSE 293,025,119406,Politz; Joseph Gibbs,9999,0,9999,0
1668507415335,CSE 293,026,119411,Porter; George M,9999,0,9999,0
1668507415335,CSE 293,027,119414,Porter; Leonard Emerson,9999,0,9999,0
1668507415335,CSE 293,028,119416,Ramamoorthi; Ravi,9999,0,9999,0
1668507415335,CSE 293,029,119417,Sahoo; Debashis,9999,0,9999,0
1668507415335,CSE 293,030,119420,Saul; Lawrence,9999,0,9999,0
1668507415335,CSE 293,031,119421,Savage; Stefan,9999,0,9999,0
1668507415335,CSE 293,032,119425,Schulze; Jurgen P.,9999,0,9999,0
1668507415335,CSE 293,033,119426,Snoeren; Alex C.,9999,0,9999,0
1668507415335,CSE 293,034,119428,Shang; Jingbo,9999,0,9999,0
1668507415335,CSE 293,035,119430,Stefan; Deian,9999,0,9999,0
1668507415335,CSE 293,036,119431,Su; Hao,9999,0,9999,0
1668507415335,CSE 293,037,119433,Swanson; Steven James,9999,0,9999,0
1668507415335,CSE 293,038,119435,Tullsen; Dean Michael,9999,0,9999,0
1668507415335,CSE 293,039,119483,Voelker; Geoffrey M.,9999,0,9999,0
1668507415335,CSE 293,040,119537,Zhao; Jishen,9999,0,9999,0
1668507415335,CSE 293,041,119538,Zhou; Yuan-Yuan,9999,0,9999,0
1668507415335,CSE 293,042,119539,Gao; Sicun,9999,0,9999,0
1668507415335,CSE 293,043,119540,Weibel; Nadir,9999,0,9999,0
1668507415335,CSE 293,044,119541,Gupta; Rajesh K.,9999,0,9999,0
1668507415335,CSE 293,045,126410,Vaccaro; Kristen Marie,9999,0,9999,0
1668507415335,CSE 293,046,126411,Klemke; Richard,9999,0,9999,0
1668507415761,CSE 294,A00,102459,Voelker; Geoffrey M.,0,2,0,0
1668507415761,CSE 294,B00,111322,Orailoglu; Alex,0,2,0,0
1668507416189,DSE 201,A00,096914,Deutsch; Alin Bernard,30,0,30,0
1668507416612,DSE 210,A00,096915,Dasgupta; Sanjoy,30,0,30,0
1668507417035,DSE 260A,A00,096916,Altintas De Callaf; Ilkay,30,0,30,0
1668507417467,ECE 200,001,103586,Antipa; Nicholas A,9999,0,9999,0
1668507417467,ECE 200,002,103587,Atanasov; Nikolay A.,9999,0,9999,0
1668507417467,ECE 200,003,103588,Bharadia; Dinesh,9999,0,9999,0
1668507417467,ECE 200,004,103589,Cheng; Chung Kuan,9999,0,9999,0
1668507417467,ECE 200,005,103590,Cosman; Pamela C.,9999,0,9999,0
1668507417467,ECE 200,006,103591,Dayeh; Shadi Ahmad,9999,0,9999,0
1668507417467,ECE 200,007,103592,Fainman; Yeshaiahu,9999,0,9999,0
1668507417467,ECE 200,008,103593,Ford; Joseph Earl,9999,0,9999,0
1668507417467,ECE 200,009,103594,Franceschetti; Massimo,9999,0,9999,0
1668507417467,ECE 200,010,103595,Fullerton; Eric E,9999,0,9999,0
1668507417467,ECE 200,011,103596,Galton; Ian A,9999,0,9999,0
1668507417467,ECE 200,012,103597,Gilja; Vikash,9999,0,9999,0
1668507417467,ECE 200,013,103598,Hall; Drew A.,9999,0,9999,0
1668507417467,ECE 200,014,103599,Hsueh; Tzu-Chien,9999,0,9999,0
1668507417467,ECE 200,015,103600,Javidi; Tara,9999,0,9999,0
1668507417467,ECE 200,016,103601,Kahng; Andrew Byun,9999,0,9999,0
1668507417467,ECE 200,017,103602,Kim; Young-Han,9999,0,9999,0
1668507417467,ECE 200,018,103603,Koushanfar; Farinaz,9999,0,9999,0
1668507417467,ECE 200,019,103604,Kuzum; Duygu,9999,0,9999,0
1668507417467,ECE 200,020,103605,Le; Hanh-Phuc,9999,0,9999,0
1668507417467,ECE 200,021,103606,Lin; Bill,9999,0,9999,0
1668507417467,ECE 200,022,103607,Liu; Zhaowei,9998,0,9999,1
1668507417467,ECE 200,023,103608,Lo; Yu-Hwa,9999,0,9999,0
1668507417467,ECE 200,024,103609,Lomakin; Vitaliy,9999,0,9999,0
1668507417467,ECE 200,025,103610,Mercier; Patrick Philip,9999,0,9999,0
1668507417467,ECE 200,026,103611,Meyer; Florian,9999,0,9999,0
1668507417467,ECE 200,027,103612,Milstein; Laurence B.,9999,0,9999,0
1668507417467,ECE 200,028,103613,Mir Arabbaygi; Siavash,9999,0,9999,0
1668507417467,ECE 200,029,103614,Mookherjea; Shayan,9999,0,9999,0
1668507417467,ECE 200,030,103615,Morris; Karcher William,9999,0,9999,0
1668507417467,ECE 200,031,103616,Ng; Tse Nga,9999,0,9999,0
1668507417467,ECE 200,032,103617,Nguyen; Truong Quang,9999,0,9999,0
1668507417467,ECE 200,033,103618,Nomura; Kenji,9999,0,9999,0
1668507417467,ECE 200,034,103619,Orlitsky; Alon,9999,0,9999,0
1668507417467,ECE 200,035,103620,Pal; Piya,9999,0,9999,0
1668507417467,ECE 200,036,103621,Papen; George C.,9999,0,9999,0
1668507417467,ECE 200,037,103622,Radic; Stojan,9999,0,9999,0
1668507417467,ECE 200,038,103623,Rao; Bhaskar D.,9999,0,9999,0
1668507417467,ECE 200,039,103624,Rao; Ramesh R,9999,0,9999,0
1668507417467,ECE 200,040,103625,Rebeiz; Gabriel,9999,0,9999,0
1668507417467,ECE 200,041,103626,Sanford; John R,9999,0,9999,0
1668507417467,ECE 200,042,103627,Siegel; Paul H.,9999,0,9999,0
1668507417467,ECE 200,043,103628,Sievenpiper; Daniel F.,9999,0,9999,0
1668507417467,ECE 200,044,103629,Sworder; David D.,9999,0,9999,0
1668507417467,ECE 200,045,103630,Taur; Yuan,9999,0,9999,0
1668507417467,ECE 200,046,103631,Touri; Behrouz,9999,0,9999,0
1668507417467,ECE 200,047,103632,Trivedi; Mohan M.,9999,0,9999,0
1668507417467,ECE 200,048,103633,Vasconcelos; Nuno,9999,0,9999,0
1668507417467,ECE 200,049,103634,Wang; Xiaolong,9999,0,9999,0
1668507417467,ECE 200,050,103635,Xie; Pengtao,9999,0,9999,0
1668507417467,ECE 200,051,103636,Yip; Michael,9999,0,9999,0
1668507417467,ECE 200,052,103637,Zeger; Kenneth A.,999,0,999,0
1668507417467,ECE 200,053,103638,Zhang; Xinyu,9999,0,9999,0
1668507417467,ECE 200,054,103639,Turakhia; Yatish Girish,9999,0,9999,0
1668507417467,ECE 200,055,103640,Kang; Mingu,9999,0,9999,0
1668507417467,ECE 200,056,103641,Shi; Yuanyuan,9999,0,9999,0
1668507417467,ECE 200,057,103642,Wang; Edward Jay,9999,0,9999,0
1668507417467,ECE 200,058,103643,Zheng; Yang,9999,0,9999,0
1668507417890,ECE 202,A00,103644,Kuzum; Duygu,0,44,0,0
1668507418314,ECE 212BN,A00,103646,Ng; Tse Nga,0,9,0,0
1668507418739,ECE 221,A00,111493,Staff,0,0,0,0
1668507419167,ECE 222B,A00,103647,Lomakin; Vitaliy,0,20,0,0
1668507419594,ECE 230B,A00,103648,Taur; Yuan,0,3,0,0
1668507420029,ECE 238B,A00,103649,Garay; Javier,0,0,0,0
1668507420463,ECE 240B,A00,112900,Fainman; Yeshaiahu,0,7,0,0
1668507420889,ECE 247A,A00,103650,Jokerst; Jesse Vincent,0,6,0,0
1668507421315,ECE 247B,A00,103651,Wang; Joseph,0,14,0,0
1668507421738,ECE 250,A00,103652,Siegel; Paul H.,0,82,0,0
1668507422165,ECE 251A,A00,103654,Rao; Bhaskar D.,0,61,0,0
1668507422592,ECE 257B,A00,103655,Bharadia; Dinesh,0,32,0,0
1668507423017,ECE 258A,A00,103656,Milstein; Laurence B.,0,29,0,0
1668507423445,ECE 260B,A00,103658,Kang; Mingu,0,119,0,0
1668507423873,ECE 264A,A00,103659,Galton; Ian A,0,65,0,0
1668507424298,ECE 265A,A00,103661,Gudem; Prasad S.S.,0,70,0,0
1668507424724,ECE 265D,A00,103662,Gudem; Prasad S.S.,0,26,0,0
1668507425146,ECE 268,A00,103663,Koushanfar; Farinaz,0,43,0,0
1668507425573,ECE 269,A01,103665,Pal; Piya,0,215,0,0
1668507425997,ECE 271B,A00,103666,Vasconcelos; Manuela,0,76,0,0
1668507426425,ECE 276A,A00,103667,Atanasov; Nikolay A.,0,126,0,0
1668507426847,ECE 277,A00,103668,An; Cheolhong,0,149,0,0
1668507427270,ECE 279,A00,117947,Hall; Drew A.,0,22,0,0
1668507428124,ECE 283,A00,103670,Hsueh; Tzu-Chien,0,53,0,0
1668507428553,ECE 284,A00,103671,Turakhia; Yatish Girish,0,39,0,0
1668507428980,ECE 285,A00,103672,Zheng; Yang,0,39,0,0
1668507428980,ECE 285,B00,103673,Sworder; David D.,0,57,0,0
1668507429407,ECE 287,A00,103676,Javidi; Tara,0,9,0,0
1668507429834,MATH 200B,A00,098023,Salehi Golsefidy; Alireza,10,0,15,5
1668507430262,MATH 202B,A00,098024,Rhoades; Brendon Patrick,7,0,15,8
1668507430690,MATH 203B,A00,098025,Oprea; Dragos N.,9,0,15,6
1668507431121,MATH 204B,A00,098026,Sorensen; Claus M,13,0,15,2
1668507431551,MATH 208,A00,098027,Izadi; Elham,7,0,10,3
1668507431980,MATH 209,A00,098028,Pollack; Aaron,10,0,10,0
1668507432407,MATH 211A,A00,112919,Rogalski; Daniel,8,0,10,2
1668507432829,MATH 211B,A00,112920,Seward; Brandon M.,9,0,10,1
1668507433255,MATH 218,A00,098029,Li; Bo,10,0,10,0
1668507433679,MATH 220B,A00,098030,Novak; Jonathan I,11,0,15,4
1668507434104,MATH 221A,A00,098031,Ebenfelt; Peter F,12,0,15,3
1668507434530,MATH 231B,A00,098032,Zlatos; Andrej,11,0,15,4
1668507434957,MATH 240B,A00,098033,Ni; Lei,7,0,15,8
1668507435382,MATH 243,A00,098034,Jekel; David Andrew,10,0,10,0
1668507435812,MATH 245A,A00,098035,Nie; Jiawang,0,4,15,18
1668507436236,MATH 248,A00,098036,Bejenaru; Ioan,10,0,10,0
1668507436663,MATH 250B,A00,098037,Spolaor; Luca,14,0,15,1
1668507437087,MATH 258,A00,098038,Ni; Lei,9,0,10,1
1668507437512,MATH 264B,A00,098041,Rhoades; Brendon Patrick,8,0,15,7
1668507437947,MATH 268,A00,098042,Buss; Samuel R,10,0,10,0
1668507438371,MATH 269,A00,098043,Rhoades; Brendon Patrick,10,0,10,0
1668507438795,MATH 270B,A00,098044,Li; Bo,6,0,15,9
1668507439224,MATH 272B,A00,098045,Holst; Michael J,13,0,15,2
1668507439656,MATH 273A,A00,098046,Tian; Xiaochuan,10,0,15,5
1668507440082,MATH 275,A01,098048,Tian; Xiaochuan,6,0,10,4
1668507440507,MATH 278A,A00,098049,Holst; Michael J,7,0,10,3
1668507440929,MATH 278B,A00,098050,Cloninger; Alexander,10,0,10,0
1668507441361,MATH 278C,A00,098051,Nie; Jiawang,5,0,10,5
1668507441785,MATH 280B,A00,098052,Zheng; Tianyi,7,0,15,8
1668507442213,MATH 281B,A00,098053,Bradic; Jelena,0,2,15,15
1668507442643,MATH 282B,A00,098054,Arias-Castro; Ery,0,1,15,15
1668507443066,MATH 285,A00,098055,Fitzsimmons; Patrick J,0,3,15,17
1668507443490,MATH 287B,A00,098056,Arias-Castro; Ery,1,0,15,14
1668507443912,MATH 288,A00,098057,Agarwal; Pooja,9,0,10,1
1668507443912,MATH 288,B00,098058,Zhang; Danna,8,0,10,2
1668507443912,MATH 288,C00,098059,Williams; Ruth J,9,0,10,1
1668507444335,MATH 290B,A00,098060,Roberts; Justin Deritter,12,0,15,3
1668507444758,MATH 292,A00,098061,Belmont; Eva Kinoshita,10,0,10,0
1668507445181,MATH 295,A00,098062,Suk; Andrew Hoon,47,0,50,3
1668507445604,MATH 296,A00,098063,Novak; Jonathan I,20,0,20,0
1668507446038,MATH 297,001,098064,Gamst; Anthony Collins,9997,0,9999,2
1668507946401,COGS 205,A00,101395,Chiba; Andrea,19,0,20,1
1668507946830,COGS 210B,001,101404,Greene; Deanna Jacquelyn,9998,0,9999,1
1668507946830,COGS 210B,002,101417,Xia; Haijun,9999,0,9999,0
1668507946830,COGS 210B,003,101422,Nitz; Douglas A.,9999,0,9999,0
1668507946830,COGS 210B,004,101423,Hollan; James D.,9998,0,9999,1
1668507946830,COGS 210B,005,101424,Deak; Gedeon O.,9998,0,9999,1
1668507946830,COGS 210B,006,101425,Rossano; Federico,9999,0,9999,0
1668507947255,COGS 211B,A00,101427,Coulson; Seana M,9996,0,9999,3
1668507947681,COGS 220,A00,101428,Hollan; James D.,0,10,25,25
1668507948106,COGS 229,A00,101429,Dow; Steven P,17,0,25,8
1668507948529,COGS 230,A00,101430,Klemmer; Scott R,7,0,17,10
1668507948952,COGS 234,A00,101431,Xia; Haijun,1,0,25,24
1668507949384,COGS 260,A00,101432,Kiyonaga; Anastasia,21,0,25,4
1668507949384,COGS 260,B00,101433,Kirsh; David Joel,15,0,25,10
1668507949810,CSE 202,A00,102371,Impagliazzo; Russell,0,65,0,0
1668507950233,CSE 203B,A01,102373,Cheng; Chung Kuan,0,58,0,0
1668507950658,CSE 208,A00,102374,Micciancio; Daniele,0,5,0,0
1668507951088,CSE 209A,A00,112895,Impagliazzo; Russell,0,12,15,15
1668507951513,CSE 209B,A00,108005,Bellare; Mihir,0,7,0,0
1668507951945,CSE 210,A00,113163,Coblenz; Michael J,0,84,0,0
1668507952369,CSE 219,A00,106111,Dow; Steven P,0,6,20,20
1668507952799,CSE 221,A00,102376,Voelker; Geoffrey M.,0,72,0,0
1668507953222,CSE 224,A01,102378,Porter; George M,0,166,0,0
1668507953646,CSE 229A,A00,102379,Savage; Stefan,0,10,0,0
1668507954082,CSE 229C,A00,102380,Munyaka; Imani N. S.,0,10,0,0
1668507954509,CSE 232B,A00,102382,Deutsch; Alin Bernard,0,32,0,0
1668507954934,CSE 234,A01,112904,Kumar; Arun Kumar,0,0,0,0
1668507955359,CSE 237A,A00,102383,Rosing; Tajana Simunic,0,55,0,0
1668507955782,CSE 239A,A00,102384,Deutsch; Alin Bernard,0,14,0,0
1668507956205,CSE 239B,A00,102385,Polikarpova; Nadezhda,0,10,0,0
1668507956628,CSE 240A,A00,102386,Pannuto; Patrick William,0,46,0,0
1668507957053,CSE 240B,A00,102387,Zhao; Jishen,0,47,0,0
1668507957477,CSE 241A,A00,106406,Kang; Mingu,0,9,0,0
1668507957903,CSE 249B,A00,102388,Kahng; Andrew Byun,0,5,8,8
1668507958326,CSE 251B,A01,102392,Cottrell; Garrison W,0,51,0,0
1668507958326,CSE 251B,A02,102393,Cottrell; Garrison W,0,34,0,0
1668507958750,CSE 252B,A00,102394,Ochoa; Benjamin Lawrence,0,59,0,0
1668507959175,CSE 257,A01,102396,Gao; Sicun,0,138,0,0
1668507959600,CSE 272,A00,102397,Li; Tzumao,0,19,0,0
1668507960028,CSE 274,A00,111323,Chern; Albert Ren-Haur,0,15,0,0
1668507960451,CSE 282,A00,102398,Pevzner; Pavel Arkadjevich,0,0,0,0
1668507960874,CSE 284,A00,114175,Gymrek; Melissa Ann,0,22,0,0
1668507961298,CSE 290,A00,102399,Chandraker; Manmohan Krishna,0,11,0,0
1668507961298,CSE 290,B00,102400,Vaccaro; Kristen Marie,0,7,25,25
1668507961298,CSE 290,C00,102414,Pannuto; Patrick William,0,1,25,25
1668507961298,CSE 290,D00,102427,Pevzner; Pavel Arkadjevich,0,0,0,0
1668507961298,CSE 290,E00,102429,Zhao; Jishen,0,4,0,0
1668507961298,CSE 290,F00,102436,Tullsen; Dean Michael,0,5,0,0
1668507961298,CSE 290,G00,102440,Christensen; Henrik I,0,6,20,20
1668507961723,CSE 291,A00,102443,Su; Hao,0,0,0,0
1668507961723,CSE 291,B00,102448,Polikarpova; Nadezhda,0,0,0,0
1668507961723,CSE 291,C00,102453,Vaccaro; Kristen Marie,0,0,0,0
1668507961723,CSE 291,D00,111343,Savage; Stefan,0,0,0,0
1668507961723,CSE 291,E00,116474,Claffy; Kimberly Claire,0,0,0,0
1668507961723,CSE 291,F00,116479,Pasquale; Joseph,0,0,0,0
1668507962155,CSE 293,001,119111,Bafna; Vineet,9999,0,9999,0
1668507962155,CSE 293,002,119118,Bellare; Mihir,9999,0,9999,0
1668507962155,CSE 293,003,119122,Berg-Kirkpatrick; Taylor D,9999,0,9999,0
1668507962155,CSE 293,004,119135,Christensen; Henrik I,9999,0,9999,0
1668507962155,CSE 293,005,119142,Cottrell; Garrison W,9999,0,9999,0
1668507962155,CSE 293,006,119146,Deutsch; Alin Bernard,9999,0,9999,0
1668507962155,CSE 293,007,119159,Esmaeilzadeh; Hadi,9999,0,9999,0
1668507962155,CSE 293,008,119166,Freund; Yoav,9999,0,9999,0
1668507962155,CSE 293,009,119170,Griswold; William G.,9999,0,9999,0
1668507962155,CSE 293,010,119183,Gymrek; Melissa Ann,9999,0,9999,0
1668507962155,CSE 293,011,119190,Heninger; Nadia A,9999,0,9999,0
1668507962155,CSE 293,012,119230,Impagliazzo; Russell,9999,0,9999,0
1668507962155,CSE 293,013,119232,Jhala; Ranjit,9999,0,9999,0
1668507962155,CSE 293,014,119233,Kahng; Andrew Byun,9999,0,9999,0
1668507962155,CSE 293,015,119298,Kane; Daniel Mertz,9999,0,9999,0
1668507962155,CSE 293,016,119299,Kriegman; David J,9999,0,9999,0
1668507962155,CSE 293,017,119300,Kumar; Arun Kumar,9999,0,9999,0
1668507962155,CSE 293,018,119301,Lerner; Sorin,9999,0,9999,0
1668507962155,CSE 293,019,119302,Lovett; Shachar,9999,0,9999,0
1668507962155,CSE 293,020,119303,McAuley; Julian John,9999,0,9999,0
1668507962155,CSE 293,021,119304,Micciancio; Daniele,9999,0,9999,0
1668507962155,CSE 293,022,119367,Orailoglu; Alex,9999,0,9999,0
1668507962155,CSE 293,023,119382,Paturi; Ramamohan,9999,0,9999,0
1668507962155,CSE 293,024,119404,Polikarpova; Nadezhda,9999,0,9999,0
1668507962155,CSE 293,025,119406,Politz; Joseph Gibbs,9999,0,9999,0
1668507962155,CSE 293,026,119411,Porter; George M,9999,0,9999,0
1668507962155,CSE 293,027,119414,Porter; Leonard Emerson,9999,0,9999,0
1668507962155,CSE 293,028,119416,Ramamoorthi; Ravi,9999,0,9999,0
1668507962155,CSE 293,029,119417,Sahoo; Debashis,9999,0,9999,0
1668507962155,CSE 293,030,119420,Saul; Lawrence,9999,0,9999,0
1668507962155,CSE 293,031,119421,Savage; Stefan,9999,0,9999,0
1668507962155,CSE 293,032,119425,Schulze; Jurgen P.,9999,0,9999,0
1668507962155,CSE 293,033,119426,Snoeren; Alex C.,9999,0,9999,0
1668507962155,CSE 293,034,119428,Shang; Jingbo,9999,0,9999,0
1668507962155,CSE 293,035,119430,Stefan; Deian,9999,0,9999,0
1668507962155,CSE 293,036,119431,Su; Hao,9999,0,9999,0
1668507962155,CSE 293,037,119433,Swanson; Steven James,9999,0,9999,0
1668507962155,CSE 293,038,119435,Tullsen; Dean Michael,9999,0,9999,0
1668507962155,CSE 293,039,119483,Voelker; Geoffrey M.,9999,0,9999,0
1668507962155,CSE 293,040,119537,Zhao; Jishen,9999,0,9999,0
1668507962155,CSE 293,041,119538,Zhou; Yuan-Yuan,9999,0,9999,0
1668507962155,CSE 293,042,119539,Gao; Sicun,9999,0,9999,0
1668507962155,CSE 293,043,119540,Weibel; Nadir,9999,0,9999,0
1668507962155,CSE 293,044,119541,Gupta; Rajesh K.,9999,0,9999,0
1668507962155,CSE 293,045,126410,Vaccaro; Kristen Marie,9999,0,9999,0
1668507962155,CSE 293,046,126411,Klemke; Richard,9999,0,9999,0
1668507962579,CSE 294,A00,102459,Voelker; Geoffrey M.,0,2,0,0
1668507962579,CSE 294,B00,111322,Orailoglu; Alex,0,2,0,0
1668507963004,DSE 201,A00,096914,Deutsch; Alin Bernard,30,0,30,0
1668507963435,DSE 210,A00,096915,Dasgupta; Sanjoy,30,0,30,0
1668507963860,DSE 260A,A00,096916,Altintas De Callaf; Ilkay,30,0,30,0
1668507964298,ECE 200,001,103586,Antipa; Nicholas A,9999,0,9999,0
1668507964298,ECE 200,002,103587,Atanasov; Nikolay A.,9999,0,9999,0
1668507964298,ECE 200,003,103588,Bharadia; Dinesh,9999,0,9999,0
1668507964298,ECE 200,004,103589,Cheng; Chung Kuan,9999,0,9999,0
1668507964298,ECE 200,005,103590,Cosman; Pamela C.,9999,0,9999,0
1668507964298,ECE 200,006,103591,Dayeh; Shadi Ahmad,9999,0,9999,0
1668507964298,ECE 200,007,103592,Fainman; Yeshaiahu,9999,0,9999,0
1668507964298,ECE 200,008,103593,Ford; Joseph Earl,9999,0,9999,0
1668507964298,ECE 200,009,103594,Franceschetti; Massimo,9999,0,9999,0
1668507964298,ECE 200,010,103595,Fullerton; Eric E,9999,0,9999,0
1668507964298,ECE 200,011,103596,Galton; Ian A,9999,0,9999,0
1668507964298,ECE 200,012,103597,Gilja; Vikash,9999,0,9999,0
1668507964298,ECE 200,013,103598,Hall; Drew A.,9999,0,9999,0
1668507964298,ECE 200,014,103599,Hsueh; Tzu-Chien,9999,0,9999,0
1668507964298,ECE 200,015,103600,Javidi; Tara,9999,0,9999,0
1668507964298,ECE 200,016,103601,Kahng; Andrew Byun,9999,0,9999,0
1668507964298,ECE 200,017,103602,Kim; Young-Han,9999,0,9999,0
1668507964298,ECE 200,018,103603,Koushanfar; Farinaz,9999,0,9999,0
1668507964298,ECE 200,019,103604,Kuzum; Duygu,9999,0,9999,0
1668507964298,ECE 200,020,103605,Le; Hanh-Phuc,9999,0,9999,0
1668507964298,ECE 200,021,103606,Lin; Bill,9999,0,9999,0
1668507964298,ECE 200,022,103607,Liu; Zhaowei,9998,0,9999,1
1668507964298,ECE 200,023,103608,Lo; Yu-Hwa,9999,0,9999,0
1668507964298,ECE 200,024,103609,Lomakin; Vitaliy,9999,0,9999,0
1668507964298,ECE 200,025,103610,Mercier; Patrick Philip,9999,0,9999,0
1668507964298,ECE 200,026,103611,Meyer; Florian,9999,0,9999,0
1668507964298,ECE 200,027,103612,Milstein; Laurence B.,9999,0,9999,0
1668507964298,ECE 200,028,103613,Mir Arabbaygi; Siavash,9999,0,9999,0
1668507964298,ECE 200,029,103614,Mookherjea; Shayan,9999,0,9999,0
1668507964298,ECE 200,030,103615,Morris; Karcher William,9999,0,9999,0
1668507964298,ECE 200,031,103616,Ng; Tse Nga,9999,0,9999,0
1668507964298,ECE 200,032,103617,Nguyen; Truong Quang,9999,0,9999,0
1668507964298,ECE 200,033,103618,Nomura; Kenji,9999,0,9999,0
1668507964298,ECE 200,034,103619,Orlitsky; Alon,9999,0,9999,0
1668507964298,ECE 200,035,103620,Pal; Piya,9999,0,9999,0
1668507964298,ECE 200,036,103621,Papen; George C.,9999,0,9999,0
1668507964298,ECE 200,037,103622,Radic; Stojan,9999,0,9999,0
1668507964298,ECE 200,038,103623,Rao; Bhaskar D.,9999,0,9999,0
1668507964298,ECE 200,039,103624,Rao; Ramesh R,9999,0,9999,0
1668507964298,ECE 200,040,103625,Rebeiz; Gabriel,9999,0,9999,0
1668507964298,ECE 200,041,103626,Sanford; John R,9999,0,9999,0
1668507964298,ECE 200,042,103627,Siegel; Paul H.,9999,0,9999,0
1668507964298,ECE 200,043,103628,Sievenpiper; Daniel F.,9999,0,9999,0
1668507964298,ECE 200,044,103629,Sworder; David D.,9999,0,9999,0
1668507964298,ECE 200,045,103630,Taur; Yuan,9999,0,9999,0
1668507964298,ECE 200,046,103631,Touri; Behrouz,9999,0,9999,0
1668507964298,ECE 200,047,103632,Trivedi; Mohan M.,9999,0,9999,0
1668507964298,ECE 200,048,103633,Vasconcelos; Nuno,9999,0,9999,0
1668507964298,ECE 200,049,103634,Wang; Xiaolong,9999,0,9999,0
1668507964298,ECE 200,050,103635,Xie; Pengtao,9999,0,9999,0
1668507964298,ECE 200,051,103636,Yip; Michael,9999,0,9999,0
1668507964298,ECE 200,052,103637,Zeger; Kenneth A.,999,0,999,0
1668507964298,ECE 200,053,103638,Zhang; Xinyu,9999,0,9999,0
1668507964298,ECE 200,054,103639,Turakhia; Yatish Girish,9999,0,9999,0
1668507964298,ECE 200,055,103640,Kang; Mingu,9999,0,9999,0
1668507964298,ECE 200,056,103641,Shi; Yuanyuan,9999,0,9999,0
1668507964298,ECE 200,057,103642,Wang; Edward Jay,9999,0,9999,0
1668507964298,ECE 200,058,103643,Zheng; Yang,9999,0,9999,0
1668507964723,ECE 202,A00,103644,Kuzum; Duygu,0,44,0,0
1668507965146,ECE 212BN,A00,103646,Ng; Tse Nga,0,9,0,0
1668507965569,ECE 221,A00,111493,Staff,0,0,0,0
1668507965992,ECE 222B,A00,103647,Lomakin; Vitaliy,0,20,0,0
1668507966418,ECE 230B,A00,103648,Taur; Yuan,0,3,0,0
1668507966846,ECE 238B,A00,103649,Garay; Javier,0,0,0,0
1668507967276,ECE 240B,A00,112900,Fainman; Yeshaiahu,0,7,0,0
1668507967709,ECE 247A,A00,103650,Jokerst; Jesse Vincent,0,6,0,0
1668507968133,ECE 247B,A00,103651,Wang; Joseph,0,14,0,0
1668507968557,ECE 250,A00,103652,Siegel; Paul H.,0,82,0,0
1668507968981,ECE 251A,A00,103654,Rao; Bhaskar D.,0,61,0,0
1668507969408,ECE 257B,A00,103655,Bharadia; Dinesh,0,32,0,0
1668507969929,ECE 258A,A00,103656,Milstein; Laurence B.,0,29,0,0
1668507970356,ECE 260B,A00,103658,Kang; Mingu,0,119,0,0
1668507970779,ECE 264A,A00,103659,Galton; Ian A,0,65,0,0
1668507971202,ECE 265A,A00,103661,Gudem; Prasad S.S.,0,70,0,0
1668507971630,ECE 265D,A00,103662,Gudem; Prasad S.S.,0,26,0,0
1668507972055,ECE 268,A00,103663,Koushanfar; Farinaz,0,43,0,0
1668507972492,ECE 269,A01,103665,Pal; Piya,0,215,0,0
1668507972916,ECE 271B,A00,103666,Vasconcelos; Manuela,0,76,0,0
1668507973340,ECE 276A,A00,103667,Atanasov; Nikolay A.,0,126,0,0
1668507973763,ECE 277,A00,103668,An; Cheolhong,0,149,0,0
1668507974188,ECE 279,A00,117947,Hall; Drew A.,0,22,0,0
1668507975038,ECE 283,A00,103670,Hsueh; Tzu-Chien,0,53,0,0
1668507975467,ECE 284,A00,103671,Turakhia; Yatish Girish,0,39,0,0
1668507975891,ECE 285,A00,103672,Zheng; Yang,0,39,0,0
1668507975891,ECE 285,B00,103673,Sworder; David D.,0,57,0,0
1668507976314,ECE 287,A00,103676,Javidi; Tara,0,9,0,0
1668507976737,MATH 200B,A00,098023,Salehi Golsefidy; Alireza,10,0,15,5
1668507977164,MATH 202B,A00,098024,Rhoades; Brendon Patrick,7,0,15,8
1668507977588,MATH 203B,A00,098025,Oprea; Dragos N.,9,0,15,6
1668507978012,MATH 204B,A00,098026,Sorensen; Claus M,13,0,15,2
1668507978439,MATH 208,A00,098027,Izadi; Elham,7,0,10,3
1668507978864,MATH 209,A00,098028,Pollack; Aaron,10,0,10,0
1668507979287,MATH 211A,A00,112919,Rogalski; Daniel,8,0,10,2
1668507979710,MATH 211B,A00,112920,Seward; Brandon M.,9,0,10,1
1668507980136,MATH 218,A00,098029,Li; Bo,10,0,10,0
1668507980564,MATH 220B,A00,098030,Novak; Jonathan I,11,0,15,4
1668507980988,MATH 221A,A00,098031,Ebenfelt; Peter F,12,0,15,3
1668507981414,MATH 231B,A00,098032,Zlatos; Andrej,11,0,15,4
1668507981843,MATH 240B,A00,098033,Ni; Lei,7,0,15,8
1668507982268,MATH 243,A00,098034,Jekel; David Andrew,10,0,10,0
1668507982692,MATH 245A,A00,098035,Nie; Jiawang,0,4,15,18
1668507983118,MATH 248,A00,098036,Bejenaru; Ioan,10,0,10,0
1668507983545,MATH 250B,A00,098037,Spolaor; Luca,14,0,15,1
1668507983971,MATH 258,A00,098038,Ni; Lei,9,0,10,1
1668507984395,MATH 264B,A00,098041,Rhoades; Brendon Patrick,8,0,15,7
1668507984819,MATH 268,A00,098042,Buss; Samuel R,10,0,10,0
1668507985243,MATH 269,A00,098043,Rhoades; Brendon Patrick,10,0,10,0
1668507985670,MATH 270B,A00,098044,Li; Bo,6,0,15,9
1668507986096,MATH 272B,A00,098045,Holst; Michael J,13,0,15,2
1668507986523,MATH 273A,A00,098046,Tian; Xiaochuan,10,0,15,5
1668507986950,MATH 275,A01,098048,Tian; Xiaochuan,6,0,10,4
1668507987374,MATH 278A,A00,098049,Holst; Michael J,7,0,10,3
1668507987799,MATH 278B,A00,098050,Cloninger; Alexander,10,0,10,0
1668507988223,MATH 278C,A00,098051,Nie; Jiawang,5,0,10,5
1668507988646,MATH 280B,A00,098052,Zheng; Tianyi,7,0,15,8
1668507989070,MATH 281B,A00,098053,Bradic; Jelena,0,2,15,15
1668507989493,MATH 282B,A00,098054,Arias-Castro; Ery,0,1,15,15
1668507989918,MATH 285,A00,098055,Fitzsimmons; Patrick J,0,3,15,17
1668507990346,MATH 287B,A00,098056,Arias-Castro; Ery,1,0,15,14
1668507990769,MATH 288,A00,098057,Agarwal; Pooja,9,0,10,1
1668507990769,MATH 288,B00,098058,Zhang; Danna,8,0,10,2
1668507990769,MATH 288,C00,098059,Williams; Ruth J,9,0,10,1
1668507991193,MATH 290B,A00,098060,Roberts; Justin Deritter,12,0,15,3
1668507991616,MATH 292,A00,098061,Belmont; Eva Kinoshita,10,0,10,0
1668507992039,MATH 295,A00,098062,Suk; Andrew Hoon,47,0,50,3
1668507992463,MATH 296,A00,098063,Novak; Jonathan I,20,0,20,0
1668507992889,MATH 297,001,098064,Gamst; Anthony Collins,9997,0,9999,2
1668508494167,COGS 205,A00,101395,Chiba; Andrea,19,0,20,1
1668508494593,COGS 210B,001,101404,Greene; Deanna Jacquelyn,9998,0,9999,1
1668508494593,COGS 210B,002,101417,Xia; Haijun,9999,0,9999,0
1668508494593,COGS 210B,003,101422,Nitz; Douglas A.,9999,0,9999,0
1668508494593,COGS 210B,004,101423,Hollan; James D.,9998,0,9999,1
1668508494593,COGS 210B,005,101424,Deak; Gedeon O.,9998,0,9999,1
1668508494593,COGS 210B,006,101425,Rossano; Federico,9999,0,9999,0
1668508495023,COGS 211B,A00,101427,Coulson; Seana M,9996,0,9999,3
1668508495452,COGS 220,A00,101428,Hollan; James D.,0,10,25,25
1668508495881,COGS 229,A00,101429,Dow; Steven P,17,0,25,8
1668508496312,COGS 230,A00,101430,Klemmer; Scott R,7,0,17,10
1668508496735,COGS 234,A00,101431,Xia; Haijun,1,0,25,24
1668508497161,COGS 260,A00,101432,Kiyonaga; Anastasia,21,0,25,4
1668508497161,COGS 260,B00,101433,Kirsh; David Joel,15,0,25,10
1668508497587,CSE 202,A00,102371,Impagliazzo; Russell,0,65,0,0
1668508498027,CSE 203B,A01,102373,Cheng; Chung Kuan,0,58,0,0
1668508498453,CSE 208,A00,102374,Micciancio; Daniele,0,5,0,0
1668508498881,CSE 209A,A00,112895,Impagliazzo; Russell,0,12,15,15
1668508499310,CSE 209B,A00,108005,Bellare; Mihir,0,7,0,0
1668508499734,CSE 210,A00,113163,Coblenz; Michael J,0,84,0,0
1668508500161,CSE 219,A00,106111,Dow; Steven P,0,6,20,20
1668508500592,CSE 221,A00,102376,Voelker; Geoffrey M.,0,72,0,0
1668508501020,CSE 224,A01,102378,Porter; George M,0,166,0,0
1668508501447,CSE 229A,A00,102379,Savage; Stefan,0,10,0,0
1668508501871,CSE 229C,A00,102380,Munyaka; Imani N. S.,0,10,0,0
1668508502296,CSE 232B,A00,102382,Deutsch; Alin Bernard,0,32,0,0
1668508502730,CSE 234,A01,112904,Kumar; Arun Kumar,0,0,0,0
1668508503177,CSE 237A,A00,102383,Rosing; Tajana Simunic,0,55,0,0
1668508503601,CSE 239A,A00,102384,Deutsch; Alin Bernard,0,14,0,0
1668508504029,CSE 239B,A00,102385,Polikarpova; Nadezhda,0,10,0,0
1668508504454,CSE 240A,A00,102386,Pannuto; Patrick William,0,46,0,0
1668508504885,CSE 240B,A00,102387,Zhao; Jishen,0,47,0,0
1668508505316,CSE 241A,A00,106406,Kang; Mingu,0,9,0,0
1668508505739,CSE 249B,A00,102388,Kahng; Andrew Byun,0,5,8,8
1668508506170,CSE 251B,A01,102392,Cottrell; Garrison W,0,51,0,0
1668508506170,CSE 251B,A02,102393,Cottrell; Garrison W,0,34,0,0
1668508506598,CSE 252B,A00,102394,Ochoa; Benjamin Lawrence,0,59,0,0
1668508507029,CSE 257,A01,102396,Gao; Sicun,0,138,0,0
1668508507460,CSE 272,A00,102397,Li; Tzumao,0,19,0,0
1668508507886,CSE 274,A00,111323,Chern; Albert Ren-Haur,0,15,0,0
1668508508311,CSE 282,A00,102398,Pevzner; Pavel Arkadjevich,0,0,0,0
1668508508741,CSE 284,A00,114175,Gymrek; Melissa Ann,0,22,0,0
1668508509181,CSE 290,A00,102399,Chandraker; Manmohan Krishna,0,11,0,0
1668508509181,CSE 290,B00,102400,Vaccaro; Kristen Marie,0,7,25,25
1668508509181,CSE 290,C00,102414,Pannuto; Patrick William,0,1,25,25
1668508509181,CSE 290,D00,102427,Pevzner; Pavel Arkadjevich,0,0,0,0
1668508509181,CSE 290,E00,102429,Zhao; Jishen,0,4,0,0
1668508509181,CSE 290,F00,102436,Tullsen; Dean Michael,0,5,0,0
1668508509181,CSE 290,G00,102440,Christensen; Henrik I,0,6,20,20
1668508509615,CSE 291,A00,102443,Su; Hao,0,0,0,0
1668508509615,CSE 291,B00,102448,Polikarpova; Nadezhda,0,0,0,0
1668508509615,CSE 291,C00,102453,Vaccaro; Kristen Marie,0,0,0,0
1668508509615,CSE 291,D00,111343,Savage; Stefan,0,0,0,0
1668508509615,CSE 291,E00,116474,Claffy; Kimberly Claire,0,0,0,0
1668508509615,CSE 291,F00,116479,Pasquale; Joseph,0,0,0,0
1668508510107,CSE 293,001,119111,Bafna; Vineet,9999,0,9999,0
1668508510107,CSE 293,002,119118,Bellare; Mihir,9999,0,9999,0
1668508510107,CSE 293,003,119122,Berg-Kirkpatrick; Taylor D,9999,0,9999,0
1668508510107,CSE 293,004,119135,Christensen; Henrik I,9999,0,9999,0
1668508510107,CSE 293,005,119142,Cottrell; Garrison W,9999,0,9999,0
1668508510107,CSE 293,006,119146,Deutsch; Alin Bernard,9999,0,9999,0
1668508510107,CSE 293,007,119159,Esmaeilzadeh; Hadi,9999,0,9999,0
1668508510107,CSE 293,008,119166,Freund; Yoav,9999,0,9999,0
1668508510107,CSE 293,009,119170,Griswold; William G.,9999,0,9999,0
1668508510107,CSE 293,010,119183,Gymrek; Melissa Ann,9999,0,9999,0
1668508510107,CSE 293,011,119190,Heninger; Nadia A,9999,0,9999,0
1668508510107,CSE 293,012,119230,Impagliazzo; Russell,9999,0,9999,0
1668508510107,CSE 293,013,119232,Jhala; Ranjit,9999,0,9999,0
1668508510107,CSE 293,014,119233,Kahng; Andrew Byun,9999,0,9999,0
1668508510107,CSE 293,015,119298,Kane; Daniel Mertz,9999,0,9999,0
1668508510107,CSE 293,016,119299,Kriegman; David J,9999,0,9999,0
1668508510107,CSE 293,017,119300,Kumar; Arun Kumar,9999,0,9999,0
1668508510107,CSE 293,018,119301,Lerner; Sorin,9999,0,9999,0
1668508510107,CSE 293,019,119302,Lovett; Shachar,9999,0,9999,0
1668508510107,CSE 293,020,119303,McAuley; Julian John,9999,0,9999,0
1668508510107,CSE 293,021,119304,Micciancio; Daniele,9999,0,9999,0
1668508510107,CSE 293,022,119367,Orailoglu; Alex,9999,0,9999,0
1668508510107,CSE 293,023,119382,Paturi; Ramamohan,9999,0,9999,0
1668508510107,CSE 293,024,119404,Polikarpova; Nadezhda,9999,0,9999,0
1668508510107,CSE 293,025,119406,Politz; Joseph Gibbs,9999,0,9999,0
1668508510107,CSE 293,026,119411,Porter; George M,9999,0,9999,0
1668508510107,CSE 293,027,119414,Porter; Leonard Emerson,9999,0,9999,0
1668508510107,CSE 293,028,119416,Ramamoorthi; Ravi,9999,0,9999,0
1668508510107,CSE 293,029,119417,Sahoo; Debashis,9999,0,9999,0
1668508510107,CSE 293,030,119420,Saul; Lawrence,9999,0,9999,0
1668508510107,CSE 293,031,119421,Savage; Stefan,9999,0,9999,0
1668508510107,CSE 293,032,119425,Schulze; Jurgen P.,9999,0,9999,0
1668508510107,CSE 293,033,119426,Snoeren; Alex C.,9999,0,9999,0
1668508510107,CSE 293,034,119428,Shang; Jingbo,9999,0,9999,0
1668508510107,CSE 293,035,119430,Stefan; Deian,9999,0,9999,0
1668508510107,CSE 293,036,119431,Su; Hao,9999,0,9999,0
1668508510107,CSE 293,037,119433,Swanson; Steven James,9999,0,9999,0
1668508510107,CSE 293,038,119435,Tullsen; Dean Michael,9999,0,9999,0
1668508510107,CSE 293,039,119483,Voelker; Geoffrey M.,9999,0,9999,0
1668508510107,CSE 293,040,119537,Zhao; Jishen,9999,0,9999,0
1668508510107,CSE 293,041,119538,Zhou; Yuan-Yuan,9999,0,9999,0
1668508510107,CSE 293,042,119539,Gao; Sicun,9999,0,9999,0
1668508510107,CSE 293,043,119540,Weibel; Nadir,9999,0,9999,0
1668508510107,CSE 293,044,119541,Gupta; Rajesh K.,9999,0,9999,0
1668508510107,CSE 293,045,126410,Vaccaro; Kristen Marie,9999,0,9999,0
1668508510107,CSE 293,046,126411,Klemke; Richard,9999,0,9999,0
1668508510533,CSE 294,A00,102459,Voelker; Geoffrey M.,0,2,0,0
1668508510533,CSE 294,B00,111322,Orailoglu; Alex,0,2,0,0
1668508510957,DSE 201,A00,096914,Deutsch; Alin Bernard,30,0,30,0
1668508511385,DSE 210,A00,096915,Dasgupta; Sanjoy,30,0,30,0
1668508511813,DSE 260A,A00,096916,Altintas De Callaf; Ilkay,30,0,30,0
1668508512289,ECE 200,001,103586,Antipa; Nicholas A,9999,0,9999,0
1668508512289,ECE 200,002,103587,Atanasov; Nikolay A.,9999,0,9999,0
1668508512289,ECE 200,003,103588,Bharadia; Dinesh,9999,0,9999,0
1668508512289,ECE 200,004,103589,Cheng; Chung Kuan,9999,0,9999,0
1668508512289,ECE 200,005,103590,Cosman; Pamela C.,9999,0,9999,0
1668508512289,ECE 200,006,103591,Dayeh; Shadi Ahmad,9999,0,9999,0
1668508512289,ECE 200,007,103592,Fainman; Yeshaiahu,9999,0,9999,0
1668508512289,ECE 200,008,103593,Ford; Joseph Earl,9999,0,9999,0
1668508512289,ECE 200,009,103594,Franceschetti; Massimo,9999,0,9999,0
1668508512289,ECE 200,010,103595,Fullerton; Eric E,9999,0,9999,0
1668508512289,ECE 200,011,103596,Galton; Ian A,9999,0,9999,0
1668508512289,ECE 200,012,103597,Gilja; Vikash,9999,0,9999,0
1668508512289,ECE 200,013,103598,Hall; Drew A.,9999,0,9999,0
1668508512289,ECE 200,014,103599,Hsueh; Tzu-Chien,9999,0,9999,0
1668508512289,ECE 200,015,103600,Javidi; Tara,9999,0,9999,0
1668508512289,ECE 200,016,103601,Kahng; Andrew Byun,9999,0,9999,0
1668508512289,ECE 200,017,103602,Kim; Young-Han,9999,0,9999,0
1668508512289,ECE 200,018,103603,Koushanfar; Farinaz,9999,0,9999,0
1668508512289,ECE 200,019,103604,Kuzum; Duygu,9999,0,9999,0
1668508512289,ECE 200,020,103605,Le; Hanh-Phuc,9999,0,9999,0
1668508512289,ECE 200,021,103606,Lin; Bill,9999,0,9999,0
1668508512289,ECE 200,022,103607,Liu; Zhaowei,9998,0,9999,1
1668508512289,ECE 200,023,103608,Lo; Yu-Hwa,9999,0,9999,0
1668508512289,ECE 200,024,103609,Lomakin; Vitaliy,9999,0,9999,0
1668508512289,ECE 200,025,103610,Mercier; Patrick Philip,9999,0,9999,0
1668508512289,ECE 200,026,103611,Meyer; Florian,9999,0,9999,0
1668508512289,ECE 200,027,103612,Milstein; Laurence B.,9999,0,9999,0
1668508512289,ECE 200,028,103613,Mir Arabbaygi; Siavash,9999,0,9999,0
1668508512289,ECE 200,029,103614,Mookherjea; Shayan,9999,0,9999,0
1668508512289,ECE 200,030,103615,Morris; Karcher William,9999,0,9999,0
1668508512289,ECE 200,031,103616,Ng; Tse Nga,9999,0,9999,0
1668508512289,ECE 200,032,103617,Nguyen; Truong Quang,9999,0,9999,0
1668508512289,ECE 200,033,103618,Nomura; Kenji,9999,0,9999,0
1668508512289,ECE 200,034,103619,Orlitsky; Alon,9999,0,9999,0
1668508512289,ECE 200,035,103620,Pal; Piya,9999,0,9999,0
1668508512289,ECE 200,036,103621,Papen; George C.,9999,0,9999,0
1668508512289,ECE 200,037,103622,Radic; Stojan,9999,0,9999,0
1668508512289,ECE 200,038,103623,Rao; Bhaskar D.,9999,0,9999,0
1668508512289,ECE 200,039,103624,Rao; Ramesh R,9999,0,9999,0
1668508512289,ECE 200,040,103625,Rebeiz; Gabriel,9999,0,9999,0
1668508512289,ECE 200,041,103626,Sanford; John R,9999,0,9999,0
1668508512289,ECE 200,042,103627,Siegel; Paul H.,9999,0,9999,0
1668508512289,ECE 200,043,103628,Sievenpiper; Daniel F.,9999,0,9999,0
1668508512289,ECE 200,044,103629,Sworder; David D.,9999,0,9999,0
1668508512289,ECE 200,045,103630,Taur; Yuan,9999,0,9999,0
1668508512289,ECE 200,046,103631,Touri; Behrouz,9999,0,9999,0
1668508512289,ECE 200,047,103632,Trivedi; Mohan M.,9999,0,9999,0
1668508512289,ECE 200,048,103633,Vasconcelos; Nuno,9999,0,9999,0
1668508512289,ECE 200,049,103634,Wang; Xiaolong,9999,0,9999,0
1668508512289,ECE 200,050,103635,Xie; Pengtao,9999,0,9999,0
1668508512289,ECE 200,051,103636,Yip; Michael,9999,0,9999,0
1668508512289,ECE 200,052,103637,Zeger; Kenneth A.,999,0,999,0
1668508512289,ECE 200,053,103638,Zhang; Xinyu,9999,0,9999,0
1668508512289,ECE 200,054,103639,Turakhia; Yatish Girish,9999,0,9999,0
1668508512289,ECE 200,055,103640,Kang; Mingu,9999,0,9999,0
1668508512289,ECE 200,056,103641,Shi; Yuanyuan,9999,0,9999,0
1668508512289,ECE 200,057,103642,Wang; Edward Jay,9999,0,9999,0
1668508512289,ECE 200,058,103643,Zheng; Yang,9999,0,9999,0
1668508512717,ECE 202,A00,103644,Kuzum; Duygu,0,44,0,0
1668508513141,ECE 212BN,A00,103646,Ng; Tse Nga,0,9,0,0
1668508513565,ECE 221,A00,111493,Staff,0,0,0,0
1668508513990,ECE 222B,A00,103647,Lomakin; Vitaliy,0,20,0,0
1668508514417,ECE 230B,A00,103648,Taur; Yuan,0,3,0,0
1668508514841,ECE 238B,A00,103649,Garay; Javier,0,0,0,0
1668508515264,ECE 240B,A00,112900,Fainman; Yeshaiahu,0,7,0,0
1668508515689,ECE 247A,A00,103650,Jokerst; Jesse Vincent,0,6,0,0
1668508516117,ECE 247B,A00,103651,Wang; Joseph,0,14,0,0
1668508516543,ECE 250,A00,103652,Siegel; Paul H.,0,82,0,0
1668508516967,ECE 251A,A00,103654,Rao; Bhaskar D.,0,61,0,0
1668508517400,ECE 257B,A00,103655,Bharadia; Dinesh,0,32,0,0
1668508517829,ECE 258A,A00,103656,Milstein; Laurence B.,0,29,0,0
1668508518259,ECE 260B,A00,103658,Kang; Mingu,0,119,0,0
1668508518686,ECE 264A,A00,103659,Galton; Ian A,0,65,0,0
1668508519110,ECE 265A,A00,103661,Gudem; Prasad S.S.,0,70,0,0
1668508519533,ECE 265D,A00,103662,Gudem; Prasad S.S.,0,26,0,0
1668508519958,ECE 268,A00,103663,Koushanfar; Farinaz,0,43,0,0
1668508520395,ECE 269,A01,103665,Pal; Piya,0,215,0,0
1668508520823,ECE 271B,A00,103666,Vasconcelos; Manuela,0,76,0,0
1668508521247,ECE 276A,A00,103667,Atanasov; Nikolay A.,0,126,0,0
1668508521678,ECE 277,A00,103668,An; Cheolhong,0,149,0,0
1668508522104,ECE 279,A00,117947,Hall; Drew A.,0,22,0,0
1668508522952,ECE 283,A00,103670,Hsueh; Tzu-Chien,0,53,0,0
1668508523376,ECE 284,A00,103671,Turakhia; Yatish Girish,0,39,0,0
1668508523801,ECE 285,A00,103672,Zheng; Yang,0,39,0,0
1668508523801,ECE 285,B00,103673,Sworder; David D.,0,57,0,0
1668508524225,ECE 287,A00,103676,Javidi; Tara,0,9,0,0
1668508524650,MATH 200B,A00,098023,Salehi Golsefidy; Alireza,10,0,15,5
1668508525078,MATH 202B,A00,098024,Rhoades; Brendon Patrick,7,0,15,8
1668508525504,MATH 203B,A00,098025,Oprea; Dragos N.,9,0,15,6
1668508525929,MATH 204B,A00,098026,Sorensen; Claus M,13,0,15,2
1668508526352,MATH 208,A00,098027,Izadi; Elham,7,0,10,3
1668508526780,MATH 209,A00,098028,Pollack; Aaron,10,0,10,0
1668508527207,MATH 211A,A00,112919,Rogalski; Daniel,8,0,10,2
1668508527632,MATH 211B,A00,112920,Seward; Brandon M.,9,0,10,1
1668508528056,MATH 218,A00,098029,Li; Bo,10,0,10,0
1668508528483,MATH 220B,A00,098030,Novak; Jonathan I,11,0,15,4
1668508528911,MATH 221A,A00,098031,Ebenfelt; Peter F,12,0,15,3
1668508529339,MATH 231B,A00,098032,Zlatos; Andrej,11,0,15,4
1668508529764,MATH 240B,A00,098033,Ni; Lei,7,0,15,8
1668508530187,MATH 243,A00,098034,Jekel; David Andrew,10,0,10,0
1668508530613,MATH 245A,A00,098035,Nie; Jiawang,0,4,15,18
1668508531039,MATH 248,A00,098036,Bejenaru; Ioan,10,0,10,0
1668508531470,MATH 250B,A00,098037,Spolaor; Luca,14,0,15,1
1668508531898,MATH 258,A00,098038,Ni; Lei,9,0,10,1
1668508532333,MATH 264B,A00,098041,Rhoades; Brendon Patrick,8,0,15,7
1668508532761,MATH 268,A00,098042,Buss; Samuel R,10,0,10,0
1668508533264,MATH 269,A00,098043,Rhoades; Brendon Patrick,10,0,10,0
1668508533691,MATH 270B,A00,098044,Li; Bo,6,0,15,9
1668508534119,MATH 272B,A00,098045,Holst; Michael J,13,0,15,2
1668508534548,MATH 273A,A00,098046,Tian; Xiaochuan,10,0,15,5
1668508534973,MATH 275,A01,098048,Tian; Xiaochuan,6,0,10,4
1668508535397,MATH 278A,A00,098049,Holst; Michael J,7,0,10,3
1668508535820,MATH 278B,A00,098050,Cloninger; Alexander,10,0,10,0
1668508536254,MATH 278C,A00,098051,Nie; Jiawang,5,0,10,5
1668508536677,MATH 280B,A00,098052,Zheng; Tianyi,7,0,15,8
1668508537105,MATH 281B,A00,098053,Bradic; Jelena,0,2,15,15
1668508537529,MATH 282B,A00,098054,Arias-Castro; Ery,0,1,15,15
1668508537955,MATH 285,A00,098055,Fitzsimmons; Patrick J,0,3,15,17
1668508538381,MATH 287B,A00,098056,Arias-Castro; Ery,1,0,15,14
1668508538810,MATH 288,A00,098057,Agarwal; Pooja,9,0,10,1
1668508538810,MATH 288,B00,098058,Zhang; Danna,8,0,10,2
1668508538810,MATH 288,C00,098059,Williams; Ruth J,9,0,10,1
1668508539237,MATH 290B,A00,098060,Roberts; Justin Deritter,12,0,15,3
1668508539661,MATH 292,A00,098061,Belmont; Eva Kinoshita,10,0,10,0
1668508540089,MATH 295,A00,098062,Suk; Andrew Hoon,47,0,50,3
1668508540513,MATH 296,A00,098063,Novak; Jonathan I,20,0,20,0
1668508540939,MATH 297,001,098064,Gamst; Anthony Collins,9997,0,9999,2
1668509044643,COGS 205,A00,101395,Chiba; Andrea,19,0,20,1
1668509045072,COGS 210B,001,101404,Greene; Deanna Jacquelyn,9998,0,9999,1
1668509045072,COGS 210B,002,101417,Xia; Haijun,9999,0,9999,0
1668509045072,COGS 210B,003,101422,Nitz; Douglas A.,9999,0,9999,0
1668509045072,COGS 210B,004,101423,Hollan; James D.,9998,0,9999,1
1668509045072,COGS 210B,005,101424,Deak; Gedeon O.,9998,0,9999,1
1668509045072,COGS 210B,006,101425,Rossano; Federico,9999,0,9999,0
1668509045498,COGS 211B,A00,101427,Coulson; Seana M,9996,0,9999,3
1668509045922,COGS 220,A00,101428,Hollan; James D.,0,10,25,25
1668509046347,COGS 229,A00,101429,Dow; Steven P,17,0,25,8
1668509046772,COGS 230,A00,101430,Klemmer; Scott R,7,0,17,10
1668509047200,COGS 234,A00,101431,Xia; Haijun,1,0,25,24
1668509047630,COGS 260,A00,101432,Kiyonaga; Anastasia,21,0,25,4
1668509047630,COGS 260,B00,101433,Kirsh; David Joel,15,0,25,10
1668509048056,CSE 202,A00,102371,Impagliazzo; Russell,0,65,0,0
1668509048485,CSE 203B,A01,102373,Cheng; Chung Kuan,0,58,0,0
1668509048910,CSE 208,A00,102374,Micciancio; Daniele,0,5,0,0
1668509049343,CSE 209A,A00,112895,Impagliazzo; Russell,0,12,15,15
1668509049768,CSE 209B,A00,108005,Bellare; Mihir,0,7,0,0
1668509050193,CSE 210,A00,113163,Coblenz; Michael J,0,84,0,0
1668509050624,CSE 219,A00,106111,Dow; Steven P,0,6,20,20
1668509051054,CSE 221,A00,102376,Voelker; Geoffrey M.,0,72,0,0
1668509051478,CSE 224,A01,102378,Porter; George M,0,166,0,0
1668509051909,CSE 229A,A00,102379,Savage; Stefan,0,10,0,0
1668509052332,CSE 229C,A00,102380,Munyaka; Imani N. S.,0,10,0,0
1668509052760,CSE 232B,A00,102382,Deutsch; Alin Bernard,0,32,0,0
1668509053184,CSE 234,A01,112904,Kumar; Arun Kumar,0,0,0,0
1668509053613,CSE 237A,A00,102383,Rosing; Tajana Simunic,0,55,0,0
1668509054039,CSE 239A,A00,102384,Deutsch; Alin Bernard,0,14,0,0
1668509054464,CSE 239B,A00,102385,Polikarpova; Nadezhda,0,10,0,0
1668509054888,CSE 240A,A00,102386,Pannuto; Patrick William,0,46,0,0
1668509055314,CSE 240B,A00,102387,Zhao; Jishen,0,47,0,0
1668509055831,CSE 241A,A00,106406,Kang; Mingu,0,9,0,0
1668509056259,CSE 249B,A00,102388,Kahng; Andrew Byun,0,5,8,8
1668509056687,CSE 251B,A01,102392,Cottrell; Garrison W,0,51,0,0
1668509056687,CSE 251B,A02,102393,Cottrell; Garrison W,0,34,0,0
1668509057112,CSE 252B,A00,102394,Ochoa; Benjamin Lawrence,0,59,0,0
1668509057555,CSE 257,A01,102396,Gao; Sicun,0,138,0,0
1668509057980,CSE 272,A00,102397,Li; Tzumao,0,19,0,0
1668509058416,CSE 274,A00,111323,Chern; Albert Ren-Haur,0,15,0,0
1668509058845,CSE 282,A00,102398,Pevzner; Pavel Arkadjevich,0,0,0,0
1668509059273,CSE 284,A00,114175,Gymrek; Melissa Ann,0,22,0,0
1668509059700,CSE 290,A00,102399,Chandraker; Manmohan Krishna,0,11,0,0
1668509059700,CSE 290,B00,102400,Vaccaro; Kristen Marie,0,7,25,25
1668509059700,CSE 290,C00,102414,Pannuto; Patrick William,0,1,25,25
1668509059700,CSE 290,D00,102427,Pevzner; Pavel Arkadjevich,0,0,0,0
1668509059700,CSE 290,E00,102429,Zhao; Jishen,0,4,0,0
1668509059700,CSE 290,F00,102436,Tullsen; Dean Michael,0,5,0,0
1668509059700,CSE 290,G00,102440,Christensen; Henrik I,0,6,20,20
1668509060126,CSE 291,A00,102443,Su; Hao,0,0,0,0
1668509060126,CSE 291,B00,102448,Polikarpova; Nadezhda,0,0,0,0
1668509060126,CSE 291,C00,102453,Vaccaro; Kristen Marie,0,0,0,0
1668509060126,CSE 291,D00,111343,Savage; Stefan,0,0,0,0
1668509060126,CSE 291,E00,116474,Claffy; Kimberly Claire,0,0,0,0
1668509060126,CSE 291,F00,116479,Pasquale; Joseph,0,0,0,0
1668509060557,CSE 293,001,119111,Bafna; Vineet,9999,0,9999,0
1668509060557,CSE 293,002,119118,Bellare; Mihir,9999,0,9999,0
1668509060557,CSE 293,003,119122,Berg-Kirkpatrick; Taylor D,9999,0,9999,0
1668509060557,CSE 293,004,119135,Christensen; Henrik I,9999,0,9999,0
1668509060557,CSE 293,005,119142,Cottrell; Garrison W,9999,0,9999,0
1668509060557,CSE 293,006,119146,Deutsch; Alin Bernard,9999,0,9999,0
1668509060557,CSE 293,007,119159,Esmaeilzadeh; Hadi,9999,0,9999,0
1668509060557,CSE 293,008,119166,Freund; Yoav,9999,0,9999,0
1668509060557,CSE 293,009,119170,Griswold; William G.,9999,0,9999,0
1668509060557,CSE 293,010,119183,Gymrek; Melissa Ann,9999,0,9999,0
1668509060557,CSE 293,011,119190,Heninger; Nadia A,9999,0,9999,0
1668509060557,CSE 293,012,119230,Impagliazzo; Russell,9999,0,9999,0
1668509060557,CSE 293,013,119232,Jhala; Ranjit,9999,0,9999,0
1668509060557,CSE 293,014,119233,Kahng; Andrew Byun,9999,0,9999,0
1668509060557,CSE 293,015,119298,Kane; Daniel Mertz,9999,0,9999,0
1668509060557,CSE 293,016,119299,Kriegman; David J,9999,0,9999,0
1668509060557,CSE 293,017,119300,Kumar; Arun Kumar,9999,0,9999,0
1668509060557,CSE 293,018,119301,Lerner; Sorin,9999,0,9999,0
1668509060557,CSE 293,019,119302,Lovett; Shachar,9999,0,9999,0
1668509060557,CSE 293,020,119303,McAuley; Julian John,9999,0,9999,0
1668509060557,CSE 293,021,119304,Micciancio; Daniele,9999,0,9999,0
1668509060557,CSE 293,022,119367,Orailoglu; Alex,9999,0,9999,0
1668509060557,CSE 293,023,119382,Paturi; Ramamohan,9999,0,9999,0
1668509060557,CSE 293,024,119404,Polikarpova; Nadezhda,9999,0,9999,0
1668509060557,CSE 293,025,119406,Politz; Joseph Gibbs,9999,0,9999,0
1668509060557,CSE 293,026,119411,Porter; George M,9999,0,9999,0
1668509060557,CSE 293,027,119414,Porter; Leonard Emerson,9999,0,9999,0
1668509060557,CSE 293,028,119416,Ramamoorthi; Ravi,9999,0,9999,0
1668509060557,CSE 293,029,119417,Sahoo; Debashis,9999,0,9999,0
1668509060557,CSE 293,030,119420,Saul; Lawrence,9999,0,9999,0
1668509060557,CSE 293,031,119421,Savage; Stefan,9999,0,9999,0
1668509060557,CSE 293,032,119425,Schulze; Jurgen P.,9999,0,9999,0
1668509060557,CSE 293,033,119426,Snoeren; Alex C.,9999,0,9999,0
1668509060557,CSE 293,034,119428,Shang; Jingbo,9999,0,9999,0
1668509060557,CSE 293,035,119430,Stefan; Deian,9999,0,9999,0
1668509060557,CSE 293,036,119431,Su; Hao,9999,0,9999,0
1668509060557,CSE 293,037,119433,Swanson; Steven James,9999,0,9999,0
1668509060557,CSE 293,038,119435,Tullsen; Dean Michael,9999,0,9999,0
1668509060557,CSE 293,039,119483,Voelker; Geoffrey M.,9999,0,9999,0
1668509060557,CSE 293,040,119537,Zhao; Jishen,9999,0,9999,0
1668509060557,CSE 293,041,119538,Zhou; Yuan-Yuan,9999,0,9999,0
1668509060557,CSE 293,042,119539,Gao; Sicun,9999,0,9999,0
1668509060557,CSE 293,043,119540,Weibel; Nadir,9999,0,9999,0
1668509060557,CSE 293,044,119541,Gupta; Rajesh K.,9999,0,9999,0
1668509060557,CSE 293,045,126410,Vaccaro; Kristen Marie,9999,0,9999,0
1668509060557,CSE 293,046,126411,Klemke; Richard,9999,0,9999,0
1668509060981,CSE 294,A00,102459,Voelker; Geoffrey M.,0,2,0,0
1668509060981,CSE 294,B00,111322,Orailoglu; Alex,0,2,0,0
1668509061409,DSE 201,A00,096914,Deutsch; Alin Bernard,30,0,30,0
1668509061833,DSE 210,A00,096915,Dasgupta; Sanjoy,30,0,30,0
1668509062282,DSE 260A,A00,096916,Altintas De Callaf; Ilkay,30,0,30,0
1668509062762,ECE 200,001,103586,Antipa; Nicholas A,9999,0,9999,0
1668509062762,ECE 200,002,103587,Atanasov; Nikolay A.,9999,0,9999,0
1668509062762,ECE 200,003,103588,Bharadia; Dinesh,9999,0,9999,0
1668509062762,ECE 200,004,103589,Cheng; Chung Kuan,9999,0,9999,0
1668509062762,ECE 200,005,103590,Cosman; Pamela C.,9999,0,9999,0
1668509062762,ECE 200,006,103591,Dayeh; Shadi Ahmad,9999,0,9999,0
1668509062762,ECE 200,007,103592,Fainman; Yeshaiahu,9999,0,9999,0
1668509062762,ECE 200,008,103593,Ford; Joseph Earl,9999,0,9999,0
1668509062762,ECE 200,009,103594,Franceschetti; Massimo,9999,0,9999,0
1668509062762,ECE 200,010,103595,Fullerton; Eric E,9999,0,9999,0
1668509062762,ECE 200,011,103596,Galton; Ian A,9999,0,9999,0
1668509062762,ECE 200,012,103597,Gilja; Vikash,9999,0,9999,0
1668509062762,ECE 200,013,103598,Hall; Drew A.,9999,0,9999,0
1668509062762,ECE 200,014,103599,Hsueh; Tzu-Chien,9999,0,9999,0
1668509062762,ECE 200,015,103600,Javidi; Tara,9999,0,9999,0
1668509062762,ECE 200,016,103601,Kahng; Andrew Byun,9999,0,9999,0
1668509062762,ECE 200,017,103602,Kim; Young-Han,9999,0,9999,0
1668509062762,ECE 200,018,103603,Koushanfar; Farinaz,9999,0,9999,0
1668509062762,ECE 200,019,103604,Kuzum; Duygu,9999,0,9999,0
1668509062762,ECE 200,020,103605,Le; Hanh-Phuc,9999,0,9999,0
1668509062762,ECE 200,021,103606,Lin; Bill,9999,0,9999,0
1668509062762,ECE 200,022,103607,Liu; Zhaowei,9998,0,9999,1
1668509062762,ECE 200,023,103608,Lo; Yu-Hwa,9999,0,9999,0
1668509062762,ECE 200,024,103609,Lomakin; Vitaliy,9999,0,9999,0
1668509062762,ECE 200,025,103610,Mercier; Patrick Philip,9999,0,9999,0
1668509062762,ECE 200,026,103611,Meyer; Florian,9999,0,9999,0
1668509062762,ECE 200,027,103612,Milstein; Laurence B.,9999,0,9999,0
1668509062762,ECE 200,028,103613,Mir Arabbaygi; Siavash,9999,0,9999,0
1668509062762,ECE 200,029,103614,Mookherjea; Shayan,9999,0,9999,0
1668509062762,ECE 200,030,103615,Morris; Karcher William,9999,0,9999,0
1668509062762,ECE 200,031,103616,Ng; Tse Nga,9999,0,9999,0
1668509062762,ECE 200,032,103617,Nguyen; Truong Quang,9999,0,9999,0
1668509062762,ECE 200,033,103618,Nomura; Kenji,9999,0,9999,0
1668509062762,ECE 200,034,103619,Orlitsky; Alon,9999,0,9999,0
1668509062762,ECE 200,035,103620,Pal; Piya,9999,0,9999,0
1668509062762,ECE 200,036,103621,Papen; George C.,9999,0,9999,0
1668509062762,ECE 200,037,103622,Radic; Stojan,9999,0,9999,0
1668509062762,ECE 200,038,103623,Rao; Bhaskar D.,9999,0,9999,0
1668509062762,ECE 200,039,103624,Rao; Ramesh R,9999,0,9999,0
1668509062762,ECE 200,040,103625,Rebeiz; Gabriel,9999,0,9999,0
1668509062762,ECE 200,041,103626,Sanford; John R,9999,0,9999,0
1668509062762,ECE 200,042,103627,Siegel; Paul H.,9999,0,9999,0
1668509062762,ECE 200,043,103628,Sievenpiper; Daniel F.,9999,0,9999,0
1668509062762,ECE 200,044,103629,Sworder; David D.,9999,0,9999,0
1668509062762,ECE 200,045,103630,Taur; Yuan,9999,0,9999,0
1668509062762,ECE 200,046,103631,Touri; Behrouz,9999,0,9999,0
1668509062762,ECE 200,047,103632,Trivedi; Mohan M.,9999,0,9999,0
1668509062762,ECE 200,048,103633,Vasconcelos; Nuno,9999,0,9999,0
1668509062762,ECE 200,049,103634,Wang; Xiaolong,9999,0,9999,0
1668509062762,ECE 200,050,103635,Xie; Pengtao,9999,0,9999,0
1668509062762,ECE 200,051,103636,Yip; Michael,9999,0,9999,0
1668509062762,ECE 200,052,103637,Zeger; Kenneth A.,999,0,999,0
1668509062762,ECE 200,053,103638,Zhang; Xinyu,9999,0,9999,0
1668509062762,ECE 200,054,103639,Turakhia; Yatish Girish,9999,0,9999,0
1668509062762,ECE 200,055,103640,Kang; Mingu,9999,0,9999,0
1668509062762,ECE 200,056,103641,Shi; Yuanyuan,9999,0,9999,0
1668509062762,ECE 200,057,103642,Wang; Edward Jay,9999,0,9999,0
1668509062762,ECE 200,058,103643,Zheng; Yang,9999,0,9999,0
1668509063188,ECE 202,A00,103644,Kuzum; Duygu,0,44,0,0
1668509063617,ECE 212BN,A00,103646,Ng; Tse Nga,0,9,0,0
1668509064050,ECE 221,A00,111493,Staff,0,0,0,0
1668509064474,ECE 222B,A00,103647,Lomakin; Vitaliy,0,20,0,0
1668509064903,ECE 230B,A00,103648,Taur; Yuan,0,3,0,0
1668509065328,ECE 238B,A00,103649,Garay; Javier,0,0,0,0
1668509065752,ECE 240B,A00,112900,Fainman; Yeshaiahu,0,7,0,0
1668509066177,ECE 247A,A00,103650,Jokerst; Jesse Vincent,0,6,0,0
1668509066605,ECE 247B,A00,103651,Wang; Joseph,0,14,0,0
1668509067030,ECE 250,A00,103652,Siegel; Paul H.,0,82,0,0
1668509067478,ECE 251A,A00,103654,Rao; Bhaskar D.,0,61,0,0
1668509067906,ECE 257B,A00,103655,Bharadia; Dinesh,0,32,0,0
1668509068335,ECE 258A,A00,103656,Milstein; Laurence B.,0,29,0,0
1668509068759,ECE 260B,A00,103658,Kang; Mingu,0,119,0,0
1668509069184,ECE 264A,A00,103659,Galton; Ian A,0,65,0,0
1668509069613,ECE 265A,A00,103661,Gudem; Prasad S.S.,0,70,0,0
1668509070041,ECE 265D,A00,103662,Gudem; Prasad S.S.,0,26,0,0
1668509070469,ECE 268,A00,103663,Koushanfar; Farinaz,0,43,0,0
1668509070894,ECE 269,A01,103665,Pal; Piya,0,215,0,0
1668509071323,ECE 271B,A00,103666,Vasconcelos; Manuela,0,76,0,0
1668509071752,ECE 276A,A00,103667,Atanasov; Nikolay A.,0,126,0,0
1668509072185,ECE 277,A00,103668,An; Cheolhong,0,149,0,0
1668509072609,ECE 279,A00,117947,Hall; Drew A.,0,22,0,0
1668509073465,ECE 283,A00,103670,Hsueh; Tzu-Chien,0,53,0,0
1668509073890,ECE 284,A00,103671,Turakhia; Yatish Girish,0,39,0,0
1668509074315,ECE 285,A00,103672,Zheng; Yang,0,39,0,0
1668509074315,ECE 285,B00,103673,Sworder; David D.,0,57,0,0
1668509074745,ECE 287,A00,103676,Javidi; Tara,0,9,0,0
1668509075178,MATH 200B,A00,098023,Salehi Golsefidy; Alireza,10,0,15,5
1668509075612,MATH 202B,A00,098024,Rhoades; Brendon Patrick,7,0,15,8
1668509076051,MATH 203B,A00,098025,Oprea; Dragos N.,9,0,15,6
1668509076480,MATH 204B,A00,098026,Sorensen; Claus M,13,0,15,2
1668509076904,MATH 208,A00,098027,Izadi; Elham,7,0,10,3
1668509077328,MATH 209,A00,098028,Pollack; Aaron,10,0,10,0
1668509077751,MATH 211A,A00,112919,Rogalski; Daniel,8,0,10,2
1668509078178,MATH 211B,A00,112920,Seward; Brandon M.,9,0,10,1
1668509078606,MATH 218,A00,098029,Li; Bo,10,0,10,0
1668509079030,MATH 220B,A00,098030,Novak; Jonathan I,11,0,15,4
1668509079461,MATH 221A,A00,098031,Ebenfelt; Peter F,12,0,15,3
1668509079892,MATH 231B,A00,098032,Zlatos; Andrej,11,0,15,4
1668509080316,MATH 240B,A00,098033,Ni; Lei,7,0,15,8
1668509080739,MATH 243,A00,098034,Jekel; David Andrew,10,0,10,0
1668509081178,MATH 245A,A00,098035,Nie; Jiawang,0,4,15,18
1668509081617,MATH 248,A00,098036,Bejenaru; Ioan,10,0,10,0
1668509082046,MATH 250B,A00,098037,Spolaor; Luca,14,0,15,1
1668509082473,MATH 258,A00,098038,Ni; Lei,9,0,10,1
1668509082898,MATH 264B,A00,098041,Rhoades; Brendon Patrick,8,0,15,7
1668509083334,MATH 268,A00,098042,Buss; Samuel R,10,0,10,0
1668509083760,MATH 269,A00,098043,Rhoades; Brendon Patrick,10,0,10,0
1668509084189,MATH 270B,A00,098044,Li; Bo,6,0,15,9
1668509084614,MATH 272B,A00,098045,Holst; Michael J,13,0,15,2
1668509085038,MATH 273A,A00,098046,Tian; Xiaochuan,10,0,15,5
1668509085464,MATH 275,A01,098048,Tian; Xiaochuan,6,0,10,4
1668509085889,MATH 278A,A00,098049,Holst; Michael J,7,0,10,3
1668509086312,MATH 278B,A00,098050,Cloninger; Alexander,10,0,10,0
1668509086736,MATH 278C,A00,098051,Nie; Jiawang,5,0,10,5
1668509087176,MATH 280B,A00,098052,Zheng; Tianyi,7,0,15,8
1668509087600,MATH 281B,A00,098053,Bradic; Jelena,0,2,15,15
1668509088040,MATH 282B,A00,098054,Arias-Castro; Ery,0,1,15,15
1668509088464,MATH 285,A00,098055,Fitzsimmons; Patrick J,0,3,15,17
1668509088899,MATH 287B,A00,098056,Arias-Castro; Ery,1,0,15,14
1668509089332,MATH 288,A00,098057,Agarwal; Pooja,9,0,10,1
1668509089332,MATH 288,B00,098058,Zhang; Danna,8,0,10,2
1668509089332,MATH 288,C00,098059,Williams; Ruth J,9,0,10,1
1668509089760,MATH 290B,A00,098060,Roberts; Justin Deritter,12,0,15,3
1668509090187,MATH 292,A00,098061,Belmont; Eva Kinoshita,10,0,10,0
1668509090616,MATH 295,A00,098062,Suk; Andrew Hoon,47,0,50,3
1668509091042,MATH 296,A00,098063,Novak; Jonathan I,20,0,20,0
1668509091466,MATH 297,001,098064,Gamst; Anthony Collins,9997,0,9999,2
1668509594566,COGS 205,A00,101395,Chiba; Andrea,19,0,20,1
1668509594992,COGS 210B,001,101404,Greene; Deanna Jacquelyn,9998,0,9999,1
1668509594992,COGS 210B,002,101417,Xia; Haijun,9999,0,9999,0
1668509594992,COGS 210B,003,101422,Nitz; Douglas A.,9999,0,9999,0
1668509594992,COGS 210B,004,101423,Hollan; James D.,9998,0,9999,1
1668509594992,COGS 210B,005,101424,Deak; Gedeon O.,9998,0,9999,1
1668509594992,COGS 210B,006,101425,Rossano; Federico,9999,0,9999,0
1668509595420,COGS 211B,A00,101427,Coulson; Seana M,9996,0,9999,3
1668509595845,COGS 220,A00,101428,Hollan; James D.,0,10,25,25
1668509596272,COGS 229,A00,101429,Dow; Steven P,17,0,25,8
1668509596703,COGS 230,A00,101430,Klemmer; Scott R,7,0,17,10
1668509597129,COGS 234,A00,101431,Xia; Haijun,1,0,25,24
1668509597557,COGS 260,A00,101432,Kiyonaga; Anastasia,21,0,25,4
1668509597557,COGS 260,B00,101433,Kirsh; David Joel,15,0,25,10
1668509597984,CSE 202,A00,102371,Impagliazzo; Russell,0,65,0,0
1668509598411,CSE 203B,A01,102373,Cheng; Chung Kuan,0,58,0,0
1668509598836,CSE 208,A00,102374,Micciancio; Daniele,0,5,0,0
1668509599263,CSE 209A,A00,112895,Impagliazzo; Russell,0,12,15,15
1668509599689,CSE 209B,A00,108005,Bellare; Mihir,0,7,0,0
1668509600113,CSE 210,A00,113163,Coblenz; Michael J,0,84,0,0
1668509600542,CSE 219,A00,106111,Dow; Steven P,0,6,20,20
1668509600972,CSE 221,A00,102376,Voelker; Geoffrey M.,0,72,0,0
1668509601398,CSE 224,A01,102378,Porter; George M,0,166,0,0
1668509601824,CSE 229A,A00,102379,Savage; Stefan,0,10,0,0
1668509602248,CSE 229C,A00,102380,Munyaka; Imani N. S.,0,10,0,0
1668509602673,CSE 232B,A00,102382,Deutsch; Alin Bernard,0,32,0,0
1668509603098,CSE 234,A01,112904,Kumar; Arun Kumar,0,0,0,0
1668509603532,CSE 237A,A00,102383,Rosing; Tajana Simunic,0,55,0,0
1668509603956,CSE 239A,A00,102384,Deutsch; Alin Bernard,0,14,0,0
1668509604381,CSE 239B,A00,102385,Polikarpova; Nadezhda,0,10,0,0
1668509604812,CSE 240A,A00,102386,Pannuto; Patrick William,0,46,0,0
1668509605241,CSE 240B,A00,102387,Zhao; Jishen,0,47,0,0
1668509605667,CSE 241A,A00,106406,Kang; Mingu,0,9,0,0
1668509606092,CSE 249B,A00,102388,Kahng; Andrew Byun,0,5,8,8
1668509606527,CSE 251B,A01,102392,Cottrell; Garrison W,0,51,0,0
1668509606527,CSE 251B,A02,102393,Cottrell; Garrison W,0,34,0,0
1668509606963,CSE 252B,A00,102394,Ochoa; Benjamin Lawrence,0,59,0,0
1668509607388,CSE 257,A01,102396,Gao; Sicun,0,139,0,0
1668509607812,CSE 272,A00,102397,Li; Tzumao,0,19,0,0
1668509608243,CSE 274,A00,111323,Chern; Albert Ren-Haur,0,15,0,0
1668509608673,CSE 282,A00,102398,Pevzner; Pavel Arkadjevich,0,0,0,0
1668509609107,CSE 284,A00,114175,Gymrek; Melissa Ann,0,22,0,0
1668509609536,CSE 290,A00,102399,Chandraker; Manmohan Krishna,0,11,0,0
1668509609536,CSE 290,B00,102400,Vaccaro; Kristen Marie,0,7,25,25
1668509609536,CSE 290,C00,102414,Pannuto; Patrick William,0,1,25,25
1668509609536,CSE 290,D00,102427,Pevzner; Pavel Arkadjevich,0,0,0,0
1668509609536,CSE 290,E00,102429,Zhao; Jishen,0,4,0,0
1668509609536,CSE 290,F00,102436,Tullsen; Dean Michael,0,5,0,0
1668509609536,CSE 290,G00,102440,Christensen; Henrik I,0,6,20,20
1668509609971,CSE 291,A00,102443,Su; Hao,0,0,0,0
1668509609971,CSE 291,B00,102448,Polikarpova; Nadezhda,0,0,0,0
1668509609971,CSE 291,C00,102453,Vaccaro; Kristen Marie,0,0,0,0
1668509609971,CSE 291,D00,111343,Savage; Stefan,0,0,0,0
1668509609971,CSE 291,E00,116474,Claffy; Kimberly Claire,0,0,0,0
1668509609971,CSE 291,F00,116479,Pasquale; Joseph,0,0,0,0
1668509610415,CSE 293,001,119111,Bafna; Vineet,9999,0,9999,0
1668509610415,CSE 293,002,119118,Bellare; Mihir,9999,0,9999,0
1668509610415,CSE 293,003,119122,Berg-Kirkpatrick; Taylor D,9999,0,9999,0
1668509610415,CSE 293,004,119135,Christensen; Henrik I,9999,0,9999,0
1668509610415,CSE 293,005,119142,Cottrell; Garrison W,9999,0,9999,0
1668509610415,CSE 293,006,119146,Deutsch; Alin Bernard,9999,0,9999,0
1668509610415,CSE 293,007,119159,Esmaeilzadeh; Hadi,9999,0,9999,0
1668509610415,CSE 293,008,119166,Freund; Yoav,9999,0,9999,0
1668509610415,CSE 293,009,119170,Griswold; William G.,9999,0,9999,0
1668509610415,CSE 293,010,119183,Gymrek; Melissa Ann,9999,0,9999,0
1668509610415,CSE 293,011,119190,Heninger; Nadia A,9999,0,9999,0
1668509610415,CSE 293,012,119230,Impagliazzo; Russell,9999,0,9999,0
1668509610415,CSE 293,013,119232,Jhala; Ranjit,9999,0,9999,0
1668509610415,CSE 293,014,119233,Kahng; Andrew Byun,9999,0,9999,0
1668509610415,CSE 293,015,119298,Kane; Daniel Mertz,9999,0,9999,0
1668509610415,CSE 293,016,119299,Kriegman; David J,9999,0,9999,0
1668509610415,CSE 293,017,119300,Kumar; Arun Kumar,9999,0,9999,0
1668509610415,CSE 293,018,119301,Lerner; Sorin,9999,0,9999,0
1668509610415,CSE 293,019,119302,Lovett; Shachar,9999,0,9999,0
1668509610415,CSE 293,020,119303,McAuley; Julian John,9999,0,9999,0
1668509610415,CSE 293,021,119304,Micciancio; Daniele,9999,0,9999,0
1668509610415,CSE 293,022,119367,Orailoglu; Alex,9999,0,9999,0
1668509610415,CSE 293,023,119382,Paturi; Ramamohan,9999,0,9999,0
1668509610415,CSE 293,024,119404,Polikarpova; Nadezhda,9999,0,9999,0
1668509610415,CSE 293,025,119406,Politz; Joseph Gibbs,9999,0,9999,0
1668509610415,CSE 293,026,119411,Porter; George M,9999,0,9999,0
1668509610415,CSE 293,027,119414,Porter; Leonard Emerson,9999,0,9999,0
1668509610415,CSE 293,028,119416,Ramamoorthi; Ravi,9999,0,9999,0
1668509610415,CSE 293,029,119417,Sahoo; Debashis,9999,0,9999,0
1668509610415,CSE 293,030,119420,Saul; Lawrence,9999,0,9999,0
1668509610415,CSE 293,031,119421,Savage; Stefan,9999,0,9999,0
1668509610415,CSE 293,032,119425,Schulze; Jurgen P.,9999,0,9999,0
1668509610415,CSE 293,033,119426,Snoeren; Alex C.,9999,0,9999,0
1668509610415,CSE 293,034,119428,Shang; Jingbo,9999,0,9999,0
1668509610415,CSE 293,035,119430,Stefan; Deian,9999,0,9999,0
1668509610415,CSE 293,036,119431,Su; Hao,9999,0,9999,0
1668509610415,CSE 293,037,119433,Swanson; Steven James,9999,0,9999,0
1668509610415,CSE 293,038,119435,Tullsen; Dean Michael,9999,0,9999,0
1668509610415,CSE 293,039,119483,Voelker; Geoffrey M.,9999,0,9999,0
1668509610415,CSE 293,040,119537,Zhao; Jishen,9999,0,9999,0
1668509610415,CSE 293,041,119538,Zhou; Yuan-Yuan,9999,0,9999,0
1668509610415,CSE 293,042,119539,Gao; Sicun,9999,0,9999,0
1668509610415,CSE 293,043,119540,Weibel; Nadir,9999,0,9999,0
1668509610415,CSE 293,044,119541,Gupta; Rajesh K.,9999,0,9999,0
1668509610415,CSE 293,045,126410,Vaccaro; Kristen Marie,9999,0,9999,0
1668509610415,CSE 293,046,126411,Klemke; Richard,9999,0,9999,0
1668509610845,CSE 294,A00,102459,Voelker; Geoffrey M.,0,2,0,0
1668509610845,CSE 294,B00,111322,Orailoglu; Alex,0,2,0,0
1668509611288,DSE 201,A00,096914,Deutsch; Alin Bernard,30,0,30,0
1668509611712,DSE 210,A00,096915,Dasgupta; Sanjoy,30,0,30,0
1668509612139,DSE 260A,A00,096916,Altintas De Callaf; Ilkay,30,0,30,0
1668509612596,ECE 200,001,103586,Antipa; Nicholas A,9999,0,9999,0
1668509612596,ECE 200,002,103587,Atanasov; Nikolay A.,9999,0,9999,0
1668509612596,ECE 200,003,103588,Bharadia; Dinesh,9999,0,9999,0
1668509612596,ECE 200,004,103589,Cheng; Chung Kuan,9999,0,9999,0
1668509612596,ECE 200,005,103590,Cosman; Pamela C.,9999,0,9999,0
1668509612596,ECE 200,006,103591,Dayeh; Shadi Ahmad,9999,0,9999,0
1668509612596,ECE 200,007,103592,Fainman; Yeshaiahu,9999,0,9999,0
1668509612596,ECE 200,008,103593,Ford; Joseph Earl,9999,0,9999,0
1668509612596,ECE 200,009,103594,Franceschetti; Massimo,9999,0,9999,0
1668509612596,ECE 200,010,103595,Fullerton; Eric E,9999,0,9999,0
1668509612596,ECE 200,011,103596,Galton; Ian A,9999,0,9999,0
1668509612596,ECE 200,012,103597,Gilja; Vikash,9999,0,9999,0
1668509612596,ECE 200,013,103598,Hall; Drew A.,9999,0,9999,0
1668509612596,ECE 200,014,103599,Hsueh; Tzu-Chien,9999,0,9999,0
1668509612596,ECE 200,015,103600,Javidi; Tara,9999,0,9999,0
1668509612596,ECE 200,016,103601,Kahng; Andrew Byun,9999,0,9999,0
1668509612596,ECE 200,017,103602,Kim; Young-Han,9999,0,9999,0
1668509612596,ECE 200,018,103603,Koushanfar; Farinaz,9999,0,9999,0
1668509612596,ECE 200,019,103604,Kuzum; Duygu,9999,0,9999,0
1668509612596,ECE 200,020,103605,Le; Hanh-Phuc,9999,0,9999,0
1668509612596,ECE 200,021,103606,Lin; Bill,9999,0,9999,0
1668509612596,ECE 200,022,103607,Liu; Zhaowei,9998,0,9999,1
1668509612596,ECE 200,023,103608,Lo; Yu-Hwa,9999,0,9999,0
1668509612596,ECE 200,024,103609,Lomakin; Vitaliy,9999,0,9999,0
1668509612596,ECE 200,025,103610,Mercier; Patrick Philip,9999,0,9999,0
1668509612596,ECE 200,026,103611,Meyer; Florian,9999,0,9999,0
1668509612596,ECE 200,027,103612,Milstein; Laurence B.,9999,0,9999,0
1668509612596,ECE 200,028,103613,Mir Arabbaygi; Siavash,9999,0,9999,0
1668509612596,ECE 200,029,103614,Mookherjea; Shayan,9999,0,9999,0
1668509612596,ECE 200,030,103615,Morris; Karcher William,9999,0,9999,0
1668509612596,ECE 200,031,103616,Ng; Tse Nga,9999,0,9999,0
1668509612596,ECE 200,032,103617,Nguyen; Truong Quang,9999,0,9999,0
1668509612596,ECE 200,033,103618,Nomura; Kenji,9999,0,9999,0
1668509612596,ECE 200,034,103619,Orlitsky; Alon,9999,0,9999,0
1668509612596,ECE 200,035,103620,Pal; Piya,9999,0,9999,0
1668509612596,ECE 200,036,103621,Papen; George C.,9999,0,9999,0
1668509612596,ECE 200,037,103622,Radic; Stojan,9999,0,9999,0
1668509612596,ECE 200,038,103623,Rao; Bhaskar D.,9999,0,9999,0
1668509612596,ECE 200,039,103624,Rao; Ramesh R,9999,0,9999,0
1668509612596,ECE 200,040,103625,Rebeiz; Gabriel,9999,0,9999,0
1668509612596,ECE 200,041,103626,Sanford; John R,9999,0,9999,0
1668509612596,ECE 200,042,103627,Siegel; Paul H.,9999,0,9999,0
1668509612596,ECE 200,043,103628,Sievenpiper; Daniel F.,9999,0,9999,0
1668509612596,ECE 200,044,103629,Sworder; David D.,9999,0,9999,0
1668509612596,ECE 200,045,103630,Taur; Yuan,9999,0,9999,0
1668509612596,ECE 200,046,103631,Touri; Behrouz,9999,0,9999,0
1668509612596,ECE 200,047,103632,Trivedi; Mohan M.,9999,0,9999,0
1668509612596,ECE 200,048,103633,Vasconcelos; Nuno,9999,0,9999,0
1668509612596,ECE 200,049,103634,Wang; Xiaolong,9999,0,9999,0
1668509612596,ECE 200,050,103635,Xie; Pengtao,9999,0,9999,0
1668509612596,ECE 200,051,103636,Yip; Michael,9999,0,9999,0
1668509612596,ECE 200,052,103637,Zeger; Kenneth A.,999,0,999,0
1668509612596,ECE 200,053,103638,Zhang; Xinyu,9999,0,9999,0
1668509612596,ECE 200,054,103639,Turakhia; Yatish Girish,9999,0,9999,0
1668509612596,ECE 200,055,103640,Kang; Mingu,9999,0,9999,0
1668509612596,ECE 200,056,103641,Shi; Yuanyuan,9999,0,9999,0
1668509612596,ECE 200,057,103642,Wang; Edward Jay,9999,0,9999,0
1668509612596,ECE 200,058,103643,Zheng; Yang,9999,0,9999,0
1668509613024,ECE 202,A00,103644,Kuzum; Duygu,0,44,0,0
1668509613455,ECE 212BN,A00,103646,Ng; Tse Nga,0,9,0,0
1668509613880,ECE 221,A00,111493,Staff,0,0,0,0
1668509614304,ECE 222B,A00,103647,Lomakin; Vitaliy,0,20,0,0
1668509614731,ECE 230B,A00,103648,Taur; Yuan,0,3,0,0
1668509615155,ECE 238B,A00,103649,Garay; Javier,0,0,0,0
1668509615583,ECE 240B,A00,112900,Fainman; Yeshaiahu,0,7,0,0
1668509616007,ECE 247A,A00,103650,Jokerst; Jesse Vincent,0,6,0,0
1668509616430,ECE 247B,A00,103651,Wang; Joseph,0,14,0,0
1668509616856,ECE 250,A00,103652,Siegel; Paul H.,0,82,0,0
1668509617287,ECE 251A,A00,103654,Rao; Bhaskar D.,0,61,0,0
1668509617715,ECE 257B,A00,103655,Bharadia; Dinesh,0,32,0,0
1668509618155,ECE 258A,A00,103656,Milstein; Laurence B.,0,29,0,0
1668509618579,ECE 260B,A00,103658,Kang; Mingu,0,119,0,0
1668509619004,ECE 264A,A00,103659,Galton; Ian A,0,65,0,0
1668509619430,ECE 265A,A00,103661,Gudem; Prasad S.S.,0,70,0,0
1668509619853,ECE 265D,A00,103662,Gudem; Prasad S.S.,0,26,0,0
1668509620278,ECE 268,A00,103663,Koushanfar; Farinaz,0,43,0,0
1668509620703,ECE 269,A01,103665,Pal; Piya,0,215,0,0
1668509621214,ECE 271B,A00,103666,Vasconcelos; Manuela,0,76,0,0
1668509621641,ECE 276A,A00,103667,Atanasov; Nikolay A.,0,126,0,0
1668509622070,ECE 277,A00,103668,An; Cheolhong,0,149,0,0
1668509622498,ECE 279,A00,117947,Hall; Drew A.,0,22,0,0
1668509623347,ECE 283,A00,103670,Hsueh; Tzu-Chien,0,53,0,0
1668509623771,ECE 284,A00,103671,Turakhia; Yatish Girish,0,39,0,0
1668509624201,ECE 285,A00,103672,Zheng; Yang,0,39,0,0
1668509624201,ECE 285,B00,103673,Sworder; David D.,0,57,0,0
1668509624626,ECE 287,A00,103676,Javidi; Tara,0,9,0,0
1668509625053,MATH 200B,A00,098023,Salehi Golsefidy; Alireza,10,0,15,5
1668509625480,MATH 202B,A00,098024,Rhoades; Brendon Patrick,7,0,15,8
1668509625905,MATH 203B,A00,098025,Oprea; Dragos N.,9,0,15,6
1668509626332,MATH 204B,A00,098026,Sorensen; Claus M,13,0,15,2
1668509626758,MATH 208,A00,098027,Izadi; Elham,7,0,10,3
1668509627187,MATH 209,A00,098028,Pollack; Aaron,10,0,10,0
1668509627611,MATH 211A,A00,112919,Rogalski; Daniel,8,0,10,2
1668509628043,MATH 211B,A00,112920,Seward; Brandon M.,9,0,10,1
1668509628470,MATH 218,A00,098029,Li; Bo,10,0,10,0
1668509628897,MATH 220B,A00,098030,Novak; Jonathan I,11,0,15,4
1668509629339,MATH 221A,A00,098031,Ebenfelt; Peter F,12,0,15,3
1668509629775,MATH 231B,A00,098032,Zlatos; Andrej,11,0,15,4
1668509630212,MATH 240B,A00,098033,Ni; Lei,7,0,15,8
1668509630636,MATH 243,A00,098034,Jekel; David Andrew,10,0,10,0
1668509631066,MATH 245A,A00,098035,Nie; Jiawang,0,4,15,18
1668509631491,MATH 248,A00,098036,Bejenaru; Ioan,10,0,10,0
1668509631920,MATH 250B,A00,098037,Spolaor; Luca,14,0,15,1
1668509632345,MATH 258,A00,098038,Ni; Lei,9,0,10,1
1668509632771,MATH 264B,A00,098041,Rhoades; Brendon Patrick,8,0,15,7
1668509633199,MATH 268,A00,098042,Buss; Samuel R,10,0,10,0
1668509633622,MATH 269,A00,098043,Rhoades; Brendon Patrick,10,0,10,0
1668509634050,MATH 270B,A00,098044,Li; Bo,6,0,15,9
1668509634478,MATH 272B,A00,098045,Holst; Michael J,13,0,15,2
1668509634904,MATH 273A,A00,098046,Tian; Xiaochuan,10,0,15,5
1668509635338,MATH 275,A01,098048,Tian; Xiaochuan,6,0,10,4
1668509635764,MATH 278A,A00,098049,Holst; Michael J,7,0,10,3
1668509636193,MATH 278B,A00,098050,Cloninger; Alexander,10,0,10,0
1668509636617,MATH 278C,A00,098051,Nie; Jiawang,5,0,10,5
1668509637041,MATH 280B,A00,098052,Zheng; Tianyi,7,0,15,8
1668509637465,MATH 281B,A00,098053,Bradic; Jelena,0,2,15,15
1668509637894,MATH 282B,A00,098054,Arias-Castro; Ery,0,1,15,15
1668509638320,MATH 285,A00,098055,Fitzsimmons; Patrick J,0,3,15,17
1668509638746,MATH 287B,A00,098056,Arias-Castro; Ery,1,0,15,14
1668509639174,MATH 288,A00,098057,Agarwal; Pooja,9,0,10,1
1668509639174,MATH 288,B00,098058,Zhang; Danna,8,0,10,2
1668509639174,MATH 288,C00,098059,Williams; Ruth J,9,0,10,1
1668509639601,MATH 290B,A00,098060,Roberts; Justin Deritter,12,0,15,3
1668509640028,MATH 292,A00,098061,Belmont; Eva Kinoshita,10,0,10,0
1668509640463,MATH 295,A00,098062,Suk; Andrew Hoon,47,0,50,3
1668509640890,MATH 296,A00,098063,Novak; Jonathan I,20,0,20,0
1668509641321,MATH 297,001,098064,Gamst; Anthony Collins,9997,0,9999,2
1668510144096,COGS 205,A00,101395,Chiba; Andrea,19,0,20,1
1668510144529,COGS 210B,001,101404,Greene; Deanna Jacquelyn,9998,0,9999,1
1668510144529,COGS 210B,002,101417,Xia; Haijun,9999,0,9999,0
1668510144529,COGS 210B,003,101422,Nitz; Douglas A.,9999,0,9999,0
1668510144529,COGS 210B,004,101423,Hollan; James D.,9998,0,9999,1
1668510144529,COGS 210B,005,101424,Deak; Gedeon O.,9998,0,9999,1
1668510144529,COGS 210B,006,101425,Rossano; Federico,9999,0,9999,0
1668510144957,COGS 211B,A00,101427,Coulson; Seana M,9996,0,9999,3
1668510145383,COGS 220,A00,101428,Hollan; James D.,0,10,25,25
1668510145806,COGS 229,A00,101429,Dow; Steven P,17,0,25,8
1668510146231,COGS 230,A00,101430,Klemmer; Scott R,7,0,17,10
1668510146662,COGS 234,A00,101431,Xia; Haijun,1,0,25,24
1668510147086,COGS 260,A00,101432,Kiyonaga; Anastasia,21,0,25,4
1668510147086,COGS 260,B00,101433,Kirsh; David Joel,15,0,25,10
1668510147511,CSE 202,A00,102371,Impagliazzo; Russell,0,65,0,0
1668510147938,CSE 203B,A01,102373,Cheng; Chung Kuan,0,58,0,0
1668510148362,CSE 208,A00,102374,Micciancio; Daniele,0,5,0,0
1668510148786,CSE 209A,A00,112895,Impagliazzo; Russell,0,12,15,15
1668510149215,CSE 209B,A00,108005,Bellare; Mihir,0,7,0,0
1668510149646,CSE 210,A00,113163,Coblenz; Michael J,0,84,0,0
1668510150073,CSE 219,A00,106111,Dow; Steven P,0,6,20,20
1668510150502,CSE 221,A00,102376,Voelker; Geoffrey M.,0,72,0,0
1668510150931,CSE 224,A01,102378,Porter; George M,0,166,0,0
1668510151365,CSE 229A,A00,102379,Savage; Stefan,0,10,0,0
1668510151794,CSE 229C,A00,102380,Munyaka; Imani N. S.,0,10,0,0
1668510152220,CSE 232B,A00,102382,Deutsch; Alin Bernard,0,32,0,0
1668510152646,CSE 234,A01,112904,Kumar; Arun Kumar,0,0,0,0
1668510153072,CSE 237A,A00,102383,Rosing; Tajana Simunic,0,55,0,0
1668510153505,CSE 239A,A00,102384,Deutsch; Alin Bernard,0,14,0,0
1668510153930,CSE 239B,A00,102385,Polikarpova; Nadezhda,0,10,0,0
1668510154355,CSE 240A,A00,102386,Pannuto; Patrick William,0,46,0,0
1668510154783,CSE 240B,A00,102387,Zhao; Jishen,0,47,0,0
1668510155207,CSE 241A,A00,106406,Kang; Mingu,0,9,0,0
1668510155632,CSE 249B,A00,102388,Kahng; Andrew Byun,0,5,8,8
1668510156061,CSE 251B,A01,102392,Cottrell; Garrison W,0,51,0,0
1668510156061,CSE 251B,A02,102393,Cottrell; Garrison W,0,34,0,0
1668510156486,CSE 252B,A00,102394,Ochoa; Benjamin Lawrence,0,59,0,0
1668510156916,CSE 257,A01,102396,Gao; Sicun,0,139,0,0
1668510157349,CSE 272,A00,102397,Li; Tzumao,0,19,0,0
1668510157775,CSE 274,A00,111323,Chern; Albert Ren-Haur,0,15,0,0
1668510158202,CSE 282,A00,102398,Pevzner; Pavel Arkadjevich,0,0,0,0
1668510158627,CSE 284,A00,114175,Gymrek; Melissa Ann,0,22,0,0
1668510159055,CSE 290,A00,102399,Chandraker; Manmohan Krishna,0,11,0,0
1668510159055,CSE 290,B00,102400,Vaccaro; Kristen Marie,0,7,25,25
1668510159055,CSE 290,C00,102414,Pannuto; Patrick William,0,1,25,25
1668510159055,CSE 290,D00,102427,Pevzner; Pavel Arkadjevich,0,0,0,0
1668510159055,CSE 290,E00,102429,Zhao; Jishen,0,4,0,0
1668510159055,CSE 290,F00,102436,Tullsen; Dean Michael,0,5,0,0
1668510159055,CSE 290,G00,102440,Christensen; Henrik I,0,6,20,20
1668510159485,CSE 291,A00,102443,Su; Hao,0,0,0,0
1668510159485,CSE 291,B00,102448,Polikarpova; Nadezhda,0,0,0,0
1668510159485,CSE 291,C00,102453,Vaccaro; Kristen Marie,0,0,0,0
1668510159485,CSE 291,D00,111343,Savage; Stefan,0,0,0,0
1668510159485,CSE 291,E00,116474,Claffy; Kimberly Claire,0,0,0,0
1668510159485,CSE 291,F00,116479,Pasquale; Joseph,0,0,0,0
1668510159927,CSE 293,001,119111,Bafna; Vineet,9999,0,9999,0
1668510159927,CSE 293,002,119118,Bellare; Mihir,9999,0,9999,0
1668510159927,CSE 293,003,119122,Berg-Kirkpatrick; Taylor D,9999,0,9999,0
1668510159927,CSE 293,004,119135,Christensen; Henrik I,9999,0,9999,0
1668510159927,CSE 293,005,119142,Cottrell; Garrison W,9999,0,9999,0
1668510159927,CSE 293,006,119146,Deutsch; Alin Bernard,9999,0,9999,0
1668510159927,CSE 293,007,119159,Esmaeilzadeh; Hadi,9999,0,9999,0
1668510159927,CSE 293,008,119166,Freund; Yoav,9999,0,9999,0
1668510159927,CSE 293,009,119170,Griswold; William G.,9999,0,9999,0
1668510159927,CSE 293,010,119183,Gymrek; Melissa Ann,9999,0,9999,0
1668510159927,CSE 293,011,119190,Heninger; Nadia A,9999,0,9999,0
1668510159927,CSE 293,012,119230,Impagliazzo; Russell,9999,0,9999,0
1668510159927,CSE 293,013,119232,Jhala; Ranjit,9999,0,9999,0
1668510159927,CSE 293,014,119233,Kahng; Andrew Byun,9999,0,9999,0
1668510159927,CSE 293,015,119298,Kane; Daniel Mertz,9999,0,9999,0
1668510159927,CSE 293,016,119299,Kriegman; David J,9999,0,9999,0
1668510159927,CSE 293,017,119300,Kumar; Arun Kumar,9999,0,9999,0
1668510159927,CSE 293,018,119301,Lerner; Sorin,9999,0,9999,0
1668510159927,CSE 293,019,119302,Lovett; Shachar,9999,0,9999,0
1668510159927,CSE 293,020,119303,McAuley; Julian John,9999,0,9999,0
1668510159927,CSE 293,021,119304,Micciancio; Daniele,9999,0,9999,0
1668510159927,CSE 293,022,119367,Orailoglu; Alex,9999,0,9999,0
1668510159927,CSE 293,023,119382,Paturi; Ramamohan,9999,0,9999,0
1668510159927,CSE 293,024,119404,Polikarpova; Nadezhda,9999,0,9999,0
1668510159927,CSE 293,025,119406,Politz; Joseph Gibbs,9999,0,9999,0
1668510159927,CSE 293,026,119411,Porter; George M,9999,0,9999,0
1668510159927,CSE 293,027,119414,Porter; Leonard Emerson,9999,0,9999,0
1668510159927,CSE 293,028,119416,Ramamoorthi; Ravi,9999,0,9999,0
1668510159927,CSE 293,029,119417,Sahoo; Debashis,9999,0,9999,0
1668510159927,CSE 293,030,119420,Saul; Lawrence,9999,0,9999,0
1668510159927,CSE 293,031,119421,Savage; Stefan,9999,0,9999,0
1668510159927,CSE 293,032,119425,Schulze; Jurgen P.,9999,0,9999,0
1668510159927,CSE 293,033,119426,Snoeren; Alex C.,9999,0,9999,0
1668510159927,CSE 293,034,119428,Shang; Jingbo,9999,0,9999,0
1668510159927,CSE 293,035,119430,Stefan; Deian,9999,0,9999,0
1668510159927,CSE 293,036,119431,Su; Hao,9999,0,9999,0
1668510159927,CSE 293,037,119433,Swanson; Steven James,9999,0,9999,0
1668510159927,CSE 293,038,119435,Tullsen; Dean Michael,9999,0,9999,0
1668510159927,CSE 293,039,119483,Voelker; Geoffrey M.,9999,0,9999,0
1668510159927,CSE 293,040,119537,Zhao; Jishen,9999,0,9999,0
1668510159927,CSE 293,041,119538,Zhou; Yuan-Yuan,9999,0,9999,0
1668510159927,CSE 293,042,119539,Gao; Sicun,9999,0,9999,0
1668510159927,CSE 293,043,119540,Weibel; Nadir,9999,0,9999,0
1668510159927,CSE 293,044,119541,Gupta; Rajesh K.,9999,0,9999,0
1668510159927,CSE 293,045,126410,Vaccaro; Kristen Marie,9999,0,9999,0
1668510159927,CSE 293,046,126411,Klemke; Richard,9999,0,9999,0
1668510160352,CSE 294,A00,102459,Voelker; Geoffrey M.,0,2,0,0
1668510160352,CSE 294,B00,111322,Orailoglu; Alex,0,2,0,0
1668510160802,DSE 201,A00,096914,Deutsch; Alin Bernard,30,0,30,0
1668510161226,DSE 210,A00,096915,Dasgupta; Sanjoy,30,0,30,0
1668510161651,DSE 260A,A00,096916,Altintas De Callaf; Ilkay,30,0,30,0
1668510162101,ECE 200,001,103586,Antipa; Nicholas A,9999,0,9999,0
1668510162101,ECE 200,002,103587,Atanasov; Nikolay A.,9999,0,9999,0
1668510162101,ECE 200,003,103588,Bharadia; Dinesh,9999,0,9999,0
1668510162101,ECE 200,004,103589,Cheng; Chung Kuan,9999,0,9999,0
1668510162101,ECE 200,005,103590,Cosman; Pamela C.,9999,0,9999,0
1668510162101,ECE 200,006,103591,Dayeh; Shadi Ahmad,9999,0,9999,0
1668510162101,ECE 200,007,103592,Fainman; Yeshaiahu,9999,0,9999,0
1668510162101,ECE 200,008,103593,Ford; Joseph Earl,9999,0,9999,0
1668510162101,ECE 200,009,103594,Franceschetti; Massimo,9999,0,9999,0
1668510162101,ECE 200,010,103595,Fullerton; Eric E,9999,0,9999,0
1668510162101,ECE 200,011,103596,Galton; Ian A,9999,0,9999,0
1668510162101,ECE 200,012,103597,Gilja; Vikash,9999,0,9999,0
1668510162101,ECE 200,013,103598,Hall; Drew A.,9999,0,9999,0
1668510162101,ECE 200,014,103599,Hsueh; Tzu-Chien,9999,0,9999,0
1668510162101,ECE 200,015,103600,Javidi; Tara,9999,0,9999,0
1668510162101,ECE 200,016,103601,Kahng; Andrew Byun,9999,0,9999,0
1668510162101,ECE 200,017,103602,Kim; Young-Han,9999,0,9999,0
1668510162101,ECE 200,018,103603,Koushanfar; Farinaz,9999,0,9999,0
1668510162101,ECE 200,019,103604,Kuzum; Duygu,9999,0,9999,0
1668510162101,ECE 200,020,103605,Le; Hanh-Phuc,9999,0,9999,0
1668510162101,ECE 200,021,103606,Lin; Bill,9999,0,9999,0
1668510162101,ECE 200,022,103607,Liu; Zhaowei,9998,0,9999,1
1668510162101,ECE 200,023,103608,Lo; Yu-Hwa,9999,0,9999,0
1668510162101,ECE 200,024,103609,Lomakin; Vitaliy,9999,0,9999,0
1668510162101,ECE 200,025,103610,Mercier; Patrick Philip,9999,0,9999,0
1668510162101,ECE 200,026,103611,Meyer; Florian,9999,0,9999,0
1668510162101,ECE 200,027,103612,Milstein; Laurence B.,9999,0,9999,0
1668510162101,ECE 200,028,103613,Mir Arabbaygi; Siavash,9999,0,9999,0
1668510162101,ECE 200,029,103614,Mookherjea; Shayan,9999,0,9999,0
1668510162101,ECE 200,030,103615,Morris; Karcher William,9999,0,9999,0
1668510162101,ECE 200,031,103616,Ng; Tse Nga,9999,0,9999,0
1668510162101,ECE 200,032,103617,Nguyen; Truong Quang,9999,0,9999,0
1668510162101,ECE 200,033,103618,Nomura; Kenji,9999,0,9999,0
1668510162101,ECE 200,034,103619,Orlitsky; Alon,9999,0,9999,0
1668510162101,ECE 200,035,103620,Pal; Piya,9999,0,9999,0
1668510162101,ECE 200,036,103621,Papen; George C.,9999,0,9999,0
1668510162101,ECE 200,037,103622,Radic; Stojan,9999,0,9999,0
1668510162101,ECE 200,038,103623,Rao; Bhaskar D.,9999,0,9999,0
1668510162101,ECE 200,039,103624,Rao; Ramesh R,9999,0,9999,0
1668510162101,ECE 200,040,103625,Rebeiz; Gabriel,9999,0,9999,0
1668510162101,ECE 200,041,103626,Sanford; John R,9999,0,9999,0
1668510162101,ECE 200,042,103627,Siegel; Paul H.,9999,0,9999,0
1668510162101,ECE 200,043,103628,Sievenpiper; Daniel F.,9999,0,9999,0
1668510162101,ECE 200,044,103629,Sworder; David D.,9999,0,9999,0
1668510162101,ECE 200,045,103630,Taur; Yuan,9999,0,9999,0
1668510162101,ECE 200,046,103631,Touri; Behrouz,9999,0,9999,0
1668510162101,ECE 200,047,103632,Trivedi; Mohan M.,9999,0,9999,0
1668510162101,ECE 200,048,103633,Vasconcelos; Nuno,9999,0,9999,0
1668510162101,ECE 200,049,103634,Wang; Xiaolong,9999,0,9999,0
1668510162101,ECE 200,050,103635,Xie; Pengtao,9999,0,9999,0
1668510162101,ECE 200,051,103636,Yip; Michael,9999,0,9999,0
1668510162101,ECE 200,052,103637,Zeger; Kenneth A.,999,0,999,0
1668510162101,ECE 200,053,103638,Zhang; Xinyu,9999,0,9999,0
1668510162101,ECE 200,054,103639,Turakhia; Yatish Girish,9999,0,9999,0
1668510162101,ECE 200,055,103640,Kang; Mingu,9999,0,9999,0
1668510162101,ECE 200,056,103641,Shi; Yuanyuan,9999,0,9999,0
1668510162101,ECE 200,057,103642,Wang; Edward Jay,9999,0,9999,0
1668510162101,ECE 200,058,103643,Zheng; Yang,9999,0,9999,0
1668510162526,ECE 202,A00,103644,Kuzum; Duygu,0,44,0,0
1668510162952,ECE 212BN,A00,103646,Ng; Tse Nga,0,9,0,0
1668510163379,ECE 221,A00,111493,Staff,0,0,0,0
1668510163805,ECE 222B,A00,103647,Lomakin; Vitaliy,0,20,0,0
1668510164234,ECE 230B,A00,103648,Taur; Yuan,0,3,0,0
1668510164660,ECE 238B,A00,103649,Garay; Javier,0,0,0,0
1668510165084,ECE 240B,A00,112900,Fainman; Yeshaiahu,0,7,0,0
1668510165510,ECE 247A,A00,103650,Jokerst; Jesse Vincent,0,6,0,0
1668510165936,ECE 247B,A00,103651,Wang; Joseph,0,14,0,0
1668510166361,ECE 250,A00,103652,Siegel; Paul H.,0,82,0,0
1668510166790,ECE 251A,A00,103654,Rao; Bhaskar D.,0,61,0,0
1668510167214,ECE 257B,A00,103655,Bharadia; Dinesh,0,32,0,0
1668510167638,ECE 258A,A00,103656,Milstein; Laurence B.,0,29,0,0
1668510168061,ECE 260B,A00,103658,Kang; Mingu,0,119,0,0
1668510168488,ECE 264A,A00,103659,Galton; Ian A,0,65,0,0
1668510168911,ECE 265A,A00,103661,Gudem; Prasad S.S.,0,70,0,0
1668510169339,ECE 265D,A00,103662,Gudem; Prasad S.S.,0,26,0,0
1668510169766,ECE 268,A00,103663,Koushanfar; Farinaz,0,43,0,0
1668510170192,ECE 269,A01,103665,Pal; Piya,0,215,0,0
1668510170616,ECE 271B,A00,103666,Vasconcelos; Manuela,0,76,0,0
1668510171041,ECE 276A,A00,103667,Atanasov; Nikolay A.,0,126,0,0
1668510171467,ECE 277,A00,103668,An; Cheolhong,0,149,0,0
1668510171905,ECE 279,A00,117947,Hall; Drew A.,0,22,0,0
1668510172759,ECE 283,A00,103670,Hsueh; Tzu-Chien,0,53,0,0
1668510173187,ECE 284,A00,103671,Turakhia; Yatish Girish,0,39,0,0
1668510173610,ECE 285,A00,103672,Zheng; Yang,0,39,0,0
1668510173610,ECE 285,B00,103673,Sworder; David D.,0,57,0,0
1668510174034,ECE 287,A00,103676,Javidi; Tara,0,9,0,0
1668510174460,MATH 200B,A00,098023,Salehi Golsefidy; Alireza,10,0,15,5
1668510174884,MATH 202B,A00,098024,Rhoades; Brendon Patrick,7,0,15,8
1668510175312,MATH 203B,A00,098025,Oprea; Dragos N.,9,0,15,6
1668510175737,MATH 204B,A00,098026,Sorensen; Claus M,13,0,15,2
1668510176162,MATH 208,A00,098027,Izadi; Elham,7,0,10,3
1668510176585,MATH 209,A00,098028,Pollack; Aaron,10,0,10,0
1668510177013,MATH 211A,A00,112919,Rogalski; Daniel,8,0,10,2
1668510177439,MATH 211B,A00,112920,Seward; Brandon M.,9,0,10,1
1668510177867,MATH 218,A00,098029,Li; Bo,10,0,10,0
1668510178291,MATH 220B,A00,098030,Novak; Jonathan I,11,0,15,4
1668510178731,MATH 221A,A00,098031,Ebenfelt; Peter F,12,0,15,3
1668510179157,MATH 231B,A00,098032,Zlatos; Andrej,11,0,15,4
1668510179582,MATH 240B,A00,098033,Ni; Lei,7,0,15,8
1668510180016,MATH 243,A00,098034,Jekel; David Andrew,10,0,10,0
1668510180441,MATH 245A,A00,098035,Nie; Jiawang,0,4,15,18
1668510180874,MATH 248,A00,098036,Bejenaru; Ioan,10,0,10,0
1668510181304,MATH 250B,A00,098037,Spolaor; Luca,14,0,15,1
1668510181725,MATH 258,A00,098038,Ni; Lei,9,0,10,1
1668510182154,MATH 264B,A00,098041,Rhoades; Brendon Patrick,8,0,15,7
1668510182582,MATH 268,A00,098042,Buss; Samuel R,10,0,10,0
1668510183008,MATH 269,A00,098043,Rhoades; Brendon Patrick,10,0,10,0
1668510183439,MATH 270B,A00,098044,Li; Bo,6,0,15,9
1668510183864,MATH 272B,A00,098045,Holst; Michael J,13,0,15,2
1668510184289,MATH 273A,A00,098046,Tian; Xiaochuan,10,0,15,5
1668510184717,MATH 275,A01,098048,Tian; Xiaochuan,6,0,10,4
1668510185141,MATH 278A,A00,098049,Holst; Michael J,7,0,10,3
1668510185569,MATH 278B,A00,098050,Cloninger; Alexander,10,0,10,0
1668510186090,MATH 278C,A00,098051,Nie; Jiawang,5,0,10,5
1668510186512,MATH 280B,A00,098052,Zheng; Tianyi,7,0,15,8
1668510186942,MATH 281B,A00,098053,Bradic; Jelena,0,2,15,15
1668510187368,MATH 282B,A00,098054,Arias-Castro; Ery,0,1,15,15
1668510187796,MATH 285,A00,098055,Fitzsimmons; Patrick J,0,3,15,17
1668510188221,MATH 287B,A00,098056,Arias-Castro; Ery,1,0,15,14
1668510188651,MATH 288,A00,098057,Agarwal; Pooja,9,0,10,1
1668510188651,MATH 288,B00,098058,Zhang; Danna,8,0,10,2
1668510188651,MATH 288,C00,098059,Williams; Ruth J,9,0,10,1
1668510189087,MATH 290B,A00,098060,Roberts; Justin Deritter,12,0,15,3
1668510189510,MATH 292,A00,098061,Belmont; Eva Kinoshita,10,0,10,0
1668510189937,MATH 295,A00,098062,Suk; Andrew Hoon,47,0,50,3
1668510190361,MATH 296,A00,098063,Novak; Jonathan I,20,0,20,0
1668510190789,MATH 297,001,098064,Gamst; Anthony Collins,9997,0,9999,2
1668510693774,COGS 205,A00,101395,Chiba; Andrea,19,0,20,1
1668510694207,COGS 210B,001,101404,Greene; Deanna Jacquelyn,9998,0,9999,1
1668510694207,COGS 210B,002,101417,Xia; Haijun,9999,0,9999,0
1668510694207,COGS 210B,003,101422,Nitz; Douglas A.,9999,0,9999,0
1668510694207,COGS 210B,004,101423,Hollan; James D.,9998,0,9999,1
1668510694207,COGS 210B,005,101424,Deak; Gedeon O.,9998,0,9999,1
1668510694207,COGS 210B,006,101425,Rossano; Federico,9999,0,9999,0
1668510694634,COGS 211B,A00,101427,Coulson; Seana M,9996,0,9999,3
1668510695060,COGS 220,A00,101428,Hollan; James D.,0,10,25,25
1668510695495,COGS 229,A00,101429,Dow; Steven P,17,0,25,8
1668510695918,COGS 230,A00,101430,Klemmer; Scott R,7,0,17,10
1668510696343,COGS 234,A00,101431,Xia; Haijun,1,0,25,24
1668510696774,COGS 260,A00,101432,Kiyonaga; Anastasia,21,0,25,4
1668510696774,COGS 260,B00,101433,Kirsh; David Joel,15,0,25,10
1668510697209,CSE 202,A00,102371,Impagliazzo; Russell,0,65,0,0
1668510697647,CSE 203B,A01,102373,Cheng; Chung Kuan,0,58,0,0
1668510698076,CSE 208,A00,102374,Micciancio; Daniele,0,5,0,0
1668510698501,CSE 209A,A00,112895,Impagliazzo; Russell,0,12,15,15
1668510698928,CSE 209B,A00,108005,Bellare; Mihir,0,7,0,0
1668510699367,CSE 210,A00,113163,Coblenz; Michael J,0,84,0,0
1668510699792,CSE 219,A00,106111,Dow; Steven P,0,6,20,20
1668510700227,CSE 221,A00,102376,Voelker; Geoffrey M.,0,72,0,0
1668510700670,CSE 224,A01,102378,Porter; George M,0,166,0,0
1668510701094,CSE 229A,A00,102379,Savage; Stefan,0,10,0,0
1668510701517,CSE 229C,A00,102380,Munyaka; Imani N. S.,0,10,0,0
1668510701952,CSE 232B,A00,102382,Deutsch; Alin Bernard,0,32,0,0
1668510702382,CSE 234,A01,112904,Kumar; Arun Kumar,0,0,0,0
1668510702815,CSE 237A,A00,102383,Rosing; Tajana Simunic,0,55,0,0
1668510703240,CSE 239A,A00,102384,Deutsch; Alin Bernard,0,14,0,0
1668510703667,CSE 239B,A00,102385,Polikarpova; Nadezhda,0,10,0,0
1668510704093,CSE 240A,A00,102386,Pannuto; Patrick William,0,46,0,0
1668510704521,CSE 240B,A00,102387,Zhao; Jishen,0,47,0,0
1668510704949,CSE 241A,A00,106406,Kang; Mingu,0,9,0,0
1668510705374,CSE 249B,A00,102388,Kahng; Andrew Byun,0,5,8,8
1668510705803,CSE 251B,A01,102392,Cottrell; Garrison W,0,51,0,0
1668510705803,CSE 251B,A02,102393,Cottrell; Garrison W,0,34,0,0
1668510706235,CSE 252B,A00,102394,Ochoa; Benjamin Lawrence,0,59,0,0
1668510706665,CSE 257,A01,102396,Gao; Sicun,0,139,0,0
1668510707090,CSE 272,A00,102397,Li; Tzumao,0,19,0,0
1668510707517,CSE 274,A00,111323,Chern; Albert Ren-Haur,0,15,0,0
1668510708043,CSE 282,A00,102398,Pevzner; Pavel Arkadjevich,0,0,0,0
1668510708480,CSE 284,A00,114175,Gymrek; Melissa Ann,0,22,0,0
1668510708904,CSE 290,A00,102399,Chandraker; Manmohan Krishna,0,11,0,0
1668510708904,CSE 290,B00,102400,Vaccaro; Kristen Marie,0,7,25,25
1668510708904,CSE 290,C00,102414,Pannuto; Patrick William,0,1,25,25
1668510708904,CSE 290,D00,102427,Pevzner; Pavel Arkadjevich,0,0,0,0
1668510708904,CSE 290,E00,102429,Zhao; Jishen,0,4,0,0
1668510708904,CSE 290,F00,102436,Tullsen; Dean Michael,0,5,0,0
1668510708904,CSE 290,G00,102440,Christensen; Henrik I,0,6,20,20
1668510709332,CSE 291,A00,102443,Su; Hao,0,0,0,0
1668510709332,CSE 291,B00,102448,Polikarpova; Nadezhda,0,0,0,0
1668510709332,CSE 291,C00,102453,Vaccaro; Kristen Marie,0,0,0,0
1668510709332,CSE 291,D00,111343,Savage; Stefan,0,0,0,0
1668510709332,CSE 291,E00,116474,Claffy; Kimberly Claire,0,0,0,0
1668510709332,CSE 291,F00,116479,Pasquale; Joseph,0,0,0,0
1668510709777,CSE 293,001,119111,Bafna; Vineet,9999,0,9999,0
1668510709777,CSE 293,002,119118,Bellare; Mihir,9999,0,9999,0
1668510709777,CSE 293,003,119122,Berg-Kirkpatrick; Taylor D,9999,0,9999,0
1668510709777,CSE 293,004,119135,Christensen; Henrik I,9999,0,9999,0
1668510709777,CSE 293,005,119142,Cottrell; Garrison W,9999,0,9999,0
1668510709777,CSE 293,006,119146,Deutsch; Alin Bernard,9999,0,9999,0
1668510709777,CSE 293,007,119159,Esmaeilzadeh; Hadi,9999,0,9999,0
1668510709777,CSE 293,008,119166,Freund; Yoav,9999,0,9999,0
1668510709777,CSE 293,009,119170,Griswold; William G.,9999,0,9999,0
1668510709777,CSE 293,010,119183,Gymrek; Melissa Ann,9999,0,9999,0
1668510709777,CSE 293,011,119190,Heninger; Nadia A,9999,0,9999,0
1668510709777,CSE 293,012,119230,Impagliazzo; Russell,9999,0,9999,0
1668510709777,CSE 293,013,119232,Jhala; Ranjit,9999,0,9999,0
1668510709777,CSE 293,014,119233,Kahng; Andrew Byun,9999,0,9999,0
1668510709777,CSE 293,015,119298,Kane; Daniel Mertz,9999,0,9999,0
1668510709777,CSE 293,016,119299,Kriegman; David J,9999,0,9999,0
1668510709777,CSE 293,017,119300,Kumar; Arun Kumar,9999,0,9999,0
1668510709777,CSE 293,018,119301,Lerner; Sorin,9999,0,9999,0
1668510709777,CSE 293,019,119302,Lovett; Shachar,9999,0,9999,0
1668510709777,CSE 293,020,119303,McAuley; Julian John,9999,0,9999,0
1668510709777,CSE 293,021,119304,Micciancio; Daniele,9999,0,9999,0
1668510709777,CSE 293,022,119367,Orailoglu; Alex,9999,0,9999,0
1668510709777,CSE 293,023,119382,Paturi; Ramamohan,9999,0,9999,0
1668510709777,CSE 293,024,119404,Polikarpova; Nadezhda,9999,0,9999,0
1668510709777,CSE 293,025,119406,Politz; Joseph Gibbs,9999,0,9999,0
1668510709777,CSE 293,026,119411,Porter; George M,9999,0,9999,0
1668510709777,CSE 293,027,119414,Porter; Leonard Emerson,9999,0,9999,0
1668510709777,CSE 293,028,119416,Ramamoorthi; Ravi,9999,0,9999,0
1668510709777,CSE 293,029,119417,Sahoo; Debashis,9999,0,9999,0
1668510709777,CSE 293,030,119420,Saul; Lawrence,9999,0,9999,0
1668510709777,CSE 293,031,119421,Savage; Stefan,9999,0,9999,0
1668510709777,CSE 293,032,119425,Schulze; Jurgen P.,9999,0,9999,0
1668510709777,CSE 293,033,119426,Snoeren; Alex C.,9999,0,9999,0
1668510709777,CSE 293,034,119428,Shang; Jingbo,9999,0,9999,0
1668510709777,CSE 293,035,119430,Stefan; Deian,9999,0,9999,0
1668510709777,CSE 293,036,119431,Su; Hao,9999,0,9999,0
1668510709777,CSE 293,037,119433,Swanson; Steven James,9999,0,9999,0
1668510709777,CSE 293,038,119435,Tullsen; Dean Michael,9999,0,9999,0
1668510709777,CSE 293,039,119483,Voelker; Geoffrey M.,9999,0,9999,0
1668510709777,CSE 293,040,119537,Zhao; Jishen,9999,0,9999,0
1668510709777,CSE 293,041,119538,Zhou; Yuan-Yuan,9999,0,9999,0
1668510709777,CSE 293,042,119539,Gao; Sicun,9999,0,9999,0
1668510709777,CSE 293,043,119540,Weibel; Nadir,9999,0,9999,0
1668510709777,CSE 293,044,119541,Gupta; Rajesh K.,9999,0,9999,0
1668510709777,CSE 293,045,126410,Vaccaro; Kristen Marie,9999,0,9999,0
1668510709777,CSE 293,046,126411,Klemke; Richard,9999,0,9999,0
1668510710205,CSE 294,A00,102459,Voelker; Geoffrey M.,0,2,0,0
1668510710205,CSE 294,B00,111322,Orailoglu; Alex,0,2,0,0
1668510710634,DSE 201,A00,096914,Deutsch; Alin Bernard,30,0,30,0
1668510711058,DSE 210,A00,096915,Dasgupta; Sanjoy,30,0,30,0
1668510711486,DSE 260A,A00,096916,Altintas De Callaf; Ilkay,30,0,30,0
1668510711940,ECE 200,001,103586,Antipa; Nicholas A,9999,0,9999,0
1668510711940,ECE 200,002,103587,Atanasov; Nikolay A.,9999,0,9999,0
1668510711940,ECE 200,003,103588,Bharadia; Dinesh,9999,0,9999,0
1668510711940,ECE 200,004,103589,Cheng; Chung Kuan,9999,0,9999,0
1668510711940,ECE 200,005,103590,Cosman; Pamela C.,9999,0,9999,0
1668510711940,ECE 200,006,103591,Dayeh; Shadi Ahmad,9999,0,9999,0
1668510711940,ECE 200,007,103592,Fainman; Yeshaiahu,9999,0,9999,0
1668510711940,ECE 200,008,103593,Ford; Joseph Earl,9999,0,9999,0
1668510711940,ECE 200,009,103594,Franceschetti; Massimo,9999,0,9999,0
1668510711940,ECE 200,010,103595,Fullerton; Eric E,9999,0,9999,0
1668510711940,ECE 200,011,103596,Galton; Ian A,9999,0,9999,0
1668510711940,ECE 200,012,103597,Gilja; Vikash,9999,0,9999,0
1668510711940,ECE 200,013,103598,Hall; Drew A.,9999,0,9999,0
1668510711940,ECE 200,014,103599,Hsueh; Tzu-Chien,9999,0,9999,0
1668510711940,ECE 200,015,103600,Javidi; Tara,9999,0,9999,0
1668510711940,ECE 200,016,103601,Kahng; Andrew Byun,9999,0,9999,0
1668510711940,ECE 200,017,103602,Kim; Young-Han,9999,0,9999,0
1668510711940,ECE 200,018,103603,Koushanfar; Farinaz,9999,0,9999,0
1668510711940,ECE 200,019,103604,Kuzum; Duygu,9999,0,9999,0
1668510711940,ECE 200,020,103605,Le; Hanh-Phuc,9999,0,9999,0
1668510711940,ECE 200,021,103606,Lin; Bill,9999,0,9999,0
1668510711940,ECE 200,022,103607,Liu; Zhaowei,9998,0,9999,1
1668510711940,ECE 200,023,103608,Lo; Yu-Hwa,9999,0,9999,0
1668510711940,ECE 200,024,103609,Lomakin; Vitaliy,9999,0,9999,0
1668510711940,ECE 200,025,103610,Mercier; Patrick Philip,9999,0,9999,0
1668510711940,ECE 200,026,103611,Meyer; Florian,9999,0,9999,0
1668510711940,ECE 200,027,103612,Milstein; Laurence B.,9999,0,9999,0
1668510711940,ECE 200,028,103613,Mir Arabbaygi; Siavash,9999,0,9999,0
1668510711940,ECE 200,029,103614,Mookherjea; Shayan,9999,0,9999,0
1668510711940,ECE 200,030,103615,Morris; Karcher William,9999,0,9999,0
1668510711940,ECE 200,031,103616,Ng; Tse Nga,9999,0,9999,0
1668510711940,ECE 200,032,103617,Nguyen; Truong Quang,9999,0,9999,0
1668510711940,ECE 200,033,103618,Nomura; Kenji,9999,0,9999,0
1668510711940,ECE 200,034,103619,Orlitsky; Alon,9999,0,9999,0
1668510711940,ECE 200,035,103620,Pal; Piya,9999,0,9999,0
1668510711940,ECE 200,036,103621,Papen; George C.,9999,0,9999,0
1668510711940,ECE 200,037,103622,Radic; Stojan,9999,0,9999,0
1668510711940,ECE 200,038,103623,Rao; Bhaskar D.,9999,0,9999,0
1668510711940,ECE 200,039,103624,Rao; Ramesh R,9999,0,9999,0
1668510711940,ECE 200,040,103625,Rebeiz; Gabriel,9999,0,9999,0
1668510711940,ECE 200,041,103626,Sanford; John R,9999,0,9999,0
1668510711940,ECE 200,042,103627,Siegel; Paul H.,9999,0,9999,0
1668510711940,ECE 200,043,103628,Sievenpiper; Daniel F.,9999,0,9999,0
1668510711940,ECE 200,044,103629,Sworder; David D.,9999,0,9999,0
1668510711940,ECE 200,045,103630,Taur; Yuan,9999,0,9999,0
1668510711940,ECE 200,046,103631,Touri; Behrouz,9999,0,9999,0
1668510711940,ECE 200,047,103632,Trivedi; Mohan M.,9999,0,9999,0
1668510711940,ECE 200,048,103633,Vasconcelos; Nuno,9999,0,9999,0
1668510711940,ECE 200,049,103634,Wang; Xiaolong,9999,0,9999,0
1668510711940,ECE 200,050,103635,Xie; Pengtao,9999,0,9999,0
1668510711940,ECE 200,051,103636,Yip; Michael,9999,0,9999,0
1668510711940,ECE 200,052,103637,Zeger; Kenneth A.,999,0,999,0
1668510711940,ECE 200,053,103638,Zhang; Xinyu,9999,0,9999,0
1668510711940,ECE 200,054,103639,Turakhia; Yatish Girish,9999,0,9999,0
1668510711940,ECE 200,055,103640,Kang; Mingu,9999,0,9999,0
1668510711940,ECE 200,056,103641,Shi; Yuanyuan,9999,0,9999,0
1668510711940,ECE 200,057,103642,Wang; Edward Jay,9999,0,9999,0
1668510711940,ECE 200,058,103643,Zheng; Yang,9999,0,9999,0
1668510712365,ECE 202,A00,103644,Kuzum; Duygu,0,44,0,0
1668510712796,ECE 212BN,A00,103646,Ng; Tse Nga,0,9,0,0
1668510713221,ECE 221,A00,111493,Staff,0,0,0,0
1668510713649,ECE 222B,A00,103647,Lomakin; Vitaliy,0,20,0,0
1668510714072,ECE 230B,A00,103648,Taur; Yuan,0,3,0,0
1668510714503,ECE 238B,A00,103649,Garay; Javier,0,0,0,0
1668510714930,ECE 240B,A00,112900,Fainman; Yeshaiahu,0,7,0,0
1668510715362,ECE 247A,A00,103650,Jokerst; Jesse Vincent,0,6,0,0
1668510715790,ECE 247B,A00,103651,Wang; Joseph,0,14,0,0
1668510716214,ECE 250,A00,103652,Siegel; Paul H.,0,82,0,0
1668510716638,ECE 251A,A00,103654,Rao; Bhaskar D.,0,61,0,0
1668510717061,ECE 257B,A00,103655,Bharadia; Dinesh,0,32,0,0
1668510717490,ECE 258A,A00,103656,Milstein; Laurence B.,0,29,0,0
1668510717915,ECE 260B,A00,103658,Kang; Mingu,0,119,0,0
1668510718344,ECE 264A,A00,103659,Galton; Ian A,0,65,0,0
1668510718767,ECE 265A,A00,103661,Gudem; Prasad S.S.,0,70,0,0
1668510719195,ECE 265D,A00,103662,Gudem; Prasad S.S.,0,26,0,0
1668510719618,ECE 268,A00,103663,Koushanfar; Farinaz,0,43,0,0
1668510720049,ECE 269,A01,103665,Pal; Piya,0,215,0,0
1668510720489,ECE 271B,A00,103666,Vasconcelos; Manuela,0,76,0,0
1668510720913,ECE 276A,A00,103667,Atanasov; Nikolay A.,0,126,0,0
1668510721336,ECE 277,A00,103668,An; Cheolhong,0,149,0,0
1668510721759,ECE 279,A00,117947,Hall; Drew A.,0,22,0,0
1668510722618,ECE 283,A00,103670,Hsueh; Tzu-Chien,0,53,0,0
1668510723041,ECE 284,A00,103671,Turakhia; Yatish Girish,0,39,0,0
1668510723484,ECE 285,A00,103672,Zheng; Yang,0,39,0,0
1668510723484,ECE 285,B00,103673,Sworder; David D.,0,57,0,0
1668510723907,ECE 287,A00,103676,Javidi; Tara,0,9,0,0
1668510724332,MATH 200B,A00,098023,Salehi Golsefidy; Alireza,10,0,15,5
1668510724761,MATH 202B,A00,098024,Rhoades; Brendon Patrick,7,0,15,8
1668510725192,MATH 203B,A00,098025,Oprea; Dragos N.,9,0,15,6
1668510725618,MATH 204B,A00,098026,Sorensen; Claus M,13,0,15,2
1668510726042,MATH 208,A00,098027,Izadi; Elham,7,0,10,3
1668510726472,MATH 209,A00,098028,Pollack; Aaron,10,0,10,0
1668510726896,MATH 211A,A00,112919,Rogalski; Daniel,8,0,10,2
1668510727323,MATH 211B,A00,112920,Seward; Brandon M.,9,0,10,1
1668510727756,MATH 218,A00,098029,Li; Bo,10,0,10,0
1668510728181,MATH 220B,A00,098030,Novak; Jonathan I,11,0,15,4
1668510728614,MATH 221A,A00,098031,Ebenfelt; Peter F,12,0,15,3
1668510729039,MATH 231B,A00,098032,Zlatos; Andrej,11,0,15,4
1668510729469,MATH 240B,A00,098033,Ni; Lei,7,0,15,8
1668510729893,MATH 243,A00,098034,Jekel; David Andrew,10,0,10,0
1668510730318,MATH 245A,A00,098035,Nie; Jiawang,0,4,15,18
1668510730752,MATH 248,A00,098036,Bejenaru; Ioan,10,0,10,0
1668510731177,MATH 250B,A00,098037,Spolaor; Luca,14,0,15,1
1668510731605,MATH 258,A00,098038,Ni; Lei,9,0,10,1
1668510732029,MATH 264B,A00,098041,Rhoades; Brendon Patrick,8,0,15,7
1668510732456,MATH 268,A00,098042,Buss; Samuel R,10,0,10,0
1668510732886,MATH 269,A00,098043,Rhoades; Brendon Patrick,10,0,10,0
1668510733327,MATH 270B,A00,098044,Li; Bo,6,0,15,9
1668510733762,MATH 272B,A00,098045,Holst; Michael J,13,0,15,2
1668510734188,MATH 273A,A00,098046,Tian; Xiaochuan,10,0,15,5
1668510734615,MATH 275,A01,098048,Tian; Xiaochuan,6,0,10,4
1668510735047,MATH 278A,A00,098049,Holst; Michael J,7,0,10,3
1668510735488,MATH 278B,A00,098050,Cloninger; Alexander,10,0,10,0
1668510735922,MATH 278C,A00,098051,Nie; Jiawang,5,0,10,5
1668510736348,MATH 280B,A00,098052,Zheng; Tianyi,7,0,15,8
1668510736774,MATH 281B,A00,098053,Bradic; Jelena,0,2,15,15
1668510737208,MATH 282B,A00,098054,Arias-Castro; Ery,0,1,15,15
1668510737632,MATH 285,A00,098055,Fitzsimmons; Patrick J,0,3,15,17
1668510738055,MATH 287B,A00,098056,Arias-Castro; Ery,1,0,15,14
1668510738478,MATH 288,A00,098057,Agarwal; Pooja,9,0,10,1
1668510738478,MATH 288,B00,098058,Zhang; Danna,8,0,10,2
1668510738478,MATH 288,C00,098059,Williams; Ruth J,9,0,10,1
1668510738906,MATH 290B,A00,098060,Roberts; Justin Deritter,12,0,15,3
1668510739346,MATH 292,A00,098061,Belmont; Eva Kinoshita,10,0,10,0
1668510739780,MATH 295,A00,098062,Suk; Andrew Hoon,47,0,50,3
1668510740204,MATH 296,A00,098063,Novak; Jonathan I,20,0,20,0
1668510740628,MATH 297,001,098064,Gamst; Anthony Collins,9997,0,9999,2
1668511243145,COGS 205,A00,101395,Chiba; Andrea,19,0,20,1
1668511243571,COGS 210B,001,101404,Greene; Deanna Jacquelyn,9998,0,9999,1
1668511243571,COGS 210B,002,101417,Xia; Haijun,9999,0,9999,0
1668511243571,COGS 210B,003,101422,Nitz; Douglas A.,9999,0,9999,0
1668511243571,COGS 210B,004,101423,Hollan; James D.,9998,0,9999,1
1668511243571,COGS 210B,005,101424,Deak; Gedeon O.,9998,0,9999,1
1668511243571,COGS 210B,006,101425,Rossano; Federico,9999,0,9999,0
1668511243995,COGS 211B,A00,101427,Coulson; Seana M,9996,0,9999,3
1668511244424,COGS 220,A00,101428,Hollan; James D.,0,10,25,25
1668511244847,COGS 229,A00,101429,Dow; Steven P,17,0,25,8
1668511245276,COGS 230,A00,101430,Klemmer; Scott R,7,0,17,10
1668511245702,COGS 234,A00,101431,Xia; Haijun,1,0,25,24
1668511246128,COGS 260,A00,101432,Kiyonaga; Anastasia,21,0,25,4
1668511246128,COGS 260,B00,101433,Kirsh; David Joel,15,0,25,10
1668511246553,CSE 202,A00,102371,Impagliazzo; Russell,0,65,0,0
1668511246977,CSE 203B,A01,102373,Cheng; Chung Kuan,0,58,0,0
1668511247406,CSE 208,A00,102374,Micciancio; Daniele,0,5,0,0
1668511247833,CSE 209A,A00,112895,Impagliazzo; Russell,0,12,15,15
1668511248261,CSE 209B,A00,108005,Bellare; Mihir,0,7,0,0
1668511248687,CSE 210,A00,113163,Coblenz; Michael J,0,84,0,0
1668511249111,CSE 219,A00,106111,Dow; Steven P,0,6,20,20
1668511249540,CSE 221,A00,102376,Voelker; Geoffrey M.,0,72,0,0
1668511249969,CSE 224,A01,102378,Porter; George M,0,166,0,0
1668511250394,CSE 229A,A00,102379,Savage; Stefan,0,10,0,0
1668511250817,CSE 229C,A00,102380,Munyaka; Imani N. S.,0,10,0,0
1668511251240,CSE 232B,A00,102382,Deutsch; Alin Bernard,0,32,0,0
1668511251669,CSE 234,A01,112904,Kumar; Arun Kumar,0,0,0,0
1668511252098,CSE 237A,A00,102383,Rosing; Tajana Simunic,0,55,0,0
1668511252527,CSE 239A,A00,102384,Deutsch; Alin Bernard,0,14,0,0
1668511252953,CSE 239B,A00,102385,Polikarpova; Nadezhda,0,10,0,0
1668511253377,CSE 240A,A00,102386,Pannuto; Patrick William,0,46,0,0
1668511253802,CSE 240B,A00,102387,Zhao; Jishen,0,47,0,0
1668511254228,CSE 241A,A00,106406,Kang; Mingu,0,9,0,0
1668511254654,CSE 249B,A00,102388,Kahng; Andrew Byun,0,5,8,8
1668511255078,CSE 251B,A01,102392,Cottrell; Garrison W,0,51,0,0
1668511255078,CSE 251B,A02,102393,Cottrell; Garrison W,0,34,0,0
1668511255505,CSE 252B,A00,102394,Ochoa; Benjamin Lawrence,0,59,0,0
1668511255932,CSE 257,A01,102396,Gao; Sicun,0,139,0,0
1668511256357,CSE 272,A00,102397,Li; Tzumao,0,19,0,0
1668511256782,CSE 274,A00,111323,Chern; Albert Ren-Haur,0,15,0,0
1668511257205,CSE 282,A00,102398,Pevzner; Pavel Arkadjevich,0,0,0,0
1668511257635,CSE 284,A00,114175,Gymrek; Melissa Ann,0,22,0,0
1668511258068,CSE 290,A00,102399,Chandraker; Manmohan Krishna,0,11,0,0
1668511258068,CSE 290,B00,102400,Vaccaro; Kristen Marie,0,7,25,25
1668511258068,CSE 290,C00,102414,Pannuto; Patrick William,0,1,25,25
1668511258068,CSE 290,D00,102427,Pevzner; Pavel Arkadjevich,0,0,0,0
1668511258068,CSE 290,E00,102429,Zhao; Jishen,0,4,0,0
1668511258068,CSE 290,F00,102436,Tullsen; Dean Michael,0,5,0,0
1668511258068,CSE 290,G00,102440,Christensen; Henrik I,0,6,20,20
1668511258497,CSE 291,A00,102443,Su; Hao,0,0,0,0
1668511258497,CSE 291,B00,102448,Polikarpova; Nadezhda,0,0,0,0
1668511258497,CSE 291,C00,102453,Vaccaro; Kristen Marie,0,0,0,0
1668511258497,CSE 291,D00,111343,Savage; Stefan,0,0,0,0
1668511258497,CSE 291,E00,116474,Claffy; Kimberly Claire,0,0,0,0
1668511258497,CSE 291,F00,116479,Pasquale; Joseph,0,0,0,0
1668511258963,CSE 293,001,119111,Bafna; Vineet,9999,0,9999,0
1668511258963,CSE 293,002,119118,Bellare; Mihir,9999,0,9999,0
1668511258963,CSE 293,003,119122,Berg-Kirkpatrick; Taylor D,9999,0,9999,0
1668511258963,CSE 293,004,119135,Christensen; Henrik I,9999,0,9999,0
1668511258963,CSE 293,005,119142,Cottrell; Garrison W,9999,0,9999,0
1668511258963,CSE 293,006,119146,Deutsch; Alin Bernard,9999,0,9999,0
1668511258963,CSE 293,007,119159,Esmaeilzadeh; Hadi,9999,0,9999,0
1668511258963,CSE 293,008,119166,Freund; Yoav,9999,0,9999,0
1668511258963,CSE 293,009,119170,Griswold; William G.,9999,0,9999,0
1668511258963,CSE 293,010,119183,Gymrek; Melissa Ann,9999,0,9999,0
1668511258963,CSE 293,011,119190,Heninger; Nadia A,9999,0,9999,0
1668511258963,CSE 293,012,119230,Impagliazzo; Russell,9999,0,9999,0
1668511258963,CSE 293,013,119232,Jhala; Ranjit,9999,0,9999,0
1668511258963,CSE 293,014,119233,Kahng; Andrew Byun,9999,0,9999,0
1668511258963,CSE 293,015,119298,Kane; Daniel Mertz,9999,0,9999,0
1668511258963,CSE 293,016,119299,Kriegman; David J,9999,0,9999,0
1668511258963,CSE 293,017,119300,Kumar; Arun Kumar,9999,0,9999,0
1668511258963,CSE 293,018,119301,Lerner; Sorin,9999,0,9999,0
1668511258963,CSE 293,019,119302,Lovett; Shachar,9999,0,9999,0
1668511258963,CSE 293,020,119303,McAuley; Julian John,9999,0,9999,0
1668511258963,CSE 293,021,119304,Micciancio; Daniele,9999,0,9999,0
1668511258963,CSE 293,022,119367,Orailoglu; Alex,9999,0,9999,0
1668511258963,CSE 293,023,119382,Paturi; Ramamohan,9999,0,9999,0
1668511258963,CSE 293,024,119404,Polikarpova; Nadezhda,9999,0,9999,0
1668511258963,CSE 293,025,119406,Politz; Joseph Gibbs,9999,0,9999,0
1668511258963,CSE 293,026,119411,Porter; George M,9999,0,9999,0
1668511258963,CSE 293,027,119414,Porter; Leonard Emerson,9999,0,9999,0
1668511258963,CSE 293,028,119416,Ramamoorthi; Ravi,9999,0,9999,0
1668511258963,CSE 293,029,119417,Sahoo; Debashis,9999,0,9999,0
1668511258963,CSE 293,030,119420,Saul; Lawrence,9999,0,9999,0
1668511258963,CSE 293,031,119421,Savage; Stefan,9999,0,9999,0
1668511258963,CSE 293,032,119425,Schulze; Jurgen P.,9999,0,9999,0
1668511258963,CSE 293,033,119426,Snoeren; Alex C.,9999,0,9999,0
1668511258963,CSE 293,034,119428,Shang; Jingbo,9999,0,9999,0
1668511258963,CSE 293,035,119430,Stefan; Deian,9999,0,9999,0
1668511258963,CSE 293,036,119431,Su; Hao,9999,0,9999,0
1668511258963,CSE 293,037,119433,Swanson; Steven James,9999,0,9999,0
1668511258963,CSE 293,038,119435,Tullsen; Dean Michael,9999,0,9999,0
1668511258963,CSE 293,039,119483,Voelker; Geoffrey M.,9999,0,9999,0
1668511258963,CSE 293,040,119537,Zhao; Jishen,9999,0,9999,0
1668511258963,CSE 293,041,119538,Zhou; Yuan-Yuan,9999,0,9999,0
1668511258963,CSE 293,042,119539,Gao; Sicun,9999,0,9999,0
1668511258963,CSE 293,043,119540,Weibel; Nadir,9999,0,9999,0
1668511258963,CSE 293,044,119541,Gupta; Rajesh K.,9999,0,9999,0
1668511258963,CSE 293,045,126410,Vaccaro; Kristen Marie,9999,0,9999,0
1668511258963,CSE 293,046,126411,Klemke; Richard,9999,0,9999,0
1668511259387,CSE 294,A00,102459,Voelker; Geoffrey M.,0,2,0,0
1668511259387,CSE 294,B00,111322,Orailoglu; Alex,0,2,0,0
1668511259818,DSE 201,A00,096914,Deutsch; Alin Bernard,30,0,30,0
1668511260246,DSE 210,A00,096915,Dasgupta; Sanjoy,30,0,30,0
1668511260673,DSE 260A,A00,096916,Altintas De Callaf; Ilkay,30,0,30,0
1668511261129,ECE 200,001,103586,Antipa; Nicholas A,9999,0,9999,0
1668511261129,ECE 200,002,103587,Atanasov; Nikolay A.,9999,0,9999,0
1668511261129,ECE 200,003,103588,Bharadia; Dinesh,9999,0,9999,0
1668511261129,ECE 200,004,103589,Cheng; Chung Kuan,9999,0,9999,0
1668511261129,ECE 200,005,103590,Cosman; Pamela C.,9999,0,9999,0
1668511261129,ECE 200,006,103591,Dayeh; Shadi Ahmad,9999,0,9999,0
1668511261129,ECE 200,007,103592,Fainman; Yeshaiahu,9999,0,9999,0
1668511261129,ECE 200,008,103593,Ford; Joseph Earl,9999,0,9999,0
1668511261129,ECE 200,009,103594,Franceschetti; Massimo,9999,0,9999,0
1668511261129,ECE 200,010,103595,Fullerton; Eric E,9999,0,9999,0
1668511261129,ECE 200,011,103596,Galton; Ian A,9999,0,9999,0
1668511261129,ECE 200,012,103597,Gilja; Vikash,9999,0,9999,0
1668511261129,ECE 200,013,103598,Hall; Drew A.,9999,0,9999,0
1668511261129,ECE 200,014,103599,Hsueh; Tzu-Chien,9999,0,9999,0
1668511261129,ECE 200,015,103600,Javidi; Tara,9999,0,9999,0
1668511261129,ECE 200,016,103601,Kahng; Andrew Byun,9999,0,9999,0
1668511261129,ECE 200,017,103602,Kim; Young-Han,9999,0,9999,0
1668511261129,ECE 200,018,103603,Koushanfar; Farinaz,9999,0,9999,0
1668511261129,ECE 200,019,103604,Kuzum; Duygu,9999,0,9999,0
1668511261129,ECE 200,020,103605,Le; Hanh-Phuc,9999,0,9999,0
1668511261129,ECE 200,021,103606,Lin; Bill,9999,0,9999,0
1668511261129,ECE 200,022,103607,Liu; Zhaowei,9998,0,9999,1
1668511261129,ECE 200,023,103608,Lo; Yu-Hwa,9999,0,9999,0
1668511261129,ECE 200,024,103609,Lomakin; Vitaliy,9999,0,9999,0
1668511261129,ECE 200,025,103610,Mercier; Patrick Philip,9999,0,9999,0
1668511261129,ECE 200,026,103611,Meyer; Florian,9999,0,9999,0
1668511261129,ECE 200,027,103612,Milstein; Laurence B.,9999,0,9999,0
1668511261129,ECE 200,028,103613,Mir Arabbaygi; Siavash,9999,0,9999,0
1668511261129,ECE 200,029,103614,Mookherjea; Shayan,9999,0,9999,0
1668511261129,ECE 200,030,103615,Morris; Karcher William,9999,0,9999,0
1668511261129,ECE 200,031,103616,Ng; Tse Nga,9999,0,9999,0
1668511261129,ECE 200,032,103617,Nguyen; Truong Quang,9999,0,9999,0
1668511261129,ECE 200,033,103618,Nomura; Kenji,9999,0,9999,0
1668511261129,ECE 200,034,103619,Orlitsky; Alon,9999,0,9999,0
1668511261129,ECE 200,035,103620,Pal; Piya,9999,0,9999,0
1668511261129,ECE 200,036,103621,Papen; George C.,9999,0,9999,0
1668511261129,ECE 200,037,103622,Radic; Stojan,9999,0,9999,0
1668511261129,ECE 200,038,103623,Rao; Bhaskar D.,9999,0,9999,0
1668511261129,ECE 200,039,103624,Rao; Ramesh R,9999,0,9999,0
1668511261129,ECE 200,040,103625,Rebeiz; Gabriel,9999,0,9999,0
1668511261129,ECE 200,041,103626,Sanford; John R,9999,0,9999,0
1668511261129,ECE 200,042,103627,Siegel; Paul H.,9999,0,9999,0
1668511261129,ECE 200,043,103628,Sievenpiper; Daniel F.,9999,0,9999,0
1668511261129,ECE 200,044,103629,Sworder; David D.,9999,0,9999,0
1668511261129,ECE 200,045,103630,Taur; Yuan,9999,0,9999,0
1668511261129,ECE 200,046,103631,Touri; Behrouz,9999,0,9999,0
1668511261129,ECE 200,047,103632,Trivedi; Mohan M.,9999,0,9999,0
1668511261129,ECE 200,048,103633,Vasconcelos; Nuno,9999,0,9999,0
1668511261129,ECE 200,049,103634,Wang; Xiaolong,9999,0,9999,0
1668511261129,ECE 200,050,103635,Xie; Pengtao,9999,0,9999,0
1668511261129,ECE 200,051,103636,Yip; Michael,9999,0,9999,0
1668511261129,ECE 200,052,103637,Zeger; Kenneth A.,999,0,999,0
1668511261129,ECE 200,053,103638,Zhang; Xinyu,9999,0,9999,0
1668511261129,ECE 200,054,103639,Turakhia; Yatish Girish,9999,0,9999,0
1668511261129,ECE 200,055,103640,Kang; Mingu,9999,0,9999,0
1668511261129,ECE 200,056,103641,Shi; Yuanyuan,9999,0,9999,0
1668511261129,ECE 200,057,103642,Wang; Edward Jay,9999,0,9999,0
1668511261129,ECE 200,058,103643,Zheng; Yang,9999,0,9999,0
1668511261552,ECE 202,A00,103644,Kuzum; Duygu,0,44,0,0
1668511261977,ECE 212BN,A00,103646,Ng; Tse Nga,0,9,0,0
1668511262412,ECE 221,A00,111493,Staff,0,0,0,0
1668511262842,ECE 222B,A00,103647,Lomakin; Vitaliy,0,20,0,0
1668511263267,ECE 230B,A00,103648,Taur; Yuan,0,3,0,0
1668511263696,ECE 238B,A00,103649,Garay; Javier,0,0,0,0
1668511264121,ECE 240B,A00,112900,Fainman; Yeshaiahu,0,7,0,0
1668511264544,ECE 247A,A00,103650,Jokerst; Jesse Vincent,0,6,0,0
1668511264978,ECE 247B,A00,103651,Wang; Joseph,0,14,0,0
1668511265408,ECE 250,A00,103652,Siegel; Paul H.,0,82,0,0
1668511265836,ECE 251A,A00,103654,Rao; Bhaskar D.,0,61,0,0
1668511266269,ECE 257B,A00,103655,Bharadia; Dinesh,0,32,0,0
1668511266700,ECE 258A,A00,103656,Milstein; Laurence B.,0,29,0,0
1668511267125,ECE 260B,A00,103658,Kang; Mingu,0,119,0,0
1668511267554,ECE 264A,A00,103659,Galton; Ian A,0,65,0,0
1668511267980,ECE 265A,A00,103661,Gudem; Prasad S.S.,0,70,0,0
1668511268404,ECE 265D,A00,103662,Gudem; Prasad S.S.,0,26,0,0
1668511268831,ECE 268,A00,103663,Koushanfar; Farinaz,0,43,0,0
1668511269255,ECE 269,A01,103665,Pal; Piya,0,215,0,0
1668511269680,ECE 271B,A00,103666,Vasconcelos; Manuela,0,76,0,0
1668511270110,ECE 276A,A00,103667,Atanasov; Nikolay A.,0,126,0,0
1668511270535,ECE 277,A00,103668,An; Cheolhong,0,149,0,0
1668511270958,ECE 279,A00,117947,Hall; Drew A.,0,22,0,0
1668511271816,ECE 283,A00,103670,Hsueh; Tzu-Chien,0,53,0,0
1668511272241,ECE 284,A00,103671,Turakhia; Yatish Girish,0,39,0,0
1668511272757,ECE 285,A00,103672,Zheng; Yang,0,39,0,0
1668511272757,ECE 285,B00,103673,Sworder; David D.,0,57,0,0
1668511273181,ECE 287,A00,103676,Javidi; Tara,0,9,0,0
1668511273606,MATH 200B,A00,098023,Salehi Golsefidy; Alireza,10,0,15,5
1668511274032,MATH 202B,A00,098024,Rhoades; Brendon Patrick,7,0,15,8
1668511274456,MATH 203B,A00,098025,Oprea; Dragos N.,9,0,15,6
1668511274879,MATH 204B,A00,098026,Sorensen; Claus M,13,0,15,2
1668511275309,MATH 208,A00,098027,Izadi; Elham,7,0,10,3
1668511275736,MATH 209,A00,098028,Pollack; Aaron,10,0,10,0
1668511276159,MATH 211A,A00,112919,Rogalski; Daniel,8,0,10,2
1668511276585,MATH 211B,A00,112920,Seward; Brandon M.,9,0,10,1
1668511277020,MATH 218,A00,098029,Li; Bo,10,0,10,0
1668511277447,MATH 220B,A00,098030,Novak; Jonathan I,11,0,15,4
1668511277874,MATH 221A,A00,098031,Ebenfelt; Peter F,12,0,15,3
1668511278299,MATH 231B,A00,098032,Zlatos; Andrej,11,0,15,4
1668511278724,MATH 240B,A00,098033,Ni; Lei,7,0,15,8
1668511279149,MATH 243,A00,098034,Jekel; David Andrew,10,0,10,0
1668511279582,MATH 245A,A00,098035,Nie; Jiawang,0,4,15,18
1668511280009,MATH 248,A00,098036,Bejenaru; Ioan,10,0,10,0
1668511280449,MATH 250B,A00,098037,Spolaor; Luca,14,0,15,1
1668511280885,MATH 258,A00,098038,Ni; Lei,9,0,10,1
1668511281322,MATH 264B,A00,098041,Rhoades; Brendon Patrick,8,0,15,7
1668511281746,MATH 268,A00,098042,Buss; Samuel R,10,0,10,0
1668511282173,MATH 269,A00,098043,Rhoades; Brendon Patrick,10,0,10,0
1668511282601,MATH 270B,A00,098044,Li; Bo,6,0,15,9
1668511283033,MATH 272B,A00,098045,Holst; Michael J,13,0,15,2
1668511283462,MATH 273A,A00,098046,Tian; Xiaochuan,10,0,15,5
1668511283885,MATH 275,A01,098048,Tian; Xiaochuan,6,0,10,4
1668511284309,MATH 278A,A00,098049,Holst; Michael J,7,0,10,3
1668511284733,MATH 278B,A00,098050,Cloninger; Alexander,10,0,10,0
1668511285160,MATH 278C,A00,098051,Nie; Jiawang,5,0,10,5
1668511285594,MATH 280B,A00,098052,Zheng; Tianyi,7,0,15,8
1668511286020,MATH 281B,A00,098053,Bradic; Jelena,0,2,15,15
1668511286446,MATH 282B,A00,098054,Arias-Castro; Ery,0,1,15,15
1668511286868,MATH 285,A00,098055,Fitzsimmons; Patrick J,0,3,15,17
1668511287291,MATH 287B,A00,098056,Arias-Castro; Ery,1,0,15,14
1668511287717,MATH 288,A00,098057,Agarwal; Pooja,9,0,10,1
1668511287717,MATH 288,B00,098058,Zhang; Danna,8,0,10,2
1668511287717,MATH 288,C00,098059,Williams; Ruth J,9,0,10,1
1668511288144,MATH 290B,A00,098060,Roberts; Justin Deritter,12,0,15,3
1668511288568,MATH 292,A00,098061,Belmont; Eva Kinoshita,10,0,10,0
1668511288993,MATH 295,A00,098062,Suk; Andrew Hoon,47,0,50,3
1668511289417,MATH 296,A00,098063,Novak; Jonathan I,20,0,20,0
1668511289841,MATH 297,001,098064,Gamst; Anthony Collins,9997,0,9999,2
1668511791471,COGS 205,A00,101395,Chiba; Andrea,19,0,20,1
1668511791899,COGS 210B,001,101404,Greene; Deanna Jacquelyn,9998,0,9999,1
1668511791899,COGS 210B,002,101417,Xia; Haijun,9999,0,9999,0
1668511791899,COGS 210B,003,101422,Nitz; Douglas A.,9999,0,9999,0
1668511791899,COGS 210B,004,101423,Hollan; James D.,9998,0,9999,1
1668511791899,COGS 210B,005,101424,Deak; Gedeon O.,9998,0,9999,1
1668511791899,COGS 210B,006,101425,Rossano; Federico,9999,0,9999,0
1668511792328,COGS 211B,A00,101427,Coulson; Seana M,9996,0,9999,3
1668511792751,COGS 220,A00,101428,Hollan; James D.,0,10,25,25
1668511793278,COGS 229,A00,101429,Dow; Steven P,17,0,25,8
1668511793702,COGS 230,A00,101430,Klemmer; Scott R,7,0,17,10
1668511794125,COGS 234,A00,101431,Xia; Haijun,1,0,25,24
1668511794550,COGS 260,A00,101432,Kiyonaga; Anastasia,21,0,25,4
1668511794550,COGS 260,B00,101433,Kirsh; David Joel,15,0,25,10
1668511794978,CSE 202,A00,102371,Impagliazzo; Russell,0,65,0,0
1668511795409,CSE 203B,A01,102373,Cheng; Chung Kuan,0,58,0,0
1668511795832,CSE 208,A00,102374,Micciancio; Daniele,0,5,0,0
1668511796257,CSE 209A,A00,112895,Impagliazzo; Russell,0,12,15,15
1668511796680,CSE 209B,A00,108005,Bellare; Mihir,0,7,0,0
1668511797104,CSE 210,A00,113163,Coblenz; Michael J,0,84,0,0
1668511797531,CSE 219,A00,106111,Dow; Steven P,0,6,20,20
1668511797958,CSE 221,A00,102376,Voelker; Geoffrey M.,0,72,0,0
1668511798386,CSE 224,A01,102378,Porter; George M,0,166,0,0
1668511798816,CSE 229A,A00,102379,Savage; Stefan,0,10,0,0
1668511799240,CSE 229C,A00,102380,Munyaka; Imani N. S.,0,10,0,0
1668511799669,CSE 232B,A00,102382,Deutsch; Alin Bernard,0,32,0,0
1668511800098,CSE 234,A01,112904,Kumar; Arun Kumar,0,0,0,0
1668511800536,CSE 237A,A00,102383,Rosing; Tajana Simunic,0,55,0,0
1668511800960,CSE 239A,A00,102384,Deutsch; Alin Bernard,0,14,0,0
1668511801392,CSE 239B,A00,102385,Polikarpova; Nadezhda,0,10,0,0
1668511801820,CSE 240A,A00,102386,Pannuto; Patrick William,0,46,0,0
1668511802243,CSE 240B,A00,102387,Zhao; Jishen,0,47,0,0
1668511802682,CSE 241A,A00,106406,Kang; Mingu,0,9,0,0
1668511803105,CSE 249B,A00,102388,Kahng; Andrew Byun,0,5,8,8
1668511803536,CSE 251B,A01,102392,Cottrell; Garrison W,0,51,0,0
1668511803536,CSE 251B,A02,102393,Cottrell; Garrison W,0,34,0,0
1668511803962,CSE 252B,A00,102394,Ochoa; Benjamin Lawrence,0,59,0,0
1668511804388,CSE 257,A01,102396,Gao; Sicun,0,139,0,0
1668511804811,CSE 272,A00,102397,Li; Tzumao,0,19,0,0
1668511805237,CSE 274,A00,111323,Chern; Albert Ren-Haur,0,15,0,0
1668511805660,CSE 282,A00,102398,Pevzner; Pavel Arkadjevich,0,0,0,0
1668511806087,CSE 284,A00,114175,Gymrek; Melissa Ann,0,22,0,0
1668511806513,CSE 290,A00,102399,Chandraker; Manmohan Krishna,0,11,0,0
1668511806513,CSE 290,B00,102400,Vaccaro; Kristen Marie,0,7,25,25
1668511806513,CSE 290,C00,102414,Pannuto; Patrick William,0,1,25,25
1668511806513,CSE 290,D00,102427,Pevzner; Pavel Arkadjevich,0,0,0,0
1668511806513,CSE 290,E00,102429,Zhao; Jishen,0,4,0,0
1668511806513,CSE 290,F00,102436,Tullsen; Dean Michael,0,5,0,0
1668511806513,CSE 290,G00,102440,Christensen; Henrik I,0,6,20,20
1668511806944,CSE 291,A00,102443,Su; Hao,0,0,0,0
1668511806944,CSE 291,B00,102448,Polikarpova; Nadezhda,0,0,0,0
1668511806944,CSE 291,C00,102453,Vaccaro; Kristen Marie,0,0,0,0
1668511806944,CSE 291,D00,111343,Savage; Stefan,0,0,0,0
1668511806944,CSE 291,E00,116474,Claffy; Kimberly Claire,0,0,0,0
1668511806944,CSE 291,F00,116479,Pasquale; Joseph,0,0,0,0
1668511807390,CSE 293,001,119111,Bafna; Vineet,9999,0,9999,0
1668511807390,CSE 293,002,119118,Bellare; Mihir,9999,0,9999,0
1668511807390,CSE 293,003,119122,Berg-Kirkpatrick; Taylor D,9999,0,9999,0
1668511807390,CSE 293,004,119135,Christensen; Henrik I,9999,0,9999,0
1668511807390,CSE 293,005,119142,Cottrell; Garrison W,9999,0,9999,0
1668511807390,CSE 293,006,119146,Deutsch; Alin Bernard,9999,0,9999,0
1668511807390,CSE 293,007,119159,Esmaeilzadeh; Hadi,9999,0,9999,0
1668511807390,CSE 293,008,119166,Freund; Yoav,9999,0,9999,0
1668511807390,CSE 293,009,119170,Griswold; William G.,9999,0,9999,0
1668511807390,CSE 293,010,119183,Gymrek; Melissa Ann,9999,0,9999,0
1668511807390,CSE 293,011,119190,Heninger; Nadia A,9999,0,9999,0
1668511807390,CSE 293,012,119230,Impagliazzo; Russell,9999,0,9999,0
1668511807390,CSE 293,013,119232,Jhala; Ranjit,9999,0,9999,0
1668511807390,CSE 293,014,119233,Kahng; Andrew Byun,9999,0,9999,0
1668511807390,CSE 293,015,119298,Kane; Daniel Mertz,9999,0,9999,0
1668511807390,CSE 293,016,119299,Kriegman; David J,9999,0,9999,0
1668511807390,CSE 293,017,119300,Kumar; Arun Kumar,9999,0,9999,0
1668511807390,CSE 293,018,119301,Lerner; Sorin,9999,0,9999,0
1668511807390,CSE 293,019,119302,Lovett; Shachar,9999,0,9999,0
1668511807390,CSE 293,020,119303,McAuley; Julian John,9999,0,9999,0
1668511807390,CSE 293,021,119304,Micciancio; Daniele,9999,0,9999,0
1668511807390,CSE 293,022,119367,Orailoglu; Alex,9999,0,9999,0
1668511807390,CSE 293,023,119382,Paturi; Ramamohan,9999,0,9999,0
1668511807390,CSE 293,024,119404,Polikarpova; Nadezhda,9999,0,9999,0
1668511807390,CSE 293,025,119406,Politz; Joseph Gibbs,9999,0,9999,0
1668511807390,CSE 293,026,119411,Porter; George M,9999,0,9999,0
1668511807390,CSE 293,027,119414,Porter; Leonard Emerson,9999,0,9999,0
1668511807390,CSE 293,028,119416,Ramamoorthi; Ravi,9999,0,9999,0
1668511807390,CSE 293,029,119417,Sahoo; Debashis,9999,0,9999,0
1668511807390,CSE 293,030,119420,Saul; Lawrence,9999,0,9999,0
1668511807390,CSE 293,031,119421,Savage; Stefan,9999,0,9999,0
1668511807390,CSE 293,032,119425,Schulze; Jurgen P.,9999,0,9999,0
1668511807390,CSE 293,033,119426,Snoeren; Alex C.,9999,0,9999,0
1668511807390,CSE 293,034,119428,Shang; Jingbo,9999,0,9999,0
1668511807390,CSE 293,035,119430,Stefan; Deian,9999,0,9999,0
1668511807390,CSE 293,036,119431,Su; Hao,9999,0,9999,0
1668511807390,CSE 293,037,119433,Swanson; Steven James,9999,0,9999,0
1668511807390,CSE 293,038,119435,Tullsen; Dean Michael,9999,0,9999,0
1668511807390,CSE 293,039,119483,Voelker; Geoffrey M.,9999,0,9999,0
1668511807390,CSE 293,040,119537,Zhao; Jishen,9999,0,9999,0
1668511807390,CSE 293,041,119538,Zhou; Yuan-Yuan,9999,0,9999,0
1668511807390,CSE 293,042,119539,Gao; Sicun,9999,0,9999,0
1668511807390,CSE 293,043,119540,Weibel; Nadir,9999,0,9999,0
1668511807390,CSE 293,044,119541,Gupta; Rajesh K.,9999,0,9999,0
1668511807390,CSE 293,045,126410,Vaccaro; Kristen Marie,9999,0,9999,0
1668511807390,CSE 293,046,126411,Klemke; Richard,9999,0,9999,0
1668511807812,CSE 294,A00,102459,Voelker; Geoffrey M.,0,2,0,0
1668511807812,CSE 294,B00,111322,Orailoglu; Alex,0,2,0,0
1668511808235,DSE 201,A00,096914,Deutsch; Alin Bernard,30,0,30,0
1668511808668,DSE 210,A00,096915,Dasgupta; Sanjoy,30,0,30,0
1668511809092,DSE 260A,A00,096916,Altintas De Callaf; Ilkay,30,0,30,0
1668511809543,ECE 200,001,103586,Antipa; Nicholas A,9999,0,9999,0
1668511809543,ECE 200,002,103587,Atanasov; Nikolay A.,9999,0,9999,0
1668511809543,ECE 200,003,103588,Bharadia; Dinesh,9999,0,9999,0
1668511809543,ECE 200,004,103589,Cheng; Chung Kuan,9999,0,9999,0
1668511809543,ECE 200,005,103590,Cosman; Pamela C.,9999,0,9999,0
1668511809543,ECE 200,006,103591,Dayeh; Shadi Ahmad,9999,0,9999,0
1668511809543,ECE 200,007,103592,Fainman; Yeshaiahu,9999,0,9999,0
1668511809543,ECE 200,008,103593,Ford; Joseph Earl,9999,0,9999,0
1668511809543,ECE 200,009,103594,Franceschetti; Massimo,9999,0,9999,0
1668511809543,ECE 200,010,103595,Fullerton; Eric E,9999,0,9999,0
1668511809543,ECE 200,011,103596,Galton; Ian A,9999,0,9999,0
1668511809543,ECE 200,012,103597,Gilja; Vikash,9999,0,9999,0
1668511809543,ECE 200,013,103598,Hall; Drew A.,9999,0,9999,0
1668511809543,ECE 200,014,103599,Hsueh; Tzu-Chien,9999,0,9999,0
1668511809543,ECE 200,015,103600,Javidi; Tara,9999,0,9999,0
1668511809543,ECE 200,016,103601,Kahng; Andrew Byun,9999,0,9999,0
1668511809543,ECE 200,017,103602,Kim; Young-Han,9999,0,9999,0
1668511809543,ECE 200,018,103603,Koushanfar; Farinaz,9999,0,9999,0
1668511809543,ECE 200,019,103604,Kuzum; Duygu,9999,0,9999,0
1668511809543,ECE 200,020,103605,Le; Hanh-Phuc,9999,0,9999,0
1668511809543,ECE 200,021,103606,Lin; Bill,9999,0,9999,0
1668511809543,ECE 200,022,103607,Liu; Zhaowei,9998,0,9999,1
1668511809543,ECE 200,023,103608,Lo; Yu-Hwa,9999,0,9999,0
1668511809543,ECE 200,024,103609,Lomakin; Vitaliy,9999,0,9999,0
1668511809543,ECE 200,025,103610,Mercier; Patrick Philip,9999,0,9999,0
1668511809543,ECE 200,026,103611,Meyer; Florian,9999,0,9999,0
1668511809543,ECE 200,027,103612,Milstein; Laurence B.,9999,0,9999,0
1668511809543,ECE 200,028,103613,Mir Arabbaygi; Siavash,9999,0,9999,0
1668511809543,ECE 200,029,103614,Mookherjea; Shayan,9999,0,9999,0
1668511809543,ECE 200,030,103615,Morris; Karcher William,9999,0,9999,0
1668511809543,ECE 200,031,103616,Ng; Tse Nga,9999,0,9999,0
1668511809543,ECE 200,032,103617,Nguyen; Truong Quang,9999,0,9999,0
1668511809543,ECE 200,033,103618,Nomura; Kenji,9999,0,9999,0
1668511809543,ECE 200,034,103619,Orlitsky; Alon,9999,0,9999,0
1668511809543,ECE 200,035,103620,Pal; Piya,9999,0,9999,0
1668511809543,ECE 200,036,103621,Papen; George C.,9999,0,9999,0
1668511809543,ECE 200,037,103622,Radic; Stojan,9999,0,9999,0
1668511809543,ECE 200,038,103623,Rao; Bhaskar D.,9999,0,9999,0
1668511809543,ECE 200,039,103624,Rao; Ramesh R,9999,0,9999,0
1668511809543,ECE 200,040,103625,Rebeiz; Gabriel,9999,0,9999,0
1668511809543,ECE 200,041,103626,Sanford; John R,9999,0,9999,0
1668511809543,ECE 200,042,103627,Siegel; Paul H.,9999,0,9999,0
1668511809543,ECE 200,043,103628,Sievenpiper; Daniel F.,9999,0,9999,0
1668511809543,ECE 200,044,103629,Sworder; David D.,9999,0,9999,0
1668511809543,ECE 200,045,103630,Taur; Yuan,9999,0,9999,0
1668511809543,ECE 200,046,103631,Touri; Behrouz,9999,0,9999,0
1668511809543,ECE 200,047,103632,Trivedi; Mohan M.,9999,0,9999,0
1668511809543,ECE 200,048,103633,Vasconcelos; Nuno,9999,0,9999,0
1668511809543,ECE 200,049,103634,Wang; Xiaolong,9999,0,9999,0
1668511809543,ECE 200,050,103635,Xie; Pengtao,9999,0,9999,0
1668511809543,ECE 200,051,103636,Yip; Michael,9999,0,9999,0
1668511809543,ECE 200,052,103637,Zeger; Kenneth A.,999,0,999,0
1668511809543,ECE 200,053,103638,Zhang; Xinyu,9999,0,9999,0
1668511809543,ECE 200,054,103639,Turakhia; Yatish Girish,9999,0,9999,0
1668511809543,ECE 200,055,103640,Kang; Mingu,9999,0,9999,0
1668511809543,ECE 200,056,103641,Shi; Yuanyuan,9999,0,9999,0
1668511809543,ECE 200,057,103642,Wang; Edward Jay,9999,0,9999,0
1668511809543,ECE 200,058,103643,Zheng; Yang,9999,0,9999,0
1668511809970,ECE 202,A00,103644,Kuzum; Duygu,0,44,0,0
1668511810396,ECE 212BN,A00,103646,Ng; Tse Nga,0,9,0,0
1668511810822,ECE 221,A00,111493,Staff,0,0,0,0
1668511811248,ECE 222B,A00,103647,Lomakin; Vitaliy,0,20,0,0
1668511811676,ECE 230B,A00,103648,Taur; Yuan,0,3,0,0
1668511812102,ECE 238B,A00,103649,Garay; Javier,0,0,0,0
1668511812529,ECE 240B,A00,112900,Fainman; Yeshaiahu,0,7,0,0
1668511812955,ECE 247A,A00,103650,Jokerst; Jesse Vincent,0,6,0,0
1668511813379,ECE 247B,A00,103651,Wang; Joseph,0,14,0,0
1668511813803,ECE 250,A00,103652,Siegel; Paul H.,0,82,0,0
1668511814227,ECE 251A,A00,103654,Rao; Bhaskar D.,0,61,0,0
1668511814652,ECE 257B,A00,103655,Bharadia; Dinesh,0,32,0,0
1668511815076,ECE 258A,A00,103656,Milstein; Laurence B.,0,29,0,0
1668511815535,ECE 260B,A00,103658,Kang; Mingu,0,119,0,0
1668511815963,ECE 264A,A00,103659,Galton; Ian A,0,65,0,0
1668511816388,ECE 265A,A00,103661,Gudem; Prasad S.S.,0,70,0,0
1668511816816,ECE 265D,A00,103662,Gudem; Prasad S.S.,0,26,0,0
1668511817240,ECE 268,A00,103663,Koushanfar; Farinaz,0,43,0,0
1668511817669,ECE 269,A01,103665,Pal; Piya,0,215,0,0
1668511818100,ECE 271B,A00,103666,Vasconcelos; Manuela,0,76,0,0
1668511818526,ECE 276A,A00,103667,Atanasov; Nikolay A.,0,126,0,0
1668511818950,ECE 277,A00,103668,An; Cheolhong,0,149,0,0
1668511819377,ECE 279,A00,117947,Hall; Drew A.,0,22,0,0
1668511820228,ECE 283,A00,103670,Hsueh; Tzu-Chien,0,53,0,0
1668511820656,ECE 284,A00,103671,Turakhia; Yatish Girish,0,39,0,0
1668511821080,ECE 285,A00,103672,Zheng; Yang,0,39,0,0
1668511821080,ECE 285,B00,103673,Sworder; David D.,0,57,0,0
1668511821508,ECE 287,A00,103676,Javidi; Tara,0,9,0,0
1668511821933,MATH 200B,A00,098023,Salehi Golsefidy; Alireza,10,0,15,5
1668511822368,MATH 202B,A00,098024,Rhoades; Brendon Patrick,7,0,15,8
1668511822796,MATH 203B,A00,098025,Oprea; Dragos N.,9,0,15,6
1668511823224,MATH 204B,A00,098026,Sorensen; Claus M,13,0,15,2
1668511823649,MATH 208,A00,098027,Izadi; Elham,7,0,10,3
1668511824074,MATH 209,A00,098028,Pollack; Aaron,10,0,10,0
1668511824508,MATH 211A,A00,112919,Rogalski; Daniel,8,0,10,2
1668511824933,MATH 211B,A00,112920,Seward; Brandon M.,9,0,10,1
1668511825359,MATH 218,A00,098029,Li; Bo,10,0,10,0
1668511825788,MATH 220B,A00,098030,Novak; Jonathan I,11,0,15,4
1668511826212,MATH 221A,A00,098031,Ebenfelt; Peter F,12,0,15,3
1668511826635,MATH 231B,A00,098032,Zlatos; Andrej,11,0,15,4
1668511827063,MATH 240B,A00,098033,Ni; Lei,7,0,15,8
1668511827490,MATH 243,A00,098034,Jekel; David Andrew,10,0,10,0
1668511827925,MATH 245A,A00,098035,Nie; Jiawang,0,4,15,18
1668511828349,MATH 248,A00,098036,Bejenaru; Ioan,10,0,10,0
1668511828775,MATH 250B,A00,098037,Spolaor; Luca,14,0,15,1
1668511829199,MATH 258,A00,098038,Ni; Lei,9,0,10,1
1668511829627,MATH 264B,A00,098041,Rhoades; Brendon Patrick,8,0,15,7
1668511830056,MATH 268,A00,098042,Buss; Samuel R,10,0,10,0
1668511830481,MATH 269,A00,098043,Rhoades; Brendon Patrick,10,0,10,0
1668511830903,MATH 270B,A00,098044,Li; Bo,6,0,15,9
1668511831328,MATH 272B,A00,098045,Holst; Michael J,13,0,15,2
1668511831757,MATH 273A,A00,098046,Tian; Xiaochuan,10,0,15,5
1668511832186,MATH 275,A01,098048,Tian; Xiaochuan,6,0,10,4
1668511832614,MATH 278A,A00,098049,Holst; Michael J,7,0,10,3
1668511833038,MATH 278B,A00,098050,Cloninger; Alexander,10,0,10,0
1668511833465,MATH 278C,A00,098051,Nie; Jiawang,5,0,10,5
1668511833894,MATH 280B,A00,098052,Zheng; Tianyi,7,0,15,8
1668511834318,MATH 281B,A00,098053,Bradic; Jelena,0,2,15,15
1668511834743,MATH 282B,A00,098054,Arias-Castro; Ery,0,1,15,15
1668511835168,MATH 285,A00,098055,Fitzsimmons; Patrick J,0,3,15,17
1668511835592,MATH 287B,A00,098056,Arias-Castro; Ery,1,0,15,14
1668511836020,MATH 288,A00,098057,Agarwal; Pooja,9,0,10,1
1668511836020,MATH 288,B00,098058,Zhang; Danna,8,0,10,2
1668511836020,MATH 288,C00,098059,Williams; Ruth J,9,0,10,1
1668511836547,MATH 290B,A00,098060,Roberts; Justin Deritter,12,0,15,3
1668511836973,MATH 292,A00,098061,Belmont; Eva Kinoshita,10,0,10,0
1668511837398,MATH 295,A00,098062,Suk; Andrew Hoon,47,0,50,3
1668511837824,MATH 296,A00,098063,Novak; Jonathan I,20,0,20,0
1668511838248,MATH 297,001,098064,Gamst; Anthony Collins,9997,0,9999,2
1668512340746,COGS 205,A00,101395,Chiba; Andrea,19,0,20,1
1668512341180,COGS 210B,001,101404,Greene; Deanna Jacquelyn,9998,0,9999,1
1668512341180,COGS 210B,002,101417,Xia; Haijun,9999,0,9999,0
1668512341180,COGS 210B,003,101422,Nitz; Douglas A.,9999,0,9999,0
1668512341180,COGS 210B,004,101423,Hollan; James D.,9998,0,9999,1
1668512341180,COGS 210B,005,101424,Deak; Gedeon O.,9998,0,9999,1
1668512341180,COGS 210B,006,101425,Rossano; Federico,9999,0,9999,0
1668512341604,COGS 211B,A00,101427,Coulson; Seana M,9996,0,9999,3
1668512342035,COGS 220,A00,101428,Hollan; James D.,0,10,25,25
1668512342460,COGS 229,A00,101429,Dow; Steven P,17,0,25,8
1668512342884,COGS 230,A00,101430,Klemmer; Scott R,7,0,17,10
1668512343309,COGS 234,A00,101431,Xia; Haijun,1,0,25,24
1668512343740,COGS 260,A00,101432,Kiyonaga; Anastasia,21,0,25,4
1668512343740,COGS 260,B00,101433,Kirsh; David Joel,15,0,25,10
1668512344167,CSE 202,A00,102371,Impagliazzo; Russell,0,65,0,0
1668512344598,CSE 203B,A01,102373,Cheng; Chung Kuan,0,58,0,0
1668512345026,CSE 208,A00,102374,Micciancio; Daniele,0,5,0,0
1668512345455,CSE 209A,A00,112895,Impagliazzo; Russell,0,12,15,15
1668512345880,CSE 209B,A00,108005,Bellare; Mihir,0,7,0,0
1668512346306,CSE 210,A00,113163,Coblenz; Michael J,0,84,0,0
1668512346731,CSE 219,A00,106111,Dow; Steven P,0,6,20,20
1668512347158,CSE 221,A00,102376,Voelker; Geoffrey M.,0,72,0,0
1668512347582,CSE 224,A01,102378,Porter; George M,0,166,0,0
1668512348006,CSE 229A,A00,102379,Savage; Stefan,0,10,0,0
1668512348436,CSE 229C,A00,102380,Munyaka; Imani N. S.,0,10,0,0
1668512348860,CSE 232B,A00,102382,Deutsch; Alin Bernard,0,32,0,0
1668512349286,CSE 234,A01,112904,Kumar; Arun Kumar,0,0,0,0
1668512349716,CSE 237A,A00,102383,Rosing; Tajana Simunic,0,55,0,0
1668512350142,CSE 239A,A00,102384,Deutsch; Alin Bernard,0,14,0,0
1668512350570,CSE 239B,A00,102385,Polikarpova; Nadezhda,0,10,0,0
1668512350998,CSE 240A,A00,102386,Pannuto; Patrick William,0,46,0,0
1668512351430,CSE 240B,A00,102387,Zhao; Jishen,0,47,0,0
1668512351858,CSE 241A,A00,106406,Kang; Mingu,0,9,0,0
1668512352282,CSE 249B,A00,102388,Kahng; Andrew Byun,0,5,8,8
1668512352714,CSE 251B,A01,102392,Cottrell; Garrison W,0,51,0,0
1668512352714,CSE 251B,A02,102393,Cottrell; Garrison W,0,34,0,0
1668512353151,CSE 252B,A00,102394,Ochoa; Benjamin Lawrence,0,59,0,0
1668512353587,CSE 257,A01,102396,Gao; Sicun,0,139,0,0
1668512354014,CSE 272,A00,102397,Li; Tzumao,0,19,0,0
1668512354443,CSE 274,A00,111323,Chern; Albert Ren-Haur,0,15,0,0
1668512354870,CSE 282,A00,102398,Pevzner; Pavel Arkadjevich,0,0,0,0
1668512355298,CSE 284,A00,114175,Gymrek; Melissa Ann,0,22,0,0
1668512355726,CSE 290,A00,102399,Chandraker; Manmohan Krishna,0,11,0,0
1668512355726,CSE 290,B00,102400,Vaccaro; Kristen Marie,0,7,25,25
1668512355726,CSE 290,C00,102414,Pannuto; Patrick William,0,1,25,25
1668512355726,CSE 290,D00,102427,Pevzner; Pavel Arkadjevich,0,0,0,0
1668512355726,CSE 290,E00,102429,Zhao; Jishen,0,4,0,0
1668512355726,CSE 290,F00,102436,Tullsen; Dean Michael,0,5,0,0
1668512355726,CSE 290,G00,102440,Christensen; Henrik I,0,6,20,20
1668512356153,CSE 291,A00,102443,Su; Hao,0,0,0,0
1668512356153,CSE 291,B00,102448,Polikarpova; Nadezhda,0,0,0,0
1668512356153,CSE 291,C00,102453,Vaccaro; Kristen Marie,0,0,0,0
1668512356153,CSE 291,D00,111343,Savage; Stefan,0,0,0,0
1668512356153,CSE 291,E00,116474,Claffy; Kimberly Claire,0,0,0,0
1668512356153,CSE 291,F00,116479,Pasquale; Joseph,0,0,0,0
1668512356620,CSE 293,001,119111,Bafna; Vineet,9999,0,9999,0
1668512356620,CSE 293,002,119118,Bellare; Mihir,9999,0,9999,0
1668512356620,CSE 293,003,119122,Berg-Kirkpatrick; Taylor D,9999,0,9999,0
1668512356620,CSE 293,004,119135,Christensen; Henrik I,9999,0,9999,0
1668512356620,CSE 293,005,119142,Cottrell; Garrison W,9999,0,9999,0
1668512356620,CSE 293,006,119146,Deutsch; Alin Bernard,9999,0,9999,0
1668512356620,CSE 293,007,119159,Esmaeilzadeh; Hadi,9999,0,9999,0
1668512356620,CSE 293,008,119166,Freund; Yoav,9999,0,9999,0
1668512356620,CSE 293,009,119170,Griswold; William G.,9999,0,9999,0
1668512356620,CSE 293,010,119183,Gymrek; Melissa Ann,9999,0,9999,0
1668512356620,CSE 293,011,119190,Heninger; Nadia A,9999,0,9999,0
1668512356620,CSE 293,012,119230,Impagliazzo; Russell,9999,0,9999,0
1668512356620,CSE 293,013,119232,Jhala; Ranjit,9999,0,9999,0
1668512356620,CSE 293,014,119233,Kahng; Andrew Byun,9999,0,9999,0
1668512356620,CSE 293,015,119298,Kane; Daniel Mertz,9999,0,9999,0
1668512356620,CSE 293,016,119299,Kriegman; David J,9999,0,9999,0
1668512356620,CSE 293,017,119300,Kumar; Arun Kumar,9999,0,9999,0
1668512356620,CSE 293,018,119301,Lerner; Sorin,9999,0,9999,0
1668512356620,CSE 293,019,119302,Lovett; Shachar,9999,0,9999,0
1668512356620,CSE 293,020,119303,McAuley; Julian John,9999,0,9999,0
1668512356620,CSE 293,021,119304,Micciancio; Daniele,9999,0,9999,0
1668512356620,CSE 293,022,119367,Orailoglu; Alex,9999,0,9999,0
1668512356620,CSE 293,023,119382,Paturi; Ramamohan,9999,0,9999,0
1668512356620,CSE 293,024,119404,Polikarpova; Nadezhda,9999,0,9999,0
1668512356620,CSE 293,025,119406,Politz; Joseph Gibbs,9999,0,9999,0
1668512356620,CSE 293,026,119411,Porter; George M,9999,0,9999,0
1668512356620,CSE 293,027,119414,Porter; Leonard Emerson,9999,0,9999,0
1668512356620,CSE 293,028,119416,Ramamoorthi; Ravi,9999,0,9999,0
1668512356620,CSE 293,029,119417,Sahoo; Debashis,9999,0,9999,0
1668512356620,CSE 293,030,119420,Saul; Lawrence,9999,0,9999,0
1668512356620,CSE 293,031,119421,Savage; Stefan,9999,0,9999,0
1668512356620,CSE 293,032,119425,Schulze; Jurgen P.,9999,0,9999,0
1668512356620,CSE 293,033,119426,Snoeren; Alex C.,9999,0,9999,0
1668512356620,CSE 293,034,119428,Shang; Jingbo,9999,0,9999,0
1668512356620,CSE 293,035,119430,Stefan; Deian,9999,0,9999,0
1668512356620,CSE 293,036,119431,Su; Hao,9999,0,9999,0
1668512356620,CSE 293,037,119433,Swanson; Steven James,9999,0,9999,0
1668512356620,CSE 293,038,119435,Tullsen; Dean Michael,9999,0,9999,0
1668512356620,CSE 293,039,119483,Voelker; Geoffrey M.,9999,0,9999,0
1668512356620,CSE 293,040,119537,Zhao; Jishen,9999,0,9999,0
1668512356620,CSE 293,041,119538,Zhou; Yuan-Yuan,9999,0,9999,0
1668512356620,CSE 293,042,119539,Gao; Sicun,9999,0,9999,0
1668512356620,CSE 293,043,119540,Weibel; Nadir,9999,0,9999,0
1668512356620,CSE 293,044,119541,Gupta; Rajesh K.,9999,0,9999,0
1668512356620,CSE 293,045,126410,Vaccaro; Kristen Marie,9999,0,9999,0
1668512356620,CSE 293,046,126411,Klemke; Richard,9999,0,9999,0
1668512357046,CSE 294,A00,102459,Voelker; Geoffrey M.,0,2,0,0
1668512357046,CSE 294,B00,111322,Orailoglu; Alex,0,2,0,0
1668512357472,DSE 201,A00,096914,Deutsch; Alin Bernard,30,0,30,0
1668512357973,DSE 210,A00,096915,Dasgupta; Sanjoy,30,0,30,0
1668512358396,DSE 260A,A00,096916,Altintas De Callaf; Ilkay,30,0,30,0
1668512358914,ECE 200,001,103586,Antipa; Nicholas A,9999,0,9999,0
1668512358914,ECE 200,002,103587,Atanasov; Nikolay A.,9999,0,9999,0
1668512358914,ECE 200,003,103588,Bharadia; Dinesh,9999,0,9999,0
1668512358914,ECE 200,004,103589,Cheng; Chung Kuan,9999,0,9999,0
1668512358914,ECE 200,005,103590,Cosman; Pamela C.,9999,0,9999,0
1668512358914,ECE 200,006,103591,Dayeh; Shadi Ahmad,9999,0,9999,0
1668512358914,ECE 200,007,103592,Fainman; Yeshaiahu,9999,0,9999,0
1668512358914,ECE 200,008,103593,Ford; Joseph Earl,9999,0,9999,0
1668512358914,ECE 200,009,103594,Franceschetti; Massimo,9999,0,9999,0
1668512358914,ECE 200,010,103595,Fullerton; Eric E,9999,0,9999,0
1668512358914,ECE 200,011,103596,Galton; Ian A,9999,0,9999,0
1668512358914,ECE 200,012,103597,Gilja; Vikash,9999,0,9999,0
1668512358914,ECE 200,013,103598,Hall; Drew A.,9999,0,9999,0
1668512358914,ECE 200,014,103599,Hsueh; Tzu-Chien,9999,0,9999,0
1668512358914,ECE 200,015,103600,Javidi; Tara,9999,0,9999,0
1668512358914,ECE 200,016,103601,Kahng; Andrew Byun,9999,0,9999,0
1668512358914,ECE 200,017,103602,Kim; Young-Han,9999,0,9999,0
1668512358914,ECE 200,018,103603,Koushanfar; Farinaz,9999,0,9999,0
1668512358914,ECE 200,019,103604,Kuzum; Duygu,9999,0,9999,0
1668512358914,ECE 200,020,103605,Le; Hanh-Phuc,9999,0,9999,0
1668512358914,ECE 200,021,103606,Lin; Bill,9999,0,9999,0
1668512358914,ECE 200,022,103607,Liu; Zhaowei,9998,0,9999,1
1668512358914,ECE 200,023,103608,Lo; Yu-Hwa,9999,0,9999,0
1668512358914,ECE 200,024,103609,Lomakin; Vitaliy,9999,0,9999,0
1668512358914,ECE 200,025,103610,Mercier; Patrick Philip,9999,0,9999,0
1668512358914,ECE 200,026,103611,Meyer; Florian,9999,0,9999,0
1668512358914,ECE 200,027,103612,Milstein; Laurence B.,9999,0,9999,0
1668512358914,ECE 200,028,103613,Mir Arabbaygi; Siavash,9999,0,9999,0
1668512358914,ECE 200,029,103614,Mookherjea; Shayan,9999,0,9999,0
1668512358914,ECE 200,030,103615,Morris; Karcher William,9999,0,9999,0
1668512358914,ECE 200,031,103616,Ng; Tse Nga,9999,0,9999,0
1668512358914,ECE 200,032,103617,Nguyen; Truong Quang,9999,0,9999,0
1668512358914,ECE 200,033,103618,Nomura; Kenji,9999,0,9999,0
1668512358914,ECE 200,034,103619,Orlitsky; Alon,9999,0,9999,0
1668512358914,ECE 200,035,103620,Pal; Piya,9999,0,9999,0
1668512358914,ECE 200,036,103621,Papen; George C.,9999,0,9999,0
1668512358914,ECE 200,037,103622,Radic; Stojan,9999,0,9999,0
1668512358914,ECE 200,038,103623,Rao; Bhaskar D.,9999,0,9999,0
1668512358914,ECE 200,039,103624,Rao; Ramesh R,9999,0,9999,0
1668512358914,ECE 200,040,103625,Rebeiz; Gabriel,9999,0,9999,0
1668512358914,ECE 200,041,103626,Sanford; John R,9999,0,9999,0
1668512358914,ECE 200,042,103627,Siegel; Paul H.,9999,0,9999,0
1668512358914,ECE 200,043,103628,Sievenpiper; Daniel F.,9999,0,9999,0
1668512358914,ECE 200,044,103629,Sworder; David D.,9999,0,9999,0
1668512358914,ECE 200,045,103630,Taur; Yuan,9999,0,9999,0
1668512358914,ECE 200,046,103631,Touri; Behrouz,9999,0,9999,0
1668512358914,ECE 200,047,103632,Trivedi; Mohan M.,9999,0,9999,0
1668512358914,ECE 200,048,103633,Vasconcelos; Nuno,9999,0,9999,0
1668512358914,ECE 200,049,103634,Wang; Xiaolong,9999,0,9999,0
1668512358914,ECE 200,050,103635,Xie; Pengtao,9999,0,9999,0
1668512358914,ECE 200,051,103636,Yip; Michael,9999,0,9999,0
1668512358914,ECE 200,052,103637,Zeger; Kenneth A.,999,0,999,0
1668512358914,ECE 200,053,103638,Zhang; Xinyu,9999,0,9999,0
1668512358914,ECE 200,054,103639,Turakhia; Yatish Girish,9999,0,9999,0
1668512358914,ECE 200,055,103640,Kang; Mingu,9999,0,9999,0
1668512358914,ECE 200,056,103641,Shi; Yuanyuan,9999,0,9999,0
1668512358914,ECE 200,057,103642,Wang; Edward Jay,9999,0,9999,0
1668512358914,ECE 200,058,103643,Zheng; Yang,9999,0,9999,0
1668512359338,ECE 202,A00,103644,Kuzum; Duygu,0,44,0,0
1668512359765,ECE 212BN,A00,103646,Ng; Tse Nga,0,9,0,0
1668512360193,ECE 221,A00,111493,Staff,0,0,0,0
1668512360620,ECE 222B,A00,103647,Lomakin; Vitaliy,0,20,0,0
1668512361069,ECE 230B,A00,103648,Taur; Yuan,0,3,0,0
1668512361499,ECE 238B,A00,103649,Garay; Javier,0,0,0,0
1668512361923,ECE 240B,A00,112900,Fainman; Yeshaiahu,0,7,0,0
1668512362352,ECE 247A,A00,103650,Jokerst; Jesse Vincent,0,6,0,0
1668512362777,ECE 247B,A00,103651,Wang; Joseph,0,14,0,0
1668512363204,ECE 250,A00,103652,Siegel; Paul H.,0,82,0,0
1668512363630,ECE 251A,A00,103654,Rao; Bhaskar D.,0,61,0,0
1668512364055,ECE 257B,A00,103655,Bharadia; Dinesh,0,32,0,0
1668512364483,ECE 258A,A00,103656,Milstein; Laurence B.,0,29,0,0
1668512364913,ECE 260B,A00,103658,Kang; Mingu,0,119,0,0
1668512365338,ECE 264A,A00,103659,Galton; Ian A,0,65,0,0
1668512365763,ECE 265A,A00,103661,Gudem; Prasad S.S.,0,70,0,0
1668512366187,ECE 265D,A00,103662,Gudem; Prasad S.S.,0,26,0,0
1668512366611,ECE 268,A00,103663,Koushanfar; Farinaz,0,43,0,0
1668512367041,ECE 269,A01,103665,Pal; Piya,0,215,0,0
1668512367468,ECE 271B,A00,103666,Vasconcelos; Manuela,0,76,0,0
1668512367894,ECE 276A,A00,103667,Atanasov; Nikolay A.,0,126,0,0
1668512368318,ECE 277,A00,103668,An; Cheolhong,0,149,0,0
1668512368744,ECE 279,A00,117947,Hall; Drew A.,0,22,0,0
1668512369603,ECE 283,A00,103670,Hsueh; Tzu-Chien,0,53,0,0
1668512370031,ECE 284,A00,103671,Turakhia; Yatish Girish,0,39,0,0
1668512370458,ECE 285,A00,103672,Zheng; Yang,0,39,0,0
1668512370458,ECE 285,B00,103673,Sworder; David D.,0,57,0,0
1668512370885,ECE 287,A00,103676,Javidi; Tara,0,9,0,0
1668512371313,MATH 200B,A00,098023,Salehi Golsefidy; Alireza,10,0,15,5
1668512371737,MATH 202B,A00,098024,Rhoades; Brendon Patrick,7,0,15,8
1668512372172,MATH 203B,A00,098025,Oprea; Dragos N.,9,0,15,6
1668512372597,MATH 204B,A00,098026,Sorensen; Claus M,13,0,15,2
1668512373019,MATH 208,A00,098027,Izadi; Elham,7,0,10,3
1668512373443,MATH 209,A00,098028,Pollack; Aaron,10,0,10,0
1668512373878,MATH 211A,A00,112919,Rogalski; Daniel,8,0,10,2
1668512374300,MATH 211B,A00,112920,Seward; Brandon M.,9,0,10,1
1668512374725,MATH 218,A00,098029,Li; Bo,10,0,10,0
1668512375148,MATH 220B,A00,098030,Novak; Jonathan I,11,0,15,4
1668512375580,MATH 221A,A00,098031,Ebenfelt; Peter F,12,0,15,3
1668512376010,MATH 231B,A00,098032,Zlatos; Andrej,11,0,15,4
1668512376435,MATH 240B,A00,098033,Ni; Lei,7,0,15,8
1668512376863,MATH 243,A00,098034,Jekel; David Andrew,10,0,10,0
1668512377289,MATH 245A,A00,098035,Nie; Jiawang,0,4,15,18
1668512377712,MATH 248,A00,098036,Bejenaru; Ioan,10,0,10,0
1668512378142,MATH 250B,A00,098037,Spolaor; Luca,14,0,15,1
1668512378574,MATH 258,A00,098038,Ni; Lei,9,0,10,1
1668512378999,MATH 264B,A00,098041,Rhoades; Brendon Patrick,8,0,15,7
1668512379422,MATH 268,A00,098042,Buss; Samuel R,10,0,10,0
1668512379849,MATH 269,A00,098043,Rhoades; Brendon Patrick,10,0,10,0
1668512380275,MATH 270B,A00,098044,Li; Bo,6,0,15,9
1668512380698,MATH 272B,A00,098045,Holst; Michael J,13,0,15,2
1668512381124,MATH 273A,A00,098046,Tian; Xiaochuan,10,0,15,5
1668512381552,MATH 275,A01,098048,Tian; Xiaochuan,6,0,10,4
1668512381977,MATH 278A,A00,098049,Holst; Michael J,7,0,10,3
1668512382402,MATH 278B,A00,098050,Cloninger; Alexander,10,0,10,0
1668512382825,MATH 278C,A00,098051,Nie; Jiawang,5,0,10,5
1668512383253,MATH 280B,A00,098052,Zheng; Tianyi,7,0,15,8
1668512383681,MATH 281B,A00,098053,Bradic; Jelena,0,2,15,15
1668512384107,MATH 282B,A00,098054,Arias-Castro; Ery,0,1,15,15
1668512384534,MATH 285,A00,098055,Fitzsimmons; Patrick J,0,3,15,17
1668512384960,MATH 287B,A00,098056,Arias-Castro; Ery,1,0,15,14
1668512385385,MATH 288,A00,098057,Agarwal; Pooja,9,0,10,1
1668512385385,MATH 288,B00,098058,Zhang; Danna,8,0,10,2
1668512385385,MATH 288,C00,098059,Williams; Ruth J,9,0,10,1
1668512385810,MATH 290B,A00,098060,Roberts; Justin Deritter,12,0,15,3
1668512386241,MATH 292,A00,098061,Belmont; Eva Kinoshita,10,0,10,0
1668512386665,MATH 295,A00,098062,Suk; Andrew Hoon,47,0,50,3
1668512387099,MATH 296,A00,098063,Novak; Jonathan I,20,0,20,0
1668512387523,MATH 297,001,098064,Gamst; Anthony Collins,9997,0,9999,2
1668512889748,COGS 205,A00,101395,Chiba; Andrea,19,0,20,1
1668512890176,COGS 210B,001,101404,Greene; Deanna Jacquelyn,9998,0,9999,1
1668512890176,COGS 210B,002,101417,Xia; Haijun,9999,0,9999,0
1668512890176,COGS 210B,003,101422,Nitz; Douglas A.,9999,0,9999,0
1668512890176,COGS 210B,004,101423,Hollan; James D.,9998,0,9999,1
1668512890176,COGS 210B,005,101424,Deak; Gedeon O.,9998,0,9999,1
1668512890176,COGS 210B,006,101425,Rossano; Federico,9999,0,9999,0
1668512890606,COGS 211B,A00,101427,Coulson; Seana M,9996,0,9999,3
1668512891032,COGS 220,A00,101428,Hollan; James D.,0,10,25,25
1668512891461,COGS 229,A00,101429,Dow; Steven P,17,0,25,8
1668512891888,COGS 230,A00,101430,Klemmer; Scott R,7,0,17,10
1668512892313,COGS 234,A00,101431,Xia; Haijun,1,0,25,24
1668512892741,COGS 260,A00,101432,Kiyonaga; Anastasia,21,0,25,4
1668512892741,COGS 260,B00,101433,Kirsh; David Joel,15,0,25,10
1668512893171,CSE 202,A00,102371,Impagliazzo; Russell,0,65,0,0
1668512893597,CSE 203B,A01,102373,Cheng; Chung Kuan,0,58,0,0
1668512894035,CSE 208,A00,102374,Micciancio; Daniele,0,5,0,0
1668512894461,CSE 209A,A00,112895,Impagliazzo; Russell,0,12,15,15
1668512894889,CSE 209B,A00,108005,Bellare; Mihir,0,7,0,0
1668512895316,CSE 210,A00,113163,Coblenz; Michael J,0,84,0,0
1668512895746,CSE 219,A00,106111,Dow; Steven P,0,6,20,20
1668512896170,CSE 221,A00,102376,Voelker; Geoffrey M.,0,72,0,0
1668512896595,CSE 224,A01,102378,Porter; George M,0,166,0,0
1668512897019,CSE 229A,A00,102379,Savage; Stefan,0,10,0,0
1668512897447,CSE 229C,A00,102380,Munyaka; Imani N. S.,0,10,0,0
1668512897876,CSE 232B,A00,102382,Deutsch; Alin Bernard,0,32,0,0
1668512898301,CSE 234,A01,112904,Kumar; Arun Kumar,0,0,0,0
1668512898733,CSE 237A,A00,102383,Rosing; Tajana Simunic,0,55,0,0
1668512899163,CSE 239A,A00,102384,Deutsch; Alin Bernard,0,14,0,0
1668512899588,CSE 239B,A00,102385,Polikarpova; Nadezhda,0,10,0,0
1668512900018,CSE 240A,A00,102386,Pannuto; Patrick William,0,46,0,0
1668512900451,CSE 240B,A00,102387,Zhao; Jishen,0,47,0,0
1668512900877,CSE 241A,A00,106406,Kang; Mingu,0,9,0,0
1668512901305,CSE 249B,A00,102388,Kahng; Andrew Byun,0,5,8,8
1668512901736,CSE 251B,A01,102392,Cottrell; Garrison W,0,51,0,0
1668512901736,CSE 251B,A02,102393,Cottrell; Garrison W,0,34,0,0
1668512902162,CSE 252B,A00,102394,Ochoa; Benjamin Lawrence,0,59,0,0
1668512902585,CSE 257,A01,102396,Gao; Sicun,0,139,0,0
1668512903014,CSE 272,A00,102397,Li; Tzumao,0,19,0,0
1668512903438,CSE 274,A00,111323,Chern; Albert Ren-Haur,0,15,0,0
1668512903867,CSE 282,A00,102398,Pevzner; Pavel Arkadjevich,0,0,0,0
1668512904304,CSE 284,A00,114175,Gymrek; Melissa Ann,0,22,0,0
1668512904740,CSE 290,A00,102399,Chandraker; Manmohan Krishna,0,11,0,0
1668512904740,CSE 290,B00,102400,Vaccaro; Kristen Marie,0,7,25,25
1668512904740,CSE 290,C00,102414,Pannuto; Patrick William,0,1,25,25
1668512904740,CSE 290,D00,102427,Pevzner; Pavel Arkadjevich,0,0,0,0
1668512904740,CSE 290,E00,102429,Zhao; Jishen,0,4,0,0
1668512904740,CSE 290,F00,102436,Tullsen; Dean Michael,0,5,0,0
1668512904740,CSE 290,G00,102440,Christensen; Henrik I,0,6,20,20
1668512905186,CSE 291,A00,102443,Su; Hao,0,0,0,0
1668512905186,CSE 291,B00,102448,Polikarpova; Nadezhda,0,0,0,0
1668512905186,CSE 291,C00,102453,Vaccaro; Kristen Marie,0,0,0,0
1668512905186,CSE 291,D00,111343,Savage; Stefan,0,0,0,0
1668512905186,CSE 291,E00,116474,Claffy; Kimberly Claire,0,0,0,0
1668512905186,CSE 291,F00,116479,Pasquale; Joseph,0,0,0,0
1668512905630,CSE 293,001,119111,Bafna; Vineet,9999,0,9999,0
1668512905630,CSE 293,002,119118,Bellare; Mihir,9999,0,9999,0
1668512905630,CSE 293,003,119122,Berg-Kirkpatrick; Taylor D,9999,0,9999,0
1668512905630,CSE 293,004,119135,Christensen; Henrik I,9999,0,9999,0
1668512905630,CSE 293,005,119142,Cottrell; Garrison W,9999,0,9999,0
1668512905630,CSE 293,006,119146,Deutsch; Alin Bernard,9999,0,9999,0
1668512905630,CSE 293,007,119159,Esmaeilzadeh; Hadi,9999,0,9999,0
1668512905630,CSE 293,008,119166,Freund; Yoav,9999,0,9999,0
1668512905630,CSE 293,009,119170,Griswold; William G.,9999,0,9999,0
1668512905630,CSE 293,010,119183,Gymrek; Melissa Ann,9999,0,9999,0
1668512905630,CSE 293,011,119190,Heninger; Nadia A,9999,0,9999,0
1668512905630,CSE 293,012,119230,Impagliazzo; Russell,9999,0,9999,0
1668512905630,CSE 293,013,119232,Jhala; Ranjit,9999,0,9999,0
1668512905630,CSE 293,014,119233,Kahng; Andrew Byun,9999,0,9999,0
1668512905630,CSE 293,015,119298,Kane; Daniel Mertz,9999,0,9999,0
1668512905630,CSE 293,016,119299,Kriegman; David J,9999,0,9999,0
1668512905630,CSE 293,017,119300,Kumar; Arun Kumar,9999,0,9999,0
1668512905630,CSE 293,018,119301,Lerner; Sorin,9999,0,9999,0
1668512905630,CSE 293,019,119302,Lovett; Shachar,9999,0,9999,0
1668512905630,CSE 293,020,119303,McAuley; Julian John,9999,0,9999,0
1668512905630,CSE 293,021,119304,Micciancio; Daniele,9999,0,9999,0
1668512905630,CSE 293,022,119367,Orailoglu; Alex,9999,0,9999,0
1668512905630,CSE 293,023,119382,Paturi; Ramamohan,9999,0,9999,0
1668512905630,CSE 293,024,119404,Polikarpova; Nadezhda,9999,0,9999,0
1668512905630,CSE 293,025,119406,Politz; Joseph Gibbs,9999,0,9999,0
1668512905630,CSE 293,026,119411,Porter; George M,9999,0,9999,0
1668512905630,CSE 293,027,119414,Porter; Leonard Emerson,9999,0,9999,0
1668512905630,CSE 293,028,119416,Ramamoorthi; Ravi,9999,0,9999,0
1668512905630,CSE 293,029,119417,Sahoo; Debashis,9999,0,9999,0
1668512905630,CSE 293,030,119420,Saul; Lawrence,9999,0,9999,0
1668512905630,CSE 293,031,119421,Savage; Stefan,9999,0,9999,0
1668512905630,CSE 293,032,119425,Schulze; Jurgen P.,9999,0,9999,0
1668512905630,CSE 293,033,119426,Snoeren; Alex C.,9999,0,9999,0
1668512905630,CSE 293,034,119428,Shang; Jingbo,9999,0,9999,0
1668512905630,CSE 293,035,119430,Stefan; Deian,9999,0,9999,0
1668512905630,CSE 293,036,119431,Su; Hao,9999,0,9999,0
1668512905630,CSE 293,037,119433,Swanson; Steven James,9999,0,9999,0
1668512905630,CSE 293,038,119435,Tullsen; Dean Michael,9999,0,9999,0
1668512905630,CSE 293,039,119483,Voelker; Geoffrey M.,9999,0,9999,0
1668512905630,CSE 293,040,119537,Zhao; Jishen,9999,0,9999,0
1668512905630,CSE 293,041,119538,Zhou; Yuan-Yuan,9999,0,9999,0
1668512905630,CSE 293,042,119539,Gao; Sicun,9999,0,9999,0
1668512905630,CSE 293,043,119540,Weibel; Nadir,9999,0,9999,0
1668512905630,CSE 293,044,119541,Gupta; Rajesh K.,9999,0,9999,0
1668512905630,CSE 293,045,126410,Vaccaro; Kristen Marie,9999,0,9999,0
1668512905630,CSE 293,046,126411,Klemke; Richard,9999,0,9999,0
1668512906057,CSE 294,A00,102459,Voelker; Geoffrey M.,0,2,0,0
1668512906057,CSE 294,B00,111322,Orailoglu; Alex,0,2,0,0
1668512906481,DSE 201,A00,096914,Deutsch; Alin Bernard,30,0,30,0
1668512906906,DSE 210,A00,096915,Dasgupta; Sanjoy,30,0,30,0
1668512907330,DSE 260A,A00,096916,Altintas De Callaf; Ilkay,30,0,30,0
1668512907788,ECE 200,001,103586,Antipa; Nicholas A,9999,0,9999,0
1668512907788,ECE 200,002,103587,Atanasov; Nikolay A.,9999,0,9999,0
1668512907788,ECE 200,003,103588,Bharadia; Dinesh,9999,0,9999,0
1668512907788,ECE 200,004,103589,Cheng; Chung Kuan,9999,0,9999,0
1668512907788,ECE 200,005,103590,Cosman; Pamela C.,9999,0,9999,0
1668512907788,ECE 200,006,103591,Dayeh; Shadi Ahmad,9999,0,9999,0
1668512907788,ECE 200,007,103592,Fainman; Yeshaiahu,9999,0,9999,0
1668512907788,ECE 200,008,103593,Ford; Joseph Earl,9999,0,9999,0
1668512907788,ECE 200,009,103594,Franceschetti; Massimo,9999,0,9999,0
1668512907788,ECE 200,010,103595,Fullerton; Eric E,9999,0,9999,0
1668512907788,ECE 200,011,103596,Galton; Ian A,9999,0,9999,0
1668512907788,ECE 200,012,103597,Gilja; Vikash,9999,0,9999,0
1668512907788,ECE 200,013,103598,Hall; Drew A.,9999,0,9999,0
1668512907788,ECE 200,014,103599,Hsueh; Tzu-Chien,9999,0,9999,0
1668512907788,ECE 200,015,103600,Javidi; Tara,9999,0,9999,0
1668512907788,ECE 200,016,103601,Kahng; Andrew Byun,9999,0,9999,0
1668512907788,ECE 200,017,103602,Kim; Young-Han,9999,0,9999,0
1668512907788,ECE 200,018,103603,Koushanfar; Farinaz,9999,0,9999,0
1668512907788,ECE 200,019,103604,Kuzum; Duygu,9999,0,9999,0
1668512907788,ECE 200,020,103605,Le; Hanh-Phuc,9999,0,9999,0
1668512907788,ECE 200,021,103606,Lin; Bill,9999,0,9999,0
1668512907788,ECE 200,022,103607,Liu; Zhaowei,9998,0,9999,1
1668512907788,ECE 200,023,103608,Lo; Yu-Hwa,9999,0,9999,0
1668512907788,ECE 200,024,103609,Lomakin; Vitaliy,9999,0,9999,0
1668512907788,ECE 200,025,103610,Mercier; Patrick Philip,9999,0,9999,0
1668512907788,ECE 200,026,103611,Meyer; Florian,9999,0,9999,0
1668512907788,ECE 200,027,103612,Milstein; Laurence B.,9999,0,9999,0
1668512907788,ECE 200,028,103613,Mir Arabbaygi; Siavash,9999,0,9999,0
1668512907788,ECE 200,029,103614,Mookherjea; Shayan,9999,0,9999,0
1668512907788,ECE 200,030,103615,Morris; Karcher William,9999,0,9999,0
1668512907788,ECE 200,031,103616,Ng; Tse Nga,9999,0,9999,0
1668512907788,ECE 200,032,103617,Nguyen; Truong Quang,9999,0,9999,0
1668512907788,ECE 200,033,103618,Nomura; Kenji,9999,0,9999,0
1668512907788,ECE 200,034,103619,Orlitsky; Alon,9999,0,9999,0
1668512907788,ECE 200,035,103620,Pal; Piya,9999,0,9999,0
1668512907788,ECE 200,036,103621,Papen; George C.,9999,0,9999,0
1668512907788,ECE 200,037,103622,Radic; Stojan,9999,0,9999,0
1668512907788,ECE 200,038,103623,Rao; Bhaskar D.,9999,0,9999,0
1668512907788,ECE 200,039,103624,Rao; Ramesh R,9999,0,9999,0
1668512907788,ECE 200,040,103625,Rebeiz; Gabriel,9999,0,9999,0
1668512907788,ECE 200,041,103626,Sanford; John R,9999,0,9999,0
1668512907788,ECE 200,042,103627,Siegel; Paul H.,9999,0,9999,0
1668512907788,ECE 200,043,103628,Sievenpiper; Daniel F.,9999,0,9999,0
1668512907788,ECE 200,044,103629,Sworder; David D.,9999,0,9999,0
1668512907788,ECE 200,045,103630,Taur; Yuan,9999,0,9999,0
1668512907788,ECE 200,046,103631,Touri; Behrouz,9999,0,9999,0
1668512907788,ECE 200,047,103632,Trivedi; Mohan M.,9999,0,9999,0
1668512907788,ECE 200,048,103633,Vasconcelos; Nuno,9999,0,9999,0
1668512907788,ECE 200,049,103634,Wang; Xiaolong,9999,0,9999,0
1668512907788,ECE 200,050,103635,Xie; Pengtao,9999,0,9999,0
1668512907788,ECE 200,051,103636,Yip; Michael,9999,0,9999,0
1668512907788,ECE 200,052,103637,Zeger; Kenneth A.,999,0,999,0
1668512907788,ECE 200,053,103638,Zhang; Xinyu,9999,0,9999,0
1668512907788,ECE 200,054,103639,Turakhia; Yatish Girish,9999,0,9999,0
1668512907788,ECE 200,055,103640,Kang; Mingu,9999,0,9999,0
1668512907788,ECE 200,056,103641,Shi; Yuanyuan,9999,0,9999,0
1668512907788,ECE 200,057,103642,Wang; Edward Jay,9999,0,9999,0
1668512907788,ECE 200,058,103643,Zheng; Yang,9999,0,9999,0
1668512908222,ECE 202,A00,103644,Kuzum; Duygu,0,44,0,0
1668512908651,ECE 212BN,A00,103646,Ng; Tse Nga,0,9,0,0
1668512909074,ECE 221,A00,111493,Staff,0,0,0,0
1668512909499,ECE 222B,A00,103647,Lomakin; Vitaliy,0,20,0,0
1668512909927,ECE 230B,A00,103648,Taur; Yuan,0,3,0,0
1668512910353,ECE 238B,A00,103649,Garay; Javier,0,0,0,0
1668512910777,ECE 240B,A00,112900,Fainman; Yeshaiahu,0,7,0,0
1668512911203,ECE 247A,A00,103650,Jokerst; Jesse Vincent,0,6,0,0
1668512911628,ECE 247B,A00,103651,Wang; Joseph,0,14,0,0
1668512912053,ECE 250,A00,103652,Siegel; Paul H.,0,82,0,0
1668512912481,ECE 251A,A00,103654,Rao; Bhaskar D.,0,62,0,0
1668512912907,ECE 257B,A00,103655,Bharadia; Dinesh,0,32,0,0
1668512913332,ECE 258A,A00,103656,Milstein; Laurence B.,0,29,0,0
1668512913755,ECE 260B,A00,103658,Kang; Mingu,0,119,0,0
1668512914189,ECE 264A,A00,103659,Galton; Ian A,0,66,0,0
1668512914619,ECE 265A,A00,103661,Gudem; Prasad S.S.,0,70,0,0
1668512915043,ECE 265D,A00,103662,Gudem; Prasad S.S.,0,26,0,0
1668512915470,ECE 268,A00,103663,Koushanfar; Farinaz,0,43,0,0
1668512915894,ECE 269,A01,103665,Pal; Piya,0,215,0,0
1668512916319,ECE 271B,A00,103666,Vasconcelos; Manuela,0,76,0,0
1668512916743,ECE 276A,A00,103667,Atanasov; Nikolay A.,0,126,0,0
1668512917173,ECE 277,A00,103668,An; Cheolhong,0,149,0,0
1668512917601,ECE 279,A00,117947,Hall; Drew A.,0,22,0,0
1668512918455,ECE 283,A00,103670,Hsueh; Tzu-Chien,0,53,0,0
1668512918888,ECE 284,A00,103671,Turakhia; Yatish Girish,0,39,0,0
1668512919316,ECE 285,A00,103672,Zheng; Yang,0,39,0,0
1668512919316,ECE 285,B00,103673,Sworder; David D.,0,57,0,0
1668512919739,ECE 287,A00,103676,Javidi; Tara,0,9,0,0
1668512920167,MATH 200B,A00,098023,Salehi Golsefidy; Alireza,10,0,15,5
1668512920600,MATH 202B,A00,098024,Rhoades; Brendon Patrick,7,0,15,8
1668512921024,MATH 203B,A00,098025,Oprea; Dragos N.,9,0,15,6
1668512921457,MATH 204B,A00,098026,Sorensen; Claus M,13,0,15,2
1668512921879,MATH 208,A00,098027,Izadi; Elham,7,0,10,3
1668512922381,MATH 209,A00,098028,Pollack; Aaron,10,0,10,0
1668512922807,MATH 211A,A00,112919,Rogalski; Daniel,8,0,10,2
1668512923237,MATH 211B,A00,112920,Seward; Brandon M.,9,0,10,1
1668512923663,MATH 218,A00,098029,Li; Bo,10,0,10,0
1668512924091,MATH 220B,A00,098030,Novak; Jonathan I,11,0,15,4
1668512924515,MATH 221A,A00,098031,Ebenfelt; Peter F,12,0,15,3
1668512924947,MATH 231B,A00,098032,Zlatos; Andrej,11,0,15,4
1668512925371,MATH 240B,A00,098033,Ni; Lei,7,0,15,8
1668512925805,MATH 243,A00,098034,Jekel; David Andrew,10,0,10,0
1668512926230,MATH 245A,A00,098035,Nie; Jiawang,0,4,15,18
1668512926655,MATH 248,A00,098036,Bejenaru; Ioan,10,0,10,0
1668512927079,MATH 250B,A00,098037,Spolaor; Luca,14,0,15,1
1668512927506,MATH 258,A00,098038,Ni; Lei,9,0,10,1
1668512927937,MATH 264B,A00,098041,Rhoades; Brendon Patrick,8,0,15,7
1668512928363,MATH 268,A00,098042,Buss; Samuel R,10,0,10,0
1668512928790,MATH 269,A00,098043,Rhoades; Brendon Patrick,10,0,10,0
1668512929219,MATH 270B,A00,098044,Li; Bo,6,0,15,9
1668512929644,MATH 272B,A00,098045,Holst; Michael J,13,0,15,2
1668512930070,MATH 273A,A00,098046,Tian; Xiaochuan,10,0,15,5
1668512930499,MATH 275,A01,098048,Tian; Xiaochuan,6,0,10,4
1668512930923,MATH 278A,A00,098049,Holst; Michael J,7,0,10,3
1668512931355,MATH 278B,A00,098050,Cloninger; Alexander,10,0,10,0
1668512931779,MATH 278C,A00,098051,Nie; Jiawang,5,0,10,5
1668512932203,MATH 280B,A00,098052,Zheng; Tianyi,7,0,15,8
1668512932631,MATH 281B,A00,098053,Bradic; Jelena,0,2,15,15
1668512933056,MATH 282B,A00,098054,Arias-Castro; Ery,0,1,15,15
1668512933483,MATH 285,A00,098055,Fitzsimmons; Patrick J,0,3,15,17
1668512933910,MATH 287B,A00,098056,Arias-Castro; Ery,1,0,15,14
1668512934335,MATH 288,A00,098057,Agarwal; Pooja,9,0,10,1
1668512934335,MATH 288,B00,098058,Zhang; Danna,8,0,10,2
1668512934335,MATH 288,C00,098059,Williams; Ruth J,9,0,10,1
1668512934760,MATH 290B,A00,098060,Roberts; Justin Deritter,12,0,15,3
1668512935186,MATH 292,A00,098061,Belmont; Eva Kinoshita,10,0,10,0
1668512935614,MATH 295,A00,098062,Suk; Andrew Hoon,47,0,50,3
1668512936040,MATH 296,A00,098063,Novak; Jonathan I,20,0,20,0
1668512936465,MATH 297,001,098064,Gamst; Anthony Collins,9997,0,9999,2
1668513439114,COGS 205,A00,101395,Chiba; Andrea,19,0,20,1
1668513439548,COGS 210B,001,101404,Greene; Deanna Jacquelyn,9998,0,9999,1
1668513439548,COGS 210B,002,101417,Xia; Haijun,9999,0,9999,0
1668513439548,COGS 210B,003,101422,Nitz; Douglas A.,9999,0,9999,0
1668513439548,COGS 210B,004,101423,Hollan; James D.,9998,0,9999,1
1668513439548,COGS 210B,005,101424,Deak; Gedeon O.,9998,0,9999,1
1668513439548,COGS 210B,006,101425,Rossano; Federico,9999,0,9999,0
1668513439973,COGS 211B,A00,101427,Coulson; Seana M,9996,0,9999,3
1668513440398,COGS 220,A00,101428,Hollan; James D.,0,10,25,25
1668513440825,COGS 229,A00,101429,Dow; Steven P,17,0,25,8
1668513441250,COGS 230,A00,101430,Klemmer; Scott R,7,0,17,10
1668513441680,COGS 234,A00,101431,Xia; Haijun,1,0,25,24
1668513442105,COGS 260,A00,101432,Kiyonaga; Anastasia,21,0,25,4
1668513442105,COGS 260,B00,101433,Kirsh; David Joel,15,0,25,10
1668513442532,CSE 202,A00,102371,Impagliazzo; Russell,0,65,0,0
1668513442961,CSE 203B,A01,102373,Cheng; Chung Kuan,0,58,0,0
1668513443384,CSE 208,A00,102374,Micciancio; Daniele,0,5,0,0
1668513443891,CSE 209A,A00,112895,Impagliazzo; Russell,0,12,15,15
1668513444317,CSE 209B,A00,108005,Bellare; Mihir,0,7,0,0
1668513444740,CSE 210,A00,113163,Coblenz; Michael J,0,84,0,0
1668513445167,CSE 219,A00,106111,Dow; Steven P,0,6,20,20
1668513445594,CSE 221,A00,102376,Voelker; Geoffrey M.,0,73,0,0
1668513446018,CSE 224,A01,102378,Porter; George M,0,166,0,0
1668513446445,CSE 229A,A00,102379,Savage; Stefan,0,10,0,0
1668513446875,CSE 229C,A00,102380,Munyaka; Imani N. S.,0,10,0,0
1668513447303,CSE 232B,A00,102382,Deutsch; Alin Bernard,0,32,0,0
1668513447730,CSE 234,A01,112904,Kumar; Arun Kumar,0,0,0,0
1668513448164,CSE 237A,A00,102383,Rosing; Tajana Simunic,0,55,0,0
1668513448597,CSE 239A,A00,102384,Deutsch; Alin Bernard,0,14,0,0
1668513449026,CSE 239B,A00,102385,Polikarpova; Nadezhda,0,10,0,0
1668513449450,CSE 240A,A00,102386,Pannuto; Patrick William,0,46,0,0
1668513449875,CSE 240B,A00,102387,Zhao; Jishen,0,47,0,0
1668513450301,CSE 241A,A00,106406,Kang; Mingu,0,9,0,0
1668513450725,CSE 249B,A00,102388,Kahng; Andrew Byun,0,5,8,8
1668513451150,CSE 251B,A01,102392,Cottrell; Garrison W,0,51,0,0
1668513451150,CSE 251B,A02,102393,Cottrell; Garrison W,0,34,0,0
1668513451574,CSE 252B,A00,102394,Ochoa; Benjamin Lawrence,0,59,0,0
1668513452004,CSE 257,A01,102396,Gao; Sicun,0,139,0,0
1668513452429,CSE 272,A00,102397,Li; Tzumao,0,19,0,0
1668513452859,CSE 274,A00,111323,Chern; Albert Ren-Haur,0,15,0,0
1668513453285,CSE 282,A00,102398,Pevzner; Pavel Arkadjevich,0,0,0,0
1668513453710,CSE 284,A00,114175,Gymrek; Melissa Ann,0,22,0,0
1668513454136,CSE 290,A00,102399,Chandraker; Manmohan Krishna,0,11,0,0
1668513454136,CSE 290,B00,102400,Vaccaro; Kristen Marie,0,7,25,25
1668513454136,CSE 290,C00,102414,Pannuto; Patrick William,0,1,25,25
1668513454136,CSE 290,D00,102427,Pevzner; Pavel Arkadjevich,0,0,0,0
1668513454136,CSE 290,E00,102429,Zhao; Jishen,0,4,0,0
1668513454136,CSE 290,F00,102436,Tullsen; Dean Michael,0,5,0,0
1668513454136,CSE 290,G00,102440,Christensen; Henrik I,0,6,20,20
1668513454574,CSE 291,A00,102443,Su; Hao,0,0,0,0
1668513454574,CSE 291,B00,102448,Polikarpova; Nadezhda,0,0,0,0
1668513454574,CSE 291,C00,102453,Vaccaro; Kristen Marie,0,0,0,0
1668513454574,CSE 291,D00,111343,Savage; Stefan,0,0,0,0
1668513454574,CSE 291,E00,116474,Claffy; Kimberly Claire,0,0,0,0
1668513454574,CSE 291,F00,116479,Pasquale; Joseph,0,0,0,0
1668513455034,CSE 293,001,119111,Bafna; Vineet,9999,0,9999,0
1668513455034,CSE 293,002,119118,Bellare; Mihir,9999,0,9999,0
1668513455034,CSE 293,003,119122,Berg-Kirkpatrick; Taylor D,9999,0,9999,0
1668513455034,CSE 293,004,119135,Christensen; Henrik I,9999,0,9999,0
1668513455034,CSE 293,005,119142,Cottrell; Garrison W,9999,0,9999,0
1668513455034,CSE 293,006,119146,Deutsch; Alin Bernard,9999,0,9999,0
1668513455034,CSE 293,007,119159,Esmaeilzadeh; Hadi,9999,0,9999,0
1668513455034,CSE 293,008,119166,Freund; Yoav,9999,0,9999,0
1668513455034,CSE 293,009,119170,Griswold; William G.,9999,0,9999,0
1668513455034,CSE 293,010,119183,Gymrek; Melissa Ann,9999,0,9999,0
1668513455034,CSE 293,011,119190,Heninger; Nadia A,9999,0,9999,0
1668513455034,CSE 293,012,119230,Impagliazzo; Russell,9999,0,9999,0
1668513455034,CSE 293,013,119232,Jhala; Ranjit,9999,0,9999,0
1668513455034,CSE 293,014,119233,Kahng; Andrew Byun,9999,0,9999,0
1668513455034,CSE 293,015,119298,Kane; Daniel Mertz,9999,0,9999,0
1668513455034,CSE 293,016,119299,Kriegman; David J,9999,0,9999,0
1668513455034,CSE 293,017,119300,Kumar; Arun Kumar,9999,0,9999,0
1668513455034,CSE 293,018,119301,Lerner; Sorin,9999,0,9999,0
1668513455034,CSE 293,019,119302,Lovett; Shachar,9999,0,9999,0
1668513455034,CSE 293,020,119303,McAuley; Julian John,9999,0,9999,0
1668513455034,CSE 293,021,119304,Micciancio; Daniele,9999,0,9999,0
1668513455034,CSE 293,022,119367,Orailoglu; Alex,9999,0,9999,0
1668513455034,CSE 293,023,119382,Paturi; Ramamohan,9999,0,9999,0
1668513455034,CSE 293,024,119404,Polikarpova; Nadezhda,9999,0,9999,0
1668513455034,CSE 293,025,119406,Politz; Joseph Gibbs,9999,0,9999,0
1668513455034,CSE 293,026,119411,Porter; George M,9999,0,9999,0
1668513455034,CSE 293,027,119414,Porter; Leonard Emerson,9999,0,9999,0
1668513455034,CSE 293,028,119416,Ramamoorthi; Ravi,9999,0,9999,0
1668513455034,CSE 293,029,119417,Sahoo; Debashis,9999,0,9999,0
1668513455034,CSE 293,030,119420,Saul; Lawrence,9999,0,9999,0
1668513455034,CSE 293,031,119421,Savage; Stefan,9999,0,9999,0
1668513455034,CSE 293,032,119425,Schulze; Jurgen P.,9999,0,9999,0
1668513455034,CSE 293,033,119426,Snoeren; Alex C.,9999,0,9999,0
1668513455034,CSE 293,034,119428,Shang; Jingbo,9999,0,9999,0
1668513455034,CSE 293,035,119430,Stefan; Deian,9999,0,9999,0
1668513455034,CSE 293,036,119431,Su; Hao,9999,0,9999,0
1668513455034,CSE 293,037,119433,Swanson; Steven James,9999,0,9999,0
1668513455034,CSE 293,038,119435,Tullsen; Dean Michael,9999,0,9999,0
1668513455034,CSE 293,039,119483,Voelker; Geoffrey M.,9999,0,9999,0
1668513455034,CSE 293,040,119537,Zhao; Jishen,9999,0,9999,0
1668513455034,CSE 293,041,119538,Zhou; Yuan-Yuan,9999,0,9999,0
1668513455034,CSE 293,042,119539,Gao; Sicun,9999,0,9999,0
1668513455034,CSE 293,043,119540,Weibel; Nadir,9999,0,9999,0
1668513455034,CSE 293,044,119541,Gupta; Rajesh K.,9999,0,9999,0
1668513455034,CSE 293,045,126410,Vaccaro; Kristen Marie,9999,0,9999,0
1668513455034,CSE 293,046,126411,Klemke; Richard,9999,0,9999,0
1668513455460,CSE 294,A00,102459,Voelker; Geoffrey M.,0,2,0,0
1668513455460,CSE 294,B00,111322,Orailoglu; Alex,0,2,0,0
1668513455884,DSE 201,A00,096914,Deutsch; Alin Bernard,30,0,30,0
1668513456310,DSE 210,A00,096915,Dasgupta; Sanjoy,30,0,30,0
1668513456746,DSE 260A,A00,096916,Altintas De Callaf; Ilkay,30,0,30,0
1668513457203,ECE 200,001,103586,Antipa; Nicholas A,9999,0,9999,0
1668513457203,ECE 200,002,103587,Atanasov; Nikolay A.,9999,0,9999,0
1668513457203,ECE 200,003,103588,Bharadia; Dinesh,9999,0,9999,0
1668513457203,ECE 200,004,103589,Cheng; Chung Kuan,9999,0,9999,0
1668513457203,ECE 200,005,103590,Cosman; Pamela C.,9999,0,9999,0
1668513457203,ECE 200,006,103591,Dayeh; Shadi Ahmad,9999,0,9999,0
1668513457203,ECE 200,007,103592,Fainman; Yeshaiahu,9999,0,9999,0
1668513457203,ECE 200,008,103593,Ford; Joseph Earl,9999,0,9999,0
1668513457203,ECE 200,009,103594,Franceschetti; Massimo,9999,0,9999,0
1668513457203,ECE 200,010,103595,Fullerton; Eric E,9999,0,9999,0
1668513457203,ECE 200,011,103596,Galton; Ian A,9999,0,9999,0
1668513457203,ECE 200,012,103597,Gilja; Vikash,9999,0,9999,0
1668513457203,ECE 200,013,103598,Hall; Drew A.,9999,0,9999,0
1668513457203,ECE 200,014,103599,Hsueh; Tzu-Chien,9999,0,9999,0
1668513457203,ECE 200,015,103600,Javidi; Tara,9999,0,9999,0
1668513457203,ECE 200,016,103601,Kahng; Andrew Byun,9999,0,9999,0
1668513457203,ECE 200,017,103602,Kim; Young-Han,9999,0,9999,0
1668513457203,ECE 200,018,103603,Koushanfar; Farinaz,9999,0,9999,0
1668513457203,ECE 200,019,103604,Kuzum; Duygu,9999,0,9999,0
1668513457203,ECE 200,020,103605,Le; Hanh-Phuc,9999,0,9999,0
1668513457203,ECE 200,021,103606,Lin; Bill,9999,0,9999,0
1668513457203,ECE 200,022,103607,Liu; Zhaowei,9998,0,9999,1
1668513457203,ECE 200,023,103608,Lo; Yu-Hwa,9999,0,9999,0
1668513457203,ECE 200,024,103609,Lomakin; Vitaliy,9999,0,9999,0
1668513457203,ECE 200,025,103610,Mercier; Patrick Philip,9999,0,9999,0
1668513457203,ECE 200,026,103611,Meyer; Florian,9999,0,9999,0
1668513457203,ECE 200,027,103612,Milstein; Laurence B.,9999,0,9999,0
1668513457203,ECE 200,028,103613,Mir Arabbaygi; Siavash,9999,0,9999,0
1668513457203,ECE 200,029,103614,Mookherjea; Shayan,9999,0,9999,0
1668513457203,ECE 200,030,103615,Morris; Karcher William,9999,0,9999,0
1668513457203,ECE 200,031,103616,Ng; Tse Nga,9999,0,9999,0
1668513457203,ECE 200,032,103617,Nguyen; Truong Quang,9999,0,9999,0
1668513457203,ECE 200,033,103618,Nomura; Kenji,9999,0,9999,0
1668513457203,ECE 200,034,103619,Orlitsky; Alon,9999,0,9999,0
1668513457203,ECE 200,035,103620,Pal; Piya,9999,0,9999,0
1668513457203,ECE 200,036,103621,Papen; George C.,9999,0,9999,0
1668513457203,ECE 200,037,103622,Radic; Stojan,9999,0,9999,0
1668513457203,ECE 200,038,103623,Rao; Bhaskar D.,9999,0,9999,0
1668513457203,ECE 200,039,103624,Rao; Ramesh R,9999,0,9999,0
1668513457203,ECE 200,040,103625,Rebeiz; Gabriel,9999,0,9999,0
1668513457203,ECE 200,041,103626,Sanford; John R,9999,0,9999,0
1668513457203,ECE 200,042,103627,Siegel; Paul H.,9999,0,9999,0
1668513457203,ECE 200,043,103628,Sievenpiper; Daniel F.,9999,0,9999,0
1668513457203,ECE 200,044,103629,Sworder; David D.,9999,0,9999,0
1668513457203,ECE 200,045,103630,Taur; Yuan,9999,0,9999,0
1668513457203,ECE 200,046,103631,Touri; Behrouz,9999,0,9999,0
1668513457203,ECE 200,047,103632,Trivedi; Mohan M.,9999,0,9999,0
1668513457203,ECE 200,048,103633,Vasconcelos; Nuno,9999,0,9999,0
1668513457203,ECE 200,049,103634,Wang; Xiaolong,9999,0,9999,0
1668513457203,ECE 200,050,103635,Xie; Pengtao,9999,0,9999,0
1668513457203,ECE 200,051,103636,Yip; Michael,9999,0,9999,0
1668513457203,ECE 200,052,103637,Zeger; Kenneth A.,999,0,999,0
1668513457203,ECE 200,053,103638,Zhang; Xinyu,9999,0,9999,0
1668513457203,ECE 200,054,103639,Turakhia; Yatish Girish,9999,0,9999,0
1668513457203,ECE 200,055,103640,Kang; Mingu,9999,0,9999,0
1668513457203,ECE 200,056,103641,Shi; Yuanyuan,9999,0,9999,0
1668513457203,ECE 200,057,103642,Wang; Edward Jay,9999,0,9999,0
1668513457203,ECE 200,058,103643,Zheng; Yang,9999,0,9999,0
1668513457628,ECE 202,A00,103644,Kuzum; Duygu,0,44,0,0
1668513458056,ECE 212BN,A00,103646,Ng; Tse Nga,0,9,0,0
1668513458479,ECE 221,A00,111493,Staff,0,0,0,0
1668513458905,ECE 222B,A00,103647,Lomakin; Vitaliy,0,20,0,0
1668513459337,ECE 230B,A00,103648,Taur; Yuan,0,3,0,0
1668513459762,ECE 238B,A00,103649,Garay; Javier,0,0,0,0
1668513460185,ECE 240B,A00,112900,Fainman; Yeshaiahu,0,7,0,0
1668513460613,ECE 247A,A00,103650,Jokerst; Jesse Vincent,0,6,0,0
1668513461038,ECE 247B,A00,103651,Wang; Joseph,0,14,0,0
1668513461461,ECE 250,A00,103652,Siegel; Paul H.,0,82,0,0
1668513461895,ECE 251A,A00,103654,Rao; Bhaskar D.,0,62,0,0
1668513462320,ECE 257B,A00,103655,Bharadia; Dinesh,0,33,0,0
1668513462748,ECE 258A,A00,103656,Milstein; Laurence B.,0,29,0,0
1668513463174,ECE 260B,A00,103658,Kang; Mingu,0,119,0,0
1668513463597,ECE 264A,A00,103659,Galton; Ian A,0,66,0,0
1668513464026,ECE 265A,A00,103661,Gudem; Prasad S.S.,0,70,0,0
1668513464451,ECE 265D,A00,103662,Gudem; Prasad S.S.,0,26,0,0
1668513464876,ECE 268,A00,103663,Koushanfar; Farinaz,0,43,0,0
1668513465299,ECE 269,A01,103665,Pal; Piya,0,215,0,0
1668513465726,ECE 271B,A00,103666,Vasconcelos; Manuela,0,76,0,0
1668513466152,ECE 276A,A00,103667,Atanasov; Nikolay A.,0,126,0,0
1668513466578,ECE 277,A00,103668,An; Cheolhong,0,149,0,0
1668513467002,ECE 279,A00,117947,Hall; Drew A.,0,22,0,0
1668513467857,ECE 283,A00,103670,Hsueh; Tzu-Chien,0,53,0,0
1668513468282,ECE 284,A00,103671,Turakhia; Yatish Girish,0,39,0,0
1668513468806,ECE 285,A00,103672,Zheng; Yang,0,39,0,0
1668513468806,ECE 285,B00,103673,Sworder; David D.,0,57,0,0
1668513469232,ECE 287,A00,103676,Javidi; Tara,0,9,0,0
1668513469658,MATH 200B,A00,098023,Salehi Golsefidy; Alireza,10,0,15,5
1668513470088,MATH 202B,A00,098024,Rhoades; Brendon Patrick,7,0,15,8
1668513470514,MATH 203B,A00,098025,Oprea; Dragos N.,9,0,15,6
1668513470939,MATH 204B,A00,098026,Sorensen; Claus M,13,0,15,2
1668513471365,MATH 208,A00,098027,Izadi; Elham,7,0,10,3
1668513471788,MATH 209,A00,098028,Pollack; Aaron,10,0,10,0
1668513472214,MATH 211A,A00,112919,Rogalski; Daniel,8,0,10,2
1668513472638,MATH 211B,A00,112920,Seward; Brandon M.,9,0,10,1
1668513473064,MATH 218,A00,098029,Li; Bo,10,0,10,0
1668513473490,MATH 220B,A00,098030,Novak; Jonathan I,11,0,15,4
1668513473914,MATH 221A,A00,098031,Ebenfelt; Peter F,12,0,15,3
1668513474341,MATH 231B,A00,098032,Zlatos; Andrej,11,0,15,4
1668513474765,MATH 240B,A00,098033,Ni; Lei,7,0,15,8
1668513475190,MATH 243,A00,098034,Jekel; David Andrew,10,0,10,0
1668513475619,MATH 245A,A00,098035,Nie; Jiawang,0,4,15,18
1668513476043,MATH 248,A00,098036,Bejenaru; Ioan,10,0,10,0
1668513476468,MATH 250B,A00,098037,Spolaor; Luca,14,0,15,1
1668513476898,MATH 258,A00,098038,Ni; Lei,9,0,10,1
1668513477325,MATH 264B,A00,098041,Rhoades; Brendon Patrick,8,0,15,7
1668513477753,MATH 268,A00,098042,Buss; Samuel R,10,0,10,0
1668513478178,MATH 269,A00,098043,Rhoades; Brendon Patrick,10,0,10,0
1668513478603,MATH 270B,A00,098044,Li; Bo,6,0,15,9
1668513479027,MATH 272B,A00,098045,Holst; Michael J,13,0,15,2
1668513479454,MATH 273A,A00,098046,Tian; Xiaochuan,10,0,15,5
1668513479882,MATH 275,A01,098048,Tian; Xiaochuan,6,0,10,4
1668513480314,MATH 278A,A00,098049,Holst; Michael J,7,0,10,3
1668513480741,MATH 278B,A00,098050,Cloninger; Alexander,10,0,10,0
1668513481164,MATH 278C,A00,098051,Nie; Jiawang,5,0,10,5
1668513481590,MATH 280B,A00,098052,Zheng; Tianyi,7,0,15,8
1668513482015,MATH 281B,A00,098053,Bradic; Jelena,0,2,15,15
1668513482445,MATH 282B,A00,098054,Arias-Castro; Ery,0,1,15,15
1668513482874,MATH 285,A00,098055,Fitzsimmons; Patrick J,0,3,15,17
1668513483299,MATH 287B,A00,098056,Arias-Castro; Ery,1,0,15,14
1668513483730,MATH 288,A00,098057,Agarwal; Pooja,9,0,10,1
1668513483730,MATH 288,B00,098058,Zhang; Danna,8,0,10,2
1668513483730,MATH 288,C00,098059,Williams; Ruth J,9,0,10,1
1668513484156,MATH 290B,A00,098060,Roberts; Justin Deritter,12,0,15,3
1668513484581,MATH 292,A00,098061,Belmont; Eva Kinoshita,10,0,10,0
1668513485011,MATH 295,A00,098062,Suk; Andrew Hoon,47,0,50,3
1668513485440,MATH 296,A00,098063,Novak; Jonathan I,20,0,20,0
1668513485868,MATH 297,001,098064,Gamst; Anthony Collins,9997,0,9999,2
1668513988237,COGS 205,A00,101395,Chiba; Andrea,19,0,20,1
1668513988662,COGS 210B,001,101404,Greene; Deanna Jacquelyn,9998,0,9999,1
1668513988662,COGS 210B,002,101417,Xia; Haijun,9999,0,9999,0
1668513988662,COGS 210B,003,101422,Nitz; Douglas A.,9999,0,9999,0
1668513988662,COGS 210B,004,101423,Hollan; James D.,9998,0,9999,1
1668513988662,COGS 210B,005,101424,Deak; Gedeon O.,9998,0,9999,1
1668513988662,COGS 210B,006,101425,Rossano; Federico,9999,0,9999,0
1668513989090,COGS 211B,A00,101427,Coulson; Seana M,9996,0,9999,3
1668513989514,COGS 220,A00,101428,Hollan; James D.,0,10,25,25
1668513989937,COGS 229,A00,101429,Dow; Steven P,17,0,25,8
1668513990385,COGS 230,A00,101430,Klemmer; Scott R,7,0,17,10
1668513990816,COGS 234,A00,101431,Xia; Haijun,1,0,25,24
1668513991240,COGS 260,A00,101432,Kiyonaga; Anastasia,21,0,25,4
1668513991240,COGS 260,B00,101433,Kirsh; David Joel,15,0,25,10
1668513991673,CSE 202,A00,102371,Impagliazzo; Russell,0,66,0,0
1668513992099,CSE 203B,A01,102373,Cheng; Chung Kuan,0,58,0,0
1668513992523,CSE 208,A00,102374,Micciancio; Daniele,0,5,0,0
1668513992946,CSE 209A,A00,112895,Impagliazzo; Russell,0,12,15,15
1668513993375,CSE 209B,A00,108005,Bellare; Mihir,0,7,0,0
1668513993801,CSE 210,A00,113163,Coblenz; Michael J,0,85,0,0
1668513994225,CSE 219,A00,106111,Dow; Steven P,0,6,20,20
1668513994656,CSE 221,A00,102376,Voelker; Geoffrey M.,0,73,0,0
1668513995079,CSE 224,A01,102378,Porter; George M,0,166,0,0
1668513995506,CSE 229A,A00,102379,Savage; Stefan,0,10,0,0
1668513995932,CSE 229C,A00,102380,Munyaka; Imani N. S.,0,10,0,0
1668513996368,CSE 232B,A00,102382,Deutsch; Alin Bernard,0,32,0,0
1668513996793,CSE 234,A01,112904,Kumar; Arun Kumar,0,0,0,0
1668513997224,CSE 237A,A00,102383,Rosing; Tajana Simunic,0,55,0,0
1668513998096,CSE 239A,A00,102384,Deutsch; Alin Bernard,0,14,0,0
1668513998520,CSE 239B,A00,102385,Polikarpova; Nadezhda,0,10,0,0
1668513998944,CSE 240A,A00,102386,Pannuto; Patrick William,0,46,0,0
1668513999373,CSE 240B,A00,102387,Zhao; Jishen,0,47,0,0
1668513999802,CSE 241A,A00,106406,Kang; Mingu,0,9,0,0
1668514000227,CSE 249B,A00,102388,Kahng; Andrew Byun,0,5,8,8
1668514000652,CSE 251B,A01,102392,Cottrell; Garrison W,0,51,0,0
1668514000652,CSE 251B,A02,102393,Cottrell; Garrison W,0,34,0,0
1668514001076,CSE 252B,A00,102394,Ochoa; Benjamin Lawrence,0,59,0,0
1668514001503,CSE 257,A01,102396,Gao; Sicun,0,139,0,0
1668514001927,CSE 272,A00,102397,Li; Tzumao,0,19,0,0
1668514002355,CSE 274,A00,111323,Chern; Albert Ren-Haur,0,15,0,0
1668514002781,CSE 282,A00,102398,Pevzner; Pavel Arkadjevich,0,0,0,0
1668514003210,CSE 284,A00,114175,Gymrek; Melissa Ann,0,22,0,0
1668514003637,CSE 290,A00,102399,Chandraker; Manmohan Krishna,0,11,0,0
1668514003637,CSE 290,B00,102400,Vaccaro; Kristen Marie,0,7,25,25
1668514003637,CSE 290,C00,102414,Pannuto; Patrick William,0,1,25,25
1668514003637,CSE 290,D00,102427,Pevzner; Pavel Arkadjevich,0,0,0,0
1668514003637,CSE 290,E00,102429,Zhao; Jishen,0,4,0,0
1668514003637,CSE 290,F00,102436,Tullsen; Dean Michael,0,5,0,0
1668514003637,CSE 290,G00,102440,Christensen; Henrik I,0,6,20,20
1668514004063,CSE 291,A00,102443,Su; Hao,0,0,0,0
1668514004063,CSE 291,B00,102448,Polikarpova; Nadezhda,0,0,0,0
1668514004063,CSE 291,C00,102453,Vaccaro; Kristen Marie,0,0,0,0
1668514004063,CSE 291,D00,111343,Savage; Stefan,0,0,0,0
1668514004063,CSE 291,E00,116474,Claffy; Kimberly Claire,0,0,0,0
1668514004063,CSE 291,F00,116479,Pasquale; Joseph,0,0,0,0
1668514004517,CSE 293,001,119111,Bafna; Vineet,9999,0,9999,0
1668514004517,CSE 293,002,119118,Bellare; Mihir,9999,0,9999,0
1668514004517,CSE 293,003,119122,Berg-Kirkpatrick; Taylor D,9999,0,9999,0
1668514004517,CSE 293,004,119135,Christensen; Henrik I,9999,0,9999,0
1668514004517,CSE 293,005,119142,Cottrell; Garrison W,9999,0,9999,0
1668514004517,CSE 293,006,119146,Deutsch; Alin Bernard,9999,0,9999,0
1668514004517,CSE 293,007,119159,Esmaeilzadeh; Hadi,9999,0,9999,0
1668514004517,CSE 293,008,119166,Freund; Yoav,9999,0,9999,0
1668514004517,CSE 293,009,119170,Griswold; William G.,9999,0,9999,0
1668514004517,CSE 293,010,119183,Gymrek; Melissa Ann,9999,0,9999,0
1668514004517,CSE 293,011,119190,Heninger; Nadia A,9999,0,9999,0
1668514004517,CSE 293,012,119230,Impagliazzo; Russell,9999,0,9999,0
1668514004517,CSE 293,013,119232,Jhala; Ranjit,9999,0,9999,0
1668514004517,CSE 293,014,119233,Kahng; Andrew Byun,9999,0,9999,0
1668514004517,CSE 293,015,119298,Kane; Daniel Mertz,9999,0,9999,0
1668514004517,CSE 293,016,119299,Kriegman; David J,9999,0,9999,0
1668514004517,CSE 293,017,119300,Kumar; Arun Kumar,9999,0,9999,0
1668514004517,CSE 293,018,119301,Lerner; Sorin,9999,0,9999,0
1668514004517,CSE 293,019,119302,Lovett; Shachar,9999,0,9999,0
1668514004517,CSE 293,020,119303,McAuley; Julian John,9999,0,9999,0
1668514004517,CSE 293,021,119304,Micciancio; Daniele,9999,0,9999,0
1668514004517,CSE 293,022,119367,Orailoglu; Alex,9999,0,9999,0
1668514004517,CSE 293,023,119382,Paturi; Ramamohan,9999,0,9999,0
1668514004517,CSE 293,024,119404,Polikarpova; Nadezhda,9999,0,9999,0
1668514004517,CSE 293,025,119406,Politz; Joseph Gibbs,9999,0,9999,0
1668514004517,CSE 293,026,119411,Porter; George M,9999,0,9999,0
1668514004517,CSE 293,027,119414,Porter; Leonard Emerson,9999,0,9999,0
1668514004517,CSE 293,028,119416,Ramamoorthi; Ravi,9999,0,9999,0
1668514004517,CSE 293,029,119417,Sahoo; Debashis,9999,0,9999,0
1668514004517,CSE 293,030,119420,Saul; Lawrence,9999,0,9999,0
1668514004517,CSE 293,031,119421,Savage; Stefan,9999,0,9999,0
1668514004517,CSE 293,032,119425,Schulze; Jurgen P.,9999,0,9999,0
1668514004517,CSE 293,033,119426,Snoeren; Alex C.,9999,0,9999,0
1668514004517,CSE 293,034,119428,Shang; Jingbo,9999,0,9999,0
1668514004517,CSE 293,035,119430,Stefan; Deian,9999,0,9999,0
1668514004517,CSE 293,036,119431,Su; Hao,9999,0,9999,0
1668514004517,CSE 293,037,119433,Swanson; Steven James,9999,0,9999,0
1668514004517,CSE 293,038,119435,Tullsen; Dean Michael,9999,0,9999,0
1668514004517,CSE 293,039,119483,Voelker; Geoffrey M.,9999,0,9999,0
1668514004517,CSE 293,040,119537,Zhao; Jishen,9999,0,9999,0
1668514004517,CSE 293,041,119538,Zhou; Yuan-Yuan,9999,0,9999,0
1668514004517,CSE 293,042,119539,Gao; Sicun,9999,0,9999,0
1668514004517,CSE 293,043,119540,Weibel; Nadir,9999,0,9999,0
1668514004517,CSE 293,044,119541,Gupta; Rajesh K.,9999,0,9999,0
1668514004517,CSE 293,045,126410,Vaccaro; Kristen Marie,9999,0,9999,0
1668514004517,CSE 293,046,126411,Klemke; Richard,9999,0,9999,0
1668514004941,CSE 294,A00,102459,Voelker; Geoffrey M.,0,2,0,0
1668514004941,CSE 294,B00,111322,Orailoglu; Alex,0,2,0,0
1668514005365,DSE 201,A00,096914,Deutsch; Alin Bernard,30,0,30,0
1668514005796,DSE 210,A00,096915,Dasgupta; Sanjoy,30,0,30,0
1668514006220,DSE 260A,A00,096916,Altintas De Callaf; Ilkay,30,0,30,0
1668514006686,ECE 200,001,103586,Antipa; Nicholas A,9999,0,9999,0
1668514006686,ECE 200,002,103587,Atanasov; Nikolay A.,9999,0,9999,0
1668514006686,ECE 200,003,103588,Bharadia; Dinesh,9999,0,9999,0
1668514006686,ECE 200,004,103589,Cheng; Chung Kuan,9999,0,9999,0
1668514006686,ECE 200,005,103590,Cosman; Pamela C.,9999,0,9999,0
1668514006686,ECE 200,006,103591,Dayeh; Shadi Ahmad,9999,0,9999,0
1668514006686,ECE 200,007,103592,Fainman; Yeshaiahu,9999,0,9999,0
1668514006686,ECE 200,008,103593,Ford; Joseph Earl,9999,0,9999,0
1668514006686,ECE 200,009,103594,Franceschetti; Massimo,9999,0,9999,0
1668514006686,ECE 200,010,103595,Fullerton; Eric E,9999,0,9999,0
1668514006686,ECE 200,011,103596,Galton; Ian A,9999,0,9999,0
1668514006686,ECE 200,012,103597,Gilja; Vikash,9999,0,9999,0
1668514006686,ECE 200,013,103598,Hall; Drew A.,9999,0,9999,0
1668514006686,ECE 200,014,103599,Hsueh; Tzu-Chien,9999,0,9999,0
1668514006686,ECE 200,015,103600,Javidi; Tara,9999,0,9999,0
1668514006686,ECE 200,016,103601,Kahng; Andrew Byun,9999,0,9999,0
1668514006686,ECE 200,017,103602,Kim; Young-Han,9999,0,9999,0
1668514006686,ECE 200,018,103603,Koushanfar; Farinaz,9999,0,9999,0
1668514006686,ECE 200,019,103604,Kuzum; Duygu,9999,0,9999,0
1668514006686,ECE 200,020,103605,Le; Hanh-Phuc,9999,0,9999,0
1668514006686,ECE 200,021,103606,Lin; Bill,9999,0,9999,0
1668514006686,ECE 200,022,103607,Liu; Zhaowei,9998,0,9999,1
1668514006686,ECE 200,023,103608,Lo; Yu-Hwa,9999,0,9999,0
1668514006686,ECE 200,024,103609,Lomakin; Vitaliy,9999,0,9999,0
1668514006686,ECE 200,025,103610,Mercier; Patrick Philip,9999,0,9999,0
1668514006686,ECE 200,026,103611,Meyer; Florian,9999,0,9999,0
1668514006686,ECE 200,027,103612,Milstein; Laurence B.,9999,0,9999,0
1668514006686,ECE 200,028,103613,Mir Arabbaygi; Siavash,9999,0,9999,0
1668514006686,ECE 200,029,103614,Mookherjea; Shayan,9999,0,9999,0
1668514006686,ECE 200,030,103615,Morris; Karcher William,9999,0,9999,0
1668514006686,ECE 200,031,103616,Ng; Tse Nga,9999,0,9999,0
1668514006686,ECE 200,032,103617,Nguyen; Truong Quang,9999,0,9999,0
1668514006686,ECE 200,033,103618,Nomura; Kenji,9999,0,9999,0
1668514006686,ECE 200,034,103619,Orlitsky; Alon,9999,0,9999,0
1668514006686,ECE 200,035,103620,Pal; Piya,9999,0,9999,0
1668514006686,ECE 200,036,103621,Papen; George C.,9999,0,9999,0
1668514006686,ECE 200,037,103622,Radic; Stojan,9999,0,9999,0
1668514006686,ECE 200,038,103623,Rao; Bhaskar D.,9999,0,9999,0
1668514006686,ECE 200,039,103624,Rao; Ramesh R,9999,0,9999,0
1668514006686,ECE 200,040,103625,Rebeiz; Gabriel,9999,0,9999,0
1668514006686,ECE 200,041,103626,Sanford; John R,9999,0,9999,0
1668514006686,ECE 200,042,103627,Siegel; Paul H.,9999,0,9999,0
1668514006686,ECE 200,043,103628,Sievenpiper; Daniel F.,9999,0,9999,0
1668514006686,ECE 200,044,103629,Sworder; David D.,9999,0,9999,0
1668514006686,ECE 200,045,103630,Taur; Yuan,9999,0,9999,0
1668514006686,ECE 200,046,103631,Touri; Behrouz,9999,0,9999,0
1668514006686,ECE 200,047,103632,Trivedi; Mohan M.,9999,0,9999,0
1668514006686,ECE 200,048,103633,Vasconcelos; Nuno,9999,0,9999,0
1668514006686,ECE 200,049,103634,Wang; Xiaolong,9999,0,9999,0
1668514006686,ECE 200,050,103635,Xie; Pengtao,9999,0,9999,0
1668514006686,ECE 200,051,103636,Yip; Michael,9999,0,9999,0
1668514006686,ECE 200,052,103637,Zeger; Kenneth A.,999,0,999,0
1668514006686,ECE 200,053,103638,Zhang; Xinyu,9999,0,9999,0
1668514006686,ECE 200,054,103639,Turakhia; Yatish Girish,9999,0,9999,0
1668514006686,ECE 200,055,103640,Kang; Mingu,9999,0,9999,0
1668514006686,ECE 200,056,103641,Shi; Yuanyuan,9999,0,9999,0
1668514006686,ECE 200,057,103642,Wang; Edward Jay,9999,0,9999,0
1668514006686,ECE 200,058,103643,Zheng; Yang,9999,0,9999,0
1668514007112,ECE 202,A00,103644,Kuzum; Duygu,0,44,0,0
1668514007542,ECE 212BN,A00,103646,Ng; Tse Nga,0,9,0,0
1668514007966,ECE 221,A00,111493,Staff,0,0,0,0
1668514008399,ECE 222B,A00,103647,Lomakin; Vitaliy,0,20,0,0
1668514008825,ECE 230B,A00,103648,Taur; Yuan,0,3,0,0
1668514009249,ECE 238B,A00,103649,Garay; Javier,0,0,0,0
1668514009673,ECE 240B,A00,112900,Fainman; Yeshaiahu,0,7,0,0
1668514010103,ECE 247A,A00,103650,Jokerst; Jesse Vincent,0,6,0,0
1668514010533,ECE 247B,A00,103651,Wang; Joseph,0,14,0,0
1668514010964,ECE 250,A00,103652,Siegel; Paul H.,0,82,0,0
1668514011402,ECE 251A,A00,103654,Rao; Bhaskar D.,0,62,0,0
1668514011830,ECE 257B,A00,103655,Bharadia; Dinesh,0,33,0,0
1668514012265,ECE 258A,A00,103656,Milstein; Laurence B.,0,29,0,0
1668514012696,ECE 260B,A00,103658,Kang; Mingu,0,119,0,0
1668514013127,ECE 264A,A00,103659,Galton; Ian A,0,66,0,0
1668514013559,ECE 265A,A00,103661,Gudem; Prasad S.S.,0,70,0,0
1668514013984,ECE 265D,A00,103662,Gudem; Prasad S.S.,0,26,0,0
1668514014408,ECE 268,A00,103663,Koushanfar; Farinaz,0,43,0,0
1668514014831,ECE 269,A01,103665,Pal; Piya,0,215,0,0
1668514015255,ECE 271B,A00,103666,Vasconcelos; Manuela,0,76,0,0
1668514015682,ECE 276A,A00,103667,Atanasov; Nikolay A.,0,126,0,0
1668514016106,ECE 277,A00,103668,An; Cheolhong,0,149,0,0
1668514016546,ECE 279,A00,117947,Hall; Drew A.,0,22,0,0
1668514017403,ECE 283,A00,103670,Hsueh; Tzu-Chien,0,53,0,0
1668514017832,ECE 284,A00,103671,Turakhia; Yatish Girish,0,39,0,0
1668514018262,ECE 285,A00,103672,Zheng; Yang,0,39,0,0
1668514018262,ECE 285,B00,103673,Sworder; David D.,0,57,0,0
1668514018686,ECE 287,A00,103676,Javidi; Tara,0,9,0,0
1668514019111,MATH 200B,A00,098023,Salehi Golsefidy; Alireza,10,0,15,5
1668514019536,MATH 202B,A00,098024,Rhoades; Brendon Patrick,7,0,15,8
1668514019964,MATH 203B,A00,098025,Oprea; Dragos N.,9,0,15,6
1668514020390,MATH 204B,A00,098026,Sorensen; Claus M,13,0,15,2
1668514020819,MATH 208,A00,098027,Izadi; Elham,7,0,10,3
1668514021243,MATH 209,A00,098028,Pollack; Aaron,10,0,10,0
1668514021669,MATH 211A,A00,112919,Rogalski; Daniel,8,0,10,2
1668514022095,MATH 211B,A00,112920,Seward; Brandon M.,9,0,10,1
1668514022527,MATH 218,A00,098029,Li; Bo,10,0,10,0
1668514022963,MATH 220B,A00,098030,Novak; Jonathan I,11,0,15,4
1668514023388,MATH 221A,A00,098031,Ebenfelt; Peter F,12,0,15,3
1668514023826,MATH 231B,A00,098032,Zlatos; Andrej,11,0,15,4
1668514024261,MATH 240B,A00,098033,Ni; Lei,7,0,15,8
1668514024685,MATH 243,A00,098034,Jekel; David Andrew,10,0,10,0
1668514025113,MATH 245A,A00,098035,Nie; Jiawang,0,4,15,18
1668514025538,MATH 248,A00,098036,Bejenaru; Ioan,10,0,10,0
1668514025962,MATH 250B,A00,098037,Spolaor; Luca,14,0,15,1
1668514026388,MATH 258,A00,098038,Ni; Lei,9,0,10,1
1668514026813,MATH 264B,A00,098041,Rhoades; Brendon Patrick,8,0,15,7
1668514027245,MATH 268,A00,098042,Buss; Samuel R,10,0,10,0
1668514027676,MATH 269,A00,098043,Rhoades; Brendon Patrick,10,0,10,0
1668514028112,MATH 270B,A00,098044,Li; Bo,6,0,15,9
1668514028540,MATH 272B,A00,098045,Holst; Michael J,13,0,15,2
1668514028969,MATH 273A,A00,098046,Tian; Xiaochuan,10,0,15,5
1668514029406,MATH 275,A01,098048,Tian; Xiaochuan,6,0,10,4
1668514029832,MATH 278A,A00,098049,Holst; Michael J,7,0,10,3
1668514030256,MATH 278B,A00,098050,Cloninger; Alexander,10,0,10,0
1668514030680,MATH 278C,A00,098051,Nie; Jiawang,5,0,10,5
1668514031109,MATH 280B,A00,098052,Zheng; Tianyi,7,0,15,8
1668514031533,MATH 281B,A00,098053,Bradic; Jelena,0,2,15,15
1668514031960,MATH 282B,A00,098054,Arias-Castro; Ery,0,1,15,15
1668514032393,MATH 285,A00,098055,Fitzsimmons; Patrick J,0,3,15,17
1668514032822,MATH 287B,A00,098056,Arias-Castro; Ery,1,0,15,14
1668514033254,MATH 288,A00,098057,Agarwal; Pooja,9,0,10,1
1668514033254,MATH 288,B00,098058,Zhang; Danna,8,0,10,2
1668514033254,MATH 288,C00,098059,Williams; Ruth J,9,0,10,1
1668514033679,MATH 290B,A00,098060,Roberts; Justin Deritter,12,0,15,3
1668514034104,MATH 292,A00,098061,Belmont; Eva Kinoshita,10,0,10,0
1668514034529,MATH 295,A00,098062,Suk; Andrew Hoon,47,0,50,3
1668514034952,MATH 296,A00,098063,Novak; Jonathan I,20,0,20,0
1668514035377,MATH 297,001,098064,Gamst; Anthony Collins,9997,0,9999,2
