time,subj_course_id,sec_code,sec_id,prof,available,waitlist,total,enrolled_ct
1668515626116,COGS 205,A00,101395,Chiba; Andrea,19,0,20,1
1668515626546,COGS 210B,001,101404,Greene; Deanna Jacquelyn,9998,0,9999,1
1668515626546,COGS 210B,002,101417,Xia; Haijun,9999,0,9999,0
1668515626546,COGS 210B,003,101422,Nitz; Douglas A.,9999,0,9999,0
1668515626546,COGS 210B,004,101423,Hollan; James D.,9998,0,9999,1
1668515626546,COGS 210B,005,101424,Deak; Gedeon O.,9998,0,9999,1
1668515626546,COGS 210B,006,101425,Rossano; Federico,9999,0,9999,0
1668515626973,COGS 211B,A00,101427,Coulson; Seana M,9996,0,9999,3
1668515627399,COGS 220,A00,101428,Hollan; James D.,0,10,25,25
1668515627826,COGS 229,A00,101429,Dow; Steven P,17,0,25,8
1668515628255,COGS 230,A00,101430,Klemmer; Scott R,7,0,17,10
1668515628683,COGS 234,A00,101431,Xia; Haijun,1,0,25,24
1668515629119,COGS 260,A00,101432,Kiyonaga; Anastasia,21,0,25,4
1668515629119,COGS 260,B00,101433,Kirsh; David Joel,15,0,25,10
1668515629548,CSE 202,A00,102371,Impagliazzo; Russell,0,66,0,0
1668515629978,CSE 203B,A01,102373,Cheng; Chung Kuan,0,58,0,0
1668515630404,CSE 208,A00,102374,Micciancio; Daniele,0,5,0,0
1668515630830,CSE 209A,A00,112895,Impagliazzo; Russell,0,12,15,15
1668515631259,CSE 209B,A00,108005,Bellare; Mihir,0,7,0,0
1668515631691,CSE 210,A00,113163,Coblenz; Michael J,0,85,0,0
1668515632122,CSE 219,A00,106111,Dow; Steven P,0,6,20,20
1668515632553,CSE 221,A00,102376,Voelker; Geoffrey M.,0,73,0,0
1668515632985,CSE 224,A01,102378,Porter; George M,0,166,0,0
1668515633411,CSE 229A,A00,102379,Savage; Stefan,0,10,0,0
1668515633835,CSE 229C,A00,102380,Munyaka; Imani N. S.,0,10,0,0
1668515634262,CSE 232B,A00,102382,Deutsch; Alin Bernard,0,32,0,0
1668515634694,CSE 234,A01,112904,Kumar; Arun Kumar,0,0,0,0
1668515635123,CSE 237A,A00,102383,Rosing; Tajana Simunic,0,55,0,0
1668515635551,CSE 239A,A00,102384,Deutsch; Alin Bernard,0,14,0,0
1668515635980,CSE 239B,A00,102385,Polikarpova; Nadezhda,0,10,0,0
1668515636406,CSE 240A,A00,102386,Pannuto; Patrick William,0,46,0,0
1668515636836,CSE 240B,A00,102387,Zhao; Jishen,0,47,0,0
1668515637265,CSE 241A,A00,106406,Kang; Mingu,0,9,0,0
1668515637692,CSE 249B,A00,102388,Kahng; Andrew Byun,0,5,8,8
1668515638124,CSE 251B,A01,102392,Cottrell; Garrison W,0,51,0,0
1668515638124,CSE 251B,A02,102393,Cottrell; Garrison W,0,34,0,0
1668515638552,CSE 252B,A00,102394,Ochoa; Benjamin Lawrence,0,59,0,0
1668515638981,CSE 257,A01,102396,Gao; Sicun,0,139,0,0
1668515639417,CSE 272,A00,102397,Li; Tzumao,0,19,0,0
1668515639844,CSE 274,A00,111323,Chern; Albert Ren-Haur,0,15,0,0
1668515640273,CSE 282,A00,102398,Pevzner; Pavel Arkadjevich,0,0,0,0
1668515640705,CSE 284,A00,114175,Gymrek; Melissa Ann,0,22,0,0
1668515641139,CSE 290,A00,102399,Chandraker; Manmohan Krishna,0,11,0,0
1668515641139,CSE 290,B00,102400,Vaccaro; Kristen Marie,0,7,25,25
1668515641139,CSE 290,C00,102414,Pannuto; Patrick William,0,1,25,25
1668515641139,CSE 290,D00,102427,Pevzner; Pavel Arkadjevich,0,0,0,0
1668515641139,CSE 290,E00,102429,Zhao; Jishen,0,4,0,0
1668515641139,CSE 290,F00,102436,Tullsen; Dean Michael,0,5,0,0
1668515641139,CSE 290,G00,102440,Christensen; Henrik I,0,6,20,20
1668515641577,CSE 291,A00,102443,Su; Hao,0,0,0,0
1668515641577,CSE 291,B00,102448,Polikarpova; Nadezhda,0,0,0,0
1668515641577,CSE 291,C00,102453,Vaccaro; Kristen Marie,0,0,0,0
1668515641577,CSE 291,D00,111343,Savage; Stefan,0,0,0,0
1668515641577,CSE 291,E00,116474,Claffy; Kimberly Claire,0,0,0,0
1668515641577,CSE 291,F00,116479,Pasquale; Joseph,0,0,0,0
1668515642045,CSE 293,001,119111,Bafna; Vineet,9999,0,9999,0
1668515642045,CSE 293,002,119118,Bellare; Mihir,9999,0,9999,0
1668515642045,CSE 293,003,119122,Berg-Kirkpatrick; Taylor D,9999,0,9999,0
1668515642045,CSE 293,004,119135,Christensen; Henrik I,9999,0,9999,0
1668515642045,CSE 293,005,119142,Cottrell; Garrison W,9999,0,9999,0
1668515642045,CSE 293,006,119146,Deutsch; Alin Bernard,9999,0,9999,0
1668515642045,CSE 293,007,119159,Esmaeilzadeh; Hadi,9999,0,9999,0
1668515642045,CSE 293,008,119166,Freund; Yoav,9999,0,9999,0
1668515642045,CSE 293,009,119170,Griswold; William G.,9999,0,9999,0
1668515642045,CSE 293,010,119183,Gymrek; Melissa Ann,9999,0,9999,0
1668515642045,CSE 293,011,119190,Heninger; Nadia A,9999,0,9999,0
1668515642045,CSE 293,012,119230,Impagliazzo; Russell,9999,0,9999,0
1668515642045,CSE 293,013,119232,Jhala; Ranjit,9999,0,9999,0
1668515642045,CSE 293,014,119233,Kahng; Andrew Byun,9999,0,9999,0
1668515642045,CSE 293,015,119298,Kane; Daniel Mertz,9999,0,9999,0
1668515642045,CSE 293,016,119299,Kriegman; David J,9999,0,9999,0
1668515642045,CSE 293,017,119300,Kumar; Arun Kumar,9999,0,9999,0
1668515642045,CSE 293,018,119301,Lerner; Sorin,9999,0,9999,0
1668515642045,CSE 293,019,119302,Lovett; Shachar,9999,0,9999,0
1668515642045,CSE 293,020,119303,McAuley; Julian John,9999,0,9999,0
1668515642045,CSE 293,021,119304,Micciancio; Daniele,9999,0,9999,0
1668515642045,CSE 293,022,119367,Orailoglu; Alex,9999,0,9999,0
1668515642045,CSE 293,023,119382,Paturi; Ramamohan,9999,0,9999,0
1668515642045,CSE 293,024,119404,Polikarpova; Nadezhda,9999,0,9999,0
1668515642045,CSE 293,025,119406,Politz; Joseph Gibbs,9999,0,9999,0
1668515642045,CSE 293,026,119411,Porter; George M,9999,0,9999,0
1668515642045,CSE 293,027,119414,Porter; Leonard Emerson,9999,0,9999,0
1668515642045,CSE 293,028,119416,Ramamoorthi; Ravi,9999,0,9999,0
1668515642045,CSE 293,029,119417,Sahoo; Debashis,9999,0,9999,0
1668515642045,CSE 293,030,119420,Saul; Lawrence,9999,0,9999,0
1668515642045,CSE 293,031,119421,Savage; Stefan,9999,0,9999,0
1668515642045,CSE 293,032,119425,Schulze; Jurgen P.,9999,0,9999,0
1668515642045,CSE 293,033,119426,Snoeren; Alex C.,9999,0,9999,0
1668515642045,CSE 293,034,119428,Shang; Jingbo,9999,0,9999,0
1668515642045,CSE 293,035,119430,Stefan; Deian,9999,0,9999,0
1668515642045,CSE 293,036,119431,Su; Hao,9999,0,9999,0
1668515642045,CSE 293,037,119433,Swanson; Steven James,9999,0,9999,0
1668515642045,CSE 293,038,119435,Tullsen; Dean Michael,9999,0,9999,0
1668515642045,CSE 293,039,119483,Voelker; Geoffrey M.,9999,0,9999,0
1668515642045,CSE 293,040,119537,Zhao; Jishen,9999,0,9999,0
1668515642045,CSE 293,041,119538,Zhou; Yuan-Yuan,9999,0,9999,0
1668515642045,CSE 293,042,119539,Gao; Sicun,9999,0,9999,0
1668515642045,CSE 293,043,119540,Weibel; Nadir,9999,0,9999,0
1668515642045,CSE 293,044,119541,Gupta; Rajesh K.,9999,0,9999,0
1668515642045,CSE 293,045,126410,Vaccaro; Kristen Marie,9999,0,9999,0
1668515642045,CSE 293,046,126411,Klemke; Richard,9999,0,9999,0
1668515642474,CSE 294,A00,102459,Voelker; Geoffrey M.,0,2,0,0
1668515642474,CSE 294,B00,111322,Orailoglu; Alex,0,2,0,0
1668515642899,DSE 201,A00,096914,Deutsch; Alin Bernard,30,0,30,0
1668515643328,DSE 210,A00,096915,Dasgupta; Sanjoy,30,0,30,0
1668515643756,DSE 260A,A00,096916,Altintas De Callaf; Ilkay,30,0,30,0
1668515644332,ECE 200,001,103586,Antipa; Nicholas A,9999,0,9999,0
1668515644332,ECE 200,002,103587,Atanasov; Nikolay A.,9999,0,9999,0
1668515644332,ECE 200,003,103588,Bharadia; Dinesh,9999,0,9999,0
1668515644332,ECE 200,004,103589,Cheng; Chung Kuan,9999,0,9999,0
1668515644332,ECE 200,005,103590,Cosman; Pamela C.,9999,0,9999,0
1668515644332,ECE 200,006,103591,Dayeh; Shadi Ahmad,9999,0,9999,0
1668515644332,ECE 200,007,103592,Fainman; Yeshaiahu,9999,0,9999,0
1668515644332,ECE 200,008,103593,Ford; Joseph Earl,9999,0,9999,0
1668515644332,ECE 200,009,103594,Franceschetti; Massimo,9999,0,9999,0
1668515644332,ECE 200,010,103595,Fullerton; Eric E,9999,0,9999,0
1668515644332,ECE 200,011,103596,Galton; Ian A,9999,0,9999,0
1668515644332,ECE 200,012,103597,Gilja; Vikash,9999,0,9999,0
1668515644332,ECE 200,013,103598,Hall; Drew A.,9999,0,9999,0
1668515644332,ECE 200,014,103599,Hsueh; Tzu-Chien,9999,0,9999,0
1668515644332,ECE 200,015,103600,Javidi; Tara,9999,0,9999,0
1668515644332,ECE 200,016,103601,Kahng; Andrew Byun,9999,0,9999,0
1668515644332,ECE 200,017,103602,Kim; Young-Han,9999,0,9999,0
1668515644332,ECE 200,018,103603,Koushanfar; Farinaz,9999,0,9999,0
1668515644332,ECE 200,019,103604,Kuzum; Duygu,9999,0,9999,0
1668515644332,ECE 200,020,103605,Le; Hanh-Phuc,9999,0,9999,0
1668515644332,ECE 200,021,103606,Lin; Bill,9999,0,9999,0
1668515644332,ECE 200,022,103607,Liu; Zhaowei,9998,0,9999,1
1668515644332,ECE 200,023,103608,Lo; Yu-Hwa,9999,0,9999,0
1668515644332,ECE 200,024,103609,Lomakin; Vitaliy,9999,0,9999,0
1668515644332,ECE 200,025,103610,Mercier; Patrick Philip,9999,0,9999,0
1668515644332,ECE 200,026,103611,Meyer; Florian,9999,0,9999,0
1668515644332,ECE 200,027,103612,Milstein; Laurence B.,9999,0,9999,0
1668515644332,ECE 200,028,103613,Mir Arabbaygi; Siavash,9999,0,9999,0
1668515644332,ECE 200,029,103614,Mookherjea; Shayan,9999,0,9999,0
1668515644332,ECE 200,030,103615,Morris; Karcher William,9999,0,9999,0
1668515644332,ECE 200,031,103616,Ng; Tse Nga,9999,0,9999,0
1668515644332,ECE 200,032,103617,Nguyen; Truong Quang,9999,0,9999,0
1668515644332,ECE 200,033,103618,Nomura; Kenji,9999,0,9999,0
1668515644332,ECE 200,034,103619,Orlitsky; Alon,9999,0,9999,0
1668515644332,ECE 200,035,103620,Pal; Piya,9999,0,9999,0
1668515644332,ECE 200,036,103621,Papen; George C.,9999,0,9999,0
1668515644332,ECE 200,037,103622,Radic; Stojan,9999,0,9999,0
1668515644332,ECE 200,038,103623,Rao; Bhaskar D.,9999,0,9999,0
1668515644332,ECE 200,039,103624,Rao; Ramesh R,9999,0,9999,0
1668515644332,ECE 200,040,103625,Rebeiz; Gabriel,9999,0,9999,0
1668515644332,ECE 200,041,103626,Sanford; John R,9999,0,9999,0
1668515644332,ECE 200,042,103627,Siegel; Paul H.,9999,0,9999,0
1668515644332,ECE 200,043,103628,Sievenpiper; Daniel F.,9999,0,9999,0
1668515644332,ECE 200,044,103629,Sworder; David D.,9999,0,9999,0
1668515644332,ECE 200,045,103630,Taur; Yuan,9999,0,9999,0
1668515644332,ECE 200,046,103631,Touri; Behrouz,9999,0,9999,0
1668515644332,ECE 200,047,103632,Trivedi; Mohan M.,9999,0,9999,0
1668515644332,ECE 200,048,103633,Vasconcelos; Nuno,9999,0,9999,0
1668515644332,ECE 200,049,103634,Wang; Xiaolong,9999,0,9999,0
1668515644332,ECE 200,050,103635,Xie; Pengtao,9999,0,9999,0
1668515644332,ECE 200,051,103636,Yip; Michael,9999,0,9999,0
1668515644332,ECE 200,052,103637,Zeger; Kenneth A.,999,0,999,0
1668515644332,ECE 200,053,103638,Zhang; Xinyu,9999,0,9999,0
1668515644332,ECE 200,054,103639,Turakhia; Yatish Girish,9999,0,9999,0
1668515644332,ECE 200,055,103640,Kang; Mingu,9999,0,9999,0
1668515644332,ECE 200,056,103641,Shi; Yuanyuan,9999,0,9999,0
1668515644332,ECE 200,057,103642,Wang; Edward Jay,9999,0,9999,0
1668515644332,ECE 200,058,103643,Zheng; Yang,9999,0,9999,0
1668515644768,ECE 202,A00,103644,Kuzum; Duygu,0,44,0,0
1668515645197,ECE 212BN,A00,103646,Ng; Tse Nga,0,9,0,0
1668515645628,ECE 221,A00,111493,Staff,0,0,0,0
1668515646058,ECE 222B,A00,103647,Lomakin; Vitaliy,0,20,0,0
1668515646482,ECE 230B,A00,103648,Taur; Yuan,0,3,0,0
1668515646909,ECE 238B,A00,103649,Garay; Javier,0,0,0,0
1668515647335,ECE 240B,A00,112900,Fainman; Yeshaiahu,0,7,0,0
1668515647765,ECE 247A,A00,103650,Jokerst; Jesse Vincent,0,6,0,0
1668515648195,ECE 247B,A00,103651,Wang; Joseph,0,14,0,0
1668515648623,ECE 250,A00,103652,Siegel; Paul H.,0,82,0,0
1668515649053,ECE 251A,A00,103654,Rao; Bhaskar D.,0,62,0,0
1668515649484,ECE 257B,A00,103655,Bharadia; Dinesh,0,33,0,0
1668515649911,ECE 258A,A00,103656,Milstein; Laurence B.,0,29,0,0
1668515650337,ECE 260B,A00,103658,Kang; Mingu,0,119,0,0
1668515650768,ECE 264A,A00,103659,Galton; Ian A,0,66,0,0
1668515651197,ECE 265A,A00,103661,Gudem; Prasad S.S.,0,70,0,0
1668515651627,ECE 265D,A00,103662,Gudem; Prasad S.S.,0,26,0,0
1668515652057,ECE 268,A00,103663,Koushanfar; Farinaz,0,43,0,0
1668515652483,ECE 269,A01,103665,Pal; Piya,0,215,0,0
1668515652909,ECE 271B,A00,103666,Vasconcelos; Manuela,0,76,0,0
1668515653334,ECE 276A,A00,103667,Atanasov; Nikolay A.,0,126,0,0
1668515653765,ECE 277,A00,103668,An; Cheolhong,0,149,0,0
1668515654193,ECE 279,A00,117947,Hall; Drew A.,0,22,0,0
1668515655046,ECE 283,A00,103670,Hsueh; Tzu-Chien,0,53,0,0
1668515655474,ECE 284,A00,103671,Turakhia; Yatish Girish,0,39,0,0
1668515655900,ECE 285,A00,103672,Zheng; Yang,0,39,0,0
1668515655900,ECE 285,B00,103673,Sworder; David D.,0,57,0,0
1668515656330,ECE 287,A00,103676,Javidi; Tara,0,9,0,0
1668515656761,MATH 200B,A00,098023,Salehi Golsefidy; Alireza,10,0,15,5
1668515657194,MATH 202B,A00,098024,Rhoades; Brendon Patrick,7,0,15,8
1668515657624,MATH 203B,A00,098025,Oprea; Dragos N.,9,0,15,6
1668515658053,MATH 204B,A00,098026,Sorensen; Claus M,13,0,15,2
1668515658480,MATH 208,A00,098027,Izadi; Elham,7,0,10,3
1668515658905,MATH 209,A00,098028,Pollack; Aaron,10,0,10,0
1668515659333,MATH 211A,A00,112919,Rogalski; Daniel,8,0,10,2
1668515659758,MATH 211B,A00,112920,Seward; Brandon M.,9,0,10,1
1668515660188,MATH 218,A00,098029,Li; Bo,10,0,10,0
1668515660617,MATH 220B,A00,098030,Novak; Jonathan I,11,0,15,4
1668515661045,MATH 221A,A00,098031,Ebenfelt; Peter F,12,0,15,3
1668515661474,MATH 231B,A00,098032,Zlatos; Andrej,11,0,15,4
1668515661904,MATH 240B,A00,098033,Ni; Lei,7,0,15,8
1668515662333,MATH 243,A00,098034,Jekel; David Andrew,10,0,10,0
1668515662765,MATH 245A,A00,098035,Nie; Jiawang,0,4,15,18
1668515663191,MATH 248,A00,098036,Bejenaru; Ioan,10,0,10,0
1668515663618,MATH 250B,A00,098037,Spolaor; Luca,14,0,15,1
1668515664043,MATH 258,A00,098038,Ni; Lei,9,0,10,1
1668515664475,MATH 264B,A00,098041,Rhoades; Brendon Patrick,8,0,15,7
1668515664901,MATH 268,A00,098042,Buss; Samuel R,10,0,10,0
1668515665328,MATH 269,A00,098043,Rhoades; Brendon Patrick,10,0,10,0
1668515665754,MATH 270B,A00,098044,Li; Bo,6,0,15,9
1668515666186,MATH 272B,A00,098045,Holst; Michael J,13,0,15,2
1668515666625,MATH 273A,A00,098046,Tian; Xiaochuan,10,0,15,5
1668515667052,MATH 275,A01,098048,Tian; Xiaochuan,6,0,10,4
1668515667477,MATH 278A,A00,098049,Holst; Michael J,7,0,10,3
1668515667902,MATH 278B,A00,098050,Cloninger; Alexander,10,0,10,0
1668515668327,MATH 278C,A00,098051,Nie; Jiawang,5,0,10,5
1668515668757,MATH 280B,A00,098052,Zheng; Tianyi,7,0,15,8
1668515669188,MATH 281B,A00,098053,Bradic; Jelena,0,2,15,15
1668515669616,MATH 282B,A00,098054,Arias-Castro; Ery,0,1,15,15
1668515670042,MATH 285,A00,098055,Fitzsimmons; Patrick J,0,3,15,17
1668515670468,MATH 287B,A00,098056,Arias-Castro; Ery,1,0,15,14
1668515670894,MATH 288,A00,098057,Agarwal; Pooja,9,0,10,1
1668515670894,MATH 288,B00,098058,Zhang; Danna,8,0,10,2
1668515670894,MATH 288,C00,098059,Williams; Ruth J,9,0,10,1
1668515671320,MATH 290B,A00,098060,Roberts; Justin Deritter,12,0,15,3
1668515671751,MATH 292,A00,098061,Belmont; Eva Kinoshita,10,0,10,0
1668515672179,MATH 295,A00,098062,Suk; Andrew Hoon,47,0,50,3
1668515672605,MATH 296,A00,098063,Novak; Jonathan I,20,0,20,0
1668515673038,MATH 297,001,098064,Gamst; Anthony Collins,9997,0,9999,2
1668516178823,COGS 205,A00,101395,Chiba; Andrea,19,0,20,1
1668516179257,COGS 210B,001,101404,Greene; Deanna Jacquelyn,9998,0,9999,1
1668516179257,COGS 210B,002,101417,Xia; Haijun,9999,0,9999,0
1668516179257,COGS 210B,003,101422,Nitz; Douglas A.,9999,0,9999,0
1668516179257,COGS 210B,004,101423,Hollan; James D.,9998,0,9999,1
1668516179257,COGS 210B,005,101424,Deak; Gedeon O.,9998,0,9999,1
1668516179257,COGS 210B,006,101425,Rossano; Federico,9999,0,9999,0
1668516179689,COGS 211B,A00,101427,Coulson; Seana M,9996,0,9999,3
1668516180114,COGS 220,A00,101428,Hollan; James D.,0,10,25,25
1668516180541,COGS 229,A00,101429,Dow; Steven P,17,0,25,8
1668516180979,COGS 230,A00,101430,Klemmer; Scott R,7,0,17,10
1668516181403,COGS 234,A00,101431,Xia; Haijun,1,0,25,24
1668516181829,COGS 260,A00,101432,Kiyonaga; Anastasia,21,0,25,4
1668516181829,COGS 260,B00,101433,Kirsh; David Joel,15,0,25,10
1668516182259,CSE 202,A00,102371,Impagliazzo; Russell,0,66,0,0
1668516182687,CSE 203B,A01,102373,Cheng; Chung Kuan,0,58,0,0
1668516183114,CSE 208,A00,102374,Micciancio; Daniele,0,5,0,0
1668516183539,CSE 209A,A00,112895,Impagliazzo; Russell,0,12,15,15
1668516183969,CSE 209B,A00,108005,Bellare; Mihir,0,7,0,0
1668516184396,CSE 210,A00,113163,Coblenz; Michael J,0,85,0,0
1668516184822,CSE 219,A00,106111,Dow; Steven P,0,6,20,20
1668516185248,CSE 221,A00,102376,Voelker; Geoffrey M.,0,73,0,0
1668516185679,CSE 224,A01,102378,Porter; George M,0,166,0,0
1668516186106,CSE 229A,A00,102379,Savage; Stefan,0,10,0,0
1668516186531,CSE 229C,A00,102380,Munyaka; Imani N. S.,0,10,0,0
1668516186961,CSE 232B,A00,102382,Deutsch; Alin Bernard,0,32,0,0
1668516187387,CSE 234,A01,112904,Kumar; Arun Kumar,0,0,0,0
1668516187820,CSE 237A,A00,102383,Rosing; Tajana Simunic,0,55,0,0
1668516188244,CSE 239A,A00,102384,Deutsch; Alin Bernard,0,14,0,0
1668516188676,CSE 239B,A00,102385,Polikarpova; Nadezhda,0,10,0,0
1668516189103,CSE 240A,A00,102386,Pannuto; Patrick William,0,46,0,0
1668516189534,CSE 240B,A00,102387,Zhao; Jishen,0,47,0,0
1668516189961,CSE 241A,A00,106406,Kang; Mingu,0,9,0,0
1668516190389,CSE 249B,A00,102388,Kahng; Andrew Byun,0,5,8,8
1668516190816,CSE 251B,A01,102392,Cottrell; Garrison W,0,51,0,0
1668516190816,CSE 251B,A02,102393,Cottrell; Garrison W,0,34,0,0
1668516191243,CSE 252B,A00,102394,Ochoa; Benjamin Lawrence,0,59,0,0
1668516191669,CSE 257,A01,102396,Gao; Sicun,0,139,0,0
1668516192095,CSE 272,A00,102397,Li; Tzumao,0,19,0,0
1668516192525,CSE 274,A00,111323,Chern; Albert Ren-Haur,0,15,0,0
1668516192953,CSE 282,A00,102398,Pevzner; Pavel Arkadjevich,0,0,0,0
1668516193383,CSE 284,A00,114175,Gymrek; Melissa Ann,0,22,0,0
1668516193824,CSE 290,A00,102399,Chandraker; Manmohan Krishna,0,11,0,0
1668516193824,CSE 290,B00,102400,Vaccaro; Kristen Marie,0,7,25,25
1668516193824,CSE 290,C00,102414,Pannuto; Patrick William,0,1,25,25
1668516193824,CSE 290,D00,102427,Pevzner; Pavel Arkadjevich,0,0,0,0
1668516193824,CSE 290,E00,102429,Zhao; Jishen,0,4,0,0
1668516193824,CSE 290,F00,102436,Tullsen; Dean Michael,0,5,0,0
1668516193824,CSE 290,G00,102440,Christensen; Henrik I,0,6,20,20
1668516194252,CSE 291,A00,102443,Su; Hao,0,0,0,0
1668516194252,CSE 291,B00,102448,Polikarpova; Nadezhda,0,0,0,0
1668516194252,CSE 291,C00,102453,Vaccaro; Kristen Marie,0,0,0,0
1668516194252,CSE 291,D00,111343,Savage; Stefan,0,0,0,0
1668516194252,CSE 291,E00,116474,Claffy; Kimberly Claire,0,0,0,0
1668516194252,CSE 291,F00,116479,Pasquale; Joseph,0,0,0,0
1668516194719,CSE 293,001,119111,Bafna; Vineet,9999,0,9999,0
1668516194719,CSE 293,002,119118,Bellare; Mihir,9999,0,9999,0
1668516194719,CSE 293,003,119122,Berg-Kirkpatrick; Taylor D,9999,0,9999,0
1668516194719,CSE 293,004,119135,Christensen; Henrik I,9999,0,9999,0
1668516194719,CSE 293,005,119142,Cottrell; Garrison W,9999,0,9999,0
1668516194719,CSE 293,006,119146,Deutsch; Alin Bernard,9999,0,9999,0
1668516194719,CSE 293,007,119159,Esmaeilzadeh; Hadi,9999,0,9999,0
1668516194719,CSE 293,008,119166,Freund; Yoav,9999,0,9999,0
1668516194719,CSE 293,009,119170,Griswold; William G.,9999,0,9999,0
1668516194719,CSE 293,010,119183,Gymrek; Melissa Ann,9999,0,9999,0
1668516194719,CSE 293,011,119190,Heninger; Nadia A,9999,0,9999,0
1668516194719,CSE 293,012,119230,Impagliazzo; Russell,9999,0,9999,0
1668516194719,CSE 293,013,119232,Jhala; Ranjit,9999,0,9999,0
1668516194719,CSE 293,014,119233,Kahng; Andrew Byun,9999,0,9999,0
1668516194719,CSE 293,015,119298,Kane; Daniel Mertz,9999,0,9999,0
1668516194719,CSE 293,016,119299,Kriegman; David J,9999,0,9999,0
1668516194719,CSE 293,017,119300,Kumar; Arun Kumar,9999,0,9999,0
1668516194719,CSE 293,018,119301,Lerner; Sorin,9999,0,9999,0
1668516194719,CSE 293,019,119302,Lovett; Shachar,9999,0,9999,0
1668516194719,CSE 293,020,119303,McAuley; Julian John,9999,0,9999,0
1668516194719,CSE 293,021,119304,Micciancio; Daniele,9999,0,9999,0
1668516194719,CSE 293,022,119367,Orailoglu; Alex,9999,0,9999,0
1668516194719,CSE 293,023,119382,Paturi; Ramamohan,9999,0,9999,0
1668516194719,CSE 293,024,119404,Polikarpova; Nadezhda,9999,0,9999,0
1668516194719,CSE 293,025,119406,Politz; Joseph Gibbs,9999,0,9999,0
1668516194719,CSE 293,026,119411,Porter; George M,9999,0,9999,0
1668516194719,CSE 293,027,119414,Porter; Leonard Emerson,9999,0,9999,0
1668516194719,CSE 293,028,119416,Ramamoorthi; Ravi,9999,0,9999,0
1668516194719,CSE 293,029,119417,Sahoo; Debashis,9999,0,9999,0
1668516194719,CSE 293,030,119420,Saul; Lawrence,9999,0,9999,0
1668516194719,CSE 293,031,119421,Savage; Stefan,9999,0,9999,0
1668516194719,CSE 293,032,119425,Schulze; Jurgen P.,9999,0,9999,0
1668516194719,CSE 293,033,119426,Snoeren; Alex C.,9999,0,9999,0
1668516194719,CSE 293,034,119428,Shang; Jingbo,9999,0,9999,0
1668516194719,CSE 293,035,119430,Stefan; Deian,9999,0,9999,0
1668516194719,CSE 293,036,119431,Su; Hao,9999,0,9999,0
1668516194719,CSE 293,037,119433,Swanson; Steven James,9999,0,9999,0
1668516194719,CSE 293,038,119435,Tullsen; Dean Michael,9999,0,9999,0
1668516194719,CSE 293,039,119483,Voelker; Geoffrey M.,9999,0,9999,0
1668516194719,CSE 293,040,119537,Zhao; Jishen,9999,0,9999,0
1668516194719,CSE 293,041,119538,Zhou; Yuan-Yuan,9999,0,9999,0
1668516194719,CSE 293,042,119539,Gao; Sicun,9999,0,9999,0
1668516194719,CSE 293,043,119540,Weibel; Nadir,9999,0,9999,0
1668516194719,CSE 293,044,119541,Gupta; Rajesh K.,9999,0,9999,0
1668516194719,CSE 293,045,126410,Vaccaro; Kristen Marie,9999,0,9999,0
1668516194719,CSE 293,046,126411,Klemke; Richard,9999,0,9999,0
1668516195145,CSE 294,A00,102459,Voelker; Geoffrey M.,0,2,0,0
1668516195145,CSE 294,B00,111322,Orailoglu; Alex,0,2,0,0
1668516195571,DSE 201,A00,096914,Deutsch; Alin Bernard,30,0,30,0
1668516196000,DSE 210,A00,096915,Dasgupta; Sanjoy,30,0,30,0
1668516196432,DSE 260A,A00,096916,Altintas De Callaf; Ilkay,30,0,30,0
1668516196882,ECE 200,001,103586,Antipa; Nicholas A,9999,0,9999,0
1668516196882,ECE 200,002,103587,Atanasov; Nikolay A.,9999,0,9999,0
1668516196882,ECE 200,003,103588,Bharadia; Dinesh,9999,0,9999,0
1668516196882,ECE 200,004,103589,Cheng; Chung Kuan,9999,0,9999,0
1668516196882,ECE 200,005,103590,Cosman; Pamela C.,9999,0,9999,0
1668516196882,ECE 200,006,103591,Dayeh; Shadi Ahmad,9999,0,9999,0
1668516196882,ECE 200,007,103592,Fainman; Yeshaiahu,9999,0,9999,0
1668516196882,ECE 200,008,103593,Ford; Joseph Earl,9999,0,9999,0
1668516196882,ECE 200,009,103594,Franceschetti; Massimo,9999,0,9999,0
1668516196882,ECE 200,010,103595,Fullerton; Eric E,9999,0,9999,0
1668516196882,ECE 200,011,103596,Galton; Ian A,9999,0,9999,0
1668516196882,ECE 200,012,103597,Gilja; Vikash,9999,0,9999,0
1668516196882,ECE 200,013,103598,Hall; Drew A.,9999,0,9999,0
1668516196882,ECE 200,014,103599,Hsueh; Tzu-Chien,9999,0,9999,0
1668516196882,ECE 200,015,103600,Javidi; Tara,9999,0,9999,0
1668516196882,ECE 200,016,103601,Kahng; Andrew Byun,9999,0,9999,0
1668516196882,ECE 200,017,103602,Kim; Young-Han,9999,0,9999,0
1668516196882,ECE 200,018,103603,Koushanfar; Farinaz,9999,0,9999,0
1668516196882,ECE 200,019,103604,Kuzum; Duygu,9999,0,9999,0
1668516196882,ECE 200,020,103605,Le; Hanh-Phuc,9999,0,9999,0
1668516196882,ECE 200,021,103606,Lin; Bill,9999,0,9999,0
1668516196882,ECE 200,022,103607,Liu; Zhaowei,9998,0,9999,1
1668516196882,ECE 200,023,103608,Lo; Yu-Hwa,9999,0,9999,0
1668516196882,ECE 200,024,103609,Lomakin; Vitaliy,9999,0,9999,0
1668516196882,ECE 200,025,103610,Mercier; Patrick Philip,9999,0,9999,0
1668516196882,ECE 200,026,103611,Meyer; Florian,9999,0,9999,0
1668516196882,ECE 200,027,103612,Milstein; Laurence B.,9999,0,9999,0
1668516196882,ECE 200,028,103613,Mir Arabbaygi; Siavash,9999,0,9999,0
1668516196882,ECE 200,029,103614,Mookherjea; Shayan,9999,0,9999,0
1668516196882,ECE 200,030,103615,Morris; Karcher William,9999,0,9999,0
1668516196882,ECE 200,031,103616,Ng; Tse Nga,9999,0,9999,0
1668516196882,ECE 200,032,103617,Nguyen; Truong Quang,9999,0,9999,0
1668516196882,ECE 200,033,103618,Nomura; Kenji,9999,0,9999,0
1668516196882,ECE 200,034,103619,Orlitsky; Alon,9999,0,9999,0
1668516196882,ECE 200,035,103620,Pal; Piya,9999,0,9999,0
1668516196882,ECE 200,036,103621,Papen; George C.,9999,0,9999,0
1668516196882,ECE 200,037,103622,Radic; Stojan,9999,0,9999,0
1668516196882,ECE 200,038,103623,Rao; Bhaskar D.,9999,0,9999,0
1668516196882,ECE 200,039,103624,Rao; Ramesh R,9999,0,9999,0
1668516196882,ECE 200,040,103625,Rebeiz; Gabriel,9999,0,9999,0
1668516196882,ECE 200,041,103626,Sanford; John R,9999,0,9999,0
1668516196882,ECE 200,042,103627,Siegel; Paul H.,9999,0,9999,0
1668516196882,ECE 200,043,103628,Sievenpiper; Daniel F.,9999,0,9999,0
1668516196882,ECE 200,044,103629,Sworder; David D.,9999,0,9999,0
1668516196882,ECE 200,045,103630,Taur; Yuan,9999,0,9999,0
1668516196882,ECE 200,046,103631,Touri; Behrouz,9999,0,9999,0
1668516196882,ECE 200,047,103632,Trivedi; Mohan M.,9999,0,9999,0
1668516196882,ECE 200,048,103633,Vasconcelos; Nuno,9999,0,9999,0
1668516196882,ECE 200,049,103634,Wang; Xiaolong,9999,0,9999,0
1668516196882,ECE 200,050,103635,Xie; Pengtao,9999,0,9999,0
1668516196882,ECE 200,051,103636,Yip; Michael,9999,0,9999,0
1668516196882,ECE 200,052,103637,Zeger; Kenneth A.,999,0,999,0
1668516196882,ECE 200,053,103638,Zhang; Xinyu,9999,0,9999,0
1668516196882,ECE 200,054,103639,Turakhia; Yatish Girish,9999,0,9999,0
1668516196882,ECE 200,055,103640,Kang; Mingu,9999,0,9999,0
1668516196882,ECE 200,056,103641,Shi; Yuanyuan,9999,0,9999,0
1668516196882,ECE 200,057,103642,Wang; Edward Jay,9999,0,9999,0
1668516196882,ECE 200,058,103643,Zheng; Yang,9999,0,9999,0
1668516197307,ECE 202,A00,103644,Kuzum; Duygu,0,44,0,0
1668516197731,ECE 212BN,A00,103646,Ng; Tse Nga,0,9,0,0
1668516198159,ECE 221,A00,111493,Staff,0,0,0,0
1668516198601,ECE 222B,A00,103647,Lomakin; Vitaliy,0,20,0,0
1668516199025,ECE 230B,A00,103648,Taur; Yuan,0,3,0,0
1668516199452,ECE 238B,A00,103649,Garay; Javier,0,0,0,0
1668516199877,ECE 240B,A00,112900,Fainman; Yeshaiahu,0,7,0,0
1668516200317,ECE 247A,A00,103650,Jokerst; Jesse Vincent,0,6,0,0
1668516200746,ECE 247B,A00,103651,Wang; Joseph,0,14,0,0
1668516201172,ECE 250,A00,103652,Siegel; Paul H.,0,82,0,0
1668516201599,ECE 251A,A00,103654,Rao; Bhaskar D.,0,62,0,0
1668516202027,ECE 257B,A00,103655,Bharadia; Dinesh,0,33,0,0
1668516202458,ECE 258A,A00,103656,Milstein; Laurence B.,0,29,0,0
1668516202886,ECE 260B,A00,103658,Kang; Mingu,0,119,0,0
1668516203316,ECE 264A,A00,103659,Galton; Ian A,0,66,0,0
1668516203743,ECE 265A,A00,103661,Gudem; Prasad S.S.,0,70,0,0
1668516204169,ECE 265D,A00,103662,Gudem; Prasad S.S.,0,26,0,0
1668516204594,ECE 268,A00,103663,Koushanfar; Farinaz,0,43,0,0
1668516205022,ECE 269,A01,103665,Pal; Piya,0,215,0,0
1668516205448,ECE 271B,A00,103666,Vasconcelos; Manuela,0,76,0,0
1668516205874,ECE 276A,A00,103667,Atanasov; Nikolay A.,0,126,0,0
1668516206299,ECE 277,A00,103668,An; Cheolhong,0,149,0,0
1668516206724,ECE 279,A00,117947,Hall; Drew A.,0,22,0,0
1668516207596,ECE 283,A00,103670,Hsueh; Tzu-Chien,0,53,0,0
1668516208032,ECE 284,A00,103671,Turakhia; Yatish Girish,0,39,0,0
1668516208469,ECE 285,A00,103672,Zheng; Yang,0,39,0,0
1668516208469,ECE 285,B00,103673,Sworder; David D.,0,57,0,0
1668516208897,ECE 287,A00,103676,Javidi; Tara,0,9,0,0
1668516209326,MATH 200B,A00,098023,Salehi Golsefidy; Alireza,10,0,15,5
1668516209751,MATH 202B,A00,098024,Rhoades; Brendon Patrick,7,0,15,8
1668516210181,MATH 203B,A00,098025,Oprea; Dragos N.,9,0,15,6
1668516210610,MATH 204B,A00,098026,Sorensen; Claus M,13,0,15,2
1668516211036,MATH 208,A00,098027,Izadi; Elham,7,0,10,3
1668516211461,MATH 209,A00,098028,Pollack; Aaron,10,0,10,0
1668516211896,MATH 211A,A00,112919,Rogalski; Daniel,8,0,10,2
1668516212423,MATH 211B,A00,112920,Seward; Brandon M.,9,0,10,1
1668516212851,MATH 218,A00,098029,Li; Bo,10,0,10,0
1668516213277,MATH 220B,A00,098030,Novak; Jonathan I,11,0,15,4
1668516213711,MATH 221A,A00,098031,Ebenfelt; Peter F,12,0,15,3
1668516214137,MATH 231B,A00,098032,Zlatos; Andrej,11,0,15,4
1668516214571,MATH 240B,A00,098033,Ni; Lei,7,0,15,8
1668516215000,MATH 243,A00,098034,Jekel; David Andrew,10,0,10,0
1668516215426,MATH 245A,A00,098035,Nie; Jiawang,0,4,15,18
1668516215854,MATH 248,A00,098036,Bejenaru; Ioan,10,0,10,0
1668516216284,MATH 250B,A00,098037,Spolaor; Luca,14,0,15,1
1668516216713,MATH 258,A00,098038,Ni; Lei,9,0,10,1
1668516217141,MATH 264B,A00,098041,Rhoades; Brendon Patrick,8,0,15,7
1668516217567,MATH 268,A00,098042,Buss; Samuel R,10,0,10,0
1668516217993,MATH 269,A00,098043,Rhoades; Brendon Patrick,10,0,10,0
1668516218420,MATH 270B,A00,098044,Li; Bo,6,0,15,9
1668516218851,MATH 272B,A00,098045,Holst; Michael J,13,0,15,2
1668516219277,MATH 273A,A00,098046,Tian; Xiaochuan,10,0,15,5
1668516219707,MATH 275,A01,098048,Tian; Xiaochuan,6,0,10,4
1668516220136,MATH 278A,A00,098049,Holst; Michael J,7,0,10,3
1668516220561,MATH 278B,A00,098050,Cloninger; Alexander,10,0,10,0
1668516220986,MATH 278C,A00,098051,Nie; Jiawang,5,0,10,5
1668516221416,MATH 280B,A00,098052,Zheng; Tianyi,7,0,15,8
1668516221849,MATH 281B,A00,098053,Bradic; Jelena,0,2,15,15
1668516222277,MATH 282B,A00,098054,Arias-Castro; Ery,0,1,15,15
1668516222707,MATH 285,A00,098055,Fitzsimmons; Patrick J,0,3,15,17
1668516223137,MATH 287B,A00,098056,Arias-Castro; Ery,1,0,15,14
1668516223564,MATH 288,A00,098057,Agarwal; Pooja,9,0,10,1
1668516223564,MATH 288,B00,098058,Zhang; Danna,8,0,10,2
1668516223564,MATH 288,C00,098059,Williams; Ruth J,9,0,10,1
1668516223998,MATH 290B,A00,098060,Roberts; Justin Deritter,12,0,15,3
1668516224424,MATH 292,A00,098061,Belmont; Eva Kinoshita,10,0,10,0
1668516224851,MATH 295,A00,098062,Suk; Andrew Hoon,47,0,50,3
1668516225276,MATH 296,A00,098063,Novak; Jonathan I,20,0,20,0
1668516225705,MATH 297,001,098064,Gamst; Anthony Collins,9997,0,9999,2
1668516729428,COGS 205,A00,101395,Chiba; Andrea,19,0,20,1
1668516729859,COGS 210B,001,101404,Greene; Deanna Jacquelyn,9998,0,9999,1
1668516729859,COGS 210B,002,101417,Xia; Haijun,9999,0,9999,0
1668516729859,COGS 210B,003,101422,Nitz; Douglas A.,9999,0,9999,0
1668516729859,COGS 210B,004,101423,Hollan; James D.,9998,0,9999,1
1668516729859,COGS 210B,005,101424,Deak; Gedeon O.,9998,0,9999,1
1668516729859,COGS 210B,006,101425,Rossano; Federico,9999,0,9999,0
1668516730283,COGS 211B,A00,101427,Coulson; Seana M,9996,0,9999,3
1668516730711,COGS 220,A00,101428,Hollan; James D.,0,10,25,25
1668516731136,COGS 229,A00,101429,Dow; Steven P,17,0,25,8
1668516731566,COGS 230,A00,101430,Klemmer; Scott R,7,0,17,10
1668516731994,COGS 234,A00,101431,Xia; Haijun,1,0,25,24
1668516732420,COGS 260,A00,101432,Kiyonaga; Anastasia,21,0,25,4
1668516732420,COGS 260,B00,101433,Kirsh; David Joel,15,0,25,10
1668516732848,CSE 202,A00,102371,Impagliazzo; Russell,0,66,0,0
1668516733278,CSE 203B,A01,102373,Cheng; Chung Kuan,0,58,0,0
1668516733704,CSE 208,A00,102374,Micciancio; Daniele,0,5,0,0
1668516734135,CSE 209A,A00,112895,Impagliazzo; Russell,0,12,15,15
1668516734569,CSE 209B,A00,108005,Bellare; Mihir,0,7,0,0
1668516735069,CSE 210,A00,113163,Coblenz; Michael J,0,85,0,0
1668516735496,CSE 219,A00,106111,Dow; Steven P,0,6,20,20
1668516735923,CSE 221,A00,102376,Voelker; Geoffrey M.,0,73,0,0
1668516736350,CSE 224,A01,102378,Porter; George M,0,166,0,0
1668516736777,CSE 229A,A00,102379,Savage; Stefan,0,10,0,0
1668516737202,CSE 229C,A00,102380,Munyaka; Imani N. S.,0,10,0,0
1668516737627,CSE 232B,A00,102382,Deutsch; Alin Bernard,0,32,0,0
1668516738055,CSE 234,A01,112904,Kumar; Arun Kumar,0,0,0,0
1668516738483,CSE 237A,A00,102383,Rosing; Tajana Simunic,0,55,0,0
1668516738908,CSE 239A,A00,102384,Deutsch; Alin Bernard,0,14,0,0
1668516739333,CSE 239B,A00,102385,Polikarpova; Nadezhda,0,10,0,0
1668516739763,CSE 240A,A00,102386,Pannuto; Patrick William,0,46,0,0
1668516740188,CSE 240B,A00,102387,Zhao; Jishen,0,47,0,0
1668516740621,CSE 241A,A00,106406,Kang; Mingu,0,9,0,0
1668516741044,CSE 249B,A00,102388,Kahng; Andrew Byun,0,5,8,8
1668516741472,CSE 251B,A01,102392,Cottrell; Garrison W,0,51,0,0
1668516741472,CSE 251B,A02,102393,Cottrell; Garrison W,0,34,0,0
1668516741896,CSE 252B,A00,102394,Ochoa; Benjamin Lawrence,0,59,0,0
1668516742325,CSE 257,A01,102396,Gao; Sicun,0,139,0,0
1668516742752,CSE 272,A00,102397,Li; Tzumao,0,19,0,0
1668516743180,CSE 274,A00,111323,Chern; Albert Ren-Haur,0,15,0,0
1668516743619,CSE 282,A00,102398,Pevzner; Pavel Arkadjevich,0,0,0,0
1668516744043,CSE 284,A00,114175,Gymrek; Melissa Ann,0,22,0,0
1668516744474,CSE 290,A00,102399,Chandraker; Manmohan Krishna,0,11,0,0
1668516744474,CSE 290,B00,102400,Vaccaro; Kristen Marie,0,7,25,25
1668516744474,CSE 290,C00,102414,Pannuto; Patrick William,0,1,25,25
1668516744474,CSE 290,D00,102427,Pevzner; Pavel Arkadjevich,0,0,0,0
1668516744474,CSE 290,E00,102429,Zhao; Jishen,0,4,0,0
1668516744474,CSE 290,F00,102436,Tullsen; Dean Michael,0,5,0,0
1668516744474,CSE 290,G00,102440,Christensen; Henrik I,0,6,20,20
1668516744910,CSE 291,A00,102443,Su; Hao,0,0,0,0
1668516744910,CSE 291,B00,102448,Polikarpova; Nadezhda,0,0,0,0
1668516744910,CSE 291,C00,102453,Vaccaro; Kristen Marie,0,0,0,0
1668516744910,CSE 291,D00,111343,Savage; Stefan,0,0,0,0
1668516744910,CSE 291,E00,116474,Claffy; Kimberly Claire,0,0,0,0
1668516744910,CSE 291,F00,116479,Pasquale; Joseph,0,0,0,0
1668516745386,CSE 293,001,119111,Bafna; Vineet,9999,0,9999,0
1668516745386,CSE 293,002,119118,Bellare; Mihir,9999,0,9999,0
1668516745386,CSE 293,003,119122,Berg-Kirkpatrick; Taylor D,9999,0,9999,0
1668516745386,CSE 293,004,119135,Christensen; Henrik I,9999,0,9999,0
1668516745386,CSE 293,005,119142,Cottrell; Garrison W,9999,0,9999,0
1668516745386,CSE 293,006,119146,Deutsch; Alin Bernard,9999,0,9999,0
1668516745386,CSE 293,007,119159,Esmaeilzadeh; Hadi,9999,0,9999,0
1668516745386,CSE 293,008,119166,Freund; Yoav,9999,0,9999,0
1668516745386,CSE 293,009,119170,Griswold; William G.,9999,0,9999,0
1668516745386,CSE 293,010,119183,Gymrek; Melissa Ann,9999,0,9999,0
1668516745386,CSE 293,011,119190,Heninger; Nadia A,9999,0,9999,0
1668516745386,CSE 293,012,119230,Impagliazzo; Russell,9999,0,9999,0
1668516745386,CSE 293,013,119232,Jhala; Ranjit,9999,0,9999,0
1668516745386,CSE 293,014,119233,Kahng; Andrew Byun,9999,0,9999,0
1668516745386,CSE 293,015,119298,Kane; Daniel Mertz,9999,0,9999,0
1668516745386,CSE 293,016,119299,Kriegman; David J,9999,0,9999,0
1668516745386,CSE 293,017,119300,Kumar; Arun Kumar,9999,0,9999,0
1668516745386,CSE 293,018,119301,Lerner; Sorin,9999,0,9999,0
1668516745386,CSE 293,019,119302,Lovett; Shachar,9999,0,9999,0
1668516745386,CSE 293,020,119303,McAuley; Julian John,9999,0,9999,0
1668516745386,CSE 293,021,119304,Micciancio; Daniele,9999,0,9999,0
1668516745386,CSE 293,022,119367,Orailoglu; Alex,9999,0,9999,0
1668516745386,CSE 293,023,119382,Paturi; Ramamohan,9999,0,9999,0
1668516745386,CSE 293,024,119404,Polikarpova; Nadezhda,9999,0,9999,0
1668516745386,CSE 293,025,119406,Politz; Joseph Gibbs,9999,0,9999,0
1668516745386,CSE 293,026,119411,Porter; George M,9999,0,9999,0
1668516745386,CSE 293,027,119414,Porter; Leonard Emerson,9999,0,9999,0
1668516745386,CSE 293,028,119416,Ramamoorthi; Ravi,9999,0,9999,0
1668516745386,CSE 293,029,119417,Sahoo; Debashis,9999,0,9999,0
1668516745386,CSE 293,030,119420,Saul; Lawrence,9999,0,9999,0
1668516745386,CSE 293,031,119421,Savage; Stefan,9999,0,9999,0
1668516745386,CSE 293,032,119425,Schulze; Jurgen P.,9999,0,9999,0
1668516745386,CSE 293,033,119426,Snoeren; Alex C.,9999,0,9999,0
1668516745386,CSE 293,034,119428,Shang; Jingbo,9999,0,9999,0
1668516745386,CSE 293,035,119430,Stefan; Deian,9999,0,9999,0
1668516745386,CSE 293,036,119431,Su; Hao,9999,0,9999,0
1668516745386,CSE 293,037,119433,Swanson; Steven James,9999,0,9999,0
1668516745386,CSE 293,038,119435,Tullsen; Dean Michael,9999,0,9999,0
1668516745386,CSE 293,039,119483,Voelker; Geoffrey M.,9999,0,9999,0
1668516745386,CSE 293,040,119537,Zhao; Jishen,9999,0,9999,0
1668516745386,CSE 293,041,119538,Zhou; Yuan-Yuan,9999,0,9999,0
1668516745386,CSE 293,042,119539,Gao; Sicun,9999,0,9999,0
1668516745386,CSE 293,043,119540,Weibel; Nadir,9999,0,9999,0
1668516745386,CSE 293,044,119541,Gupta; Rajesh K.,9999,0,9999,0
1668516745386,CSE 293,045,126410,Vaccaro; Kristen Marie,9999,0,9999,0
1668516745386,CSE 293,046,126411,Klemke; Richard,9999,0,9999,0
1668516745814,CSE 294,A00,102459,Voelker; Geoffrey M.,0,2,0,0
1668516745814,CSE 294,B00,111322,Orailoglu; Alex,0,2,0,0
1668516746239,DSE 201,A00,096914,Deutsch; Alin Bernard,30,0,30,0
1668516746667,DSE 210,A00,096915,Dasgupta; Sanjoy,30,0,30,0
1668516747093,DSE 260A,A00,096916,Altintas De Callaf; Ilkay,30,0,30,0
1668516747619,ECE 200,001,103586,Antipa; Nicholas A,9999,0,9999,0
1668516747619,ECE 200,002,103587,Atanasov; Nikolay A.,9999,0,9999,0
1668516747619,ECE 200,003,103588,Bharadia; Dinesh,9999,0,9999,0
1668516747619,ECE 200,004,103589,Cheng; Chung Kuan,9999,0,9999,0
1668516747619,ECE 200,005,103590,Cosman; Pamela C.,9999,0,9999,0
1668516747619,ECE 200,006,103591,Dayeh; Shadi Ahmad,9999,0,9999,0
1668516747619,ECE 200,007,103592,Fainman; Yeshaiahu,9999,0,9999,0
1668516747619,ECE 200,008,103593,Ford; Joseph Earl,9999,0,9999,0
1668516747619,ECE 200,009,103594,Franceschetti; Massimo,9999,0,9999,0
1668516747619,ECE 200,010,103595,Fullerton; Eric E,9999,0,9999,0
1668516747619,ECE 200,011,103596,Galton; Ian A,9999,0,9999,0
1668516747619,ECE 200,012,103597,Gilja; Vikash,9999,0,9999,0
1668516747619,ECE 200,013,103598,Hall; Drew A.,9999,0,9999,0
1668516747619,ECE 200,014,103599,Hsueh; Tzu-Chien,9999,0,9999,0
1668516747619,ECE 200,015,103600,Javidi; Tara,9999,0,9999,0
1668516747619,ECE 200,016,103601,Kahng; Andrew Byun,9999,0,9999,0
1668516747619,ECE 200,017,103602,Kim; Young-Han,9999,0,9999,0
1668516747619,ECE 200,018,103603,Koushanfar; Farinaz,9999,0,9999,0
1668516747619,ECE 200,019,103604,Kuzum; Duygu,9999,0,9999,0
1668516747619,ECE 200,020,103605,Le; Hanh-Phuc,9999,0,9999,0
1668516747619,ECE 200,021,103606,Lin; Bill,9999,0,9999,0
1668516747619,ECE 200,022,103607,Liu; Zhaowei,9998,0,9999,1
1668516747619,ECE 200,023,103608,Lo; Yu-Hwa,9999,0,9999,0
1668516747619,ECE 200,024,103609,Lomakin; Vitaliy,9999,0,9999,0
1668516747619,ECE 200,025,103610,Mercier; Patrick Philip,9999,0,9999,0
1668516747619,ECE 200,026,103611,Meyer; Florian,9999,0,9999,0
1668516747619,ECE 200,027,103612,Milstein; Laurence B.,9999,0,9999,0
1668516747619,ECE 200,028,103613,Mir Arabbaygi; Siavash,9999,0,9999,0
1668516747619,ECE 200,029,103614,Mookherjea; Shayan,9999,0,9999,0
1668516747619,ECE 200,030,103615,Morris; Karcher William,9999,0,9999,0
1668516747619,ECE 200,031,103616,Ng; Tse Nga,9999,0,9999,0
1668516747619,ECE 200,032,103617,Nguyen; Truong Quang,9999,0,9999,0
1668516747619,ECE 200,033,103618,Nomura; Kenji,9999,0,9999,0
1668516747619,ECE 200,034,103619,Orlitsky; Alon,9999,0,9999,0
1668516747619,ECE 200,035,103620,Pal; Piya,9999,0,9999,0
1668516747619,ECE 200,036,103621,Papen; George C.,9999,0,9999,0
1668516747619,ECE 200,037,103622,Radic; Stojan,9999,0,9999,0
1668516747619,ECE 200,038,103623,Rao; Bhaskar D.,9999,0,9999,0
1668516747619,ECE 200,039,103624,Rao; Ramesh R,9999,0,9999,0
1668516747619,ECE 200,040,103625,Rebeiz; Gabriel,9999,0,9999,0
1668516747619,ECE 200,041,103626,Sanford; John R,9999,0,9999,0
1668516747619,ECE 200,042,103627,Siegel; Paul H.,9999,0,9999,0
1668516747619,ECE 200,043,103628,Sievenpiper; Daniel F.,9999,0,9999,0
1668516747619,ECE 200,044,103629,Sworder; David D.,9999,0,9999,0
1668516747619,ECE 200,045,103630,Taur; Yuan,9999,0,9999,0
1668516747619,ECE 200,046,103631,Touri; Behrouz,9999,0,9999,0
1668516747619,ECE 200,047,103632,Trivedi; Mohan M.,9999,0,9999,0
1668516747619,ECE 200,048,103633,Vasconcelos; Nuno,9999,0,9999,0
1668516747619,ECE 200,049,103634,Wang; Xiaolong,9999,0,9999,0
1668516747619,ECE 200,050,103635,Xie; Pengtao,9999,0,9999,0
1668516747619,ECE 200,051,103636,Yip; Michael,9999,0,9999,0
1668516747619,ECE 200,052,103637,Zeger; Kenneth A.,999,0,999,0
1668516747619,ECE 200,053,103638,Zhang; Xinyu,9999,0,9999,0
1668516747619,ECE 200,054,103639,Turakhia; Yatish Girish,9999,0,9999,0
1668516747619,ECE 200,055,103640,Kang; Mingu,9999,0,9999,0
1668516747619,ECE 200,056,103641,Shi; Yuanyuan,9999,0,9999,0
1668516747619,ECE 200,057,103642,Wang; Edward Jay,9999,0,9999,0
1668516747619,ECE 200,058,103643,Zheng; Yang,9999,0,9999,0
1668516748044,ECE 202,A00,103644,Kuzum; Duygu,0,44,0,0
1668516748469,ECE 212BN,A00,103646,Ng; Tse Nga,0,9,0,0
1668516748895,ECE 221,A00,111493,Staff,0,0,0,0
1668516749321,ECE 222B,A00,103647,Lomakin; Vitaliy,0,20,0,0
1668516749744,ECE 230B,A00,103648,Taur; Yuan,0,3,0,0
1668516750173,ECE 238B,A00,103649,Garay; Javier,0,0,0,0
1668516750599,ECE 240B,A00,112900,Fainman; Yeshaiahu,0,7,0,0
1668516751026,ECE 247A,A00,103650,Jokerst; Jesse Vincent,0,6,0,0
1668516751458,ECE 247B,A00,103651,Wang; Joseph,0,14,0,0
1668516751887,ECE 250,A00,103652,Siegel; Paul H.,0,82,0,0
1668516752311,ECE 251A,A00,103654,Rao; Bhaskar D.,0,62,0,0
1668516752739,ECE 257B,A00,103655,Bharadia; Dinesh,0,33,0,0
1668516753166,ECE 258A,A00,103656,Milstein; Laurence B.,0,29,0,0
1668516753612,ECE 260B,A00,103658,Kang; Mingu,0,119,0,0
1668516754038,ECE 264A,A00,103659,Galton; Ian A,0,66,0,0
1668516754472,ECE 265A,A00,103661,Gudem; Prasad S.S.,0,70,0,0
1668516754899,ECE 265D,A00,103662,Gudem; Prasad S.S.,0,26,0,0
1668516755324,ECE 268,A00,103663,Koushanfar; Farinaz,0,43,0,0
1668516755750,ECE 269,A01,103665,Pal; Piya,0,215,0,0
1668516756176,ECE 271B,A00,103666,Vasconcelos; Manuela,0,76,0,0
1668516756605,ECE 276A,A00,103667,Atanasov; Nikolay A.,0,126,0,0
1668516757030,ECE 277,A00,103668,An; Cheolhong,0,149,0,0
1668516757459,ECE 279,A00,117947,Hall; Drew A.,0,22,0,0
1668516758310,ECE 283,A00,103670,Hsueh; Tzu-Chien,0,53,0,0
1668516758737,ECE 284,A00,103671,Turakhia; Yatish Girish,0,39,0,0
1668516759164,ECE 285,A00,103672,Zheng; Yang,0,39,0,0
1668516759164,ECE 285,B00,103673,Sworder; David D.,0,57,0,0
1668516759596,ECE 287,A00,103676,Javidi; Tara,0,9,0,0
1668516760021,MATH 200B,A00,098023,Salehi Golsefidy; Alireza,10,0,15,5
1668516760446,MATH 202B,A00,098024,Rhoades; Brendon Patrick,7,0,15,8
1668516760875,MATH 203B,A00,098025,Oprea; Dragos N.,9,0,15,6
1668516761302,MATH 204B,A00,098026,Sorensen; Claus M,13,0,15,2
1668516761731,MATH 208,A00,098027,Izadi; Elham,7,0,10,3
1668516762158,MATH 209,A00,098028,Pollack; Aaron,10,0,10,0
1668516762588,MATH 211A,A00,112919,Rogalski; Daniel,8,0,10,2
1668516763016,MATH 211B,A00,112920,Seward; Brandon M.,9,0,10,1
1668516763443,MATH 218,A00,098029,Li; Bo,10,0,10,0
1668516763878,MATH 220B,A00,098030,Novak; Jonathan I,11,0,15,4
1668516764304,MATH 221A,A00,098031,Ebenfelt; Peter F,12,0,15,3
1668516764729,MATH 231B,A00,098032,Zlatos; Andrej,11,0,15,4
1668516765160,MATH 240B,A00,098033,Ni; Lei,7,0,15,8
1668516765586,MATH 243,A00,098034,Jekel; David Andrew,10,0,10,0
1668516766015,MATH 245A,A00,098035,Nie; Jiawang,0,4,15,18
1668516766443,MATH 248,A00,098036,Bejenaru; Ioan,10,0,10,0
1668516766869,MATH 250B,A00,098037,Spolaor; Luca,14,0,15,1
1668516767299,MATH 258,A00,098038,Ni; Lei,9,0,10,1
1668516767727,MATH 264B,A00,098041,Rhoades; Brendon Patrick,8,0,15,7
1668516768151,MATH 268,A00,098042,Buss; Samuel R,10,0,10,0
1668516768576,MATH 269,A00,098043,Rhoades; Brendon Patrick,10,0,10,0
1668516769000,MATH 270B,A00,098044,Li; Bo,6,0,15,9
1668516769429,MATH 272B,A00,098045,Holst; Michael J,13,0,15,2
1668516769858,MATH 273A,A00,098046,Tian; Xiaochuan,10,0,15,5
1668516770284,MATH 275,A01,098048,Tian; Xiaochuan,6,0,10,4
1668516770708,MATH 278A,A00,098049,Holst; Michael J,7,0,10,3
1668516771133,MATH 278B,A00,098050,Cloninger; Alexander,10,0,10,0
1668516771557,MATH 278C,A00,098051,Nie; Jiawang,5,0,10,5
1668516771983,MATH 280B,A00,098052,Zheng; Tianyi,7,0,15,8
1668516772407,MATH 281B,A00,098053,Bradic; Jelena,0,2,15,15
1668516772838,MATH 282B,A00,098054,Arias-Castro; Ery,0,1,15,15
1668516773265,MATH 285,A00,098055,Fitzsimmons; Patrick J,0,3,15,17
1668516773694,MATH 287B,A00,098056,Arias-Castro; Ery,1,0,15,14
1668516774125,MATH 288,A00,098057,Agarwal; Pooja,9,0,10,1
1668516774125,MATH 288,B00,098058,Zhang; Danna,8,0,10,2
1668516774125,MATH 288,C00,098059,Williams; Ruth J,9,0,10,1
1668516774550,MATH 290B,A00,098060,Roberts; Justin Deritter,12,0,15,3
1668516774975,MATH 292,A00,098061,Belmont; Eva Kinoshita,10,0,10,0
1668516775401,MATH 295,A00,098062,Suk; Andrew Hoon,47,0,50,3
1668516775829,MATH 296,A00,098063,Novak; Jonathan I,20,0,20,0
1668516776259,MATH 297,001,098064,Gamst; Anthony Collins,9997,0,9999,2
1668517279497,COGS 205,A00,101395,Chiba; Andrea,19,0,20,1
1668517279923,COGS 210B,001,101404,Greene; Deanna Jacquelyn,9998,0,9999,1
1668517279923,COGS 210B,002,101417,Xia; Haijun,9999,0,9999,0
1668517279923,COGS 210B,003,101422,Nitz; Douglas A.,9999,0,9999,0
1668517279923,COGS 210B,004,101423,Hollan; James D.,9998,0,9999,1
1668517279923,COGS 210B,005,101424,Deak; Gedeon O.,9998,0,9999,1
1668517279923,COGS 210B,006,101425,Rossano; Federico,9999,0,9999,0
1668517280349,COGS 211B,A00,101427,Coulson; Seana M,9996,0,9999,3
1668517280776,COGS 220,A00,101428,Hollan; James D.,0,10,25,25
1668517281205,COGS 229,A00,101429,Dow; Steven P,17,0,25,8
1668517281629,COGS 230,A00,101430,Klemmer; Scott R,7,0,17,10
1668517282054,COGS 234,A00,101431,Xia; Haijun,1,0,25,24
1668517282486,COGS 260,A00,101432,Kiyonaga; Anastasia,21,0,25,4
1668517282486,COGS 260,B00,101433,Kirsh; David Joel,15,0,25,10
1668517282910,CSE 202,A00,102371,Impagliazzo; Russell,0,66,0,0
1668517283335,CSE 203B,A01,102373,Cheng; Chung Kuan,0,58,0,0
1668517283763,CSE 208,A00,102374,Micciancio; Daniele,0,5,0,0
1668517284189,CSE 209A,A00,112895,Impagliazzo; Russell,0,12,15,15
1668517284613,CSE 209B,A00,108005,Bellare; Mihir,0,7,0,0
1668517285066,CSE 210,A00,113163,Coblenz; Michael J,0,85,0,0
1668517285496,CSE 219,A00,106111,Dow; Steven P,0,6,20,20
1668517285922,CSE 221,A00,102376,Voelker; Geoffrey M.,0,73,0,0
1668517286347,CSE 224,A01,102378,Porter; George M,0,166,0,0
1668517286779,CSE 229A,A00,102379,Savage; Stefan,0,10,0,0
1668517287202,CSE 229C,A00,102380,Munyaka; Imani N. S.,0,10,0,0
1668517287629,CSE 232B,A00,102382,Deutsch; Alin Bernard,0,32,0,0
1668517288054,CSE 234,A01,112904,Kumar; Arun Kumar,0,0,0,0
1668517288479,CSE 237A,A00,102383,Rosing; Tajana Simunic,0,55,0,0
1668517288905,CSE 239A,A00,102384,Deutsch; Alin Bernard,0,14,0,0
1668517289342,CSE 239B,A00,102385,Polikarpova; Nadezhda,0,10,0,0
1668517289769,CSE 240A,A00,102386,Pannuto; Patrick William,0,46,0,0
1668517290195,CSE 240B,A00,102387,Zhao; Jishen,0,47,0,0
1668517290625,CSE 241A,A00,106406,Kang; Mingu,0,9,0,0
1668517291054,CSE 249B,A00,102388,Kahng; Andrew Byun,0,5,8,8
1668517291479,CSE 251B,A01,102392,Cottrell; Garrison W,0,51,0,0
1668517291479,CSE 251B,A02,102393,Cottrell; Garrison W,0,34,0,0
1668517291909,CSE 252B,A00,102394,Ochoa; Benjamin Lawrence,0,59,0,0
1668517292338,CSE 257,A01,102396,Gao; Sicun,0,139,0,0
1668517292767,CSE 272,A00,102397,Li; Tzumao,0,19,0,0
1668517293203,CSE 274,A00,111323,Chern; Albert Ren-Haur,0,15,0,0
1668517293632,CSE 282,A00,102398,Pevzner; Pavel Arkadjevich,0,0,0,0
1668517294062,CSE 284,A00,114175,Gymrek; Melissa Ann,0,22,0,0
1668517294497,CSE 290,A00,102399,Chandraker; Manmohan Krishna,0,11,0,0
1668517294497,CSE 290,B00,102400,Vaccaro; Kristen Marie,0,7,25,25
1668517294497,CSE 290,C00,102414,Pannuto; Patrick William,0,1,25,25
1668517294497,CSE 290,D00,102427,Pevzner; Pavel Arkadjevich,0,0,0,0
1668517294497,CSE 290,E00,102429,Zhao; Jishen,0,4,0,0
1668517294497,CSE 290,F00,102436,Tullsen; Dean Michael,0,5,0,0
1668517294497,CSE 290,G00,102440,Christensen; Henrik I,0,6,20,20
1668517294928,CSE 291,A00,102443,Su; Hao,0,0,0,0
1668517294928,CSE 291,B00,102448,Polikarpova; Nadezhda,0,0,0,0
1668517294928,CSE 291,C00,102453,Vaccaro; Kristen Marie,0,0,0,0
1668517294928,CSE 291,D00,111343,Savage; Stefan,0,0,0,0
1668517294928,CSE 291,E00,116474,Claffy; Kimberly Claire,0,0,0,0
1668517294928,CSE 291,F00,116479,Pasquale; Joseph,0,0,0,0
1668517295368,CSE 293,001,119111,Bafna; Vineet,9999,0,9999,0
1668517295368,CSE 293,002,119118,Bellare; Mihir,9999,0,9999,0
1668517295368,CSE 293,003,119122,Berg-Kirkpatrick; Taylor D,9999,0,9999,0
1668517295368,CSE 293,004,119135,Christensen; Henrik I,9999,0,9999,0
1668517295368,CSE 293,005,119142,Cottrell; Garrison W,9999,0,9999,0
1668517295368,CSE 293,006,119146,Deutsch; Alin Bernard,9999,0,9999,0
1668517295368,CSE 293,007,119159,Esmaeilzadeh; Hadi,9999,0,9999,0
1668517295368,CSE 293,008,119166,Freund; Yoav,9999,0,9999,0
1668517295368,CSE 293,009,119170,Griswold; William G.,9999,0,9999,0
1668517295368,CSE 293,010,119183,Gymrek; Melissa Ann,9999,0,9999,0
1668517295368,CSE 293,011,119190,Heninger; Nadia A,9999,0,9999,0
1668517295368,CSE 293,012,119230,Impagliazzo; Russell,9999,0,9999,0
1668517295368,CSE 293,013,119232,Jhala; Ranjit,9999,0,9999,0
1668517295368,CSE 293,014,119233,Kahng; Andrew Byun,9999,0,9999,0
1668517295368,CSE 293,015,119298,Kane; Daniel Mertz,9999,0,9999,0
1668517295368,CSE 293,016,119299,Kriegman; David J,9999,0,9999,0
1668517295368,CSE 293,017,119300,Kumar; Arun Kumar,9999,0,9999,0
1668517295368,CSE 293,018,119301,Lerner; Sorin,9999,0,9999,0
1668517295368,CSE 293,019,119302,Lovett; Shachar,9999,0,9999,0
1668517295368,CSE 293,020,119303,McAuley; Julian John,9999,0,9999,0
1668517295368,CSE 293,021,119304,Micciancio; Daniele,9999,0,9999,0
1668517295368,CSE 293,022,119367,Orailoglu; Alex,9999,0,9999,0
1668517295368,CSE 293,023,119382,Paturi; Ramamohan,9999,0,9999,0
1668517295368,CSE 293,024,119404,Polikarpova; Nadezhda,9999,0,9999,0
1668517295368,CSE 293,025,119406,Politz; Joseph Gibbs,9999,0,9999,0
1668517295368,CSE 293,026,119411,Porter; George M,9999,0,9999,0
1668517295368,CSE 293,027,119414,Porter; Leonard Emerson,9999,0,9999,0
1668517295368,CSE 293,028,119416,Ramamoorthi; Ravi,9999,0,9999,0
1668517295368,CSE 293,029,119417,Sahoo; Debashis,9999,0,9999,0
1668517295368,CSE 293,030,119420,Saul; Lawrence,9999,0,9999,0
1668517295368,CSE 293,031,119421,Savage; Stefan,9999,0,9999,0
1668517295368,CSE 293,032,119425,Schulze; Jurgen P.,9999,0,9999,0
1668517295368,CSE 293,033,119426,Snoeren; Alex C.,9999,0,9999,0
1668517295368,CSE 293,034,119428,Shang; Jingbo,9999,0,9999,0
1668517295368,CSE 293,035,119430,Stefan; Deian,9999,0,9999,0
1668517295368,CSE 293,036,119431,Su; Hao,9999,0,9999,0
1668517295368,CSE 293,037,119433,Swanson; Steven James,9999,0,9999,0
1668517295368,CSE 293,038,119435,Tullsen; Dean Michael,9999,0,9999,0
1668517295368,CSE 293,039,119483,Voelker; Geoffrey M.,9999,0,9999,0
1668517295368,CSE 293,040,119537,Zhao; Jishen,9999,0,9999,0
1668517295368,CSE 293,041,119538,Zhou; Yuan-Yuan,9999,0,9999,0
1668517295368,CSE 293,042,119539,Gao; Sicun,9999,0,9999,0
1668517295368,CSE 293,043,119540,Weibel; Nadir,9999,0,9999,0
1668517295368,CSE 293,044,119541,Gupta; Rajesh K.,9999,0,9999,0
1668517295368,CSE 293,045,126410,Vaccaro; Kristen Marie,9999,0,9999,0
1668517295368,CSE 293,046,126411,Klemke; Richard,9999,0,9999,0
1668517295790,CSE 294,A00,102459,Voelker; Geoffrey M.,0,2,0,0
1668517295790,CSE 294,B00,111322,Orailoglu; Alex,0,2,0,0
1668517296214,DSE 201,A00,096914,Deutsch; Alin Bernard,30,0,30,0
1668517296642,DSE 210,A00,096915,Dasgupta; Sanjoy,30,0,30,0
1668517297068,DSE 260A,A00,096916,Altintas De Callaf; Ilkay,30,0,30,0
1668517297495,ECE 200,001,103586,Antipa; Nicholas A,9999,0,9999,0
1668517297495,ECE 200,002,103587,Atanasov; Nikolay A.,9999,0,9999,0
1668517297495,ECE 200,003,103588,Bharadia; Dinesh,9999,0,9999,0
1668517297495,ECE 200,004,103589,Cheng; Chung Kuan,9999,0,9999,0
1668517297495,ECE 200,005,103590,Cosman; Pamela C.,9999,0,9999,0
1668517297495,ECE 200,006,103591,Dayeh; Shadi Ahmad,9999,0,9999,0
1668517297495,ECE 200,007,103592,Fainman; Yeshaiahu,9999,0,9999,0
1668517297495,ECE 200,008,103593,Ford; Joseph Earl,9999,0,9999,0
1668517297495,ECE 200,009,103594,Franceschetti; Massimo,9999,0,9999,0
1668517297495,ECE 200,010,103595,Fullerton; Eric E,9999,0,9999,0
1668517297495,ECE 200,011,103596,Galton; Ian A,9999,0,9999,0
1668517297495,ECE 200,012,103597,Gilja; Vikash,9999,0,9999,0
1668517297495,ECE 200,013,103598,Hall; Drew A.,9999,0,9999,0
1668517297495,ECE 200,014,103599,Hsueh; Tzu-Chien,9999,0,9999,0
1668517297495,ECE 200,015,103600,Javidi; Tara,9999,0,9999,0
1668517297495,ECE 200,016,103601,Kahng; Andrew Byun,9999,0,9999,0
1668517297495,ECE 200,017,103602,Kim; Young-Han,9999,0,9999,0
1668517297495,ECE 200,018,103603,Koushanfar; Farinaz,9999,0,9999,0
1668517297495,ECE 200,019,103604,Kuzum; Duygu,9999,0,9999,0
1668517297495,ECE 200,020,103605,Le; Hanh-Phuc,9999,0,9999,0
1668517297495,ECE 200,021,103606,Lin; Bill,9999,0,9999,0
1668517297495,ECE 200,022,103607,Liu; Zhaowei,9998,0,9999,1
1668517297495,ECE 200,023,103608,Lo; Yu-Hwa,9999,0,9999,0
1668517297495,ECE 200,024,103609,Lomakin; Vitaliy,9999,0,9999,0
1668517297495,ECE 200,025,103610,Mercier; Patrick Philip,9999,0,9999,0
1668517297495,ECE 200,026,103611,Meyer; Florian,9999,0,9999,0
1668517297495,ECE 200,027,103612,Milstein; Laurence B.,9999,0,9999,0
1668517297495,ECE 200,028,103613,Mir Arabbaygi; Siavash,9999,0,9999,0
1668517297495,ECE 200,029,103614,Mookherjea; Shayan,9999,0,9999,0
1668517297495,ECE 200,030,103615,Morris; Karcher William,9999,0,9999,0
1668517297495,ECE 200,031,103616,Ng; Tse Nga,9999,0,9999,0
1668517297495,ECE 200,032,103617,Nguyen; Truong Quang,9999,0,9999,0
1668517297495,ECE 200,033,103618,Nomura; Kenji,9999,0,9999,0
1668517297495,ECE 200,034,103619,Orlitsky; Alon,9999,0,9999,0
1668517297495,ECE 200,035,103620,Pal; Piya,9999,0,9999,0
1668517297495,ECE 200,036,103621,Papen; George C.,9999,0,9999,0
1668517297495,ECE 200,037,103622,Radic; Stojan,9999,0,9999,0
1668517297495,ECE 200,038,103623,Rao; Bhaskar D.,9999,0,9999,0
1668517297495,ECE 200,039,103624,Rao; Ramesh R,9999,0,9999,0
1668517297495,ECE 200,040,103625,Rebeiz; Gabriel,9999,0,9999,0
1668517297495,ECE 200,041,103626,Sanford; John R,9999,0,9999,0
1668517297495,ECE 200,042,103627,Siegel; Paul H.,9999,0,9999,0
1668517297495,ECE 200,043,103628,Sievenpiper; Daniel F.,9999,0,9999,0
1668517297495,ECE 200,044,103629,Sworder; David D.,9999,0,9999,0
1668517297495,ECE 200,045,103630,Taur; Yuan,9999,0,9999,0
1668517297495,ECE 200,046,103631,Touri; Behrouz,9999,0,9999,0
1668517297495,ECE 200,047,103632,Trivedi; Mohan M.,9999,0,9999,0
1668517297495,ECE 200,048,103633,Vasconcelos; Nuno,9999,0,9999,0
1668517297495,ECE 200,049,103634,Wang; Xiaolong,9999,0,9999,0
1668517297495,ECE 200,050,103635,Xie; Pengtao,9999,0,9999,0
1668517297495,ECE 200,051,103636,Yip; Michael,9999,0,9999,0
1668517297495,ECE 200,052,103637,Zeger; Kenneth A.,999,0,999,0
1668517297495,ECE 200,053,103638,Zhang; Xinyu,9999,0,9999,0
1668517297495,ECE 200,054,103639,Turakhia; Yatish Girish,9999,0,9999,0
1668517297495,ECE 200,055,103640,Kang; Mingu,9999,0,9999,0
1668517297495,ECE 200,056,103641,Shi; Yuanyuan,9999,0,9999,0
1668517297495,ECE 200,057,103642,Wang; Edward Jay,9999,0,9999,0
1668517297495,ECE 200,058,103643,Zheng; Yang,9999,0,9999,0
1668517297923,ECE 202,A00,103644,Kuzum; Duygu,0,44,0,0
1668517298346,ECE 212BN,A00,103646,Ng; Tse Nga,0,9,0,0
1668517298773,ECE 221,A00,111493,Staff,0,0,0,0
1668517299204,ECE 222B,A00,103647,Lomakin; Vitaliy,0,20,0,0
1668517299648,ECE 230B,A00,103648,Taur; Yuan,0,3,0,0
1668517300074,ECE 238B,A00,103649,Garay; Javier,0,0,0,0
1668517300579,ECE 240B,A00,112900,Fainman; Yeshaiahu,0,7,0,0
1668517301003,ECE 247A,A00,103650,Jokerst; Jesse Vincent,0,6,0,0
1668517301431,ECE 247B,A00,103651,Wang; Joseph,0,14,0,0
1668517301859,ECE 250,A00,103652,Siegel; Paul H.,0,82,0,0
1668517302284,ECE 251A,A00,103654,Rao; Bhaskar D.,0,62,0,0
1668517302708,ECE 257B,A00,103655,Bharadia; Dinesh,0,33,0,0
1668517303133,ECE 258A,A00,103656,Milstein; Laurence B.,0,29,0,0
1668517303558,ECE 260B,A00,103658,Kang; Mingu,0,119,0,0
1668517303991,ECE 264A,A00,103659,Galton; Ian A,0,66,0,0
1668517304418,ECE 265A,A00,103661,Gudem; Prasad S.S.,0,70,0,0
1668517304844,ECE 265D,A00,103662,Gudem; Prasad S.S.,0,26,0,0
1668517305271,ECE 268,A00,103663,Koushanfar; Farinaz,0,43,0,0
1668517305699,ECE 269,A01,103665,Pal; Piya,0,215,0,0
1668517306126,ECE 271B,A00,103666,Vasconcelos; Manuela,0,76,0,0
1668517306553,ECE 276A,A00,103667,Atanasov; Nikolay A.,0,126,0,0
1668517306979,ECE 277,A00,103668,An; Cheolhong,0,149,0,0
1668517307407,ECE 279,A00,117947,Hall; Drew A.,0,22,0,0
1668517308279,ECE 283,A00,103670,Hsueh; Tzu-Chien,0,53,0,0
1668517308721,ECE 284,A00,103671,Turakhia; Yatish Girish,0,39,0,0
1668517309168,ECE 285,A00,103672,Zheng; Yang,0,39,0,0
1668517309168,ECE 285,B00,103673,Sworder; David D.,0,57,0,0
1668517309591,ECE 287,A00,103676,Javidi; Tara,0,9,0,0
1668517310025,MATH 200B,A00,098023,Salehi Golsefidy; Alireza,10,0,15,5
1668517310455,MATH 202B,A00,098024,Rhoades; Brendon Patrick,7,0,15,8
1668517310878,MATH 203B,A00,098025,Oprea; Dragos N.,9,0,15,6
1668517311307,MATH 204B,A00,098026,Sorensen; Claus M,13,0,15,2
1668517311744,MATH 208,A00,098027,Izadi; Elham,7,0,10,3
1668517312171,MATH 209,A00,098028,Pollack; Aaron,10,0,10,0
1668517312600,MATH 211A,A00,112919,Rogalski; Daniel,8,0,10,2
1668517313027,MATH 211B,A00,112920,Seward; Brandon M.,9,0,10,1
1668517313456,MATH 218,A00,098029,Li; Bo,10,0,10,0
1668517313881,MATH 220B,A00,098030,Novak; Jonathan I,11,0,15,4
1668517314314,MATH 221A,A00,098031,Ebenfelt; Peter F,12,0,15,3
1668517314745,MATH 231B,A00,098032,Zlatos; Andrej,11,0,15,4
1668517315176,MATH 240B,A00,098033,Ni; Lei,7,0,15,8
1668517315603,MATH 243,A00,098034,Jekel; David Andrew,10,0,10,0
1668517316035,MATH 245A,A00,098035,Nie; Jiawang,0,4,15,18
1668517316458,MATH 248,A00,098036,Bejenaru; Ioan,10,0,10,0
1668517316886,MATH 250B,A00,098037,Spolaor; Luca,14,0,15,1
1668517317309,MATH 258,A00,098038,Ni; Lei,9,0,10,1
1668517317733,MATH 264B,A00,098041,Rhoades; Brendon Patrick,8,0,15,7
1668517318157,MATH 268,A00,098042,Buss; Samuel R,10,0,10,0
1668517318581,MATH 269,A00,098043,Rhoades; Brendon Patrick,10,0,10,0
1668517319010,MATH 270B,A00,098044,Li; Bo,6,0,15,9
1668517319439,MATH 272B,A00,098045,Holst; Michael J,13,0,15,2
1668517319867,MATH 273A,A00,098046,Tian; Xiaochuan,10,0,15,5
1668517320302,MATH 275,A01,098048,Tian; Xiaochuan,6,0,10,4
1668517320735,MATH 278A,A00,098049,Holst; Michael J,7,0,10,3
1668517321164,MATH 278B,A00,098050,Cloninger; Alexander,10,0,10,0
1668517321592,MATH 278C,A00,098051,Nie; Jiawang,5,0,10,5
1668517322019,MATH 280B,A00,098052,Zheng; Tianyi,7,0,15,8
1668517322444,MATH 281B,A00,098053,Bradic; Jelena,0,2,15,15
1668517322872,MATH 282B,A00,098054,Arias-Castro; Ery,0,1,15,15
1668517323301,MATH 285,A00,098055,Fitzsimmons; Patrick J,0,3,15,17
1668517323724,MATH 287B,A00,098056,Arias-Castro; Ery,1,0,15,14
1668517324153,MATH 288,A00,098057,Agarwal; Pooja,9,0,10,1
1668517324153,MATH 288,B00,098058,Zhang; Danna,8,0,10,2
1668517324153,MATH 288,C00,098059,Williams; Ruth J,9,0,10,1
1668517324578,MATH 290B,A00,098060,Roberts; Justin Deritter,12,0,15,3
1668517325002,MATH 292,A00,098061,Belmont; Eva Kinoshita,10,0,10,0
1668517325430,MATH 295,A00,098062,Suk; Andrew Hoon,47,0,50,3
1668517325858,MATH 296,A00,098063,Novak; Jonathan I,20,0,20,0
1668517326283,MATH 297,001,098064,Gamst; Anthony Collins,9997,0,9999,2
1668517829995,COGS 205,A00,101395,Chiba; Andrea,19,0,20,1
1668517830423,COGS 210B,001,101404,Greene; Deanna Jacquelyn,9998,0,9999,1
1668517830423,COGS 210B,002,101417,Xia; Haijun,9999,0,9999,0
1668517830423,COGS 210B,003,101422,Nitz; Douglas A.,9999,0,9999,0
1668517830423,COGS 210B,004,101423,Hollan; James D.,9998,0,9999,1
1668517830423,COGS 210B,005,101424,Deak; Gedeon O.,9998,0,9999,1
1668517830423,COGS 210B,006,101425,Rossano; Federico,9999,0,9999,0
1668517830848,COGS 211B,A00,101427,Coulson; Seana M,9996,0,9999,3
1668517831273,COGS 220,A00,101428,Hollan; James D.,0,10,25,25
1668517831706,COGS 229,A00,101429,Dow; Steven P,17,0,25,8
1668517832134,COGS 230,A00,101430,Klemmer; Scott R,7,0,17,10
1668517832557,COGS 234,A00,101431,Xia; Haijun,1,0,25,24
1668517832990,COGS 260,A00,101432,Kiyonaga; Anastasia,21,0,25,4
1668517832990,COGS 260,B00,101433,Kirsh; David Joel,15,0,25,10
1668517833416,CSE 202,A00,102371,Impagliazzo; Russell,0,66,0,0
1668517833845,CSE 203B,A01,102373,Cheng; Chung Kuan,0,58,0,0
1668517834271,CSE 208,A00,102374,Micciancio; Daniele,0,5,0,0
1668517834696,CSE 209A,A00,112895,Impagliazzo; Russell,0,12,15,15
1668517835125,CSE 209B,A00,108005,Bellare; Mihir,0,7,0,0
1668517835560,CSE 210,A00,113163,Coblenz; Michael J,0,85,0,0
1668517835986,CSE 219,A00,106111,Dow; Steven P,0,6,20,20
1668517836410,CSE 221,A00,102376,Voelker; Geoffrey M.,0,73,0,0
1668517836838,CSE 224,A01,102378,Porter; George M,0,166,0,0
1668517837271,CSE 229A,A00,102379,Savage; Stefan,0,10,0,0
1668517837694,CSE 229C,A00,102380,Munyaka; Imani N. S.,0,10,0,0
1668517838126,CSE 232B,A00,102382,Deutsch; Alin Bernard,0,32,0,0
1668517838551,CSE 234,A01,112904,Kumar; Arun Kumar,0,0,0,0
1668517838978,CSE 237A,A00,102383,Rosing; Tajana Simunic,0,55,0,0
1668517839402,CSE 239A,A00,102384,Deutsch; Alin Bernard,0,14,0,0
1668517839828,CSE 239B,A00,102385,Polikarpova; Nadezhda,0,10,0,0
1668517840260,CSE 240A,A00,102386,Pannuto; Patrick William,0,46,0,0
1668517840688,CSE 240B,A00,102387,Zhao; Jishen,0,47,0,0
1668517841112,CSE 241A,A00,106406,Kang; Mingu,0,9,0,0
1668517841536,CSE 249B,A00,102388,Kahng; Andrew Byun,0,5,8,8
1668517841964,CSE 251B,A01,102392,Cottrell; Garrison W,0,51,0,0
1668517841964,CSE 251B,A02,102393,Cottrell; Garrison W,0,34,0,0
1668517842388,CSE 252B,A00,102394,Ochoa; Benjamin Lawrence,0,59,0,0
1668517842815,CSE 257,A01,102396,Gao; Sicun,0,139,0,0
1668517843239,CSE 272,A00,102397,Li; Tzumao,0,19,0,0
1668517843673,CSE 274,A00,111323,Chern; Albert Ren-Haur,0,15,0,0
1668517844100,CSE 282,A00,102398,Pevzner; Pavel Arkadjevich,0,0,0,0
1668517844543,CSE 284,A00,114175,Gymrek; Melissa Ann,0,22,0,0
1668517844977,CSE 290,A00,102399,Chandraker; Manmohan Krishna,0,11,0,0
1668517844977,CSE 290,B00,102400,Vaccaro; Kristen Marie,0,7,25,25
1668517844977,CSE 290,C00,102414,Pannuto; Patrick William,0,1,25,25
1668517844977,CSE 290,D00,102427,Pevzner; Pavel Arkadjevich,0,0,0,0
1668517844977,CSE 290,E00,102429,Zhao; Jishen,0,4,0,0
1668517844977,CSE 290,F00,102436,Tullsen; Dean Michael,0,5,0,0
1668517844977,CSE 290,G00,102440,Christensen; Henrik I,0,6,20,20
1668517845424,CSE 291,A00,102443,Su; Hao,0,0,0,0
1668517845424,CSE 291,B00,102448,Polikarpova; Nadezhda,0,0,0,0
1668517845424,CSE 291,C00,102453,Vaccaro; Kristen Marie,0,0,0,0
1668517845424,CSE 291,D00,111343,Savage; Stefan,0,0,0,0
1668517845424,CSE 291,E00,116474,Claffy; Kimberly Claire,0,0,0,0
1668517845424,CSE 291,F00,116479,Pasquale; Joseph,0,0,0,0
1668517845862,CSE 293,001,119111,Bafna; Vineet,9999,0,9999,0
1668517845862,CSE 293,002,119118,Bellare; Mihir,9999,0,9999,0
1668517845862,CSE 293,003,119122,Berg-Kirkpatrick; Taylor D,9999,0,9999,0
1668517845862,CSE 293,004,119135,Christensen; Henrik I,9999,0,9999,0
1668517845862,CSE 293,005,119142,Cottrell; Garrison W,9999,0,9999,0
1668517845862,CSE 293,006,119146,Deutsch; Alin Bernard,9999,0,9999,0
1668517845862,CSE 293,007,119159,Esmaeilzadeh; Hadi,9999,0,9999,0
1668517845862,CSE 293,008,119166,Freund; Yoav,9999,0,9999,0
1668517845862,CSE 293,009,119170,Griswold; William G.,9999,0,9999,0
1668517845862,CSE 293,010,119183,Gymrek; Melissa Ann,9999,0,9999,0
1668517845862,CSE 293,011,119190,Heninger; Nadia A,9999,0,9999,0
1668517845862,CSE 293,012,119230,Impagliazzo; Russell,9999,0,9999,0
1668517845862,CSE 293,013,119232,Jhala; Ranjit,9999,0,9999,0
1668517845862,CSE 293,014,119233,Kahng; Andrew Byun,9999,0,9999,0
1668517845862,CSE 293,015,119298,Kane; Daniel Mertz,9999,0,9999,0
1668517845862,CSE 293,016,119299,Kriegman; David J,9999,0,9999,0
1668517845862,CSE 293,017,119300,Kumar; Arun Kumar,9999,0,9999,0
1668517845862,CSE 293,018,119301,Lerner; Sorin,9999,0,9999,0
1668517845862,CSE 293,019,119302,Lovett; Shachar,9999,0,9999,0
1668517845862,CSE 293,020,119303,McAuley; Julian John,9999,0,9999,0
1668517845862,CSE 293,021,119304,Micciancio; Daniele,9999,0,9999,0
1668517845862,CSE 293,022,119367,Orailoglu; Alex,9999,0,9999,0
1668517845862,CSE 293,023,119382,Paturi; Ramamohan,9999,0,9999,0
1668517845862,CSE 293,024,119404,Polikarpova; Nadezhda,9999,0,9999,0
1668517845862,CSE 293,025,119406,Politz; Joseph Gibbs,9999,0,9999,0
1668517845862,CSE 293,026,119411,Porter; George M,9999,0,9999,0
1668517845862,CSE 293,027,119414,Porter; Leonard Emerson,9999,0,9999,0
1668517845862,CSE 293,028,119416,Ramamoorthi; Ravi,9999,0,9999,0
1668517845862,CSE 293,029,119417,Sahoo; Debashis,9999,0,9999,0
1668517845862,CSE 293,030,119420,Saul; Lawrence,9999,0,9999,0
1668517845862,CSE 293,031,119421,Savage; Stefan,9999,0,9999,0
1668517845862,CSE 293,032,119425,Schulze; Jurgen P.,9999,0,9999,0
1668517845862,CSE 293,033,119426,Snoeren; Alex C.,9999,0,9999,0
1668517845862,CSE 293,034,119428,Shang; Jingbo,9999,0,9999,0
1668517845862,CSE 293,035,119430,Stefan; Deian,9999,0,9999,0
1668517845862,CSE 293,036,119431,Su; Hao,9999,0,9999,0
1668517845862,CSE 293,037,119433,Swanson; Steven James,9999,0,9999,0
1668517845862,CSE 293,038,119435,Tullsen; Dean Michael,9999,0,9999,0
1668517845862,CSE 293,039,119483,Voelker; Geoffrey M.,9999,0,9999,0
1668517845862,CSE 293,040,119537,Zhao; Jishen,9999,0,9999,0
1668517845862,CSE 293,041,119538,Zhou; Yuan-Yuan,9999,0,9999,0
1668517845862,CSE 293,042,119539,Gao; Sicun,9999,0,9999,0
1668517845862,CSE 293,043,119540,Weibel; Nadir,9999,0,9999,0
1668517845862,CSE 293,044,119541,Gupta; Rajesh K.,9999,0,9999,0
1668517845862,CSE 293,045,126410,Vaccaro; Kristen Marie,9999,0,9999,0
1668517845862,CSE 293,046,126411,Klemke; Richard,9999,0,9999,0
1668517846290,CSE 294,A00,102459,Voelker; Geoffrey M.,0,2,0,0
1668517846290,CSE 294,B00,111322,Orailoglu; Alex,0,2,0,0
1668517846714,DSE 201,A00,096914,Deutsch; Alin Bernard,30,0,30,0
1668517847138,DSE 210,A00,096915,Dasgupta; Sanjoy,30,0,30,0
1668517847561,DSE 260A,A00,096916,Altintas De Callaf; Ilkay,30,0,30,0
1668517848004,ECE 200,001,103586,Antipa; Nicholas A,9999,0,9999,0
1668517848004,ECE 200,002,103587,Atanasov; Nikolay A.,9999,0,9999,0
1668517848004,ECE 200,003,103588,Bharadia; Dinesh,9999,0,9999,0
1668517848004,ECE 200,004,103589,Cheng; Chung Kuan,9999,0,9999,0
1668517848004,ECE 200,005,103590,Cosman; Pamela C.,9999,0,9999,0
1668517848004,ECE 200,006,103591,Dayeh; Shadi Ahmad,9999,0,9999,0
1668517848004,ECE 200,007,103592,Fainman; Yeshaiahu,9999,0,9999,0
1668517848004,ECE 200,008,103593,Ford; Joseph Earl,9999,0,9999,0
1668517848004,ECE 200,009,103594,Franceschetti; Massimo,9999,0,9999,0
1668517848004,ECE 200,010,103595,Fullerton; Eric E,9999,0,9999,0
1668517848004,ECE 200,011,103596,Galton; Ian A,9999,0,9999,0
1668517848004,ECE 200,012,103597,Gilja; Vikash,9999,0,9999,0
1668517848004,ECE 200,013,103598,Hall; Drew A.,9999,0,9999,0
1668517848004,ECE 200,014,103599,Hsueh; Tzu-Chien,9999,0,9999,0
1668517848004,ECE 200,015,103600,Javidi; Tara,9999,0,9999,0
1668517848004,ECE 200,016,103601,Kahng; Andrew Byun,9999,0,9999,0
1668517848004,ECE 200,017,103602,Kim; Young-Han,9999,0,9999,0
1668517848004,ECE 200,018,103603,Koushanfar; Farinaz,9999,0,9999,0
1668517848004,ECE 200,019,103604,Kuzum; Duygu,9999,0,9999,0
1668517848004,ECE 200,020,103605,Le; Hanh-Phuc,9999,0,9999,0
1668517848004,ECE 200,021,103606,Lin; Bill,9999,0,9999,0
1668517848004,ECE 200,022,103607,Liu; Zhaowei,9998,0,9999,1
1668517848004,ECE 200,023,103608,Lo; Yu-Hwa,9999,0,9999,0
1668517848004,ECE 200,024,103609,Lomakin; Vitaliy,9999,0,9999,0
1668517848004,ECE 200,025,103610,Mercier; Patrick Philip,9999,0,9999,0
1668517848004,ECE 200,026,103611,Meyer; Florian,9999,0,9999,0
1668517848004,ECE 200,027,103612,Milstein; Laurence B.,9999,0,9999,0
1668517848004,ECE 200,028,103613,Mir Arabbaygi; Siavash,9999,0,9999,0
1668517848004,ECE 200,029,103614,Mookherjea; Shayan,9999,0,9999,0
1668517848004,ECE 200,030,103615,Morris; Karcher William,9999,0,9999,0
1668517848004,ECE 200,031,103616,Ng; Tse Nga,9999,0,9999,0
1668517848004,ECE 200,032,103617,Nguyen; Truong Quang,9999,0,9999,0
1668517848004,ECE 200,033,103618,Nomura; Kenji,9999,0,9999,0
1668517848004,ECE 200,034,103619,Orlitsky; Alon,9999,0,9999,0
1668517848004,ECE 200,035,103620,Pal; Piya,9999,0,9999,0
1668517848004,ECE 200,036,103621,Papen; George C.,9999,0,9999,0
1668517848004,ECE 200,037,103622,Radic; Stojan,9999,0,9999,0
1668517848004,ECE 200,038,103623,Rao; Bhaskar D.,9999,0,9999,0
1668517848004,ECE 200,039,103624,Rao; Ramesh R,9999,0,9999,0
1668517848004,ECE 200,040,103625,Rebeiz; Gabriel,9999,0,9999,0
1668517848004,ECE 200,041,103626,Sanford; John R,9999,0,9999,0
1668517848004,ECE 200,042,103627,Siegel; Paul H.,9999,0,9999,0
1668517848004,ECE 200,043,103628,Sievenpiper; Daniel F.,9999,0,9999,0
1668517848004,ECE 200,044,103629,Sworder; David D.,9999,0,9999,0
1668517848004,ECE 200,045,103630,Taur; Yuan,9999,0,9999,0
1668517848004,ECE 200,046,103631,Touri; Behrouz,9999,0,9999,0
1668517848004,ECE 200,047,103632,Trivedi; Mohan M.,9999,0,9999,0
1668517848004,ECE 200,048,103633,Vasconcelos; Nuno,9999,0,9999,0
1668517848004,ECE 200,049,103634,Wang; Xiaolong,9999,0,9999,0
1668517848004,ECE 200,050,103635,Xie; Pengtao,9999,0,9999,0
1668517848004,ECE 200,051,103636,Yip; Michael,9999,0,9999,0
1668517848004,ECE 200,052,103637,Zeger; Kenneth A.,999,0,999,0
1668517848004,ECE 200,053,103638,Zhang; Xinyu,9999,0,9999,0
1668517848004,ECE 200,054,103639,Turakhia; Yatish Girish,9999,0,9999,0
1668517848004,ECE 200,055,103640,Kang; Mingu,9999,0,9999,0
1668517848004,ECE 200,056,103641,Shi; Yuanyuan,9999,0,9999,0
1668517848004,ECE 200,057,103642,Wang; Edward Jay,9999,0,9999,0
1668517848004,ECE 200,058,103643,Zheng; Yang,9999,0,9999,0
1668517848435,ECE 202,A00,103644,Kuzum; Duygu,0,44,0,0
1668517848862,ECE 212BN,A00,103646,Ng; Tse Nga,0,9,0,0
1668517849287,ECE 221,A00,111493,Staff,0,0,0,0
1668517849712,ECE 222B,A00,103647,Lomakin; Vitaliy,0,20,0,0
1668517850142,ECE 230B,A00,103648,Taur; Yuan,0,3,0,0
1668517850568,ECE 238B,A00,103649,Garay; Javier,0,0,0,0
1668517850991,ECE 240B,A00,112900,Fainman; Yeshaiahu,0,7,0,0
1668517851422,ECE 247A,A00,103650,Jokerst; Jesse Vincent,0,6,0,0
1668517851850,ECE 247B,A00,103651,Wang; Joseph,0,14,0,0
1668517852277,ECE 250,A00,103652,Siegel; Paul H.,0,82,0,0
1668517852703,ECE 251A,A00,103654,Rao; Bhaskar D.,0,62,0,0
1668517853137,ECE 257B,A00,103655,Bharadia; Dinesh,0,33,0,0
1668517853572,ECE 258A,A00,103656,Milstein; Laurence B.,0,29,0,0
1668517854005,ECE 260B,A00,103658,Kang; Mingu,0,119,0,0
1668517854431,ECE 264A,A00,103659,Galton; Ian A,0,66,0,0
1668517854862,ECE 265A,A00,103661,Gudem; Prasad S.S.,0,70,0,0
1668517855289,ECE 265D,A00,103662,Gudem; Prasad S.S.,0,26,0,0
1668517855713,ECE 268,A00,103663,Koushanfar; Farinaz,0,43,0,0
1668517856137,ECE 269,A01,103665,Pal; Piya,0,215,0,0
1668517856562,ECE 271B,A00,103666,Vasconcelos; Manuela,0,76,0,0
1668517856985,ECE 276A,A00,103667,Atanasov; Nikolay A.,0,126,0,0
1668517857415,ECE 277,A00,103668,An; Cheolhong,0,149,0,0
1668517857850,ECE 279,A00,117947,Hall; Drew A.,0,22,0,0
1668517858707,ECE 283,A00,103670,Hsueh; Tzu-Chien,0,53,0,0
1668517859135,ECE 284,A00,103671,Turakhia; Yatish Girish,0,39,0,0
1668517859560,ECE 285,A00,103672,Zheng; Yang,0,39,0,0
1668517859560,ECE 285,B00,103673,Sworder; David D.,0,57,0,0
1668517859985,ECE 287,A00,103676,Javidi; Tara,0,9,0,0
1668517860410,MATH 200B,A00,098023,Salehi Golsefidy; Alireza,10,0,15,5
1668517860839,MATH 202B,A00,098024,Rhoades; Brendon Patrick,7,0,15,8
1668517861263,MATH 203B,A00,098025,Oprea; Dragos N.,9,0,15,6
1668517861687,MATH 204B,A00,098026,Sorensen; Claus M,13,0,15,2
1668517862119,MATH 208,A00,098027,Izadi; Elham,7,0,10,3
1668517862560,MATH 209,A00,098028,Pollack; Aaron,10,0,10,0
1668517862986,MATH 211A,A00,112919,Rogalski; Daniel,8,0,10,2
1668517863411,MATH 211B,A00,112920,Seward; Brandon M.,9,0,10,1
1668517863838,MATH 218,A00,098029,Li; Bo,10,0,10,0
1668517864264,MATH 220B,A00,098030,Novak; Jonathan I,11,0,15,4
1668517864694,MATH 221A,A00,098031,Ebenfelt; Peter F,12,0,15,3
1668517865119,MATH 231B,A00,098032,Zlatos; Andrej,11,0,15,4
1668517865544,MATH 240B,A00,098033,Ni; Lei,7,0,15,8
1668517865967,MATH 243,A00,098034,Jekel; David Andrew,10,0,10,0
1668517866489,MATH 245A,A00,098035,Nie; Jiawang,0,4,15,18
1668517866914,MATH 248,A00,098036,Bejenaru; Ioan,10,0,10,0
1668517867338,MATH 250B,A00,098037,Spolaor; Luca,14,0,15,1
1668517867762,MATH 258,A00,098038,Ni; Lei,9,0,10,1
1668517868191,MATH 264B,A00,098041,Rhoades; Brendon Patrick,8,0,15,7
1668517868621,MATH 268,A00,098042,Buss; Samuel R,10,0,10,0
1668517869046,MATH 269,A00,098043,Rhoades; Brendon Patrick,10,0,10,0
1668517869471,MATH 270B,A00,098044,Li; Bo,6,0,15,9
1668517869897,MATH 272B,A00,098045,Holst; Michael J,13,0,15,2
1668517870331,MATH 273A,A00,098046,Tian; Xiaochuan,10,0,15,5
1668517870762,MATH 275,A01,098048,Tian; Xiaochuan,6,0,10,4
1668517871187,MATH 278A,A00,098049,Holst; Michael J,7,0,10,3
1668517871613,MATH 278B,A00,098050,Cloninger; Alexander,10,0,10,0
1668517872037,MATH 278C,A00,098051,Nie; Jiawang,5,0,10,5
1668517872462,MATH 280B,A00,098052,Zheng; Tianyi,7,0,15,8
1668517872890,MATH 281B,A00,098053,Bradic; Jelena,0,2,15,15
1668517873318,MATH 282B,A00,098054,Arias-Castro; Ery,0,1,15,15
1668517873743,MATH 285,A00,098055,Fitzsimmons; Patrick J,0,3,15,17
1668517874169,MATH 287B,A00,098056,Arias-Castro; Ery,1,0,15,14
1668517874594,MATH 288,A00,098057,Agarwal; Pooja,9,0,10,1
1668517874594,MATH 288,B00,098058,Zhang; Danna,8,0,10,2
1668517874594,MATH 288,C00,098059,Williams; Ruth J,9,0,10,1
1668517875019,MATH 290B,A00,098060,Roberts; Justin Deritter,12,0,15,3
1668517875459,MATH 292,A00,098061,Belmont; Eva Kinoshita,10,0,10,0
1668517875894,MATH 295,A00,098062,Suk; Andrew Hoon,47,0,50,3
1668517876319,MATH 296,A00,098063,Novak; Jonathan I,20,0,20,0
1668517876743,MATH 297,001,098064,Gamst; Anthony Collins,9997,0,9999,2
1668518378577,COGS 205,A00,101395,Chiba; Andrea,19,0,20,1
1668518379003,COGS 210B,001,101404,Greene; Deanna Jacquelyn,9998,0,9999,1
1668518379003,COGS 210B,002,101417,Xia; Haijun,9999,0,9999,0
1668518379003,COGS 210B,003,101422,Nitz; Douglas A.,9999,0,9999,0
1668518379003,COGS 210B,004,101423,Hollan; James D.,9998,0,9999,1
1668518379003,COGS 210B,005,101424,Deak; Gedeon O.,9998,0,9999,1
1668518379003,COGS 210B,006,101425,Rossano; Federico,9999,0,9999,0
1668518379429,COGS 211B,A00,101427,Coulson; Seana M,9996,0,9999,3
1668518379854,COGS 220,A00,101428,Hollan; James D.,0,10,25,25
1668518380280,COGS 229,A00,101429,Dow; Steven P,17,0,25,8
1668518380714,COGS 230,A00,101430,Klemmer; Scott R,7,0,17,10
1668518381140,COGS 234,A00,101431,Xia; Haijun,1,0,25,24
1668518381563,COGS 260,A00,101432,Kiyonaga; Anastasia,21,0,25,4
1668518381563,COGS 260,B00,101433,Kirsh; David Joel,15,0,25,10
1668518381986,CSE 202,A00,102371,Impagliazzo; Russell,0,66,0,0
1668518382410,CSE 203B,A01,102373,Cheng; Chung Kuan,0,58,0,0
1668518382835,CSE 208,A00,102374,Micciancio; Daniele,0,5,0,0
1668518383259,CSE 209A,A00,112895,Impagliazzo; Russell,0,12,15,15
1668518383686,CSE 209B,A00,108005,Bellare; Mihir,0,7,0,0
1668518384116,CSE 210,A00,113163,Coblenz; Michael J,0,85,0,0
1668518384542,CSE 219,A00,106111,Dow; Steven P,0,6,20,20
1668518384965,CSE 221,A00,102376,Voelker; Geoffrey M.,0,73,0,0
1668518385389,CSE 224,A01,102378,Porter; George M,0,166,0,0
1668518385817,CSE 229A,A00,102379,Savage; Stefan,0,10,0,0
1668518386245,CSE 229C,A00,102380,Munyaka; Imani N. S.,0,10,0,0
1668518386671,CSE 232B,A00,102382,Deutsch; Alin Bernard,0,32,0,0
1668518387188,CSE 234,A01,112904,Kumar; Arun Kumar,0,0,0,0
1668518387612,CSE 237A,A00,102383,Rosing; Tajana Simunic,0,55,0,0
1668518388036,CSE 239A,A00,102384,Deutsch; Alin Bernard,0,14,0,0
1668518388462,CSE 239B,A00,102385,Polikarpova; Nadezhda,0,10,0,0
1668518388891,CSE 240A,A00,102386,Pannuto; Patrick William,0,46,0,0
1668518389316,CSE 240B,A00,102387,Zhao; Jishen,0,47,0,0
1668518389740,CSE 241A,A00,106406,Kang; Mingu,0,9,0,0
1668518390165,CSE 249B,A00,102388,Kahng; Andrew Byun,0,5,8,8
1668518390590,CSE 251B,A01,102392,Cottrell; Garrison W,0,51,0,0
1668518390590,CSE 251B,A02,102393,Cottrell; Garrison W,0,34,0,0
1668518391017,CSE 252B,A00,102394,Ochoa; Benjamin Lawrence,0,59,0,0
1668518391458,CSE 257,A01,102396,Gao; Sicun,0,139,0,0
1668518391896,CSE 272,A00,102397,Li; Tzumao,0,19,0,0
1668518392323,CSE 274,A00,111323,Chern; Albert Ren-Haur,0,15,0,0
1668518392752,CSE 282,A00,102398,Pevzner; Pavel Arkadjevich,0,0,0,0
1668518393175,CSE 284,A00,114175,Gymrek; Melissa Ann,0,22,0,0
1668518393600,CSE 290,A00,102399,Chandraker; Manmohan Krishna,0,11,0,0
1668518393600,CSE 290,B00,102400,Vaccaro; Kristen Marie,0,7,25,25
1668518393600,CSE 290,C00,102414,Pannuto; Patrick William,0,1,25,25
1668518393600,CSE 290,D00,102427,Pevzner; Pavel Arkadjevich,0,0,0,0
1668518393600,CSE 290,E00,102429,Zhao; Jishen,0,4,0,0
1668518393600,CSE 290,F00,102436,Tullsen; Dean Michael,0,5,0,0
1668518393600,CSE 290,G00,102440,Christensen; Henrik I,0,6,20,20
1668518394025,CSE 291,A00,102443,Su; Hao,0,0,0,0
1668518394025,CSE 291,B00,102448,Polikarpova; Nadezhda,0,0,0,0
1668518394025,CSE 291,C00,102453,Vaccaro; Kristen Marie,0,0,0,0
1668518394025,CSE 291,D00,111343,Savage; Stefan,0,0,0,0
1668518394025,CSE 291,E00,116474,Claffy; Kimberly Claire,0,0,0,0
1668518394025,CSE 291,F00,116479,Pasquale; Joseph,0,0,0,0
1668518394453,CSE 293,001,119111,Bafna; Vineet,9999,0,9999,0
1668518394453,CSE 293,002,119118,Bellare; Mihir,9999,0,9999,0
1668518394453,CSE 293,003,119122,Berg-Kirkpatrick; Taylor D,9999,0,9999,0
1668518394453,CSE 293,004,119135,Christensen; Henrik I,9999,0,9999,0
1668518394453,CSE 293,005,119142,Cottrell; Garrison W,9999,0,9999,0
1668518394453,CSE 293,006,119146,Deutsch; Alin Bernard,9999,0,9999,0
1668518394453,CSE 293,007,119159,Esmaeilzadeh; Hadi,9999,0,9999,0
1668518394453,CSE 293,008,119166,Freund; Yoav,9999,0,9999,0
1668518394453,CSE 293,009,119170,Griswold; William G.,9999,0,9999,0
1668518394453,CSE 293,010,119183,Gymrek; Melissa Ann,9999,0,9999,0
1668518394453,CSE 293,011,119190,Heninger; Nadia A,9999,0,9999,0
1668518394453,CSE 293,012,119230,Impagliazzo; Russell,9999,0,9999,0
1668518394453,CSE 293,013,119232,Jhala; Ranjit,9999,0,9999,0
1668518394453,CSE 293,014,119233,Kahng; Andrew Byun,9999,0,9999,0
1668518394453,CSE 293,015,119298,Kane; Daniel Mertz,9999,0,9999,0
1668518394453,CSE 293,016,119299,Kriegman; David J,9999,0,9999,0
1668518394453,CSE 293,017,119300,Kumar; Arun Kumar,9999,0,9999,0
1668518394453,CSE 293,018,119301,Lerner; Sorin,9999,0,9999,0
1668518394453,CSE 293,019,119302,Lovett; Shachar,9999,0,9999,0
1668518394453,CSE 293,020,119303,McAuley; Julian John,9999,0,9999,0
1668518394453,CSE 293,021,119304,Micciancio; Daniele,9999,0,9999,0
1668518394453,CSE 293,022,119367,Orailoglu; Alex,9999,0,9999,0
1668518394453,CSE 293,023,119382,Paturi; Ramamohan,9999,0,9999,0
1668518394453,CSE 293,024,119404,Polikarpova; Nadezhda,9999,0,9999,0
1668518394453,CSE 293,025,119406,Politz; Joseph Gibbs,9999,0,9999,0
1668518394453,CSE 293,026,119411,Porter; George M,9999,0,9999,0
1668518394453,CSE 293,027,119414,Porter; Leonard Emerson,9999,0,9999,0
1668518394453,CSE 293,028,119416,Ramamoorthi; Ravi,9999,0,9999,0
1668518394453,CSE 293,029,119417,Sahoo; Debashis,9999,0,9999,0
1668518394453,CSE 293,030,119420,Saul; Lawrence,9999,0,9999,0
1668518394453,CSE 293,031,119421,Savage; Stefan,9999,0,9999,0
1668518394453,CSE 293,032,119425,Schulze; Jurgen P.,9999,0,9999,0
1668518394453,CSE 293,033,119426,Snoeren; Alex C.,9999,0,9999,0
1668518394453,CSE 293,034,119428,Shang; Jingbo,9999,0,9999,0
1668518394453,CSE 293,035,119430,Stefan; Deian,9999,0,9999,0
1668518394453,CSE 293,036,119431,Su; Hao,9999,0,9999,0
1668518394453,CSE 293,037,119433,Swanson; Steven James,9999,0,9999,0
1668518394453,CSE 293,038,119435,Tullsen; Dean Michael,9999,0,9999,0
1668518394453,CSE 293,039,119483,Voelker; Geoffrey M.,9999,0,9999,0
1668518394453,CSE 293,040,119537,Zhao; Jishen,9999,0,9999,0
1668518394453,CSE 293,041,119538,Zhou; Yuan-Yuan,9999,0,9999,0
1668518394453,CSE 293,042,119539,Gao; Sicun,9999,0,9999,0
1668518394453,CSE 293,043,119540,Weibel; Nadir,9999,0,9999,0
1668518394453,CSE 293,044,119541,Gupta; Rajesh K.,9999,0,9999,0
1668518394453,CSE 293,045,126410,Vaccaro; Kristen Marie,9999,0,9999,0
1668518394453,CSE 293,046,126411,Klemke; Richard,9999,0,9999,0
1668518394879,CSE 294,A00,102459,Voelker; Geoffrey M.,0,2,0,0
1668518394879,CSE 294,B00,111322,Orailoglu; Alex,0,2,0,0
1668518395307,DSE 201,A00,096914,Deutsch; Alin Bernard,30,0,30,0
1668518395738,DSE 210,A00,096915,Dasgupta; Sanjoy,30,0,30,0
1668518396162,DSE 260A,A00,096916,Altintas De Callaf; Ilkay,30,0,30,0
1668518396591,ECE 200,001,103586,Antipa; Nicholas A,9999,0,9999,0
1668518396591,ECE 200,002,103587,Atanasov; Nikolay A.,9999,0,9999,0
1668518396591,ECE 200,003,103588,Bharadia; Dinesh,9999,0,9999,0
1668518396591,ECE 200,004,103589,Cheng; Chung Kuan,9999,0,9999,0
1668518396591,ECE 200,005,103590,Cosman; Pamela C.,9999,0,9999,0
1668518396591,ECE 200,006,103591,Dayeh; Shadi Ahmad,9999,0,9999,0
1668518396591,ECE 200,007,103592,Fainman; Yeshaiahu,9999,0,9999,0
1668518396591,ECE 200,008,103593,Ford; Joseph Earl,9999,0,9999,0
1668518396591,ECE 200,009,103594,Franceschetti; Massimo,9999,0,9999,0
1668518396591,ECE 200,010,103595,Fullerton; Eric E,9999,0,9999,0
1668518396591,ECE 200,011,103596,Galton; Ian A,9999,0,9999,0
1668518396591,ECE 200,012,103597,Gilja; Vikash,9999,0,9999,0
1668518396591,ECE 200,013,103598,Hall; Drew A.,9999,0,9999,0
1668518396591,ECE 200,014,103599,Hsueh; Tzu-Chien,9999,0,9999,0
1668518396591,ECE 200,015,103600,Javidi; Tara,9999,0,9999,0
1668518396591,ECE 200,016,103601,Kahng; Andrew Byun,9999,0,9999,0
1668518396591,ECE 200,017,103602,Kim; Young-Han,9999,0,9999,0
1668518396591,ECE 200,018,103603,Koushanfar; Farinaz,9999,0,9999,0
1668518396591,ECE 200,019,103604,Kuzum; Duygu,9999,0,9999,0
1668518396591,ECE 200,020,103605,Le; Hanh-Phuc,9999,0,9999,0
1668518396591,ECE 200,021,103606,Lin; Bill,9999,0,9999,0
1668518396591,ECE 200,022,103607,Liu; Zhaowei,9998,0,9999,1
1668518396591,ECE 200,023,103608,Lo; Yu-Hwa,9999,0,9999,0
1668518396591,ECE 200,024,103609,Lomakin; Vitaliy,9999,0,9999,0
1668518396591,ECE 200,025,103610,Mercier; Patrick Philip,9999,0,9999,0
1668518396591,ECE 200,026,103611,Meyer; Florian,9999,0,9999,0
1668518396591,ECE 200,027,103612,Milstein; Laurence B.,9999,0,9999,0
1668518396591,ECE 200,028,103613,Mir Arabbaygi; Siavash,9999,0,9999,0
1668518396591,ECE 200,029,103614,Mookherjea; Shayan,9999,0,9999,0
1668518396591,ECE 200,030,103615,Morris; Karcher William,9999,0,9999,0
1668518396591,ECE 200,031,103616,Ng; Tse Nga,9999,0,9999,0
1668518396591,ECE 200,032,103617,Nguyen; Truong Quang,9999,0,9999,0
1668518396591,ECE 200,033,103618,Nomura; Kenji,9999,0,9999,0
1668518396591,ECE 200,034,103619,Orlitsky; Alon,9999,0,9999,0
1668518396591,ECE 200,035,103620,Pal; Piya,9999,0,9999,0
1668518396591,ECE 200,036,103621,Papen; George C.,9999,0,9999,0
1668518396591,ECE 200,037,103622,Radic; Stojan,9999,0,9999,0
1668518396591,ECE 200,038,103623,Rao; Bhaskar D.,9999,0,9999,0
1668518396591,ECE 200,039,103624,Rao; Ramesh R,9999,0,9999,0
1668518396591,ECE 200,040,103625,Rebeiz; Gabriel,9999,0,9999,0
1668518396591,ECE 200,041,103626,Sanford; John R,9999,0,9999,0
1668518396591,ECE 200,042,103627,Siegel; Paul H.,9999,0,9999,0
1668518396591,ECE 200,043,103628,Sievenpiper; Daniel F.,9999,0,9999,0
1668518396591,ECE 200,044,103629,Sworder; David D.,9999,0,9999,0
1668518396591,ECE 200,045,103630,Taur; Yuan,9999,0,9999,0
1668518396591,ECE 200,046,103631,Touri; Behrouz,9999,0,9999,0
1668518396591,ECE 200,047,103632,Trivedi; Mohan M.,9999,0,9999,0
1668518396591,ECE 200,048,103633,Vasconcelos; Nuno,9999,0,9999,0
1668518396591,ECE 200,049,103634,Wang; Xiaolong,9999,0,9999,0
1668518396591,ECE 200,050,103635,Xie; Pengtao,9999,0,9999,0
1668518396591,ECE 200,051,103636,Yip; Michael,9999,0,9999,0
1668518396591,ECE 200,052,103637,Zeger; Kenneth A.,999,0,999,0
1668518396591,ECE 200,053,103638,Zhang; Xinyu,9999,0,9999,0
1668518396591,ECE 200,054,103639,Turakhia; Yatish Girish,9999,0,9999,0
1668518396591,ECE 200,055,103640,Kang; Mingu,9999,0,9999,0
1668518396591,ECE 200,056,103641,Shi; Yuanyuan,9999,0,9999,0
1668518396591,ECE 200,057,103642,Wang; Edward Jay,9999,0,9999,0
1668518396591,ECE 200,058,103643,Zheng; Yang,9999,0,9999,0
1668518397013,ECE 202,A00,103644,Kuzum; Duygu,0,44,0,0
1668518397443,ECE 212BN,A00,103646,Ng; Tse Nga,0,9,0,0
1668518397868,ECE 221,A00,111493,Staff,0,0,0,0
1668518398297,ECE 222B,A00,103647,Lomakin; Vitaliy,0,20,0,0
1668518398722,ECE 230B,A00,103648,Taur; Yuan,0,3,0,0
1668518399147,ECE 238B,A00,103649,Garay; Javier,0,0,0,0
1668518399572,ECE 240B,A00,112900,Fainman; Yeshaiahu,0,7,0,0
1668518399999,ECE 247A,A00,103650,Jokerst; Jesse Vincent,0,6,0,0
1668518400428,ECE 247B,A00,103651,Wang; Joseph,0,14,0,0
1668518400857,ECE 250,A00,103652,Siegel; Paul H.,0,82,0,0
1668518401284,ECE 251A,A00,103654,Rao; Bhaskar D.,0,62,0,0
1668518401712,ECE 257B,A00,103655,Bharadia; Dinesh,0,33,0,0
1668518402136,ECE 258A,A00,103656,Milstein; Laurence B.,0,29,0,0
1668518402564,ECE 260B,A00,103658,Kang; Mingu,0,119,0,0
1668518402990,ECE 264A,A00,103659,Galton; Ian A,0,66,0,0
1668518403418,ECE 265A,A00,103661,Gudem; Prasad S.S.,0,70,0,0
1668518403844,ECE 265D,A00,103662,Gudem; Prasad S.S.,0,26,0,0
1668518404267,ECE 268,A00,103663,Koushanfar; Farinaz,0,43,0,0
1668518404692,ECE 269,A01,103665,Pal; Piya,0,215,0,0
1668518405123,ECE 271B,A00,103666,Vasconcelos; Manuela,0,76,0,0
1668518405551,ECE 276A,A00,103667,Atanasov; Nikolay A.,0,126,0,0
1668518405975,ECE 277,A00,103668,An; Cheolhong,0,149,0,0
1668518406402,ECE 279,A00,117947,Hall; Drew A.,0,22,0,0
1668518407253,ECE 283,A00,103670,Hsueh; Tzu-Chien,0,53,0,0
1668518407690,ECE 284,A00,103671,Turakhia; Yatish Girish,0,39,0,0
1668518408113,ECE 285,A00,103672,Zheng; Yang,0,39,0,0
1668518408113,ECE 285,B00,103673,Sworder; David D.,0,57,0,0
1668518408541,ECE 287,A00,103676,Javidi; Tara,0,9,0,0
1668518408966,MATH 200B,A00,098023,Salehi Golsefidy; Alireza,10,0,15,5
1668518409390,MATH 202B,A00,098024,Rhoades; Brendon Patrick,7,0,15,8
1668518409824,MATH 203B,A00,098025,Oprea; Dragos N.,9,0,15,6
1668518410251,MATH 204B,A00,098026,Sorensen; Claus M,13,0,15,2
1668518410675,MATH 208,A00,098027,Izadi; Elham,7,0,10,3
1668518411100,MATH 209,A00,098028,Pollack; Aaron,10,0,10,0
1668518411530,MATH 211A,A00,112919,Rogalski; Daniel,8,0,10,2
1668518411958,MATH 211B,A00,112920,Seward; Brandon M.,9,0,10,1
1668518412385,MATH 218,A00,098029,Li; Bo,10,0,10,0
1668518412811,MATH 220B,A00,098030,Novak; Jonathan I,11,0,15,4
1668518413234,MATH 221A,A00,098031,Ebenfelt; Peter F,12,0,15,3
1668518413659,MATH 231B,A00,098032,Zlatos; Andrej,11,0,15,4
1668518414086,MATH 240B,A00,098033,Ni; Lei,7,0,15,8
1668518414510,MATH 243,A00,098034,Jekel; David Andrew,10,0,10,0
1668518414937,MATH 245A,A00,098035,Nie; Jiawang,0,4,15,18
1668518415364,MATH 248,A00,098036,Bejenaru; Ioan,10,0,10,0
1668518415788,MATH 250B,A00,098037,Spolaor; Luca,14,0,15,1
1668518416213,MATH 258,A00,098038,Ni; Lei,9,0,10,1
1668518416639,MATH 264B,A00,098041,Rhoades; Brendon Patrick,8,0,15,7
1668518417064,MATH 268,A00,098042,Buss; Samuel R,10,0,10,0
1668518417492,MATH 269,A00,098043,Rhoades; Brendon Patrick,10,0,10,0
1668518417926,MATH 270B,A00,098044,Li; Bo,6,0,15,9
1668518418349,MATH 272B,A00,098045,Holst; Michael J,13,0,15,2
1668518418774,MATH 273A,A00,098046,Tian; Xiaochuan,10,0,15,5
1668518419198,MATH 275,A01,098048,Tian; Xiaochuan,6,0,10,4
1668518419624,MATH 278A,A00,098049,Holst; Michael J,7,0,10,3
1668518420052,MATH 278B,A00,098050,Cloninger; Alexander,10,0,10,0
1668518420476,MATH 278C,A00,098051,Nie; Jiawang,5,0,10,5
1668518420898,MATH 280B,A00,098052,Zheng; Tianyi,7,0,15,8
1668518421322,MATH 281B,A00,098053,Bradic; Jelena,0,2,15,15
1668518421749,MATH 282B,A00,098054,Arias-Castro; Ery,0,1,15,15
1668518422176,MATH 285,A00,098055,Fitzsimmons; Patrick J,0,3,15,17
1668518422608,MATH 287B,A00,098056,Arias-Castro; Ery,1,0,15,14
1668518423035,MATH 288,A00,098057,Agarwal; Pooja,9,0,10,1
1668518423035,MATH 288,B00,098058,Zhang; Danna,8,0,10,2
1668518423035,MATH 288,C00,098059,Williams; Ruth J,9,0,10,1
1668518423463,MATH 290B,A00,098060,Roberts; Justin Deritter,12,0,15,3
1668518423895,MATH 292,A00,098061,Belmont; Eva Kinoshita,10,0,10,0
1668518424323,MATH 295,A00,098062,Suk; Andrew Hoon,47,0,50,3
1668518424749,MATH 296,A00,098063,Novak; Jonathan I,20,0,20,0
1668518425177,MATH 297,001,098064,Gamst; Anthony Collins,9997,0,9999,2
1668518925959,COGS 205,A00,101395,Chiba; Andrea,19,0,20,1
1668518926382,COGS 210B,001,101404,Greene; Deanna Jacquelyn,9998,0,9999,1
1668518926382,COGS 210B,002,101417,Xia; Haijun,9999,0,9999,0
1668518926382,COGS 210B,003,101422,Nitz; Douglas A.,9999,0,9999,0
1668518926382,COGS 210B,004,101423,Hollan; James D.,9998,0,9999,1
1668518926382,COGS 210B,005,101424,Deak; Gedeon O.,9998,0,9999,1
1668518926382,COGS 210B,006,101425,Rossano; Federico,9999,0,9999,0
1668518926806,COGS 211B,A00,101427,Coulson; Seana M,9996,0,9999,3
1668518927234,COGS 220,A00,101428,Hollan; James D.,0,10,25,25
1668518927658,COGS 229,A00,101429,Dow; Steven P,17,0,25,8
1668518928081,COGS 230,A00,101430,Klemmer; Scott R,7,0,17,10
1668518928507,COGS 234,A00,101431,Xia; Haijun,1,0,25,24
1668518928934,COGS 260,A00,101432,Kiyonaga; Anastasia,21,0,25,4
1668518928934,COGS 260,B00,101433,Kirsh; David Joel,15,0,25,10
1668518929358,CSE 202,A00,102371,Impagliazzo; Russell,0,66,0,0
1668518929783,CSE 203B,A01,102373,Cheng; Chung Kuan,0,58,0,0
1668518930206,CSE 208,A00,102374,Micciancio; Daniele,0,5,0,0
1668518930629,CSE 209A,A00,112895,Impagliazzo; Russell,0,12,15,15
1668518931059,CSE 209B,A00,108005,Bellare; Mihir,0,7,0,0
1668518931492,CSE 210,A00,113163,Coblenz; Michael J,0,85,0,0
1668518931915,CSE 219,A00,106111,Dow; Steven P,0,6,20,20
1668518932339,CSE 221,A00,102376,Voelker; Geoffrey M.,0,73,0,0
1668518932764,CSE 224,A01,102378,Porter; George M,0,166,0,0
1668518933189,CSE 229A,A00,102379,Savage; Stefan,0,10,0,0
1668518933617,CSE 229C,A00,102380,Munyaka; Imani N. S.,0,10,0,0
1668518934043,CSE 232B,A00,102382,Deutsch; Alin Bernard,0,32,0,0
1668518934468,CSE 234,A01,112904,Kumar; Arun Kumar,0,0,0,0
1668518934892,CSE 237A,A00,102383,Rosing; Tajana Simunic,0,55,0,0
1668518935319,CSE 239A,A00,102384,Deutsch; Alin Bernard,0,14,0,0
1668518935746,CSE 239B,A00,102385,Polikarpova; Nadezhda,0,10,0,0
1668518936170,CSE 240A,A00,102386,Pannuto; Patrick William,0,46,0,0
1668518936595,CSE 240B,A00,102387,Zhao; Jishen,0,47,0,0
1668518937019,CSE 241A,A00,106406,Kang; Mingu,0,9,0,0
1668518937443,CSE 249B,A00,102388,Kahng; Andrew Byun,0,5,8,8
1668518937872,CSE 251B,A01,102392,Cottrell; Garrison W,0,51,0,0
1668518937872,CSE 251B,A02,102393,Cottrell; Garrison W,0,34,0,0
1668518938296,CSE 252B,A00,102394,Ochoa; Benjamin Lawrence,0,59,0,0
1668518938724,CSE 257,A01,102396,Gao; Sicun,0,139,0,0
1668518939149,CSE 272,A00,102397,Li; Tzumao,0,19,0,0
1668518939574,CSE 274,A00,111323,Chern; Albert Ren-Haur,0,15,0,0
1668518939996,CSE 282,A00,102398,Pevzner; Pavel Arkadjevich,0,0,0,0
1668518940420,CSE 284,A00,114175,Gymrek; Melissa Ann,0,22,0,0
1668518940845,CSE 290,A00,102399,Chandraker; Manmohan Krishna,0,11,0,0
1668518940845,CSE 290,B00,102400,Vaccaro; Kristen Marie,0,7,25,25
1668518940845,CSE 290,C00,102414,Pannuto; Patrick William,0,1,25,25
1668518940845,CSE 290,D00,102427,Pevzner; Pavel Arkadjevich,0,0,0,0
1668518940845,CSE 290,E00,102429,Zhao; Jishen,0,4,0,0
1668518940845,CSE 290,F00,102436,Tullsen; Dean Michael,0,5,0,0
1668518940845,CSE 290,G00,102440,Christensen; Henrik I,0,6,20,20
1668518941271,CSE 291,A00,102443,Su; Hao,0,0,0,0
1668518941271,CSE 291,B00,102448,Polikarpova; Nadezhda,0,0,0,0
1668518941271,CSE 291,C00,102453,Vaccaro; Kristen Marie,0,0,0,0
1668518941271,CSE 291,D00,111343,Savage; Stefan,0,0,0,0
1668518941271,CSE 291,E00,116474,Claffy; Kimberly Claire,0,0,0,0
1668518941271,CSE 291,F00,116479,Pasquale; Joseph,0,0,0,0
1668518941706,CSE 293,001,119111,Bafna; Vineet,9999,0,9999,0
1668518941706,CSE 293,002,119118,Bellare; Mihir,9999,0,9999,0
1668518941706,CSE 293,003,119122,Berg-Kirkpatrick; Taylor D,9999,0,9999,0
1668518941706,CSE 293,004,119135,Christensen; Henrik I,9999,0,9999,0
1668518941706,CSE 293,005,119142,Cottrell; Garrison W,9999,0,9999,0
1668518941706,CSE 293,006,119146,Deutsch; Alin Bernard,9999,0,9999,0
1668518941706,CSE 293,007,119159,Esmaeilzadeh; Hadi,9999,0,9999,0
1668518941706,CSE 293,008,119166,Freund; Yoav,9999,0,9999,0
1668518941706,CSE 293,009,119170,Griswold; William G.,9999,0,9999,0
1668518941706,CSE 293,010,119183,Gymrek; Melissa Ann,9999,0,9999,0
1668518941706,CSE 293,011,119190,Heninger; Nadia A,9999,0,9999,0
1668518941706,CSE 293,012,119230,Impagliazzo; Russell,9999,0,9999,0
1668518941706,CSE 293,013,119232,Jhala; Ranjit,9999,0,9999,0
1668518941706,CSE 293,014,119233,Kahng; Andrew Byun,9999,0,9999,0
1668518941706,CSE 293,015,119298,Kane; Daniel Mertz,9999,0,9999,0
1668518941706,CSE 293,016,119299,Kriegman; David J,9999,0,9999,0
1668518941706,CSE 293,017,119300,Kumar; Arun Kumar,9999,0,9999,0
1668518941706,CSE 293,018,119301,Lerner; Sorin,9999,0,9999,0
1668518941706,CSE 293,019,119302,Lovett; Shachar,9999,0,9999,0
1668518941706,CSE 293,020,119303,McAuley; Julian John,9999,0,9999,0
1668518941706,CSE 293,021,119304,Micciancio; Daniele,9999,0,9999,0
1668518941706,CSE 293,022,119367,Orailoglu; Alex,9999,0,9999,0
1668518941706,CSE 293,023,119382,Paturi; Ramamohan,9999,0,9999,0
1668518941706,CSE 293,024,119404,Polikarpova; Nadezhda,9999,0,9999,0
1668518941706,CSE 293,025,119406,Politz; Joseph Gibbs,9999,0,9999,0
1668518941706,CSE 293,026,119411,Porter; George M,9999,0,9999,0
1668518941706,CSE 293,027,119414,Porter; Leonard Emerson,9999,0,9999,0
1668518941706,CSE 293,028,119416,Ramamoorthi; Ravi,9999,0,9999,0
1668518941706,CSE 293,029,119417,Sahoo; Debashis,9999,0,9999,0
1668518941706,CSE 293,030,119420,Saul; Lawrence,9999,0,9999,0
1668518941706,CSE 293,031,119421,Savage; Stefan,9999,0,9999,0
1668518941706,CSE 293,032,119425,Schulze; Jurgen P.,9999,0,9999,0
1668518941706,CSE 293,033,119426,Snoeren; Alex C.,9999,0,9999,0
1668518941706,CSE 293,034,119428,Shang; Jingbo,9999,0,9999,0
1668518941706,CSE 293,035,119430,Stefan; Deian,9999,0,9999,0
1668518941706,CSE 293,036,119431,Su; Hao,9999,0,9999,0
1668518941706,CSE 293,037,119433,Swanson; Steven James,9999,0,9999,0
1668518941706,CSE 293,038,119435,Tullsen; Dean Michael,9999,0,9999,0
1668518941706,CSE 293,039,119483,Voelker; Geoffrey M.,9999,0,9999,0
1668518941706,CSE 293,040,119537,Zhao; Jishen,9999,0,9999,0
1668518941706,CSE 293,041,119538,Zhou; Yuan-Yuan,9999,0,9999,0
1668518941706,CSE 293,042,119539,Gao; Sicun,9999,0,9999,0
1668518941706,CSE 293,043,119540,Weibel; Nadir,9999,0,9999,0
1668518941706,CSE 293,044,119541,Gupta; Rajesh K.,9999,0,9999,0
1668518941706,CSE 293,045,126410,Vaccaro; Kristen Marie,9999,0,9999,0
1668518941706,CSE 293,046,126411,Klemke; Richard,9999,0,9999,0
1668518942130,CSE 294,A00,102459,Voelker; Geoffrey M.,0,2,0,0
1668518942130,CSE 294,B00,111322,Orailoglu; Alex,0,2,0,0
1668518942553,DSE 201,A00,096914,Deutsch; Alin Bernard,30,0,30,0
1668518942975,DSE 210,A00,096915,Dasgupta; Sanjoy,30,0,30,0
1668518943403,DSE 260A,A00,096916,Altintas De Callaf; Ilkay,30,0,30,0
1668518943844,ECE 200,001,103586,Antipa; Nicholas A,9999,0,9999,0
1668518943844,ECE 200,002,103587,Atanasov; Nikolay A.,9999,0,9999,0
1668518943844,ECE 200,003,103588,Bharadia; Dinesh,9999,0,9999,0
1668518943844,ECE 200,004,103589,Cheng; Chung Kuan,9999,0,9999,0
1668518943844,ECE 200,005,103590,Cosman; Pamela C.,9999,0,9999,0
1668518943844,ECE 200,006,103591,Dayeh; Shadi Ahmad,9999,0,9999,0
1668518943844,ECE 200,007,103592,Fainman; Yeshaiahu,9999,0,9999,0
1668518943844,ECE 200,008,103593,Ford; Joseph Earl,9999,0,9999,0
1668518943844,ECE 200,009,103594,Franceschetti; Massimo,9999,0,9999,0
1668518943844,ECE 200,010,103595,Fullerton; Eric E,9999,0,9999,0
1668518943844,ECE 200,011,103596,Galton; Ian A,9999,0,9999,0
1668518943844,ECE 200,012,103597,Gilja; Vikash,9999,0,9999,0
1668518943844,ECE 200,013,103598,Hall; Drew A.,9999,0,9999,0
1668518943844,ECE 200,014,103599,Hsueh; Tzu-Chien,9999,0,9999,0
1668518943844,ECE 200,015,103600,Javidi; Tara,9999,0,9999,0
1668518943844,ECE 200,016,103601,Kahng; Andrew Byun,9999,0,9999,0
1668518943844,ECE 200,017,103602,Kim; Young-Han,9999,0,9999,0
1668518943844,ECE 200,018,103603,Koushanfar; Farinaz,9999,0,9999,0
1668518943844,ECE 200,019,103604,Kuzum; Duygu,9999,0,9999,0
1668518943844,ECE 200,020,103605,Le; Hanh-Phuc,9999,0,9999,0
1668518943844,ECE 200,021,103606,Lin; Bill,9999,0,9999,0
1668518943844,ECE 200,022,103607,Liu; Zhaowei,9998,0,9999,1
1668518943844,ECE 200,023,103608,Lo; Yu-Hwa,9999,0,9999,0
1668518943844,ECE 200,024,103609,Lomakin; Vitaliy,9999,0,9999,0
1668518943844,ECE 200,025,103610,Mercier; Patrick Philip,9999,0,9999,0
1668518943844,ECE 200,026,103611,Meyer; Florian,9999,0,9999,0
1668518943844,ECE 200,027,103612,Milstein; Laurence B.,9999,0,9999,0
1668518943844,ECE 200,028,103613,Mir Arabbaygi; Siavash,9999,0,9999,0
1668518943844,ECE 200,029,103614,Mookherjea; Shayan,9999,0,9999,0
1668518943844,ECE 200,030,103615,Morris; Karcher William,9999,0,9999,0
1668518943844,ECE 200,031,103616,Ng; Tse Nga,9999,0,9999,0
1668518943844,ECE 200,032,103617,Nguyen; Truong Quang,9999,0,9999,0
1668518943844,ECE 200,033,103618,Nomura; Kenji,9999,0,9999,0
1668518943844,ECE 200,034,103619,Orlitsky; Alon,9999,0,9999,0
1668518943844,ECE 200,035,103620,Pal; Piya,9999,0,9999,0
1668518943844,ECE 200,036,103621,Papen; George C.,9999,0,9999,0
1668518943844,ECE 200,037,103622,Radic; Stojan,9999,0,9999,0
1668518943844,ECE 200,038,103623,Rao; Bhaskar D.,9999,0,9999,0
1668518943844,ECE 200,039,103624,Rao; Ramesh R,9999,0,9999,0
1668518943844,ECE 200,040,103625,Rebeiz; Gabriel,9999,0,9999,0
1668518943844,ECE 200,041,103626,Sanford; John R,9999,0,9999,0
1668518943844,ECE 200,042,103627,Siegel; Paul H.,9999,0,9999,0
1668518943844,ECE 200,043,103628,Sievenpiper; Daniel F.,9999,0,9999,0
1668518943844,ECE 200,044,103629,Sworder; David D.,9999,0,9999,0
1668518943844,ECE 200,045,103630,Taur; Yuan,9999,0,9999,0
1668518943844,ECE 200,046,103631,Touri; Behrouz,9999,0,9999,0
1668518943844,ECE 200,047,103632,Trivedi; Mohan M.,9999,0,9999,0
1668518943844,ECE 200,048,103633,Vasconcelos; Nuno,9999,0,9999,0
1668518943844,ECE 200,049,103634,Wang; Xiaolong,9999,0,9999,0
1668518943844,ECE 200,050,103635,Xie; Pengtao,9999,0,9999,0
1668518943844,ECE 200,051,103636,Yip; Michael,9999,0,9999,0
1668518943844,ECE 200,052,103637,Zeger; Kenneth A.,999,0,999,0
1668518943844,ECE 200,053,103638,Zhang; Xinyu,9999,0,9999,0
1668518943844,ECE 200,054,103639,Turakhia; Yatish Girish,9999,0,9999,0
1668518943844,ECE 200,055,103640,Kang; Mingu,9999,0,9999,0
1668518943844,ECE 200,056,103641,Shi; Yuanyuan,9999,0,9999,0
1668518943844,ECE 200,057,103642,Wang; Edward Jay,9999,0,9999,0
1668518943844,ECE 200,058,103643,Zheng; Yang,9999,0,9999,0
1668518944267,ECE 202,A00,103644,Kuzum; Duygu,0,44,0,0
1668518944701,ECE 212BN,A00,103646,Ng; Tse Nga,0,9,0,0
1668518945124,ECE 221,A00,111493,Staff,0,0,0,0
1668518945556,ECE 222B,A00,103647,Lomakin; Vitaliy,0,20,0,0
1668518945978,ECE 230B,A00,103648,Taur; Yuan,0,3,0,0
1668518946405,ECE 238B,A00,103649,Garay; Javier,0,0,0,0
1668518946832,ECE 240B,A00,112900,Fainman; Yeshaiahu,0,7,0,0
1668518947255,ECE 247A,A00,103650,Jokerst; Jesse Vincent,0,6,0,0
1668518947680,ECE 247B,A00,103651,Wang; Joseph,0,14,0,0
1668518948103,ECE 250,A00,103652,Siegel; Paul H.,0,82,0,0
1668518948530,ECE 251A,A00,103654,Rao; Bhaskar D.,0,62,0,0
1668518948961,ECE 257B,A00,103655,Bharadia; Dinesh,0,33,0,0
1668518949385,ECE 258A,A00,103656,Milstein; Laurence B.,0,29,0,0
1668518949922,ECE 260B,A00,103658,Kang; Mingu,0,119,0,0
1668518950352,ECE 264A,A00,103659,Galton; Ian A,0,66,0,0
1668518950779,ECE 265A,A00,103661,Gudem; Prasad S.S.,0,70,0,0
1668518951203,ECE 265D,A00,103662,Gudem; Prasad S.S.,0,26,0,0
1668518951628,ECE 268,A00,103663,Koushanfar; Farinaz,0,43,0,0
1668518952052,ECE 269,A01,103665,Pal; Piya,0,215,0,0
1668518952483,ECE 271B,A00,103666,Vasconcelos; Manuela,0,76,0,0
1668518952908,ECE 276A,A00,103667,Atanasov; Nikolay A.,0,126,0,0
1668518953335,ECE 277,A00,103668,An; Cheolhong,0,149,0,0
1668518953759,ECE 279,A00,117947,Hall; Drew A.,0,22,0,0
1668518954607,ECE 283,A00,103670,Hsueh; Tzu-Chien,0,53,0,0
1668518955033,ECE 284,A00,103671,Turakhia; Yatish Girish,0,39,0,0
1668518955458,ECE 285,A00,103672,Zheng; Yang,0,39,0,0
1668518955458,ECE 285,B00,103673,Sworder; David D.,0,57,0,0
1668518955884,ECE 287,A00,103676,Javidi; Tara,0,9,0,0
1668518956312,MATH 200B,A00,098023,Salehi Golsefidy; Alireza,10,0,15,5
1668518956739,MATH 202B,A00,098024,Rhoades; Brendon Patrick,7,0,15,8
1668518957163,MATH 203B,A00,098025,Oprea; Dragos N.,9,0,15,6
1668518957594,MATH 204B,A00,098026,Sorensen; Claus M,13,0,15,2
1668518958019,MATH 208,A00,098027,Izadi; Elham,7,0,10,3
1668518958444,MATH 209,A00,098028,Pollack; Aaron,10,0,10,0
1668518958870,MATH 211A,A00,112919,Rogalski; Daniel,8,0,10,2
1668518959294,MATH 211B,A00,112920,Seward; Brandon M.,9,0,10,1
1668518959721,MATH 218,A00,098029,Li; Bo,10,0,10,0
1668518960148,MATH 220B,A00,098030,Novak; Jonathan I,11,0,15,4
1668518960572,MATH 221A,A00,098031,Ebenfelt; Peter F,12,0,15,3
1668518960998,MATH 231B,A00,098032,Zlatos; Andrej,11,0,15,4
1668518961424,MATH 240B,A00,098033,Ni; Lei,7,0,15,8
1668518961852,MATH 243,A00,098034,Jekel; David Andrew,10,0,10,0
1668518962280,MATH 245A,A00,098035,Nie; Jiawang,0,4,15,18
1668518962707,MATH 248,A00,098036,Bejenaru; Ioan,10,0,10,0
1668518963130,MATH 250B,A00,098037,Spolaor; Luca,14,0,15,1
1668518963562,MATH 258,A00,098038,Ni; Lei,9,0,10,1
1668518963986,MATH 264B,A00,098041,Rhoades; Brendon Patrick,8,0,15,7
1668518964409,MATH 268,A00,098042,Buss; Samuel R,10,0,10,0
1668518964832,MATH 269,A00,098043,Rhoades; Brendon Patrick,10,0,10,0
1668518965257,MATH 270B,A00,098044,Li; Bo,6,0,15,9
1668518965681,MATH 272B,A00,098045,Holst; Michael J,13,0,15,2
1668518966106,MATH 273A,A00,098046,Tian; Xiaochuan,10,0,15,5
1668518966534,MATH 275,A01,098048,Tian; Xiaochuan,6,0,10,4
1668518966957,MATH 278A,A00,098049,Holst; Michael J,7,0,10,3
1668518967383,MATH 278B,A00,098050,Cloninger; Alexander,10,0,10,0
1668518967810,MATH 278C,A00,098051,Nie; Jiawang,5,0,10,5
1668518968235,MATH 280B,A00,098052,Zheng; Tianyi,7,0,15,8
1668518968659,MATH 281B,A00,098053,Bradic; Jelena,0,2,15,15
1668518969086,MATH 282B,A00,098054,Arias-Castro; Ery,0,1,15,15
1668518969513,MATH 285,A00,098055,Fitzsimmons; Patrick J,0,3,15,17
1668518969940,MATH 287B,A00,098056,Arias-Castro; Ery,1,0,15,14
1668518970367,MATH 288,A00,098057,Agarwal; Pooja,9,0,10,1
1668518970367,MATH 288,B00,098058,Zhang; Danna,8,0,10,2
1668518970367,MATH 288,C00,098059,Williams; Ruth J,9,0,10,1
1668518970792,MATH 290B,A00,098060,Roberts; Justin Deritter,12,0,15,3
1668518971217,MATH 292,A00,098061,Belmont; Eva Kinoshita,10,0,10,0
1668518971640,MATH 295,A00,098062,Suk; Andrew Hoon,47,0,50,3
1668518972067,MATH 296,A00,098063,Novak; Jonathan I,20,0,20,0
1668518972491,MATH 297,001,098064,Gamst; Anthony Collins,9997,0,9999,2
1668519473895,COGS 205,A00,101395,Chiba; Andrea,19,0,20,1
1668519474323,COGS 210B,001,101404,Greene; Deanna Jacquelyn,9998,0,9999,1
1668519474323,COGS 210B,002,101417,Xia; Haijun,9999,0,9999,0
1668519474323,COGS 210B,003,101422,Nitz; Douglas A.,9999,0,9999,0
1668519474323,COGS 210B,004,101423,Hollan; James D.,9998,0,9999,1
1668519474323,COGS 210B,005,101424,Deak; Gedeon O.,9998,0,9999,1
1668519474323,COGS 210B,006,101425,Rossano; Federico,9999,0,9999,0
1668519474749,COGS 211B,A00,101427,Coulson; Seana M,9996,0,9999,3
1668519475172,COGS 220,A00,101428,Hollan; James D.,0,10,25,25
1668519475595,COGS 229,A00,101429,Dow; Steven P,17,0,25,8
1668519476019,COGS 230,A00,101430,Klemmer; Scott R,7,0,17,10
1668519476442,COGS 234,A00,101431,Xia; Haijun,1,0,25,24
1668519476880,COGS 260,A00,101432,Kiyonaga; Anastasia,21,0,25,4
1668519476880,COGS 260,B00,101433,Kirsh; David Joel,15,0,25,10
1668519477306,CSE 202,A00,102371,Impagliazzo; Russell,0,66,0,0
1668519477733,CSE 203B,A01,102373,Cheng; Chung Kuan,0,58,0,0
1668519478161,CSE 208,A00,102374,Micciancio; Daniele,0,5,0,0
1668519478590,CSE 209A,A00,112895,Impagliazzo; Russell,0,12,15,15
1668519479012,CSE 209B,A00,108005,Bellare; Mihir,0,7,0,0
1668519479440,CSE 210,A00,113163,Coblenz; Michael J,0,85,0,0
1668519479865,CSE 219,A00,106111,Dow; Steven P,0,6,20,20
1668519480298,CSE 221,A00,102376,Voelker; Geoffrey M.,0,73,0,0
1668519480723,CSE 224,A01,102378,Porter; George M,0,166,0,0
1668519481149,CSE 229A,A00,102379,Savage; Stefan,0,10,0,0
1668519481576,CSE 229C,A00,102380,Munyaka; Imani N. S.,0,10,0,0
1668519481999,CSE 232B,A00,102382,Deutsch; Alin Bernard,0,32,0,0
1668519482423,CSE 234,A01,112904,Kumar; Arun Kumar,0,0,0,0
1668519482848,CSE 237A,A00,102383,Rosing; Tajana Simunic,0,55,0,0
1668519483274,CSE 239A,A00,102384,Deutsch; Alin Bernard,0,14,0,0
1668519483700,CSE 239B,A00,102385,Polikarpova; Nadezhda,0,10,0,0
1668519484129,CSE 240A,A00,102386,Pannuto; Patrick William,0,46,0,0
1668519484553,CSE 240B,A00,102387,Zhao; Jishen,0,47,0,0
1668519484978,CSE 241A,A00,106406,Kang; Mingu,0,9,0,0
1668519485403,CSE 249B,A00,102388,Kahng; Andrew Byun,0,5,8,8
1668519485833,CSE 251B,A01,102392,Cottrell; Garrison W,0,51,0,0
1668519485833,CSE 251B,A02,102393,Cottrell; Garrison W,0,34,0,0
1668519486257,CSE 252B,A00,102394,Ochoa; Benjamin Lawrence,0,59,0,0
1668519486693,CSE 257,A01,102396,Gao; Sicun,0,139,0,0
1668519487117,CSE 272,A00,102397,Li; Tzumao,0,19,0,0
1668519487541,CSE 274,A00,111323,Chern; Albert Ren-Haur,0,15,0,0
1668519487972,CSE 282,A00,102398,Pevzner; Pavel Arkadjevich,0,0,0,0
1668519488398,CSE 284,A00,114175,Gymrek; Melissa Ann,0,22,0,0
1668519488834,CSE 290,A00,102399,Chandraker; Manmohan Krishna,0,11,0,0
1668519488834,CSE 290,B00,102400,Vaccaro; Kristen Marie,0,7,25,25
1668519488834,CSE 290,C00,102414,Pannuto; Patrick William,0,1,25,25
1668519488834,CSE 290,D00,102427,Pevzner; Pavel Arkadjevich,0,0,0,0
1668519488834,CSE 290,E00,102429,Zhao; Jishen,0,4,0,0
1668519488834,CSE 290,F00,102436,Tullsen; Dean Michael,0,5,0,0
1668519488834,CSE 290,G00,102440,Christensen; Henrik I,0,6,20,20
1668519489266,CSE 291,A00,102443,Su; Hao,0,0,0,0
1668519489266,CSE 291,B00,102448,Polikarpova; Nadezhda,0,0,0,0
1668519489266,CSE 291,C00,102453,Vaccaro; Kristen Marie,0,0,0,0
1668519489266,CSE 291,D00,111343,Savage; Stefan,0,0,0,0
1668519489266,CSE 291,E00,116474,Claffy; Kimberly Claire,0,0,0,0
1668519489266,CSE 291,F00,116479,Pasquale; Joseph,0,0,0,0
1668519489699,CSE 293,001,119111,Bafna; Vineet,9999,0,9999,0
1668519489699,CSE 293,002,119118,Bellare; Mihir,9999,0,9999,0
1668519489699,CSE 293,003,119122,Berg-Kirkpatrick; Taylor D,9999,0,9999,0
1668519489699,CSE 293,004,119135,Christensen; Henrik I,9999,0,9999,0
1668519489699,CSE 293,005,119142,Cottrell; Garrison W,9999,0,9999,0
1668519489699,CSE 293,006,119146,Deutsch; Alin Bernard,9999,0,9999,0
1668519489699,CSE 293,007,119159,Esmaeilzadeh; Hadi,9999,0,9999,0
1668519489699,CSE 293,008,119166,Freund; Yoav,9999,0,9999,0
1668519489699,CSE 293,009,119170,Griswold; William G.,9999,0,9999,0
1668519489699,CSE 293,010,119183,Gymrek; Melissa Ann,9999,0,9999,0
1668519489699,CSE 293,011,119190,Heninger; Nadia A,9999,0,9999,0
1668519489699,CSE 293,012,119230,Impagliazzo; Russell,9999,0,9999,0
1668519489699,CSE 293,013,119232,Jhala; Ranjit,9999,0,9999,0
1668519489699,CSE 293,014,119233,Kahng; Andrew Byun,9999,0,9999,0
1668519489699,CSE 293,015,119298,Kane; Daniel Mertz,9999,0,9999,0
1668519489699,CSE 293,016,119299,Kriegman; David J,9999,0,9999,0
1668519489699,CSE 293,017,119300,Kumar; Arun Kumar,9999,0,9999,0
1668519489699,CSE 293,018,119301,Lerner; Sorin,9999,0,9999,0
1668519489699,CSE 293,019,119302,Lovett; Shachar,9999,0,9999,0
1668519489699,CSE 293,020,119303,McAuley; Julian John,9999,0,9999,0
1668519489699,CSE 293,021,119304,Micciancio; Daniele,9999,0,9999,0
1668519489699,CSE 293,022,119367,Orailoglu; Alex,9999,0,9999,0
1668519489699,CSE 293,023,119382,Paturi; Ramamohan,9999,0,9999,0
1668519489699,CSE 293,024,119404,Polikarpova; Nadezhda,9999,0,9999,0
1668519489699,CSE 293,025,119406,Politz; Joseph Gibbs,9999,0,9999,0
1668519489699,CSE 293,026,119411,Porter; George M,9999,0,9999,0
1668519489699,CSE 293,027,119414,Porter; Leonard Emerson,9999,0,9999,0
1668519489699,CSE 293,028,119416,Ramamoorthi; Ravi,9999,0,9999,0
1668519489699,CSE 293,029,119417,Sahoo; Debashis,9999,0,9999,0
1668519489699,CSE 293,030,119420,Saul; Lawrence,9999,0,9999,0
1668519489699,CSE 293,031,119421,Savage; Stefan,9999,0,9999,0
1668519489699,CSE 293,032,119425,Schulze; Jurgen P.,9999,0,9999,0
1668519489699,CSE 293,033,119426,Snoeren; Alex C.,9999,0,9999,0
1668519489699,CSE 293,034,119428,Shang; Jingbo,9999,0,9999,0
1668519489699,CSE 293,035,119430,Stefan; Deian,9999,0,9999,0
1668519489699,CSE 293,036,119431,Su; Hao,9999,0,9999,0
1668519489699,CSE 293,037,119433,Swanson; Steven James,9999,0,9999,0
1668519489699,CSE 293,038,119435,Tullsen; Dean Michael,9999,0,9999,0
1668519489699,CSE 293,039,119483,Voelker; Geoffrey M.,9999,0,9999,0
1668519489699,CSE 293,040,119537,Zhao; Jishen,9999,0,9999,0
1668519489699,CSE 293,041,119538,Zhou; Yuan-Yuan,9999,0,9999,0
1668519489699,CSE 293,042,119539,Gao; Sicun,9999,0,9999,0
1668519489699,CSE 293,043,119540,Weibel; Nadir,9999,0,9999,0
1668519489699,CSE 293,044,119541,Gupta; Rajesh K.,9999,0,9999,0
1668519489699,CSE 293,045,126410,Vaccaro; Kristen Marie,9999,0,9999,0
1668519489699,CSE 293,046,126411,Klemke; Richard,9999,0,9999,0
1668519490125,CSE 294,A00,102459,Voelker; Geoffrey M.,0,2,0,0
1668519490125,CSE 294,B00,111322,Orailoglu; Alex,0,2,0,0
1668519490552,DSE 201,A00,096914,Deutsch; Alin Bernard,30,0,30,0
1668519490977,DSE 210,A00,096915,Dasgupta; Sanjoy,30,0,30,0
1668519491403,DSE 260A,A00,096916,Altintas De Callaf; Ilkay,30,0,30,0
1668519491828,ECE 200,001,103586,Antipa; Nicholas A,9999,0,9999,0
1668519491828,ECE 200,002,103587,Atanasov; Nikolay A.,9999,0,9999,0
1668519491828,ECE 200,003,103588,Bharadia; Dinesh,9999,0,9999,0
1668519491828,ECE 200,004,103589,Cheng; Chung Kuan,9999,0,9999,0
1668519491828,ECE 200,005,103590,Cosman; Pamela C.,9999,0,9999,0
1668519491828,ECE 200,006,103591,Dayeh; Shadi Ahmad,9999,0,9999,0
1668519491828,ECE 200,007,103592,Fainman; Yeshaiahu,9999,0,9999,0
1668519491828,ECE 200,008,103593,Ford; Joseph Earl,9999,0,9999,0
1668519491828,ECE 200,009,103594,Franceschetti; Massimo,9999,0,9999,0
1668519491828,ECE 200,010,103595,Fullerton; Eric E,9999,0,9999,0
1668519491828,ECE 200,011,103596,Galton; Ian A,9999,0,9999,0
1668519491828,ECE 200,012,103597,Gilja; Vikash,9999,0,9999,0
1668519491828,ECE 200,013,103598,Hall; Drew A.,9999,0,9999,0
1668519491828,ECE 200,014,103599,Hsueh; Tzu-Chien,9999,0,9999,0
1668519491828,ECE 200,015,103600,Javidi; Tara,9999,0,9999,0
1668519491828,ECE 200,016,103601,Kahng; Andrew Byun,9999,0,9999,0
1668519491828,ECE 200,017,103602,Kim; Young-Han,9999,0,9999,0
1668519491828,ECE 200,018,103603,Koushanfar; Farinaz,9999,0,9999,0
1668519491828,ECE 200,019,103604,Kuzum; Duygu,9999,0,9999,0
1668519491828,ECE 200,020,103605,Le; Hanh-Phuc,9999,0,9999,0
1668519491828,ECE 200,021,103606,Lin; Bill,9999,0,9999,0
1668519491828,ECE 200,022,103607,Liu; Zhaowei,9998,0,9999,1
1668519491828,ECE 200,023,103608,Lo; Yu-Hwa,9999,0,9999,0
1668519491828,ECE 200,024,103609,Lomakin; Vitaliy,9999,0,9999,0
1668519491828,ECE 200,025,103610,Mercier; Patrick Philip,9999,0,9999,0
1668519491828,ECE 200,026,103611,Meyer; Florian,9999,0,9999,0
1668519491828,ECE 200,027,103612,Milstein; Laurence B.,9999,0,9999,0
1668519491828,ECE 200,028,103613,Mir Arabbaygi; Siavash,9999,0,9999,0
1668519491828,ECE 200,029,103614,Mookherjea; Shayan,9999,0,9999,0
1668519491828,ECE 200,030,103615,Morris; Karcher William,9999,0,9999,0
1668519491828,ECE 200,031,103616,Ng; Tse Nga,9999,0,9999,0
1668519491828,ECE 200,032,103617,Nguyen; Truong Quang,9999,0,9999,0
1668519491828,ECE 200,033,103618,Nomura; Kenji,9999,0,9999,0
1668519491828,ECE 200,034,103619,Orlitsky; Alon,9999,0,9999,0
1668519491828,ECE 200,035,103620,Pal; Piya,9999,0,9999,0
1668519491828,ECE 200,036,103621,Papen; George C.,9999,0,9999,0
1668519491828,ECE 200,037,103622,Radic; Stojan,9999,0,9999,0
1668519491828,ECE 200,038,103623,Rao; Bhaskar D.,9999,0,9999,0
1668519491828,ECE 200,039,103624,Rao; Ramesh R,9999,0,9999,0
1668519491828,ECE 200,040,103625,Rebeiz; Gabriel,9999,0,9999,0
1668519491828,ECE 200,041,103626,Sanford; John R,9999,0,9999,0
1668519491828,ECE 200,042,103627,Siegel; Paul H.,9999,0,9999,0
1668519491828,ECE 200,043,103628,Sievenpiper; Daniel F.,9999,0,9999,0
1668519491828,ECE 200,044,103629,Sworder; David D.,9999,0,9999,0
1668519491828,ECE 200,045,103630,Taur; Yuan,9999,0,9999,0
1668519491828,ECE 200,046,103631,Touri; Behrouz,9999,0,9999,0
1668519491828,ECE 200,047,103632,Trivedi; Mohan M.,9999,0,9999,0
1668519491828,ECE 200,048,103633,Vasconcelos; Nuno,9999,0,9999,0
1668519491828,ECE 200,049,103634,Wang; Xiaolong,9999,0,9999,0
1668519491828,ECE 200,050,103635,Xie; Pengtao,9999,0,9999,0
1668519491828,ECE 200,051,103636,Yip; Michael,9999,0,9999,0
1668519491828,ECE 200,052,103637,Zeger; Kenneth A.,999,0,999,0
1668519491828,ECE 200,053,103638,Zhang; Xinyu,9999,0,9999,0
1668519491828,ECE 200,054,103639,Turakhia; Yatish Girish,9999,0,9999,0
1668519491828,ECE 200,055,103640,Kang; Mingu,9999,0,9999,0
1668519491828,ECE 200,056,103641,Shi; Yuanyuan,9999,0,9999,0
1668519491828,ECE 200,057,103642,Wang; Edward Jay,9999,0,9999,0
1668519491828,ECE 200,058,103643,Zheng; Yang,9999,0,9999,0
1668519492254,ECE 202,A00,103644,Kuzum; Duygu,0,44,0,0
1668519492681,ECE 212BN,A00,103646,Ng; Tse Nga,0,9,0,0
1668519493111,ECE 221,A00,111493,Staff,0,0,0,0
1668519493534,ECE 222B,A00,103647,Lomakin; Vitaliy,0,20,0,0
1668519493964,ECE 230B,A00,103648,Taur; Yuan,0,3,0,0
1668519494389,ECE 238B,A00,103649,Garay; Javier,0,0,0,0
1668519494813,ECE 240B,A00,112900,Fainman; Yeshaiahu,0,7,0,0
1668519495239,ECE 247A,A00,103650,Jokerst; Jesse Vincent,0,6,0,0
1668519495665,ECE 247B,A00,103651,Wang; Joseph,0,14,0,0
1668519496090,ECE 250,A00,103652,Siegel; Paul H.,0,82,0,0
1668519496518,ECE 251A,A00,103654,Rao; Bhaskar D.,0,62,0,0
1668519496947,ECE 257B,A00,103655,Bharadia; Dinesh,0,33,0,0
1668519497374,ECE 258A,A00,103656,Milstein; Laurence B.,0,29,0,0
1668519497799,ECE 260B,A00,103658,Kang; Mingu,0,119,0,0
1668519498223,ECE 264A,A00,103659,Galton; Ian A,0,66,0,0
1668519498647,ECE 265A,A00,103661,Gudem; Prasad S.S.,0,70,0,0
1668519499072,ECE 265D,A00,103662,Gudem; Prasad S.S.,0,26,0,0
1668519499499,ECE 268,A00,103663,Koushanfar; Farinaz,0,43,0,0
1668519499927,ECE 269,A01,103665,Pal; Piya,0,215,0,0
1668519500357,ECE 271B,A00,103666,Vasconcelos; Manuela,0,76,0,0
1668519500779,ECE 276A,A00,103667,Atanasov; Nikolay A.,0,126,0,0
1668519501212,ECE 277,A00,103668,An; Cheolhong,0,149,0,0
1668519501643,ECE 279,A00,117947,Hall; Drew A.,0,22,0,0
1668519502491,ECE 283,A00,103670,Hsueh; Tzu-Chien,0,53,0,0
1668519502916,ECE 284,A00,103671,Turakhia; Yatish Girish,0,39,0,0
1668519503345,ECE 285,A00,103672,Zheng; Yang,0,39,0,0
1668519503345,ECE 285,B00,103673,Sworder; David D.,0,57,0,0
1668519503767,ECE 287,A00,103676,Javidi; Tara,0,9,0,0
1668519504191,MATH 200B,A00,098023,Salehi Golsefidy; Alireza,10,0,15,5
1668519504617,MATH 202B,A00,098024,Rhoades; Brendon Patrick,7,0,15,8
1668519505042,MATH 203B,A00,098025,Oprea; Dragos N.,9,0,15,6
1668519505466,MATH 204B,A00,098026,Sorensen; Claus M,13,0,15,2
1668519505900,MATH 208,A00,098027,Izadi; Elham,7,0,10,3
1668519506326,MATH 209,A00,098028,Pollack; Aaron,10,0,10,0
1668519506749,MATH 211A,A00,112919,Rogalski; Daniel,8,0,10,2
1668519507173,MATH 211B,A00,112920,Seward; Brandon M.,9,0,10,1
1668519507601,MATH 218,A00,098029,Li; Bo,10,0,10,0
1668519508031,MATH 220B,A00,098030,Novak; Jonathan I,11,0,15,4
1668519508463,MATH 221A,A00,098031,Ebenfelt; Peter F,12,0,15,3
1668519508890,MATH 231B,A00,098032,Zlatos; Andrej,11,0,15,4
1668519509318,MATH 240B,A00,098033,Ni; Lei,7,0,15,8
1668519509740,MATH 243,A00,098034,Jekel; David Andrew,10,0,10,0
1668519510163,MATH 245A,A00,098035,Nie; Jiawang,0,4,15,18
1668519510586,MATH 248,A00,098036,Bejenaru; Ioan,10,0,10,0
1668519511014,MATH 250B,A00,098037,Spolaor; Luca,14,0,15,1
1668519511439,MATH 258,A00,098038,Ni; Lei,9,0,10,1
1668519511864,MATH 264B,A00,098041,Rhoades; Brendon Patrick,8,0,15,7
1668519512302,MATH 268,A00,098042,Buss; Samuel R,10,0,10,0
1668519512729,MATH 269,A00,098043,Rhoades; Brendon Patrick,10,0,10,0
1668519513246,MATH 270B,A00,098044,Li; Bo,6,0,15,9
1668519513675,MATH 272B,A00,098045,Holst; Michael J,13,0,15,2
1668519514105,MATH 273A,A00,098046,Tian; Xiaochuan,10,0,15,5
1668519514533,MATH 275,A01,098048,Tian; Xiaochuan,6,0,10,4
1668519514957,MATH 278A,A00,098049,Holst; Michael J,7,0,10,3
1668519515390,MATH 278B,A00,098050,Cloninger; Alexander,10,0,10,0
1668519515812,MATH 278C,A00,098051,Nie; Jiawang,5,0,10,5
1668519516236,MATH 280B,A00,098052,Zheng; Tianyi,7,0,15,8
1668519516663,MATH 281B,A00,098053,Bradic; Jelena,0,2,15,15
1668519517088,MATH 282B,A00,098054,Arias-Castro; Ery,0,1,15,15
1668519517514,MATH 285,A00,098055,Fitzsimmons; Patrick J,0,3,15,17
1668519517941,MATH 287B,A00,098056,Arias-Castro; Ery,1,0,15,14
1668519518366,MATH 288,A00,098057,Agarwal; Pooja,9,0,10,1
1668519518366,MATH 288,B00,098058,Zhang; Danna,8,0,10,2
1668519518366,MATH 288,C00,098059,Williams; Ruth J,9,0,10,1
1668519518790,MATH 290B,A00,098060,Roberts; Justin Deritter,12,0,15,3
1668519519221,MATH 292,A00,098061,Belmont; Eva Kinoshita,10,0,10,0
1668519519647,MATH 295,A00,098062,Suk; Andrew Hoon,47,0,50,3
1668519520073,MATH 296,A00,098063,Novak; Jonathan I,20,0,20,0
1668519520498,MATH 297,001,098064,Gamst; Anthony Collins,9997,0,9999,2
1668520021978,COGS 205,A00,101395,Chiba; Andrea,19,0,20,1
1668520022401,COGS 210B,001,101404,Greene; Deanna Jacquelyn,9998,0,9999,1
1668520022401,COGS 210B,002,101417,Xia; Haijun,9999,0,9999,0
1668520022401,COGS 210B,003,101422,Nitz; Douglas A.,9999,0,9999,0
1668520022401,COGS 210B,004,101423,Hollan; James D.,9998,0,9999,1
1668520022401,COGS 210B,005,101424,Deak; Gedeon O.,9998,0,9999,1
1668520022401,COGS 210B,006,101425,Rossano; Federico,9999,0,9999,0
1668520022828,COGS 211B,A00,101427,Coulson; Seana M,9996,0,9999,3
1668520023261,COGS 220,A00,101428,Hollan; James D.,0,10,25,25
1668520023695,COGS 229,A00,101429,Dow; Steven P,17,0,25,8
1668520024126,COGS 230,A00,101430,Klemmer; Scott R,7,0,17,10
1668520024550,COGS 234,A00,101431,Xia; Haijun,1,0,25,24
1668520024974,COGS 260,A00,101432,Kiyonaga; Anastasia,21,0,25,4
1668520024974,COGS 260,B00,101433,Kirsh; David Joel,15,0,25,10
1668520025400,CSE 202,A00,102371,Impagliazzo; Russell,0,66,0,0
1668520025826,CSE 203B,A01,102373,Cheng; Chung Kuan,0,58,0,0
1668520026254,CSE 208,A00,102374,Micciancio; Daniele,0,5,0,0
1668520026681,CSE 209A,A00,112895,Impagliazzo; Russell,0,12,15,15
1668520027106,CSE 209B,A00,108005,Bellare; Mihir,0,7,0,0
1668520027529,CSE 210,A00,113163,Coblenz; Michael J,0,85,0,0
1668520027957,CSE 219,A00,106111,Dow; Steven P,0,6,20,20
1668520028381,CSE 221,A00,102376,Voelker; Geoffrey M.,0,73,0,0
1668520028813,CSE 224,A01,102378,Porter; George M,0,166,0,0
1668520029239,CSE 229A,A00,102379,Savage; Stefan,0,10,0,0
1668520029662,CSE 229C,A00,102380,Munyaka; Imani N. S.,0,10,0,0
1668520030093,CSE 232B,A00,102382,Deutsch; Alin Bernard,0,32,0,0
1668520030517,CSE 234,A01,112904,Kumar; Arun Kumar,0,0,0,0
1668520030939,CSE 237A,A00,102383,Rosing; Tajana Simunic,0,55,0,0
1668520031372,CSE 239A,A00,102384,Deutsch; Alin Bernard,0,14,0,0
1668520031797,CSE 239B,A00,102385,Polikarpova; Nadezhda,0,10,0,0
1668520032221,CSE 240A,A00,102386,Pannuto; Patrick William,0,46,0,0
1668520032650,CSE 240B,A00,102387,Zhao; Jishen,0,47,0,0
1668520033074,CSE 241A,A00,106406,Kang; Mingu,0,9,0,0
1668520033589,CSE 249B,A00,102388,Kahng; Andrew Byun,0,5,8,8
1668520034018,CSE 251B,A01,102392,Cottrell; Garrison W,0,51,0,0
1668520034018,CSE 251B,A02,102393,Cottrell; Garrison W,0,34,0,0
1668520034443,CSE 252B,A00,102394,Ochoa; Benjamin Lawrence,0,59,0,0
1668520034866,CSE 257,A01,102396,Gao; Sicun,0,139,0,0
1668520035289,CSE 272,A00,102397,Li; Tzumao,0,19,0,0
1668520035719,CSE 274,A00,111323,Chern; Albert Ren-Haur,0,15,0,0
1668520036145,CSE 282,A00,102398,Pevzner; Pavel Arkadjevich,0,0,0,0
1668520036577,CSE 284,A00,114175,Gymrek; Melissa Ann,0,22,0,0
1668520037007,CSE 290,A00,102399,Chandraker; Manmohan Krishna,0,11,0,0
1668520037007,CSE 290,B00,102400,Vaccaro; Kristen Marie,0,7,25,25
1668520037007,CSE 290,C00,102414,Pannuto; Patrick William,0,1,25,25
1668520037007,CSE 290,D00,102427,Pevzner; Pavel Arkadjevich,0,0,0,0
1668520037007,CSE 290,E00,102429,Zhao; Jishen,0,4,0,0
1668520037007,CSE 290,F00,102436,Tullsen; Dean Michael,0,5,0,0
1668520037007,CSE 290,G00,102440,Christensen; Henrik I,0,6,20,20
1668520037433,CSE 291,A00,102443,Su; Hao,0,0,0,0
1668520037433,CSE 291,B00,102448,Polikarpova; Nadezhda,0,0,0,0
1668520037433,CSE 291,C00,102453,Vaccaro; Kristen Marie,0,0,0,0
1668520037433,CSE 291,D00,111343,Savage; Stefan,0,0,0,0
1668520037433,CSE 291,E00,116474,Claffy; Kimberly Claire,0,0,0,0
1668520037433,CSE 291,F00,116479,Pasquale; Joseph,0,0,0,0
1668520037857,CSE 293,001,119111,Bafna; Vineet,9999,0,9999,0
1668520037857,CSE 293,002,119118,Bellare; Mihir,9999,0,9999,0
1668520037857,CSE 293,003,119122,Berg-Kirkpatrick; Taylor D,9999,0,9999,0
1668520037857,CSE 293,004,119135,Christensen; Henrik I,9999,0,9999,0
1668520037857,CSE 293,005,119142,Cottrell; Garrison W,9999,0,9999,0
1668520037857,CSE 293,006,119146,Deutsch; Alin Bernard,9999,0,9999,0
1668520037857,CSE 293,007,119159,Esmaeilzadeh; Hadi,9999,0,9999,0
1668520037857,CSE 293,008,119166,Freund; Yoav,9999,0,9999,0
1668520037857,CSE 293,009,119170,Griswold; William G.,9999,0,9999,0
1668520037857,CSE 293,010,119183,Gymrek; Melissa Ann,9999,0,9999,0
1668520037857,CSE 293,011,119190,Heninger; Nadia A,9999,0,9999,0
1668520037857,CSE 293,012,119230,Impagliazzo; Russell,9999,0,9999,0
1668520037857,CSE 293,013,119232,Jhala; Ranjit,9999,0,9999,0
1668520037857,CSE 293,014,119233,Kahng; Andrew Byun,9999,0,9999,0
1668520037857,CSE 293,015,119298,Kane; Daniel Mertz,9999,0,9999,0
1668520037857,CSE 293,016,119299,Kriegman; David J,9999,0,9999,0
1668520037857,CSE 293,017,119300,Kumar; Arun Kumar,9999,0,9999,0
1668520037857,CSE 293,018,119301,Lerner; Sorin,9999,0,9999,0
1668520037857,CSE 293,019,119302,Lovett; Shachar,9999,0,9999,0
1668520037857,CSE 293,020,119303,McAuley; Julian John,9999,0,9999,0
1668520037857,CSE 293,021,119304,Micciancio; Daniele,9999,0,9999,0
1668520037857,CSE 293,022,119367,Orailoglu; Alex,9999,0,9999,0
1668520037857,CSE 293,023,119382,Paturi; Ramamohan,9999,0,9999,0
1668520037857,CSE 293,024,119404,Polikarpova; Nadezhda,9999,0,9999,0
1668520037857,CSE 293,025,119406,Politz; Joseph Gibbs,9999,0,9999,0
1668520037857,CSE 293,026,119411,Porter; George M,9999,0,9999,0
1668520037857,CSE 293,027,119414,Porter; Leonard Emerson,9999,0,9999,0
1668520037857,CSE 293,028,119416,Ramamoorthi; Ravi,9999,0,9999,0
1668520037857,CSE 293,029,119417,Sahoo; Debashis,9999,0,9999,0
1668520037857,CSE 293,030,119420,Saul; Lawrence,9999,0,9999,0
1668520037857,CSE 293,031,119421,Savage; Stefan,9999,0,9999,0
1668520037857,CSE 293,032,119425,Schulze; Jurgen P.,9999,0,9999,0
1668520037857,CSE 293,033,119426,Snoeren; Alex C.,9999,0,9999,0
1668520037857,CSE 293,034,119428,Shang; Jingbo,9999,0,9999,0
1668520037857,CSE 293,035,119430,Stefan; Deian,9999,0,9999,0
1668520037857,CSE 293,036,119431,Su; Hao,9999,0,9999,0
1668520037857,CSE 293,037,119433,Swanson; Steven James,9999,0,9999,0
1668520037857,CSE 293,038,119435,Tullsen; Dean Michael,9999,0,9999,0
1668520037857,CSE 293,039,119483,Voelker; Geoffrey M.,9999,0,9999,0
1668520037857,CSE 293,040,119537,Zhao; Jishen,9999,0,9999,0
1668520037857,CSE 293,041,119538,Zhou; Yuan-Yuan,9999,0,9999,0
1668520037857,CSE 293,042,119539,Gao; Sicun,9999,0,9999,0
1668520037857,CSE 293,043,119540,Weibel; Nadir,9999,0,9999,0
1668520037857,CSE 293,044,119541,Gupta; Rajesh K.,9999,0,9999,0
1668520037857,CSE 293,045,126410,Vaccaro; Kristen Marie,9999,0,9999,0
1668520037857,CSE 293,046,126411,Klemke; Richard,9999,0,9999,0
1668520038284,CSE 294,A00,102459,Voelker; Geoffrey M.,0,2,0,0
1668520038284,CSE 294,B00,111322,Orailoglu; Alex,0,2,0,0
1668520038711,DSE 201,A00,096914,Deutsch; Alin Bernard,30,0,30,0
1668520039134,DSE 210,A00,096915,Dasgupta; Sanjoy,30,0,30,0
1668520039561,DSE 260A,A00,096916,Altintas De Callaf; Ilkay,30,0,30,0
1668520039989,ECE 200,001,103586,Antipa; Nicholas A,9999,0,9999,0
1668520039989,ECE 200,002,103587,Atanasov; Nikolay A.,9999,0,9999,0
1668520039989,ECE 200,003,103588,Bharadia; Dinesh,9999,0,9999,0
1668520039989,ECE 200,004,103589,Cheng; Chung Kuan,9999,0,9999,0
1668520039989,ECE 200,005,103590,Cosman; Pamela C.,9999,0,9999,0
1668520039989,ECE 200,006,103591,Dayeh; Shadi Ahmad,9999,0,9999,0
1668520039989,ECE 200,007,103592,Fainman; Yeshaiahu,9999,0,9999,0
1668520039989,ECE 200,008,103593,Ford; Joseph Earl,9999,0,9999,0
1668520039989,ECE 200,009,103594,Franceschetti; Massimo,9999,0,9999,0
1668520039989,ECE 200,010,103595,Fullerton; Eric E,9999,0,9999,0
1668520039989,ECE 200,011,103596,Galton; Ian A,9999,0,9999,0
1668520039989,ECE 200,012,103597,Gilja; Vikash,9999,0,9999,0
1668520039989,ECE 200,013,103598,Hall; Drew A.,9999,0,9999,0
1668520039989,ECE 200,014,103599,Hsueh; Tzu-Chien,9999,0,9999,0
1668520039989,ECE 200,015,103600,Javidi; Tara,9999,0,9999,0
1668520039989,ECE 200,016,103601,Kahng; Andrew Byun,9999,0,9999,0
1668520039989,ECE 200,017,103602,Kim; Young-Han,9999,0,9999,0
1668520039989,ECE 200,018,103603,Koushanfar; Farinaz,9999,0,9999,0
1668520039989,ECE 200,019,103604,Kuzum; Duygu,9999,0,9999,0
1668520039989,ECE 200,020,103605,Le; Hanh-Phuc,9999,0,9999,0
1668520039989,ECE 200,021,103606,Lin; Bill,9999,0,9999,0
1668520039989,ECE 200,022,103607,Liu; Zhaowei,9998,0,9999,1
1668520039989,ECE 200,023,103608,Lo; Yu-Hwa,9999,0,9999,0
1668520039989,ECE 200,024,103609,Lomakin; Vitaliy,9999,0,9999,0
1668520039989,ECE 200,025,103610,Mercier; Patrick Philip,9999,0,9999,0
1668520039989,ECE 200,026,103611,Meyer; Florian,9999,0,9999,0
1668520039989,ECE 200,027,103612,Milstein; Laurence B.,9999,0,9999,0
1668520039989,ECE 200,028,103613,Mir Arabbaygi; Siavash,9999,0,9999,0
1668520039989,ECE 200,029,103614,Mookherjea; Shayan,9999,0,9999,0
1668520039989,ECE 200,030,103615,Morris; Karcher William,9999,0,9999,0
1668520039989,ECE 200,031,103616,Ng; Tse Nga,9999,0,9999,0
1668520039989,ECE 200,032,103617,Nguyen; Truong Quang,9999,0,9999,0
1668520039989,ECE 200,033,103618,Nomura; Kenji,9999,0,9999,0
1668520039989,ECE 200,034,103619,Orlitsky; Alon,9999,0,9999,0
1668520039989,ECE 200,035,103620,Pal; Piya,9999,0,9999,0
1668520039989,ECE 200,036,103621,Papen; George C.,9999,0,9999,0
1668520039989,ECE 200,037,103622,Radic; Stojan,9999,0,9999,0
1668520039989,ECE 200,038,103623,Rao; Bhaskar D.,9999,0,9999,0
1668520039989,ECE 200,039,103624,Rao; Ramesh R,9999,0,9999,0
1668520039989,ECE 200,040,103625,Rebeiz; Gabriel,9999,0,9999,0
1668520039989,ECE 200,041,103626,Sanford; John R,9999,0,9999,0
1668520039989,ECE 200,042,103627,Siegel; Paul H.,9999,0,9999,0
1668520039989,ECE 200,043,103628,Sievenpiper; Daniel F.,9999,0,9999,0
1668520039989,ECE 200,044,103629,Sworder; David D.,9999,0,9999,0
1668520039989,ECE 200,045,103630,Taur; Yuan,9999,0,9999,0
1668520039989,ECE 200,046,103631,Touri; Behrouz,9999,0,9999,0
1668520039989,ECE 200,047,103632,Trivedi; Mohan M.,9999,0,9999,0
1668520039989,ECE 200,048,103633,Vasconcelos; Nuno,9999,0,9999,0
1668520039989,ECE 200,049,103634,Wang; Xiaolong,9999,0,9999,0
1668520039989,ECE 200,050,103635,Xie; Pengtao,9999,0,9999,0
1668520039989,ECE 200,051,103636,Yip; Michael,9999,0,9999,0
1668520039989,ECE 200,052,103637,Zeger; Kenneth A.,999,0,999,0
1668520039989,ECE 200,053,103638,Zhang; Xinyu,9999,0,9999,0
1668520039989,ECE 200,054,103639,Turakhia; Yatish Girish,9999,0,9999,0
1668520039989,ECE 200,055,103640,Kang; Mingu,9999,0,9999,0
1668520039989,ECE 200,056,103641,Shi; Yuanyuan,9999,0,9999,0
1668520039989,ECE 200,057,103642,Wang; Edward Jay,9999,0,9999,0
1668520039989,ECE 200,058,103643,Zheng; Yang,9999,0,9999,0
1668520040414,ECE 202,A00,103644,Kuzum; Duygu,0,44,0,0
1668520040848,ECE 212BN,A00,103646,Ng; Tse Nga,0,9,0,0
1668520041271,ECE 221,A00,111493,Staff,0,0,0,0
1668520041696,ECE 222B,A00,103647,Lomakin; Vitaliy,0,20,0,0
1668520042119,ECE 230B,A00,103648,Taur; Yuan,0,3,0,0
1668520042555,ECE 238B,A00,103649,Garay; Javier,0,0,0,0
1668520042982,ECE 240B,A00,112900,Fainman; Yeshaiahu,0,7,0,0
1668520043412,ECE 247A,A00,103650,Jokerst; Jesse Vincent,0,6,0,0
1668520043837,ECE 247B,A00,103651,Wang; Joseph,0,14,0,0
1668520044269,ECE 250,A00,103652,Siegel; Paul H.,0,82,0,0
1668520044693,ECE 251A,A00,103654,Rao; Bhaskar D.,0,62,0,0
1668520045118,ECE 257B,A00,103655,Bharadia; Dinesh,0,33,0,0
1668520045545,ECE 258A,A00,103656,Milstein; Laurence B.,0,29,0,0
1668520045969,ECE 260B,A00,103658,Kang; Mingu,0,119,0,0
1668520046394,ECE 264A,A00,103659,Galton; Ian A,0,66,0,0
1668520046821,ECE 265A,A00,103661,Gudem; Prasad S.S.,0,70,0,0
1668520047245,ECE 265D,A00,103662,Gudem; Prasad S.S.,0,26,0,0
1668520047682,ECE 268,A00,103663,Koushanfar; Farinaz,0,43,0,0
1668520048106,ECE 269,A01,103665,Pal; Piya,0,215,0,0
1668520048529,ECE 271B,A00,103666,Vasconcelos; Manuela,0,76,0,0
1668520048954,ECE 276A,A00,103667,Atanasov; Nikolay A.,0,126,0,0
1668520049377,ECE 277,A00,103668,An; Cheolhong,0,149,0,0
1668520049803,ECE 279,A00,117947,Hall; Drew A.,0,22,0,0
1668520050658,ECE 283,A00,103670,Hsueh; Tzu-Chien,0,53,0,0
1668520051083,ECE 284,A00,103671,Turakhia; Yatish Girish,0,39,0,0
1668520051508,ECE 285,A00,103672,Zheng; Yang,0,39,0,0
1668520051508,ECE 285,B00,103673,Sworder; David D.,0,57,0,0
1668520051939,ECE 287,A00,103676,Javidi; Tara,0,9,0,0
1668520052366,MATH 200B,A00,098023,Salehi Golsefidy; Alireza,10,0,15,5
1668520052792,MATH 202B,A00,098024,Rhoades; Brendon Patrick,7,0,15,8
1668520053218,MATH 203B,A00,098025,Oprea; Dragos N.,9,0,15,6
1668520053645,MATH 204B,A00,098026,Sorensen; Claus M,13,0,15,2
1668520054069,MATH 208,A00,098027,Izadi; Elham,7,0,10,3
1668520054494,MATH 209,A00,098028,Pollack; Aaron,10,0,10,0
1668520054917,MATH 211A,A00,112919,Rogalski; Daniel,8,0,10,2
1668520055345,MATH 211B,A00,112920,Seward; Brandon M.,9,0,10,1
1668520055772,MATH 218,A00,098029,Li; Bo,10,0,10,0
1668520056205,MATH 220B,A00,098030,Novak; Jonathan I,11,0,15,4
1668520056631,MATH 221A,A00,098031,Ebenfelt; Peter F,12,0,15,3
1668520057054,MATH 231B,A00,098032,Zlatos; Andrej,11,0,15,4
1668520057477,MATH 240B,A00,098033,Ni; Lei,7,0,15,8
1668520057901,MATH 243,A00,098034,Jekel; David Andrew,10,0,10,0
1668520058327,MATH 245A,A00,098035,Nie; Jiawang,0,4,15,18
1668520058749,MATH 248,A00,098036,Bejenaru; Ioan,10,0,10,0
1668520059175,MATH 250B,A00,098037,Spolaor; Luca,14,0,15,1
1668520059605,MATH 258,A00,098038,Ni; Lei,9,0,10,1
1668520060032,MATH 264B,A00,098041,Rhoades; Brendon Patrick,8,0,15,7
1668520060456,MATH 268,A00,098042,Buss; Samuel R,10,0,10,0
1668520060885,MATH 269,A00,098043,Rhoades; Brendon Patrick,10,0,10,0
1668520061314,MATH 270B,A00,098044,Li; Bo,6,0,15,9
1668520061738,MATH 272B,A00,098045,Holst; Michael J,13,0,15,2
1668520062165,MATH 273A,A00,098046,Tian; Xiaochuan,10,0,15,5
1668520062590,MATH 275,A01,098048,Tian; Xiaochuan,6,0,10,4
1668520063021,MATH 278A,A00,098049,Holst; Michael J,7,0,10,3
1668520063444,MATH 278B,A00,098050,Cloninger; Alexander,10,0,10,0
1668520063884,MATH 278C,A00,098051,Nie; Jiawang,5,0,10,5
1668520064326,MATH 280B,A00,098052,Zheng; Tianyi,7,0,15,8
1668520064749,MATH 281B,A00,098053,Bradic; Jelena,0,2,15,15
1668520065175,MATH 282B,A00,098054,Arias-Castro; Ery,0,1,15,15
1668520065600,MATH 285,A00,098055,Fitzsimmons; Patrick J,0,3,15,17
1668520066031,MATH 287B,A00,098056,Arias-Castro; Ery,1,0,15,14
1668520066456,MATH 288,A00,098057,Agarwal; Pooja,9,0,10,1
1668520066456,MATH 288,B00,098058,Zhang; Danna,8,0,10,2
1668520066456,MATH 288,C00,098059,Williams; Ruth J,9,0,10,1
1668520066882,MATH 290B,A00,098060,Roberts; Justin Deritter,12,0,15,3
1668520067308,MATH 292,A00,098061,Belmont; Eva Kinoshita,10,0,10,0
1668520067733,MATH 295,A00,098062,Suk; Andrew Hoon,47,0,50,3
1668520068164,MATH 296,A00,098063,Novak; Jonathan I,20,0,20,0
1668520068595,MATH 297,001,098064,Gamst; Anthony Collins,9997,0,9999,2
1668520572417,COGS 205,A00,101395,Chiba; Andrea,19,0,20,1
1668520572847,COGS 210B,001,101404,Greene; Deanna Jacquelyn,9998,0,9999,1
1668520572847,COGS 210B,002,101417,Xia; Haijun,9999,0,9999,0
1668520572847,COGS 210B,003,101422,Nitz; Douglas A.,9999,0,9999,0
1668520572847,COGS 210B,004,101423,Hollan; James D.,9998,0,9999,1
1668520572847,COGS 210B,005,101424,Deak; Gedeon O.,9998,0,9999,1
1668520572847,COGS 210B,006,101425,Rossano; Federico,9999,0,9999,0
1668520573272,COGS 211B,A00,101427,Coulson; Seana M,9996,0,9999,3
1668520573695,COGS 220,A00,101428,Hollan; James D.,0,10,25,25
1668520574123,COGS 229,A00,101429,Dow; Steven P,17,0,25,8
1668520574546,COGS 230,A00,101430,Klemmer; Scott R,7,0,17,10
1668520574972,COGS 234,A00,101431,Xia; Haijun,1,0,25,24
1668520575413,COGS 260,A00,101432,Kiyonaga; Anastasia,21,0,25,4
1668520575413,COGS 260,B00,101433,Kirsh; David Joel,15,0,25,10
1668520575839,CSE 202,A00,102371,Impagliazzo; Russell,0,66,0,0
1668520576273,CSE 203B,A01,102373,Cheng; Chung Kuan,0,58,0,0
1668520576709,CSE 208,A00,102374,Micciancio; Daniele,0,5,0,0
1668520577134,CSE 209A,A00,112895,Impagliazzo; Russell,0,12,15,15
1668520577571,CSE 209B,A00,108005,Bellare; Mihir,0,7,0,0
1668520578010,CSE 210,A00,113163,Coblenz; Michael J,0,85,0,0
1668520578450,CSE 219,A00,106111,Dow; Steven P,0,6,20,20
1668520578889,CSE 221,A00,102376,Voelker; Geoffrey M.,0,73,0,0
1668520579327,CSE 224,A01,102378,Porter; George M,0,166,0,0
1668520579753,CSE 229A,A00,102379,Savage; Stefan,0,10,0,0
1668520580177,CSE 229C,A00,102380,Munyaka; Imani N. S.,0,10,0,0
1668520580602,CSE 232B,A00,102382,Deutsch; Alin Bernard,0,32,0,0
1668520581039,CSE 234,A01,112904,Kumar; Arun Kumar,0,0,0,0
1668520581465,CSE 237A,A00,102383,Rosing; Tajana Simunic,0,55,0,0
1668520581891,CSE 239A,A00,102384,Deutsch; Alin Bernard,0,14,0,0
1668520582320,CSE 239B,A00,102385,Polikarpova; Nadezhda,0,10,0,0
1668520582743,CSE 240A,A00,102386,Pannuto; Patrick William,0,46,0,0
1668520583183,CSE 240B,A00,102387,Zhao; Jishen,0,47,0,0
1668520583614,CSE 241A,A00,106406,Kang; Mingu,0,9,0,0
1668520584041,CSE 249B,A00,102388,Kahng; Andrew Byun,0,5,8,8
1668520584473,CSE 251B,A01,102392,Cottrell; Garrison W,0,51,0,0
1668520584473,CSE 251B,A02,102393,Cottrell; Garrison W,0,34,0,0
1668520584903,CSE 252B,A00,102394,Ochoa; Benjamin Lawrence,0,59,0,0
1668520585327,CSE 257,A01,102396,Gao; Sicun,0,139,0,0
1668520585755,CSE 272,A00,102397,Li; Tzumao,0,19,0,0
1668520586182,CSE 274,A00,111323,Chern; Albert Ren-Haur,0,15,0,0
1668520586623,CSE 282,A00,102398,Pevzner; Pavel Arkadjevich,0,0,0,0
1668520587053,CSE 284,A00,114175,Gymrek; Melissa Ann,0,22,0,0
1668520587482,CSE 290,A00,102399,Chandraker; Manmohan Krishna,0,11,0,0
1668520587482,CSE 290,B00,102400,Vaccaro; Kristen Marie,0,7,25,25
1668520587482,CSE 290,C00,102414,Pannuto; Patrick William,0,1,25,25
1668520587482,CSE 290,D00,102427,Pevzner; Pavel Arkadjevich,0,0,0,0
1668520587482,CSE 290,E00,102429,Zhao; Jishen,0,4,0,0
1668520587482,CSE 290,F00,102436,Tullsen; Dean Michael,0,5,0,0
1668520587482,CSE 290,G00,102440,Christensen; Henrik I,0,6,20,20
1668520587920,CSE 291,A00,102443,Su; Hao,0,0,0,0
1668520587920,CSE 291,B00,102448,Polikarpova; Nadezhda,0,0,0,0
1668520587920,CSE 291,C00,102453,Vaccaro; Kristen Marie,0,0,0,0
1668520587920,CSE 291,D00,111343,Savage; Stefan,0,0,0,0
1668520587920,CSE 291,E00,116474,Claffy; Kimberly Claire,0,0,0,0
1668520587920,CSE 291,F00,116479,Pasquale; Joseph,0,0,0,0
1668520588387,CSE 293,001,119111,Bafna; Vineet,9999,0,9999,0
1668520588387,CSE 293,002,119118,Bellare; Mihir,9999,0,9999,0
1668520588387,CSE 293,003,119122,Berg-Kirkpatrick; Taylor D,9999,0,9999,0
1668520588387,CSE 293,004,119135,Christensen; Henrik I,9999,0,9999,0
1668520588387,CSE 293,005,119142,Cottrell; Garrison W,9999,0,9999,0
1668520588387,CSE 293,006,119146,Deutsch; Alin Bernard,9999,0,9999,0
1668520588387,CSE 293,007,119159,Esmaeilzadeh; Hadi,9999,0,9999,0
1668520588387,CSE 293,008,119166,Freund; Yoav,9999,0,9999,0
1668520588387,CSE 293,009,119170,Griswold; William G.,9999,0,9999,0
1668520588387,CSE 293,010,119183,Gymrek; Melissa Ann,9999,0,9999,0
1668520588387,CSE 293,011,119190,Heninger; Nadia A,9999,0,9999,0
1668520588387,CSE 293,012,119230,Impagliazzo; Russell,9999,0,9999,0
1668520588387,CSE 293,013,119232,Jhala; Ranjit,9999,0,9999,0
1668520588387,CSE 293,014,119233,Kahng; Andrew Byun,9999,0,9999,0
1668520588387,CSE 293,015,119298,Kane; Daniel Mertz,9999,0,9999,0
1668520588387,CSE 293,016,119299,Kriegman; David J,9999,0,9999,0
1668520588387,CSE 293,017,119300,Kumar; Arun Kumar,9999,0,9999,0
1668520588387,CSE 293,018,119301,Lerner; Sorin,9999,0,9999,0
1668520588387,CSE 293,019,119302,Lovett; Shachar,9999,0,9999,0
1668520588387,CSE 293,020,119303,McAuley; Julian John,9999,0,9999,0
1668520588387,CSE 293,021,119304,Micciancio; Daniele,9999,0,9999,0
1668520588387,CSE 293,022,119367,Orailoglu; Alex,9999,0,9999,0
1668520588387,CSE 293,023,119382,Paturi; Ramamohan,9999,0,9999,0
1668520588387,CSE 293,024,119404,Polikarpova; Nadezhda,9999,0,9999,0
1668520588387,CSE 293,025,119406,Politz; Joseph Gibbs,9999,0,9999,0
1668520588387,CSE 293,026,119411,Porter; George M,9999,0,9999,0
1668520588387,CSE 293,027,119414,Porter; Leonard Emerson,9999,0,9999,0
1668520588387,CSE 293,028,119416,Ramamoorthi; Ravi,9999,0,9999,0
1668520588387,CSE 293,029,119417,Sahoo; Debashis,9999,0,9999,0
1668520588387,CSE 293,030,119420,Saul; Lawrence,9999,0,9999,0
1668520588387,CSE 293,031,119421,Savage; Stefan,9999,0,9999,0
1668520588387,CSE 293,032,119425,Schulze; Jurgen P.,9999,0,9999,0
1668520588387,CSE 293,033,119426,Snoeren; Alex C.,9999,0,9999,0
1668520588387,CSE 293,034,119428,Shang; Jingbo,9999,0,9999,0
1668520588387,CSE 293,035,119430,Stefan; Deian,9999,0,9999,0
1668520588387,CSE 293,036,119431,Su; Hao,9999,0,9999,0
1668520588387,CSE 293,037,119433,Swanson; Steven James,9999,0,9999,0
1668520588387,CSE 293,038,119435,Tullsen; Dean Michael,9999,0,9999,0
1668520588387,CSE 293,039,119483,Voelker; Geoffrey M.,9999,0,9999,0
1668520588387,CSE 293,040,119537,Zhao; Jishen,9999,0,9999,0
1668520588387,CSE 293,041,119538,Zhou; Yuan-Yuan,9999,0,9999,0
1668520588387,CSE 293,042,119539,Gao; Sicun,9999,0,9999,0
1668520588387,CSE 293,043,119540,Weibel; Nadir,9999,0,9999,0
1668520588387,CSE 293,044,119541,Gupta; Rajesh K.,9999,0,9999,0
1668520588387,CSE 293,045,126410,Vaccaro; Kristen Marie,9999,0,9999,0
1668520588387,CSE 293,046,126411,Klemke; Richard,9999,0,9999,0
1668520588825,CSE 294,A00,102459,Voelker; Geoffrey M.,0,2,0,0
1668520588825,CSE 294,B00,111322,Orailoglu; Alex,0,2,0,0
1668520589267,DSE 201,A00,096914,Deutsch; Alin Bernard,30,0,30,0
1668520589695,DSE 210,A00,096915,Dasgupta; Sanjoy,30,0,30,0
1668520590120,DSE 260A,A00,096916,Altintas De Callaf; Ilkay,30,0,30,0
1668520590600,ECE 200,001,103586,Antipa; Nicholas A,9999,0,9999,0
1668520590600,ECE 200,002,103587,Atanasov; Nikolay A.,9999,0,9999,0
1668520590600,ECE 200,003,103588,Bharadia; Dinesh,9999,0,9999,0
1668520590600,ECE 200,004,103589,Cheng; Chung Kuan,9999,0,9999,0
1668520590600,ECE 200,005,103590,Cosman; Pamela C.,9999,0,9999,0
1668520590600,ECE 200,006,103591,Dayeh; Shadi Ahmad,9999,0,9999,0
1668520590600,ECE 200,007,103592,Fainman; Yeshaiahu,9999,0,9999,0
1668520590600,ECE 200,008,103593,Ford; Joseph Earl,9999,0,9999,0
1668520590600,ECE 200,009,103594,Franceschetti; Massimo,9999,0,9999,0
1668520590600,ECE 200,010,103595,Fullerton; Eric E,9999,0,9999,0
1668520590600,ECE 200,011,103596,Galton; Ian A,9999,0,9999,0
1668520590600,ECE 200,012,103597,Gilja; Vikash,9999,0,9999,0
1668520590600,ECE 200,013,103598,Hall; Drew A.,9999,0,9999,0
1668520590600,ECE 200,014,103599,Hsueh; Tzu-Chien,9999,0,9999,0
1668520590600,ECE 200,015,103600,Javidi; Tara,9999,0,9999,0
1668520590600,ECE 200,016,103601,Kahng; Andrew Byun,9999,0,9999,0
1668520590600,ECE 200,017,103602,Kim; Young-Han,9999,0,9999,0
1668520590600,ECE 200,018,103603,Koushanfar; Farinaz,9999,0,9999,0
1668520590600,ECE 200,019,103604,Kuzum; Duygu,9999,0,9999,0
1668520590600,ECE 200,020,103605,Le; Hanh-Phuc,9999,0,9999,0
1668520590600,ECE 200,021,103606,Lin; Bill,9999,0,9999,0
1668520590600,ECE 200,022,103607,Liu; Zhaowei,9998,0,9999,1
1668520590600,ECE 200,023,103608,Lo; Yu-Hwa,9999,0,9999,0
1668520590600,ECE 200,024,103609,Lomakin; Vitaliy,9999,0,9999,0
1668520590600,ECE 200,025,103610,Mercier; Patrick Philip,9999,0,9999,0
1668520590600,ECE 200,026,103611,Meyer; Florian,9999,0,9999,0
1668520590600,ECE 200,027,103612,Milstein; Laurence B.,9999,0,9999,0
1668520590600,ECE 200,028,103613,Mir Arabbaygi; Siavash,9999,0,9999,0
1668520590600,ECE 200,029,103614,Mookherjea; Shayan,9999,0,9999,0
1668520590600,ECE 200,030,103615,Morris; Karcher William,9999,0,9999,0
1668520590600,ECE 200,031,103616,Ng; Tse Nga,9999,0,9999,0
1668520590600,ECE 200,032,103617,Nguyen; Truong Quang,9999,0,9999,0
1668520590600,ECE 200,033,103618,Nomura; Kenji,9999,0,9999,0
1668520590600,ECE 200,034,103619,Orlitsky; Alon,9999,0,9999,0
1668520590600,ECE 200,035,103620,Pal; Piya,9999,0,9999,0
1668520590600,ECE 200,036,103621,Papen; George C.,9999,0,9999,0
1668520590600,ECE 200,037,103622,Radic; Stojan,9999,0,9999,0
1668520590600,ECE 200,038,103623,Rao; Bhaskar D.,9999,0,9999,0
1668520590600,ECE 200,039,103624,Rao; Ramesh R,9999,0,9999,0
1668520590600,ECE 200,040,103625,Rebeiz; Gabriel,9999,0,9999,0
1668520590600,ECE 200,041,103626,Sanford; John R,9999,0,9999,0
1668520590600,ECE 200,042,103627,Siegel; Paul H.,9999,0,9999,0
1668520590600,ECE 200,043,103628,Sievenpiper; Daniel F.,9999,0,9999,0
1668520590600,ECE 200,044,103629,Sworder; David D.,9999,0,9999,0
1668520590600,ECE 200,045,103630,Taur; Yuan,9999,0,9999,0
1668520590600,ECE 200,046,103631,Touri; Behrouz,9999,0,9999,0
1668520590600,ECE 200,047,103632,Trivedi; Mohan M.,9999,0,9999,0
1668520590600,ECE 200,048,103633,Vasconcelos; Nuno,9999,0,9999,0
1668520590600,ECE 200,049,103634,Wang; Xiaolong,9999,0,9999,0
1668520590600,ECE 200,050,103635,Xie; Pengtao,9999,0,9999,0
1668520590600,ECE 200,051,103636,Yip; Michael,9999,0,9999,0
1668520590600,ECE 200,052,103637,Zeger; Kenneth A.,999,0,999,0
1668520590600,ECE 200,053,103638,Zhang; Xinyu,9999,0,9999,0
1668520590600,ECE 200,054,103639,Turakhia; Yatish Girish,9999,0,9999,0
1668520590600,ECE 200,055,103640,Kang; Mingu,9999,0,9999,0
1668520590600,ECE 200,056,103641,Shi; Yuanyuan,9999,0,9999,0
1668520590600,ECE 200,057,103642,Wang; Edward Jay,9999,0,9999,0
1668520590600,ECE 200,058,103643,Zheng; Yang,9999,0,9999,0
1668520591027,ECE 202,A00,103644,Kuzum; Duygu,0,44,0,0
1668520591451,ECE 212BN,A00,103646,Ng; Tse Nga,0,9,0,0
1668520591878,ECE 221,A00,111493,Staff,0,0,0,0
1668520592305,ECE 222B,A00,103647,Lomakin; Vitaliy,0,20,0,0
1668520592745,ECE 230B,A00,103648,Taur; Yuan,0,3,0,0
1668520593183,ECE 238B,A00,103649,Garay; Javier,0,0,0,0
1668520593631,ECE 240B,A00,112900,Fainman; Yeshaiahu,0,7,0,0
1668520594070,ECE 247A,A00,103650,Jokerst; Jesse Vincent,0,6,0,0
1668520594494,ECE 247B,A00,103651,Wang; Joseph,0,14,0,0
1668520594920,ECE 250,A00,103652,Siegel; Paul H.,0,82,0,0
1668520595345,ECE 251A,A00,103654,Rao; Bhaskar D.,0,62,0,0
1668520595778,ECE 257B,A00,103655,Bharadia; Dinesh,0,33,0,0
1668520596202,ECE 258A,A00,103656,Milstein; Laurence B.,0,29,0,0
1668520596630,ECE 260B,A00,103658,Kang; Mingu,0,119,0,0
1668520597059,ECE 264A,A00,103659,Galton; Ian A,0,66,0,0
1668520597483,ECE 265A,A00,103661,Gudem; Prasad S.S.,0,70,0,0
1668520597909,ECE 265D,A00,103662,Gudem; Prasad S.S.,0,26,0,0
1668520598337,ECE 268,A00,103663,Koushanfar; Farinaz,0,43,0,0
1668520598769,ECE 269,A01,103665,Pal; Piya,0,215,0,0
1668520599197,ECE 271B,A00,103666,Vasconcelos; Manuela,0,76,0,0
1668520599701,ECE 276A,A00,103667,Atanasov; Nikolay A.,0,126,0,0
1668520600126,ECE 277,A00,103668,An; Cheolhong,0,149,0,0
1668520600554,ECE 279,A00,117947,Hall; Drew A.,0,22,0,0
1668520601408,ECE 283,A00,103670,Hsueh; Tzu-Chien,0,53,0,0
1668520601834,ECE 284,A00,103671,Turakhia; Yatish Girish,0,39,0,0
1668520602262,ECE 285,A00,103672,Zheng; Yang,0,39,0,0
1668520602262,ECE 285,B00,103673,Sworder; David D.,0,57,0,0
1668520602693,ECE 287,A00,103676,Javidi; Tara,0,9,0,0
1668520603122,MATH 200B,A00,098023,Salehi Golsefidy; Alireza,10,0,15,5
1668520603553,MATH 202B,A00,098024,Rhoades; Brendon Patrick,7,0,15,8
1668520603990,MATH 203B,A00,098025,Oprea; Dragos N.,9,0,15,6
1668520604419,MATH 204B,A00,098026,Sorensen; Claus M,13,0,15,2
1668520604848,MATH 208,A00,098027,Izadi; Elham,7,0,10,3
1668520605274,MATH 209,A00,098028,Pollack; Aaron,10,0,10,0
1668520605698,MATH 211A,A00,112919,Rogalski; Daniel,8,0,10,2
1668520606123,MATH 211B,A00,112920,Seward; Brandon M.,9,0,10,1
1668520606554,MATH 218,A00,098029,Li; Bo,10,0,10,0
1668520606981,MATH 220B,A00,098030,Novak; Jonathan I,11,0,15,4
1668520607405,MATH 221A,A00,098031,Ebenfelt; Peter F,12,0,15,3
1668520607834,MATH 231B,A00,098032,Zlatos; Andrej,11,0,15,4
1668520608259,MATH 240B,A00,098033,Ni; Lei,7,0,15,8
1668520608682,MATH 243,A00,098034,Jekel; David Andrew,10,0,10,0
1668520609110,MATH 245A,A00,098035,Nie; Jiawang,0,4,15,18
1668520609535,MATH 248,A00,098036,Bejenaru; Ioan,10,0,10,0
1668520609967,MATH 250B,A00,098037,Spolaor; Luca,14,0,15,1
1668520610391,MATH 258,A00,098038,Ni; Lei,9,0,10,1
1668520610825,MATH 264B,A00,098041,Rhoades; Brendon Patrick,8,0,15,7
1668520611254,MATH 268,A00,098042,Buss; Samuel R,10,0,10,0
1668520611690,MATH 269,A00,098043,Rhoades; Brendon Patrick,10,0,10,0
1668520612114,MATH 270B,A00,098044,Li; Bo,6,0,15,9
1668520612538,MATH 272B,A00,098045,Holst; Michael J,13,0,15,2
1668520612965,MATH 273A,A00,098046,Tian; Xiaochuan,10,0,15,5
1668520613390,MATH 275,A01,098048,Tian; Xiaochuan,6,0,10,4
1668520613815,MATH 278A,A00,098049,Holst; Michael J,7,0,10,3
1668520614240,MATH 278B,A00,098050,Cloninger; Alexander,10,0,10,0
1668520614667,MATH 278C,A00,098051,Nie; Jiawang,5,0,10,5
1668520615096,MATH 280B,A00,098052,Zheng; Tianyi,7,0,15,8
1668520615521,MATH 281B,A00,098053,Bradic; Jelena,0,2,15,15
1668520615961,MATH 282B,A00,098054,Arias-Castro; Ery,0,1,15,15
1668520616390,MATH 285,A00,098055,Fitzsimmons; Patrick J,0,3,15,17
1668520616814,MATH 287B,A00,098056,Arias-Castro; Ery,1,0,15,14
1668520617241,MATH 288,A00,098057,Agarwal; Pooja,9,0,10,1
1668520617241,MATH 288,B00,098058,Zhang; Danna,8,0,10,2
1668520617241,MATH 288,C00,098059,Williams; Ruth J,9,0,10,1
1668520617675,MATH 290B,A00,098060,Roberts; Justin Deritter,12,0,15,3
1668520618104,MATH 292,A00,098061,Belmont; Eva Kinoshita,10,0,10,0
1668520618529,MATH 295,A00,098062,Suk; Andrew Hoon,47,0,50,3
1668520618954,MATH 296,A00,098063,Novak; Jonathan I,20,0,20,0
1668520619381,MATH 297,001,098064,Gamst; Anthony Collins,9997,0,9999,2
1668521125265,COGS 205,A00,101395,Chiba; Andrea,19,0,20,1
1668521125694,COGS 210B,001,101404,Greene; Deanna Jacquelyn,9998,0,9999,1
1668521125694,COGS 210B,002,101417,Xia; Haijun,9999,0,9999,0
1668521125694,COGS 210B,003,101422,Nitz; Douglas A.,9999,0,9999,0
1668521125694,COGS 210B,004,101423,Hollan; James D.,9998,0,9999,1
1668521125694,COGS 210B,005,101424,Deak; Gedeon O.,9998,0,9999,1
1668521125694,COGS 210B,006,101425,Rossano; Federico,9999,0,9999,0
1668521126117,COGS 211B,A00,101427,Coulson; Seana M,9996,0,9999,3
1668521126545,COGS 220,A00,101428,Hollan; James D.,0,10,25,25
1668521126967,COGS 229,A00,101429,Dow; Steven P,17,0,25,8
1668521127397,COGS 230,A00,101430,Klemmer; Scott R,7,0,17,10
1668521127840,COGS 234,A00,101431,Xia; Haijun,1,0,25,24
1668521128265,COGS 260,A00,101432,Kiyonaga; Anastasia,21,0,25,4
1668521128265,COGS 260,B00,101433,Kirsh; David Joel,15,0,25,10
1668521128691,CSE 202,A00,102371,Impagliazzo; Russell,0,66,0,0
1668521129117,CSE 203B,A01,102373,Cheng; Chung Kuan,0,58,0,0
1668521129545,CSE 208,A00,102374,Micciancio; Daniele,0,5,0,0
1668521129969,CSE 209A,A00,112895,Impagliazzo; Russell,0,12,15,15
1668521130398,CSE 209B,A00,108005,Bellare; Mihir,0,7,0,0
1668521130834,CSE 210,A00,113163,Coblenz; Michael J,0,85,0,0
1668521131269,CSE 219,A00,106111,Dow; Steven P,0,6,20,20
1668521131714,CSE 221,A00,102376,Voelker; Geoffrey M.,0,73,0,0
1668521132140,CSE 224,A01,102378,Porter; George M,0,166,0,0
1668521132568,CSE 229A,A00,102379,Savage; Stefan,0,10,0,0
1668521132993,CSE 229C,A00,102380,Munyaka; Imani N. S.,0,10,0,0
1668521133418,CSE 232B,A00,102382,Deutsch; Alin Bernard,0,32,0,0
1668521133843,CSE 234,A01,112904,Kumar; Arun Kumar,0,0,0,0
1668521134269,CSE 237A,A00,102383,Rosing; Tajana Simunic,0,55,0,0
1668521134692,CSE 239A,A00,102384,Deutsch; Alin Bernard,0,14,0,0
1668521135122,CSE 239B,A00,102385,Polikarpova; Nadezhda,0,10,0,0
1668521135552,CSE 240A,A00,102386,Pannuto; Patrick William,0,46,0,0
1668521135974,CSE 240B,A00,102387,Zhao; Jishen,0,47,0,0
1668521136406,CSE 241A,A00,106406,Kang; Mingu,0,9,0,0
1668521136832,CSE 249B,A00,102388,Kahng; Andrew Byun,0,5,8,8
1668521137257,CSE 251B,A01,102392,Cottrell; Garrison W,0,51,0,0
1668521137257,CSE 251B,A02,102393,Cottrell; Garrison W,0,34,0,0
1668521137685,CSE 252B,A00,102394,Ochoa; Benjamin Lawrence,0,59,0,0
1668521138111,CSE 257,A01,102396,Gao; Sicun,0,139,0,0
1668521138545,CSE 272,A00,102397,Li; Tzumao,0,19,0,0
1668521138970,CSE 274,A00,111323,Chern; Albert Ren-Haur,0,15,0,0
1668521139394,CSE 282,A00,102398,Pevzner; Pavel Arkadjevich,0,0,0,0
1668521139819,CSE 284,A00,114175,Gymrek; Melissa Ann,0,22,0,0
1668521140255,CSE 290,A00,102399,Chandraker; Manmohan Krishna,0,11,0,0
1668521140255,CSE 290,B00,102400,Vaccaro; Kristen Marie,0,7,25,25
1668521140255,CSE 290,C00,102414,Pannuto; Patrick William,0,1,25,25
1668521140255,CSE 290,D00,102427,Pevzner; Pavel Arkadjevich,0,0,0,0
1668521140255,CSE 290,E00,102429,Zhao; Jishen,0,4,0,0
1668521140255,CSE 290,F00,102436,Tullsen; Dean Michael,0,5,0,0
1668521140255,CSE 290,G00,102440,Christensen; Henrik I,0,6,20,20
1668521140695,CSE 291,A00,102443,Su; Hao,0,0,0,0
1668521140695,CSE 291,B00,102448,Polikarpova; Nadezhda,0,0,0,0
1668521140695,CSE 291,C00,102453,Vaccaro; Kristen Marie,0,0,0,0
1668521140695,CSE 291,D00,111343,Savage; Stefan,0,0,0,0
1668521140695,CSE 291,E00,116474,Claffy; Kimberly Claire,0,0,0,0
1668521140695,CSE 291,F00,116479,Pasquale; Joseph,0,0,0,0
1668521141157,CSE 293,001,119111,Bafna; Vineet,9999,0,9999,0
1668521141157,CSE 293,002,119118,Bellare; Mihir,9999,0,9999,0
1668521141157,CSE 293,003,119122,Berg-Kirkpatrick; Taylor D,9999,0,9999,0
1668521141157,CSE 293,004,119135,Christensen; Henrik I,9999,0,9999,0
1668521141157,CSE 293,005,119142,Cottrell; Garrison W,9999,0,9999,0
1668521141157,CSE 293,006,119146,Deutsch; Alin Bernard,9999,0,9999,0
1668521141157,CSE 293,007,119159,Esmaeilzadeh; Hadi,9999,0,9999,0
1668521141157,CSE 293,008,119166,Freund; Yoav,9999,0,9999,0
1668521141157,CSE 293,009,119170,Griswold; William G.,9999,0,9999,0
1668521141157,CSE 293,010,119183,Gymrek; Melissa Ann,9999,0,9999,0
1668521141157,CSE 293,011,119190,Heninger; Nadia A,9999,0,9999,0
1668521141157,CSE 293,012,119230,Impagliazzo; Russell,9999,0,9999,0
1668521141157,CSE 293,013,119232,Jhala; Ranjit,9999,0,9999,0
1668521141157,CSE 293,014,119233,Kahng; Andrew Byun,9999,0,9999,0
1668521141157,CSE 293,015,119298,Kane; Daniel Mertz,9999,0,9999,0
1668521141157,CSE 293,016,119299,Kriegman; David J,9999,0,9999,0
1668521141157,CSE 293,017,119300,Kumar; Arun Kumar,9999,0,9999,0
1668521141157,CSE 293,018,119301,Lerner; Sorin,9999,0,9999,0
1668521141157,CSE 293,019,119302,Lovett; Shachar,9999,0,9999,0
1668521141157,CSE 293,020,119303,McAuley; Julian John,9999,0,9999,0
1668521141157,CSE 293,021,119304,Micciancio; Daniele,9999,0,9999,0
1668521141157,CSE 293,022,119367,Orailoglu; Alex,9999,0,9999,0
1668521141157,CSE 293,023,119382,Paturi; Ramamohan,9999,0,9999,0
1668521141157,CSE 293,024,119404,Polikarpova; Nadezhda,9999,0,9999,0
1668521141157,CSE 293,025,119406,Politz; Joseph Gibbs,9999,0,9999,0
1668521141157,CSE 293,026,119411,Porter; George M,9999,0,9999,0
1668521141157,CSE 293,027,119414,Porter; Leonard Emerson,9999,0,9999,0
1668521141157,CSE 293,028,119416,Ramamoorthi; Ravi,9999,0,9999,0
1668521141157,CSE 293,029,119417,Sahoo; Debashis,9999,0,9999,0
1668521141157,CSE 293,030,119420,Saul; Lawrence,9999,0,9999,0
1668521141157,CSE 293,031,119421,Savage; Stefan,9999,0,9999,0
1668521141157,CSE 293,032,119425,Schulze; Jurgen P.,9999,0,9999,0
1668521141157,CSE 293,033,119426,Snoeren; Alex C.,9999,0,9999,0
1668521141157,CSE 293,034,119428,Shang; Jingbo,9999,0,9999,0
1668521141157,CSE 293,035,119430,Stefan; Deian,9999,0,9999,0
1668521141157,CSE 293,036,119431,Su; Hao,9999,0,9999,0
1668521141157,CSE 293,037,119433,Swanson; Steven James,9999,0,9999,0
1668521141157,CSE 293,038,119435,Tullsen; Dean Michael,9999,0,9999,0
1668521141157,CSE 293,039,119483,Voelker; Geoffrey M.,9999,0,9999,0
1668521141157,CSE 293,040,119537,Zhao; Jishen,9999,0,9999,0
1668521141157,CSE 293,041,119538,Zhou; Yuan-Yuan,9999,0,9999,0
1668521141157,CSE 293,042,119539,Gao; Sicun,9999,0,9999,0
1668521141157,CSE 293,043,119540,Weibel; Nadir,9999,0,9999,0
1668521141157,CSE 293,044,119541,Gupta; Rajesh K.,9999,0,9999,0
1668521141157,CSE 293,045,126410,Vaccaro; Kristen Marie,9999,0,9999,0
1668521141157,CSE 293,046,126411,Klemke; Richard,9999,0,9999,0
1668521141581,CSE 294,A00,102459,Voelker; Geoffrey M.,0,2,0,0
1668521141581,CSE 294,B00,111322,Orailoglu; Alex,0,2,0,0
1668521142012,DSE 201,A00,096914,Deutsch; Alin Bernard,30,0,30,0
1668521142442,DSE 210,A00,096915,Dasgupta; Sanjoy,30,0,30,0
1668521142875,DSE 260A,A00,096916,Altintas De Callaf; Ilkay,30,0,30,0
1668521143321,ECE 200,001,103586,Antipa; Nicholas A,9999,0,9999,0
1668521143321,ECE 200,002,103587,Atanasov; Nikolay A.,9999,0,9999,0
1668521143321,ECE 200,003,103588,Bharadia; Dinesh,9999,0,9999,0
1668521143321,ECE 200,004,103589,Cheng; Chung Kuan,9999,0,9999,0
1668521143321,ECE 200,005,103590,Cosman; Pamela C.,9999,0,9999,0
1668521143321,ECE 200,006,103591,Dayeh; Shadi Ahmad,9999,0,9999,0
1668521143321,ECE 200,007,103592,Fainman; Yeshaiahu,9999,0,9999,0
1668521143321,ECE 200,008,103593,Ford; Joseph Earl,9999,0,9999,0
1668521143321,ECE 200,009,103594,Franceschetti; Massimo,9999,0,9999,0
1668521143321,ECE 200,010,103595,Fullerton; Eric E,9999,0,9999,0
1668521143321,ECE 200,011,103596,Galton; Ian A,9999,0,9999,0
1668521143321,ECE 200,012,103597,Gilja; Vikash,9999,0,9999,0
1668521143321,ECE 200,013,103598,Hall; Drew A.,9999,0,9999,0
1668521143321,ECE 200,014,103599,Hsueh; Tzu-Chien,9999,0,9999,0
1668521143321,ECE 200,015,103600,Javidi; Tara,9999,0,9999,0
1668521143321,ECE 200,016,103601,Kahng; Andrew Byun,9999,0,9999,0
1668521143321,ECE 200,017,103602,Kim; Young-Han,9999,0,9999,0
1668521143321,ECE 200,018,103603,Koushanfar; Farinaz,9999,0,9999,0
1668521143321,ECE 200,019,103604,Kuzum; Duygu,9999,0,9999,0
1668521143321,ECE 200,020,103605,Le; Hanh-Phuc,9999,0,9999,0
1668521143321,ECE 200,021,103606,Lin; Bill,9999,0,9999,0
1668521143321,ECE 200,022,103607,Liu; Zhaowei,9998,0,9999,1
1668521143321,ECE 200,023,103608,Lo; Yu-Hwa,9999,0,9999,0
1668521143321,ECE 200,024,103609,Lomakin; Vitaliy,9999,0,9999,0
1668521143321,ECE 200,025,103610,Mercier; Patrick Philip,9999,0,9999,0
1668521143321,ECE 200,026,103611,Meyer; Florian,9999,0,9999,0
1668521143321,ECE 200,027,103612,Milstein; Laurence B.,9999,0,9999,0
1668521143321,ECE 200,028,103613,Mir Arabbaygi; Siavash,9999,0,9999,0
1668521143321,ECE 200,029,103614,Mookherjea; Shayan,9999,0,9999,0
1668521143321,ECE 200,030,103615,Morris; Karcher William,9999,0,9999,0
1668521143321,ECE 200,031,103616,Ng; Tse Nga,9999,0,9999,0
1668521143321,ECE 200,032,103617,Nguyen; Truong Quang,9999,0,9999,0
1668521143321,ECE 200,033,103618,Nomura; Kenji,9999,0,9999,0
1668521143321,ECE 200,034,103619,Orlitsky; Alon,9999,0,9999,0
1668521143321,ECE 200,035,103620,Pal; Piya,9999,0,9999,0
1668521143321,ECE 200,036,103621,Papen; George C.,9999,0,9999,0
1668521143321,ECE 200,037,103622,Radic; Stojan,9999,0,9999,0
1668521143321,ECE 200,038,103623,Rao; Bhaskar D.,9999,0,9999,0
1668521143321,ECE 200,039,103624,Rao; Ramesh R,9999,0,9999,0
1668521143321,ECE 200,040,103625,Rebeiz; Gabriel,9999,0,9999,0
1668521143321,ECE 200,041,103626,Sanford; John R,9999,0,9999,0
1668521143321,ECE 200,042,103627,Siegel; Paul H.,9999,0,9999,0
1668521143321,ECE 200,043,103628,Sievenpiper; Daniel F.,9999,0,9999,0
1668521143321,ECE 200,044,103629,Sworder; David D.,9999,0,9999,0
1668521143321,ECE 200,045,103630,Taur; Yuan,9999,0,9999,0
1668521143321,ECE 200,046,103631,Touri; Behrouz,9999,0,9999,0
1668521143321,ECE 200,047,103632,Trivedi; Mohan M.,9999,0,9999,0
1668521143321,ECE 200,048,103633,Vasconcelos; Nuno,9999,0,9999,0
1668521143321,ECE 200,049,103634,Wang; Xiaolong,9999,0,9999,0
1668521143321,ECE 200,050,103635,Xie; Pengtao,9999,0,9999,0
1668521143321,ECE 200,051,103636,Yip; Michael,9999,0,9999,0
1668521143321,ECE 200,052,103637,Zeger; Kenneth A.,999,0,999,0
1668521143321,ECE 200,053,103638,Zhang; Xinyu,9999,0,9999,0
1668521143321,ECE 200,054,103639,Turakhia; Yatish Girish,9999,0,9999,0
1668521143321,ECE 200,055,103640,Kang; Mingu,9999,0,9999,0
1668521143321,ECE 200,056,103641,Shi; Yuanyuan,9999,0,9999,0
1668521143321,ECE 200,057,103642,Wang; Edward Jay,9999,0,9999,0
1668521143321,ECE 200,058,103643,Zheng; Yang,9999,0,9999,0
1668521143758,ECE 202,A00,103644,Kuzum; Duygu,0,44,0,0
1668521144192,ECE 212BN,A00,103646,Ng; Tse Nga,0,9,0,0
1668521144629,ECE 221,A00,111493,Staff,0,0,0,0
1668521145053,ECE 222B,A00,103647,Lomakin; Vitaliy,0,20,0,0
1668521145483,ECE 230B,A00,103648,Taur; Yuan,0,3,0,0
1668521145908,ECE 238B,A00,103649,Garay; Javier,0,0,0,0
1668521146333,ECE 240B,A00,112900,Fainman; Yeshaiahu,0,7,0,0
1668521146763,ECE 247A,A00,103650,Jokerst; Jesse Vincent,0,6,0,0
1668521147198,ECE 247B,A00,103651,Wang; Joseph,0,14,0,0
1668521147631,ECE 250,A00,103652,Siegel; Paul H.,0,82,0,0
1668521148056,ECE 251A,A00,103654,Rao; Bhaskar D.,0,62,0,0
1668521148487,ECE 257B,A00,103655,Bharadia; Dinesh,0,33,0,0
1668521148912,ECE 258A,A00,103656,Milstein; Laurence B.,0,29,0,0
1668521149339,ECE 260B,A00,103658,Kang; Mingu,0,119,0,0
1668521149777,ECE 264A,A00,103659,Galton; Ian A,0,66,0,0
1668521150212,ECE 265A,A00,103661,Gudem; Prasad S.S.,0,70,0,0
1668521150642,ECE 265D,A00,103662,Gudem; Prasad S.S.,0,26,0,0
1668521151072,ECE 268,A00,103663,Koushanfar; Farinaz,0,43,0,0
1668521151505,ECE 269,A01,103665,Pal; Piya,0,215,0,0
1668521151934,ECE 271B,A00,103666,Vasconcelos; Manuela,0,76,0,0
1668521152368,ECE 276A,A00,103667,Atanasov; Nikolay A.,0,126,0,0
1668521152794,ECE 277,A00,103668,An; Cheolhong,0,149,0,0
1668521153221,ECE 279,A00,117947,Hall; Drew A.,0,22,0,0
1668521154076,ECE 283,A00,103670,Hsueh; Tzu-Chien,0,53,0,0
1668521154505,ECE 284,A00,103671,Turakhia; Yatish Girish,0,39,0,0
1668521154936,ECE 285,A00,103672,Zheng; Yang,0,39,0,0
1668521154936,ECE 285,B00,103673,Sworder; David D.,0,57,0,0
1668521155364,ECE 287,A00,103676,Javidi; Tara,0,9,0,0
1668521155794,MATH 200B,A00,098023,Salehi Golsefidy; Alireza,10,0,15,5
1668521156218,MATH 202B,A00,098024,Rhoades; Brendon Patrick,7,0,15,8
1668521156651,MATH 203B,A00,098025,Oprea; Dragos N.,9,0,15,6
1668521157076,MATH 204B,A00,098026,Sorensen; Claus M,13,0,15,2
1668521157501,MATH 208,A00,098027,Izadi; Elham,7,0,10,3
1668521157925,MATH 209,A00,098028,Pollack; Aaron,10,0,10,0
1668521158354,MATH 211A,A00,112919,Rogalski; Daniel,8,0,10,2
1668521158780,MATH 211B,A00,112920,Seward; Brandon M.,9,0,10,1
1668521159207,MATH 218,A00,098029,Li; Bo,10,0,10,0
1668521159636,MATH 220B,A00,098030,Novak; Jonathan I,11,0,15,4
1668521160071,MATH 221A,A00,098031,Ebenfelt; Peter F,12,0,15,3
1668521160521,MATH 231B,A00,098032,Zlatos; Andrej,11,0,15,4
1668521160946,MATH 240B,A00,098033,Ni; Lei,7,0,15,8
1668521161371,MATH 243,A00,098034,Jekel; David Andrew,10,0,10,0
1668521161796,MATH 245A,A00,098035,Nie; Jiawang,0,4,15,18
1668521162236,MATH 248,A00,098036,Bejenaru; Ioan,10,0,10,0
1668521162661,MATH 250B,A00,098037,Spolaor; Luca,14,0,15,1
1668521163102,MATH 258,A00,098038,Ni; Lei,9,0,10,1
1668521163556,MATH 264B,A00,098041,Rhoades; Brendon Patrick,8,0,15,7
1668521163998,MATH 268,A00,098042,Buss; Samuel R,10,0,10,0
1668521164424,MATH 269,A00,098043,Rhoades; Brendon Patrick,10,0,10,0
1668521164855,MATH 270B,A00,098044,Li; Bo,6,0,15,9
1668521165281,MATH 272B,A00,098045,Holst; Michael J,13,0,15,2
1668521165708,MATH 273A,A00,098046,Tian; Xiaochuan,10,0,15,5
1668521166131,MATH 275,A01,098048,Tian; Xiaochuan,6,0,10,4
1668521166559,MATH 278A,A00,098049,Holst; Michael J,7,0,10,3
1668521166985,MATH 278B,A00,098050,Cloninger; Alexander,10,0,10,0
1668521167411,MATH 278C,A00,098051,Nie; Jiawang,5,0,10,5
1668521167928,MATH 280B,A00,098052,Zheng; Tianyi,7,0,15,8
1668521168356,MATH 281B,A00,098053,Bradic; Jelena,0,2,15,15
1668521168786,MATH 282B,A00,098054,Arias-Castro; Ery,0,1,15,15
1668521169216,MATH 285,A00,098055,Fitzsimmons; Patrick J,0,3,15,17
1668521169640,MATH 287B,A00,098056,Arias-Castro; Ery,1,0,15,14
1668521170070,MATH 288,A00,098057,Agarwal; Pooja,9,0,10,1
1668521170070,MATH 288,B00,098058,Zhang; Danna,8,0,10,2
1668521170070,MATH 288,C00,098059,Williams; Ruth J,9,0,10,1
1668521170497,MATH 290B,A00,098060,Roberts; Justin Deritter,12,0,15,3
1668521170929,MATH 292,A00,098061,Belmont; Eva Kinoshita,10,0,10,0
1668521171354,MATH 295,A00,098062,Suk; Andrew Hoon,47,0,50,3
1668521171793,MATH 296,A00,098063,Novak; Jonathan I,20,0,20,0
1668521172218,MATH 297,001,098064,Gamst; Anthony Collins,9997,0,9999,2
1668521676290,COGS 205,A00,101395,Chiba; Andrea,19,0,20,1
1668521676724,COGS 210B,001,101404,Greene; Deanna Jacquelyn,9998,0,9999,1
1668521676724,COGS 210B,002,101417,Xia; Haijun,9999,0,9999,0
1668521676724,COGS 210B,003,101422,Nitz; Douglas A.,9999,0,9999,0
1668521676724,COGS 210B,004,101423,Hollan; James D.,9998,0,9999,1
1668521676724,COGS 210B,005,101424,Deak; Gedeon O.,9998,0,9999,1
1668521676724,COGS 210B,006,101425,Rossano; Federico,9999,0,9999,0
1668521677158,COGS 211B,A00,101427,Coulson; Seana M,9996,0,9999,3
1668521677584,COGS 220,A00,101428,Hollan; James D.,0,10,25,25
1668521678011,COGS 229,A00,101429,Dow; Steven P,17,0,25,8
1668521678435,COGS 230,A00,101430,Klemmer; Scott R,7,0,17,10
1668521678862,COGS 234,A00,101431,Xia; Haijun,1,0,25,24
1668521679287,COGS 260,A00,101432,Kiyonaga; Anastasia,21,0,25,4
1668521679287,COGS 260,B00,101433,Kirsh; David Joel,15,0,25,10
1668521679717,CSE 202,A00,102371,Impagliazzo; Russell,0,66,0,0
1668521680150,CSE 203B,A01,102373,Cheng; Chung Kuan,0,58,0,0
1668521680575,CSE 208,A00,102374,Micciancio; Daniele,0,5,0,0
1668521681001,CSE 209A,A00,112895,Impagliazzo; Russell,0,12,15,15
1668521681425,CSE 209B,A00,108005,Bellare; Mihir,0,7,0,0
1668521681855,CSE 210,A00,113163,Coblenz; Michael J,0,85,0,0
1668521682283,CSE 219,A00,106111,Dow; Steven P,0,6,20,20
1668521682718,CSE 221,A00,102376,Voelker; Geoffrey M.,0,73,0,0
1668521683153,CSE 224,A01,102378,Porter; George M,0,166,0,0
1668521683591,CSE 229A,A00,102379,Savage; Stefan,0,10,0,0
1668521684020,CSE 229C,A00,102380,Munyaka; Imani N. S.,0,10,0,0
1668521684448,CSE 232B,A00,102382,Deutsch; Alin Bernard,0,32,0,0
1668521684872,CSE 234,A01,112904,Kumar; Arun Kumar,0,0,0,0
1668521685297,CSE 237A,A00,102383,Rosing; Tajana Simunic,0,55,0,0
1668521685723,CSE 239A,A00,102384,Deutsch; Alin Bernard,0,14,0,0
1668521686147,CSE 239B,A00,102385,Polikarpova; Nadezhda,0,10,0,0
1668521686576,CSE 240A,A00,102386,Pannuto; Patrick William,0,46,0,0
1668521687000,CSE 240B,A00,102387,Zhao; Jishen,0,47,0,0
1668521687431,CSE 241A,A00,106406,Kang; Mingu,0,9,0,0
1668521687874,CSE 249B,A00,102388,Kahng; Andrew Byun,0,5,8,8
1668521688306,CSE 251B,A01,102392,Cottrell; Garrison W,0,51,0,0
1668521688306,CSE 251B,A02,102393,Cottrell; Garrison W,0,34,0,0
1668521688730,CSE 252B,A00,102394,Ochoa; Benjamin Lawrence,0,59,0,0
1668521689155,CSE 257,A01,102396,Gao; Sicun,0,139,0,0
1668521689581,CSE 272,A00,102397,Li; Tzumao,0,19,0,0
1668521690008,CSE 274,A00,111323,Chern; Albert Ren-Haur,0,15,0,0
1668521690434,CSE 282,A00,102398,Pevzner; Pavel Arkadjevich,0,0,0,0
1668521690959,CSE 284,A00,114175,Gymrek; Melissa Ann,0,22,0,0
1668521691385,CSE 290,A00,102399,Chandraker; Manmohan Krishna,0,11,0,0
1668521691385,CSE 290,B00,102400,Vaccaro; Kristen Marie,0,7,25,25
1668521691385,CSE 290,C00,102414,Pannuto; Patrick William,0,1,25,25
1668521691385,CSE 290,D00,102427,Pevzner; Pavel Arkadjevich,0,0,0,0
1668521691385,CSE 290,E00,102429,Zhao; Jishen,0,4,0,0
1668521691385,CSE 290,F00,102436,Tullsen; Dean Michael,0,5,0,0
1668521691385,CSE 290,G00,102440,Christensen; Henrik I,0,6,20,20
1668521691810,CSE 291,A00,102443,Su; Hao,0,0,0,0
1668521691810,CSE 291,B00,102448,Polikarpova; Nadezhda,0,0,0,0
1668521691810,CSE 291,C00,102453,Vaccaro; Kristen Marie,0,0,0,0
1668521691810,CSE 291,D00,111343,Savage; Stefan,0,0,0,0
1668521691810,CSE 291,E00,116474,Claffy; Kimberly Claire,0,0,0,0
1668521691810,CSE 291,F00,116479,Pasquale; Joseph,0,0,0,0
1668521692251,CSE 293,001,119111,Bafna; Vineet,9999,0,9999,0
1668521692251,CSE 293,002,119118,Bellare; Mihir,9999,0,9999,0
1668521692251,CSE 293,003,119122,Berg-Kirkpatrick; Taylor D,9999,0,9999,0
1668521692251,CSE 293,004,119135,Christensen; Henrik I,9999,0,9999,0
1668521692251,CSE 293,005,119142,Cottrell; Garrison W,9999,0,9999,0
1668521692251,CSE 293,006,119146,Deutsch; Alin Bernard,9999,0,9999,0
1668521692251,CSE 293,007,119159,Esmaeilzadeh; Hadi,9999,0,9999,0
1668521692251,CSE 293,008,119166,Freund; Yoav,9999,0,9999,0
1668521692251,CSE 293,009,119170,Griswold; William G.,9999,0,9999,0
1668521692251,CSE 293,010,119183,Gymrek; Melissa Ann,9999,0,9999,0
1668521692251,CSE 293,011,119190,Heninger; Nadia A,9999,0,9999,0
1668521692251,CSE 293,012,119230,Impagliazzo; Russell,9999,0,9999,0
1668521692251,CSE 293,013,119232,Jhala; Ranjit,9999,0,9999,0
1668521692251,CSE 293,014,119233,Kahng; Andrew Byun,9999,0,9999,0
1668521692251,CSE 293,015,119298,Kane; Daniel Mertz,9999,0,9999,0
1668521692251,CSE 293,016,119299,Kriegman; David J,9999,0,9999,0
1668521692251,CSE 293,017,119300,Kumar; Arun Kumar,9999,0,9999,0
1668521692251,CSE 293,018,119301,Lerner; Sorin,9999,0,9999,0
1668521692251,CSE 293,019,119302,Lovett; Shachar,9999,0,9999,0
1668521692251,CSE 293,020,119303,McAuley; Julian John,9999,0,9999,0
1668521692251,CSE 293,021,119304,Micciancio; Daniele,9999,0,9999,0
1668521692251,CSE 293,022,119367,Orailoglu; Alex,9999,0,9999,0
1668521692251,CSE 293,023,119382,Paturi; Ramamohan,9999,0,9999,0
1668521692251,CSE 293,024,119404,Polikarpova; Nadezhda,9999,0,9999,0
1668521692251,CSE 293,025,119406,Politz; Joseph Gibbs,9999,0,9999,0
1668521692251,CSE 293,026,119411,Porter; George M,9999,0,9999,0
1668521692251,CSE 293,027,119414,Porter; Leonard Emerson,9999,0,9999,0
1668521692251,CSE 293,028,119416,Ramamoorthi; Ravi,9999,0,9999,0
1668521692251,CSE 293,029,119417,Sahoo; Debashis,9999,0,9999,0
1668521692251,CSE 293,030,119420,Saul; Lawrence,9999,0,9999,0
1668521692251,CSE 293,031,119421,Savage; Stefan,9999,0,9999,0
1668521692251,CSE 293,032,119425,Schulze; Jurgen P.,9999,0,9999,0
1668521692251,CSE 293,033,119426,Snoeren; Alex C.,9999,0,9999,0
1668521692251,CSE 293,034,119428,Shang; Jingbo,9999,0,9999,0
1668521692251,CSE 293,035,119430,Stefan; Deian,9999,0,9999,0
1668521692251,CSE 293,036,119431,Su; Hao,9999,0,9999,0
1668521692251,CSE 293,037,119433,Swanson; Steven James,9999,0,9999,0
1668521692251,CSE 293,038,119435,Tullsen; Dean Michael,9999,0,9999,0
1668521692251,CSE 293,039,119483,Voelker; Geoffrey M.,9999,0,9999,0
1668521692251,CSE 293,040,119537,Zhao; Jishen,9999,0,9999,0
1668521692251,CSE 293,041,119538,Zhou; Yuan-Yuan,9999,0,9999,0
1668521692251,CSE 293,042,119539,Gao; Sicun,9999,0,9999,0
1668521692251,CSE 293,043,119540,Weibel; Nadir,9999,0,9999,0
1668521692251,CSE 293,044,119541,Gupta; Rajesh K.,9999,0,9999,0
1668521692251,CSE 293,045,126410,Vaccaro; Kristen Marie,9999,0,9999,0
1668521692251,CSE 293,046,126411,Klemke; Richard,9999,0,9999,0
1668521692678,CSE 294,A00,102459,Voelker; Geoffrey M.,0,2,0,0
1668521692678,CSE 294,B00,111322,Orailoglu; Alex,0,2,0,0
1668521693102,DSE 201,A00,096914,Deutsch; Alin Bernard,30,0,30,0
1668521693528,DSE 210,A00,096915,Dasgupta; Sanjoy,30,0,30,0
1668521693955,DSE 260A,A00,096916,Altintas De Callaf; Ilkay,30,0,30,0
1668521694464,ECE 200,001,103586,Antipa; Nicholas A,9999,0,9999,0
1668521694464,ECE 200,002,103587,Atanasov; Nikolay A.,9999,0,9999,0
1668521694464,ECE 200,003,103588,Bharadia; Dinesh,9999,0,9999,0
1668521694464,ECE 200,004,103589,Cheng; Chung Kuan,9999,0,9999,0
1668521694464,ECE 200,005,103590,Cosman; Pamela C.,9999,0,9999,0
1668521694464,ECE 200,006,103591,Dayeh; Shadi Ahmad,9999,0,9999,0
1668521694464,ECE 200,007,103592,Fainman; Yeshaiahu,9999,0,9999,0
1668521694464,ECE 200,008,103593,Ford; Joseph Earl,9999,0,9999,0
1668521694464,ECE 200,009,103594,Franceschetti; Massimo,9999,0,9999,0
1668521694464,ECE 200,010,103595,Fullerton; Eric E,9999,0,9999,0
1668521694464,ECE 200,011,103596,Galton; Ian A,9999,0,9999,0
1668521694464,ECE 200,012,103597,Gilja; Vikash,9999,0,9999,0
1668521694464,ECE 200,013,103598,Hall; Drew A.,9999,0,9999,0
1668521694464,ECE 200,014,103599,Hsueh; Tzu-Chien,9999,0,9999,0
1668521694464,ECE 200,015,103600,Javidi; Tara,9999,0,9999,0
1668521694464,ECE 200,016,103601,Kahng; Andrew Byun,9999,0,9999,0
1668521694464,ECE 200,017,103602,Kim; Young-Han,9999,0,9999,0
1668521694464,ECE 200,018,103603,Koushanfar; Farinaz,9999,0,9999,0
1668521694464,ECE 200,019,103604,Kuzum; Duygu,9999,0,9999,0
1668521694464,ECE 200,020,103605,Le; Hanh-Phuc,9999,0,9999,0
1668521694464,ECE 200,021,103606,Lin; Bill,9999,0,9999,0
1668521694464,ECE 200,022,103607,Liu; Zhaowei,9998,0,9999,1
1668521694464,ECE 200,023,103608,Lo; Yu-Hwa,9999,0,9999,0
1668521694464,ECE 200,024,103609,Lomakin; Vitaliy,9999,0,9999,0
1668521694464,ECE 200,025,103610,Mercier; Patrick Philip,9999,0,9999,0
1668521694464,ECE 200,026,103611,Meyer; Florian,9999,0,9999,0
1668521694464,ECE 200,027,103612,Milstein; Laurence B.,9999,0,9999,0
1668521694464,ECE 200,028,103613,Mir Arabbaygi; Siavash,9999,0,9999,0
1668521694464,ECE 200,029,103614,Mookherjea; Shayan,9999,0,9999,0
1668521694464,ECE 200,030,103615,Morris; Karcher William,9999,0,9999,0
1668521694464,ECE 200,031,103616,Ng; Tse Nga,9999,0,9999,0
1668521694464,ECE 200,032,103617,Nguyen; Truong Quang,9999,0,9999,0
1668521694464,ECE 200,033,103618,Nomura; Kenji,9999,0,9999,0
1668521694464,ECE 200,034,103619,Orlitsky; Alon,9999,0,9999,0
1668521694464,ECE 200,035,103620,Pal; Piya,9999,0,9999,0
1668521694464,ECE 200,036,103621,Papen; George C.,9999,0,9999,0
1668521694464,ECE 200,037,103622,Radic; Stojan,9999,0,9999,0
1668521694464,ECE 200,038,103623,Rao; Bhaskar D.,9999,0,9999,0
1668521694464,ECE 200,039,103624,Rao; Ramesh R,9999,0,9999,0
1668521694464,ECE 200,040,103625,Rebeiz; Gabriel,9999,0,9999,0
1668521694464,ECE 200,041,103626,Sanford; John R,9999,0,9999,0
1668521694464,ECE 200,042,103627,Siegel; Paul H.,9999,0,9999,0
1668521694464,ECE 200,043,103628,Sievenpiper; Daniel F.,9999,0,9999,0
1668521694464,ECE 200,044,103629,Sworder; David D.,9999,0,9999,0
1668521694464,ECE 200,045,103630,Taur; Yuan,9999,0,9999,0
1668521694464,ECE 200,046,103631,Touri; Behrouz,9999,0,9999,0
1668521694464,ECE 200,047,103632,Trivedi; Mohan M.,9999,0,9999,0
1668521694464,ECE 200,048,103633,Vasconcelos; Nuno,9999,0,9999,0
1668521694464,ECE 200,049,103634,Wang; Xiaolong,9999,0,9999,0
1668521694464,ECE 200,050,103635,Xie; Pengtao,9999,0,9999,0
1668521694464,ECE 200,051,103636,Yip; Michael,9999,0,9999,0
1668521694464,ECE 200,052,103637,Zeger; Kenneth A.,999,0,999,0
1668521694464,ECE 200,053,103638,Zhang; Xinyu,9999,0,9999,0
1668521694464,ECE 200,054,103639,Turakhia; Yatish Girish,9999,0,9999,0
1668521694464,ECE 200,055,103640,Kang; Mingu,9999,0,9999,0
1668521694464,ECE 200,056,103641,Shi; Yuanyuan,9999,0,9999,0
1668521694464,ECE 200,057,103642,Wang; Edward Jay,9999,0,9999,0
1668521694464,ECE 200,058,103643,Zheng; Yang,9999,0,9999,0
1668521694891,ECE 202,A00,103644,Kuzum; Duygu,0,44,0,0
1668521695320,ECE 212BN,A00,103646,Ng; Tse Nga,0,9,0,0
1668521695747,ECE 221,A00,111493,Staff,0,0,0,0
1668521696173,ECE 222B,A00,103647,Lomakin; Vitaliy,0,20,0,0
1668521696617,ECE 230B,A00,103648,Taur; Yuan,0,3,0,0
1668521697043,ECE 238B,A00,103649,Garay; Javier,0,0,0,0
1668521697485,ECE 240B,A00,112900,Fainman; Yeshaiahu,0,7,0,0
1668521697909,ECE 247A,A00,103650,Jokerst; Jesse Vincent,0,6,0,0
1668521698340,ECE 247B,A00,103651,Wang; Joseph,0,14,0,0
1668521698766,ECE 250,A00,103652,Siegel; Paul H.,0,82,0,0
1668521699189,ECE 251A,A00,103654,Rao; Bhaskar D.,0,62,0,0
1668521699626,ECE 257B,A00,103655,Bharadia; Dinesh,0,33,0,0
1668521700055,ECE 258A,A00,103656,Milstein; Laurence B.,0,29,0,0
1668521700484,ECE 260B,A00,103658,Kang; Mingu,0,119,0,0
1668521700917,ECE 264A,A00,103659,Galton; Ian A,0,66,0,0
1668521701345,ECE 265A,A00,103661,Gudem; Prasad S.S.,0,70,0,0
1668521701782,ECE 265D,A00,103662,Gudem; Prasad S.S.,0,26,0,0
1668521702221,ECE 268,A00,103663,Koushanfar; Farinaz,0,43,0,0
1668521702644,ECE 269,A01,103665,Pal; Piya,0,215,0,0
1668521703069,ECE 271B,A00,103666,Vasconcelos; Manuela,0,76,0,0
1668521703494,ECE 276A,A00,103667,Atanasov; Nikolay A.,0,126,0,0
1668521703919,ECE 277,A00,103668,An; Cheolhong,0,149,0,0
1668521704346,ECE 279,A00,117947,Hall; Drew A.,0,22,0,0
1668521705192,ECE 283,A00,103670,Hsueh; Tzu-Chien,0,53,0,0
1668521705617,ECE 284,A00,103671,Turakhia; Yatish Girish,0,39,0,0
1668521706041,ECE 285,A00,103672,Zheng; Yang,0,39,0,0
1668521706041,ECE 285,B00,103673,Sworder; David D.,0,57,0,0
1668521706467,ECE 287,A00,103676,Javidi; Tara,0,9,0,0
1668521706893,MATH 200B,A00,098023,Salehi Golsefidy; Alireza,10,0,15,5
1668521707316,MATH 202B,A00,098024,Rhoades; Brendon Patrick,7,0,15,8
1668521707743,MATH 203B,A00,098025,Oprea; Dragos N.,9,0,15,6
1668521708171,MATH 204B,A00,098026,Sorensen; Claus M,13,0,15,2
1668521708599,MATH 208,A00,098027,Izadi; Elham,7,0,10,3
1668521709023,MATH 209,A00,098028,Pollack; Aaron,10,0,10,0
1668521709450,MATH 211A,A00,112919,Rogalski; Daniel,8,0,10,2
1668521709876,MATH 211B,A00,112920,Seward; Brandon M.,9,0,10,1
1668521710301,MATH 218,A00,098029,Li; Bo,10,0,10,0
1668521710734,MATH 220B,A00,098030,Novak; Jonathan I,11,0,15,4
1668521711174,MATH 221A,A00,098031,Ebenfelt; Peter F,12,0,15,3
1668521711621,MATH 231B,A00,098032,Zlatos; Andrej,11,0,15,4
1668521712058,MATH 240B,A00,098033,Ni; Lei,7,0,15,8
1668521712483,MATH 243,A00,098034,Jekel; David Andrew,10,0,10,0
1668521712909,MATH 245A,A00,098035,Nie; Jiawang,0,4,15,18
1668521713338,MATH 248,A00,098036,Bejenaru; Ioan,10,0,10,0
1668521713762,MATH 250B,A00,098037,Spolaor; Luca,14,0,15,1
1668521714187,MATH 258,A00,098038,Ni; Lei,9,0,10,1
1668521714611,MATH 264B,A00,098041,Rhoades; Brendon Patrick,8,0,15,7
1668521715036,MATH 268,A00,098042,Buss; Samuel R,10,0,10,0
1668521715466,MATH 269,A00,098043,Rhoades; Brendon Patrick,10,0,10,0
1668521715894,MATH 270B,A00,098044,Li; Bo,6,0,15,9
1668521716327,MATH 272B,A00,098045,Holst; Michael J,13,0,15,2
1668521716764,MATH 273A,A00,098046,Tian; Xiaochuan,10,0,15,5
1668521717194,MATH 275,A01,098048,Tian; Xiaochuan,6,0,10,4
1668521717618,MATH 278A,A00,098049,Holst; Michael J,7,0,10,3
1668521718044,MATH 278B,A00,098050,Cloninger; Alexander,10,0,10,0
1668521718467,MATH 278C,A00,098051,Nie; Jiawang,5,0,10,5
1668521718893,MATH 280B,A00,098052,Zheng; Tianyi,7,0,15,8
1668521719322,MATH 281B,A00,098053,Bradic; Jelena,0,2,15,15
1668521719746,MATH 282B,A00,098054,Arias-Castro; Ery,0,1,15,15
1668521720173,MATH 285,A00,098055,Fitzsimmons; Patrick J,0,3,15,17
1668521720597,MATH 287B,A00,098056,Arias-Castro; Ery,1,0,15,14
1668521721025,MATH 288,A00,098057,Agarwal; Pooja,9,0,10,1
1668521721025,MATH 288,B00,098058,Zhang; Danna,8,0,10,2
1668521721025,MATH 288,C00,098059,Williams; Ruth J,9,0,10,1
1668521721453,MATH 290B,A00,098060,Roberts; Justin Deritter,12,0,15,3
1668521721878,MATH 292,A00,098061,Belmont; Eva Kinoshita,10,0,10,0
1668521722302,MATH 295,A00,098062,Suk; Andrew Hoon,47,0,50,3
1668521722728,MATH 296,A00,098063,Novak; Jonathan I,20,0,20,0
1668521723154,MATH 297,001,098064,Gamst; Anthony Collins,9997,0,9999,2
1668522227074,COGS 205,A00,101395,Chiba; Andrea,19,0,20,1
1668522227502,COGS 210B,001,101404,Greene; Deanna Jacquelyn,9998,0,9999,1
1668522227502,COGS 210B,002,101417,Xia; Haijun,9999,0,9999,0
1668522227502,COGS 210B,003,101422,Nitz; Douglas A.,9999,0,9999,0
1668522227502,COGS 210B,004,101423,Hollan; James D.,9998,0,9999,1
1668522227502,COGS 210B,005,101424,Deak; Gedeon O.,9998,0,9999,1
1668522227502,COGS 210B,006,101425,Rossano; Federico,9999,0,9999,0
1668522227926,COGS 211B,A00,101427,Coulson; Seana M,9996,0,9999,3
1668522228350,COGS 220,A00,101428,Hollan; James D.,0,10,25,25
1668522228774,COGS 229,A00,101429,Dow; Steven P,17,0,25,8
1668522229204,COGS 230,A00,101430,Klemmer; Scott R,7,0,17,10
1668522229630,COGS 234,A00,101431,Xia; Haijun,1,0,25,24
1668522230054,COGS 260,A00,101432,Kiyonaga; Anastasia,21,0,25,4
1668522230054,COGS 260,B00,101433,Kirsh; David Joel,15,0,25,10
1668522230483,CSE 202,A00,102371,Impagliazzo; Russell,0,66,0,0
1668522230905,CSE 203B,A01,102373,Cheng; Chung Kuan,0,58,0,0
1668522231330,CSE 208,A00,102374,Micciancio; Daniele,0,5,0,0
1668522231753,CSE 209A,A00,112895,Impagliazzo; Russell,0,12,15,15
1668522232187,CSE 209B,A00,108005,Bellare; Mihir,0,7,0,0
1668522232614,CSE 210,A00,113163,Coblenz; Michael J,0,85,0,0
1668522233041,CSE 219,A00,106111,Dow; Steven P,0,6,20,20
1668522233477,CSE 221,A00,102376,Voelker; Geoffrey M.,0,73,0,0
1668522233898,CSE 224,A01,102378,Porter; George M,0,166,0,0
1668522234329,CSE 229A,A00,102379,Savage; Stefan,0,10,0,0
1668522234767,CSE 229C,A00,102380,Munyaka; Imani N. S.,0,10,0,0
1668522235190,CSE 232B,A00,102382,Deutsch; Alin Bernard,0,32,0,0
1668522235614,CSE 234,A01,112904,Kumar; Arun Kumar,0,0,0,0
1668522236040,CSE 237A,A00,102383,Rosing; Tajana Simunic,0,55,0,0
1668522236464,CSE 239A,A00,102384,Deutsch; Alin Bernard,0,14,0,0
1668522236887,CSE 239B,A00,102385,Polikarpova; Nadezhda,0,10,0,0
1668522237315,CSE 240A,A00,102386,Pannuto; Patrick William,0,46,0,0
1668522237749,CSE 240B,A00,102387,Zhao; Jishen,0,47,0,0
1668522238179,CSE 241A,A00,106406,Kang; Mingu,0,9,0,0
1668522238612,CSE 249B,A00,102388,Kahng; Andrew Byun,0,5,8,8
1668522239048,CSE 251B,A01,102392,Cottrell; Garrison W,0,51,0,0
1668522239048,CSE 251B,A02,102393,Cottrell; Garrison W,0,34,0,0
1668522239471,CSE 252B,A00,102394,Ochoa; Benjamin Lawrence,0,59,0,0
1668522239899,CSE 257,A01,102396,Gao; Sicun,0,139,0,0
1668522240330,CSE 272,A00,102397,Li; Tzumao,0,19,0,0
1668522240754,CSE 274,A00,111323,Chern; Albert Ren-Haur,0,15,0,0
1668522241180,CSE 282,A00,102398,Pevzner; Pavel Arkadjevich,0,0,0,0
1668522241605,CSE 284,A00,114175,Gymrek; Melissa Ann,0,22,0,0
1668522242033,CSE 290,A00,102399,Chandraker; Manmohan Krishna,0,11,0,0
1668522242033,CSE 290,B00,102400,Vaccaro; Kristen Marie,0,7,25,25
1668522242033,CSE 290,C00,102414,Pannuto; Patrick William,0,1,25,25
1668522242033,CSE 290,D00,102427,Pevzner; Pavel Arkadjevich,0,0,0,0
1668522242033,CSE 290,E00,102429,Zhao; Jishen,0,4,0,0
1668522242033,CSE 290,F00,102436,Tullsen; Dean Michael,0,5,0,0
1668522242033,CSE 290,G00,102440,Christensen; Henrik I,0,6,20,20
1668522242461,CSE 291,A00,102443,Su; Hao,0,0,0,0
1668522242461,CSE 291,B00,102448,Polikarpova; Nadezhda,0,0,0,0
1668522242461,CSE 291,C00,102453,Vaccaro; Kristen Marie,0,0,0,0
1668522242461,CSE 291,D00,111343,Savage; Stefan,0,0,0,0
1668522242461,CSE 291,E00,116474,Claffy; Kimberly Claire,0,0,0,0
1668522242461,CSE 291,F00,116479,Pasquale; Joseph,0,0,0,0
1668522242899,CSE 293,001,119111,Bafna; Vineet,9999,0,9999,0
1668522242899,CSE 293,002,119118,Bellare; Mihir,9999,0,9999,0
1668522242899,CSE 293,003,119122,Berg-Kirkpatrick; Taylor D,9999,0,9999,0
1668522242899,CSE 293,004,119135,Christensen; Henrik I,9999,0,9999,0
1668522242899,CSE 293,005,119142,Cottrell; Garrison W,9999,0,9999,0
1668522242899,CSE 293,006,119146,Deutsch; Alin Bernard,9999,0,9999,0
1668522242899,CSE 293,007,119159,Esmaeilzadeh; Hadi,9999,0,9999,0
1668522242899,CSE 293,008,119166,Freund; Yoav,9999,0,9999,0
1668522242899,CSE 293,009,119170,Griswold; William G.,9999,0,9999,0
1668522242899,CSE 293,010,119183,Gymrek; Melissa Ann,9999,0,9999,0
1668522242899,CSE 293,011,119190,Heninger; Nadia A,9999,0,9999,0
1668522242899,CSE 293,012,119230,Impagliazzo; Russell,9999,0,9999,0
1668522242899,CSE 293,013,119232,Jhala; Ranjit,9999,0,9999,0
1668522242899,CSE 293,014,119233,Kahng; Andrew Byun,9999,0,9999,0
1668522242899,CSE 293,015,119298,Kane; Daniel Mertz,9999,0,9999,0
1668522242899,CSE 293,016,119299,Kriegman; David J,9999,0,9999,0
1668522242899,CSE 293,017,119300,Kumar; Arun Kumar,9999,0,9999,0
1668522242899,CSE 293,018,119301,Lerner; Sorin,9999,0,9999,0
1668522242899,CSE 293,019,119302,Lovett; Shachar,9999,0,9999,0
1668522242899,CSE 293,020,119303,McAuley; Julian John,9999,0,9999,0
1668522242899,CSE 293,021,119304,Micciancio; Daniele,9999,0,9999,0
1668522242899,CSE 293,022,119367,Orailoglu; Alex,9999,0,9999,0
1668522242899,CSE 293,023,119382,Paturi; Ramamohan,9999,0,9999,0
1668522242899,CSE 293,024,119404,Polikarpova; Nadezhda,9999,0,9999,0
1668522242899,CSE 293,025,119406,Politz; Joseph Gibbs,9999,0,9999,0
1668522242899,CSE 293,026,119411,Porter; George M,9999,0,9999,0
1668522242899,CSE 293,027,119414,Porter; Leonard Emerson,9999,0,9999,0
1668522242899,CSE 293,028,119416,Ramamoorthi; Ravi,9999,0,9999,0
1668522242899,CSE 293,029,119417,Sahoo; Debashis,9999,0,9999,0
1668522242899,CSE 293,030,119420,Saul; Lawrence,9999,0,9999,0
1668522242899,CSE 293,031,119421,Savage; Stefan,9999,0,9999,0
1668522242899,CSE 293,032,119425,Schulze; Jurgen P.,9999,0,9999,0
1668522242899,CSE 293,033,119426,Snoeren; Alex C.,9999,0,9999,0
1668522242899,CSE 293,034,119428,Shang; Jingbo,9999,0,9999,0
1668522242899,CSE 293,035,119430,Stefan; Deian,9999,0,9999,0
1668522242899,CSE 293,036,119431,Su; Hao,9999,0,9999,0
1668522242899,CSE 293,037,119433,Swanson; Steven James,9999,0,9999,0
1668522242899,CSE 293,038,119435,Tullsen; Dean Michael,9999,0,9999,0
1668522242899,CSE 293,039,119483,Voelker; Geoffrey M.,9999,0,9999,0
1668522242899,CSE 293,040,119537,Zhao; Jishen,9999,0,9999,0
1668522242899,CSE 293,041,119538,Zhou; Yuan-Yuan,9999,0,9999,0
1668522242899,CSE 293,042,119539,Gao; Sicun,9999,0,9999,0
1668522242899,CSE 293,043,119540,Weibel; Nadir,9999,0,9999,0
1668522242899,CSE 293,044,119541,Gupta; Rajesh K.,9999,0,9999,0
1668522242899,CSE 293,045,126410,Vaccaro; Kristen Marie,9999,0,9999,0
1668522242899,CSE 293,046,126411,Klemke; Richard,9999,0,9999,0
1668522243327,CSE 294,A00,102459,Voelker; Geoffrey M.,0,2,0,0
1668522243327,CSE 294,B00,111322,Orailoglu; Alex,0,2,0,0
1668522243751,DSE 201,A00,096914,Deutsch; Alin Bernard,30,0,30,0
1668522244181,DSE 210,A00,096915,Dasgupta; Sanjoy,30,0,30,0
1668522244606,DSE 260A,A00,096916,Altintas De Callaf; Ilkay,30,0,30,0
1668522245083,ECE 200,001,103586,Antipa; Nicholas A,9999,0,9999,0
1668522245083,ECE 200,002,103587,Atanasov; Nikolay A.,9999,0,9999,0
1668522245083,ECE 200,003,103588,Bharadia; Dinesh,9999,0,9999,0
1668522245083,ECE 200,004,103589,Cheng; Chung Kuan,9999,0,9999,0
1668522245083,ECE 200,005,103590,Cosman; Pamela C.,9999,0,9999,0
1668522245083,ECE 200,006,103591,Dayeh; Shadi Ahmad,9999,0,9999,0
1668522245083,ECE 200,007,103592,Fainman; Yeshaiahu,9999,0,9999,0
1668522245083,ECE 200,008,103593,Ford; Joseph Earl,9999,0,9999,0
1668522245083,ECE 200,009,103594,Franceschetti; Massimo,9999,0,9999,0
1668522245083,ECE 200,010,103595,Fullerton; Eric E,9999,0,9999,0
1668522245083,ECE 200,011,103596,Galton; Ian A,9999,0,9999,0
1668522245083,ECE 200,012,103597,Gilja; Vikash,9999,0,9999,0
1668522245083,ECE 200,013,103598,Hall; Drew A.,9999,0,9999,0
1668522245083,ECE 200,014,103599,Hsueh; Tzu-Chien,9999,0,9999,0
1668522245083,ECE 200,015,103600,Javidi; Tara,9999,0,9999,0
1668522245083,ECE 200,016,103601,Kahng; Andrew Byun,9999,0,9999,0
1668522245083,ECE 200,017,103602,Kim; Young-Han,9999,0,9999,0
1668522245083,ECE 200,018,103603,Koushanfar; Farinaz,9999,0,9999,0
1668522245083,ECE 200,019,103604,Kuzum; Duygu,9999,0,9999,0
1668522245083,ECE 200,020,103605,Le; Hanh-Phuc,9999,0,9999,0
1668522245083,ECE 200,021,103606,Lin; Bill,9999,0,9999,0
1668522245083,ECE 200,022,103607,Liu; Zhaowei,9998,0,9999,1
1668522245083,ECE 200,023,103608,Lo; Yu-Hwa,9999,0,9999,0
1668522245083,ECE 200,024,103609,Lomakin; Vitaliy,9999,0,9999,0
1668522245083,ECE 200,025,103610,Mercier; Patrick Philip,9999,0,9999,0
1668522245083,ECE 200,026,103611,Meyer; Florian,9999,0,9999,0
1668522245083,ECE 200,027,103612,Milstein; Laurence B.,9999,0,9999,0
1668522245083,ECE 200,028,103613,Mir Arabbaygi; Siavash,9999,0,9999,0
1668522245083,ECE 200,029,103614,Mookherjea; Shayan,9999,0,9999,0
1668522245083,ECE 200,030,103615,Morris; Karcher William,9999,0,9999,0
1668522245083,ECE 200,031,103616,Ng; Tse Nga,9999,0,9999,0
1668522245083,ECE 200,032,103617,Nguyen; Truong Quang,9999,0,9999,0
1668522245083,ECE 200,033,103618,Nomura; Kenji,9999,0,9999,0
1668522245083,ECE 200,034,103619,Orlitsky; Alon,9999,0,9999,0
1668522245083,ECE 200,035,103620,Pal; Piya,9999,0,9999,0
1668522245083,ECE 200,036,103621,Papen; George C.,9999,0,9999,0
1668522245083,ECE 200,037,103622,Radic; Stojan,9999,0,9999,0
1668522245083,ECE 200,038,103623,Rao; Bhaskar D.,9999,0,9999,0
1668522245083,ECE 200,039,103624,Rao; Ramesh R,9999,0,9999,0
1668522245083,ECE 200,040,103625,Rebeiz; Gabriel,9999,0,9999,0
1668522245083,ECE 200,041,103626,Sanford; John R,9999,0,9999,0
1668522245083,ECE 200,042,103627,Siegel; Paul H.,9999,0,9999,0
1668522245083,ECE 200,043,103628,Sievenpiper; Daniel F.,9999,0,9999,0
1668522245083,ECE 200,044,103629,Sworder; David D.,9999,0,9999,0
1668522245083,ECE 200,045,103630,Taur; Yuan,9999,0,9999,0
1668522245083,ECE 200,046,103631,Touri; Behrouz,9999,0,9999,0
1668522245083,ECE 200,047,103632,Trivedi; Mohan M.,9999,0,9999,0
1668522245083,ECE 200,048,103633,Vasconcelos; Nuno,9999,0,9999,0
1668522245083,ECE 200,049,103634,Wang; Xiaolong,9999,0,9999,0
1668522245083,ECE 200,050,103635,Xie; Pengtao,9999,0,9999,0
1668522245083,ECE 200,051,103636,Yip; Michael,9999,0,9999,0
1668522245083,ECE 200,052,103637,Zeger; Kenneth A.,999,0,999,0
1668522245083,ECE 200,053,103638,Zhang; Xinyu,9999,0,9999,0
1668522245083,ECE 200,054,103639,Turakhia; Yatish Girish,9999,0,9999,0
1668522245083,ECE 200,055,103640,Kang; Mingu,9999,0,9999,0
1668522245083,ECE 200,056,103641,Shi; Yuanyuan,9999,0,9999,0
1668522245083,ECE 200,057,103642,Wang; Edward Jay,9999,0,9999,0
1668522245083,ECE 200,058,103643,Zheng; Yang,9999,0,9999,0
1668522245521,ECE 202,A00,103644,Kuzum; Duygu,0,44,0,0
1668522245947,ECE 212BN,A00,103646,Ng; Tse Nga,0,9,0,0
1668522246372,ECE 221,A00,111493,Staff,0,0,0,0
1668522246796,ECE 222B,A00,103647,Lomakin; Vitaliy,0,20,0,0
1668522247219,ECE 230B,A00,103648,Taur; Yuan,0,3,0,0
1668522247644,ECE 238B,A00,103649,Garay; Javier,0,0,0,0
1668522248085,ECE 240B,A00,112900,Fainman; Yeshaiahu,0,7,0,0
1668522248509,ECE 247A,A00,103650,Jokerst; Jesse Vincent,0,6,0,0
1668522248933,ECE 247B,A00,103651,Wang; Joseph,0,14,0,0
1668522249358,ECE 250,A00,103652,Siegel; Paul H.,0,82,0,0
1668522249783,ECE 251A,A00,103654,Rao; Bhaskar D.,0,62,0,0
1668522250221,ECE 257B,A00,103655,Bharadia; Dinesh,0,33,0,0
1668522250663,ECE 258A,A00,103656,Milstein; Laurence B.,0,29,0,0
1668522251101,ECE 260B,A00,103658,Kang; Mingu,0,119,0,0
1668522251533,ECE 264A,A00,103659,Galton; Ian A,0,66,0,0
1668522251955,ECE 265A,A00,103661,Gudem; Prasad S.S.,0,70,0,0
1668522252379,ECE 265D,A00,103662,Gudem; Prasad S.S.,0,26,0,0
1668522252803,ECE 268,A00,103663,Koushanfar; Farinaz,0,43,0,0
1668522253230,ECE 269,A01,103665,Pal; Piya,0,215,0,0
1668522253656,ECE 271B,A00,103666,Vasconcelos; Manuela,0,76,0,0
1668522254079,ECE 276A,A00,103667,Atanasov; Nikolay A.,0,126,0,0
1668522254507,ECE 277,A00,103668,An; Cheolhong,0,149,0,0
1668522254928,ECE 279,A00,117947,Hall; Drew A.,0,22,0,0
1668522255778,ECE 283,A00,103670,Hsueh; Tzu-Chien,0,53,0,0
1668522256216,ECE 284,A00,103671,Turakhia; Yatish Girish,0,39,0,0
1668522256654,ECE 285,A00,103672,Zheng; Yang,0,39,0,0
1668522256654,ECE 285,B00,103673,Sworder; David D.,0,57,0,0
1668522257158,ECE 287,A00,103676,Javidi; Tara,0,9,0,0
1668522257592,MATH 200B,A00,098023,Salehi Golsefidy; Alireza,10,0,15,5
1668522258016,MATH 202B,A00,098024,Rhoades; Brendon Patrick,7,0,15,8
1668522258447,MATH 203B,A00,098025,Oprea; Dragos N.,9,0,15,6
1668522258874,MATH 204B,A00,098026,Sorensen; Claus M,13,0,15,2
1668522259309,MATH 208,A00,098027,Izadi; Elham,7,0,10,3
1668522259744,MATH 209,A00,098028,Pollack; Aaron,10,0,10,0
1668522260180,MATH 211A,A00,112919,Rogalski; Daniel,8,0,10,2
1668522260603,MATH 211B,A00,112920,Seward; Brandon M.,9,0,10,1
1668522261026,MATH 218,A00,098029,Li; Bo,10,0,10,0
1668522261451,MATH 220B,A00,098030,Novak; Jonathan I,11,0,15,4
1668522261873,MATH 221A,A00,098031,Ebenfelt; Peter F,12,0,15,3
1668522262298,MATH 231B,A00,098032,Zlatos; Andrej,11,0,15,4
1668522262735,MATH 240B,A00,098033,Ni; Lei,7,0,15,8
1668522263160,MATH 243,A00,098034,Jekel; David Andrew,10,0,10,0
1668522263586,MATH 245A,A00,098035,Nie; Jiawang,0,4,15,18
1668522264014,MATH 248,A00,098036,Bejenaru; Ioan,10,0,10,0
1668522264438,MATH 250B,A00,098037,Spolaor; Luca,14,0,15,1
1668522264861,MATH 258,A00,098038,Ni; Lei,9,0,10,1
1668522265285,MATH 264B,A00,098041,Rhoades; Brendon Patrick,8,0,15,7
1668522265709,MATH 268,A00,098042,Buss; Samuel R,10,0,10,0
1668522266146,MATH 269,A00,098043,Rhoades; Brendon Patrick,10,0,10,0
1668522266579,MATH 270B,A00,098044,Li; Bo,6,0,15,9
1668522267010,MATH 272B,A00,098045,Holst; Michael J,13,0,15,2
1668522267434,MATH 273A,A00,098046,Tian; Xiaochuan,10,0,15,5
1668522267856,MATH 275,A01,098048,Tian; Xiaochuan,6,0,10,4
1668522268282,MATH 278A,A00,098049,Holst; Michael J,7,0,10,3
1668522268706,MATH 278B,A00,098050,Cloninger; Alexander,10,0,10,0
1668522269132,MATH 278C,A00,098051,Nie; Jiawang,5,0,10,5
1668522269558,MATH 280B,A00,098052,Zheng; Tianyi,7,0,15,8
1668522269991,MATH 281B,A00,098053,Bradic; Jelena,0,2,15,15
1668522270423,MATH 282B,A00,098054,Arias-Castro; Ery,0,1,15,15
1668522270849,MATH 285,A00,098055,Fitzsimmons; Patrick J,0,3,15,17
1668522271273,MATH 287B,A00,098056,Arias-Castro; Ery,1,0,15,14
1668522271701,MATH 288,A00,098057,Agarwal; Pooja,9,0,10,1
1668522271701,MATH 288,B00,098058,Zhang; Danna,8,0,10,2
1668522271701,MATH 288,C00,098059,Williams; Ruth J,9,0,10,1
1668522272126,MATH 290B,A00,098060,Roberts; Justin Deritter,12,0,15,3
1668522272549,MATH 292,A00,098061,Belmont; Eva Kinoshita,10,0,10,0
1668522272973,MATH 295,A00,098062,Suk; Andrew Hoon,47,0,50,3
1668522273397,MATH 296,A00,098063,Novak; Jonathan I,20,0,20,0
1668522273822,MATH 297,001,098064,Gamst; Anthony Collins,9997,0,9999,2
1668522776109,COGS 205,A00,101395,Chiba; Andrea,19,0,20,1
1668522776534,COGS 210B,001,101404,Greene; Deanna Jacquelyn,9998,0,9999,1
1668522776534,COGS 210B,002,101417,Xia; Haijun,9999,0,9999,0
1668522776534,COGS 210B,003,101422,Nitz; Douglas A.,9999,0,9999,0
1668522776534,COGS 210B,004,101423,Hollan; James D.,9998,0,9999,1
1668522776534,COGS 210B,005,101424,Deak; Gedeon O.,9998,0,9999,1
1668522776534,COGS 210B,006,101425,Rossano; Federico,9999,0,9999,0
1668522776960,COGS 211B,A00,101427,Coulson; Seana M,9996,0,9999,3
1668522777385,COGS 220,A00,101428,Hollan; James D.,0,10,25,25
1668522777810,COGS 229,A00,101429,Dow; Steven P,17,0,25,8
1668522778311,COGS 230,A00,101430,Klemmer; Scott R,7,0,17,10
1668522778736,COGS 234,A00,101431,Xia; Haijun,1,0,25,24
1668522779161,COGS 260,A00,101432,Kiyonaga; Anastasia,21,0,25,4
1668522779161,COGS 260,B00,101433,Kirsh; David Joel,15,0,25,10
1668522779584,CSE 202,A00,102371,Impagliazzo; Russell,0,66,0,0
1668522780011,CSE 203B,A01,102373,Cheng; Chung Kuan,0,58,0,0
1668522780444,CSE 208,A00,102374,Micciancio; Daniele,0,5,0,0
1668522780867,CSE 209A,A00,112895,Impagliazzo; Russell,0,12,15,15
1668522781290,CSE 209B,A00,108005,Bellare; Mihir,0,7,0,0
1668522781712,CSE 210,A00,113163,Coblenz; Michael J,0,85,0,0
1668522782140,CSE 219,A00,106111,Dow; Steven P,0,6,20,20
1668522782570,CSE 221,A00,102376,Voelker; Geoffrey M.,0,73,0,0
1668522782996,CSE 224,A01,102378,Porter; George M,0,166,0,0
1668522783422,CSE 229A,A00,102379,Savage; Stefan,0,10,0,0
1668522783849,CSE 229C,A00,102380,Munyaka; Imani N. S.,0,10,0,0
1668522784273,CSE 232B,A00,102382,Deutsch; Alin Bernard,0,32,0,0
1668522784698,CSE 234,A01,112904,Kumar; Arun Kumar,0,0,0,0
1668522785124,CSE 237A,A00,102383,Rosing; Tajana Simunic,0,55,0,0
1668522785550,CSE 239A,A00,102384,Deutsch; Alin Bernard,0,14,0,0
1668522785976,CSE 239B,A00,102385,Polikarpova; Nadezhda,0,10,0,0
1668522786402,CSE 240A,A00,102386,Pannuto; Patrick William,0,46,0,0
1668522786838,CSE 240B,A00,102387,Zhao; Jishen,0,47,0,0
1668522787264,CSE 241A,A00,106406,Kang; Mingu,0,9,0,0
1668522787690,CSE 249B,A00,102388,Kahng; Andrew Byun,0,5,8,8
1668522788113,CSE 251B,A01,102392,Cottrell; Garrison W,0,51,0,0
1668522788113,CSE 251B,A02,102393,Cottrell; Garrison W,0,34,0,0
1668522788540,CSE 252B,A00,102394,Ochoa; Benjamin Lawrence,0,59,0,0
1668522788965,CSE 257,A01,102396,Gao; Sicun,0,139,0,0
1668522789392,CSE 272,A00,102397,Li; Tzumao,0,19,0,0
1668522789819,CSE 274,A00,111323,Chern; Albert Ren-Haur,0,15,0,0
1668522790246,CSE 282,A00,102398,Pevzner; Pavel Arkadjevich,0,0,0,0
1668522790671,CSE 284,A00,114175,Gymrek; Melissa Ann,0,22,0,0
1668522791096,CSE 290,A00,102399,Chandraker; Manmohan Krishna,0,11,0,0
1668522791096,CSE 290,B00,102400,Vaccaro; Kristen Marie,0,7,25,25
1668522791096,CSE 290,C00,102414,Pannuto; Patrick William,0,1,25,25
1668522791096,CSE 290,D00,102427,Pevzner; Pavel Arkadjevich,0,0,0,0
1668522791096,CSE 290,E00,102429,Zhao; Jishen,0,4,0,0
1668522791096,CSE 290,F00,102436,Tullsen; Dean Michael,0,5,0,0
1668522791096,CSE 290,G00,102440,Christensen; Henrik I,0,6,20,20
1668522791537,CSE 291,A00,102443,Su; Hao,0,0,0,0
1668522791537,CSE 291,B00,102448,Polikarpova; Nadezhda,0,0,0,0
1668522791537,CSE 291,C00,102453,Vaccaro; Kristen Marie,0,0,0,0
1668522791537,CSE 291,D00,111343,Savage; Stefan,0,0,0,0
1668522791537,CSE 291,E00,116474,Claffy; Kimberly Claire,0,0,0,0
1668522791537,CSE 291,F00,116479,Pasquale; Joseph,0,0,0,0
1668522791988,CSE 293,001,119111,Bafna; Vineet,9999,0,9999,0
1668522791988,CSE 293,002,119118,Bellare; Mihir,9999,0,9999,0
1668522791988,CSE 293,003,119122,Berg-Kirkpatrick; Taylor D,9999,0,9999,0
1668522791988,CSE 293,004,119135,Christensen; Henrik I,9999,0,9999,0
1668522791988,CSE 293,005,119142,Cottrell; Garrison W,9999,0,9999,0
1668522791988,CSE 293,006,119146,Deutsch; Alin Bernard,9999,0,9999,0
1668522791988,CSE 293,007,119159,Esmaeilzadeh; Hadi,9999,0,9999,0
1668522791988,CSE 293,008,119166,Freund; Yoav,9999,0,9999,0
1668522791988,CSE 293,009,119170,Griswold; William G.,9999,0,9999,0
1668522791988,CSE 293,010,119183,Gymrek; Melissa Ann,9999,0,9999,0
1668522791988,CSE 293,011,119190,Heninger; Nadia A,9999,0,9999,0
1668522791988,CSE 293,012,119230,Impagliazzo; Russell,9999,0,9999,0
1668522791988,CSE 293,013,119232,Jhala; Ranjit,9999,0,9999,0
1668522791988,CSE 293,014,119233,Kahng; Andrew Byun,9999,0,9999,0
1668522791988,CSE 293,015,119298,Kane; Daniel Mertz,9999,0,9999,0
1668522791988,CSE 293,016,119299,Kriegman; David J,9999,0,9999,0
1668522791988,CSE 293,017,119300,Kumar; Arun Kumar,9999,0,9999,0
1668522791988,CSE 293,018,119301,Lerner; Sorin,9999,0,9999,0
1668522791988,CSE 293,019,119302,Lovett; Shachar,9999,0,9999,0
1668522791988,CSE 293,020,119303,McAuley; Julian John,9999,0,9999,0
1668522791988,CSE 293,021,119304,Micciancio; Daniele,9999,0,9999,0
1668522791988,CSE 293,022,119367,Orailoglu; Alex,9999,0,9999,0
1668522791988,CSE 293,023,119382,Paturi; Ramamohan,9999,0,9999,0
1668522791988,CSE 293,024,119404,Polikarpova; Nadezhda,9999,0,9999,0
1668522791988,CSE 293,025,119406,Politz; Joseph Gibbs,9999,0,9999,0
1668522791988,CSE 293,026,119411,Porter; George M,9999,0,9999,0
1668522791988,CSE 293,027,119414,Porter; Leonard Emerson,9999,0,9999,0
1668522791988,CSE 293,028,119416,Ramamoorthi; Ravi,9999,0,9999,0
1668522791988,CSE 293,029,119417,Sahoo; Debashis,9999,0,9999,0
1668522791988,CSE 293,030,119420,Saul; Lawrence,9999,0,9999,0
1668522791988,CSE 293,031,119421,Savage; Stefan,9999,0,9999,0
1668522791988,CSE 293,032,119425,Schulze; Jurgen P.,9999,0,9999,0
1668522791988,CSE 293,033,119426,Snoeren; Alex C.,9999,0,9999,0
1668522791988,CSE 293,034,119428,Shang; Jingbo,9999,0,9999,0
1668522791988,CSE 293,035,119430,Stefan; Deian,9999,0,9999,0
1668522791988,CSE 293,036,119431,Su; Hao,9999,0,9999,0
1668522791988,CSE 293,037,119433,Swanson; Steven James,9999,0,9999,0
1668522791988,CSE 293,038,119435,Tullsen; Dean Michael,9999,0,9999,0
1668522791988,CSE 293,039,119483,Voelker; Geoffrey M.,9999,0,9999,0
1668522791988,CSE 293,040,119537,Zhao; Jishen,9999,0,9999,0
1668522791988,CSE 293,041,119538,Zhou; Yuan-Yuan,9999,0,9999,0
1668522791988,CSE 293,042,119539,Gao; Sicun,9999,0,9999,0
1668522791988,CSE 293,043,119540,Weibel; Nadir,9999,0,9999,0
1668522791988,CSE 293,044,119541,Gupta; Rajesh K.,9999,0,9999,0
1668522791988,CSE 293,045,126410,Vaccaro; Kristen Marie,9999,0,9999,0
1668522791988,CSE 293,046,126411,Klemke; Richard,9999,0,9999,0
1668522792427,CSE 294,A00,102459,Voelker; Geoffrey M.,0,2,0,0
1668522792427,CSE 294,B00,111322,Orailoglu; Alex,0,2,0,0
1668522792853,DSE 201,A00,096914,Deutsch; Alin Bernard,30,0,30,0
1668522793283,DSE 210,A00,096915,Dasgupta; Sanjoy,30,0,30,0
1668522793707,DSE 260A,A00,096916,Altintas De Callaf; Ilkay,30,0,30,0
1668522794134,ECE 200,001,103586,Antipa; Nicholas A,9999,0,9999,0
1668522794134,ECE 200,002,103587,Atanasov; Nikolay A.,9999,0,9999,0
1668522794134,ECE 200,003,103588,Bharadia; Dinesh,9999,0,9999,0
1668522794134,ECE 200,004,103589,Cheng; Chung Kuan,9999,0,9999,0
1668522794134,ECE 200,005,103590,Cosman; Pamela C.,9999,0,9999,0
1668522794134,ECE 200,006,103591,Dayeh; Shadi Ahmad,9999,0,9999,0
1668522794134,ECE 200,007,103592,Fainman; Yeshaiahu,9999,0,9999,0
1668522794134,ECE 200,008,103593,Ford; Joseph Earl,9999,0,9999,0
1668522794134,ECE 200,009,103594,Franceschetti; Massimo,9999,0,9999,0
1668522794134,ECE 200,010,103595,Fullerton; Eric E,9999,0,9999,0
1668522794134,ECE 200,011,103596,Galton; Ian A,9999,0,9999,0
1668522794134,ECE 200,012,103597,Gilja; Vikash,9999,0,9999,0
1668522794134,ECE 200,013,103598,Hall; Drew A.,9999,0,9999,0
1668522794134,ECE 200,014,103599,Hsueh; Tzu-Chien,9999,0,9999,0
1668522794134,ECE 200,015,103600,Javidi; Tara,9999,0,9999,0
1668522794134,ECE 200,016,103601,Kahng; Andrew Byun,9999,0,9999,0
1668522794134,ECE 200,017,103602,Kim; Young-Han,9999,0,9999,0
1668522794134,ECE 200,018,103603,Koushanfar; Farinaz,9999,0,9999,0
1668522794134,ECE 200,019,103604,Kuzum; Duygu,9999,0,9999,0
1668522794134,ECE 200,020,103605,Le; Hanh-Phuc,9999,0,9999,0
1668522794134,ECE 200,021,103606,Lin; Bill,9999,0,9999,0
1668522794134,ECE 200,022,103607,Liu; Zhaowei,9998,0,9999,1
1668522794134,ECE 200,023,103608,Lo; Yu-Hwa,9999,0,9999,0
1668522794134,ECE 200,024,103609,Lomakin; Vitaliy,9999,0,9999,0
1668522794134,ECE 200,025,103610,Mercier; Patrick Philip,9999,0,9999,0
1668522794134,ECE 200,026,103611,Meyer; Florian,9999,0,9999,0
1668522794134,ECE 200,027,103612,Milstein; Laurence B.,9999,0,9999,0
1668522794134,ECE 200,028,103613,Mir Arabbaygi; Siavash,9999,0,9999,0
1668522794134,ECE 200,029,103614,Mookherjea; Shayan,9999,0,9999,0
1668522794134,ECE 200,030,103615,Morris; Karcher William,9999,0,9999,0
1668522794134,ECE 200,031,103616,Ng; Tse Nga,9999,0,9999,0
1668522794134,ECE 200,032,103617,Nguyen; Truong Quang,9999,0,9999,0
1668522794134,ECE 200,033,103618,Nomura; Kenji,9999,0,9999,0
1668522794134,ECE 200,034,103619,Orlitsky; Alon,9999,0,9999,0
1668522794134,ECE 200,035,103620,Pal; Piya,9999,0,9999,0
1668522794134,ECE 200,036,103621,Papen; George C.,9999,0,9999,0
1668522794134,ECE 200,037,103622,Radic; Stojan,9999,0,9999,0
1668522794134,ECE 200,038,103623,Rao; Bhaskar D.,9999,0,9999,0
1668522794134,ECE 200,039,103624,Rao; Ramesh R,9999,0,9999,0
1668522794134,ECE 200,040,103625,Rebeiz; Gabriel,9999,0,9999,0
1668522794134,ECE 200,041,103626,Sanford; John R,9999,0,9999,0
1668522794134,ECE 200,042,103627,Siegel; Paul H.,9999,0,9999,0
1668522794134,ECE 200,043,103628,Sievenpiper; Daniel F.,9999,0,9999,0
1668522794134,ECE 200,044,103629,Sworder; David D.,9999,0,9999,0
1668522794134,ECE 200,045,103630,Taur; Yuan,9999,0,9999,0
1668522794134,ECE 200,046,103631,Touri; Behrouz,9999,0,9999,0
1668522794134,ECE 200,047,103632,Trivedi; Mohan M.,9999,0,9999,0
1668522794134,ECE 200,048,103633,Vasconcelos; Nuno,9999,0,9999,0
1668522794134,ECE 200,049,103634,Wang; Xiaolong,9999,0,9999,0
1668522794134,ECE 200,050,103635,Xie; Pengtao,9999,0,9999,0
1668522794134,ECE 200,051,103636,Yip; Michael,9999,0,9999,0
1668522794134,ECE 200,052,103637,Zeger; Kenneth A.,999,0,999,0
1668522794134,ECE 200,053,103638,Zhang; Xinyu,9999,0,9999,0
1668522794134,ECE 200,054,103639,Turakhia; Yatish Girish,9999,0,9999,0
1668522794134,ECE 200,055,103640,Kang; Mingu,9999,0,9999,0
1668522794134,ECE 200,056,103641,Shi; Yuanyuan,9999,0,9999,0
1668522794134,ECE 200,057,103642,Wang; Edward Jay,9999,0,9999,0
1668522794134,ECE 200,058,103643,Zheng; Yang,9999,0,9999,0
1668522794558,ECE 202,A00,103644,Kuzum; Duygu,0,44,0,0
1668522794988,ECE 212BN,A00,103646,Ng; Tse Nga,0,9,0,0
1668522795412,ECE 221,A00,111493,Staff,0,0,0,0
1668522795840,ECE 222B,A00,103647,Lomakin; Vitaliy,0,20,0,0
1668522796265,ECE 230B,A00,103648,Taur; Yuan,0,3,0,0
1668522796689,ECE 238B,A00,103649,Garay; Javier,0,0,0,0
1668522797120,ECE 240B,A00,112900,Fainman; Yeshaiahu,0,7,0,0
1668522797555,ECE 247A,A00,103650,Jokerst; Jesse Vincent,0,6,0,0
1668522797979,ECE 247B,A00,103651,Wang; Joseph,0,14,0,0
1668522798404,ECE 250,A00,103652,Siegel; Paul H.,0,82,0,0
1668522798832,ECE 251A,A00,103654,Rao; Bhaskar D.,0,62,0,0
1668522799259,ECE 257B,A00,103655,Bharadia; Dinesh,0,33,0,0
1668522799682,ECE 258A,A00,103656,Milstein; Laurence B.,0,29,0,0
1668522800109,ECE 260B,A00,103658,Kang; Mingu,0,119,0,0
1668522800539,ECE 264A,A00,103659,Galton; Ian A,0,66,0,0
1668522800973,ECE 265A,A00,103661,Gudem; Prasad S.S.,0,70,0,0
1668522801396,ECE 265D,A00,103662,Gudem; Prasad S.S.,0,26,0,0
1668522801820,ECE 268,A00,103663,Koushanfar; Farinaz,0,43,0,0
1668522802244,ECE 269,A01,103665,Pal; Piya,0,215,0,0
1668522802672,ECE 271B,A00,103666,Vasconcelos; Manuela,0,76,0,0
1668522803098,ECE 276A,A00,103667,Atanasov; Nikolay A.,0,126,0,0
1668522803523,ECE 277,A00,103668,An; Cheolhong,0,149,0,0
1668522803949,ECE 279,A00,117947,Hall; Drew A.,0,22,0,0
1668522804813,ECE 283,A00,103670,Hsueh; Tzu-Chien,0,53,0,0
1668522805251,ECE 284,A00,103671,Turakhia; Yatish Girish,0,39,0,0
1668522805688,ECE 285,A00,103672,Zheng; Yang,0,39,0,0
1668522805688,ECE 285,B00,103673,Sworder; David D.,0,57,0,0
1668522806113,ECE 287,A00,103676,Javidi; Tara,0,9,0,0
1668522806536,MATH 200B,A00,098023,Salehi Golsefidy; Alireza,10,0,15,5
1668522806962,MATH 202B,A00,098024,Rhoades; Brendon Patrick,7,0,15,8
1668522807389,MATH 203B,A00,098025,Oprea; Dragos N.,9,0,15,6
1668522807815,MATH 204B,A00,098026,Sorensen; Claus M,13,0,15,2
1668522808238,MATH 208,A00,098027,Izadi; Elham,7,0,10,3
1668522808662,MATH 209,A00,098028,Pollack; Aaron,10,0,10,0
1668522809085,MATH 211A,A00,112919,Rogalski; Daniel,8,0,10,2
1668522809509,MATH 211B,A00,112920,Seward; Brandon M.,9,0,10,1
1668522809936,MATH 218,A00,098029,Li; Bo,10,0,10,0
1668522810364,MATH 220B,A00,098030,Novak; Jonathan I,11,0,15,4
1668522810787,MATH 221A,A00,098031,Ebenfelt; Peter F,12,0,15,3
1668522811222,MATH 231B,A00,098032,Zlatos; Andrej,11,0,15,4
1668522811651,MATH 240B,A00,098033,Ni; Lei,7,0,15,8
1668522812075,MATH 243,A00,098034,Jekel; David Andrew,10,0,10,0
1668522812502,MATH 245A,A00,098035,Nie; Jiawang,0,4,15,18
1668522812931,MATH 248,A00,098036,Bejenaru; Ioan,10,0,10,0
1668522813354,MATH 250B,A00,098037,Spolaor; Luca,14,0,15,1
1668522813782,MATH 258,A00,098038,Ni; Lei,9,0,10,1
1668522814205,MATH 264B,A00,098041,Rhoades; Brendon Patrick,8,0,15,7
1668522814628,MATH 268,A00,098042,Buss; Samuel R,10,0,10,0
1668522815054,MATH 269,A00,098043,Rhoades; Brendon Patrick,10,0,10,0
1668522815481,MATH 270B,A00,098044,Li; Bo,6,0,15,9
1668522815903,MATH 272B,A00,098045,Holst; Michael J,13,0,15,2
1668522816341,MATH 273A,A00,098046,Tian; Xiaochuan,10,0,15,5
1668522816770,MATH 275,A01,098048,Tian; Xiaochuan,6,0,10,4
1668522817200,MATH 278A,A00,098049,Holst; Michael J,7,0,10,3
1668522817627,MATH 278B,A00,098050,Cloninger; Alexander,10,0,10,0
1668522818051,MATH 278C,A00,098051,Nie; Jiawang,5,0,10,5
1668522818476,MATH 280B,A00,098052,Zheng; Tianyi,7,0,15,8
1668522818899,MATH 281B,A00,098053,Bradic; Jelena,0,2,15,15
1668522819330,MATH 282B,A00,098054,Arias-Castro; Ery,0,1,15,15
1668522819753,MATH 285,A00,098055,Fitzsimmons; Patrick J,0,3,15,17
1668522820179,MATH 287B,A00,098056,Arias-Castro; Ery,1,0,15,14
1668522820602,MATH 288,A00,098057,Agarwal; Pooja,9,0,10,1
1668522820602,MATH 288,B00,098058,Zhang; Danna,8,0,10,2
1668522820602,MATH 288,C00,098059,Williams; Ruth J,9,0,10,1
1668522821027,MATH 290B,A00,098060,Roberts; Justin Deritter,12,0,15,3
1668522821561,MATH 292,A00,098061,Belmont; Eva Kinoshita,10,0,10,0
1668522821995,MATH 295,A00,098062,Suk; Andrew Hoon,47,0,50,3
1668522822420,MATH 296,A00,098063,Novak; Jonathan I,20,0,20,0
1668522822846,MATH 297,001,098064,Gamst; Anthony Collins,9997,0,9999,2
1668523324990,COGS 205,A00,101395,Chiba; Andrea,19,0,20,1
1668523325417,COGS 210B,001,101404,Greene; Deanna Jacquelyn,9998,0,9999,1
1668523325417,COGS 210B,002,101417,Xia; Haijun,9999,0,9999,0
1668523325417,COGS 210B,003,101422,Nitz; Douglas A.,9999,0,9999,0
1668523325417,COGS 210B,004,101423,Hollan; James D.,9998,0,9999,1
1668523325417,COGS 210B,005,101424,Deak; Gedeon O.,9998,0,9999,1
1668523325417,COGS 210B,006,101425,Rossano; Federico,9999,0,9999,0
1668523325849,COGS 211B,A00,101427,Coulson; Seana M,9996,0,9999,3
1668523326271,COGS 220,A00,101428,Hollan; James D.,0,10,25,25
1668523326702,COGS 229,A00,101429,Dow; Steven P,17,0,25,8
1668523327125,COGS 230,A00,101430,Klemmer; Scott R,7,0,17,10
1668523327563,COGS 234,A00,101431,Xia; Haijun,1,0,25,24
1668523327988,COGS 260,A00,101432,Kiyonaga; Anastasia,21,0,25,4
1668523327988,COGS 260,B00,101433,Kirsh; David Joel,15,0,25,10
1668523328424,CSE 202,A00,102371,Impagliazzo; Russell,0,66,0,0
1668523328847,CSE 203B,A01,102373,Cheng; Chung Kuan,0,58,0,0
1668523329275,CSE 208,A00,102374,Micciancio; Daniele,0,5,0,0
1668523329713,CSE 209A,A00,112895,Impagliazzo; Russell,0,12,15,15
1668523330142,CSE 209B,A00,108005,Bellare; Mihir,0,7,0,0
1668523330575,CSE 210,A00,113163,Coblenz; Michael J,0,85,0,0
1668523331000,CSE 219,A00,106111,Dow; Steven P,0,6,20,20
1668523331423,CSE 221,A00,102376,Voelker; Geoffrey M.,0,73,0,0
1668523331846,CSE 224,A01,102378,Porter; George M,0,166,0,0
1668523332277,CSE 229A,A00,102379,Savage; Stefan,0,10,0,0
1668523332705,CSE 229C,A00,102380,Munyaka; Imani N. S.,0,10,0,0
1668523333128,CSE 232B,A00,102382,Deutsch; Alin Bernard,0,32,0,0
1668523333554,CSE 234,A01,112904,Kumar; Arun Kumar,0,0,0,0
1668523333997,CSE 237A,A00,102383,Rosing; Tajana Simunic,0,55,0,0
1668523334423,CSE 239A,A00,102384,Deutsch; Alin Bernard,0,14,0,0
1668523334859,CSE 239B,A00,102385,Polikarpova; Nadezhda,0,10,0,0
1668523335282,CSE 240A,A00,102386,Pannuto; Patrick William,0,46,0,0
1668523335705,CSE 240B,A00,102387,Zhao; Jishen,0,47,0,0
1668523336133,CSE 241A,A00,106406,Kang; Mingu,0,9,0,0
1668523336562,CSE 249B,A00,102388,Kahng; Andrew Byun,0,5,8,8
1668523336988,CSE 251B,A01,102392,Cottrell; Garrison W,0,51,0,0
1668523336988,CSE 251B,A02,102393,Cottrell; Garrison W,0,34,0,0
1668523337411,CSE 252B,A00,102394,Ochoa; Benjamin Lawrence,0,59,0,0
1668523337837,CSE 257,A01,102396,Gao; Sicun,0,139,0,0
1668523338260,CSE 272,A00,102397,Li; Tzumao,0,19,0,0
1668523338683,CSE 274,A00,111323,Chern; Albert Ren-Haur,0,15,0,0
1668523339116,CSE 282,A00,102398,Pevzner; Pavel Arkadjevich,0,0,0,0
1668523339543,CSE 284,A00,114175,Gymrek; Melissa Ann,0,22,0,0
1668523339972,CSE 290,A00,102399,Chandraker; Manmohan Krishna,0,11,0,0
1668523339972,CSE 290,B00,102400,Vaccaro; Kristen Marie,0,7,25,25
1668523339972,CSE 290,C00,102414,Pannuto; Patrick William,0,1,25,25
1668523339972,CSE 290,D00,102427,Pevzner; Pavel Arkadjevich,0,0,0,0
1668523339972,CSE 290,E00,102429,Zhao; Jishen,0,4,0,0
1668523339972,CSE 290,F00,102436,Tullsen; Dean Michael,0,5,0,0
1668523339972,CSE 290,G00,102440,Christensen; Henrik I,0,6,20,20
1668523340406,CSE 291,A00,102443,Su; Hao,0,0,0,0
1668523340406,CSE 291,B00,102448,Polikarpova; Nadezhda,0,0,0,0
1668523340406,CSE 291,C00,102453,Vaccaro; Kristen Marie,0,0,0,0
1668523340406,CSE 291,D00,111343,Savage; Stefan,0,0,0,0
1668523340406,CSE 291,E00,116474,Claffy; Kimberly Claire,0,0,0,0
1668523340406,CSE 291,F00,116479,Pasquale; Joseph,0,0,0,0
1668523340856,CSE 293,001,119111,Bafna; Vineet,9999,0,9999,0
1668523340856,CSE 293,002,119118,Bellare; Mihir,9999,0,9999,0
1668523340856,CSE 293,003,119122,Berg-Kirkpatrick; Taylor D,9999,0,9999,0
1668523340856,CSE 293,004,119135,Christensen; Henrik I,9999,0,9999,0
1668523340856,CSE 293,005,119142,Cottrell; Garrison W,9999,0,9999,0
1668523340856,CSE 293,006,119146,Deutsch; Alin Bernard,9999,0,9999,0
1668523340856,CSE 293,007,119159,Esmaeilzadeh; Hadi,9999,0,9999,0
1668523340856,CSE 293,008,119166,Freund; Yoav,9999,0,9999,0
1668523340856,CSE 293,009,119170,Griswold; William G.,9999,0,9999,0
1668523340856,CSE 293,010,119183,Gymrek; Melissa Ann,9999,0,9999,0
1668523340856,CSE 293,011,119190,Heninger; Nadia A,9999,0,9999,0
1668523340856,CSE 293,012,119230,Impagliazzo; Russell,9999,0,9999,0
1668523340856,CSE 293,013,119232,Jhala; Ranjit,9999,0,9999,0
1668523340856,CSE 293,014,119233,Kahng; Andrew Byun,9999,0,9999,0
1668523340856,CSE 293,015,119298,Kane; Daniel Mertz,9999,0,9999,0
1668523340856,CSE 293,016,119299,Kriegman; David J,9999,0,9999,0
1668523340856,CSE 293,017,119300,Kumar; Arun Kumar,9999,0,9999,0
1668523340856,CSE 293,018,119301,Lerner; Sorin,9999,0,9999,0
1668523340856,CSE 293,019,119302,Lovett; Shachar,9999,0,9999,0
1668523340856,CSE 293,020,119303,McAuley; Julian John,9999,0,9999,0
1668523340856,CSE 293,021,119304,Micciancio; Daniele,9999,0,9999,0
1668523340856,CSE 293,022,119367,Orailoglu; Alex,9999,0,9999,0
1668523340856,CSE 293,023,119382,Paturi; Ramamohan,9999,0,9999,0
1668523340856,CSE 293,024,119404,Polikarpova; Nadezhda,9999,0,9999,0
1668523340856,CSE 293,025,119406,Politz; Joseph Gibbs,9999,0,9999,0
1668523340856,CSE 293,026,119411,Porter; George M,9999,0,9999,0
1668523340856,CSE 293,027,119414,Porter; Leonard Emerson,9999,0,9999,0
1668523340856,CSE 293,028,119416,Ramamoorthi; Ravi,9999,0,9999,0
1668523340856,CSE 293,029,119417,Sahoo; Debashis,9999,0,9999,0
1668523340856,CSE 293,030,119420,Saul; Lawrence,9999,0,9999,0
1668523340856,CSE 293,031,119421,Savage; Stefan,9999,0,9999,0
1668523340856,CSE 293,032,119425,Schulze; Jurgen P.,9999,0,9999,0
1668523340856,CSE 293,033,119426,Snoeren; Alex C.,9999,0,9999,0
1668523340856,CSE 293,034,119428,Shang; Jingbo,9999,0,9999,0
1668523340856,CSE 293,035,119430,Stefan; Deian,9999,0,9999,0
1668523340856,CSE 293,036,119431,Su; Hao,9999,0,9999,0
1668523340856,CSE 293,037,119433,Swanson; Steven James,9999,0,9999,0
1668523340856,CSE 293,038,119435,Tullsen; Dean Michael,9999,0,9999,0
1668523340856,CSE 293,039,119483,Voelker; Geoffrey M.,9999,0,9999,0
1668523340856,CSE 293,040,119537,Zhao; Jishen,9999,0,9999,0
1668523340856,CSE 293,041,119538,Zhou; Yuan-Yuan,9999,0,9999,0
1668523340856,CSE 293,042,119539,Gao; Sicun,9999,0,9999,0
1668523340856,CSE 293,043,119540,Weibel; Nadir,9999,0,9999,0
1668523340856,CSE 293,044,119541,Gupta; Rajesh K.,9999,0,9999,0
1668523340856,CSE 293,045,126410,Vaccaro; Kristen Marie,9999,0,9999,0
1668523340856,CSE 293,046,126411,Klemke; Richard,9999,0,9999,0
1668523341283,CSE 294,A00,102459,Voelker; Geoffrey M.,0,2,0,0
1668523341283,CSE 294,B00,111322,Orailoglu; Alex,0,2,0,0
1668523341709,DSE 201,A00,096914,Deutsch; Alin Bernard,30,0,30,0
1668523342137,DSE 210,A00,096915,Dasgupta; Sanjoy,30,0,30,0
1668523342672,DSE 260A,A00,096916,Altintas De Callaf; Ilkay,30,0,30,0
1668523343144,ECE 200,001,103586,Antipa; Nicholas A,9999,0,9999,0
1668523343144,ECE 200,002,103587,Atanasov; Nikolay A.,9999,0,9999,0
1668523343144,ECE 200,003,103588,Bharadia; Dinesh,9999,0,9999,0
1668523343144,ECE 200,004,103589,Cheng; Chung Kuan,9999,0,9999,0
1668523343144,ECE 200,005,103590,Cosman; Pamela C.,9999,0,9999,0
1668523343144,ECE 200,006,103591,Dayeh; Shadi Ahmad,9999,0,9999,0
1668523343144,ECE 200,007,103592,Fainman; Yeshaiahu,9999,0,9999,0
1668523343144,ECE 200,008,103593,Ford; Joseph Earl,9999,0,9999,0
1668523343144,ECE 200,009,103594,Franceschetti; Massimo,9999,0,9999,0
1668523343144,ECE 200,010,103595,Fullerton; Eric E,9999,0,9999,0
1668523343144,ECE 200,011,103596,Galton; Ian A,9999,0,9999,0
1668523343144,ECE 200,012,103597,Gilja; Vikash,9999,0,9999,0
1668523343144,ECE 200,013,103598,Hall; Drew A.,9999,0,9999,0
1668523343144,ECE 200,014,103599,Hsueh; Tzu-Chien,9999,0,9999,0
1668523343144,ECE 200,015,103600,Javidi; Tara,9999,0,9999,0
1668523343144,ECE 200,016,103601,Kahng; Andrew Byun,9999,0,9999,0
1668523343144,ECE 200,017,103602,Kim; Young-Han,9999,0,9999,0
1668523343144,ECE 200,018,103603,Koushanfar; Farinaz,9999,0,9999,0
1668523343144,ECE 200,019,103604,Kuzum; Duygu,9999,0,9999,0
1668523343144,ECE 200,020,103605,Le; Hanh-Phuc,9999,0,9999,0
1668523343144,ECE 200,021,103606,Lin; Bill,9999,0,9999,0
1668523343144,ECE 200,022,103607,Liu; Zhaowei,9998,0,9999,1
1668523343144,ECE 200,023,103608,Lo; Yu-Hwa,9999,0,9999,0
1668523343144,ECE 200,024,103609,Lomakin; Vitaliy,9999,0,9999,0
1668523343144,ECE 200,025,103610,Mercier; Patrick Philip,9999,0,9999,0
1668523343144,ECE 200,026,103611,Meyer; Florian,9999,0,9999,0
1668523343144,ECE 200,027,103612,Milstein; Laurence B.,9999,0,9999,0
1668523343144,ECE 200,028,103613,Mir Arabbaygi; Siavash,9999,0,9999,0
1668523343144,ECE 200,029,103614,Mookherjea; Shayan,9999,0,9999,0
1668523343144,ECE 200,030,103615,Morris; Karcher William,9999,0,9999,0
1668523343144,ECE 200,031,103616,Ng; Tse Nga,9999,0,9999,0
1668523343144,ECE 200,032,103617,Nguyen; Truong Quang,9999,0,9999,0
1668523343144,ECE 200,033,103618,Nomura; Kenji,9999,0,9999,0
1668523343144,ECE 200,034,103619,Orlitsky; Alon,9999,0,9999,0
1668523343144,ECE 200,035,103620,Pal; Piya,9999,0,9999,0
1668523343144,ECE 200,036,103621,Papen; George C.,9999,0,9999,0
1668523343144,ECE 200,037,103622,Radic; Stojan,9999,0,9999,0
1668523343144,ECE 200,038,103623,Rao; Bhaskar D.,9999,0,9999,0
1668523343144,ECE 200,039,103624,Rao; Ramesh R,9999,0,9999,0
1668523343144,ECE 200,040,103625,Rebeiz; Gabriel,9999,0,9999,0
1668523343144,ECE 200,041,103626,Sanford; John R,9999,0,9999,0
1668523343144,ECE 200,042,103627,Siegel; Paul H.,9999,0,9999,0
1668523343144,ECE 200,043,103628,Sievenpiper; Daniel F.,9999,0,9999,0
1668523343144,ECE 200,044,103629,Sworder; David D.,9999,0,9999,0
1668523343144,ECE 200,045,103630,Taur; Yuan,9999,0,9999,0
1668523343144,ECE 200,046,103631,Touri; Behrouz,9999,0,9999,0
1668523343144,ECE 200,047,103632,Trivedi; Mohan M.,9999,0,9999,0
1668523343144,ECE 200,048,103633,Vasconcelos; Nuno,9999,0,9999,0
1668523343144,ECE 200,049,103634,Wang; Xiaolong,9999,0,9999,0
1668523343144,ECE 200,050,103635,Xie; Pengtao,9999,0,9999,0
1668523343144,ECE 200,051,103636,Yip; Michael,9999,0,9999,0
1668523343144,ECE 200,052,103637,Zeger; Kenneth A.,999,0,999,0
1668523343144,ECE 200,053,103638,Zhang; Xinyu,9999,0,9999,0
1668523343144,ECE 200,054,103639,Turakhia; Yatish Girish,9999,0,9999,0
1668523343144,ECE 200,055,103640,Kang; Mingu,9999,0,9999,0
1668523343144,ECE 200,056,103641,Shi; Yuanyuan,9999,0,9999,0
1668523343144,ECE 200,057,103642,Wang; Edward Jay,9999,0,9999,0
1668523343144,ECE 200,058,103643,Zheng; Yang,9999,0,9999,0
1668523343578,ECE 202,A00,103644,Kuzum; Duygu,0,44,0,0
1668523344007,ECE 212BN,A00,103646,Ng; Tse Nga,0,9,0,0
1668523344431,ECE 221,A00,111493,Staff,0,0,0,0
1668523344860,ECE 222B,A00,103647,Lomakin; Vitaliy,0,20,0,0
1668523345288,ECE 230B,A00,103648,Taur; Yuan,0,3,0,0
1668523345711,ECE 238B,A00,103649,Garay; Javier,0,0,0,0
1668523346135,ECE 240B,A00,112900,Fainman; Yeshaiahu,0,7,0,0
1668523346562,ECE 247A,A00,103650,Jokerst; Jesse Vincent,0,6,0,0
1668523346987,ECE 247B,A00,103651,Wang; Joseph,0,14,0,0
1668523347419,ECE 250,A00,103652,Siegel; Paul H.,0,82,0,0
1668523347843,ECE 251A,A00,103654,Rao; Bhaskar D.,0,62,0,0
1668523348269,ECE 257B,A00,103655,Bharadia; Dinesh,0,33,0,0
1668523348693,ECE 258A,A00,103656,Milstein; Laurence B.,0,29,0,0
1668523349121,ECE 260B,A00,103658,Kang; Mingu,0,119,0,0
1668523349549,ECE 264A,A00,103659,Galton; Ian A,0,66,0,0
1668523349972,ECE 265A,A00,103661,Gudem; Prasad S.S.,0,70,0,0
1668523350412,ECE 265D,A00,103662,Gudem; Prasad S.S.,0,26,0,0
1668523350840,ECE 268,A00,103663,Koushanfar; Farinaz,0,43,0,0
1668523351267,ECE 269,A01,103665,Pal; Piya,0,215,0,0
1668523351696,ECE 271B,A00,103666,Vasconcelos; Manuela,0,76,0,0
1668523352120,ECE 276A,A00,103667,Atanasov; Nikolay A.,0,126,0,0
1668523352559,ECE 277,A00,103668,An; Cheolhong,0,149,0,0
1668523353001,ECE 279,A00,117947,Hall; Drew A.,0,22,0,0
1668523353862,ECE 283,A00,103670,Hsueh; Tzu-Chien,0,53,0,0
1668523354300,ECE 284,A00,103671,Turakhia; Yatish Girish,0,39,0,0
1668523354726,ECE 285,A00,103672,Zheng; Yang,0,39,0,0
1668523354726,ECE 285,B00,103673,Sworder; David D.,0,57,0,0
1668523355152,ECE 287,A00,103676,Javidi; Tara,0,9,0,0
1668523355578,MATH 200B,A00,098023,Salehi Golsefidy; Alireza,10,0,15,5
1668523356001,MATH 202B,A00,098024,Rhoades; Brendon Patrick,7,0,15,8
1668523356427,MATH 203B,A00,098025,Oprea; Dragos N.,9,0,15,6
1668523356852,MATH 204B,A00,098026,Sorensen; Claus M,13,0,15,2
1668523357290,MATH 208,A00,098027,Izadi; Elham,7,0,10,3
1668523357716,MATH 209,A00,098028,Pollack; Aaron,10,0,10,0
1668523358147,MATH 211A,A00,112919,Rogalski; Daniel,8,0,10,2
1668523358572,MATH 211B,A00,112920,Seward; Brandon M.,9,0,10,1
1668523359012,MATH 218,A00,098029,Li; Bo,10,0,10,0
1668523359453,MATH 220B,A00,098030,Novak; Jonathan I,11,0,15,4
1668523359886,MATH 221A,A00,098031,Ebenfelt; Peter F,12,0,15,3
1668523360313,MATH 231B,A00,098032,Zlatos; Andrej,11,0,15,4
1668523360745,MATH 240B,A00,098033,Ni; Lei,7,0,15,8
1668523361175,MATH 243,A00,098034,Jekel; David Andrew,10,0,10,0
1668523361600,MATH 245A,A00,098035,Nie; Jiawang,0,4,15,18
1668523362027,MATH 248,A00,098036,Bejenaru; Ioan,10,0,10,0
1668523362451,MATH 250B,A00,098037,Spolaor; Luca,14,0,15,1
1668523362934,MATH 258,A00,098038,Ni; Lei,9,0,10,1
1668523363361,MATH 264B,A00,098041,Rhoades; Brendon Patrick,8,0,15,7
1668523363785,MATH 268,A00,098042,Buss; Samuel R,10,0,10,0
1668523364211,MATH 269,A00,098043,Rhoades; Brendon Patrick,10,0,10,0
1668523364635,MATH 270B,A00,098044,Li; Bo,6,0,15,9
1668523365072,MATH 272B,A00,098045,Holst; Michael J,13,0,15,2
1668523365505,MATH 273A,A00,098046,Tian; Xiaochuan,10,0,15,5
1668523365930,MATH 275,A01,098048,Tian; Xiaochuan,6,0,10,4
1668523366353,MATH 278A,A00,098049,Holst; Michael J,7,0,10,3
1668523366780,MATH 278B,A00,098050,Cloninger; Alexander,10,0,10,0
1668523367208,MATH 278C,A00,098051,Nie; Jiawang,5,0,10,5
1668523367632,MATH 280B,A00,098052,Zheng; Tianyi,7,0,15,8
1668523368055,MATH 281B,A00,098053,Bradic; Jelena,0,2,15,15
1668523368482,MATH 282B,A00,098054,Arias-Castro; Ery,0,1,15,15
1668523368913,MATH 285,A00,098055,Fitzsimmons; Patrick J,0,3,15,17
1668523369339,MATH 287B,A00,098056,Arias-Castro; Ery,1,0,15,14
1668523369766,MATH 288,A00,098057,Agarwal; Pooja,9,0,10,1
1668523369766,MATH 288,B00,098058,Zhang; Danna,8,0,10,2
1668523369766,MATH 288,C00,098059,Williams; Ruth J,9,0,10,1
1668523370195,MATH 290B,A00,098060,Roberts; Justin Deritter,12,0,15,3
1668523370627,MATH 292,A00,098061,Belmont; Eva Kinoshita,10,0,10,0
1668523371051,MATH 295,A00,098062,Suk; Andrew Hoon,47,0,50,3
1668523371475,MATH 296,A00,098063,Novak; Jonathan I,20,0,20,0
1668523371903,MATH 297,001,098064,Gamst; Anthony Collins,9997,0,9999,2
1668523874915,COGS 205,A00,101395,Chiba; Andrea,19,0,20,1
1668523875348,COGS 210B,001,101404,Greene; Deanna Jacquelyn,9998,0,9999,1
1668523875348,COGS 210B,002,101417,Xia; Haijun,9999,0,9999,0
1668523875348,COGS 210B,003,101422,Nitz; Douglas A.,9999,0,9999,0
1668523875348,COGS 210B,004,101423,Hollan; James D.,9998,0,9999,1
1668523875348,COGS 210B,005,101424,Deak; Gedeon O.,9998,0,9999,1
1668523875348,COGS 210B,006,101425,Rossano; Federico,9999,0,9999,0
1668523875787,COGS 211B,A00,101427,Coulson; Seana M,9996,0,9999,3
1668523876216,COGS 220,A00,101428,Hollan; James D.,0,10,25,25
1668523876647,COGS 229,A00,101429,Dow; Steven P,17,0,25,8
1668523877081,COGS 230,A00,101430,Klemmer; Scott R,7,0,17,10
1668523877522,COGS 234,A00,101431,Xia; Haijun,1,0,25,24
1668523877946,COGS 260,A00,101432,Kiyonaga; Anastasia,21,0,25,4
1668523877946,COGS 260,B00,101433,Kirsh; David Joel,15,0,25,10
1668523878371,CSE 202,A00,102371,Impagliazzo; Russell,0,66,0,0
1668523878797,CSE 203B,A01,102373,Cheng; Chung Kuan,0,58,0,0
1668523879220,CSE 208,A00,102374,Micciancio; Daniele,0,5,0,0
1668523879651,CSE 209A,A00,112895,Impagliazzo; Russell,0,12,15,15
1668523880075,CSE 209B,A00,108005,Bellare; Mihir,0,7,0,0
1668523880499,CSE 210,A00,113163,Coblenz; Michael J,0,85,0,0
1668523880923,CSE 219,A00,106111,Dow; Steven P,0,6,20,20
1668523881357,CSE 221,A00,102376,Voelker; Geoffrey M.,0,73,0,0
1668523881798,CSE 224,A01,102378,Porter; George M,0,166,0,0
1668523882222,CSE 229A,A00,102379,Savage; Stefan,0,10,0,0
1668523882645,CSE 229C,A00,102380,Munyaka; Imani N. S.,0,10,0,0
1668523883072,CSE 232B,A00,102382,Deutsch; Alin Bernard,0,32,0,0
1668523883495,CSE 234,A01,112904,Kumar; Arun Kumar,0,0,0,0
1668523883918,CSE 237A,A00,102383,Rosing; Tajana Simunic,0,55,0,0
1668523884346,CSE 239A,A00,102384,Deutsch; Alin Bernard,0,14,0,0
1668523884773,CSE 239B,A00,102385,Polikarpova; Nadezhda,0,10,0,0
1668523885200,CSE 240A,A00,102386,Pannuto; Patrick William,0,46,0,0
1668523885624,CSE 240B,A00,102387,Zhao; Jishen,0,47,0,0
1668523886058,CSE 241A,A00,106406,Kang; Mingu,0,9,0,0
1668523886481,CSE 249B,A00,102388,Kahng; Andrew Byun,0,5,8,8
1668523886913,CSE 251B,A01,102392,Cottrell; Garrison W,0,51,0,0
1668523886913,CSE 251B,A02,102393,Cottrell; Garrison W,0,34,0,0
1668523887336,CSE 252B,A00,102394,Ochoa; Benjamin Lawrence,0,59,0,0
1668523887763,CSE 257,A01,102396,Gao; Sicun,0,139,0,0
1668523888190,CSE 272,A00,102397,Li; Tzumao,0,19,0,0
1668523888614,CSE 274,A00,111323,Chern; Albert Ren-Haur,0,15,0,0
1668523889065,CSE 282,A00,102398,Pevzner; Pavel Arkadjevich,0,0,0,0
1668523889498,CSE 284,A00,114175,Gymrek; Melissa Ann,0,22,0,0
1668523889926,CSE 290,A00,102399,Chandraker; Manmohan Krishna,0,11,0,0
1668523889926,CSE 290,B00,102400,Vaccaro; Kristen Marie,0,7,25,25
1668523889926,CSE 290,C00,102414,Pannuto; Patrick William,0,1,25,25
1668523889926,CSE 290,D00,102427,Pevzner; Pavel Arkadjevich,0,0,0,0
1668523889926,CSE 290,E00,102429,Zhao; Jishen,0,4,0,0
1668523889926,CSE 290,F00,102436,Tullsen; Dean Michael,0,5,0,0
1668523889926,CSE 290,G00,102440,Christensen; Henrik I,0,6,20,20
1668523890360,CSE 291,A00,102443,Su; Hao,0,0,0,0
1668523890360,CSE 291,B00,102448,Polikarpova; Nadezhda,0,0,0,0
1668523890360,CSE 291,C00,102453,Vaccaro; Kristen Marie,0,0,0,0
1668523890360,CSE 291,D00,111343,Savage; Stefan,0,0,0,0
1668523890360,CSE 291,E00,116474,Claffy; Kimberly Claire,0,0,0,0
1668523890360,CSE 291,F00,116479,Pasquale; Joseph,0,0,0,0
1668523890800,CSE 293,001,119111,Bafna; Vineet,9999,0,9999,0
1668523890800,CSE 293,002,119118,Bellare; Mihir,9999,0,9999,0
1668523890800,CSE 293,003,119122,Berg-Kirkpatrick; Taylor D,9999,0,9999,0
1668523890800,CSE 293,004,119135,Christensen; Henrik I,9999,0,9999,0
1668523890800,CSE 293,005,119142,Cottrell; Garrison W,9999,0,9999,0
1668523890800,CSE 293,006,119146,Deutsch; Alin Bernard,9999,0,9999,0
1668523890800,CSE 293,007,119159,Esmaeilzadeh; Hadi,9999,0,9999,0
1668523890800,CSE 293,008,119166,Freund; Yoav,9999,0,9999,0
1668523890800,CSE 293,009,119170,Griswold; William G.,9999,0,9999,0
1668523890800,CSE 293,010,119183,Gymrek; Melissa Ann,9999,0,9999,0
1668523890800,CSE 293,011,119190,Heninger; Nadia A,9999,0,9999,0
1668523890800,CSE 293,012,119230,Impagliazzo; Russell,9999,0,9999,0
1668523890800,CSE 293,013,119232,Jhala; Ranjit,9999,0,9999,0
1668523890800,CSE 293,014,119233,Kahng; Andrew Byun,9999,0,9999,0
1668523890800,CSE 293,015,119298,Kane; Daniel Mertz,9999,0,9999,0
1668523890800,CSE 293,016,119299,Kriegman; David J,9999,0,9999,0
1668523890800,CSE 293,017,119300,Kumar; Arun Kumar,9999,0,9999,0
1668523890800,CSE 293,018,119301,Lerner; Sorin,9999,0,9999,0
1668523890800,CSE 293,019,119302,Lovett; Shachar,9999,0,9999,0
1668523890800,CSE 293,020,119303,McAuley; Julian John,9999,0,9999,0
1668523890800,CSE 293,021,119304,Micciancio; Daniele,9999,0,9999,0
1668523890800,CSE 293,022,119367,Orailoglu; Alex,9999,0,9999,0
1668523890800,CSE 293,023,119382,Paturi; Ramamohan,9999,0,9999,0
1668523890800,CSE 293,024,119404,Polikarpova; Nadezhda,9999,0,9999,0
1668523890800,CSE 293,025,119406,Politz; Joseph Gibbs,9999,0,9999,0
1668523890800,CSE 293,026,119411,Porter; George M,9999,0,9999,0
1668523890800,CSE 293,027,119414,Porter; Leonard Emerson,9999,0,9999,0
1668523890800,CSE 293,028,119416,Ramamoorthi; Ravi,9999,0,9999,0
1668523890800,CSE 293,029,119417,Sahoo; Debashis,9999,0,9999,0
1668523890800,CSE 293,030,119420,Saul; Lawrence,9999,0,9999,0
1668523890800,CSE 293,031,119421,Savage; Stefan,9999,0,9999,0
1668523890800,CSE 293,032,119425,Schulze; Jurgen P.,9999,0,9999,0
1668523890800,CSE 293,033,119426,Snoeren; Alex C.,9999,0,9999,0
1668523890800,CSE 293,034,119428,Shang; Jingbo,9999,0,9999,0
1668523890800,CSE 293,035,119430,Stefan; Deian,9999,0,9999,0
1668523890800,CSE 293,036,119431,Su; Hao,9999,0,9999,0
1668523890800,CSE 293,037,119433,Swanson; Steven James,9999,0,9999,0
1668523890800,CSE 293,038,119435,Tullsen; Dean Michael,9999,0,9999,0
1668523890800,CSE 293,039,119483,Voelker; Geoffrey M.,9999,0,9999,0
1668523890800,CSE 293,040,119537,Zhao; Jishen,9999,0,9999,0
1668523890800,CSE 293,041,119538,Zhou; Yuan-Yuan,9999,0,9999,0
1668523890800,CSE 293,042,119539,Gao; Sicun,9999,0,9999,0
1668523890800,CSE 293,043,119540,Weibel; Nadir,9999,0,9999,0
1668523890800,CSE 293,044,119541,Gupta; Rajesh K.,9999,0,9999,0
1668523890800,CSE 293,045,126410,Vaccaro; Kristen Marie,9999,0,9999,0
1668523890800,CSE 293,046,126411,Klemke; Richard,9999,0,9999,0
1668523891237,CSE 294,A00,102459,Voelker; Geoffrey M.,0,2,0,0
1668523891237,CSE 294,B00,111322,Orailoglu; Alex,0,2,0,0
1668523891664,DSE 201,A00,096914,Deutsch; Alin Bernard,30,0,30,0
1668523892094,DSE 210,A00,096915,Dasgupta; Sanjoy,30,0,30,0
1668523892521,DSE 260A,A00,096916,Altintas De Callaf; Ilkay,30,0,30,0
1668523892957,ECE 200,001,103586,Antipa; Nicholas A,9999,0,9999,0
1668523892957,ECE 200,002,103587,Atanasov; Nikolay A.,9999,0,9999,0
1668523892957,ECE 200,003,103588,Bharadia; Dinesh,9999,0,9999,0
1668523892957,ECE 200,004,103589,Cheng; Chung Kuan,9999,0,9999,0
1668523892957,ECE 200,005,103590,Cosman; Pamela C.,9999,0,9999,0
1668523892957,ECE 200,006,103591,Dayeh; Shadi Ahmad,9999,0,9999,0
1668523892957,ECE 200,007,103592,Fainman; Yeshaiahu,9999,0,9999,0
1668523892957,ECE 200,008,103593,Ford; Joseph Earl,9999,0,9999,0
1668523892957,ECE 200,009,103594,Franceschetti; Massimo,9999,0,9999,0
1668523892957,ECE 200,010,103595,Fullerton; Eric E,9999,0,9999,0
1668523892957,ECE 200,011,103596,Galton; Ian A,9999,0,9999,0
1668523892957,ECE 200,012,103597,Gilja; Vikash,9999,0,9999,0
1668523892957,ECE 200,013,103598,Hall; Drew A.,9999,0,9999,0
1668523892957,ECE 200,014,103599,Hsueh; Tzu-Chien,9999,0,9999,0
1668523892957,ECE 200,015,103600,Javidi; Tara,9999,0,9999,0
1668523892957,ECE 200,016,103601,Kahng; Andrew Byun,9999,0,9999,0
1668523892957,ECE 200,017,103602,Kim; Young-Han,9999,0,9999,0
1668523892957,ECE 200,018,103603,Koushanfar; Farinaz,9999,0,9999,0
1668523892957,ECE 200,019,103604,Kuzum; Duygu,9999,0,9999,0
1668523892957,ECE 200,020,103605,Le; Hanh-Phuc,9999,0,9999,0
1668523892957,ECE 200,021,103606,Lin; Bill,9999,0,9999,0
1668523892957,ECE 200,022,103607,Liu; Zhaowei,9998,0,9999,1
1668523892957,ECE 200,023,103608,Lo; Yu-Hwa,9999,0,9999,0
1668523892957,ECE 200,024,103609,Lomakin; Vitaliy,9999,0,9999,0
1668523892957,ECE 200,025,103610,Mercier; Patrick Philip,9999,0,9999,0
1668523892957,ECE 200,026,103611,Meyer; Florian,9999,0,9999,0
1668523892957,ECE 200,027,103612,Milstein; Laurence B.,9999,0,9999,0
1668523892957,ECE 200,028,103613,Mir Arabbaygi; Siavash,9999,0,9999,0
1668523892957,ECE 200,029,103614,Mookherjea; Shayan,9999,0,9999,0
1668523892957,ECE 200,030,103615,Morris; Karcher William,9999,0,9999,0
1668523892957,ECE 200,031,103616,Ng; Tse Nga,9999,0,9999,0
1668523892957,ECE 200,032,103617,Nguyen; Truong Quang,9999,0,9999,0
1668523892957,ECE 200,033,103618,Nomura; Kenji,9999,0,9999,0
1668523892957,ECE 200,034,103619,Orlitsky; Alon,9999,0,9999,0
1668523892957,ECE 200,035,103620,Pal; Piya,9999,0,9999,0
1668523892957,ECE 200,036,103621,Papen; George C.,9999,0,9999,0
1668523892957,ECE 200,037,103622,Radic; Stojan,9999,0,9999,0
1668523892957,ECE 200,038,103623,Rao; Bhaskar D.,9999,0,9999,0
1668523892957,ECE 200,039,103624,Rao; Ramesh R,9999,0,9999,0
1668523892957,ECE 200,040,103625,Rebeiz; Gabriel,9999,0,9999,0
1668523892957,ECE 200,041,103626,Sanford; John R,9999,0,9999,0
1668523892957,ECE 200,042,103627,Siegel; Paul H.,9999,0,9999,0
1668523892957,ECE 200,043,103628,Sievenpiper; Daniel F.,9999,0,9999,0
1668523892957,ECE 200,044,103629,Sworder; David D.,9999,0,9999,0
1668523892957,ECE 200,045,103630,Taur; Yuan,9999,0,9999,0
1668523892957,ECE 200,046,103631,Touri; Behrouz,9999,0,9999,0
1668523892957,ECE 200,047,103632,Trivedi; Mohan M.,9999,0,9999,0
1668523892957,ECE 200,048,103633,Vasconcelos; Nuno,9999,0,9999,0
1668523892957,ECE 200,049,103634,Wang; Xiaolong,9999,0,9999,0
1668523892957,ECE 200,050,103635,Xie; Pengtao,9999,0,9999,0
1668523892957,ECE 200,051,103636,Yip; Michael,9999,0,9999,0
1668523892957,ECE 200,052,103637,Zeger; Kenneth A.,999,0,999,0
1668523892957,ECE 200,053,103638,Zhang; Xinyu,9999,0,9999,0
1668523892957,ECE 200,054,103639,Turakhia; Yatish Girish,9999,0,9999,0
1668523892957,ECE 200,055,103640,Kang; Mingu,9999,0,9999,0
1668523892957,ECE 200,056,103641,Shi; Yuanyuan,9999,0,9999,0
1668523892957,ECE 200,057,103642,Wang; Edward Jay,9999,0,9999,0
1668523892957,ECE 200,058,103643,Zheng; Yang,9999,0,9999,0
1668523893385,ECE 202,A00,103644,Kuzum; Duygu,0,44,0,0
1668523893810,ECE 212BN,A00,103646,Ng; Tse Nga,0,9,0,0
1668523894239,ECE 221,A00,111493,Staff,0,0,0,0
1668523894673,ECE 222B,A00,103647,Lomakin; Vitaliy,0,20,0,0
1668523895096,ECE 230B,A00,103648,Taur; Yuan,0,3,0,0
1668523895522,ECE 238B,A00,103649,Garay; Javier,0,0,0,0
1668523895945,ECE 240B,A00,112900,Fainman; Yeshaiahu,0,7,0,0
1668523896368,ECE 247A,A00,103650,Jokerst; Jesse Vincent,0,6,0,0
1668523896796,ECE 247B,A00,103651,Wang; Joseph,0,14,0,0
1668523897235,ECE 250,A00,103652,Siegel; Paul H.,0,82,0,0
1668523897670,ECE 251A,A00,103654,Rao; Bhaskar D.,0,62,0,0
1668523898093,ECE 257B,A00,103655,Bharadia; Dinesh,0,33,0,0
1668523898517,ECE 258A,A00,103656,Milstein; Laurence B.,0,29,0,0
1668523898944,ECE 260B,A00,103658,Kang; Mingu,0,119,0,0
1668523899367,ECE 264A,A00,103659,Galton; Ian A,0,66,0,0
1668523899795,ECE 265A,A00,103661,Gudem; Prasad S.S.,0,70,0,0
1668523900227,ECE 265D,A00,103662,Gudem; Prasad S.S.,0,26,0,0
1668523900661,ECE 268,A00,103663,Koushanfar; Farinaz,0,43,0,0
1668523901084,ECE 269,A01,103665,Pal; Piya,0,215,0,0
1668523901512,ECE 271B,A00,103666,Vasconcelos; Manuela,0,76,0,0
1668523901941,ECE 276A,A00,103667,Atanasov; Nikolay A.,0,126,0,0
1668523902367,ECE 277,A00,103668,An; Cheolhong,0,149,0,0
1668523902792,ECE 279,A00,117947,Hall; Drew A.,0,22,0,0
1668523903655,ECE 283,A00,103670,Hsueh; Tzu-Chien,0,53,0,0
1668523904080,ECE 284,A00,103671,Turakhia; Yatish Girish,0,39,0,0
1668523904509,ECE 285,A00,103672,Zheng; Yang,0,39,0,0
1668523904509,ECE 285,B00,103673,Sworder; David D.,0,57,0,0
1668523904936,ECE 287,A00,103676,Javidi; Tara,0,9,0,0
1668523905362,MATH 200B,A00,098023,Salehi Golsefidy; Alireza,10,0,15,5
1668523905789,MATH 202B,A00,098024,Rhoades; Brendon Patrick,7,0,15,8
1668523906216,MATH 203B,A00,098025,Oprea; Dragos N.,9,0,15,6
1668523906652,MATH 204B,A00,098026,Sorensen; Claus M,13,0,15,2
1668523907078,MATH 208,A00,098027,Izadi; Elham,7,0,10,3
1668523907505,MATH 209,A00,098028,Pollack; Aaron,10,0,10,0
1668523908006,MATH 211A,A00,112919,Rogalski; Daniel,8,0,10,2
1668523908432,MATH 211B,A00,112920,Seward; Brandon M.,9,0,10,1
1668523908857,MATH 218,A00,098029,Li; Bo,10,0,10,0
1668523909284,MATH 220B,A00,098030,Novak; Jonathan I,11,0,15,4
1668523909710,MATH 221A,A00,098031,Ebenfelt; Peter F,12,0,15,3
1668523910135,MATH 231B,A00,098032,Zlatos; Andrej,11,0,15,4
1668523910562,MATH 240B,A00,098033,Ni; Lei,7,0,15,8
1668523911001,MATH 243,A00,098034,Jekel; David Andrew,10,0,10,0
1668523911425,MATH 245A,A00,098035,Nie; Jiawang,0,4,15,18
1668523911849,MATH 248,A00,098036,Bejenaru; Ioan,10,0,10,0
1668523912275,MATH 250B,A00,098037,Spolaor; Luca,14,0,15,1
1668523912701,MATH 258,A00,098038,Ni; Lei,9,0,10,1
1668523913128,MATH 264B,A00,098041,Rhoades; Brendon Patrick,8,0,15,7
1668523913550,MATH 268,A00,098042,Buss; Samuel R,10,0,10,0
1668523913973,MATH 269,A00,098043,Rhoades; Brendon Patrick,10,0,10,0
1668523914404,MATH 270B,A00,098044,Li; Bo,6,0,15,9
1668523914833,MATH 272B,A00,098045,Holst; Michael J,13,0,15,2
1668523915258,MATH 273A,A00,098046,Tian; Xiaochuan,10,0,15,5
1668523915683,MATH 275,A01,098048,Tian; Xiaochuan,6,0,10,4
1668523916108,MATH 278A,A00,098049,Holst; Michael J,7,0,10,3
1668523916543,MATH 278B,A00,098050,Cloninger; Alexander,10,0,10,0
1668523916973,MATH 278C,A00,098051,Nie; Jiawang,5,0,10,5
1668523917398,MATH 280B,A00,098052,Zheng; Tianyi,7,0,15,8
1668523917839,MATH 281B,A00,098053,Bradic; Jelena,0,2,15,15
1668523918266,MATH 282B,A00,098054,Arias-Castro; Ery,0,1,15,15
1668523918701,MATH 285,A00,098055,Fitzsimmons; Patrick J,0,3,15,17
1668523919128,MATH 287B,A00,098056,Arias-Castro; Ery,1,0,15,14
1668523919555,MATH 288,A00,098057,Agarwal; Pooja,9,0,10,1
1668523919555,MATH 288,B00,098058,Zhang; Danna,8,0,10,2
1668523919555,MATH 288,C00,098059,Williams; Ruth J,9,0,10,1
1668523919983,MATH 290B,A00,098060,Roberts; Justin Deritter,12,0,15,3
1668523920411,MATH 292,A00,098061,Belmont; Eva Kinoshita,10,0,10,0
1668523920834,MATH 295,A00,098062,Suk; Andrew Hoon,47,0,50,3
1668523921257,MATH 296,A00,098063,Novak; Jonathan I,20,0,20,0
1668523921683,MATH 297,001,098064,Gamst; Anthony Collins,9997,0,9999,2
1668524423882,COGS 205,A00,101395,Chiba; Andrea,19,0,20,1
1668524424314,COGS 210B,001,101404,Greene; Deanna Jacquelyn,9998,0,9999,1
1668524424314,COGS 210B,002,101417,Xia; Haijun,9999,0,9999,0
1668524424314,COGS 210B,003,101422,Nitz; Douglas A.,9999,0,9999,0
1668524424314,COGS 210B,004,101423,Hollan; James D.,9998,0,9999,1
1668524424314,COGS 210B,005,101424,Deak; Gedeon O.,9998,0,9999,1
1668524424314,COGS 210B,006,101425,Rossano; Federico,9999,0,9999,0
1668524424751,COGS 211B,A00,101427,Coulson; Seana M,9996,0,9999,3
1668524425179,COGS 220,A00,101428,Hollan; James D.,0,10,25,25
1668524425603,COGS 229,A00,101429,Dow; Steven P,17,0,25,8
1668524426027,COGS 230,A00,101430,Klemmer; Scott R,7,0,17,10
1668524426451,COGS 234,A00,101431,Xia; Haijun,1,0,25,24
1668524426874,COGS 260,A00,101432,Kiyonaga; Anastasia,21,0,25,4
1668524426874,COGS 260,B00,101433,Kirsh; David Joel,15,0,25,10
1668524427311,CSE 202,A00,102371,Impagliazzo; Russell,0,66,0,0
1668524427732,CSE 203B,A01,102373,Cheng; Chung Kuan,0,58,0,0
1668524428160,CSE 208,A00,102374,Micciancio; Daniele,0,5,0,0
1668524428593,CSE 209A,A00,112895,Impagliazzo; Russell,0,12,15,15
1668524429114,CSE 209B,A00,108005,Bellare; Mihir,0,7,0,0
1668524429537,CSE 210,A00,113163,Coblenz; Michael J,0,85,0,0
1668524429961,CSE 219,A00,106111,Dow; Steven P,0,6,20,20
1668524430384,CSE 221,A00,102376,Voelker; Geoffrey M.,0,73,0,0
1668524430814,CSE 224,A01,102378,Porter; George M,0,166,0,0
1668524431236,CSE 229A,A00,102379,Savage; Stefan,0,10,0,0
1668524431659,CSE 229C,A00,102380,Munyaka; Imani N. S.,0,10,0,0
1668524432085,CSE 232B,A00,102382,Deutsch; Alin Bernard,0,32,0,0
1668524432514,CSE 234,A01,112904,Kumar; Arun Kumar,0,0,0,0
1668524432939,CSE 237A,A00,102383,Rosing; Tajana Simunic,0,55,0,0
1668524433380,CSE 239A,A00,102384,Deutsch; Alin Bernard,0,14,0,0
1668524433809,CSE 239B,A00,102385,Polikarpova; Nadezhda,0,10,0,0
1668524434238,CSE 240A,A00,102386,Pannuto; Patrick William,0,46,0,0
1668524434668,CSE 240B,A00,102387,Zhao; Jishen,0,47,0,0
1668524435100,CSE 241A,A00,106406,Kang; Mingu,0,9,0,0
1668524435525,CSE 249B,A00,102388,Kahng; Andrew Byun,0,5,8,8
1668524435949,CSE 251B,A01,102392,Cottrell; Garrison W,0,51,0,0
1668524435949,CSE 251B,A02,102393,Cottrell; Garrison W,0,34,0,0
1668524436388,CSE 252B,A00,102394,Ochoa; Benjamin Lawrence,0,59,0,0
1668524436810,CSE 257,A01,102396,Gao; Sicun,0,139,0,0
1668524437243,CSE 272,A00,102397,Li; Tzumao,0,19,0,0
1668524437678,CSE 274,A00,111323,Chern; Albert Ren-Haur,0,15,0,0
1668524438102,CSE 282,A00,102398,Pevzner; Pavel Arkadjevich,0,0,0,0
1668524438537,CSE 284,A00,114175,Gymrek; Melissa Ann,0,22,0,0
1668524438966,CSE 290,A00,102399,Chandraker; Manmohan Krishna,0,11,0,0
1668524438966,CSE 290,B00,102400,Vaccaro; Kristen Marie,0,7,25,25
1668524438966,CSE 290,C00,102414,Pannuto; Patrick William,0,1,25,25
1668524438966,CSE 290,D00,102427,Pevzner; Pavel Arkadjevich,0,0,0,0
1668524438966,CSE 290,E00,102429,Zhao; Jishen,0,4,0,0
1668524438966,CSE 290,F00,102436,Tullsen; Dean Michael,0,5,0,0
1668524438966,CSE 290,G00,102440,Christensen; Henrik I,0,6,20,20
1668524439392,CSE 291,A00,102443,Su; Hao,0,0,0,0
1668524439392,CSE 291,B00,102448,Polikarpova; Nadezhda,0,0,0,0
1668524439392,CSE 291,C00,102453,Vaccaro; Kristen Marie,0,0,0,0
1668524439392,CSE 291,D00,111343,Savage; Stefan,0,0,0,0
1668524439392,CSE 291,E00,116474,Claffy; Kimberly Claire,0,0,0,0
1668524439392,CSE 291,F00,116479,Pasquale; Joseph,0,0,0,0
1668524439823,CSE 293,001,119111,Bafna; Vineet,9999,0,9999,0
1668524439823,CSE 293,002,119118,Bellare; Mihir,9999,0,9999,0
1668524439823,CSE 293,003,119122,Berg-Kirkpatrick; Taylor D,9999,0,9999,0
1668524439823,CSE 293,004,119135,Christensen; Henrik I,9999,0,9999,0
1668524439823,CSE 293,005,119142,Cottrell; Garrison W,9999,0,9999,0
1668524439823,CSE 293,006,119146,Deutsch; Alin Bernard,9999,0,9999,0
1668524439823,CSE 293,007,119159,Esmaeilzadeh; Hadi,9999,0,9999,0
1668524439823,CSE 293,008,119166,Freund; Yoav,9999,0,9999,0
1668524439823,CSE 293,009,119170,Griswold; William G.,9999,0,9999,0
1668524439823,CSE 293,010,119183,Gymrek; Melissa Ann,9999,0,9999,0
1668524439823,CSE 293,011,119190,Heninger; Nadia A,9999,0,9999,0
1668524439823,CSE 293,012,119230,Impagliazzo; Russell,9999,0,9999,0
1668524439823,CSE 293,013,119232,Jhala; Ranjit,9999,0,9999,0
1668524439823,CSE 293,014,119233,Kahng; Andrew Byun,9999,0,9999,0
1668524439823,CSE 293,015,119298,Kane; Daniel Mertz,9999,0,9999,0
1668524439823,CSE 293,016,119299,Kriegman; David J,9999,0,9999,0
1668524439823,CSE 293,017,119300,Kumar; Arun Kumar,9999,0,9999,0
1668524439823,CSE 293,018,119301,Lerner; Sorin,9999,0,9999,0
1668524439823,CSE 293,019,119302,Lovett; Shachar,9999,0,9999,0
1668524439823,CSE 293,020,119303,McAuley; Julian John,9999,0,9999,0
1668524439823,CSE 293,021,119304,Micciancio; Daniele,9999,0,9999,0
1668524439823,CSE 293,022,119367,Orailoglu; Alex,9999,0,9999,0
1668524439823,CSE 293,023,119382,Paturi; Ramamohan,9999,0,9999,0
1668524439823,CSE 293,024,119404,Polikarpova; Nadezhda,9999,0,9999,0
1668524439823,CSE 293,025,119406,Politz; Joseph Gibbs,9999,0,9999,0
1668524439823,CSE 293,026,119411,Porter; George M,9999,0,9999,0
1668524439823,CSE 293,027,119414,Porter; Leonard Emerson,9999,0,9999,0
1668524439823,CSE 293,028,119416,Ramamoorthi; Ravi,9999,0,9999,0
1668524439823,CSE 293,029,119417,Sahoo; Debashis,9999,0,9999,0
1668524439823,CSE 293,030,119420,Saul; Lawrence,9999,0,9999,0
1668524439823,CSE 293,031,119421,Savage; Stefan,9999,0,9999,0
1668524439823,CSE 293,032,119425,Schulze; Jurgen P.,9999,0,9999,0
1668524439823,CSE 293,033,119426,Snoeren; Alex C.,9999,0,9999,0
1668524439823,CSE 293,034,119428,Shang; Jingbo,9999,0,9999,0
1668524439823,CSE 293,035,119430,Stefan; Deian,9999,0,9999,0
1668524439823,CSE 293,036,119431,Su; Hao,9999,0,9999,0
1668524439823,CSE 293,037,119433,Swanson; Steven James,9999,0,9999,0
1668524439823,CSE 293,038,119435,Tullsen; Dean Michael,9999,0,9999,0
1668524439823,CSE 293,039,119483,Voelker; Geoffrey M.,9999,0,9999,0
1668524439823,CSE 293,040,119537,Zhao; Jishen,9999,0,9999,0
1668524439823,CSE 293,041,119538,Zhou; Yuan-Yuan,9999,0,9999,0
1668524439823,CSE 293,042,119539,Gao; Sicun,9999,0,9999,0
1668524439823,CSE 293,043,119540,Weibel; Nadir,9999,0,9999,0
1668524439823,CSE 293,044,119541,Gupta; Rajesh K.,9999,0,9999,0
1668524439823,CSE 293,045,126410,Vaccaro; Kristen Marie,9999,0,9999,0
1668524439823,CSE 293,046,126411,Klemke; Richard,9999,0,9999,0
1668524440246,CSE 294,A00,102459,Voelker; Geoffrey M.,0,2,0,0
1668524440246,CSE 294,B00,111322,Orailoglu; Alex,0,2,0,0
1668524440671,DSE 201,A00,096914,Deutsch; Alin Bernard,30,0,30,0
1668524441106,DSE 210,A00,096915,Dasgupta; Sanjoy,30,0,30,0
1668524441531,DSE 260A,A00,096916,Altintas De Callaf; Ilkay,30,0,30,0
1668524441960,ECE 200,001,103586,Antipa; Nicholas A,9999,0,9999,0
1668524441960,ECE 200,002,103587,Atanasov; Nikolay A.,9999,0,9999,0
1668524441960,ECE 200,003,103588,Bharadia; Dinesh,9999,0,9999,0
1668524441960,ECE 200,004,103589,Cheng; Chung Kuan,9999,0,9999,0
1668524441960,ECE 200,005,103590,Cosman; Pamela C.,9999,0,9999,0
1668524441960,ECE 200,006,103591,Dayeh; Shadi Ahmad,9999,0,9999,0
1668524441960,ECE 200,007,103592,Fainman; Yeshaiahu,9999,0,9999,0
1668524441960,ECE 200,008,103593,Ford; Joseph Earl,9999,0,9999,0
1668524441960,ECE 200,009,103594,Franceschetti; Massimo,9999,0,9999,0
1668524441960,ECE 200,010,103595,Fullerton; Eric E,9999,0,9999,0
1668524441960,ECE 200,011,103596,Galton; Ian A,9999,0,9999,0
1668524441960,ECE 200,012,103597,Gilja; Vikash,9999,0,9999,0
1668524441960,ECE 200,013,103598,Hall; Drew A.,9999,0,9999,0
1668524441960,ECE 200,014,103599,Hsueh; Tzu-Chien,9999,0,9999,0
1668524441960,ECE 200,015,103600,Javidi; Tara,9999,0,9999,0
1668524441960,ECE 200,016,103601,Kahng; Andrew Byun,9999,0,9999,0
1668524441960,ECE 200,017,103602,Kim; Young-Han,9999,0,9999,0
1668524441960,ECE 200,018,103603,Koushanfar; Farinaz,9999,0,9999,0
1668524441960,ECE 200,019,103604,Kuzum; Duygu,9999,0,9999,0
1668524441960,ECE 200,020,103605,Le; Hanh-Phuc,9999,0,9999,0
1668524441960,ECE 200,021,103606,Lin; Bill,9999,0,9999,0
1668524441960,ECE 200,022,103607,Liu; Zhaowei,9998,0,9999,1
1668524441960,ECE 200,023,103608,Lo; Yu-Hwa,9999,0,9999,0
1668524441960,ECE 200,024,103609,Lomakin; Vitaliy,9999,0,9999,0
1668524441960,ECE 200,025,103610,Mercier; Patrick Philip,9999,0,9999,0
1668524441960,ECE 200,026,103611,Meyer; Florian,9999,0,9999,0
1668524441960,ECE 200,027,103612,Milstein; Laurence B.,9999,0,9999,0
1668524441960,ECE 200,028,103613,Mir Arabbaygi; Siavash,9999,0,9999,0
1668524441960,ECE 200,029,103614,Mookherjea; Shayan,9999,0,9999,0
1668524441960,ECE 200,030,103615,Morris; Karcher William,9999,0,9999,0
1668524441960,ECE 200,031,103616,Ng; Tse Nga,9999,0,9999,0
1668524441960,ECE 200,032,103617,Nguyen; Truong Quang,9999,0,9999,0
1668524441960,ECE 200,033,103618,Nomura; Kenji,9999,0,9999,0
1668524441960,ECE 200,034,103619,Orlitsky; Alon,9999,0,9999,0
1668524441960,ECE 200,035,103620,Pal; Piya,9999,0,9999,0
1668524441960,ECE 200,036,103621,Papen; George C.,9999,0,9999,0
1668524441960,ECE 200,037,103622,Radic; Stojan,9999,0,9999,0
1668524441960,ECE 200,038,103623,Rao; Bhaskar D.,9999,0,9999,0
1668524441960,ECE 200,039,103624,Rao; Ramesh R,9999,0,9999,0
1668524441960,ECE 200,040,103625,Rebeiz; Gabriel,9999,0,9999,0
1668524441960,ECE 200,041,103626,Sanford; John R,9999,0,9999,0
1668524441960,ECE 200,042,103627,Siegel; Paul H.,9999,0,9999,0
1668524441960,ECE 200,043,103628,Sievenpiper; Daniel F.,9999,0,9999,0
1668524441960,ECE 200,044,103629,Sworder; David D.,9999,0,9999,0
1668524441960,ECE 200,045,103630,Taur; Yuan,9999,0,9999,0
1668524441960,ECE 200,046,103631,Touri; Behrouz,9999,0,9999,0
1668524441960,ECE 200,047,103632,Trivedi; Mohan M.,9999,0,9999,0
1668524441960,ECE 200,048,103633,Vasconcelos; Nuno,9999,0,9999,0
1668524441960,ECE 200,049,103634,Wang; Xiaolong,9999,0,9999,0
1668524441960,ECE 200,050,103635,Xie; Pengtao,9999,0,9999,0
1668524441960,ECE 200,051,103636,Yip; Michael,9999,0,9999,0
1668524441960,ECE 200,052,103637,Zeger; Kenneth A.,999,0,999,0
1668524441960,ECE 200,053,103638,Zhang; Xinyu,9999,0,9999,0
1668524441960,ECE 200,054,103639,Turakhia; Yatish Girish,9999,0,9999,0
1668524441960,ECE 200,055,103640,Kang; Mingu,9999,0,9999,0
1668524441960,ECE 200,056,103641,Shi; Yuanyuan,9999,0,9999,0
1668524441960,ECE 200,057,103642,Wang; Edward Jay,9999,0,9999,0
1668524441960,ECE 200,058,103643,Zheng; Yang,9999,0,9999,0
1668524442400,ECE 202,A00,103644,Kuzum; Duygu,0,44,0,0
1668524442823,ECE 212BN,A00,103646,Ng; Tse Nga,0,9,0,0
1668524443249,ECE 221,A00,111493,Staff,0,0,0,0
1668524443686,ECE 222B,A00,103647,Lomakin; Vitaliy,0,20,0,0
1668524444112,ECE 230B,A00,103648,Taur; Yuan,0,3,0,0
1668524444540,ECE 238B,A00,103649,Garay; Javier,0,0,0,0
1668524444968,ECE 240B,A00,112900,Fainman; Yeshaiahu,0,7,0,0
1668524445395,ECE 247A,A00,103650,Jokerst; Jesse Vincent,0,6,0,0
1668524445819,ECE 247B,A00,103651,Wang; Joseph,0,14,0,0
1668524446241,ECE 250,A00,103652,Siegel; Paul H.,0,82,0,0
1668524446675,ECE 251A,A00,103654,Rao; Bhaskar D.,0,62,0,0
1668524447104,ECE 257B,A00,103655,Bharadia; Dinesh,0,33,0,0
1668524447547,ECE 258A,A00,103656,Milstein; Laurence B.,0,29,0,0
1668524447970,ECE 260B,A00,103658,Kang; Mingu,0,119,0,0
1668524448424,ECE 264A,A00,103659,Galton; Ian A,0,66,0,0
1668524448851,ECE 265A,A00,103661,Gudem; Prasad S.S.,0,70,0,0
1668524449274,ECE 265D,A00,103662,Gudem; Prasad S.S.,0,26,0,0
1668524449703,ECE 268,A00,103663,Koushanfar; Farinaz,0,43,0,0
1668524450133,ECE 269,A01,103665,Pal; Piya,0,215,0,0
1668524450557,ECE 271B,A00,103666,Vasconcelos; Manuela,0,76,0,0
1668524450980,ECE 276A,A00,103667,Atanasov; Nikolay A.,0,126,0,0
1668524451419,ECE 277,A00,103668,An; Cheolhong,0,149,0,0
1668524451847,ECE 279,A00,117947,Hall; Drew A.,0,22,0,0
1668524452698,ECE 283,A00,103670,Hsueh; Tzu-Chien,0,53,0,0
1668524453125,ECE 284,A00,103671,Turakhia; Yatish Girish,0,39,0,0
1668524453549,ECE 285,A00,103672,Zheng; Yang,0,39,0,0
1668524453549,ECE 285,B00,103673,Sworder; David D.,0,57,0,0
1668524453973,ECE 287,A00,103676,Javidi; Tara,0,9,0,0
1668524454398,MATH 200B,A00,098023,Salehi Golsefidy; Alireza,10,0,15,5
1668524454821,MATH 202B,A00,098024,Rhoades; Brendon Patrick,7,0,15,8
1668524455248,MATH 203B,A00,098025,Oprea; Dragos N.,9,0,15,6
1668524455671,MATH 204B,A00,098026,Sorensen; Claus M,13,0,15,2
1668524456095,MATH 208,A00,098027,Izadi; Elham,7,0,10,3
1668524456527,MATH 209,A00,098028,Pollack; Aaron,10,0,10,0
1668524456950,MATH 211A,A00,112919,Rogalski; Daniel,8,0,10,2
1668524457384,MATH 211B,A00,112920,Seward; Brandon M.,9,0,10,1
1668524457808,MATH 218,A00,098029,Li; Bo,10,0,10,0
1668524458234,MATH 220B,A00,098030,Novak; Jonathan I,11,0,15,4
1668524458668,MATH 221A,A00,098031,Ebenfelt; Peter F,12,0,15,3
1668524459095,MATH 231B,A00,098032,Zlatos; Andrej,11,0,15,4
1668524459523,MATH 240B,A00,098033,Ni; Lei,7,0,15,8
1668524459948,MATH 243,A00,098034,Jekel; David Andrew,10,0,10,0
1668524460383,MATH 245A,A00,098035,Nie; Jiawang,0,4,15,18
1668524460806,MATH 248,A00,098036,Bejenaru; Ioan,10,0,10,0
1668524461229,MATH 250B,A00,098037,Spolaor; Luca,14,0,15,1
1668524461683,MATH 258,A00,098038,Ni; Lei,9,0,10,1
1668524462115,MATH 264B,A00,098041,Rhoades; Brendon Patrick,8,0,15,7
1668524462551,MATH 268,A00,098042,Buss; Samuel R,10,0,10,0
1668524462976,MATH 269,A00,098043,Rhoades; Brendon Patrick,10,0,10,0
1668524463402,MATH 270B,A00,098044,Li; Bo,6,0,15,9
1668524463832,MATH 272B,A00,098045,Holst; Michael J,13,0,15,2
1668524464258,MATH 273A,A00,098046,Tian; Xiaochuan,10,0,15,5
1668524464679,MATH 275,A01,098048,Tian; Xiaochuan,6,0,10,4
1668524465104,MATH 278A,A00,098049,Holst; Michael J,7,0,10,3
1668524465530,MATH 278B,A00,098050,Cloninger; Alexander,10,0,10,0
1668524465951,MATH 278C,A00,098051,Nie; Jiawang,5,0,10,5
1668524466375,MATH 280B,A00,098052,Zheng; Tianyi,7,0,15,8
1668524466803,MATH 281B,A00,098053,Bradic; Jelena,0,2,15,15
1668524467228,MATH 282B,A00,098054,Arias-Castro; Ery,0,1,15,15
1668524467653,MATH 285,A00,098055,Fitzsimmons; Patrick J,0,3,15,17
1668524468079,MATH 287B,A00,098056,Arias-Castro; Ery,1,0,15,14
1668524468511,MATH 288,A00,098057,Agarwal; Pooja,9,0,10,1
1668524468511,MATH 288,B00,098058,Zhang; Danna,8,0,10,2
1668524468511,MATH 288,C00,098059,Williams; Ruth J,9,0,10,1
1668524468937,MATH 290B,A00,098060,Roberts; Justin Deritter,12,0,15,3
1668524469363,MATH 292,A00,098061,Belmont; Eva Kinoshita,10,0,10,0
1668524469787,MATH 295,A00,098062,Suk; Andrew Hoon,47,0,50,3
1668524470215,MATH 296,A00,098063,Novak; Jonathan I,20,0,20,0
1668524470643,MATH 297,001,098064,Gamst; Anthony Collins,9997,0,9999,2
1668524974990,COGS 205,A00,101395,Chiba; Andrea,19,0,20,1
1668524975416,COGS 210B,001,101404,Greene; Deanna Jacquelyn,9998,0,9999,1
1668524975416,COGS 210B,002,101417,Xia; Haijun,9999,0,9999,0
1668524975416,COGS 210B,003,101422,Nitz; Douglas A.,9999,0,9999,0
1668524975416,COGS 210B,004,101423,Hollan; James D.,9998,0,9999,1
1668524975416,COGS 210B,005,101424,Deak; Gedeon O.,9998,0,9999,1
1668524975416,COGS 210B,006,101425,Rossano; Federico,9999,0,9999,0
1668524975839,COGS 211B,A00,101427,Coulson; Seana M,9996,0,9999,3
1668524976273,COGS 220,A00,101428,Hollan; James D.,0,10,25,25
1668524976697,COGS 229,A00,101429,Dow; Steven P,17,0,25,8
1668524977120,COGS 230,A00,101430,Klemmer; Scott R,7,0,17,10
1668524977548,COGS 234,A00,101431,Xia; Haijun,1,0,25,24
1668524977981,COGS 260,A00,101432,Kiyonaga; Anastasia,21,0,25,4
1668524977981,COGS 260,B00,101433,Kirsh; David Joel,15,0,25,10
1668524978407,CSE 202,A00,102371,Impagliazzo; Russell,0,66,0,0
1668524978835,CSE 203B,A01,102373,Cheng; Chung Kuan,0,58,0,0
1668524979261,CSE 208,A00,102374,Micciancio; Daniele,0,5,0,0
1668524979686,CSE 209A,A00,112895,Impagliazzo; Russell,0,12,15,15
1668524980109,CSE 209B,A00,108005,Bellare; Mihir,0,7,0,0
1668524980532,CSE 210,A00,113163,Coblenz; Michael J,0,85,0,0
1668524980961,CSE 219,A00,106111,Dow; Steven P,0,6,20,20
1668524981397,CSE 221,A00,102376,Voelker; Geoffrey M.,0,73,0,0
1668524981819,CSE 224,A01,102378,Porter; George M,0,166,0,0
1668524982243,CSE 229A,A00,102379,Savage; Stefan,0,10,0,0
1668524982683,CSE 229C,A00,102380,Munyaka; Imani N. S.,0,10,0,0
1668524983106,CSE 232B,A00,102382,Deutsch; Alin Bernard,0,32,0,0
1668524983529,CSE 234,A01,112904,Kumar; Arun Kumar,0,0,0,0
1668524983953,CSE 237A,A00,102383,Rosing; Tajana Simunic,0,55,0,0
1668524984380,CSE 239A,A00,102384,Deutsch; Alin Bernard,0,14,0,0
1668524984805,CSE 239B,A00,102385,Polikarpova; Nadezhda,0,10,0,0
1668524985240,CSE 240A,A00,102386,Pannuto; Patrick William,0,46,0,0
1668524985668,CSE 240B,A00,102387,Zhao; Jishen,0,47,0,0
1668524986092,CSE 241A,A00,106406,Kang; Mingu,0,9,0,0
1668524986516,CSE 249B,A00,102388,Kahng; Andrew Byun,0,5,8,8
1668524986944,CSE 251B,A01,102392,Cottrell; Garrison W,0,51,0,0
1668524986944,CSE 251B,A02,102393,Cottrell; Garrison W,0,34,0,0
1668524987383,CSE 252B,A00,102394,Ochoa; Benjamin Lawrence,0,59,0,0
1668524987811,CSE 257,A01,102396,Gao; Sicun,0,139,0,0
1668524988245,CSE 272,A00,102397,Li; Tzumao,0,19,0,0
1668524988680,CSE 274,A00,111323,Chern; Albert Ren-Haur,0,15,0,0
1668524989125,CSE 282,A00,102398,Pevzner; Pavel Arkadjevich,0,0,0,0
1668524989555,CSE 284,A00,114175,Gymrek; Melissa Ann,0,22,0,0
1668524989983,CSE 290,A00,102399,Chandraker; Manmohan Krishna,0,11,0,0
1668524989983,CSE 290,B00,102400,Vaccaro; Kristen Marie,0,7,25,25
1668524989983,CSE 290,C00,102414,Pannuto; Patrick William,0,1,25,25
1668524989983,CSE 290,D00,102427,Pevzner; Pavel Arkadjevich,0,0,0,0
1668524989983,CSE 290,E00,102429,Zhao; Jishen,0,4,0,0
1668524989983,CSE 290,F00,102436,Tullsen; Dean Michael,0,5,0,0
1668524989983,CSE 290,G00,102440,Christensen; Henrik I,0,6,20,20
1668524990423,CSE 291,A00,102443,Su; Hao,0,0,0,0
1668524990423,CSE 291,B00,102448,Polikarpova; Nadezhda,0,0,0,0
1668524990423,CSE 291,C00,102453,Vaccaro; Kristen Marie,0,0,0,0
1668524990423,CSE 291,D00,111343,Savage; Stefan,0,0,0,0
1668524990423,CSE 291,E00,116474,Claffy; Kimberly Claire,0,0,0,0
1668524990423,CSE 291,F00,116479,Pasquale; Joseph,0,0,0,0
1668524990859,CSE 293,001,119111,Bafna; Vineet,9999,0,9999,0
1668524990859,CSE 293,002,119118,Bellare; Mihir,9999,0,9999,0
1668524990859,CSE 293,003,119122,Berg-Kirkpatrick; Taylor D,9999,0,9999,0
1668524990859,CSE 293,004,119135,Christensen; Henrik I,9999,0,9999,0
1668524990859,CSE 293,005,119142,Cottrell; Garrison W,9999,0,9999,0
1668524990859,CSE 293,006,119146,Deutsch; Alin Bernard,9999,0,9999,0
1668524990859,CSE 293,007,119159,Esmaeilzadeh; Hadi,9999,0,9999,0
1668524990859,CSE 293,008,119166,Freund; Yoav,9999,0,9999,0
1668524990859,CSE 293,009,119170,Griswold; William G.,9999,0,9999,0
1668524990859,CSE 293,010,119183,Gymrek; Melissa Ann,9999,0,9999,0
1668524990859,CSE 293,011,119190,Heninger; Nadia A,9999,0,9999,0
1668524990859,CSE 293,012,119230,Impagliazzo; Russell,9999,0,9999,0
1668524990859,CSE 293,013,119232,Jhala; Ranjit,9999,0,9999,0
1668524990859,CSE 293,014,119233,Kahng; Andrew Byun,9999,0,9999,0
1668524990859,CSE 293,015,119298,Kane; Daniel Mertz,9999,0,9999,0
1668524990859,CSE 293,016,119299,Kriegman; David J,9999,0,9999,0
1668524990859,CSE 293,017,119300,Kumar; Arun Kumar,9999,0,9999,0
1668524990859,CSE 293,018,119301,Lerner; Sorin,9999,0,9999,0
1668524990859,CSE 293,019,119302,Lovett; Shachar,9999,0,9999,0
1668524990859,CSE 293,020,119303,McAuley; Julian John,9999,0,9999,0
1668524990859,CSE 293,021,119304,Micciancio; Daniele,9999,0,9999,0
1668524990859,CSE 293,022,119367,Orailoglu; Alex,9999,0,9999,0
1668524990859,CSE 293,023,119382,Paturi; Ramamohan,9999,0,9999,0
1668524990859,CSE 293,024,119404,Polikarpova; Nadezhda,9999,0,9999,0
1668524990859,CSE 293,025,119406,Politz; Joseph Gibbs,9999,0,9999,0
1668524990859,CSE 293,026,119411,Porter; George M,9999,0,9999,0
1668524990859,CSE 293,027,119414,Porter; Leonard Emerson,9999,0,9999,0
1668524990859,CSE 293,028,119416,Ramamoorthi; Ravi,9999,0,9999,0
1668524990859,CSE 293,029,119417,Sahoo; Debashis,9999,0,9999,0
1668524990859,CSE 293,030,119420,Saul; Lawrence,9999,0,9999,0
1668524990859,CSE 293,031,119421,Savage; Stefan,9999,0,9999,0
1668524990859,CSE 293,032,119425,Schulze; Jurgen P.,9999,0,9999,0
1668524990859,CSE 293,033,119426,Snoeren; Alex C.,9999,0,9999,0
1668524990859,CSE 293,034,119428,Shang; Jingbo,9999,0,9999,0
1668524990859,CSE 293,035,119430,Stefan; Deian,9999,0,9999,0
1668524990859,CSE 293,036,119431,Su; Hao,9999,0,9999,0
1668524990859,CSE 293,037,119433,Swanson; Steven James,9999,0,9999,0
1668524990859,CSE 293,038,119435,Tullsen; Dean Michael,9999,0,9999,0
1668524990859,CSE 293,039,119483,Voelker; Geoffrey M.,9999,0,9999,0
1668524990859,CSE 293,040,119537,Zhao; Jishen,9999,0,9999,0
1668524990859,CSE 293,041,119538,Zhou; Yuan-Yuan,9999,0,9999,0
1668524990859,CSE 293,042,119539,Gao; Sicun,9999,0,9999,0
1668524990859,CSE 293,043,119540,Weibel; Nadir,9999,0,9999,0
1668524990859,CSE 293,044,119541,Gupta; Rajesh K.,9999,0,9999,0
1668524990859,CSE 293,045,126410,Vaccaro; Kristen Marie,9999,0,9999,0
1668524990859,CSE 293,046,126411,Klemke; Richard,9999,0,9999,0
1668524991285,CSE 294,A00,102459,Voelker; Geoffrey M.,0,2,0,0
1668524991285,CSE 294,B00,111322,Orailoglu; Alex,0,2,0,0
1668524991712,DSE 201,A00,096914,Deutsch; Alin Bernard,30,0,30,0
1668524992144,DSE 210,A00,096915,Dasgupta; Sanjoy,30,0,30,0
1668524992571,DSE 260A,A00,096916,Altintas De Callaf; Ilkay,30,0,30,0
1668524993002,ECE 200,001,103586,Antipa; Nicholas A,9999,0,9999,0
1668524993002,ECE 200,002,103587,Atanasov; Nikolay A.,9999,0,9999,0
1668524993002,ECE 200,003,103588,Bharadia; Dinesh,9999,0,9999,0
1668524993002,ECE 200,004,103589,Cheng; Chung Kuan,9999,0,9999,0
1668524993002,ECE 200,005,103590,Cosman; Pamela C.,9999,0,9999,0
1668524993002,ECE 200,006,103591,Dayeh; Shadi Ahmad,9999,0,9999,0
1668524993002,ECE 200,007,103592,Fainman; Yeshaiahu,9999,0,9999,0
1668524993002,ECE 200,008,103593,Ford; Joseph Earl,9999,0,9999,0
1668524993002,ECE 200,009,103594,Franceschetti; Massimo,9999,0,9999,0
1668524993002,ECE 200,010,103595,Fullerton; Eric E,9999,0,9999,0
1668524993002,ECE 200,011,103596,Galton; Ian A,9999,0,9999,0
1668524993002,ECE 200,012,103597,Gilja; Vikash,9999,0,9999,0
1668524993002,ECE 200,013,103598,Hall; Drew A.,9999,0,9999,0
1668524993002,ECE 200,014,103599,Hsueh; Tzu-Chien,9999,0,9999,0
1668524993002,ECE 200,015,103600,Javidi; Tara,9999,0,9999,0
1668524993002,ECE 200,016,103601,Kahng; Andrew Byun,9999,0,9999,0
1668524993002,ECE 200,017,103602,Kim; Young-Han,9999,0,9999,0
1668524993002,ECE 200,018,103603,Koushanfar; Farinaz,9999,0,9999,0
1668524993002,ECE 200,019,103604,Kuzum; Duygu,9999,0,9999,0
1668524993002,ECE 200,020,103605,Le; Hanh-Phuc,9999,0,9999,0
1668524993002,ECE 200,021,103606,Lin; Bill,9999,0,9999,0
1668524993002,ECE 200,022,103607,Liu; Zhaowei,9998,0,9999,1
1668524993002,ECE 200,023,103608,Lo; Yu-Hwa,9999,0,9999,0
1668524993002,ECE 200,024,103609,Lomakin; Vitaliy,9999,0,9999,0
1668524993002,ECE 200,025,103610,Mercier; Patrick Philip,9999,0,9999,0
1668524993002,ECE 200,026,103611,Meyer; Florian,9999,0,9999,0
1668524993002,ECE 200,027,103612,Milstein; Laurence B.,9999,0,9999,0
1668524993002,ECE 200,028,103613,Mir Arabbaygi; Siavash,9999,0,9999,0
1668524993002,ECE 200,029,103614,Mookherjea; Shayan,9999,0,9999,0
1668524993002,ECE 200,030,103615,Morris; Karcher William,9999,0,9999,0
1668524993002,ECE 200,031,103616,Ng; Tse Nga,9999,0,9999,0
1668524993002,ECE 200,032,103617,Nguyen; Truong Quang,9999,0,9999,0
1668524993002,ECE 200,033,103618,Nomura; Kenji,9999,0,9999,0
1668524993002,ECE 200,034,103619,Orlitsky; Alon,9999,0,9999,0
1668524993002,ECE 200,035,103620,Pal; Piya,9999,0,9999,0
1668524993002,ECE 200,036,103621,Papen; George C.,9999,0,9999,0
1668524993002,ECE 200,037,103622,Radic; Stojan,9999,0,9999,0
1668524993002,ECE 200,038,103623,Rao; Bhaskar D.,9999,0,9999,0
1668524993002,ECE 200,039,103624,Rao; Ramesh R,9999,0,9999,0
1668524993002,ECE 200,040,103625,Rebeiz; Gabriel,9999,0,9999,0
1668524993002,ECE 200,041,103626,Sanford; John R,9999,0,9999,0
1668524993002,ECE 200,042,103627,Siegel; Paul H.,9999,0,9999,0
1668524993002,ECE 200,043,103628,Sievenpiper; Daniel F.,9999,0,9999,0
1668524993002,ECE 200,044,103629,Sworder; David D.,9999,0,9999,0
1668524993002,ECE 200,045,103630,Taur; Yuan,9999,0,9999,0
1668524993002,ECE 200,046,103631,Touri; Behrouz,9999,0,9999,0
1668524993002,ECE 200,047,103632,Trivedi; Mohan M.,9999,0,9999,0
1668524993002,ECE 200,048,103633,Vasconcelos; Nuno,9999,0,9999,0
1668524993002,ECE 200,049,103634,Wang; Xiaolong,9999,0,9999,0
1668524993002,ECE 200,050,103635,Xie; Pengtao,9999,0,9999,0
1668524993002,ECE 200,051,103636,Yip; Michael,9999,0,9999,0
1668524993002,ECE 200,052,103637,Zeger; Kenneth A.,999,0,999,0
1668524993002,ECE 200,053,103638,Zhang; Xinyu,9999,0,9999,0
1668524993002,ECE 200,054,103639,Turakhia; Yatish Girish,9999,0,9999,0
1668524993002,ECE 200,055,103640,Kang; Mingu,9999,0,9999,0
1668524993002,ECE 200,056,103641,Shi; Yuanyuan,9999,0,9999,0
1668524993002,ECE 200,057,103642,Wang; Edward Jay,9999,0,9999,0
1668524993002,ECE 200,058,103643,Zheng; Yang,9999,0,9999,0
1668524993431,ECE 202,A00,103644,Kuzum; Duygu,0,44,0,0
1668524993854,ECE 212BN,A00,103646,Ng; Tse Nga,0,9,0,0
1668524994277,ECE 221,A00,111493,Staff,0,0,0,0
1668524994715,ECE 222B,A00,103647,Lomakin; Vitaliy,0,20,0,0
1668524995141,ECE 230B,A00,103648,Taur; Yuan,0,3,0,0
1668524995648,ECE 238B,A00,103649,Garay; Javier,0,0,0,0
1668524996074,ECE 240B,A00,112900,Fainman; Yeshaiahu,0,7,0,0
1668524996512,ECE 247A,A00,103650,Jokerst; Jesse Vincent,0,6,0,0
1668524996934,ECE 247B,A00,103651,Wang; Joseph,0,14,0,0
1668524997371,ECE 250,A00,103652,Siegel; Paul H.,0,82,0,0
1668524997801,ECE 251A,A00,103654,Rao; Bhaskar D.,0,62,0,0
1668524998228,ECE 257B,A00,103655,Bharadia; Dinesh,0,33,0,0
1668524998666,ECE 258A,A00,103656,Milstein; Laurence B.,0,29,0,0
1668524999091,ECE 260B,A00,103658,Kang; Mingu,0,119,0,0
1668524999524,ECE 264A,A00,103659,Galton; Ian A,0,66,0,0
1668524999947,ECE 265A,A00,103661,Gudem; Prasad S.S.,0,70,0,0
1668525000379,ECE 265D,A00,103662,Gudem; Prasad S.S.,0,26,0,0
1668525000813,ECE 268,A00,103663,Koushanfar; Farinaz,0,43,0,0
1668525001247,ECE 269,A01,103665,Pal; Piya,0,215,0,0
1668525001677,ECE 271B,A00,103666,Vasconcelos; Manuela,0,76,0,0
1668525002112,ECE 276A,A00,103667,Atanasov; Nikolay A.,0,126,0,0
1668525002541,ECE 277,A00,103668,An; Cheolhong,0,149,0,0
1668525002965,ECE 279,A00,117947,Hall; Drew A.,0,22,0,0
1668525003828,ECE 283,A00,103670,Hsueh; Tzu-Chien,0,53,0,0
1668525004251,ECE 284,A00,103671,Turakhia; Yatish Girish,0,39,0,0
1668525004687,ECE 285,A00,103672,Zheng; Yang,0,39,0,0
1668525004687,ECE 285,B00,103673,Sworder; David D.,0,57,0,0
1668525005111,ECE 287,A00,103676,Javidi; Tara,0,9,0,0
1668525005536,MATH 200B,A00,098023,Salehi Golsefidy; Alireza,10,0,15,5
1668525005959,MATH 202B,A00,098024,Rhoades; Brendon Patrick,7,0,15,8
1668525006388,MATH 203B,A00,098025,Oprea; Dragos N.,9,0,15,6
1668525006818,MATH 204B,A00,098026,Sorensen; Claus M,13,0,15,2
1668525007250,MATH 208,A00,098027,Izadi; Elham,7,0,10,3
1668525007683,MATH 209,A00,098028,Pollack; Aaron,10,0,10,0
1668525008108,MATH 211A,A00,112919,Rogalski; Daniel,8,0,10,2
1668525008532,MATH 211B,A00,112920,Seward; Brandon M.,9,0,10,1
1668525008974,MATH 218,A00,098029,Li; Bo,10,0,10,0
1668525009404,MATH 220B,A00,098030,Novak; Jonathan I,11,0,15,4
1668525009844,MATH 221A,A00,098031,Ebenfelt; Peter F,12,0,15,3
1668525010291,MATH 231B,A00,098032,Zlatos; Andrej,11,0,15,4
1668525010715,MATH 240B,A00,098033,Ni; Lei,7,0,15,8
1668525011160,MATH 243,A00,098034,Jekel; David Andrew,10,0,10,0
1668525011585,MATH 245A,A00,098035,Nie; Jiawang,0,4,15,18
1668525012007,MATH 248,A00,098036,Bejenaru; Ioan,10,0,10,0
1668525012440,MATH 250B,A00,098037,Spolaor; Luca,14,0,15,1
1668525012862,MATH 258,A00,098038,Ni; Lei,9,0,10,1
1668525013284,MATH 264B,A00,098041,Rhoades; Brendon Patrick,8,0,15,7
1668525013711,MATH 268,A00,098042,Buss; Samuel R,10,0,10,0
1668525014148,MATH 269,A00,098043,Rhoades; Brendon Patrick,10,0,10,0
1668525014578,MATH 270B,A00,098044,Li; Bo,6,0,15,9
1668525015004,MATH 272B,A00,098045,Holst; Michael J,13,0,15,2
1668525015448,MATH 273A,A00,098046,Tian; Xiaochuan,10,0,15,5
1668525015873,MATH 275,A01,098048,Tian; Xiaochuan,6,0,10,4
1668525016300,MATH 278A,A00,098049,Holst; Michael J,7,0,10,3
1668525016739,MATH 278B,A00,098050,Cloninger; Alexander,10,0,10,0
1668525017167,MATH 278C,A00,098051,Nie; Jiawang,5,0,10,5
1668525017605,MATH 280B,A00,098052,Zheng; Tianyi,7,0,15,8
1668525018040,MATH 281B,A00,098053,Bradic; Jelena,0,2,15,15
1668525018468,MATH 282B,A00,098054,Arias-Castro; Ery,0,1,15,15
1668525018893,MATH 285,A00,098055,Fitzsimmons; Patrick J,0,3,15,17
1668525019325,MATH 287B,A00,098056,Arias-Castro; Ery,1,0,15,14
1668525019753,MATH 288,A00,098057,Agarwal; Pooja,9,0,10,1
1668525019753,MATH 288,B00,098058,Zhang; Danna,8,0,10,2
1668525019753,MATH 288,C00,098059,Williams; Ruth J,9,0,10,1
1668525020182,MATH 290B,A00,098060,Roberts; Justin Deritter,12,0,15,3
1668525020606,MATH 292,A00,098061,Belmont; Eva Kinoshita,10,0,10,0
1668525021030,MATH 295,A00,098062,Suk; Andrew Hoon,47,0,50,3
1668525021464,MATH 296,A00,098063,Novak; Jonathan I,20,0,20,0
1668525021892,MATH 297,001,098064,Gamst; Anthony Collins,9997,0,9999,2
1668525525875,COGS 205,A00,101395,Chiba; Andrea,19,0,20,1
1668525526306,COGS 210B,001,101404,Greene; Deanna Jacquelyn,9998,0,9999,1
1668525526306,COGS 210B,002,101417,Xia; Haijun,9999,0,9999,0
1668525526306,COGS 210B,003,101422,Nitz; Douglas A.,9999,0,9999,0
1668525526306,COGS 210B,004,101423,Hollan; James D.,9998,0,9999,1
1668525526306,COGS 210B,005,101424,Deak; Gedeon O.,9998,0,9999,1
1668525526306,COGS 210B,006,101425,Rossano; Federico,9999,0,9999,0
1668525526732,COGS 211B,A00,101427,Coulson; Seana M,9996,0,9999,3
1668525527164,COGS 220,A00,101428,Hollan; James D.,0,10,25,25
1668525527589,COGS 229,A00,101429,Dow; Steven P,17,0,25,8
1668525528024,COGS 230,A00,101430,Klemmer; Scott R,7,0,17,10
1668525528456,COGS 234,A00,101431,Xia; Haijun,1,0,25,24
1668525528880,COGS 260,A00,101432,Kiyonaga; Anastasia,21,0,25,4
1668525528880,COGS 260,B00,101433,Kirsh; David Joel,15,0,25,10
1668525529304,CSE 202,A00,102371,Impagliazzo; Russell,0,66,0,0
1668525529727,CSE 203B,A01,102373,Cheng; Chung Kuan,0,58,0,0
1668525530151,CSE 208,A00,102374,Micciancio; Daniele,0,5,0,0
1668525530579,CSE 209A,A00,112895,Impagliazzo; Russell,0,12,15,15
1668525531002,CSE 209B,A00,108005,Bellare; Mihir,0,7,0,0
1668525531436,CSE 210,A00,113163,Coblenz; Michael J,0,85,0,0
1668525531874,CSE 219,A00,106111,Dow; Steven P,0,6,20,20
1668525532302,CSE 221,A00,102376,Voelker; Geoffrey M.,0,73,0,0
1668525532736,CSE 224,A01,102378,Porter; George M,0,166,0,0
1668525533173,CSE 229A,A00,102379,Savage; Stefan,0,10,0,0
1668525533609,CSE 229C,A00,102380,Munyaka; Imani N. S.,0,10,0,0
1668525534047,CSE 232B,A00,102382,Deutsch; Alin Bernard,0,32,0,0
1668525534472,CSE 234,A01,112904,Kumar; Arun Kumar,0,0,0,0
1668525534897,CSE 237A,A00,102383,Rosing; Tajana Simunic,0,55,0,0
1668525535320,CSE 239A,A00,102384,Deutsch; Alin Bernard,0,14,0,0
1668525535746,CSE 239B,A00,102385,Polikarpova; Nadezhda,0,10,0,0
1668525536172,CSE 240A,A00,102386,Pannuto; Patrick William,0,46,0,0
1668525536598,CSE 240B,A00,102387,Zhao; Jishen,0,47,0,0
1668525537031,CSE 241A,A00,106406,Kang; Mingu,0,9,0,0
1668525537469,CSE 249B,A00,102388,Kahng; Andrew Byun,0,5,8,8
1668525537897,CSE 251B,A01,102392,Cottrell; Garrison W,0,51,0,0
1668525537897,CSE 251B,A02,102393,Cottrell; Garrison W,0,34,0,0
1668525538330,CSE 252B,A00,102394,Ochoa; Benjamin Lawrence,0,59,0,0
1668525538757,CSE 257,A01,102396,Gao; Sicun,0,139,0,0
1668525539183,CSE 272,A00,102397,Li; Tzumao,0,19,0,0
1668525539610,CSE 274,A00,111323,Chern; Albert Ren-Haur,0,15,0,0
1668525540042,CSE 282,A00,102398,Pevzner; Pavel Arkadjevich,0,0,0,0
1668525540466,CSE 284,A00,114175,Gymrek; Melissa Ann,0,22,0,0
1668525540895,CSE 290,A00,102399,Chandraker; Manmohan Krishna,0,11,0,0
1668525540895,CSE 290,B00,102400,Vaccaro; Kristen Marie,0,7,25,25
1668525540895,CSE 290,C00,102414,Pannuto; Patrick William,0,1,25,25
1668525540895,CSE 290,D00,102427,Pevzner; Pavel Arkadjevich,0,0,0,0
1668525540895,CSE 290,E00,102429,Zhao; Jishen,0,4,0,0
1668525540895,CSE 290,F00,102436,Tullsen; Dean Michael,0,5,0,0
1668525540895,CSE 290,G00,102440,Christensen; Henrik I,0,6,20,20
1668525541328,CSE 291,A00,102443,Su; Hao,0,0,0,0
1668525541328,CSE 291,B00,102448,Polikarpova; Nadezhda,0,0,0,0
1668525541328,CSE 291,C00,102453,Vaccaro; Kristen Marie,0,0,0,0
1668525541328,CSE 291,D00,111343,Savage; Stefan,0,0,0,0
1668525541328,CSE 291,E00,116474,Claffy; Kimberly Claire,0,0,0,0
1668525541328,CSE 291,F00,116479,Pasquale; Joseph,0,0,0,0
1668525541758,CSE 293,001,119111,Bafna; Vineet,9999,0,9999,0
1668525541758,CSE 293,002,119118,Bellare; Mihir,9999,0,9999,0
1668525541758,CSE 293,003,119122,Berg-Kirkpatrick; Taylor D,9999,0,9999,0
1668525541758,CSE 293,004,119135,Christensen; Henrik I,9999,0,9999,0
1668525541758,CSE 293,005,119142,Cottrell; Garrison W,9999,0,9999,0
1668525541758,CSE 293,006,119146,Deutsch; Alin Bernard,9999,0,9999,0
1668525541758,CSE 293,007,119159,Esmaeilzadeh; Hadi,9999,0,9999,0
1668525541758,CSE 293,008,119166,Freund; Yoav,9999,0,9999,0
1668525541758,CSE 293,009,119170,Griswold; William G.,9999,0,9999,0
1668525541758,CSE 293,010,119183,Gymrek; Melissa Ann,9999,0,9999,0
1668525541758,CSE 293,011,119190,Heninger; Nadia A,9999,0,9999,0
1668525541758,CSE 293,012,119230,Impagliazzo; Russell,9999,0,9999,0
1668525541758,CSE 293,013,119232,Jhala; Ranjit,9999,0,9999,0
1668525541758,CSE 293,014,119233,Kahng; Andrew Byun,9999,0,9999,0
1668525541758,CSE 293,015,119298,Kane; Daniel Mertz,9999,0,9999,0
1668525541758,CSE 293,016,119299,Kriegman; David J,9999,0,9999,0
1668525541758,CSE 293,017,119300,Kumar; Arun Kumar,9999,0,9999,0
1668525541758,CSE 293,018,119301,Lerner; Sorin,9999,0,9999,0
1668525541758,CSE 293,019,119302,Lovett; Shachar,9999,0,9999,0
1668525541758,CSE 293,020,119303,McAuley; Julian John,9999,0,9999,0
1668525541758,CSE 293,021,119304,Micciancio; Daniele,9999,0,9999,0
1668525541758,CSE 293,022,119367,Orailoglu; Alex,9999,0,9999,0
1668525541758,CSE 293,023,119382,Paturi; Ramamohan,9999,0,9999,0
1668525541758,CSE 293,024,119404,Polikarpova; Nadezhda,9999,0,9999,0
1668525541758,CSE 293,025,119406,Politz; Joseph Gibbs,9999,0,9999,0
1668525541758,CSE 293,026,119411,Porter; George M,9999,0,9999,0
1668525541758,CSE 293,027,119414,Porter; Leonard Emerson,9999,0,9999,0
1668525541758,CSE 293,028,119416,Ramamoorthi; Ravi,9999,0,9999,0
1668525541758,CSE 293,029,119417,Sahoo; Debashis,9999,0,9999,0
1668525541758,CSE 293,030,119420,Saul; Lawrence,9999,0,9999,0
1668525541758,CSE 293,031,119421,Savage; Stefan,9999,0,9999,0
1668525541758,CSE 293,032,119425,Schulze; Jurgen P.,9999,0,9999,0
1668525541758,CSE 293,033,119426,Snoeren; Alex C.,9999,0,9999,0
1668525541758,CSE 293,034,119428,Shang; Jingbo,9999,0,9999,0
1668525541758,CSE 293,035,119430,Stefan; Deian,9999,0,9999,0
1668525541758,CSE 293,036,119431,Su; Hao,9999,0,9999,0
1668525541758,CSE 293,037,119433,Swanson; Steven James,9999,0,9999,0
1668525541758,CSE 293,038,119435,Tullsen; Dean Michael,9999,0,9999,0
1668525541758,CSE 293,039,119483,Voelker; Geoffrey M.,9999,0,9999,0
1668525541758,CSE 293,040,119537,Zhao; Jishen,9999,0,9999,0
1668525541758,CSE 293,041,119538,Zhou; Yuan-Yuan,9999,0,9999,0
1668525541758,CSE 293,042,119539,Gao; Sicun,9999,0,9999,0
1668525541758,CSE 293,043,119540,Weibel; Nadir,9999,0,9999,0
1668525541758,CSE 293,044,119541,Gupta; Rajesh K.,9999,0,9999,0
1668525541758,CSE 293,045,126410,Vaccaro; Kristen Marie,9999,0,9999,0
1668525541758,CSE 293,046,126411,Klemke; Richard,9999,0,9999,0
1668525542183,CSE 294,A00,102459,Voelker; Geoffrey M.,0,2,0,0
1668525542183,CSE 294,B00,111322,Orailoglu; Alex,0,2,0,0
1668525542606,DSE 201,A00,096914,Deutsch; Alin Bernard,30,0,30,0
1668525543029,DSE 210,A00,096915,Dasgupta; Sanjoy,30,0,30,0
1668525543463,DSE 260A,A00,096916,Altintas De Callaf; Ilkay,30,0,30,0
1668525543893,ECE 200,001,103586,Antipa; Nicholas A,9999,0,9999,0
1668525543893,ECE 200,002,103587,Atanasov; Nikolay A.,9999,0,9999,0
1668525543893,ECE 200,003,103588,Bharadia; Dinesh,9999,0,9999,0
1668525543893,ECE 200,004,103589,Cheng; Chung Kuan,9999,0,9999,0
1668525543893,ECE 200,005,103590,Cosman; Pamela C.,9999,0,9999,0
1668525543893,ECE 200,006,103591,Dayeh; Shadi Ahmad,9999,0,9999,0
1668525543893,ECE 200,007,103592,Fainman; Yeshaiahu,9999,0,9999,0
1668525543893,ECE 200,008,103593,Ford; Joseph Earl,9999,0,9999,0
1668525543893,ECE 200,009,103594,Franceschetti; Massimo,9999,0,9999,0
1668525543893,ECE 200,010,103595,Fullerton; Eric E,9999,0,9999,0
1668525543893,ECE 200,011,103596,Galton; Ian A,9999,0,9999,0
1668525543893,ECE 200,012,103597,Gilja; Vikash,9999,0,9999,0
1668525543893,ECE 200,013,103598,Hall; Drew A.,9999,0,9999,0
1668525543893,ECE 200,014,103599,Hsueh; Tzu-Chien,9999,0,9999,0
1668525543893,ECE 200,015,103600,Javidi; Tara,9999,0,9999,0
1668525543893,ECE 200,016,103601,Kahng; Andrew Byun,9999,0,9999,0
1668525543893,ECE 200,017,103602,Kim; Young-Han,9999,0,9999,0
1668525543893,ECE 200,018,103603,Koushanfar; Farinaz,9999,0,9999,0
1668525543893,ECE 200,019,103604,Kuzum; Duygu,9999,0,9999,0
1668525543893,ECE 200,020,103605,Le; Hanh-Phuc,9999,0,9999,0
1668525543893,ECE 200,021,103606,Lin; Bill,9999,0,9999,0
1668525543893,ECE 200,022,103607,Liu; Zhaowei,9998,0,9999,1
1668525543893,ECE 200,023,103608,Lo; Yu-Hwa,9999,0,9999,0
1668525543893,ECE 200,024,103609,Lomakin; Vitaliy,9999,0,9999,0
1668525543893,ECE 200,025,103610,Mercier; Patrick Philip,9999,0,9999,0
1668525543893,ECE 200,026,103611,Meyer; Florian,9999,0,9999,0
1668525543893,ECE 200,027,103612,Milstein; Laurence B.,9999,0,9999,0
1668525543893,ECE 200,028,103613,Mir Arabbaygi; Siavash,9999,0,9999,0
1668525543893,ECE 200,029,103614,Mookherjea; Shayan,9999,0,9999,0
1668525543893,ECE 200,030,103615,Morris; Karcher William,9999,0,9999,0
1668525543893,ECE 200,031,103616,Ng; Tse Nga,9999,0,9999,0
1668525543893,ECE 200,032,103617,Nguyen; Truong Quang,9999,0,9999,0
1668525543893,ECE 200,033,103618,Nomura; Kenji,9999,0,9999,0
1668525543893,ECE 200,034,103619,Orlitsky; Alon,9999,0,9999,0
1668525543893,ECE 200,035,103620,Pal; Piya,9999,0,9999,0
1668525543893,ECE 200,036,103621,Papen; George C.,9999,0,9999,0
1668525543893,ECE 200,037,103622,Radic; Stojan,9999,0,9999,0
1668525543893,ECE 200,038,103623,Rao; Bhaskar D.,9999,0,9999,0
1668525543893,ECE 200,039,103624,Rao; Ramesh R,9999,0,9999,0
1668525543893,ECE 200,040,103625,Rebeiz; Gabriel,9999,0,9999,0
1668525543893,ECE 200,041,103626,Sanford; John R,9999,0,9999,0
1668525543893,ECE 200,042,103627,Siegel; Paul H.,9999,0,9999,0
1668525543893,ECE 200,043,103628,Sievenpiper; Daniel F.,9999,0,9999,0
1668525543893,ECE 200,044,103629,Sworder; David D.,9999,0,9999,0
1668525543893,ECE 200,045,103630,Taur; Yuan,9999,0,9999,0
1668525543893,ECE 200,046,103631,Touri; Behrouz,9999,0,9999,0
1668525543893,ECE 200,047,103632,Trivedi; Mohan M.,9999,0,9999,0
1668525543893,ECE 200,048,103633,Vasconcelos; Nuno,9999,0,9999,0
1668525543893,ECE 200,049,103634,Wang; Xiaolong,9999,0,9999,0
1668525543893,ECE 200,050,103635,Xie; Pengtao,9999,0,9999,0
1668525543893,ECE 200,051,103636,Yip; Michael,9999,0,9999,0
1668525543893,ECE 200,052,103637,Zeger; Kenneth A.,999,0,999,0
1668525543893,ECE 200,053,103638,Zhang; Xinyu,9999,0,9999,0
1668525543893,ECE 200,054,103639,Turakhia; Yatish Girish,9999,0,9999,0
1668525543893,ECE 200,055,103640,Kang; Mingu,9999,0,9999,0
1668525543893,ECE 200,056,103641,Shi; Yuanyuan,9999,0,9999,0
1668525543893,ECE 200,057,103642,Wang; Edward Jay,9999,0,9999,0
1668525543893,ECE 200,058,103643,Zheng; Yang,9999,0,9999,0
1668525544321,ECE 202,A00,103644,Kuzum; Duygu,0,44,0,0
1668525544746,ECE 212BN,A00,103646,Ng; Tse Nga,0,9,0,0
1668525545173,ECE 221,A00,111493,Staff,0,0,0,0
1668525545597,ECE 222B,A00,103647,Lomakin; Vitaliy,0,20,0,0
1668525546021,ECE 230B,A00,103648,Taur; Yuan,0,3,0,0
1668525546449,ECE 238B,A00,103649,Garay; Javier,0,0,0,0
1668525546877,ECE 240B,A00,112900,Fainman; Yeshaiahu,0,7,0,0
1668525547307,ECE 247A,A00,103650,Jokerst; Jesse Vincent,0,6,0,0
1668525547732,ECE 247B,A00,103651,Wang; Joseph,0,14,0,0
1668525548156,ECE 250,A00,103652,Siegel; Paul H.,0,82,0,0
1668525548580,ECE 251A,A00,103654,Rao; Bhaskar D.,0,62,0,0
1668525549023,ECE 257B,A00,103655,Bharadia; Dinesh,0,33,0,0
1668525549456,ECE 258A,A00,103656,Milstein; Laurence B.,0,29,0,0
1668525549883,ECE 260B,A00,103658,Kang; Mingu,0,119,0,0
1668525550308,ECE 264A,A00,103659,Galton; Ian A,0,66,0,0
1668525550738,ECE 265A,A00,103661,Gudem; Prasad S.S.,0,70,0,0
1668525551162,ECE 265D,A00,103662,Gudem; Prasad S.S.,0,26,0,0
1668525551592,ECE 268,A00,103663,Koushanfar; Farinaz,0,43,0,0
1668525552015,ECE 269,A01,103665,Pal; Piya,0,215,0,0
1668525552442,ECE 271B,A00,103666,Vasconcelos; Manuela,0,76,0,0
1668525552875,ECE 276A,A00,103667,Atanasov; Nikolay A.,0,126,0,0
1668525553302,ECE 277,A00,103668,An; Cheolhong,0,149,0,0
1668525553738,ECE 279,A00,117947,Hall; Drew A.,0,22,0,0
1668525554597,ECE 283,A00,103670,Hsueh; Tzu-Chien,0,54,0,0
1668525555030,ECE 284,A00,103671,Turakhia; Yatish Girish,0,39,0,0
1668525555454,ECE 285,A00,103672,Zheng; Yang,0,39,0,0
1668525555454,ECE 285,B00,103673,Sworder; David D.,0,57,0,0
1668525555892,ECE 287,A00,103676,Javidi; Tara,0,9,0,0
1668525556315,MATH 200B,A00,098023,Salehi Golsefidy; Alireza,10,0,15,5
1668525556739,MATH 202B,A00,098024,Rhoades; Brendon Patrick,7,0,15,8
1668525557164,MATH 203B,A00,098025,Oprea; Dragos N.,9,0,15,6
1668525557590,MATH 204B,A00,098026,Sorensen; Claus M,13,0,15,2
1668525558025,MATH 208,A00,098027,Izadi; Elham,7,0,10,3
1668525558449,MATH 209,A00,098028,Pollack; Aaron,10,0,10,0
1668525558875,MATH 211A,A00,112919,Rogalski; Daniel,8,0,10,2
1668525559299,MATH 211B,A00,112920,Seward; Brandon M.,9,0,10,1
1668525559734,MATH 218,A00,098029,Li; Bo,10,0,10,0
1668525560166,MATH 220B,A00,098030,Novak; Jonathan I,11,0,15,4
1668525560592,MATH 221A,A00,098031,Ebenfelt; Peter F,12,0,15,3
1668525561025,MATH 231B,A00,098032,Zlatos; Andrej,11,0,15,4
1668525561456,MATH 240B,A00,098033,Ni; Lei,7,0,15,8
1668525561975,MATH 243,A00,098034,Jekel; David Andrew,10,0,10,0
1668525562406,MATH 245A,A00,098035,Nie; Jiawang,0,4,15,18
1668525562832,MATH 248,A00,098036,Bejenaru; Ioan,10,0,10,0
1668525563256,MATH 250B,A00,098037,Spolaor; Luca,14,0,15,1
1668525563680,MATH 258,A00,098038,Ni; Lei,9,0,10,1
1668525564103,MATH 264B,A00,098041,Rhoades; Brendon Patrick,8,0,15,7
1668525564539,MATH 268,A00,098042,Buss; Samuel R,10,0,10,0
1668525564974,MATH 269,A00,098043,Rhoades; Brendon Patrick,10,0,10,0
1668525565398,MATH 270B,A00,098044,Li; Bo,6,0,15,9
1668525565821,MATH 272B,A00,098045,Holst; Michael J,13,0,15,2
1668525566247,MATH 273A,A00,098046,Tian; Xiaochuan,10,0,15,5
1668525566671,MATH 275,A01,098048,Tian; Xiaochuan,6,0,10,4
1668525567095,MATH 278A,A00,098049,Holst; Michael J,7,0,10,3
1668525567532,MATH 278B,A00,098050,Cloninger; Alexander,10,0,10,0
1668525567959,MATH 278C,A00,098051,Nie; Jiawang,5,0,10,5
1668525568396,MATH 280B,A00,098052,Zheng; Tianyi,7,0,15,8
1668525568823,MATH 281B,A00,098053,Bradic; Jelena,0,2,15,15
1668525569247,MATH 282B,A00,098054,Arias-Castro; Ery,0,1,15,15
1668525569682,MATH 285,A00,098055,Fitzsimmons; Patrick J,0,3,15,17
1668525570122,MATH 287B,A00,098056,Arias-Castro; Ery,1,0,15,14
1668525570547,MATH 288,A00,098057,Agarwal; Pooja,9,0,10,1
1668525570547,MATH 288,B00,098058,Zhang; Danna,8,0,10,2
1668525570547,MATH 288,C00,098059,Williams; Ruth J,9,0,10,1
1668525570994,MATH 290B,A00,098060,Roberts; Justin Deritter,12,0,15,3
1668525571420,MATH 292,A00,098061,Belmont; Eva Kinoshita,10,0,10,0
1668525571844,MATH 295,A00,098062,Suk; Andrew Hoon,47,0,50,3
1668525572267,MATH 296,A00,098063,Novak; Jonathan I,20,0,20,0
1668525572692,MATH 297,001,098064,Gamst; Anthony Collins,9997,0,9999,2
1668526076453,COGS 205,A00,101395,Chiba; Andrea,19,0,20,1
1668526076884,COGS 210B,001,101404,Greene; Deanna Jacquelyn,9998,0,9999,1
1668526076884,COGS 210B,002,101417,Xia; Haijun,9999,0,9999,0
1668526076884,COGS 210B,003,101422,Nitz; Douglas A.,9999,0,9999,0
1668526076884,COGS 210B,004,101423,Hollan; James D.,9998,0,9999,1
1668526076884,COGS 210B,005,101424,Deak; Gedeon O.,9998,0,9999,1
1668526076884,COGS 210B,006,101425,Rossano; Federico,9999,0,9999,0
1668526077312,COGS 211B,A00,101427,Coulson; Seana M,9996,0,9999,3
1668526077736,COGS 220,A00,101428,Hollan; James D.,0,10,25,25
1668526078161,COGS 229,A00,101429,Dow; Steven P,17,0,25,8
1668526078594,COGS 230,A00,101430,Klemmer; Scott R,7,0,17,10
1668526079023,COGS 234,A00,101431,Xia; Haijun,1,0,25,24
1668526079456,COGS 260,A00,101432,Kiyonaga; Anastasia,21,0,25,4
1668526079456,COGS 260,B00,101433,Kirsh; David Joel,15,0,25,10
1668526079883,CSE 202,A00,102371,Impagliazzo; Russell,0,66,0,0
1668526080307,CSE 203B,A01,102373,Cheng; Chung Kuan,0,58,0,0
1668526080731,CSE 208,A00,102374,Micciancio; Daniele,0,5,0,0
1668526081157,CSE 209A,A00,112895,Impagliazzo; Russell,0,12,15,15
1668526081584,CSE 209B,A00,108005,Bellare; Mihir,0,7,0,0
1668526082015,CSE 210,A00,113163,Coblenz; Michael J,0,85,0,0
1668526082448,CSE 219,A00,106111,Dow; Steven P,0,6,20,20
1668526082878,CSE 221,A00,102376,Voelker; Geoffrey M.,0,73,0,0
1668526083301,CSE 224,A01,102378,Porter; George M,0,166,0,0
1668526083729,CSE 229A,A00,102379,Savage; Stefan,0,10,0,0
1668526084161,CSE 229C,A00,102380,Munyaka; Imani N. S.,0,10,0,0
1668526084694,CSE 232B,A00,102382,Deutsch; Alin Bernard,0,32,0,0
1668526085126,CSE 234,A01,112904,Kumar; Arun Kumar,0,0,0,0
1668526085550,CSE 237A,A00,102383,Rosing; Tajana Simunic,0,55,0,0
1668526085981,CSE 239A,A00,102384,Deutsch; Alin Bernard,0,14,0,0
1668526086406,CSE 239B,A00,102385,Polikarpova; Nadezhda,0,10,0,0
1668526086830,CSE 240A,A00,102386,Pannuto; Patrick William,0,46,0,0
1668526087265,CSE 240B,A00,102387,Zhao; Jishen,0,47,0,0
1668526087688,CSE 241A,A00,106406,Kang; Mingu,0,9,0,0
1668526088128,CSE 249B,A00,102388,Kahng; Andrew Byun,0,5,8,8
1668526088558,CSE 251B,A01,102392,Cottrell; Garrison W,0,51,0,0
1668526088558,CSE 251B,A02,102393,Cottrell; Garrison W,0,34,0,0
1668526088983,CSE 252B,A00,102394,Ochoa; Benjamin Lawrence,0,59,0,0
1668526089407,CSE 257,A01,102396,Gao; Sicun,0,139,0,0
1668526089842,CSE 272,A00,102397,Li; Tzumao,0,19,0,0
1668526090273,CSE 274,A00,111323,Chern; Albert Ren-Haur,0,15,0,0
1668526090697,CSE 282,A00,102398,Pevzner; Pavel Arkadjevich,0,0,0,0
1668526091122,CSE 284,A00,114175,Gymrek; Melissa Ann,0,22,0,0
1668526091557,CSE 290,A00,102399,Chandraker; Manmohan Krishna,0,11,0,0
1668526091557,CSE 290,B00,102400,Vaccaro; Kristen Marie,0,7,25,25
1668526091557,CSE 290,C00,102414,Pannuto; Patrick William,0,1,25,25
1668526091557,CSE 290,D00,102427,Pevzner; Pavel Arkadjevich,0,0,0,0
1668526091557,CSE 290,E00,102429,Zhao; Jishen,0,4,0,0
1668526091557,CSE 290,F00,102436,Tullsen; Dean Michael,0,5,0,0
1668526091557,CSE 290,G00,102440,Christensen; Henrik I,0,6,20,20
1668526091980,CSE 291,A00,102443,Su; Hao,0,0,0,0
1668526091980,CSE 291,B00,102448,Polikarpova; Nadezhda,0,0,0,0
1668526091980,CSE 291,C00,102453,Vaccaro; Kristen Marie,0,0,0,0
1668526091980,CSE 291,D00,111343,Savage; Stefan,0,0,0,0
1668526091980,CSE 291,E00,116474,Claffy; Kimberly Claire,0,0,0,0
1668526091980,CSE 291,F00,116479,Pasquale; Joseph,0,0,0,0
1668526092429,CSE 293,001,119111,Bafna; Vineet,9999,0,9999,0
1668526092429,CSE 293,002,119118,Bellare; Mihir,9999,0,9999,0
1668526092429,CSE 293,003,119122,Berg-Kirkpatrick; Taylor D,9999,0,9999,0
1668526092429,CSE 293,004,119135,Christensen; Henrik I,9999,0,9999,0
1668526092429,CSE 293,005,119142,Cottrell; Garrison W,9999,0,9999,0
1668526092429,CSE 293,006,119146,Deutsch; Alin Bernard,9999,0,9999,0
1668526092429,CSE 293,007,119159,Esmaeilzadeh; Hadi,9999,0,9999,0
1668526092429,CSE 293,008,119166,Freund; Yoav,9999,0,9999,0
1668526092429,CSE 293,009,119170,Griswold; William G.,9999,0,9999,0
1668526092429,CSE 293,010,119183,Gymrek; Melissa Ann,9999,0,9999,0
1668526092429,CSE 293,011,119190,Heninger; Nadia A,9999,0,9999,0
1668526092429,CSE 293,012,119230,Impagliazzo; Russell,9999,0,9999,0
1668526092429,CSE 293,013,119232,Jhala; Ranjit,9999,0,9999,0
1668526092429,CSE 293,014,119233,Kahng; Andrew Byun,9999,0,9999,0
1668526092429,CSE 293,015,119298,Kane; Daniel Mertz,9999,0,9999,0
1668526092429,CSE 293,016,119299,Kriegman; David J,9999,0,9999,0
1668526092429,CSE 293,017,119300,Kumar; Arun Kumar,9999,0,9999,0
1668526092429,CSE 293,018,119301,Lerner; Sorin,9999,0,9999,0
1668526092429,CSE 293,019,119302,Lovett; Shachar,9999,0,9999,0
1668526092429,CSE 293,020,119303,McAuley; Julian John,9999,0,9999,0
1668526092429,CSE 293,021,119304,Micciancio; Daniele,9999,0,9999,0
1668526092429,CSE 293,022,119367,Orailoglu; Alex,9999,0,9999,0
1668526092429,CSE 293,023,119382,Paturi; Ramamohan,9999,0,9999,0
1668526092429,CSE 293,024,119404,Polikarpova; Nadezhda,9999,0,9999,0
1668526092429,CSE 293,025,119406,Politz; Joseph Gibbs,9999,0,9999,0
1668526092429,CSE 293,026,119411,Porter; George M,9999,0,9999,0
1668526092429,CSE 293,027,119414,Porter; Leonard Emerson,9999,0,9999,0
1668526092429,CSE 293,028,119416,Ramamoorthi; Ravi,9999,0,9999,0
1668526092429,CSE 293,029,119417,Sahoo; Debashis,9999,0,9999,0
1668526092429,CSE 293,030,119420,Saul; Lawrence,9999,0,9999,0
1668526092429,CSE 293,031,119421,Savage; Stefan,9999,0,9999,0
1668526092429,CSE 293,032,119425,Schulze; Jurgen P.,9999,0,9999,0
1668526092429,CSE 293,033,119426,Snoeren; Alex C.,9999,0,9999,0
1668526092429,CSE 293,034,119428,Shang; Jingbo,9999,0,9999,0
1668526092429,CSE 293,035,119430,Stefan; Deian,9999,0,9999,0
1668526092429,CSE 293,036,119431,Su; Hao,9999,0,9999,0
1668526092429,CSE 293,037,119433,Swanson; Steven James,9999,0,9999,0
1668526092429,CSE 293,038,119435,Tullsen; Dean Michael,9999,0,9999,0
1668526092429,CSE 293,039,119483,Voelker; Geoffrey M.,9999,0,9999,0
1668526092429,CSE 293,040,119537,Zhao; Jishen,9999,0,9999,0
1668526092429,CSE 293,041,119538,Zhou; Yuan-Yuan,9999,0,9999,0
1668526092429,CSE 293,042,119539,Gao; Sicun,9999,0,9999,0
1668526092429,CSE 293,043,119540,Weibel; Nadir,9999,0,9999,0
1668526092429,CSE 293,044,119541,Gupta; Rajesh K.,9999,0,9999,0
1668526092429,CSE 293,045,126410,Vaccaro; Kristen Marie,9999,0,9999,0
1668526092429,CSE 293,046,126411,Klemke; Richard,9999,0,9999,0
1668526092853,CSE 294,A00,102459,Voelker; Geoffrey M.,0,2,0,0
1668526092853,CSE 294,B00,111322,Orailoglu; Alex,0,2,0,0
1668526093290,DSE 201,A00,096914,Deutsch; Alin Bernard,30,0,30,0
1668526093716,DSE 210,A00,096915,Dasgupta; Sanjoy,30,0,30,0
1668526094142,DSE 260A,A00,096916,Altintas De Callaf; Ilkay,30,0,30,0
1668526094573,ECE 200,001,103586,Antipa; Nicholas A,9999,0,9999,0
1668526094573,ECE 200,002,103587,Atanasov; Nikolay A.,9999,0,9999,0
1668526094573,ECE 200,003,103588,Bharadia; Dinesh,9999,0,9999,0
1668526094573,ECE 200,004,103589,Cheng; Chung Kuan,9999,0,9999,0
1668526094573,ECE 200,005,103590,Cosman; Pamela C.,9999,0,9999,0
1668526094573,ECE 200,006,103591,Dayeh; Shadi Ahmad,9999,0,9999,0
1668526094573,ECE 200,007,103592,Fainman; Yeshaiahu,9999,0,9999,0
1668526094573,ECE 200,008,103593,Ford; Joseph Earl,9999,0,9999,0
1668526094573,ECE 200,009,103594,Franceschetti; Massimo,9999,0,9999,0
1668526094573,ECE 200,010,103595,Fullerton; Eric E,9999,0,9999,0
1668526094573,ECE 200,011,103596,Galton; Ian A,9999,0,9999,0
1668526094573,ECE 200,012,103597,Gilja; Vikash,9999,0,9999,0
1668526094573,ECE 200,013,103598,Hall; Drew A.,9999,0,9999,0
1668526094573,ECE 200,014,103599,Hsueh; Tzu-Chien,9999,0,9999,0
1668526094573,ECE 200,015,103600,Javidi; Tara,9999,0,9999,0
1668526094573,ECE 200,016,103601,Kahng; Andrew Byun,9999,0,9999,0
1668526094573,ECE 200,017,103602,Kim; Young-Han,9999,0,9999,0
1668526094573,ECE 200,018,103603,Koushanfar; Farinaz,9999,0,9999,0
1668526094573,ECE 200,019,103604,Kuzum; Duygu,9999,0,9999,0
1668526094573,ECE 200,020,103605,Le; Hanh-Phuc,9999,0,9999,0
1668526094573,ECE 200,021,103606,Lin; Bill,9999,0,9999,0
1668526094573,ECE 200,022,103607,Liu; Zhaowei,9998,0,9999,1
1668526094573,ECE 200,023,103608,Lo; Yu-Hwa,9999,0,9999,0
1668526094573,ECE 200,024,103609,Lomakin; Vitaliy,9999,0,9999,0
1668526094573,ECE 200,025,103610,Mercier; Patrick Philip,9999,0,9999,0
1668526094573,ECE 200,026,103611,Meyer; Florian,9999,0,9999,0
1668526094573,ECE 200,027,103612,Milstein; Laurence B.,9999,0,9999,0
1668526094573,ECE 200,028,103613,Mir Arabbaygi; Siavash,9999,0,9999,0
1668526094573,ECE 200,029,103614,Mookherjea; Shayan,9999,0,9999,0
1668526094573,ECE 200,030,103615,Morris; Karcher William,9999,0,9999,0
1668526094573,ECE 200,031,103616,Ng; Tse Nga,9999,0,9999,0
1668526094573,ECE 200,032,103617,Nguyen; Truong Quang,9999,0,9999,0
1668526094573,ECE 200,033,103618,Nomura; Kenji,9999,0,9999,0
1668526094573,ECE 200,034,103619,Orlitsky; Alon,9999,0,9999,0
1668526094573,ECE 200,035,103620,Pal; Piya,9999,0,9999,0
1668526094573,ECE 200,036,103621,Papen; George C.,9999,0,9999,0
1668526094573,ECE 200,037,103622,Radic; Stojan,9999,0,9999,0
1668526094573,ECE 200,038,103623,Rao; Bhaskar D.,9999,0,9999,0
1668526094573,ECE 200,039,103624,Rao; Ramesh R,9999,0,9999,0
1668526094573,ECE 200,040,103625,Rebeiz; Gabriel,9999,0,9999,0
1668526094573,ECE 200,041,103626,Sanford; John R,9999,0,9999,0
1668526094573,ECE 200,042,103627,Siegel; Paul H.,9999,0,9999,0
1668526094573,ECE 200,043,103628,Sievenpiper; Daniel F.,9999,0,9999,0
1668526094573,ECE 200,044,103629,Sworder; David D.,9999,0,9999,0
1668526094573,ECE 200,045,103630,Taur; Yuan,9999,0,9999,0
1668526094573,ECE 200,046,103631,Touri; Behrouz,9999,0,9999,0
1668526094573,ECE 200,047,103632,Trivedi; Mohan M.,9999,0,9999,0
1668526094573,ECE 200,048,103633,Vasconcelos; Nuno,9999,0,9999,0
1668526094573,ECE 200,049,103634,Wang; Xiaolong,9999,0,9999,0
1668526094573,ECE 200,050,103635,Xie; Pengtao,9999,0,9999,0
1668526094573,ECE 200,051,103636,Yip; Michael,9999,0,9999,0
1668526094573,ECE 200,052,103637,Zeger; Kenneth A.,999,0,999,0
1668526094573,ECE 200,053,103638,Zhang; Xinyu,9999,0,9999,0
1668526094573,ECE 200,054,103639,Turakhia; Yatish Girish,9999,0,9999,0
1668526094573,ECE 200,055,103640,Kang; Mingu,9999,0,9999,0
1668526094573,ECE 200,056,103641,Shi; Yuanyuan,9999,0,9999,0
1668526094573,ECE 200,057,103642,Wang; Edward Jay,9999,0,9999,0
1668526094573,ECE 200,058,103643,Zheng; Yang,9999,0,9999,0
1668526095004,ECE 202,A00,103644,Kuzum; Duygu,0,44,0,0
1668526095429,ECE 212BN,A00,103646,Ng; Tse Nga,0,9,0,0
1668526095861,ECE 221,A00,111493,Staff,0,0,0,0
1668526096288,ECE 222B,A00,103647,Lomakin; Vitaliy,0,20,0,0
1668526096717,ECE 230B,A00,103648,Taur; Yuan,0,3,0,0
1668526097142,ECE 238B,A00,103649,Garay; Javier,0,0,0,0
1668526097565,ECE 240B,A00,112900,Fainman; Yeshaiahu,0,7,0,0
1668526097991,ECE 247A,A00,103650,Jokerst; Jesse Vincent,0,6,0,0
1668526098419,ECE 247B,A00,103651,Wang; Joseph,0,14,0,0
1668526098850,ECE 250,A00,103652,Siegel; Paul H.,0,82,0,0
1668526099276,ECE 251A,A00,103654,Rao; Bhaskar D.,0,62,0,0
1668526099708,ECE 257B,A00,103655,Bharadia; Dinesh,0,33,0,0
1668526100145,ECE 258A,A00,103656,Milstein; Laurence B.,0,29,0,0
1668526100573,ECE 260B,A00,103658,Kang; Mingu,0,119,0,0
1668526100996,ECE 264A,A00,103659,Galton; Ian A,0,66,0,0
1668526101419,ECE 265A,A00,103661,Gudem; Prasad S.S.,0,70,0,0
1668526101842,ECE 265D,A00,103662,Gudem; Prasad S.S.,0,26,0,0
1668526102269,ECE 268,A00,103663,Koushanfar; Farinaz,0,43,0,0
1668526102700,ECE 269,A01,103665,Pal; Piya,0,215,0,0
1668526103124,ECE 271B,A00,103666,Vasconcelos; Manuela,0,76,0,0
1668526103550,ECE 276A,A00,103667,Atanasov; Nikolay A.,0,126,0,0
1668526103983,ECE 277,A00,103668,An; Cheolhong,0,149,0,0
1668526104407,ECE 279,A00,117947,Hall; Drew A.,0,22,0,0
1668526105279,ECE 283,A00,103670,Hsueh; Tzu-Chien,0,54,0,0
1668526105704,ECE 284,A00,103671,Turakhia; Yatish Girish,0,39,0,0
1668526106127,ECE 285,A00,103672,Zheng; Yang,0,39,0,0
1668526106127,ECE 285,B00,103673,Sworder; David D.,0,57,0,0
1668526106553,ECE 287,A00,103676,Javidi; Tara,0,9,0,0
1668526106988,MATH 200B,A00,098023,Salehi Golsefidy; Alireza,10,0,15,5
1668526107412,MATH 202B,A00,098024,Rhoades; Brendon Patrick,7,0,15,8
1668526107839,MATH 203B,A00,098025,Oprea; Dragos N.,9,0,15,6
1668526108263,MATH 204B,A00,098026,Sorensen; Claus M,13,0,15,2
1668526108687,MATH 208,A00,098027,Izadi; Elham,7,0,10,3
1668526109113,MATH 209,A00,098028,Pollack; Aaron,10,0,10,0
1668526109545,MATH 211A,A00,112919,Rogalski; Daniel,8,0,10,2
1668526109967,MATH 211B,A00,112920,Seward; Brandon M.,9,0,10,1
1668526110392,MATH 218,A00,098029,Li; Bo,10,0,10,0
1668526110816,MATH 220B,A00,098030,Novak; Jonathan I,11,0,15,4
1668526111241,MATH 221A,A00,098031,Ebenfelt; Peter F,12,0,15,3
1668526111674,MATH 231B,A00,098032,Zlatos; Andrej,11,0,15,4
1668526112097,MATH 240B,A00,098033,Ni; Lei,7,0,15,8
1668526112522,MATH 243,A00,098034,Jekel; David Andrew,10,0,10,0
1668526112948,MATH 245A,A00,098035,Nie; Jiawang,0,4,15,18
1668526113385,MATH 248,A00,098036,Bejenaru; Ioan,10,0,10,0
1668526113812,MATH 250B,A00,098037,Spolaor; Luca,14,0,15,1
1668526114236,MATH 258,A00,098038,Ni; Lei,9,0,10,1
1668526114659,MATH 264B,A00,098041,Rhoades; Brendon Patrick,8,0,15,7
1668526115090,MATH 268,A00,098042,Buss; Samuel R,10,0,10,0
1668526115513,MATH 269,A00,098043,Rhoades; Brendon Patrick,10,0,10,0
1668526115941,MATH 270B,A00,098044,Li; Bo,6,0,15,9
1668526116366,MATH 272B,A00,098045,Holst; Michael J,13,0,15,2
1668526116791,MATH 273A,A00,098046,Tian; Xiaochuan,10,0,15,5
1668526117219,MATH 275,A01,098048,Tian; Xiaochuan,6,0,10,4
1668526117648,MATH 278A,A00,098049,Holst; Michael J,7,0,10,3
1668526118078,MATH 278B,A00,098050,Cloninger; Alexander,10,0,10,0
1668526118515,MATH 278C,A00,098051,Nie; Jiawang,5,0,10,5
1668526118940,MATH 280B,A00,098052,Zheng; Tianyi,7,0,15,8
1668526119376,MATH 281B,A00,098053,Bradic; Jelena,0,2,15,15
1668526119801,MATH 282B,A00,098054,Arias-Castro; Ery,0,1,15,15
1668526120227,MATH 285,A00,098055,Fitzsimmons; Patrick J,0,3,15,17
1668526120652,MATH 287B,A00,098056,Arias-Castro; Ery,1,0,15,14
1668526121076,MATH 288,A00,098057,Agarwal; Pooja,9,0,10,1
1668526121076,MATH 288,B00,098058,Zhang; Danna,8,0,10,2
1668526121076,MATH 288,C00,098059,Williams; Ruth J,9,0,10,1
1668526121500,MATH 290B,A00,098060,Roberts; Justin Deritter,12,0,15,3
1668526121926,MATH 292,A00,098061,Belmont; Eva Kinoshita,10,0,10,0
1668526122349,MATH 295,A00,098062,Suk; Andrew Hoon,47,0,50,3
1668526122773,MATH 296,A00,098063,Novak; Jonathan I,20,0,20,0
1668526123201,MATH 297,001,098064,Gamst; Anthony Collins,9997,0,9999,2
1668526630262,COGS 205,A00,101395,Chiba; Andrea,19,0,20,1
1668526630700,COGS 210B,001,101404,Greene; Deanna Jacquelyn,9998,0,9999,1
1668526630700,COGS 210B,002,101417,Xia; Haijun,9999,0,9999,0
1668526630700,COGS 210B,003,101422,Nitz; Douglas A.,9999,0,9999,0
1668526630700,COGS 210B,004,101423,Hollan; James D.,9998,0,9999,1
1668526630700,COGS 210B,005,101424,Deak; Gedeon O.,9998,0,9999,1
1668526630700,COGS 210B,006,101425,Rossano; Federico,9999,0,9999,0
1668526631125,COGS 211B,A00,101427,Coulson; Seana M,9996,0,9999,3
1668526631557,COGS 220,A00,101428,Hollan; James D.,0,10,25,25
1668526631981,COGS 229,A00,101429,Dow; Steven P,17,0,25,8
1668526632405,COGS 230,A00,101430,Klemmer; Scott R,7,0,17,10
1668526632828,COGS 234,A00,101431,Xia; Haijun,1,0,25,24
1668526633253,COGS 260,A00,101432,Kiyonaga; Anastasia,21,0,25,4
1668526633253,COGS 260,B00,101433,Kirsh; David Joel,15,0,25,10
1668526633682,CSE 202,A00,102371,Impagliazzo; Russell,0,66,0,0
1668526634109,CSE 203B,A01,102373,Cheng; Chung Kuan,0,58,0,0
1668526634533,CSE 208,A00,102374,Micciancio; Daniele,0,5,0,0
1668526634963,CSE 209A,A00,112895,Impagliazzo; Russell,0,12,15,15
1668526635392,CSE 209B,A00,108005,Bellare; Mihir,0,7,0,0
1668526635826,CSE 210,A00,113163,Coblenz; Michael J,0,85,0,0
1668526636259,CSE 219,A00,106111,Dow; Steven P,0,6,20,20
1668526636690,CSE 221,A00,102376,Voelker; Geoffrey M.,0,73,0,0
1668526637133,CSE 224,A01,102378,Porter; George M,0,166,0,0
1668526637558,CSE 229A,A00,102379,Savage; Stefan,0,10,0,0
1668526637987,CSE 229C,A00,102380,Munyaka; Imani N. S.,0,10,0,0
1668526638422,CSE 232B,A00,102382,Deutsch; Alin Bernard,0,32,0,0
1668526638857,CSE 234,A01,112904,Kumar; Arun Kumar,0,0,0,0
1668526639283,CSE 237A,A00,102383,Rosing; Tajana Simunic,0,55,0,0
1668526639707,CSE 239A,A00,102384,Deutsch; Alin Bernard,0,14,0,0
1668526640132,CSE 239B,A00,102385,Polikarpova; Nadezhda,0,10,0,0
1668526640556,CSE 240A,A00,102386,Pannuto; Patrick William,0,46,0,0
1668526640979,CSE 240B,A00,102387,Zhao; Jishen,0,47,0,0
1668526641406,CSE 241A,A00,106406,Kang; Mingu,0,9,0,0
1668526641836,CSE 249B,A00,102388,Kahng; Andrew Byun,0,5,8,8
1668526642260,CSE 251B,A01,102392,Cottrell; Garrison W,0,51,0,0
1668526642260,CSE 251B,A02,102393,Cottrell; Garrison W,0,34,0,0
1668526642684,CSE 252B,A00,102394,Ochoa; Benjamin Lawrence,0,59,0,0
1668526643111,CSE 257,A01,102396,Gao; Sicun,0,139,0,0
1668526643536,CSE 272,A00,102397,Li; Tzumao,0,19,0,0
1668526643959,CSE 274,A00,111323,Chern; Albert Ren-Haur,0,15,0,0
1668526644384,CSE 282,A00,102398,Pevzner; Pavel Arkadjevich,0,0,0,0
1668526644807,CSE 284,A00,114175,Gymrek; Melissa Ann,0,22,0,0
1668526645233,CSE 290,A00,102399,Chandraker; Manmohan Krishna,0,11,0,0
1668526645233,CSE 290,B00,102400,Vaccaro; Kristen Marie,0,7,25,25
1668526645233,CSE 290,C00,102414,Pannuto; Patrick William,0,1,25,25
1668526645233,CSE 290,D00,102427,Pevzner; Pavel Arkadjevich,0,0,0,0
1668526645233,CSE 290,E00,102429,Zhao; Jishen,0,4,0,0
1668526645233,CSE 290,F00,102436,Tullsen; Dean Michael,0,5,0,0
1668526645233,CSE 290,G00,102440,Christensen; Henrik I,0,6,20,20
1668526645657,CSE 291,A00,102443,Su; Hao,0,0,0,0
1668526645657,CSE 291,B00,102448,Polikarpova; Nadezhda,0,0,0,0
1668526645657,CSE 291,C00,102453,Vaccaro; Kristen Marie,0,0,0,0
1668526645657,CSE 291,D00,111343,Savage; Stefan,0,0,0,0
1668526645657,CSE 291,E00,116474,Claffy; Kimberly Claire,0,0,0,0
1668526645657,CSE 291,F00,116479,Pasquale; Joseph,0,0,0,0
1668526646089,CSE 293,001,119111,Bafna; Vineet,9999,0,9999,0
1668526646089,CSE 293,002,119118,Bellare; Mihir,9999,0,9999,0
1668526646089,CSE 293,003,119122,Berg-Kirkpatrick; Taylor D,9999,0,9999,0
1668526646089,CSE 293,004,119135,Christensen; Henrik I,9999,0,9999,0
1668526646089,CSE 293,005,119142,Cottrell; Garrison W,9999,0,9999,0
1668526646089,CSE 293,006,119146,Deutsch; Alin Bernard,9999,0,9999,0
1668526646089,CSE 293,007,119159,Esmaeilzadeh; Hadi,9999,0,9999,0
1668526646089,CSE 293,008,119166,Freund; Yoav,9999,0,9999,0
1668526646089,CSE 293,009,119170,Griswold; William G.,9999,0,9999,0
1668526646089,CSE 293,010,119183,Gymrek; Melissa Ann,9999,0,9999,0
1668526646089,CSE 293,011,119190,Heninger; Nadia A,9999,0,9999,0
1668526646089,CSE 293,012,119230,Impagliazzo; Russell,9999,0,9999,0
1668526646089,CSE 293,013,119232,Jhala; Ranjit,9999,0,9999,0
1668526646089,CSE 293,014,119233,Kahng; Andrew Byun,9999,0,9999,0
1668526646089,CSE 293,015,119298,Kane; Daniel Mertz,9999,0,9999,0
1668526646089,CSE 293,016,119299,Kriegman; David J,9999,0,9999,0
1668526646089,CSE 293,017,119300,Kumar; Arun Kumar,9999,0,9999,0
1668526646089,CSE 293,018,119301,Lerner; Sorin,9999,0,9999,0
1668526646089,CSE 293,019,119302,Lovett; Shachar,9999,0,9999,0
1668526646089,CSE 293,020,119303,McAuley; Julian John,9999,0,9999,0
1668526646089,CSE 293,021,119304,Micciancio; Daniele,9999,0,9999,0
1668526646089,CSE 293,022,119367,Orailoglu; Alex,9999,0,9999,0
1668526646089,CSE 293,023,119382,Paturi; Ramamohan,9999,0,9999,0
1668526646089,CSE 293,024,119404,Polikarpova; Nadezhda,9999,0,9999,0
1668526646089,CSE 293,025,119406,Politz; Joseph Gibbs,9999,0,9999,0
1668526646089,CSE 293,026,119411,Porter; George M,9999,0,9999,0
1668526646089,CSE 293,027,119414,Porter; Leonard Emerson,9999,0,9999,0
1668526646089,CSE 293,028,119416,Ramamoorthi; Ravi,9999,0,9999,0
1668526646089,CSE 293,029,119417,Sahoo; Debashis,9999,0,9999,0
1668526646089,CSE 293,030,119420,Saul; Lawrence,9999,0,9999,0
1668526646089,CSE 293,031,119421,Savage; Stefan,9999,0,9999,0
1668526646089,CSE 293,032,119425,Schulze; Jurgen P.,9999,0,9999,0
1668526646089,CSE 293,033,119426,Snoeren; Alex C.,9999,0,9999,0
1668526646089,CSE 293,034,119428,Shang; Jingbo,9999,0,9999,0
1668526646089,CSE 293,035,119430,Stefan; Deian,9999,0,9999,0
1668526646089,CSE 293,036,119431,Su; Hao,9999,0,9999,0
1668526646089,CSE 293,037,119433,Swanson; Steven James,9999,0,9999,0
1668526646089,CSE 293,038,119435,Tullsen; Dean Michael,9999,0,9999,0
1668526646089,CSE 293,039,119483,Voelker; Geoffrey M.,9999,0,9999,0
1668526646089,CSE 293,040,119537,Zhao; Jishen,9999,0,9999,0
1668526646089,CSE 293,041,119538,Zhou; Yuan-Yuan,9999,0,9999,0
1668526646089,CSE 293,042,119539,Gao; Sicun,9999,0,9999,0
1668526646089,CSE 293,043,119540,Weibel; Nadir,9999,0,9999,0
1668526646089,CSE 293,044,119541,Gupta; Rajesh K.,9999,0,9999,0
1668526646089,CSE 293,045,126410,Vaccaro; Kristen Marie,9999,0,9999,0
1668526646089,CSE 293,046,126411,Klemke; Richard,9999,0,9999,0
1668526646524,CSE 294,A00,102459,Voelker; Geoffrey M.,0,2,0,0
1668526646524,CSE 294,B00,111322,Orailoglu; Alex,0,2,0,0
1668526646947,DSE 201,A00,096914,Deutsch; Alin Bernard,30,0,30,0
1668526647373,DSE 210,A00,096915,Dasgupta; Sanjoy,30,0,30,0
1668526647808,DSE 260A,A00,096916,Altintas De Callaf; Ilkay,30,0,30,0
1668526648245,ECE 200,001,103586,Antipa; Nicholas A,9999,0,9999,0
1668526648245,ECE 200,002,103587,Atanasov; Nikolay A.,9999,0,9999,0
1668526648245,ECE 200,003,103588,Bharadia; Dinesh,9999,0,9999,0
1668526648245,ECE 200,004,103589,Cheng; Chung Kuan,9999,0,9999,0
1668526648245,ECE 200,005,103590,Cosman; Pamela C.,9999,0,9999,0
1668526648245,ECE 200,006,103591,Dayeh; Shadi Ahmad,9999,0,9999,0
1668526648245,ECE 200,007,103592,Fainman; Yeshaiahu,9999,0,9999,0
1668526648245,ECE 200,008,103593,Ford; Joseph Earl,9999,0,9999,0
1668526648245,ECE 200,009,103594,Franceschetti; Massimo,9999,0,9999,0
1668526648245,ECE 200,010,103595,Fullerton; Eric E,9999,0,9999,0
1668526648245,ECE 200,011,103596,Galton; Ian A,9999,0,9999,0
1668526648245,ECE 200,012,103597,Gilja; Vikash,9999,0,9999,0
1668526648245,ECE 200,013,103598,Hall; Drew A.,9999,0,9999,0
1668526648245,ECE 200,014,103599,Hsueh; Tzu-Chien,9999,0,9999,0
1668526648245,ECE 200,015,103600,Javidi; Tara,9999,0,9999,0
1668526648245,ECE 200,016,103601,Kahng; Andrew Byun,9999,0,9999,0
1668526648245,ECE 200,017,103602,Kim; Young-Han,9999,0,9999,0
1668526648245,ECE 200,018,103603,Koushanfar; Farinaz,9999,0,9999,0
1668526648245,ECE 200,019,103604,Kuzum; Duygu,9999,0,9999,0
1668526648245,ECE 200,020,103605,Le; Hanh-Phuc,9999,0,9999,0
1668526648245,ECE 200,021,103606,Lin; Bill,9999,0,9999,0
1668526648245,ECE 200,022,103607,Liu; Zhaowei,9998,0,9999,1
1668526648245,ECE 200,023,103608,Lo; Yu-Hwa,9999,0,9999,0
1668526648245,ECE 200,024,103609,Lomakin; Vitaliy,9999,0,9999,0
1668526648245,ECE 200,025,103610,Mercier; Patrick Philip,9999,0,9999,0
1668526648245,ECE 200,026,103611,Meyer; Florian,9999,0,9999,0
1668526648245,ECE 200,027,103612,Milstein; Laurence B.,9999,0,9999,0
1668526648245,ECE 200,028,103613,Mir Arabbaygi; Siavash,9999,0,9999,0
1668526648245,ECE 200,029,103614,Mookherjea; Shayan,9999,0,9999,0
1668526648245,ECE 200,030,103615,Morris; Karcher William,9999,0,9999,0
1668526648245,ECE 200,031,103616,Ng; Tse Nga,9999,0,9999,0
1668526648245,ECE 200,032,103617,Nguyen; Truong Quang,9999,0,9999,0
1668526648245,ECE 200,033,103618,Nomura; Kenji,9999,0,9999,0
1668526648245,ECE 200,034,103619,Orlitsky; Alon,9999,0,9999,0
1668526648245,ECE 200,035,103620,Pal; Piya,9999,0,9999,0
1668526648245,ECE 200,036,103621,Papen; George C.,9999,0,9999,0
1668526648245,ECE 200,037,103622,Radic; Stojan,9999,0,9999,0
1668526648245,ECE 200,038,103623,Rao; Bhaskar D.,9999,0,9999,0
1668526648245,ECE 200,039,103624,Rao; Ramesh R,9999,0,9999,0
1668526648245,ECE 200,040,103625,Rebeiz; Gabriel,9999,0,9999,0
1668526648245,ECE 200,041,103626,Sanford; John R,9999,0,9999,0
1668526648245,ECE 200,042,103627,Siegel; Paul H.,9999,0,9999,0
1668526648245,ECE 200,043,103628,Sievenpiper; Daniel F.,9999,0,9999,0
1668526648245,ECE 200,044,103629,Sworder; David D.,9999,0,9999,0
1668526648245,ECE 200,045,103630,Taur; Yuan,9999,0,9999,0
1668526648245,ECE 200,046,103631,Touri; Behrouz,9999,0,9999,0
1668526648245,ECE 200,047,103632,Trivedi; Mohan M.,9999,0,9999,0
1668526648245,ECE 200,048,103633,Vasconcelos; Nuno,9999,0,9999,0
1668526648245,ECE 200,049,103634,Wang; Xiaolong,9999,0,9999,0
1668526648245,ECE 200,050,103635,Xie; Pengtao,9999,0,9999,0
1668526648245,ECE 200,051,103636,Yip; Michael,9999,0,9999,0
1668526648245,ECE 200,052,103637,Zeger; Kenneth A.,999,0,999,0
1668526648245,ECE 200,053,103638,Zhang; Xinyu,9999,0,9999,0
1668526648245,ECE 200,054,103639,Turakhia; Yatish Girish,9999,0,9999,0
1668526648245,ECE 200,055,103640,Kang; Mingu,9999,0,9999,0
1668526648245,ECE 200,056,103641,Shi; Yuanyuan,9999,0,9999,0
1668526648245,ECE 200,057,103642,Wang; Edward Jay,9999,0,9999,0
1668526648245,ECE 200,058,103643,Zheng; Yang,9999,0,9999,0
1668526648670,ECE 202,A00,103644,Kuzum; Duygu,0,44,0,0
1668526649102,ECE 212BN,A00,103646,Ng; Tse Nga,0,9,0,0
1668526649535,ECE 221,A00,111493,Staff,0,0,0,0
1668526649957,ECE 222B,A00,103647,Lomakin; Vitaliy,0,20,0,0
1668526650381,ECE 230B,A00,103648,Taur; Yuan,0,3,0,0
1668526650808,ECE 238B,A00,103649,Garay; Javier,0,0,0,0
1668526651231,ECE 240B,A00,112900,Fainman; Yeshaiahu,0,7,0,0
1668526651657,ECE 247A,A00,103650,Jokerst; Jesse Vincent,0,6,0,0
1668526652080,ECE 247B,A00,103651,Wang; Joseph,0,14,0,0
1668526652510,ECE 250,A00,103652,Siegel; Paul H.,0,82,0,0
1668526652946,ECE 251A,A00,103654,Rao; Bhaskar D.,0,62,0,0
1668526653382,ECE 257B,A00,103655,Bharadia; Dinesh,0,33,0,0
1668526653904,ECE 258A,A00,103656,Milstein; Laurence B.,0,29,0,0
1668526654329,ECE 260B,A00,103658,Kang; Mingu,0,119,0,0
1668526654757,ECE 264A,A00,103659,Galton; Ian A,0,66,0,0
1668526655195,ECE 265A,A00,103661,Gudem; Prasad S.S.,0,70,0,0
1668526655623,ECE 265D,A00,103662,Gudem; Prasad S.S.,0,26,0,0
1668526656051,ECE 268,A00,103663,Koushanfar; Farinaz,0,43,0,0
1668526656490,ECE 269,A01,103665,Pal; Piya,0,216,0,0
1668526656919,ECE 271B,A00,103666,Vasconcelos; Manuela,0,76,0,0
1668526657341,ECE 276A,A00,103667,Atanasov; Nikolay A.,0,127,0,0
1668526657770,ECE 277,A00,103668,An; Cheolhong,0,149,0,0
1668526658209,ECE 279,A00,117947,Hall; Drew A.,0,22,0,0
1668526659076,ECE 283,A00,103670,Hsueh; Tzu-Chien,0,54,0,0
1668526659501,ECE 284,A00,103671,Turakhia; Yatish Girish,0,39,0,0
1668526659933,ECE 285,A00,103672,Zheng; Yang,0,39,0,0
1668526659933,ECE 285,B00,103673,Sworder; David D.,0,57,0,0
1668526660359,ECE 287,A00,103676,Javidi; Tara,0,9,0,0
1668526660788,MATH 200B,A00,098023,Salehi Golsefidy; Alireza,10,0,15,5
1668526661211,MATH 202B,A00,098024,Rhoades; Brendon Patrick,7,0,15,8
1668526661640,MATH 203B,A00,098025,Oprea; Dragos N.,9,0,15,6
1668526662065,MATH 204B,A00,098026,Sorensen; Claus M,13,0,15,2
1668526662494,MATH 208,A00,098027,Izadi; Elham,7,0,10,3
1668526662925,MATH 209,A00,098028,Pollack; Aaron,10,0,10,0
1668526663351,MATH 211A,A00,112919,Rogalski; Daniel,8,0,10,2
1668526663778,MATH 211B,A00,112920,Seward; Brandon M.,9,0,10,1
1668526664201,MATH 218,A00,098029,Li; Bo,10,0,10,0
1668526664634,MATH 220B,A00,098030,Novak; Jonathan I,11,0,15,4
1668526665058,MATH 221A,A00,098031,Ebenfelt; Peter F,12,0,15,3
1668526665485,MATH 231B,A00,098032,Zlatos; Andrej,11,0,15,4
1668526665912,MATH 240B,A00,098033,Ni; Lei,7,0,15,8
1668526666336,MATH 243,A00,098034,Jekel; David Andrew,10,0,10,0
1668526666759,MATH 245A,A00,098035,Nie; Jiawang,0,4,15,18
1668526667197,MATH 248,A00,098036,Bejenaru; Ioan,10,0,10,0
1668526667626,MATH 250B,A00,098037,Spolaor; Luca,14,0,15,1
1668526668051,MATH 258,A00,098038,Ni; Lei,9,0,10,1
1668526668477,MATH 264B,A00,098041,Rhoades; Brendon Patrick,8,0,15,7
1668526668900,MATH 268,A00,098042,Buss; Samuel R,10,0,10,0
1668526669323,MATH 269,A00,098043,Rhoades; Brendon Patrick,10,0,10,0
1668526669750,MATH 270B,A00,098044,Li; Bo,6,0,15,9
1668526670185,MATH 272B,A00,098045,Holst; Michael J,13,0,15,2
1668526670611,MATH 273A,A00,098046,Tian; Xiaochuan,10,0,15,5
1668526671035,MATH 275,A01,098048,Tian; Xiaochuan,6,0,10,4
1668526671458,MATH 278A,A00,098049,Holst; Michael J,7,0,10,3
1668526671890,MATH 278B,A00,098050,Cloninger; Alexander,10,0,10,0
1668526672315,MATH 278C,A00,098051,Nie; Jiawang,5,0,10,5
1668526672743,MATH 280B,A00,098052,Zheng; Tianyi,7,0,15,8
1668526673172,MATH 281B,A00,098053,Bradic; Jelena,0,2,15,15
1668526673595,MATH 282B,A00,098054,Arias-Castro; Ery,0,1,15,15
1668526674023,MATH 285,A00,098055,Fitzsimmons; Patrick J,0,3,15,17
1668526674451,MATH 287B,A00,098056,Arias-Castro; Ery,1,0,15,14
1668526674874,MATH 288,A00,098057,Agarwal; Pooja,9,0,10,1
1668526674874,MATH 288,B00,098058,Zhang; Danna,8,0,10,2
1668526674874,MATH 288,C00,098059,Williams; Ruth J,9,0,10,1
1668526675304,MATH 290B,A00,098060,Roberts; Justin Deritter,12,0,15,3
1668526675737,MATH 292,A00,098061,Belmont; Eva Kinoshita,10,0,10,0
1668526676160,MATH 295,A00,098062,Suk; Andrew Hoon,47,0,50,3
1668526676596,MATH 296,A00,098063,Novak; Jonathan I,20,0,20,0
1668526677022,MATH 297,001,098064,Gamst; Anthony Collins,9997,0,9999,2
1668527181319,COGS 205,A00,101395,Chiba; Andrea,19,0,20,1
1668527181743,COGS 210B,001,101404,Greene; Deanna Jacquelyn,9998,0,9999,1
1668527181743,COGS 210B,002,101417,Xia; Haijun,9999,0,9999,0
1668527181743,COGS 210B,003,101422,Nitz; Douglas A.,9999,0,9999,0
1668527181743,COGS 210B,004,101423,Hollan; James D.,9998,0,9999,1
1668527181743,COGS 210B,005,101424,Deak; Gedeon O.,9998,0,9999,1
1668527181743,COGS 210B,006,101425,Rossano; Federico,9999,0,9999,0
1668527182177,COGS 211B,A00,101427,Coulson; Seana M,9996,0,9999,3
1668527182612,COGS 220,A00,101428,Hollan; James D.,0,10,25,25
1668527183037,COGS 229,A00,101429,Dow; Steven P,17,0,25,8
1668527183470,COGS 230,A00,101430,Klemmer; Scott R,7,0,17,10
1668527183894,COGS 234,A00,101431,Xia; Haijun,1,0,25,24
1668527184319,COGS 260,A00,101432,Kiyonaga; Anastasia,21,0,25,4
1668527184319,COGS 260,B00,101433,Kirsh; David Joel,15,0,25,10
1668527184746,CSE 202,A00,102371,Impagliazzo; Russell,0,66,0,0
1668527185173,CSE 203B,A01,102373,Cheng; Chung Kuan,0,59,0,0
1668527185605,CSE 208,A00,102374,Micciancio; Daniele,0,5,0,0
1668527186038,CSE 209A,A00,112895,Impagliazzo; Russell,0,12,15,15
1668527186463,CSE 209B,A00,108005,Bellare; Mihir,0,7,0,0
1668527186892,CSE 210,A00,113163,Coblenz; Michael J,0,85,0,0
1668527187316,CSE 219,A00,106111,Dow; Steven P,0,6,20,20
1668527187755,CSE 221,A00,102376,Voelker; Geoffrey M.,0,73,0,0
1668527188180,CSE 224,A01,102378,Porter; George M,0,167,0,0
1668527188608,CSE 229A,A00,102379,Savage; Stefan,0,10,0,0
1668527189034,CSE 229C,A00,102380,Munyaka; Imani N. S.,0,10,0,0
1668527189466,CSE 232B,A00,102382,Deutsch; Alin Bernard,0,32,0,0
1668527189893,CSE 234,A01,112904,Kumar; Arun Kumar,0,0,0,0
1668527190316,CSE 237A,A00,102383,Rosing; Tajana Simunic,0,55,0,0
1668527190749,CSE 239A,A00,102384,Deutsch; Alin Bernard,0,14,0,0
1668527191172,CSE 239B,A00,102385,Polikarpova; Nadezhda,0,10,0,0
1668527191596,CSE 240A,A00,102386,Pannuto; Patrick William,0,46,0,0
1668527192017,CSE 240B,A00,102387,Zhao; Jishen,0,47,0,0
1668527192445,CSE 241A,A00,106406,Kang; Mingu,0,9,0,0
1668527192891,CSE 249B,A00,102388,Kahng; Andrew Byun,0,5,8,8
1668527193322,CSE 251B,A01,102392,Cottrell; Garrison W,0,51,0,0
1668527193322,CSE 251B,A02,102393,Cottrell; Garrison W,0,34,0,0
1668527193753,CSE 252B,A00,102394,Ochoa; Benjamin Lawrence,0,59,0,0
1668527194176,CSE 257,A01,102396,Gao; Sicun,0,139,0,0
1668527194602,CSE 272,A00,102397,Li; Tzumao,0,19,0,0
1668527195026,CSE 274,A00,111323,Chern; Albert Ren-Haur,0,15,0,0
1668527195457,CSE 282,A00,102398,Pevzner; Pavel Arkadjevich,0,0,0,0
1668527195880,CSE 284,A00,114175,Gymrek; Melissa Ann,0,22,0,0
1668527196306,CSE 290,A00,102399,Chandraker; Manmohan Krishna,0,11,0,0
1668527196306,CSE 290,B00,102400,Vaccaro; Kristen Marie,0,7,25,25
1668527196306,CSE 290,C00,102414,Pannuto; Patrick William,0,1,25,25
1668527196306,CSE 290,D00,102427,Pevzner; Pavel Arkadjevich,0,0,0,0
1668527196306,CSE 290,E00,102429,Zhao; Jishen,0,4,0,0
1668527196306,CSE 290,F00,102436,Tullsen; Dean Michael,0,5,0,0
1668527196306,CSE 290,G00,102440,Christensen; Henrik I,0,6,20,20
1668527196735,CSE 291,A00,102443,Su; Hao,0,0,0,0
1668527196735,CSE 291,B00,102448,Polikarpova; Nadezhda,0,0,0,0
1668527196735,CSE 291,C00,102453,Vaccaro; Kristen Marie,0,0,0,0
1668527196735,CSE 291,D00,111343,Savage; Stefan,0,0,0,0
1668527196735,CSE 291,E00,116474,Claffy; Kimberly Claire,0,0,0,0
1668527196735,CSE 291,F00,116479,Pasquale; Joseph,0,0,0,0
1668527197163,CSE 293,001,119111,Bafna; Vineet,9999,0,9999,0
1668527197163,CSE 293,002,119118,Bellare; Mihir,9999,0,9999,0
1668527197163,CSE 293,003,119122,Berg-Kirkpatrick; Taylor D,9999,0,9999,0
1668527197163,CSE 293,004,119135,Christensen; Henrik I,9999,0,9999,0
1668527197163,CSE 293,005,119142,Cottrell; Garrison W,9999,0,9999,0
1668527197163,CSE 293,006,119146,Deutsch; Alin Bernard,9999,0,9999,0
1668527197163,CSE 293,007,119159,Esmaeilzadeh; Hadi,9999,0,9999,0
1668527197163,CSE 293,008,119166,Freund; Yoav,9999,0,9999,0
1668527197163,CSE 293,009,119170,Griswold; William G.,9999,0,9999,0
1668527197163,CSE 293,010,119183,Gymrek; Melissa Ann,9999,0,9999,0
1668527197163,CSE 293,011,119190,Heninger; Nadia A,9999,0,9999,0
1668527197163,CSE 293,012,119230,Impagliazzo; Russell,9999,0,9999,0
1668527197163,CSE 293,013,119232,Jhala; Ranjit,9999,0,9999,0
1668527197163,CSE 293,014,119233,Kahng; Andrew Byun,9999,0,9999,0
1668527197163,CSE 293,015,119298,Kane; Daniel Mertz,9999,0,9999,0
1668527197163,CSE 293,016,119299,Kriegman; David J,9999,0,9999,0
1668527197163,CSE 293,017,119300,Kumar; Arun Kumar,9999,0,9999,0
1668527197163,CSE 293,018,119301,Lerner; Sorin,9999,0,9999,0
1668527197163,CSE 293,019,119302,Lovett; Shachar,9999,0,9999,0
1668527197163,CSE 293,020,119303,McAuley; Julian John,9999,0,9999,0
1668527197163,CSE 293,021,119304,Micciancio; Daniele,9999,0,9999,0
1668527197163,CSE 293,022,119367,Orailoglu; Alex,9999,0,9999,0
1668527197163,CSE 293,023,119382,Paturi; Ramamohan,9999,0,9999,0
1668527197163,CSE 293,024,119404,Polikarpova; Nadezhda,9999,0,9999,0
1668527197163,CSE 293,025,119406,Politz; Joseph Gibbs,9999,0,9999,0
1668527197163,CSE 293,026,119411,Porter; George M,9999,0,9999,0
1668527197163,CSE 293,027,119414,Porter; Leonard Emerson,9999,0,9999,0
1668527197163,CSE 293,028,119416,Ramamoorthi; Ravi,9999,0,9999,0
1668527197163,CSE 293,029,119417,Sahoo; Debashis,9999,0,9999,0
1668527197163,CSE 293,030,119420,Saul; Lawrence,9999,0,9999,0
1668527197163,CSE 293,031,119421,Savage; Stefan,9999,0,9999,0
1668527197163,CSE 293,032,119425,Schulze; Jurgen P.,9999,0,9999,0
1668527197163,CSE 293,033,119426,Snoeren; Alex C.,9999,0,9999,0
1668527197163,CSE 293,034,119428,Shang; Jingbo,9999,0,9999,0
1668527197163,CSE 293,035,119430,Stefan; Deian,9999,0,9999,0
1668527197163,CSE 293,036,119431,Su; Hao,9999,0,9999,0
1668527197163,CSE 293,037,119433,Swanson; Steven James,9999,0,9999,0
1668527197163,CSE 293,038,119435,Tullsen; Dean Michael,9999,0,9999,0
1668527197163,CSE 293,039,119483,Voelker; Geoffrey M.,9999,0,9999,0
1668527197163,CSE 293,040,119537,Zhao; Jishen,9999,0,9999,0
1668527197163,CSE 293,041,119538,Zhou; Yuan-Yuan,9999,0,9999,0
1668527197163,CSE 293,042,119539,Gao; Sicun,9999,0,9999,0
1668527197163,CSE 293,043,119540,Weibel; Nadir,9999,0,9999,0
1668527197163,CSE 293,044,119541,Gupta; Rajesh K.,9999,0,9999,0
1668527197163,CSE 293,045,126410,Vaccaro; Kristen Marie,9999,0,9999,0
1668527197163,CSE 293,046,126411,Klemke; Richard,9999,0,9999,0
1668527197588,CSE 294,A00,102459,Voelker; Geoffrey M.,0,2,0,0
1668527197588,CSE 294,B00,111322,Orailoglu; Alex,0,2,0,0
1668527198016,DSE 201,A00,096914,Deutsch; Alin Bernard,30,0,30,0
1668527198443,DSE 210,A00,096915,Dasgupta; Sanjoy,30,0,30,0
1668527198877,DSE 260A,A00,096916,Altintas De Callaf; Ilkay,30,0,30,0
1668527199335,ECE 200,001,103586,Antipa; Nicholas A,9999,0,9999,0
1668527199335,ECE 200,002,103587,Atanasov; Nikolay A.,9999,0,9999,0
1668527199335,ECE 200,003,103588,Bharadia; Dinesh,9999,0,9999,0
1668527199335,ECE 200,004,103589,Cheng; Chung Kuan,9999,0,9999,0
1668527199335,ECE 200,005,103590,Cosman; Pamela C.,9999,0,9999,0
1668527199335,ECE 200,006,103591,Dayeh; Shadi Ahmad,9999,0,9999,0
1668527199335,ECE 200,007,103592,Fainman; Yeshaiahu,9999,0,9999,0
1668527199335,ECE 200,008,103593,Ford; Joseph Earl,9999,0,9999,0
1668527199335,ECE 200,009,103594,Franceschetti; Massimo,9999,0,9999,0
1668527199335,ECE 200,010,103595,Fullerton; Eric E,9999,0,9999,0
1668527199335,ECE 200,011,103596,Galton; Ian A,9999,0,9999,0
1668527199335,ECE 200,012,103597,Gilja; Vikash,9999,0,9999,0
1668527199335,ECE 200,013,103598,Hall; Drew A.,9999,0,9999,0
1668527199335,ECE 200,014,103599,Hsueh; Tzu-Chien,9999,0,9999,0
1668527199335,ECE 200,015,103600,Javidi; Tara,9999,0,9999,0
1668527199335,ECE 200,016,103601,Kahng; Andrew Byun,9999,0,9999,0
1668527199335,ECE 200,017,103602,Kim; Young-Han,9999,0,9999,0
1668527199335,ECE 200,018,103603,Koushanfar; Farinaz,9999,0,9999,0
1668527199335,ECE 200,019,103604,Kuzum; Duygu,9999,0,9999,0
1668527199335,ECE 200,020,103605,Le; Hanh-Phuc,9999,0,9999,0
1668527199335,ECE 200,021,103606,Lin; Bill,9999,0,9999,0
1668527199335,ECE 200,022,103607,Liu; Zhaowei,9998,0,9999,1
1668527199335,ECE 200,023,103608,Lo; Yu-Hwa,9999,0,9999,0
1668527199335,ECE 200,024,103609,Lomakin; Vitaliy,9999,0,9999,0
1668527199335,ECE 200,025,103610,Mercier; Patrick Philip,9999,0,9999,0
1668527199335,ECE 200,026,103611,Meyer; Florian,9999,0,9999,0
1668527199335,ECE 200,027,103612,Milstein; Laurence B.,9999,0,9999,0
1668527199335,ECE 200,028,103613,Mir Arabbaygi; Siavash,9999,0,9999,0
1668527199335,ECE 200,029,103614,Mookherjea; Shayan,9999,0,9999,0
1668527199335,ECE 200,030,103615,Morris; Karcher William,9999,0,9999,0
1668527199335,ECE 200,031,103616,Ng; Tse Nga,9999,0,9999,0
1668527199335,ECE 200,032,103617,Nguyen; Truong Quang,9999,0,9999,0
1668527199335,ECE 200,033,103618,Nomura; Kenji,9999,0,9999,0
1668527199335,ECE 200,034,103619,Orlitsky; Alon,9999,0,9999,0
1668527199335,ECE 200,035,103620,Pal; Piya,9999,0,9999,0
1668527199335,ECE 200,036,103621,Papen; George C.,9999,0,9999,0
1668527199335,ECE 200,037,103622,Radic; Stojan,9999,0,9999,0
1668527199335,ECE 200,038,103623,Rao; Bhaskar D.,9999,0,9999,0
1668527199335,ECE 200,039,103624,Rao; Ramesh R,9999,0,9999,0
1668527199335,ECE 200,040,103625,Rebeiz; Gabriel,9999,0,9999,0
1668527199335,ECE 200,041,103626,Sanford; John R,9999,0,9999,0
1668527199335,ECE 200,042,103627,Siegel; Paul H.,9999,0,9999,0
1668527199335,ECE 200,043,103628,Sievenpiper; Daniel F.,9999,0,9999,0
1668527199335,ECE 200,044,103629,Sworder; David D.,9999,0,9999,0
1668527199335,ECE 200,045,103630,Taur; Yuan,9999,0,9999,0
1668527199335,ECE 200,046,103631,Touri; Behrouz,9999,0,9999,0
1668527199335,ECE 200,047,103632,Trivedi; Mohan M.,9999,0,9999,0
1668527199335,ECE 200,048,103633,Vasconcelos; Nuno,9999,0,9999,0
1668527199335,ECE 200,049,103634,Wang; Xiaolong,9999,0,9999,0
1668527199335,ECE 200,050,103635,Xie; Pengtao,9999,0,9999,0
1668527199335,ECE 200,051,103636,Yip; Michael,9999,0,9999,0
1668527199335,ECE 200,052,103637,Zeger; Kenneth A.,999,0,999,0
1668527199335,ECE 200,053,103638,Zhang; Xinyu,9999,0,9999,0
1668527199335,ECE 200,054,103639,Turakhia; Yatish Girish,9999,0,9999,0
1668527199335,ECE 200,055,103640,Kang; Mingu,9999,0,9999,0
1668527199335,ECE 200,056,103641,Shi; Yuanyuan,9999,0,9999,0
1668527199335,ECE 200,057,103642,Wang; Edward Jay,9999,0,9999,0
1668527199335,ECE 200,058,103643,Zheng; Yang,9999,0,9999,0
1668527199759,ECE 202,A00,103644,Kuzum; Duygu,0,44,0,0
1668527200187,ECE 212BN,A00,103646,Ng; Tse Nga,0,9,0,0
1668527200618,ECE 221,A00,111493,Staff,0,0,0,0
1668527201044,ECE 222B,A00,103647,Lomakin; Vitaliy,0,20,0,0
1668527201471,ECE 230B,A00,103648,Taur; Yuan,0,3,0,0
1668527201894,ECE 238B,A00,103649,Garay; Javier,0,0,0,0
1668527202325,ECE 240B,A00,112900,Fainman; Yeshaiahu,0,7,0,0
1668527202749,ECE 247A,A00,103650,Jokerst; Jesse Vincent,0,6,0,0
1668527203189,ECE 247B,A00,103651,Wang; Joseph,0,14,0,0
1668527203626,ECE 250,A00,103652,Siegel; Paul H.,0,82,0,0
1668527204060,ECE 251A,A00,103654,Rao; Bhaskar D.,0,62,0,0
1668527204484,ECE 257B,A00,103655,Bharadia; Dinesh,0,33,0,0
1668527204907,ECE 258A,A00,103656,Milstein; Laurence B.,0,29,0,0
1668527205330,ECE 260B,A00,103658,Kang; Mingu,0,119,0,0
1668527205770,ECE 264A,A00,103659,Galton; Ian A,0,66,0,0
1668527206195,ECE 265A,A00,103661,Gudem; Prasad S.S.,0,70,0,0
1668527206630,ECE 265D,A00,103662,Gudem; Prasad S.S.,0,26,0,0
1668527207063,ECE 268,A00,103663,Koushanfar; Farinaz,0,43,0,0
1668527207503,ECE 269,A01,103665,Pal; Piya,0,216,0,0
1668527207926,ECE 271B,A00,103666,Vasconcelos; Manuela,0,76,0,0
1668527208361,ECE 276A,A00,103667,Atanasov; Nikolay A.,0,127,0,0
1668527208785,ECE 277,A00,103668,An; Cheolhong,0,149,0,0
1668527209211,ECE 279,A00,117947,Hall; Drew A.,0,22,0,0
1668527210076,ECE 283,A00,103670,Hsueh; Tzu-Chien,0,54,0,0
1668527210521,ECE 284,A00,103671,Turakhia; Yatish Girish,0,39,0,0
1668527210963,ECE 285,A00,103672,Zheng; Yang,0,40,0,0
1668527210963,ECE 285,B00,103673,Sworder; David D.,0,57,0,0
1668527211397,ECE 287,A00,103676,Javidi; Tara,0,9,0,0
1668527211831,MATH 200B,A00,098023,Salehi Golsefidy; Alireza,10,0,15,5
1668527212256,MATH 202B,A00,098024,Rhoades; Brendon Patrick,7,0,15,8
1668527212680,MATH 203B,A00,098025,Oprea; Dragos N.,9,0,15,6
1668527213115,MATH 204B,A00,098026,Sorensen; Claus M,13,0,15,2
1668527213538,MATH 208,A00,098027,Izadi; Elham,7,0,10,3
1668527213961,MATH 209,A00,098028,Pollack; Aaron,10,0,10,0
1668527214395,MATH 211A,A00,112919,Rogalski; Daniel,8,0,10,2
1668527214821,MATH 211B,A00,112920,Seward; Brandon M.,9,0,10,1
1668527215254,MATH 218,A00,098029,Li; Bo,10,0,10,0
1668527215689,MATH 220B,A00,098030,Novak; Jonathan I,11,0,15,4
1668527216129,MATH 221A,A00,098031,Ebenfelt; Peter F,12,0,15,3
1668527216553,MATH 231B,A00,098032,Zlatos; Andrej,11,0,15,4
1668527216977,MATH 240B,A00,098033,Ni; Lei,7,0,15,8
1668527217417,MATH 243,A00,098034,Jekel; David Andrew,10,0,10,0
1668527217843,MATH 245A,A00,098035,Nie; Jiawang,0,5,15,18
1668527218272,MATH 248,A00,098036,Bejenaru; Ioan,10,0,10,0
1668527218701,MATH 250B,A00,098037,Spolaor; Luca,14,0,15,1
1668527219129,MATH 258,A00,098038,Ni; Lei,9,0,10,1
1668527219554,MATH 264B,A00,098041,Rhoades; Brendon Patrick,8,0,15,7
1668527219977,MATH 268,A00,098042,Buss; Samuel R,10,0,10,0
1668527220513,MATH 269,A00,098043,Rhoades; Brendon Patrick,10,0,10,0
1668527220948,MATH 270B,A00,098044,Li; Bo,6,0,15,9
1668527221373,MATH 272B,A00,098045,Holst; Michael J,13,0,15,2
1668527221812,MATH 273A,A00,098046,Tian; Xiaochuan,10,0,15,5
1668527222236,MATH 275,A01,098048,Tian; Xiaochuan,6,0,10,4
1668527222671,MATH 278A,A00,098049,Holst; Michael J,7,0,10,3
1668527223098,MATH 278B,A00,098050,Cloninger; Alexander,10,0,10,0
1668527223526,MATH 278C,A00,098051,Nie; Jiawang,5,0,10,5
1668527223958,MATH 280B,A00,098052,Zheng; Tianyi,7,0,15,8
1668527224387,MATH 281B,A00,098053,Bradic; Jelena,0,2,15,15
1668527224826,MATH 282B,A00,098054,Arias-Castro; Ery,0,1,15,15
1668527225251,MATH 285,A00,098055,Fitzsimmons; Patrick J,0,3,15,17
1668527225674,MATH 287B,A00,098056,Arias-Castro; Ery,1,0,15,14
1668527226100,MATH 288,A00,098057,Agarwal; Pooja,9,0,10,1
1668527226100,MATH 288,B00,098058,Zhang; Danna,8,0,10,2
1668527226100,MATH 288,C00,098059,Williams; Ruth J,9,0,10,1
1668527226531,MATH 290B,A00,098060,Roberts; Justin Deritter,12,0,15,3
1668527226956,MATH 292,A00,098061,Belmont; Eva Kinoshita,10,0,10,0
1668527227395,MATH 295,A00,098062,Suk; Andrew Hoon,47,0,50,3
1668527227819,MATH 296,A00,098063,Novak; Jonathan I,20,0,20,0
1668527228247,MATH 297,001,098064,Gamst; Anthony Collins,9997,0,9999,2
1668527732366,COGS 205,A00,101395,Chiba; Andrea,19,0,20,1
1668527732789,COGS 210B,001,101404,Greene; Deanna Jacquelyn,9998,0,9999,1
1668527732789,COGS 210B,002,101417,Xia; Haijun,9999,0,9999,0
1668527732789,COGS 210B,003,101422,Nitz; Douglas A.,9999,0,9999,0
1668527732789,COGS 210B,004,101423,Hollan; James D.,9998,0,9999,1
1668527732789,COGS 210B,005,101424,Deak; Gedeon O.,9998,0,9999,1
1668527732789,COGS 210B,006,101425,Rossano; Federico,9999,0,9999,0
1668527733215,COGS 211B,A00,101427,Coulson; Seana M,9996,0,9999,3
1668527733646,COGS 220,A00,101428,Hollan; James D.,0,10,25,25
1668527734068,COGS 229,A00,101429,Dow; Steven P,17,0,25,8
1668527734492,COGS 230,A00,101430,Klemmer; Scott R,7,0,17,10
1668527734918,COGS 234,A00,101431,Xia; Haijun,1,0,25,24
1668527735356,COGS 260,A00,101432,Kiyonaga; Anastasia,21,0,25,4
1668527735356,COGS 260,B00,101433,Kirsh; David Joel,15,0,25,10
1668527735781,CSE 202,A00,102371,Impagliazzo; Russell,0,66,0,0
1668527736208,CSE 203B,A01,102373,Cheng; Chung Kuan,0,59,0,0
1668527736644,CSE 208,A00,102374,Micciancio; Daniele,0,5,0,0
1668527737069,CSE 209A,A00,112895,Impagliazzo; Russell,0,12,15,15
1668527737495,CSE 209B,A00,108005,Bellare; Mihir,0,7,0,0
1668527737923,CSE 210,A00,113163,Coblenz; Michael J,0,85,0,0
1668527738347,CSE 219,A00,106111,Dow; Steven P,0,6,20,20
1668527738772,CSE 221,A00,102376,Voelker; Geoffrey M.,0,73,0,0
1668527739201,CSE 224,A01,102378,Porter; George M,0,167,0,0
1668527739628,CSE 229A,A00,102379,Savage; Stefan,0,10,0,0
1668527740051,CSE 229C,A00,102380,Munyaka; Imani N. S.,0,10,0,0
1668527740475,CSE 232B,A00,102382,Deutsch; Alin Bernard,0,32,0,0
1668527740905,CSE 234,A01,112904,Kumar; Arun Kumar,0,0,0,0
1668527741333,CSE 237A,A00,102383,Rosing; Tajana Simunic,0,55,0,0
1668527741759,CSE 239A,A00,102384,Deutsch; Alin Bernard,0,14,0,0
1668527742185,CSE 239B,A00,102385,Polikarpova; Nadezhda,0,10,0,0
1668527742608,CSE 240A,A00,102386,Pannuto; Patrick William,0,46,0,0
1668527743034,CSE 240B,A00,102387,Zhao; Jishen,0,47,0,0
1668527743559,CSE 241A,A00,106406,Kang; Mingu,0,9,0,0
1668527743987,CSE 249B,A00,102388,Kahng; Andrew Byun,0,5,8,8
1668527744414,CSE 251B,A01,102392,Cottrell; Garrison W,0,51,0,0
1668527744414,CSE 251B,A02,102393,Cottrell; Garrison W,0,34,0,0
1668527744840,CSE 252B,A00,102394,Ochoa; Benjamin Lawrence,0,59,0,0
1668527745266,CSE 257,A01,102396,Gao; Sicun,0,139,0,0
1668527745693,CSE 272,A00,102397,Li; Tzumao,0,19,0,0
1668527746116,CSE 274,A00,111323,Chern; Albert Ren-Haur,0,15,0,0
1668527746550,CSE 282,A00,102398,Pevzner; Pavel Arkadjevich,0,0,0,0
1668527746977,CSE 284,A00,114175,Gymrek; Melissa Ann,0,22,0,0
1668527747401,CSE 290,A00,102399,Chandraker; Manmohan Krishna,0,11,0,0
1668527747401,CSE 290,B00,102400,Vaccaro; Kristen Marie,0,7,25,25
1668527747401,CSE 290,C00,102414,Pannuto; Patrick William,0,1,25,25
1668527747401,CSE 290,D00,102427,Pevzner; Pavel Arkadjevich,0,0,0,0
1668527747401,CSE 290,E00,102429,Zhao; Jishen,0,4,0,0
1668527747401,CSE 290,F00,102436,Tullsen; Dean Michael,0,5,0,0
1668527747401,CSE 290,G00,102440,Christensen; Henrik I,0,6,20,20
1668527747829,CSE 291,A00,102443,Su; Hao,0,0,0,0
1668527747829,CSE 291,B00,102448,Polikarpova; Nadezhda,0,0,0,0
1668527747829,CSE 291,C00,102453,Vaccaro; Kristen Marie,0,0,0,0
1668527747829,CSE 291,D00,111343,Savage; Stefan,0,0,0,0
1668527747829,CSE 291,E00,116474,Claffy; Kimberly Claire,0,0,0,0
1668527747829,CSE 291,F00,116479,Pasquale; Joseph,0,0,0,0
1668527748274,CSE 293,001,119111,Bafna; Vineet,9999,0,9999,0
1668527748274,CSE 293,002,119118,Bellare; Mihir,9999,0,9999,0
1668527748274,CSE 293,003,119122,Berg-Kirkpatrick; Taylor D,9999,0,9999,0
1668527748274,CSE 293,004,119135,Christensen; Henrik I,9999,0,9999,0
1668527748274,CSE 293,005,119142,Cottrell; Garrison W,9999,0,9999,0
1668527748274,CSE 293,006,119146,Deutsch; Alin Bernard,9999,0,9999,0
1668527748274,CSE 293,007,119159,Esmaeilzadeh; Hadi,9999,0,9999,0
1668527748274,CSE 293,008,119166,Freund; Yoav,9999,0,9999,0
1668527748274,CSE 293,009,119170,Griswold; William G.,9999,0,9999,0
1668527748274,CSE 293,010,119183,Gymrek; Melissa Ann,9999,0,9999,0
1668527748274,CSE 293,011,119190,Heninger; Nadia A,9999,0,9999,0
1668527748274,CSE 293,012,119230,Impagliazzo; Russell,9999,0,9999,0
1668527748274,CSE 293,013,119232,Jhala; Ranjit,9999,0,9999,0
1668527748274,CSE 293,014,119233,Kahng; Andrew Byun,9999,0,9999,0
1668527748274,CSE 293,015,119298,Kane; Daniel Mertz,9999,0,9999,0
1668527748274,CSE 293,016,119299,Kriegman; David J,9999,0,9999,0
1668527748274,CSE 293,017,119300,Kumar; Arun Kumar,9999,0,9999,0
1668527748274,CSE 293,018,119301,Lerner; Sorin,9999,0,9999,0
1668527748274,CSE 293,019,119302,Lovett; Shachar,9999,0,9999,0
1668527748274,CSE 293,020,119303,McAuley; Julian John,9999,0,9999,0
1668527748274,CSE 293,021,119304,Micciancio; Daniele,9999,0,9999,0
1668527748274,CSE 293,022,119367,Orailoglu; Alex,9999,0,9999,0
1668527748274,CSE 293,023,119382,Paturi; Ramamohan,9999,0,9999,0
1668527748274,CSE 293,024,119404,Polikarpova; Nadezhda,9999,0,9999,0
1668527748274,CSE 293,025,119406,Politz; Joseph Gibbs,9999,0,9999,0
1668527748274,CSE 293,026,119411,Porter; George M,9999,0,9999,0
1668527748274,CSE 293,027,119414,Porter; Leonard Emerson,9999,0,9999,0
1668527748274,CSE 293,028,119416,Ramamoorthi; Ravi,9999,0,9999,0
1668527748274,CSE 293,029,119417,Sahoo; Debashis,9999,0,9999,0
1668527748274,CSE 293,030,119420,Saul; Lawrence,9999,0,9999,0
1668527748274,CSE 293,031,119421,Savage; Stefan,9999,0,9999,0
1668527748274,CSE 293,032,119425,Schulze; Jurgen P.,9999,0,9999,0
1668527748274,CSE 293,033,119426,Snoeren; Alex C.,9999,0,9999,0
1668527748274,CSE 293,034,119428,Shang; Jingbo,9999,0,9999,0
1668527748274,CSE 293,035,119430,Stefan; Deian,9999,0,9999,0
1668527748274,CSE 293,036,119431,Su; Hao,9999,0,9999,0
1668527748274,CSE 293,037,119433,Swanson; Steven James,9999,0,9999,0
1668527748274,CSE 293,038,119435,Tullsen; Dean Michael,9999,0,9999,0
1668527748274,CSE 293,039,119483,Voelker; Geoffrey M.,9999,0,9999,0
1668527748274,CSE 293,040,119537,Zhao; Jishen,9999,0,9999,0
1668527748274,CSE 293,041,119538,Zhou; Yuan-Yuan,9999,0,9999,0
1668527748274,CSE 293,042,119539,Gao; Sicun,9999,0,9999,0
1668527748274,CSE 293,043,119540,Weibel; Nadir,9999,0,9999,0
1668527748274,CSE 293,044,119541,Gupta; Rajesh K.,9999,0,9999,0
1668527748274,CSE 293,045,126410,Vaccaro; Kristen Marie,9999,0,9999,0
1668527748274,CSE 293,046,126411,Klemke; Richard,9999,0,9999,0
1668527748697,CSE 294,A00,102459,Voelker; Geoffrey M.,0,2,0,0
1668527748697,CSE 294,B00,111322,Orailoglu; Alex,0,2,0,0
1668527749130,DSE 201,A00,096914,Deutsch; Alin Bernard,30,0,30,0
1668527749571,DSE 210,A00,096915,Dasgupta; Sanjoy,30,0,30,0
1668527749999,DSE 260A,A00,096916,Altintas De Callaf; Ilkay,30,0,30,0
1668527750434,ECE 200,001,103586,Antipa; Nicholas A,9999,0,9999,0
1668527750434,ECE 200,002,103587,Atanasov; Nikolay A.,9999,0,9999,0
1668527750434,ECE 200,003,103588,Bharadia; Dinesh,9999,0,9999,0
1668527750434,ECE 200,004,103589,Cheng; Chung Kuan,9999,0,9999,0
1668527750434,ECE 200,005,103590,Cosman; Pamela C.,9999,0,9999,0
1668527750434,ECE 200,006,103591,Dayeh; Shadi Ahmad,9999,0,9999,0
1668527750434,ECE 200,007,103592,Fainman; Yeshaiahu,9999,0,9999,0
1668527750434,ECE 200,008,103593,Ford; Joseph Earl,9999,0,9999,0
1668527750434,ECE 200,009,103594,Franceschetti; Massimo,9999,0,9999,0
1668527750434,ECE 200,010,103595,Fullerton; Eric E,9999,0,9999,0
1668527750434,ECE 200,011,103596,Galton; Ian A,9999,0,9999,0
1668527750434,ECE 200,012,103597,Gilja; Vikash,9999,0,9999,0
1668527750434,ECE 200,013,103598,Hall; Drew A.,9999,0,9999,0
1668527750434,ECE 200,014,103599,Hsueh; Tzu-Chien,9999,0,9999,0
1668527750434,ECE 200,015,103600,Javidi; Tara,9999,0,9999,0
1668527750434,ECE 200,016,103601,Kahng; Andrew Byun,9999,0,9999,0
1668527750434,ECE 200,017,103602,Kim; Young-Han,9999,0,9999,0
1668527750434,ECE 200,018,103603,Koushanfar; Farinaz,9999,0,9999,0
1668527750434,ECE 200,019,103604,Kuzum; Duygu,9999,0,9999,0
1668527750434,ECE 200,020,103605,Le; Hanh-Phuc,9999,0,9999,0
1668527750434,ECE 200,021,103606,Lin; Bill,9999,0,9999,0
1668527750434,ECE 200,022,103607,Liu; Zhaowei,9998,0,9999,1
1668527750434,ECE 200,023,103608,Lo; Yu-Hwa,9999,0,9999,0
1668527750434,ECE 200,024,103609,Lomakin; Vitaliy,9999,0,9999,0
1668527750434,ECE 200,025,103610,Mercier; Patrick Philip,9999,0,9999,0
1668527750434,ECE 200,026,103611,Meyer; Florian,9999,0,9999,0
1668527750434,ECE 200,027,103612,Milstein; Laurence B.,9999,0,9999,0
1668527750434,ECE 200,028,103613,Mir Arabbaygi; Siavash,9999,0,9999,0
1668527750434,ECE 200,029,103614,Mookherjea; Shayan,9999,0,9999,0
1668527750434,ECE 200,030,103615,Morris; Karcher William,9999,0,9999,0
1668527750434,ECE 200,031,103616,Ng; Tse Nga,9999,0,9999,0
1668527750434,ECE 200,032,103617,Nguyen; Truong Quang,9999,0,9999,0
1668527750434,ECE 200,033,103618,Nomura; Kenji,9999,0,9999,0
1668527750434,ECE 200,034,103619,Orlitsky; Alon,9999,0,9999,0
1668527750434,ECE 200,035,103620,Pal; Piya,9999,0,9999,0
1668527750434,ECE 200,036,103621,Papen; George C.,9999,0,9999,0
1668527750434,ECE 200,037,103622,Radic; Stojan,9999,0,9999,0
1668527750434,ECE 200,038,103623,Rao; Bhaskar D.,9999,0,9999,0
1668527750434,ECE 200,039,103624,Rao; Ramesh R,9999,0,9999,0
1668527750434,ECE 200,040,103625,Rebeiz; Gabriel,9999,0,9999,0
1668527750434,ECE 200,041,103626,Sanford; John R,9999,0,9999,0
1668527750434,ECE 200,042,103627,Siegel; Paul H.,9999,0,9999,0
1668527750434,ECE 200,043,103628,Sievenpiper; Daniel F.,9999,0,9999,0
1668527750434,ECE 200,044,103629,Sworder; David D.,9999,0,9999,0
1668527750434,ECE 200,045,103630,Taur; Yuan,9999,0,9999,0
1668527750434,ECE 200,046,103631,Touri; Behrouz,9999,0,9999,0
1668527750434,ECE 200,047,103632,Trivedi; Mohan M.,9999,0,9999,0
1668527750434,ECE 200,048,103633,Vasconcelos; Nuno,9999,0,9999,0
1668527750434,ECE 200,049,103634,Wang; Xiaolong,9999,0,9999,0
1668527750434,ECE 200,050,103635,Xie; Pengtao,9999,0,9999,0
1668527750434,ECE 200,051,103636,Yip; Michael,9999,0,9999,0
1668527750434,ECE 200,052,103637,Zeger; Kenneth A.,999,0,999,0
1668527750434,ECE 200,053,103638,Zhang; Xinyu,9999,0,9999,0
1668527750434,ECE 200,054,103639,Turakhia; Yatish Girish,9999,0,9999,0
1668527750434,ECE 200,055,103640,Kang; Mingu,9999,0,9999,0
1668527750434,ECE 200,056,103641,Shi; Yuanyuan,9999,0,9999,0
1668527750434,ECE 200,057,103642,Wang; Edward Jay,9999,0,9999,0
1668527750434,ECE 200,058,103643,Zheng; Yang,9999,0,9999,0
1668527750865,ECE 202,A00,103644,Kuzum; Duygu,0,44,0,0
1668527751291,ECE 212BN,A00,103646,Ng; Tse Nga,0,9,0,0
1668527751717,ECE 221,A00,111493,Staff,0,0,0,0
1668527752142,ECE 222B,A00,103647,Lomakin; Vitaliy,0,20,0,0
1668527752567,ECE 230B,A00,103648,Taur; Yuan,0,3,0,0
1668527752990,ECE 238B,A00,103649,Garay; Javier,0,0,0,0
1668527753413,ECE 240B,A00,112900,Fainman; Yeshaiahu,0,7,0,0
1668527753841,ECE 247A,A00,103650,Jokerst; Jesse Vincent,0,6,0,0
1668527754265,ECE 247B,A00,103651,Wang; Joseph,0,14,0,0
1668527754690,ECE 250,A00,103652,Siegel; Paul H.,0,82,0,0
1668527755119,ECE 251A,A00,103654,Rao; Bhaskar D.,0,62,0,0
1668527755546,ECE 257B,A00,103655,Bharadia; Dinesh,0,33,0,0
1668527755973,ECE 258A,A00,103656,Milstein; Laurence B.,0,29,0,0
1668527756398,ECE 260B,A00,103658,Kang; Mingu,0,119,0,0
1668527756831,ECE 264A,A00,103659,Galton; Ian A,0,66,0,0
1668527757257,ECE 265A,A00,103661,Gudem; Prasad S.S.,0,70,0,0
1668527757688,ECE 265D,A00,103662,Gudem; Prasad S.S.,0,26,0,0
1668527758125,ECE 268,A00,103663,Koushanfar; Farinaz,0,43,0,0
1668527758550,ECE 269,A01,103665,Pal; Piya,0,216,0,0
1668527758974,ECE 271B,A00,103666,Vasconcelos; Manuela,0,76,0,0
1668527759399,ECE 276A,A00,103667,Atanasov; Nikolay A.,0,127,0,0
1668527759831,ECE 277,A00,103668,An; Cheolhong,0,149,0,0
1668527760257,ECE 279,A00,117947,Hall; Drew A.,0,22,0,0
1668527761116,ECE 283,A00,103670,Hsueh; Tzu-Chien,0,54,0,0
1668527761540,ECE 284,A00,103671,Turakhia; Yatish Girish,0,39,0,0
1668527761974,ECE 285,A00,103672,Zheng; Yang,0,40,0,0
1668527761974,ECE 285,B00,103673,Sworder; David D.,0,57,0,0
1668527762409,ECE 287,A00,103676,Javidi; Tara,0,9,0,0
1668527762839,MATH 200B,A00,098023,Salehi Golsefidy; Alireza,10,0,15,5
1668527763271,MATH 202B,A00,098024,Rhoades; Brendon Patrick,7,0,15,8
1668527763694,MATH 203B,A00,098025,Oprea; Dragos N.,9,0,15,6
1668527764129,MATH 204B,A00,098026,Sorensen; Claus M,13,0,15,2
1668527764562,MATH 208,A00,098027,Izadi; Elham,7,0,10,3
1668527764989,MATH 209,A00,098028,Pollack; Aaron,10,0,10,0
1668527765417,MATH 211A,A00,112919,Rogalski; Daniel,8,0,10,2
1668527765842,MATH 211B,A00,112920,Seward; Brandon M.,9,0,10,1
1668527766265,MATH 218,A00,098029,Li; Bo,10,0,10,0
1668527766696,MATH 220B,A00,098030,Novak; Jonathan I,11,0,15,4
1668527767123,MATH 221A,A00,098031,Ebenfelt; Peter F,12,0,15,3
1668527767549,MATH 231B,A00,098032,Zlatos; Andrej,11,0,15,4
1668527767977,MATH 240B,A00,098033,Ni; Lei,7,0,15,8
1668527768399,MATH 243,A00,098034,Jekel; David Andrew,10,0,10,0
1668527768840,MATH 245A,A00,098035,Nie; Jiawang,0,5,15,18
1668527769264,MATH 248,A00,098036,Bejenaru; Ioan,10,0,10,0
1668527769710,MATH 250B,A00,098037,Spolaor; Luca,14,0,15,1
1668527770141,MATH 258,A00,098038,Ni; Lei,9,0,10,1
1668527770569,MATH 264B,A00,098041,Rhoades; Brendon Patrick,8,0,15,7
1668527770992,MATH 268,A00,098042,Buss; Samuel R,10,0,10,0
1668527771423,MATH 269,A00,098043,Rhoades; Brendon Patrick,10,0,10,0
1668527771846,MATH 270B,A00,098044,Li; Bo,6,0,15,9
1668527772280,MATH 272B,A00,098045,Holst; Michael J,13,0,15,2
1668527772704,MATH 273A,A00,098046,Tian; Xiaochuan,10,0,15,5
1668527773129,MATH 275,A01,098048,Tian; Xiaochuan,6,0,10,4
1668527773554,MATH 278A,A00,098049,Holst; Michael J,7,0,10,3
1668527773979,MATH 278B,A00,098050,Cloninger; Alexander,10,0,10,0
1668527774407,MATH 278C,A00,098051,Nie; Jiawang,5,0,10,5
1668527774831,MATH 280B,A00,098052,Zheng; Tianyi,7,0,15,8
1668527775263,MATH 281B,A00,098053,Bradic; Jelena,0,2,15,15
1668527775692,MATH 282B,A00,098054,Arias-Castro; Ery,0,1,15,15
1668527776133,MATH 285,A00,098055,Fitzsimmons; Patrick J,0,3,15,17
1668527776556,MATH 287B,A00,098056,Arias-Castro; Ery,1,0,15,14
1668527776983,MATH 288,A00,098057,Agarwal; Pooja,9,0,10,1
1668527776983,MATH 288,B00,098058,Zhang; Danna,8,0,10,2
1668527776983,MATH 288,C00,098059,Williams; Ruth J,9,0,10,1
1668527777407,MATH 290B,A00,098060,Roberts; Justin Deritter,12,0,15,3
1668527777837,MATH 292,A00,098061,Belmont; Eva Kinoshita,10,0,10,0
1668527778263,MATH 295,A00,098062,Suk; Andrew Hoon,47,0,50,3
1668527778715,MATH 296,A00,098063,Novak; Jonathan I,20,0,20,0
1668527779139,MATH 297,001,098064,Gamst; Anthony Collins,9997,0,9999,2
1668528283929,COGS 205,A00,101395,Chiba; Andrea,19,0,20,1
1668528284356,COGS 210B,001,101404,Greene; Deanna Jacquelyn,9998,0,9999,1
1668528284356,COGS 210B,002,101417,Xia; Haijun,9999,0,9999,0
1668528284356,COGS 210B,003,101422,Nitz; Douglas A.,9999,0,9999,0
1668528284356,COGS 210B,004,101423,Hollan; James D.,9998,0,9999,1
1668528284356,COGS 210B,005,101424,Deak; Gedeon O.,9998,0,9999,1
1668528284356,COGS 210B,006,101425,Rossano; Federico,9999,0,9999,0
1668528284794,COGS 211B,A00,101427,Coulson; Seana M,9996,0,9999,3
1668528285217,COGS 220,A00,101428,Hollan; James D.,0,10,25,25
1668528285642,COGS 229,A00,101429,Dow; Steven P,17,0,25,8
1668528286069,COGS 230,A00,101430,Klemmer; Scott R,7,0,17,10
1668528286497,COGS 234,A00,101431,Xia; Haijun,1,0,25,24
1668528286925,COGS 260,A00,101432,Kiyonaga; Anastasia,21,0,25,4
1668528286925,COGS 260,B00,101433,Kirsh; David Joel,15,0,25,10
1668528287348,CSE 202,A00,102371,Impagliazzo; Russell,0,66,0,0
1668528287774,CSE 203B,A01,102373,Cheng; Chung Kuan,0,59,0,0
1668528288200,CSE 208,A00,102374,Micciancio; Daniele,0,5,0,0
1668528288636,CSE 209A,A00,112895,Impagliazzo; Russell,0,12,15,15
1668528289062,CSE 209B,A00,108005,Bellare; Mihir,0,7,0,0
1668528289490,CSE 210,A00,113163,Coblenz; Michael J,0,85,0,0
1668528289913,CSE 219,A00,106111,Dow; Steven P,0,6,20,20
1668528290343,CSE 221,A00,102376,Voelker; Geoffrey M.,0,73,0,0
1668528290773,CSE 224,A01,102378,Porter; George M,0,167,0,0
1668528291198,CSE 229A,A00,102379,Savage; Stefan,0,10,0,0
1668528291623,CSE 229C,A00,102380,Munyaka; Imani N. S.,0,10,0,0
1668528292052,CSE 232B,A00,102382,Deutsch; Alin Bernard,0,32,0,0
1668528292483,CSE 234,A01,112904,Kumar; Arun Kumar,0,0,0,0
1668528292912,CSE 237A,A00,102383,Rosing; Tajana Simunic,0,55,0,0
1668528293335,CSE 239A,A00,102384,Deutsch; Alin Bernard,0,14,0,0
1668528293760,CSE 239B,A00,102385,Polikarpova; Nadezhda,0,10,0,0
1668528294182,CSE 240A,A00,102386,Pannuto; Patrick William,0,46,0,0
1668528294608,CSE 240B,A00,102387,Zhao; Jishen,0,47,0,0
1668528295031,CSE 241A,A00,106406,Kang; Mingu,0,9,0,0
1668528295454,CSE 249B,A00,102388,Kahng; Andrew Byun,0,5,8,8
1668528295886,CSE 251B,A01,102392,Cottrell; Garrison W,0,51,0,0
1668528295886,CSE 251B,A02,102393,Cottrell; Garrison W,0,34,0,0
1668528296315,CSE 252B,A00,102394,Ochoa; Benjamin Lawrence,0,59,0,0
1668528296746,CSE 257,A01,102396,Gao; Sicun,0,139,0,0
1668528297180,CSE 272,A00,102397,Li; Tzumao,0,19,0,0
1668528297616,CSE 274,A00,111323,Chern; Albert Ren-Haur,0,15,0,0
1668528298046,CSE 282,A00,102398,Pevzner; Pavel Arkadjevich,0,0,0,0
1668528298479,CSE 284,A00,114175,Gymrek; Melissa Ann,0,22,0,0
1668528298912,CSE 290,A00,102399,Chandraker; Manmohan Krishna,0,11,0,0
1668528298912,CSE 290,B00,102400,Vaccaro; Kristen Marie,0,7,25,25
1668528298912,CSE 290,C00,102414,Pannuto; Patrick William,0,1,25,25
1668528298912,CSE 290,D00,102427,Pevzner; Pavel Arkadjevich,0,0,0,0
1668528298912,CSE 290,E00,102429,Zhao; Jishen,0,4,0,0
1668528298912,CSE 290,F00,102436,Tullsen; Dean Michael,0,5,0,0
1668528298912,CSE 290,G00,102440,Christensen; Henrik I,0,6,20,20
1668528299336,CSE 291,A00,102443,Su; Hao,0,0,0,0
1668528299336,CSE 291,B00,102448,Polikarpova; Nadezhda,0,0,0,0
1668528299336,CSE 291,C00,102453,Vaccaro; Kristen Marie,0,0,0,0
1668528299336,CSE 291,D00,111343,Savage; Stefan,0,0,0,0
1668528299336,CSE 291,E00,116474,Claffy; Kimberly Claire,0,0,0,0
1668528299336,CSE 291,F00,116479,Pasquale; Joseph,0,0,0,0
1668528299780,CSE 293,001,119111,Bafna; Vineet,9999,0,9999,0
1668528299780,CSE 293,002,119118,Bellare; Mihir,9999,0,9999,0
1668528299780,CSE 293,003,119122,Berg-Kirkpatrick; Taylor D,9999,0,9999,0
1668528299780,CSE 293,004,119135,Christensen; Henrik I,9999,0,9999,0
1668528299780,CSE 293,005,119142,Cottrell; Garrison W,9999,0,9999,0
1668528299780,CSE 293,006,119146,Deutsch; Alin Bernard,9999,0,9999,0
1668528299780,CSE 293,007,119159,Esmaeilzadeh; Hadi,9999,0,9999,0
1668528299780,CSE 293,008,119166,Freund; Yoav,9999,0,9999,0
1668528299780,CSE 293,009,119170,Griswold; William G.,9999,0,9999,0
1668528299780,CSE 293,010,119183,Gymrek; Melissa Ann,9999,0,9999,0
1668528299780,CSE 293,011,119190,Heninger; Nadia A,9999,0,9999,0
1668528299780,CSE 293,012,119230,Impagliazzo; Russell,9999,0,9999,0
1668528299780,CSE 293,013,119232,Jhala; Ranjit,9999,0,9999,0
1668528299780,CSE 293,014,119233,Kahng; Andrew Byun,9999,0,9999,0
1668528299780,CSE 293,015,119298,Kane; Daniel Mertz,9999,0,9999,0
1668528299780,CSE 293,016,119299,Kriegman; David J,9999,0,9999,0
1668528299780,CSE 293,017,119300,Kumar; Arun Kumar,9999,0,9999,0
1668528299780,CSE 293,018,119301,Lerner; Sorin,9999,0,9999,0
1668528299780,CSE 293,019,119302,Lovett; Shachar,9999,0,9999,0
1668528299780,CSE 293,020,119303,McAuley; Julian John,9999,0,9999,0
1668528299780,CSE 293,021,119304,Micciancio; Daniele,9999,0,9999,0
1668528299780,CSE 293,022,119367,Orailoglu; Alex,9999,0,9999,0
1668528299780,CSE 293,023,119382,Paturi; Ramamohan,9999,0,9999,0
1668528299780,CSE 293,024,119404,Polikarpova; Nadezhda,9999,0,9999,0
1668528299780,CSE 293,025,119406,Politz; Joseph Gibbs,9999,0,9999,0
1668528299780,CSE 293,026,119411,Porter; George M,9999,0,9999,0
1668528299780,CSE 293,027,119414,Porter; Leonard Emerson,9999,0,9999,0
1668528299780,CSE 293,028,119416,Ramamoorthi; Ravi,9999,0,9999,0
1668528299780,CSE 293,029,119417,Sahoo; Debashis,9999,0,9999,0
1668528299780,CSE 293,030,119420,Saul; Lawrence,9999,0,9999,0
1668528299780,CSE 293,031,119421,Savage; Stefan,9999,0,9999,0
1668528299780,CSE 293,032,119425,Schulze; Jurgen P.,9999,0,9999,0
1668528299780,CSE 293,033,119426,Snoeren; Alex C.,9999,0,9999,0
1668528299780,CSE 293,034,119428,Shang; Jingbo,9999,0,9999,0
1668528299780,CSE 293,035,119430,Stefan; Deian,9999,0,9999,0
1668528299780,CSE 293,036,119431,Su; Hao,9999,0,9999,0
1668528299780,CSE 293,037,119433,Swanson; Steven James,9999,0,9999,0
1668528299780,CSE 293,038,119435,Tullsen; Dean Michael,9999,0,9999,0
1668528299780,CSE 293,039,119483,Voelker; Geoffrey M.,9999,0,9999,0
1668528299780,CSE 293,040,119537,Zhao; Jishen,9999,0,9999,0
1668528299780,CSE 293,041,119538,Zhou; Yuan-Yuan,9999,0,9999,0
1668528299780,CSE 293,042,119539,Gao; Sicun,9999,0,9999,0
1668528299780,CSE 293,043,119540,Weibel; Nadir,9999,0,9999,0
1668528299780,CSE 293,044,119541,Gupta; Rajesh K.,9999,0,9999,0
1668528299780,CSE 293,045,126410,Vaccaro; Kristen Marie,9999,0,9999,0
1668528299780,CSE 293,046,126411,Klemke; Richard,9999,0,9999,0
1668528300202,CSE 294,A00,102459,Voelker; Geoffrey M.,0,2,0,0
1668528300202,CSE 294,B00,111322,Orailoglu; Alex,0,2,0,0
1668528300641,DSE 201,A00,096914,Deutsch; Alin Bernard,30,0,30,0
1668528301079,DSE 210,A00,096915,Dasgupta; Sanjoy,30,0,30,0
1668528301504,DSE 260A,A00,096916,Altintas De Callaf; Ilkay,30,0,30,0
1668528301951,ECE 200,001,103586,Antipa; Nicholas A,9999,0,9999,0
1668528301951,ECE 200,002,103587,Atanasov; Nikolay A.,9999,0,9999,0
1668528301951,ECE 200,003,103588,Bharadia; Dinesh,9999,0,9999,0
1668528301951,ECE 200,004,103589,Cheng; Chung Kuan,9999,0,9999,0
1668528301951,ECE 200,005,103590,Cosman; Pamela C.,9999,0,9999,0
1668528301951,ECE 200,006,103591,Dayeh; Shadi Ahmad,9999,0,9999,0
1668528301951,ECE 200,007,103592,Fainman; Yeshaiahu,9999,0,9999,0
1668528301951,ECE 200,008,103593,Ford; Joseph Earl,9999,0,9999,0
1668528301951,ECE 200,009,103594,Franceschetti; Massimo,9999,0,9999,0
1668528301951,ECE 200,010,103595,Fullerton; Eric E,9999,0,9999,0
1668528301951,ECE 200,011,103596,Galton; Ian A,9999,0,9999,0
1668528301951,ECE 200,012,103597,Gilja; Vikash,9999,0,9999,0
1668528301951,ECE 200,013,103598,Hall; Drew A.,9999,0,9999,0
1668528301951,ECE 200,014,103599,Hsueh; Tzu-Chien,9999,0,9999,0
1668528301951,ECE 200,015,103600,Javidi; Tara,9999,0,9999,0
1668528301951,ECE 200,016,103601,Kahng; Andrew Byun,9999,0,9999,0
1668528301951,ECE 200,017,103602,Kim; Young-Han,9999,0,9999,0
1668528301951,ECE 200,018,103603,Koushanfar; Farinaz,9999,0,9999,0
1668528301951,ECE 200,019,103604,Kuzum; Duygu,9999,0,9999,0
1668528301951,ECE 200,020,103605,Le; Hanh-Phuc,9999,0,9999,0
1668528301951,ECE 200,021,103606,Lin; Bill,9999,0,9999,0
1668528301951,ECE 200,022,103607,Liu; Zhaowei,9998,0,9999,1
1668528301951,ECE 200,023,103608,Lo; Yu-Hwa,9999,0,9999,0
1668528301951,ECE 200,024,103609,Lomakin; Vitaliy,9999,0,9999,0
1668528301951,ECE 200,025,103610,Mercier; Patrick Philip,9999,0,9999,0
1668528301951,ECE 200,026,103611,Meyer; Florian,9999,0,9999,0
1668528301951,ECE 200,027,103612,Milstein; Laurence B.,9999,0,9999,0
1668528301951,ECE 200,028,103613,Mir Arabbaygi; Siavash,9999,0,9999,0
1668528301951,ECE 200,029,103614,Mookherjea; Shayan,9999,0,9999,0
1668528301951,ECE 200,030,103615,Morris; Karcher William,9999,0,9999,0
1668528301951,ECE 200,031,103616,Ng; Tse Nga,9999,0,9999,0
1668528301951,ECE 200,032,103617,Nguyen; Truong Quang,9999,0,9999,0
1668528301951,ECE 200,033,103618,Nomura; Kenji,9999,0,9999,0
1668528301951,ECE 200,034,103619,Orlitsky; Alon,9999,0,9999,0
1668528301951,ECE 200,035,103620,Pal; Piya,9999,0,9999,0
1668528301951,ECE 200,036,103621,Papen; George C.,9999,0,9999,0
1668528301951,ECE 200,037,103622,Radic; Stojan,9999,0,9999,0
1668528301951,ECE 200,038,103623,Rao; Bhaskar D.,9999,0,9999,0
1668528301951,ECE 200,039,103624,Rao; Ramesh R,9999,0,9999,0
1668528301951,ECE 200,040,103625,Rebeiz; Gabriel,9999,0,9999,0
1668528301951,ECE 200,041,103626,Sanford; John R,9999,0,9999,0
1668528301951,ECE 200,042,103627,Siegel; Paul H.,9999,0,9999,0
1668528301951,ECE 200,043,103628,Sievenpiper; Daniel F.,9999,0,9999,0
1668528301951,ECE 200,044,103629,Sworder; David D.,9999,0,9999,0
1668528301951,ECE 200,045,103630,Taur; Yuan,9999,0,9999,0
1668528301951,ECE 200,046,103631,Touri; Behrouz,9999,0,9999,0
1668528301951,ECE 200,047,103632,Trivedi; Mohan M.,9999,0,9999,0
1668528301951,ECE 200,048,103633,Vasconcelos; Nuno,9999,0,9999,0
1668528301951,ECE 200,049,103634,Wang; Xiaolong,9999,0,9999,0
1668528301951,ECE 200,050,103635,Xie; Pengtao,9999,0,9999,0
1668528301951,ECE 200,051,103636,Yip; Michael,9999,0,9999,0
1668528301951,ECE 200,052,103637,Zeger; Kenneth A.,999,0,999,0
1668528301951,ECE 200,053,103638,Zhang; Xinyu,9999,0,9999,0
1668528301951,ECE 200,054,103639,Turakhia; Yatish Girish,9999,0,9999,0
1668528301951,ECE 200,055,103640,Kang; Mingu,9999,0,9999,0
1668528301951,ECE 200,056,103641,Shi; Yuanyuan,9999,0,9999,0
1668528301951,ECE 200,057,103642,Wang; Edward Jay,9999,0,9999,0
1668528301951,ECE 200,058,103643,Zheng; Yang,9999,0,9999,0
1668528302383,ECE 202,A00,103644,Kuzum; Duygu,0,44,0,0
1668528302805,ECE 212BN,A00,103646,Ng; Tse Nga,0,9,0,0
1668528303238,ECE 221,A00,111493,Staff,0,0,0,0
1668528303672,ECE 222B,A00,103647,Lomakin; Vitaliy,0,20,0,0
1668528304094,ECE 230B,A00,103648,Taur; Yuan,0,3,0,0
1668528304518,ECE 238B,A00,103649,Garay; Javier,0,0,0,0
1668528304942,ECE 240B,A00,112900,Fainman; Yeshaiahu,0,7,0,0
1668528305397,ECE 247A,A00,103650,Jokerst; Jesse Vincent,0,6,0,0
1668528305835,ECE 247B,A00,103651,Wang; Joseph,0,14,0,0
1668528306262,ECE 250,A00,103652,Siegel; Paul H.,0,82,0,0
1668528306688,ECE 251A,A00,103654,Rao; Bhaskar D.,0,62,0,0
1668528307116,ECE 257B,A00,103655,Bharadia; Dinesh,0,33,0,0
1668528307546,ECE 258A,A00,103656,Milstein; Laurence B.,0,29,0,0
1668528307972,ECE 260B,A00,103658,Kang; Mingu,0,119,0,0
1668528308408,ECE 264A,A00,103659,Galton; Ian A,0,66,0,0
1668528308837,ECE 265A,A00,103661,Gudem; Prasad S.S.,0,70,0,0
1668528309261,ECE 265D,A00,103662,Gudem; Prasad S.S.,0,26,0,0
1668528309684,ECE 268,A00,103663,Koushanfar; Farinaz,0,43,0,0
1668528310110,ECE 269,A01,103665,Pal; Piya,0,216,0,0
1668528310611,ECE 271B,A00,103666,Vasconcelos; Manuela,0,76,0,0
1668528311051,ECE 276A,A00,103667,Atanasov; Nikolay A.,0,127,0,0
1668528311478,ECE 277,A00,103668,An; Cheolhong,0,149,0,0
1668528311911,ECE 279,A00,117947,Hall; Drew A.,0,22,0,0
1668528312766,ECE 283,A00,103670,Hsueh; Tzu-Chien,0,54,0,0
1668528313200,ECE 284,A00,103671,Turakhia; Yatish Girish,0,39,0,0
1668528313630,ECE 285,A00,103672,Zheng; Yang,0,40,0,0
1668528313630,ECE 285,B00,103673,Sworder; David D.,0,57,0,0
1668528314071,ECE 287,A00,103676,Javidi; Tara,0,9,0,0
1668528314499,MATH 200B,A00,098023,Salehi Golsefidy; Alireza,10,0,15,5
1668528314932,MATH 202B,A00,098024,Rhoades; Brendon Patrick,7,0,15,8
1668528315357,MATH 203B,A00,098025,Oprea; Dragos N.,9,0,15,6
1668528315791,MATH 204B,A00,098026,Sorensen; Claus M,13,0,15,2
1668528316219,MATH 208,A00,098027,Izadi; Elham,7,0,10,3
1668528316647,MATH 209,A00,098028,Pollack; Aaron,10,0,10,0
1668528317075,MATH 211A,A00,112919,Rogalski; Daniel,8,0,10,2
1668528317498,MATH 211B,A00,112920,Seward; Brandon M.,9,0,10,1
1668528317939,MATH 218,A00,098029,Li; Bo,10,0,10,0
1668528318371,MATH 220B,A00,098030,Novak; Jonathan I,11,0,15,4
1668528318798,MATH 221A,A00,098031,Ebenfelt; Peter F,12,0,15,3
1668528319223,MATH 231B,A00,098032,Zlatos; Andrej,11,0,15,4
1668528319649,MATH 240B,A00,098033,Ni; Lei,7,0,15,8
1668528320071,MATH 243,A00,098034,Jekel; David Andrew,10,0,10,0
1668528320497,MATH 245A,A00,098035,Nie; Jiawang,0,5,15,18
1668528320919,MATH 248,A00,098036,Bejenaru; Ioan,10,0,10,0
1668528321343,MATH 250B,A00,098037,Spolaor; Luca,14,0,15,1
1668528321767,MATH 258,A00,098038,Ni; Lei,9,0,10,1
1668528322191,MATH 264B,A00,098041,Rhoades; Brendon Patrick,8,0,15,7
1668528322617,MATH 268,A00,098042,Buss; Samuel R,10,0,10,0
1668528323041,MATH 269,A00,098043,Rhoades; Brendon Patrick,10,0,10,0
1668528323480,MATH 270B,A00,098044,Li; Bo,6,0,15,9
1668528323905,MATH 272B,A00,098045,Holst; Michael J,13,0,15,2
1668528324331,MATH 273A,A00,098046,Tian; Xiaochuan,10,0,15,5
1668528324761,MATH 275,A01,098048,Tian; Xiaochuan,6,0,10,4
1668528325186,MATH 278A,A00,098049,Holst; Michael J,7,0,10,3
1668528325619,MATH 278B,A00,098050,Cloninger; Alexander,10,0,10,0
1668528326064,MATH 278C,A00,098051,Nie; Jiawang,5,0,10,5
1668528326492,MATH 280B,A00,098052,Zheng; Tianyi,7,0,15,8
1668528326916,MATH 281B,A00,098053,Bradic; Jelena,0,2,15,15
1668528327345,MATH 282B,A00,098054,Arias-Castro; Ery,0,1,15,15
1668528327781,MATH 285,A00,098055,Fitzsimmons; Patrick J,0,3,15,17
1668528328206,MATH 287B,A00,098056,Arias-Castro; Ery,1,0,15,14
1668528328642,MATH 288,A00,098057,Agarwal; Pooja,9,0,10,1
1668528328642,MATH 288,B00,098058,Zhang; Danna,8,0,10,2
1668528328642,MATH 288,C00,098059,Williams; Ruth J,9,0,10,1
1668528329065,MATH 290B,A00,098060,Roberts; Justin Deritter,12,0,15,3
1668528329488,MATH 292,A00,098061,Belmont; Eva Kinoshita,10,0,10,0
1668528329923,MATH 295,A00,098062,Suk; Andrew Hoon,47,0,50,3
1668528330363,MATH 296,A00,098063,Novak; Jonathan I,20,0,20,0
1668528330797,MATH 297,001,098064,Gamst; Anthony Collins,9997,0,9999,2
1668528845712,COGS 205,A00,101395,Chiba; Andrea,19,0,20,1
1668528846139,COGS 210B,001,101404,Greene; Deanna Jacquelyn,9998,0,9999,1
1668528846139,COGS 210B,002,101417,Xia; Haijun,9999,0,9999,0
1668528846139,COGS 210B,003,101422,Nitz; Douglas A.,9999,0,9999,0
1668528846139,COGS 210B,004,101423,Hollan; James D.,9998,0,9999,1
1668528846139,COGS 210B,005,101424,Deak; Gedeon O.,9998,0,9999,1
1668528846139,COGS 210B,006,101425,Rossano; Federico,9999,0,9999,0
1668528846567,COGS 211B,A00,101427,Coulson; Seana M,9996,0,9999,3
1668528846998,COGS 220,A00,101428,Hollan; James D.,0,10,25,25
1668528847433,COGS 229,A00,101429,Dow; Steven P,17,0,25,8
1668528847865,COGS 230,A00,101430,Klemmer; Scott R,7,0,17,10
1668528848294,COGS 234,A00,101431,Xia; Haijun,1,0,25,24
1668528848724,COGS 260,A00,101432,Kiyonaga; Anastasia,21,0,25,4
1668528848724,COGS 260,B00,101433,Kirsh; David Joel,15,0,25,10
1668528849161,CSE 202,A00,102371,Impagliazzo; Russell,0,66,0,0
1668528849589,CSE 203B,A01,102373,Cheng; Chung Kuan,0,59,0,0
1668528850021,CSE 208,A00,102374,Micciancio; Daniele,0,5,0,0
1668528850442,CSE 209A,A00,112895,Impagliazzo; Russell,0,12,15,15
1668528850875,CSE 209B,A00,108005,Bellare; Mihir,0,7,0,0
1668528851301,CSE 210,A00,113163,Coblenz; Michael J,0,85,0,0
1668528851736,CSE 219,A00,106111,Dow; Steven P,0,6,20,20
1668528852171,CSE 221,A00,102376,Voelker; Geoffrey M.,0,73,0,0
1668528852607,CSE 224,A01,102378,Porter; George M,0,167,0,0
1668528853032,CSE 229A,A00,102379,Savage; Stefan,0,10,0,0
1668528853457,CSE 229C,A00,102380,Munyaka; Imani N. S.,0,10,0,0
1668528853882,CSE 232B,A00,102382,Deutsch; Alin Bernard,0,32,0,0
1668528854312,CSE 234,A01,112904,Kumar; Arun Kumar,0,0,0,0
1668528854748,CSE 237A,A00,102383,Rosing; Tajana Simunic,0,55,0,0
1668528855171,CSE 239A,A00,102384,Deutsch; Alin Bernard,0,14,0,0
1668528855598,CSE 239B,A00,102385,Polikarpova; Nadezhda,0,10,0,0
1668528856020,CSE 240A,A00,102386,Pannuto; Patrick William,0,46,0,0
1668528856443,CSE 240B,A00,102387,Zhao; Jishen,0,47,0,0
1668528856870,CSE 241A,A00,106406,Kang; Mingu,0,9,0,0
1668528857297,CSE 249B,A00,102388,Kahng; Andrew Byun,0,5,8,8
1668528857750,CSE 251B,A01,102392,Cottrell; Garrison W,0,51,0,0
1668528857750,CSE 251B,A02,102393,Cottrell; Garrison W,0,34,0,0
1668528858178,CSE 252B,A00,102394,Ochoa; Benjamin Lawrence,0,59,0,0
1668528858600,CSE 257,A01,102396,Gao; Sicun,0,139,0,0
1668528859023,CSE 272,A00,102397,Li; Tzumao,0,19,0,0
1668528859445,CSE 274,A00,111323,Chern; Albert Ren-Haur,0,15,0,0
1668528859870,CSE 282,A00,102398,Pevzner; Pavel Arkadjevich,0,0,0,0
1668528860310,CSE 284,A00,114175,Gymrek; Melissa Ann,0,22,0,0
1668528860732,CSE 290,A00,102399,Chandraker; Manmohan Krishna,0,11,0,0
1668528860732,CSE 290,B00,102400,Vaccaro; Kristen Marie,0,7,25,25
1668528860732,CSE 290,C00,102414,Pannuto; Patrick William,0,1,25,25
1668528860732,CSE 290,D00,102427,Pevzner; Pavel Arkadjevich,0,0,0,0
1668528860732,CSE 290,E00,102429,Zhao; Jishen,0,4,0,0
1668528860732,CSE 290,F00,102436,Tullsen; Dean Michael,0,5,0,0
1668528860732,CSE 290,G00,102440,Christensen; Henrik I,0,6,20,20
1668528861155,CSE 291,A00,102443,Su; Hao,0,0,0,0
1668528861155,CSE 291,B00,102448,Polikarpova; Nadezhda,0,0,0,0
1668528861155,CSE 291,C00,102453,Vaccaro; Kristen Marie,0,0,0,0
1668528861155,CSE 291,D00,111343,Savage; Stefan,0,0,0,0
1668528861155,CSE 291,E00,116474,Claffy; Kimberly Claire,0,0,0,0
1668528861155,CSE 291,F00,116479,Pasquale; Joseph,0,0,0,0
1668528861581,CSE 293,001,119111,Bafna; Vineet,9999,0,9999,0
1668528861581,CSE 293,002,119118,Bellare; Mihir,9999,0,9999,0
1668528861581,CSE 293,003,119122,Berg-Kirkpatrick; Taylor D,9999,0,9999,0
1668528861581,CSE 293,004,119135,Christensen; Henrik I,9999,0,9999,0
1668528861581,CSE 293,005,119142,Cottrell; Garrison W,9999,0,9999,0
1668528861581,CSE 293,006,119146,Deutsch; Alin Bernard,9999,0,9999,0
1668528861581,CSE 293,007,119159,Esmaeilzadeh; Hadi,9999,0,9999,0
1668528861581,CSE 293,008,119166,Freund; Yoav,9999,0,9999,0
1668528861581,CSE 293,009,119170,Griswold; William G.,9999,0,9999,0
1668528861581,CSE 293,010,119183,Gymrek; Melissa Ann,9999,0,9999,0
1668528861581,CSE 293,011,119190,Heninger; Nadia A,9999,0,9999,0
1668528861581,CSE 293,012,119230,Impagliazzo; Russell,9999,0,9999,0
1668528861581,CSE 293,013,119232,Jhala; Ranjit,9999,0,9999,0
1668528861581,CSE 293,014,119233,Kahng; Andrew Byun,9999,0,9999,0
1668528861581,CSE 293,015,119298,Kane; Daniel Mertz,9999,0,9999,0
1668528861581,CSE 293,016,119299,Kriegman; David J,9999,0,9999,0
1668528861581,CSE 293,017,119300,Kumar; Arun Kumar,9999,0,9999,0
1668528861581,CSE 293,018,119301,Lerner; Sorin,9999,0,9999,0
1668528861581,CSE 293,019,119302,Lovett; Shachar,9999,0,9999,0
1668528861581,CSE 293,020,119303,McAuley; Julian John,9999,0,9999,0
1668528861581,CSE 293,021,119304,Micciancio; Daniele,9999,0,9999,0
1668528861581,CSE 293,022,119367,Orailoglu; Alex,9999,0,9999,0
1668528861581,CSE 293,023,119382,Paturi; Ramamohan,9999,0,9999,0
1668528861581,CSE 293,024,119404,Polikarpova; Nadezhda,9999,0,9999,0
1668528861581,CSE 293,025,119406,Politz; Joseph Gibbs,9999,0,9999,0
1668528861581,CSE 293,026,119411,Porter; George M,9999,0,9999,0
1668528861581,CSE 293,027,119414,Porter; Leonard Emerson,9999,0,9999,0
1668528861581,CSE 293,028,119416,Ramamoorthi; Ravi,9999,0,9999,0
1668528861581,CSE 293,029,119417,Sahoo; Debashis,9999,0,9999,0
1668528861581,CSE 293,030,119420,Saul; Lawrence,9999,0,9999,0
1668528861581,CSE 293,031,119421,Savage; Stefan,9999,0,9999,0
1668528861581,CSE 293,032,119425,Schulze; Jurgen P.,9999,0,9999,0
1668528861581,CSE 293,033,119426,Snoeren; Alex C.,9999,0,9999,0
1668528861581,CSE 293,034,119428,Shang; Jingbo,9999,0,9999,0
1668528861581,CSE 293,035,119430,Stefan; Deian,9999,0,9999,0
1668528861581,CSE 293,036,119431,Su; Hao,9999,0,9999,0
1668528861581,CSE 293,037,119433,Swanson; Steven James,9999,0,9999,0
1668528861581,CSE 293,038,119435,Tullsen; Dean Michael,9999,0,9999,0
1668528861581,CSE 293,039,119483,Voelker; Geoffrey M.,9999,0,9999,0
1668528861581,CSE 293,040,119537,Zhao; Jishen,9999,0,9999,0
1668528861581,CSE 293,041,119538,Zhou; Yuan-Yuan,9999,0,9999,0
1668528861581,CSE 293,042,119539,Gao; Sicun,9999,0,9999,0
1668528861581,CSE 293,043,119540,Weibel; Nadir,9999,0,9999,0
1668528861581,CSE 293,044,119541,Gupta; Rajesh K.,9999,0,9999,0
1668528861581,CSE 293,045,126410,Vaccaro; Kristen Marie,9999,0,9999,0
1668528861581,CSE 293,046,126411,Klemke; Richard,9999,0,9999,0
1668528862006,CSE 294,A00,102459,Voelker; Geoffrey M.,0,2,0,0
1668528862006,CSE 294,B00,111322,Orailoglu; Alex,0,2,0,0
1668528862430,DSE 201,A00,096914,Deutsch; Alin Bernard,30,0,30,0
1668528862867,DSE 210,A00,096915,Dasgupta; Sanjoy,30,0,30,0
1668528863292,DSE 260A,A00,096916,Altintas De Callaf; Ilkay,30,0,30,0
1668528863721,ECE 200,001,103586,Antipa; Nicholas A,9999,0,9999,0
1668528863721,ECE 200,002,103587,Atanasov; Nikolay A.,9999,0,9999,0
1668528863721,ECE 200,003,103588,Bharadia; Dinesh,9999,0,9999,0
1668528863721,ECE 200,004,103589,Cheng; Chung Kuan,9999,0,9999,0
1668528863721,ECE 200,005,103590,Cosman; Pamela C.,9999,0,9999,0
1668528863721,ECE 200,006,103591,Dayeh; Shadi Ahmad,9999,0,9999,0
1668528863721,ECE 200,007,103592,Fainman; Yeshaiahu,9999,0,9999,0
1668528863721,ECE 200,008,103593,Ford; Joseph Earl,9999,0,9999,0
1668528863721,ECE 200,009,103594,Franceschetti; Massimo,9999,0,9999,0
1668528863721,ECE 200,010,103595,Fullerton; Eric E,9999,0,9999,0
1668528863721,ECE 200,011,103596,Galton; Ian A,9999,0,9999,0
1668528863721,ECE 200,012,103597,Gilja; Vikash,9999,0,9999,0
1668528863721,ECE 200,013,103598,Hall; Drew A.,9999,0,9999,0
1668528863721,ECE 200,014,103599,Hsueh; Tzu-Chien,9999,0,9999,0
1668528863721,ECE 200,015,103600,Javidi; Tara,9999,0,9999,0
1668528863721,ECE 200,016,103601,Kahng; Andrew Byun,9999,0,9999,0
1668528863721,ECE 200,017,103602,Kim; Young-Han,9999,0,9999,0
1668528863721,ECE 200,018,103603,Koushanfar; Farinaz,9999,0,9999,0
1668528863721,ECE 200,019,103604,Kuzum; Duygu,9999,0,9999,0
1668528863721,ECE 200,020,103605,Le; Hanh-Phuc,9999,0,9999,0
1668528863721,ECE 200,021,103606,Lin; Bill,9999,0,9999,0
1668528863721,ECE 200,022,103607,Liu; Zhaowei,9998,0,9999,1
1668528863721,ECE 200,023,103608,Lo; Yu-Hwa,9999,0,9999,0
1668528863721,ECE 200,024,103609,Lomakin; Vitaliy,9999,0,9999,0
1668528863721,ECE 200,025,103610,Mercier; Patrick Philip,9999,0,9999,0
1668528863721,ECE 200,026,103611,Meyer; Florian,9999,0,9999,0
1668528863721,ECE 200,027,103612,Milstein; Laurence B.,9999,0,9999,0
1668528863721,ECE 200,028,103613,Mir Arabbaygi; Siavash,9999,0,9999,0
1668528863721,ECE 200,029,103614,Mookherjea; Shayan,9999,0,9999,0
1668528863721,ECE 200,030,103615,Morris; Karcher William,9999,0,9999,0
1668528863721,ECE 200,031,103616,Ng; Tse Nga,9999,0,9999,0
1668528863721,ECE 200,032,103617,Nguyen; Truong Quang,9999,0,9999,0
1668528863721,ECE 200,033,103618,Nomura; Kenji,9999,0,9999,0
1668528863721,ECE 200,034,103619,Orlitsky; Alon,9999,0,9999,0
1668528863721,ECE 200,035,103620,Pal; Piya,9999,0,9999,0
1668528863721,ECE 200,036,103621,Papen; George C.,9999,0,9999,0
1668528863721,ECE 200,037,103622,Radic; Stojan,9999,0,9999,0
1668528863721,ECE 200,038,103623,Rao; Bhaskar D.,9999,0,9999,0
1668528863721,ECE 200,039,103624,Rao; Ramesh R,9999,0,9999,0
1668528863721,ECE 200,040,103625,Rebeiz; Gabriel,9999,0,9999,0
1668528863721,ECE 200,041,103626,Sanford; John R,9999,0,9999,0
1668528863721,ECE 200,042,103627,Siegel; Paul H.,9999,0,9999,0
1668528863721,ECE 200,043,103628,Sievenpiper; Daniel F.,9999,0,9999,0
1668528863721,ECE 200,044,103629,Sworder; David D.,9999,0,9999,0
1668528863721,ECE 200,045,103630,Taur; Yuan,9999,0,9999,0
1668528863721,ECE 200,046,103631,Touri; Behrouz,9999,0,9999,0
1668528863721,ECE 200,047,103632,Trivedi; Mohan M.,9999,0,9999,0
1668528863721,ECE 200,048,103633,Vasconcelos; Nuno,9999,0,9999,0
1668528863721,ECE 200,049,103634,Wang; Xiaolong,9999,0,9999,0
1668528863721,ECE 200,050,103635,Xie; Pengtao,9999,0,9999,0
1668528863721,ECE 200,051,103636,Yip; Michael,9999,0,9999,0
1668528863721,ECE 200,052,103637,Zeger; Kenneth A.,999,0,999,0
1668528863721,ECE 200,053,103638,Zhang; Xinyu,9999,0,9999,0
1668528863721,ECE 200,054,103639,Turakhia; Yatish Girish,9999,0,9999,0
1668528863721,ECE 200,055,103640,Kang; Mingu,9999,0,9999,0
1668528863721,ECE 200,056,103641,Shi; Yuanyuan,9999,0,9999,0
1668528863721,ECE 200,057,103642,Wang; Edward Jay,9999,0,9999,0
1668528863721,ECE 200,058,103643,Zheng; Yang,9999,0,9999,0
1668528864160,ECE 202,A00,103644,Kuzum; Duygu,0,44,0,0
1668528864585,ECE 212BN,A00,103646,Ng; Tse Nga,0,9,0,0
1668528865007,ECE 221,A00,111493,Staff,0,0,0,0
1668528865431,ECE 222B,A00,103647,Lomakin; Vitaliy,0,20,0,0
1668528865868,ECE 230B,A00,103648,Taur; Yuan,0,3,0,0
1668528866289,ECE 238B,A00,103649,Garay; Javier,0,0,0,0
1668528866798,ECE 240B,A00,112900,Fainman; Yeshaiahu,0,7,0,0
1668528867237,ECE 247A,A00,103650,Jokerst; Jesse Vincent,0,6,0,0
1668528867674,ECE 247B,A00,103651,Wang; Joseph,0,14,0,0
1668528868098,ECE 250,A00,103652,Siegel; Paul H.,0,82,0,0
1668528868521,ECE 251A,A00,103654,Rao; Bhaskar D.,0,62,0,0
1668528868948,ECE 257B,A00,103655,Bharadia; Dinesh,0,33,0,0
1668528869374,ECE 258A,A00,103656,Milstein; Laurence B.,0,29,0,0
1668528869802,ECE 260B,A00,103658,Kang; Mingu,0,119,0,0
1668528870225,ECE 264A,A00,103659,Galton; Ian A,0,66,0,0
1668528870652,ECE 265A,A00,103661,Gudem; Prasad S.S.,0,70,0,0
1668528871084,ECE 265D,A00,103662,Gudem; Prasad S.S.,0,26,0,0
1668528871506,ECE 268,A00,103663,Koushanfar; Farinaz,0,43,0,0
1668528871942,ECE 269,A01,103665,Pal; Piya,0,216,0,0
1668528872381,ECE 271B,A00,103666,Vasconcelos; Manuela,0,76,0,0
1668528872805,ECE 276A,A00,103667,Atanasov; Nikolay A.,0,127,0,0
1668528873239,ECE 277,A00,103668,An; Cheolhong,0,149,0,0
1668528873661,ECE 279,A00,117947,Hall; Drew A.,0,22,0,0
1668528874524,ECE 283,A00,103670,Hsueh; Tzu-Chien,0,54,0,0
1668528874952,ECE 284,A00,103671,Turakhia; Yatish Girish,0,39,0,0
1668528875379,ECE 285,A00,103672,Zheng; Yang,0,40,0,0
1668528875379,ECE 285,B00,103673,Sworder; David D.,0,57,0,0
1668528875802,ECE 287,A00,103676,Javidi; Tara,0,9,0,0
1668528876244,MATH 200B,A00,098023,Salehi Golsefidy; Alireza,10,0,15,5
1668528876666,MATH 202B,A00,098024,Rhoades; Brendon Patrick,7,0,15,8
1668528877092,MATH 203B,A00,098025,Oprea; Dragos N.,9,0,15,6
1668528877515,MATH 204B,A00,098026,Sorensen; Claus M,13,0,15,2
1668528877939,MATH 208,A00,098027,Izadi; Elham,7,0,10,3
1668528878362,MATH 209,A00,098028,Pollack; Aaron,10,0,10,0
1668528878803,MATH 211A,A00,112919,Rogalski; Daniel,8,0,10,2
1668528879231,MATH 211B,A00,112920,Seward; Brandon M.,9,0,10,1
1668528879655,MATH 218,A00,098029,Li; Bo,10,0,10,0
1668528880084,MATH 220B,A00,098030,Novak; Jonathan I,11,0,15,4
1668528880508,MATH 221A,A00,098031,Ebenfelt; Peter F,12,0,15,3
1668528881014,MATH 231B,A00,098032,Zlatos; Andrej,11,0,15,4
1668528881436,MATH 240B,A00,098033,Ni; Lei,7,0,15,8
1668528881860,MATH 243,A00,098034,Jekel; David Andrew,10,0,10,0
1668528882288,MATH 245A,A00,098035,Nie; Jiawang,0,5,15,18
1668528882710,MATH 248,A00,098036,Bejenaru; Ioan,10,0,10,0
1668528883141,MATH 250B,A00,098037,Spolaor; Luca,14,0,15,1
1668528883576,MATH 258,A00,098038,Ni; Lei,9,0,10,1
1668528884004,MATH 264B,A00,098041,Rhoades; Brendon Patrick,8,0,15,7
1668528884428,MATH 268,A00,098042,Buss; Samuel R,10,0,10,0
1668528884852,MATH 269,A00,098043,Rhoades; Brendon Patrick,10,0,10,0
1668528885286,MATH 270B,A00,098044,Li; Bo,6,0,15,9
1668528885710,MATH 272B,A00,098045,Holst; Michael J,13,0,15,2
1668528886139,MATH 273A,A00,098046,Tian; Xiaochuan,10,0,15,5
1668528886574,MATH 275,A01,098048,Tian; Xiaochuan,6,0,10,4
1668528886997,MATH 278A,A00,098049,Holst; Michael J,7,0,10,3
1668528887420,MATH 278B,A00,098050,Cloninger; Alexander,10,0,10,0
1668528887947,MATH 278C,A00,098051,Nie; Jiawang,5,0,10,5
1668528888379,MATH 280B,A00,098052,Zheng; Tianyi,7,0,15,8
1668528888803,MATH 281B,A00,098053,Bradic; Jelena,0,2,15,15
1668528889228,MATH 282B,A00,098054,Arias-Castro; Ery,0,1,15,15
1668528889659,MATH 285,A00,098055,Fitzsimmons; Patrick J,0,3,15,17
1668528890082,MATH 287B,A00,098056,Arias-Castro; Ery,1,0,15,14
1668528890504,MATH 288,A00,098057,Agarwal; Pooja,9,0,10,1
1668528890504,MATH 288,B00,098058,Zhang; Danna,8,0,10,2
1668528890504,MATH 288,C00,098059,Williams; Ruth J,9,0,10,1
1668528890929,MATH 290B,A00,098060,Roberts; Justin Deritter,12,0,15,3
1668528891351,MATH 292,A00,098061,Belmont; Eva Kinoshita,10,0,10,0
1668528891776,MATH 295,A00,098062,Suk; Andrew Hoon,47,0,50,3
1668528892208,MATH 296,A00,098063,Novak; Jonathan I,20,0,20,0
1668528892631,MATH 297,001,098064,Gamst; Anthony Collins,9997,0,9999,2
1668529396766,COGS 205,A00,101395,Chiba; Andrea,19,0,20,1
1668529397190,COGS 210B,001,101404,Greene; Deanna Jacquelyn,9998,0,9999,1
1668529397190,COGS 210B,002,101417,Xia; Haijun,9999,0,9999,0
1668529397190,COGS 210B,003,101422,Nitz; Douglas A.,9999,0,9999,0
1668529397190,COGS 210B,004,101423,Hollan; James D.,9998,0,9999,1
1668529397190,COGS 210B,005,101424,Deak; Gedeon O.,9998,0,9999,1
1668529397190,COGS 210B,006,101425,Rossano; Federico,9999,0,9999,0
1668529397625,COGS 211B,A00,101427,Coulson; Seana M,9996,0,9999,3
1668529398057,COGS 220,A00,101428,Hollan; James D.,0,10,25,25
1668529398480,COGS 229,A00,101429,Dow; Steven P,17,0,25,8
1668529398910,COGS 230,A00,101430,Klemmer; Scott R,7,0,17,10
1668529399349,COGS 234,A00,101431,Xia; Haijun,1,0,25,24
1668529399787,COGS 260,A00,101432,Kiyonaga; Anastasia,21,0,25,4
1668529399787,COGS 260,B00,101433,Kirsh; David Joel,15,0,25,10
1668529400225,CSE 202,A00,102371,Impagliazzo; Russell,0,66,0,0
1668529400656,CSE 203B,A01,102373,Cheng; Chung Kuan,0,59,0,0
1668529401082,CSE 208,A00,102374,Micciancio; Daniele,0,5,0,0
1668529401510,CSE 209A,A00,112895,Impagliazzo; Russell,0,12,15,15
1668529401935,CSE 209B,A00,108005,Bellare; Mihir,0,7,0,0
1668529402359,CSE 210,A00,113163,Coblenz; Michael J,0,85,0,0
1668529402799,CSE 219,A00,106111,Dow; Steven P,0,6,20,20
1668529403225,CSE 221,A00,102376,Voelker; Geoffrey M.,0,73,0,0
1668529403651,CSE 224,A01,102378,Porter; George M,0,167,0,0
1668529404089,CSE 229A,A00,102379,Savage; Stefan,0,10,0,0
1668529404539,CSE 229C,A00,102380,Munyaka; Imani N. S.,0,10,0,0
1668529404962,CSE 232B,A00,102382,Deutsch; Alin Bernard,0,33,0,0
1668529405389,CSE 234,A01,112904,Kumar; Arun Kumar,0,0,0,0
1668529405816,CSE 237A,A00,102383,Rosing; Tajana Simunic,0,55,0,0
1668529406250,CSE 239A,A00,102384,Deutsch; Alin Bernard,0,14,0,0
1668529406675,CSE 239B,A00,102385,Polikarpova; Nadezhda,0,10,0,0
1668529407109,CSE 240A,A00,102386,Pannuto; Patrick William,0,46,0,0
1668529407549,CSE 240B,A00,102387,Zhao; Jishen,0,47,0,0
1668529407979,CSE 241A,A00,106406,Kang; Mingu,0,9,0,0
1668529408417,CSE 249B,A00,102388,Kahng; Andrew Byun,0,5,8,8
1668529408853,CSE 251B,A01,102392,Cottrell; Garrison W,0,51,0,0
1668529408853,CSE 251B,A02,102393,Cottrell; Garrison W,0,34,0,0
1668529409283,CSE 252B,A00,102394,Ochoa; Benjamin Lawrence,0,59,0,0
1668529409714,CSE 257,A01,102396,Gao; Sicun,0,139,0,0
1668529410150,CSE 272,A00,102397,Li; Tzumao,0,19,0,0
1668529410590,CSE 274,A00,111323,Chern; Albert Ren-Haur,0,15,0,0
1668529411091,CSE 282,A00,102398,Pevzner; Pavel Arkadjevich,0,0,0,0
1668529411519,CSE 284,A00,114175,Gymrek; Melissa Ann,0,22,0,0
1668529411950,CSE 290,A00,102399,Chandraker; Manmohan Krishna,0,11,0,0
1668529411950,CSE 290,B00,102400,Vaccaro; Kristen Marie,0,7,25,25
1668529411950,CSE 290,C00,102414,Pannuto; Patrick William,0,1,25,25
1668529411950,CSE 290,D00,102427,Pevzner; Pavel Arkadjevich,0,0,0,0
1668529411950,CSE 290,E00,102429,Zhao; Jishen,0,4,0,0
1668529411950,CSE 290,F00,102436,Tullsen; Dean Michael,0,5,0,0
1668529411950,CSE 290,G00,102440,Christensen; Henrik I,0,6,20,20
1668529412377,CSE 291,A00,102443,Su; Hao,0,0,0,0
1668529412377,CSE 291,B00,102448,Polikarpova; Nadezhda,0,0,0,0
1668529412377,CSE 291,C00,102453,Vaccaro; Kristen Marie,0,0,0,0
1668529412377,CSE 291,D00,111343,Savage; Stefan,0,0,0,0
1668529412377,CSE 291,E00,116474,Claffy; Kimberly Claire,0,0,0,0
1668529412377,CSE 291,F00,116479,Pasquale; Joseph,0,0,0,0
1668529412849,CSE 293,001,119111,Bafna; Vineet,9999,0,9999,0
1668529412849,CSE 293,002,119118,Bellare; Mihir,9999,0,9999,0
1668529412849,CSE 293,003,119122,Berg-Kirkpatrick; Taylor D,9999,0,9999,0
1668529412849,CSE 293,004,119135,Christensen; Henrik I,9999,0,9999,0
1668529412849,CSE 293,005,119142,Cottrell; Garrison W,9999,0,9999,0
1668529412849,CSE 293,006,119146,Deutsch; Alin Bernard,9999,0,9999,0
1668529412849,CSE 293,007,119159,Esmaeilzadeh; Hadi,9999,0,9999,0
1668529412849,CSE 293,008,119166,Freund; Yoav,9999,0,9999,0
1668529412849,CSE 293,009,119170,Griswold; William G.,9999,0,9999,0
1668529412849,CSE 293,010,119183,Gymrek; Melissa Ann,9999,0,9999,0
1668529412849,CSE 293,011,119190,Heninger; Nadia A,9999,0,9999,0
1668529412849,CSE 293,012,119230,Impagliazzo; Russell,9999,0,9999,0
1668529412849,CSE 293,013,119232,Jhala; Ranjit,9999,0,9999,0
1668529412849,CSE 293,014,119233,Kahng; Andrew Byun,9999,0,9999,0
1668529412849,CSE 293,015,119298,Kane; Daniel Mertz,9999,0,9999,0
1668529412849,CSE 293,016,119299,Kriegman; David J,9999,0,9999,0
1668529412849,CSE 293,017,119300,Kumar; Arun Kumar,9999,0,9999,0
1668529412849,CSE 293,018,119301,Lerner; Sorin,9999,0,9999,0
1668529412849,CSE 293,019,119302,Lovett; Shachar,9999,0,9999,0
1668529412849,CSE 293,020,119303,McAuley; Julian John,9999,0,9999,0
1668529412849,CSE 293,021,119304,Micciancio; Daniele,9999,0,9999,0
1668529412849,CSE 293,022,119367,Orailoglu; Alex,9999,0,9999,0
1668529412849,CSE 293,023,119382,Paturi; Ramamohan,9999,0,9999,0
1668529412849,CSE 293,024,119404,Polikarpova; Nadezhda,9999,0,9999,0
1668529412849,CSE 293,025,119406,Politz; Joseph Gibbs,9999,0,9999,0
1668529412849,CSE 293,026,119411,Porter; George M,9999,0,9999,0
1668529412849,CSE 293,027,119414,Porter; Leonard Emerson,9999,0,9999,0
1668529412849,CSE 293,028,119416,Ramamoorthi; Ravi,9999,0,9999,0
1668529412849,CSE 293,029,119417,Sahoo; Debashis,9999,0,9999,0
1668529412849,CSE 293,030,119420,Saul; Lawrence,9999,0,9999,0
1668529412849,CSE 293,031,119421,Savage; Stefan,9999,0,9999,0
1668529412849,CSE 293,032,119425,Schulze; Jurgen P.,9999,0,9999,0
1668529412849,CSE 293,033,119426,Snoeren; Alex C.,9999,0,9999,0
1668529412849,CSE 293,034,119428,Shang; Jingbo,9999,0,9999,0
1668529412849,CSE 293,035,119430,Stefan; Deian,9999,0,9999,0
1668529412849,CSE 293,036,119431,Su; Hao,9999,0,9999,0
1668529412849,CSE 293,037,119433,Swanson; Steven James,9999,0,9999,0
1668529412849,CSE 293,038,119435,Tullsen; Dean Michael,9999,0,9999,0
1668529412849,CSE 293,039,119483,Voelker; Geoffrey M.,9999,0,9999,0
1668529412849,CSE 293,040,119537,Zhao; Jishen,9999,0,9999,0
1668529412849,CSE 293,041,119538,Zhou; Yuan-Yuan,9999,0,9999,0
1668529412849,CSE 293,042,119539,Gao; Sicun,9999,0,9999,0
1668529412849,CSE 293,043,119540,Weibel; Nadir,9999,0,9999,0
1668529412849,CSE 293,044,119541,Gupta; Rajesh K.,9999,0,9999,0
1668529412849,CSE 293,045,126410,Vaccaro; Kristen Marie,9999,0,9999,0
1668529412849,CSE 293,046,126411,Klemke; Richard,9999,0,9999,0
1668529413276,CSE 294,A00,102459,Voelker; Geoffrey M.,0,2,0,0
1668529413276,CSE 294,B00,111322,Orailoglu; Alex,0,2,0,0
1668529413727,DSE 201,A00,096914,Deutsch; Alin Bernard,30,0,30,0
1668529414151,DSE 210,A00,096915,Dasgupta; Sanjoy,30,0,30,0
1668529414574,DSE 260A,A00,096916,Altintas De Callaf; Ilkay,30,0,30,0
1668529415038,ECE 200,001,103586,Antipa; Nicholas A,9999,0,9999,0
1668529415038,ECE 200,002,103587,Atanasov; Nikolay A.,9999,0,9999,0
1668529415038,ECE 200,003,103588,Bharadia; Dinesh,9999,0,9999,0
1668529415038,ECE 200,004,103589,Cheng; Chung Kuan,9999,0,9999,0
1668529415038,ECE 200,005,103590,Cosman; Pamela C.,9999,0,9999,0
1668529415038,ECE 200,006,103591,Dayeh; Shadi Ahmad,9999,0,9999,0
1668529415038,ECE 200,007,103592,Fainman; Yeshaiahu,9999,0,9999,0
1668529415038,ECE 200,008,103593,Ford; Joseph Earl,9999,0,9999,0
1668529415038,ECE 200,009,103594,Franceschetti; Massimo,9999,0,9999,0
1668529415038,ECE 200,010,103595,Fullerton; Eric E,9999,0,9999,0
1668529415038,ECE 200,011,103596,Galton; Ian A,9999,0,9999,0
1668529415038,ECE 200,012,103597,Gilja; Vikash,9999,0,9999,0
1668529415038,ECE 200,013,103598,Hall; Drew A.,9999,0,9999,0
1668529415038,ECE 200,014,103599,Hsueh; Tzu-Chien,9999,0,9999,0
1668529415038,ECE 200,015,103600,Javidi; Tara,9999,0,9999,0
1668529415038,ECE 200,016,103601,Kahng; Andrew Byun,9999,0,9999,0
1668529415038,ECE 200,017,103602,Kim; Young-Han,9999,0,9999,0
1668529415038,ECE 200,018,103603,Koushanfar; Farinaz,9999,0,9999,0
1668529415038,ECE 200,019,103604,Kuzum; Duygu,9999,0,9999,0
1668529415038,ECE 200,020,103605,Le; Hanh-Phuc,9999,0,9999,0
1668529415038,ECE 200,021,103606,Lin; Bill,9999,0,9999,0
1668529415038,ECE 200,022,103607,Liu; Zhaowei,9998,0,9999,1
1668529415038,ECE 200,023,103608,Lo; Yu-Hwa,9999,0,9999,0
1668529415038,ECE 200,024,103609,Lomakin; Vitaliy,9999,0,9999,0
1668529415038,ECE 200,025,103610,Mercier; Patrick Philip,9999,0,9999,0
1668529415038,ECE 200,026,103611,Meyer; Florian,9999,0,9999,0
1668529415038,ECE 200,027,103612,Milstein; Laurence B.,9999,0,9999,0
1668529415038,ECE 200,028,103613,Mir Arabbaygi; Siavash,9999,0,9999,0
1668529415038,ECE 200,029,103614,Mookherjea; Shayan,9999,0,9999,0
1668529415038,ECE 200,030,103615,Morris; Karcher William,9999,0,9999,0
1668529415038,ECE 200,031,103616,Ng; Tse Nga,9999,0,9999,0
1668529415038,ECE 200,032,103617,Nguyen; Truong Quang,9999,0,9999,0
1668529415038,ECE 200,033,103618,Nomura; Kenji,9999,0,9999,0
1668529415038,ECE 200,034,103619,Orlitsky; Alon,9999,0,9999,0
1668529415038,ECE 200,035,103620,Pal; Piya,9999,0,9999,0
1668529415038,ECE 200,036,103621,Papen; George C.,9999,0,9999,0
1668529415038,ECE 200,037,103622,Radic; Stojan,9999,0,9999,0
1668529415038,ECE 200,038,103623,Rao; Bhaskar D.,9999,0,9999,0
1668529415038,ECE 200,039,103624,Rao; Ramesh R,9999,0,9999,0
1668529415038,ECE 200,040,103625,Rebeiz; Gabriel,9999,0,9999,0
1668529415038,ECE 200,041,103626,Sanford; John R,9999,0,9999,0
1668529415038,ECE 200,042,103627,Siegel; Paul H.,9999,0,9999,0
1668529415038,ECE 200,043,103628,Sievenpiper; Daniel F.,9999,0,9999,0
1668529415038,ECE 200,044,103629,Sworder; David D.,9999,0,9999,0
1668529415038,ECE 200,045,103630,Taur; Yuan,9999,0,9999,0
1668529415038,ECE 200,046,103631,Touri; Behrouz,9999,0,9999,0
1668529415038,ECE 200,047,103632,Trivedi; Mohan M.,9999,0,9999,0
1668529415038,ECE 200,048,103633,Vasconcelos; Nuno,9999,0,9999,0
1668529415038,ECE 200,049,103634,Wang; Xiaolong,9999,0,9999,0
1668529415038,ECE 200,050,103635,Xie; Pengtao,9999,0,9999,0
1668529415038,ECE 200,051,103636,Yip; Michael,9999,0,9999,0
1668529415038,ECE 200,052,103637,Zeger; Kenneth A.,999,0,999,0
1668529415038,ECE 200,053,103638,Zhang; Xinyu,9999,0,9999,0
1668529415038,ECE 200,054,103639,Turakhia; Yatish Girish,9999,0,9999,0
1668529415038,ECE 200,055,103640,Kang; Mingu,9999,0,9999,0
1668529415038,ECE 200,056,103641,Shi; Yuanyuan,9999,0,9999,0
1668529415038,ECE 200,057,103642,Wang; Edward Jay,9999,0,9999,0
1668529415038,ECE 200,058,103643,Zheng; Yang,9999,0,9999,0
1668529415472,ECE 202,A00,103644,Kuzum; Duygu,0,44,0,0
1668529415900,ECE 212BN,A00,103646,Ng; Tse Nga,0,9,0,0
1668529416326,ECE 221,A00,111493,Staff,0,0,0,0
1668529416752,ECE 222B,A00,103647,Lomakin; Vitaliy,0,20,0,0
1668529417189,ECE 230B,A00,103648,Taur; Yuan,0,3,0,0
1668529417617,ECE 238B,A00,103649,Garay; Javier,0,0,0,0
1668529418044,ECE 240B,A00,112900,Fainman; Yeshaiahu,0,7,0,0
1668529418486,ECE 247A,A00,103650,Jokerst; Jesse Vincent,0,6,0,0
1668529418919,ECE 247B,A00,103651,Wang; Joseph,0,14,0,0
1668529419345,ECE 250,A00,103652,Siegel; Paul H.,0,82,0,0
1668529419769,ECE 251A,A00,103654,Rao; Bhaskar D.,0,62,0,0
1668529420204,ECE 257B,A00,103655,Bharadia; Dinesh,0,33,0,0
1668529420633,ECE 258A,A00,103656,Milstein; Laurence B.,0,29,0,0
1668529421080,ECE 260B,A00,103658,Kang; Mingu,0,120,0,0
1668529421504,ECE 264A,A00,103659,Galton; Ian A,0,67,0,0
1668529421934,ECE 265A,A00,103661,Gudem; Prasad S.S.,0,71,0,0
1668529422359,ECE 265D,A00,103662,Gudem; Prasad S.S.,0,26,0,0
1668529422795,ECE 268,A00,103663,Koushanfar; Farinaz,0,43,0,0
1668529423220,ECE 269,A01,103665,Pal; Piya,0,216,0,0
1668529423656,ECE 271B,A00,103666,Vasconcelos; Manuela,0,76,0,0
1668529424088,ECE 276A,A00,103667,Atanasov; Nikolay A.,0,127,0,0
1668529424521,ECE 277,A00,103668,An; Cheolhong,0,149,0,0
1668529424950,ECE 279,A00,117947,Hall; Drew A.,0,22,0,0
1668529425805,ECE 283,A00,103670,Hsueh; Tzu-Chien,0,55,0,0
1668529426229,ECE 284,A00,103671,Turakhia; Yatish Girish,0,39,0,0
1668529426652,ECE 285,A00,103672,Zheng; Yang,0,40,0,0
1668529426652,ECE 285,B00,103673,Sworder; David D.,0,57,0,0
1668529427080,ECE 287,A00,103676,Javidi; Tara,0,9,0,0
1668529427506,MATH 200B,A00,098023,Salehi Golsefidy; Alireza,10,0,15,5
1668529427931,MATH 202B,A00,098024,Rhoades; Brendon Patrick,7,0,15,8
1668529428374,MATH 203B,A00,098025,Oprea; Dragos N.,9,0,15,6
1668529428797,MATH 204B,A00,098026,Sorensen; Claus M,13,0,15,2
1668529429225,MATH 208,A00,098027,Izadi; Elham,7,0,10,3
1668529429650,MATH 209,A00,098028,Pollack; Aaron,10,0,10,0
1668529430077,MATH 211A,A00,112919,Rogalski; Daniel,8,0,10,2
1668529430499,MATH 211B,A00,112920,Seward; Brandon M.,9,0,10,1
1668529430923,MATH 218,A00,098029,Li; Bo,10,0,10,0
1668529431346,MATH 220B,A00,098030,Novak; Jonathan I,11,0,15,4
1668529431774,MATH 221A,A00,098031,Ebenfelt; Peter F,12,0,15,3
1668529432199,MATH 231B,A00,098032,Zlatos; Andrej,11,0,15,4
1668529432633,MATH 240B,A00,098033,Ni; Lei,7,0,15,8
1668529433065,MATH 243,A00,098034,Jekel; David Andrew,10,0,10,0
1668529433492,MATH 245A,A00,098035,Nie; Jiawang,0,5,15,18
1668529433920,MATH 248,A00,098036,Bejenaru; Ioan,10,0,10,0
1668529434360,MATH 250B,A00,098037,Spolaor; Luca,14,0,15,1
1668529434794,MATH 258,A00,098038,Ni; Lei,9,0,10,1
1668529435217,MATH 264B,A00,098041,Rhoades; Brendon Patrick,8,0,15,7
1668529435646,MATH 268,A00,098042,Buss; Samuel R,10,0,10,0
1668529436082,MATH 269,A00,098043,Rhoades; Brendon Patrick,10,0,10,0
1668529436521,MATH 270B,A00,098044,Li; Bo,6,0,15,9
1668529436962,MATH 272B,A00,098045,Holst; Michael J,13,0,15,2
1668529437401,MATH 273A,A00,098046,Tian; Xiaochuan,10,0,15,5
1668529437824,MATH 275,A01,098048,Tian; Xiaochuan,6,0,10,4
1668529438259,MATH 278A,A00,098049,Holst; Michael J,7,0,10,3
1668529438688,MATH 278B,A00,098050,Cloninger; Alexander,10,0,10,0
1668529439125,MATH 278C,A00,098051,Nie; Jiawang,5,0,10,5
1668529439561,MATH 280B,A00,098052,Zheng; Tianyi,7,0,15,8
1668529439989,MATH 281B,A00,098053,Bradic; Jelena,0,2,15,15
1668529440418,MATH 282B,A00,098054,Arias-Castro; Ery,0,1,15,15
1668529440842,MATH 285,A00,098055,Fitzsimmons; Patrick J,0,3,15,17
1668529441269,MATH 287B,A00,098056,Arias-Castro; Ery,1,0,15,14
1668529441756,MATH 288,A00,098057,Agarwal; Pooja,9,0,10,1
1668529441756,MATH 288,B00,098058,Zhang; Danna,8,0,10,2
1668529441756,MATH 288,C00,098059,Williams; Ruth J,9,0,10,1
1668529442182,MATH 290B,A00,098060,Roberts; Justin Deritter,12,0,15,3
1668529442606,MATH 292,A00,098061,Belmont; Eva Kinoshita,10,0,10,0
1668529443064,MATH 295,A00,098062,Suk; Andrew Hoon,47,0,50,3
1668529443488,MATH 296,A00,098063,Novak; Jonathan I,20,0,20,0
1668529443915,MATH 297,001,098064,Gamst; Anthony Collins,9997,0,9999,2
1668529948559,COGS 205,A00,101395,Chiba; Andrea,19,0,20,1
1668529948986,COGS 210B,001,101404,Greene; Deanna Jacquelyn,9998,0,9999,1
1668529948986,COGS 210B,002,101417,Xia; Haijun,9999,0,9999,0
1668529948986,COGS 210B,003,101422,Nitz; Douglas A.,9999,0,9999,0
1668529948986,COGS 210B,004,101423,Hollan; James D.,9998,0,9999,1
1668529948986,COGS 210B,005,101424,Deak; Gedeon O.,9998,0,9999,1
1668529948986,COGS 210B,006,101425,Rossano; Federico,9999,0,9999,0
1668529949424,COGS 211B,A00,101427,Coulson; Seana M,9996,0,9999,3
1668529949846,COGS 220,A00,101428,Hollan; James D.,0,10,25,25
1668529950279,COGS 229,A00,101429,Dow; Steven P,17,0,25,8
1668529950705,COGS 230,A00,101430,Klemmer; Scott R,7,0,17,10
1668529951128,COGS 234,A00,101431,Xia; Haijun,1,0,25,24
1668529951557,COGS 260,A00,101432,Kiyonaga; Anastasia,21,0,25,4
1668529951557,COGS 260,B00,101433,Kirsh; David Joel,15,0,25,10
1668529951983,CSE 202,A00,102371,Impagliazzo; Russell,0,66,0,0
1668529952412,CSE 203B,A01,102373,Cheng; Chung Kuan,0,59,0,0
1668529952834,CSE 208,A00,102374,Micciancio; Daniele,0,5,0,0
1668529953264,CSE 209A,A00,112895,Impagliazzo; Russell,0,12,15,15
1668529953689,CSE 209B,A00,108005,Bellare; Mihir,0,7,0,0
1668529954115,CSE 210,A00,113163,Coblenz; Michael J,0,85,0,0
1668529954539,CSE 219,A00,106111,Dow; Steven P,0,6,20,20
1668529954972,CSE 221,A00,102376,Voelker; Geoffrey M.,0,73,0,0
1668529955411,CSE 224,A01,102378,Porter; George M,0,167,0,0
1668529955835,CSE 229A,A00,102379,Savage; Stefan,0,10,0,0
1668529956257,CSE 229C,A00,102380,Munyaka; Imani N. S.,0,10,0,0
1668529956680,CSE 232B,A00,102382,Deutsch; Alin Bernard,0,33,0,0
1668529957106,CSE 234,A01,112904,Kumar; Arun Kumar,0,0,0,0
1668529957529,CSE 237A,A00,102383,Rosing; Tajana Simunic,0,55,0,0
1668529957963,CSE 239A,A00,102384,Deutsch; Alin Bernard,0,14,0,0
1668529958388,CSE 239B,A00,102385,Polikarpova; Nadezhda,0,10,0,0
1668529958822,CSE 240A,A00,102386,Pannuto; Patrick William,0,46,0,0
1668529959245,CSE 240B,A00,102387,Zhao; Jishen,0,47,0,0
1668529959667,CSE 241A,A00,106406,Kang; Mingu,0,9,0,0
1668529960090,CSE 249B,A00,102388,Kahng; Andrew Byun,0,5,8,8
1668529960514,CSE 251B,A01,102392,Cottrell; Garrison W,0,51,0,0
1668529960514,CSE 251B,A02,102393,Cottrell; Garrison W,0,34,0,0
1668529960941,CSE 252B,A00,102394,Ochoa; Benjamin Lawrence,0,59,0,0
1668529961367,CSE 257,A01,102396,Gao; Sicun,0,139,0,0
1668529961792,CSE 272,A00,102397,Li; Tzumao,0,19,0,0
1668529962217,CSE 274,A00,111323,Chern; Albert Ren-Haur,0,15,0,0
1668529962641,CSE 282,A00,102398,Pevzner; Pavel Arkadjevich,0,0,0,0
1668529963065,CSE 284,A00,114175,Gymrek; Melissa Ann,0,22,0,0
1668529963490,CSE 290,A00,102399,Chandraker; Manmohan Krishna,0,11,0,0
1668529963490,CSE 290,B00,102400,Vaccaro; Kristen Marie,0,7,25,25
1668529963490,CSE 290,C00,102414,Pannuto; Patrick William,0,1,25,25
1668529963490,CSE 290,D00,102427,Pevzner; Pavel Arkadjevich,0,0,0,0
1668529963490,CSE 290,E00,102429,Zhao; Jishen,0,4,0,0
1668529963490,CSE 290,F00,102436,Tullsen; Dean Michael,0,5,0,0
1668529963490,CSE 290,G00,102440,Christensen; Henrik I,0,6,20,20
1668529963918,CSE 291,A00,102443,Su; Hao,0,0,0,0
1668529963918,CSE 291,B00,102448,Polikarpova; Nadezhda,0,0,0,0
1668529963918,CSE 291,C00,102453,Vaccaro; Kristen Marie,0,0,0,0
1668529963918,CSE 291,D00,111343,Savage; Stefan,0,0,0,0
1668529963918,CSE 291,E00,116474,Claffy; Kimberly Claire,0,0,0,0
1668529963918,CSE 291,F00,116479,Pasquale; Joseph,0,0,0,0
1668529964358,CSE 293,001,119111,Bafna; Vineet,9999,0,9999,0
1668529964358,CSE 293,002,119118,Bellare; Mihir,9999,0,9999,0
1668529964358,CSE 293,003,119122,Berg-Kirkpatrick; Taylor D,9999,0,9999,0
1668529964358,CSE 293,004,119135,Christensen; Henrik I,9999,0,9999,0
1668529964358,CSE 293,005,119142,Cottrell; Garrison W,9999,0,9999,0
1668529964358,CSE 293,006,119146,Deutsch; Alin Bernard,9999,0,9999,0
1668529964358,CSE 293,007,119159,Esmaeilzadeh; Hadi,9999,0,9999,0
1668529964358,CSE 293,008,119166,Freund; Yoav,9999,0,9999,0
1668529964358,CSE 293,009,119170,Griswold; William G.,9999,0,9999,0
1668529964358,CSE 293,010,119183,Gymrek; Melissa Ann,9999,0,9999,0
1668529964358,CSE 293,011,119190,Heninger; Nadia A,9999,0,9999,0
1668529964358,CSE 293,012,119230,Impagliazzo; Russell,9999,0,9999,0
1668529964358,CSE 293,013,119232,Jhala; Ranjit,9999,0,9999,0
1668529964358,CSE 293,014,119233,Kahng; Andrew Byun,9999,0,9999,0
1668529964358,CSE 293,015,119298,Kane; Daniel Mertz,9999,0,9999,0
1668529964358,CSE 293,016,119299,Kriegman; David J,9999,0,9999,0
1668529964358,CSE 293,017,119300,Kumar; Arun Kumar,9999,0,9999,0
1668529964358,CSE 293,018,119301,Lerner; Sorin,9999,0,9999,0
1668529964358,CSE 293,019,119302,Lovett; Shachar,9999,0,9999,0
1668529964358,CSE 293,020,119303,McAuley; Julian John,9999,0,9999,0
1668529964358,CSE 293,021,119304,Micciancio; Daniele,9999,0,9999,0
1668529964358,CSE 293,022,119367,Orailoglu; Alex,9999,0,9999,0
1668529964358,CSE 293,023,119382,Paturi; Ramamohan,9999,0,9999,0
1668529964358,CSE 293,024,119404,Polikarpova; Nadezhda,9999,0,9999,0
1668529964358,CSE 293,025,119406,Politz; Joseph Gibbs,9999,0,9999,0
1668529964358,CSE 293,026,119411,Porter; George M,9999,0,9999,0
1668529964358,CSE 293,027,119414,Porter; Leonard Emerson,9999,0,9999,0
1668529964358,CSE 293,028,119416,Ramamoorthi; Ravi,9999,0,9999,0
1668529964358,CSE 293,029,119417,Sahoo; Debashis,9999,0,9999,0
1668529964358,CSE 293,030,119420,Saul; Lawrence,9999,0,9999,0
1668529964358,CSE 293,031,119421,Savage; Stefan,9999,0,9999,0
1668529964358,CSE 293,032,119425,Schulze; Jurgen P.,9999,0,9999,0
1668529964358,CSE 293,033,119426,Snoeren; Alex C.,9999,0,9999,0
1668529964358,CSE 293,034,119428,Shang; Jingbo,9999,0,9999,0
1668529964358,CSE 293,035,119430,Stefan; Deian,9999,0,9999,0
1668529964358,CSE 293,036,119431,Su; Hao,9999,0,9999,0
1668529964358,CSE 293,037,119433,Swanson; Steven James,9999,0,9999,0
1668529964358,CSE 293,038,119435,Tullsen; Dean Michael,9999,0,9999,0
1668529964358,CSE 293,039,119483,Voelker; Geoffrey M.,9999,0,9999,0
1668529964358,CSE 293,040,119537,Zhao; Jishen,9999,0,9999,0
1668529964358,CSE 293,041,119538,Zhou; Yuan-Yuan,9999,0,9999,0
1668529964358,CSE 293,042,119539,Gao; Sicun,9999,0,9999,0
1668529964358,CSE 293,043,119540,Weibel; Nadir,9999,0,9999,0
1668529964358,CSE 293,044,119541,Gupta; Rajesh K.,9999,0,9999,0
1668529964358,CSE 293,045,126410,Vaccaro; Kristen Marie,9999,0,9999,0
1668529964358,CSE 293,046,126411,Klemke; Richard,9999,0,9999,0
1668529964783,CSE 294,A00,102459,Voelker; Geoffrey M.,0,2,0,0
1668529964783,CSE 294,B00,111322,Orailoglu; Alex,0,2,0,0
1668529965207,DSE 201,A00,096914,Deutsch; Alin Bernard,30,0,30,0
1668529965635,DSE 210,A00,096915,Dasgupta; Sanjoy,30,0,30,0
1668529966057,DSE 260A,A00,096916,Altintas De Callaf; Ilkay,30,0,30,0
1668529966527,ECE 200,001,103586,Antipa; Nicholas A,9999,0,9999,0
1668529966527,ECE 200,002,103587,Atanasov; Nikolay A.,9999,0,9999,0
1668529966527,ECE 200,003,103588,Bharadia; Dinesh,9999,0,9999,0
1668529966527,ECE 200,004,103589,Cheng; Chung Kuan,9999,0,9999,0
1668529966527,ECE 200,005,103590,Cosman; Pamela C.,9999,0,9999,0
1668529966527,ECE 200,006,103591,Dayeh; Shadi Ahmad,9999,0,9999,0
1668529966527,ECE 200,007,103592,Fainman; Yeshaiahu,9999,0,9999,0
1668529966527,ECE 200,008,103593,Ford; Joseph Earl,9999,0,9999,0
1668529966527,ECE 200,009,103594,Franceschetti; Massimo,9999,0,9999,0
1668529966527,ECE 200,010,103595,Fullerton; Eric E,9999,0,9999,0
1668529966527,ECE 200,011,103596,Galton; Ian A,9999,0,9999,0
1668529966527,ECE 200,012,103597,Gilja; Vikash,9999,0,9999,0
1668529966527,ECE 200,013,103598,Hall; Drew A.,9999,0,9999,0
1668529966527,ECE 200,014,103599,Hsueh; Tzu-Chien,9999,0,9999,0
1668529966527,ECE 200,015,103600,Javidi; Tara,9999,0,9999,0
1668529966527,ECE 200,016,103601,Kahng; Andrew Byun,9999,0,9999,0
1668529966527,ECE 200,017,103602,Kim; Young-Han,9999,0,9999,0
1668529966527,ECE 200,018,103603,Koushanfar; Farinaz,9999,0,9999,0
1668529966527,ECE 200,019,103604,Kuzum; Duygu,9999,0,9999,0
1668529966527,ECE 200,020,103605,Le; Hanh-Phuc,9999,0,9999,0
1668529966527,ECE 200,021,103606,Lin; Bill,9999,0,9999,0
1668529966527,ECE 200,022,103607,Liu; Zhaowei,9998,0,9999,1
1668529966527,ECE 200,023,103608,Lo; Yu-Hwa,9999,0,9999,0
1668529966527,ECE 200,024,103609,Lomakin; Vitaliy,9999,0,9999,0
1668529966527,ECE 200,025,103610,Mercier; Patrick Philip,9999,0,9999,0
1668529966527,ECE 200,026,103611,Meyer; Florian,9999,0,9999,0
1668529966527,ECE 200,027,103612,Milstein; Laurence B.,9999,0,9999,0
1668529966527,ECE 200,028,103613,Mir Arabbaygi; Siavash,9999,0,9999,0
1668529966527,ECE 200,029,103614,Mookherjea; Shayan,9999,0,9999,0
1668529966527,ECE 200,030,103615,Morris; Karcher William,9999,0,9999,0
1668529966527,ECE 200,031,103616,Ng; Tse Nga,9999,0,9999,0
1668529966527,ECE 200,032,103617,Nguyen; Truong Quang,9999,0,9999,0
1668529966527,ECE 200,033,103618,Nomura; Kenji,9999,0,9999,0
1668529966527,ECE 200,034,103619,Orlitsky; Alon,9999,0,9999,0
1668529966527,ECE 200,035,103620,Pal; Piya,9999,0,9999,0
1668529966527,ECE 200,036,103621,Papen; George C.,9999,0,9999,0
1668529966527,ECE 200,037,103622,Radic; Stojan,9999,0,9999,0
1668529966527,ECE 200,038,103623,Rao; Bhaskar D.,9999,0,9999,0
1668529966527,ECE 200,039,103624,Rao; Ramesh R,9999,0,9999,0
1668529966527,ECE 200,040,103625,Rebeiz; Gabriel,9999,0,9999,0
1668529966527,ECE 200,041,103626,Sanford; John R,9999,0,9999,0
1668529966527,ECE 200,042,103627,Siegel; Paul H.,9999,0,9999,0
1668529966527,ECE 200,043,103628,Sievenpiper; Daniel F.,9999,0,9999,0
1668529966527,ECE 200,044,103629,Sworder; David D.,9999,0,9999,0
1668529966527,ECE 200,045,103630,Taur; Yuan,9999,0,9999,0
1668529966527,ECE 200,046,103631,Touri; Behrouz,9999,0,9999,0
1668529966527,ECE 200,047,103632,Trivedi; Mohan M.,9999,0,9999,0
1668529966527,ECE 200,048,103633,Vasconcelos; Nuno,9999,0,9999,0
1668529966527,ECE 200,049,103634,Wang; Xiaolong,9999,0,9999,0
1668529966527,ECE 200,050,103635,Xie; Pengtao,9999,0,9999,0
1668529966527,ECE 200,051,103636,Yip; Michael,9999,0,9999,0
1668529966527,ECE 200,052,103637,Zeger; Kenneth A.,999,0,999,0
1668529966527,ECE 200,053,103638,Zhang; Xinyu,9999,0,9999,0
1668529966527,ECE 200,054,103639,Turakhia; Yatish Girish,9999,0,9999,0
1668529966527,ECE 200,055,103640,Kang; Mingu,9999,0,9999,0
1668529966527,ECE 200,056,103641,Shi; Yuanyuan,9999,0,9999,0
1668529966527,ECE 200,057,103642,Wang; Edward Jay,9999,0,9999,0
1668529966527,ECE 200,058,103643,Zheng; Yang,9999,0,9999,0
1668529966959,ECE 202,A00,103644,Kuzum; Duygu,0,44,0,0
1668529967384,ECE 212BN,A00,103646,Ng; Tse Nga,0,9,0,0
1668529967816,ECE 221,A00,111493,Staff,0,0,0,0
1668529968246,ECE 222B,A00,103647,Lomakin; Vitaliy,0,20,0,0
1668529968668,ECE 230B,A00,103648,Taur; Yuan,0,3,0,0
1668529969092,ECE 238B,A00,103649,Garay; Javier,0,0,0,0
1668529969521,ECE 240B,A00,112900,Fainman; Yeshaiahu,0,7,0,0
1668529969944,ECE 247A,A00,103650,Jokerst; Jesse Vincent,0,6,0,0
1668529970368,ECE 247B,A00,103651,Wang; Joseph,0,14,0,0
1668529970796,ECE 250,A00,103652,Siegel; Paul H.,0,82,0,0
1668529971221,ECE 251A,A00,103654,Rao; Bhaskar D.,0,62,0,0
1668529971645,ECE 257B,A00,103655,Bharadia; Dinesh,0,33,0,0
1668529972072,ECE 258A,A00,103656,Milstein; Laurence B.,0,29,0,0
1668529972505,ECE 260B,A00,103658,Kang; Mingu,0,120,0,0
1668529972932,ECE 264A,A00,103659,Galton; Ian A,0,67,0,0
1668529973360,ECE 265A,A00,103661,Gudem; Prasad S.S.,0,71,0,0
1668529973795,ECE 265D,A00,103662,Gudem; Prasad S.S.,0,26,0,0
1668529974222,ECE 268,A00,103663,Koushanfar; Farinaz,0,43,0,0
1668529974645,ECE 269,A01,103665,Pal; Piya,0,216,0,0
1668529975074,ECE 271B,A00,103666,Vasconcelos; Manuela,0,76,0,0
1668529975503,ECE 276A,A00,103667,Atanasov; Nikolay A.,0,127,0,0
1668529975933,ECE 277,A00,103668,An; Cheolhong,0,149,0,0
1668529976381,ECE 279,A00,117947,Hall; Drew A.,0,22,0,0
1668529977245,ECE 283,A00,103670,Hsueh; Tzu-Chien,0,55,0,0
1668529977669,ECE 284,A00,103671,Turakhia; Yatish Girish,0,39,0,0
1668529978203,ECE 285,A00,103672,Zheng; Yang,0,40,0,0
1668529978203,ECE 285,B00,103673,Sworder; David D.,0,57,0,0
1668529978635,ECE 287,A00,103676,Javidi; Tara,0,9,0,0
1668529979058,MATH 200B,A00,098023,Salehi Golsefidy; Alireza,10,0,15,5
1668529979498,MATH 202B,A00,098024,Rhoades; Brendon Patrick,7,0,15,8
1668529979937,MATH 203B,A00,098025,Oprea; Dragos N.,9,0,15,6
1668529980360,MATH 204B,A00,098026,Sorensen; Claus M,13,0,15,2
1668529980792,MATH 208,A00,098027,Izadi; Elham,7,0,10,3
1668529981228,MATH 209,A00,098028,Pollack; Aaron,10,0,10,0
1668529981667,MATH 211A,A00,112919,Rogalski; Daniel,8,0,10,2
1668529982109,MATH 211B,A00,112920,Seward; Brandon M.,9,0,10,1
1668529982545,MATH 218,A00,098029,Li; Bo,10,0,10,0
1668529982973,MATH 220B,A00,098030,Novak; Jonathan I,11,0,15,4
1668529983425,MATH 221A,A00,098031,Ebenfelt; Peter F,12,0,15,3
1668529983851,MATH 231B,A00,098032,Zlatos; Andrej,11,0,15,4
1668529984274,MATH 240B,A00,098033,Ni; Lei,7,0,15,8
1668529984697,MATH 243,A00,098034,Jekel; David Andrew,10,0,10,0
1668529985120,MATH 245A,A00,098035,Nie; Jiawang,0,5,15,18
1668529985542,MATH 248,A00,098036,Bejenaru; Ioan,10,0,10,0
1668529985974,MATH 250B,A00,098037,Spolaor; Luca,14,0,15,1
1668529986398,MATH 258,A00,098038,Ni; Lei,9,0,10,1
1668529986822,MATH 264B,A00,098041,Rhoades; Brendon Patrick,8,0,15,7
1668529987255,MATH 268,A00,098042,Buss; Samuel R,10,0,10,0
1668529987679,MATH 269,A00,098043,Rhoades; Brendon Patrick,10,0,10,0
1668529988106,MATH 270B,A00,098044,Li; Bo,6,0,15,9
1668529988533,MATH 272B,A00,098045,Holst; Michael J,13,0,15,2
1668529988973,MATH 273A,A00,098046,Tian; Xiaochuan,10,0,15,5
1668529989398,MATH 275,A01,098048,Tian; Xiaochuan,6,0,10,4
1668529989821,MATH 278A,A00,098049,Holst; Michael J,7,0,10,3
1668529990247,MATH 278B,A00,098050,Cloninger; Alexander,10,0,10,0
1668529990672,MATH 278C,A00,098051,Nie; Jiawang,5,0,10,5
1668529991101,MATH 280B,A00,098052,Zheng; Tianyi,7,0,15,8
1668529991525,MATH 281B,A00,098053,Bradic; Jelena,0,2,15,15
1668529991948,MATH 282B,A00,098054,Arias-Castro; Ery,0,1,15,15
1668529992373,MATH 285,A00,098055,Fitzsimmons; Patrick J,0,3,15,17
1668529992805,MATH 287B,A00,098056,Arias-Castro; Ery,1,0,15,14
1668529993228,MATH 288,A00,098057,Agarwal; Pooja,9,0,10,1
1668529993228,MATH 288,B00,098058,Zhang; Danna,8,0,10,2
1668529993228,MATH 288,C00,098059,Williams; Ruth J,9,0,10,1
1668529993658,MATH 290B,A00,098060,Roberts; Justin Deritter,12,0,15,3
1668529994081,MATH 292,A00,098061,Belmont; Eva Kinoshita,10,0,10,0
1668529994511,MATH 295,A00,098062,Suk; Andrew Hoon,47,0,50,3
1668529994934,MATH 296,A00,098063,Novak; Jonathan I,20,0,20,0
1668529995357,MATH 297,001,098064,Gamst; Anthony Collins,9997,0,9999,2
1668530498927,COGS 205,A00,101395,Chiba; Andrea,19,0,20,1
1668530499360,COGS 210B,001,101404,Greene; Deanna Jacquelyn,9998,0,9999,1
1668530499360,COGS 210B,002,101417,Xia; Haijun,9999,0,9999,0
1668530499360,COGS 210B,003,101422,Nitz; Douglas A.,9999,0,9999,0
1668530499360,COGS 210B,004,101423,Hollan; James D.,9998,0,9999,1
1668530499360,COGS 210B,005,101424,Deak; Gedeon O.,9998,0,9999,1
1668530499360,COGS 210B,006,101425,Rossano; Federico,9999,0,9999,0
1668530499785,COGS 211B,A00,101427,Coulson; Seana M,9996,0,9999,3
1668530500208,COGS 220,A00,101428,Hollan; James D.,0,10,25,25
1668530500723,COGS 229,A00,101429,Dow; Steven P,17,0,25,8
1668530501155,COGS 230,A00,101430,Klemmer; Scott R,7,0,17,10
1668530501577,COGS 234,A00,101431,Xia; Haijun,1,0,25,24
1668530502000,COGS 260,A00,101432,Kiyonaga; Anastasia,21,0,25,4
1668530502000,COGS 260,B00,101433,Kirsh; David Joel,15,0,25,10
1668530502424,CSE 202,A00,102371,Impagliazzo; Russell,0,66,0,0
1668530502846,CSE 203B,A01,102373,Cheng; Chung Kuan,0,59,0,0
1668530503274,CSE 208,A00,102374,Micciancio; Daniele,0,5,0,0
1668530503702,CSE 209A,A00,112895,Impagliazzo; Russell,0,12,15,15
1668530504133,CSE 209B,A00,108005,Bellare; Mihir,0,7,0,0
1668530504566,CSE 210,A00,113163,Coblenz; Michael J,0,85,0,0
1668530505004,CSE 219,A00,106111,Dow; Steven P,0,6,20,20
1668530505431,CSE 221,A00,102376,Voelker; Geoffrey M.,0,73,0,0
1668530505856,CSE 224,A01,102378,Porter; George M,0,167,0,0
1668530506282,CSE 229A,A00,102379,Savage; Stefan,0,10,0,0
1668530506706,CSE 229C,A00,102380,Munyaka; Imani N. S.,0,10,0,0
1668530507131,CSE 232B,A00,102382,Deutsch; Alin Bernard,0,33,0,0
1668530507573,CSE 234,A01,112904,Kumar; Arun Kumar,0,0,0,0
1668530508002,CSE 237A,A00,102383,Rosing; Tajana Simunic,0,55,0,0
1668530508424,CSE 239A,A00,102384,Deutsch; Alin Bernard,0,14,0,0
1668530508862,CSE 239B,A00,102385,Polikarpova; Nadezhda,0,10,0,0
1668530509290,CSE 240A,A00,102386,Pannuto; Patrick William,0,46,0,0
1668530509726,CSE 240B,A00,102387,Zhao; Jishen,0,47,0,0
1668530510157,CSE 241A,A00,106406,Kang; Mingu,0,9,0,0
1668530510602,CSE 249B,A00,102388,Kahng; Andrew Byun,0,5,8,8
1668530511026,CSE 251B,A01,102392,Cottrell; Garrison W,0,51,0,0
1668530511026,CSE 251B,A02,102393,Cottrell; Garrison W,0,34,0,0
1668530511459,CSE 252B,A00,102394,Ochoa; Benjamin Lawrence,0,59,0,0
1668530511883,CSE 257,A01,102396,Gao; Sicun,0,139,0,0
1668530512306,CSE 272,A00,102397,Li; Tzumao,0,19,0,0
1668530512731,CSE 274,A00,111323,Chern; Albert Ren-Haur,0,15,0,0
1668530513157,CSE 282,A00,102398,Pevzner; Pavel Arkadjevich,0,0,0,0
1668530513584,CSE 284,A00,114175,Gymrek; Melissa Ann,0,22,0,0
1668530514017,CSE 290,A00,102399,Chandraker; Manmohan Krishna,0,11,0,0
1668530514017,CSE 290,B00,102400,Vaccaro; Kristen Marie,0,7,25,25
1668530514017,CSE 290,C00,102414,Pannuto; Patrick William,0,1,25,25
1668530514017,CSE 290,D00,102427,Pevzner; Pavel Arkadjevich,0,0,0,0
1668530514017,CSE 290,E00,102429,Zhao; Jishen,0,4,0,0
1668530514017,CSE 290,F00,102436,Tullsen; Dean Michael,0,5,0,0
1668530514017,CSE 290,G00,102440,Christensen; Henrik I,0,6,20,20
1668530514447,CSE 291,A00,102443,Su; Hao,0,0,0,0
1668530514447,CSE 291,B00,102448,Polikarpova; Nadezhda,0,0,0,0
1668530514447,CSE 291,C00,102453,Vaccaro; Kristen Marie,0,0,0,0
1668530514447,CSE 291,D00,111343,Savage; Stefan,0,0,0,0
1668530514447,CSE 291,E00,116474,Claffy; Kimberly Claire,0,0,0,0
1668530514447,CSE 291,F00,116479,Pasquale; Joseph,0,0,0,0
1668530514880,CSE 293,001,119111,Bafna; Vineet,9999,0,9999,0
1668530514880,CSE 293,002,119118,Bellare; Mihir,9999,0,9999,0
1668530514880,CSE 293,003,119122,Berg-Kirkpatrick; Taylor D,9999,0,9999,0
1668530514880,CSE 293,004,119135,Christensen; Henrik I,9999,0,9999,0
1668530514880,CSE 293,005,119142,Cottrell; Garrison W,9999,0,9999,0
1668530514880,CSE 293,006,119146,Deutsch; Alin Bernard,9999,0,9999,0
1668530514880,CSE 293,007,119159,Esmaeilzadeh; Hadi,9999,0,9999,0
1668530514880,CSE 293,008,119166,Freund; Yoav,9999,0,9999,0
1668530514880,CSE 293,009,119170,Griswold; William G.,9999,0,9999,0
1668530514880,CSE 293,010,119183,Gymrek; Melissa Ann,9999,0,9999,0
1668530514880,CSE 293,011,119190,Heninger; Nadia A,9999,0,9999,0
1668530514880,CSE 293,012,119230,Impagliazzo; Russell,9999,0,9999,0
1668530514880,CSE 293,013,119232,Jhala; Ranjit,9999,0,9999,0
1668530514880,CSE 293,014,119233,Kahng; Andrew Byun,9999,0,9999,0
1668530514880,CSE 293,015,119298,Kane; Daniel Mertz,9999,0,9999,0
1668530514880,CSE 293,016,119299,Kriegman; David J,9999,0,9999,0
1668530514880,CSE 293,017,119300,Kumar; Arun Kumar,9999,0,9999,0
1668530514880,CSE 293,018,119301,Lerner; Sorin,9999,0,9999,0
1668530514880,CSE 293,019,119302,Lovett; Shachar,9999,0,9999,0
1668530514880,CSE 293,020,119303,McAuley; Julian John,9999,0,9999,0
1668530514880,CSE 293,021,119304,Micciancio; Daniele,9999,0,9999,0
1668530514880,CSE 293,022,119367,Orailoglu; Alex,9999,0,9999,0
1668530514880,CSE 293,023,119382,Paturi; Ramamohan,9999,0,9999,0
1668530514880,CSE 293,024,119404,Polikarpova; Nadezhda,9999,0,9999,0
1668530514880,CSE 293,025,119406,Politz; Joseph Gibbs,9999,0,9999,0
1668530514880,CSE 293,026,119411,Porter; George M,9999,0,9999,0
1668530514880,CSE 293,027,119414,Porter; Leonard Emerson,9999,0,9999,0
1668530514880,CSE 293,028,119416,Ramamoorthi; Ravi,9999,0,9999,0
1668530514880,CSE 293,029,119417,Sahoo; Debashis,9999,0,9999,0
1668530514880,CSE 293,030,119420,Saul; Lawrence,9999,0,9999,0
1668530514880,CSE 293,031,119421,Savage; Stefan,9999,0,9999,0
1668530514880,CSE 293,032,119425,Schulze; Jurgen P.,9999,0,9999,0
1668530514880,CSE 293,033,119426,Snoeren; Alex C.,9999,0,9999,0
1668530514880,CSE 293,034,119428,Shang; Jingbo,9999,0,9999,0
1668530514880,CSE 293,035,119430,Stefan; Deian,9999,0,9999,0
1668530514880,CSE 293,036,119431,Su; Hao,9999,0,9999,0
1668530514880,CSE 293,037,119433,Swanson; Steven James,9999,0,9999,0
1668530514880,CSE 293,038,119435,Tullsen; Dean Michael,9999,0,9999,0
1668530514880,CSE 293,039,119483,Voelker; Geoffrey M.,9999,0,9999,0
1668530514880,CSE 293,040,119537,Zhao; Jishen,9999,0,9999,0
1668530514880,CSE 293,041,119538,Zhou; Yuan-Yuan,9999,0,9999,0
1668530514880,CSE 293,042,119539,Gao; Sicun,9999,0,9999,0
1668530514880,CSE 293,043,119540,Weibel; Nadir,9999,0,9999,0
1668530514880,CSE 293,044,119541,Gupta; Rajesh K.,9999,0,9999,0
1668530514880,CSE 293,045,126410,Vaccaro; Kristen Marie,9999,0,9999,0
1668530514880,CSE 293,046,126411,Klemke; Richard,9999,0,9999,0
1668530515307,CSE 294,A00,102459,Voelker; Geoffrey M.,0,2,0,0
1668530515307,CSE 294,B00,111322,Orailoglu; Alex,0,2,0,0
1668530515729,DSE 201,A00,096914,Deutsch; Alin Bernard,30,0,30,0
1668530516153,DSE 210,A00,096915,Dasgupta; Sanjoy,30,0,30,0
1668530516579,DSE 260A,A00,096916,Altintas De Callaf; Ilkay,30,0,30,0
1668530517006,ECE 200,001,103586,Antipa; Nicholas A,9999,0,9999,0
1668530517006,ECE 200,002,103587,Atanasov; Nikolay A.,9999,0,9999,0
1668530517006,ECE 200,003,103588,Bharadia; Dinesh,9999,0,9999,0
1668530517006,ECE 200,004,103589,Cheng; Chung Kuan,9999,0,9999,0
1668530517006,ECE 200,005,103590,Cosman; Pamela C.,9999,0,9999,0
1668530517006,ECE 200,006,103591,Dayeh; Shadi Ahmad,9999,0,9999,0
1668530517006,ECE 200,007,103592,Fainman; Yeshaiahu,9999,0,9999,0
1668530517006,ECE 200,008,103593,Ford; Joseph Earl,9999,0,9999,0
1668530517006,ECE 200,009,103594,Franceschetti; Massimo,9999,0,9999,0
1668530517006,ECE 200,010,103595,Fullerton; Eric E,9999,0,9999,0
1668530517006,ECE 200,011,103596,Galton; Ian A,9999,0,9999,0
1668530517006,ECE 200,012,103597,Gilja; Vikash,9999,0,9999,0
1668530517006,ECE 200,013,103598,Hall; Drew A.,9999,0,9999,0
1668530517006,ECE 200,014,103599,Hsueh; Tzu-Chien,9999,0,9999,0
1668530517006,ECE 200,015,103600,Javidi; Tara,9999,0,9999,0
1668530517006,ECE 200,016,103601,Kahng; Andrew Byun,9999,0,9999,0
1668530517006,ECE 200,017,103602,Kim; Young-Han,9999,0,9999,0
1668530517006,ECE 200,018,103603,Koushanfar; Farinaz,9999,0,9999,0
1668530517006,ECE 200,019,103604,Kuzum; Duygu,9999,0,9999,0
1668530517006,ECE 200,020,103605,Le; Hanh-Phuc,9999,0,9999,0
1668530517006,ECE 200,021,103606,Lin; Bill,9999,0,9999,0
1668530517006,ECE 200,022,103607,Liu; Zhaowei,9998,0,9999,1
1668530517006,ECE 200,023,103608,Lo; Yu-Hwa,9999,0,9999,0
1668530517006,ECE 200,024,103609,Lomakin; Vitaliy,9999,0,9999,0
1668530517006,ECE 200,025,103610,Mercier; Patrick Philip,9999,0,9999,0
1668530517006,ECE 200,026,103611,Meyer; Florian,9999,0,9999,0
1668530517006,ECE 200,027,103612,Milstein; Laurence B.,9999,0,9999,0
1668530517006,ECE 200,028,103613,Mir Arabbaygi; Siavash,9999,0,9999,0
1668530517006,ECE 200,029,103614,Mookherjea; Shayan,9999,0,9999,0
1668530517006,ECE 200,030,103615,Morris; Karcher William,9999,0,9999,0
1668530517006,ECE 200,031,103616,Ng; Tse Nga,9999,0,9999,0
1668530517006,ECE 200,032,103617,Nguyen; Truong Quang,9999,0,9999,0
1668530517006,ECE 200,033,103618,Nomura; Kenji,9999,0,9999,0
1668530517006,ECE 200,034,103619,Orlitsky; Alon,9999,0,9999,0
1668530517006,ECE 200,035,103620,Pal; Piya,9999,0,9999,0
1668530517006,ECE 200,036,103621,Papen; George C.,9999,0,9999,0
1668530517006,ECE 200,037,103622,Radic; Stojan,9999,0,9999,0
1668530517006,ECE 200,038,103623,Rao; Bhaskar D.,9999,0,9999,0
1668530517006,ECE 200,039,103624,Rao; Ramesh R,9999,0,9999,0
1668530517006,ECE 200,040,103625,Rebeiz; Gabriel,9999,0,9999,0
1668530517006,ECE 200,041,103626,Sanford; John R,9999,0,9999,0
1668530517006,ECE 200,042,103627,Siegel; Paul H.,9999,0,9999,0
1668530517006,ECE 200,043,103628,Sievenpiper; Daniel F.,9999,0,9999,0
1668530517006,ECE 200,044,103629,Sworder; David D.,9999,0,9999,0
1668530517006,ECE 200,045,103630,Taur; Yuan,9999,0,9999,0
1668530517006,ECE 200,046,103631,Touri; Behrouz,9999,0,9999,0
1668530517006,ECE 200,047,103632,Trivedi; Mohan M.,9999,0,9999,0
1668530517006,ECE 200,048,103633,Vasconcelos; Nuno,9999,0,9999,0
1668530517006,ECE 200,049,103634,Wang; Xiaolong,9999,0,9999,0
1668530517006,ECE 200,050,103635,Xie; Pengtao,9999,0,9999,0
1668530517006,ECE 200,051,103636,Yip; Michael,9999,0,9999,0
1668530517006,ECE 200,052,103637,Zeger; Kenneth A.,999,0,999,0
1668530517006,ECE 200,053,103638,Zhang; Xinyu,9999,0,9999,0
1668530517006,ECE 200,054,103639,Turakhia; Yatish Girish,9999,0,9999,0
1668530517006,ECE 200,055,103640,Kang; Mingu,9999,0,9999,0
1668530517006,ECE 200,056,103641,Shi; Yuanyuan,9999,0,9999,0
1668530517006,ECE 200,057,103642,Wang; Edward Jay,9999,0,9999,0
1668530517006,ECE 200,058,103643,Zheng; Yang,9999,0,9999,0
1668530517432,ECE 202,A00,103644,Kuzum; Duygu,0,44,0,0
1668530517855,ECE 212BN,A00,103646,Ng; Tse Nga,0,9,0,0
1668530518280,ECE 221,A00,111493,Staff,0,0,0,0
1668530518708,ECE 222B,A00,103647,Lomakin; Vitaliy,0,20,0,0
1668530519132,ECE 230B,A00,103648,Taur; Yuan,0,3,0,0
1668530519561,ECE 238B,A00,103649,Garay; Javier,0,0,0,0
1668530519985,ECE 240B,A00,112900,Fainman; Yeshaiahu,0,7,0,0
1668530520434,ECE 247A,A00,103650,Jokerst; Jesse Vincent,0,6,0,0
1668530520859,ECE 247B,A00,103651,Wang; Joseph,0,14,0,0
1668530521286,ECE 250,A00,103652,Siegel; Paul H.,0,82,0,0
1668530521718,ECE 251A,A00,103654,Rao; Bhaskar D.,0,62,0,0
1668530522144,ECE 257B,A00,103655,Bharadia; Dinesh,0,33,0,0
1668530522571,ECE 258A,A00,103656,Milstein; Laurence B.,0,29,0,0
1668530522997,ECE 260B,A00,103658,Kang; Mingu,0,120,0,0
1668530523422,ECE 264A,A00,103659,Galton; Ian A,0,67,0,0
1668530523859,ECE 265A,A00,103661,Gudem; Prasad S.S.,0,71,0,0
1668530524287,ECE 265D,A00,103662,Gudem; Prasad S.S.,0,26,0,0
1668530524713,ECE 268,A00,103663,Koushanfar; Farinaz,0,43,0,0
1668530525138,ECE 269,A01,103665,Pal; Piya,0,216,0,0
1668530525573,ECE 271B,A00,103666,Vasconcelos; Manuela,0,76,0,0
1668530526001,ECE 276A,A00,103667,Atanasov; Nikolay A.,0,127,0,0
1668530526435,ECE 277,A00,103668,An; Cheolhong,0,149,0,0
1668530526860,ECE 279,A00,117947,Hall; Drew A.,0,22,0,0
1668530527717,ECE 283,A00,103670,Hsueh; Tzu-Chien,0,55,0,0
1668530528141,ECE 284,A00,103671,Turakhia; Yatish Girish,0,39,0,0
1668530528568,ECE 285,A00,103672,Zheng; Yang,0,40,0,0
1668530528568,ECE 285,B00,103673,Sworder; David D.,0,57,0,0
1668530528994,ECE 287,A00,103676,Javidi; Tara,0,9,0,0
1668530529419,MATH 200B,A00,098023,Salehi Golsefidy; Alireza,10,0,15,5
1668530529847,MATH 202B,A00,098024,Rhoades; Brendon Patrick,7,0,15,8
1668530530271,MATH 203B,A00,098025,Oprea; Dragos N.,9,0,15,6
1668530530701,MATH 204B,A00,098026,Sorensen; Claus M,13,0,15,2
1668530531128,MATH 208,A00,098027,Izadi; Elham,7,0,10,3
1668530531555,MATH 209,A00,098028,Pollack; Aaron,10,0,10,0
1668530531976,MATH 211A,A00,112919,Rogalski; Daniel,8,0,10,2
1668530532401,MATH 211B,A00,112920,Seward; Brandon M.,9,0,10,1
1668530532826,MATH 218,A00,098029,Li; Bo,10,0,10,0
1668530533269,MATH 220B,A00,098030,Novak; Jonathan I,11,0,15,4
1668530533697,MATH 221A,A00,098031,Ebenfelt; Peter F,12,0,15,3
1668530534121,MATH 231B,A00,098032,Zlatos; Andrej,11,0,15,4
1668530534559,MATH 240B,A00,098033,Ni; Lei,7,0,15,8
1668530534984,MATH 243,A00,098034,Jekel; David Andrew,10,0,10,0
1668530535432,MATH 245A,A00,098035,Nie; Jiawang,0,5,15,18
1668530535870,MATH 248,A00,098036,Bejenaru; Ioan,10,0,10,0
1668530536321,MATH 250B,A00,098037,Spolaor; Luca,14,0,15,1
1668530536758,MATH 258,A00,098038,Ni; Lei,9,0,10,1
1668530537188,MATH 264B,A00,098041,Rhoades; Brendon Patrick,8,0,15,7
1668530537619,MATH 268,A00,098042,Buss; Samuel R,10,0,10,0
1668530538045,MATH 269,A00,098043,Rhoades; Brendon Patrick,10,0,10,0
1668530538479,MATH 270B,A00,098044,Li; Bo,6,0,15,9
1668530538903,MATH 272B,A00,098045,Holst; Michael J,13,0,15,2
1668530539328,MATH 273A,A00,098046,Tian; Xiaochuan,10,0,15,5
1668530539751,MATH 275,A01,098048,Tian; Xiaochuan,6,0,10,4
1668530540190,MATH 278A,A00,098049,Holst; Michael J,7,0,10,3
1668530540615,MATH 278B,A00,098050,Cloninger; Alexander,10,0,10,0
1668530541054,MATH 278C,A00,098051,Nie; Jiawang,5,0,10,5
1668530541486,MATH 280B,A00,098052,Zheng; Tianyi,7,0,15,8
1668530541910,MATH 281B,A00,098053,Bradic; Jelena,0,2,15,15
1668530542335,MATH 282B,A00,098054,Arias-Castro; Ery,0,1,15,15
1668530542767,MATH 285,A00,098055,Fitzsimmons; Patrick J,0,3,15,17
1668530543202,MATH 287B,A00,098056,Arias-Castro; Ery,1,0,15,14
1668530543630,MATH 288,A00,098057,Agarwal; Pooja,9,0,10,1
1668530543630,MATH 288,B00,098058,Zhang; Danna,8,0,10,2
1668530543630,MATH 288,C00,098059,Williams; Ruth J,9,0,10,1
1668530544133,MATH 290B,A00,098060,Roberts; Justin Deritter,12,0,15,3
1668530544564,MATH 292,A00,098061,Belmont; Eva Kinoshita,10,0,10,0
1668530544999,MATH 295,A00,098062,Suk; Andrew Hoon,47,0,50,3
1668530545431,MATH 296,A00,098063,Novak; Jonathan I,20,0,20,0
1668530545853,MATH 297,001,098064,Gamst; Anthony Collins,9997,0,9999,2
1668531049593,COGS 205,A00,101395,Chiba; Andrea,19,0,20,1
1668531050027,COGS 210B,001,101404,Greene; Deanna Jacquelyn,9998,0,9999,1
1668531050027,COGS 210B,002,101417,Xia; Haijun,9999,0,9999,0
1668531050027,COGS 210B,003,101422,Nitz; Douglas A.,9999,0,9999,0
1668531050027,COGS 210B,004,101423,Hollan; James D.,9998,0,9999,1
1668531050027,COGS 210B,005,101424,Deak; Gedeon O.,9998,0,9999,1
1668531050027,COGS 210B,006,101425,Rossano; Federico,9999,0,9999,0
1668531050452,COGS 211B,A00,101427,Coulson; Seana M,9996,0,9999,3
1668531050876,COGS 220,A00,101428,Hollan; James D.,0,10,25,25
1668531051312,COGS 229,A00,101429,Dow; Steven P,17,0,25,8
1668531051856,COGS 230,A00,101430,Klemmer; Scott R,7,0,17,10
1668531052301,COGS 234,A00,101431,Xia; Haijun,1,0,25,24
1668531052727,COGS 260,A00,101432,Kiyonaga; Anastasia,21,0,25,4
1668531052727,COGS 260,B00,101433,Kirsh; David Joel,15,0,25,10
1668531053165,CSE 202,A00,102371,Impagliazzo; Russell,0,66,0,0
1668531053588,CSE 203B,A01,102373,Cheng; Chung Kuan,0,59,0,0
1668531054022,CSE 208,A00,102374,Micciancio; Daniele,0,5,0,0
1668531054447,CSE 209A,A00,112895,Impagliazzo; Russell,0,12,15,15
1668531054883,CSE 209B,A00,108005,Bellare; Mihir,0,7,0,0
1668531055306,CSE 210,A00,113163,Coblenz; Michael J,0,85,0,0
1668531055740,CSE 219,A00,106111,Dow; Steven P,0,6,20,20
1668531056164,CSE 221,A00,102376,Voelker; Geoffrey M.,0,73,0,0
1668531056601,CSE 224,A01,102378,Porter; George M,0,167,0,0
1668531057027,CSE 229A,A00,102379,Savage; Stefan,0,10,0,0
1668531057463,CSE 229C,A00,102380,Munyaka; Imani N. S.,0,10,0,0
1668531057888,CSE 232B,A00,102382,Deutsch; Alin Bernard,0,33,0,0
1668531058311,CSE 234,A01,112904,Kumar; Arun Kumar,0,0,0,0
1668531058737,CSE 237A,A00,102383,Rosing; Tajana Simunic,0,55,0,0
1668531059160,CSE 239A,A00,102384,Deutsch; Alin Bernard,0,14,0,0
1668531059588,CSE 239B,A00,102385,Polikarpova; Nadezhda,0,10,0,0
1668531060016,CSE 240A,A00,102386,Pannuto; Patrick William,0,46,0,0
1668531060441,CSE 240B,A00,102387,Zhao; Jishen,0,47,0,0
1668531060877,CSE 241A,A00,106406,Kang; Mingu,0,9,0,0
1668531061312,CSE 249B,A00,102388,Kahng; Andrew Byun,0,5,8,8
1668531061744,CSE 251B,A01,102392,Cottrell; Garrison W,0,51,0,0
1668531061744,CSE 251B,A02,102393,Cottrell; Garrison W,0,34,0,0
1668531062178,CSE 252B,A00,102394,Ochoa; Benjamin Lawrence,0,59,0,0
1668531062605,CSE 257,A01,102396,Gao; Sicun,0,139,0,0
1668531063029,CSE 272,A00,102397,Li; Tzumao,0,19,0,0
1668531063458,CSE 274,A00,111323,Chern; Albert Ren-Haur,0,15,0,0
1668531063880,CSE 282,A00,102398,Pevzner; Pavel Arkadjevich,0,0,0,0
1668531064311,CSE 284,A00,114175,Gymrek; Melissa Ann,0,22,0,0
1668531064742,CSE 290,A00,102399,Chandraker; Manmohan Krishna,0,11,0,0
1668531064742,CSE 290,B00,102400,Vaccaro; Kristen Marie,0,7,25,25
1668531064742,CSE 290,C00,102414,Pannuto; Patrick William,0,1,25,25
1668531064742,CSE 290,D00,102427,Pevzner; Pavel Arkadjevich,0,0,0,0
1668531064742,CSE 290,E00,102429,Zhao; Jishen,0,4,0,0
1668531064742,CSE 290,F00,102436,Tullsen; Dean Michael,0,5,0,0
1668531064742,CSE 290,G00,102440,Christensen; Henrik I,0,6,20,20
1668531065174,CSE 291,A00,102443,Su; Hao,0,0,0,0
1668531065174,CSE 291,B00,102448,Polikarpova; Nadezhda,0,0,0,0
1668531065174,CSE 291,C00,102453,Vaccaro; Kristen Marie,0,0,0,0
1668531065174,CSE 291,D00,111343,Savage; Stefan,0,0,0,0
1668531065174,CSE 291,E00,116474,Claffy; Kimberly Claire,0,0,0,0
1668531065174,CSE 291,F00,116479,Pasquale; Joseph,0,0,0,0
1668531065603,CSE 293,001,119111,Bafna; Vineet,9999,0,9999,0
1668531065603,CSE 293,002,119118,Bellare; Mihir,9999,0,9999,0
1668531065603,CSE 293,003,119122,Berg-Kirkpatrick; Taylor D,9999,0,9999,0
1668531065603,CSE 293,004,119135,Christensen; Henrik I,9999,0,9999,0
1668531065603,CSE 293,005,119142,Cottrell; Garrison W,9999,0,9999,0
1668531065603,CSE 293,006,119146,Deutsch; Alin Bernard,9999,0,9999,0
1668531065603,CSE 293,007,119159,Esmaeilzadeh; Hadi,9999,0,9999,0
1668531065603,CSE 293,008,119166,Freund; Yoav,9999,0,9999,0
1668531065603,CSE 293,009,119170,Griswold; William G.,9999,0,9999,0
1668531065603,CSE 293,010,119183,Gymrek; Melissa Ann,9999,0,9999,0
1668531065603,CSE 293,011,119190,Heninger; Nadia A,9999,0,9999,0
1668531065603,CSE 293,012,119230,Impagliazzo; Russell,9999,0,9999,0
1668531065603,CSE 293,013,119232,Jhala; Ranjit,9999,0,9999,0
1668531065603,CSE 293,014,119233,Kahng; Andrew Byun,9999,0,9999,0
1668531065603,CSE 293,015,119298,Kane; Daniel Mertz,9999,0,9999,0
1668531065603,CSE 293,016,119299,Kriegman; David J,9999,0,9999,0
1668531065603,CSE 293,017,119300,Kumar; Arun Kumar,9999,0,9999,0
1668531065603,CSE 293,018,119301,Lerner; Sorin,9999,0,9999,0
1668531065603,CSE 293,019,119302,Lovett; Shachar,9999,0,9999,0
1668531065603,CSE 293,020,119303,McAuley; Julian John,9999,0,9999,0
1668531065603,CSE 293,021,119304,Micciancio; Daniele,9999,0,9999,0
1668531065603,CSE 293,022,119367,Orailoglu; Alex,9999,0,9999,0
1668531065603,CSE 293,023,119382,Paturi; Ramamohan,9999,0,9999,0
1668531065603,CSE 293,024,119404,Polikarpova; Nadezhda,9999,0,9999,0
1668531065603,CSE 293,025,119406,Politz; Joseph Gibbs,9999,0,9999,0
1668531065603,CSE 293,026,119411,Porter; George M,9999,0,9999,0
1668531065603,CSE 293,027,119414,Porter; Leonard Emerson,9999,0,9999,0
1668531065603,CSE 293,028,119416,Ramamoorthi; Ravi,9999,0,9999,0
1668531065603,CSE 293,029,119417,Sahoo; Debashis,9999,0,9999,0
1668531065603,CSE 293,030,119420,Saul; Lawrence,9999,0,9999,0
1668531065603,CSE 293,031,119421,Savage; Stefan,9999,0,9999,0
1668531065603,CSE 293,032,119425,Schulze; Jurgen P.,9999,0,9999,0
1668531065603,CSE 293,033,119426,Snoeren; Alex C.,9999,0,9999,0
1668531065603,CSE 293,034,119428,Shang; Jingbo,9999,0,9999,0
1668531065603,CSE 293,035,119430,Stefan; Deian,9999,0,9999,0
1668531065603,CSE 293,036,119431,Su; Hao,9999,0,9999,0
1668531065603,CSE 293,037,119433,Swanson; Steven James,9999,0,9999,0
1668531065603,CSE 293,038,119435,Tullsen; Dean Michael,9999,0,9999,0
1668531065603,CSE 293,039,119483,Voelker; Geoffrey M.,9999,0,9999,0
1668531065603,CSE 293,040,119537,Zhao; Jishen,9999,0,9999,0
1668531065603,CSE 293,041,119538,Zhou; Yuan-Yuan,9999,0,9999,0
1668531065603,CSE 293,042,119539,Gao; Sicun,9999,0,9999,0
1668531065603,CSE 293,043,119540,Weibel; Nadir,9999,0,9999,0
1668531065603,CSE 293,044,119541,Gupta; Rajesh K.,9999,0,9999,0
1668531065603,CSE 293,045,126410,Vaccaro; Kristen Marie,9999,0,9999,0
1668531065603,CSE 293,046,126411,Klemke; Richard,9999,0,9999,0
1668531066039,CSE 294,A00,102459,Voelker; Geoffrey M.,0,2,0,0
1668531066039,CSE 294,B00,111322,Orailoglu; Alex,0,2,0,0
1668531066463,DSE 201,A00,096914,Deutsch; Alin Bernard,30,0,30,0
1668531066970,DSE 210,A00,096915,Dasgupta; Sanjoy,30,0,30,0
1668531067395,DSE 260A,A00,096916,Altintas De Callaf; Ilkay,30,0,30,0
1668531067848,ECE 200,001,103586,Antipa; Nicholas A,9999,0,9999,0
1668531067848,ECE 200,002,103587,Atanasov; Nikolay A.,9999,0,9999,0
1668531067848,ECE 200,003,103588,Bharadia; Dinesh,9999,0,9999,0
1668531067848,ECE 200,004,103589,Cheng; Chung Kuan,9999,0,9999,0
1668531067848,ECE 200,005,103590,Cosman; Pamela C.,9999,0,9999,0
1668531067848,ECE 200,006,103591,Dayeh; Shadi Ahmad,9999,0,9999,0
1668531067848,ECE 200,007,103592,Fainman; Yeshaiahu,9999,0,9999,0
1668531067848,ECE 200,008,103593,Ford; Joseph Earl,9999,0,9999,0
1668531067848,ECE 200,009,103594,Franceschetti; Massimo,9999,0,9999,0
1668531067848,ECE 200,010,103595,Fullerton; Eric E,9999,0,9999,0
1668531067848,ECE 200,011,103596,Galton; Ian A,9999,0,9999,0
1668531067848,ECE 200,012,103597,Gilja; Vikash,9999,0,9999,0
1668531067848,ECE 200,013,103598,Hall; Drew A.,9999,0,9999,0
1668531067848,ECE 200,014,103599,Hsueh; Tzu-Chien,9999,0,9999,0
1668531067848,ECE 200,015,103600,Javidi; Tara,9999,0,9999,0
1668531067848,ECE 200,016,103601,Kahng; Andrew Byun,9999,0,9999,0
1668531067848,ECE 200,017,103602,Kim; Young-Han,9999,0,9999,0
1668531067848,ECE 200,018,103603,Koushanfar; Farinaz,9999,0,9999,0
1668531067848,ECE 200,019,103604,Kuzum; Duygu,9999,0,9999,0
1668531067848,ECE 200,020,103605,Le; Hanh-Phuc,9999,0,9999,0
1668531067848,ECE 200,021,103606,Lin; Bill,9999,0,9999,0
1668531067848,ECE 200,022,103607,Liu; Zhaowei,9998,0,9999,1
1668531067848,ECE 200,023,103608,Lo; Yu-Hwa,9999,0,9999,0
1668531067848,ECE 200,024,103609,Lomakin; Vitaliy,9999,0,9999,0
1668531067848,ECE 200,025,103610,Mercier; Patrick Philip,9999,0,9999,0
1668531067848,ECE 200,026,103611,Meyer; Florian,9999,0,9999,0
1668531067848,ECE 200,027,103612,Milstein; Laurence B.,9999,0,9999,0
1668531067848,ECE 200,028,103613,Mir Arabbaygi; Siavash,9999,0,9999,0
1668531067848,ECE 200,029,103614,Mookherjea; Shayan,9999,0,9999,0
1668531067848,ECE 200,030,103615,Morris; Karcher William,9999,0,9999,0
1668531067848,ECE 200,031,103616,Ng; Tse Nga,9999,0,9999,0
1668531067848,ECE 200,032,103617,Nguyen; Truong Quang,9999,0,9999,0
1668531067848,ECE 200,033,103618,Nomura; Kenji,9999,0,9999,0
1668531067848,ECE 200,034,103619,Orlitsky; Alon,9999,0,9999,0
1668531067848,ECE 200,035,103620,Pal; Piya,9999,0,9999,0
1668531067848,ECE 200,036,103621,Papen; George C.,9999,0,9999,0
1668531067848,ECE 200,037,103622,Radic; Stojan,9999,0,9999,0
1668531067848,ECE 200,038,103623,Rao; Bhaskar D.,9999,0,9999,0
1668531067848,ECE 200,039,103624,Rao; Ramesh R,9999,0,9999,0
1668531067848,ECE 200,040,103625,Rebeiz; Gabriel,9999,0,9999,0
1668531067848,ECE 200,041,103626,Sanford; John R,9999,0,9999,0
1668531067848,ECE 200,042,103627,Siegel; Paul H.,9999,0,9999,0
1668531067848,ECE 200,043,103628,Sievenpiper; Daniel F.,9999,0,9999,0
1668531067848,ECE 200,044,103629,Sworder; David D.,9999,0,9999,0
1668531067848,ECE 200,045,103630,Taur; Yuan,9999,0,9999,0
1668531067848,ECE 200,046,103631,Touri; Behrouz,9999,0,9999,0
1668531067848,ECE 200,047,103632,Trivedi; Mohan M.,9999,0,9999,0
1668531067848,ECE 200,048,103633,Vasconcelos; Nuno,9999,0,9999,0
1668531067848,ECE 200,049,103634,Wang; Xiaolong,9999,0,9999,0
1668531067848,ECE 200,050,103635,Xie; Pengtao,9999,0,9999,0
1668531067848,ECE 200,051,103636,Yip; Michael,9999,0,9999,0
1668531067848,ECE 200,052,103637,Zeger; Kenneth A.,999,0,999,0
1668531067848,ECE 200,053,103638,Zhang; Xinyu,9999,0,9999,0
1668531067848,ECE 200,054,103639,Turakhia; Yatish Girish,9999,0,9999,0
1668531067848,ECE 200,055,103640,Kang; Mingu,9999,0,9999,0
1668531067848,ECE 200,056,103641,Shi; Yuanyuan,9999,0,9999,0
1668531067848,ECE 200,057,103642,Wang; Edward Jay,9999,0,9999,0
1668531067848,ECE 200,058,103643,Zheng; Yang,9999,0,9999,0
1668531068270,ECE 202,A00,103644,Kuzum; Duygu,0,44,0,0
1668531068710,ECE 212BN,A00,103646,Ng; Tse Nga,0,9,0,0
1668531069139,ECE 221,A00,111493,Staff,0,0,0,0
1668531069567,ECE 222B,A00,103647,Lomakin; Vitaliy,0,20,0,0
1668531069990,ECE 230B,A00,103648,Taur; Yuan,0,3,0,0
1668531070417,ECE 238B,A00,103649,Garay; Javier,0,0,0,0
1668531070841,ECE 240B,A00,112900,Fainman; Yeshaiahu,0,7,0,0
1668531071270,ECE 247A,A00,103650,Jokerst; Jesse Vincent,0,6,0,0
1668531071706,ECE 247B,A00,103651,Wang; Joseph,0,14,0,0
1668531072132,ECE 250,A00,103652,Siegel; Paul H.,0,82,0,0
1668531072556,ECE 251A,A00,103654,Rao; Bhaskar D.,0,62,0,0
1668531072982,ECE 257B,A00,103655,Bharadia; Dinesh,0,33,0,0
1668531073404,ECE 258A,A00,103656,Milstein; Laurence B.,0,29,0,0
1668531073835,ECE 260B,A00,103658,Kang; Mingu,0,120,0,0
1668531074258,ECE 264A,A00,103659,Galton; Ian A,0,67,0,0
1668531074681,ECE 265A,A00,103661,Gudem; Prasad S.S.,0,71,0,0
1668531075120,ECE 265D,A00,103662,Gudem; Prasad S.S.,0,26,0,0
1668531075548,ECE 268,A00,103663,Koushanfar; Farinaz,0,43,0,0
1668531075974,ECE 269,A01,103665,Pal; Piya,0,216,0,0
1668531076397,ECE 271B,A00,103666,Vasconcelos; Manuela,0,76,0,0
1668531076824,ECE 276A,A00,103667,Atanasov; Nikolay A.,0,127,0,0
1668531077253,ECE 277,A00,103668,An; Cheolhong,0,149,0,0
1668531077679,ECE 279,A00,117947,Hall; Drew A.,0,22,0,0
1668531078527,ECE 283,A00,103670,Hsueh; Tzu-Chien,0,55,0,0
1668531078951,ECE 284,A00,103671,Turakhia; Yatish Girish,0,39,0,0
1668531079386,ECE 285,A00,103672,Zheng; Yang,0,40,0,0
1668531079386,ECE 285,B00,103673,Sworder; David D.,0,57,0,0
1668531079819,ECE 287,A00,103676,Javidi; Tara,0,9,0,0
1668531080241,MATH 200B,A00,098023,Salehi Golsefidy; Alireza,10,0,15,5
1668531080662,MATH 202B,A00,098024,Rhoades; Brendon Patrick,7,0,15,8
1668531081086,MATH 203B,A00,098025,Oprea; Dragos N.,9,0,15,6
1668531081521,MATH 204B,A00,098026,Sorensen; Claus M,13,0,15,2
1668531081946,MATH 208,A00,098027,Izadi; Elham,7,0,10,3
1668531082377,MATH 209,A00,098028,Pollack; Aaron,10,0,10,0
1668531082801,MATH 211A,A00,112919,Rogalski; Daniel,8,0,10,2
1668531083226,MATH 211B,A00,112920,Seward; Brandon M.,9,0,10,1
1668531083654,MATH 218,A00,098029,Li; Bo,10,0,10,0
1668531084087,MATH 220B,A00,098030,Novak; Jonathan I,11,0,15,4
1668531084517,MATH 221A,A00,098031,Ebenfelt; Peter F,12,0,15,3
1668531084941,MATH 231B,A00,098032,Zlatos; Andrej,11,0,15,4
1668531085369,MATH 240B,A00,098033,Ni; Lei,7,0,15,8
1668531085806,MATH 243,A00,098034,Jekel; David Andrew,10,0,10,0
1668531086231,MATH 245A,A00,098035,Nie; Jiawang,0,5,15,18
1668531086655,MATH 248,A00,098036,Bejenaru; Ioan,10,0,10,0
1668531087082,MATH 250B,A00,098037,Spolaor; Luca,14,0,15,1
1668531087515,MATH 258,A00,098038,Ni; Lei,9,0,10,1
1668531087937,MATH 264B,A00,098041,Rhoades; Brendon Patrick,8,0,15,7
1668531088361,MATH 268,A00,098042,Buss; Samuel R,10,0,10,0
1668531088808,MATH 269,A00,098043,Rhoades; Brendon Patrick,10,0,10,0
1668531089251,MATH 270B,A00,098044,Li; Bo,6,0,15,9
1668531089686,MATH 272B,A00,098045,Holst; Michael J,13,0,15,2
1668531090112,MATH 273A,A00,098046,Tian; Xiaochuan,10,0,15,5
1668531090534,MATH 275,A01,098048,Tian; Xiaochuan,6,0,10,4
1668531090960,MATH 278A,A00,098049,Holst; Michael J,7,0,10,3
1668531091382,MATH 278B,A00,098050,Cloninger; Alexander,10,0,10,0
1668531091814,MATH 278C,A00,098051,Nie; Jiawang,5,0,10,5
1668531092244,MATH 280B,A00,098052,Zheng; Tianyi,7,0,15,8
1668531092671,MATH 281B,A00,098053,Bradic; Jelena,0,2,15,15
1668531093094,MATH 282B,A00,098054,Arias-Castro; Ery,0,1,15,15
1668531093520,MATH 285,A00,098055,Fitzsimmons; Patrick J,0,3,15,17
1668531093943,MATH 287B,A00,098056,Arias-Castro; Ery,1,0,15,14
1668531094382,MATH 288,A00,098057,Agarwal; Pooja,9,0,10,1
1668531094382,MATH 288,B00,098058,Zhang; Danna,8,0,10,2
1668531094382,MATH 288,C00,098059,Williams; Ruth J,9,0,10,1
1668531094807,MATH 290B,A00,098060,Roberts; Justin Deritter,12,0,15,3
1668531095245,MATH 292,A00,098061,Belmont; Eva Kinoshita,10,0,10,0
1668531095666,MATH 295,A00,098062,Suk; Andrew Hoon,47,0,50,3
1668531096099,MATH 296,A00,098063,Novak; Jonathan I,20,0,20,0
1668531096537,MATH 297,001,098064,Gamst; Anthony Collins,9997,0,9999,2
1668531600399,COGS 205,A00,101395,Chiba; Andrea,19,0,20,1
1668531600830,COGS 210B,001,101404,Greene; Deanna Jacquelyn,9998,0,9999,1
1668531600830,COGS 210B,002,101417,Xia; Haijun,9999,0,9999,0
1668531600830,COGS 210B,003,101422,Nitz; Douglas A.,9999,0,9999,0
1668531600830,COGS 210B,004,101423,Hollan; James D.,9998,0,9999,1
1668531600830,COGS 210B,005,101424,Deak; Gedeon O.,9998,0,9999,1
1668531600830,COGS 210B,006,101425,Rossano; Federico,9999,0,9999,0
1668531601253,COGS 211B,A00,101427,Coulson; Seana M,9996,0,9999,3
1668531601681,COGS 220,A00,101428,Hollan; James D.,0,10,25,25
1668531602104,COGS 229,A00,101429,Dow; Steven P,17,0,25,8
1668531602540,COGS 230,A00,101430,Klemmer; Scott R,7,0,17,10
1668531602964,COGS 234,A00,101431,Xia; Haijun,1,0,25,24
1668531603399,COGS 260,A00,101432,Kiyonaga; Anastasia,21,0,25,4
1668531603399,COGS 260,B00,101433,Kirsh; David Joel,15,0,25,10
1668531603832,CSE 202,A00,102371,Impagliazzo; Russell,0,66,0,0
1668531604268,CSE 203B,A01,102373,Cheng; Chung Kuan,0,59,0,0
1668531604735,CSE 208,A00,102374,Micciancio; Daniele,0,5,0,0
1668531605162,CSE 209A,A00,112895,Impagliazzo; Russell,0,12,15,15
1668531605591,CSE 209B,A00,108005,Bellare; Mihir,0,7,0,0
1668531606018,CSE 210,A00,113163,Coblenz; Michael J,0,85,0,0
1668531606443,CSE 219,A00,106111,Dow; Steven P,0,6,20,20
1668531606866,CSE 221,A00,102376,Voelker; Geoffrey M.,0,73,0,0
1668531607293,CSE 224,A01,102378,Porter; George M,0,167,0,0
1668531607726,CSE 229A,A00,102379,Savage; Stefan,0,10,0,0
1668531608150,CSE 229C,A00,102380,Munyaka; Imani N. S.,0,10,0,0
1668531608581,CSE 232B,A00,102382,Deutsch; Alin Bernard,0,33,0,0
1668531609018,CSE 234,A01,112904,Kumar; Arun Kumar,0,0,0,0
1668531609441,CSE 237A,A00,102383,Rosing; Tajana Simunic,0,55,0,0
1668531609864,CSE 239A,A00,102384,Deutsch; Alin Bernard,0,14,0,0
1668531610303,CSE 239B,A00,102385,Polikarpova; Nadezhda,0,10,0,0
1668531610774,CSE 240A,A00,102386,Pannuto; Patrick William,0,46,0,0
1668531611206,CSE 240B,A00,102387,Zhao; Jishen,0,47,0,0
1668531611629,CSE 241A,A00,106406,Kang; Mingu,0,9,0,0
1668531612055,CSE 249B,A00,102388,Kahng; Andrew Byun,0,5,8,8
1668531612480,CSE 251B,A01,102392,Cottrell; Garrison W,0,51,0,0
1668531612480,CSE 251B,A02,102393,Cottrell; Garrison W,0,34,0,0
1668531612917,CSE 252B,A00,102394,Ochoa; Benjamin Lawrence,0,59,0,0
1668531613341,CSE 257,A01,102396,Gao; Sicun,0,139,0,0
1668531613771,CSE 272,A00,102397,Li; Tzumao,0,19,0,0
1668531614209,CSE 274,A00,111323,Chern; Albert Ren-Haur,0,15,0,0
1668531614631,CSE 282,A00,102398,Pevzner; Pavel Arkadjevich,0,0,0,0
1668531615068,CSE 284,A00,114175,Gymrek; Melissa Ann,0,22,0,0
1668531615491,CSE 290,A00,102399,Chandraker; Manmohan Krishna,0,11,0,0
1668531615491,CSE 290,B00,102400,Vaccaro; Kristen Marie,0,7,25,25
1668531615491,CSE 290,C00,102414,Pannuto; Patrick William,0,1,25,25
1668531615491,CSE 290,D00,102427,Pevzner; Pavel Arkadjevich,0,0,0,0
1668531615491,CSE 290,E00,102429,Zhao; Jishen,0,4,0,0
1668531615491,CSE 290,F00,102436,Tullsen; Dean Michael,0,5,0,0
1668531615491,CSE 290,G00,102440,Christensen; Henrik I,0,6,20,20
1668531615926,CSE 291,A00,102443,Su; Hao,0,0,0,0
1668531615926,CSE 291,B00,102448,Polikarpova; Nadezhda,0,0,0,0
1668531615926,CSE 291,C00,102453,Vaccaro; Kristen Marie,0,0,0,0
1668531615926,CSE 291,D00,111343,Savage; Stefan,0,0,0,0
1668531615926,CSE 291,E00,116474,Claffy; Kimberly Claire,0,0,0,0
1668531615926,CSE 291,F00,116479,Pasquale; Joseph,0,0,0,0
1668531616371,CSE 293,001,119111,Bafna; Vineet,9999,0,9999,0
1668531616371,CSE 293,002,119118,Bellare; Mihir,9999,0,9999,0
1668531616371,CSE 293,003,119122,Berg-Kirkpatrick; Taylor D,9999,0,9999,0
1668531616371,CSE 293,004,119135,Christensen; Henrik I,9999,0,9999,0
1668531616371,CSE 293,005,119142,Cottrell; Garrison W,9999,0,9999,0
1668531616371,CSE 293,006,119146,Deutsch; Alin Bernard,9999,0,9999,0
1668531616371,CSE 293,007,119159,Esmaeilzadeh; Hadi,9999,0,9999,0
1668531616371,CSE 293,008,119166,Freund; Yoav,9999,0,9999,0
1668531616371,CSE 293,009,119170,Griswold; William G.,9999,0,9999,0
1668531616371,CSE 293,010,119183,Gymrek; Melissa Ann,9999,0,9999,0
1668531616371,CSE 293,011,119190,Heninger; Nadia A,9999,0,9999,0
1668531616371,CSE 293,012,119230,Impagliazzo; Russell,9999,0,9999,0
1668531616371,CSE 293,013,119232,Jhala; Ranjit,9999,0,9999,0
1668531616371,CSE 293,014,119233,Kahng; Andrew Byun,9999,0,9999,0
1668531616371,CSE 293,015,119298,Kane; Daniel Mertz,9999,0,9999,0
1668531616371,CSE 293,016,119299,Kriegman; David J,9999,0,9999,0
1668531616371,CSE 293,017,119300,Kumar; Arun Kumar,9999,0,9999,0
1668531616371,CSE 293,018,119301,Lerner; Sorin,9999,0,9999,0
1668531616371,CSE 293,019,119302,Lovett; Shachar,9999,0,9999,0
1668531616371,CSE 293,020,119303,McAuley; Julian John,9999,0,9999,0
1668531616371,CSE 293,021,119304,Micciancio; Daniele,9999,0,9999,0
1668531616371,CSE 293,022,119367,Orailoglu; Alex,9999,0,9999,0
1668531616371,CSE 293,023,119382,Paturi; Ramamohan,9999,0,9999,0
1668531616371,CSE 293,024,119404,Polikarpova; Nadezhda,9999,0,9999,0
1668531616371,CSE 293,025,119406,Politz; Joseph Gibbs,9999,0,9999,0
1668531616371,CSE 293,026,119411,Porter; George M,9999,0,9999,0
1668531616371,CSE 293,027,119414,Porter; Leonard Emerson,9999,0,9999,0
1668531616371,CSE 293,028,119416,Ramamoorthi; Ravi,9999,0,9999,0
1668531616371,CSE 293,029,119417,Sahoo; Debashis,9999,0,9999,0
1668531616371,CSE 293,030,119420,Saul; Lawrence,9999,0,9999,0
1668531616371,CSE 293,031,119421,Savage; Stefan,9999,0,9999,0
1668531616371,CSE 293,032,119425,Schulze; Jurgen P.,9999,0,9999,0
1668531616371,CSE 293,033,119426,Snoeren; Alex C.,9999,0,9999,0
1668531616371,CSE 293,034,119428,Shang; Jingbo,9999,0,9999,0
1668531616371,CSE 293,035,119430,Stefan; Deian,9999,0,9999,0
1668531616371,CSE 293,036,119431,Su; Hao,9999,0,9999,0
1668531616371,CSE 293,037,119433,Swanson; Steven James,9999,0,9999,0
1668531616371,CSE 293,038,119435,Tullsen; Dean Michael,9999,0,9999,0
1668531616371,CSE 293,039,119483,Voelker; Geoffrey M.,9999,0,9999,0
1668531616371,CSE 293,040,119537,Zhao; Jishen,9999,0,9999,0
1668531616371,CSE 293,041,119538,Zhou; Yuan-Yuan,9999,0,9999,0
1668531616371,CSE 293,042,119539,Gao; Sicun,9999,0,9999,0
1668531616371,CSE 293,043,119540,Weibel; Nadir,9999,0,9999,0
1668531616371,CSE 293,044,119541,Gupta; Rajesh K.,9999,0,9999,0
1668531616371,CSE 293,045,126410,Vaccaro; Kristen Marie,9999,0,9999,0
1668531616371,CSE 293,046,126411,Klemke; Richard,9999,0,9999,0
1668531616795,CSE 294,A00,102459,Voelker; Geoffrey M.,0,2,0,0
1668531616795,CSE 294,B00,111322,Orailoglu; Alex,0,2,0,0
1668531617223,DSE 201,A00,096914,Deutsch; Alin Bernard,30,0,30,0
1668531617658,DSE 210,A00,096915,Dasgupta; Sanjoy,30,0,30,0
1668531618089,DSE 260A,A00,096916,Altintas De Callaf; Ilkay,30,0,30,0
1668531618551,ECE 200,001,103586,Antipa; Nicholas A,9999,0,9999,0
1668531618551,ECE 200,002,103587,Atanasov; Nikolay A.,9999,0,9999,0
1668531618551,ECE 200,003,103588,Bharadia; Dinesh,9999,0,9999,0
1668531618551,ECE 200,004,103589,Cheng; Chung Kuan,9999,0,9999,0
1668531618551,ECE 200,005,103590,Cosman; Pamela C.,9999,0,9999,0
1668531618551,ECE 200,006,103591,Dayeh; Shadi Ahmad,9999,0,9999,0
1668531618551,ECE 200,007,103592,Fainman; Yeshaiahu,9999,0,9999,0
1668531618551,ECE 200,008,103593,Ford; Joseph Earl,9999,0,9999,0
1668531618551,ECE 200,009,103594,Franceschetti; Massimo,9999,0,9999,0
1668531618551,ECE 200,010,103595,Fullerton; Eric E,9999,0,9999,0
1668531618551,ECE 200,011,103596,Galton; Ian A,9999,0,9999,0
1668531618551,ECE 200,012,103597,Gilja; Vikash,9999,0,9999,0
1668531618551,ECE 200,013,103598,Hall; Drew A.,9999,0,9999,0
1668531618551,ECE 200,014,103599,Hsueh; Tzu-Chien,9999,0,9999,0
1668531618551,ECE 200,015,103600,Javidi; Tara,9999,0,9999,0
1668531618551,ECE 200,016,103601,Kahng; Andrew Byun,9999,0,9999,0
1668531618551,ECE 200,017,103602,Kim; Young-Han,9999,0,9999,0
1668531618551,ECE 200,018,103603,Koushanfar; Farinaz,9999,0,9999,0
1668531618551,ECE 200,019,103604,Kuzum; Duygu,9999,0,9999,0
1668531618551,ECE 200,020,103605,Le; Hanh-Phuc,9999,0,9999,0
1668531618551,ECE 200,021,103606,Lin; Bill,9999,0,9999,0
1668531618551,ECE 200,022,103607,Liu; Zhaowei,9998,0,9999,1
1668531618551,ECE 200,023,103608,Lo; Yu-Hwa,9999,0,9999,0
1668531618551,ECE 200,024,103609,Lomakin; Vitaliy,9999,0,9999,0
1668531618551,ECE 200,025,103610,Mercier; Patrick Philip,9999,0,9999,0
1668531618551,ECE 200,026,103611,Meyer; Florian,9999,0,9999,0
1668531618551,ECE 200,027,103612,Milstein; Laurence B.,9999,0,9999,0
1668531618551,ECE 200,028,103613,Mir Arabbaygi; Siavash,9999,0,9999,0
1668531618551,ECE 200,029,103614,Mookherjea; Shayan,9999,0,9999,0
1668531618551,ECE 200,030,103615,Morris; Karcher William,9999,0,9999,0
1668531618551,ECE 200,031,103616,Ng; Tse Nga,9999,0,9999,0
1668531618551,ECE 200,032,103617,Nguyen; Truong Quang,9999,0,9999,0
1668531618551,ECE 200,033,103618,Nomura; Kenji,9999,0,9999,0
1668531618551,ECE 200,034,103619,Orlitsky; Alon,9999,0,9999,0
1668531618551,ECE 200,035,103620,Pal; Piya,9999,0,9999,0
1668531618551,ECE 200,036,103621,Papen; George C.,9999,0,9999,0
1668531618551,ECE 200,037,103622,Radic; Stojan,9999,0,9999,0
1668531618551,ECE 200,038,103623,Rao; Bhaskar D.,9999,0,9999,0
1668531618551,ECE 200,039,103624,Rao; Ramesh R,9999,0,9999,0
1668531618551,ECE 200,040,103625,Rebeiz; Gabriel,9999,0,9999,0
1668531618551,ECE 200,041,103626,Sanford; John R,9999,0,9999,0
1668531618551,ECE 200,042,103627,Siegel; Paul H.,9999,0,9999,0
1668531618551,ECE 200,043,103628,Sievenpiper; Daniel F.,9999,0,9999,0
1668531618551,ECE 200,044,103629,Sworder; David D.,9999,0,9999,0
1668531618551,ECE 200,045,103630,Taur; Yuan,9999,0,9999,0
1668531618551,ECE 200,046,103631,Touri; Behrouz,9999,0,9999,0
1668531618551,ECE 200,047,103632,Trivedi; Mohan M.,9999,0,9999,0
1668531618551,ECE 200,048,103633,Vasconcelos; Nuno,9999,0,9999,0
1668531618551,ECE 200,049,103634,Wang; Xiaolong,9999,0,9999,0
1668531618551,ECE 200,050,103635,Xie; Pengtao,9999,0,9999,0
1668531618551,ECE 200,051,103636,Yip; Michael,9999,0,9999,0
1668531618551,ECE 200,052,103637,Zeger; Kenneth A.,999,0,999,0
1668531618551,ECE 200,053,103638,Zhang; Xinyu,9999,0,9999,0
1668531618551,ECE 200,054,103639,Turakhia; Yatish Girish,9999,0,9999,0
1668531618551,ECE 200,055,103640,Kang; Mingu,9999,0,9999,0
1668531618551,ECE 200,056,103641,Shi; Yuanyuan,9999,0,9999,0
1668531618551,ECE 200,057,103642,Wang; Edward Jay,9999,0,9999,0
1668531618551,ECE 200,058,103643,Zheng; Yang,9999,0,9999,0
1668531618978,ECE 202,A00,103644,Kuzum; Duygu,0,44,0,0
1668531619408,ECE 212BN,A00,103646,Ng; Tse Nga,0,9,0,0
1668531619838,ECE 221,A00,111493,Staff,0,0,0,0
1668531620262,ECE 222B,A00,103647,Lomakin; Vitaliy,0,20,0,0
1668531620686,ECE 230B,A00,103648,Taur; Yuan,0,3,0,0
1668531621108,ECE 238B,A00,103649,Garay; Javier,0,0,0,0
1668531621537,ECE 240B,A00,112900,Fainman; Yeshaiahu,0,7,0,0
1668531621962,ECE 247A,A00,103650,Jokerst; Jesse Vincent,0,6,0,0
1668531622403,ECE 247B,A00,103651,Wang; Joseph,0,14,0,0
1668531622850,ECE 250,A00,103652,Siegel; Paul H.,0,82,0,0
1668531623293,ECE 251A,A00,103654,Rao; Bhaskar D.,0,62,0,0
1668531623717,ECE 257B,A00,103655,Bharadia; Dinesh,0,33,0,0
1668531624144,ECE 258A,A00,103656,Milstein; Laurence B.,0,29,0,0
1668531624572,ECE 260B,A00,103658,Kang; Mingu,0,120,0,0
1668531624998,ECE 264A,A00,103659,Galton; Ian A,0,67,0,0
1668531625436,ECE 265A,A00,103661,Gudem; Prasad S.S.,0,71,0,0
1668531625866,ECE 265D,A00,103662,Gudem; Prasad S.S.,0,26,0,0
1668531626294,ECE 268,A00,103663,Koushanfar; Farinaz,0,43,0,0
1668531626717,ECE 269,A01,103665,Pal; Piya,0,216,0,0
1668531627154,ECE 271B,A00,103666,Vasconcelos; Manuela,0,76,0,0
1668531627592,ECE 276A,A00,103667,Atanasov; Nikolay A.,0,127,0,0
1668531628017,ECE 277,A00,103668,An; Cheolhong,0,149,0,0
1668531628450,ECE 279,A00,117947,Hall; Drew A.,0,22,0,0
1668531629305,ECE 283,A00,103670,Hsueh; Tzu-Chien,0,55,0,0
1668531629727,ECE 284,A00,103671,Turakhia; Yatish Girish,0,39,0,0
1668531630170,ECE 285,A00,103672,Zheng; Yang,0,40,0,0
1668531630170,ECE 285,B00,103673,Sworder; David D.,0,57,0,0
1668531630593,ECE 287,A00,103676,Javidi; Tara,0,9,0,0
1668531631017,MATH 200B,A00,098023,Salehi Golsefidy; Alireza,10,0,15,5
1668531631444,MATH 202B,A00,098024,Rhoades; Brendon Patrick,7,0,15,8
1668531631867,MATH 203B,A00,098025,Oprea; Dragos N.,9,0,15,6
1668531632289,MATH 204B,A00,098026,Sorensen; Claus M,13,0,15,2
1668531632713,MATH 208,A00,098027,Izadi; Elham,7,0,10,3
1668531633235,MATH 209,A00,098028,Pollack; Aaron,10,0,10,0
1668531633672,MATH 211A,A00,112919,Rogalski; Daniel,8,0,10,2
1668531634101,MATH 211B,A00,112920,Seward; Brandon M.,9,0,10,1
1668531634530,MATH 218,A00,098029,Li; Bo,10,0,10,0
1668531634958,MATH 220B,A00,098030,Novak; Jonathan I,11,0,15,4
1668531635381,MATH 221A,A00,098031,Ebenfelt; Peter F,12,0,15,3
1668531635809,MATH 231B,A00,098032,Zlatos; Andrej,11,0,15,4
1668531636233,MATH 240B,A00,098033,Ni; Lei,7,0,15,8
1668531636665,MATH 243,A00,098034,Jekel; David Andrew,10,0,10,0
1668531637087,MATH 245A,A00,098035,Nie; Jiawang,0,5,15,18
1668531637514,MATH 248,A00,098036,Bejenaru; Ioan,10,0,10,0
1668531637948,MATH 250B,A00,098037,Spolaor; Luca,14,0,15,1
1668531638374,MATH 258,A00,098038,Ni; Lei,9,0,10,1
1668531638798,MATH 264B,A00,098041,Rhoades; Brendon Patrick,8,0,15,7
1668531639222,MATH 268,A00,098042,Buss; Samuel R,10,0,10,0
1668531639659,MATH 269,A00,098043,Rhoades; Brendon Patrick,10,0,10,0
1668531640094,MATH 270B,A00,098044,Li; Bo,6,0,15,9
1668531640523,MATH 272B,A00,098045,Holst; Michael J,13,0,15,2
1668531640951,MATH 273A,A00,098046,Tian; Xiaochuan,10,0,15,5
1668531641387,MATH 275,A01,098048,Tian; Xiaochuan,6,0,10,4
1668531641815,MATH 278A,A00,098049,Holst; Michael J,7,0,10,3
1668531642239,MATH 278B,A00,098050,Cloninger; Alexander,10,0,10,0
1668531642662,MATH 278C,A00,098051,Nie; Jiawang,5,0,10,5
1668531643086,MATH 280B,A00,098052,Zheng; Tianyi,7,0,15,8
1668531643512,MATH 281B,A00,098053,Bradic; Jelena,0,2,15,15
1668531643945,MATH 282B,A00,098054,Arias-Castro; Ery,0,1,15,15
1668531644371,MATH 285,A00,098055,Fitzsimmons; Patrick J,0,3,15,17
1668531644797,MATH 287B,A00,098056,Arias-Castro; Ery,1,0,15,14
1668531645226,MATH 288,A00,098057,Agarwal; Pooja,9,0,10,1
1668531645226,MATH 288,B00,098058,Zhang; Danna,8,0,10,2
1668531645226,MATH 288,C00,098059,Williams; Ruth J,9,0,10,1
1668531645652,MATH 290B,A00,098060,Roberts; Justin Deritter,12,0,15,3
1668531646077,MATH 292,A00,098061,Belmont; Eva Kinoshita,10,0,10,0
1668531646502,MATH 295,A00,098062,Suk; Andrew Hoon,47,0,50,3
1668531646924,MATH 296,A00,098063,Novak; Jonathan I,20,0,20,0
1668531647358,MATH 297,001,098064,Gamst; Anthony Collins,9997,0,9999,2
1668532151479,COGS 205,A00,101395,Chiba; Andrea,19,0,20,1
1668532151905,COGS 210B,001,101404,Greene; Deanna Jacquelyn,9998,0,9999,1
1668532151905,COGS 210B,002,101417,Xia; Haijun,9999,0,9999,0
1668532151905,COGS 210B,003,101422,Nitz; Douglas A.,9999,0,9999,0
1668532151905,COGS 210B,004,101423,Hollan; James D.,9998,0,9999,1
1668532151905,COGS 210B,005,101424,Deak; Gedeon O.,9998,0,9999,1
1668532151905,COGS 210B,006,101425,Rossano; Federico,9999,0,9999,0
1668532152334,COGS 211B,A00,101427,Coulson; Seana M,9996,0,9999,3
1668532152763,COGS 220,A00,101428,Hollan; James D.,0,10,25,25
1668532153196,COGS 229,A00,101429,Dow; Steven P,17,0,25,8
1668532153624,COGS 230,A00,101430,Klemmer; Scott R,7,0,17,10
1668532154049,COGS 234,A00,101431,Xia; Haijun,1,0,25,24
1668532154473,COGS 260,A00,101432,Kiyonaga; Anastasia,21,0,25,4
1668532154473,COGS 260,B00,101433,Kirsh; David Joel,15,0,25,10
1668532154896,CSE 202,A00,102371,Impagliazzo; Russell,0,66,0,0
1668532155328,CSE 203B,A01,102373,Cheng; Chung Kuan,0,59,0,0
1668532155750,CSE 208,A00,102374,Micciancio; Daniele,0,5,0,0
1668532156281,CSE 209A,A00,112895,Impagliazzo; Russell,0,12,15,15
1668532156705,CSE 209B,A00,108005,Bellare; Mihir,0,7,0,0
1668532157128,CSE 210,A00,113163,Coblenz; Michael J,0,85,0,0
1668532157560,CSE 219,A00,106111,Dow; Steven P,0,7,20,20
1668532157985,CSE 221,A00,102376,Voelker; Geoffrey M.,0,73,0,0
1668532158407,CSE 224,A01,102378,Porter; George M,0,167,0,0
1668532158848,CSE 229A,A00,102379,Savage; Stefan,0,11,0,0
1668532159277,CSE 229C,A00,102380,Munyaka; Imani N. S.,0,10,0,0
1668532159700,CSE 232B,A00,102382,Deutsch; Alin Bernard,0,33,0,0
1668532160122,CSE 234,A01,112904,Kumar; Arun Kumar,0,0,0,0
1668532160548,CSE 237A,A00,102383,Rosing; Tajana Simunic,0,56,0,0
1668532160984,CSE 239A,A00,102384,Deutsch; Alin Bernard,0,15,0,0
1668532161412,CSE 239B,A00,102385,Polikarpova; Nadezhda,0,11,0,0
1668532161847,CSE 240A,A00,102386,Pannuto; Patrick William,0,46,0,0
1668532162268,CSE 240B,A00,102387,Zhao; Jishen,0,48,0,0
1668532162690,CSE 241A,A00,106406,Kang; Mingu,0,9,0,0
1668532163113,CSE 249B,A00,102388,Kahng; Andrew Byun,0,5,8,8
1668532163536,CSE 251B,A01,102392,Cottrell; Garrison W,0,51,0,0
1668532163536,CSE 251B,A02,102393,Cottrell; Garrison W,0,34,0,0
1668532163958,CSE 252B,A00,102394,Ochoa; Benjamin Lawrence,0,59,0,0
1668532164381,CSE 257,A01,102396,Gao; Sicun,0,139,0,0
1668532164808,CSE 272,A00,102397,Li; Tzumao,0,19,0,0
1668532165230,CSE 274,A00,111323,Chern; Albert Ren-Haur,0,15,0,0
1668532165654,CSE 282,A00,102398,Pevzner; Pavel Arkadjevich,0,0,0,0
1668532166084,CSE 284,A00,114175,Gymrek; Melissa Ann,0,22,0,0
1668532166526,CSE 290,A00,102399,Chandraker; Manmohan Krishna,0,11,0,0
1668532166526,CSE 290,B00,102400,Vaccaro; Kristen Marie,0,7,25,25
1668532166526,CSE 290,C00,102414,Pannuto; Patrick William,0,1,25,25
1668532166526,CSE 290,D00,102427,Pevzner; Pavel Arkadjevich,0,0,0,0
1668532166526,CSE 290,E00,102429,Zhao; Jishen,0,4,0,0
1668532166526,CSE 290,F00,102436,Tullsen; Dean Michael,0,6,0,0
1668532166526,CSE 290,G00,102440,Christensen; Henrik I,0,6,20,20
1668532166948,CSE 291,A00,102443,Su; Hao,0,0,0,0
1668532166948,CSE 291,B00,102448,Polikarpova; Nadezhda,0,0,0,0
1668532166948,CSE 291,C00,102453,Vaccaro; Kristen Marie,0,0,0,0
1668532166948,CSE 291,D00,111343,Savage; Stefan,0,0,0,0
1668532166948,CSE 291,E00,116474,Claffy; Kimberly Claire,0,0,0,0
1668532166948,CSE 291,F00,116479,Pasquale; Joseph,0,0,0,0
1668532167411,CSE 293,001,119111,Bafna; Vineet,9999,0,9999,0
1668532167411,CSE 293,002,119118,Bellare; Mihir,9999,0,9999,0
1668532167411,CSE 293,003,119122,Berg-Kirkpatrick; Taylor D,9999,0,9999,0
1668532167411,CSE 293,004,119135,Christensen; Henrik I,9999,0,9999,0
1668532167411,CSE 293,005,119142,Cottrell; Garrison W,9999,0,9999,0
1668532167411,CSE 293,006,119146,Deutsch; Alin Bernard,9999,0,9999,0
1668532167411,CSE 293,007,119159,Esmaeilzadeh; Hadi,9999,0,9999,0
1668532167411,CSE 293,008,119166,Freund; Yoav,9999,0,9999,0
1668532167411,CSE 293,009,119170,Griswold; William G.,9999,0,9999,0
1668532167411,CSE 293,010,119183,Gymrek; Melissa Ann,9999,0,9999,0
1668532167411,CSE 293,011,119190,Heninger; Nadia A,9999,0,9999,0
1668532167411,CSE 293,012,119230,Impagliazzo; Russell,9999,0,9999,0
1668532167411,CSE 293,013,119232,Jhala; Ranjit,9999,0,9999,0
1668532167411,CSE 293,014,119233,Kahng; Andrew Byun,9999,0,9999,0
1668532167411,CSE 293,015,119298,Kane; Daniel Mertz,9999,0,9999,0
1668532167411,CSE 293,016,119299,Kriegman; David J,9999,0,9999,0
1668532167411,CSE 293,017,119300,Kumar; Arun Kumar,9999,0,9999,0
1668532167411,CSE 293,018,119301,Lerner; Sorin,9999,0,9999,0
1668532167411,CSE 293,019,119302,Lovett; Shachar,9999,0,9999,0
1668532167411,CSE 293,020,119303,McAuley; Julian John,9999,0,9999,0
1668532167411,CSE 293,021,119304,Micciancio; Daniele,9999,0,9999,0
1668532167411,CSE 293,022,119367,Orailoglu; Alex,9999,0,9999,0
1668532167411,CSE 293,023,119382,Paturi; Ramamohan,9999,0,9999,0
1668532167411,CSE 293,024,119404,Polikarpova; Nadezhda,9999,0,9999,0
1668532167411,CSE 293,025,119406,Politz; Joseph Gibbs,9999,0,9999,0
1668532167411,CSE 293,026,119411,Porter; George M,9999,0,9999,0
1668532167411,CSE 293,027,119414,Porter; Leonard Emerson,9999,0,9999,0
1668532167411,CSE 293,028,119416,Ramamoorthi; Ravi,9999,0,9999,0
1668532167411,CSE 293,029,119417,Sahoo; Debashis,9999,0,9999,0
1668532167411,CSE 293,030,119420,Saul; Lawrence,9999,0,9999,0
1668532167411,CSE 293,031,119421,Savage; Stefan,9999,0,9999,0
1668532167411,CSE 293,032,119425,Schulze; Jurgen P.,9999,0,9999,0
1668532167411,CSE 293,033,119426,Snoeren; Alex C.,9999,0,9999,0
1668532167411,CSE 293,034,119428,Shang; Jingbo,9999,0,9999,0
1668532167411,CSE 293,035,119430,Stefan; Deian,9999,0,9999,0
1668532167411,CSE 293,036,119431,Su; Hao,9999,0,9999,0
1668532167411,CSE 293,037,119433,Swanson; Steven James,9999,0,9999,0
1668532167411,CSE 293,038,119435,Tullsen; Dean Michael,9999,0,9999,0
1668532167411,CSE 293,039,119483,Voelker; Geoffrey M.,9999,0,9999,0
1668532167411,CSE 293,040,119537,Zhao; Jishen,9999,0,9999,0
1668532167411,CSE 293,041,119538,Zhou; Yuan-Yuan,9999,0,9999,0
1668532167411,CSE 293,042,119539,Gao; Sicun,9999,0,9999,0
1668532167411,CSE 293,043,119540,Weibel; Nadir,9999,0,9999,0
1668532167411,CSE 293,044,119541,Gupta; Rajesh K.,9999,0,9999,0
1668532167411,CSE 293,045,126410,Vaccaro; Kristen Marie,9999,0,9999,0
1668532167411,CSE 293,046,126411,Klemke; Richard,9999,0,9999,0
1668532167844,CSE 294,A00,102459,Voelker; Geoffrey M.,0,2,0,0
1668532167844,CSE 294,B00,111322,Orailoglu; Alex,0,2,0,0
1668532168283,DSE 201,A00,096914,Deutsch; Alin Bernard,30,0,30,0
1668532168706,DSE 210,A00,096915,Dasgupta; Sanjoy,30,0,30,0
1668532169128,DSE 260A,A00,096916,Altintas De Callaf; Ilkay,30,0,30,0
1668532169566,ECE 200,001,103586,Antipa; Nicholas A,9999,0,9999,0
1668532169566,ECE 200,002,103587,Atanasov; Nikolay A.,9999,0,9999,0
1668532169566,ECE 200,003,103588,Bharadia; Dinesh,9999,0,9999,0
1668532169566,ECE 200,004,103589,Cheng; Chung Kuan,9999,0,9999,0
1668532169566,ECE 200,005,103590,Cosman; Pamela C.,9999,0,9999,0
1668532169566,ECE 200,006,103591,Dayeh; Shadi Ahmad,9999,0,9999,0
1668532169566,ECE 200,007,103592,Fainman; Yeshaiahu,9999,0,9999,0
1668532169566,ECE 200,008,103593,Ford; Joseph Earl,9999,0,9999,0
1668532169566,ECE 200,009,103594,Franceschetti; Massimo,9999,0,9999,0
1668532169566,ECE 200,010,103595,Fullerton; Eric E,9999,0,9999,0
1668532169566,ECE 200,011,103596,Galton; Ian A,9999,0,9999,0
1668532169566,ECE 200,012,103597,Gilja; Vikash,9999,0,9999,0
1668532169566,ECE 200,013,103598,Hall; Drew A.,9999,0,9999,0
1668532169566,ECE 200,014,103599,Hsueh; Tzu-Chien,9999,0,9999,0
1668532169566,ECE 200,015,103600,Javidi; Tara,9999,0,9999,0
1668532169566,ECE 200,016,103601,Kahng; Andrew Byun,9999,0,9999,0
1668532169566,ECE 200,017,103602,Kim; Young-Han,9999,0,9999,0
1668532169566,ECE 200,018,103603,Koushanfar; Farinaz,9999,0,9999,0
1668532169566,ECE 200,019,103604,Kuzum; Duygu,9999,0,9999,0
1668532169566,ECE 200,020,103605,Le; Hanh-Phuc,9999,0,9999,0
1668532169566,ECE 200,021,103606,Lin; Bill,9999,0,9999,0
1668532169566,ECE 200,022,103607,Liu; Zhaowei,9998,0,9999,1
1668532169566,ECE 200,023,103608,Lo; Yu-Hwa,9999,0,9999,0
1668532169566,ECE 200,024,103609,Lomakin; Vitaliy,9999,0,9999,0
1668532169566,ECE 200,025,103610,Mercier; Patrick Philip,9999,0,9999,0
1668532169566,ECE 200,026,103611,Meyer; Florian,9999,0,9999,0
1668532169566,ECE 200,027,103612,Milstein; Laurence B.,9999,0,9999,0
1668532169566,ECE 200,028,103613,Mir Arabbaygi; Siavash,9999,0,9999,0
1668532169566,ECE 200,029,103614,Mookherjea; Shayan,9999,0,9999,0
1668532169566,ECE 200,030,103615,Morris; Karcher William,9999,0,9999,0
1668532169566,ECE 200,031,103616,Ng; Tse Nga,9999,0,9999,0
1668532169566,ECE 200,032,103617,Nguyen; Truong Quang,9999,0,9999,0
1668532169566,ECE 200,033,103618,Nomura; Kenji,9999,0,9999,0
1668532169566,ECE 200,034,103619,Orlitsky; Alon,9999,0,9999,0
1668532169566,ECE 200,035,103620,Pal; Piya,9999,0,9999,0
1668532169566,ECE 200,036,103621,Papen; George C.,9999,0,9999,0
1668532169566,ECE 200,037,103622,Radic; Stojan,9999,0,9999,0
1668532169566,ECE 200,038,103623,Rao; Bhaskar D.,9999,0,9999,0
1668532169566,ECE 200,039,103624,Rao; Ramesh R,9999,0,9999,0
1668532169566,ECE 200,040,103625,Rebeiz; Gabriel,9999,0,9999,0
1668532169566,ECE 200,041,103626,Sanford; John R,9999,0,9999,0
1668532169566,ECE 200,042,103627,Siegel; Paul H.,9999,0,9999,0
1668532169566,ECE 200,043,103628,Sievenpiper; Daniel F.,9999,0,9999,0
1668532169566,ECE 200,044,103629,Sworder; David D.,9999,0,9999,0
1668532169566,ECE 200,045,103630,Taur; Yuan,9999,0,9999,0
1668532169566,ECE 200,046,103631,Touri; Behrouz,9999,0,9999,0
1668532169566,ECE 200,047,103632,Trivedi; Mohan M.,9999,0,9999,0
1668532169566,ECE 200,048,103633,Vasconcelos; Nuno,9999,0,9999,0
1668532169566,ECE 200,049,103634,Wang; Xiaolong,9999,0,9999,0
1668532169566,ECE 200,050,103635,Xie; Pengtao,9999,0,9999,0
1668532169566,ECE 200,051,103636,Yip; Michael,9999,0,9999,0
1668532169566,ECE 200,052,103637,Zeger; Kenneth A.,999,0,999,0
1668532169566,ECE 200,053,103638,Zhang; Xinyu,9999,0,9999,0
1668532169566,ECE 200,054,103639,Turakhia; Yatish Girish,9999,0,9999,0
1668532169566,ECE 200,055,103640,Kang; Mingu,9999,0,9999,0
1668532169566,ECE 200,056,103641,Shi; Yuanyuan,9999,0,9999,0
1668532169566,ECE 200,057,103642,Wang; Edward Jay,9999,0,9999,0
1668532169566,ECE 200,058,103643,Zheng; Yang,9999,0,9999,0
1668532170002,ECE 202,A00,103644,Kuzum; Duygu,0,44,0,0
1668532170423,ECE 212BN,A00,103646,Ng; Tse Nga,0,9,0,0
1668532170850,ECE 221,A00,111493,Staff,0,0,0,0
1668532171279,ECE 222B,A00,103647,Lomakin; Vitaliy,0,20,0,0
1668532171703,ECE 230B,A00,103648,Taur; Yuan,0,3,0,0
1668532172129,ECE 238B,A00,103649,Garay; Javier,0,0,0,0
1668532172559,ECE 240B,A00,112900,Fainman; Yeshaiahu,0,7,0,0
1668532172999,ECE 247A,A00,103650,Jokerst; Jesse Vincent,0,6,0,0
1668532173422,ECE 247B,A00,103651,Wang; Joseph,0,14,0,0
1668532173853,ECE 250,A00,103652,Siegel; Paul H.,0,82,0,0
1668532174287,ECE 251A,A00,103654,Rao; Bhaskar D.,0,62,0,0
1668532174730,ECE 257B,A00,103655,Bharadia; Dinesh,0,33,0,0
1668532175163,ECE 258A,A00,103656,Milstein; Laurence B.,0,29,0,0
1668532175587,ECE 260B,A00,103658,Kang; Mingu,0,121,0,0
1668532176009,ECE 264A,A00,103659,Galton; Ian A,0,67,0,0
1668532176440,ECE 265A,A00,103661,Gudem; Prasad S.S.,0,71,0,0
1668532176868,ECE 265D,A00,103662,Gudem; Prasad S.S.,0,26,0,0
1668532177294,ECE 268,A00,103663,Koushanfar; Farinaz,0,43,0,0
1668532177716,ECE 269,A01,103665,Pal; Piya,0,216,0,0
1668532178143,ECE 271B,A00,103666,Vasconcelos; Manuela,0,76,0,0
1668532178580,ECE 276A,A00,103667,Atanasov; Nikolay A.,0,127,0,0
1668532179004,ECE 277,A00,103668,An; Cheolhong,0,150,0,0
1668532179429,ECE 279,A00,117947,Hall; Drew A.,0,22,0,0
1668532180291,ECE 283,A00,103670,Hsueh; Tzu-Chien,0,55,0,0
1668532180728,ECE 284,A00,103671,Turakhia; Yatish Girish,0,39,0,0
1668532181156,ECE 285,A00,103672,Zheng; Yang,0,40,0,0
1668532181156,ECE 285,B00,103673,Sworder; David D.,0,57,0,0
1668532181580,ECE 287,A00,103676,Javidi; Tara,0,9,0,0
1668532182002,MATH 200B,A00,098023,Salehi Golsefidy; Alireza,10,0,15,5
1668532182435,MATH 202B,A00,098024,Rhoades; Brendon Patrick,7,0,15,8
1668532182868,MATH 203B,A00,098025,Oprea; Dragos N.,9,0,15,6
1668532183298,MATH 204B,A00,098026,Sorensen; Claus M,13,0,15,2
1668532183721,MATH 208,A00,098027,Izadi; Elham,7,0,10,3
1668532184158,MATH 209,A00,098028,Pollack; Aaron,10,0,10,0
1668532184586,MATH 211A,A00,112919,Rogalski; Daniel,8,0,10,2
1668532185010,MATH 211B,A00,112920,Seward; Brandon M.,9,0,10,1
1668532185432,MATH 218,A00,098029,Li; Bo,10,0,10,0
1668532185857,MATH 220B,A00,098030,Novak; Jonathan I,11,0,15,4
1668532186281,MATH 221A,A00,098031,Ebenfelt; Peter F,12,0,15,3
1668532186706,MATH 231B,A00,098032,Zlatos; Andrej,11,0,15,4
1668532187132,MATH 240B,A00,098033,Ni; Lei,7,0,15,8
1668532187558,MATH 243,A00,098034,Jekel; David Andrew,10,0,10,0
1668532187985,MATH 245A,A00,098035,Nie; Jiawang,0,5,15,18
1668532188408,MATH 248,A00,098036,Bejenaru; Ioan,10,0,10,0
1668532188840,MATH 250B,A00,098037,Spolaor; Luca,14,0,15,1
1668532189265,MATH 258,A00,098038,Ni; Lei,9,0,10,1
1668532189690,MATH 264B,A00,098041,Rhoades; Brendon Patrick,8,0,15,7
1668532190124,MATH 268,A00,098042,Buss; Samuel R,10,0,10,0
1668532190549,MATH 269,A00,098043,Rhoades; Brendon Patrick,10,0,10,0
1668532190974,MATH 270B,A00,098044,Li; Bo,6,0,15,9
1668532191404,MATH 272B,A00,098045,Holst; Michael J,13,0,15,2
1668532191831,MATH 273A,A00,098046,Tian; Xiaochuan,10,0,15,5
1668532192257,MATH 275,A01,098048,Tian; Xiaochuan,6,0,10,4
1668532192680,MATH 278A,A00,098049,Holst; Michael J,7,0,10,3
1668532193102,MATH 278B,A00,098050,Cloninger; Alexander,10,0,10,0
1668532193526,MATH 278C,A00,098051,Nie; Jiawang,5,0,10,5
1668532193947,MATH 280B,A00,098052,Zheng; Tianyi,7,0,15,8
1668532194371,MATH 281B,A00,098053,Bradic; Jelena,0,2,15,15
1668532194797,MATH 282B,A00,098054,Arias-Castro; Ery,0,1,15,15
1668532195224,MATH 285,A00,098055,Fitzsimmons; Patrick J,0,3,15,17
1668532195650,MATH 287B,A00,098056,Arias-Castro; Ery,1,0,15,14
1668532196087,MATH 288,A00,098057,Agarwal; Pooja,9,0,10,1
1668532196087,MATH 288,B00,098058,Zhang; Danna,8,0,10,2
1668532196087,MATH 288,C00,098059,Williams; Ruth J,9,0,10,1
1668532196520,MATH 290B,A00,098060,Roberts; Justin Deritter,12,0,15,3
1668532196943,MATH 292,A00,098061,Belmont; Eva Kinoshita,10,0,10,0
1668532197375,MATH 295,A00,098062,Suk; Andrew Hoon,47,0,50,3
1668532197810,MATH 296,A00,098063,Novak; Jonathan I,20,0,20,0
1668532198233,MATH 297,001,098064,Gamst; Anthony Collins,9997,0,9999,2
1668532702412,COGS 205,A00,101395,Chiba; Andrea,19,0,20,1
1668532702840,COGS 210B,001,101404,Greene; Deanna Jacquelyn,9998,0,9999,1
1668532702840,COGS 210B,002,101417,Xia; Haijun,9999,0,9999,0
1668532702840,COGS 210B,003,101422,Nitz; Douglas A.,9999,0,9999,0
1668532702840,COGS 210B,004,101423,Hollan; James D.,9998,0,9999,1
1668532702840,COGS 210B,005,101424,Deak; Gedeon O.,9998,0,9999,1
1668532702840,COGS 210B,006,101425,Rossano; Federico,9999,0,9999,0
1668532703265,COGS 211B,A00,101427,Coulson; Seana M,9996,0,9999,3
1668532703698,COGS 220,A00,101428,Hollan; James D.,0,10,25,25
1668532704122,COGS 229,A00,101429,Dow; Steven P,17,0,25,8
1668532704557,COGS 230,A00,101430,Klemmer; Scott R,7,0,17,10
1668532704987,COGS 234,A00,101431,Xia; Haijun,1,0,25,24
1668532705412,COGS 260,A00,101432,Kiyonaga; Anastasia,21,0,25,4
1668532705412,COGS 260,B00,101433,Kirsh; David Joel,15,0,25,10
1668532705848,CSE 202,A00,102371,Impagliazzo; Russell,0,66,0,0
1668532706281,CSE 203B,A01,102373,Cheng; Chung Kuan,0,59,0,0
1668532706708,CSE 208,A00,102374,Micciancio; Daniele,0,5,0,0
1668532707131,CSE 209A,A00,112895,Impagliazzo; Russell,0,12,15,15
1668532707552,CSE 209B,A00,108005,Bellare; Mihir,0,7,0,0
1668532707980,CSE 210,A00,113163,Coblenz; Michael J,0,85,0,0
1668532708407,CSE 219,A00,106111,Dow; Steven P,0,7,20,20
1668532708829,CSE 221,A00,102376,Voelker; Geoffrey M.,0,73,0,0
1668532709257,CSE 224,A01,102378,Porter; George M,0,167,0,0
1668532709699,CSE 229A,A00,102379,Savage; Stefan,0,11,0,0
1668532710122,CSE 229C,A00,102380,Munyaka; Imani N. S.,0,10,0,0
1668532710549,CSE 232B,A00,102382,Deutsch; Alin Bernard,0,33,0,0
1668532710975,CSE 234,A01,112904,Kumar; Arun Kumar,0,0,0,0
1668532711406,CSE 237A,A00,102383,Rosing; Tajana Simunic,0,56,0,0
1668532711832,CSE 239A,A00,102384,Deutsch; Alin Bernard,0,15,0,0
1668532712255,CSE 239B,A00,102385,Polikarpova; Nadezhda,0,11,0,0
1668532712685,CSE 240A,A00,102386,Pannuto; Patrick William,0,46,0,0
1668532713112,CSE 240B,A00,102387,Zhao; Jishen,0,48,0,0
1668532713545,CSE 241A,A00,106406,Kang; Mingu,0,9,0,0
1668532713968,CSE 249B,A00,102388,Kahng; Andrew Byun,0,5,8,8
1668532714391,CSE 251B,A01,102392,Cottrell; Garrison W,0,51,0,0
1668532714391,CSE 251B,A02,102393,Cottrell; Garrison W,0,35,0,0
1668532714830,CSE 252B,A00,102394,Ochoa; Benjamin Lawrence,0,59,0,0
1668532715270,CSE 257,A01,102396,Gao; Sicun,0,139,0,0
1668532715695,CSE 272,A00,102397,Li; Tzumao,0,19,0,0
1668532716134,CSE 274,A00,111323,Chern; Albert Ren-Haur,0,15,0,0
1668532716558,CSE 282,A00,102398,Pevzner; Pavel Arkadjevich,0,0,0,0
1668532716980,CSE 284,A00,114175,Gymrek; Melissa Ann,0,22,0,0
1668532717406,CSE 290,A00,102399,Chandraker; Manmohan Krishna,0,11,0,0
1668532717406,CSE 290,B00,102400,Vaccaro; Kristen Marie,0,7,25,25
1668532717406,CSE 290,C00,102414,Pannuto; Patrick William,0,1,25,25
1668532717406,CSE 290,D00,102427,Pevzner; Pavel Arkadjevich,0,0,0,0
1668532717406,CSE 290,E00,102429,Zhao; Jishen,0,4,0,0
1668532717406,CSE 290,F00,102436,Tullsen; Dean Michael,0,6,0,0
1668532717406,CSE 290,G00,102440,Christensen; Henrik I,0,6,20,20
1668532717840,CSE 291,A00,102443,Su; Hao,0,0,0,0
1668532717840,CSE 291,B00,102448,Polikarpova; Nadezhda,0,0,0,0
1668532717840,CSE 291,C00,102453,Vaccaro; Kristen Marie,0,0,0,0
1668532717840,CSE 291,D00,111343,Savage; Stefan,0,0,0,0
1668532717840,CSE 291,E00,116474,Claffy; Kimberly Claire,0,0,0,0
1668532717840,CSE 291,F00,116479,Pasquale; Joseph,0,0,0,0
1668532718276,CSE 293,001,119111,Bafna; Vineet,9999,0,9999,0
1668532718276,CSE 293,002,119118,Bellare; Mihir,9999,0,9999,0
1668532718276,CSE 293,003,119122,Berg-Kirkpatrick; Taylor D,9999,0,9999,0
1668532718276,CSE 293,004,119135,Christensen; Henrik I,9999,0,9999,0
1668532718276,CSE 293,005,119142,Cottrell; Garrison W,9999,0,9999,0
1668532718276,CSE 293,006,119146,Deutsch; Alin Bernard,9999,0,9999,0
1668532718276,CSE 293,007,119159,Esmaeilzadeh; Hadi,9999,0,9999,0
1668532718276,CSE 293,008,119166,Freund; Yoav,9999,0,9999,0
1668532718276,CSE 293,009,119170,Griswold; William G.,9999,0,9999,0
1668532718276,CSE 293,010,119183,Gymrek; Melissa Ann,9999,0,9999,0
1668532718276,CSE 293,011,119190,Heninger; Nadia A,9999,0,9999,0
1668532718276,CSE 293,012,119230,Impagliazzo; Russell,9999,0,9999,0
1668532718276,CSE 293,013,119232,Jhala; Ranjit,9999,0,9999,0
1668532718276,CSE 293,014,119233,Kahng; Andrew Byun,9999,0,9999,0
1668532718276,CSE 293,015,119298,Kane; Daniel Mertz,9999,0,9999,0
1668532718276,CSE 293,016,119299,Kriegman; David J,9999,0,9999,0
1668532718276,CSE 293,017,119300,Kumar; Arun Kumar,9999,0,9999,0
1668532718276,CSE 293,018,119301,Lerner; Sorin,9999,0,9999,0
1668532718276,CSE 293,019,119302,Lovett; Shachar,9999,0,9999,0
1668532718276,CSE 293,020,119303,McAuley; Julian John,9999,0,9999,0
1668532718276,CSE 293,021,119304,Micciancio; Daniele,9999,0,9999,0
1668532718276,CSE 293,022,119367,Orailoglu; Alex,9999,0,9999,0
1668532718276,CSE 293,023,119382,Paturi; Ramamohan,9999,0,9999,0
1668532718276,CSE 293,024,119404,Polikarpova; Nadezhda,9999,0,9999,0
1668532718276,CSE 293,025,119406,Politz; Joseph Gibbs,9999,0,9999,0
1668532718276,CSE 293,026,119411,Porter; George M,9999,0,9999,0
1668532718276,CSE 293,027,119414,Porter; Leonard Emerson,9999,0,9999,0
1668532718276,CSE 293,028,119416,Ramamoorthi; Ravi,9999,0,9999,0
1668532718276,CSE 293,029,119417,Sahoo; Debashis,9999,0,9999,0
1668532718276,CSE 293,030,119420,Saul; Lawrence,9999,0,9999,0
1668532718276,CSE 293,031,119421,Savage; Stefan,9999,0,9999,0
1668532718276,CSE 293,032,119425,Schulze; Jurgen P.,9999,0,9999,0
1668532718276,CSE 293,033,119426,Snoeren; Alex C.,9999,0,9999,0
1668532718276,CSE 293,034,119428,Shang; Jingbo,9999,0,9999,0
1668532718276,CSE 293,035,119430,Stefan; Deian,9999,0,9999,0
1668532718276,CSE 293,036,119431,Su; Hao,9999,0,9999,0
1668532718276,CSE 293,037,119433,Swanson; Steven James,9999,0,9999,0
1668532718276,CSE 293,038,119435,Tullsen; Dean Michael,9999,0,9999,0
1668532718276,CSE 293,039,119483,Voelker; Geoffrey M.,9999,0,9999,0
1668532718276,CSE 293,040,119537,Zhao; Jishen,9999,0,9999,0
1668532718276,CSE 293,041,119538,Zhou; Yuan-Yuan,9999,0,9999,0
1668532718276,CSE 293,042,119539,Gao; Sicun,9999,0,9999,0
1668532718276,CSE 293,043,119540,Weibel; Nadir,9999,0,9999,0
1668532718276,CSE 293,044,119541,Gupta; Rajesh K.,9999,0,9999,0
1668532718276,CSE 293,045,126410,Vaccaro; Kristen Marie,9999,0,9999,0
1668532718276,CSE 293,046,126411,Klemke; Richard,9999,0,9999,0
1668532718713,CSE 294,A00,102459,Voelker; Geoffrey M.,0,2,0,0
1668532718713,CSE 294,B00,111322,Orailoglu; Alex,0,2,0,0
1668532719153,DSE 201,A00,096914,Deutsch; Alin Bernard,30,0,30,0
1668532719579,DSE 210,A00,096915,Dasgupta; Sanjoy,30,0,30,0
1668532720003,DSE 260A,A00,096916,Altintas De Callaf; Ilkay,30,0,30,0
1668532720463,ECE 200,001,103586,Antipa; Nicholas A,9999,0,9999,0
1668532720463,ECE 200,002,103587,Atanasov; Nikolay A.,9999,0,9999,0
1668532720463,ECE 200,003,103588,Bharadia; Dinesh,9999,0,9999,0
1668532720463,ECE 200,004,103589,Cheng; Chung Kuan,9999,0,9999,0
1668532720463,ECE 200,005,103590,Cosman; Pamela C.,9999,0,9999,0
1668532720463,ECE 200,006,103591,Dayeh; Shadi Ahmad,9999,0,9999,0
1668532720463,ECE 200,007,103592,Fainman; Yeshaiahu,9999,0,9999,0
1668532720463,ECE 200,008,103593,Ford; Joseph Earl,9999,0,9999,0
1668532720463,ECE 200,009,103594,Franceschetti; Massimo,9999,0,9999,0
1668532720463,ECE 200,010,103595,Fullerton; Eric E,9999,0,9999,0
1668532720463,ECE 200,011,103596,Galton; Ian A,9999,0,9999,0
1668532720463,ECE 200,012,103597,Gilja; Vikash,9999,0,9999,0
1668532720463,ECE 200,013,103598,Hall; Drew A.,9999,0,9999,0
1668532720463,ECE 200,014,103599,Hsueh; Tzu-Chien,9999,0,9999,0
1668532720463,ECE 200,015,103600,Javidi; Tara,9999,0,9999,0
1668532720463,ECE 200,016,103601,Kahng; Andrew Byun,9999,0,9999,0
1668532720463,ECE 200,017,103602,Kim; Young-Han,9999,0,9999,0
1668532720463,ECE 200,018,103603,Koushanfar; Farinaz,9999,0,9999,0
1668532720463,ECE 200,019,103604,Kuzum; Duygu,9999,0,9999,0
1668532720463,ECE 200,020,103605,Le; Hanh-Phuc,9999,0,9999,0
1668532720463,ECE 200,021,103606,Lin; Bill,9999,0,9999,0
1668532720463,ECE 200,022,103607,Liu; Zhaowei,9998,0,9999,1
1668532720463,ECE 200,023,103608,Lo; Yu-Hwa,9999,0,9999,0
1668532720463,ECE 200,024,103609,Lomakin; Vitaliy,9999,0,9999,0
1668532720463,ECE 200,025,103610,Mercier; Patrick Philip,9999,0,9999,0
1668532720463,ECE 200,026,103611,Meyer; Florian,9999,0,9999,0
1668532720463,ECE 200,027,103612,Milstein; Laurence B.,9999,0,9999,0
1668532720463,ECE 200,028,103613,Mir Arabbaygi; Siavash,9999,0,9999,0
1668532720463,ECE 200,029,103614,Mookherjea; Shayan,9999,0,9999,0
1668532720463,ECE 200,030,103615,Morris; Karcher William,9999,0,9999,0
1668532720463,ECE 200,031,103616,Ng; Tse Nga,9999,0,9999,0
1668532720463,ECE 200,032,103617,Nguyen; Truong Quang,9999,0,9999,0
1668532720463,ECE 200,033,103618,Nomura; Kenji,9999,0,9999,0
1668532720463,ECE 200,034,103619,Orlitsky; Alon,9999,0,9999,0
1668532720463,ECE 200,035,103620,Pal; Piya,9999,0,9999,0
1668532720463,ECE 200,036,103621,Papen; George C.,9999,0,9999,0
1668532720463,ECE 200,037,103622,Radic; Stojan,9999,0,9999,0
1668532720463,ECE 200,038,103623,Rao; Bhaskar D.,9999,0,9999,0
1668532720463,ECE 200,039,103624,Rao; Ramesh R,9999,0,9999,0
1668532720463,ECE 200,040,103625,Rebeiz; Gabriel,9999,0,9999,0
1668532720463,ECE 200,041,103626,Sanford; John R,9999,0,9999,0
1668532720463,ECE 200,042,103627,Siegel; Paul H.,9999,0,9999,0
1668532720463,ECE 200,043,103628,Sievenpiper; Daniel F.,9999,0,9999,0
1668532720463,ECE 200,044,103629,Sworder; David D.,9999,0,9999,0
1668532720463,ECE 200,045,103630,Taur; Yuan,9999,0,9999,0
1668532720463,ECE 200,046,103631,Touri; Behrouz,9999,0,9999,0
1668532720463,ECE 200,047,103632,Trivedi; Mohan M.,9999,0,9999,0
1668532720463,ECE 200,048,103633,Vasconcelos; Nuno,9999,0,9999,0
1668532720463,ECE 200,049,103634,Wang; Xiaolong,9999,0,9999,0
1668532720463,ECE 200,050,103635,Xie; Pengtao,9999,0,9999,0
1668532720463,ECE 200,051,103636,Yip; Michael,9999,0,9999,0
1668532720463,ECE 200,052,103637,Zeger; Kenneth A.,999,0,999,0
1668532720463,ECE 200,053,103638,Zhang; Xinyu,9999,0,9999,0
1668532720463,ECE 200,054,103639,Turakhia; Yatish Girish,9999,0,9999,0
1668532720463,ECE 200,055,103640,Kang; Mingu,9999,0,9999,0
1668532720463,ECE 200,056,103641,Shi; Yuanyuan,9999,0,9999,0
1668532720463,ECE 200,057,103642,Wang; Edward Jay,9999,0,9999,0
1668532720463,ECE 200,058,103643,Zheng; Yang,9999,0,9999,0
1668532720886,ECE 202,A00,103644,Kuzum; Duygu,0,44,0,0
1668532721310,ECE 212BN,A00,103646,Ng; Tse Nga,0,9,0,0
1668532721747,ECE 221,A00,111493,Staff,0,0,0,0
1668532722182,ECE 222B,A00,103647,Lomakin; Vitaliy,0,20,0,0
1668532722794,ECE 230B,A00,103648,Taur; Yuan,0,3,0,0
1668532723220,ECE 238B,A00,103649,Garay; Javier,0,0,0,0
1668532723657,ECE 240B,A00,112900,Fainman; Yeshaiahu,0,7,0,0
1668532724095,ECE 247A,A00,103650,Jokerst; Jesse Vincent,0,6,0,0
1668532724519,ECE 247B,A00,103651,Wang; Joseph,0,14,0,0
1668532724943,ECE 250,A00,103652,Siegel; Paul H.,0,82,0,0
1668532725367,ECE 251A,A00,103654,Rao; Bhaskar D.,0,62,0,0
1668532725790,ECE 257B,A00,103655,Bharadia; Dinesh,0,33,0,0
1668532726212,ECE 258A,A00,103656,Milstein; Laurence B.,0,29,0,0
1668532726641,ECE 260B,A00,103658,Kang; Mingu,0,121,0,0
1668532727067,ECE 264A,A00,103659,Galton; Ian A,0,67,0,0
1668532727493,ECE 265A,A00,103661,Gudem; Prasad S.S.,0,71,0,0
1668532727922,ECE 265D,A00,103662,Gudem; Prasad S.S.,0,26,0,0
1668532728345,ECE 268,A00,103663,Koushanfar; Farinaz,0,43,0,0
1668532728772,ECE 269,A01,103665,Pal; Piya,0,216,0,0
1668532729206,ECE 271B,A00,103666,Vasconcelos; Manuela,0,76,0,0
1668532729633,ECE 276A,A00,103667,Atanasov; Nikolay A.,0,127,0,0
1668532730063,ECE 277,A00,103668,An; Cheolhong,0,150,0,0
1668532730487,ECE 279,A00,117947,Hall; Drew A.,0,22,0,0
1668532731333,ECE 283,A00,103670,Hsueh; Tzu-Chien,0,55,0,0
1668532731772,ECE 284,A00,103671,Turakhia; Yatish Girish,0,39,0,0
1668532732199,ECE 285,A00,103672,Zheng; Yang,0,40,0,0
1668532732199,ECE 285,B00,103673,Sworder; David D.,0,57,0,0
1668532732634,ECE 287,A00,103676,Javidi; Tara,0,9,0,0
1668532733062,MATH 200B,A00,098023,Salehi Golsefidy; Alireza,10,0,15,5
1668532733495,MATH 202B,A00,098024,Rhoades; Brendon Patrick,7,0,15,8
1668532733916,MATH 203B,A00,098025,Oprea; Dragos N.,9,0,15,6
1668532734345,MATH 204B,A00,098026,Sorensen; Claus M,13,0,15,2
1668532734769,MATH 208,A00,098027,Izadi; Elham,7,0,10,3
1668532735193,MATH 209,A00,098028,Pollack; Aaron,10,0,10,0
1668532735628,MATH 211A,A00,112919,Rogalski; Daniel,8,0,10,2
1668532736053,MATH 211B,A00,112920,Seward; Brandon M.,9,0,10,1
1668532736492,MATH 218,A00,098029,Li; Bo,10,0,10,0
1668532736929,MATH 220B,A00,098030,Novak; Jonathan I,11,0,15,4
1668532737361,MATH 221A,A00,098031,Ebenfelt; Peter F,12,0,15,3
1668532737797,MATH 231B,A00,098032,Zlatos; Andrej,11,0,15,4
1668532738225,MATH 240B,A00,098033,Ni; Lei,7,0,15,8
1668532738660,MATH 243,A00,098034,Jekel; David Andrew,10,0,10,0
1668532739090,MATH 245A,A00,098035,Nie; Jiawang,0,5,15,18
1668532739517,MATH 248,A00,098036,Bejenaru; Ioan,10,0,10,0
1668532739954,MATH 250B,A00,098037,Spolaor; Luca,14,0,15,1
1668532740397,MATH 258,A00,098038,Ni; Lei,9,0,10,1
1668532740820,MATH 264B,A00,098041,Rhoades; Brendon Patrick,8,0,15,7
1668532741242,MATH 268,A00,098042,Buss; Samuel R,10,0,10,0
1668532741668,MATH 269,A00,098043,Rhoades; Brendon Patrick,10,0,10,0
1668532742090,MATH 270B,A00,098044,Li; Bo,6,0,15,9
1668532742522,MATH 272B,A00,098045,Holst; Michael J,13,0,15,2
1668532742944,MATH 273A,A00,098046,Tian; Xiaochuan,10,0,15,5
1668532743385,MATH 275,A01,098048,Tian; Xiaochuan,6,0,10,4
1668532743815,MATH 278A,A00,098049,Holst; Michael J,7,0,10,3
1668532744243,MATH 278B,A00,098050,Cloninger; Alexander,10,0,10,0
1668532744666,MATH 278C,A00,098051,Nie; Jiawang,5,0,10,5
1668532745099,MATH 280B,A00,098052,Zheng; Tianyi,7,0,15,8
1668532745524,MATH 281B,A00,098053,Bradic; Jelena,0,2,15,15
1668532745948,MATH 282B,A00,098054,Arias-Castro; Ery,0,1,15,15
1668532746374,MATH 285,A00,098055,Fitzsimmons; Patrick J,0,3,15,17
1668532746798,MATH 287B,A00,098056,Arias-Castro; Ery,1,0,15,14
1668532747246,MATH 288,A00,098057,Agarwal; Pooja,9,0,10,1
1668532747246,MATH 288,B00,098058,Zhang; Danna,8,0,10,2
1668532747246,MATH 288,C00,098059,Williams; Ruth J,9,0,10,1
1668532747674,MATH 290B,A00,098060,Roberts; Justin Deritter,12,0,15,3
1668532748097,MATH 292,A00,098061,Belmont; Eva Kinoshita,10,0,10,0
1668532748524,MATH 295,A00,098062,Suk; Andrew Hoon,47,0,50,3
1668532748960,MATH 296,A00,098063,Novak; Jonathan I,20,0,20,0
1668532749391,MATH 297,001,098064,Gamst; Anthony Collins,9997,0,9999,2
1668533253638,COGS 205,A00,101395,Chiba; Andrea,19,0,20,1
1668533254069,COGS 210B,001,101404,Greene; Deanna Jacquelyn,9998,0,9999,1
1668533254069,COGS 210B,002,101417,Xia; Haijun,9999,0,9999,0
1668533254069,COGS 210B,003,101422,Nitz; Douglas A.,9999,0,9999,0
1668533254069,COGS 210B,004,101423,Hollan; James D.,9998,0,9999,1
1668533254069,COGS 210B,005,101424,Deak; Gedeon O.,9998,0,9999,1
1668533254069,COGS 210B,006,101425,Rossano; Federico,9999,0,9999,0
1668533254492,COGS 211B,A00,101427,Coulson; Seana M,9996,0,9999,3
1668533254918,COGS 220,A00,101428,Hollan; James D.,0,10,25,25
1668533255351,COGS 229,A00,101429,Dow; Steven P,17,0,25,8
1668533255773,COGS 230,A00,101430,Klemmer; Scott R,7,0,17,10
1668533256203,COGS 234,A00,101431,Xia; Haijun,1,0,25,24
1668533256625,COGS 260,A00,101432,Kiyonaga; Anastasia,21,0,25,4
1668533256625,COGS 260,B00,101433,Kirsh; David Joel,15,0,25,10
1668533257054,CSE 202,A00,102371,Impagliazzo; Russell,0,66,0,0
1668533257481,CSE 203B,A01,102373,Cheng; Chung Kuan,0,59,0,0
1668533257905,CSE 208,A00,102374,Micciancio; Daniele,0,5,0,0
1668533258331,CSE 209A,A00,112895,Impagliazzo; Russell,0,12,15,15
1668533258754,CSE 209B,A00,108005,Bellare; Mihir,0,7,0,0
1668533259176,CSE 210,A00,113163,Coblenz; Michael J,0,86,0,0
1668533259605,CSE 219,A00,106111,Dow; Steven P,0,7,20,20
1668533260031,CSE 221,A00,102376,Voelker; Geoffrey M.,0,73,0,0
1668533260454,CSE 224,A01,102378,Porter; George M,0,167,0,0
1668533260890,CSE 229A,A00,102379,Savage; Stefan,0,11,0,0
1668533261316,CSE 229C,A00,102380,Munyaka; Imani N. S.,0,10,0,0
1668533261738,CSE 232B,A00,102382,Deutsch; Alin Bernard,0,33,0,0
1668533262164,CSE 234,A01,112904,Kumar; Arun Kumar,0,0,0,0
1668533262586,CSE 237A,A00,102383,Rosing; Tajana Simunic,0,56,0,0
1668533263009,CSE 239A,A00,102384,Deutsch; Alin Bernard,0,15,0,0
1668533263438,CSE 239B,A00,102385,Polikarpova; Nadezhda,0,11,0,0
1668533263861,CSE 240A,A00,102386,Pannuto; Patrick William,0,46,0,0
1668533264287,CSE 240B,A00,102387,Zhao; Jishen,0,48,0,0
1668533264710,CSE 241A,A00,106406,Kang; Mingu,0,9,0,0
1668533265136,CSE 249B,A00,102388,Kahng; Andrew Byun,0,5,8,8
1668533265559,CSE 251B,A01,102392,Cottrell; Garrison W,0,51,0,0
1668533265559,CSE 251B,A02,102393,Cottrell; Garrison W,0,35,0,0
1668533265985,CSE 252B,A00,102394,Ochoa; Benjamin Lawrence,0,59,0,0
1668533266411,CSE 257,A01,102396,Gao; Sicun,0,139,0,0
1668533266834,CSE 272,A00,102397,Li; Tzumao,0,19,0,0
1668533267260,CSE 274,A00,111323,Chern; Albert Ren-Haur,0,15,0,0
1668533267684,CSE 282,A00,102398,Pevzner; Pavel Arkadjevich,0,0,0,0
1668533268107,CSE 284,A00,114175,Gymrek; Melissa Ann,0,23,0,0
1668533268530,CSE 290,A00,102399,Chandraker; Manmohan Krishna,0,11,0,0
1668533268530,CSE 290,B00,102400,Vaccaro; Kristen Marie,0,7,25,25
1668533268530,CSE 290,C00,102414,Pannuto; Patrick William,0,1,25,25
1668533268530,CSE 290,D00,102427,Pevzner; Pavel Arkadjevich,0,0,0,0
1668533268530,CSE 290,E00,102429,Zhao; Jishen,0,4,0,0
1668533268530,CSE 290,F00,102436,Tullsen; Dean Michael,0,6,0,0
1668533268530,CSE 290,G00,102440,Christensen; Henrik I,0,6,20,20
1668533268953,CSE 291,A00,102443,Su; Hao,0,0,0,0
1668533268953,CSE 291,B00,102448,Polikarpova; Nadezhda,0,0,0,0
1668533268953,CSE 291,C00,102453,Vaccaro; Kristen Marie,0,0,0,0
1668533268953,CSE 291,D00,111343,Savage; Stefan,0,0,0,0
1668533268953,CSE 291,E00,116474,Claffy; Kimberly Claire,0,0,0,0
1668533268953,CSE 291,F00,116479,Pasquale; Joseph,0,0,0,0
1668533269406,CSE 293,001,119111,Bafna; Vineet,9999,0,9999,0
1668533269406,CSE 293,002,119118,Bellare; Mihir,9999,0,9999,0
1668533269406,CSE 293,003,119122,Berg-Kirkpatrick; Taylor D,9999,0,9999,0
1668533269406,CSE 293,004,119135,Christensen; Henrik I,9999,0,9999,0
1668533269406,CSE 293,005,119142,Cottrell; Garrison W,9999,0,9999,0
1668533269406,CSE 293,006,119146,Deutsch; Alin Bernard,9999,0,9999,0
1668533269406,CSE 293,007,119159,Esmaeilzadeh; Hadi,9999,0,9999,0
1668533269406,CSE 293,008,119166,Freund; Yoav,9999,0,9999,0
1668533269406,CSE 293,009,119170,Griswold; William G.,9999,0,9999,0
1668533269406,CSE 293,010,119183,Gymrek; Melissa Ann,9999,0,9999,0
1668533269406,CSE 293,011,119190,Heninger; Nadia A,9999,0,9999,0
1668533269406,CSE 293,012,119230,Impagliazzo; Russell,9999,0,9999,0
1668533269406,CSE 293,013,119232,Jhala; Ranjit,9999,0,9999,0
1668533269406,CSE 293,014,119233,Kahng; Andrew Byun,9999,0,9999,0
1668533269406,CSE 293,015,119298,Kane; Daniel Mertz,9999,0,9999,0
1668533269406,CSE 293,016,119299,Kriegman; David J,9999,0,9999,0
1668533269406,CSE 293,017,119300,Kumar; Arun Kumar,9999,0,9999,0
1668533269406,CSE 293,018,119301,Lerner; Sorin,9999,0,9999,0
1668533269406,CSE 293,019,119302,Lovett; Shachar,9999,0,9999,0
1668533269406,CSE 293,020,119303,McAuley; Julian John,9999,0,9999,0
1668533269406,CSE 293,021,119304,Micciancio; Daniele,9999,0,9999,0
1668533269406,CSE 293,022,119367,Orailoglu; Alex,9999,0,9999,0
1668533269406,CSE 293,023,119382,Paturi; Ramamohan,9999,0,9999,0
1668533269406,CSE 293,024,119404,Polikarpova; Nadezhda,9999,0,9999,0
1668533269406,CSE 293,025,119406,Politz; Joseph Gibbs,9999,0,9999,0
1668533269406,CSE 293,026,119411,Porter; George M,9999,0,9999,0
1668533269406,CSE 293,027,119414,Porter; Leonard Emerson,9999,0,9999,0
1668533269406,CSE 293,028,119416,Ramamoorthi; Ravi,9999,0,9999,0
1668533269406,CSE 293,029,119417,Sahoo; Debashis,9999,0,9999,0
1668533269406,CSE 293,030,119420,Saul; Lawrence,9999,0,9999,0
1668533269406,CSE 293,031,119421,Savage; Stefan,9999,0,9999,0
1668533269406,CSE 293,032,119425,Schulze; Jurgen P.,9999,0,9999,0
1668533269406,CSE 293,033,119426,Snoeren; Alex C.,9999,0,9999,0
1668533269406,CSE 293,034,119428,Shang; Jingbo,9999,0,9999,0
1668533269406,CSE 293,035,119430,Stefan; Deian,9999,0,9999,0
1668533269406,CSE 293,036,119431,Su; Hao,9999,0,9999,0
1668533269406,CSE 293,037,119433,Swanson; Steven James,9999,0,9999,0
1668533269406,CSE 293,038,119435,Tullsen; Dean Michael,9999,0,9999,0
1668533269406,CSE 293,039,119483,Voelker; Geoffrey M.,9999,0,9999,0
1668533269406,CSE 293,040,119537,Zhao; Jishen,9999,0,9999,0
1668533269406,CSE 293,041,119538,Zhou; Yuan-Yuan,9999,0,9999,0
1668533269406,CSE 293,042,119539,Gao; Sicun,9999,0,9999,0
1668533269406,CSE 293,043,119540,Weibel; Nadir,9999,0,9999,0
1668533269406,CSE 293,044,119541,Gupta; Rajesh K.,9999,0,9999,0
1668533269406,CSE 293,045,126410,Vaccaro; Kristen Marie,9999,0,9999,0
1668533269406,CSE 293,046,126411,Klemke; Richard,9999,0,9999,0
1668533269830,CSE 294,A00,102459,Voelker; Geoffrey M.,0,2,0,0
1668533269830,CSE 294,B00,111322,Orailoglu; Alex,0,2,0,0
1668533270254,DSE 201,A00,096914,Deutsch; Alin Bernard,30,0,30,0
1668533270689,DSE 210,A00,096915,Dasgupta; Sanjoy,30,0,30,0
1668533271112,DSE 260A,A00,096916,Altintas De Callaf; Ilkay,30,0,30,0
1668533271582,ECE 200,001,103586,Antipa; Nicholas A,9999,0,9999,0
1668533271582,ECE 200,002,103587,Atanasov; Nikolay A.,9999,0,9999,0
1668533271582,ECE 200,003,103588,Bharadia; Dinesh,9999,0,9999,0
1668533271582,ECE 200,004,103589,Cheng; Chung Kuan,9999,0,9999,0
1668533271582,ECE 200,005,103590,Cosman; Pamela C.,9999,0,9999,0
1668533271582,ECE 200,006,103591,Dayeh; Shadi Ahmad,9999,0,9999,0
1668533271582,ECE 200,007,103592,Fainman; Yeshaiahu,9999,0,9999,0
1668533271582,ECE 200,008,103593,Ford; Joseph Earl,9999,0,9999,0
1668533271582,ECE 200,009,103594,Franceschetti; Massimo,9999,0,9999,0
1668533271582,ECE 200,010,103595,Fullerton; Eric E,9999,0,9999,0
1668533271582,ECE 200,011,103596,Galton; Ian A,9999,0,9999,0
1668533271582,ECE 200,012,103597,Gilja; Vikash,9999,0,9999,0
1668533271582,ECE 200,013,103598,Hall; Drew A.,9999,0,9999,0
1668533271582,ECE 200,014,103599,Hsueh; Tzu-Chien,9999,0,9999,0
1668533271582,ECE 200,015,103600,Javidi; Tara,9999,0,9999,0
1668533271582,ECE 200,016,103601,Kahng; Andrew Byun,9999,0,9999,0
1668533271582,ECE 200,017,103602,Kim; Young-Han,9999,0,9999,0
1668533271582,ECE 200,018,103603,Koushanfar; Farinaz,9999,0,9999,0
1668533271582,ECE 200,019,103604,Kuzum; Duygu,9999,0,9999,0
1668533271582,ECE 200,020,103605,Le; Hanh-Phuc,9999,0,9999,0
1668533271582,ECE 200,021,103606,Lin; Bill,9999,0,9999,0
1668533271582,ECE 200,022,103607,Liu; Zhaowei,9998,0,9999,1
1668533271582,ECE 200,023,103608,Lo; Yu-Hwa,9999,0,9999,0
1668533271582,ECE 200,024,103609,Lomakin; Vitaliy,9999,0,9999,0
1668533271582,ECE 200,025,103610,Mercier; Patrick Philip,9999,0,9999,0
1668533271582,ECE 200,026,103611,Meyer; Florian,9999,0,9999,0
1668533271582,ECE 200,027,103612,Milstein; Laurence B.,9999,0,9999,0
1668533271582,ECE 200,028,103613,Mir Arabbaygi; Siavash,9999,0,9999,0
1668533271582,ECE 200,029,103614,Mookherjea; Shayan,9999,0,9999,0
1668533271582,ECE 200,030,103615,Morris; Karcher William,9999,0,9999,0
1668533271582,ECE 200,031,103616,Ng; Tse Nga,9999,0,9999,0
1668533271582,ECE 200,032,103617,Nguyen; Truong Quang,9999,0,9999,0
1668533271582,ECE 200,033,103618,Nomura; Kenji,9999,0,9999,0
1668533271582,ECE 200,034,103619,Orlitsky; Alon,9999,0,9999,0
1668533271582,ECE 200,035,103620,Pal; Piya,9999,0,9999,0
1668533271582,ECE 200,036,103621,Papen; George C.,9999,0,9999,0
1668533271582,ECE 200,037,103622,Radic; Stojan,9999,0,9999,0
1668533271582,ECE 200,038,103623,Rao; Bhaskar D.,9999,0,9999,0
1668533271582,ECE 200,039,103624,Rao; Ramesh R,9999,0,9999,0
1668533271582,ECE 200,040,103625,Rebeiz; Gabriel,9999,0,9999,0
1668533271582,ECE 200,041,103626,Sanford; John R,9999,0,9999,0
1668533271582,ECE 200,042,103627,Siegel; Paul H.,9999,0,9999,0
1668533271582,ECE 200,043,103628,Sievenpiper; Daniel F.,9999,0,9999,0
1668533271582,ECE 200,044,103629,Sworder; David D.,9999,0,9999,0
1668533271582,ECE 200,045,103630,Taur; Yuan,9999,0,9999,0
1668533271582,ECE 200,046,103631,Touri; Behrouz,9999,0,9999,0
1668533271582,ECE 200,047,103632,Trivedi; Mohan M.,9999,0,9999,0
1668533271582,ECE 200,048,103633,Vasconcelos; Nuno,9999,0,9999,0
1668533271582,ECE 200,049,103634,Wang; Xiaolong,9999,0,9999,0
1668533271582,ECE 200,050,103635,Xie; Pengtao,9999,0,9999,0
1668533271582,ECE 200,051,103636,Yip; Michael,9999,0,9999,0
1668533271582,ECE 200,052,103637,Zeger; Kenneth A.,999,0,999,0
1668533271582,ECE 200,053,103638,Zhang; Xinyu,9999,0,9999,0
1668533271582,ECE 200,054,103639,Turakhia; Yatish Girish,9999,0,9999,0
1668533271582,ECE 200,055,103640,Kang; Mingu,9999,0,9999,0
1668533271582,ECE 200,056,103641,Shi; Yuanyuan,9999,0,9999,0
1668533271582,ECE 200,057,103642,Wang; Edward Jay,9999,0,9999,0
1668533271582,ECE 200,058,103643,Zheng; Yang,9999,0,9999,0
1668533272008,ECE 202,A00,103644,Kuzum; Duygu,0,44,0,0
1668533272447,ECE 212BN,A00,103646,Ng; Tse Nga,0,9,0,0
1668533272901,ECE 221,A00,111493,Staff,0,0,0,0
1668533273328,ECE 222B,A00,103647,Lomakin; Vitaliy,0,20,0,0
1668533273752,ECE 230B,A00,103648,Taur; Yuan,0,3,0,0
1668533274197,ECE 238B,A00,103649,Garay; Javier,0,0,0,0
1668533274619,ECE 240B,A00,112900,Fainman; Yeshaiahu,0,7,0,0
1668533275044,ECE 247A,A00,103650,Jokerst; Jesse Vincent,0,6,0,0
1668533275468,ECE 247B,A00,103651,Wang; Joseph,0,14,0,0
1668533275895,ECE 250,A00,103652,Siegel; Paul H.,0,82,0,0
1668533276320,ECE 251A,A00,103654,Rao; Bhaskar D.,0,62,0,0
1668533276756,ECE 257B,A00,103655,Bharadia; Dinesh,0,33,0,0
1668533277196,ECE 258A,A00,103656,Milstein; Laurence B.,0,29,0,0
1668533277625,ECE 260B,A00,103658,Kang; Mingu,0,121,0,0
1668533278050,ECE 264A,A00,103659,Galton; Ian A,0,67,0,0
1668533278487,ECE 265A,A00,103661,Gudem; Prasad S.S.,0,71,0,0
1668533278924,ECE 265D,A00,103662,Gudem; Prasad S.S.,0,26,0,0
1668533279349,ECE 268,A00,103663,Koushanfar; Farinaz,0,43,0,0
1668533279784,ECE 269,A01,103665,Pal; Piya,0,216,0,0
1668533280213,ECE 271B,A00,103666,Vasconcelos; Manuela,0,76,0,0
1668533280638,ECE 276A,A00,103667,Atanasov; Nikolay A.,0,127,0,0
1668533281064,ECE 277,A00,103668,An; Cheolhong,0,150,0,0
1668533281489,ECE 279,A00,117947,Hall; Drew A.,0,22,0,0
1668533282353,ECE 283,A00,103670,Hsueh; Tzu-Chien,0,55,0,0
1668533282779,ECE 284,A00,103671,Turakhia; Yatish Girish,0,39,0,0
1668533283207,ECE 285,A00,103672,Zheng; Yang,0,40,0,0
1668533283207,ECE 285,B00,103673,Sworder; David D.,0,57,0,0
1668533283635,ECE 287,A00,103676,Javidi; Tara,0,9,0,0
1668533284059,MATH 200B,A00,098023,Salehi Golsefidy; Alireza,10,0,15,5
1668533284488,MATH 202B,A00,098024,Rhoades; Brendon Patrick,7,0,15,8
1668533284914,MATH 203B,A00,098025,Oprea; Dragos N.,9,0,15,6
1668533285350,MATH 204B,A00,098026,Sorensen; Claus M,13,0,15,2
1668533285779,MATH 208,A00,098027,Izadi; Elham,7,0,10,3
1668533286222,MATH 209,A00,098028,Pollack; Aaron,10,0,10,0
1668533286645,MATH 211A,A00,112919,Rogalski; Daniel,8,0,10,2
1668533287069,MATH 211B,A00,112920,Seward; Brandon M.,9,0,10,1
1668533287500,MATH 218,A00,098029,Li; Bo,10,0,10,0
1668533287929,MATH 220B,A00,098030,Novak; Jonathan I,11,0,15,4
1668533288359,MATH 221A,A00,098031,Ebenfelt; Peter F,12,0,15,3
1668533288789,MATH 231B,A00,098032,Zlatos; Andrej,11,0,15,4
1668533289304,MATH 240B,A00,098033,Ni; Lei,7,0,15,8
1668533289728,MATH 243,A00,098034,Jekel; David Andrew,10,0,10,0
1668533290154,MATH 245A,A00,098035,Nie; Jiawang,0,5,15,18
1668533290585,MATH 248,A00,098036,Bejenaru; Ioan,10,0,10,0
1668533291011,MATH 250B,A00,098037,Spolaor; Luca,14,0,15,1
1668533291456,MATH 258,A00,098038,Ni; Lei,9,0,10,1
1668533291881,MATH 264B,A00,098041,Rhoades; Brendon Patrick,8,0,15,7
1668533292307,MATH 268,A00,098042,Buss; Samuel R,10,0,10,0
1668533292734,MATH 269,A00,098043,Rhoades; Brendon Patrick,10,0,10,0
1668533293176,MATH 270B,A00,098044,Li; Bo,6,0,15,9
1668533293600,MATH 272B,A00,098045,Holst; Michael J,13,0,15,2
1668533294030,MATH 273A,A00,098046,Tian; Xiaochuan,10,0,15,5
1668533294460,MATH 275,A01,098048,Tian; Xiaochuan,6,0,10,4
1668533294884,MATH 278A,A00,098049,Holst; Michael J,7,0,10,3
1668533295320,MATH 278B,A00,098050,Cloninger; Alexander,10,0,10,0
1668533295756,MATH 278C,A00,098051,Nie; Jiawang,5,0,10,5
1668533296182,MATH 280B,A00,098052,Zheng; Tianyi,7,0,15,8
1668533296611,MATH 281B,A00,098053,Bradic; Jelena,0,2,15,15
1668533297046,MATH 282B,A00,098054,Arias-Castro; Ery,0,1,15,15
1668533297490,MATH 285,A00,098055,Fitzsimmons; Patrick J,0,3,15,17
1668533297914,MATH 287B,A00,098056,Arias-Castro; Ery,1,0,15,14
1668533298346,MATH 288,A00,098057,Agarwal; Pooja,9,0,10,1
1668533298346,MATH 288,B00,098058,Zhang; Danna,8,0,10,2
1668533298346,MATH 288,C00,098059,Williams; Ruth J,9,0,10,1
1668533298775,MATH 290B,A00,098060,Roberts; Justin Deritter,12,0,15,3
1668533299198,MATH 292,A00,098061,Belmont; Eva Kinoshita,10,0,10,0
1668533299621,MATH 295,A00,098062,Suk; Andrew Hoon,47,0,50,3
1668533300052,MATH 296,A00,098063,Novak; Jonathan I,20,0,20,0
1668533300484,MATH 297,001,098064,Gamst; Anthony Collins,9997,0,9999,2
1668533804673,COGS 205,A00,101395,Chiba; Andrea,19,0,20,1
1668533805101,COGS 210B,001,101404,Greene; Deanna Jacquelyn,9998,0,9999,1
1668533805101,COGS 210B,002,101417,Xia; Haijun,9999,0,9999,0
1668533805101,COGS 210B,003,101422,Nitz; Douglas A.,9999,0,9999,0
1668533805101,COGS 210B,004,101423,Hollan; James D.,9998,0,9999,1
1668533805101,COGS 210B,005,101424,Deak; Gedeon O.,9998,0,9999,1
1668533805101,COGS 210B,006,101425,Rossano; Federico,9999,0,9999,0
1668533805530,COGS 211B,A00,101427,Coulson; Seana M,9996,0,9999,3
1668533805961,COGS 220,A00,101428,Hollan; James D.,0,10,25,25
1668533806388,COGS 229,A00,101429,Dow; Steven P,17,0,25,8
1668533806816,COGS 230,A00,101430,Klemmer; Scott R,7,0,17,10
1668533807241,COGS 234,A00,101431,Xia; Haijun,1,0,25,24
1668533807674,COGS 260,A00,101432,Kiyonaga; Anastasia,21,0,25,4
1668533807674,COGS 260,B00,101433,Kirsh; David Joel,15,0,25,10
1668533808098,CSE 202,A00,102371,Impagliazzo; Russell,0,66,0,0
1668533808524,CSE 203B,A01,102373,Cheng; Chung Kuan,0,59,0,0
1668533808949,CSE 208,A00,102374,Micciancio; Daniele,0,5,0,0
1668533809378,CSE 209A,A00,112895,Impagliazzo; Russell,0,12,15,15
1668533809809,CSE 209B,A00,108005,Bellare; Mihir,0,7,0,0
1668533810237,CSE 210,A00,113163,Coblenz; Michael J,0,86,0,0
1668533810662,CSE 219,A00,106111,Dow; Steven P,0,7,20,20
1668533811089,CSE 221,A00,102376,Voelker; Geoffrey M.,0,73,0,0
1668533811517,CSE 224,A01,102378,Porter; George M,0,168,0,0
1668533811949,CSE 229A,A00,102379,Savage; Stefan,0,11,0,0
1668533812480,CSE 229C,A00,102380,Munyaka; Imani N. S.,0,10,0,0
1668533812919,CSE 232B,A00,102382,Deutsch; Alin Bernard,0,34,0,0
1668533813355,CSE 234,A01,112904,Kumar; Arun Kumar,0,0,0,0
1668533813789,CSE 237A,A00,102383,Rosing; Tajana Simunic,0,56,0,0
1668533814223,CSE 239A,A00,102384,Deutsch; Alin Bernard,0,15,0,0
1668533814648,CSE 239B,A00,102385,Polikarpova; Nadezhda,0,11,0,0
1668533815085,CSE 240A,A00,102386,Pannuto; Patrick William,0,46,0,0
1668533815518,CSE 240B,A00,102387,Zhao; Jishen,0,48,0,0
1668533815941,CSE 241A,A00,106406,Kang; Mingu,0,9,0,0
1668533816363,CSE 249B,A00,102388,Kahng; Andrew Byun,0,5,8,8
1668533816791,CSE 251B,A01,102392,Cottrell; Garrison W,0,51,0,0
1668533816791,CSE 251B,A02,102393,Cottrell; Garrison W,0,35,0,0
1668533817215,CSE 252B,A00,102394,Ochoa; Benjamin Lawrence,0,60,0,0
1668533817649,CSE 257,A01,102396,Gao; Sicun,0,139,0,0
1668533818080,CSE 272,A00,102397,Li; Tzumao,0,19,0,0
1668533818504,CSE 274,A00,111323,Chern; Albert Ren-Haur,0,15,0,0
1668533818937,CSE 282,A00,102398,Pevzner; Pavel Arkadjevich,0,0,0,0
1668533819364,CSE 284,A00,114175,Gymrek; Melissa Ann,0,23,0,0
1668533819793,CSE 290,A00,102399,Chandraker; Manmohan Krishna,0,11,0,0
1668533819793,CSE 290,B00,102400,Vaccaro; Kristen Marie,0,7,25,25
1668533819793,CSE 290,C00,102414,Pannuto; Patrick William,0,1,25,25
1668533819793,CSE 290,D00,102427,Pevzner; Pavel Arkadjevich,0,0,0,0
1668533819793,CSE 290,E00,102429,Zhao; Jishen,0,5,0,0
1668533819793,CSE 290,F00,102436,Tullsen; Dean Michael,0,6,0,0
1668533819793,CSE 290,G00,102440,Christensen; Henrik I,0,6,20,20
1668533820235,CSE 291,A00,102443,Su; Hao,0,0,0,0
1668533820235,CSE 291,B00,102448,Polikarpova; Nadezhda,0,0,0,0
1668533820235,CSE 291,C00,102453,Vaccaro; Kristen Marie,0,0,0,0
1668533820235,CSE 291,D00,111343,Savage; Stefan,0,0,0,0
1668533820235,CSE 291,E00,116474,Claffy; Kimberly Claire,0,0,0,0
1668533820235,CSE 291,F00,116479,Pasquale; Joseph,0,0,0,0
1668533820696,CSE 293,001,119111,Bafna; Vineet,9999,0,9999,0
1668533820696,CSE 293,002,119118,Bellare; Mihir,9999,0,9999,0
1668533820696,CSE 293,003,119122,Berg-Kirkpatrick; Taylor D,9999,0,9999,0
1668533820696,CSE 293,004,119135,Christensen; Henrik I,9999,0,9999,0
1668533820696,CSE 293,005,119142,Cottrell; Garrison W,9999,0,9999,0
1668533820696,CSE 293,006,119146,Deutsch; Alin Bernard,9999,0,9999,0
1668533820696,CSE 293,007,119159,Esmaeilzadeh; Hadi,9999,0,9999,0
1668533820696,CSE 293,008,119166,Freund; Yoav,9999,0,9999,0
1668533820696,CSE 293,009,119170,Griswold; William G.,9999,0,9999,0
1668533820696,CSE 293,010,119183,Gymrek; Melissa Ann,9999,0,9999,0
1668533820696,CSE 293,011,119190,Heninger; Nadia A,9999,0,9999,0
1668533820696,CSE 293,012,119230,Impagliazzo; Russell,9999,0,9999,0
1668533820696,CSE 293,013,119232,Jhala; Ranjit,9999,0,9999,0
1668533820696,CSE 293,014,119233,Kahng; Andrew Byun,9999,0,9999,0
1668533820696,CSE 293,015,119298,Kane; Daniel Mertz,9999,0,9999,0
1668533820696,CSE 293,016,119299,Kriegman; David J,9999,0,9999,0
1668533820696,CSE 293,017,119300,Kumar; Arun Kumar,9999,0,9999,0
1668533820696,CSE 293,018,119301,Lerner; Sorin,9999,0,9999,0
1668533820696,CSE 293,019,119302,Lovett; Shachar,9999,0,9999,0
1668533820696,CSE 293,020,119303,McAuley; Julian John,9999,0,9999,0
1668533820696,CSE 293,021,119304,Micciancio; Daniele,9999,0,9999,0
1668533820696,CSE 293,022,119367,Orailoglu; Alex,9999,0,9999,0
1668533820696,CSE 293,023,119382,Paturi; Ramamohan,9999,0,9999,0
1668533820696,CSE 293,024,119404,Polikarpova; Nadezhda,9999,0,9999,0
1668533820696,CSE 293,025,119406,Politz; Joseph Gibbs,9999,0,9999,0
1668533820696,CSE 293,026,119411,Porter; George M,9999,0,9999,0
1668533820696,CSE 293,027,119414,Porter; Leonard Emerson,9999,0,9999,0
1668533820696,CSE 293,028,119416,Ramamoorthi; Ravi,9999,0,9999,0
1668533820696,CSE 293,029,119417,Sahoo; Debashis,9999,0,9999,0
1668533820696,CSE 293,030,119420,Saul; Lawrence,9999,0,9999,0
1668533820696,CSE 293,031,119421,Savage; Stefan,9999,0,9999,0
1668533820696,CSE 293,032,119425,Schulze; Jurgen P.,9999,0,9999,0
1668533820696,CSE 293,033,119426,Snoeren; Alex C.,9999,0,9999,0
1668533820696,CSE 293,034,119428,Shang; Jingbo,9999,0,9999,0
1668533820696,CSE 293,035,119430,Stefan; Deian,9999,0,9999,0
1668533820696,CSE 293,036,119431,Su; Hao,9999,0,9999,0
1668533820696,CSE 293,037,119433,Swanson; Steven James,9999,0,9999,0
1668533820696,CSE 293,038,119435,Tullsen; Dean Michael,9999,0,9999,0
1668533820696,CSE 293,039,119483,Voelker; Geoffrey M.,9999,0,9999,0
1668533820696,CSE 293,040,119537,Zhao; Jishen,9999,0,9999,0
1668533820696,CSE 293,041,119538,Zhou; Yuan-Yuan,9999,0,9999,0
1668533820696,CSE 293,042,119539,Gao; Sicun,9999,0,9999,0
1668533820696,CSE 293,043,119540,Weibel; Nadir,9999,0,9999,0
1668533820696,CSE 293,044,119541,Gupta; Rajesh K.,9999,0,9999,0
1668533820696,CSE 293,045,126410,Vaccaro; Kristen Marie,9999,0,9999,0
1668533820696,CSE 293,046,126411,Klemke; Richard,9999,0,9999,0
1668533821119,CSE 294,A00,102459,Voelker; Geoffrey M.,0,2,0,0
1668533821119,CSE 294,B00,111322,Orailoglu; Alex,0,2,0,0
1668533821543,DSE 201,A00,096914,Deutsch; Alin Bernard,30,0,30,0
1668533821965,DSE 210,A00,096915,Dasgupta; Sanjoy,30,0,30,0
1668533822395,DSE 260A,A00,096916,Altintas De Callaf; Ilkay,30,0,30,0
1668533822822,ECE 200,001,103586,Antipa; Nicholas A,9999,0,9999,0
1668533822822,ECE 200,002,103587,Atanasov; Nikolay A.,9999,0,9999,0
1668533822822,ECE 200,003,103588,Bharadia; Dinesh,9999,0,9999,0
1668533822822,ECE 200,004,103589,Cheng; Chung Kuan,9999,0,9999,0
1668533822822,ECE 200,005,103590,Cosman; Pamela C.,9999,0,9999,0
1668533822822,ECE 200,006,103591,Dayeh; Shadi Ahmad,9999,0,9999,0
1668533822822,ECE 200,007,103592,Fainman; Yeshaiahu,9999,0,9999,0
1668533822822,ECE 200,008,103593,Ford; Joseph Earl,9999,0,9999,0
1668533822822,ECE 200,009,103594,Franceschetti; Massimo,9999,0,9999,0
1668533822822,ECE 200,010,103595,Fullerton; Eric E,9999,0,9999,0
1668533822822,ECE 200,011,103596,Galton; Ian A,9999,0,9999,0
1668533822822,ECE 200,012,103597,Gilja; Vikash,9999,0,9999,0
1668533822822,ECE 200,013,103598,Hall; Drew A.,9999,0,9999,0
1668533822822,ECE 200,014,103599,Hsueh; Tzu-Chien,9999,0,9999,0
1668533822822,ECE 200,015,103600,Javidi; Tara,9999,0,9999,0
1668533822822,ECE 200,016,103601,Kahng; Andrew Byun,9999,0,9999,0
1668533822822,ECE 200,017,103602,Kim; Young-Han,9999,0,9999,0
1668533822822,ECE 200,018,103603,Koushanfar; Farinaz,9999,0,9999,0
1668533822822,ECE 200,019,103604,Kuzum; Duygu,9999,0,9999,0
1668533822822,ECE 200,020,103605,Le; Hanh-Phuc,9999,0,9999,0
1668533822822,ECE 200,021,103606,Lin; Bill,9999,0,9999,0
1668533822822,ECE 200,022,103607,Liu; Zhaowei,9998,0,9999,1
1668533822822,ECE 200,023,103608,Lo; Yu-Hwa,9999,0,9999,0
1668533822822,ECE 200,024,103609,Lomakin; Vitaliy,9999,0,9999,0
1668533822822,ECE 200,025,103610,Mercier; Patrick Philip,9999,0,9999,0
1668533822822,ECE 200,026,103611,Meyer; Florian,9999,0,9999,0
1668533822822,ECE 200,027,103612,Milstein; Laurence B.,9999,0,9999,0
1668533822822,ECE 200,028,103613,Mir Arabbaygi; Siavash,9999,0,9999,0
1668533822822,ECE 200,029,103614,Mookherjea; Shayan,9999,0,9999,0
1668533822822,ECE 200,030,103615,Morris; Karcher William,9999,0,9999,0
1668533822822,ECE 200,031,103616,Ng; Tse Nga,9999,0,9999,0
1668533822822,ECE 200,032,103617,Nguyen; Truong Quang,9999,0,9999,0
1668533822822,ECE 200,033,103618,Nomura; Kenji,9999,0,9999,0
1668533822822,ECE 200,034,103619,Orlitsky; Alon,9999,0,9999,0
1668533822822,ECE 200,035,103620,Pal; Piya,9999,0,9999,0
1668533822822,ECE 200,036,103621,Papen; George C.,9999,0,9999,0
1668533822822,ECE 200,037,103622,Radic; Stojan,9999,0,9999,0
1668533822822,ECE 200,038,103623,Rao; Bhaskar D.,9999,0,9999,0
1668533822822,ECE 200,039,103624,Rao; Ramesh R,9999,0,9999,0
1668533822822,ECE 200,040,103625,Rebeiz; Gabriel,9999,0,9999,0
1668533822822,ECE 200,041,103626,Sanford; John R,9999,0,9999,0
1668533822822,ECE 200,042,103627,Siegel; Paul H.,9999,0,9999,0
1668533822822,ECE 200,043,103628,Sievenpiper; Daniel F.,9999,0,9999,0
1668533822822,ECE 200,044,103629,Sworder; David D.,9999,0,9999,0
1668533822822,ECE 200,045,103630,Taur; Yuan,9999,0,9999,0
1668533822822,ECE 200,046,103631,Touri; Behrouz,9999,0,9999,0
1668533822822,ECE 200,047,103632,Trivedi; Mohan M.,9999,0,9999,0
1668533822822,ECE 200,048,103633,Vasconcelos; Nuno,9999,0,9999,0
1668533822822,ECE 200,049,103634,Wang; Xiaolong,9999,0,9999,0
1668533822822,ECE 200,050,103635,Xie; Pengtao,9999,0,9999,0
1668533822822,ECE 200,051,103636,Yip; Michael,9999,0,9999,0
1668533822822,ECE 200,052,103637,Zeger; Kenneth A.,999,0,999,0
1668533822822,ECE 200,053,103638,Zhang; Xinyu,9999,0,9999,0
1668533822822,ECE 200,054,103639,Turakhia; Yatish Girish,9999,0,9999,0
1668533822822,ECE 200,055,103640,Kang; Mingu,9999,0,9999,0
1668533822822,ECE 200,056,103641,Shi; Yuanyuan,9999,0,9999,0
1668533822822,ECE 200,057,103642,Wang; Edward Jay,9999,0,9999,0
1668533822822,ECE 200,058,103643,Zheng; Yang,9999,0,9999,0
1668533823251,ECE 202,A00,103644,Kuzum; Duygu,0,44,0,0
1668533823673,ECE 212BN,A00,103646,Ng; Tse Nga,0,9,0,0
1668533824102,ECE 221,A00,111493,Staff,0,0,0,0
1668533824530,ECE 222B,A00,103647,Lomakin; Vitaliy,0,20,0,0
1668533824962,ECE 230B,A00,103648,Taur; Yuan,0,3,0,0
1668533825386,ECE 238B,A00,103649,Garay; Javier,0,0,0,0
1668533825812,ECE 240B,A00,112900,Fainman; Yeshaiahu,0,7,0,0
1668533826237,ECE 247A,A00,103650,Jokerst; Jesse Vincent,0,6,0,0
1668533826661,ECE 247B,A00,103651,Wang; Joseph,0,14,0,0
1668533827098,ECE 250,A00,103652,Siegel; Paul H.,0,82,0,0
1668533827527,ECE 251A,A00,103654,Rao; Bhaskar D.,0,62,0,0
1668533827949,ECE 257B,A00,103655,Bharadia; Dinesh,0,33,0,0
1668533828390,ECE 258A,A00,103656,Milstein; Laurence B.,0,29,0,0
1668533828846,ECE 260B,A00,103658,Kang; Mingu,0,121,0,0
1668533829280,ECE 264A,A00,103659,Galton; Ian A,0,67,0,0
1668533829713,ECE 265A,A00,103661,Gudem; Prasad S.S.,0,71,0,0
1668533830137,ECE 265D,A00,103662,Gudem; Prasad S.S.,0,26,0,0
1668533830560,ECE 268,A00,103663,Koushanfar; Farinaz,0,43,0,0
1668533830983,ECE 269,A01,103665,Pal; Piya,0,216,0,0
1668533831406,ECE 271B,A00,103666,Vasconcelos; Manuela,0,76,0,0
1668533831830,ECE 276A,A00,103667,Atanasov; Nikolay A.,0,127,0,0
1668533832260,ECE 277,A00,103668,An; Cheolhong,0,150,0,0
1668533832696,ECE 279,A00,117947,Hall; Drew A.,0,22,0,0
1668533833551,ECE 283,A00,103670,Hsueh; Tzu-Chien,0,55,0,0
1668533833977,ECE 284,A00,103671,Turakhia; Yatish Girish,0,39,0,0
1668533834405,ECE 285,A00,103672,Zheng; Yang,0,40,0,0
1668533834405,ECE 285,B00,103673,Sworder; David D.,0,57,0,0
1668533834828,ECE 287,A00,103676,Javidi; Tara,0,9,0,0
1668533835250,MATH 200B,A00,098023,Salehi Golsefidy; Alireza,10,0,15,5
1668533835679,MATH 202B,A00,098024,Rhoades; Brendon Patrick,7,0,15,8
1668533836108,MATH 203B,A00,098025,Oprea; Dragos N.,9,0,15,6
1668533836541,MATH 204B,A00,098026,Sorensen; Claus M,13,0,15,2
1668533836967,MATH 208,A00,098027,Izadi; Elham,7,0,10,3
1668533837406,MATH 209,A00,098028,Pollack; Aaron,10,0,10,0
1668533837839,MATH 211A,A00,112919,Rogalski; Daniel,8,0,10,2
1668533838264,MATH 211B,A00,112920,Seward; Brandon M.,9,0,10,1
1668533838687,MATH 218,A00,098029,Li; Bo,10,0,10,0
1668533839117,MATH 220B,A00,098030,Novak; Jonathan I,11,0,15,4
1668533839541,MATH 221A,A00,098031,Ebenfelt; Peter F,12,0,15,3
1668533839966,MATH 231B,A00,098032,Zlatos; Andrej,11,0,15,4
1668533840395,MATH 240B,A00,098033,Ni; Lei,7,0,15,8
1668533840833,MATH 243,A00,098034,Jekel; David Andrew,10,0,10,0
1668533841263,MATH 245A,A00,098035,Nie; Jiawang,0,5,15,18
1668533841691,MATH 248,A00,098036,Bejenaru; Ioan,10,0,10,0
1668533842117,MATH 250B,A00,098037,Spolaor; Luca,14,0,15,1
1668533842547,MATH 258,A00,098038,Ni; Lei,9,0,10,1
1668533842973,MATH 264B,A00,098041,Rhoades; Brendon Patrick,8,0,15,7
1668533843413,MATH 268,A00,098042,Buss; Samuel R,10,0,10,0
1668533843849,MATH 269,A00,098043,Rhoades; Brendon Patrick,10,0,10,0
1668533844271,MATH 270B,A00,098044,Li; Bo,6,0,15,9
1668533844705,MATH 272B,A00,098045,Holst; Michael J,13,0,15,2
1668533845132,MATH 273A,A00,098046,Tian; Xiaochuan,10,0,15,5
1668533845558,MATH 275,A01,098048,Tian; Xiaochuan,6,0,10,4
1668533845990,MATH 278A,A00,098049,Holst; Michael J,7,0,10,3
1668533846417,MATH 278B,A00,098050,Cloninger; Alexander,10,0,10,0
1668533846839,MATH 278C,A00,098051,Nie; Jiawang,5,0,10,5
1668533847273,MATH 280B,A00,098052,Zheng; Tianyi,7,0,15,8
1668533847696,MATH 281B,A00,098053,Bradic; Jelena,0,2,15,15
1668533848118,MATH 282B,A00,098054,Arias-Castro; Ery,0,1,15,15
1668533848542,MATH 285,A00,098055,Fitzsimmons; Patrick J,0,3,15,17
1668533848975,MATH 287B,A00,098056,Arias-Castro; Ery,1,0,15,14
1668533849399,MATH 288,A00,098057,Agarwal; Pooja,9,0,10,1
1668533849399,MATH 288,B00,098058,Zhang; Danna,8,0,10,2
1668533849399,MATH 288,C00,098059,Williams; Ruth J,9,0,10,1
1668533849827,MATH 290B,A00,098060,Roberts; Justin Deritter,12,0,15,3
1668533850265,MATH 292,A00,098061,Belmont; Eva Kinoshita,10,0,10,0
1668533850687,MATH 295,A00,098062,Suk; Andrew Hoon,47,0,50,3
1668533851113,MATH 296,A00,098063,Novak; Jonathan I,20,0,20,0
1668533851537,MATH 297,001,098064,Gamst; Anthony Collins,9997,0,9999,2
1668534368277,COGS 205,A00,101395,Chiba; Andrea,19,0,20,1
1668534368714,COGS 210B,001,101404,Greene; Deanna Jacquelyn,9998,0,9999,1
1668534368714,COGS 210B,002,101417,Xia; Haijun,9999,0,9999,0
1668534368714,COGS 210B,003,101422,Nitz; Douglas A.,9999,0,9999,0
1668534368714,COGS 210B,004,101423,Hollan; James D.,9998,0,9999,1
1668534368714,COGS 210B,005,101424,Deak; Gedeon O.,9998,0,9999,1
1668534368714,COGS 210B,006,101425,Rossano; Federico,9999,0,9999,0
1668534369137,COGS 211B,A00,101427,Coulson; Seana M,9996,0,9999,3
1668534369560,COGS 220,A00,101428,Hollan; James D.,0,10,25,25
1668534369992,COGS 229,A00,101429,Dow; Steven P,17,0,25,8
1668534370419,COGS 230,A00,101430,Klemmer; Scott R,7,0,17,10
1668534370847,COGS 234,A00,101431,Xia; Haijun,1,0,25,24
1668534371291,COGS 260,A00,101432,Kiyonaga; Anastasia,21,0,25,4
1668534371291,COGS 260,B00,101433,Kirsh; David Joel,15,0,25,10
1668534371725,CSE 202,A00,102371,Impagliazzo; Russell,0,66,0,0
1668534372153,CSE 203B,A01,102373,Cheng; Chung Kuan,0,59,0,0
1668534372580,CSE 208,A00,102374,Micciancio; Daniele,0,5,0,0
1668534373016,CSE 209A,A00,112895,Impagliazzo; Russell,0,12,15,15
1668534373441,CSE 209B,A00,108005,Bellare; Mihir,0,7,0,0
1668534373868,CSE 210,A00,113163,Coblenz; Michael J,0,86,0,0
1668534374298,CSE 219,A00,106111,Dow; Steven P,0,7,20,20
1668534374736,CSE 221,A00,102376,Voelker; Geoffrey M.,0,72,0,0
1668534375175,CSE 224,A01,102378,Porter; George M,0,168,0,0
1668534375601,CSE 229A,A00,102379,Savage; Stefan,0,11,0,0
1668534376033,CSE 229C,A00,102380,Munyaka; Imani N. S.,0,10,0,0
1668534376459,CSE 232B,A00,102382,Deutsch; Alin Bernard,0,35,0,0
1668534376883,CSE 234,A01,112904,Kumar; Arun Kumar,0,0,0,0
1668534377307,CSE 237A,A00,102383,Rosing; Tajana Simunic,0,56,0,0
1668534377733,CSE 239A,A00,102384,Deutsch; Alin Bernard,0,16,0,0
1668534378163,CSE 239B,A00,102385,Polikarpova; Nadezhda,0,11,0,0
1668534378589,CSE 240A,A00,102386,Pannuto; Patrick William,0,46,0,0
1668534379031,CSE 240B,A00,102387,Zhao; Jishen,0,48,0,0
1668534379466,CSE 241A,A00,106406,Kang; Mingu,0,9,0,0
1668534379896,CSE 249B,A00,102388,Kahng; Andrew Byun,0,5,8,8
1668534380326,CSE 251B,A01,102392,Cottrell; Garrison W,0,50,0,0
1668534380326,CSE 251B,A02,102393,Cottrell; Garrison W,0,35,0,0
1668534380958,CSE 252B,A00,102394,Ochoa; Benjamin Lawrence,0,60,0,0
1668534381384,CSE 257,A01,102396,Gao; Sicun,0,140,0,0
1668534381822,CSE 272,A00,102397,Li; Tzumao,0,19,0,0
1668534382270,CSE 274,A00,111323,Chern; Albert Ren-Haur,0,15,0,0
1668534382705,CSE 282,A00,102398,Pevzner; Pavel Arkadjevich,0,0,0,0
1668534383140,CSE 284,A00,114175,Gymrek; Melissa Ann,0,23,0,0
1668534383578,CSE 290,A00,102399,Chandraker; Manmohan Krishna,0,11,0,0
1668534383578,CSE 290,B00,102400,Vaccaro; Kristen Marie,0,7,25,25
1668534383578,CSE 290,C00,102414,Pannuto; Patrick William,0,1,25,25
1668534383578,CSE 290,D00,102427,Pevzner; Pavel Arkadjevich,0,0,0,0
1668534383578,CSE 290,E00,102429,Zhao; Jishen,0,5,0,0
1668534383578,CSE 290,F00,102436,Tullsen; Dean Michael,0,6,0,0
1668534383578,CSE 290,G00,102440,Christensen; Henrik I,0,6,20,20
1668534384006,CSE 291,A00,102443,Su; Hao,0,0,0,0
1668534384006,CSE 291,B00,102448,Polikarpova; Nadezhda,0,0,0,0
1668534384006,CSE 291,C00,102453,Vaccaro; Kristen Marie,0,0,0,0
1668534384006,CSE 291,D00,111343,Savage; Stefan,0,0,0,0
1668534384006,CSE 291,E00,116474,Claffy; Kimberly Claire,0,0,0,0
1668534384006,CSE 291,F00,116479,Pasquale; Joseph,0,0,0,0
1668534384432,CSE 293,001,119111,Bafna; Vineet,9999,0,9999,0
1668534384432,CSE 293,002,119118,Bellare; Mihir,9999,0,9999,0
1668534384432,CSE 293,003,119122,Berg-Kirkpatrick; Taylor D,9999,0,9999,0
1668534384432,CSE 293,004,119135,Christensen; Henrik I,9999,0,9999,0
1668534384432,CSE 293,005,119142,Cottrell; Garrison W,9999,0,9999,0
1668534384432,CSE 293,006,119146,Deutsch; Alin Bernard,9999,0,9999,0
1668534384432,CSE 293,007,119159,Esmaeilzadeh; Hadi,9999,0,9999,0
1668534384432,CSE 293,008,119166,Freund; Yoav,9999,0,9999,0
1668534384432,CSE 293,009,119170,Griswold; William G.,9999,0,9999,0
1668534384432,CSE 293,010,119183,Gymrek; Melissa Ann,9999,0,9999,0
1668534384432,CSE 293,011,119190,Heninger; Nadia A,9999,0,9999,0
1668534384432,CSE 293,012,119230,Impagliazzo; Russell,9999,0,9999,0
1668534384432,CSE 293,013,119232,Jhala; Ranjit,9999,0,9999,0
1668534384432,CSE 293,014,119233,Kahng; Andrew Byun,9999,0,9999,0
1668534384432,CSE 293,015,119298,Kane; Daniel Mertz,9999,0,9999,0
1668534384432,CSE 293,016,119299,Kriegman; David J,9999,0,9999,0
1668534384432,CSE 293,017,119300,Kumar; Arun Kumar,9999,0,9999,0
1668534384432,CSE 293,018,119301,Lerner; Sorin,9999,0,9999,0
1668534384432,CSE 293,019,119302,Lovett; Shachar,9999,0,9999,0
1668534384432,CSE 293,020,119303,McAuley; Julian John,9999,0,9999,0
1668534384432,CSE 293,021,119304,Micciancio; Daniele,9999,0,9999,0
1668534384432,CSE 293,022,119367,Orailoglu; Alex,9999,0,9999,0
1668534384432,CSE 293,023,119382,Paturi; Ramamohan,9999,0,9999,0
1668534384432,CSE 293,024,119404,Polikarpova; Nadezhda,9999,0,9999,0
1668534384432,CSE 293,025,119406,Politz; Joseph Gibbs,9999,0,9999,0
1668534384432,CSE 293,026,119411,Porter; George M,9999,0,9999,0
1668534384432,CSE 293,027,119414,Porter; Leonard Emerson,9999,0,9999,0
1668534384432,CSE 293,028,119416,Ramamoorthi; Ravi,9999,0,9999,0
1668534384432,CSE 293,029,119417,Sahoo; Debashis,9999,0,9999,0
1668534384432,CSE 293,030,119420,Saul; Lawrence,9999,0,9999,0
1668534384432,CSE 293,031,119421,Savage; Stefan,9999,0,9999,0
1668534384432,CSE 293,032,119425,Schulze; Jurgen P.,9999,0,9999,0
1668534384432,CSE 293,033,119426,Snoeren; Alex C.,9999,0,9999,0
1668534384432,CSE 293,034,119428,Shang; Jingbo,9999,0,9999,0
1668534384432,CSE 293,035,119430,Stefan; Deian,9999,0,9999,0
1668534384432,CSE 293,036,119431,Su; Hao,9999,0,9999,0
1668534384432,CSE 293,037,119433,Swanson; Steven James,9999,0,9999,0
1668534384432,CSE 293,038,119435,Tullsen; Dean Michael,9999,0,9999,0
1668534384432,CSE 293,039,119483,Voelker; Geoffrey M.,9999,0,9999,0
1668534384432,CSE 293,040,119537,Zhao; Jishen,9999,0,9999,0
1668534384432,CSE 293,041,119538,Zhou; Yuan-Yuan,9999,0,9999,0
1668534384432,CSE 293,042,119539,Gao; Sicun,9999,0,9999,0
1668534384432,CSE 293,043,119540,Weibel; Nadir,9999,0,9999,0
1668534384432,CSE 293,044,119541,Gupta; Rajesh K.,9999,0,9999,0
1668534384432,CSE 293,045,126410,Vaccaro; Kristen Marie,9999,0,9999,0
1668534384432,CSE 293,046,126411,Klemke; Richard,9999,0,9999,0
1668534384869,CSE 294,A00,102459,Voelker; Geoffrey M.,0,2,0,0
1668534384869,CSE 294,B00,111322,Orailoglu; Alex,0,2,0,0
1668534385290,DSE 201,A00,096914,Deutsch; Alin Bernard,30,0,30,0
1668534385714,DSE 210,A00,096915,Dasgupta; Sanjoy,30,0,30,0
1668534386145,DSE 260A,A00,096916,Altintas De Callaf; Ilkay,30,0,30,0
1668534386602,ECE 200,001,103586,Antipa; Nicholas A,9999,0,9999,0
1668534386602,ECE 200,002,103587,Atanasov; Nikolay A.,9999,0,9999,0
1668534386602,ECE 200,003,103588,Bharadia; Dinesh,9999,0,9999,0
1668534386602,ECE 200,004,103589,Cheng; Chung Kuan,9999,0,9999,0
1668534386602,ECE 200,005,103590,Cosman; Pamela C.,9999,0,9999,0
1668534386602,ECE 200,006,103591,Dayeh; Shadi Ahmad,9999,0,9999,0
1668534386602,ECE 200,007,103592,Fainman; Yeshaiahu,9999,0,9999,0
1668534386602,ECE 200,008,103593,Ford; Joseph Earl,9999,0,9999,0
1668534386602,ECE 200,009,103594,Franceschetti; Massimo,9999,0,9999,0
1668534386602,ECE 200,010,103595,Fullerton; Eric E,9999,0,9999,0
1668534386602,ECE 200,011,103596,Galton; Ian A,9999,0,9999,0
1668534386602,ECE 200,012,103597,Gilja; Vikash,9999,0,9999,0
1668534386602,ECE 200,013,103598,Hall; Drew A.,9999,0,9999,0
1668534386602,ECE 200,014,103599,Hsueh; Tzu-Chien,9999,0,9999,0
1668534386602,ECE 200,015,103600,Javidi; Tara,9999,0,9999,0
1668534386602,ECE 200,016,103601,Kahng; Andrew Byun,9999,0,9999,0
1668534386602,ECE 200,017,103602,Kim; Young-Han,9999,0,9999,0
1668534386602,ECE 200,018,103603,Koushanfar; Farinaz,9999,0,9999,0
1668534386602,ECE 200,019,103604,Kuzum; Duygu,9999,0,9999,0
1668534386602,ECE 200,020,103605,Le; Hanh-Phuc,9999,0,9999,0
1668534386602,ECE 200,021,103606,Lin; Bill,9999,0,9999,0
1668534386602,ECE 200,022,103607,Liu; Zhaowei,9998,0,9999,1
1668534386602,ECE 200,023,103608,Lo; Yu-Hwa,9999,0,9999,0
1668534386602,ECE 200,024,103609,Lomakin; Vitaliy,9999,0,9999,0
1668534386602,ECE 200,025,103610,Mercier; Patrick Philip,9999,0,9999,0
1668534386602,ECE 200,026,103611,Meyer; Florian,9999,0,9999,0
1668534386602,ECE 200,027,103612,Milstein; Laurence B.,9999,0,9999,0
1668534386602,ECE 200,028,103613,Mir Arabbaygi; Siavash,9999,0,9999,0
1668534386602,ECE 200,029,103614,Mookherjea; Shayan,9999,0,9999,0
1668534386602,ECE 200,030,103615,Morris; Karcher William,9999,0,9999,0
1668534386602,ECE 200,031,103616,Ng; Tse Nga,9999,0,9999,0
1668534386602,ECE 200,032,103617,Nguyen; Truong Quang,9999,0,9999,0
1668534386602,ECE 200,033,103618,Nomura; Kenji,9999,0,9999,0
1668534386602,ECE 200,034,103619,Orlitsky; Alon,9999,0,9999,0
1668534386602,ECE 200,035,103620,Pal; Piya,9999,0,9999,0
1668534386602,ECE 200,036,103621,Papen; George C.,9999,0,9999,0
1668534386602,ECE 200,037,103622,Radic; Stojan,9999,0,9999,0
1668534386602,ECE 200,038,103623,Rao; Bhaskar D.,9999,0,9999,0
1668534386602,ECE 200,039,103624,Rao; Ramesh R,9999,0,9999,0
1668534386602,ECE 200,040,103625,Rebeiz; Gabriel,9999,0,9999,0
1668534386602,ECE 200,041,103626,Sanford; John R,9999,0,9999,0
1668534386602,ECE 200,042,103627,Siegel; Paul H.,9999,0,9999,0
1668534386602,ECE 200,043,103628,Sievenpiper; Daniel F.,9999,0,9999,0
1668534386602,ECE 200,044,103629,Sworder; David D.,9999,0,9999,0
1668534386602,ECE 200,045,103630,Taur; Yuan,9999,0,9999,0
1668534386602,ECE 200,046,103631,Touri; Behrouz,9999,0,9999,0
1668534386602,ECE 200,047,103632,Trivedi; Mohan M.,9999,0,9999,0
1668534386602,ECE 200,048,103633,Vasconcelos; Nuno,9999,0,9999,0
1668534386602,ECE 200,049,103634,Wang; Xiaolong,9999,0,9999,0
1668534386602,ECE 200,050,103635,Xie; Pengtao,9999,0,9999,0
1668534386602,ECE 200,051,103636,Yip; Michael,9999,0,9999,0
1668534386602,ECE 200,052,103637,Zeger; Kenneth A.,999,0,999,0
1668534386602,ECE 200,053,103638,Zhang; Xinyu,9999,0,9999,0
1668534386602,ECE 200,054,103639,Turakhia; Yatish Girish,9999,0,9999,0
1668534386602,ECE 200,055,103640,Kang; Mingu,9999,0,9999,0
1668534386602,ECE 200,056,103641,Shi; Yuanyuan,9999,0,9999,0
1668534386602,ECE 200,057,103642,Wang; Edward Jay,9999,0,9999,0
1668534386602,ECE 200,058,103643,Zheng; Yang,9999,0,9999,0
1668534387039,ECE 202,A00,103644,Kuzum; Duygu,0,44,0,0
1668534387465,ECE 212BN,A00,103646,Ng; Tse Nga,0,9,0,0
1668534387894,ECE 221,A00,111493,Staff,0,0,0,0
1668534388327,ECE 222B,A00,103647,Lomakin; Vitaliy,0,20,0,0
1668534388758,ECE 230B,A00,103648,Taur; Yuan,0,3,0,0
1668534389197,ECE 238B,A00,103649,Garay; Javier,0,0,0,0
1668534389622,ECE 240B,A00,112900,Fainman; Yeshaiahu,0,7,0,0
1668534390061,ECE 247A,A00,103650,Jokerst; Jesse Vincent,0,6,0,0
1668534390484,ECE 247B,A00,103651,Wang; Joseph,0,14,0,0
1668534390912,ECE 250,A00,103652,Siegel; Paul H.,0,82,0,0
1668534391335,ECE 251A,A00,103654,Rao; Bhaskar D.,0,62,0,0
1668534391854,ECE 257B,A00,103655,Bharadia; Dinesh,0,33,0,0
1668534392284,ECE 258A,A00,103656,Milstein; Laurence B.,0,29,0,0
1668534392719,ECE 260B,A00,103658,Kang; Mingu,0,121,0,0
1668534393143,ECE 264A,A00,103659,Galton; Ian A,0,67,0,0
1668534393571,ECE 265A,A00,103661,Gudem; Prasad S.S.,0,72,0,0
1668534393993,ECE 265D,A00,103662,Gudem; Prasad S.S.,0,26,0,0
1668534394415,ECE 268,A00,103663,Koushanfar; Farinaz,0,43,0,0
1668534394845,ECE 269,A01,103665,Pal; Piya,0,216,0,0
1668534395274,ECE 271B,A00,103666,Vasconcelos; Manuela,0,76,0,0
1668534395698,ECE 276A,A00,103667,Atanasov; Nikolay A.,0,127,0,0
1668534396120,ECE 277,A00,103668,An; Cheolhong,0,150,0,0
1668534396547,ECE 279,A00,117947,Hall; Drew A.,0,22,0,0
1668534397411,ECE 283,A00,103670,Hsueh; Tzu-Chien,0,55,0,0
1668534397839,ECE 284,A00,103671,Turakhia; Yatish Girish,0,39,0,0
1668534398264,ECE 285,A00,103672,Zheng; Yang,0,40,0,0
1668534398264,ECE 285,B00,103673,Sworder; David D.,0,57,0,0
1668534398686,ECE 287,A00,103676,Javidi; Tara,0,9,0,0
1668534399107,MATH 200B,A00,098023,Salehi Golsefidy; Alireza,10,0,15,5
1668534399537,MATH 202B,A00,098024,Rhoades; Brendon Patrick,7,0,15,8
1668534399960,MATH 203B,A00,098025,Oprea; Dragos N.,9,0,15,6
1668534400398,MATH 204B,A00,098026,Sorensen; Claus M,13,0,15,2
1668534400829,MATH 208,A00,098027,Izadi; Elham,7,0,10,3
1668534401270,MATH 209,A00,098028,Pollack; Aaron,10,0,10,0
1668534401694,MATH 211A,A00,112919,Rogalski; Daniel,8,0,10,2
1668534402118,MATH 211B,A00,112920,Seward; Brandon M.,9,0,10,1
1668534402542,MATH 218,A00,098029,Li; Bo,10,0,10,0
1668534402969,MATH 220B,A00,098030,Novak; Jonathan I,11,0,15,4
1668534403413,MATH 221A,A00,098031,Ebenfelt; Peter F,12,0,15,3
1668534403850,MATH 231B,A00,098032,Zlatos; Andrej,11,0,15,4
1668534404282,MATH 240B,A00,098033,Ni; Lei,7,0,15,8
1668534404719,MATH 243,A00,098034,Jekel; David Andrew,10,0,10,0
1668534405142,MATH 245A,A00,098035,Nie; Jiawang,0,5,15,18
1668534405566,MATH 248,A00,098036,Bejenaru; Ioan,10,0,10,0
1668534406004,MATH 250B,A00,098037,Spolaor; Luca,14,0,15,1
1668534406426,MATH 258,A00,098038,Ni; Lei,9,0,10,1
1668534406852,MATH 264B,A00,098041,Rhoades; Brendon Patrick,8,0,15,7
1668534407275,MATH 268,A00,098042,Buss; Samuel R,10,0,10,0
1668534407699,MATH 269,A00,098043,Rhoades; Brendon Patrick,10,0,10,0
1668534408136,MATH 270B,A00,098044,Li; Bo,6,0,15,9
1668534408562,MATH 272B,A00,098045,Holst; Michael J,13,0,15,2
1668534409005,MATH 273A,A00,098046,Tian; Xiaochuan,10,0,15,5
1668534409429,MATH 275,A01,098048,Tian; Xiaochuan,6,0,10,4
1668534409871,MATH 278A,A00,098049,Holst; Michael J,7,0,10,3
1668534410312,MATH 278B,A00,098050,Cloninger; Alexander,10,0,10,0
1668534410735,MATH 278C,A00,098051,Nie; Jiawang,5,0,10,5
1668534411171,MATH 280B,A00,098052,Zheng; Tianyi,7,0,15,8
1668534411613,MATH 281B,A00,098053,Bradic; Jelena,0,2,15,15
1668534412062,MATH 282B,A00,098054,Arias-Castro; Ery,0,1,15,15
1668534412491,MATH 285,A00,098055,Fitzsimmons; Patrick J,0,3,15,17
1668534412913,MATH 287B,A00,098056,Arias-Castro; Ery,1,0,15,14
1668534413341,MATH 288,A00,098057,Agarwal; Pooja,9,0,10,1
1668534413341,MATH 288,B00,098058,Zhang; Danna,8,0,10,2
1668534413341,MATH 288,C00,098059,Williams; Ruth J,9,0,10,1
1668534413778,MATH 290B,A00,098060,Roberts; Justin Deritter,12,0,15,3
1668534414214,MATH 292,A00,098061,Belmont; Eva Kinoshita,10,0,10,0
1668534414638,MATH 295,A00,098062,Suk; Andrew Hoon,47,0,50,3
1668534415061,MATH 296,A00,098063,Novak; Jonathan I,20,0,20,0
1668534415497,MATH 297,001,098064,Gamst; Anthony Collins,9997,0,9999,2
1668534919833,COGS 205,A00,101395,Chiba; Andrea,19,0,20,1
1668534920265,COGS 210B,001,101404,Greene; Deanna Jacquelyn,9998,0,9999,1
1668534920265,COGS 210B,002,101417,Xia; Haijun,9999,0,9999,0
1668534920265,COGS 210B,003,101422,Nitz; Douglas A.,9999,0,9999,0
1668534920265,COGS 210B,004,101423,Hollan; James D.,9998,0,9999,1
1668534920265,COGS 210B,005,101424,Deak; Gedeon O.,9998,0,9999,1
1668534920265,COGS 210B,006,101425,Rossano; Federico,9999,0,9999,0
1668534920694,COGS 211B,A00,101427,Coulson; Seana M,9996,0,9999,3
1668534921124,COGS 220,A00,101428,Hollan; James D.,0,10,25,25
1668534921547,COGS 229,A00,101429,Dow; Steven P,17,0,25,8
1668534921971,COGS 230,A00,101430,Klemmer; Scott R,7,0,17,10
1668534922405,COGS 234,A00,101431,Xia; Haijun,1,0,25,24
1668534922835,COGS 260,A00,101432,Kiyonaga; Anastasia,21,0,25,4
1668534922835,COGS 260,B00,101433,Kirsh; David Joel,15,0,25,10
1668534923277,CSE 202,A00,102371,Impagliazzo; Russell,0,66,0,0
1668534923702,CSE 203B,A01,102373,Cheng; Chung Kuan,0,59,0,0
1668534924128,CSE 208,A00,102374,Micciancio; Daniele,0,5,0,0
1668534924579,CSE 209A,A00,112895,Impagliazzo; Russell,0,12,15,15
1668534925002,CSE 209B,A00,108005,Bellare; Mihir,0,7,0,0
1668534925430,CSE 210,A00,113163,Coblenz; Michael J,0,86,0,0
1668534925860,CSE 219,A00,106111,Dow; Steven P,0,7,20,20
1668534926296,CSE 221,A00,102376,Voelker; Geoffrey M.,0,72,0,0
1668534926718,CSE 224,A01,102378,Porter; George M,0,168,0,0
1668534927143,CSE 229A,A00,102379,Savage; Stefan,0,11,0,0
1668534927578,CSE 229C,A00,102380,Munyaka; Imani N. S.,0,10,0,0
1668534928005,CSE 232B,A00,102382,Deutsch; Alin Bernard,0,35,0,0
1668534928441,CSE 234,A01,112904,Kumar; Arun Kumar,0,0,0,0
1668534928883,CSE 237A,A00,102383,Rosing; Tajana Simunic,0,56,0,0
1668534929319,CSE 239A,A00,102384,Deutsch; Alin Bernard,0,16,0,0
1668534929746,CSE 239B,A00,102385,Polikarpova; Nadezhda,0,11,0,0
1668534930215,CSE 240A,A00,102386,Pannuto; Patrick William,0,46,0,0
1668534930649,CSE 240B,A00,102387,Zhao; Jishen,0,48,0,0
1668534931074,CSE 241A,A00,106406,Kang; Mingu,0,9,0,0
1668534931506,CSE 249B,A00,102388,Kahng; Andrew Byun,0,5,8,8
1668534931939,CSE 251B,A01,102392,Cottrell; Garrison W,0,50,0,0
1668534931939,CSE 251B,A02,102393,Cottrell; Garrison W,0,35,0,0
1668534932379,CSE 252B,A00,102394,Ochoa; Benjamin Lawrence,0,60,0,0
1668534932805,CSE 257,A01,102396,Gao; Sicun,0,140,0,0
1668534933228,CSE 272,A00,102397,Li; Tzumao,0,19,0,0
1668534933652,CSE 274,A00,111323,Chern; Albert Ren-Haur,0,15,0,0
1668534934078,CSE 282,A00,102398,Pevzner; Pavel Arkadjevich,0,0,0,0
1668534934512,CSE 284,A00,114175,Gymrek; Melissa Ann,0,23,0,0
1668534934944,CSE 290,A00,102399,Chandraker; Manmohan Krishna,0,11,0,0
1668534934944,CSE 290,B00,102400,Vaccaro; Kristen Marie,0,7,25,25
1668534934944,CSE 290,C00,102414,Pannuto; Patrick William,0,1,25,25
1668534934944,CSE 290,D00,102427,Pevzner; Pavel Arkadjevich,0,0,0,0
1668534934944,CSE 290,E00,102429,Zhao; Jishen,0,5,0,0
1668534934944,CSE 290,F00,102436,Tullsen; Dean Michael,0,6,0,0
1668534934944,CSE 290,G00,102440,Christensen; Henrik I,0,6,20,20
1668534935381,CSE 291,A00,102443,Su; Hao,0,0,0,0
1668534935381,CSE 291,B00,102448,Polikarpova; Nadezhda,0,0,0,0
1668534935381,CSE 291,C00,102453,Vaccaro; Kristen Marie,0,0,0,0
1668534935381,CSE 291,D00,111343,Savage; Stefan,0,0,0,0
1668534935381,CSE 291,E00,116474,Claffy; Kimberly Claire,0,0,0,0
1668534935381,CSE 291,F00,116479,Pasquale; Joseph,0,0,0,0
1668534935824,CSE 293,001,119111,Bafna; Vineet,9999,0,9999,0
1668534935824,CSE 293,002,119118,Bellare; Mihir,9999,0,9999,0
1668534935824,CSE 293,003,119122,Berg-Kirkpatrick; Taylor D,9999,0,9999,0
1668534935824,CSE 293,004,119135,Christensen; Henrik I,9999,0,9999,0
1668534935824,CSE 293,005,119142,Cottrell; Garrison W,9999,0,9999,0
1668534935824,CSE 293,006,119146,Deutsch; Alin Bernard,9999,0,9999,0
1668534935824,CSE 293,007,119159,Esmaeilzadeh; Hadi,9999,0,9999,0
1668534935824,CSE 293,008,119166,Freund; Yoav,9999,0,9999,0
1668534935824,CSE 293,009,119170,Griswold; William G.,9999,0,9999,0
1668534935824,CSE 293,010,119183,Gymrek; Melissa Ann,9999,0,9999,0
1668534935824,CSE 293,011,119190,Heninger; Nadia A,9999,0,9999,0
1668534935824,CSE 293,012,119230,Impagliazzo; Russell,9999,0,9999,0
1668534935824,CSE 293,013,119232,Jhala; Ranjit,9999,0,9999,0
1668534935824,CSE 293,014,119233,Kahng; Andrew Byun,9999,0,9999,0
1668534935824,CSE 293,015,119298,Kane; Daniel Mertz,9999,0,9999,0
1668534935824,CSE 293,016,119299,Kriegman; David J,9999,0,9999,0
1668534935824,CSE 293,017,119300,Kumar; Arun Kumar,9999,0,9999,0
1668534935824,CSE 293,018,119301,Lerner; Sorin,9999,0,9999,0
1668534935824,CSE 293,019,119302,Lovett; Shachar,9999,0,9999,0
1668534935824,CSE 293,020,119303,McAuley; Julian John,9999,0,9999,0
1668534935824,CSE 293,021,119304,Micciancio; Daniele,9999,0,9999,0
1668534935824,CSE 293,022,119367,Orailoglu; Alex,9999,0,9999,0
1668534935824,CSE 293,023,119382,Paturi; Ramamohan,9999,0,9999,0
1668534935824,CSE 293,024,119404,Polikarpova; Nadezhda,9999,0,9999,0
1668534935824,CSE 293,025,119406,Politz; Joseph Gibbs,9999,0,9999,0
1668534935824,CSE 293,026,119411,Porter; George M,9999,0,9999,0
1668534935824,CSE 293,027,119414,Porter; Leonard Emerson,9999,0,9999,0
1668534935824,CSE 293,028,119416,Ramamoorthi; Ravi,9999,0,9999,0
1668534935824,CSE 293,029,119417,Sahoo; Debashis,9999,0,9999,0
1668534935824,CSE 293,030,119420,Saul; Lawrence,9999,0,9999,0
1668534935824,CSE 293,031,119421,Savage; Stefan,9999,0,9999,0
1668534935824,CSE 293,032,119425,Schulze; Jurgen P.,9999,0,9999,0
1668534935824,CSE 293,033,119426,Snoeren; Alex C.,9999,0,9999,0
1668534935824,CSE 293,034,119428,Shang; Jingbo,9999,0,9999,0
1668534935824,CSE 293,035,119430,Stefan; Deian,9999,0,9999,0
1668534935824,CSE 293,036,119431,Su; Hao,9999,0,9999,0
1668534935824,CSE 293,037,119433,Swanson; Steven James,9999,0,9999,0
1668534935824,CSE 293,038,119435,Tullsen; Dean Michael,9999,0,9999,0
1668534935824,CSE 293,039,119483,Voelker; Geoffrey M.,9999,0,9999,0
1668534935824,CSE 293,040,119537,Zhao; Jishen,9999,0,9999,0
1668534935824,CSE 293,041,119538,Zhou; Yuan-Yuan,9999,0,9999,0
1668534935824,CSE 293,042,119539,Gao; Sicun,9999,0,9999,0
1668534935824,CSE 293,043,119540,Weibel; Nadir,9999,0,9999,0
1668534935824,CSE 293,044,119541,Gupta; Rajesh K.,9999,0,9999,0
1668534935824,CSE 293,045,126410,Vaccaro; Kristen Marie,9999,0,9999,0
1668534935824,CSE 293,046,126411,Klemke; Richard,9999,0,9999,0
1668534936245,CSE 294,A00,102459,Voelker; Geoffrey M.,0,2,0,0
1668534936245,CSE 294,B00,111322,Orailoglu; Alex,0,2,0,0
1668534936672,DSE 201,A00,096914,Deutsch; Alin Bernard,30,0,30,0
1668534937104,DSE 210,A00,096915,Dasgupta; Sanjoy,30,0,30,0
1668534937532,DSE 260A,A00,096916,Altintas De Callaf; Ilkay,30,0,30,0
1668534937996,ECE 200,001,103586,Antipa; Nicholas A,9999,0,9999,0
1668534937996,ECE 200,002,103587,Atanasov; Nikolay A.,9999,0,9999,0
1668534937996,ECE 200,003,103588,Bharadia; Dinesh,9999,0,9999,0
1668534937996,ECE 200,004,103589,Cheng; Chung Kuan,9999,0,9999,0
1668534937996,ECE 200,005,103590,Cosman; Pamela C.,9999,0,9999,0
1668534937996,ECE 200,006,103591,Dayeh; Shadi Ahmad,9999,0,9999,0
1668534937996,ECE 200,007,103592,Fainman; Yeshaiahu,9999,0,9999,0
1668534937996,ECE 200,008,103593,Ford; Joseph Earl,9999,0,9999,0
1668534937996,ECE 200,009,103594,Franceschetti; Massimo,9999,0,9999,0
1668534937996,ECE 200,010,103595,Fullerton; Eric E,9999,0,9999,0
1668534937996,ECE 200,011,103596,Galton; Ian A,9999,0,9999,0
1668534937996,ECE 200,012,103597,Gilja; Vikash,9999,0,9999,0
1668534937996,ECE 200,013,103598,Hall; Drew A.,9999,0,9999,0
1668534937996,ECE 200,014,103599,Hsueh; Tzu-Chien,9999,0,9999,0
1668534937996,ECE 200,015,103600,Javidi; Tara,9999,0,9999,0
1668534937996,ECE 200,016,103601,Kahng; Andrew Byun,9999,0,9999,0
1668534937996,ECE 200,017,103602,Kim; Young-Han,9999,0,9999,0
1668534937996,ECE 200,018,103603,Koushanfar; Farinaz,9999,0,9999,0
1668534937996,ECE 200,019,103604,Kuzum; Duygu,9999,0,9999,0
1668534937996,ECE 200,020,103605,Le; Hanh-Phuc,9999,0,9999,0
1668534937996,ECE 200,021,103606,Lin; Bill,9999,0,9999,0
1668534937996,ECE 200,022,103607,Liu; Zhaowei,9998,0,9999,1
1668534937996,ECE 200,023,103608,Lo; Yu-Hwa,9999,0,9999,0
1668534937996,ECE 200,024,103609,Lomakin; Vitaliy,9999,0,9999,0
1668534937996,ECE 200,025,103610,Mercier; Patrick Philip,9999,0,9999,0
1668534937996,ECE 200,026,103611,Meyer; Florian,9999,0,9999,0
1668534937996,ECE 200,027,103612,Milstein; Laurence B.,9999,0,9999,0
1668534937996,ECE 200,028,103613,Mir Arabbaygi; Siavash,9999,0,9999,0
1668534937996,ECE 200,029,103614,Mookherjea; Shayan,9999,0,9999,0
1668534937996,ECE 200,030,103615,Morris; Karcher William,9999,0,9999,0
1668534937996,ECE 200,031,103616,Ng; Tse Nga,9999,0,9999,0
1668534937996,ECE 200,032,103617,Nguyen; Truong Quang,9999,0,9999,0
1668534937996,ECE 200,033,103618,Nomura; Kenji,9999,0,9999,0
1668534937996,ECE 200,034,103619,Orlitsky; Alon,9999,0,9999,0
1668534937996,ECE 200,035,103620,Pal; Piya,9999,0,9999,0
1668534937996,ECE 200,036,103621,Papen; George C.,9999,0,9999,0
1668534937996,ECE 200,037,103622,Radic; Stojan,9999,0,9999,0
1668534937996,ECE 200,038,103623,Rao; Bhaskar D.,9999,0,9999,0
1668534937996,ECE 200,039,103624,Rao; Ramesh R,9999,0,9999,0
1668534937996,ECE 200,040,103625,Rebeiz; Gabriel,9999,0,9999,0
1668534937996,ECE 200,041,103626,Sanford; John R,9999,0,9999,0
1668534937996,ECE 200,042,103627,Siegel; Paul H.,9999,0,9999,0
1668534937996,ECE 200,043,103628,Sievenpiper; Daniel F.,9999,0,9999,0
1668534937996,ECE 200,044,103629,Sworder; David D.,9999,0,9999,0
1668534937996,ECE 200,045,103630,Taur; Yuan,9999,0,9999,0
1668534937996,ECE 200,046,103631,Touri; Behrouz,9999,0,9999,0
1668534937996,ECE 200,047,103632,Trivedi; Mohan M.,9999,0,9999,0
1668534937996,ECE 200,048,103633,Vasconcelos; Nuno,9999,0,9999,0
1668534937996,ECE 200,049,103634,Wang; Xiaolong,9999,0,9999,0
1668534937996,ECE 200,050,103635,Xie; Pengtao,9999,0,9999,0
1668534937996,ECE 200,051,103636,Yip; Michael,9999,0,9999,0
1668534937996,ECE 200,052,103637,Zeger; Kenneth A.,999,0,999,0
1668534937996,ECE 200,053,103638,Zhang; Xinyu,9999,0,9999,0
1668534937996,ECE 200,054,103639,Turakhia; Yatish Girish,9999,0,9999,0
1668534937996,ECE 200,055,103640,Kang; Mingu,9999,0,9999,0
1668534937996,ECE 200,056,103641,Shi; Yuanyuan,9999,0,9999,0
1668534937996,ECE 200,057,103642,Wang; Edward Jay,9999,0,9999,0
1668534937996,ECE 200,058,103643,Zheng; Yang,9999,0,9999,0
1668534938431,ECE 202,A00,103644,Kuzum; Duygu,0,44,0,0
1668534938854,ECE 212BN,A00,103646,Ng; Tse Nga,0,9,0,0
1668534939279,ECE 221,A00,111493,Staff,0,0,0,0
1668534939705,ECE 222B,A00,103647,Lomakin; Vitaliy,0,20,0,0
1668534940130,ECE 230B,A00,103648,Taur; Yuan,0,3,0,0
1668534940578,ECE 238B,A00,103649,Garay; Javier,0,0,0,0
1668534941003,ECE 240B,A00,112900,Fainman; Yeshaiahu,0,7,0,0
1668534941431,ECE 247A,A00,103650,Jokerst; Jesse Vincent,0,6,0,0
1668534941857,ECE 247B,A00,103651,Wang; Joseph,0,14,0,0
1668534942287,ECE 250,A00,103652,Siegel; Paul H.,0,82,0,0
1668534942710,ECE 251A,A00,103654,Rao; Bhaskar D.,0,62,0,0
1668534943133,ECE 257B,A00,103655,Bharadia; Dinesh,0,33,0,0
1668534943558,ECE 258A,A00,103656,Milstein; Laurence B.,0,29,0,0
1668534943990,ECE 260B,A00,103658,Kang; Mingu,0,121,0,0
1668534944412,ECE 264A,A00,103659,Galton; Ian A,0,68,0,0
1668534944835,ECE 265A,A00,103661,Gudem; Prasad S.S.,0,73,0,0
1668534945258,ECE 265D,A00,103662,Gudem; Prasad S.S.,0,26,0,0
1668534945685,ECE 268,A00,103663,Koushanfar; Farinaz,0,43,0,0
1668534946108,ECE 269,A01,103665,Pal; Piya,0,216,0,0
1668534946539,ECE 271B,A00,103666,Vasconcelos; Manuela,0,76,0,0
1668534946973,ECE 276A,A00,103667,Atanasov; Nikolay A.,0,127,0,0
1668534947412,ECE 277,A00,103668,An; Cheolhong,0,150,0,0
1668534947845,ECE 279,A00,117947,Hall; Drew A.,0,22,0,0
1668534948707,ECE 283,A00,103670,Hsueh; Tzu-Chien,0,55,0,0
1668534949138,ECE 284,A00,103671,Turakhia; Yatish Girish,0,39,0,0
1668534949569,ECE 285,A00,103672,Zheng; Yang,0,40,0,0
1668534949569,ECE 285,B00,103673,Sworder; David D.,0,57,0,0
1668534949994,ECE 287,A00,103676,Javidi; Tara,0,9,0,0
1668534950420,MATH 200B,A00,098023,Salehi Golsefidy; Alireza,10,0,15,5
1668534950841,MATH 202B,A00,098024,Rhoades; Brendon Patrick,7,0,15,8
1668534951268,MATH 203B,A00,098025,Oprea; Dragos N.,9,0,15,6
1668534951711,MATH 204B,A00,098026,Sorensen; Claus M,13,0,15,2
1668534952133,MATH 208,A00,098027,Izadi; Elham,7,0,10,3
1668534952562,MATH 209,A00,098028,Pollack; Aaron,10,0,10,0
1668534952988,MATH 211A,A00,112919,Rogalski; Daniel,8,0,10,2
1668534953412,MATH 211B,A00,112920,Seward; Brandon M.,9,0,10,1
1668534953835,MATH 218,A00,098029,Li; Bo,10,0,10,0
1668534954260,MATH 220B,A00,098030,Novak; Jonathan I,11,0,15,4
1668534954690,MATH 221A,A00,098031,Ebenfelt; Peter F,12,0,15,3
1668534955119,MATH 231B,A00,098032,Zlatos; Andrej,11,0,15,4
1668534955546,MATH 240B,A00,098033,Ni; Lei,7,0,15,8
1668534955974,MATH 243,A00,098034,Jekel; David Andrew,10,0,10,0
1668534956408,MATH 245A,A00,098035,Nie; Jiawang,0,5,15,18
1668534956842,MATH 248,A00,098036,Bejenaru; Ioan,10,0,10,0
1668534957277,MATH 250B,A00,098037,Spolaor; Luca,14,0,15,1
1668534957702,MATH 258,A00,098038,Ni; Lei,9,0,10,1
1668534958141,MATH 264B,A00,098041,Rhoades; Brendon Patrick,8,0,15,7
1668534958707,MATH 268,A00,098042,Buss; Samuel R,10,0,10,0
1668534959130,MATH 269,A00,098043,Rhoades; Brendon Patrick,10,0,10,0
1668534959554,MATH 270B,A00,098044,Li; Bo,6,0,15,9
1668534959982,MATH 272B,A00,098045,Holst; Michael J,13,0,15,2
1668534960409,MATH 273A,A00,098046,Tian; Xiaochuan,10,0,15,5
1668534960833,MATH 275,A01,098048,Tian; Xiaochuan,6,0,10,4
1668534961259,MATH 278A,A00,098049,Holst; Michael J,7,0,10,3
1668534961682,MATH 278B,A00,098050,Cloninger; Alexander,10,0,10,0
1668534962106,MATH 278C,A00,098051,Nie; Jiawang,5,0,10,5
1668534962533,MATH 280B,A00,098052,Zheng; Tianyi,7,0,15,8
1668534962968,MATH 281B,A00,098053,Bradic; Jelena,0,2,15,15
1668534963392,MATH 282B,A00,098054,Arias-Castro; Ery,0,1,15,15
1668534963832,MATH 285,A00,098055,Fitzsimmons; Patrick J,0,3,15,17
1668534964271,MATH 287B,A00,098056,Arias-Castro; Ery,1,0,15,14
1668534964696,MATH 288,A00,098057,Agarwal; Pooja,9,0,10,1
1668534964696,MATH 288,B00,098058,Zhang; Danna,8,0,10,2
1668534964696,MATH 288,C00,098059,Williams; Ruth J,9,0,10,1
1668534965123,MATH 290B,A00,098060,Roberts; Justin Deritter,12,0,15,3
1668534965545,MATH 292,A00,098061,Belmont; Eva Kinoshita,10,0,10,0
1668534965970,MATH 295,A00,098062,Suk; Andrew Hoon,47,0,50,3
1668534966392,MATH 296,A00,098063,Novak; Jonathan I,20,0,20,0
1668534966818,MATH 297,001,098064,Gamst; Anthony Collins,9997,0,9999,2
1668535470845,COGS 205,A00,101395,Chiba; Andrea,19,0,20,1
1668535471268,COGS 210B,001,101404,Greene; Deanna Jacquelyn,9998,0,9999,1
1668535471268,COGS 210B,002,101417,Xia; Haijun,9999,0,9999,0
1668535471268,COGS 210B,003,101422,Nitz; Douglas A.,9999,0,9999,0
1668535471268,COGS 210B,004,101423,Hollan; James D.,9998,0,9999,1
1668535471268,COGS 210B,005,101424,Deak; Gedeon O.,9998,0,9999,1
1668535471268,COGS 210B,006,101425,Rossano; Federico,9999,0,9999,0
1668535471706,COGS 211B,A00,101427,Coulson; Seana M,9996,0,9999,3
1668535472146,COGS 220,A00,101428,Hollan; James D.,0,10,25,25
1668535472573,COGS 229,A00,101429,Dow; Steven P,17,0,25,8
1668535473003,COGS 230,A00,101430,Klemmer; Scott R,7,0,17,10
1668535473427,COGS 234,A00,101431,Xia; Haijun,1,0,25,24
1668535473854,COGS 260,A00,101432,Kiyonaga; Anastasia,21,0,25,4
1668535473854,COGS 260,B00,101433,Kirsh; David Joel,15,0,25,10
1668535474289,CSE 202,A00,102371,Impagliazzo; Russell,0,66,0,0
1668535474715,CSE 203B,A01,102373,Cheng; Chung Kuan,0,60,0,0
1668535475137,CSE 208,A00,102374,Micciancio; Daniele,0,5,0,0
1668535475572,CSE 209A,A00,112895,Impagliazzo; Russell,0,12,15,15
1668535476004,CSE 209B,A00,108005,Bellare; Mihir,0,7,0,0
1668535476431,CSE 210,A00,113163,Coblenz; Michael J,0,86,0,0
1668535476852,CSE 219,A00,106111,Dow; Steven P,0,7,20,20
1668535477277,CSE 221,A00,102376,Voelker; Geoffrey M.,0,72,0,0
1668535477705,CSE 224,A01,102378,Porter; George M,0,168,0,0
1668535478137,CSE 229A,A00,102379,Savage; Stefan,0,11,0,0
1668535478561,CSE 229C,A00,102380,Munyaka; Imani N. S.,0,10,0,0
1668535479001,CSE 232B,A00,102382,Deutsch; Alin Bernard,0,35,0,0
1668535479425,CSE 234,A01,112904,Kumar; Arun Kumar,0,0,0,0
1668535479853,CSE 237A,A00,102383,Rosing; Tajana Simunic,0,56,0,0
1668535480284,CSE 239A,A00,102384,Deutsch; Alin Bernard,0,16,0,0
1668535480707,CSE 239B,A00,102385,Polikarpova; Nadezhda,0,11,0,0
1668535481131,CSE 240A,A00,102386,Pannuto; Patrick William,0,46,0,0
1668535481670,CSE 240B,A00,102387,Zhao; Jishen,0,48,0,0
1668535482099,CSE 241A,A00,106406,Kang; Mingu,0,9,0,0
1668535482524,CSE 249B,A00,102388,Kahng; Andrew Byun,0,5,8,8
1668535482946,CSE 251B,A01,102392,Cottrell; Garrison W,0,50,0,0
1668535482946,CSE 251B,A02,102393,Cottrell; Garrison W,0,35,0,0
1668535483388,CSE 252B,A00,102394,Ochoa; Benjamin Lawrence,0,60,0,0
1668535483831,CSE 257,A01,102396,Gao; Sicun,0,141,0,0
1668535484255,CSE 272,A00,102397,Li; Tzumao,0,19,0,0
1668535484686,CSE 274,A00,111323,Chern; Albert Ren-Haur,0,15,0,0
1668535485114,CSE 282,A00,102398,Pevzner; Pavel Arkadjevich,0,0,0,0
1668535485554,CSE 284,A00,114175,Gymrek; Melissa Ann,0,23,0,0
1668535485985,CSE 290,A00,102399,Chandraker; Manmohan Krishna,0,11,0,0
1668535485985,CSE 290,B00,102400,Vaccaro; Kristen Marie,0,7,25,25
1668535485985,CSE 290,C00,102414,Pannuto; Patrick William,0,1,25,25
1668535485985,CSE 290,D00,102427,Pevzner; Pavel Arkadjevich,0,0,0,0
1668535485985,CSE 290,E00,102429,Zhao; Jishen,0,5,0,0
1668535485985,CSE 290,F00,102436,Tullsen; Dean Michael,0,6,0,0
1668535485985,CSE 290,G00,102440,Christensen; Henrik I,0,6,20,20
1668535486415,CSE 291,A00,102443,Su; Hao,0,0,0,0
1668535486415,CSE 291,B00,102448,Polikarpova; Nadezhda,0,0,0,0
1668535486415,CSE 291,C00,102453,Vaccaro; Kristen Marie,0,0,0,0
1668535486415,CSE 291,D00,111343,Savage; Stefan,0,0,0,0
1668535486415,CSE 291,E00,116474,Claffy; Kimberly Claire,0,0,0,0
1668535486415,CSE 291,F00,116479,Pasquale; Joseph,0,0,0,0
1668535486852,CSE 293,001,119111,Bafna; Vineet,9999,0,9999,0
1668535486852,CSE 293,002,119118,Bellare; Mihir,9999,0,9999,0
1668535486852,CSE 293,003,119122,Berg-Kirkpatrick; Taylor D,9999,0,9999,0
1668535486852,CSE 293,004,119135,Christensen; Henrik I,9999,0,9999,0
1668535486852,CSE 293,005,119142,Cottrell; Garrison W,9999,0,9999,0
1668535486852,CSE 293,006,119146,Deutsch; Alin Bernard,9999,0,9999,0
1668535486852,CSE 293,007,119159,Esmaeilzadeh; Hadi,9999,0,9999,0
1668535486852,CSE 293,008,119166,Freund; Yoav,9999,0,9999,0
1668535486852,CSE 293,009,119170,Griswold; William G.,9999,0,9999,0
1668535486852,CSE 293,010,119183,Gymrek; Melissa Ann,9999,0,9999,0
1668535486852,CSE 293,011,119190,Heninger; Nadia A,9999,0,9999,0
1668535486852,CSE 293,012,119230,Impagliazzo; Russell,9999,0,9999,0
1668535486852,CSE 293,013,119232,Jhala; Ranjit,9999,0,9999,0
1668535486852,CSE 293,014,119233,Kahng; Andrew Byun,9999,0,9999,0
1668535486852,CSE 293,015,119298,Kane; Daniel Mertz,9999,0,9999,0
1668535486852,CSE 293,016,119299,Kriegman; David J,9999,0,9999,0
1668535486852,CSE 293,017,119300,Kumar; Arun Kumar,9999,0,9999,0
1668535486852,CSE 293,018,119301,Lerner; Sorin,9999,0,9999,0
1668535486852,CSE 293,019,119302,Lovett; Shachar,9999,0,9999,0
1668535486852,CSE 293,020,119303,McAuley; Julian John,9999,0,9999,0
1668535486852,CSE 293,021,119304,Micciancio; Daniele,9999,0,9999,0
1668535486852,CSE 293,022,119367,Orailoglu; Alex,9999,0,9999,0
1668535486852,CSE 293,023,119382,Paturi; Ramamohan,9999,0,9999,0
1668535486852,CSE 293,024,119404,Polikarpova; Nadezhda,9999,0,9999,0
1668535486852,CSE 293,025,119406,Politz; Joseph Gibbs,9999,0,9999,0
1668535486852,CSE 293,026,119411,Porter; George M,9999,0,9999,0
1668535486852,CSE 293,027,119414,Porter; Leonard Emerson,9999,0,9999,0
1668535486852,CSE 293,028,119416,Ramamoorthi; Ravi,9999,0,9999,0
1668535486852,CSE 293,029,119417,Sahoo; Debashis,9999,0,9999,0
1668535486852,CSE 293,030,119420,Saul; Lawrence,9999,0,9999,0
1668535486852,CSE 293,031,119421,Savage; Stefan,9999,0,9999,0
1668535486852,CSE 293,032,119425,Schulze; Jurgen P.,9999,0,9999,0
1668535486852,CSE 293,033,119426,Snoeren; Alex C.,9999,0,9999,0
1668535486852,CSE 293,034,119428,Shang; Jingbo,9999,0,9999,0
1668535486852,CSE 293,035,119430,Stefan; Deian,9999,0,9999,0
1668535486852,CSE 293,036,119431,Su; Hao,9999,0,9999,0
1668535486852,CSE 293,037,119433,Swanson; Steven James,9999,0,9999,0
1668535486852,CSE 293,038,119435,Tullsen; Dean Michael,9999,0,9999,0
1668535486852,CSE 293,039,119483,Voelker; Geoffrey M.,9999,0,9999,0
1668535486852,CSE 293,040,119537,Zhao; Jishen,9999,0,9999,0
1668535486852,CSE 293,041,119538,Zhou; Yuan-Yuan,9999,0,9999,0
1668535486852,CSE 293,042,119539,Gao; Sicun,9999,0,9999,0
1668535486852,CSE 293,043,119540,Weibel; Nadir,9999,0,9999,0
1668535486852,CSE 293,044,119541,Gupta; Rajesh K.,9999,0,9999,0
1668535486852,CSE 293,045,126410,Vaccaro; Kristen Marie,9999,0,9999,0
1668535486852,CSE 293,046,126411,Klemke; Richard,9999,0,9999,0
1668535487276,CSE 294,A00,102459,Voelker; Geoffrey M.,0,2,0,0
1668535487276,CSE 294,B00,111322,Orailoglu; Alex,0,2,0,0
1668535487700,DSE 201,A00,096914,Deutsch; Alin Bernard,30,0,30,0
1668535488129,DSE 210,A00,096915,Dasgupta; Sanjoy,30,0,30,0
1668535488553,DSE 260A,A00,096916,Altintas De Callaf; Ilkay,30,0,30,0
1668535489024,ECE 200,001,103586,Antipa; Nicholas A,9999,0,9999,0
1668535489024,ECE 200,002,103587,Atanasov; Nikolay A.,9999,0,9999,0
1668535489024,ECE 200,003,103588,Bharadia; Dinesh,9999,0,9999,0
1668535489024,ECE 200,004,103589,Cheng; Chung Kuan,9999,0,9999,0
1668535489024,ECE 200,005,103590,Cosman; Pamela C.,9999,0,9999,0
1668535489024,ECE 200,006,103591,Dayeh; Shadi Ahmad,9999,0,9999,0
1668535489024,ECE 200,007,103592,Fainman; Yeshaiahu,9999,0,9999,0
1668535489024,ECE 200,008,103593,Ford; Joseph Earl,9999,0,9999,0
1668535489024,ECE 200,009,103594,Franceschetti; Massimo,9999,0,9999,0
1668535489024,ECE 200,010,103595,Fullerton; Eric E,9999,0,9999,0
1668535489024,ECE 200,011,103596,Galton; Ian A,9999,0,9999,0
1668535489024,ECE 200,012,103597,Gilja; Vikash,9999,0,9999,0
1668535489024,ECE 200,013,103598,Hall; Drew A.,9999,0,9999,0
1668535489024,ECE 200,014,103599,Hsueh; Tzu-Chien,9999,0,9999,0
1668535489024,ECE 200,015,103600,Javidi; Tara,9999,0,9999,0
1668535489024,ECE 200,016,103601,Kahng; Andrew Byun,9999,0,9999,0
1668535489024,ECE 200,017,103602,Kim; Young-Han,9999,0,9999,0
1668535489024,ECE 200,018,103603,Koushanfar; Farinaz,9999,0,9999,0
1668535489024,ECE 200,019,103604,Kuzum; Duygu,9999,0,9999,0
1668535489024,ECE 200,020,103605,Le; Hanh-Phuc,9999,0,9999,0
1668535489024,ECE 200,021,103606,Lin; Bill,9999,0,9999,0
1668535489024,ECE 200,022,103607,Liu; Zhaowei,9998,0,9999,1
1668535489024,ECE 200,023,103608,Lo; Yu-Hwa,9999,0,9999,0
1668535489024,ECE 200,024,103609,Lomakin; Vitaliy,9999,0,9999,0
1668535489024,ECE 200,025,103610,Mercier; Patrick Philip,9999,0,9999,0
1668535489024,ECE 200,026,103611,Meyer; Florian,9999,0,9999,0
1668535489024,ECE 200,027,103612,Milstein; Laurence B.,9999,0,9999,0
1668535489024,ECE 200,028,103613,Mir Arabbaygi; Siavash,9999,0,9999,0
1668535489024,ECE 200,029,103614,Mookherjea; Shayan,9999,0,9999,0
1668535489024,ECE 200,030,103615,Morris; Karcher William,9999,0,9999,0
1668535489024,ECE 200,031,103616,Ng; Tse Nga,9999,0,9999,0
1668535489024,ECE 200,032,103617,Nguyen; Truong Quang,9999,0,9999,0
1668535489024,ECE 200,033,103618,Nomura; Kenji,9999,0,9999,0
1668535489024,ECE 200,034,103619,Orlitsky; Alon,9999,0,9999,0
1668535489024,ECE 200,035,103620,Pal; Piya,9999,0,9999,0
1668535489024,ECE 200,036,103621,Papen; George C.,9999,0,9999,0
1668535489024,ECE 200,037,103622,Radic; Stojan,9999,0,9999,0
1668535489024,ECE 200,038,103623,Rao; Bhaskar D.,9999,0,9999,0
1668535489024,ECE 200,039,103624,Rao; Ramesh R,9999,0,9999,0
1668535489024,ECE 200,040,103625,Rebeiz; Gabriel,9999,0,9999,0
1668535489024,ECE 200,041,103626,Sanford; John R,9999,0,9999,0
1668535489024,ECE 200,042,103627,Siegel; Paul H.,9999,0,9999,0
1668535489024,ECE 200,043,103628,Sievenpiper; Daniel F.,9999,0,9999,0
1668535489024,ECE 200,044,103629,Sworder; David D.,9999,0,9999,0
1668535489024,ECE 200,045,103630,Taur; Yuan,9999,0,9999,0
1668535489024,ECE 200,046,103631,Touri; Behrouz,9999,0,9999,0
1668535489024,ECE 200,047,103632,Trivedi; Mohan M.,9999,0,9999,0
1668535489024,ECE 200,048,103633,Vasconcelos; Nuno,9999,0,9999,0
1668535489024,ECE 200,049,103634,Wang; Xiaolong,9999,0,9999,0
1668535489024,ECE 200,050,103635,Xie; Pengtao,9999,0,9999,0
1668535489024,ECE 200,051,103636,Yip; Michael,9999,0,9999,0
1668535489024,ECE 200,052,103637,Zeger; Kenneth A.,999,0,999,0
1668535489024,ECE 200,053,103638,Zhang; Xinyu,9999,0,9999,0
1668535489024,ECE 200,054,103639,Turakhia; Yatish Girish,9999,0,9999,0
1668535489024,ECE 200,055,103640,Kang; Mingu,9999,0,9999,0
1668535489024,ECE 200,056,103641,Shi; Yuanyuan,9999,0,9999,0
1668535489024,ECE 200,057,103642,Wang; Edward Jay,9999,0,9999,0
1668535489024,ECE 200,058,103643,Zheng; Yang,9999,0,9999,0
1668535489457,ECE 202,A00,103644,Kuzum; Duygu,0,44,0,0
1668535489881,ECE 212BN,A00,103646,Ng; Tse Nga,0,9,0,0
1668535490306,ECE 221,A00,111493,Staff,0,0,0,0
1668535490733,ECE 222B,A00,103647,Lomakin; Vitaliy,0,20,0,0
1668535491166,ECE 230B,A00,103648,Taur; Yuan,0,3,0,0
1668535491593,ECE 238B,A00,103649,Garay; Javier,0,0,0,0
1668535492016,ECE 240B,A00,112900,Fainman; Yeshaiahu,0,7,0,0
1668535492443,ECE 247A,A00,103650,Jokerst; Jesse Vincent,0,6,0,0
1668535492868,ECE 247B,A00,103651,Wang; Joseph,0,14,0,0
1668535493292,ECE 250,A00,103652,Siegel; Paul H.,0,82,0,0
1668535493715,ECE 251A,A00,103654,Rao; Bhaskar D.,0,62,0,0
1668535494142,ECE 257B,A00,103655,Bharadia; Dinesh,0,33,0,0
1668535494572,ECE 258A,A00,103656,Milstein; Laurence B.,0,29,0,0
1668535494997,ECE 260B,A00,103658,Kang; Mingu,0,121,0,0
1668535495421,ECE 264A,A00,103659,Galton; Ian A,0,68,0,0
1668535495849,ECE 265A,A00,103661,Gudem; Prasad S.S.,0,73,0,0
1668535496273,ECE 265D,A00,103662,Gudem; Prasad S.S.,0,26,0,0
1668535496696,ECE 268,A00,103663,Koushanfar; Farinaz,0,43,0,0
1668535497128,ECE 269,A01,103665,Pal; Piya,0,216,0,0
1668535497556,ECE 271B,A00,103666,Vasconcelos; Manuela,0,77,0,0
1668535497989,ECE 276A,A00,103667,Atanasov; Nikolay A.,0,127,0,0
1668535498425,ECE 277,A00,103668,An; Cheolhong,0,150,0,0
1668535498848,ECE 279,A00,117947,Hall; Drew A.,0,22,0,0
1668535499705,ECE 283,A00,103670,Hsueh; Tzu-Chien,0,55,0,0
1668535500129,ECE 284,A00,103671,Turakhia; Yatish Girish,0,39,0,0
1668535500572,ECE 285,A00,103672,Zheng; Yang,0,40,0,0
1668535500572,ECE 285,B00,103673,Sworder; David D.,0,57,0,0
1668535500998,ECE 287,A00,103676,Javidi; Tara,0,9,0,0
1668535501423,MATH 200B,A00,098023,Salehi Golsefidy; Alireza,10,0,15,5
1668535501851,MATH 202B,A00,098024,Rhoades; Brendon Patrick,7,0,15,8
1668535502279,MATH 203B,A00,098025,Oprea; Dragos N.,9,0,15,6
1668535502702,MATH 204B,A00,098026,Sorensen; Claus M,13,0,15,2
1668535503124,MATH 208,A00,098027,Izadi; Elham,7,0,10,3
1668535503547,MATH 209,A00,098028,Pollack; Aaron,10,0,10,0
1668535503969,MATH 211A,A00,112919,Rogalski; Daniel,8,0,10,2
1668535504405,MATH 211B,A00,112920,Seward; Brandon M.,9,0,10,1
1668535504830,MATH 218,A00,098029,Li; Bo,10,0,10,0
1668535505255,MATH 220B,A00,098030,Novak; Jonathan I,11,0,15,4
1668535505698,MATH 221A,A00,098031,Ebenfelt; Peter F,12,0,15,3
1668535506121,MATH 231B,A00,098032,Zlatos; Andrej,11,0,15,4
1668535506546,MATH 240B,A00,098033,Ni; Lei,7,0,15,8
1668535506968,MATH 243,A00,098034,Jekel; David Andrew,10,0,10,0
1668535507393,MATH 245A,A00,098035,Nie; Jiawang,0,5,15,18
1668535507819,MATH 248,A00,098036,Bejenaru; Ioan,10,0,10,0
1668535508243,MATH 250B,A00,098037,Spolaor; Luca,14,0,15,1
1668535508667,MATH 258,A00,098038,Ni; Lei,9,0,10,1
1668535509098,MATH 264B,A00,098041,Rhoades; Brendon Patrick,8,0,15,7
1668535509520,MATH 268,A00,098042,Buss; Samuel R,10,0,10,0
1668535509945,MATH 269,A00,098043,Rhoades; Brendon Patrick,10,0,10,0
1668535510368,MATH 270B,A00,098044,Li; Bo,6,0,15,9
1668535510792,MATH 272B,A00,098045,Holst; Michael J,13,0,15,2
1668535511227,MATH 273A,A00,098046,Tian; Xiaochuan,10,0,15,5
1668535511651,MATH 275,A01,098048,Tian; Xiaochuan,6,0,10,4
1668535512084,MATH 278A,A00,098049,Holst; Michael J,7,0,10,3
1668535512506,MATH 278B,A00,098050,Cloninger; Alexander,10,0,10,0
1668535512935,MATH 278C,A00,098051,Nie; Jiawang,5,0,10,5
1668535513361,MATH 280B,A00,098052,Zheng; Tianyi,7,0,15,8
1668535513792,MATH 281B,A00,098053,Bradic; Jelena,0,2,15,15
1668535514222,MATH 282B,A00,098054,Arias-Castro; Ery,0,1,15,15
1668535514646,MATH 285,A00,098055,Fitzsimmons; Patrick J,0,3,15,17
1668535515069,MATH 287B,A00,098056,Arias-Castro; Ery,1,0,15,14
1668535515502,MATH 288,A00,098057,Agarwal; Pooja,9,0,10,1
1668535515502,MATH 288,B00,098058,Zhang; Danna,8,0,10,2
1668535515502,MATH 288,C00,098059,Williams; Ruth J,9,0,10,1
1668535515928,MATH 290B,A00,098060,Roberts; Justin Deritter,12,0,15,3
1668535516353,MATH 292,A00,098061,Belmont; Eva Kinoshita,10,0,10,0
1668535516792,MATH 295,A00,098062,Suk; Andrew Hoon,47,0,50,3
1668535517218,MATH 296,A00,098063,Novak; Jonathan I,20,0,20,0
1668535517643,MATH 297,001,098064,Gamst; Anthony Collins,9997,0,9999,2
1668536022525,COGS 205,A00,101395,Chiba; Andrea,19,0,20,1
1668536022949,COGS 210B,001,101404,Greene; Deanna Jacquelyn,9998,0,9999,1
1668536022949,COGS 210B,002,101417,Xia; Haijun,9999,0,9999,0
1668536022949,COGS 210B,003,101422,Nitz; Douglas A.,9999,0,9999,0
1668536022949,COGS 210B,004,101423,Hollan; James D.,9998,0,9999,1
1668536022949,COGS 210B,005,101424,Deak; Gedeon O.,9998,0,9999,1
1668536022949,COGS 210B,006,101425,Rossano; Federico,9999,0,9999,0
1668536023378,COGS 211B,A00,101427,Coulson; Seana M,9996,0,9999,3
1668536023812,COGS 220,A00,101428,Hollan; James D.,0,10,25,25
1668536024234,COGS 229,A00,101429,Dow; Steven P,17,0,25,8
1668536024660,COGS 230,A00,101430,Klemmer; Scott R,7,0,17,10
1668536025095,COGS 234,A00,101431,Xia; Haijun,1,0,25,24
1668536025535,COGS 260,A00,101432,Kiyonaga; Anastasia,21,0,25,4
1668536025535,COGS 260,B00,101433,Kirsh; David Joel,15,0,25,10
1668536025958,CSE 202,A00,102371,Impagliazzo; Russell,0,66,0,0
1668536026385,CSE 203B,A01,102373,Cheng; Chung Kuan,0,60,0,0
1668536026811,CSE 208,A00,102374,Micciancio; Daniele,0,5,0,0
1668536027238,CSE 209A,A00,112895,Impagliazzo; Russell,0,13,15,15
1668536027661,CSE 209B,A00,108005,Bellare; Mihir,0,7,0,0
1668536028089,CSE 210,A00,113163,Coblenz; Michael J,0,86,0,0
1668536028516,CSE 219,A00,106111,Dow; Steven P,0,7,20,20
1668536028944,CSE 221,A00,102376,Voelker; Geoffrey M.,0,72,0,0
1668536029371,CSE 224,A01,102378,Porter; George M,0,168,0,0
1668536029794,CSE 229A,A00,102379,Savage; Stefan,0,11,0,0
1668536030218,CSE 229C,A00,102380,Munyaka; Imani N. S.,0,10,0,0
1668536030640,CSE 232B,A00,102382,Deutsch; Alin Bernard,0,35,0,0
1668536031064,CSE 234,A01,112904,Kumar; Arun Kumar,0,0,0,0
1668536031487,CSE 237A,A00,102383,Rosing; Tajana Simunic,0,56,0,0
1668536031911,CSE 239A,A00,102384,Deutsch; Alin Bernard,0,16,0,0
1668536032341,CSE 239B,A00,102385,Polikarpova; Nadezhda,0,11,0,0
1668536032770,CSE 240A,A00,102386,Pannuto; Patrick William,0,47,0,0
1668536033195,CSE 240B,A00,102387,Zhao; Jishen,0,48,0,0
1668536033630,CSE 241A,A00,106406,Kang; Mingu,0,9,0,0
1668536034058,CSE 249B,A00,102388,Kahng; Andrew Byun,0,5,8,8
1668536034485,CSE 251B,A01,102392,Cottrell; Garrison W,0,50,0,0
1668536034485,CSE 251B,A02,102393,Cottrell; Garrison W,0,35,0,0
1668536034917,CSE 252B,A00,102394,Ochoa; Benjamin Lawrence,0,60,0,0
1668536035352,CSE 257,A01,102396,Gao; Sicun,0,141,0,0
1668536035786,CSE 272,A00,102397,Li; Tzumao,0,19,0,0
1668536036217,CSE 274,A00,111323,Chern; Albert Ren-Haur,0,15,0,0
1668536036643,CSE 282,A00,102398,Pevzner; Pavel Arkadjevich,0,0,0,0
1668536037069,CSE 284,A00,114175,Gymrek; Melissa Ann,0,23,0,0
1668536037496,CSE 290,A00,102399,Chandraker; Manmohan Krishna,0,11,0,0
1668536037496,CSE 290,B00,102400,Vaccaro; Kristen Marie,0,7,25,25
1668536037496,CSE 290,C00,102414,Pannuto; Patrick William,0,1,25,25
1668536037496,CSE 290,D00,102427,Pevzner; Pavel Arkadjevich,0,0,0,0
1668536037496,CSE 290,E00,102429,Zhao; Jishen,0,5,0,0
1668536037496,CSE 290,F00,102436,Tullsen; Dean Michael,0,6,0,0
1668536037496,CSE 290,G00,102440,Christensen; Henrik I,0,6,20,20
1668536037919,CSE 291,A00,102443,Su; Hao,0,0,0,0
1668536037919,CSE 291,B00,102448,Polikarpova; Nadezhda,0,0,0,0
1668536037919,CSE 291,C00,102453,Vaccaro; Kristen Marie,0,0,0,0
1668536037919,CSE 291,D00,111343,Savage; Stefan,0,0,0,0
1668536037919,CSE 291,E00,116474,Claffy; Kimberly Claire,0,0,0,0
1668536037919,CSE 291,F00,116479,Pasquale; Joseph,0,0,0,0
1668536038362,CSE 293,001,119111,Bafna; Vineet,9999,0,9999,0
1668536038362,CSE 293,002,119118,Bellare; Mihir,9999,0,9999,0
1668536038362,CSE 293,003,119122,Berg-Kirkpatrick; Taylor D,9999,0,9999,0
1668536038362,CSE 293,004,119135,Christensen; Henrik I,9999,0,9999,0
1668536038362,CSE 293,005,119142,Cottrell; Garrison W,9999,0,9999,0
1668536038362,CSE 293,006,119146,Deutsch; Alin Bernard,9999,0,9999,0
1668536038362,CSE 293,007,119159,Esmaeilzadeh; Hadi,9999,0,9999,0
1668536038362,CSE 293,008,119166,Freund; Yoav,9999,0,9999,0
1668536038362,CSE 293,009,119170,Griswold; William G.,9999,0,9999,0
1668536038362,CSE 293,010,119183,Gymrek; Melissa Ann,9999,0,9999,0
1668536038362,CSE 293,011,119190,Heninger; Nadia A,9999,0,9999,0
1668536038362,CSE 293,012,119230,Impagliazzo; Russell,9999,0,9999,0
1668536038362,CSE 293,013,119232,Jhala; Ranjit,9999,0,9999,0
1668536038362,CSE 293,014,119233,Kahng; Andrew Byun,9999,0,9999,0
1668536038362,CSE 293,015,119298,Kane; Daniel Mertz,9999,0,9999,0
1668536038362,CSE 293,016,119299,Kriegman; David J,9999,0,9999,0
1668536038362,CSE 293,017,119300,Kumar; Arun Kumar,9999,0,9999,0
1668536038362,CSE 293,018,119301,Lerner; Sorin,9999,0,9999,0
1668536038362,CSE 293,019,119302,Lovett; Shachar,9999,0,9999,0
1668536038362,CSE 293,020,119303,McAuley; Julian John,9999,0,9999,0
1668536038362,CSE 293,021,119304,Micciancio; Daniele,9999,0,9999,0
1668536038362,CSE 293,022,119367,Orailoglu; Alex,9999,0,9999,0
1668536038362,CSE 293,023,119382,Paturi; Ramamohan,9999,0,9999,0
1668536038362,CSE 293,024,119404,Polikarpova; Nadezhda,9999,0,9999,0
1668536038362,CSE 293,025,119406,Politz; Joseph Gibbs,9999,0,9999,0
1668536038362,CSE 293,026,119411,Porter; George M,9999,0,9999,0
1668536038362,CSE 293,027,119414,Porter; Leonard Emerson,9999,0,9999,0
1668536038362,CSE 293,028,119416,Ramamoorthi; Ravi,9999,0,9999,0
1668536038362,CSE 293,029,119417,Sahoo; Debashis,9999,0,9999,0
1668536038362,CSE 293,030,119420,Saul; Lawrence,9999,0,9999,0
1668536038362,CSE 293,031,119421,Savage; Stefan,9999,0,9999,0
1668536038362,CSE 293,032,119425,Schulze; Jurgen P.,9999,0,9999,0
1668536038362,CSE 293,033,119426,Snoeren; Alex C.,9999,0,9999,0
1668536038362,CSE 293,034,119428,Shang; Jingbo,9999,0,9999,0
1668536038362,CSE 293,035,119430,Stefan; Deian,9999,0,9999,0
1668536038362,CSE 293,036,119431,Su; Hao,9999,0,9999,0
1668536038362,CSE 293,037,119433,Swanson; Steven James,9999,0,9999,0
1668536038362,CSE 293,038,119435,Tullsen; Dean Michael,9999,0,9999,0
1668536038362,CSE 293,039,119483,Voelker; Geoffrey M.,9999,0,9999,0
1668536038362,CSE 293,040,119537,Zhao; Jishen,9999,0,9999,0
1668536038362,CSE 293,041,119538,Zhou; Yuan-Yuan,9999,0,9999,0
1668536038362,CSE 293,042,119539,Gao; Sicun,9999,0,9999,0
1668536038362,CSE 293,043,119540,Weibel; Nadir,9999,0,9999,0
1668536038362,CSE 293,044,119541,Gupta; Rajesh K.,9999,0,9999,0
1668536038362,CSE 293,045,126410,Vaccaro; Kristen Marie,9999,0,9999,0
1668536038362,CSE 293,046,126411,Klemke; Richard,9999,0,9999,0
1668536038784,CSE 294,A00,102459,Voelker; Geoffrey M.,0,2,0,0
1668536038784,CSE 294,B00,111322,Orailoglu; Alex,0,2,0,0
1668536039217,DSE 201,A00,096914,Deutsch; Alin Bernard,30,0,30,0
1668536039642,DSE 210,A00,096915,Dasgupta; Sanjoy,30,0,30,0
1668536040066,DSE 260A,A00,096916,Altintas De Callaf; Ilkay,30,0,30,0
1668536040506,ECE 200,001,103586,Antipa; Nicholas A,9999,0,9999,0
1668536040506,ECE 200,002,103587,Atanasov; Nikolay A.,9999,0,9999,0
1668536040506,ECE 200,003,103588,Bharadia; Dinesh,9999,0,9999,0
1668536040506,ECE 200,004,103589,Cheng; Chung Kuan,9999,0,9999,0
1668536040506,ECE 200,005,103590,Cosman; Pamela C.,9999,0,9999,0
1668536040506,ECE 200,006,103591,Dayeh; Shadi Ahmad,9999,0,9999,0
1668536040506,ECE 200,007,103592,Fainman; Yeshaiahu,9999,0,9999,0
1668536040506,ECE 200,008,103593,Ford; Joseph Earl,9999,0,9999,0
1668536040506,ECE 200,009,103594,Franceschetti; Massimo,9999,0,9999,0
1668536040506,ECE 200,010,103595,Fullerton; Eric E,9999,0,9999,0
1668536040506,ECE 200,011,103596,Galton; Ian A,9999,0,9999,0
1668536040506,ECE 200,012,103597,Gilja; Vikash,9999,0,9999,0
1668536040506,ECE 200,013,103598,Hall; Drew A.,9999,0,9999,0
1668536040506,ECE 200,014,103599,Hsueh; Tzu-Chien,9999,0,9999,0
1668536040506,ECE 200,015,103600,Javidi; Tara,9999,0,9999,0
1668536040506,ECE 200,016,103601,Kahng; Andrew Byun,9999,0,9999,0
1668536040506,ECE 200,017,103602,Kim; Young-Han,9999,0,9999,0
1668536040506,ECE 200,018,103603,Koushanfar; Farinaz,9999,0,9999,0
1668536040506,ECE 200,019,103604,Kuzum; Duygu,9999,0,9999,0
1668536040506,ECE 200,020,103605,Le; Hanh-Phuc,9999,0,9999,0
1668536040506,ECE 200,021,103606,Lin; Bill,9999,0,9999,0
1668536040506,ECE 200,022,103607,Liu; Zhaowei,9998,0,9999,1
1668536040506,ECE 200,023,103608,Lo; Yu-Hwa,9999,0,9999,0
1668536040506,ECE 200,024,103609,Lomakin; Vitaliy,9999,0,9999,0
1668536040506,ECE 200,025,103610,Mercier; Patrick Philip,9999,0,9999,0
1668536040506,ECE 200,026,103611,Meyer; Florian,9999,0,9999,0
1668536040506,ECE 200,027,103612,Milstein; Laurence B.,9999,0,9999,0
1668536040506,ECE 200,028,103613,Mir Arabbaygi; Siavash,9999,0,9999,0
1668536040506,ECE 200,029,103614,Mookherjea; Shayan,9999,0,9999,0
1668536040506,ECE 200,030,103615,Morris; Karcher William,9999,0,9999,0
1668536040506,ECE 200,031,103616,Ng; Tse Nga,9999,0,9999,0
1668536040506,ECE 200,032,103617,Nguyen; Truong Quang,9999,0,9999,0
1668536040506,ECE 200,033,103618,Nomura; Kenji,9999,0,9999,0
1668536040506,ECE 200,034,103619,Orlitsky; Alon,9999,0,9999,0
1668536040506,ECE 200,035,103620,Pal; Piya,9999,0,9999,0
1668536040506,ECE 200,036,103621,Papen; George C.,9999,0,9999,0
1668536040506,ECE 200,037,103622,Radic; Stojan,9999,0,9999,0
1668536040506,ECE 200,038,103623,Rao; Bhaskar D.,9999,0,9999,0
1668536040506,ECE 200,039,103624,Rao; Ramesh R,9999,0,9999,0
1668536040506,ECE 200,040,103625,Rebeiz; Gabriel,9999,0,9999,0
1668536040506,ECE 200,041,103626,Sanford; John R,9999,0,9999,0
1668536040506,ECE 200,042,103627,Siegel; Paul H.,9999,0,9999,0
1668536040506,ECE 200,043,103628,Sievenpiper; Daniel F.,9999,0,9999,0
1668536040506,ECE 200,044,103629,Sworder; David D.,9999,0,9999,0
1668536040506,ECE 200,045,103630,Taur; Yuan,9999,0,9999,0
1668536040506,ECE 200,046,103631,Touri; Behrouz,9999,0,9999,0
1668536040506,ECE 200,047,103632,Trivedi; Mohan M.,9999,0,9999,0
1668536040506,ECE 200,048,103633,Vasconcelos; Nuno,9999,0,9999,0
1668536040506,ECE 200,049,103634,Wang; Xiaolong,9999,0,9999,0
1668536040506,ECE 200,050,103635,Xie; Pengtao,9999,0,9999,0
1668536040506,ECE 200,051,103636,Yip; Michael,9999,0,9999,0
1668536040506,ECE 200,052,103637,Zeger; Kenneth A.,999,0,999,0
1668536040506,ECE 200,053,103638,Zhang; Xinyu,9999,0,9999,0
1668536040506,ECE 200,054,103639,Turakhia; Yatish Girish,9999,0,9999,0
1668536040506,ECE 200,055,103640,Kang; Mingu,9999,0,9999,0
1668536040506,ECE 200,056,103641,Shi; Yuanyuan,9999,0,9999,0
1668536040506,ECE 200,057,103642,Wang; Edward Jay,9999,0,9999,0
1668536040506,ECE 200,058,103643,Zheng; Yang,9999,0,9999,0
1668536040941,ECE 202,A00,103644,Kuzum; Duygu,0,44,0,0
1668536041364,ECE 212BN,A00,103646,Ng; Tse Nga,0,9,0,0
1668536041795,ECE 221,A00,111493,Staff,0,0,0,0
1668536042239,ECE 222B,A00,103647,Lomakin; Vitaliy,0,20,0,0
1668536042661,ECE 230B,A00,103648,Taur; Yuan,0,3,0,0
1668536043096,ECE 238B,A00,103649,Garay; Javier,0,0,0,0
1668536043529,ECE 240B,A00,112900,Fainman; Yeshaiahu,0,7,0,0
1668536043967,ECE 247A,A00,103650,Jokerst; Jesse Vincent,0,6,0,0
1668536044393,ECE 247B,A00,103651,Wang; Joseph,0,14,0,0
1668536044832,ECE 250,A00,103652,Siegel; Paul H.,0,82,0,0
1668536045259,ECE 251A,A00,103654,Rao; Bhaskar D.,0,62,0,0
1668536045697,ECE 257B,A00,103655,Bharadia; Dinesh,0,33,0,0
1668536046119,ECE 258A,A00,103656,Milstein; Laurence B.,0,29,0,0
1668536046546,ECE 260B,A00,103658,Kang; Mingu,0,121,0,0
1668536046984,ECE 264A,A00,103659,Galton; Ian A,0,68,0,0
1668536047423,ECE 265A,A00,103661,Gudem; Prasad S.S.,0,73,0,0
1668536047853,ECE 265D,A00,103662,Gudem; Prasad S.S.,0,26,0,0
1668536048276,ECE 268,A00,103663,Koushanfar; Farinaz,0,43,0,0
1668536048843,ECE 269,A01,103665,Pal; Piya,0,217,0,0
1668536049289,ECE 271B,A00,103666,Vasconcelos; Manuela,0,77,0,0
1668536049716,ECE 276A,A00,103667,Atanasov; Nikolay A.,0,127,0,0
1668536050167,ECE 277,A00,103668,An; Cheolhong,0,150,0,0
1668536050594,ECE 279,A00,117947,Hall; Drew A.,0,22,0,0
1668536051447,ECE 283,A00,103670,Hsueh; Tzu-Chien,0,55,0,0
1668536051881,ECE 284,A00,103671,Turakhia; Yatish Girish,0,39,0,0
1668536052309,ECE 285,A00,103672,Zheng; Yang,0,40,0,0
1668536052309,ECE 285,B00,103673,Sworder; David D.,0,58,0,0
1668536052748,ECE 287,A00,103676,Javidi; Tara,0,9,0,0
1668536053177,MATH 200B,A00,098023,Salehi Golsefidy; Alireza,10,0,15,5
1668536053613,MATH 202B,A00,098024,Rhoades; Brendon Patrick,7,0,15,8
1668536054046,MATH 203B,A00,098025,Oprea; Dragos N.,9,0,15,6
1668536054485,MATH 204B,A00,098026,Sorensen; Claus M,13,0,15,2
1668536054910,MATH 208,A00,098027,Izadi; Elham,7,0,10,3
1668536055343,MATH 209,A00,098028,Pollack; Aaron,10,0,10,0
1668536055769,MATH 211A,A00,112919,Rogalski; Daniel,8,0,10,2
1668536056194,MATH 211B,A00,112920,Seward; Brandon M.,9,0,10,1
1668536056627,MATH 218,A00,098029,Li; Bo,10,0,10,0
1668536057051,MATH 220B,A00,098030,Novak; Jonathan I,11,0,15,4
1668536057486,MATH 221A,A00,098031,Ebenfelt; Peter F,12,0,15,3
1668536057916,MATH 231B,A00,098032,Zlatos; Andrej,11,0,15,4
1668536058340,MATH 240B,A00,098033,Ni; Lei,7,0,15,8
1668536058768,MATH 243,A00,098034,Jekel; David Andrew,10,0,10,0
1668536059192,MATH 245A,A00,098035,Nie; Jiawang,0,5,15,18
1668536059635,MATH 248,A00,098036,Bejenaru; Ioan,10,0,10,0
1668536060062,MATH 250B,A00,098037,Spolaor; Luca,14,0,15,1
1668536060493,MATH 258,A00,098038,Ni; Lei,9,0,10,1
1668536060935,MATH 264B,A00,098041,Rhoades; Brendon Patrick,8,0,15,7
1668536061359,MATH 268,A00,098042,Buss; Samuel R,10,0,10,0
1668536061786,MATH 269,A00,098043,Rhoades; Brendon Patrick,10,0,10,0
1668536062222,MATH 270B,A00,098044,Li; Bo,6,0,15,9
1668536062662,MATH 272B,A00,098045,Holst; Michael J,13,0,15,2
1668536063098,MATH 273A,A00,098046,Tian; Xiaochuan,10,0,15,5
1668536063543,MATH 275,A01,098048,Tian; Xiaochuan,6,0,10,4
1668536063978,MATH 278A,A00,098049,Holst; Michael J,7,0,10,3
1668536064404,MATH 278B,A00,098050,Cloninger; Alexander,10,0,10,0
1668536064829,MATH 278C,A00,098051,Nie; Jiawang,5,0,10,5
1668536065252,MATH 280B,A00,098052,Zheng; Tianyi,7,0,15,8
1668536065684,MATH 281B,A00,098053,Bradic; Jelena,0,2,15,15
1668536066108,MATH 282B,A00,098054,Arias-Castro; Ery,0,1,15,15
1668536066531,MATH 285,A00,098055,Fitzsimmons; Patrick J,0,3,15,17
1668536066955,MATH 287B,A00,098056,Arias-Castro; Ery,1,0,15,14
1668536067386,MATH 288,A00,098057,Agarwal; Pooja,9,0,10,1
1668536067386,MATH 288,B00,098058,Zhang; Danna,8,0,10,2
1668536067386,MATH 288,C00,098059,Williams; Ruth J,9,0,10,1
1668536067812,MATH 290B,A00,098060,Roberts; Justin Deritter,12,0,15,3
1668536068234,MATH 292,A00,098061,Belmont; Eva Kinoshita,10,0,10,0
1668536068664,MATH 295,A00,098062,Suk; Andrew Hoon,47,0,50,3
1668536069090,MATH 296,A00,098063,Novak; Jonathan I,20,0,20,0
1668536069512,MATH 297,001,098064,Gamst; Anthony Collins,9997,0,9999,2
1668536573687,COGS 205,A00,101395,Chiba; Andrea,19,0,20,1
1668536574115,COGS 210B,001,101404,Greene; Deanna Jacquelyn,9998,0,9999,1
1668536574115,COGS 210B,002,101417,Xia; Haijun,9999,0,9999,0
1668536574115,COGS 210B,003,101422,Nitz; Douglas A.,9999,0,9999,0
1668536574115,COGS 210B,004,101423,Hollan; James D.,9998,0,9999,1
1668536574115,COGS 210B,005,101424,Deak; Gedeon O.,9998,0,9999,1
1668536574115,COGS 210B,006,101425,Rossano; Federico,9999,0,9999,0
1668536574549,COGS 211B,A00,101427,Coulson; Seana M,9996,0,9999,3
1668536574983,COGS 220,A00,101428,Hollan; James D.,0,10,25,25
1668536575405,COGS 229,A00,101429,Dow; Steven P,17,0,25,8
1668536575841,COGS 230,A00,101430,Klemmer; Scott R,7,0,17,10
1668536576270,COGS 234,A00,101431,Xia; Haijun,1,0,25,24
1668536576700,COGS 260,A00,101432,Kiyonaga; Anastasia,21,0,25,4
1668536576700,COGS 260,B00,101433,Kirsh; David Joel,15,0,25,10
1668536577139,CSE 202,A00,102371,Impagliazzo; Russell,0,66,0,0
1668536577565,CSE 203B,A01,102373,Cheng; Chung Kuan,0,60,0,0
1668536577989,CSE 208,A00,102374,Micciancio; Daniele,0,5,0,0
1668536578411,CSE 209A,A00,112895,Impagliazzo; Russell,0,13,15,15
1668536578845,CSE 209B,A00,108005,Bellare; Mihir,0,7,0,0
1668536579269,CSE 210,A00,113163,Coblenz; Michael J,0,86,0,0
1668536579692,CSE 219,A00,106111,Dow; Steven P,0,7,20,20
1668536580116,CSE 221,A00,102376,Voelker; Geoffrey M.,0,72,0,0
1668536580548,CSE 224,A01,102378,Porter; George M,0,168,0,0
1668536580974,CSE 229A,A00,102379,Savage; Stefan,0,11,0,0
1668536581407,CSE 229C,A00,102380,Munyaka; Imani N. S.,0,10,0,0
1668536581833,CSE 232B,A00,102382,Deutsch; Alin Bernard,0,35,0,0
1668536582256,CSE 234,A01,112904,Kumar; Arun Kumar,0,0,0,0
1668536582684,CSE 237A,A00,102383,Rosing; Tajana Simunic,0,56,0,0
1668536583110,CSE 239A,A00,102384,Deutsch; Alin Bernard,0,16,0,0
1668536583550,CSE 239B,A00,102385,Polikarpova; Nadezhda,0,11,0,0
1668536583974,CSE 240A,A00,102386,Pannuto; Patrick William,0,47,0,0
1668536584397,CSE 240B,A00,102387,Zhao; Jishen,0,48,0,0
1668536584826,CSE 241A,A00,106406,Kang; Mingu,0,9,0,0
1668536585253,CSE 249B,A00,102388,Kahng; Andrew Byun,0,5,8,8
1668536585677,CSE 251B,A01,102392,Cottrell; Garrison W,0,50,0,0
1668536585677,CSE 251B,A02,102393,Cottrell; Garrison W,0,35,0,0
1668536586112,CSE 252B,A00,102394,Ochoa; Benjamin Lawrence,0,60,0,0
1668536586553,CSE 257,A01,102396,Gao; Sicun,0,141,0,0
1668536586979,CSE 272,A00,102397,Li; Tzumao,0,19,0,0
1668536587409,CSE 274,A00,111323,Chern; Albert Ren-Haur,0,15,0,0
1668536587839,CSE 282,A00,102398,Pevzner; Pavel Arkadjevich,0,0,0,0
1668536588261,CSE 284,A00,114175,Gymrek; Melissa Ann,0,23,0,0
1668536588699,CSE 290,A00,102399,Chandraker; Manmohan Krishna,0,11,0,0
1668536588699,CSE 290,B00,102400,Vaccaro; Kristen Marie,0,7,25,25
1668536588699,CSE 290,C00,102414,Pannuto; Patrick William,0,1,25,25
1668536588699,CSE 290,D00,102427,Pevzner; Pavel Arkadjevich,0,0,0,0
1668536588699,CSE 290,E00,102429,Zhao; Jishen,0,5,0,0
1668536588699,CSE 290,F00,102436,Tullsen; Dean Michael,0,6,0,0
1668536588699,CSE 290,G00,102440,Christensen; Henrik I,0,6,20,20
1668536589127,CSE 291,A00,102443,Su; Hao,0,0,0,0
1668536589127,CSE 291,B00,102448,Polikarpova; Nadezhda,0,0,0,0
1668536589127,CSE 291,C00,102453,Vaccaro; Kristen Marie,0,0,0,0
1668536589127,CSE 291,D00,111343,Savage; Stefan,0,0,0,0
1668536589127,CSE 291,E00,116474,Claffy; Kimberly Claire,0,0,0,0
1668536589127,CSE 291,F00,116479,Pasquale; Joseph,0,0,0,0
1668536589555,CSE 293,001,119111,Bafna; Vineet,9999,0,9999,0
1668536589555,CSE 293,002,119118,Bellare; Mihir,9999,0,9999,0
1668536589555,CSE 293,003,119122,Berg-Kirkpatrick; Taylor D,9999,0,9999,0
1668536589555,CSE 293,004,119135,Christensen; Henrik I,9999,0,9999,0
1668536589555,CSE 293,005,119142,Cottrell; Garrison W,9999,0,9999,0
1668536589555,CSE 293,006,119146,Deutsch; Alin Bernard,9999,0,9999,0
1668536589555,CSE 293,007,119159,Esmaeilzadeh; Hadi,9999,0,9999,0
1668536589555,CSE 293,008,119166,Freund; Yoav,9999,0,9999,0
1668536589555,CSE 293,009,119170,Griswold; William G.,9999,0,9999,0
1668536589555,CSE 293,010,119183,Gymrek; Melissa Ann,9999,0,9999,0
1668536589555,CSE 293,011,119190,Heninger; Nadia A,9999,0,9999,0
1668536589555,CSE 293,012,119230,Impagliazzo; Russell,9999,0,9999,0
1668536589555,CSE 293,013,119232,Jhala; Ranjit,9999,0,9999,0
1668536589555,CSE 293,014,119233,Kahng; Andrew Byun,9999,0,9999,0
1668536589555,CSE 293,015,119298,Kane; Daniel Mertz,9999,0,9999,0
1668536589555,CSE 293,016,119299,Kriegman; David J,9999,0,9999,0
1668536589555,CSE 293,017,119300,Kumar; Arun Kumar,9999,0,9999,0
1668536589555,CSE 293,018,119301,Lerner; Sorin,9999,0,9999,0
1668536589555,CSE 293,019,119302,Lovett; Shachar,9999,0,9999,0
1668536589555,CSE 293,020,119303,McAuley; Julian John,9999,0,9999,0
1668536589555,CSE 293,021,119304,Micciancio; Daniele,9999,0,9999,0
1668536589555,CSE 293,022,119367,Orailoglu; Alex,9999,0,9999,0
1668536589555,CSE 293,023,119382,Paturi; Ramamohan,9999,0,9999,0
1668536589555,CSE 293,024,119404,Polikarpova; Nadezhda,9999,0,9999,0
1668536589555,CSE 293,025,119406,Politz; Joseph Gibbs,9999,0,9999,0
1668536589555,CSE 293,026,119411,Porter; George M,9999,0,9999,0
1668536589555,CSE 293,027,119414,Porter; Leonard Emerson,9999,0,9999,0
1668536589555,CSE 293,028,119416,Ramamoorthi; Ravi,9999,0,9999,0
1668536589555,CSE 293,029,119417,Sahoo; Debashis,9999,0,9999,0
1668536589555,CSE 293,030,119420,Saul; Lawrence,9999,0,9999,0
1668536589555,CSE 293,031,119421,Savage; Stefan,9999,0,9999,0
1668536589555,CSE 293,032,119425,Schulze; Jurgen P.,9999,0,9999,0
1668536589555,CSE 293,033,119426,Snoeren; Alex C.,9999,0,9999,0
1668536589555,CSE 293,034,119428,Shang; Jingbo,9999,0,9999,0
1668536589555,CSE 293,035,119430,Stefan; Deian,9999,0,9999,0
1668536589555,CSE 293,036,119431,Su; Hao,9999,0,9999,0
1668536589555,CSE 293,037,119433,Swanson; Steven James,9999,0,9999,0
1668536589555,CSE 293,038,119435,Tullsen; Dean Michael,9999,0,9999,0
1668536589555,CSE 293,039,119483,Voelker; Geoffrey M.,9999,0,9999,0
1668536589555,CSE 293,040,119537,Zhao; Jishen,9999,0,9999,0
1668536589555,CSE 293,041,119538,Zhou; Yuan-Yuan,9999,0,9999,0
1668536589555,CSE 293,042,119539,Gao; Sicun,9999,0,9999,0
1668536589555,CSE 293,043,119540,Weibel; Nadir,9999,0,9999,0
1668536589555,CSE 293,044,119541,Gupta; Rajesh K.,9999,0,9999,0
1668536589555,CSE 293,045,126410,Vaccaro; Kristen Marie,9999,0,9999,0
1668536589555,CSE 293,046,126411,Klemke; Richard,9999,0,9999,0
1668536589978,CSE 294,A00,102459,Voelker; Geoffrey M.,0,2,0,0
1668536589978,CSE 294,B00,111322,Orailoglu; Alex,0,2,0,0
1668536590401,DSE 201,A00,096914,Deutsch; Alin Bernard,30,0,30,0
1668536590829,DSE 210,A00,096915,Dasgupta; Sanjoy,30,0,30,0
1668536591312,DSE 260A,A00,096916,Altintas De Callaf; Ilkay,30,0,30,0
1668536591747,ECE 200,001,103586,Antipa; Nicholas A,9999,0,9999,0
1668536591747,ECE 200,002,103587,Atanasov; Nikolay A.,9999,0,9999,0
1668536591747,ECE 200,003,103588,Bharadia; Dinesh,9999,0,9999,0
1668536591747,ECE 200,004,103589,Cheng; Chung Kuan,9999,0,9999,0
1668536591747,ECE 200,005,103590,Cosman; Pamela C.,9999,0,9999,0
1668536591747,ECE 200,006,103591,Dayeh; Shadi Ahmad,9999,0,9999,0
1668536591747,ECE 200,007,103592,Fainman; Yeshaiahu,9999,0,9999,0
1668536591747,ECE 200,008,103593,Ford; Joseph Earl,9999,0,9999,0
1668536591747,ECE 200,009,103594,Franceschetti; Massimo,9999,0,9999,0
1668536591747,ECE 200,010,103595,Fullerton; Eric E,9999,0,9999,0
1668536591747,ECE 200,011,103596,Galton; Ian A,9999,0,9999,0
1668536591747,ECE 200,012,103597,Gilja; Vikash,9999,0,9999,0
1668536591747,ECE 200,013,103598,Hall; Drew A.,9999,0,9999,0
1668536591747,ECE 200,014,103599,Hsueh; Tzu-Chien,9999,0,9999,0
1668536591747,ECE 200,015,103600,Javidi; Tara,9999,0,9999,0
1668536591747,ECE 200,016,103601,Kahng; Andrew Byun,9999,0,9999,0
1668536591747,ECE 200,017,103602,Kim; Young-Han,9999,0,9999,0
1668536591747,ECE 200,018,103603,Koushanfar; Farinaz,9999,0,9999,0
1668536591747,ECE 200,019,103604,Kuzum; Duygu,9999,0,9999,0
1668536591747,ECE 200,020,103605,Le; Hanh-Phuc,9999,0,9999,0
1668536591747,ECE 200,021,103606,Lin; Bill,9999,0,9999,0
1668536591747,ECE 200,022,103607,Liu; Zhaowei,9998,0,9999,1
1668536591747,ECE 200,023,103608,Lo; Yu-Hwa,9999,0,9999,0
1668536591747,ECE 200,024,103609,Lomakin; Vitaliy,9999,0,9999,0
1668536591747,ECE 200,025,103610,Mercier; Patrick Philip,9999,0,9999,0
1668536591747,ECE 200,026,103611,Meyer; Florian,9999,0,9999,0
1668536591747,ECE 200,027,103612,Milstein; Laurence B.,9999,0,9999,0
1668536591747,ECE 200,028,103613,Mir Arabbaygi; Siavash,9999,0,9999,0
1668536591747,ECE 200,029,103614,Mookherjea; Shayan,9999,0,9999,0
1668536591747,ECE 200,030,103615,Morris; Karcher William,9999,0,9999,0
1668536591747,ECE 200,031,103616,Ng; Tse Nga,9999,0,9999,0
1668536591747,ECE 200,032,103617,Nguyen; Truong Quang,9999,0,9999,0
1668536591747,ECE 200,033,103618,Nomura; Kenji,9999,0,9999,0
1668536591747,ECE 200,034,103619,Orlitsky; Alon,9999,0,9999,0
1668536591747,ECE 200,035,103620,Pal; Piya,9999,0,9999,0
1668536591747,ECE 200,036,103621,Papen; George C.,9999,0,9999,0
1668536591747,ECE 200,037,103622,Radic; Stojan,9999,0,9999,0
1668536591747,ECE 200,038,103623,Rao; Bhaskar D.,9999,0,9999,0
1668536591747,ECE 200,039,103624,Rao; Ramesh R,9999,0,9999,0
1668536591747,ECE 200,040,103625,Rebeiz; Gabriel,9999,0,9999,0
1668536591747,ECE 200,041,103626,Sanford; John R,9999,0,9999,0
1668536591747,ECE 200,042,103627,Siegel; Paul H.,9999,0,9999,0
1668536591747,ECE 200,043,103628,Sievenpiper; Daniel F.,9999,0,9999,0
1668536591747,ECE 200,044,103629,Sworder; David D.,9999,0,9999,0
1668536591747,ECE 200,045,103630,Taur; Yuan,9999,0,9999,0
1668536591747,ECE 200,046,103631,Touri; Behrouz,9999,0,9999,0
1668536591747,ECE 200,047,103632,Trivedi; Mohan M.,9999,0,9999,0
1668536591747,ECE 200,048,103633,Vasconcelos; Nuno,9999,0,9999,0
1668536591747,ECE 200,049,103634,Wang; Xiaolong,9999,0,9999,0
1668536591747,ECE 200,050,103635,Xie; Pengtao,9999,0,9999,0
1668536591747,ECE 200,051,103636,Yip; Michael,9999,0,9999,0
1668536591747,ECE 200,052,103637,Zeger; Kenneth A.,999,0,999,0
1668536591747,ECE 200,053,103638,Zhang; Xinyu,9999,0,9999,0
1668536591747,ECE 200,054,103639,Turakhia; Yatish Girish,9999,0,9999,0
1668536591747,ECE 200,055,103640,Kang; Mingu,9999,0,9999,0
1668536591747,ECE 200,056,103641,Shi; Yuanyuan,9999,0,9999,0
1668536591747,ECE 200,057,103642,Wang; Edward Jay,9999,0,9999,0
1668536591747,ECE 200,058,103643,Zheng; Yang,9999,0,9999,0
1668536592170,ECE 202,A00,103644,Kuzum; Duygu,0,44,0,0
1668536592594,ECE 212BN,A00,103646,Ng; Tse Nga,0,9,0,0
1668536593017,ECE 221,A00,111493,Staff,0,0,0,0
1668536593440,ECE 222B,A00,103647,Lomakin; Vitaliy,0,20,0,0
1668536593866,ECE 230B,A00,103648,Taur; Yuan,0,3,0,0
1668536594298,ECE 238B,A00,103649,Garay; Javier,0,0,0,0
1668536594729,ECE 240B,A00,112900,Fainman; Yeshaiahu,0,7,0,0
1668536595153,ECE 247A,A00,103650,Jokerst; Jesse Vincent,0,6,0,0
1668536595585,ECE 247B,A00,103651,Wang; Joseph,0,14,0,0
1668536596015,ECE 250,A00,103652,Siegel; Paul H.,0,82,0,0
1668536596441,ECE 251A,A00,103654,Rao; Bhaskar D.,0,62,0,0
1668536596865,ECE 257B,A00,103655,Bharadia; Dinesh,0,33,0,0
1668536597288,ECE 258A,A00,103656,Milstein; Laurence B.,0,29,0,0
1668536597714,ECE 260B,A00,103658,Kang; Mingu,0,121,0,0
1668536598136,ECE 264A,A00,103659,Galton; Ian A,0,68,0,0
1668536598559,ECE 265A,A00,103661,Gudem; Prasad S.S.,0,73,0,0
1668536598983,ECE 265D,A00,103662,Gudem; Prasad S.S.,0,26,0,0
1668536599406,ECE 268,A00,103663,Koushanfar; Farinaz,0,43,0,0
1668536599837,ECE 269,A01,103665,Pal; Piya,0,217,0,0
1668536600269,ECE 271B,A00,103666,Vasconcelos; Manuela,0,77,0,0
1668536600702,ECE 276A,A00,103667,Atanasov; Nikolay A.,0,127,0,0
1668536601137,ECE 277,A00,103668,An; Cheolhong,0,150,0,0
1668536601560,ECE 279,A00,117947,Hall; Drew A.,0,22,0,0
1668536602428,ECE 283,A00,103670,Hsueh; Tzu-Chien,0,55,0,0
1668536602876,ECE 284,A00,103671,Turakhia; Yatish Girish,0,39,0,0
1668536603308,ECE 285,A00,103672,Zheng; Yang,0,40,0,0
1668536603308,ECE 285,B00,103673,Sworder; David D.,0,59,0,0
1668536603735,ECE 287,A00,103676,Javidi; Tara,0,9,0,0
1668536604167,MATH 200B,A00,098023,Salehi Golsefidy; Alireza,10,0,15,5
1668536604599,MATH 202B,A00,098024,Rhoades; Brendon Patrick,7,0,15,8
1668536605037,MATH 203B,A00,098025,Oprea; Dragos N.,9,0,15,6
1668536605473,MATH 204B,A00,098026,Sorensen; Claus M,13,0,15,2
1668536605899,MATH 208,A00,098027,Izadi; Elham,7,0,10,3
1668536606332,MATH 209,A00,098028,Pollack; Aaron,10,0,10,0
1668536606755,MATH 211A,A00,112919,Rogalski; Daniel,8,0,10,2
1668536607178,MATH 211B,A00,112920,Seward; Brandon M.,9,0,10,1
1668536607604,MATH 218,A00,098029,Li; Bo,10,0,10,0
1668536608037,MATH 220B,A00,098030,Novak; Jonathan I,11,0,15,4
1668536608464,MATH 221A,A00,098031,Ebenfelt; Peter F,12,0,15,3
1668536608887,MATH 231B,A00,098032,Zlatos; Andrej,11,0,15,4
1668536609311,MATH 240B,A00,098033,Ni; Lei,7,0,15,8
1668536609742,MATH 243,A00,098034,Jekel; David Andrew,10,0,10,0
1668536610175,MATH 245A,A00,098035,Nie; Jiawang,0,5,15,18
1668536610602,MATH 248,A00,098036,Bejenaru; Ioan,10,0,10,0
1668536611034,MATH 250B,A00,098037,Spolaor; Luca,14,0,15,1
1668536611460,MATH 258,A00,098038,Ni; Lei,9,0,10,1
1668536611884,MATH 264B,A00,098041,Rhoades; Brendon Patrick,8,0,15,7
1668536612306,MATH 268,A00,098042,Buss; Samuel R,10,0,10,0
1668536612729,MATH 269,A00,098043,Rhoades; Brendon Patrick,10,0,10,0
1668536613156,MATH 270B,A00,098044,Li; Bo,6,0,15,9
1668536613595,MATH 272B,A00,098045,Holst; Michael J,13,0,15,2
1668536614024,MATH 273A,A00,098046,Tian; Xiaochuan,10,0,15,5
1668536614448,MATH 275,A01,098048,Tian; Xiaochuan,6,0,10,4
1668536614872,MATH 278A,A00,098049,Holst; Michael J,7,0,10,3
1668536615384,MATH 278B,A00,098050,Cloninger; Alexander,10,0,10,0
1668536615807,MATH 278C,A00,098051,Nie; Jiawang,5,0,10,5
1668536616241,MATH 280B,A00,098052,Zheng; Tianyi,7,0,15,8
1668536616676,MATH 281B,A00,098053,Bradic; Jelena,0,2,15,15
1668536617106,MATH 282B,A00,098054,Arias-Castro; Ery,0,1,15,15
1668536617531,MATH 285,A00,098055,Fitzsimmons; Patrick J,0,4,15,17
1668536617955,MATH 287B,A00,098056,Arias-Castro; Ery,1,0,15,14
1668536618392,MATH 288,A00,098057,Agarwal; Pooja,9,0,10,1
1668536618392,MATH 288,B00,098058,Zhang; Danna,8,0,10,2
1668536618392,MATH 288,C00,098059,Williams; Ruth J,9,0,10,1
1668536618816,MATH 290B,A00,098060,Roberts; Justin Deritter,12,0,15,3
1668536619239,MATH 292,A00,098061,Belmont; Eva Kinoshita,10,0,10,0
1668536619662,MATH 295,A00,098062,Suk; Andrew Hoon,47,0,50,3
1668536620092,MATH 296,A00,098063,Novak; Jonathan I,20,0,20,0
1668536620515,MATH 297,001,098064,Gamst; Anthony Collins,9997,0,9999,2
1668537124427,COGS 205,A00,101395,Chiba; Andrea,19,0,20,1
1668537124857,COGS 210B,001,101404,Greene; Deanna Jacquelyn,9998,0,9999,1
1668537124857,COGS 210B,002,101417,Xia; Haijun,9999,0,9999,0
1668537124857,COGS 210B,003,101422,Nitz; Douglas A.,9999,0,9999,0
1668537124857,COGS 210B,004,101423,Hollan; James D.,9998,0,9999,1
1668537124857,COGS 210B,005,101424,Deak; Gedeon O.,9998,0,9999,1
1668537124857,COGS 210B,006,101425,Rossano; Federico,9999,0,9999,0
1668537125283,COGS 211B,A00,101427,Coulson; Seana M,9996,0,9999,3
1668537125709,COGS 220,A00,101428,Hollan; James D.,0,11,25,25
1668537126139,COGS 229,A00,101429,Dow; Steven P,17,0,25,8
1668537126563,COGS 230,A00,101430,Klemmer; Scott R,7,0,17,10
1668537126989,COGS 234,A00,101431,Xia; Haijun,0,0,25,25
1668537127411,COGS 260,A00,101432,Kiyonaga; Anastasia,21,0,25,4
1668537127411,COGS 260,B00,101433,Kirsh; David Joel,15,0,25,10
1668537127841,CSE 202,A00,102371,Impagliazzo; Russell,0,66,0,0
1668537128267,CSE 203B,A01,102373,Cheng; Chung Kuan,0,60,0,0
1668537128692,CSE 208,A00,102374,Micciancio; Daniele,0,5,0,0
1668537129125,CSE 209A,A00,112895,Impagliazzo; Russell,0,13,15,15
1668537129553,CSE 209B,A00,108005,Bellare; Mihir,0,7,0,0
1668537129986,CSE 210,A00,113163,Coblenz; Michael J,0,86,0,0
1668537130429,CSE 219,A00,106111,Dow; Steven P,0,7,20,20
1668537130855,CSE 221,A00,102376,Voelker; Geoffrey M.,0,72,0,0
1668537131298,CSE 224,A01,102378,Porter; George M,0,168,0,0
1668537131731,CSE 229A,A00,102379,Savage; Stefan,0,11,0,0
1668537132158,CSE 229C,A00,102380,Munyaka; Imani N. S.,0,10,0,0
1668537132596,CSE 232B,A00,102382,Deutsch; Alin Bernard,0,35,0,0
1668537133032,CSE 234,A01,112904,Kumar; Arun Kumar,0,0,0,0
1668537133467,CSE 237A,A00,102383,Rosing; Tajana Simunic,0,56,0,0
1668537133896,CSE 239A,A00,102384,Deutsch; Alin Bernard,0,16,0,0
1668537134320,CSE 239B,A00,102385,Polikarpova; Nadezhda,0,11,0,0
1668537134743,CSE 240A,A00,102386,Pannuto; Patrick William,0,46,0,0
1668537135171,CSE 240B,A00,102387,Zhao; Jishen,0,48,0,0
1668537135603,CSE 241A,A00,106406,Kang; Mingu,0,9,0,0
1668537136031,CSE 249B,A00,102388,Kahng; Andrew Byun,0,5,8,8
1668537136455,CSE 251B,A01,102392,Cottrell; Garrison W,0,50,0,0
1668537136455,CSE 251B,A02,102393,Cottrell; Garrison W,0,35,0,0
1668537136882,CSE 252B,A00,102394,Ochoa; Benjamin Lawrence,0,60,0,0
1668537137306,CSE 257,A01,102396,Gao; Sicun,0,141,0,0
1668537137730,CSE 272,A00,102397,Li; Tzumao,0,19,0,0
1668537138235,CSE 274,A00,111323,Chern; Albert Ren-Haur,0,15,0,0
1668537138657,CSE 282,A00,102398,Pevzner; Pavel Arkadjevich,0,0,0,0
1668537139082,CSE 284,A00,114175,Gymrek; Melissa Ann,0,23,0,0
1668537139505,CSE 290,A00,102399,Chandraker; Manmohan Krishna,0,11,0,0
1668537139505,CSE 290,B00,102400,Vaccaro; Kristen Marie,0,7,25,25
1668537139505,CSE 290,C00,102414,Pannuto; Patrick William,0,1,25,25
1668537139505,CSE 290,D00,102427,Pevzner; Pavel Arkadjevich,0,0,0,0
1668537139505,CSE 290,E00,102429,Zhao; Jishen,0,5,0,0
1668537139505,CSE 290,F00,102436,Tullsen; Dean Michael,0,6,0,0
1668537139505,CSE 290,G00,102440,Christensen; Henrik I,0,6,20,20
1668537139934,CSE 291,A00,102443,Su; Hao,0,0,0,0
1668537139934,CSE 291,B00,102448,Polikarpova; Nadezhda,0,0,0,0
1668537139934,CSE 291,C00,102453,Vaccaro; Kristen Marie,0,0,0,0
1668537139934,CSE 291,D00,111343,Savage; Stefan,0,0,0,0
1668537139934,CSE 291,E00,116474,Claffy; Kimberly Claire,0,0,0,0
1668537139934,CSE 291,F00,116479,Pasquale; Joseph,0,0,0,0
1668537140366,CSE 293,001,119111,Bafna; Vineet,9999,0,9999,0
1668537140366,CSE 293,002,119118,Bellare; Mihir,9999,0,9999,0
1668537140366,CSE 293,003,119122,Berg-Kirkpatrick; Taylor D,9999,0,9999,0
1668537140366,CSE 293,004,119135,Christensen; Henrik I,9999,0,9999,0
1668537140366,CSE 293,005,119142,Cottrell; Garrison W,9999,0,9999,0
1668537140366,CSE 293,006,119146,Deutsch; Alin Bernard,9999,0,9999,0
1668537140366,CSE 293,007,119159,Esmaeilzadeh; Hadi,9999,0,9999,0
1668537140366,CSE 293,008,119166,Freund; Yoav,9999,0,9999,0
1668537140366,CSE 293,009,119170,Griswold; William G.,9999,0,9999,0
1668537140366,CSE 293,010,119183,Gymrek; Melissa Ann,9999,0,9999,0
1668537140366,CSE 293,011,119190,Heninger; Nadia A,9999,0,9999,0
1668537140366,CSE 293,012,119230,Impagliazzo; Russell,9999,0,9999,0
1668537140366,CSE 293,013,119232,Jhala; Ranjit,9999,0,9999,0
1668537140366,CSE 293,014,119233,Kahng; Andrew Byun,9999,0,9999,0
1668537140366,CSE 293,015,119298,Kane; Daniel Mertz,9999,0,9999,0
1668537140366,CSE 293,016,119299,Kriegman; David J,9999,0,9999,0
1668537140366,CSE 293,017,119300,Kumar; Arun Kumar,9999,0,9999,0
1668537140366,CSE 293,018,119301,Lerner; Sorin,9999,0,9999,0
1668537140366,CSE 293,019,119302,Lovett; Shachar,9999,0,9999,0
1668537140366,CSE 293,020,119303,McAuley; Julian John,9999,0,9999,0
1668537140366,CSE 293,021,119304,Micciancio; Daniele,9999,0,9999,0
1668537140366,CSE 293,022,119367,Orailoglu; Alex,9999,0,9999,0
1668537140366,CSE 293,023,119382,Paturi; Ramamohan,9999,0,9999,0
1668537140366,CSE 293,024,119404,Polikarpova; Nadezhda,9999,0,9999,0
1668537140366,CSE 293,025,119406,Politz; Joseph Gibbs,9999,0,9999,0
1668537140366,CSE 293,026,119411,Porter; George M,9999,0,9999,0
1668537140366,CSE 293,027,119414,Porter; Leonard Emerson,9999,0,9999,0
1668537140366,CSE 293,028,119416,Ramamoorthi; Ravi,9999,0,9999,0
1668537140366,CSE 293,029,119417,Sahoo; Debashis,9999,0,9999,0
1668537140366,CSE 293,030,119420,Saul; Lawrence,9999,0,9999,0
1668537140366,CSE 293,031,119421,Savage; Stefan,9999,0,9999,0
1668537140366,CSE 293,032,119425,Schulze; Jurgen P.,9999,0,9999,0
1668537140366,CSE 293,033,119426,Snoeren; Alex C.,9999,0,9999,0
1668537140366,CSE 293,034,119428,Shang; Jingbo,9999,0,9999,0
1668537140366,CSE 293,035,119430,Stefan; Deian,9999,0,9999,0
1668537140366,CSE 293,036,119431,Su; Hao,9999,0,9999,0
1668537140366,CSE 293,037,119433,Swanson; Steven James,9999,0,9999,0
1668537140366,CSE 293,038,119435,Tullsen; Dean Michael,9999,0,9999,0
1668537140366,CSE 293,039,119483,Voelker; Geoffrey M.,9999,0,9999,0
1668537140366,CSE 293,040,119537,Zhao; Jishen,9999,0,9999,0
1668537140366,CSE 293,041,119538,Zhou; Yuan-Yuan,9999,0,9999,0
1668537140366,CSE 293,042,119539,Gao; Sicun,9999,0,9999,0
1668537140366,CSE 293,043,119540,Weibel; Nadir,9999,0,9999,0
1668537140366,CSE 293,044,119541,Gupta; Rajesh K.,9999,0,9999,0
1668537140366,CSE 293,045,126410,Vaccaro; Kristen Marie,9999,0,9999,0
1668537140366,CSE 293,046,126411,Klemke; Richard,9999,0,9999,0
1668537140791,CSE 294,A00,102459,Voelker; Geoffrey M.,0,2,0,0
1668537140791,CSE 294,B00,111322,Orailoglu; Alex,0,2,0,0
1668537141215,DSE 201,A00,096914,Deutsch; Alin Bernard,30,0,30,0
1668537141644,DSE 210,A00,096915,Dasgupta; Sanjoy,30,0,30,0
1668537142070,DSE 260A,A00,096916,Altintas De Callaf; Ilkay,30,0,30,0
1668537142513,ECE 200,001,103586,Antipa; Nicholas A,9999,0,9999,0
1668537142513,ECE 200,002,103587,Atanasov; Nikolay A.,9999,0,9999,0
1668537142513,ECE 200,003,103588,Bharadia; Dinesh,9999,0,9999,0
1668537142513,ECE 200,004,103589,Cheng; Chung Kuan,9999,0,9999,0
1668537142513,ECE 200,005,103590,Cosman; Pamela C.,9999,0,9999,0
1668537142513,ECE 200,006,103591,Dayeh; Shadi Ahmad,9999,0,9999,0
1668537142513,ECE 200,007,103592,Fainman; Yeshaiahu,9999,0,9999,0
1668537142513,ECE 200,008,103593,Ford; Joseph Earl,9999,0,9999,0
1668537142513,ECE 200,009,103594,Franceschetti; Massimo,9999,0,9999,0
1668537142513,ECE 200,010,103595,Fullerton; Eric E,9999,0,9999,0
1668537142513,ECE 200,011,103596,Galton; Ian A,9999,0,9999,0
1668537142513,ECE 200,012,103597,Gilja; Vikash,9999,0,9999,0
1668537142513,ECE 200,013,103598,Hall; Drew A.,9999,0,9999,0
1668537142513,ECE 200,014,103599,Hsueh; Tzu-Chien,9999,0,9999,0
1668537142513,ECE 200,015,103600,Javidi; Tara,9999,0,9999,0
1668537142513,ECE 200,016,103601,Kahng; Andrew Byun,9999,0,9999,0
1668537142513,ECE 200,017,103602,Kim; Young-Han,9999,0,9999,0
1668537142513,ECE 200,018,103603,Koushanfar; Farinaz,9999,0,9999,0
1668537142513,ECE 200,019,103604,Kuzum; Duygu,9999,0,9999,0
1668537142513,ECE 200,020,103605,Le; Hanh-Phuc,9999,0,9999,0
1668537142513,ECE 200,021,103606,Lin; Bill,9999,0,9999,0
1668537142513,ECE 200,022,103607,Liu; Zhaowei,9998,0,9999,1
1668537142513,ECE 200,023,103608,Lo; Yu-Hwa,9999,0,9999,0
1668537142513,ECE 200,024,103609,Lomakin; Vitaliy,9999,0,9999,0
1668537142513,ECE 200,025,103610,Mercier; Patrick Philip,9999,0,9999,0
1668537142513,ECE 200,026,103611,Meyer; Florian,9999,0,9999,0
1668537142513,ECE 200,027,103612,Milstein; Laurence B.,9999,0,9999,0
1668537142513,ECE 200,028,103613,Mir Arabbaygi; Siavash,9999,0,9999,0
1668537142513,ECE 200,029,103614,Mookherjea; Shayan,9999,0,9999,0
1668537142513,ECE 200,030,103615,Morris; Karcher William,9999,0,9999,0
1668537142513,ECE 200,031,103616,Ng; Tse Nga,9999,0,9999,0
1668537142513,ECE 200,032,103617,Nguyen; Truong Quang,9999,0,9999,0
1668537142513,ECE 200,033,103618,Nomura; Kenji,9999,0,9999,0
1668537142513,ECE 200,034,103619,Orlitsky; Alon,9999,0,9999,0
1668537142513,ECE 200,035,103620,Pal; Piya,9999,0,9999,0
1668537142513,ECE 200,036,103621,Papen; George C.,9999,0,9999,0
1668537142513,ECE 200,037,103622,Radic; Stojan,9999,0,9999,0
1668537142513,ECE 200,038,103623,Rao; Bhaskar D.,9999,0,9999,0
1668537142513,ECE 200,039,103624,Rao; Ramesh R,9999,0,9999,0
1668537142513,ECE 200,040,103625,Rebeiz; Gabriel,9999,0,9999,0
1668537142513,ECE 200,041,103626,Sanford; John R,9999,0,9999,0
1668537142513,ECE 200,042,103627,Siegel; Paul H.,9999,0,9999,0
1668537142513,ECE 200,043,103628,Sievenpiper; Daniel F.,9999,0,9999,0
1668537142513,ECE 200,044,103629,Sworder; David D.,9999,0,9999,0
1668537142513,ECE 200,045,103630,Taur; Yuan,9999,0,9999,0
1668537142513,ECE 200,046,103631,Touri; Behrouz,9999,0,9999,0
1668537142513,ECE 200,047,103632,Trivedi; Mohan M.,9999,0,9999,0
1668537142513,ECE 200,048,103633,Vasconcelos; Nuno,9999,0,9999,0
1668537142513,ECE 200,049,103634,Wang; Xiaolong,9999,0,9999,0
1668537142513,ECE 200,050,103635,Xie; Pengtao,9999,0,9999,0
1668537142513,ECE 200,051,103636,Yip; Michael,9999,0,9999,0
1668537142513,ECE 200,052,103637,Zeger; Kenneth A.,999,0,999,0
1668537142513,ECE 200,053,103638,Zhang; Xinyu,9999,0,9999,0
1668537142513,ECE 200,054,103639,Turakhia; Yatish Girish,9999,0,9999,0
1668537142513,ECE 200,055,103640,Kang; Mingu,9999,0,9999,0
1668537142513,ECE 200,056,103641,Shi; Yuanyuan,9999,0,9999,0
1668537142513,ECE 200,057,103642,Wang; Edward Jay,9999,0,9999,0
1668537142513,ECE 200,058,103643,Zheng; Yang,9999,0,9999,0
1668537142946,ECE 202,A00,103644,Kuzum; Duygu,0,44,0,0
1668537143373,ECE 212BN,A00,103646,Ng; Tse Nga,0,9,0,0
1668537143797,ECE 221,A00,111493,Staff,0,0,0,0
1668537144235,ECE 222B,A00,103647,Lomakin; Vitaliy,0,20,0,0
1668537144677,ECE 230B,A00,103648,Taur; Yuan,0,3,0,0
1668537145112,ECE 238B,A00,103649,Garay; Javier,0,0,0,0
1668537145537,ECE 240B,A00,112900,Fainman; Yeshaiahu,0,7,0,0
1668537145960,ECE 247A,A00,103650,Jokerst; Jesse Vincent,0,6,0,0
1668537146381,ECE 247B,A00,103651,Wang; Joseph,0,14,0,0
1668537146804,ECE 250,A00,103652,Siegel; Paul H.,0,82,0,0
1668537147240,ECE 251A,A00,103654,Rao; Bhaskar D.,0,62,0,0
1668537147668,ECE 257B,A00,103655,Bharadia; Dinesh,0,33,0,0
1668537148094,ECE 258A,A00,103656,Milstein; Laurence B.,0,29,0,0
1668537148517,ECE 260B,A00,103658,Kang; Mingu,0,121,0,0
1668537148944,ECE 264A,A00,103659,Galton; Ian A,0,68,0,0
1668537149370,ECE 265A,A00,103661,Gudem; Prasad S.S.,0,73,0,0
1668537149806,ECE 265D,A00,103662,Gudem; Prasad S.S.,0,26,0,0
1668537150239,ECE 268,A00,103663,Koushanfar; Farinaz,0,43,0,0
1668537150672,ECE 269,A01,103665,Pal; Piya,0,217,0,0
1668537151107,ECE 271B,A00,103666,Vasconcelos; Manuela,0,77,0,0
1668537151530,ECE 276A,A00,103667,Atanasov; Nikolay A.,0,127,0,0
1668537151954,ECE 277,A00,103668,An; Cheolhong,0,150,0,0
1668537152380,ECE 279,A00,117947,Hall; Drew A.,0,22,0,0
1668537153246,ECE 283,A00,103670,Hsueh; Tzu-Chien,0,55,0,0
1668537153678,ECE 284,A00,103671,Turakhia; Yatish Girish,0,39,0,0
1668537154123,ECE 285,A00,103672,Zheng; Yang,0,40,0,0
1668537154123,ECE 285,B00,103673,Sworder; David D.,0,59,0,0
1668537154554,ECE 287,A00,103676,Javidi; Tara,0,9,0,0
1668537154976,MATH 200B,A00,098023,Salehi Golsefidy; Alireza,10,0,15,5
1668537155404,MATH 202B,A00,098024,Rhoades; Brendon Patrick,7,0,15,8
1668537155839,MATH 203B,A00,098025,Oprea; Dragos N.,9,0,15,6
1668537156263,MATH 204B,A00,098026,Sorensen; Claus M,13,0,15,2
1668537156692,MATH 208,A00,098027,Izadi; Elham,7,0,10,3
1668537157114,MATH 209,A00,098028,Pollack; Aaron,10,0,10,0
1668537157536,MATH 211A,A00,112919,Rogalski; Daniel,8,0,10,2
1668537157970,MATH 211B,A00,112920,Seward; Brandon M.,9,0,10,1
1668537158408,MATH 218,A00,098029,Li; Bo,10,0,10,0
1668537158833,MATH 220B,A00,098030,Novak; Jonathan I,11,0,15,4
1668537159265,MATH 221A,A00,098031,Ebenfelt; Peter F,12,0,15,3
1668537159690,MATH 231B,A00,098032,Zlatos; Andrej,11,0,15,4
1668537160121,MATH 240B,A00,098033,Ni; Lei,7,0,15,8
1668537160547,MATH 243,A00,098034,Jekel; David Andrew,10,0,10,0
1668537160974,MATH 245A,A00,098035,Nie; Jiawang,0,5,15,18
1668537161396,MATH 248,A00,098036,Bejenaru; Ioan,10,0,10,0
1668537161821,MATH 250B,A00,098037,Spolaor; Luca,14,0,15,1
1668537162253,MATH 258,A00,098038,Ni; Lei,9,0,10,1
1668537162677,MATH 264B,A00,098041,Rhoades; Brendon Patrick,8,0,15,7
1668537163111,MATH 268,A00,098042,Buss; Samuel R,10,0,10,0
1668537163539,MATH 269,A00,098043,Rhoades; Brendon Patrick,10,0,10,0
1668537163963,MATH 270B,A00,098044,Li; Bo,6,0,15,9
1668537164399,MATH 272B,A00,098045,Holst; Michael J,13,0,15,2
1668537164824,MATH 273A,A00,098046,Tian; Xiaochuan,10,0,15,5
1668537165251,MATH 275,A01,098048,Tian; Xiaochuan,6,0,10,4
1668537165697,MATH 278A,A00,098049,Holst; Michael J,7,0,10,3
1668537166121,MATH 278B,A00,098050,Cloninger; Alexander,10,0,10,0
1668537166557,MATH 278C,A00,098051,Nie; Jiawang,5,0,10,5
1668537166982,MATH 280B,A00,098052,Zheng; Tianyi,7,0,15,8
1668537167421,MATH 281B,A00,098053,Bradic; Jelena,0,2,15,15
1668537167855,MATH 282B,A00,098054,Arias-Castro; Ery,0,1,15,15
1668537168295,MATH 285,A00,098055,Fitzsimmons; Patrick J,0,4,15,17
1668537168734,MATH 287B,A00,098056,Arias-Castro; Ery,1,0,15,14
1668537169166,MATH 288,A00,098057,Agarwal; Pooja,9,0,10,1
1668537169166,MATH 288,B00,098058,Zhang; Danna,8,0,10,2
1668537169166,MATH 288,C00,098059,Williams; Ruth J,9,0,10,1
1668537169594,MATH 290B,A00,098060,Roberts; Justin Deritter,12,0,15,3
1668537170018,MATH 292,A00,098061,Belmont; Eva Kinoshita,10,0,10,0
1668537170444,MATH 295,A00,098062,Suk; Andrew Hoon,47,0,50,3
1668537170866,MATH 296,A00,098063,Novak; Jonathan I,20,0,20,0
1668537171297,MATH 297,001,098064,Gamst; Anthony Collins,9997,0,9999,2
1668537709025,COGS 205,A00,101395,Chiba; Andrea,19,0,20,1
1668537709460,COGS 210B,001,101404,Greene; Deanna Jacquelyn,9998,0,9999,1
1668537709460,COGS 210B,002,101417,Xia; Haijun,9999,0,9999,0
1668537709460,COGS 210B,003,101422,Nitz; Douglas A.,9999,0,9999,0
1668537709460,COGS 210B,004,101423,Hollan; James D.,9998,0,9999,1
1668537709460,COGS 210B,005,101424,Deak; Gedeon O.,9998,0,9999,1
1668537709460,COGS 210B,006,101425,Rossano; Federico,9999,0,9999,0
1668537709904,COGS 211B,A00,101427,Coulson; Seana M,9996,0,9999,3
1668537710340,COGS 220,A00,101428,Hollan; James D.,0,12,25,25
1668537710761,COGS 229,A00,101429,Dow; Steven P,17,0,25,8
1668537711184,COGS 230,A00,101430,Klemmer; Scott R,7,0,17,10
1668537711608,COGS 234,A00,101431,Xia; Haijun,0,0,25,25
1668537712050,COGS 260,A00,101432,Kiyonaga; Anastasia,21,0,25,4
1668537712050,COGS 260,B00,101433,Kirsh; David Joel,15,0,25,10
1668537712487,CSE 202,A00,102371,Impagliazzo; Russell,0,66,0,0
1668537712925,CSE 203B,A01,102373,Cheng; Chung Kuan,0,61,0,0
1668537713362,CSE 208,A00,102374,Micciancio; Daniele,0,5,0,0
1668537713799,CSE 209A,A00,112895,Impagliazzo; Russell,0,13,15,15
1668537714238,CSE 209B,A00,108005,Bellare; Mihir,0,7,0,0
1668537714663,CSE 210,A00,113163,Coblenz; Michael J,0,86,0,0
1668537715101,CSE 219,A00,106111,Dow; Steven P,0,7,20,20
1668537715530,CSE 221,A00,102376,Voelker; Geoffrey M.,0,73,0,0
1668537715952,CSE 224,A01,102378,Porter; George M,0,169,0,0
1668537716391,CSE 229A,A00,102379,Savage; Stefan,0,11,0,0
1668537716831,CSE 229C,A00,102380,Munyaka; Imani N. S.,0,10,0,0
1668537717256,CSE 232B,A00,102382,Deutsch; Alin Bernard,0,35,0,0
1668537717689,CSE 234,A01,112904,Kumar; Arun Kumar,0,0,0,0
1668537718144,CSE 237A,A00,102383,Rosing; Tajana Simunic,0,56,0,0
1668537718568,CSE 239A,A00,102384,Deutsch; Alin Bernard,0,16,0,0
1668537719000,CSE 239B,A00,102385,Polikarpova; Nadezhda,0,11,0,0
1668537719426,CSE 240A,A00,102386,Pannuto; Patrick William,0,47,0,0
1668537719862,CSE 240B,A00,102387,Zhao; Jishen,0,48,0,0
1668537720295,CSE 241A,A00,106406,Kang; Mingu,0,9,0,0
1668537720718,CSE 249B,A00,102388,Kahng; Andrew Byun,0,5,8,8
1668537721152,CSE 251B,A01,102392,Cottrell; Garrison W,0,50,0,0
1668537721152,CSE 251B,A02,102393,Cottrell; Garrison W,0,35,0,0
1668537721581,CSE 252B,A00,102394,Ochoa; Benjamin Lawrence,0,60,0,0
1668537722008,CSE 257,A01,102396,Gao; Sicun,0,142,0,0
1668537722441,CSE 272,A00,102397,Li; Tzumao,0,19,0,0
1668537722868,CSE 274,A00,111323,Chern; Albert Ren-Haur,0,15,0,0
1668537723300,CSE 282,A00,102398,Pevzner; Pavel Arkadjevich,0,0,0,0
1668537723727,CSE 284,A00,114175,Gymrek; Melissa Ann,0,23,0,0
1668537724154,CSE 290,A00,102399,Chandraker; Manmohan Krishna,0,11,0,0
1668537724154,CSE 290,B00,102400,Vaccaro; Kristen Marie,0,7,25,25
1668537724154,CSE 290,C00,102414,Pannuto; Patrick William,0,1,25,25
1668537724154,CSE 290,D00,102427,Pevzner; Pavel Arkadjevich,0,0,0,0
1668537724154,CSE 290,E00,102429,Zhao; Jishen,0,5,0,0
1668537724154,CSE 290,F00,102436,Tullsen; Dean Michael,0,6,0,0
1668537724154,CSE 290,G00,102440,Christensen; Henrik I,0,6,20,20
1668537724590,CSE 291,A00,102443,Su; Hao,0,0,0,0
1668537724590,CSE 291,B00,102448,Polikarpova; Nadezhda,0,0,0,0
1668537724590,CSE 291,C00,102453,Vaccaro; Kristen Marie,0,0,0,0
1668537724590,CSE 291,D00,111343,Savage; Stefan,0,0,0,0
1668537724590,CSE 291,E00,116474,Claffy; Kimberly Claire,0,0,0,0
1668537724590,CSE 291,F00,116479,Pasquale; Joseph,0,0,0,0
1668537725025,CSE 293,001,119111,Bafna; Vineet,9999,0,9999,0
1668537725025,CSE 293,002,119118,Bellare; Mihir,9999,0,9999,0
1668537725025,CSE 293,003,119122,Berg-Kirkpatrick; Taylor D,9999,0,9999,0
1668537725025,CSE 293,004,119135,Christensen; Henrik I,9999,0,9999,0
1668537725025,CSE 293,005,119142,Cottrell; Garrison W,9999,0,9999,0
1668537725025,CSE 293,006,119146,Deutsch; Alin Bernard,9999,0,9999,0
1668537725025,CSE 293,007,119159,Esmaeilzadeh; Hadi,9999,0,9999,0
1668537725025,CSE 293,008,119166,Freund; Yoav,9999,0,9999,0
1668537725025,CSE 293,009,119170,Griswold; William G.,9999,0,9999,0
1668537725025,CSE 293,010,119183,Gymrek; Melissa Ann,9999,0,9999,0
1668537725025,CSE 293,011,119190,Heninger; Nadia A,9999,0,9999,0
1668537725025,CSE 293,012,119230,Impagliazzo; Russell,9999,0,9999,0
1668537725025,CSE 293,013,119232,Jhala; Ranjit,9999,0,9999,0
1668537725025,CSE 293,014,119233,Kahng; Andrew Byun,9999,0,9999,0
1668537725025,CSE 293,015,119298,Kane; Daniel Mertz,9999,0,9999,0
1668537725025,CSE 293,016,119299,Kriegman; David J,9999,0,9999,0
1668537725025,CSE 293,017,119300,Kumar; Arun Kumar,9999,0,9999,0
1668537725025,CSE 293,018,119301,Lerner; Sorin,9999,0,9999,0
1668537725025,CSE 293,019,119302,Lovett; Shachar,9999,0,9999,0
1668537725025,CSE 293,020,119303,McAuley; Julian John,9999,0,9999,0
1668537725025,CSE 293,021,119304,Micciancio; Daniele,9999,0,9999,0
1668537725025,CSE 293,022,119367,Orailoglu; Alex,9999,0,9999,0
1668537725025,CSE 293,023,119382,Paturi; Ramamohan,9999,0,9999,0
1668537725025,CSE 293,024,119404,Polikarpova; Nadezhda,9999,0,9999,0
1668537725025,CSE 293,025,119406,Politz; Joseph Gibbs,9999,0,9999,0
1668537725025,CSE 293,026,119411,Porter; George M,9999,0,9999,0
1668537725025,CSE 293,027,119414,Porter; Leonard Emerson,9999,0,9999,0
1668537725025,CSE 293,028,119416,Ramamoorthi; Ravi,9999,0,9999,0
1668537725025,CSE 293,029,119417,Sahoo; Debashis,9999,0,9999,0
1668537725025,CSE 293,030,119420,Saul; Lawrence,9999,0,9999,0
1668537725025,CSE 293,031,119421,Savage; Stefan,9999,0,9999,0
1668537725025,CSE 293,032,119425,Schulze; Jurgen P.,9999,0,9999,0
1668537725025,CSE 293,033,119426,Snoeren; Alex C.,9999,0,9999,0
1668537725025,CSE 293,034,119428,Shang; Jingbo,9999,0,9999,0
1668537725025,CSE 293,035,119430,Stefan; Deian,9999,0,9999,0
1668537725025,CSE 293,036,119431,Su; Hao,9999,0,9999,0
1668537725025,CSE 293,037,119433,Swanson; Steven James,9999,0,9999,0
1668537725025,CSE 293,038,119435,Tullsen; Dean Michael,9999,0,9999,0
1668537725025,CSE 293,039,119483,Voelker; Geoffrey M.,9999,0,9999,0
1668537725025,CSE 293,040,119537,Zhao; Jishen,9999,0,9999,0
1668537725025,CSE 293,041,119538,Zhou; Yuan-Yuan,9999,0,9999,0
1668537725025,CSE 293,042,119539,Gao; Sicun,9999,0,9999,0
1668537725025,CSE 293,043,119540,Weibel; Nadir,9999,0,9999,0
1668537725025,CSE 293,044,119541,Gupta; Rajesh K.,9999,0,9999,0
1668537725025,CSE 293,045,126410,Vaccaro; Kristen Marie,9999,0,9999,0
1668537725025,CSE 293,046,126411,Klemke; Richard,9999,0,9999,0
1668537725453,CSE 294,A00,102459,Voelker; Geoffrey M.,0,2,0,0
1668537725453,CSE 294,B00,111322,Orailoglu; Alex,0,2,0,0
1668537725878,DSE 201,A00,096914,Deutsch; Alin Bernard,30,0,30,0
1668537726303,DSE 210,A00,096915,Dasgupta; Sanjoy,30,0,30,0
1668537726739,DSE 260A,A00,096916,Altintas De Callaf; Ilkay,30,0,30,0
1668537727172,ECE 200,001,103586,Antipa; Nicholas A,9999,0,9999,0
1668537727172,ECE 200,002,103587,Atanasov; Nikolay A.,9999,0,9999,0
1668537727172,ECE 200,003,103588,Bharadia; Dinesh,9999,0,9999,0
1668537727172,ECE 200,004,103589,Cheng; Chung Kuan,9999,0,9999,0
1668537727172,ECE 200,005,103590,Cosman; Pamela C.,9999,0,9999,0
1668537727172,ECE 200,006,103591,Dayeh; Shadi Ahmad,9999,0,9999,0
1668537727172,ECE 200,007,103592,Fainman; Yeshaiahu,9999,0,9999,0
1668537727172,ECE 200,008,103593,Ford; Joseph Earl,9999,0,9999,0
1668537727172,ECE 200,009,103594,Franceschetti; Massimo,9999,0,9999,0
1668537727172,ECE 200,010,103595,Fullerton; Eric E,9999,0,9999,0
1668537727172,ECE 200,011,103596,Galton; Ian A,9999,0,9999,0
1668537727172,ECE 200,012,103597,Gilja; Vikash,9999,0,9999,0
1668537727172,ECE 200,013,103598,Hall; Drew A.,9999,0,9999,0
1668537727172,ECE 200,014,103599,Hsueh; Tzu-Chien,9999,0,9999,0
1668537727172,ECE 200,015,103600,Javidi; Tara,9999,0,9999,0
1668537727172,ECE 200,016,103601,Kahng; Andrew Byun,9999,0,9999,0
1668537727172,ECE 200,017,103602,Kim; Young-Han,9999,0,9999,0
1668537727172,ECE 200,018,103603,Koushanfar; Farinaz,9999,0,9999,0
1668537727172,ECE 200,019,103604,Kuzum; Duygu,9999,0,9999,0
1668537727172,ECE 200,020,103605,Le; Hanh-Phuc,9999,0,9999,0
1668537727172,ECE 200,021,103606,Lin; Bill,9999,0,9999,0
1668537727172,ECE 200,022,103607,Liu; Zhaowei,9998,0,9999,1
1668537727172,ECE 200,023,103608,Lo; Yu-Hwa,9999,0,9999,0
1668537727172,ECE 200,024,103609,Lomakin; Vitaliy,9999,0,9999,0
1668537727172,ECE 200,025,103610,Mercier; Patrick Philip,9999,0,9999,0
1668537727172,ECE 200,026,103611,Meyer; Florian,9999,0,9999,0
1668537727172,ECE 200,027,103612,Milstein; Laurence B.,9999,0,9999,0
1668537727172,ECE 200,028,103613,Mir Arabbaygi; Siavash,9999,0,9999,0
1668537727172,ECE 200,029,103614,Mookherjea; Shayan,9999,0,9999,0
1668537727172,ECE 200,030,103615,Morris; Karcher William,9999,0,9999,0
1668537727172,ECE 200,031,103616,Ng; Tse Nga,9999,0,9999,0
1668537727172,ECE 200,032,103617,Nguyen; Truong Quang,9999,0,9999,0
1668537727172,ECE 200,033,103618,Nomura; Kenji,9999,0,9999,0
1668537727172,ECE 200,034,103619,Orlitsky; Alon,9999,0,9999,0
1668537727172,ECE 200,035,103620,Pal; Piya,9999,0,9999,0
1668537727172,ECE 200,036,103621,Papen; George C.,9999,0,9999,0
1668537727172,ECE 200,037,103622,Radic; Stojan,9999,0,9999,0
1668537727172,ECE 200,038,103623,Rao; Bhaskar D.,9999,0,9999,0
1668537727172,ECE 200,039,103624,Rao; Ramesh R,9999,0,9999,0
1668537727172,ECE 200,040,103625,Rebeiz; Gabriel,9999,0,9999,0
1668537727172,ECE 200,041,103626,Sanford; John R,9999,0,9999,0
1668537727172,ECE 200,042,103627,Siegel; Paul H.,9999,0,9999,0
1668537727172,ECE 200,043,103628,Sievenpiper; Daniel F.,9999,0,9999,0
1668537727172,ECE 200,044,103629,Sworder; David D.,9999,0,9999,0
1668537727172,ECE 200,045,103630,Taur; Yuan,9999,0,9999,0
1668537727172,ECE 200,046,103631,Touri; Behrouz,9999,0,9999,0
1668537727172,ECE 200,047,103632,Trivedi; Mohan M.,9999,0,9999,0
1668537727172,ECE 200,048,103633,Vasconcelos; Nuno,9999,0,9999,0
1668537727172,ECE 200,049,103634,Wang; Xiaolong,9999,0,9999,0
1668537727172,ECE 200,050,103635,Xie; Pengtao,9999,0,9999,0
1668537727172,ECE 200,051,103636,Yip; Michael,9999,0,9999,0
1668537727172,ECE 200,052,103637,Zeger; Kenneth A.,999,0,999,0
1668537727172,ECE 200,053,103638,Zhang; Xinyu,9999,0,9999,0
1668537727172,ECE 200,054,103639,Turakhia; Yatish Girish,9999,0,9999,0
1668537727172,ECE 200,055,103640,Kang; Mingu,9999,0,9999,0
1668537727172,ECE 200,056,103641,Shi; Yuanyuan,9999,0,9999,0
1668537727172,ECE 200,057,103642,Wang; Edward Jay,9999,0,9999,0
1668537727172,ECE 200,058,103643,Zheng; Yang,9999,0,9999,0
1668537727608,ECE 202,A00,103644,Kuzum; Duygu,0,44,0,0
1668537728040,ECE 212BN,A00,103646,Ng; Tse Nga,0,9,0,0
1668537728469,ECE 221,A00,111493,Staff,0,0,0,0
1668537728892,ECE 222B,A00,103647,Lomakin; Vitaliy,0,20,0,0
1668537729327,ECE 230B,A00,103648,Taur; Yuan,0,3,0,0
1668537729751,ECE 238B,A00,103649,Garay; Javier,0,0,0,0
1668537730185,ECE 240B,A00,112900,Fainman; Yeshaiahu,0,7,0,0
1668537730612,ECE 247A,A00,103650,Jokerst; Jesse Vincent,0,6,0,0
1668537731036,ECE 247B,A00,103651,Wang; Joseph,0,14,0,0
1668537731471,ECE 250,A00,103652,Siegel; Paul H.,0,82,0,0
1668537731896,ECE 251A,A00,103654,Rao; Bhaskar D.,0,62,0,0
1668537732319,ECE 257B,A00,103655,Bharadia; Dinesh,0,33,0,0
1668537732761,ECE 258A,A00,103656,Milstein; Laurence B.,0,29,0,0
1668537733190,ECE 260B,A00,103658,Kang; Mingu,0,121,0,0
1668537733613,ECE 264A,A00,103659,Galton; Ian A,0,69,0,0
1668537734039,ECE 265A,A00,103661,Gudem; Prasad S.S.,0,73,0,0
1668537734468,ECE 265D,A00,103662,Gudem; Prasad S.S.,0,26,0,0
1668537734896,ECE 268,A00,103663,Koushanfar; Farinaz,0,43,0,0
1668537735318,ECE 269,A01,103665,Pal; Piya,0,217,0,0
1668537735743,ECE 271B,A00,103666,Vasconcelos; Manuela,0,77,0,0
1668537736170,ECE 276A,A00,103667,Atanasov; Nikolay A.,0,127,0,0
1668537736605,ECE 277,A00,103668,An; Cheolhong,0,150,0,0
1668537737029,ECE 279,A00,117947,Hall; Drew A.,0,22,0,0
1668537737878,ECE 283,A00,103670,Hsueh; Tzu-Chien,0,56,0,0
1668537738410,ECE 284,A00,103671,Turakhia; Yatish Girish,0,39,0,0
1668537738835,ECE 285,A00,103672,Zheng; Yang,0,40,0,0
1668537738835,ECE 285,B00,103673,Sworder; David D.,0,59,0,0
1668537739266,ECE 287,A00,103676,Javidi; Tara,0,9,0,0
1668537739704,MATH 200B,A00,098023,Salehi Golsefidy; Alireza,10,0,15,5
1668537740133,MATH 202B,A00,098024,Rhoades; Brendon Patrick,7,0,15,8
1668537740563,MATH 203B,A00,098025,Oprea; Dragos N.,9,0,15,6
1668537740996,MATH 204B,A00,098026,Sorensen; Claus M,13,0,15,2
1668537741429,MATH 208,A00,098027,Izadi; Elham,7,0,10,3
1668537741871,MATH 209,A00,098028,Pollack; Aaron,10,0,10,0
1668537742297,MATH 211A,A00,112919,Rogalski; Daniel,8,0,10,2
1668537742721,MATH 211B,A00,112920,Seward; Brandon M.,9,0,10,1
1668537743158,MATH 218,A00,098029,Li; Bo,10,0,10,0
1668537743590,MATH 220B,A00,098030,Novak; Jonathan I,11,0,15,4
1668537744021,MATH 221A,A00,098031,Ebenfelt; Peter F,12,0,15,3
1668537744449,MATH 231B,A00,098032,Zlatos; Andrej,11,0,15,4
1668537744872,MATH 240B,A00,098033,Ni; Lei,7,0,15,8
1668537745307,MATH 243,A00,098034,Jekel; David Andrew,10,0,10,0
1668537745730,MATH 245A,A00,098035,Nie; Jiawang,0,5,15,18
1668537746154,MATH 248,A00,098036,Bejenaru; Ioan,10,0,10,0
1668537746585,MATH 250B,A00,098037,Spolaor; Luca,14,0,15,1
1668537747025,MATH 258,A00,098038,Ni; Lei,9,0,10,1
1668537747465,MATH 264B,A00,098041,Rhoades; Brendon Patrick,8,0,15,7
1668537747897,MATH 268,A00,098042,Buss; Samuel R,10,0,10,0
1668537748323,MATH 269,A00,098043,Rhoades; Brendon Patrick,10,0,10,0
1668537748752,MATH 270B,A00,098044,Li; Bo,6,0,15,9
1668537749176,MATH 272B,A00,098045,Holst; Michael J,13,0,15,2
1668537749606,MATH 273A,A00,098046,Tian; Xiaochuan,10,0,15,5
1668537750034,MATH 275,A01,098048,Tian; Xiaochuan,6,0,10,4
1668537750470,MATH 278A,A00,098049,Holst; Michael J,7,0,10,3
1668537750898,MATH 278B,A00,098050,Cloninger; Alexander,10,0,10,0
1668537751323,MATH 278C,A00,098051,Nie; Jiawang,5,0,10,5
1668537751756,MATH 280B,A00,098052,Zheng; Tianyi,7,0,15,8
1668537752183,MATH 281B,A00,098053,Bradic; Jelena,0,2,15,15
1668537752618,MATH 282B,A00,098054,Arias-Castro; Ery,0,1,15,15
1668537753055,MATH 285,A00,098055,Fitzsimmons; Patrick J,0,4,15,17
1668537753483,MATH 287B,A00,098056,Arias-Castro; Ery,1,0,15,14
1668537753905,MATH 288,A00,098057,Agarwal; Pooja,9,0,10,1
1668537753905,MATH 288,B00,098058,Zhang; Danna,8,0,10,2
1668537753905,MATH 288,C00,098059,Williams; Ruth J,9,0,10,1
1668537754332,MATH 290B,A00,098060,Roberts; Justin Deritter,12,0,15,3
1668537754757,MATH 292,A00,098061,Belmont; Eva Kinoshita,10,0,10,0
1668537755193,MATH 295,A00,098062,Suk; Andrew Hoon,47,0,50,3
1668537755624,MATH 296,A00,098063,Novak; Jonathan I,20,0,20,0
1668537756048,MATH 297,001,098064,Gamst; Anthony Collins,9997,0,9999,2
1668538262134,COGS 205,A00,101395,Chiba; Andrea,19,0,20,1
1668538262558,COGS 210B,001,101404,Greene; Deanna Jacquelyn,9998,0,9999,1
1668538262558,COGS 210B,002,101417,Xia; Haijun,9999,0,9999,0
1668538262558,COGS 210B,003,101422,Nitz; Douglas A.,9999,0,9999,0
1668538262558,COGS 210B,004,101423,Hollan; James D.,9998,0,9999,1
1668538262558,COGS 210B,005,101424,Deak; Gedeon O.,9998,0,9999,1
1668538262558,COGS 210B,006,101425,Rossano; Federico,9999,0,9999,0
1668538262982,COGS 211B,A00,101427,Coulson; Seana M,9996,0,9999,3
1668538263521,COGS 220,A00,101428,Hollan; James D.,0,12,25,25
1668538263945,COGS 229,A00,101429,Dow; Steven P,17,0,25,8
1668538264379,COGS 230,A00,101430,Klemmer; Scott R,7,0,17,10
1668538264808,COGS 234,A00,101431,Xia; Haijun,0,0,25,25
1668538265243,COGS 260,A00,101432,Kiyonaga; Anastasia,21,0,25,4
1668538265243,COGS 260,B00,101433,Kirsh; David Joel,15,0,25,10
1668538265667,CSE 202,A00,102371,Impagliazzo; Russell,0,66,0,0
1668538266095,CSE 203B,A01,102373,Cheng; Chung Kuan,0,61,0,0
1668538266535,CSE 208,A00,102374,Micciancio; Daniele,0,5,0,0
1668538266962,CSE 209A,A00,112895,Impagliazzo; Russell,0,13,15,15
1668538267390,CSE 209B,A00,108005,Bellare; Mihir,0,7,0,0
1668538267813,CSE 210,A00,113163,Coblenz; Michael J,0,88,0,0
1668538268235,CSE 219,A00,106111,Dow; Steven P,0,8,20,20
1668538268665,CSE 221,A00,102376,Voelker; Geoffrey M.,0,73,0,0
1668538269087,CSE 224,A01,102378,Porter; George M,0,170,0,0
1668538269519,CSE 229A,A00,102379,Savage; Stefan,0,11,0,0
1668538269943,CSE 229C,A00,102380,Munyaka; Imani N. S.,0,10,0,0
1668538270368,CSE 232B,A00,102382,Deutsch; Alin Bernard,0,36,0,0
1668538270797,CSE 234,A01,112904,Kumar; Arun Kumar,0,0,0,0
1668538271220,CSE 237A,A00,102383,Rosing; Tajana Simunic,0,56,0,0
1668538271666,CSE 239A,A00,102384,Deutsch; Alin Bernard,0,16,0,0
1668538272087,CSE 239B,A00,102385,Polikarpova; Nadezhda,0,11,0,0
1668538272517,CSE 240A,A00,102386,Pannuto; Patrick William,0,47,0,0
1668538272942,CSE 240B,A00,102387,Zhao; Jishen,0,48,0,0
1668538273368,CSE 241A,A00,106406,Kang; Mingu,0,9,0,0
1668538273794,CSE 249B,A00,102388,Kahng; Andrew Byun,0,5,8,8
1668538274223,CSE 251B,A01,102392,Cottrell; Garrison W,0,51,0,0
1668538274223,CSE 251B,A02,102393,Cottrell; Garrison W,0,35,0,0
1668538274648,CSE 252B,A00,102394,Ochoa; Benjamin Lawrence,0,60,0,0
1668538275083,CSE 257,A01,102396,Gao; Sicun,0,143,0,0
1668538275511,CSE 272,A00,102397,Li; Tzumao,0,19,0,0
1668538275955,CSE 274,A00,111323,Chern; Albert Ren-Haur,0,15,0,0
1668538276384,CSE 282,A00,102398,Pevzner; Pavel Arkadjevich,0,0,0,0
1668538276806,CSE 284,A00,114175,Gymrek; Melissa Ann,0,23,0,0
1668538277230,CSE 290,A00,102399,Chandraker; Manmohan Krishna,0,11,0,0
1668538277230,CSE 290,B00,102400,Vaccaro; Kristen Marie,0,7,25,25
1668538277230,CSE 290,C00,102414,Pannuto; Patrick William,0,1,25,25
1668538277230,CSE 290,D00,102427,Pevzner; Pavel Arkadjevich,0,0,0,0
1668538277230,CSE 290,E00,102429,Zhao; Jishen,0,5,0,0
1668538277230,CSE 290,F00,102436,Tullsen; Dean Michael,0,6,0,0
1668538277230,CSE 290,G00,102440,Christensen; Henrik I,0,6,20,20
1668538277660,CSE 291,A00,102443,Su; Hao,0,0,0,0
1668538277660,CSE 291,B00,102448,Polikarpova; Nadezhda,0,0,0,0
1668538277660,CSE 291,C00,102453,Vaccaro; Kristen Marie,0,0,0,0
1668538277660,CSE 291,D00,111343,Savage; Stefan,0,0,0,0
1668538277660,CSE 291,E00,116474,Claffy; Kimberly Claire,0,0,0,0
1668538277660,CSE 291,F00,116479,Pasquale; Joseph,0,0,0,0
1668538278116,CSE 293,001,119111,Bafna; Vineet,9999,0,9999,0
1668538278116,CSE 293,002,119118,Bellare; Mihir,9999,0,9999,0
1668538278116,CSE 293,003,119122,Berg-Kirkpatrick; Taylor D,9999,0,9999,0
1668538278116,CSE 293,004,119135,Christensen; Henrik I,9999,0,9999,0
1668538278116,CSE 293,005,119142,Cottrell; Garrison W,9999,0,9999,0
1668538278116,CSE 293,006,119146,Deutsch; Alin Bernard,9999,0,9999,0
1668538278116,CSE 293,007,119159,Esmaeilzadeh; Hadi,9999,0,9999,0
1668538278116,CSE 293,008,119166,Freund; Yoav,9999,0,9999,0
1668538278116,CSE 293,009,119170,Griswold; William G.,9999,0,9999,0
1668538278116,CSE 293,010,119183,Gymrek; Melissa Ann,9999,0,9999,0
1668538278116,CSE 293,011,119190,Heninger; Nadia A,9999,0,9999,0
1668538278116,CSE 293,012,119230,Impagliazzo; Russell,9999,0,9999,0
1668538278116,CSE 293,013,119232,Jhala; Ranjit,9999,0,9999,0
1668538278116,CSE 293,014,119233,Kahng; Andrew Byun,9999,0,9999,0
1668538278116,CSE 293,015,119298,Kane; Daniel Mertz,9999,0,9999,0
1668538278116,CSE 293,016,119299,Kriegman; David J,9999,0,9999,0
1668538278116,CSE 293,017,119300,Kumar; Arun Kumar,9999,0,9999,0
1668538278116,CSE 293,018,119301,Lerner; Sorin,9999,0,9999,0
1668538278116,CSE 293,019,119302,Lovett; Shachar,9999,0,9999,0
1668538278116,CSE 293,020,119303,McAuley; Julian John,9999,0,9999,0
1668538278116,CSE 293,021,119304,Micciancio; Daniele,9999,0,9999,0
1668538278116,CSE 293,022,119367,Orailoglu; Alex,9999,0,9999,0
1668538278116,CSE 293,023,119382,Paturi; Ramamohan,9999,0,9999,0
1668538278116,CSE 293,024,119404,Polikarpova; Nadezhda,9999,0,9999,0
1668538278116,CSE 293,025,119406,Politz; Joseph Gibbs,9999,0,9999,0
1668538278116,CSE 293,026,119411,Porter; George M,9999,0,9999,0
1668538278116,CSE 293,027,119414,Porter; Leonard Emerson,9999,0,9999,0
1668538278116,CSE 293,028,119416,Ramamoorthi; Ravi,9999,0,9999,0
1668538278116,CSE 293,029,119417,Sahoo; Debashis,9999,0,9999,0
1668538278116,CSE 293,030,119420,Saul; Lawrence,9999,0,9999,0
1668538278116,CSE 293,031,119421,Savage; Stefan,9999,0,9999,0
1668538278116,CSE 293,032,119425,Schulze; Jurgen P.,9999,0,9999,0
1668538278116,CSE 293,033,119426,Snoeren; Alex C.,9999,0,9999,0
1668538278116,CSE 293,034,119428,Shang; Jingbo,9999,0,9999,0
1668538278116,CSE 293,035,119430,Stefan; Deian,9999,0,9999,0
1668538278116,CSE 293,036,119431,Su; Hao,9999,0,9999,0
1668538278116,CSE 293,037,119433,Swanson; Steven James,9999,0,9999,0
1668538278116,CSE 293,038,119435,Tullsen; Dean Michael,9999,0,9999,0
1668538278116,CSE 293,039,119483,Voelker; Geoffrey M.,9999,0,9999,0
1668538278116,CSE 293,040,119537,Zhao; Jishen,9999,0,9999,0
1668538278116,CSE 293,041,119538,Zhou; Yuan-Yuan,9999,0,9999,0
1668538278116,CSE 293,042,119539,Gao; Sicun,9999,0,9999,0
1668538278116,CSE 293,043,119540,Weibel; Nadir,9999,0,9999,0
1668538278116,CSE 293,044,119541,Gupta; Rajesh K.,9999,0,9999,0
1668538278116,CSE 293,045,126410,Vaccaro; Kristen Marie,9999,0,9999,0
1668538278116,CSE 293,046,126411,Klemke; Richard,9999,0,9999,0
1668538278557,CSE 294,A00,102459,Voelker; Geoffrey M.,0,2,0,0
1668538278557,CSE 294,B00,111322,Orailoglu; Alex,0,2,0,0
1668538278980,DSE 201,A00,096914,Deutsch; Alin Bernard,30,0,30,0
1668538279410,DSE 210,A00,096915,Dasgupta; Sanjoy,30,0,30,0
1668538279846,DSE 260A,A00,096916,Altintas De Callaf; Ilkay,30,0,30,0
1668538280281,ECE 200,001,103586,Antipa; Nicholas A,9999,0,9999,0
1668538280281,ECE 200,002,103587,Atanasov; Nikolay A.,9999,0,9999,0
1668538280281,ECE 200,003,103588,Bharadia; Dinesh,9999,0,9999,0
1668538280281,ECE 200,004,103589,Cheng; Chung Kuan,9999,0,9999,0
1668538280281,ECE 200,005,103590,Cosman; Pamela C.,9999,0,9999,0
1668538280281,ECE 200,006,103591,Dayeh; Shadi Ahmad,9999,0,9999,0
1668538280281,ECE 200,007,103592,Fainman; Yeshaiahu,9999,0,9999,0
1668538280281,ECE 200,008,103593,Ford; Joseph Earl,9999,0,9999,0
1668538280281,ECE 200,009,103594,Franceschetti; Massimo,9999,0,9999,0
1668538280281,ECE 200,010,103595,Fullerton; Eric E,9999,0,9999,0
1668538280281,ECE 200,011,103596,Galton; Ian A,9999,0,9999,0
1668538280281,ECE 200,012,103597,Gilja; Vikash,9999,0,9999,0
1668538280281,ECE 200,013,103598,Hall; Drew A.,9999,0,9999,0
1668538280281,ECE 200,014,103599,Hsueh; Tzu-Chien,9999,0,9999,0
1668538280281,ECE 200,015,103600,Javidi; Tara,9999,0,9999,0
1668538280281,ECE 200,016,103601,Kahng; Andrew Byun,9999,0,9999,0
1668538280281,ECE 200,017,103602,Kim; Young-Han,9999,0,9999,0
1668538280281,ECE 200,018,103603,Koushanfar; Farinaz,9999,0,9999,0
1668538280281,ECE 200,019,103604,Kuzum; Duygu,9999,0,9999,0
1668538280281,ECE 200,020,103605,Le; Hanh-Phuc,9999,0,9999,0
1668538280281,ECE 200,021,103606,Lin; Bill,9999,0,9999,0
1668538280281,ECE 200,022,103607,Liu; Zhaowei,9998,0,9999,1
1668538280281,ECE 200,023,103608,Lo; Yu-Hwa,9999,0,9999,0
1668538280281,ECE 200,024,103609,Lomakin; Vitaliy,9999,0,9999,0
1668538280281,ECE 200,025,103610,Mercier; Patrick Philip,9999,0,9999,0
1668538280281,ECE 200,026,103611,Meyer; Florian,9999,0,9999,0
1668538280281,ECE 200,027,103612,Milstein; Laurence B.,9999,0,9999,0
1668538280281,ECE 200,028,103613,Mir Arabbaygi; Siavash,9999,0,9999,0
1668538280281,ECE 200,029,103614,Mookherjea; Shayan,9999,0,9999,0
1668538280281,ECE 200,030,103615,Morris; Karcher William,9999,0,9999,0
1668538280281,ECE 200,031,103616,Ng; Tse Nga,9999,0,9999,0
1668538280281,ECE 200,032,103617,Nguyen; Truong Quang,9999,0,9999,0
1668538280281,ECE 200,033,103618,Nomura; Kenji,9999,0,9999,0
1668538280281,ECE 200,034,103619,Orlitsky; Alon,9999,0,9999,0
1668538280281,ECE 200,035,103620,Pal; Piya,9999,0,9999,0
1668538280281,ECE 200,036,103621,Papen; George C.,9999,0,9999,0
1668538280281,ECE 200,037,103622,Radic; Stojan,9999,0,9999,0
1668538280281,ECE 200,038,103623,Rao; Bhaskar D.,9999,0,9999,0
1668538280281,ECE 200,039,103624,Rao; Ramesh R,9999,0,9999,0
1668538280281,ECE 200,040,103625,Rebeiz; Gabriel,9999,0,9999,0
1668538280281,ECE 200,041,103626,Sanford; John R,9999,0,9999,0
1668538280281,ECE 200,042,103627,Siegel; Paul H.,9999,0,9999,0
1668538280281,ECE 200,043,103628,Sievenpiper; Daniel F.,9999,0,9999,0
1668538280281,ECE 200,044,103629,Sworder; David D.,9999,0,9999,0
1668538280281,ECE 200,045,103630,Taur; Yuan,9999,0,9999,0
1668538280281,ECE 200,046,103631,Touri; Behrouz,9999,0,9999,0
1668538280281,ECE 200,047,103632,Trivedi; Mohan M.,9999,0,9999,0
1668538280281,ECE 200,048,103633,Vasconcelos; Nuno,9999,0,9999,0
1668538280281,ECE 200,049,103634,Wang; Xiaolong,9999,0,9999,0
1668538280281,ECE 200,050,103635,Xie; Pengtao,9999,0,9999,0
1668538280281,ECE 200,051,103636,Yip; Michael,9999,0,9999,0
1668538280281,ECE 200,052,103637,Zeger; Kenneth A.,999,0,999,0
1668538280281,ECE 200,053,103638,Zhang; Xinyu,9999,0,9999,0
1668538280281,ECE 200,054,103639,Turakhia; Yatish Girish,9999,0,9999,0
1668538280281,ECE 200,055,103640,Kang; Mingu,9999,0,9999,0
1668538280281,ECE 200,056,103641,Shi; Yuanyuan,9999,0,9999,0
1668538280281,ECE 200,057,103642,Wang; Edward Jay,9999,0,9999,0
1668538280281,ECE 200,058,103643,Zheng; Yang,9999,0,9999,0
1668538280705,ECE 202,A00,103644,Kuzum; Duygu,0,44,0,0
1668538281133,ECE 212BN,A00,103646,Ng; Tse Nga,0,9,0,0
1668538281560,ECE 221,A00,111493,Staff,0,0,0,0
1668538282002,ECE 222B,A00,103647,Lomakin; Vitaliy,0,20,0,0
1668538282426,ECE 230B,A00,103648,Taur; Yuan,0,3,0,0
1668538282856,ECE 238B,A00,103649,Garay; Javier,0,0,0,0
1668538283291,ECE 240B,A00,112900,Fainman; Yeshaiahu,0,7,0,0
1668538283717,ECE 247A,A00,103650,Jokerst; Jesse Vincent,0,6,0,0
1668538284156,ECE 247B,A00,103651,Wang; Joseph,0,14,0,0
1668538284580,ECE 250,A00,103652,Siegel; Paul H.,0,82,0,0
1668538285008,ECE 251A,A00,103654,Rao; Bhaskar D.,0,62,0,0
1668538285430,ECE 257B,A00,103655,Bharadia; Dinesh,0,33,0,0
1668538285855,ECE 258A,A00,103656,Milstein; Laurence B.,0,29,0,0
1668538286292,ECE 260B,A00,103658,Kang; Mingu,0,121,0,0
1668538286716,ECE 264A,A00,103659,Galton; Ian A,0,69,0,0
1668538287141,ECE 265A,A00,103661,Gudem; Prasad S.S.,0,73,0,0
1668538287567,ECE 265D,A00,103662,Gudem; Prasad S.S.,0,26,0,0
1668538288003,ECE 268,A00,103663,Koushanfar; Farinaz,0,43,0,0
1668538288444,ECE 269,A01,103665,Pal; Piya,0,217,0,0
1668538288868,ECE 271B,A00,103666,Vasconcelos; Manuela,0,77,0,0
1668538289303,ECE 276A,A00,103667,Atanasov; Nikolay A.,0,127,0,0
1668538289732,ECE 277,A00,103668,An; Cheolhong,0,150,0,0
1668538290158,ECE 279,A00,117947,Hall; Drew A.,0,22,0,0
1668538291011,ECE 283,A00,103670,Hsueh; Tzu-Chien,0,56,0,0
1668538291443,ECE 284,A00,103671,Turakhia; Yatish Girish,0,39,0,0
1668538291882,ECE 285,A00,103672,Zheng; Yang,0,40,0,0
1668538291882,ECE 285,B00,103673,Sworder; David D.,0,59,0,0
1668538292313,ECE 287,A00,103676,Javidi; Tara,0,9,0,0
1668538292746,MATH 200B,A00,098023,Salehi Golsefidy; Alireza,10,0,15,5
1668538293172,MATH 202B,A00,098024,Rhoades; Brendon Patrick,7,0,15,8
1668538293614,MATH 203B,A00,098025,Oprea; Dragos N.,9,0,15,6
1668538294053,MATH 204B,A00,098026,Sorensen; Claus M,13,0,15,2
1668538294499,MATH 208,A00,098027,Izadi; Elham,7,0,10,3
1668538294930,MATH 209,A00,098028,Pollack; Aaron,10,0,10,0
1668538295362,MATH 211A,A00,112919,Rogalski; Daniel,8,0,10,2
1668538295793,MATH 211B,A00,112920,Seward; Brandon M.,9,0,10,1
1668538296216,MATH 218,A00,098029,Li; Bo,10,0,10,0
1668538296639,MATH 220B,A00,098030,Novak; Jonathan I,11,0,15,4
1668538297064,MATH 221A,A00,098031,Ebenfelt; Peter F,12,0,15,3
1668538297491,MATH 231B,A00,098032,Zlatos; Andrej,11,0,15,4
1668538297928,MATH 240B,A00,098033,Ni; Lei,7,0,15,8
1668538298365,MATH 243,A00,098034,Jekel; David Andrew,10,0,10,0
1668538298792,MATH 245A,A00,098035,Nie; Jiawang,0,5,15,18
1668538299217,MATH 248,A00,098036,Bejenaru; Ioan,10,0,10,0
1668538299656,MATH 250B,A00,098037,Spolaor; Luca,14,0,15,1
1668538300080,MATH 258,A00,098038,Ni; Lei,9,0,10,1
1668538300506,MATH 264B,A00,098041,Rhoades; Brendon Patrick,8,0,15,7
1668538300946,MATH 268,A00,098042,Buss; Samuel R,10,0,10,0
1668538301371,MATH 269,A00,098043,Rhoades; Brendon Patrick,10,0,10,0
1668538301795,MATH 270B,A00,098044,Li; Bo,6,0,15,9
1668538302222,MATH 272B,A00,098045,Holst; Michael J,13,0,15,2
1668538302645,MATH 273A,A00,098046,Tian; Xiaochuan,10,0,15,5
1668538303082,MATH 275,A01,098048,Tian; Xiaochuan,6,0,10,4
1668538303516,MATH 278A,A00,098049,Holst; Michael J,7,0,10,3
1668538303943,MATH 278B,A00,098050,Cloninger; Alexander,10,0,10,0
1668538304378,MATH 278C,A00,098051,Nie; Jiawang,5,0,10,5
1668538304810,MATH 280B,A00,098052,Zheng; Tianyi,7,0,15,8
1668538305239,MATH 281B,A00,098053,Bradic; Jelena,0,2,15,15
1668538305668,MATH 282B,A00,098054,Arias-Castro; Ery,0,1,15,15
1668538306099,MATH 285,A00,098055,Fitzsimmons; Patrick J,0,4,15,17
1668538306536,MATH 287B,A00,098056,Arias-Castro; Ery,1,0,15,14
1668538307060,MATH 288,A00,098057,Agarwal; Pooja,9,0,10,1
1668538307060,MATH 288,B00,098058,Zhang; Danna,8,0,10,2
1668538307060,MATH 288,C00,098059,Williams; Ruth J,9,0,10,1
1668538307489,MATH 290B,A00,098060,Roberts; Justin Deritter,12,0,15,3
1668538307929,MATH 292,A00,098061,Belmont; Eva Kinoshita,10,0,10,0
1668538308352,MATH 295,A00,098062,Suk; Andrew Hoon,47,0,50,3
1668538308792,MATH 296,A00,098063,Novak; Jonathan I,20,0,20,0
1668538309230,MATH 297,001,098064,Gamst; Anthony Collins,9997,0,9999,2
1668538814886,COGS 205,A00,101395,Chiba; Andrea,19,0,20,1
1668538815317,COGS 210B,001,101404,Greene; Deanna Jacquelyn,9998,0,9999,1
1668538815317,COGS 210B,002,101417,Xia; Haijun,9999,0,9999,0
1668538815317,COGS 210B,003,101422,Nitz; Douglas A.,9999,0,9999,0
1668538815317,COGS 210B,004,101423,Hollan; James D.,9998,0,9999,1
1668538815317,COGS 210B,005,101424,Deak; Gedeon O.,9998,0,9999,1
1668538815317,COGS 210B,006,101425,Rossano; Federico,9999,0,9999,0
1668538815759,COGS 211B,A00,101427,Coulson; Seana M,9996,0,9999,3
1668538816180,COGS 220,A00,101428,Hollan; James D.,0,12,25,25
1668538816606,COGS 229,A00,101429,Dow; Steven P,17,0,25,8
1668538817030,COGS 230,A00,101430,Klemmer; Scott R,7,0,17,10
1668538817454,COGS 234,A00,101431,Xia; Haijun,0,0,25,25
1668538817915,COGS 260,A00,101432,Kiyonaga; Anastasia,21,0,25,4
1668538817915,COGS 260,B00,101433,Kirsh; David Joel,15,0,25,10
1668538818353,CSE 202,A00,102371,Impagliazzo; Russell,0,66,0,0
1668538818799,CSE 203B,A01,102373,Cheng; Chung Kuan,0,61,0,0
1668538819233,CSE 208,A00,102374,Micciancio; Daniele,0,5,0,0
1668538819681,CSE 209A,A00,112895,Impagliazzo; Russell,0,13,15,15
1668538820112,CSE 209B,A00,108005,Bellare; Mihir,0,7,0,0
1668538820537,CSE 210,A00,113163,Coblenz; Michael J,0,88,0,0
1668538820959,CSE 219,A00,106111,Dow; Steven P,0,8,20,20
1668538821386,CSE 221,A00,102376,Voelker; Geoffrey M.,0,73,0,0
1668538821816,CSE 224,A01,102378,Porter; George M,0,170,0,0
1668538822240,CSE 229A,A00,102379,Savage; Stefan,0,11,0,0
1668538822679,CSE 229C,A00,102380,Munyaka; Imani N. S.,0,10,0,0
1668538823108,CSE 232B,A00,102382,Deutsch; Alin Bernard,0,36,0,0
1668538823531,CSE 234,A01,112904,Kumar; Arun Kumar,0,0,0,0
1668538823962,CSE 237A,A00,102383,Rosing; Tajana Simunic,0,56,0,0
1668538824393,CSE 239A,A00,102384,Deutsch; Alin Bernard,0,16,0,0
1668538824820,CSE 239B,A00,102385,Polikarpova; Nadezhda,0,11,0,0
1668538825246,CSE 240A,A00,102386,Pannuto; Patrick William,0,47,0,0
1668538825672,CSE 240B,A00,102387,Zhao; Jishen,0,48,0,0
1668538826094,CSE 241A,A00,106406,Kang; Mingu,0,9,0,0
1668538826520,CSE 249B,A00,102388,Kahng; Andrew Byun,0,5,8,8
1668538826947,CSE 251B,A01,102392,Cottrell; Garrison W,0,51,0,0
1668538826947,CSE 251B,A02,102393,Cottrell; Garrison W,0,35,0,0
1668538827384,CSE 252B,A00,102394,Ochoa; Benjamin Lawrence,0,60,0,0
1668538827809,CSE 257,A01,102396,Gao; Sicun,0,143,0,0
1668538828241,CSE 272,A00,102397,Li; Tzumao,0,19,0,0
1668538828667,CSE 274,A00,111323,Chern; Albert Ren-Haur,0,15,0,0
1668538829099,CSE 282,A00,102398,Pevzner; Pavel Arkadjevich,0,0,0,0
1668538829529,CSE 284,A00,114175,Gymrek; Melissa Ann,0,24,0,0
1668538829956,CSE 290,A00,102399,Chandraker; Manmohan Krishna,0,11,0,0
1668538829956,CSE 290,B00,102400,Vaccaro; Kristen Marie,0,7,25,25
1668538829956,CSE 290,C00,102414,Pannuto; Patrick William,0,1,25,25
1668538829956,CSE 290,D00,102427,Pevzner; Pavel Arkadjevich,0,0,0,0
1668538829956,CSE 290,E00,102429,Zhao; Jishen,0,5,0,0
1668538829956,CSE 290,F00,102436,Tullsen; Dean Michael,0,6,0,0
1668538829956,CSE 290,G00,102440,Christensen; Henrik I,0,6,20,20
1668538830394,CSE 291,A00,102443,Su; Hao,0,0,0,0
1668538830394,CSE 291,B00,102448,Polikarpova; Nadezhda,0,0,0,0
1668538830394,CSE 291,C00,102453,Vaccaro; Kristen Marie,0,0,0,0
1668538830394,CSE 291,D00,111343,Savage; Stefan,0,0,0,0
1668538830394,CSE 291,E00,116474,Claffy; Kimberly Claire,0,0,0,0
1668538830394,CSE 291,F00,116479,Pasquale; Joseph,0,0,0,0
1668538830896,CSE 293,001,119111,Bafna; Vineet,9999,0,9999,0
1668538830896,CSE 293,002,119118,Bellare; Mihir,9999,0,9999,0
1668538830896,CSE 293,003,119122,Berg-Kirkpatrick; Taylor D,9999,0,9999,0
1668538830896,CSE 293,004,119135,Christensen; Henrik I,9999,0,9999,0
1668538830896,CSE 293,005,119142,Cottrell; Garrison W,9999,0,9999,0
1668538830896,CSE 293,006,119146,Deutsch; Alin Bernard,9999,0,9999,0
1668538830896,CSE 293,007,119159,Esmaeilzadeh; Hadi,9999,0,9999,0
1668538830896,CSE 293,008,119166,Freund; Yoav,9999,0,9999,0
1668538830896,CSE 293,009,119170,Griswold; William G.,9999,0,9999,0
1668538830896,CSE 293,010,119183,Gymrek; Melissa Ann,9999,0,9999,0
1668538830896,CSE 293,011,119190,Heninger; Nadia A,9999,0,9999,0
1668538830896,CSE 293,012,119230,Impagliazzo; Russell,9999,0,9999,0
1668538830896,CSE 293,013,119232,Jhala; Ranjit,9999,0,9999,0
1668538830896,CSE 293,014,119233,Kahng; Andrew Byun,9999,0,9999,0
1668538830896,CSE 293,015,119298,Kane; Daniel Mertz,9999,0,9999,0
1668538830896,CSE 293,016,119299,Kriegman; David J,9999,0,9999,0
1668538830896,CSE 293,017,119300,Kumar; Arun Kumar,9999,0,9999,0
1668538830896,CSE 293,018,119301,Lerner; Sorin,9999,0,9999,0
1668538830896,CSE 293,019,119302,Lovett; Shachar,9999,0,9999,0
1668538830896,CSE 293,020,119303,McAuley; Julian John,9999,0,9999,0
1668538830896,CSE 293,021,119304,Micciancio; Daniele,9999,0,9999,0
1668538830896,CSE 293,022,119367,Orailoglu; Alex,9999,0,9999,0
1668538830896,CSE 293,023,119382,Paturi; Ramamohan,9999,0,9999,0
1668538830896,CSE 293,024,119404,Polikarpova; Nadezhda,9999,0,9999,0
1668538830896,CSE 293,025,119406,Politz; Joseph Gibbs,9999,0,9999,0
1668538830896,CSE 293,026,119411,Porter; George M,9999,0,9999,0
1668538830896,CSE 293,027,119414,Porter; Leonard Emerson,9999,0,9999,0
1668538830896,CSE 293,028,119416,Ramamoorthi; Ravi,9999,0,9999,0
1668538830896,CSE 293,029,119417,Sahoo; Debashis,9999,0,9999,0
1668538830896,CSE 293,030,119420,Saul; Lawrence,9999,0,9999,0
1668538830896,CSE 293,031,119421,Savage; Stefan,9999,0,9999,0
1668538830896,CSE 293,032,119425,Schulze; Jurgen P.,9999,0,9999,0
1668538830896,CSE 293,033,119426,Snoeren; Alex C.,9999,0,9999,0
1668538830896,CSE 293,034,119428,Shang; Jingbo,9999,0,9999,0
1668538830896,CSE 293,035,119430,Stefan; Deian,9999,0,9999,0
1668538830896,CSE 293,036,119431,Su; Hao,9999,0,9999,0
1668538830896,CSE 293,037,119433,Swanson; Steven James,9999,0,9999,0
1668538830896,CSE 293,038,119435,Tullsen; Dean Michael,9999,0,9999,0
1668538830896,CSE 293,039,119483,Voelker; Geoffrey M.,9999,0,9999,0
1668538830896,CSE 293,040,119537,Zhao; Jishen,9999,0,9999,0
1668538830896,CSE 293,041,119538,Zhou; Yuan-Yuan,9999,0,9999,0
1668538830896,CSE 293,042,119539,Gao; Sicun,9999,0,9999,0
1668538830896,CSE 293,043,119540,Weibel; Nadir,9999,0,9999,0
1668538830896,CSE 293,044,119541,Gupta; Rajesh K.,9999,0,9999,0
1668538830896,CSE 293,045,126410,Vaccaro; Kristen Marie,9999,0,9999,0
1668538830896,CSE 293,046,126411,Klemke; Richard,9999,0,9999,0
1668538831754,CSE 294,A00,102459,Voelker; Geoffrey M.,0,2,0,0
1668538831754,CSE 294,B00,111322,Orailoglu; Alex,0,2,0,0
1668538832180,DSE 201,A00,096914,Deutsch; Alin Bernard,30,0,30,0
1668538832606,DSE 210,A00,096915,Dasgupta; Sanjoy,30,0,30,0
1668538833037,DSE 260A,A00,096916,Altintas De Callaf; Ilkay,30,0,30,0
1668538833487,ECE 200,001,103586,Antipa; Nicholas A,9999,0,9999,0
1668538833487,ECE 200,002,103587,Atanasov; Nikolay A.,9999,0,9999,0
1668538833487,ECE 200,003,103588,Bharadia; Dinesh,9999,0,9999,0
1668538833487,ECE 200,004,103589,Cheng; Chung Kuan,9999,0,9999,0
1668538833487,ECE 200,005,103590,Cosman; Pamela C.,9999,0,9999,0
1668538833487,ECE 200,006,103591,Dayeh; Shadi Ahmad,9999,0,9999,0
1668538833487,ECE 200,007,103592,Fainman; Yeshaiahu,9999,0,9999,0
1668538833487,ECE 200,008,103593,Ford; Joseph Earl,9999,0,9999,0
1668538833487,ECE 200,009,103594,Franceschetti; Massimo,9999,0,9999,0
1668538833487,ECE 200,010,103595,Fullerton; Eric E,9999,0,9999,0
1668538833487,ECE 200,011,103596,Galton; Ian A,9999,0,9999,0
1668538833487,ECE 200,012,103597,Gilja; Vikash,9999,0,9999,0
1668538833487,ECE 200,013,103598,Hall; Drew A.,9999,0,9999,0
1668538833487,ECE 200,014,103599,Hsueh; Tzu-Chien,9999,0,9999,0
1668538833487,ECE 200,015,103600,Javidi; Tara,9999,0,9999,0
1668538833487,ECE 200,016,103601,Kahng; Andrew Byun,9999,0,9999,0
1668538833487,ECE 200,017,103602,Kim; Young-Han,9999,0,9999,0
1668538833487,ECE 200,018,103603,Koushanfar; Farinaz,9999,0,9999,0
1668538833487,ECE 200,019,103604,Kuzum; Duygu,9999,0,9999,0
1668538833487,ECE 200,020,103605,Le; Hanh-Phuc,9999,0,9999,0
1668538833487,ECE 200,021,103606,Lin; Bill,9999,0,9999,0
1668538833487,ECE 200,022,103607,Liu; Zhaowei,9998,0,9999,1
1668538833487,ECE 200,023,103608,Lo; Yu-Hwa,9999,0,9999,0
1668538833487,ECE 200,024,103609,Lomakin; Vitaliy,9999,0,9999,0
1668538833487,ECE 200,025,103610,Mercier; Patrick Philip,9999,0,9999,0
1668538833487,ECE 200,026,103611,Meyer; Florian,9999,0,9999,0
1668538833487,ECE 200,027,103612,Milstein; Laurence B.,9999,0,9999,0
1668538833487,ECE 200,028,103613,Mir Arabbaygi; Siavash,9999,0,9999,0
1668538833487,ECE 200,029,103614,Mookherjea; Shayan,9999,0,9999,0
1668538833487,ECE 200,030,103615,Morris; Karcher William,9999,0,9999,0
1668538833487,ECE 200,031,103616,Ng; Tse Nga,9999,0,9999,0
1668538833487,ECE 200,032,103617,Nguyen; Truong Quang,9999,0,9999,0
1668538833487,ECE 200,033,103618,Nomura; Kenji,9999,0,9999,0
1668538833487,ECE 200,034,103619,Orlitsky; Alon,9999,0,9999,0
1668538833487,ECE 200,035,103620,Pal; Piya,9999,0,9999,0
1668538833487,ECE 200,036,103621,Papen; George C.,9999,0,9999,0
1668538833487,ECE 200,037,103622,Radic; Stojan,9999,0,9999,0
1668538833487,ECE 200,038,103623,Rao; Bhaskar D.,9999,0,9999,0
1668538833487,ECE 200,039,103624,Rao; Ramesh R,9999,0,9999,0
1668538833487,ECE 200,040,103625,Rebeiz; Gabriel,9999,0,9999,0
1668538833487,ECE 200,041,103626,Sanford; John R,9999,0,9999,0
1668538833487,ECE 200,042,103627,Siegel; Paul H.,9999,0,9999,0
1668538833487,ECE 200,043,103628,Sievenpiper; Daniel F.,9999,0,9999,0
1668538833487,ECE 200,044,103629,Sworder; David D.,9999,0,9999,0
1668538833487,ECE 200,045,103630,Taur; Yuan,9999,0,9999,0
1668538833487,ECE 200,046,103631,Touri; Behrouz,9999,0,9999,0
1668538833487,ECE 200,047,103632,Trivedi; Mohan M.,9999,0,9999,0
1668538833487,ECE 200,048,103633,Vasconcelos; Nuno,9999,0,9999,0
1668538833487,ECE 200,049,103634,Wang; Xiaolong,9999,0,9999,0
1668538833487,ECE 200,050,103635,Xie; Pengtao,9999,0,9999,0
1668538833487,ECE 200,051,103636,Yip; Michael,9999,0,9999,0
1668538833487,ECE 200,052,103637,Zeger; Kenneth A.,999,0,999,0
1668538833487,ECE 200,053,103638,Zhang; Xinyu,9999,0,9999,0
1668538833487,ECE 200,054,103639,Turakhia; Yatish Girish,9999,0,9999,0
1668538833487,ECE 200,055,103640,Kang; Mingu,9999,0,9999,0
1668538833487,ECE 200,056,103641,Shi; Yuanyuan,9999,0,9999,0
1668538833487,ECE 200,057,103642,Wang; Edward Jay,9999,0,9999,0
1668538833487,ECE 200,058,103643,Zheng; Yang,9999,0,9999,0
1668538833911,ECE 202,A00,103644,Kuzum; Duygu,0,44,0,0
1668538834339,ECE 212BN,A00,103646,Ng; Tse Nga,0,9,0,0
1668538834764,ECE 221,A00,111493,Staff,0,0,0,0
1668538835188,ECE 222B,A00,103647,Lomakin; Vitaliy,0,20,0,0
1668538835623,ECE 230B,A00,103648,Taur; Yuan,0,3,0,0
1668538836050,ECE 238B,A00,103649,Garay; Javier,0,0,0,0
1668538836479,ECE 240B,A00,112900,Fainman; Yeshaiahu,0,7,0,0
1668538836903,ECE 247A,A00,103650,Jokerst; Jesse Vincent,0,6,0,0
1668538837335,ECE 247B,A00,103651,Wang; Joseph,0,14,0,0
1668538837762,ECE 250,A00,103652,Siegel; Paul H.,0,82,0,0
1668538838186,ECE 251A,A00,103654,Rao; Bhaskar D.,0,62,0,0
1668538838625,ECE 257B,A00,103655,Bharadia; Dinesh,0,33,0,0
1668538839068,ECE 258A,A00,103656,Milstein; Laurence B.,0,29,0,0
1668538839491,ECE 260B,A00,103658,Kang; Mingu,0,121,0,0
1668538839917,ECE 264A,A00,103659,Galton; Ian A,0,69,0,0
1668538840343,ECE 265A,A00,103661,Gudem; Prasad S.S.,0,73,0,0
1668538840772,ECE 265D,A00,103662,Gudem; Prasad S.S.,0,26,0,0
1668538841196,ECE 268,A00,103663,Koushanfar; Farinaz,0,43,0,0
1668538841632,ECE 269,A01,103665,Pal; Piya,0,217,0,0
1668538842071,ECE 271B,A00,103666,Vasconcelos; Manuela,0,77,0,0
1668538842503,ECE 276A,A00,103667,Atanasov; Nikolay A.,0,127,0,0
1668538842926,ECE 277,A00,103668,An; Cheolhong,0,150,0,0
1668538843354,ECE 279,A00,117947,Hall; Drew A.,0,22,0,0
1668538844220,ECE 283,A00,103670,Hsueh; Tzu-Chien,0,56,0,0
1668538844649,ECE 284,A00,103671,Turakhia; Yatish Girish,0,39,0,0
1668538845078,ECE 285,A00,103672,Zheng; Yang,0,40,0,0
1668538845078,ECE 285,B00,103673,Sworder; David D.,0,59,0,0
1668538845503,ECE 287,A00,103676,Javidi; Tara,0,9,0,0
1668538845926,MATH 200B,A00,098023,Salehi Golsefidy; Alireza,10,0,15,5
1668538846350,MATH 202B,A00,098024,Rhoades; Brendon Patrick,7,0,15,8
1668538846774,MATH 203B,A00,098025,Oprea; Dragos N.,9,0,15,6
1668538847198,MATH 204B,A00,098026,Sorensen; Claus M,13,0,15,2
1668538847638,MATH 208,A00,098027,Izadi; Elham,7,0,10,3
1668538848065,MATH 209,A00,098028,Pollack; Aaron,10,0,10,0
1668538848492,MATH 211A,A00,112919,Rogalski; Daniel,8,0,10,2
1668538848916,MATH 211B,A00,112920,Seward; Brandon M.,9,0,10,1
1668538849339,MATH 218,A00,098029,Li; Bo,10,0,10,0
1668538849791,MATH 220B,A00,098030,Novak; Jonathan I,11,0,15,4
1668538850232,MATH 221A,A00,098031,Ebenfelt; Peter F,12,0,15,3
1668538850659,MATH 231B,A00,098032,Zlatos; Andrej,11,0,15,4
1668538851095,MATH 240B,A00,098033,Ni; Lei,7,0,15,8
1668538851525,MATH 243,A00,098034,Jekel; David Andrew,10,0,10,0
1668538851953,MATH 245A,A00,098035,Nie; Jiawang,0,5,15,18
1668538852388,MATH 248,A00,098036,Bejenaru; Ioan,10,0,10,0
1668538852811,MATH 250B,A00,098037,Spolaor; Luca,14,0,15,1
1668538853237,MATH 258,A00,098038,Ni; Lei,9,0,10,1
1668538853660,MATH 264B,A00,098041,Rhoades; Brendon Patrick,8,0,15,7
1668538854088,MATH 268,A00,098042,Buss; Samuel R,10,0,10,0
1668538854515,MATH 269,A00,098043,Rhoades; Brendon Patrick,10,0,10,0
1668538854938,MATH 270B,A00,098044,Li; Bo,6,0,15,9
1668538855363,MATH 272B,A00,098045,Holst; Michael J,13,0,15,2
1668538855788,MATH 273A,A00,098046,Tian; Xiaochuan,10,0,15,5
1668538856221,MATH 275,A01,098048,Tian; Xiaochuan,6,0,10,4
1668538856658,MATH 278A,A00,098049,Holst; Michael J,7,0,10,3
1668538857083,MATH 278B,A00,098050,Cloninger; Alexander,10,0,10,0
1668538857508,MATH 278C,A00,098051,Nie; Jiawang,5,0,10,5
1668538857934,MATH 280B,A00,098052,Zheng; Tianyi,7,0,15,8
1668538858369,MATH 281B,A00,098053,Bradic; Jelena,0,2,15,15
1668538858794,MATH 282B,A00,098054,Arias-Castro; Ery,0,1,15,15
1668538859229,MATH 285,A00,098055,Fitzsimmons; Patrick J,0,4,15,17
1668538859652,MATH 287B,A00,098056,Arias-Castro; Ery,1,0,15,14
1668538860085,MATH 288,A00,098057,Agarwal; Pooja,9,0,10,1
1668538860085,MATH 288,B00,098058,Zhang; Danna,8,0,10,2
1668538860085,MATH 288,C00,098059,Williams; Ruth J,9,0,10,1
1668538860533,MATH 290B,A00,098060,Roberts; Justin Deritter,12,0,15,3
1668538860959,MATH 292,A00,098061,Belmont; Eva Kinoshita,10,0,10,0
1668538861381,MATH 295,A00,098062,Suk; Andrew Hoon,47,0,50,3
1668538861875,MATH 296,A00,098063,Novak; Jonathan I,20,0,20,0
1668538862298,MATH 297,001,098064,Gamst; Anthony Collins,9997,0,9999,2
1668539367732,COGS 205,A00,101395,Chiba; Andrea,19,0,20,1
1668539368164,COGS 210B,001,101404,Greene; Deanna Jacquelyn,9998,0,9999,1
1668539368164,COGS 210B,002,101417,Xia; Haijun,9999,0,9999,0
1668539368164,COGS 210B,003,101422,Nitz; Douglas A.,9999,0,9999,0
1668539368164,COGS 210B,004,101423,Hollan; James D.,9998,0,9999,1
1668539368164,COGS 210B,005,101424,Deak; Gedeon O.,9998,0,9999,1
1668539368164,COGS 210B,006,101425,Rossano; Federico,9999,0,9999,0
1668539368598,COGS 211B,A00,101427,Coulson; Seana M,9996,0,9999,3
1668539369032,COGS 220,A00,101428,Hollan; James D.,0,12,25,25
1668539369468,COGS 229,A00,101429,Dow; Steven P,17,0,25,8
1668539369895,COGS 230,A00,101430,Klemmer; Scott R,7,0,17,10
1668539370330,COGS 234,A00,101431,Xia; Haijun,0,0,25,25
1668539370765,COGS 260,A00,101432,Kiyonaga; Anastasia,21,0,25,4
1668539370765,COGS 260,B00,101433,Kirsh; David Joel,15,0,25,10
1668539371196,CSE 202,A00,102371,Impagliazzo; Russell,0,67,0,0
1668539371623,CSE 203B,A01,102373,Cheng; Chung Kuan,0,61,0,0
1668539372063,CSE 208,A00,102374,Micciancio; Daniele,0,5,0,0
1668539372488,CSE 209A,A00,112895,Impagliazzo; Russell,0,13,15,15
1668539372919,CSE 209B,A00,108005,Bellare; Mihir,0,7,0,0
1668539373348,CSE 210,A00,113163,Coblenz; Michael J,0,88,0,0
1668539373772,CSE 219,A00,106111,Dow; Steven P,0,8,20,20
1668539374201,CSE 221,A00,102376,Voelker; Geoffrey M.,0,73,0,0
1668539374644,CSE 224,A01,102378,Porter; George M,0,170,0,0
1668539375066,CSE 229A,A00,102379,Savage; Stefan,0,11,0,0
1668539375493,CSE 229C,A00,102380,Munyaka; Imani N. S.,0,10,0,0
1668539375915,CSE 232B,A00,102382,Deutsch; Alin Bernard,0,36,0,0
1668539376342,CSE 234,A01,112904,Kumar; Arun Kumar,0,0,0,0
1668539376766,CSE 237A,A00,102383,Rosing; Tajana Simunic,0,56,0,0
1668539377196,CSE 239A,A00,102384,Deutsch; Alin Bernard,0,16,0,0
1668539377629,CSE 239B,A00,102385,Polikarpova; Nadezhda,0,11,0,0
1668539378053,CSE 240A,A00,102386,Pannuto; Patrick William,0,47,0,0
1668539378519,CSE 240B,A00,102387,Zhao; Jishen,0,48,0,0
1668539378941,CSE 241A,A00,106406,Kang; Mingu,0,9,0,0
1668539379368,CSE 249B,A00,102388,Kahng; Andrew Byun,0,5,8,8
1668539379803,CSE 251B,A01,102392,Cottrell; Garrison W,0,51,0,0
1668539379803,CSE 251B,A02,102393,Cottrell; Garrison W,0,35,0,0
1668539380227,CSE 252B,A00,102394,Ochoa; Benjamin Lawrence,0,60,0,0
1668539380662,CSE 257,A01,102396,Gao; Sicun,0,143,0,0
1668539381099,CSE 272,A00,102397,Li; Tzumao,0,19,0,0
1668539381534,CSE 274,A00,111323,Chern; Albert Ren-Haur,0,15,0,0
1668539381956,CSE 282,A00,102398,Pevzner; Pavel Arkadjevich,0,0,0,0
1668539382378,CSE 284,A00,114175,Gymrek; Melissa Ann,0,24,0,0
1668539382810,CSE 290,A00,102399,Chandraker; Manmohan Krishna,0,11,0,0
1668539382810,CSE 290,B00,102400,Vaccaro; Kristen Marie,0,7,25,25
1668539382810,CSE 290,C00,102414,Pannuto; Patrick William,0,1,25,25
1668539382810,CSE 290,D00,102427,Pevzner; Pavel Arkadjevich,0,0,0,0
1668539382810,CSE 290,E00,102429,Zhao; Jishen,0,5,0,0
1668539382810,CSE 290,F00,102436,Tullsen; Dean Michael,0,6,0,0
1668539382810,CSE 290,G00,102440,Christensen; Henrik I,0,6,20,20
1668539383234,CSE 291,A00,102443,Su; Hao,0,0,0,0
1668539383234,CSE 291,B00,102448,Polikarpova; Nadezhda,0,0,0,0
1668539383234,CSE 291,C00,102453,Vaccaro; Kristen Marie,0,0,0,0
1668539383234,CSE 291,D00,111343,Savage; Stefan,0,0,0,0
1668539383234,CSE 291,E00,116474,Claffy; Kimberly Claire,0,0,0,0
1668539383234,CSE 291,F00,116479,Pasquale; Joseph,0,0,0,0
1668539383688,CSE 293,001,119111,Bafna; Vineet,9999,0,9999,0
1668539383688,CSE 293,002,119118,Bellare; Mihir,9999,0,9999,0
1668539383688,CSE 293,003,119122,Berg-Kirkpatrick; Taylor D,9999,0,9999,0
1668539383688,CSE 293,004,119135,Christensen; Henrik I,9999,0,9999,0
1668539383688,CSE 293,005,119142,Cottrell; Garrison W,9999,0,9999,0
1668539383688,CSE 293,006,119146,Deutsch; Alin Bernard,9999,0,9999,0
1668539383688,CSE 293,007,119159,Esmaeilzadeh; Hadi,9999,0,9999,0
1668539383688,CSE 293,008,119166,Freund; Yoav,9999,0,9999,0
1668539383688,CSE 293,009,119170,Griswold; William G.,9999,0,9999,0
1668539383688,CSE 293,010,119183,Gymrek; Melissa Ann,9999,0,9999,0
1668539383688,CSE 293,011,119190,Heninger; Nadia A,9999,0,9999,0
1668539383688,CSE 293,012,119230,Impagliazzo; Russell,9999,0,9999,0
1668539383688,CSE 293,013,119232,Jhala; Ranjit,9999,0,9999,0
1668539383688,CSE 293,014,119233,Kahng; Andrew Byun,9999,0,9999,0
1668539383688,CSE 293,015,119298,Kane; Daniel Mertz,9999,0,9999,0
1668539383688,CSE 293,016,119299,Kriegman; David J,9999,0,9999,0
1668539383688,CSE 293,017,119300,Kumar; Arun Kumar,9999,0,9999,0
1668539383688,CSE 293,018,119301,Lerner; Sorin,9999,0,9999,0
1668539383688,CSE 293,019,119302,Lovett; Shachar,9999,0,9999,0
1668539383688,CSE 293,020,119303,McAuley; Julian John,9999,0,9999,0
1668539383688,CSE 293,021,119304,Micciancio; Daniele,9999,0,9999,0
1668539383688,CSE 293,022,119367,Orailoglu; Alex,9999,0,9999,0
1668539383688,CSE 293,023,119382,Paturi; Ramamohan,9999,0,9999,0
1668539383688,CSE 293,024,119404,Polikarpova; Nadezhda,9999,0,9999,0
1668539383688,CSE 293,025,119406,Politz; Joseph Gibbs,9999,0,9999,0
1668539383688,CSE 293,026,119411,Porter; George M,9999,0,9999,0
1668539383688,CSE 293,027,119414,Porter; Leonard Emerson,9999,0,9999,0
1668539383688,CSE 293,028,119416,Ramamoorthi; Ravi,9999,0,9999,0
1668539383688,CSE 293,029,119417,Sahoo; Debashis,9999,0,9999,0
1668539383688,CSE 293,030,119420,Saul; Lawrence,9999,0,9999,0
1668539383688,CSE 293,031,119421,Savage; Stefan,9999,0,9999,0
1668539383688,CSE 293,032,119425,Schulze; Jurgen P.,9999,0,9999,0
1668539383688,CSE 293,033,119426,Snoeren; Alex C.,9999,0,9999,0
1668539383688,CSE 293,034,119428,Shang; Jingbo,9999,0,9999,0
1668539383688,CSE 293,035,119430,Stefan; Deian,9999,0,9999,0
1668539383688,CSE 293,036,119431,Su; Hao,9999,0,9999,0
1668539383688,CSE 293,037,119433,Swanson; Steven James,9999,0,9999,0
1668539383688,CSE 293,038,119435,Tullsen; Dean Michael,9999,0,9999,0
1668539383688,CSE 293,039,119483,Voelker; Geoffrey M.,9999,0,9999,0
1668539383688,CSE 293,040,119537,Zhao; Jishen,9999,0,9999,0
1668539383688,CSE 293,041,119538,Zhou; Yuan-Yuan,9999,0,9999,0
1668539383688,CSE 293,042,119539,Gao; Sicun,9999,0,9999,0
1668539383688,CSE 293,043,119540,Weibel; Nadir,9999,0,9999,0
1668539383688,CSE 293,044,119541,Gupta; Rajesh K.,9999,0,9999,0
1668539383688,CSE 293,045,126410,Vaccaro; Kristen Marie,9999,0,9999,0
1668539383688,CSE 293,046,126411,Klemke; Richard,9999,0,9999,0
1668539384111,CSE 294,A00,102459,Voelker; Geoffrey M.,0,2,0,0
1668539384111,CSE 294,B00,111322,Orailoglu; Alex,0,2,0,0
1668539384536,DSE 201,A00,096914,Deutsch; Alin Bernard,30,0,30,0
1668539384962,DSE 210,A00,096915,Dasgupta; Sanjoy,30,0,30,0
1668539385386,DSE 260A,A00,096916,Altintas De Callaf; Ilkay,30,0,30,0
1668539385818,ECE 200,001,103586,Antipa; Nicholas A,9999,0,9999,0
1668539385818,ECE 200,002,103587,Atanasov; Nikolay A.,9999,0,9999,0
1668539385818,ECE 200,003,103588,Bharadia; Dinesh,9999,0,9999,0
1668539385818,ECE 200,004,103589,Cheng; Chung Kuan,9999,0,9999,0
1668539385818,ECE 200,005,103590,Cosman; Pamela C.,9999,0,9999,0
1668539385818,ECE 200,006,103591,Dayeh; Shadi Ahmad,9999,0,9999,0
1668539385818,ECE 200,007,103592,Fainman; Yeshaiahu,9999,0,9999,0
1668539385818,ECE 200,008,103593,Ford; Joseph Earl,9999,0,9999,0
1668539385818,ECE 200,009,103594,Franceschetti; Massimo,9999,0,9999,0
1668539385818,ECE 200,010,103595,Fullerton; Eric E,9999,0,9999,0
1668539385818,ECE 200,011,103596,Galton; Ian A,9999,0,9999,0
1668539385818,ECE 200,012,103597,Gilja; Vikash,9999,0,9999,0
1668539385818,ECE 200,013,103598,Hall; Drew A.,9999,0,9999,0
1668539385818,ECE 200,014,103599,Hsueh; Tzu-Chien,9999,0,9999,0
1668539385818,ECE 200,015,103600,Javidi; Tara,9999,0,9999,0
1668539385818,ECE 200,016,103601,Kahng; Andrew Byun,9999,0,9999,0
1668539385818,ECE 200,017,103602,Kim; Young-Han,9999,0,9999,0
1668539385818,ECE 200,018,103603,Koushanfar; Farinaz,9999,0,9999,0
1668539385818,ECE 200,019,103604,Kuzum; Duygu,9999,0,9999,0
1668539385818,ECE 200,020,103605,Le; Hanh-Phuc,9999,0,9999,0
1668539385818,ECE 200,021,103606,Lin; Bill,9999,0,9999,0
1668539385818,ECE 200,022,103607,Liu; Zhaowei,9998,0,9999,1
1668539385818,ECE 200,023,103608,Lo; Yu-Hwa,9999,0,9999,0
1668539385818,ECE 200,024,103609,Lomakin; Vitaliy,9999,0,9999,0
1668539385818,ECE 200,025,103610,Mercier; Patrick Philip,9999,0,9999,0
1668539385818,ECE 200,026,103611,Meyer; Florian,9999,0,9999,0
1668539385818,ECE 200,027,103612,Milstein; Laurence B.,9999,0,9999,0
1668539385818,ECE 200,028,103613,Mir Arabbaygi; Siavash,9999,0,9999,0
1668539385818,ECE 200,029,103614,Mookherjea; Shayan,9999,0,9999,0
1668539385818,ECE 200,030,103615,Morris; Karcher William,9999,0,9999,0
1668539385818,ECE 200,031,103616,Ng; Tse Nga,9999,0,9999,0
1668539385818,ECE 200,032,103617,Nguyen; Truong Quang,9999,0,9999,0
1668539385818,ECE 200,033,103618,Nomura; Kenji,9999,0,9999,0
1668539385818,ECE 200,034,103619,Orlitsky; Alon,9999,0,9999,0
1668539385818,ECE 200,035,103620,Pal; Piya,9999,0,9999,0
1668539385818,ECE 200,036,103621,Papen; George C.,9999,0,9999,0
1668539385818,ECE 200,037,103622,Radic; Stojan,9999,0,9999,0
1668539385818,ECE 200,038,103623,Rao; Bhaskar D.,9999,0,9999,0
1668539385818,ECE 200,039,103624,Rao; Ramesh R,9999,0,9999,0
1668539385818,ECE 200,040,103625,Rebeiz; Gabriel,9999,0,9999,0
1668539385818,ECE 200,041,103626,Sanford; John R,9999,0,9999,0
1668539385818,ECE 200,042,103627,Siegel; Paul H.,9999,0,9999,0
1668539385818,ECE 200,043,103628,Sievenpiper; Daniel F.,9999,0,9999,0
1668539385818,ECE 200,044,103629,Sworder; David D.,9999,0,9999,0
1668539385818,ECE 200,045,103630,Taur; Yuan,9999,0,9999,0
1668539385818,ECE 200,046,103631,Touri; Behrouz,9999,0,9999,0
1668539385818,ECE 200,047,103632,Trivedi; Mohan M.,9999,0,9999,0
1668539385818,ECE 200,048,103633,Vasconcelos; Nuno,9999,0,9999,0
1668539385818,ECE 200,049,103634,Wang; Xiaolong,9999,0,9999,0
1668539385818,ECE 200,050,103635,Xie; Pengtao,9999,0,9999,0
1668539385818,ECE 200,051,103636,Yip; Michael,9999,0,9999,0
1668539385818,ECE 200,052,103637,Zeger; Kenneth A.,999,0,999,0
1668539385818,ECE 200,053,103638,Zhang; Xinyu,9999,0,9999,0
1668539385818,ECE 200,054,103639,Turakhia; Yatish Girish,9999,0,9999,0
1668539385818,ECE 200,055,103640,Kang; Mingu,9999,0,9999,0
1668539385818,ECE 200,056,103641,Shi; Yuanyuan,9999,0,9999,0
1668539385818,ECE 200,057,103642,Wang; Edward Jay,9999,0,9999,0
1668539385818,ECE 200,058,103643,Zheng; Yang,9999,0,9999,0
1668539386248,ECE 202,A00,103644,Kuzum; Duygu,0,44,0,0
1668539386683,ECE 212BN,A00,103646,Ng; Tse Nga,0,9,0,0
1668539387119,ECE 221,A00,111493,Staff,0,0,0,0
1668539387545,ECE 222B,A00,103647,Lomakin; Vitaliy,0,20,0,0
1668539387968,ECE 230B,A00,103648,Taur; Yuan,0,3,0,0
1668539388392,ECE 238B,A00,103649,Garay; Javier,0,0,0,0
1668539388826,ECE 240B,A00,112900,Fainman; Yeshaiahu,0,7,0,0
1668539389253,ECE 247A,A00,103650,Jokerst; Jesse Vincent,0,6,0,0
1668539389678,ECE 247B,A00,103651,Wang; Joseph,0,14,0,0
1668539390102,ECE 250,A00,103652,Siegel; Paul H.,0,82,0,0
1668539390530,ECE 251A,A00,103654,Rao; Bhaskar D.,0,62,0,0
1668539390953,ECE 257B,A00,103655,Bharadia; Dinesh,0,33,0,0
1668539391389,ECE 258A,A00,103656,Milstein; Laurence B.,0,29,0,0
1668539391828,ECE 260B,A00,103658,Kang; Mingu,0,122,0,0
1668539392253,ECE 264A,A00,103659,Galton; Ian A,0,70,0,0
1668539392678,ECE 265A,A00,103661,Gudem; Prasad S.S.,0,73,0,0
1668539393105,ECE 265D,A00,103662,Gudem; Prasad S.S.,0,26,0,0
1668539393532,ECE 268,A00,103663,Koushanfar; Farinaz,0,43,0,0
1668539393955,ECE 269,A01,103665,Pal; Piya,0,217,0,0
1668539394379,ECE 271B,A00,103666,Vasconcelos; Manuela,0,77,0,0
1668539394805,ECE 276A,A00,103667,Atanasov; Nikolay A.,0,127,0,0
1668539395229,ECE 277,A00,103668,An; Cheolhong,0,150,0,0
1668539395669,ECE 279,A00,117947,Hall; Drew A.,0,22,0,0
1668539396520,ECE 283,A00,103670,Hsueh; Tzu-Chien,0,56,0,0
1668539396942,ECE 284,A00,103671,Turakhia; Yatish Girish,0,39,0,0
1668539397366,ECE 285,A00,103672,Zheng; Yang,0,40,0,0
1668539397366,ECE 285,B00,103673,Sworder; David D.,0,59,0,0
1668539397789,ECE 287,A00,103676,Javidi; Tara,0,9,0,0
1668539398213,MATH 200B,A00,098023,Salehi Golsefidy; Alireza,10,0,15,5
1668539398643,MATH 202B,A00,098024,Rhoades; Brendon Patrick,7,0,15,8
1668539399174,MATH 203B,A00,098025,Oprea; Dragos N.,9,0,15,6
1668539399597,MATH 204B,A00,098026,Sorensen; Claus M,13,0,15,2
1668539400019,MATH 208,A00,098027,Izadi; Elham,7,0,10,3
1668539400448,MATH 209,A00,098028,Pollack; Aaron,10,0,10,0
1668539400897,MATH 211A,A00,112919,Rogalski; Daniel,8,0,10,2
1668539401329,MATH 211B,A00,112920,Seward; Brandon M.,9,0,10,1
1668539401755,MATH 218,A00,098029,Li; Bo,10,0,10,0
1668539402182,MATH 220B,A00,098030,Novak; Jonathan I,11,0,15,4
1668539402618,MATH 221A,A00,098031,Ebenfelt; Peter F,12,0,15,3
1668539403046,MATH 231B,A00,098032,Zlatos; Andrej,11,0,15,4
1668539403475,MATH 240B,A00,098033,Ni; Lei,7,0,15,8
1668539403899,MATH 243,A00,098034,Jekel; David Andrew,10,0,10,0
1668539404341,MATH 245A,A00,098035,Nie; Jiawang,0,5,15,18
1668539404768,MATH 248,A00,098036,Bejenaru; Ioan,10,0,10,0
1668539405200,MATH 250B,A00,098037,Spolaor; Luca,14,0,15,1
1668539405634,MATH 258,A00,098038,Ni; Lei,9,0,10,1
1668539406058,MATH 264B,A00,098041,Rhoades; Brendon Patrick,8,0,15,7
1668539406483,MATH 268,A00,098042,Buss; Samuel R,10,0,10,0
1668539406917,MATH 269,A00,098043,Rhoades; Brendon Patrick,10,0,10,0
1668539407341,MATH 270B,A00,098044,Li; Bo,6,0,15,9
1668539407763,MATH 272B,A00,098045,Holst; Michael J,13,0,15,2
1668539408198,MATH 273A,A00,098046,Tian; Xiaochuan,10,0,15,5
1668539408628,MATH 275,A01,098048,Tian; Xiaochuan,6,0,10,4
1668539409062,MATH 278A,A00,098049,Holst; Michael J,7,0,10,3
1668539409492,MATH 278B,A00,098050,Cloninger; Alexander,10,0,10,0
1668539409923,MATH 278C,A00,098051,Nie; Jiawang,5,0,10,5
1668539410356,MATH 280B,A00,098052,Zheng; Tianyi,7,0,15,8
1668539410787,MATH 281B,A00,098053,Bradic; Jelena,0,2,15,15
1668539411211,MATH 282B,A00,098054,Arias-Castro; Ery,0,1,15,15
1668539411638,MATH 285,A00,098055,Fitzsimmons; Patrick J,0,4,15,17
1668539412070,MATH 287B,A00,098056,Arias-Castro; Ery,1,0,15,14
1668539412505,MATH 288,A00,098057,Agarwal; Pooja,9,0,10,1
1668539412505,MATH 288,B00,098058,Zhang; Danna,8,0,10,2
1668539412505,MATH 288,C00,098059,Williams; Ruth J,9,0,10,1
1668539412932,MATH 290B,A00,098060,Roberts; Justin Deritter,12,0,15,3
1668539413370,MATH 292,A00,098061,Belmont; Eva Kinoshita,10,0,10,0
1668539413819,MATH 295,A00,098062,Suk; Andrew Hoon,47,0,50,3
1668539414244,MATH 296,A00,098063,Novak; Jonathan I,20,0,20,0
1668539414666,MATH 297,001,098064,Gamst; Anthony Collins,9997,0,9999,2
1668539919384,COGS 205,A00,101395,Chiba; Andrea,19,0,20,1
1668539919812,COGS 210B,001,101404,Greene; Deanna Jacquelyn,9998,0,9999,1
1668539919812,COGS 210B,002,101417,Xia; Haijun,9999,0,9999,0
1668539919812,COGS 210B,003,101422,Nitz; Douglas A.,9999,0,9999,0
1668539919812,COGS 210B,004,101423,Hollan; James D.,9998,0,9999,1
1668539919812,COGS 210B,005,101424,Deak; Gedeon O.,9998,0,9999,1
1668539919812,COGS 210B,006,101425,Rossano; Federico,9999,0,9999,0
1668539920243,COGS 211B,A00,101427,Coulson; Seana M,9996,0,9999,3
1668539920680,COGS 220,A00,101428,Hollan; James D.,0,12,25,25
1668539921103,COGS 229,A00,101429,Dow; Steven P,17,0,25,8
1668539921528,COGS 230,A00,101430,Klemmer; Scott R,7,0,17,10
1668539921957,COGS 234,A00,101431,Xia; Haijun,0,0,25,25
1668539922477,COGS 260,A00,101432,Kiyonaga; Anastasia,21,0,25,4
1668539922477,COGS 260,B00,101433,Kirsh; David Joel,15,0,25,10
1668539922901,CSE 202,A00,102371,Impagliazzo; Russell,0,67,0,0
1668539923333,CSE 203B,A01,102373,Cheng; Chung Kuan,0,61,0,0
1668539923760,CSE 208,A00,102374,Micciancio; Daniele,0,5,0,0
1668539924195,CSE 209A,A00,112895,Impagliazzo; Russell,0,13,15,15
1668539924621,CSE 209B,A00,108005,Bellare; Mihir,0,7,0,0
1668539925052,CSE 210,A00,113163,Coblenz; Michael J,0,88,0,0
1668539925479,CSE 219,A00,106111,Dow; Steven P,0,8,20,20
1668539925904,CSE 221,A00,102376,Voelker; Geoffrey M.,0,74,0,0
1668539926327,CSE 224,A01,102378,Porter; George M,0,170,0,0
1668539926768,CSE 229A,A00,102379,Savage; Stefan,0,11,0,0
1668539927190,CSE 229C,A00,102380,Munyaka; Imani N. S.,0,10,0,0
1668539927623,CSE 232B,A00,102382,Deutsch; Alin Bernard,0,36,0,0
1668539928051,CSE 234,A01,112904,Kumar; Arun Kumar,0,0,0,0
1668539928477,CSE 237A,A00,102383,Rosing; Tajana Simunic,0,56,0,0
1668539928904,CSE 239A,A00,102384,Deutsch; Alin Bernard,0,16,0,0
1668539929331,CSE 239B,A00,102385,Polikarpova; Nadezhda,0,11,0,0
1668539929762,CSE 240A,A00,102386,Pannuto; Patrick William,0,47,0,0
1668539930186,CSE 240B,A00,102387,Zhao; Jishen,0,48,0,0
1668539930620,CSE 241A,A00,106406,Kang; Mingu,0,9,0,0
1668539931052,CSE 249B,A00,102388,Kahng; Andrew Byun,0,5,8,8
1668539931488,CSE 251B,A01,102392,Cottrell; Garrison W,0,51,0,0
1668539931488,CSE 251B,A02,102393,Cottrell; Garrison W,0,35,0,0
1668539931919,CSE 252B,A00,102394,Ochoa; Benjamin Lawrence,0,60,0,0
1668539932351,CSE 257,A01,102396,Gao; Sicun,0,143,0,0
1668539932777,CSE 272,A00,102397,Li; Tzumao,0,19,0,0
1668539933201,CSE 274,A00,111323,Chern; Albert Ren-Haur,0,15,0,0
1668539933627,CSE 282,A00,102398,Pevzner; Pavel Arkadjevich,0,0,0,0
1668539934058,CSE 284,A00,114175,Gymrek; Melissa Ann,0,24,0,0
1668539934494,CSE 290,A00,102399,Chandraker; Manmohan Krishna,0,11,0,0
1668539934494,CSE 290,B00,102400,Vaccaro; Kristen Marie,0,7,25,25
1668539934494,CSE 290,C00,102414,Pannuto; Patrick William,0,1,25,25
1668539934494,CSE 290,D00,102427,Pevzner; Pavel Arkadjevich,0,0,0,0
1668539934494,CSE 290,E00,102429,Zhao; Jishen,0,5,0,0
1668539934494,CSE 290,F00,102436,Tullsen; Dean Michael,0,6,0,0
1668539934494,CSE 290,G00,102440,Christensen; Henrik I,0,6,20,20
1668539934931,CSE 291,A00,102443,Su; Hao,0,0,0,0
1668539934931,CSE 291,B00,102448,Polikarpova; Nadezhda,0,0,0,0
1668539934931,CSE 291,C00,102453,Vaccaro; Kristen Marie,0,0,0,0
1668539934931,CSE 291,D00,111343,Savage; Stefan,0,0,0,0
1668539934931,CSE 291,E00,116474,Claffy; Kimberly Claire,0,0,0,0
1668539934931,CSE 291,F00,116479,Pasquale; Joseph,0,0,0,0
1668539935371,CSE 293,001,119111,Bafna; Vineet,9999,0,9999,0
1668539935371,CSE 293,002,119118,Bellare; Mihir,9999,0,9999,0
1668539935371,CSE 293,003,119122,Berg-Kirkpatrick; Taylor D,9999,0,9999,0
1668539935371,CSE 293,004,119135,Christensen; Henrik I,9999,0,9999,0
1668539935371,CSE 293,005,119142,Cottrell; Garrison W,9999,0,9999,0
1668539935371,CSE 293,006,119146,Deutsch; Alin Bernard,9999,0,9999,0
1668539935371,CSE 293,007,119159,Esmaeilzadeh; Hadi,9999,0,9999,0
1668539935371,CSE 293,008,119166,Freund; Yoav,9999,0,9999,0
1668539935371,CSE 293,009,119170,Griswold; William G.,9999,0,9999,0
1668539935371,CSE 293,010,119183,Gymrek; Melissa Ann,9999,0,9999,0
1668539935371,CSE 293,011,119190,Heninger; Nadia A,9999,0,9999,0
1668539935371,CSE 293,012,119230,Impagliazzo; Russell,9999,0,9999,0
1668539935371,CSE 293,013,119232,Jhala; Ranjit,9999,0,9999,0
1668539935371,CSE 293,014,119233,Kahng; Andrew Byun,9999,0,9999,0
1668539935371,CSE 293,015,119298,Kane; Daniel Mertz,9999,0,9999,0
1668539935371,CSE 293,016,119299,Kriegman; David J,9999,0,9999,0
1668539935371,CSE 293,017,119300,Kumar; Arun Kumar,9999,0,9999,0
1668539935371,CSE 293,018,119301,Lerner; Sorin,9999,0,9999,0
1668539935371,CSE 293,019,119302,Lovett; Shachar,9999,0,9999,0
1668539935371,CSE 293,020,119303,McAuley; Julian John,9999,0,9999,0
1668539935371,CSE 293,021,119304,Micciancio; Daniele,9999,0,9999,0
1668539935371,CSE 293,022,119367,Orailoglu; Alex,9999,0,9999,0
1668539935371,CSE 293,023,119382,Paturi; Ramamohan,9999,0,9999,0
1668539935371,CSE 293,024,119404,Polikarpova; Nadezhda,9999,0,9999,0
1668539935371,CSE 293,025,119406,Politz; Joseph Gibbs,9999,0,9999,0
1668539935371,CSE 293,026,119411,Porter; George M,9999,0,9999,0
1668539935371,CSE 293,027,119414,Porter; Leonard Emerson,9999,0,9999,0
1668539935371,CSE 293,028,119416,Ramamoorthi; Ravi,9999,0,9999,0
1668539935371,CSE 293,029,119417,Sahoo; Debashis,9999,0,9999,0
1668539935371,CSE 293,030,119420,Saul; Lawrence,9999,0,9999,0
1668539935371,CSE 293,031,119421,Savage; Stefan,9999,0,9999,0
1668539935371,CSE 293,032,119425,Schulze; Jurgen P.,9999,0,9999,0
1668539935371,CSE 293,033,119426,Snoeren; Alex C.,9999,0,9999,0
1668539935371,CSE 293,034,119428,Shang; Jingbo,9999,0,9999,0
1668539935371,CSE 293,035,119430,Stefan; Deian,9999,0,9999,0
1668539935371,CSE 293,036,119431,Su; Hao,9999,0,9999,0
1668539935371,CSE 293,037,119433,Swanson; Steven James,9999,0,9999,0
1668539935371,CSE 293,038,119435,Tullsen; Dean Michael,9999,0,9999,0
1668539935371,CSE 293,039,119483,Voelker; Geoffrey M.,9999,0,9999,0
1668539935371,CSE 293,040,119537,Zhao; Jishen,9999,0,9999,0
1668539935371,CSE 293,041,119538,Zhou; Yuan-Yuan,9999,0,9999,0
1668539935371,CSE 293,042,119539,Gao; Sicun,9999,0,9999,0
1668539935371,CSE 293,043,119540,Weibel; Nadir,9999,0,9999,0
1668539935371,CSE 293,044,119541,Gupta; Rajesh K.,9999,0,9999,0
1668539935371,CSE 293,045,126410,Vaccaro; Kristen Marie,9999,0,9999,0
1668539935371,CSE 293,046,126411,Klemke; Richard,9999,0,9999,0
1668539935793,CSE 294,A00,102459,Voelker; Geoffrey M.,0,2,0,0
1668539935793,CSE 294,B00,111322,Orailoglu; Alex,0,2,0,0
1668539936215,DSE 201,A00,096914,Deutsch; Alin Bernard,30,0,30,0
1668539936642,DSE 210,A00,096915,Dasgupta; Sanjoy,30,0,30,0
1668539937068,DSE 260A,A00,096916,Altintas De Callaf; Ilkay,30,0,30,0
1668539937511,ECE 200,001,103586,Antipa; Nicholas A,9999,0,9999,0
1668539937511,ECE 200,002,103587,Atanasov; Nikolay A.,9999,0,9999,0
1668539937511,ECE 200,003,103588,Bharadia; Dinesh,9999,0,9999,0
1668539937511,ECE 200,004,103589,Cheng; Chung Kuan,9999,0,9999,0
1668539937511,ECE 200,005,103590,Cosman; Pamela C.,9999,0,9999,0
1668539937511,ECE 200,006,103591,Dayeh; Shadi Ahmad,9999,0,9999,0
1668539937511,ECE 200,007,103592,Fainman; Yeshaiahu,9999,0,9999,0
1668539937511,ECE 200,008,103593,Ford; Joseph Earl,9999,0,9999,0
1668539937511,ECE 200,009,103594,Franceschetti; Massimo,9999,0,9999,0
1668539937511,ECE 200,010,103595,Fullerton; Eric E,9999,0,9999,0
1668539937511,ECE 200,011,103596,Galton; Ian A,9999,0,9999,0
1668539937511,ECE 200,012,103597,Gilja; Vikash,9999,0,9999,0
1668539937511,ECE 200,013,103598,Hall; Drew A.,9999,0,9999,0
1668539937511,ECE 200,014,103599,Hsueh; Tzu-Chien,9999,0,9999,0
1668539937511,ECE 200,015,103600,Javidi; Tara,9999,0,9999,0
1668539937511,ECE 200,016,103601,Kahng; Andrew Byun,9999,0,9999,0
1668539937511,ECE 200,017,103602,Kim; Young-Han,9999,0,9999,0
1668539937511,ECE 200,018,103603,Koushanfar; Farinaz,9999,0,9999,0
1668539937511,ECE 200,019,103604,Kuzum; Duygu,9999,0,9999,0
1668539937511,ECE 200,020,103605,Le; Hanh-Phuc,9999,0,9999,0
1668539937511,ECE 200,021,103606,Lin; Bill,9999,0,9999,0
1668539937511,ECE 200,022,103607,Liu; Zhaowei,9998,0,9999,1
1668539937511,ECE 200,023,103608,Lo; Yu-Hwa,9999,0,9999,0
1668539937511,ECE 200,024,103609,Lomakin; Vitaliy,9999,0,9999,0
1668539937511,ECE 200,025,103610,Mercier; Patrick Philip,9999,0,9999,0
1668539937511,ECE 200,026,103611,Meyer; Florian,9999,0,9999,0
1668539937511,ECE 200,027,103612,Milstein; Laurence B.,9999,0,9999,0
1668539937511,ECE 200,028,103613,Mir Arabbaygi; Siavash,9999,0,9999,0
1668539937511,ECE 200,029,103614,Mookherjea; Shayan,9999,0,9999,0
1668539937511,ECE 200,030,103615,Morris; Karcher William,9999,0,9999,0
1668539937511,ECE 200,031,103616,Ng; Tse Nga,9999,0,9999,0
1668539937511,ECE 200,032,103617,Nguyen; Truong Quang,9999,0,9999,0
1668539937511,ECE 200,033,103618,Nomura; Kenji,9999,0,9999,0
1668539937511,ECE 200,034,103619,Orlitsky; Alon,9999,0,9999,0
1668539937511,ECE 200,035,103620,Pal; Piya,9999,0,9999,0
1668539937511,ECE 200,036,103621,Papen; George C.,9999,0,9999,0
1668539937511,ECE 200,037,103622,Radic; Stojan,9999,0,9999,0
1668539937511,ECE 200,038,103623,Rao; Bhaskar D.,9999,0,9999,0
1668539937511,ECE 200,039,103624,Rao; Ramesh R,9999,0,9999,0
1668539937511,ECE 200,040,103625,Rebeiz; Gabriel,9999,0,9999,0
1668539937511,ECE 200,041,103626,Sanford; John R,9999,0,9999,0
1668539937511,ECE 200,042,103627,Siegel; Paul H.,9999,0,9999,0
1668539937511,ECE 200,043,103628,Sievenpiper; Daniel F.,9999,0,9999,0
1668539937511,ECE 200,044,103629,Sworder; David D.,9999,0,9999,0
1668539937511,ECE 200,045,103630,Taur; Yuan,9999,0,9999,0
1668539937511,ECE 200,046,103631,Touri; Behrouz,9999,0,9999,0
1668539937511,ECE 200,047,103632,Trivedi; Mohan M.,9999,0,9999,0
1668539937511,ECE 200,048,103633,Vasconcelos; Nuno,9999,0,9999,0
1668539937511,ECE 200,049,103634,Wang; Xiaolong,9999,0,9999,0
1668539937511,ECE 200,050,103635,Xie; Pengtao,9999,0,9999,0
1668539937511,ECE 200,051,103636,Yip; Michael,9999,0,9999,0
1668539937511,ECE 200,052,103637,Zeger; Kenneth A.,999,0,999,0
1668539937511,ECE 200,053,103638,Zhang; Xinyu,9999,0,9999,0
1668539937511,ECE 200,054,103639,Turakhia; Yatish Girish,9999,0,9999,0
1668539937511,ECE 200,055,103640,Kang; Mingu,9999,0,9999,0
1668539937511,ECE 200,056,103641,Shi; Yuanyuan,9999,0,9999,0
1668539937511,ECE 200,057,103642,Wang; Edward Jay,9999,0,9999,0
1668539937511,ECE 200,058,103643,Zheng; Yang,9999,0,9999,0
1668539937935,ECE 202,A00,103644,Kuzum; Duygu,0,45,0,0
1668539938359,ECE 212BN,A00,103646,Ng; Tse Nga,0,9,0,0
1668539938784,ECE 221,A00,111493,Staff,0,0,0,0
1668539939212,ECE 222B,A00,103647,Lomakin; Vitaliy,0,20,0,0
1668539939652,ECE 230B,A00,103648,Taur; Yuan,0,3,0,0
1668539940076,ECE 238B,A00,103649,Garay; Javier,0,0,0,0
1668539940507,ECE 240B,A00,112900,Fainman; Yeshaiahu,0,7,0,0
1668539940939,ECE 247A,A00,103650,Jokerst; Jesse Vincent,0,6,0,0
1668539941364,ECE 247B,A00,103651,Wang; Joseph,0,14,0,0
1668539941789,ECE 250,A00,103652,Siegel; Paul H.,0,82,0,0
1668539942214,ECE 251A,A00,103654,Rao; Bhaskar D.,0,62,0,0
1668539942647,ECE 257B,A00,103655,Bharadia; Dinesh,0,33,0,0
1668539943081,ECE 258A,A00,103656,Milstein; Laurence B.,0,29,0,0
1668539943505,ECE 260B,A00,103658,Kang; Mingu,0,123,0,0
1668539943927,ECE 264A,A00,103659,Galton; Ian A,0,70,0,0
1668539944350,ECE 265A,A00,103661,Gudem; Prasad S.S.,0,73,0,0
1668539944779,ECE 265D,A00,103662,Gudem; Prasad S.S.,0,26,0,0
1668539945221,ECE 268,A00,103663,Koushanfar; Farinaz,0,43,0,0
1668539945649,ECE 269,A01,103665,Pal; Piya,0,218,0,0
1668539946080,ECE 271B,A00,103666,Vasconcelos; Manuela,0,77,0,0
1668539946511,ECE 276A,A00,103667,Atanasov; Nikolay A.,0,127,0,0
1668539946947,ECE 277,A00,103668,An; Cheolhong,0,151,0,0
1668539947381,ECE 279,A00,117947,Hall; Drew A.,0,22,0,0
1668539948250,ECE 283,A00,103670,Hsueh; Tzu-Chien,0,56,0,0
1668539948675,ECE 284,A00,103671,Turakhia; Yatish Girish,0,40,0,0
1668539949107,ECE 285,A00,103672,Zheng; Yang,0,40,0,0
1668539949107,ECE 285,B00,103673,Sworder; David D.,0,59,0,0
1668539949538,ECE 287,A00,103676,Javidi; Tara,0,9,0,0
1668539949982,MATH 200B,A00,098023,Salehi Golsefidy; Alireza,10,0,15,5
1668539950404,MATH 202B,A00,098024,Rhoades; Brendon Patrick,7,0,15,8
1668539950841,MATH 203B,A00,098025,Oprea; Dragos N.,9,0,15,6
1668539951274,MATH 204B,A00,098026,Sorensen; Claus M,13,0,15,2
1668539951714,MATH 208,A00,098027,Izadi; Elham,7,0,10,3
1668539952138,MATH 209,A00,098028,Pollack; Aaron,10,0,10,0
1668539952590,MATH 211A,A00,112919,Rogalski; Daniel,8,0,10,2
1668539953034,MATH 211B,A00,112920,Seward; Brandon M.,9,0,10,1
1668539953478,MATH 218,A00,098029,Li; Bo,10,0,10,0
1668539953902,MATH 220B,A00,098030,Novak; Jonathan I,11,0,15,4
1668539954329,MATH 221A,A00,098031,Ebenfelt; Peter F,12,0,15,3
1668539954760,MATH 231B,A00,098032,Zlatos; Andrej,11,0,15,4
1668539955196,MATH 240B,A00,098033,Ni; Lei,7,0,15,8
1668539955618,MATH 243,A00,098034,Jekel; David Andrew,10,0,10,0
1668539956046,MATH 245A,A00,098035,Nie; Jiawang,0,5,15,18
1668539956469,MATH 248,A00,098036,Bejenaru; Ioan,10,0,10,0
1668539956894,MATH 250B,A00,098037,Spolaor; Luca,14,0,15,1
1668539957334,MATH 258,A00,098038,Ni; Lei,9,0,10,1
1668539957761,MATH 264B,A00,098041,Rhoades; Brendon Patrick,8,0,15,7
1668539958196,MATH 268,A00,098042,Buss; Samuel R,10,0,10,0
1668539958618,MATH 269,A00,098043,Rhoades; Brendon Patrick,10,0,10,0
1668539959042,MATH 270B,A00,098044,Li; Bo,6,0,15,9
1668539959465,MATH 272B,A00,098045,Holst; Michael J,13,0,15,2
1668539959890,MATH 273A,A00,098046,Tian; Xiaochuan,10,0,15,5
1668539960313,MATH 275,A01,098048,Tian; Xiaochuan,6,0,10,4
1668539960737,MATH 278A,A00,098049,Holst; Michael J,7,0,10,3
1668539961170,MATH 278B,A00,098050,Cloninger; Alexander,10,0,10,0
1668539961595,MATH 278C,A00,098051,Nie; Jiawang,5,0,10,5
1668539962028,MATH 280B,A00,098052,Zheng; Tianyi,7,0,15,8
1668539962454,MATH 281B,A00,098053,Bradic; Jelena,0,2,15,15
1668539962878,MATH 282B,A00,098054,Arias-Castro; Ery,0,1,15,15
1668539963305,MATH 285,A00,098055,Fitzsimmons; Patrick J,0,4,15,17
1668539963728,MATH 287B,A00,098056,Arias-Castro; Ery,1,0,15,14
1668539964151,MATH 288,A00,098057,Agarwal; Pooja,9,0,10,1
1668539964151,MATH 288,B00,098058,Zhang; Danna,8,0,10,2
1668539964151,MATH 288,C00,098059,Williams; Ruth J,9,0,10,1
1668539964582,MATH 290B,A00,098060,Roberts; Justin Deritter,12,0,15,3
1668539965007,MATH 292,A00,098061,Belmont; Eva Kinoshita,10,0,10,0
1668539965430,MATH 295,A00,098062,Suk; Andrew Hoon,47,0,50,3
1668539965997,MATH 296,A00,098063,Novak; Jonathan I,20,0,20,0
1668539966428,MATH 297,001,098064,Gamst; Anthony Collins,9997,0,9999,2
1668540485890,COGS 205,A00,101395,Chiba; Andrea,19,0,20,1
1668540486333,COGS 210B,001,101404,Greene; Deanna Jacquelyn,9998,0,9999,1
1668540486333,COGS 210B,002,101417,Xia; Haijun,9999,0,9999,0
1668540486333,COGS 210B,003,101422,Nitz; Douglas A.,9999,0,9999,0
1668540486333,COGS 210B,004,101423,Hollan; James D.,9998,0,9999,1
1668540486333,COGS 210B,005,101424,Deak; Gedeon O.,9998,0,9999,1
1668540486333,COGS 210B,006,101425,Rossano; Federico,9999,0,9999,0
1668540486758,COGS 211B,A00,101427,Coulson; Seana M,9996,0,9999,3
1668540487182,COGS 220,A00,101428,Hollan; James D.,0,13,25,25
1668540487612,COGS 229,A00,101429,Dow; Steven P,17,0,25,8
1668540488044,COGS 230,A00,101430,Klemmer; Scott R,7,0,17,10
1668540488475,COGS 234,A00,101431,Xia; Haijun,0,1,25,25
1668540488902,COGS 260,A00,101432,Kiyonaga; Anastasia,21,0,25,4
1668540488902,COGS 260,B00,101433,Kirsh; David Joel,15,0,25,10
1668540489332,CSE 202,A00,102371,Impagliazzo; Russell,0,67,0,0
1668540489761,CSE 203B,A01,102373,Cheng; Chung Kuan,0,62,0,0
1668540490183,CSE 208,A00,102374,Micciancio; Daniele,0,5,0,0
1668540490606,CSE 209A,A00,112895,Impagliazzo; Russell,0,13,15,15
1668540491032,CSE 209B,A00,108005,Bellare; Mihir,0,7,0,0
1668540491460,CSE 210,A00,113163,Coblenz; Michael J,0,88,0,0
1668540491883,CSE 219,A00,106111,Dow; Steven P,0,8,20,20
1668540492310,CSE 221,A00,102376,Voelker; Geoffrey M.,0,75,0,0
1668540492754,CSE 224,A01,102378,Porter; George M,0,172,0,0
1668540493178,CSE 229A,A00,102379,Savage; Stefan,0,11,0,0
1668540493607,CSE 229C,A00,102380,Munyaka; Imani N. S.,0,10,0,0
1668540494037,CSE 232B,A00,102382,Deutsch; Alin Bernard,0,36,0,0
1668540494466,CSE 234,A01,112904,Kumar; Arun Kumar,0,0,0,0
1668540494900,CSE 237A,A00,102383,Rosing; Tajana Simunic,0,56,0,0
1668540495334,CSE 239A,A00,102384,Deutsch; Alin Bernard,0,16,0,0
1668540495765,CSE 239B,A00,102385,Polikarpova; Nadezhda,0,11,0,0
1668540496189,CSE 240A,A00,102386,Pannuto; Patrick William,0,47,0,0
1668540496614,CSE 240B,A00,102387,Zhao; Jishen,0,48,0,0
1668540497037,CSE 241A,A00,106406,Kang; Mingu,0,9,0,0
1668540497475,CSE 249B,A00,102388,Kahng; Andrew Byun,0,5,8,8
1668540497914,CSE 251B,A01,102392,Cottrell; Garrison W,0,51,0,0
1668540497914,CSE 251B,A02,102393,Cottrell; Garrison W,0,35,0,0
1668540498338,CSE 252B,A00,102394,Ochoa; Benjamin Lawrence,0,60,0,0
1668540498776,CSE 257,A01,102396,Gao; Sicun,0,146,0,0
1668540499202,CSE 272,A00,102397,Li; Tzumao,0,19,0,0
1668540499634,CSE 274,A00,111323,Chern; Albert Ren-Haur,0,15,0,0
1668540500083,CSE 282,A00,102398,Pevzner; Pavel Arkadjevich,0,0,0,0
1668540500520,CSE 284,A00,114175,Gymrek; Melissa Ann,0,25,0,0
1668540500947,CSE 290,A00,102399,Chandraker; Manmohan Krishna,0,11,0,0
1668540500947,CSE 290,B00,102400,Vaccaro; Kristen Marie,0,7,25,25
1668540500947,CSE 290,C00,102414,Pannuto; Patrick William,0,1,25,25
1668540500947,CSE 290,D00,102427,Pevzner; Pavel Arkadjevich,0,0,0,0
1668540500947,CSE 290,E00,102429,Zhao; Jishen,0,6,0,0
1668540500947,CSE 290,F00,102436,Tullsen; Dean Michael,0,6,0,0
1668540500947,CSE 290,G00,102440,Christensen; Henrik I,0,6,20,20
1668540501370,CSE 291,A00,102443,Su; Hao,0,0,0,0
1668540501370,CSE 291,B00,102448,Polikarpova; Nadezhda,0,0,0,0
1668540501370,CSE 291,C00,102453,Vaccaro; Kristen Marie,0,0,0,0
1668540501370,CSE 291,D00,111343,Savage; Stefan,0,0,0,0
1668540501370,CSE 291,E00,116474,Claffy; Kimberly Claire,0,0,0,0
1668540501370,CSE 291,F00,116479,Pasquale; Joseph,0,0,0,0
1668540501805,CSE 293,001,119111,Bafna; Vineet,9999,0,9999,0
1668540501805,CSE 293,002,119118,Bellare; Mihir,9999,0,9999,0
1668540501805,CSE 293,003,119122,Berg-Kirkpatrick; Taylor D,9999,0,9999,0
1668540501805,CSE 293,004,119135,Christensen; Henrik I,9999,0,9999,0
1668540501805,CSE 293,005,119142,Cottrell; Garrison W,9999,0,9999,0
1668540501805,CSE 293,006,119146,Deutsch; Alin Bernard,9999,0,9999,0
1668540501805,CSE 293,007,119159,Esmaeilzadeh; Hadi,9999,0,9999,0
1668540501805,CSE 293,008,119166,Freund; Yoav,9999,0,9999,0
1668540501805,CSE 293,009,119170,Griswold; William G.,9999,0,9999,0
1668540501805,CSE 293,010,119183,Gymrek; Melissa Ann,9999,0,9999,0
1668540501805,CSE 293,011,119190,Heninger; Nadia A,9999,0,9999,0
1668540501805,CSE 293,012,119230,Impagliazzo; Russell,9999,0,9999,0
1668540501805,CSE 293,013,119232,Jhala; Ranjit,9999,0,9999,0
1668540501805,CSE 293,014,119233,Kahng; Andrew Byun,9999,0,9999,0
1668540501805,CSE 293,015,119298,Kane; Daniel Mertz,9999,0,9999,0
1668540501805,CSE 293,016,119299,Kriegman; David J,9999,0,9999,0
1668540501805,CSE 293,017,119300,Kumar; Arun Kumar,9999,0,9999,0
1668540501805,CSE 293,018,119301,Lerner; Sorin,9999,0,9999,0
1668540501805,CSE 293,019,119302,Lovett; Shachar,9999,0,9999,0
1668540501805,CSE 293,020,119303,McAuley; Julian John,9999,0,9999,0
1668540501805,CSE 293,021,119304,Micciancio; Daniele,9999,0,9999,0
1668540501805,CSE 293,022,119367,Orailoglu; Alex,9999,0,9999,0
1668540501805,CSE 293,023,119382,Paturi; Ramamohan,9999,0,9999,0
1668540501805,CSE 293,024,119404,Polikarpova; Nadezhda,9999,0,9999,0
1668540501805,CSE 293,025,119406,Politz; Joseph Gibbs,9999,0,9999,0
1668540501805,CSE 293,026,119411,Porter; George M,9999,0,9999,0
1668540501805,CSE 293,027,119414,Porter; Leonard Emerson,9999,0,9999,0
1668540501805,CSE 293,028,119416,Ramamoorthi; Ravi,9999,0,9999,0
1668540501805,CSE 293,029,119417,Sahoo; Debashis,9999,0,9999,0
1668540501805,CSE 293,030,119420,Saul; Lawrence,9999,0,9999,0
1668540501805,CSE 293,031,119421,Savage; Stefan,9999,0,9999,0
1668540501805,CSE 293,032,119425,Schulze; Jurgen P.,9999,0,9999,0
1668540501805,CSE 293,033,119426,Snoeren; Alex C.,9999,0,9999,0
1668540501805,CSE 293,034,119428,Shang; Jingbo,9999,0,9999,0
1668540501805,CSE 293,035,119430,Stefan; Deian,9999,0,9999,0
1668540501805,CSE 293,036,119431,Su; Hao,9999,0,9999,0
1668540501805,CSE 293,037,119433,Swanson; Steven James,9999,0,9999,0
1668540501805,CSE 293,038,119435,Tullsen; Dean Michael,9999,0,9999,0
1668540501805,CSE 293,039,119483,Voelker; Geoffrey M.,9999,0,9999,0
1668540501805,CSE 293,040,119537,Zhao; Jishen,9999,0,9999,0
1668540501805,CSE 293,041,119538,Zhou; Yuan-Yuan,9999,0,9999,0
1668540501805,CSE 293,042,119539,Gao; Sicun,9999,0,9999,0
1668540501805,CSE 293,043,119540,Weibel; Nadir,9999,0,9999,0
1668540501805,CSE 293,044,119541,Gupta; Rajesh K.,9999,0,9999,0
1668540501805,CSE 293,045,126410,Vaccaro; Kristen Marie,9999,0,9999,0
1668540501805,CSE 293,046,126411,Klemke; Richard,9999,0,9999,0
1668540502242,CSE 294,A00,102459,Voelker; Geoffrey M.,0,2,0,0
1668540502242,CSE 294,B00,111322,Orailoglu; Alex,0,2,0,0
1668540502680,DSE 201,A00,096914,Deutsch; Alin Bernard,30,0,30,0
1668540503102,DSE 210,A00,096915,Dasgupta; Sanjoy,30,0,30,0
1668540503526,DSE 260A,A00,096916,Altintas De Callaf; Ilkay,30,0,30,0
1668540504084,ECE 200,001,103586,Antipa; Nicholas A,9999,0,9999,0
1668540504084,ECE 200,002,103587,Atanasov; Nikolay A.,9999,0,9999,0
1668540504084,ECE 200,003,103588,Bharadia; Dinesh,9999,0,9999,0
1668540504084,ECE 200,004,103589,Cheng; Chung Kuan,9999,0,9999,0
1668540504084,ECE 200,005,103590,Cosman; Pamela C.,9999,0,9999,0
1668540504084,ECE 200,006,103591,Dayeh; Shadi Ahmad,9999,0,9999,0
1668540504084,ECE 200,007,103592,Fainman; Yeshaiahu,9999,0,9999,0
1668540504084,ECE 200,008,103593,Ford; Joseph Earl,9999,0,9999,0
1668540504084,ECE 200,009,103594,Franceschetti; Massimo,9999,0,9999,0
1668540504084,ECE 200,010,103595,Fullerton; Eric E,9999,0,9999,0
1668540504084,ECE 200,011,103596,Galton; Ian A,9999,0,9999,0
1668540504084,ECE 200,012,103597,Gilja; Vikash,9999,0,9999,0
1668540504084,ECE 200,013,103598,Hall; Drew A.,9999,0,9999,0
1668540504084,ECE 200,014,103599,Hsueh; Tzu-Chien,9999,0,9999,0
1668540504084,ECE 200,015,103600,Javidi; Tara,9999,0,9999,0
1668540504084,ECE 200,016,103601,Kahng; Andrew Byun,9999,0,9999,0
1668540504084,ECE 200,017,103602,Kim; Young-Han,9999,0,9999,0
1668540504084,ECE 200,018,103603,Koushanfar; Farinaz,9999,0,9999,0
1668540504084,ECE 200,019,103604,Kuzum; Duygu,9999,0,9999,0
1668540504084,ECE 200,020,103605,Le; Hanh-Phuc,9999,0,9999,0
1668540504084,ECE 200,021,103606,Lin; Bill,9999,0,9999,0
1668540504084,ECE 200,022,103607,Liu; Zhaowei,9998,0,9999,1
1668540504084,ECE 200,023,103608,Lo; Yu-Hwa,9999,0,9999,0
1668540504084,ECE 200,024,103609,Lomakin; Vitaliy,9999,0,9999,0
1668540504084,ECE 200,025,103610,Mercier; Patrick Philip,9999,0,9999,0
1668540504084,ECE 200,026,103611,Meyer; Florian,9999,0,9999,0
1668540504084,ECE 200,027,103612,Milstein; Laurence B.,9999,0,9999,0
1668540504084,ECE 200,028,103613,Mir Arabbaygi; Siavash,9999,0,9999,0
1668540504084,ECE 200,029,103614,Mookherjea; Shayan,9999,0,9999,0
1668540504084,ECE 200,030,103615,Morris; Karcher William,9999,0,9999,0
1668540504084,ECE 200,031,103616,Ng; Tse Nga,9999,0,9999,0
1668540504084,ECE 200,032,103617,Nguyen; Truong Quang,9999,0,9999,0
1668540504084,ECE 200,033,103618,Nomura; Kenji,9999,0,9999,0
1668540504084,ECE 200,034,103619,Orlitsky; Alon,9999,0,9999,0
1668540504084,ECE 200,035,103620,Pal; Piya,9999,0,9999,0
1668540504084,ECE 200,036,103621,Papen; George C.,9999,0,9999,0
1668540504084,ECE 200,037,103622,Radic; Stojan,9999,0,9999,0
1668540504084,ECE 200,038,103623,Rao; Bhaskar D.,9999,0,9999,0
1668540504084,ECE 200,039,103624,Rao; Ramesh R,9999,0,9999,0
1668540504084,ECE 200,040,103625,Rebeiz; Gabriel,9999,0,9999,0
1668540504084,ECE 200,041,103626,Sanford; John R,9999,0,9999,0
1668540504084,ECE 200,042,103627,Siegel; Paul H.,9999,0,9999,0
1668540504084,ECE 200,043,103628,Sievenpiper; Daniel F.,9999,0,9999,0
1668540504084,ECE 200,044,103629,Sworder; David D.,9999,0,9999,0
1668540504084,ECE 200,045,103630,Taur; Yuan,9999,0,9999,0
1668540504084,ECE 200,046,103631,Touri; Behrouz,9999,0,9999,0
1668540504084,ECE 200,047,103632,Trivedi; Mohan M.,9999,0,9999,0
1668540504084,ECE 200,048,103633,Vasconcelos; Nuno,9999,0,9999,0
1668540504084,ECE 200,049,103634,Wang; Xiaolong,9999,0,9999,0
1668540504084,ECE 200,050,103635,Xie; Pengtao,9999,0,9999,0
1668540504084,ECE 200,051,103636,Yip; Michael,9999,0,9999,0
1668540504084,ECE 200,052,103637,Zeger; Kenneth A.,999,0,999,0
1668540504084,ECE 200,053,103638,Zhang; Xinyu,9999,0,9999,0
1668540504084,ECE 200,054,103639,Turakhia; Yatish Girish,9999,0,9999,0
1668540504084,ECE 200,055,103640,Kang; Mingu,9999,0,9999,0
1668540504084,ECE 200,056,103641,Shi; Yuanyuan,9999,0,9999,0
1668540504084,ECE 200,057,103642,Wang; Edward Jay,9999,0,9999,0
1668540504084,ECE 200,058,103643,Zheng; Yang,9999,0,9999,0
1668540504523,ECE 202,A00,103644,Kuzum; Duygu,0,45,0,0
1668540504946,ECE 212BN,A00,103646,Ng; Tse Nga,0,9,0,0
1668540505369,ECE 221,A00,111493,Staff,0,0,0,0
1668540505808,ECE 222B,A00,103647,Lomakin; Vitaliy,0,20,0,0
1668540506251,ECE 230B,A00,103648,Taur; Yuan,0,3,0,0
1668540506677,ECE 238B,A00,103649,Garay; Javier,0,0,0,0
1668540507098,ECE 240B,A00,112900,Fainman; Yeshaiahu,0,7,0,0
1668540507520,ECE 247A,A00,103650,Jokerst; Jesse Vincent,0,6,0,0
1668540507943,ECE 247B,A00,103651,Wang; Joseph,0,14,0,0
1668540508378,ECE 250,A00,103652,Siegel; Paul H.,0,82,0,0
1668540508802,ECE 251A,A00,103654,Rao; Bhaskar D.,0,62,0,0
1668540509233,ECE 257B,A00,103655,Bharadia; Dinesh,0,33,0,0
1668540509682,ECE 258A,A00,103656,Milstein; Laurence B.,0,29,0,0
1668540510104,ECE 260B,A00,103658,Kang; Mingu,0,123,0,0
1668540510534,ECE 264A,A00,103659,Galton; Ian A,0,71,0,0
1668540510975,ECE 265A,A00,103661,Gudem; Prasad S.S.,0,73,0,0
1668540511408,ECE 265D,A00,103662,Gudem; Prasad S.S.,0,26,0,0
1668540511837,ECE 268,A00,103663,Koushanfar; Farinaz,0,43,0,0
1668540512259,ECE 269,A01,103665,Pal; Piya,0,218,0,0
1668540512688,ECE 271B,A00,103666,Vasconcelos; Manuela,0,78,0,0
1668540513111,ECE 276A,A00,103667,Atanasov; Nikolay A.,0,127,0,0
1668540513535,ECE 277,A00,103668,An; Cheolhong,0,150,0,0
1668540513957,ECE 279,A00,117947,Hall; Drew A.,0,22,0,0
1668540514814,ECE 283,A00,103670,Hsueh; Tzu-Chien,0,56,0,0
1668540515261,ECE 284,A00,103671,Turakhia; Yatish Girish,0,40,0,0
1668540515694,ECE 285,A00,103672,Zheng; Yang,0,40,0,0
1668540515694,ECE 285,B00,103673,Sworder; David D.,0,59,0,0
1668540516115,ECE 287,A00,103676,Javidi; Tara,0,9,0,0
1668540516547,MATH 200B,A00,098023,Salehi Golsefidy; Alireza,10,0,15,5
1668540516976,MATH 202B,A00,098024,Rhoades; Brendon Patrick,7,0,15,8
1668540517416,MATH 203B,A00,098025,Oprea; Dragos N.,9,0,15,6
1668540517841,MATH 204B,A00,098026,Sorensen; Claus M,13,0,15,2
1668540518273,MATH 208,A00,098027,Izadi; Elham,7,0,10,3
1668540518701,MATH 209,A00,098028,Pollack; Aaron,10,0,10,0
1668540519142,MATH 211A,A00,112919,Rogalski; Daniel,8,0,10,2
1668540519567,MATH 211B,A00,112920,Seward; Brandon M.,9,0,10,1
1668540519995,MATH 218,A00,098029,Li; Bo,10,0,10,0
1668540520423,MATH 220B,A00,098030,Novak; Jonathan I,11,0,15,4
1668540520847,MATH 221A,A00,098031,Ebenfelt; Peter F,12,0,15,3
1668540521272,MATH 231B,A00,098032,Zlatos; Andrej,10,0,15,5
1668540521694,MATH 240B,A00,098033,Ni; Lei,7,0,15,8
1668540522120,MATH 243,A00,098034,Jekel; David Andrew,10,0,10,0
1668540522546,MATH 245A,A00,098035,Nie; Jiawang,0,5,15,18
1668540522975,MATH 248,A00,098036,Bejenaru; Ioan,10,0,10,0
1668540523412,MATH 250B,A00,098037,Spolaor; Luca,14,0,15,1
1668540523851,MATH 258,A00,098038,Ni; Lei,9,0,10,1
1668540524277,MATH 264B,A00,098041,Rhoades; Brendon Patrick,8,0,15,7
1668540524712,MATH 268,A00,098042,Buss; Samuel R,10,0,10,0
1668540525138,MATH 269,A00,098043,Rhoades; Brendon Patrick,10,0,10,0
1668540525581,MATH 270B,A00,098044,Li; Bo,6,0,15,9
1668540526011,MATH 272B,A00,098045,Holst; Michael J,13,0,15,2
1668540526447,MATH 273A,A00,098046,Tian; Xiaochuan,10,0,15,5
1668540526871,MATH 275,A01,098048,Tian; Xiaochuan,6,0,10,4
1668540527299,MATH 278A,A00,098049,Holst; Michael J,7,0,10,3
1668540527722,MATH 278B,A00,098050,Cloninger; Alexander,10,0,10,0
1668540528155,MATH 278C,A00,098051,Nie; Jiawang,5,0,10,5
1668540528579,MATH 280B,A00,098052,Zheng; Tianyi,7,0,15,8
1668540529021,MATH 281B,A00,098053,Bradic; Jelena,0,2,15,15
1668540529447,MATH 282B,A00,098054,Arias-Castro; Ery,0,1,15,15
1668540529868,MATH 285,A00,098055,Fitzsimmons; Patrick J,0,4,15,17
1668540530305,MATH 287B,A00,098056,Arias-Castro; Ery,1,0,15,14
1668540530732,MATH 288,A00,098057,Agarwal; Pooja,9,0,10,1
1668540530732,MATH 288,B00,098058,Zhang; Danna,8,0,10,2
1668540530732,MATH 288,C00,098059,Williams; Ruth J,9,0,10,1
1668540531159,MATH 290B,A00,098060,Roberts; Justin Deritter,12,0,15,3
1668540531591,MATH 292,A00,098061,Belmont; Eva Kinoshita,10,0,10,0
1668540532021,MATH 295,A00,098062,Suk; Andrew Hoon,47,0,50,3
1668540532448,MATH 296,A00,098063,Novak; Jonathan I,20,0,20,0
1668540532871,MATH 297,001,098064,Gamst; Anthony Collins,9997,0,9999,2
1668541042276,COGS 205,A00,101395,Chiba; Andrea,19,0,20,1
1668541042714,COGS 210B,001,101404,Greene; Deanna Jacquelyn,9998,0,9999,1
1668541042714,COGS 210B,002,101417,Xia; Haijun,9999,0,9999,0
1668541042714,COGS 210B,003,101422,Nitz; Douglas A.,9999,0,9999,0
1668541042714,COGS 210B,004,101423,Hollan; James D.,9998,0,9999,1
1668541042714,COGS 210B,005,101424,Deak; Gedeon O.,9998,0,9999,1
1668541042714,COGS 210B,006,101425,Rossano; Federico,9999,0,9999,0
1668541043135,COGS 211B,A00,101427,Coulson; Seana M,9996,0,9999,3
1668541043560,COGS 220,A00,101428,Hollan; James D.,0,13,25,25
1668541043995,COGS 229,A00,101429,Dow; Steven P,17,0,25,8
1668541044427,COGS 230,A00,101430,Klemmer; Scott R,7,0,17,10
1668541044868,COGS 234,A00,101431,Xia; Haijun,0,1,25,25
1668541045293,COGS 260,A00,101432,Kiyonaga; Anastasia,21,0,25,4
1668541045293,COGS 260,B00,101433,Kirsh; David Joel,15,0,25,10
1668541045718,CSE 202,A00,102371,Impagliazzo; Russell,0,67,0,0
1668541046142,CSE 203B,A01,102373,Cheng; Chung Kuan,0,62,0,0
1668541046575,CSE 208,A00,102374,Micciancio; Daniele,0,5,0,0
1668541047000,CSE 209A,A00,112895,Impagliazzo; Russell,0,13,15,15
1668541047441,CSE 209B,A00,108005,Bellare; Mihir,0,7,0,0
1668541047867,CSE 210,A00,113163,Coblenz; Michael J,0,88,0,0
1668541048297,CSE 219,A00,106111,Dow; Steven P,0,8,20,20
1668541048732,CSE 221,A00,102376,Voelker; Geoffrey M.,0,75,0,0
1668541049165,CSE 224,A01,102378,Porter; George M,0,172,0,0
1668541049587,CSE 229A,A00,102379,Savage; Stefan,0,11,0,0
1668541050015,CSE 229C,A00,102380,Munyaka; Imani N. S.,0,10,0,0
1668541050449,CSE 232B,A00,102382,Deutsch; Alin Bernard,0,36,0,0
1668541050879,CSE 234,A01,112904,Kumar; Arun Kumar,0,0,0,0
1668541051302,CSE 237A,A00,102383,Rosing; Tajana Simunic,0,56,0,0
1668541051725,CSE 239A,A00,102384,Deutsch; Alin Bernard,0,16,0,0
1668541052160,CSE 239B,A00,102385,Polikarpova; Nadezhda,0,11,0,0
1668541052591,CSE 240A,A00,102386,Pannuto; Patrick William,0,47,0,0
1668541053015,CSE 240B,A00,102387,Zhao; Jishen,0,48,0,0
1668541053444,CSE 241A,A00,106406,Kang; Mingu,0,9,0,0
1668541053867,CSE 249B,A00,102388,Kahng; Andrew Byun,0,5,8,8
1668541054294,CSE 251B,A01,102392,Cottrell; Garrison W,0,51,0,0
1668541054294,CSE 251B,A02,102393,Cottrell; Garrison W,0,35,0,0
1668541054723,CSE 252B,A00,102394,Ochoa; Benjamin Lawrence,0,60,0,0
1668541055156,CSE 257,A01,102396,Gao; Sicun,0,146,0,0
1668541055582,CSE 272,A00,102397,Li; Tzumao,0,19,0,0
1668541056003,CSE 274,A00,111323,Chern; Albert Ren-Haur,0,15,0,0
1668541056440,CSE 282,A00,102398,Pevzner; Pavel Arkadjevich,0,0,0,0
1668541056872,CSE 284,A00,114175,Gymrek; Melissa Ann,0,25,0,0
1668541057299,CSE 290,A00,102399,Chandraker; Manmohan Krishna,0,11,0,0
1668541057299,CSE 290,B00,102400,Vaccaro; Kristen Marie,0,7,25,25
1668541057299,CSE 290,C00,102414,Pannuto; Patrick William,0,1,25,25
1668541057299,CSE 290,D00,102427,Pevzner; Pavel Arkadjevich,0,0,0,0
1668541057299,CSE 290,E00,102429,Zhao; Jishen,0,6,0,0
1668541057299,CSE 290,F00,102436,Tullsen; Dean Michael,0,6,0,0
1668541057299,CSE 290,G00,102440,Christensen; Henrik I,0,6,20,20
1668541057733,CSE 291,A00,102443,Su; Hao,0,0,0,0
1668541057733,CSE 291,B00,102448,Polikarpova; Nadezhda,0,0,0,0
1668541057733,CSE 291,C00,102453,Vaccaro; Kristen Marie,0,0,0,0
1668541057733,CSE 291,D00,111343,Savage; Stefan,0,0,0,0
1668541057733,CSE 291,E00,116474,Claffy; Kimberly Claire,0,0,0,0
1668541057733,CSE 291,F00,116479,Pasquale; Joseph,0,0,0,0
1668541058192,CSE 293,001,119111,Bafna; Vineet,9999,0,9999,0
1668541058192,CSE 293,002,119118,Bellare; Mihir,9999,0,9999,0
1668541058192,CSE 293,003,119122,Berg-Kirkpatrick; Taylor D,9999,0,9999,0
1668541058192,CSE 293,004,119135,Christensen; Henrik I,9999,0,9999,0
1668541058192,CSE 293,005,119142,Cottrell; Garrison W,9999,0,9999,0
1668541058192,CSE 293,006,119146,Deutsch; Alin Bernard,9999,0,9999,0
1668541058192,CSE 293,007,119159,Esmaeilzadeh; Hadi,9999,0,9999,0
1668541058192,CSE 293,008,119166,Freund; Yoav,9999,0,9999,0
1668541058192,CSE 293,009,119170,Griswold; William G.,9999,0,9999,0
1668541058192,CSE 293,010,119183,Gymrek; Melissa Ann,9999,0,9999,0
1668541058192,CSE 293,011,119190,Heninger; Nadia A,9999,0,9999,0
1668541058192,CSE 293,012,119230,Impagliazzo; Russell,9999,0,9999,0
1668541058192,CSE 293,013,119232,Jhala; Ranjit,9999,0,9999,0
1668541058192,CSE 293,014,119233,Kahng; Andrew Byun,9999,0,9999,0
1668541058192,CSE 293,015,119298,Kane; Daniel Mertz,9999,0,9999,0
1668541058192,CSE 293,016,119299,Kriegman; David J,9999,0,9999,0
1668541058192,CSE 293,017,119300,Kumar; Arun Kumar,9999,0,9999,0
1668541058192,CSE 293,018,119301,Lerner; Sorin,9999,0,9999,0
1668541058192,CSE 293,019,119302,Lovett; Shachar,9999,0,9999,0
1668541058192,CSE 293,020,119303,McAuley; Julian John,9999,0,9999,0
1668541058192,CSE 293,021,119304,Micciancio; Daniele,9999,0,9999,0
1668541058192,CSE 293,022,119367,Orailoglu; Alex,9999,0,9999,0
1668541058192,CSE 293,023,119382,Paturi; Ramamohan,9999,0,9999,0
1668541058192,CSE 293,024,119404,Polikarpova; Nadezhda,9999,0,9999,0
1668541058192,CSE 293,025,119406,Politz; Joseph Gibbs,9999,0,9999,0
1668541058192,CSE 293,026,119411,Porter; George M,9999,0,9999,0
1668541058192,CSE 293,027,119414,Porter; Leonard Emerson,9999,0,9999,0
1668541058192,CSE 293,028,119416,Ramamoorthi; Ravi,9999,0,9999,0
1668541058192,CSE 293,029,119417,Sahoo; Debashis,9999,0,9999,0
1668541058192,CSE 293,030,119420,Saul; Lawrence,9999,0,9999,0
1668541058192,CSE 293,031,119421,Savage; Stefan,9999,0,9999,0
1668541058192,CSE 293,032,119425,Schulze; Jurgen P.,9999,0,9999,0
1668541058192,CSE 293,033,119426,Snoeren; Alex C.,9999,0,9999,0
1668541058192,CSE 293,034,119428,Shang; Jingbo,9999,0,9999,0
1668541058192,CSE 293,035,119430,Stefan; Deian,9999,0,9999,0
1668541058192,CSE 293,036,119431,Su; Hao,9999,0,9999,0
1668541058192,CSE 293,037,119433,Swanson; Steven James,9999,0,9999,0
1668541058192,CSE 293,038,119435,Tullsen; Dean Michael,9999,0,9999,0
1668541058192,CSE 293,039,119483,Voelker; Geoffrey M.,9999,0,9999,0
1668541058192,CSE 293,040,119537,Zhao; Jishen,9999,0,9999,0
1668541058192,CSE 293,041,119538,Zhou; Yuan-Yuan,9999,0,9999,0
1668541058192,CSE 293,042,119539,Gao; Sicun,9999,0,9999,0
1668541058192,CSE 293,043,119540,Weibel; Nadir,9999,0,9999,0
1668541058192,CSE 293,044,119541,Gupta; Rajesh K.,9999,0,9999,0
1668541058192,CSE 293,045,126410,Vaccaro; Kristen Marie,9999,0,9999,0
1668541058192,CSE 293,046,126411,Klemke; Richard,9999,0,9999,0
1668541058617,CSE 294,A00,102459,Voelker; Geoffrey M.,0,2,0,0
1668541058617,CSE 294,B00,111322,Orailoglu; Alex,0,2,0,0
1668541059041,DSE 201,A00,096914,Deutsch; Alin Bernard,30,0,30,0
1668541059468,DSE 210,A00,096915,Dasgupta; Sanjoy,30,0,30,0
1668541059891,DSE 260A,A00,096916,Altintas De Callaf; Ilkay,30,0,30,0
1668541060352,ECE 200,001,103586,Antipa; Nicholas A,9999,0,9999,0
1668541060352,ECE 200,002,103587,Atanasov; Nikolay A.,9999,0,9999,0
1668541060352,ECE 200,003,103588,Bharadia; Dinesh,9999,0,9999,0
1668541060352,ECE 200,004,103589,Cheng; Chung Kuan,9999,0,9999,0
1668541060352,ECE 200,005,103590,Cosman; Pamela C.,9999,0,9999,0
1668541060352,ECE 200,006,103591,Dayeh; Shadi Ahmad,9999,0,9999,0
1668541060352,ECE 200,007,103592,Fainman; Yeshaiahu,9999,0,9999,0
1668541060352,ECE 200,008,103593,Ford; Joseph Earl,9999,0,9999,0
1668541060352,ECE 200,009,103594,Franceschetti; Massimo,9999,0,9999,0
1668541060352,ECE 200,010,103595,Fullerton; Eric E,9999,0,9999,0
1668541060352,ECE 200,011,103596,Galton; Ian A,9999,0,9999,0
1668541060352,ECE 200,012,103597,Gilja; Vikash,9999,0,9999,0
1668541060352,ECE 200,013,103598,Hall; Drew A.,9999,0,9999,0
1668541060352,ECE 200,014,103599,Hsueh; Tzu-Chien,9999,0,9999,0
1668541060352,ECE 200,015,103600,Javidi; Tara,9999,0,9999,0
1668541060352,ECE 200,016,103601,Kahng; Andrew Byun,9999,0,9999,0
1668541060352,ECE 200,017,103602,Kim; Young-Han,9999,0,9999,0
1668541060352,ECE 200,018,103603,Koushanfar; Farinaz,9999,0,9999,0
1668541060352,ECE 200,019,103604,Kuzum; Duygu,9999,0,9999,0
1668541060352,ECE 200,020,103605,Le; Hanh-Phuc,9999,0,9999,0
1668541060352,ECE 200,021,103606,Lin; Bill,9999,0,9999,0
1668541060352,ECE 200,022,103607,Liu; Zhaowei,9998,0,9999,1
1668541060352,ECE 200,023,103608,Lo; Yu-Hwa,9999,0,9999,0
1668541060352,ECE 200,024,103609,Lomakin; Vitaliy,9999,0,9999,0
1668541060352,ECE 200,025,103610,Mercier; Patrick Philip,9999,0,9999,0
1668541060352,ECE 200,026,103611,Meyer; Florian,9999,0,9999,0
1668541060352,ECE 200,027,103612,Milstein; Laurence B.,9999,0,9999,0
1668541060352,ECE 200,028,103613,Mir Arabbaygi; Siavash,9999,0,9999,0
1668541060352,ECE 200,029,103614,Mookherjea; Shayan,9999,0,9999,0
1668541060352,ECE 200,030,103615,Morris; Karcher William,9999,0,9999,0
1668541060352,ECE 200,031,103616,Ng; Tse Nga,9999,0,9999,0
1668541060352,ECE 200,032,103617,Nguyen; Truong Quang,9999,0,9999,0
1668541060352,ECE 200,033,103618,Nomura; Kenji,9999,0,9999,0
1668541060352,ECE 200,034,103619,Orlitsky; Alon,9999,0,9999,0
1668541060352,ECE 200,035,103620,Pal; Piya,9999,0,9999,0
1668541060352,ECE 200,036,103621,Papen; George C.,9999,0,9999,0
1668541060352,ECE 200,037,103622,Radic; Stojan,9999,0,9999,0
1668541060352,ECE 200,038,103623,Rao; Bhaskar D.,9999,0,9999,0
1668541060352,ECE 200,039,103624,Rao; Ramesh R,9999,0,9999,0
1668541060352,ECE 200,040,103625,Rebeiz; Gabriel,9999,0,9999,0
1668541060352,ECE 200,041,103626,Sanford; John R,9999,0,9999,0
1668541060352,ECE 200,042,103627,Siegel; Paul H.,9999,0,9999,0
1668541060352,ECE 200,043,103628,Sievenpiper; Daniel F.,9999,0,9999,0
1668541060352,ECE 200,044,103629,Sworder; David D.,9999,0,9999,0
1668541060352,ECE 200,045,103630,Taur; Yuan,9999,0,9999,0
1668541060352,ECE 200,046,103631,Touri; Behrouz,9999,0,9999,0
1668541060352,ECE 200,047,103632,Trivedi; Mohan M.,9999,0,9999,0
1668541060352,ECE 200,048,103633,Vasconcelos; Nuno,9999,0,9999,0
1668541060352,ECE 200,049,103634,Wang; Xiaolong,9999,0,9999,0
1668541060352,ECE 200,050,103635,Xie; Pengtao,9999,0,9999,0
1668541060352,ECE 200,051,103636,Yip; Michael,9999,0,9999,0
1668541060352,ECE 200,052,103637,Zeger; Kenneth A.,999,0,999,0
1668541060352,ECE 200,053,103638,Zhang; Xinyu,9999,0,9999,0
1668541060352,ECE 200,054,103639,Turakhia; Yatish Girish,9999,0,9999,0
1668541060352,ECE 200,055,103640,Kang; Mingu,9999,0,9999,0
1668541060352,ECE 200,056,103641,Shi; Yuanyuan,9999,0,9999,0
1668541060352,ECE 200,057,103642,Wang; Edward Jay,9999,0,9999,0
1668541060352,ECE 200,058,103643,Zheng; Yang,9999,0,9999,0
1668541060784,ECE 202,A00,103644,Kuzum; Duygu,0,45,0,0
1668541061226,ECE 212BN,A00,103646,Ng; Tse Nga,0,9,0,0
1668541061649,ECE 221,A00,111493,Staff,0,0,0,0
1668541062074,ECE 222B,A00,103647,Lomakin; Vitaliy,0,20,0,0
1668541062509,ECE 230B,A00,103648,Taur; Yuan,0,3,0,0
1668541062951,ECE 238B,A00,103649,Garay; Javier,0,0,0,0
1668541063374,ECE 240B,A00,112900,Fainman; Yeshaiahu,0,7,0,0
1668541063804,ECE 247A,A00,103650,Jokerst; Jesse Vincent,0,6,0,0
1668541064234,ECE 247B,A00,103651,Wang; Joseph,0,14,0,0
1668541064662,ECE 250,A00,103652,Siegel; Paul H.,0,82,0,0
1668541065084,ECE 251A,A00,103654,Rao; Bhaskar D.,0,62,0,0
1668541065507,ECE 257B,A00,103655,Bharadia; Dinesh,0,33,0,0
1668541065930,ECE 258A,A00,103656,Milstein; Laurence B.,0,29,0,0
1668541066361,ECE 260B,A00,103658,Kang; Mingu,0,123,0,0
1668541066785,ECE 264A,A00,103659,Galton; Ian A,0,71,0,0
1668541067208,ECE 265A,A00,103661,Gudem; Prasad S.S.,0,73,0,0
1668541067635,ECE 265D,A00,103662,Gudem; Prasad S.S.,0,26,0,0
1668541068069,ECE 268,A00,103663,Koushanfar; Farinaz,0,43,0,0
1668541068491,ECE 269,A01,103665,Pal; Piya,0,218,0,0
1668541068913,ECE 271B,A00,103666,Vasconcelos; Manuela,0,78,0,0
1668541069340,ECE 276A,A00,103667,Atanasov; Nikolay A.,0,127,0,0
1668541069762,ECE 277,A00,103668,An; Cheolhong,0,150,0,0
1668541070192,ECE 279,A00,117947,Hall; Drew A.,0,22,0,0
1668541071070,ECE 283,A00,103670,Hsueh; Tzu-Chien,0,56,0,0
1668541071494,ECE 284,A00,103671,Turakhia; Yatish Girish,0,40,0,0
1668541071917,ECE 285,A00,103672,Zheng; Yang,0,40,0,0
1668541071917,ECE 285,B00,103673,Sworder; David D.,0,60,0,0
1668541072340,ECE 287,A00,103676,Javidi; Tara,0,9,0,0
1668541072763,MATH 200B,A00,098023,Salehi Golsefidy; Alireza,10,0,15,5
1668541073185,MATH 202B,A00,098024,Rhoades; Brendon Patrick,7,0,15,8
1668541073609,MATH 203B,A00,098025,Oprea; Dragos N.,9,0,15,6
1668541074047,MATH 204B,A00,098026,Sorensen; Claus M,13,0,15,2
1668541074479,MATH 208,A00,098027,Izadi; Elham,7,0,10,3
1668541074918,MATH 209,A00,098028,Pollack; Aaron,10,0,10,0
1668541075439,MATH 211A,A00,112919,Rogalski; Daniel,8,0,10,2
1668541075880,MATH 211B,A00,112920,Seward; Brandon M.,9,0,10,1
1668541076309,MATH 218,A00,098029,Li; Bo,10,0,10,0
1668541076742,MATH 220B,A00,098030,Novak; Jonathan I,11,0,15,4
1668541077173,MATH 221A,A00,098031,Ebenfelt; Peter F,12,0,15,3
1668541077596,MATH 231B,A00,098032,Zlatos; Andrej,10,0,15,5
1668541078033,MATH 240B,A00,098033,Ni; Lei,7,0,15,8
1668541078455,MATH 243,A00,098034,Jekel; David Andrew,10,0,10,0
1668541078881,MATH 245A,A00,098035,Nie; Jiawang,0,5,15,18
1668541079305,MATH 248,A00,098036,Bejenaru; Ioan,10,0,10,0
1668541079738,MATH 250B,A00,098037,Spolaor; Luca,14,0,15,1
1668541080173,MATH 258,A00,098038,Ni; Lei,9,0,10,1
1668541080609,MATH 264B,A00,098041,Rhoades; Brendon Patrick,8,0,15,7
1668541081047,MATH 268,A00,098042,Buss; Samuel R,10,0,10,0
1668541081486,MATH 269,A00,098043,Rhoades; Brendon Patrick,10,0,10,0
1668541081909,MATH 270B,A00,098044,Li; Bo,6,0,15,9
1668541082340,MATH 272B,A00,098045,Holst; Michael J,13,0,15,2
1668541082764,MATH 273A,A00,098046,Tian; Xiaochuan,10,0,15,5
1668541083188,MATH 275,A01,098048,Tian; Xiaochuan,6,0,10,4
1668541083619,MATH 278A,A00,098049,Holst; Michael J,6,0,10,4
1668541084044,MATH 278B,A00,098050,Cloninger; Alexander,10,0,10,0
1668541084468,MATH 278C,A00,098051,Nie; Jiawang,5,0,10,5
1668541084894,MATH 280B,A00,098052,Zheng; Tianyi,7,0,15,8
1668541085334,MATH 281B,A00,098053,Bradic; Jelena,0,2,15,15
1668541085769,MATH 282B,A00,098054,Arias-Castro; Ery,0,1,15,15
1668541086204,MATH 285,A00,098055,Fitzsimmons; Patrick J,0,4,15,17
1668541086630,MATH 287B,A00,098056,Arias-Castro; Ery,1,0,15,14
1668541087054,MATH 288,A00,098057,Agarwal; Pooja,9,0,10,1
1668541087054,MATH 288,B00,098058,Zhang; Danna,8,0,10,2
1668541087054,MATH 288,C00,098059,Williams; Ruth J,9,0,10,1
1668541087480,MATH 290B,A00,098060,Roberts; Justin Deritter,12,0,15,3
1668541087904,MATH 292,A00,098061,Belmont; Eva Kinoshita,10,0,10,0
1668541088328,MATH 295,A00,098062,Suk; Andrew Hoon,47,0,50,3
1668541088766,MATH 296,A00,098063,Novak; Jonathan I,20,0,20,0
1668541089195,MATH 297,001,098064,Gamst; Anthony Collins,9997,0,9999,2
1668541595270,COGS 205,A00,101395,Chiba; Andrea,19,0,20,1
1668541595693,COGS 210B,001,101404,Greene; Deanna Jacquelyn,9998,0,9999,1
1668541595693,COGS 210B,002,101417,Xia; Haijun,9999,0,9999,0
1668541595693,COGS 210B,003,101422,Nitz; Douglas A.,9999,0,9999,0
1668541595693,COGS 210B,004,101423,Hollan; James D.,9998,0,9999,1
1668541595693,COGS 210B,005,101424,Deak; Gedeon O.,9998,0,9999,1
1668541595693,COGS 210B,006,101425,Rossano; Federico,9999,0,9999,0
1668541596127,COGS 211B,A00,101427,Coulson; Seana M,9996,0,9999,3
1668541596549,COGS 220,A00,101428,Hollan; James D.,0,14,25,25
1668541596985,COGS 229,A00,101429,Dow; Steven P,17,0,25,8
1668541597418,COGS 230,A00,101430,Klemmer; Scott R,6,0,17,11
1668541597844,COGS 234,A00,101431,Xia; Haijun,0,1,25,25
1668541598270,COGS 260,A00,101432,Kiyonaga; Anastasia,21,0,25,4
1668541598270,COGS 260,B00,101433,Kirsh; David Joel,15,0,25,10
1668541598692,CSE 202,A00,102371,Impagliazzo; Russell,0,67,0,0
1668541599118,CSE 203B,A01,102373,Cheng; Chung Kuan,0,62,0,0
1668541599558,CSE 208,A00,102374,Micciancio; Daniele,0,5,0,0
1668541600091,CSE 209A,A00,112895,Impagliazzo; Russell,0,13,15,15
1668541600514,CSE 209B,A00,108005,Bellare; Mihir,0,7,0,0
1668541600944,CSE 210,A00,113163,Coblenz; Michael J,0,88,0,0
1668541601369,CSE 219,A00,106111,Dow; Steven P,0,8,20,20
1668541601791,CSE 221,A00,102376,Voelker; Geoffrey M.,0,75,0,0
1668541602215,CSE 224,A01,102378,Porter; George M,0,172,0,0
1668541602638,CSE 229A,A00,102379,Savage; Stefan,0,11,0,0
1668541603086,CSE 229C,A00,102380,Munyaka; Imani N. S.,0,10,0,0
1668541603511,CSE 232B,A00,102382,Deutsch; Alin Bernard,0,36,0,0
1668541603943,CSE 234,A01,112904,Kumar; Arun Kumar,0,0,0,0
1668541604379,CSE 237A,A00,102383,Rosing; Tajana Simunic,0,56,0,0
1668541604815,CSE 239A,A00,102384,Deutsch; Alin Bernard,0,16,0,0
1668541605249,CSE 239B,A00,102385,Polikarpova; Nadezhda,0,11,0,0
1668541605679,CSE 240A,A00,102386,Pannuto; Patrick William,0,47,0,0
1668541606105,CSE 240B,A00,102387,Zhao; Jishen,0,48,0,0
1668541606540,CSE 241A,A00,106406,Kang; Mingu,0,9,0,0
1668541606972,CSE 249B,A00,102388,Kahng; Andrew Byun,0,5,8,8
1668541607395,CSE 251B,A01,102392,Cottrell; Garrison W,0,51,0,0
1668541607395,CSE 251B,A02,102393,Cottrell; Garrison W,0,35,0,0
1668541607827,CSE 252B,A00,102394,Ochoa; Benjamin Lawrence,0,60,0,0
1668541608253,CSE 257,A01,102396,Gao; Sicun,0,146,0,0
1668541608678,CSE 272,A00,102397,Li; Tzumao,0,19,0,0
1668541609113,CSE 274,A00,111323,Chern; Albert Ren-Haur,0,15,0,0
1668541609538,CSE 282,A00,102398,Pevzner; Pavel Arkadjevich,0,0,0,0
1668541609962,CSE 284,A00,114175,Gymrek; Melissa Ann,0,25,0,0
1668541610392,CSE 290,A00,102399,Chandraker; Manmohan Krishna,0,11,0,0
1668541610392,CSE 290,B00,102400,Vaccaro; Kristen Marie,0,8,25,25
1668541610392,CSE 290,C00,102414,Pannuto; Patrick William,0,1,25,25
1668541610392,CSE 290,D00,102427,Pevzner; Pavel Arkadjevich,0,0,0,0
1668541610392,CSE 290,E00,102429,Zhao; Jishen,0,6,0,0
1668541610392,CSE 290,F00,102436,Tullsen; Dean Michael,0,6,0,0
1668541610392,CSE 290,G00,102440,Christensen; Henrik I,0,6,20,20
1668541610813,CSE 291,A00,102443,Su; Hao,0,0,0,0
1668541610813,CSE 291,B00,102448,Polikarpova; Nadezhda,0,0,0,0
1668541610813,CSE 291,C00,102453,Vaccaro; Kristen Marie,0,0,0,0
1668541610813,CSE 291,D00,111343,Savage; Stefan,0,0,0,0
1668541610813,CSE 291,E00,116474,Claffy; Kimberly Claire,0,0,0,0
1668541610813,CSE 291,F00,116479,Pasquale; Joseph,0,0,0,0
1668541611260,CSE 293,001,119111,Bafna; Vineet,9999,0,9999,0
1668541611260,CSE 293,002,119118,Bellare; Mihir,9999,0,9999,0
1668541611260,CSE 293,003,119122,Berg-Kirkpatrick; Taylor D,9999,0,9999,0
1668541611260,CSE 293,004,119135,Christensen; Henrik I,9999,0,9999,0
1668541611260,CSE 293,005,119142,Cottrell; Garrison W,9999,0,9999,0
1668541611260,CSE 293,006,119146,Deutsch; Alin Bernard,9999,0,9999,0
1668541611260,CSE 293,007,119159,Esmaeilzadeh; Hadi,9999,0,9999,0
1668541611260,CSE 293,008,119166,Freund; Yoav,9999,0,9999,0
1668541611260,CSE 293,009,119170,Griswold; William G.,9999,0,9999,0
1668541611260,CSE 293,010,119183,Gymrek; Melissa Ann,9999,0,9999,0
1668541611260,CSE 293,011,119190,Heninger; Nadia A,9999,0,9999,0
1668541611260,CSE 293,012,119230,Impagliazzo; Russell,9999,0,9999,0
1668541611260,CSE 293,013,119232,Jhala; Ranjit,9999,0,9999,0
1668541611260,CSE 293,014,119233,Kahng; Andrew Byun,9999,0,9999,0
1668541611260,CSE 293,015,119298,Kane; Daniel Mertz,9999,0,9999,0
1668541611260,CSE 293,016,119299,Kriegman; David J,9999,0,9999,0
1668541611260,CSE 293,017,119300,Kumar; Arun Kumar,9999,0,9999,0
1668541611260,CSE 293,018,119301,Lerner; Sorin,9999,0,9999,0
1668541611260,CSE 293,019,119302,Lovett; Shachar,9999,0,9999,0
1668541611260,CSE 293,020,119303,McAuley; Julian John,9999,0,9999,0
1668541611260,CSE 293,021,119304,Micciancio; Daniele,9999,0,9999,0
1668541611260,CSE 293,022,119367,Orailoglu; Alex,9999,0,9999,0
1668541611260,CSE 293,023,119382,Paturi; Ramamohan,9999,0,9999,0
1668541611260,CSE 293,024,119404,Polikarpova; Nadezhda,9999,0,9999,0
1668541611260,CSE 293,025,119406,Politz; Joseph Gibbs,9999,0,9999,0
1668541611260,CSE 293,026,119411,Porter; George M,9999,0,9999,0
1668541611260,CSE 293,027,119414,Porter; Leonard Emerson,9999,0,9999,0
1668541611260,CSE 293,028,119416,Ramamoorthi; Ravi,9999,0,9999,0
1668541611260,CSE 293,029,119417,Sahoo; Debashis,9999,0,9999,0
1668541611260,CSE 293,030,119420,Saul; Lawrence,9999,0,9999,0
1668541611260,CSE 293,031,119421,Savage; Stefan,9999,0,9999,0
1668541611260,CSE 293,032,119425,Schulze; Jurgen P.,9999,0,9999,0
1668541611260,CSE 293,033,119426,Snoeren; Alex C.,9999,0,9999,0
1668541611260,CSE 293,034,119428,Shang; Jingbo,9999,0,9999,0
1668541611260,CSE 293,035,119430,Stefan; Deian,9999,0,9999,0
1668541611260,CSE 293,036,119431,Su; Hao,9999,0,9999,0
1668541611260,CSE 293,037,119433,Swanson; Steven James,9999,0,9999,0
1668541611260,CSE 293,038,119435,Tullsen; Dean Michael,9999,0,9999,0
1668541611260,CSE 293,039,119483,Voelker; Geoffrey M.,9999,0,9999,0
1668541611260,CSE 293,040,119537,Zhao; Jishen,9999,0,9999,0
1668541611260,CSE 293,041,119538,Zhou; Yuan-Yuan,9999,0,9999,0
1668541611260,CSE 293,042,119539,Gao; Sicun,9999,0,9999,0
1668541611260,CSE 293,043,119540,Weibel; Nadir,9999,0,9999,0
1668541611260,CSE 293,044,119541,Gupta; Rajesh K.,9999,0,9999,0
1668541611260,CSE 293,045,126410,Vaccaro; Kristen Marie,9999,0,9999,0
1668541611260,CSE 293,046,126411,Klemke; Richard,9999,0,9999,0
1668541611685,CSE 294,A00,102459,Voelker; Geoffrey M.,0,2,0,0
1668541611685,CSE 294,B00,111322,Orailoglu; Alex,0,2,0,0
1668541612115,DSE 201,A00,096914,Deutsch; Alin Bernard,30,0,30,0
1668541612551,DSE 210,A00,096915,Dasgupta; Sanjoy,30,0,30,0
1668541612975,DSE 260A,A00,096916,Altintas De Callaf; Ilkay,30,0,30,0
1668541613456,ECE 200,001,103586,Antipa; Nicholas A,9999,0,9999,0
1668541613456,ECE 200,002,103587,Atanasov; Nikolay A.,9999,0,9999,0
1668541613456,ECE 200,003,103588,Bharadia; Dinesh,9999,0,9999,0
1668541613456,ECE 200,004,103589,Cheng; Chung Kuan,9999,0,9999,0
1668541613456,ECE 200,005,103590,Cosman; Pamela C.,9999,0,9999,0
1668541613456,ECE 200,006,103591,Dayeh; Shadi Ahmad,9999,0,9999,0
1668541613456,ECE 200,007,103592,Fainman; Yeshaiahu,9999,0,9999,0
1668541613456,ECE 200,008,103593,Ford; Joseph Earl,9999,0,9999,0
1668541613456,ECE 200,009,103594,Franceschetti; Massimo,9999,0,9999,0
1668541613456,ECE 200,010,103595,Fullerton; Eric E,9999,0,9999,0
1668541613456,ECE 200,011,103596,Galton; Ian A,9999,0,9999,0
1668541613456,ECE 200,012,103597,Gilja; Vikash,9999,0,9999,0
1668541613456,ECE 200,013,103598,Hall; Drew A.,9999,0,9999,0
1668541613456,ECE 200,014,103599,Hsueh; Tzu-Chien,9999,0,9999,0
1668541613456,ECE 200,015,103600,Javidi; Tara,9999,0,9999,0
1668541613456,ECE 200,016,103601,Kahng; Andrew Byun,9999,0,9999,0
1668541613456,ECE 200,017,103602,Kim; Young-Han,9999,0,9999,0
1668541613456,ECE 200,018,103603,Koushanfar; Farinaz,9999,0,9999,0
1668541613456,ECE 200,019,103604,Kuzum; Duygu,9999,0,9999,0
1668541613456,ECE 200,020,103605,Le; Hanh-Phuc,9999,0,9999,0
1668541613456,ECE 200,021,103606,Lin; Bill,9999,0,9999,0
1668541613456,ECE 200,022,103607,Liu; Zhaowei,9998,0,9999,1
1668541613456,ECE 200,023,103608,Lo; Yu-Hwa,9999,0,9999,0
1668541613456,ECE 200,024,103609,Lomakin; Vitaliy,9999,0,9999,0
1668541613456,ECE 200,025,103610,Mercier; Patrick Philip,9999,0,9999,0
1668541613456,ECE 200,026,103611,Meyer; Florian,9999,0,9999,0
1668541613456,ECE 200,027,103612,Milstein; Laurence B.,9999,0,9999,0
1668541613456,ECE 200,028,103613,Mir Arabbaygi; Siavash,9999,0,9999,0
1668541613456,ECE 200,029,103614,Mookherjea; Shayan,9999,0,9999,0
1668541613456,ECE 200,030,103615,Morris; Karcher William,9999,0,9999,0
1668541613456,ECE 200,031,103616,Ng; Tse Nga,9999,0,9999,0
1668541613456,ECE 200,032,103617,Nguyen; Truong Quang,9999,0,9999,0
1668541613456,ECE 200,033,103618,Nomura; Kenji,9999,0,9999,0
1668541613456,ECE 200,034,103619,Orlitsky; Alon,9999,0,9999,0
1668541613456,ECE 200,035,103620,Pal; Piya,9999,0,9999,0
1668541613456,ECE 200,036,103621,Papen; George C.,9999,0,9999,0
1668541613456,ECE 200,037,103622,Radic; Stojan,9999,0,9999,0
1668541613456,ECE 200,038,103623,Rao; Bhaskar D.,9999,0,9999,0
1668541613456,ECE 200,039,103624,Rao; Ramesh R,9999,0,9999,0
1668541613456,ECE 200,040,103625,Rebeiz; Gabriel,9999,0,9999,0
1668541613456,ECE 200,041,103626,Sanford; John R,9999,0,9999,0
1668541613456,ECE 200,042,103627,Siegel; Paul H.,9999,0,9999,0
1668541613456,ECE 200,043,103628,Sievenpiper; Daniel F.,9999,0,9999,0
1668541613456,ECE 200,044,103629,Sworder; David D.,9999,0,9999,0
1668541613456,ECE 200,045,103630,Taur; Yuan,9999,0,9999,0
1668541613456,ECE 200,046,103631,Touri; Behrouz,9999,0,9999,0
1668541613456,ECE 200,047,103632,Trivedi; Mohan M.,9999,0,9999,0
1668541613456,ECE 200,048,103633,Vasconcelos; Nuno,9999,0,9999,0
1668541613456,ECE 200,049,103634,Wang; Xiaolong,9999,0,9999,0
1668541613456,ECE 200,050,103635,Xie; Pengtao,9999,0,9999,0
1668541613456,ECE 200,051,103636,Yip; Michael,9999,0,9999,0
1668541613456,ECE 200,052,103637,Zeger; Kenneth A.,999,0,999,0
1668541613456,ECE 200,053,103638,Zhang; Xinyu,9999,0,9999,0
1668541613456,ECE 200,054,103639,Turakhia; Yatish Girish,9999,0,9999,0
1668541613456,ECE 200,055,103640,Kang; Mingu,9999,0,9999,0
1668541613456,ECE 200,056,103641,Shi; Yuanyuan,9999,0,9999,0
1668541613456,ECE 200,057,103642,Wang; Edward Jay,9999,0,9999,0
1668541613456,ECE 200,058,103643,Zheng; Yang,9999,0,9999,0
1668541613890,ECE 202,A00,103644,Kuzum; Duygu,0,45,0,0
1668541614314,ECE 212BN,A00,103646,Ng; Tse Nga,0,9,0,0
1668541614740,ECE 221,A00,111493,Staff,0,0,0,0
1668541615163,ECE 222B,A00,103647,Lomakin; Vitaliy,0,20,0,0
1668541615590,ECE 230B,A00,103648,Taur; Yuan,0,3,0,0
1668541616012,ECE 238B,A00,103649,Garay; Javier,0,0,0,0
1668541616444,ECE 240B,A00,112900,Fainman; Yeshaiahu,0,7,0,0
1668541616868,ECE 247A,A00,103650,Jokerst; Jesse Vincent,0,6,0,0
1668541617291,ECE 247B,A00,103651,Wang; Joseph,0,14,0,0
1668541617718,ECE 250,A00,103652,Siegel; Paul H.,0,82,0,0
1668541618142,ECE 251A,A00,103654,Rao; Bhaskar D.,0,62,0,0
1668541618582,ECE 257B,A00,103655,Bharadia; Dinesh,0,33,0,0
1668541619008,ECE 258A,A00,103656,Milstein; Laurence B.,0,29,0,0
1668541619435,ECE 260B,A00,103658,Kang; Mingu,0,123,0,0
1668541619862,ECE 264A,A00,103659,Galton; Ian A,0,71,0,0
1668541620290,ECE 265A,A00,103661,Gudem; Prasad S.S.,0,74,0,0
1668541620714,ECE 265D,A00,103662,Gudem; Prasad S.S.,0,26,0,0
1668541621136,ECE 268,A00,103663,Koushanfar; Farinaz,0,43,0,0
1668541621578,ECE 269,A01,103665,Pal; Piya,0,218,0,0
1668541622005,ECE 271B,A00,103666,Vasconcelos; Manuela,0,78,0,0
1668541622430,ECE 276A,A00,103667,Atanasov; Nikolay A.,0,127,0,0
1668541622857,ECE 277,A00,103668,An; Cheolhong,0,150,0,0
1668541623292,ECE 279,A00,117947,Hall; Drew A.,0,22,0,0
1668541624149,ECE 283,A00,103670,Hsueh; Tzu-Chien,0,56,0,0
1668541624582,ECE 284,A00,103671,Turakhia; Yatish Girish,0,40,0,0
1668541625006,ECE 285,A00,103672,Zheng; Yang,0,40,0,0
1668541625006,ECE 285,B00,103673,Sworder; David D.,0,60,0,0
1668541625433,ECE 287,A00,103676,Javidi; Tara,0,9,0,0
1668541625868,MATH 200B,A00,098023,Salehi Golsefidy; Alireza,10,0,15,5
1668541626294,MATH 202B,A00,098024,Rhoades; Brendon Patrick,7,0,15,8
1668541626719,MATH 203B,A00,098025,Oprea; Dragos N.,9,0,15,6
1668541627142,MATH 204B,A00,098026,Sorensen; Claus M,13,0,15,2
1668541627570,MATH 208,A00,098027,Izadi; Elham,7,0,10,3
1668541627993,MATH 209,A00,098028,Pollack; Aaron,10,0,10,0
1668541628430,MATH 211A,A00,112919,Rogalski; Daniel,8,0,10,2
1668541628854,MATH 211B,A00,112920,Seward; Brandon M.,9,0,10,1
1668541629282,MATH 218,A00,098029,Li; Bo,10,0,10,0
1668541629710,MATH 220B,A00,098030,Novak; Jonathan I,11,0,15,4
1668541630137,MATH 221A,A00,098031,Ebenfelt; Peter F,12,0,15,3
1668541630562,MATH 231B,A00,098032,Zlatos; Andrej,10,0,15,5
1668541630985,MATH 240B,A00,098033,Ni; Lei,7,0,15,8
1668541631416,MATH 243,A00,098034,Jekel; David Andrew,10,0,10,0
1668541631844,MATH 245A,A00,098035,Nie; Jiawang,0,5,15,18
1668541632270,MATH 248,A00,098036,Bejenaru; Ioan,10,0,10,0
1668541632696,MATH 250B,A00,098037,Spolaor; Luca,14,0,15,1
1668541633128,MATH 258,A00,098038,Ni; Lei,9,0,10,1
1668541633557,MATH 264B,A00,098041,Rhoades; Brendon Patrick,8,0,15,7
1668541633993,MATH 268,A00,098042,Buss; Samuel R,10,0,10,0
1668541634420,MATH 269,A00,098043,Rhoades; Brendon Patrick,10,0,10,0
1668541634843,MATH 270B,A00,098044,Li; Bo,6,0,15,9
1668541635270,MATH 272B,A00,098045,Holst; Michael J,13,0,15,2
1668541635697,MATH 273A,A00,098046,Tian; Xiaochuan,10,0,15,5
1668541636130,MATH 275,A01,098048,Tian; Xiaochuan,6,0,10,4
1668541636558,MATH 278A,A00,098049,Holst; Michael J,6,0,10,4
1668541636984,MATH 278B,A00,098050,Cloninger; Alexander,10,0,10,0
1668541637411,MATH 278C,A00,098051,Nie; Jiawang,5,0,10,5
1668541637837,MATH 280B,A00,098052,Zheng; Tianyi,7,0,15,8
1668541638262,MATH 281B,A00,098053,Bradic; Jelena,0,2,15,15
1668541638686,MATH 282B,A00,098054,Arias-Castro; Ery,0,1,15,15
1668541639110,MATH 285,A00,098055,Fitzsimmons; Patrick J,0,4,15,17
1668541639533,MATH 287B,A00,098056,Arias-Castro; Ery,1,0,15,14
1668541639967,MATH 288,A00,098057,Agarwal; Pooja,9,0,10,1
1668541639967,MATH 288,B00,098058,Zhang; Danna,8,0,10,2
1668541639967,MATH 288,C00,098059,Williams; Ruth J,9,0,10,1
1668541640403,MATH 290B,A00,098060,Roberts; Justin Deritter,12,0,15,3
1668541640825,MATH 292,A00,098061,Belmont; Eva Kinoshita,10,0,10,0
1668541641250,MATH 295,A00,098062,Suk; Andrew Hoon,47,0,50,3
1668541641674,MATH 296,A00,098063,Novak; Jonathan I,20,0,20,0
1668541642099,MATH 297,001,098064,Gamst; Anthony Collins,9997,0,9999,2
1668542147418,COGS 205,A00,101395,Chiba; Andrea,19,0,20,1
1668542147842,COGS 210B,001,101404,Greene; Deanna Jacquelyn,9998,0,9999,1
1668542147842,COGS 210B,002,101417,Xia; Haijun,9999,0,9999,0
1668542147842,COGS 210B,003,101422,Nitz; Douglas A.,9999,0,9999,0
1668542147842,COGS 210B,004,101423,Hollan; James D.,9998,0,9999,1
1668542147842,COGS 210B,005,101424,Deak; Gedeon O.,9998,0,9999,1
1668542147842,COGS 210B,006,101425,Rossano; Federico,9999,0,9999,0
1668542148265,COGS 211B,A00,101427,Coulson; Seana M,9996,0,9999,3
1668542148689,COGS 220,A00,101428,Hollan; James D.,0,14,25,25
1668542149115,COGS 229,A00,101429,Dow; Steven P,17,0,25,8
1668542149541,COGS 230,A00,101430,Klemmer; Scott R,6,0,17,11
1668542149968,COGS 234,A00,101431,Xia; Haijun,0,1,25,25
1668542150401,COGS 260,A00,101432,Kiyonaga; Anastasia,21,0,25,4
1668542150401,COGS 260,B00,101433,Kirsh; David Joel,15,0,25,10
1668542150832,CSE 202,A00,102371,Impagliazzo; Russell,0,68,0,0
1668542151256,CSE 203B,A01,102373,Cheng; Chung Kuan,0,62,0,0
1668542151683,CSE 208,A00,102374,Micciancio; Daniele,0,5,0,0
1668542152106,CSE 209A,A00,112895,Impagliazzo; Russell,0,13,15,15
1668542152532,CSE 209B,A00,108005,Bellare; Mihir,0,7,0,0
1668542152962,CSE 210,A00,113163,Coblenz; Michael J,0,89,0,0
1668542153384,CSE 219,A00,106111,Dow; Steven P,0,8,20,20
1668542153807,CSE 221,A00,102376,Voelker; Geoffrey M.,0,75,0,0
1668542154233,CSE 224,A01,102378,Porter; George M,0,172,0,0
1668542154665,CSE 229A,A00,102379,Savage; Stefan,0,11,0,0
1668542155091,CSE 229C,A00,102380,Munyaka; Imani N. S.,0,10,0,0
1668542155515,CSE 232B,A00,102382,Deutsch; Alin Bernard,0,37,0,0
1668542156002,CSE 234,A01,112904,Kumar; Arun Kumar,0,0,0,0
1668542156426,CSE 237A,A00,102383,Rosing; Tajana Simunic,0,56,0,0
1668542156852,CSE 239A,A00,102384,Deutsch; Alin Bernard,0,16,0,0
1668542157277,CSE 239B,A00,102385,Polikarpova; Nadezhda,0,11,0,0
1668542157700,CSE 240A,A00,102386,Pannuto; Patrick William,0,47,0,0
1668542158135,CSE 240B,A00,102387,Zhao; Jishen,0,48,0,0
1668542158566,CSE 241A,A00,106406,Kang; Mingu,0,9,0,0
1668542158990,CSE 249B,A00,102388,Kahng; Andrew Byun,0,5,8,8
1668542159422,CSE 251B,A01,102392,Cottrell; Garrison W,0,52,0,0
1668542159422,CSE 251B,A02,102393,Cottrell; Garrison W,0,35,0,0
1668542159856,CSE 252B,A00,102394,Ochoa; Benjamin Lawrence,0,60,0,0
1668542160283,CSE 257,A01,102396,Gao; Sicun,0,147,0,0
1668542160709,CSE 272,A00,102397,Li; Tzumao,0,19,0,0
1668542161132,CSE 274,A00,111323,Chern; Albert Ren-Haur,0,15,0,0
1668542161558,CSE 282,A00,102398,Pevzner; Pavel Arkadjevich,0,0,0,0
1668542161982,CSE 284,A00,114175,Gymrek; Melissa Ann,0,25,0,0
1668542162415,CSE 290,A00,102399,Chandraker; Manmohan Krishna,0,11,0,0
1668542162415,CSE 290,B00,102400,Vaccaro; Kristen Marie,0,8,25,25
1668542162415,CSE 290,C00,102414,Pannuto; Patrick William,0,1,25,25
1668542162415,CSE 290,D00,102427,Pevzner; Pavel Arkadjevich,0,0,0,0
1668542162415,CSE 290,E00,102429,Zhao; Jishen,0,6,0,0
1668542162415,CSE 290,F00,102436,Tullsen; Dean Michael,0,6,0,0
1668542162415,CSE 290,G00,102440,Christensen; Henrik I,0,6,20,20
1668542162839,CSE 291,A00,102443,Su; Hao,0,0,0,0
1668542162839,CSE 291,B00,102448,Polikarpova; Nadezhda,0,0,0,0
1668542162839,CSE 291,C00,102453,Vaccaro; Kristen Marie,0,0,0,0
1668542162839,CSE 291,D00,111343,Savage; Stefan,0,0,0,0
1668542162839,CSE 291,E00,116474,Claffy; Kimberly Claire,0,0,0,0
1668542162839,CSE 291,F00,116479,Pasquale; Joseph,0,0,0,0
1668542163291,CSE 293,001,119111,Bafna; Vineet,9999,0,9999,0
1668542163291,CSE 293,002,119118,Bellare; Mihir,9999,0,9999,0
1668542163291,CSE 293,003,119122,Berg-Kirkpatrick; Taylor D,9999,0,9999,0
1668542163291,CSE 293,004,119135,Christensen; Henrik I,9999,0,9999,0
1668542163291,CSE 293,005,119142,Cottrell; Garrison W,9999,0,9999,0
1668542163291,CSE 293,006,119146,Deutsch; Alin Bernard,9999,0,9999,0
1668542163291,CSE 293,007,119159,Esmaeilzadeh; Hadi,9999,0,9999,0
1668542163291,CSE 293,008,119166,Freund; Yoav,9999,0,9999,0
1668542163291,CSE 293,009,119170,Griswold; William G.,9999,0,9999,0
1668542163291,CSE 293,010,119183,Gymrek; Melissa Ann,9999,0,9999,0
1668542163291,CSE 293,011,119190,Heninger; Nadia A,9999,0,9999,0
1668542163291,CSE 293,012,119230,Impagliazzo; Russell,9999,0,9999,0
1668542163291,CSE 293,013,119232,Jhala; Ranjit,9999,0,9999,0
1668542163291,CSE 293,014,119233,Kahng; Andrew Byun,9999,0,9999,0
1668542163291,CSE 293,015,119298,Kane; Daniel Mertz,9999,0,9999,0
1668542163291,CSE 293,016,119299,Kriegman; David J,9999,0,9999,0
1668542163291,CSE 293,017,119300,Kumar; Arun Kumar,9999,0,9999,0
1668542163291,CSE 293,018,119301,Lerner; Sorin,9999,0,9999,0
1668542163291,CSE 293,019,119302,Lovett; Shachar,9999,0,9999,0
1668542163291,CSE 293,020,119303,McAuley; Julian John,9999,0,9999,0
1668542163291,CSE 293,021,119304,Micciancio; Daniele,9999,0,9999,0
1668542163291,CSE 293,022,119367,Orailoglu; Alex,9999,0,9999,0
1668542163291,CSE 293,023,119382,Paturi; Ramamohan,9999,0,9999,0
1668542163291,CSE 293,024,119404,Polikarpova; Nadezhda,9999,0,9999,0
1668542163291,CSE 293,025,119406,Politz; Joseph Gibbs,9999,0,9999,0
1668542163291,CSE 293,026,119411,Porter; George M,9999,0,9999,0
1668542163291,CSE 293,027,119414,Porter; Leonard Emerson,9999,0,9999,0
1668542163291,CSE 293,028,119416,Ramamoorthi; Ravi,9999,0,9999,0
1668542163291,CSE 293,029,119417,Sahoo; Debashis,9999,0,9999,0
1668542163291,CSE 293,030,119420,Saul; Lawrence,9999,0,9999,0
1668542163291,CSE 293,031,119421,Savage; Stefan,9999,0,9999,0
1668542163291,CSE 293,032,119425,Schulze; Jurgen P.,9999,0,9999,0
1668542163291,CSE 293,033,119426,Snoeren; Alex C.,9999,0,9999,0
1668542163291,CSE 293,034,119428,Shang; Jingbo,9999,0,9999,0
1668542163291,CSE 293,035,119430,Stefan; Deian,9999,0,9999,0
1668542163291,CSE 293,036,119431,Su; Hao,9999,0,9999,0
1668542163291,CSE 293,037,119433,Swanson; Steven James,9999,0,9999,0
1668542163291,CSE 293,038,119435,Tullsen; Dean Michael,9999,0,9999,0
1668542163291,CSE 293,039,119483,Voelker; Geoffrey M.,9999,0,9999,0
1668542163291,CSE 293,040,119537,Zhao; Jishen,9999,0,9999,0
1668542163291,CSE 293,041,119538,Zhou; Yuan-Yuan,9999,0,9999,0
1668542163291,CSE 293,042,119539,Gao; Sicun,9999,0,9999,0
1668542163291,CSE 293,043,119540,Weibel; Nadir,9999,0,9999,0
1668542163291,CSE 293,044,119541,Gupta; Rajesh K.,9999,0,9999,0
1668542163291,CSE 293,045,126410,Vaccaro; Kristen Marie,9999,0,9999,0
1668542163291,CSE 293,046,126411,Klemke; Richard,9999,0,9999,0
1668542163715,CSE 294,A00,102459,Voelker; Geoffrey M.,0,2,0,0
1668542163715,CSE 294,B00,111322,Orailoglu; Alex,0,2,0,0
1668542164139,DSE 201,A00,096914,Deutsch; Alin Bernard,30,0,30,0
1668542164565,DSE 210,A00,096915,Dasgupta; Sanjoy,30,0,30,0
1668542164989,DSE 260A,A00,096916,Altintas De Callaf; Ilkay,30,0,30,0
1668542165428,ECE 200,001,103586,Antipa; Nicholas A,9999,0,9999,0
1668542165428,ECE 200,002,103587,Atanasov; Nikolay A.,9999,0,9999,0
1668542165428,ECE 200,003,103588,Bharadia; Dinesh,9999,0,9999,0
1668542165428,ECE 200,004,103589,Cheng; Chung Kuan,9999,0,9999,0
1668542165428,ECE 200,005,103590,Cosman; Pamela C.,9999,0,9999,0
1668542165428,ECE 200,006,103591,Dayeh; Shadi Ahmad,9999,0,9999,0
1668542165428,ECE 200,007,103592,Fainman; Yeshaiahu,9999,0,9999,0
1668542165428,ECE 200,008,103593,Ford; Joseph Earl,9999,0,9999,0
1668542165428,ECE 200,009,103594,Franceschetti; Massimo,9999,0,9999,0
1668542165428,ECE 200,010,103595,Fullerton; Eric E,9999,0,9999,0
1668542165428,ECE 200,011,103596,Galton; Ian A,9999,0,9999,0
1668542165428,ECE 200,012,103597,Gilja; Vikash,9999,0,9999,0
1668542165428,ECE 200,013,103598,Hall; Drew A.,9999,0,9999,0
1668542165428,ECE 200,014,103599,Hsueh; Tzu-Chien,9999,0,9999,0
1668542165428,ECE 200,015,103600,Javidi; Tara,9999,0,9999,0
1668542165428,ECE 200,016,103601,Kahng; Andrew Byun,9999,0,9999,0
1668542165428,ECE 200,017,103602,Kim; Young-Han,9999,0,9999,0
1668542165428,ECE 200,018,103603,Koushanfar; Farinaz,9999,0,9999,0
1668542165428,ECE 200,019,103604,Kuzum; Duygu,9999,0,9999,0
1668542165428,ECE 200,020,103605,Le; Hanh-Phuc,9999,0,9999,0
1668542165428,ECE 200,021,103606,Lin; Bill,9999,0,9999,0
1668542165428,ECE 200,022,103607,Liu; Zhaowei,9998,0,9999,1
1668542165428,ECE 200,023,103608,Lo; Yu-Hwa,9999,0,9999,0
1668542165428,ECE 200,024,103609,Lomakin; Vitaliy,9999,0,9999,0
1668542165428,ECE 200,025,103610,Mercier; Patrick Philip,9999,0,9999,0
1668542165428,ECE 200,026,103611,Meyer; Florian,9999,0,9999,0
1668542165428,ECE 200,027,103612,Milstein; Laurence B.,9999,0,9999,0
1668542165428,ECE 200,028,103613,Mir Arabbaygi; Siavash,9999,0,9999,0
1668542165428,ECE 200,029,103614,Mookherjea; Shayan,9999,0,9999,0
1668542165428,ECE 200,030,103615,Morris; Karcher William,9999,0,9999,0
1668542165428,ECE 200,031,103616,Ng; Tse Nga,9999,0,9999,0
1668542165428,ECE 200,032,103617,Nguyen; Truong Quang,9999,0,9999,0
1668542165428,ECE 200,033,103618,Nomura; Kenji,9999,0,9999,0
1668542165428,ECE 200,034,103619,Orlitsky; Alon,9999,0,9999,0
1668542165428,ECE 200,035,103620,Pal; Piya,9999,0,9999,0
1668542165428,ECE 200,036,103621,Papen; George C.,9999,0,9999,0
1668542165428,ECE 200,037,103622,Radic; Stojan,9999,0,9999,0
1668542165428,ECE 200,038,103623,Rao; Bhaskar D.,9999,0,9999,0
1668542165428,ECE 200,039,103624,Rao; Ramesh R,9999,0,9999,0
1668542165428,ECE 200,040,103625,Rebeiz; Gabriel,9999,0,9999,0
1668542165428,ECE 200,041,103626,Sanford; John R,9999,0,9999,0
1668542165428,ECE 200,042,103627,Siegel; Paul H.,9999,0,9999,0
1668542165428,ECE 200,043,103628,Sievenpiper; Daniel F.,9999,0,9999,0
1668542165428,ECE 200,044,103629,Sworder; David D.,9999,0,9999,0
1668542165428,ECE 200,045,103630,Taur; Yuan,9999,0,9999,0
1668542165428,ECE 200,046,103631,Touri; Behrouz,9999,0,9999,0
1668542165428,ECE 200,047,103632,Trivedi; Mohan M.,9999,0,9999,0
1668542165428,ECE 200,048,103633,Vasconcelos; Nuno,9999,0,9999,0
1668542165428,ECE 200,049,103634,Wang; Xiaolong,9999,0,9999,0
1668542165428,ECE 200,050,103635,Xie; Pengtao,9999,0,9999,0
1668542165428,ECE 200,051,103636,Yip; Michael,9999,0,9999,0
1668542165428,ECE 200,052,103637,Zeger; Kenneth A.,999,0,999,0
1668542165428,ECE 200,053,103638,Zhang; Xinyu,9999,0,9999,0
1668542165428,ECE 200,054,103639,Turakhia; Yatish Girish,9999,0,9999,0
1668542165428,ECE 200,055,103640,Kang; Mingu,9999,0,9999,0
1668542165428,ECE 200,056,103641,Shi; Yuanyuan,9999,0,9999,0
1668542165428,ECE 200,057,103642,Wang; Edward Jay,9999,0,9999,0
1668542165428,ECE 200,058,103643,Zheng; Yang,9999,0,9999,0
1668542165859,ECE 202,A00,103644,Kuzum; Duygu,0,45,0,0
1668542166283,ECE 212BN,A00,103646,Ng; Tse Nga,0,9,0,0
1668542166713,ECE 221,A00,111493,Staff,0,0,0,0
1668542167227,ECE 222B,A00,103647,Lomakin; Vitaliy,0,20,0,0
1668542167654,ECE 230B,A00,103648,Taur; Yuan,0,3,0,0
1668542168087,ECE 238B,A00,103649,Garay; Javier,0,0,0,0
1668542168512,ECE 240B,A00,112900,Fainman; Yeshaiahu,0,7,0,0
1668542168946,ECE 247A,A00,103650,Jokerst; Jesse Vincent,0,6,0,0
1668542169369,ECE 247B,A00,103651,Wang; Joseph,0,14,0,0
1668542169806,ECE 250,A00,103652,Siegel; Paul H.,0,82,0,0
1668542170234,ECE 251A,A00,103654,Rao; Bhaskar D.,0,62,0,0
1668542170657,ECE 257B,A00,103655,Bharadia; Dinesh,0,33,0,0
1668542171083,ECE 258A,A00,103656,Milstein; Laurence B.,0,29,0,0
1668542171512,ECE 260B,A00,103658,Kang; Mingu,0,123,0,0
1668542171938,ECE 264A,A00,103659,Galton; Ian A,0,71,0,0
1668542172363,ECE 265A,A00,103661,Gudem; Prasad S.S.,0,73,0,0
1668542172795,ECE 265D,A00,103662,Gudem; Prasad S.S.,0,26,0,0
1668542173218,ECE 268,A00,103663,Koushanfar; Farinaz,0,43,0,0
1668542173640,ECE 269,A01,103665,Pal; Piya,0,218,0,0
1668542174076,ECE 271B,A00,103666,Vasconcelos; Manuela,0,78,0,0
1668542174522,ECE 276A,A00,103667,Atanasov; Nikolay A.,0,127,0,0
1668542174958,ECE 277,A00,103668,An; Cheolhong,0,150,0,0
1668542175389,ECE 279,A00,117947,Hall; Drew A.,0,22,0,0
1668542176240,ECE 283,A00,103670,Hsueh; Tzu-Chien,0,57,0,0
1668542176668,ECE 284,A00,103671,Turakhia; Yatish Girish,0,40,0,0
1668542177096,ECE 285,A00,103672,Zheng; Yang,0,40,0,0
1668542177096,ECE 285,B00,103673,Sworder; David D.,0,60,0,0
1668542177522,ECE 287,A00,103676,Javidi; Tara,0,9,0,0
1668542177953,MATH 200B,A00,098023,Salehi Golsefidy; Alireza,10,0,15,5
1668542178376,MATH 202B,A00,098024,Rhoades; Brendon Patrick,7,0,15,8
1668542178809,MATH 203B,A00,098025,Oprea; Dragos N.,9,0,15,6
1668542179233,MATH 204B,A00,098026,Sorensen; Claus M,13,0,15,2
1668542179657,MATH 208,A00,098027,Izadi; Elham,7,0,10,3
1668542180081,MATH 209,A00,098028,Pollack; Aaron,10,0,10,0
1668542180507,MATH 211A,A00,112919,Rogalski; Daniel,8,0,10,2
1668542180930,MATH 211B,A00,112920,Seward; Brandon M.,9,0,10,1
1668542181354,MATH 218,A00,098029,Li; Bo,10,0,10,0
1668542181775,MATH 220B,A00,098030,Novak; Jonathan I,11,0,15,4
1668542182202,MATH 221A,A00,098031,Ebenfelt; Peter F,12,0,15,3
1668542182623,MATH 231B,A00,098032,Zlatos; Andrej,10,0,15,5
1668542183049,MATH 240B,A00,098033,Ni; Lei,7,0,15,8
1668542183475,MATH 243,A00,098034,Jekel; David Andrew,10,0,10,0
1668542183900,MATH 245A,A00,098035,Nie; Jiawang,0,5,15,18
1668542184336,MATH 248,A00,098036,Bejenaru; Ioan,10,0,10,0
1668542184758,MATH 250B,A00,098037,Spolaor; Luca,14,0,15,1
1668542185198,MATH 258,A00,098038,Ni; Lei,9,0,10,1
1668542185630,MATH 264B,A00,098041,Rhoades; Brendon Patrick,8,0,15,7
1668542186060,MATH 268,A00,098042,Buss; Samuel R,10,0,10,0
1668542186483,MATH 269,A00,098043,Rhoades; Brendon Patrick,10,0,10,0
1668542186913,MATH 270B,A00,098044,Li; Bo,6,0,15,9
1668542187350,MATH 272B,A00,098045,Holst; Michael J,13,0,15,2
1668542187775,MATH 273A,A00,098046,Tian; Xiaochuan,10,0,15,5
1668542188202,MATH 275,A01,098048,Tian; Xiaochuan,6,0,10,4
1668542188628,MATH 278A,A00,098049,Holst; Michael J,6,0,10,4
1668542189059,MATH 278B,A00,098050,Cloninger; Alexander,10,0,10,0
1668542189481,MATH 278C,A00,098051,Nie; Jiawang,5,0,10,5
1668542189909,MATH 280B,A00,098052,Zheng; Tianyi,7,0,15,8
1668542190334,MATH 281B,A00,098053,Bradic; Jelena,0,2,15,15
1668542190757,MATH 282B,A00,098054,Arias-Castro; Ery,0,1,15,15
1668542191185,MATH 285,A00,098055,Fitzsimmons; Patrick J,0,4,15,17
1668542191615,MATH 287B,A00,098056,Arias-Castro; Ery,1,0,15,14
1668542192046,MATH 288,A00,098057,Agarwal; Pooja,9,0,10,1
1668542192046,MATH 288,B00,098058,Zhang; Danna,8,0,10,2
1668542192046,MATH 288,C00,098059,Williams; Ruth J,9,0,10,1
1668542192495,MATH 290B,A00,098060,Roberts; Justin Deritter,12,0,15,3
1668542192916,MATH 292,A00,098061,Belmont; Eva Kinoshita,10,0,10,0
1668542193339,MATH 295,A00,098062,Suk; Andrew Hoon,47,0,50,3
1668542193765,MATH 296,A00,098063,Novak; Jonathan I,20,0,20,0
1668542194187,MATH 297,001,098064,Gamst; Anthony Collins,9997,0,9999,2
1668542702534,COGS 205,A00,101395,Chiba; Andrea,19,0,20,1
1668542702958,COGS 210B,001,101404,Greene; Deanna Jacquelyn,9998,0,9999,1
1668542702958,COGS 210B,002,101417,Xia; Haijun,9999,0,9999,0
1668542702958,COGS 210B,003,101422,Nitz; Douglas A.,9999,0,9999,0
1668542702958,COGS 210B,004,101423,Hollan; James D.,9998,0,9999,1
1668542702958,COGS 210B,005,101424,Deak; Gedeon O.,9998,0,9999,1
1668542702958,COGS 210B,006,101425,Rossano; Federico,9999,0,9999,0
1668542703381,COGS 211B,A00,101427,Coulson; Seana M,9996,0,9999,3
1668542703822,COGS 220,A00,101428,Hollan; James D.,0,14,25,25
1668542704248,COGS 229,A00,101429,Dow; Steven P,17,0,25,8
1668542704676,COGS 230,A00,101430,Klemmer; Scott R,6,0,17,11
1668542705109,COGS 234,A00,101431,Xia; Haijun,0,1,25,25
1668542705538,COGS 260,A00,101432,Kiyonaga; Anastasia,21,0,25,4
1668542705538,COGS 260,B00,101433,Kirsh; David Joel,15,0,25,10
1668542705961,CSE 202,A00,102371,Impagliazzo; Russell,0,68,0,0
1668542706393,CSE 203B,A01,102373,Cheng; Chung Kuan,0,62,0,0
1668542706817,CSE 208,A00,102374,Micciancio; Daniele,0,5,0,0
1668542707250,CSE 209A,A00,112895,Impagliazzo; Russell,0,13,15,15
1668542707671,CSE 209B,A00,108005,Bellare; Mihir,0,7,0,0
1668542708122,CSE 210,A00,113163,Coblenz; Michael J,0,89,0,0
1668542708547,CSE 219,A00,106111,Dow; Steven P,0,8,20,20
1668542708971,CSE 221,A00,102376,Voelker; Geoffrey M.,0,75,0,0
1668542709393,CSE 224,A01,102378,Porter; George M,0,172,0,0
1668542709816,CSE 229A,A00,102379,Savage; Stefan,0,11,0,0
1668542710245,CSE 229C,A00,102380,Munyaka; Imani N. S.,0,10,0,0
1668542710668,CSE 232B,A00,102382,Deutsch; Alin Bernard,0,37,0,0
1668542711096,CSE 234,A01,112904,Kumar; Arun Kumar,0,0,0,0
1668542711522,CSE 237A,A00,102383,Rosing; Tajana Simunic,0,56,0,0
1668542711945,CSE 239A,A00,102384,Deutsch; Alin Bernard,0,16,0,0
1668542712369,CSE 239B,A00,102385,Polikarpova; Nadezhda,0,11,0,0
1668542712799,CSE 240A,A00,102386,Pannuto; Patrick William,0,47,0,0
1668542713224,CSE 240B,A00,102387,Zhao; Jishen,0,48,0,0
1668542713647,CSE 241A,A00,106406,Kang; Mingu,0,9,0,0
1668542714075,CSE 249B,A00,102388,Kahng; Andrew Byun,0,5,8,8
1668542714502,CSE 251B,A01,102392,Cottrell; Garrison W,0,52,0,0
1668542714502,CSE 251B,A02,102393,Cottrell; Garrison W,0,35,0,0
1668542714928,CSE 252B,A00,102394,Ochoa; Benjamin Lawrence,0,60,0,0
1668542715354,CSE 257,A01,102396,Gao; Sicun,0,148,0,0
1668542715776,CSE 272,A00,102397,Li; Tzumao,0,19,0,0
1668542716233,CSE 274,A00,111323,Chern; Albert Ren-Haur,0,15,0,0
1668542716655,CSE 282,A00,102398,Pevzner; Pavel Arkadjevich,0,0,0,0
1668542717080,CSE 284,A00,114175,Gymrek; Melissa Ann,0,25,0,0
1668542717507,CSE 290,A00,102399,Chandraker; Manmohan Krishna,0,11,0,0
1668542717507,CSE 290,B00,102400,Vaccaro; Kristen Marie,0,8,25,25
1668542717507,CSE 290,C00,102414,Pannuto; Patrick William,0,1,25,25
1668542717507,CSE 290,D00,102427,Pevzner; Pavel Arkadjevich,0,0,0,0
1668542717507,CSE 290,E00,102429,Zhao; Jishen,0,6,0,0
1668542717507,CSE 290,F00,102436,Tullsen; Dean Michael,0,6,0,0
1668542717507,CSE 290,G00,102440,Christensen; Henrik I,0,6,20,20
1668542717929,CSE 291,A00,102443,Su; Hao,0,0,0,0
1668542717929,CSE 291,B00,102448,Polikarpova; Nadezhda,0,0,0,0
1668542717929,CSE 291,C00,102453,Vaccaro; Kristen Marie,0,0,0,0
1668542717929,CSE 291,D00,111343,Savage; Stefan,0,0,0,0
1668542717929,CSE 291,E00,116474,Claffy; Kimberly Claire,0,0,0,0
1668542717929,CSE 291,F00,116479,Pasquale; Joseph,0,0,0,0
1668542718354,CSE 293,001,119111,Bafna; Vineet,9999,0,9999,0
1668542718354,CSE 293,002,119118,Bellare; Mihir,9999,0,9999,0
1668542718354,CSE 293,003,119122,Berg-Kirkpatrick; Taylor D,9999,0,9999,0
1668542718354,CSE 293,004,119135,Christensen; Henrik I,9999,0,9999,0
1668542718354,CSE 293,005,119142,Cottrell; Garrison W,9999,0,9999,0
1668542718354,CSE 293,006,119146,Deutsch; Alin Bernard,9999,0,9999,0
1668542718354,CSE 293,007,119159,Esmaeilzadeh; Hadi,9999,0,9999,0
1668542718354,CSE 293,008,119166,Freund; Yoav,9999,0,9999,0
1668542718354,CSE 293,009,119170,Griswold; William G.,9999,0,9999,0
1668542718354,CSE 293,010,119183,Gymrek; Melissa Ann,9999,0,9999,0
1668542718354,CSE 293,011,119190,Heninger; Nadia A,9999,0,9999,0
1668542718354,CSE 293,012,119230,Impagliazzo; Russell,9999,0,9999,0
1668542718354,CSE 293,013,119232,Jhala; Ranjit,9999,0,9999,0
1668542718354,CSE 293,014,119233,Kahng; Andrew Byun,9999,0,9999,0
1668542718354,CSE 293,015,119298,Kane; Daniel Mertz,9999,0,9999,0
1668542718354,CSE 293,016,119299,Kriegman; David J,9999,0,9999,0
1668542718354,CSE 293,017,119300,Kumar; Arun Kumar,9999,0,9999,0
1668542718354,CSE 293,018,119301,Lerner; Sorin,9999,0,9999,0
1668542718354,CSE 293,019,119302,Lovett; Shachar,9999,0,9999,0
1668542718354,CSE 293,020,119303,McAuley; Julian John,9999,0,9999,0
1668542718354,CSE 293,021,119304,Micciancio; Daniele,9999,0,9999,0
1668542718354,CSE 293,022,119367,Orailoglu; Alex,9999,0,9999,0
1668542718354,CSE 293,023,119382,Paturi; Ramamohan,9999,0,9999,0
1668542718354,CSE 293,024,119404,Polikarpova; Nadezhda,9999,0,9999,0
1668542718354,CSE 293,025,119406,Politz; Joseph Gibbs,9999,0,9999,0
1668542718354,CSE 293,026,119411,Porter; George M,9999,0,9999,0
1668542718354,CSE 293,027,119414,Porter; Leonard Emerson,9999,0,9999,0
1668542718354,CSE 293,028,119416,Ramamoorthi; Ravi,9999,0,9999,0
1668542718354,CSE 293,029,119417,Sahoo; Debashis,9999,0,9999,0
1668542718354,CSE 293,030,119420,Saul; Lawrence,9999,0,9999,0
1668542718354,CSE 293,031,119421,Savage; Stefan,9999,0,9999,0
1668542718354,CSE 293,032,119425,Schulze; Jurgen P.,9999,0,9999,0
1668542718354,CSE 293,033,119426,Snoeren; Alex C.,9999,0,9999,0
1668542718354,CSE 293,034,119428,Shang; Jingbo,9999,0,9999,0
1668542718354,CSE 293,035,119430,Stefan; Deian,9999,0,9999,0
1668542718354,CSE 293,036,119431,Su; Hao,9999,0,9999,0
1668542718354,CSE 293,037,119433,Swanson; Steven James,9999,0,9999,0
1668542718354,CSE 293,038,119435,Tullsen; Dean Michael,9999,0,9999,0
1668542718354,CSE 293,039,119483,Voelker; Geoffrey M.,9999,0,9999,0
1668542718354,CSE 293,040,119537,Zhao; Jishen,9999,0,9999,0
1668542718354,CSE 293,041,119538,Zhou; Yuan-Yuan,9999,0,9999,0
1668542718354,CSE 293,042,119539,Gao; Sicun,9999,0,9999,0
1668542718354,CSE 293,043,119540,Weibel; Nadir,9999,0,9999,0
1668542718354,CSE 293,044,119541,Gupta; Rajesh K.,9999,0,9999,0
1668542718354,CSE 293,045,126410,Vaccaro; Kristen Marie,9999,0,9999,0
1668542718354,CSE 293,046,126411,Klemke; Richard,9999,0,9999,0
1668542718781,CSE 294,A00,102459,Voelker; Geoffrey M.,0,2,0,0
1668542718781,CSE 294,B00,111322,Orailoglu; Alex,0,2,0,0
1668542719206,DSE 201,A00,096914,Deutsch; Alin Bernard,30,0,30,0
1668542719635,DSE 210,A00,096915,Dasgupta; Sanjoy,30,0,30,0
1668542720074,DSE 260A,A00,096916,Altintas De Callaf; Ilkay,30,0,30,0
1668542720528,ECE 200,001,103586,Antipa; Nicholas A,9999,0,9999,0
1668542720528,ECE 200,002,103587,Atanasov; Nikolay A.,9999,0,9999,0
1668542720528,ECE 200,003,103588,Bharadia; Dinesh,9999,0,9999,0
1668542720528,ECE 200,004,103589,Cheng; Chung Kuan,9999,0,9999,0
1668542720528,ECE 200,005,103590,Cosman; Pamela C.,9999,0,9999,0
1668542720528,ECE 200,006,103591,Dayeh; Shadi Ahmad,9999,0,9999,0
1668542720528,ECE 200,007,103592,Fainman; Yeshaiahu,9999,0,9999,0
1668542720528,ECE 200,008,103593,Ford; Joseph Earl,9999,0,9999,0
1668542720528,ECE 200,009,103594,Franceschetti; Massimo,9999,0,9999,0
1668542720528,ECE 200,010,103595,Fullerton; Eric E,9999,0,9999,0
1668542720528,ECE 200,011,103596,Galton; Ian A,9999,0,9999,0
1668542720528,ECE 200,012,103597,Gilja; Vikash,9999,0,9999,0
1668542720528,ECE 200,013,103598,Hall; Drew A.,9999,0,9999,0
1668542720528,ECE 200,014,103599,Hsueh; Tzu-Chien,9999,0,9999,0
1668542720528,ECE 200,015,103600,Javidi; Tara,9999,0,9999,0
1668542720528,ECE 200,016,103601,Kahng; Andrew Byun,9999,0,9999,0
1668542720528,ECE 200,017,103602,Kim; Young-Han,9999,0,9999,0
1668542720528,ECE 200,018,103603,Koushanfar; Farinaz,9999,0,9999,0
1668542720528,ECE 200,019,103604,Kuzum; Duygu,9999,0,9999,0
1668542720528,ECE 200,020,103605,Le; Hanh-Phuc,9999,0,9999,0
1668542720528,ECE 200,021,103606,Lin; Bill,9999,0,9999,0
1668542720528,ECE 200,022,103607,Liu; Zhaowei,9998,0,9999,1
1668542720528,ECE 200,023,103608,Lo; Yu-Hwa,9999,0,9999,0
1668542720528,ECE 200,024,103609,Lomakin; Vitaliy,9999,0,9999,0
1668542720528,ECE 200,025,103610,Mercier; Patrick Philip,9999,0,9999,0
1668542720528,ECE 200,026,103611,Meyer; Florian,9999,0,9999,0
1668542720528,ECE 200,027,103612,Milstein; Laurence B.,9999,0,9999,0
1668542720528,ECE 200,028,103613,Mir Arabbaygi; Siavash,9999,0,9999,0
1668542720528,ECE 200,029,103614,Mookherjea; Shayan,9999,0,9999,0
1668542720528,ECE 200,030,103615,Morris; Karcher William,9999,0,9999,0
1668542720528,ECE 200,031,103616,Ng; Tse Nga,9999,0,9999,0
1668542720528,ECE 200,032,103617,Nguyen; Truong Quang,9999,0,9999,0
1668542720528,ECE 200,033,103618,Nomura; Kenji,9999,0,9999,0
1668542720528,ECE 200,034,103619,Orlitsky; Alon,9999,0,9999,0
1668542720528,ECE 200,035,103620,Pal; Piya,9999,0,9999,0
1668542720528,ECE 200,036,103621,Papen; George C.,9999,0,9999,0
1668542720528,ECE 200,037,103622,Radic; Stojan,9999,0,9999,0
1668542720528,ECE 200,038,103623,Rao; Bhaskar D.,9999,0,9999,0
1668542720528,ECE 200,039,103624,Rao; Ramesh R,9999,0,9999,0
1668542720528,ECE 200,040,103625,Rebeiz; Gabriel,9999,0,9999,0
1668542720528,ECE 200,041,103626,Sanford; John R,9999,0,9999,0
1668542720528,ECE 200,042,103627,Siegel; Paul H.,9999,0,9999,0
1668542720528,ECE 200,043,103628,Sievenpiper; Daniel F.,9999,0,9999,0
1668542720528,ECE 200,044,103629,Sworder; David D.,9999,0,9999,0
1668542720528,ECE 200,045,103630,Taur; Yuan,9999,0,9999,0
1668542720528,ECE 200,046,103631,Touri; Behrouz,9999,0,9999,0
1668542720528,ECE 200,047,103632,Trivedi; Mohan M.,9999,0,9999,0
1668542720528,ECE 200,048,103633,Vasconcelos; Nuno,9999,0,9999,0
1668542720528,ECE 200,049,103634,Wang; Xiaolong,9999,0,9999,0
1668542720528,ECE 200,050,103635,Xie; Pengtao,9999,0,9999,0
1668542720528,ECE 200,051,103636,Yip; Michael,9999,0,9999,0
1668542720528,ECE 200,052,103637,Zeger; Kenneth A.,999,0,999,0
1668542720528,ECE 200,053,103638,Zhang; Xinyu,9999,0,9999,0
1668542720528,ECE 200,054,103639,Turakhia; Yatish Girish,9999,0,9999,0
1668542720528,ECE 200,055,103640,Kang; Mingu,9999,0,9999,0
1668542720528,ECE 200,056,103641,Shi; Yuanyuan,9999,0,9999,0
1668542720528,ECE 200,057,103642,Wang; Edward Jay,9999,0,9999,0
1668542720528,ECE 200,058,103643,Zheng; Yang,9999,0,9999,0
1668542720954,ECE 202,A00,103644,Kuzum; Duygu,0,45,0,0
1668542721387,ECE 212BN,A00,103646,Ng; Tse Nga,0,9,0,0
1668542721812,ECE 221,A00,111493,Staff,0,0,0,0
1668542722243,ECE 222B,A00,103647,Lomakin; Vitaliy,0,20,0,0
1668542722666,ECE 230B,A00,103648,Taur; Yuan,0,3,0,0
1668542723111,ECE 238B,A00,103649,Garay; Javier,0,0,0,0
1668542723535,ECE 240B,A00,112900,Fainman; Yeshaiahu,0,7,0,0
1668542723962,ECE 247A,A00,103650,Jokerst; Jesse Vincent,0,6,0,0
1668542724388,ECE 247B,A00,103651,Wang; Joseph,0,14,0,0
1668542724812,ECE 250,A00,103652,Siegel; Paul H.,0,82,0,0
1668542725235,ECE 251A,A00,103654,Rao; Bhaskar D.,0,62,0,0
1668542725659,ECE 257B,A00,103655,Bharadia; Dinesh,0,33,0,0
1668542726089,ECE 258A,A00,103656,Milstein; Laurence B.,0,29,0,0
1668542726515,ECE 260B,A00,103658,Kang; Mingu,0,123,0,0
1668542726941,ECE 264A,A00,103659,Galton; Ian A,0,71,0,0
1668542727375,ECE 265A,A00,103661,Gudem; Prasad S.S.,0,73,0,0
1668542727809,ECE 265D,A00,103662,Gudem; Prasad S.S.,0,26,0,0
1668542728247,ECE 268,A00,103663,Koushanfar; Farinaz,0,43,0,0
1668542728691,ECE 269,A01,103665,Pal; Piya,0,218,0,0
1668542729123,ECE 271B,A00,103666,Vasconcelos; Manuela,0,78,0,0
1668542729550,ECE 276A,A00,103667,Atanasov; Nikolay A.,0,127,0,0
1668542729972,ECE 277,A00,103668,An; Cheolhong,0,150,0,0
1668542730398,ECE 279,A00,117947,Hall; Drew A.,0,22,0,0
1668542731259,ECE 283,A00,103670,Hsueh; Tzu-Chien,0,57,0,0
1668542731682,ECE 284,A00,103671,Turakhia; Yatish Girish,0,40,0,0
1668542732105,ECE 285,A00,103672,Zheng; Yang,0,40,0,0
1668542732105,ECE 285,B00,103673,Sworder; David D.,0,60,0,0
1668542732545,ECE 287,A00,103676,Javidi; Tara,0,9,0,0
1668542732973,MATH 200B,A00,098023,Salehi Golsefidy; Alireza,10,0,15,5
1668542733400,MATH 202B,A00,098024,Rhoades; Brendon Patrick,7,0,15,8
1668542733824,MATH 203B,A00,098025,Oprea; Dragos N.,9,0,15,6
1668542734247,MATH 204B,A00,098026,Sorensen; Claus M,13,0,15,2
1668542734674,MATH 208,A00,098027,Izadi; Elham,7,0,10,3
1668542735106,MATH 209,A00,098028,Pollack; Aaron,10,0,10,0
1668542735532,MATH 211A,A00,112919,Rogalski; Daniel,8,0,10,2
1668542735953,MATH 211B,A00,112920,Seward; Brandon M.,9,0,10,1
1668542736382,MATH 218,A00,098029,Li; Bo,10,0,10,0
1668542736807,MATH 220B,A00,098030,Novak; Jonathan I,11,0,15,4
1668542737327,MATH 221A,A00,098031,Ebenfelt; Peter F,12,0,15,3
1668542737748,MATH 231B,A00,098032,Zlatos; Andrej,10,0,15,5
1668542738190,MATH 240B,A00,098033,Ni; Lei,7,0,15,8
1668542738615,MATH 243,A00,098034,Jekel; David Andrew,10,0,10,0
1668542739043,MATH 245A,A00,098035,Nie; Jiawang,0,5,15,18
1668542739468,MATH 248,A00,098036,Bejenaru; Ioan,10,0,10,0
1668542739891,MATH 250B,A00,098037,Spolaor; Luca,14,0,15,1
1668542740317,MATH 258,A00,098038,Ni; Lei,9,0,10,1
1668542740742,MATH 264B,A00,098041,Rhoades; Brendon Patrick,8,0,15,7
1668542741167,MATH 268,A00,098042,Buss; Samuel R,10,0,10,0
1668542741594,MATH 269,A00,098043,Rhoades; Brendon Patrick,10,0,10,0
1668542742019,MATH 270B,A00,098044,Li; Bo,6,0,15,9
1668542742443,MATH 272B,A00,098045,Holst; Michael J,13,0,15,2
1668542742869,MATH 273A,A00,098046,Tian; Xiaochuan,10,0,15,5
1668542743295,MATH 275,A01,098048,Tian; Xiaochuan,6,0,10,4
1668542743722,MATH 278A,A00,098049,Holst; Michael J,6,0,10,4
1668542744159,MATH 278B,A00,098050,Cloninger; Alexander,10,0,10,0
1668542744585,MATH 278C,A00,098051,Nie; Jiawang,5,0,10,5
1668542745022,MATH 280B,A00,098052,Zheng; Tianyi,7,0,15,8
1668542745446,MATH 281B,A00,098053,Bradic; Jelena,0,2,15,15
1668542745885,MATH 282B,A00,098054,Arias-Castro; Ery,0,1,15,15
1668542746327,MATH 285,A00,098055,Fitzsimmons; Patrick J,0,4,15,17
1668542746761,MATH 287B,A00,098056,Arias-Castro; Ery,1,0,15,14
1668542747186,MATH 288,A00,098057,Agarwal; Pooja,9,0,10,1
1668542747186,MATH 288,B00,098058,Zhang; Danna,8,0,10,2
1668542747186,MATH 288,C00,098059,Williams; Ruth J,9,0,10,1
1668542747609,MATH 290B,A00,098060,Roberts; Justin Deritter,12,0,15,3
1668542748044,MATH 292,A00,098061,Belmont; Eva Kinoshita,10,0,10,0
1668542748473,MATH 295,A00,098062,Suk; Andrew Hoon,47,0,50,3
1668542748900,MATH 296,A00,098063,Novak; Jonathan I,20,0,20,0
1668542749325,MATH 297,001,098064,Gamst; Anthony Collins,9997,0,9999,2
1668543254215,COGS 205,A00,101395,Chiba; Andrea,19,0,20,1
1668543254641,COGS 210B,001,101404,Greene; Deanna Jacquelyn,9998,0,9999,1
1668543254641,COGS 210B,002,101417,Xia; Haijun,9999,0,9999,0
1668543254641,COGS 210B,003,101422,Nitz; Douglas A.,9999,0,9999,0
1668543254641,COGS 210B,004,101423,Hollan; James D.,9998,0,9999,1
1668543254641,COGS 210B,005,101424,Deak; Gedeon O.,9998,0,9999,1
1668543254641,COGS 210B,006,101425,Rossano; Federico,9999,0,9999,0
1668543255070,COGS 211B,A00,101427,Coulson; Seana M,9996,0,9999,3
1668543255493,COGS 220,A00,101428,Hollan; James D.,0,14,25,25
1668543255915,COGS 229,A00,101429,Dow; Steven P,17,0,25,8
1668543256357,COGS 230,A00,101430,Klemmer; Scott R,6,0,17,11
1668543256779,COGS 234,A00,101431,Xia; Haijun,0,1,25,25
1668543257208,COGS 260,A00,101432,Kiyonaga; Anastasia,21,0,25,4
1668543257208,COGS 260,B00,101433,Kirsh; David Joel,15,0,25,10
1668543257664,CSE 202,A00,102371,Impagliazzo; Russell,0,68,0,0
1668543258094,CSE 203B,A01,102373,Cheng; Chung Kuan,0,62,0,0
1668543258523,CSE 208,A00,102374,Micciancio; Daniele,0,5,0,0
1668543258948,CSE 209A,A00,112895,Impagliazzo; Russell,0,13,15,15
1668543259383,CSE 209B,A00,108005,Bellare; Mihir,0,7,0,0
1668543259821,CSE 210,A00,113163,Coblenz; Michael J,0,89,0,0
1668543260252,CSE 219,A00,106111,Dow; Steven P,0,8,20,20
1668543261264,CSE 221,A00,102376,Voelker; Geoffrey M.,0,75,0,0
1668543261700,CSE 224,A01,102378,Porter; George M,0,172,0,0
1668543262148,CSE 229A,A00,102379,Savage; Stefan,0,11,0,0
1668543262570,CSE 229C,A00,102380,Munyaka; Imani N. S.,0,10,0,0
1668543262996,CSE 232B,A00,102382,Deutsch; Alin Bernard,0,37,0,0
1668543263424,CSE 234,A01,112904,Kumar; Arun Kumar,0,0,0,0
1668543263856,CSE 237A,A00,102383,Rosing; Tajana Simunic,0,56,0,0
1668543264279,CSE 239A,A00,102384,Deutsch; Alin Bernard,0,16,0,0
1668543264702,CSE 239B,A00,102385,Polikarpova; Nadezhda,0,11,0,0
1668543265134,CSE 240A,A00,102386,Pannuto; Patrick William,0,47,0,0
1668543265569,CSE 240B,A00,102387,Zhao; Jishen,0,49,0,0
1668543265993,CSE 241A,A00,106406,Kang; Mingu,0,9,0,0
1668543266419,CSE 249B,A00,102388,Kahng; Andrew Byun,0,5,8,8
1668543266844,CSE 251B,A01,102392,Cottrell; Garrison W,0,52,0,0
1668543266844,CSE 251B,A02,102393,Cottrell; Garrison W,0,35,0,0
1668543267284,CSE 252B,A00,102394,Ochoa; Benjamin Lawrence,0,61,0,0
1668543267715,CSE 257,A01,102396,Gao; Sicun,0,149,0,0
1668543268141,CSE 272,A00,102397,Li; Tzumao,0,19,0,0
1668543268575,CSE 274,A00,111323,Chern; Albert Ren-Haur,0,15,0,0
1668543269002,CSE 282,A00,102398,Pevzner; Pavel Arkadjevich,0,0,0,0
1668543269429,CSE 284,A00,114175,Gymrek; Melissa Ann,0,25,0,0
1668543269865,CSE 290,A00,102399,Chandraker; Manmohan Krishna,0,11,0,0
1668543269865,CSE 290,B00,102400,Vaccaro; Kristen Marie,0,8,25,25
1668543269865,CSE 290,C00,102414,Pannuto; Patrick William,0,1,25,25
1668543269865,CSE 290,D00,102427,Pevzner; Pavel Arkadjevich,0,0,0,0
1668543269865,CSE 290,E00,102429,Zhao; Jishen,0,6,0,0
1668543269865,CSE 290,F00,102436,Tullsen; Dean Michael,0,6,0,0
1668543269865,CSE 290,G00,102440,Christensen; Henrik I,0,6,20,20
1668543270302,CSE 291,A00,102443,Su; Hao,0,0,0,0
1668543270302,CSE 291,B00,102448,Polikarpova; Nadezhda,0,0,0,0
1668543270302,CSE 291,C00,102453,Vaccaro; Kristen Marie,0,0,0,0
1668543270302,CSE 291,D00,111343,Savage; Stefan,0,0,0,0
1668543270302,CSE 291,E00,116474,Claffy; Kimberly Claire,0,0,0,0
1668543270302,CSE 291,F00,116479,Pasquale; Joseph,0,0,0,0
1668543270741,CSE 293,001,119111,Bafna; Vineet,9999,0,9999,0
1668543270741,CSE 293,002,119118,Bellare; Mihir,9999,0,9999,0
1668543270741,CSE 293,003,119122,Berg-Kirkpatrick; Taylor D,9999,0,9999,0
1668543270741,CSE 293,004,119135,Christensen; Henrik I,9999,0,9999,0
1668543270741,CSE 293,005,119142,Cottrell; Garrison W,9999,0,9999,0
1668543270741,CSE 293,006,119146,Deutsch; Alin Bernard,9999,0,9999,0
1668543270741,CSE 293,007,119159,Esmaeilzadeh; Hadi,9999,0,9999,0
1668543270741,CSE 293,008,119166,Freund; Yoav,9999,0,9999,0
1668543270741,CSE 293,009,119170,Griswold; William G.,9999,0,9999,0
1668543270741,CSE 293,010,119183,Gymrek; Melissa Ann,9999,0,9999,0
1668543270741,CSE 293,011,119190,Heninger; Nadia A,9999,0,9999,0
1668543270741,CSE 293,012,119230,Impagliazzo; Russell,9999,0,9999,0
1668543270741,CSE 293,013,119232,Jhala; Ranjit,9999,0,9999,0
1668543270741,CSE 293,014,119233,Kahng; Andrew Byun,9999,0,9999,0
1668543270741,CSE 293,015,119298,Kane; Daniel Mertz,9999,0,9999,0
1668543270741,CSE 293,016,119299,Kriegman; David J,9999,0,9999,0
1668543270741,CSE 293,017,119300,Kumar; Arun Kumar,9999,0,9999,0
1668543270741,CSE 293,018,119301,Lerner; Sorin,9999,0,9999,0
1668543270741,CSE 293,019,119302,Lovett; Shachar,9999,0,9999,0
1668543270741,CSE 293,020,119303,McAuley; Julian John,9999,0,9999,0
1668543270741,CSE 293,021,119304,Micciancio; Daniele,9999,0,9999,0
1668543270741,CSE 293,022,119367,Orailoglu; Alex,9999,0,9999,0
1668543270741,CSE 293,023,119382,Paturi; Ramamohan,9999,0,9999,0
1668543270741,CSE 293,024,119404,Polikarpova; Nadezhda,9999,0,9999,0
1668543270741,CSE 293,025,119406,Politz; Joseph Gibbs,9999,0,9999,0
1668543270741,CSE 293,026,119411,Porter; George M,9999,0,9999,0
1668543270741,CSE 293,027,119414,Porter; Leonard Emerson,9999,0,9999,0
1668543270741,CSE 293,028,119416,Ramamoorthi; Ravi,9999,0,9999,0
1668543270741,CSE 293,029,119417,Sahoo; Debashis,9999,0,9999,0
1668543270741,CSE 293,030,119420,Saul; Lawrence,9999,0,9999,0
1668543270741,CSE 293,031,119421,Savage; Stefan,9999,0,9999,0
1668543270741,CSE 293,032,119425,Schulze; Jurgen P.,9999,0,9999,0
1668543270741,CSE 293,033,119426,Snoeren; Alex C.,9999,0,9999,0
1668543270741,CSE 293,034,119428,Shang; Jingbo,9999,0,9999,0
1668543270741,CSE 293,035,119430,Stefan; Deian,9999,0,9999,0
1668543270741,CSE 293,036,119431,Su; Hao,9999,0,9999,0
1668543270741,CSE 293,037,119433,Swanson; Steven James,9999,0,9999,0
1668543270741,CSE 293,038,119435,Tullsen; Dean Michael,9999,0,9999,0
1668543270741,CSE 293,039,119483,Voelker; Geoffrey M.,9999,0,9999,0
1668543270741,CSE 293,040,119537,Zhao; Jishen,9999,0,9999,0
1668543270741,CSE 293,041,119538,Zhou; Yuan-Yuan,9999,0,9999,0
1668543270741,CSE 293,042,119539,Gao; Sicun,9999,0,9999,0
1668543270741,CSE 293,043,119540,Weibel; Nadir,9999,0,9999,0
1668543270741,CSE 293,044,119541,Gupta; Rajesh K.,9999,0,9999,0
1668543270741,CSE 293,045,126410,Vaccaro; Kristen Marie,9999,0,9999,0
1668543270741,CSE 293,046,126411,Klemke; Richard,9999,0,9999,0
1668543271173,CSE 294,A00,102459,Voelker; Geoffrey M.,0,2,0,0
1668543271173,CSE 294,B00,111322,Orailoglu; Alex,0,2,0,0
1668543271596,DSE 201,A00,096914,Deutsch; Alin Bernard,30,0,30,0
1668543272030,DSE 210,A00,096915,Dasgupta; Sanjoy,30,0,30,0
1668543272460,DSE 260A,A00,096916,Altintas De Callaf; Ilkay,30,0,30,0
1668543272917,ECE 200,001,103586,Antipa; Nicholas A,9999,0,9999,0
1668543272917,ECE 200,002,103587,Atanasov; Nikolay A.,9999,0,9999,0
1668543272917,ECE 200,003,103588,Bharadia; Dinesh,9999,0,9999,0
1668543272917,ECE 200,004,103589,Cheng; Chung Kuan,9999,0,9999,0
1668543272917,ECE 200,005,103590,Cosman; Pamela C.,9999,0,9999,0
1668543272917,ECE 200,006,103591,Dayeh; Shadi Ahmad,9999,0,9999,0
1668543272917,ECE 200,007,103592,Fainman; Yeshaiahu,9999,0,9999,0
1668543272917,ECE 200,008,103593,Ford; Joseph Earl,9999,0,9999,0
1668543272917,ECE 200,009,103594,Franceschetti; Massimo,9999,0,9999,0
1668543272917,ECE 200,010,103595,Fullerton; Eric E,9999,0,9999,0
1668543272917,ECE 200,011,103596,Galton; Ian A,9999,0,9999,0
1668543272917,ECE 200,012,103597,Gilja; Vikash,9999,0,9999,0
1668543272917,ECE 200,013,103598,Hall; Drew A.,9999,0,9999,0
1668543272917,ECE 200,014,103599,Hsueh; Tzu-Chien,9999,0,9999,0
1668543272917,ECE 200,015,103600,Javidi; Tara,9999,0,9999,0
1668543272917,ECE 200,016,103601,Kahng; Andrew Byun,9999,0,9999,0
1668543272917,ECE 200,017,103602,Kim; Young-Han,9999,0,9999,0
1668543272917,ECE 200,018,103603,Koushanfar; Farinaz,9999,0,9999,0
1668543272917,ECE 200,019,103604,Kuzum; Duygu,9999,0,9999,0
1668543272917,ECE 200,020,103605,Le; Hanh-Phuc,9999,0,9999,0
1668543272917,ECE 200,021,103606,Lin; Bill,9999,0,9999,0
1668543272917,ECE 200,022,103607,Liu; Zhaowei,9998,0,9999,1
1668543272917,ECE 200,023,103608,Lo; Yu-Hwa,9999,0,9999,0
1668543272917,ECE 200,024,103609,Lomakin; Vitaliy,9999,0,9999,0
1668543272917,ECE 200,025,103610,Mercier; Patrick Philip,9999,0,9999,0
1668543272917,ECE 200,026,103611,Meyer; Florian,9999,0,9999,0
1668543272917,ECE 200,027,103612,Milstein; Laurence B.,9999,0,9999,0
1668543272917,ECE 200,028,103613,Mir Arabbaygi; Siavash,9999,0,9999,0
1668543272917,ECE 200,029,103614,Mookherjea; Shayan,9999,0,9999,0
1668543272917,ECE 200,030,103615,Morris; Karcher William,9999,0,9999,0
1668543272917,ECE 200,031,103616,Ng; Tse Nga,9999,0,9999,0
1668543272917,ECE 200,032,103617,Nguyen; Truong Quang,9999,0,9999,0
1668543272917,ECE 200,033,103618,Nomura; Kenji,9999,0,9999,0
1668543272917,ECE 200,034,103619,Orlitsky; Alon,9999,0,9999,0
1668543272917,ECE 200,035,103620,Pal; Piya,9999,0,9999,0
1668543272917,ECE 200,036,103621,Papen; George C.,9999,0,9999,0
1668543272917,ECE 200,037,103622,Radic; Stojan,9999,0,9999,0
1668543272917,ECE 200,038,103623,Rao; Bhaskar D.,9999,0,9999,0
1668543272917,ECE 200,039,103624,Rao; Ramesh R,9999,0,9999,0
1668543272917,ECE 200,040,103625,Rebeiz; Gabriel,9999,0,9999,0
1668543272917,ECE 200,041,103626,Sanford; John R,9999,0,9999,0
1668543272917,ECE 200,042,103627,Siegel; Paul H.,9999,0,9999,0
1668543272917,ECE 200,043,103628,Sievenpiper; Daniel F.,9999,0,9999,0
1668543272917,ECE 200,044,103629,Sworder; David D.,9999,0,9999,0
1668543272917,ECE 200,045,103630,Taur; Yuan,9999,0,9999,0
1668543272917,ECE 200,046,103631,Touri; Behrouz,9999,0,9999,0
1668543272917,ECE 200,047,103632,Trivedi; Mohan M.,9999,0,9999,0
1668543272917,ECE 200,048,103633,Vasconcelos; Nuno,9999,0,9999,0
1668543272917,ECE 200,049,103634,Wang; Xiaolong,9999,0,9999,0
1668543272917,ECE 200,050,103635,Xie; Pengtao,9999,0,9999,0
1668543272917,ECE 200,051,103636,Yip; Michael,9999,0,9999,0
1668543272917,ECE 200,052,103637,Zeger; Kenneth A.,999,0,999,0
1668543272917,ECE 200,053,103638,Zhang; Xinyu,9999,0,9999,0
1668543272917,ECE 200,054,103639,Turakhia; Yatish Girish,9999,0,9999,0
1668543272917,ECE 200,055,103640,Kang; Mingu,9999,0,9999,0
1668543272917,ECE 200,056,103641,Shi; Yuanyuan,9999,0,9999,0
1668543272917,ECE 200,057,103642,Wang; Edward Jay,9999,0,9999,0
1668543272917,ECE 200,058,103643,Zheng; Yang,9999,0,9999,0
1668543273347,ECE 202,A00,103644,Kuzum; Duygu,0,45,0,0
1668543273772,ECE 212BN,A00,103646,Ng; Tse Nga,0,9,0,0
1668543274202,ECE 221,A00,111493,Staff,0,0,0,0
1668543274636,ECE 222B,A00,103647,Lomakin; Vitaliy,0,20,0,0
1668543275061,ECE 230B,A00,103648,Taur; Yuan,0,3,0,0
1668543275504,ECE 238B,A00,103649,Garay; Javier,0,0,0,0
1668543275930,ECE 240B,A00,112900,Fainman; Yeshaiahu,0,7,0,0
1668543276370,ECE 247A,A00,103650,Jokerst; Jesse Vincent,0,6,0,0
1668543276802,ECE 247B,A00,103651,Wang; Joseph,0,14,0,0
1668543277241,ECE 250,A00,103652,Siegel; Paul H.,0,82,0,0
1668543277670,ECE 251A,A00,103654,Rao; Bhaskar D.,0,62,0,0
1668543278102,ECE 257B,A00,103655,Bharadia; Dinesh,0,33,0,0
1668543278535,ECE 258A,A00,103656,Milstein; Laurence B.,0,29,0,0
1668543278973,ECE 260B,A00,103658,Kang; Mingu,0,123,0,0
1668543279398,ECE 264A,A00,103659,Galton; Ian A,0,71,0,0
1668543279829,ECE 265A,A00,103661,Gudem; Prasad S.S.,0,73,0,0
1668543280258,ECE 265D,A00,103662,Gudem; Prasad S.S.,0,26,0,0
1668543280688,ECE 268,A00,103663,Koushanfar; Farinaz,0,43,0,0
1668543281120,ECE 269,A01,103665,Pal; Piya,0,218,0,0
1668543281543,ECE 271B,A00,103666,Vasconcelos; Manuela,0,78,0,0
1668543281968,ECE 276A,A00,103667,Atanasov; Nikolay A.,0,127,0,0
1668543282397,ECE 277,A00,103668,An; Cheolhong,0,150,0,0
1668543282821,ECE 279,A00,117947,Hall; Drew A.,0,22,0,0
1668543283672,ECE 283,A00,103670,Hsueh; Tzu-Chien,0,57,0,0
1668543284114,ECE 284,A00,103671,Turakhia; Yatish Girish,0,40,0,0
1668543284547,ECE 285,A00,103672,Zheng; Yang,0,40,0,0
1668543284547,ECE 285,B00,103673,Sworder; David D.,0,60,0,0
1668543284970,ECE 287,A00,103676,Javidi; Tara,0,9,0,0
1668543285397,MATH 200B,A00,098023,Salehi Golsefidy; Alireza,10,0,15,5
1668543285833,MATH 202B,A00,098024,Rhoades; Brendon Patrick,7,0,15,8
1668543286267,MATH 203B,A00,098025,Oprea; Dragos N.,9,0,15,6
1668543286691,MATH 204B,A00,098026,Sorensen; Claus M,13,0,15,2
1668543287123,MATH 208,A00,098027,Izadi; Elham,7,0,10,3
1668543287555,MATH 209,A00,098028,Pollack; Aaron,10,0,10,0
1668543287979,MATH 211A,A00,112919,Rogalski; Daniel,8,0,10,2
1668543288408,MATH 211B,A00,112920,Seward; Brandon M.,9,0,10,1
1668543288831,MATH 218,A00,098029,Li; Bo,10,0,10,0
1668543289268,MATH 220B,A00,098030,Novak; Jonathan I,11,0,15,4
1668543289706,MATH 221A,A00,098031,Ebenfelt; Peter F,12,0,15,3
1668543290134,MATH 231B,A00,098032,Zlatos; Andrej,10,0,15,5
1668543290561,MATH 240B,A00,098033,Ni; Lei,7,0,15,8
1668543290992,MATH 243,A00,098034,Jekel; David Andrew,10,0,10,0
1668543291417,MATH 245A,A00,098035,Nie; Jiawang,0,5,15,18
1668543291841,MATH 248,A00,098036,Bejenaru; Ioan,10,0,10,0
1668543292265,MATH 250B,A00,098037,Spolaor; Luca,14,0,15,1
1668543292689,MATH 258,A00,098038,Ni; Lei,9,0,10,1
1668543293111,MATH 264B,A00,098041,Rhoades; Brendon Patrick,8,0,15,7
1668543293534,MATH 268,A00,098042,Buss; Samuel R,10,0,10,0
1668543293958,MATH 269,A00,098043,Rhoades; Brendon Patrick,10,0,10,0
1668543294381,MATH 270B,A00,098044,Li; Bo,6,0,15,9
1668543294808,MATH 272B,A00,098045,Holst; Michael J,13,0,15,2
1668543295233,MATH 273A,A00,098046,Tian; Xiaochuan,10,0,15,5
1668543295655,MATH 275,A01,098048,Tian; Xiaochuan,6,0,10,4
1668543296078,MATH 278A,A00,098049,Holst; Michael J,6,0,10,4
1668543296512,MATH 278B,A00,098050,Cloninger; Alexander,10,0,10,0
1668543296939,MATH 278C,A00,098051,Nie; Jiawang,5,0,10,5
1668543297386,MATH 280B,A00,098052,Zheng; Tianyi,7,0,15,8
1668543297809,MATH 281B,A00,098053,Bradic; Jelena,0,2,15,15
1668543298248,MATH 282B,A00,098054,Arias-Castro; Ery,0,1,15,15
1668543298671,MATH 285,A00,098055,Fitzsimmons; Patrick J,0,4,15,17
1668543299095,MATH 287B,A00,098056,Arias-Castro; Ery,1,0,15,14
1668543299534,MATH 288,A00,098057,Agarwal; Pooja,9,0,10,1
1668543299534,MATH 288,B00,098058,Zhang; Danna,8,0,10,2
1668543299534,MATH 288,C00,098059,Williams; Ruth J,9,0,10,1
1668543299968,MATH 290B,A00,098060,Roberts; Justin Deritter,12,0,15,3
1668543300390,MATH 292,A00,098061,Belmont; Eva Kinoshita,10,0,10,0
1668543300813,MATH 295,A00,098062,Suk; Andrew Hoon,47,0,50,3
1668543301243,MATH 296,A00,098063,Novak; Jonathan I,20,0,20,0
1668543301665,MATH 297,001,098064,Gamst; Anthony Collins,9997,0,9999,2
1668543821403,COGS 205,A00,101395,Chiba; Andrea,19,0,20,1
1668543821829,COGS 210B,001,101404,Greene; Deanna Jacquelyn,9998,0,9999,1
1668543821829,COGS 210B,002,101417,Xia; Haijun,9999,0,9999,0
1668543821829,COGS 210B,003,101422,Nitz; Douglas A.,9999,0,9999,0
1668543821829,COGS 210B,004,101423,Hollan; James D.,9998,0,9999,1
1668543821829,COGS 210B,005,101424,Deak; Gedeon O.,9998,0,9999,1
1668543821829,COGS 210B,006,101425,Rossano; Federico,9999,0,9999,0
1668543822256,COGS 211B,A00,101427,Coulson; Seana M,9996,0,9999,3
1668543822679,COGS 220,A00,101428,Hollan; James D.,0,14,25,25
1668543823103,COGS 229,A00,101429,Dow; Steven P,17,0,25,8
1668543823533,COGS 230,A00,101430,Klemmer; Scott R,6,0,17,11
1668543823955,COGS 234,A00,101431,Xia; Haijun,0,1,25,25
1668543824385,COGS 260,A00,101432,Kiyonaga; Anastasia,21,0,25,4
1668543824385,COGS 260,B00,101433,Kirsh; David Joel,15,0,25,10
1668543824811,CSE 202,A00,102371,Impagliazzo; Russell,0,68,0,0
1668543825241,CSE 203B,A01,102373,Cheng; Chung Kuan,0,62,0,0
1668543825663,CSE 208,A00,102374,Micciancio; Daniele,0,5,0,0
1668543826088,CSE 209A,A00,112895,Impagliazzo; Russell,0,13,15,15
1668543826513,CSE 209B,A00,108005,Bellare; Mihir,0,7,0,0
1668543826935,CSE 210,A00,113163,Coblenz; Michael J,0,89,0,0
1668543827361,CSE 219,A00,106111,Dow; Steven P,0,8,20,20
1668543827784,CSE 221,A00,102376,Voelker; Geoffrey M.,0,75,0,0
1668543828220,CSE 224,A01,102378,Porter; George M,0,173,0,0
1668543828651,CSE 229A,A00,102379,Savage; Stefan,0,11,0,0
1668543829088,CSE 229C,A00,102380,Munyaka; Imani N. S.,0,10,0,0
1668543829512,CSE 232B,A00,102382,Deutsch; Alin Bernard,0,37,0,0
1668543829942,CSE 234,A01,112904,Kumar; Arun Kumar,0,0,0,0
1668543830375,CSE 237A,A00,102383,Rosing; Tajana Simunic,0,56,0,0
1668543830798,CSE 239A,A00,102384,Deutsch; Alin Bernard,0,16,0,0
1668543831222,CSE 239B,A00,102385,Polikarpova; Nadezhda,0,11,0,0
1668543831659,CSE 240A,A00,102386,Pannuto; Patrick William,0,47,0,0
1668543832082,CSE 240B,A00,102387,Zhao; Jishen,0,49,0,0
1668543832505,CSE 241A,A00,106406,Kang; Mingu,0,9,0,0
1668543832940,CSE 249B,A00,102388,Kahng; Andrew Byun,0,5,8,8
1668543833377,CSE 251B,A01,102392,Cottrell; Garrison W,0,52,0,0
1668543833377,CSE 251B,A02,102393,Cottrell; Garrison W,0,35,0,0
1668543833800,CSE 252B,A00,102394,Ochoa; Benjamin Lawrence,0,61,0,0
1668543834233,CSE 257,A01,102396,Gao; Sicun,0,149,0,0
1668543834657,CSE 272,A00,102397,Li; Tzumao,0,19,0,0
1668543835082,CSE 274,A00,111323,Chern; Albert Ren-Haur,0,15,0,0
1668543835521,CSE 282,A00,102398,Pevzner; Pavel Arkadjevich,0,0,0,0
1668543835944,CSE 284,A00,114175,Gymrek; Melissa Ann,0,25,0,0
1668543836375,CSE 290,A00,102399,Chandraker; Manmohan Krishna,0,11,0,0
1668543836375,CSE 290,B00,102400,Vaccaro; Kristen Marie,0,8,25,25
1668543836375,CSE 290,C00,102414,Pannuto; Patrick William,0,1,25,25
1668543836375,CSE 290,D00,102427,Pevzner; Pavel Arkadjevich,0,0,0,0
1668543836375,CSE 290,E00,102429,Zhao; Jishen,0,6,0,0
1668543836375,CSE 290,F00,102436,Tullsen; Dean Michael,0,6,0,0
1668543836375,CSE 290,G00,102440,Christensen; Henrik I,0,6,20,20
1668543836807,CSE 291,A00,102443,Su; Hao,0,0,0,0
1668543836807,CSE 291,B00,102448,Polikarpova; Nadezhda,0,0,0,0
1668543836807,CSE 291,C00,102453,Vaccaro; Kristen Marie,0,0,0,0
1668543836807,CSE 291,D00,111343,Savage; Stefan,0,0,0,0
1668543836807,CSE 291,E00,116474,Claffy; Kimberly Claire,0,0,0,0
1668543836807,CSE 291,F00,116479,Pasquale; Joseph,0,0,0,0
1668543837241,CSE 293,001,119111,Bafna; Vineet,9999,0,9999,0
1668543837241,CSE 293,002,119118,Bellare; Mihir,9999,0,9999,0
1668543837241,CSE 293,003,119122,Berg-Kirkpatrick; Taylor D,9999,0,9999,0
1668543837241,CSE 293,004,119135,Christensen; Henrik I,9999,0,9999,0
1668543837241,CSE 293,005,119142,Cottrell; Garrison W,9999,0,9999,0
1668543837241,CSE 293,006,119146,Deutsch; Alin Bernard,9999,0,9999,0
1668543837241,CSE 293,007,119159,Esmaeilzadeh; Hadi,9999,0,9999,0
1668543837241,CSE 293,008,119166,Freund; Yoav,9999,0,9999,0
1668543837241,CSE 293,009,119170,Griswold; William G.,9999,0,9999,0
1668543837241,CSE 293,010,119183,Gymrek; Melissa Ann,9999,0,9999,0
1668543837241,CSE 293,011,119190,Heninger; Nadia A,9999,0,9999,0
1668543837241,CSE 293,012,119230,Impagliazzo; Russell,9999,0,9999,0
1668543837241,CSE 293,013,119232,Jhala; Ranjit,9999,0,9999,0
1668543837241,CSE 293,014,119233,Kahng; Andrew Byun,9999,0,9999,0
1668543837241,CSE 293,015,119298,Kane; Daniel Mertz,9999,0,9999,0
1668543837241,CSE 293,016,119299,Kriegman; David J,9999,0,9999,0
1668543837241,CSE 293,017,119300,Kumar; Arun Kumar,9999,0,9999,0
1668543837241,CSE 293,018,119301,Lerner; Sorin,9999,0,9999,0
1668543837241,CSE 293,019,119302,Lovett; Shachar,9999,0,9999,0
1668543837241,CSE 293,020,119303,McAuley; Julian John,9999,0,9999,0
1668543837241,CSE 293,021,119304,Micciancio; Daniele,9999,0,9999,0
1668543837241,CSE 293,022,119367,Orailoglu; Alex,9999,0,9999,0
1668543837241,CSE 293,023,119382,Paturi; Ramamohan,9999,0,9999,0
1668543837241,CSE 293,024,119404,Polikarpova; Nadezhda,9999,0,9999,0
1668543837241,CSE 293,025,119406,Politz; Joseph Gibbs,9999,0,9999,0
1668543837241,CSE 293,026,119411,Porter; George M,9999,0,9999,0
1668543837241,CSE 293,027,119414,Porter; Leonard Emerson,9999,0,9999,0
1668543837241,CSE 293,028,119416,Ramamoorthi; Ravi,9999,0,9999,0
1668543837241,CSE 293,029,119417,Sahoo; Debashis,9999,0,9999,0
1668543837241,CSE 293,030,119420,Saul; Lawrence,9999,0,9999,0
1668543837241,CSE 293,031,119421,Savage; Stefan,9999,0,9999,0
1668543837241,CSE 293,032,119425,Schulze; Jurgen P.,9999,0,9999,0
1668543837241,CSE 293,033,119426,Snoeren; Alex C.,9999,0,9999,0
1668543837241,CSE 293,034,119428,Shang; Jingbo,9999,0,9999,0
1668543837241,CSE 293,035,119430,Stefan; Deian,9999,0,9999,0
1668543837241,CSE 293,036,119431,Su; Hao,9999,0,9999,0
1668543837241,CSE 293,037,119433,Swanson; Steven James,9999,0,9999,0
1668543837241,CSE 293,038,119435,Tullsen; Dean Michael,9999,0,9999,0
1668543837241,CSE 293,039,119483,Voelker; Geoffrey M.,9999,0,9999,0
1668543837241,CSE 293,040,119537,Zhao; Jishen,9999,0,9999,0
1668543837241,CSE 293,041,119538,Zhou; Yuan-Yuan,9999,0,9999,0
1668543837241,CSE 293,042,119539,Gao; Sicun,9999,0,9999,0
1668543837241,CSE 293,043,119540,Weibel; Nadir,9999,0,9999,0
1668543837241,CSE 293,044,119541,Gupta; Rajesh K.,9999,0,9999,0
1668543837241,CSE 293,045,126410,Vaccaro; Kristen Marie,9999,0,9999,0
1668543837241,CSE 293,046,126411,Klemke; Richard,9999,0,9999,0
1668543837665,CSE 294,A00,102459,Voelker; Geoffrey M.,0,2,0,0
1668543837665,CSE 294,B00,111322,Orailoglu; Alex,0,2,0,0
1668543838094,DSE 201,A00,096914,Deutsch; Alin Bernard,30,0,30,0
1668543838524,DSE 210,A00,096915,Dasgupta; Sanjoy,30,0,30,0
1668543838960,DSE 260A,A00,096916,Altintas De Callaf; Ilkay,30,0,30,0
1668543839387,ECE 200,001,103586,Antipa; Nicholas A,9999,0,9999,0
1668543839387,ECE 200,002,103587,Atanasov; Nikolay A.,9999,0,9999,0
1668543839387,ECE 200,003,103588,Bharadia; Dinesh,9999,0,9999,0
1668543839387,ECE 200,004,103589,Cheng; Chung Kuan,9999,0,9999,0
1668543839387,ECE 200,005,103590,Cosman; Pamela C.,9999,0,9999,0
1668543839387,ECE 200,006,103591,Dayeh; Shadi Ahmad,9999,0,9999,0
1668543839387,ECE 200,007,103592,Fainman; Yeshaiahu,9999,0,9999,0
1668543839387,ECE 200,008,103593,Ford; Joseph Earl,9999,0,9999,0
1668543839387,ECE 200,009,103594,Franceschetti; Massimo,9999,0,9999,0
1668543839387,ECE 200,010,103595,Fullerton; Eric E,9999,0,9999,0
1668543839387,ECE 200,011,103596,Galton; Ian A,9999,0,9999,0
1668543839387,ECE 200,012,103597,Gilja; Vikash,9999,0,9999,0
1668543839387,ECE 200,013,103598,Hall; Drew A.,9999,0,9999,0
1668543839387,ECE 200,014,103599,Hsueh; Tzu-Chien,9999,0,9999,0
1668543839387,ECE 200,015,103600,Javidi; Tara,9999,0,9999,0
1668543839387,ECE 200,016,103601,Kahng; Andrew Byun,9999,0,9999,0
1668543839387,ECE 200,017,103602,Kim; Young-Han,9999,0,9999,0
1668543839387,ECE 200,018,103603,Koushanfar; Farinaz,9999,0,9999,0
1668543839387,ECE 200,019,103604,Kuzum; Duygu,9999,0,9999,0
1668543839387,ECE 200,020,103605,Le; Hanh-Phuc,9999,0,9999,0
1668543839387,ECE 200,021,103606,Lin; Bill,9999,0,9999,0
1668543839387,ECE 200,022,103607,Liu; Zhaowei,9998,0,9999,1
1668543839387,ECE 200,023,103608,Lo; Yu-Hwa,9999,0,9999,0
1668543839387,ECE 200,024,103609,Lomakin; Vitaliy,9999,0,9999,0
1668543839387,ECE 200,025,103610,Mercier; Patrick Philip,9999,0,9999,0
1668543839387,ECE 200,026,103611,Meyer; Florian,9999,0,9999,0
1668543839387,ECE 200,027,103612,Milstein; Laurence B.,9999,0,9999,0
1668543839387,ECE 200,028,103613,Mir Arabbaygi; Siavash,9999,0,9999,0
1668543839387,ECE 200,029,103614,Mookherjea; Shayan,9999,0,9999,0
1668543839387,ECE 200,030,103615,Morris; Karcher William,9999,0,9999,0
1668543839387,ECE 200,031,103616,Ng; Tse Nga,9999,0,9999,0
1668543839387,ECE 200,032,103617,Nguyen; Truong Quang,9999,0,9999,0
1668543839387,ECE 200,033,103618,Nomura; Kenji,9999,0,9999,0
1668543839387,ECE 200,034,103619,Orlitsky; Alon,9999,0,9999,0
1668543839387,ECE 200,035,103620,Pal; Piya,9999,0,9999,0
1668543839387,ECE 200,036,103621,Papen; George C.,9999,0,9999,0
1668543839387,ECE 200,037,103622,Radic; Stojan,9999,0,9999,0
1668543839387,ECE 200,038,103623,Rao; Bhaskar D.,9999,0,9999,0
1668543839387,ECE 200,039,103624,Rao; Ramesh R,9999,0,9999,0
1668543839387,ECE 200,040,103625,Rebeiz; Gabriel,9999,0,9999,0
1668543839387,ECE 200,041,103626,Sanford; John R,9999,0,9999,0
1668543839387,ECE 200,042,103627,Siegel; Paul H.,9999,0,9999,0
1668543839387,ECE 200,043,103628,Sievenpiper; Daniel F.,9999,0,9999,0
1668543839387,ECE 200,044,103629,Sworder; David D.,9999,0,9999,0
1668543839387,ECE 200,045,103630,Taur; Yuan,9999,0,9999,0
1668543839387,ECE 200,046,103631,Touri; Behrouz,9999,0,9999,0
1668543839387,ECE 200,047,103632,Trivedi; Mohan M.,9999,0,9999,0
1668543839387,ECE 200,048,103633,Vasconcelos; Nuno,9999,0,9999,0
1668543839387,ECE 200,049,103634,Wang; Xiaolong,9999,0,9999,0
1668543839387,ECE 200,050,103635,Xie; Pengtao,9999,0,9999,0
1668543839387,ECE 200,051,103636,Yip; Michael,9999,0,9999,0
1668543839387,ECE 200,052,103637,Zeger; Kenneth A.,999,0,999,0
1668543839387,ECE 200,053,103638,Zhang; Xinyu,9999,0,9999,0
1668543839387,ECE 200,054,103639,Turakhia; Yatish Girish,9999,0,9999,0
1668543839387,ECE 200,055,103640,Kang; Mingu,9999,0,9999,0
1668543839387,ECE 200,056,103641,Shi; Yuanyuan,9999,0,9999,0
1668543839387,ECE 200,057,103642,Wang; Edward Jay,9999,0,9999,0
1668543839387,ECE 200,058,103643,Zheng; Yang,9999,0,9999,0
1668543839817,ECE 202,A00,103644,Kuzum; Duygu,0,45,0,0
1668543840241,ECE 212BN,A00,103646,Ng; Tse Nga,0,9,0,0
1668543840667,ECE 221,A00,111493,Staff,0,0,0,0
1668543841094,ECE 222B,A00,103647,Lomakin; Vitaliy,0,20,0,0
1668543841530,ECE 230B,A00,103648,Taur; Yuan,0,3,0,0
1668543841954,ECE 238B,A00,103649,Garay; Javier,0,0,0,0
1668543842387,ECE 240B,A00,112900,Fainman; Yeshaiahu,0,7,0,0
1668543843228,ECE 247A,A00,103650,Jokerst; Jesse Vincent,0,6,0,0
1668543843650,ECE 247B,A00,103651,Wang; Joseph,0,14,0,0
1668543844073,ECE 250,A00,103652,Siegel; Paul H.,0,82,0,0
1668543844495,ECE 251A,A00,103654,Rao; Bhaskar D.,0,63,0,0
1668543844919,ECE 257B,A00,103655,Bharadia; Dinesh,0,33,0,0
1668543845342,ECE 258A,A00,103656,Milstein; Laurence B.,0,29,0,0
1668543845769,ECE 260B,A00,103658,Kang; Mingu,0,123,0,0
1668543846199,ECE 264A,A00,103659,Galton; Ian A,0,71,0,0
1668543846623,ECE 265A,A00,103661,Gudem; Prasad S.S.,0,73,0,0
1668543847048,ECE 265D,A00,103662,Gudem; Prasad S.S.,0,26,0,0
1668543847476,ECE 268,A00,103663,Koushanfar; Farinaz,0,43,0,0
1668543847903,ECE 269,A01,103665,Pal; Piya,0,219,0,0
1668543848329,ECE 271B,A00,103666,Vasconcelos; Manuela,0,78,0,0
1668543848758,ECE 276A,A00,103667,Atanasov; Nikolay A.,0,127,0,0
1668543849185,ECE 277,A00,103668,An; Cheolhong,0,150,0,0
1668543849614,ECE 279,A00,117947,Hall; Drew A.,0,22,0,0
1668543850467,ECE 283,A00,103670,Hsueh; Tzu-Chien,0,57,0,0
1668543850907,ECE 284,A00,103671,Turakhia; Yatish Girish,0,40,0,0
1668543851330,ECE 285,A00,103672,Zheng; Yang,0,40,0,0
1668543851330,ECE 285,B00,103673,Sworder; David D.,0,60,0,0
1668543851759,ECE 287,A00,103676,Javidi; Tara,0,9,0,0
1668543852188,MATH 200B,A00,098023,Salehi Golsefidy; Alireza,10,0,15,5
1668543852613,MATH 202B,A00,098024,Rhoades; Brendon Patrick,7,0,15,8
1668543853045,MATH 203B,A00,098025,Oprea; Dragos N.,9,0,15,6
1668543853477,MATH 204B,A00,098026,Sorensen; Claus M,13,0,15,2
1668543853909,MATH 208,A00,098027,Izadi; Elham,7,0,10,3
1668543854333,MATH 209,A00,098028,Pollack; Aaron,10,0,10,0
1668543854757,MATH 211A,A00,112919,Rogalski; Daniel,8,0,10,2
1668543855181,MATH 211B,A00,112920,Seward; Brandon M.,9,0,10,1
1668543855623,MATH 218,A00,098029,Li; Bo,10,0,10,0
1668543856055,MATH 220B,A00,098030,Novak; Jonathan I,11,0,15,4
1668543856482,MATH 221A,A00,098031,Ebenfelt; Peter F,12,0,15,3
1668543856914,MATH 231B,A00,098032,Zlatos; Andrej,10,0,15,5
1668543857341,MATH 240B,A00,098033,Ni; Lei,7,0,15,8
1668543857774,MATH 243,A00,098034,Jekel; David Andrew,10,0,10,0
1668543858200,MATH 245A,A00,098035,Nie; Jiawang,0,5,15,18
1668543858624,MATH 248,A00,098036,Bejenaru; Ioan,10,0,10,0
1668543859059,MATH 250B,A00,098037,Spolaor; Luca,14,0,15,1
1668543859489,MATH 258,A00,098038,Ni; Lei,9,0,10,1
1668543859912,MATH 264B,A00,098041,Rhoades; Brendon Patrick,8,0,15,7
1668543860339,MATH 268,A00,098042,Buss; Samuel R,10,0,10,0
1668543860778,MATH 269,A00,098043,Rhoades; Brendon Patrick,10,0,10,0
1668543861204,MATH 270B,A00,098044,Li; Bo,6,0,15,9
1668543861630,MATH 272B,A00,098045,Holst; Michael J,13,0,15,2
1668543862053,MATH 273A,A00,098046,Tian; Xiaochuan,10,0,15,5
1668543862477,MATH 275,A01,098048,Tian; Xiaochuan,6,0,10,4
1668543862906,MATH 278A,A00,098049,Holst; Michael J,6,0,10,4
1668543863332,MATH 278B,A00,098050,Cloninger; Alexander,10,0,10,0
1668543863756,MATH 278C,A00,098051,Nie; Jiawang,5,0,10,5
1668543864185,MATH 280B,A00,098052,Zheng; Tianyi,7,0,15,8
1668543864610,MATH 281B,A00,098053,Bradic; Jelena,0,2,15,15
1668543865034,MATH 282B,A00,098054,Arias-Castro; Ery,0,1,15,15
1668543865465,MATH 285,A00,098055,Fitzsimmons; Patrick J,0,4,15,17
1668543865894,MATH 287B,A00,098056,Arias-Castro; Ery,1,0,15,14
1668543866322,MATH 288,A00,098057,Agarwal; Pooja,9,0,10,1
1668543866322,MATH 288,B00,098058,Zhang; Danna,8,0,10,2
1668543866322,MATH 288,C00,098059,Williams; Ruth J,9,0,10,1
1668543866745,MATH 290B,A00,098060,Roberts; Justin Deritter,12,0,15,3
1668543867171,MATH 292,A00,098061,Belmont; Eva Kinoshita,10,0,10,0
1668543867595,MATH 295,A00,098062,Suk; Andrew Hoon,47,0,50,3
1668543868021,MATH 296,A00,098063,Novak; Jonathan I,20,0,20,0
1668543868444,MATH 297,001,098064,Gamst; Anthony Collins,9997,0,9999,2
1668544375789,COGS 205,A00,101395,Chiba; Andrea,19,0,20,1
1668544376226,COGS 210B,001,101404,Greene; Deanna Jacquelyn,9998,0,9999,1
1668544376226,COGS 210B,002,101417,Xia; Haijun,9999,0,9999,0
1668544376226,COGS 210B,003,101422,Nitz; Douglas A.,9999,0,9999,0
1668544376226,COGS 210B,004,101423,Hollan; James D.,9998,0,9999,1
1668544376226,COGS 210B,005,101424,Deak; Gedeon O.,9998,0,9999,1
1668544376226,COGS 210B,006,101425,Rossano; Federico,9999,0,9999,0
1668544376648,COGS 211B,A00,101427,Coulson; Seana M,9996,0,9999,3
1668544377087,COGS 220,A00,101428,Hollan; James D.,0,14,25,25
1668544377518,COGS 229,A00,101429,Dow; Steven P,17,0,25,8
1668544377941,COGS 230,A00,101430,Klemmer; Scott R,6,0,17,11
1668544378382,COGS 234,A00,101431,Xia; Haijun,0,1,25,25
1668544378806,COGS 260,A00,101432,Kiyonaga; Anastasia,21,0,25,4
1668544378806,COGS 260,B00,101433,Kirsh; David Joel,15,0,25,10
1668544379227,CSE 202,A00,102371,Impagliazzo; Russell,0,68,0,0
1668544379650,CSE 203B,A01,102373,Cheng; Chung Kuan,0,62,0,0
1668544380073,CSE 208,A00,102374,Micciancio; Daniele,0,5,0,0
1668544380497,CSE 209A,A00,112895,Impagliazzo; Russell,0,13,15,15
1668544380932,CSE 209B,A00,108005,Bellare; Mihir,0,7,0,0
1668544381357,CSE 210,A00,113163,Coblenz; Michael J,0,89,0,0
1668544381795,CSE 219,A00,106111,Dow; Steven P,0,8,20,20
1668544382227,CSE 221,A00,102376,Voelker; Geoffrey M.,0,75,0,0
1668544382654,CSE 224,A01,102378,Porter; George M,0,173,0,0
1668544383083,CSE 229A,A00,102379,Savage; Stefan,0,11,0,0
1668544383511,CSE 229C,A00,102380,Munyaka; Imani N. S.,0,10,0,0
1668544383942,CSE 232B,A00,102382,Deutsch; Alin Bernard,0,37,0,0
1668544384383,CSE 234,A01,112904,Kumar; Arun Kumar,0,0,0,0
1668544384810,CSE 237A,A00,102383,Rosing; Tajana Simunic,0,56,0,0
1668544385237,CSE 239A,A00,102384,Deutsch; Alin Bernard,0,16,0,0
1668544385665,CSE 239B,A00,102385,Polikarpova; Nadezhda,0,11,0,0
1668544386090,CSE 240A,A00,102386,Pannuto; Patrick William,0,47,0,0
1668544386512,CSE 240B,A00,102387,Zhao; Jishen,0,50,0,0
1668544386943,CSE 241A,A00,106406,Kang; Mingu,0,9,0,0
1668544387377,CSE 249B,A00,102388,Kahng; Andrew Byun,0,5,8,8
1668544387804,CSE 251B,A01,102392,Cottrell; Garrison W,0,52,0,0
1668544387804,CSE 251B,A02,102393,Cottrell; Garrison W,0,35,0,0
1668544388233,CSE 252B,A00,102394,Ochoa; Benjamin Lawrence,0,61,0,0
1668544388667,CSE 257,A01,102396,Gao; Sicun,0,149,0,0
1668544389103,CSE 272,A00,102397,Li; Tzumao,0,19,0,0
1668544389538,CSE 274,A00,111323,Chern; Albert Ren-Haur,0,15,0,0
1668544389968,CSE 282,A00,102398,Pevzner; Pavel Arkadjevich,0,0,0,0
1668544390401,CSE 284,A00,114175,Gymrek; Melissa Ann,0,25,0,0
1668544390837,CSE 290,A00,102399,Chandraker; Manmohan Krishna,0,11,0,0
1668544390837,CSE 290,B00,102400,Vaccaro; Kristen Marie,0,8,25,25
1668544390837,CSE 290,C00,102414,Pannuto; Patrick William,0,1,25,25
1668544390837,CSE 290,D00,102427,Pevzner; Pavel Arkadjevich,0,0,0,0
1668544390837,CSE 290,E00,102429,Zhao; Jishen,0,6,0,0
1668544390837,CSE 290,F00,102436,Tullsen; Dean Michael,0,6,0,0
1668544390837,CSE 290,G00,102440,Christensen; Henrik I,0,6,20,20
1668544391268,CSE 291,A00,102443,Su; Hao,0,0,0,0
1668544391268,CSE 291,B00,102448,Polikarpova; Nadezhda,0,0,0,0
1668544391268,CSE 291,C00,102453,Vaccaro; Kristen Marie,0,0,0,0
1668544391268,CSE 291,D00,111343,Savage; Stefan,0,0,0,0
1668544391268,CSE 291,E00,116474,Claffy; Kimberly Claire,0,0,0,0
1668544391268,CSE 291,F00,116479,Pasquale; Joseph,0,0,0,0
1668544391724,CSE 293,001,119111,Bafna; Vineet,9999,0,9999,0
1668544391724,CSE 293,002,119118,Bellare; Mihir,9999,0,9999,0
1668544391724,CSE 293,003,119122,Berg-Kirkpatrick; Taylor D,9999,0,9999,0
1668544391724,CSE 293,004,119135,Christensen; Henrik I,9999,0,9999,0
1668544391724,CSE 293,005,119142,Cottrell; Garrison W,9999,0,9999,0
1668544391724,CSE 293,006,119146,Deutsch; Alin Bernard,9999,0,9999,0
1668544391724,CSE 293,007,119159,Esmaeilzadeh; Hadi,9999,0,9999,0
1668544391724,CSE 293,008,119166,Freund; Yoav,9999,0,9999,0
1668544391724,CSE 293,009,119170,Griswold; William G.,9999,0,9999,0
1668544391724,CSE 293,010,119183,Gymrek; Melissa Ann,9999,0,9999,0
1668544391724,CSE 293,011,119190,Heninger; Nadia A,9999,0,9999,0
1668544391724,CSE 293,012,119230,Impagliazzo; Russell,9999,0,9999,0
1668544391724,CSE 293,013,119232,Jhala; Ranjit,9999,0,9999,0
1668544391724,CSE 293,014,119233,Kahng; Andrew Byun,9999,0,9999,0
1668544391724,CSE 293,015,119298,Kane; Daniel Mertz,9999,0,9999,0
1668544391724,CSE 293,016,119299,Kriegman; David J,9999,0,9999,0
1668544391724,CSE 293,017,119300,Kumar; Arun Kumar,9999,0,9999,0
1668544391724,CSE 293,018,119301,Lerner; Sorin,9999,0,9999,0
1668544391724,CSE 293,019,119302,Lovett; Shachar,9999,0,9999,0
1668544391724,CSE 293,020,119303,McAuley; Julian John,9999,0,9999,0
1668544391724,CSE 293,021,119304,Micciancio; Daniele,9999,0,9999,0
1668544391724,CSE 293,022,119367,Orailoglu; Alex,9999,0,9999,0
1668544391724,CSE 293,023,119382,Paturi; Ramamohan,9999,0,9999,0
1668544391724,CSE 293,024,119404,Polikarpova; Nadezhda,9999,0,9999,0
1668544391724,CSE 293,025,119406,Politz; Joseph Gibbs,9999,0,9999,0
1668544391724,CSE 293,026,119411,Porter; George M,9999,0,9999,0
1668544391724,CSE 293,027,119414,Porter; Leonard Emerson,9999,0,9999,0
1668544391724,CSE 293,028,119416,Ramamoorthi; Ravi,9999,0,9999,0
1668544391724,CSE 293,029,119417,Sahoo; Debashis,9999,0,9999,0
1668544391724,CSE 293,030,119420,Saul; Lawrence,9999,0,9999,0
1668544391724,CSE 293,031,119421,Savage; Stefan,9999,0,9999,0
1668544391724,CSE 293,032,119425,Schulze; Jurgen P.,9999,0,9999,0
1668544391724,CSE 293,033,119426,Snoeren; Alex C.,9999,0,9999,0
1668544391724,CSE 293,034,119428,Shang; Jingbo,9999,0,9999,0
1668544391724,CSE 293,035,119430,Stefan; Deian,9999,0,9999,0
1668544391724,CSE 293,036,119431,Su; Hao,9999,0,9999,0
1668544391724,CSE 293,037,119433,Swanson; Steven James,9999,0,9999,0
1668544391724,CSE 293,038,119435,Tullsen; Dean Michael,9999,0,9999,0
1668544391724,CSE 293,039,119483,Voelker; Geoffrey M.,9999,0,9999,0
1668544391724,CSE 293,040,119537,Zhao; Jishen,9999,0,9999,0
1668544391724,CSE 293,041,119538,Zhou; Yuan-Yuan,9999,0,9999,0
1668544391724,CSE 293,042,119539,Gao; Sicun,9999,0,9999,0
1668544391724,CSE 293,043,119540,Weibel; Nadir,9999,0,9999,0
1668544391724,CSE 293,044,119541,Gupta; Rajesh K.,9999,0,9999,0
1668544391724,CSE 293,045,126410,Vaccaro; Kristen Marie,9999,0,9999,0
1668544391724,CSE 293,046,126411,Klemke; Richard,9999,0,9999,0
1668544392156,CSE 294,A00,102459,Voelker; Geoffrey M.,0,2,0,0
1668544392156,CSE 294,B00,111322,Orailoglu; Alex,0,2,0,0
1668544392590,DSE 201,A00,096914,Deutsch; Alin Bernard,30,0,30,0
1668544393014,DSE 210,A00,096915,Dasgupta; Sanjoy,30,0,30,0
1668544393451,DSE 260A,A00,096916,Altintas De Callaf; Ilkay,30,0,30,0
1668544393900,ECE 200,001,103586,Antipa; Nicholas A,9999,0,9999,0
1668544393900,ECE 200,002,103587,Atanasov; Nikolay A.,9999,0,9999,0
1668544393900,ECE 200,003,103588,Bharadia; Dinesh,9999,0,9999,0
1668544393900,ECE 200,004,103589,Cheng; Chung Kuan,9999,0,9999,0
1668544393900,ECE 200,005,103590,Cosman; Pamela C.,9999,0,9999,0
1668544393900,ECE 200,006,103591,Dayeh; Shadi Ahmad,9999,0,9999,0
1668544393900,ECE 200,007,103592,Fainman; Yeshaiahu,9999,0,9999,0
1668544393900,ECE 200,008,103593,Ford; Joseph Earl,9999,0,9999,0
1668544393900,ECE 200,009,103594,Franceschetti; Massimo,9999,0,9999,0
1668544393900,ECE 200,010,103595,Fullerton; Eric E,9999,0,9999,0
1668544393900,ECE 200,011,103596,Galton; Ian A,9999,0,9999,0
1668544393900,ECE 200,012,103597,Gilja; Vikash,9999,0,9999,0
1668544393900,ECE 200,013,103598,Hall; Drew A.,9999,0,9999,0
1668544393900,ECE 200,014,103599,Hsueh; Tzu-Chien,9999,0,9999,0
1668544393900,ECE 200,015,103600,Javidi; Tara,9999,0,9999,0
1668544393900,ECE 200,016,103601,Kahng; Andrew Byun,9999,0,9999,0
1668544393900,ECE 200,017,103602,Kim; Young-Han,9999,0,9999,0
1668544393900,ECE 200,018,103603,Koushanfar; Farinaz,9999,0,9999,0
1668544393900,ECE 200,019,103604,Kuzum; Duygu,9999,0,9999,0
1668544393900,ECE 200,020,103605,Le; Hanh-Phuc,9999,0,9999,0
1668544393900,ECE 200,021,103606,Lin; Bill,9999,0,9999,0
1668544393900,ECE 200,022,103607,Liu; Zhaowei,9998,0,9999,1
1668544393900,ECE 200,023,103608,Lo; Yu-Hwa,9999,0,9999,0
1668544393900,ECE 200,024,103609,Lomakin; Vitaliy,9999,0,9999,0
1668544393900,ECE 200,025,103610,Mercier; Patrick Philip,9999,0,9999,0
1668544393900,ECE 200,026,103611,Meyer; Florian,9999,0,9999,0
1668544393900,ECE 200,027,103612,Milstein; Laurence B.,9999,0,9999,0
1668544393900,ECE 200,028,103613,Mir Arabbaygi; Siavash,9999,0,9999,0
1668544393900,ECE 200,029,103614,Mookherjea; Shayan,9999,0,9999,0
1668544393900,ECE 200,030,103615,Morris; Karcher William,9999,0,9999,0
1668544393900,ECE 200,031,103616,Ng; Tse Nga,9999,0,9999,0
1668544393900,ECE 200,032,103617,Nguyen; Truong Quang,9999,0,9999,0
1668544393900,ECE 200,033,103618,Nomura; Kenji,9999,0,9999,0
1668544393900,ECE 200,034,103619,Orlitsky; Alon,9999,0,9999,0
1668544393900,ECE 200,035,103620,Pal; Piya,9999,0,9999,0
1668544393900,ECE 200,036,103621,Papen; George C.,9999,0,9999,0
1668544393900,ECE 200,037,103622,Radic; Stojan,9999,0,9999,0
1668544393900,ECE 200,038,103623,Rao; Bhaskar D.,9999,0,9999,0
1668544393900,ECE 200,039,103624,Rao; Ramesh R,9999,0,9999,0
1668544393900,ECE 200,040,103625,Rebeiz; Gabriel,9999,0,9999,0
1668544393900,ECE 200,041,103626,Sanford; John R,9999,0,9999,0
1668544393900,ECE 200,042,103627,Siegel; Paul H.,9999,0,9999,0
1668544393900,ECE 200,043,103628,Sievenpiper; Daniel F.,9999,0,9999,0
1668544393900,ECE 200,044,103629,Sworder; David D.,9999,0,9999,0
1668544393900,ECE 200,045,103630,Taur; Yuan,9999,0,9999,0
1668544393900,ECE 200,046,103631,Touri; Behrouz,9999,0,9999,0
1668544393900,ECE 200,047,103632,Trivedi; Mohan M.,9999,0,9999,0
1668544393900,ECE 200,048,103633,Vasconcelos; Nuno,9999,0,9999,0
1668544393900,ECE 200,049,103634,Wang; Xiaolong,9999,0,9999,0
1668544393900,ECE 200,050,103635,Xie; Pengtao,9999,0,9999,0
1668544393900,ECE 200,051,103636,Yip; Michael,9999,0,9999,0
1668544393900,ECE 200,052,103637,Zeger; Kenneth A.,999,0,999,0
1668544393900,ECE 200,053,103638,Zhang; Xinyu,9999,0,9999,0
1668544393900,ECE 200,054,103639,Turakhia; Yatish Girish,9999,0,9999,0
1668544393900,ECE 200,055,103640,Kang; Mingu,9999,0,9999,0
1668544393900,ECE 200,056,103641,Shi; Yuanyuan,9999,0,9999,0
1668544393900,ECE 200,057,103642,Wang; Edward Jay,9999,0,9999,0
1668544393900,ECE 200,058,103643,Zheng; Yang,9999,0,9999,0
1668544394321,ECE 202,A00,103644,Kuzum; Duygu,0,45,0,0
1668544394747,ECE 212BN,A00,103646,Ng; Tse Nga,0,9,0,0
1668544395168,ECE 221,A00,111493,Staff,0,0,0,0
1668544395598,ECE 222B,A00,103647,Lomakin; Vitaliy,0,20,0,0
1668544396030,ECE 230B,A00,103648,Taur; Yuan,0,3,0,0
1668544396452,ECE 238B,A00,103649,Garay; Javier,0,0,0,0
1668544396878,ECE 240B,A00,112900,Fainman; Yeshaiahu,0,7,0,0
1668544397305,ECE 247A,A00,103650,Jokerst; Jesse Vincent,0,6,0,0
1668544397730,ECE 247B,A00,103651,Wang; Joseph,0,14,0,0
1668544398162,ECE 250,A00,103652,Siegel; Paul H.,0,82,0,0
1668544398586,ECE 251A,A00,103654,Rao; Bhaskar D.,0,63,0,0
1668544399009,ECE 257B,A00,103655,Bharadia; Dinesh,0,33,0,0
1668544399457,ECE 258A,A00,103656,Milstein; Laurence B.,0,29,0,0
1668544399884,ECE 260B,A00,103658,Kang; Mingu,0,123,0,0
1668544400313,ECE 264A,A00,103659,Galton; Ian A,0,71,0,0
1668544400742,ECE 265A,A00,103661,Gudem; Prasad S.S.,0,73,0,0
1668544401164,ECE 265D,A00,103662,Gudem; Prasad S.S.,0,26,0,0
1668544401588,ECE 268,A00,103663,Koushanfar; Farinaz,0,43,0,0
1668544402014,ECE 269,A01,103665,Pal; Piya,0,219,0,0
1668544402441,ECE 271B,A00,103666,Vasconcelos; Manuela,0,78,0,0
1668544402880,ECE 276A,A00,103667,Atanasov; Nikolay A.,0,127,0,0
1668544403303,ECE 277,A00,103668,An; Cheolhong,0,150,0,0
1668544403733,ECE 279,A00,117947,Hall; Drew A.,0,22,0,0
1668544404599,ECE 283,A00,103670,Hsueh; Tzu-Chien,0,57,0,0
1668544405025,ECE 284,A00,103671,Turakhia; Yatish Girish,0,40,0,0
1668544405448,ECE 285,A00,103672,Zheng; Yang,0,41,0,0
1668544405448,ECE 285,B00,103673,Sworder; David D.,0,60,0,0
1668544405872,ECE 287,A00,103676,Javidi; Tara,0,9,0,0
1668544406303,MATH 200B,A00,098023,Salehi Golsefidy; Alireza,10,0,15,5
1668544406743,MATH 202B,A00,098024,Rhoades; Brendon Patrick,7,0,15,8
1668544407166,MATH 203B,A00,098025,Oprea; Dragos N.,9,0,15,6
1668544407591,MATH 204B,A00,098026,Sorensen; Claus M,13,0,15,2
1668544408014,MATH 208,A00,098027,Izadi; Elham,7,0,10,3
1668544408439,MATH 209,A00,098028,Pollack; Aaron,10,0,10,0
1668544408873,MATH 211A,A00,112919,Rogalski; Daniel,8,0,10,2
1668544409317,MATH 211B,A00,112920,Seward; Brandon M.,9,0,10,1
1668544409739,MATH 218,A00,098029,Li; Bo,10,0,10,0
1668544410162,MATH 220B,A00,098030,Novak; Jonathan I,11,0,15,4
1668544410591,MATH 221A,A00,098031,Ebenfelt; Peter F,12,0,15,3
1668544411021,MATH 231B,A00,098032,Zlatos; Andrej,10,0,15,5
1668544411454,MATH 240B,A00,098033,Ni; Lei,7,0,15,8
1668544411878,MATH 243,A00,098034,Jekel; David Andrew,10,0,10,0
1668544413013,MATH 245A,A00,098035,Nie; Jiawang,0,5,15,18
1668544413439,MATH 248,A00,098036,Bejenaru; Ioan,10,0,10,0
1668544413874,MATH 250B,A00,098037,Spolaor; Luca,14,0,15,1
1668544414299,MATH 258,A00,098038,Ni; Lei,9,0,10,1
1668544414725,MATH 264B,A00,098041,Rhoades; Brendon Patrick,8,0,15,7
1668544415154,MATH 268,A00,098042,Buss; Samuel R,10,0,10,0
1668544415577,MATH 269,A00,098043,Rhoades; Brendon Patrick,10,0,10,0
1668544415998,MATH 270B,A00,098044,Li; Bo,6,0,15,9
1668544416420,MATH 272B,A00,098045,Holst; Michael J,13,0,15,2
1668544416846,MATH 273A,A00,098046,Tian; Xiaochuan,10,0,15,5
1668544417287,MATH 275,A01,098048,Tian; Xiaochuan,6,0,10,4
1668544417708,MATH 278A,A00,098049,Holst; Michael J,6,0,10,4
1668544418138,MATH 278B,A00,098050,Cloninger; Alexander,10,0,10,0
1668544418569,MATH 278C,A00,098051,Nie; Jiawang,5,0,10,5
1668544418992,MATH 280B,A00,098052,Zheng; Tianyi,7,0,15,8
1668544419417,MATH 281B,A00,098053,Bradic; Jelena,0,2,15,15
1668544419843,MATH 282B,A00,098054,Arias-Castro; Ery,0,1,15,15
1668544420274,MATH 285,A00,098055,Fitzsimmons; Patrick J,0,4,15,17
1668544420698,MATH 287B,A00,098056,Arias-Castro; Ery,1,0,15,14
1668544421132,MATH 288,A00,098057,Agarwal; Pooja,9,0,10,1
1668544421132,MATH 288,B00,098058,Zhang; Danna,8,0,10,2
1668544421132,MATH 288,C00,098059,Williams; Ruth J,9,0,10,1
1668544421558,MATH 290B,A00,098060,Roberts; Justin Deritter,12,0,15,3
1668544421987,MATH 292,A00,098061,Belmont; Eva Kinoshita,10,0,10,0
1668544422411,MATH 295,A00,098062,Suk; Andrew Hoon,47,0,50,3
1668544422842,MATH 296,A00,098063,Novak; Jonathan I,20,0,20,0
1668544423269,MATH 297,001,098064,Gamst; Anthony Collins,9997,0,9999,2
1668544930477,COGS 205,A00,101395,Chiba; Andrea,19,0,20,1
1668544930909,COGS 210B,001,101404,Greene; Deanna Jacquelyn,9998,0,9999,1
1668544930909,COGS 210B,002,101417,Xia; Haijun,9999,0,9999,0
1668544930909,COGS 210B,003,101422,Nitz; Douglas A.,9999,0,9999,0
1668544930909,COGS 210B,004,101423,Hollan; James D.,9998,0,9999,1
1668544930909,COGS 210B,005,101424,Deak; Gedeon O.,9998,0,9999,1
1668544930909,COGS 210B,006,101425,Rossano; Federico,9999,0,9999,0
1668544931344,COGS 211B,A00,101427,Coulson; Seana M,9996,0,9999,3
1668544931775,COGS 220,A00,101428,Hollan; James D.,0,14,25,25
1668544932201,COGS 229,A00,101429,Dow; Steven P,17,0,25,8
1668544932627,COGS 230,A00,101430,Klemmer; Scott R,6,0,17,11
1668544933060,COGS 234,A00,101431,Xia; Haijun,0,1,25,25
1668544933486,COGS 260,A00,101432,Kiyonaga; Anastasia,21,0,25,4
1668544933486,COGS 260,B00,101433,Kirsh; David Joel,15,0,25,10
1668544933911,CSE 202,A00,102371,Impagliazzo; Russell,0,68,0,0
1668544934346,CSE 203B,A01,102373,Cheng; Chung Kuan,0,62,0,0
1668544934775,CSE 208,A00,102374,Micciancio; Daniele,0,5,0,0
1668544935201,CSE 209A,A00,112895,Impagliazzo; Russell,0,13,15,15
1668544935626,CSE 209B,A00,108005,Bellare; Mihir,0,7,0,0
1668544936061,CSE 210,A00,113163,Coblenz; Michael J,0,89,0,0
1668544936504,CSE 219,A00,106111,Dow; Steven P,0,8,20,20
1668544936927,CSE 221,A00,102376,Voelker; Geoffrey M.,0,75,0,0
1668544937354,CSE 224,A01,102378,Porter; George M,0,173,0,0
1668544937834,CSE 229A,A00,102379,Savage; Stefan,0,11,0,0
1668544938256,CSE 229C,A00,102380,Munyaka; Imani N. S.,0,10,0,0
1668544938779,CSE 232B,A00,102382,Deutsch; Alin Bernard,0,37,0,0
1668544939206,CSE 234,A01,112904,Kumar; Arun Kumar,0,0,0,0
1668544939630,CSE 237A,A00,102383,Rosing; Tajana Simunic,0,56,0,0
1668544940056,CSE 239A,A00,102384,Deutsch; Alin Bernard,0,16,0,0
1668544940481,CSE 239B,A00,102385,Polikarpova; Nadezhda,0,11,0,0
1668544940904,CSE 240A,A00,102386,Pannuto; Patrick William,0,47,0,0
1668544941332,CSE 240B,A00,102387,Zhao; Jishen,0,50,0,0
1668544941765,CSE 241A,A00,106406,Kang; Mingu,0,9,0,0
1668544942194,CSE 249B,A00,102388,Kahng; Andrew Byun,0,5,8,8
1668544942626,CSE 251B,A01,102392,Cottrell; Garrison W,0,52,0,0
1668544942626,CSE 251B,A02,102393,Cottrell; Garrison W,0,35,0,0
1668544943053,CSE 252B,A00,102394,Ochoa; Benjamin Lawrence,0,61,0,0
1668544943477,CSE 257,A01,102396,Gao; Sicun,0,149,0,0
1668544943911,CSE 272,A00,102397,Li; Tzumao,0,19,0,0
1668544944353,CSE 274,A00,111323,Chern; Albert Ren-Haur,0,15,0,0
1668544944781,CSE 282,A00,102398,Pevzner; Pavel Arkadjevich,0,0,0,0
1668544945220,CSE 284,A00,114175,Gymrek; Melissa Ann,0,26,0,0
1668544945647,CSE 290,A00,102399,Chandraker; Manmohan Krishna,0,11,0,0
1668544945647,CSE 290,B00,102400,Vaccaro; Kristen Marie,0,8,25,25
1668544945647,CSE 290,C00,102414,Pannuto; Patrick William,0,1,25,25
1668544945647,CSE 290,D00,102427,Pevzner; Pavel Arkadjevich,0,0,0,0
1668544945647,CSE 290,E00,102429,Zhao; Jishen,0,6,0,0
1668544945647,CSE 290,F00,102436,Tullsen; Dean Michael,0,6,0,0
1668544945647,CSE 290,G00,102440,Christensen; Henrik I,0,6,20,20
1668544946077,CSE 291,A00,102443,Su; Hao,0,0,0,0
1668544946077,CSE 291,B00,102448,Polikarpova; Nadezhda,0,0,0,0
1668544946077,CSE 291,C00,102453,Vaccaro; Kristen Marie,0,0,0,0
1668544946077,CSE 291,D00,111343,Savage; Stefan,0,0,0,0
1668544946077,CSE 291,E00,116474,Claffy; Kimberly Claire,0,0,0,0
1668544946077,CSE 291,F00,116479,Pasquale; Joseph,0,0,0,0
1668544946514,CSE 293,001,119111,Bafna; Vineet,9999,0,9999,0
1668544946514,CSE 293,002,119118,Bellare; Mihir,9999,0,9999,0
1668544946514,CSE 293,003,119122,Berg-Kirkpatrick; Taylor D,9999,0,9999,0
1668544946514,CSE 293,004,119135,Christensen; Henrik I,9999,0,9999,0
1668544946514,CSE 293,005,119142,Cottrell; Garrison W,9999,0,9999,0
1668544946514,CSE 293,006,119146,Deutsch; Alin Bernard,9999,0,9999,0
1668544946514,CSE 293,007,119159,Esmaeilzadeh; Hadi,9999,0,9999,0
1668544946514,CSE 293,008,119166,Freund; Yoav,9999,0,9999,0
1668544946514,CSE 293,009,119170,Griswold; William G.,9999,0,9999,0
1668544946514,CSE 293,010,119183,Gymrek; Melissa Ann,9999,0,9999,0
1668544946514,CSE 293,011,119190,Heninger; Nadia A,9999,0,9999,0
1668544946514,CSE 293,012,119230,Impagliazzo; Russell,9999,0,9999,0
1668544946514,CSE 293,013,119232,Jhala; Ranjit,9999,0,9999,0
1668544946514,CSE 293,014,119233,Kahng; Andrew Byun,9999,0,9999,0
1668544946514,CSE 293,015,119298,Kane; Daniel Mertz,9999,0,9999,0
1668544946514,CSE 293,016,119299,Kriegman; David J,9999,0,9999,0
1668544946514,CSE 293,017,119300,Kumar; Arun Kumar,9999,0,9999,0
1668544946514,CSE 293,018,119301,Lerner; Sorin,9999,0,9999,0
1668544946514,CSE 293,019,119302,Lovett; Shachar,9999,0,9999,0
1668544946514,CSE 293,020,119303,McAuley; Julian John,9999,0,9999,0
1668544946514,CSE 293,021,119304,Micciancio; Daniele,9999,0,9999,0
1668544946514,CSE 293,022,119367,Orailoglu; Alex,9999,0,9999,0
1668544946514,CSE 293,023,119382,Paturi; Ramamohan,9999,0,9999,0
1668544946514,CSE 293,024,119404,Polikarpova; Nadezhda,9999,0,9999,0
1668544946514,CSE 293,025,119406,Politz; Joseph Gibbs,9999,0,9999,0
1668544946514,CSE 293,026,119411,Porter; George M,9999,0,9999,0
1668544946514,CSE 293,027,119414,Porter; Leonard Emerson,9999,0,9999,0
1668544946514,CSE 293,028,119416,Ramamoorthi; Ravi,9999,0,9999,0
1668544946514,CSE 293,029,119417,Sahoo; Debashis,9999,0,9999,0
1668544946514,CSE 293,030,119420,Saul; Lawrence,9999,0,9999,0
1668544946514,CSE 293,031,119421,Savage; Stefan,9999,0,9999,0
1668544946514,CSE 293,032,119425,Schulze; Jurgen P.,9999,0,9999,0
1668544946514,CSE 293,033,119426,Snoeren; Alex C.,9999,0,9999,0
1668544946514,CSE 293,034,119428,Shang; Jingbo,9999,0,9999,0
1668544946514,CSE 293,035,119430,Stefan; Deian,9999,0,9999,0
1668544946514,CSE 293,036,119431,Su; Hao,9999,0,9999,0
1668544946514,CSE 293,037,119433,Swanson; Steven James,9999,0,9999,0
1668544946514,CSE 293,038,119435,Tullsen; Dean Michael,9999,0,9999,0
1668544946514,CSE 293,039,119483,Voelker; Geoffrey M.,9999,0,9999,0
1668544946514,CSE 293,040,119537,Zhao; Jishen,9999,0,9999,0
1668544946514,CSE 293,041,119538,Zhou; Yuan-Yuan,9999,0,9999,0
1668544946514,CSE 293,042,119539,Gao; Sicun,9999,0,9999,0
1668544946514,CSE 293,043,119540,Weibel; Nadir,9999,0,9999,0
1668544946514,CSE 293,044,119541,Gupta; Rajesh K.,9999,0,9999,0
1668544946514,CSE 293,045,126410,Vaccaro; Kristen Marie,9999,0,9999,0
1668544946514,CSE 293,046,126411,Klemke; Richard,9999,0,9999,0
1668544946938,CSE 294,A00,102459,Voelker; Geoffrey M.,0,2,0,0
1668544946938,CSE 294,B00,111322,Orailoglu; Alex,0,2,0,0
1668544947373,DSE 201,A00,096914,Deutsch; Alin Bernard,30,0,30,0
1668544947799,DSE 210,A00,096915,Dasgupta; Sanjoy,30,0,30,0
1668544948223,DSE 260A,A00,096916,Altintas De Callaf; Ilkay,30,0,30,0
1668544948667,ECE 200,001,103586,Antipa; Nicholas A,9999,0,9999,0
1668544948667,ECE 200,002,103587,Atanasov; Nikolay A.,9999,0,9999,0
1668544948667,ECE 200,003,103588,Bharadia; Dinesh,9999,0,9999,0
1668544948667,ECE 200,004,103589,Cheng; Chung Kuan,9999,0,9999,0
1668544948667,ECE 200,005,103590,Cosman; Pamela C.,9999,0,9999,0
1668544948667,ECE 200,006,103591,Dayeh; Shadi Ahmad,9999,0,9999,0
1668544948667,ECE 200,007,103592,Fainman; Yeshaiahu,9999,0,9999,0
1668544948667,ECE 200,008,103593,Ford; Joseph Earl,9999,0,9999,0
1668544948667,ECE 200,009,103594,Franceschetti; Massimo,9999,0,9999,0
1668544948667,ECE 200,010,103595,Fullerton; Eric E,9999,0,9999,0
1668544948667,ECE 200,011,103596,Galton; Ian A,9999,0,9999,0
1668544948667,ECE 200,012,103597,Gilja; Vikash,9999,0,9999,0
1668544948667,ECE 200,013,103598,Hall; Drew A.,9999,0,9999,0
1668544948667,ECE 200,014,103599,Hsueh; Tzu-Chien,9999,0,9999,0
1668544948667,ECE 200,015,103600,Javidi; Tara,9999,0,9999,0
1668544948667,ECE 200,016,103601,Kahng; Andrew Byun,9999,0,9999,0
1668544948667,ECE 200,017,103602,Kim; Young-Han,9999,0,9999,0
1668544948667,ECE 200,018,103603,Koushanfar; Farinaz,9999,0,9999,0
1668544948667,ECE 200,019,103604,Kuzum; Duygu,9999,0,9999,0
1668544948667,ECE 200,020,103605,Le; Hanh-Phuc,9999,0,9999,0
1668544948667,ECE 200,021,103606,Lin; Bill,9999,0,9999,0
1668544948667,ECE 200,022,103607,Liu; Zhaowei,9998,0,9999,1
1668544948667,ECE 200,023,103608,Lo; Yu-Hwa,9999,0,9999,0
1668544948667,ECE 200,024,103609,Lomakin; Vitaliy,9999,0,9999,0
1668544948667,ECE 200,025,103610,Mercier; Patrick Philip,9999,0,9999,0
1668544948667,ECE 200,026,103611,Meyer; Florian,9999,0,9999,0
1668544948667,ECE 200,027,103612,Milstein; Laurence B.,9999,0,9999,0
1668544948667,ECE 200,028,103613,Mir Arabbaygi; Siavash,9999,0,9999,0
1668544948667,ECE 200,029,103614,Mookherjea; Shayan,9999,0,9999,0
1668544948667,ECE 200,030,103615,Morris; Karcher William,9999,0,9999,0
1668544948667,ECE 200,031,103616,Ng; Tse Nga,9999,0,9999,0
1668544948667,ECE 200,032,103617,Nguyen; Truong Quang,9999,0,9999,0
1668544948667,ECE 200,033,103618,Nomura; Kenji,9999,0,9999,0
1668544948667,ECE 200,034,103619,Orlitsky; Alon,9999,0,9999,0
1668544948667,ECE 200,035,103620,Pal; Piya,9999,0,9999,0
1668544948667,ECE 200,036,103621,Papen; George C.,9999,0,9999,0
1668544948667,ECE 200,037,103622,Radic; Stojan,9999,0,9999,0
1668544948667,ECE 200,038,103623,Rao; Bhaskar D.,9999,0,9999,0
1668544948667,ECE 200,039,103624,Rao; Ramesh R,9999,0,9999,0
1668544948667,ECE 200,040,103625,Rebeiz; Gabriel,9999,0,9999,0
1668544948667,ECE 200,041,103626,Sanford; John R,9999,0,9999,0
1668544948667,ECE 200,042,103627,Siegel; Paul H.,9999,0,9999,0
1668544948667,ECE 200,043,103628,Sievenpiper; Daniel F.,9999,0,9999,0
1668544948667,ECE 200,044,103629,Sworder; David D.,9999,0,9999,0
1668544948667,ECE 200,045,103630,Taur; Yuan,9999,0,9999,0
1668544948667,ECE 200,046,103631,Touri; Behrouz,9999,0,9999,0
1668544948667,ECE 200,047,103632,Trivedi; Mohan M.,9999,0,9999,0
1668544948667,ECE 200,048,103633,Vasconcelos; Nuno,9999,0,9999,0
1668544948667,ECE 200,049,103634,Wang; Xiaolong,9999,0,9999,0
1668544948667,ECE 200,050,103635,Xie; Pengtao,9999,0,9999,0
1668544948667,ECE 200,051,103636,Yip; Michael,9999,0,9999,0
1668544948667,ECE 200,052,103637,Zeger; Kenneth A.,999,0,999,0
1668544948667,ECE 200,053,103638,Zhang; Xinyu,9999,0,9999,0
1668544948667,ECE 200,054,103639,Turakhia; Yatish Girish,9999,0,9999,0
1668544948667,ECE 200,055,103640,Kang; Mingu,9999,0,9999,0
1668544948667,ECE 200,056,103641,Shi; Yuanyuan,9999,0,9999,0
1668544948667,ECE 200,057,103642,Wang; Edward Jay,9999,0,9999,0
1668544948667,ECE 200,058,103643,Zheng; Yang,9999,0,9999,0
1668544949098,ECE 202,A00,103644,Kuzum; Duygu,0,45,0,0
1668544949522,ECE 212BN,A00,103646,Ng; Tse Nga,0,9,0,0
1668544949947,ECE 221,A00,111493,Staff,0,0,0,0
1668544950371,ECE 222B,A00,103647,Lomakin; Vitaliy,0,20,0,0
1668544950809,ECE 230B,A00,103648,Taur; Yuan,0,3,0,0
1668544951234,ECE 238B,A00,103649,Garay; Javier,0,0,0,0
1668544951657,ECE 240B,A00,112900,Fainman; Yeshaiahu,0,7,0,0
1668544952094,ECE 247A,A00,103650,Jokerst; Jesse Vincent,0,6,0,0
1668544952521,ECE 247B,A00,103651,Wang; Joseph,0,14,0,0
1668544952956,ECE 250,A00,103652,Siegel; Paul H.,0,82,0,0
1668544953401,ECE 251A,A00,103654,Rao; Bhaskar D.,0,63,0,0
1668544953842,ECE 257B,A00,103655,Bharadia; Dinesh,0,33,0,0
1668544954264,ECE 258A,A00,103656,Milstein; Laurence B.,0,29,0,0
1668544954688,ECE 260B,A00,103658,Kang; Mingu,0,123,0,0
1668544955121,ECE 264A,A00,103659,Galton; Ian A,0,72,0,0
1668544955546,ECE 265A,A00,103661,Gudem; Prasad S.S.,0,73,0,0
1668544955980,ECE 265D,A00,103662,Gudem; Prasad S.S.,0,26,0,0
1668544956402,ECE 268,A00,103663,Koushanfar; Farinaz,0,43,0,0
1668544956828,ECE 269,A01,103665,Pal; Piya,0,219,0,0
1668544957257,ECE 271B,A00,103666,Vasconcelos; Manuela,0,78,0,0
1668544957689,ECE 276A,A00,103667,Atanasov; Nikolay A.,0,127,0,0
1668544958114,ECE 277,A00,103668,An; Cheolhong,0,151,0,0
1668544958539,ECE 279,A00,117947,Hall; Drew A.,0,22,0,0
1668544959391,ECE 283,A00,103670,Hsueh; Tzu-Chien,0,57,0,0
1668544959815,ECE 284,A00,103671,Turakhia; Yatish Girish,0,40,0,0
1668544960252,ECE 285,A00,103672,Zheng; Yang,0,41,0,0
1668544960252,ECE 285,B00,103673,Sworder; David D.,0,60,0,0
1668544960677,ECE 287,A00,103676,Javidi; Tara,0,9,0,0
1668544961101,MATH 200B,A00,098023,Salehi Golsefidy; Alireza,10,0,15,5
1668544961523,MATH 202B,A00,098024,Rhoades; Brendon Patrick,7,0,15,8
1668544961946,MATH 203B,A00,098025,Oprea; Dragos N.,9,0,15,6
1668544962377,MATH 204B,A00,098026,Sorensen; Claus M,13,0,15,2
1668544962800,MATH 208,A00,098027,Izadi; Elham,7,0,10,3
1668544963222,MATH 209,A00,098028,Pollack; Aaron,10,0,10,0
1668544963646,MATH 211A,A00,112919,Rogalski; Daniel,8,0,10,2
1668544964069,MATH 211B,A00,112920,Seward; Brandon M.,9,0,10,1
1668544964499,MATH 218,A00,098029,Li; Bo,10,0,10,0
1668544964920,MATH 220B,A00,098030,Novak; Jonathan I,11,0,15,4
1668544965344,MATH 221A,A00,098031,Ebenfelt; Peter F,12,0,15,3
1668544965772,MATH 231B,A00,098032,Zlatos; Andrej,10,0,15,5
1668544966198,MATH 240B,A00,098033,Ni; Lei,7,0,15,8
1668544966618,MATH 243,A00,098034,Jekel; David Andrew,10,0,10,0
1668544967041,MATH 245A,A00,098035,Nie; Jiawang,0,5,15,18
1668544967469,MATH 248,A00,098036,Bejenaru; Ioan,10,0,10,0
1668544967903,MATH 250B,A00,098037,Spolaor; Luca,14,0,15,1
1668544968330,MATH 258,A00,098038,Ni; Lei,9,0,10,1
1668544968757,MATH 264B,A00,098041,Rhoades; Brendon Patrick,8,0,15,7
1668544969180,MATH 268,A00,098042,Buss; Samuel R,10,0,10,0
1668544969605,MATH 269,A00,098043,Rhoades; Brendon Patrick,10,0,10,0
1668544970034,MATH 270B,A00,098044,Li; Bo,6,0,15,9
1668544970459,MATH 272B,A00,098045,Holst; Michael J,13,0,15,2
1668544970890,MATH 273A,A00,098046,Tian; Xiaochuan,10,0,15,5
1668544971315,MATH 275,A01,098048,Tian; Xiaochuan,6,0,10,4
1668544971738,MATH 278A,A00,098049,Holst; Michael J,6,0,10,4
1668544972162,MATH 278B,A00,098050,Cloninger; Alexander,10,0,10,0
1668544972595,MATH 278C,A00,098051,Nie; Jiawang,5,0,10,5
1668544973031,MATH 280B,A00,098052,Zheng; Tianyi,7,0,15,8
1668544973464,MATH 281B,A00,098053,Bradic; Jelena,0,2,15,15
1668544973897,MATH 282B,A00,098054,Arias-Castro; Ery,0,1,15,15
1668544974327,MATH 285,A00,098055,Fitzsimmons; Patrick J,0,4,15,17
1668544974758,MATH 287B,A00,098056,Arias-Castro; Ery,1,0,15,14
1668544975183,MATH 288,A00,098057,Agarwal; Pooja,9,0,10,1
1668544975183,MATH 288,B00,098058,Zhang; Danna,8,0,10,2
1668544975183,MATH 288,C00,098059,Williams; Ruth J,9,0,10,1
1668544975605,MATH 290B,A00,098060,Roberts; Justin Deritter,12,0,15,3
1668544976031,MATH 292,A00,098061,Belmont; Eva Kinoshita,10,0,10,0
1668544976454,MATH 295,A00,098062,Suk; Andrew Hoon,47,0,50,3
1668544976878,MATH 296,A00,098063,Novak; Jonathan I,20,0,20,0
1668544977304,MATH 297,001,098064,Gamst; Anthony Collins,9997,0,9999,2
1668545481922,COGS 205,A00,101395,Chiba; Andrea,19,0,20,1
1668545482350,COGS 210B,001,101404,Greene; Deanna Jacquelyn,9998,0,9999,1
1668545482350,COGS 210B,002,101417,Xia; Haijun,9999,0,9999,0
1668545482350,COGS 210B,003,101422,Nitz; Douglas A.,9999,0,9999,0
1668545482350,COGS 210B,004,101423,Hollan; James D.,9998,0,9999,1
1668545482350,COGS 210B,005,101424,Deak; Gedeon O.,9998,0,9999,1
1668545482350,COGS 210B,006,101425,Rossano; Federico,9999,0,9999,0
1668545482783,COGS 211B,A00,101427,Coulson; Seana M,9996,0,9999,3
1668545483215,COGS 220,A00,101428,Hollan; James D.,0,14,25,25
1668545483639,COGS 229,A00,101429,Dow; Steven P,17,0,25,8
1668545484066,COGS 230,A00,101430,Klemmer; Scott R,6,0,17,11
1668545484490,COGS 234,A00,101431,Xia; Haijun,0,1,25,25
1668545484920,COGS 260,A00,101432,Kiyonaga; Anastasia,21,0,25,4
1668545484920,COGS 260,B00,101433,Kirsh; David Joel,15,0,25,10
1668545485343,CSE 202,A00,102371,Impagliazzo; Russell,0,68,0,0
1668545485770,CSE 203B,A01,102373,Cheng; Chung Kuan,0,62,0,0
1668545486194,CSE 208,A00,102374,Micciancio; Daniele,0,5,0,0
1668545486618,CSE 209A,A00,112895,Impagliazzo; Russell,0,13,15,15
1668545487042,CSE 209B,A00,108005,Bellare; Mihir,0,7,0,0
1668545487467,CSE 210,A00,113163,Coblenz; Michael J,0,89,0,0
1668545487902,CSE 219,A00,106111,Dow; Steven P,0,8,20,20
1668545488331,CSE 221,A00,102376,Voelker; Geoffrey M.,0,75,0,0
1668545488759,CSE 224,A01,102378,Porter; George M,0,173,0,0
1668545489195,CSE 229A,A00,102379,Savage; Stefan,0,11,0,0
1668545489635,CSE 229C,A00,102380,Munyaka; Imani N. S.,0,10,0,0
1668545490066,CSE 232B,A00,102382,Deutsch; Alin Bernard,0,37,0,0
1668545490495,CSE 234,A01,112904,Kumar; Arun Kumar,0,0,0,0
1668545490927,CSE 237A,A00,102383,Rosing; Tajana Simunic,0,56,0,0
1668545491357,CSE 239A,A00,102384,Deutsch; Alin Bernard,0,16,0,0
1668545491798,CSE 239B,A00,102385,Polikarpova; Nadezhda,0,11,0,0
1668545492222,CSE 240A,A00,102386,Pannuto; Patrick William,0,47,0,0
1668545492651,CSE 240B,A00,102387,Zhao; Jishen,0,50,0,0
1668545493082,CSE 241A,A00,106406,Kang; Mingu,0,9,0,0
1668545493505,CSE 249B,A00,102388,Kahng; Andrew Byun,0,5,8,8
1668545493929,CSE 251B,A01,102392,Cottrell; Garrison W,0,52,0,0
1668545493929,CSE 251B,A02,102393,Cottrell; Garrison W,0,35,0,0
1668545494356,CSE 252B,A00,102394,Ochoa; Benjamin Lawrence,0,61,0,0
1668545494797,CSE 257,A01,102396,Gao; Sicun,0,149,0,0
1668545495233,CSE 272,A00,102397,Li; Tzumao,0,19,0,0
1668545495657,CSE 274,A00,111323,Chern; Albert Ren-Haur,0,15,0,0
1668545496078,CSE 282,A00,102398,Pevzner; Pavel Arkadjevich,0,0,0,0
1668545496505,CSE 284,A00,114175,Gymrek; Melissa Ann,0,27,0,0
1668545496933,CSE 290,A00,102399,Chandraker; Manmohan Krishna,0,11,0,0
1668545496933,CSE 290,B00,102400,Vaccaro; Kristen Marie,0,8,25,25
1668545496933,CSE 290,C00,102414,Pannuto; Patrick William,0,1,25,25
1668545496933,CSE 290,D00,102427,Pevzner; Pavel Arkadjevich,0,0,0,0
1668545496933,CSE 290,E00,102429,Zhao; Jishen,0,6,0,0
1668545496933,CSE 290,F00,102436,Tullsen; Dean Michael,0,6,0,0
1668545496933,CSE 290,G00,102440,Christensen; Henrik I,0,6,20,20
1668545497376,CSE 291,A00,102443,Su; Hao,0,0,0,0
1668545497376,CSE 291,B00,102448,Polikarpova; Nadezhda,0,0,0,0
1668545497376,CSE 291,C00,102453,Vaccaro; Kristen Marie,0,0,0,0
1668545497376,CSE 291,D00,111343,Savage; Stefan,0,0,0,0
1668545497376,CSE 291,E00,116474,Claffy; Kimberly Claire,0,0,0,0
1668545497376,CSE 291,F00,116479,Pasquale; Joseph,0,0,0,0
1668545497804,CSE 293,001,119111,Bafna; Vineet,9999,0,9999,0
1668545497804,CSE 293,002,119118,Bellare; Mihir,9999,0,9999,0
1668545497804,CSE 293,003,119122,Berg-Kirkpatrick; Taylor D,9999,0,9999,0
1668545497804,CSE 293,004,119135,Christensen; Henrik I,9999,0,9999,0
1668545497804,CSE 293,005,119142,Cottrell; Garrison W,9999,0,9999,0
1668545497804,CSE 293,006,119146,Deutsch; Alin Bernard,9999,0,9999,0
1668545497804,CSE 293,007,119159,Esmaeilzadeh; Hadi,9999,0,9999,0
1668545497804,CSE 293,008,119166,Freund; Yoav,9999,0,9999,0
1668545497804,CSE 293,009,119170,Griswold; William G.,9999,0,9999,0
1668545497804,CSE 293,010,119183,Gymrek; Melissa Ann,9999,0,9999,0
1668545497804,CSE 293,011,119190,Heninger; Nadia A,9999,0,9999,0
1668545497804,CSE 293,012,119230,Impagliazzo; Russell,9999,0,9999,0
1668545497804,CSE 293,013,119232,Jhala; Ranjit,9999,0,9999,0
1668545497804,CSE 293,014,119233,Kahng; Andrew Byun,9999,0,9999,0
1668545497804,CSE 293,015,119298,Kane; Daniel Mertz,9999,0,9999,0
1668545497804,CSE 293,016,119299,Kriegman; David J,9999,0,9999,0
1668545497804,CSE 293,017,119300,Kumar; Arun Kumar,9999,0,9999,0
1668545497804,CSE 293,018,119301,Lerner; Sorin,9999,0,9999,0
1668545497804,CSE 293,019,119302,Lovett; Shachar,9999,0,9999,0
1668545497804,CSE 293,020,119303,McAuley; Julian John,9999,0,9999,0
1668545497804,CSE 293,021,119304,Micciancio; Daniele,9999,0,9999,0
1668545497804,CSE 293,022,119367,Orailoglu; Alex,9999,0,9999,0
1668545497804,CSE 293,023,119382,Paturi; Ramamohan,9999,0,9999,0
1668545497804,CSE 293,024,119404,Polikarpova; Nadezhda,9999,0,9999,0
1668545497804,CSE 293,025,119406,Politz; Joseph Gibbs,9999,0,9999,0
1668545497804,CSE 293,026,119411,Porter; George M,9999,0,9999,0
1668545497804,CSE 293,027,119414,Porter; Leonard Emerson,9999,0,9999,0
1668545497804,CSE 293,028,119416,Ramamoorthi; Ravi,9999,0,9999,0
1668545497804,CSE 293,029,119417,Sahoo; Debashis,9999,0,9999,0
1668545497804,CSE 293,030,119420,Saul; Lawrence,9999,0,9999,0
1668545497804,CSE 293,031,119421,Savage; Stefan,9999,0,9999,0
1668545497804,CSE 293,032,119425,Schulze; Jurgen P.,9999,0,9999,0
1668545497804,CSE 293,033,119426,Snoeren; Alex C.,9999,0,9999,0
1668545497804,CSE 293,034,119428,Shang; Jingbo,9999,0,9999,0
1668545497804,CSE 293,035,119430,Stefan; Deian,9999,0,9999,0
1668545497804,CSE 293,036,119431,Su; Hao,9999,0,9999,0
1668545497804,CSE 293,037,119433,Swanson; Steven James,9999,0,9999,0
1668545497804,CSE 293,038,119435,Tullsen; Dean Michael,9999,0,9999,0
1668545497804,CSE 293,039,119483,Voelker; Geoffrey M.,9999,0,9999,0
1668545497804,CSE 293,040,119537,Zhao; Jishen,9999,0,9999,0
1668545497804,CSE 293,041,119538,Zhou; Yuan-Yuan,9999,0,9999,0
1668545497804,CSE 293,042,119539,Gao; Sicun,9999,0,9999,0
1668545497804,CSE 293,043,119540,Weibel; Nadir,9999,0,9999,0
1668545497804,CSE 293,044,119541,Gupta; Rajesh K.,9999,0,9999,0
1668545497804,CSE 293,045,126410,Vaccaro; Kristen Marie,9999,0,9999,0
1668545497804,CSE 293,046,126411,Klemke; Richard,9999,0,9999,0
1668545498229,CSE 294,A00,102459,Voelker; Geoffrey M.,0,2,0,0
1668545498229,CSE 294,B00,111322,Orailoglu; Alex,0,2,0,0
1668545498650,DSE 201,A00,096914,Deutsch; Alin Bernard,30,0,30,0
1668545499076,DSE 210,A00,096915,Dasgupta; Sanjoy,30,0,30,0
1668545499504,DSE 260A,A00,096916,Altintas De Callaf; Ilkay,30,0,30,0
1668545499957,ECE 200,001,103586,Antipa; Nicholas A,9999,0,9999,0
1668545499957,ECE 200,002,103587,Atanasov; Nikolay A.,9999,0,9999,0
1668545499957,ECE 200,003,103588,Bharadia; Dinesh,9999,0,9999,0
1668545499957,ECE 200,004,103589,Cheng; Chung Kuan,9999,0,9999,0
1668545499957,ECE 200,005,103590,Cosman; Pamela C.,9999,0,9999,0
1668545499957,ECE 200,006,103591,Dayeh; Shadi Ahmad,9999,0,9999,0
1668545499957,ECE 200,007,103592,Fainman; Yeshaiahu,9999,0,9999,0
1668545499957,ECE 200,008,103593,Ford; Joseph Earl,9999,0,9999,0
1668545499957,ECE 200,009,103594,Franceschetti; Massimo,9999,0,9999,0
1668545499957,ECE 200,010,103595,Fullerton; Eric E,9999,0,9999,0
1668545499957,ECE 200,011,103596,Galton; Ian A,9999,0,9999,0
1668545499957,ECE 200,012,103597,Gilja; Vikash,9999,0,9999,0
1668545499957,ECE 200,013,103598,Hall; Drew A.,9999,0,9999,0
1668545499957,ECE 200,014,103599,Hsueh; Tzu-Chien,9999,0,9999,0
1668545499957,ECE 200,015,103600,Javidi; Tara,9999,0,9999,0
1668545499957,ECE 200,016,103601,Kahng; Andrew Byun,9999,0,9999,0
1668545499957,ECE 200,017,103602,Kim; Young-Han,9999,0,9999,0
1668545499957,ECE 200,018,103603,Koushanfar; Farinaz,9999,0,9999,0
1668545499957,ECE 200,019,103604,Kuzum; Duygu,9999,0,9999,0
1668545499957,ECE 200,020,103605,Le; Hanh-Phuc,9999,0,9999,0
1668545499957,ECE 200,021,103606,Lin; Bill,9999,0,9999,0
1668545499957,ECE 200,022,103607,Liu; Zhaowei,9998,0,9999,1
1668545499957,ECE 200,023,103608,Lo; Yu-Hwa,9999,0,9999,0
1668545499957,ECE 200,024,103609,Lomakin; Vitaliy,9999,0,9999,0
1668545499957,ECE 200,025,103610,Mercier; Patrick Philip,9999,0,9999,0
1668545499957,ECE 200,026,103611,Meyer; Florian,9999,0,9999,0
1668545499957,ECE 200,027,103612,Milstein; Laurence B.,9999,0,9999,0
1668545499957,ECE 200,028,103613,Mir Arabbaygi; Siavash,9999,0,9999,0
1668545499957,ECE 200,029,103614,Mookherjea; Shayan,9999,0,9999,0
1668545499957,ECE 200,030,103615,Morris; Karcher William,9999,0,9999,0
1668545499957,ECE 200,031,103616,Ng; Tse Nga,9999,0,9999,0
1668545499957,ECE 200,032,103617,Nguyen; Truong Quang,9999,0,9999,0
1668545499957,ECE 200,033,103618,Nomura; Kenji,9999,0,9999,0
1668545499957,ECE 200,034,103619,Orlitsky; Alon,9999,0,9999,0
1668545499957,ECE 200,035,103620,Pal; Piya,9999,0,9999,0
1668545499957,ECE 200,036,103621,Papen; George C.,9999,0,9999,0
1668545499957,ECE 200,037,103622,Radic; Stojan,9999,0,9999,0
1668545499957,ECE 200,038,103623,Rao; Bhaskar D.,9999,0,9999,0
1668545499957,ECE 200,039,103624,Rao; Ramesh R,9999,0,9999,0
1668545499957,ECE 200,040,103625,Rebeiz; Gabriel,9999,0,9999,0
1668545499957,ECE 200,041,103626,Sanford; John R,9999,0,9999,0
1668545499957,ECE 200,042,103627,Siegel; Paul H.,9999,0,9999,0
1668545499957,ECE 200,043,103628,Sievenpiper; Daniel F.,9999,0,9999,0
1668545499957,ECE 200,044,103629,Sworder; David D.,9999,0,9999,0
1668545499957,ECE 200,045,103630,Taur; Yuan,9999,0,9999,0
1668545499957,ECE 200,046,103631,Touri; Behrouz,9999,0,9999,0
1668545499957,ECE 200,047,103632,Trivedi; Mohan M.,9999,0,9999,0
1668545499957,ECE 200,048,103633,Vasconcelos; Nuno,9999,0,9999,0
1668545499957,ECE 200,049,103634,Wang; Xiaolong,9999,0,9999,0
1668545499957,ECE 200,050,103635,Xie; Pengtao,9999,0,9999,0
1668545499957,ECE 200,051,103636,Yip; Michael,9999,0,9999,0
1668545499957,ECE 200,052,103637,Zeger; Kenneth A.,999,0,999,0
1668545499957,ECE 200,053,103638,Zhang; Xinyu,9999,0,9999,0
1668545499957,ECE 200,054,103639,Turakhia; Yatish Girish,9999,0,9999,0
1668545499957,ECE 200,055,103640,Kang; Mingu,9999,0,9999,0
1668545499957,ECE 200,056,103641,Shi; Yuanyuan,9999,0,9999,0
1668545499957,ECE 200,057,103642,Wang; Edward Jay,9999,0,9999,0
1668545499957,ECE 200,058,103643,Zheng; Yang,9999,0,9999,0
1668545500384,ECE 202,A00,103644,Kuzum; Duygu,0,45,0,0
1668545500808,ECE 212BN,A00,103646,Ng; Tse Nga,0,9,0,0
1668545501240,ECE 221,A00,111493,Staff,0,0,0,0
1668545501663,ECE 222B,A00,103647,Lomakin; Vitaliy,0,20,0,0
1668545502094,ECE 230B,A00,103648,Taur; Yuan,0,3,0,0
1668545502516,ECE 238B,A00,103649,Garay; Javier,0,0,0,0
1668545502957,ECE 240B,A00,112900,Fainman; Yeshaiahu,0,7,0,0
1668545503387,ECE 247A,A00,103650,Jokerst; Jesse Vincent,0,6,0,0
1668545503835,ECE 247B,A00,103651,Wang; Joseph,0,14,0,0
1668545504272,ECE 250,A00,103652,Siegel; Paul H.,0,82,0,0
1668545504698,ECE 251A,A00,103654,Rao; Bhaskar D.,0,63,0,0
1668545505214,ECE 257B,A00,103655,Bharadia; Dinesh,0,33,0,0
1668545505644,ECE 258A,A00,103656,Milstein; Laurence B.,0,29,0,0
1668545506082,ECE 260B,A00,103658,Kang; Mingu,0,123,0,0
1668545506506,ECE 264A,A00,103659,Galton; Ian A,0,72,0,0
1668545506960,ECE 265A,A00,103661,Gudem; Prasad S.S.,0,73,0,0
1668545507386,ECE 265D,A00,103662,Gudem; Prasad S.S.,0,26,0,0
1668545507811,ECE 268,A00,103663,Koushanfar; Farinaz,0,43,0,0
1668545508244,ECE 269,A01,103665,Pal; Piya,0,219,0,0
1668545508669,ECE 271B,A00,103666,Vasconcelos; Manuela,0,78,0,0
1668545509099,ECE 276A,A00,103667,Atanasov; Nikolay A.,0,127,0,0
1668545509522,ECE 277,A00,103668,An; Cheolhong,0,151,0,0
1668545509960,ECE 279,A00,117947,Hall; Drew A.,0,22,0,0
1668545510825,ECE 283,A00,103670,Hsueh; Tzu-Chien,0,57,0,0
1668545511265,ECE 284,A00,103671,Turakhia; Yatish Girish,0,40,0,0
1668545511694,ECE 285,A00,103672,Zheng; Yang,0,41,0,0
1668545511694,ECE 285,B00,103673,Sworder; David D.,0,61,0,0
1668545512117,ECE 287,A00,103676,Javidi; Tara,0,9,0,0
1668545512551,MATH 200B,A00,098023,Salehi Golsefidy; Alireza,10,0,15,5
1668545512973,MATH 202B,A00,098024,Rhoades; Brendon Patrick,7,0,15,8
1668545513398,MATH 203B,A00,098025,Oprea; Dragos N.,9,0,15,6
1668545513832,MATH 204B,A00,098026,Sorensen; Claus M,13,0,15,2
1668545514256,MATH 208,A00,098027,Izadi; Elham,7,0,10,3
1668545514684,MATH 209,A00,098028,Pollack; Aaron,10,0,10,0
1668545515112,MATH 211A,A00,112919,Rogalski; Daniel,8,0,10,2
1668545515536,MATH 211B,A00,112920,Seward; Brandon M.,9,0,10,1
1668545515969,MATH 218,A00,098029,Li; Bo,10,0,10,0
1668545516393,MATH 220B,A00,098030,Novak; Jonathan I,11,0,15,4
1668545516817,MATH 221A,A00,098031,Ebenfelt; Peter F,12,0,15,3
1668545517243,MATH 231B,A00,098032,Zlatos; Andrej,10,0,15,5
1668545517683,MATH 240B,A00,098033,Ni; Lei,7,0,15,8
1668545518106,MATH 243,A00,098034,Jekel; David Andrew,10,0,10,0
1668545518533,MATH 245A,A00,098035,Nie; Jiawang,0,5,15,18
1668545518960,MATH 248,A00,098036,Bejenaru; Ioan,10,0,10,0
1668545519387,MATH 250B,A00,098037,Spolaor; Luca,14,0,15,1
1668545519820,MATH 258,A00,098038,Ni; Lei,9,0,10,1
1668545520252,MATH 264B,A00,098041,Rhoades; Brendon Patrick,8,0,15,7
1668545520677,MATH 268,A00,098042,Buss; Samuel R,10,0,10,0
1668545521101,MATH 269,A00,098043,Rhoades; Brendon Patrick,10,0,10,0
1668545521529,MATH 270B,A00,098044,Li; Bo,6,0,15,9
1668545521961,MATH 272B,A00,098045,Holst; Michael J,13,0,15,2
1668545522384,MATH 273A,A00,098046,Tian; Xiaochuan,10,0,15,5
1668545522822,MATH 275,A01,098048,Tian; Xiaochuan,6,0,10,4
1668545523249,MATH 278A,A00,098049,Holst; Michael J,6,0,10,4
1668545523684,MATH 278B,A00,098050,Cloninger; Alexander,10,0,10,0
1668545524109,MATH 278C,A00,098051,Nie; Jiawang,5,0,10,5
1668545524538,MATH 280B,A00,098052,Zheng; Tianyi,7,0,15,8
1668545524978,MATH 281B,A00,098053,Bradic; Jelena,0,2,15,15
1668545525401,MATH 282B,A00,098054,Arias-Castro; Ery,0,1,15,15
1668545525824,MATH 285,A00,098055,Fitzsimmons; Patrick J,0,4,15,17
1668545526256,MATH 287B,A00,098056,Arias-Castro; Ery,1,0,15,14
1668545526687,MATH 288,A00,098057,Agarwal; Pooja,9,0,10,1
1668545526687,MATH 288,B00,098058,Zhang; Danna,8,0,10,2
1668545526687,MATH 288,C00,098059,Williams; Ruth J,9,0,10,1
1668545527118,MATH 290B,A00,098060,Roberts; Justin Deritter,12,0,15,3
1668545527545,MATH 292,A00,098061,Belmont; Eva Kinoshita,10,0,10,0
1668545527986,MATH 295,A00,098062,Suk; Andrew Hoon,47,0,50,3
1668545528411,MATH 296,A00,098063,Novak; Jonathan I,20,0,20,0
1668545528853,MATH 297,001,098064,Gamst; Anthony Collins,9997,0,9999,2
1668546047325,COGS 205,A00,101395,Chiba; Andrea,19,0,20,1
1668546047755,COGS 210B,001,101404,Greene; Deanna Jacquelyn,9998,0,9999,1
1668546047755,COGS 210B,002,101417,Xia; Haijun,9999,0,9999,0
1668546047755,COGS 210B,003,101422,Nitz; Douglas A.,9999,0,9999,0
1668546047755,COGS 210B,004,101423,Hollan; James D.,9998,0,9999,1
1668546047755,COGS 210B,005,101424,Deak; Gedeon O.,9998,0,9999,1
1668546047755,COGS 210B,006,101425,Rossano; Federico,9999,0,9999,0
1668546048191,COGS 211B,A00,101427,Coulson; Seana M,9996,0,9999,3
1668546048625,COGS 220,A00,101428,Hollan; James D.,0,14,25,25
1668546049057,COGS 229,A00,101429,Dow; Steven P,17,0,25,8
1668546049485,COGS 230,A00,101430,Klemmer; Scott R,6,0,17,11
1668546049924,COGS 234,A00,101431,Xia; Haijun,0,1,25,25
1668546050361,COGS 260,A00,101432,Kiyonaga; Anastasia,21,0,25,4
1668546050361,COGS 260,B00,101433,Kirsh; David Joel,15,0,25,10
1668546050786,CSE 202,A00,102371,Impagliazzo; Russell,0,68,0,0
1668546051218,CSE 203B,A01,102373,Cheng; Chung Kuan,0,62,0,0
1668546051642,CSE 208,A00,102374,Micciancio; Daniele,0,5,0,0
1668546052082,CSE 209A,A00,112895,Impagliazzo; Russell,0,13,15,15
1668546052518,CSE 209B,A00,108005,Bellare; Mihir,0,7,0,0
1668546052947,CSE 210,A00,113163,Coblenz; Michael J,0,89,0,0
1668546053369,CSE 219,A00,106111,Dow; Steven P,0,8,20,20
1668546053803,CSE 221,A00,102376,Voelker; Geoffrey M.,0,75,0,0
1668546054229,CSE 224,A01,102378,Porter; George M,0,173,0,0
1668546054653,CSE 229A,A00,102379,Savage; Stefan,0,11,0,0
1668546055098,CSE 229C,A00,102380,Munyaka; Imani N. S.,0,10,0,0
1668546055533,CSE 232B,A00,102382,Deutsch; Alin Bernard,0,37,0,0
1668546055957,CSE 234,A01,112904,Kumar; Arun Kumar,0,0,0,0
1668546056379,CSE 237A,A00,102383,Rosing; Tajana Simunic,0,56,0,0
1668546056802,CSE 239A,A00,102384,Deutsch; Alin Bernard,0,16,0,0
1668546057231,CSE 239B,A00,102385,Polikarpova; Nadezhda,0,11,0,0
1668546057655,CSE 240A,A00,102386,Pannuto; Patrick William,0,47,0,0
1668546058081,CSE 240B,A00,102387,Zhao; Jishen,0,50,0,0
1668546058508,CSE 241A,A00,106406,Kang; Mingu,0,9,0,0
1668546058949,CSE 249B,A00,102388,Kahng; Andrew Byun,0,5,8,8
1668546059374,CSE 251B,A01,102392,Cottrell; Garrison W,0,52,0,0
1668546059374,CSE 251B,A02,102393,Cottrell; Garrison W,0,35,0,0
1668546059811,CSE 252B,A00,102394,Ochoa; Benjamin Lawrence,0,61,0,0
1668546060248,CSE 257,A01,102396,Gao; Sicun,0,149,0,0
1668546060674,CSE 272,A00,102397,Li; Tzumao,0,19,0,0
1668546061099,CSE 274,A00,111323,Chern; Albert Ren-Haur,0,15,0,0
1668546061526,CSE 282,A00,102398,Pevzner; Pavel Arkadjevich,0,0,0,0
1668546061954,CSE 284,A00,114175,Gymrek; Melissa Ann,0,28,0,0
1668546062381,CSE 290,A00,102399,Chandraker; Manmohan Krishna,0,11,0,0
1668546062381,CSE 290,B00,102400,Vaccaro; Kristen Marie,0,8,25,25
1668546062381,CSE 290,C00,102414,Pannuto; Patrick William,0,1,25,25
1668546062381,CSE 290,D00,102427,Pevzner; Pavel Arkadjevich,0,0,0,0
1668546062381,CSE 290,E00,102429,Zhao; Jishen,0,6,0,0
1668546062381,CSE 290,F00,102436,Tullsen; Dean Michael,0,6,0,0
1668546062381,CSE 290,G00,102440,Christensen; Henrik I,0,6,20,20
1668546062814,CSE 291,A00,102443,Su; Hao,0,0,0,0
1668546062814,CSE 291,B00,102448,Polikarpova; Nadezhda,0,0,0,0
1668546062814,CSE 291,C00,102453,Vaccaro; Kristen Marie,0,0,0,0
1668546062814,CSE 291,D00,111343,Savage; Stefan,0,0,0,0
1668546062814,CSE 291,E00,116474,Claffy; Kimberly Claire,0,0,0,0
1668546062814,CSE 291,F00,116479,Pasquale; Joseph,0,0,0,0
1668546063252,CSE 293,001,119111,Bafna; Vineet,9999,0,9999,0
1668546063252,CSE 293,002,119118,Bellare; Mihir,9999,0,9999,0
1668546063252,CSE 293,003,119122,Berg-Kirkpatrick; Taylor D,9999,0,9999,0
1668546063252,CSE 293,004,119135,Christensen; Henrik I,9999,0,9999,0
1668546063252,CSE 293,005,119142,Cottrell; Garrison W,9999,0,9999,0
1668546063252,CSE 293,006,119146,Deutsch; Alin Bernard,9999,0,9999,0
1668546063252,CSE 293,007,119159,Esmaeilzadeh; Hadi,9999,0,9999,0
1668546063252,CSE 293,008,119166,Freund; Yoav,9999,0,9999,0
1668546063252,CSE 293,009,119170,Griswold; William G.,9999,0,9999,0
1668546063252,CSE 293,010,119183,Gymrek; Melissa Ann,9999,0,9999,0
1668546063252,CSE 293,011,119190,Heninger; Nadia A,9999,0,9999,0
1668546063252,CSE 293,012,119230,Impagliazzo; Russell,9999,0,9999,0
1668546063252,CSE 293,013,119232,Jhala; Ranjit,9999,0,9999,0
1668546063252,CSE 293,014,119233,Kahng; Andrew Byun,9999,0,9999,0
1668546063252,CSE 293,015,119298,Kane; Daniel Mertz,9999,0,9999,0
1668546063252,CSE 293,016,119299,Kriegman; David J,9999,0,9999,0
1668546063252,CSE 293,017,119300,Kumar; Arun Kumar,9999,0,9999,0
1668546063252,CSE 293,018,119301,Lerner; Sorin,9999,0,9999,0
1668546063252,CSE 293,019,119302,Lovett; Shachar,9999,0,9999,0
1668546063252,CSE 293,020,119303,McAuley; Julian John,9999,0,9999,0
1668546063252,CSE 293,021,119304,Micciancio; Daniele,9999,0,9999,0
1668546063252,CSE 293,022,119367,Orailoglu; Alex,9999,0,9999,0
1668546063252,CSE 293,023,119382,Paturi; Ramamohan,9999,0,9999,0
1668546063252,CSE 293,024,119404,Polikarpova; Nadezhda,9999,0,9999,0
1668546063252,CSE 293,025,119406,Politz; Joseph Gibbs,9999,0,9999,0
1668546063252,CSE 293,026,119411,Porter; George M,9999,0,9999,0
1668546063252,CSE 293,027,119414,Porter; Leonard Emerson,9999,0,9999,0
1668546063252,CSE 293,028,119416,Ramamoorthi; Ravi,9999,0,9999,0
1668546063252,CSE 293,029,119417,Sahoo; Debashis,9999,0,9999,0
1668546063252,CSE 293,030,119420,Saul; Lawrence,9999,0,9999,0
1668546063252,CSE 293,031,119421,Savage; Stefan,9999,0,9999,0
1668546063252,CSE 293,032,119425,Schulze; Jurgen P.,9999,0,9999,0
1668546063252,CSE 293,033,119426,Snoeren; Alex C.,9999,0,9999,0
1668546063252,CSE 293,034,119428,Shang; Jingbo,9999,0,9999,0
1668546063252,CSE 293,035,119430,Stefan; Deian,9999,0,9999,0
1668546063252,CSE 293,036,119431,Su; Hao,9999,0,9999,0
1668546063252,CSE 293,037,119433,Swanson; Steven James,9999,0,9999,0
1668546063252,CSE 293,038,119435,Tullsen; Dean Michael,9999,0,9999,0
1668546063252,CSE 293,039,119483,Voelker; Geoffrey M.,9999,0,9999,0
1668546063252,CSE 293,040,119537,Zhao; Jishen,9999,0,9999,0
1668546063252,CSE 293,041,119538,Zhou; Yuan-Yuan,9999,0,9999,0
1668546063252,CSE 293,042,119539,Gao; Sicun,9999,0,9999,0
1668546063252,CSE 293,043,119540,Weibel; Nadir,9999,0,9999,0
1668546063252,CSE 293,044,119541,Gupta; Rajesh K.,9999,0,9999,0
1668546063252,CSE 293,045,126410,Vaccaro; Kristen Marie,9999,0,9999,0
1668546063252,CSE 293,046,126411,Klemke; Richard,9999,0,9999,0
1668546063677,CSE 294,A00,102459,Voelker; Geoffrey M.,0,2,0,0
1668546063677,CSE 294,B00,111322,Orailoglu; Alex,0,2,0,0
1668546064114,DSE 201,A00,096914,Deutsch; Alin Bernard,30,0,30,0
1668546064540,DSE 210,A00,096915,Dasgupta; Sanjoy,30,0,30,0
1668546064971,DSE 260A,A00,096916,Altintas De Callaf; Ilkay,30,0,30,0
1668546065440,ECE 200,001,103586,Antipa; Nicholas A,9999,0,9999,0
1668546065440,ECE 200,002,103587,Atanasov; Nikolay A.,9999,0,9999,0
1668546065440,ECE 200,003,103588,Bharadia; Dinesh,9999,0,9999,0
1668546065440,ECE 200,004,103589,Cheng; Chung Kuan,9999,0,9999,0
1668546065440,ECE 200,005,103590,Cosman; Pamela C.,9999,0,9999,0
1668546065440,ECE 200,006,103591,Dayeh; Shadi Ahmad,9999,0,9999,0
1668546065440,ECE 200,007,103592,Fainman; Yeshaiahu,9999,0,9999,0
1668546065440,ECE 200,008,103593,Ford; Joseph Earl,9999,0,9999,0
1668546065440,ECE 200,009,103594,Franceschetti; Massimo,9999,0,9999,0
1668546065440,ECE 200,010,103595,Fullerton; Eric E,9999,0,9999,0
1668546065440,ECE 200,011,103596,Galton; Ian A,9999,0,9999,0
1668546065440,ECE 200,012,103597,Gilja; Vikash,9999,0,9999,0
1668546065440,ECE 200,013,103598,Hall; Drew A.,9999,0,9999,0
1668546065440,ECE 200,014,103599,Hsueh; Tzu-Chien,9999,0,9999,0
1668546065440,ECE 200,015,103600,Javidi; Tara,9999,0,9999,0
1668546065440,ECE 200,016,103601,Kahng; Andrew Byun,9999,0,9999,0
1668546065440,ECE 200,017,103602,Kim; Young-Han,9999,0,9999,0
1668546065440,ECE 200,018,103603,Koushanfar; Farinaz,9999,0,9999,0
1668546065440,ECE 200,019,103604,Kuzum; Duygu,9999,0,9999,0
1668546065440,ECE 200,020,103605,Le; Hanh-Phuc,9999,0,9999,0
1668546065440,ECE 200,021,103606,Lin; Bill,9999,0,9999,0
1668546065440,ECE 200,022,103607,Liu; Zhaowei,9998,0,9999,1
1668546065440,ECE 200,023,103608,Lo; Yu-Hwa,9999,0,9999,0
1668546065440,ECE 200,024,103609,Lomakin; Vitaliy,9999,0,9999,0
1668546065440,ECE 200,025,103610,Mercier; Patrick Philip,9999,0,9999,0
1668546065440,ECE 200,026,103611,Meyer; Florian,9999,0,9999,0
1668546065440,ECE 200,027,103612,Milstein; Laurence B.,9999,0,9999,0
1668546065440,ECE 200,028,103613,Mir Arabbaygi; Siavash,9999,0,9999,0
1668546065440,ECE 200,029,103614,Mookherjea; Shayan,9999,0,9999,0
1668546065440,ECE 200,030,103615,Morris; Karcher William,9999,0,9999,0
1668546065440,ECE 200,031,103616,Ng; Tse Nga,9999,0,9999,0
1668546065440,ECE 200,032,103617,Nguyen; Truong Quang,9999,0,9999,0
1668546065440,ECE 200,033,103618,Nomura; Kenji,9999,0,9999,0
1668546065440,ECE 200,034,103619,Orlitsky; Alon,9999,0,9999,0
1668546065440,ECE 200,035,103620,Pal; Piya,9999,0,9999,0
1668546065440,ECE 200,036,103621,Papen; George C.,9999,0,9999,0
1668546065440,ECE 200,037,103622,Radic; Stojan,9999,0,9999,0
1668546065440,ECE 200,038,103623,Rao; Bhaskar D.,9999,0,9999,0
1668546065440,ECE 200,039,103624,Rao; Ramesh R,9999,0,9999,0
1668546065440,ECE 200,040,103625,Rebeiz; Gabriel,9999,0,9999,0
1668546065440,ECE 200,041,103626,Sanford; John R,9999,0,9999,0
1668546065440,ECE 200,042,103627,Siegel; Paul H.,9999,0,9999,0
1668546065440,ECE 200,043,103628,Sievenpiper; Daniel F.,9999,0,9999,0
1668546065440,ECE 200,044,103629,Sworder; David D.,9999,0,9999,0
1668546065440,ECE 200,045,103630,Taur; Yuan,9999,0,9999,0
1668546065440,ECE 200,046,103631,Touri; Behrouz,9999,0,9999,0
1668546065440,ECE 200,047,103632,Trivedi; Mohan M.,9999,0,9999,0
1668546065440,ECE 200,048,103633,Vasconcelos; Nuno,9999,0,9999,0
1668546065440,ECE 200,049,103634,Wang; Xiaolong,9999,0,9999,0
1668546065440,ECE 200,050,103635,Xie; Pengtao,9999,0,9999,0
1668546065440,ECE 200,051,103636,Yip; Michael,9999,0,9999,0
1668546065440,ECE 200,052,103637,Zeger; Kenneth A.,999,0,999,0
1668546065440,ECE 200,053,103638,Zhang; Xinyu,9999,0,9999,0
1668546065440,ECE 200,054,103639,Turakhia; Yatish Girish,9999,0,9999,0
1668546065440,ECE 200,055,103640,Kang; Mingu,9999,0,9999,0
1668546065440,ECE 200,056,103641,Shi; Yuanyuan,9999,0,9999,0
1668546065440,ECE 200,057,103642,Wang; Edward Jay,9999,0,9999,0
1668546065440,ECE 200,058,103643,Zheng; Yang,9999,0,9999,0
1668546065868,ECE 202,A00,103644,Kuzum; Duygu,0,45,0,0
1668546066299,ECE 212BN,A00,103646,Ng; Tse Nga,0,9,0,0
1668546066726,ECE 221,A00,111493,Staff,0,0,0,0
1668546067151,ECE 222B,A00,103647,Lomakin; Vitaliy,0,20,0,0
1668546067584,ECE 230B,A00,103648,Taur; Yuan,0,3,0,0
1668546068011,ECE 238B,A00,103649,Garay; Javier,0,0,0,0
1668546068444,ECE 240B,A00,112900,Fainman; Yeshaiahu,0,7,0,0
1668546068873,ECE 247A,A00,103650,Jokerst; Jesse Vincent,0,6,0,0
1668546069296,ECE 247B,A00,103651,Wang; Joseph,0,14,0,0
1668546069731,ECE 250,A00,103652,Siegel; Paul H.,0,82,0,0
1668546070160,ECE 251A,A00,103654,Rao; Bhaskar D.,0,63,0,0
1668546070587,ECE 257B,A00,103655,Bharadia; Dinesh,0,33,0,0
1668546071014,ECE 258A,A00,103656,Milstein; Laurence B.,0,29,0,0
1668546071438,ECE 260B,A00,103658,Kang; Mingu,0,123,0,0
1668546071863,ECE 264A,A00,103659,Galton; Ian A,0,72,0,0
1668546072297,ECE 265A,A00,103661,Gudem; Prasad S.S.,0,73,0,0
1668546072733,ECE 265D,A00,103662,Gudem; Prasad S.S.,0,26,0,0
1668546073156,ECE 268,A00,103663,Koushanfar; Farinaz,0,43,0,0
1668546073605,ECE 269,A01,103665,Pal; Piya,0,219,0,0
1668546074029,ECE 271B,A00,103666,Vasconcelos; Manuela,0,78,0,0
1668546074472,ECE 276A,A00,103667,Atanasov; Nikolay A.,0,127,0,0
1668546074912,ECE 277,A00,103668,An; Cheolhong,0,151,0,0
1668546075343,ECE 279,A00,117947,Hall; Drew A.,0,22,0,0
1668546076198,ECE 283,A00,103670,Hsueh; Tzu-Chien,0,57,0,0
1668546076626,ECE 284,A00,103671,Turakhia; Yatish Girish,0,40,0,0
1668546077065,ECE 285,A00,103672,Zheng; Yang,0,41,0,0
1668546077065,ECE 285,B00,103673,Sworder; David D.,0,61,0,0
1668546077488,ECE 287,A00,103676,Javidi; Tara,0,9,0,0
1668546077910,MATH 200B,A00,098023,Salehi Golsefidy; Alireza,10,0,15,5
1668546078333,MATH 202B,A00,098024,Rhoades; Brendon Patrick,7,0,15,8
1668546078769,MATH 203B,A00,098025,Oprea; Dragos N.,9,0,15,6
1668546079200,MATH 204B,A00,098026,Sorensen; Claus M,13,0,15,2
1668546079628,MATH 208,A00,098027,Izadi; Elham,7,0,10,3
1668546080051,MATH 209,A00,098028,Pollack; Aaron,10,0,10,0
1668546080480,MATH 211A,A00,112919,Rogalski; Daniel,8,0,10,2
1668546080918,MATH 211B,A00,112920,Seward; Brandon M.,9,0,10,1
1668546081341,MATH 218,A00,098029,Li; Bo,10,0,10,0
1668546081781,MATH 220B,A00,098030,Novak; Jonathan I,11,0,15,4
1668546082219,MATH 221A,A00,098031,Ebenfelt; Peter F,12,0,15,3
1668546082659,MATH 231B,A00,098032,Zlatos; Andrej,10,0,15,5
1668546083083,MATH 240B,A00,098033,Ni; Lei,7,0,15,8
1668546083523,MATH 243,A00,098034,Jekel; David Andrew,10,0,10,0
1668546083960,MATH 245A,A00,098035,Nie; Jiawang,0,5,15,18
1668546084382,MATH 248,A00,098036,Bejenaru; Ioan,10,0,10,0
1668546084822,MATH 250B,A00,098037,Spolaor; Luca,14,0,15,1
1668546085247,MATH 258,A00,098038,Ni; Lei,9,0,10,1
1668546086216,MATH 264B,A00,098041,Rhoades; Brendon Patrick,8,0,15,7
1668546086645,MATH 268,A00,098042,Buss; Samuel R,10,0,10,0
1668546087067,MATH 269,A00,098043,Rhoades; Brendon Patrick,10,0,10,0
1668546087493,MATH 270B,A00,098044,Li; Bo,6,0,15,9
1668546087917,MATH 272B,A00,098045,Holst; Michael J,13,0,15,2
1668546088355,MATH 273A,A00,098046,Tian; Xiaochuan,10,0,15,5
1668546088779,MATH 275,A01,098048,Tian; Xiaochuan,6,0,10,4
1668546089204,MATH 278A,A00,098049,Holst; Michael J,6,0,10,4
1668546089628,MATH 278B,A00,098050,Cloninger; Alexander,10,0,10,0
1668546090055,MATH 278C,A00,098051,Nie; Jiawang,5,0,10,5
1668546090480,MATH 280B,A00,098052,Zheng; Tianyi,7,0,15,8
1668546090908,MATH 281B,A00,098053,Bradic; Jelena,0,2,15,15
1668546091334,MATH 282B,A00,098054,Arias-Castro; Ery,0,1,15,15
1668546091756,MATH 285,A00,098055,Fitzsimmons; Patrick J,0,4,15,17
1668546092195,MATH 287B,A00,098056,Arias-Castro; Ery,1,0,15,14
1668546092633,MATH 288,A00,098057,Agarwal; Pooja,9,0,10,1
1668546092633,MATH 288,B00,098058,Zhang; Danna,8,0,10,2
1668546092633,MATH 288,C00,098059,Williams; Ruth J,9,0,10,1
1668546093057,MATH 290B,A00,098060,Roberts; Justin Deritter,12,0,15,3
1668546093487,MATH 292,A00,098061,Belmont; Eva Kinoshita,10,0,10,0
1668546093917,MATH 295,A00,098062,Suk; Andrew Hoon,47,0,50,3
1668546094352,MATH 296,A00,098063,Novak; Jonathan I,20,0,20,0
1668546094775,MATH 297,001,098064,Gamst; Anthony Collins,9997,0,9999,2
1668546602438,COGS 205,A00,101395,Chiba; Andrea,19,0,20,1
1668546602860,COGS 210B,001,101404,Greene; Deanna Jacquelyn,9998,0,9999,1
1668546602860,COGS 210B,002,101417,Xia; Haijun,9999,0,9999,0
1668546602860,COGS 210B,003,101422,Nitz; Douglas A.,9999,0,9999,0
1668546602860,COGS 210B,004,101423,Hollan; James D.,9998,0,9999,1
1668546602860,COGS 210B,005,101424,Deak; Gedeon O.,9998,0,9999,1
1668546602860,COGS 210B,006,101425,Rossano; Federico,9999,0,9999,0
1668546603288,COGS 211B,A00,101427,Coulson; Seana M,9996,0,9999,3
1668546603719,COGS 220,A00,101428,Hollan; James D.,0,14,25,25
1668546604148,COGS 229,A00,101429,Dow; Steven P,17,0,25,8
1668546604575,COGS 230,A00,101430,Klemmer; Scott R,6,0,17,11
1668546605012,COGS 234,A00,101431,Xia; Haijun,0,1,25,25
1668546605454,COGS 260,A00,101432,Kiyonaga; Anastasia,21,0,25,4
1668546605454,COGS 260,B00,101433,Kirsh; David Joel,15,0,25,10
1668546605881,CSE 202,A00,102371,Impagliazzo; Russell,0,68,0,0
1668546606307,CSE 203B,A01,102373,Cheng; Chung Kuan,0,62,0,0
1668546606731,CSE 208,A00,102374,Micciancio; Daniele,0,5,0,0
1668546607154,CSE 209A,A00,112895,Impagliazzo; Russell,0,13,15,15
1668546607582,CSE 209B,A00,108005,Bellare; Mihir,0,7,0,0
1668546608013,CSE 210,A00,113163,Coblenz; Michael J,0,89,0,0
1668546608442,CSE 219,A00,106111,Dow; Steven P,0,8,20,20
1668546608874,CSE 221,A00,102376,Voelker; Geoffrey M.,0,75,0,0
1668546609303,CSE 224,A01,102378,Porter; George M,0,173,0,0
1668546609729,CSE 229A,A00,102379,Savage; Stefan,0,11,0,0
1668546610156,CSE 229C,A00,102380,Munyaka; Imani N. S.,0,10,0,0
1668546610581,CSE 232B,A00,102382,Deutsch; Alin Bernard,0,37,0,0
1668546611011,CSE 234,A01,112904,Kumar; Arun Kumar,0,0,0,0
1668546611444,CSE 237A,A00,102383,Rosing; Tajana Simunic,0,56,0,0
1668546611879,CSE 239A,A00,102384,Deutsch; Alin Bernard,0,16,0,0
1668546612389,CSE 239B,A00,102385,Polikarpova; Nadezhda,0,11,0,0
1668546612825,CSE 240A,A00,102386,Pannuto; Patrick William,0,47,0,0
1668546613265,CSE 240B,A00,102387,Zhao; Jishen,0,50,0,0
1668546613689,CSE 241A,A00,106406,Kang; Mingu,0,9,0,0
1668546614134,CSE 249B,A00,102388,Kahng; Andrew Byun,0,5,8,8
1668546614562,CSE 251B,A01,102392,Cottrell; Garrison W,0,52,0,0
1668546614562,CSE 251B,A02,102393,Cottrell; Garrison W,0,35,0,0
1668546614990,CSE 252B,A00,102394,Ochoa; Benjamin Lawrence,0,61,0,0
1668546615418,CSE 257,A01,102396,Gao; Sicun,0,149,0,0
1668546615845,CSE 272,A00,102397,Li; Tzumao,0,19,0,0
1668546616282,CSE 274,A00,111323,Chern; Albert Ren-Haur,0,15,0,0
1668546616706,CSE 282,A00,102398,Pevzner; Pavel Arkadjevich,0,0,0,0
1668546617141,CSE 284,A00,114175,Gymrek; Melissa Ann,0,29,0,0
1668546617568,CSE 290,A00,102399,Chandraker; Manmohan Krishna,0,11,0,0
1668546617568,CSE 290,B00,102400,Vaccaro; Kristen Marie,0,8,25,25
1668546617568,CSE 290,C00,102414,Pannuto; Patrick William,0,1,25,25
1668546617568,CSE 290,D00,102427,Pevzner; Pavel Arkadjevich,0,0,0,0
1668546617568,CSE 290,E00,102429,Zhao; Jishen,0,6,0,0
1668546617568,CSE 290,F00,102436,Tullsen; Dean Michael,0,6,0,0
1668546617568,CSE 290,G00,102440,Christensen; Henrik I,0,6,20,20
1668546617991,CSE 291,A00,102443,Su; Hao,0,0,0,0
1668546617991,CSE 291,B00,102448,Polikarpova; Nadezhda,0,0,0,0
1668546617991,CSE 291,C00,102453,Vaccaro; Kristen Marie,0,0,0,0
1668546617991,CSE 291,D00,111343,Savage; Stefan,0,0,0,0
1668546617991,CSE 291,E00,116474,Claffy; Kimberly Claire,0,0,0,0
1668546617991,CSE 291,F00,116479,Pasquale; Joseph,0,0,0,0
1668546618465,CSE 293,001,119111,Bafna; Vineet,9999,0,9999,0
1668546618465,CSE 293,002,119118,Bellare; Mihir,9999,0,9999,0
1668546618465,CSE 293,003,119122,Berg-Kirkpatrick; Taylor D,9999,0,9999,0
1668546618465,CSE 293,004,119135,Christensen; Henrik I,9999,0,9999,0
1668546618465,CSE 293,005,119142,Cottrell; Garrison W,9999,0,9999,0
1668546618465,CSE 293,006,119146,Deutsch; Alin Bernard,9999,0,9999,0
1668546618465,CSE 293,007,119159,Esmaeilzadeh; Hadi,9999,0,9999,0
1668546618465,CSE 293,008,119166,Freund; Yoav,9999,0,9999,0
1668546618465,CSE 293,009,119170,Griswold; William G.,9999,0,9999,0
1668546618465,CSE 293,010,119183,Gymrek; Melissa Ann,9999,0,9999,0
1668546618465,CSE 293,011,119190,Heninger; Nadia A,9999,0,9999,0
1668546618465,CSE 293,012,119230,Impagliazzo; Russell,9999,0,9999,0
1668546618465,CSE 293,013,119232,Jhala; Ranjit,9999,0,9999,0
1668546618465,CSE 293,014,119233,Kahng; Andrew Byun,9999,0,9999,0
1668546618465,CSE 293,015,119298,Kane; Daniel Mertz,9999,0,9999,0
1668546618465,CSE 293,016,119299,Kriegman; David J,9999,0,9999,0
1668546618465,CSE 293,017,119300,Kumar; Arun Kumar,9999,0,9999,0
1668546618465,CSE 293,018,119301,Lerner; Sorin,9999,0,9999,0
1668546618465,CSE 293,019,119302,Lovett; Shachar,9999,0,9999,0
1668546618465,CSE 293,020,119303,McAuley; Julian John,9999,0,9999,0
1668546618465,CSE 293,021,119304,Micciancio; Daniele,9999,0,9999,0
1668546618465,CSE 293,022,119367,Orailoglu; Alex,9999,0,9999,0
1668546618465,CSE 293,023,119382,Paturi; Ramamohan,9999,0,9999,0
1668546618465,CSE 293,024,119404,Polikarpova; Nadezhda,9999,0,9999,0
1668546618465,CSE 293,025,119406,Politz; Joseph Gibbs,9999,0,9999,0
1668546618465,CSE 293,026,119411,Porter; George M,9999,0,9999,0
1668546618465,CSE 293,027,119414,Porter; Leonard Emerson,9999,0,9999,0
1668546618465,CSE 293,028,119416,Ramamoorthi; Ravi,9999,0,9999,0
1668546618465,CSE 293,029,119417,Sahoo; Debashis,9999,0,9999,0
1668546618465,CSE 293,030,119420,Saul; Lawrence,9999,0,9999,0
1668546618465,CSE 293,031,119421,Savage; Stefan,9999,0,9999,0
1668546618465,CSE 293,032,119425,Schulze; Jurgen P.,9999,0,9999,0
1668546618465,CSE 293,033,119426,Snoeren; Alex C.,9999,0,9999,0
1668546618465,CSE 293,034,119428,Shang; Jingbo,9999,0,9999,0
1668546618465,CSE 293,035,119430,Stefan; Deian,9999,0,9999,0
1668546618465,CSE 293,036,119431,Su; Hao,9999,0,9999,0
1668546618465,CSE 293,037,119433,Swanson; Steven James,9999,0,9999,0
1668546618465,CSE 293,038,119435,Tullsen; Dean Michael,9999,0,9999,0
1668546618465,CSE 293,039,119483,Voelker; Geoffrey M.,9999,0,9999,0
1668546618465,CSE 293,040,119537,Zhao; Jishen,9999,0,9999,0
1668546618465,CSE 293,041,119538,Zhou; Yuan-Yuan,9999,0,9999,0
1668546618465,CSE 293,042,119539,Gao; Sicun,9999,0,9999,0
1668546618465,CSE 293,043,119540,Weibel; Nadir,9999,0,9999,0
1668546618465,CSE 293,044,119541,Gupta; Rajesh K.,9999,0,9999,0
1668546618465,CSE 293,045,126410,Vaccaro; Kristen Marie,9999,0,9999,0
1668546618465,CSE 293,046,126411,Klemke; Richard,9999,0,9999,0
1668546618892,CSE 294,A00,102459,Voelker; Geoffrey M.,0,2,0,0
1668546618892,CSE 294,B00,111322,Orailoglu; Alex,0,2,0,0
1668546619319,DSE 201,A00,096914,Deutsch; Alin Bernard,30,0,30,0
1668546619755,DSE 210,A00,096915,Dasgupta; Sanjoy,30,0,30,0
1668546620181,DSE 260A,A00,096916,Altintas De Callaf; Ilkay,30,0,30,0
1668546620644,ECE 200,001,103586,Antipa; Nicholas A,9999,0,9999,0
1668546620644,ECE 200,002,103587,Atanasov; Nikolay A.,9999,0,9999,0
1668546620644,ECE 200,003,103588,Bharadia; Dinesh,9999,0,9999,0
1668546620644,ECE 200,004,103589,Cheng; Chung Kuan,9999,0,9999,0
1668546620644,ECE 200,005,103590,Cosman; Pamela C.,9999,0,9999,0
1668546620644,ECE 200,006,103591,Dayeh; Shadi Ahmad,9999,0,9999,0
1668546620644,ECE 200,007,103592,Fainman; Yeshaiahu,9999,0,9999,0
1668546620644,ECE 200,008,103593,Ford; Joseph Earl,9999,0,9999,0
1668546620644,ECE 200,009,103594,Franceschetti; Massimo,9999,0,9999,0
1668546620644,ECE 200,010,103595,Fullerton; Eric E,9999,0,9999,0
1668546620644,ECE 200,011,103596,Galton; Ian A,9999,0,9999,0
1668546620644,ECE 200,012,103597,Gilja; Vikash,9999,0,9999,0
1668546620644,ECE 200,013,103598,Hall; Drew A.,9999,0,9999,0
1668546620644,ECE 200,014,103599,Hsueh; Tzu-Chien,9999,0,9999,0
1668546620644,ECE 200,015,103600,Javidi; Tara,9999,0,9999,0
1668546620644,ECE 200,016,103601,Kahng; Andrew Byun,9999,0,9999,0
1668546620644,ECE 200,017,103602,Kim; Young-Han,9999,0,9999,0
1668546620644,ECE 200,018,103603,Koushanfar; Farinaz,9999,0,9999,0
1668546620644,ECE 200,019,103604,Kuzum; Duygu,9999,0,9999,0
1668546620644,ECE 200,020,103605,Le; Hanh-Phuc,9999,0,9999,0
1668546620644,ECE 200,021,103606,Lin; Bill,9999,0,9999,0
1668546620644,ECE 200,022,103607,Liu; Zhaowei,9998,0,9999,1
1668546620644,ECE 200,023,103608,Lo; Yu-Hwa,9999,0,9999,0
1668546620644,ECE 200,024,103609,Lomakin; Vitaliy,9999,0,9999,0
1668546620644,ECE 200,025,103610,Mercier; Patrick Philip,9999,0,9999,0
1668546620644,ECE 200,026,103611,Meyer; Florian,9999,0,9999,0
1668546620644,ECE 200,027,103612,Milstein; Laurence B.,9999,0,9999,0
1668546620644,ECE 200,028,103613,Mir Arabbaygi; Siavash,9999,0,9999,0
1668546620644,ECE 200,029,103614,Mookherjea; Shayan,9999,0,9999,0
1668546620644,ECE 200,030,103615,Morris; Karcher William,9999,0,9999,0
1668546620644,ECE 200,031,103616,Ng; Tse Nga,9999,0,9999,0
1668546620644,ECE 200,032,103617,Nguyen; Truong Quang,9999,0,9999,0
1668546620644,ECE 200,033,103618,Nomura; Kenji,9999,0,9999,0
1668546620644,ECE 200,034,103619,Orlitsky; Alon,9999,0,9999,0
1668546620644,ECE 200,035,103620,Pal; Piya,9999,0,9999,0
1668546620644,ECE 200,036,103621,Papen; George C.,9999,0,9999,0
1668546620644,ECE 200,037,103622,Radic; Stojan,9999,0,9999,0
1668546620644,ECE 200,038,103623,Rao; Bhaskar D.,9999,0,9999,0
1668546620644,ECE 200,039,103624,Rao; Ramesh R,9999,0,9999,0
1668546620644,ECE 200,040,103625,Rebeiz; Gabriel,9999,0,9999,0
1668546620644,ECE 200,041,103626,Sanford; John R,9999,0,9999,0
1668546620644,ECE 200,042,103627,Siegel; Paul H.,9999,0,9999,0
1668546620644,ECE 200,043,103628,Sievenpiper; Daniel F.,9999,0,9999,0
1668546620644,ECE 200,044,103629,Sworder; David D.,9999,0,9999,0
1668546620644,ECE 200,045,103630,Taur; Yuan,9999,0,9999,0
1668546620644,ECE 200,046,103631,Touri; Behrouz,9999,0,9999,0
1668546620644,ECE 200,047,103632,Trivedi; Mohan M.,9999,0,9999,0
1668546620644,ECE 200,048,103633,Vasconcelos; Nuno,9999,0,9999,0
1668546620644,ECE 200,049,103634,Wang; Xiaolong,9999,0,9999,0
1668546620644,ECE 200,050,103635,Xie; Pengtao,9999,0,9999,0
1668546620644,ECE 200,051,103636,Yip; Michael,9999,0,9999,0
1668546620644,ECE 200,052,103637,Zeger; Kenneth A.,999,0,999,0
1668546620644,ECE 200,053,103638,Zhang; Xinyu,9999,0,9999,0
1668546620644,ECE 200,054,103639,Turakhia; Yatish Girish,9999,0,9999,0
1668546620644,ECE 200,055,103640,Kang; Mingu,9999,0,9999,0
1668546620644,ECE 200,056,103641,Shi; Yuanyuan,9999,0,9999,0
1668546620644,ECE 200,057,103642,Wang; Edward Jay,9999,0,9999,0
1668546620644,ECE 200,058,103643,Zheng; Yang,9999,0,9999,0
1668546621075,ECE 202,A00,103644,Kuzum; Duygu,0,45,0,0
1668546621499,ECE 212BN,A00,103646,Ng; Tse Nga,0,9,0,0
1668546621922,ECE 221,A00,111493,Staff,0,0,0,0
1668546622356,ECE 222B,A00,103647,Lomakin; Vitaliy,0,20,0,0
1668546622790,ECE 230B,A00,103648,Taur; Yuan,0,3,0,0
1668546623218,ECE 238B,A00,103649,Garay; Javier,0,0,0,0
1668546623655,ECE 240B,A00,112900,Fainman; Yeshaiahu,0,7,0,0
1668546624080,ECE 247A,A00,103650,Jokerst; Jesse Vincent,0,6,0,0
1668546624504,ECE 247B,A00,103651,Wang; Joseph,0,14,0,0
1668546624936,ECE 250,A00,103652,Siegel; Paul H.,0,82,0,0
1668546625359,ECE 251A,A00,103654,Rao; Bhaskar D.,0,63,0,0
1668546625784,ECE 257B,A00,103655,Bharadia; Dinesh,0,33,0,0
1668546626214,ECE 258A,A00,103656,Milstein; Laurence B.,0,29,0,0
1668546626641,ECE 260B,A00,103658,Kang; Mingu,0,123,0,0
1668546627064,ECE 264A,A00,103659,Galton; Ian A,0,72,0,0
1668546627498,ECE 265A,A00,103661,Gudem; Prasad S.S.,0,73,0,0
1668546627932,ECE 265D,A00,103662,Gudem; Prasad S.S.,0,26,0,0
1668546628358,ECE 268,A00,103663,Koushanfar; Farinaz,0,43,0,0
1668546628796,ECE 269,A01,103665,Pal; Piya,0,219,0,0
1668546629239,ECE 271B,A00,103666,Vasconcelos; Manuela,0,78,0,0
1668546629664,ECE 276A,A00,103667,Atanasov; Nikolay A.,0,127,0,0
1668546630092,ECE 277,A00,103668,An; Cheolhong,0,151,0,0
1668546630529,ECE 279,A00,117947,Hall; Drew A.,0,22,0,0
1668546631392,ECE 283,A00,103670,Hsueh; Tzu-Chien,0,57,0,0
1668546631833,ECE 284,A00,103671,Turakhia; Yatish Girish,0,40,0,0
1668546632256,ECE 285,A00,103672,Zheng; Yang,0,41,0,0
1668546632256,ECE 285,B00,103673,Sworder; David D.,0,61,0,0
1668546632692,ECE 287,A00,103676,Javidi; Tara,0,9,0,0
1668546633127,MATH 200B,A00,098023,Salehi Golsefidy; Alireza,10,0,15,5
1668546633560,MATH 202B,A00,098024,Rhoades; Brendon Patrick,7,0,15,8
1668546633992,MATH 203B,A00,098025,Oprea; Dragos N.,9,0,15,6
1668546634422,MATH 204B,A00,098026,Sorensen; Claus M,13,0,15,2
1668546634849,MATH 208,A00,098027,Izadi; Elham,7,0,10,3
1668546635276,MATH 209,A00,098028,Pollack; Aaron,10,0,10,0
1668546635715,MATH 211A,A00,112919,Rogalski; Daniel,8,0,10,2
1668546636139,MATH 211B,A00,112920,Seward; Brandon M.,9,0,10,1
1668546636569,MATH 218,A00,098029,Li; Bo,10,0,10,0
1668546637003,MATH 220B,A00,098030,Novak; Jonathan I,11,0,15,4
1668546637429,MATH 221A,A00,098031,Ebenfelt; Peter F,12,0,15,3
1668546637867,MATH 231B,A00,098032,Zlatos; Andrej,10,0,15,5
1668546638294,MATH 240B,A00,098033,Ni; Lei,7,0,15,8
1668546638721,MATH 243,A00,098034,Jekel; David Andrew,10,0,10,0
1668546639147,MATH 245A,A00,098035,Nie; Jiawang,0,5,15,18
1668546639571,MATH 248,A00,098036,Bejenaru; Ioan,10,0,10,0
1668546639996,MATH 250B,A00,098037,Spolaor; Luca,14,0,15,1
1668546640427,MATH 258,A00,098038,Ni; Lei,9,0,10,1
1668546640874,MATH 264B,A00,098041,Rhoades; Brendon Patrick,8,0,15,7
1668546641312,MATH 268,A00,098042,Buss; Samuel R,10,0,10,0
1668546641734,MATH 269,A00,098043,Rhoades; Brendon Patrick,10,0,10,0
1668546642159,MATH 270B,A00,098044,Li; Bo,6,0,15,9
1668546642582,MATH 272B,A00,098045,Holst; Michael J,13,0,15,2
1668546643027,MATH 273A,A00,098046,Tian; Xiaochuan,10,0,15,5
1668546643470,MATH 275,A01,098048,Tian; Xiaochuan,6,0,10,4
1668546643893,MATH 278A,A00,098049,Holst; Michael J,6,0,10,4
1668546644316,MATH 278B,A00,098050,Cloninger; Alexander,10,0,10,0
1668546644741,MATH 278C,A00,098051,Nie; Jiawang,5,0,10,5
1668546645174,MATH 280B,A00,098052,Zheng; Tianyi,7,0,15,8
1668546645607,MATH 281B,A00,098053,Bradic; Jelena,0,2,15,15
1668546646042,MATH 282B,A00,098054,Arias-Castro; Ery,0,1,15,15
1668546646475,MATH 285,A00,098055,Fitzsimmons; Patrick J,0,4,15,17
1668546646910,MATH 287B,A00,098056,Arias-Castro; Ery,1,0,15,14
1668546647347,MATH 288,A00,098057,Agarwal; Pooja,9,0,10,1
1668546647347,MATH 288,B00,098058,Zhang; Danna,8,0,10,2
1668546647347,MATH 288,C00,098059,Williams; Ruth J,9,0,10,1
1668546647770,MATH 290B,A00,098060,Roberts; Justin Deritter,12,0,15,3
1668546648194,MATH 292,A00,098061,Belmont; Eva Kinoshita,10,0,10,0
1668546648625,MATH 295,A00,098062,Suk; Andrew Hoon,47,0,50,3
1668546649051,MATH 296,A00,098063,Novak; Jonathan I,20,0,20,0
1668546649485,MATH 297,001,098064,Gamst; Anthony Collins,9997,0,9999,2
1668547154801,COGS 205,A00,101395,Chiba; Andrea,19,0,20,1
1668547155241,COGS 210B,001,101404,Greene; Deanna Jacquelyn,9998,0,9999,1
1668547155241,COGS 210B,002,101417,Xia; Haijun,9999,0,9999,0
1668547155241,COGS 210B,003,101422,Nitz; Douglas A.,9999,0,9999,0
1668547155241,COGS 210B,004,101423,Hollan; James D.,9998,0,9999,1
1668547155241,COGS 210B,005,101424,Deak; Gedeon O.,9998,0,9999,1
1668547155241,COGS 210B,006,101425,Rossano; Federico,9999,0,9999,0
1668547155663,COGS 211B,A00,101427,Coulson; Seana M,9996,0,9999,3
1668547156098,COGS 220,A00,101428,Hollan; James D.,0,14,25,25
1668547156520,COGS 229,A00,101429,Dow; Steven P,17,0,25,8
1668547156960,COGS 230,A00,101430,Klemmer; Scott R,6,0,17,11
1668547157385,COGS 234,A00,101431,Xia; Haijun,0,1,25,25
1668547157806,COGS 260,A00,101432,Kiyonaga; Anastasia,21,0,25,4
1668547157806,COGS 260,B00,101433,Kirsh; David Joel,15,0,25,10
1668547158243,CSE 202,A00,102371,Impagliazzo; Russell,0,68,0,0
1668547158666,CSE 203B,A01,102373,Cheng; Chung Kuan,0,62,0,0
1668547159089,CSE 208,A00,102374,Micciancio; Daniele,0,5,0,0
1668547159522,CSE 209A,A00,112895,Impagliazzo; Russell,0,13,15,15
1668547159948,CSE 209B,A00,108005,Bellare; Mihir,0,7,0,0
1668547160375,CSE 210,A00,113163,Coblenz; Michael J,0,89,0,0
1668547160800,CSE 219,A00,106111,Dow; Steven P,0,8,20,20
1668547161224,CSE 221,A00,102376,Voelker; Geoffrey M.,0,75,0,0
1668547161649,CSE 224,A01,102378,Porter; George M,0,173,0,0
1668547162081,CSE 229A,A00,102379,Savage; Stefan,0,11,0,0
1668547162509,CSE 229C,A00,102380,Munyaka; Imani N. S.,0,10,0,0
1668547162939,CSE 232B,A00,102382,Deutsch; Alin Bernard,0,37,0,0
1668547163363,CSE 234,A01,112904,Kumar; Arun Kumar,0,0,0,0
1668547163789,CSE 237A,A00,102383,Rosing; Tajana Simunic,0,57,0,0
1668547164215,CSE 239A,A00,102384,Deutsch; Alin Bernard,0,16,0,0
1668547164641,CSE 239B,A00,102385,Polikarpova; Nadezhda,0,11,0,0
1668547165078,CSE 240A,A00,102386,Pannuto; Patrick William,0,47,0,0
1668547165501,CSE 240B,A00,102387,Zhao; Jishen,0,50,0,0
1668547165925,CSE 241A,A00,106406,Kang; Mingu,0,9,0,0
1668547166355,CSE 249B,A00,102388,Kahng; Andrew Byun,0,5,8,8
1668547166781,CSE 251B,A01,102392,Cottrell; Garrison W,0,52,0,0
1668547166781,CSE 251B,A02,102393,Cottrell; Garrison W,0,35,0,0
1668547167203,CSE 252B,A00,102394,Ochoa; Benjamin Lawrence,0,61,0,0
1668547167626,CSE 257,A01,102396,Gao; Sicun,0,149,0,0
1668547168056,CSE 272,A00,102397,Li; Tzumao,0,19,0,0
1668547168480,CSE 274,A00,111323,Chern; Albert Ren-Haur,0,15,0,0
1668547168920,CSE 282,A00,102398,Pevzner; Pavel Arkadjevich,0,0,0,0
1668547169345,CSE 284,A00,114175,Gymrek; Melissa Ann,0,29,0,0
1668547169773,CSE 290,A00,102399,Chandraker; Manmohan Krishna,0,11,0,0
1668547169773,CSE 290,B00,102400,Vaccaro; Kristen Marie,0,8,25,25
1668547169773,CSE 290,C00,102414,Pannuto; Patrick William,0,1,25,25
1668547169773,CSE 290,D00,102427,Pevzner; Pavel Arkadjevich,0,0,0,0
1668547169773,CSE 290,E00,102429,Zhao; Jishen,0,6,0,0
1668547169773,CSE 290,F00,102436,Tullsen; Dean Michael,0,6,0,0
1668547169773,CSE 290,G00,102440,Christensen; Henrik I,0,6,20,20
1668547170203,CSE 291,A00,102443,Su; Hao,0,0,0,0
1668547170203,CSE 291,B00,102448,Polikarpova; Nadezhda,0,0,0,0
1668547170203,CSE 291,C00,102453,Vaccaro; Kristen Marie,0,0,0,0
1668547170203,CSE 291,D00,111343,Savage; Stefan,0,0,0,0
1668547170203,CSE 291,E00,116474,Claffy; Kimberly Claire,0,0,0,0
1668547170203,CSE 291,F00,116479,Pasquale; Joseph,0,0,0,0
1668547170648,CSE 293,001,119111,Bafna; Vineet,9999,0,9999,0
1668547170648,CSE 293,002,119118,Bellare; Mihir,9999,0,9999,0
1668547170648,CSE 293,003,119122,Berg-Kirkpatrick; Taylor D,9999,0,9999,0
1668547170648,CSE 293,004,119135,Christensen; Henrik I,9999,0,9999,0
1668547170648,CSE 293,005,119142,Cottrell; Garrison W,9999,0,9999,0
1668547170648,CSE 293,006,119146,Deutsch; Alin Bernard,9999,0,9999,0
1668547170648,CSE 293,007,119159,Esmaeilzadeh; Hadi,9999,0,9999,0
1668547170648,CSE 293,008,119166,Freund; Yoav,9999,0,9999,0
1668547170648,CSE 293,009,119170,Griswold; William G.,9999,0,9999,0
1668547170648,CSE 293,010,119183,Gymrek; Melissa Ann,9999,0,9999,0
1668547170648,CSE 293,011,119190,Heninger; Nadia A,9999,0,9999,0
1668547170648,CSE 293,012,119230,Impagliazzo; Russell,9999,0,9999,0
1668547170648,CSE 293,013,119232,Jhala; Ranjit,9999,0,9999,0
1668547170648,CSE 293,014,119233,Kahng; Andrew Byun,9999,0,9999,0
1668547170648,CSE 293,015,119298,Kane; Daniel Mertz,9999,0,9999,0
1668547170648,CSE 293,016,119299,Kriegman; David J,9999,0,9999,0
1668547170648,CSE 293,017,119300,Kumar; Arun Kumar,9999,0,9999,0
1668547170648,CSE 293,018,119301,Lerner; Sorin,9999,0,9999,0
1668547170648,CSE 293,019,119302,Lovett; Shachar,9999,0,9999,0
1668547170648,CSE 293,020,119303,McAuley; Julian John,9999,0,9999,0
1668547170648,CSE 293,021,119304,Micciancio; Daniele,9999,0,9999,0
1668547170648,CSE 293,022,119367,Orailoglu; Alex,9999,0,9999,0
1668547170648,CSE 293,023,119382,Paturi; Ramamohan,9999,0,9999,0
1668547170648,CSE 293,024,119404,Polikarpova; Nadezhda,9999,0,9999,0
1668547170648,CSE 293,025,119406,Politz; Joseph Gibbs,9999,0,9999,0
1668547170648,CSE 293,026,119411,Porter; George M,9999,0,9999,0
1668547170648,CSE 293,027,119414,Porter; Leonard Emerson,9999,0,9999,0
1668547170648,CSE 293,028,119416,Ramamoorthi; Ravi,9999,0,9999,0
1668547170648,CSE 293,029,119417,Sahoo; Debashis,9999,0,9999,0
1668547170648,CSE 293,030,119420,Saul; Lawrence,9999,0,9999,0
1668547170648,CSE 293,031,119421,Savage; Stefan,9999,0,9999,0
1668547170648,CSE 293,032,119425,Schulze; Jurgen P.,9999,0,9999,0
1668547170648,CSE 293,033,119426,Snoeren; Alex C.,9999,0,9999,0
1668547170648,CSE 293,034,119428,Shang; Jingbo,9999,0,9999,0
1668547170648,CSE 293,035,119430,Stefan; Deian,9999,0,9999,0
1668547170648,CSE 293,036,119431,Su; Hao,9999,0,9999,0
1668547170648,CSE 293,037,119433,Swanson; Steven James,9999,0,9999,0
1668547170648,CSE 293,038,119435,Tullsen; Dean Michael,9999,0,9999,0
1668547170648,CSE 293,039,119483,Voelker; Geoffrey M.,9999,0,9999,0
1668547170648,CSE 293,040,119537,Zhao; Jishen,9999,0,9999,0
1668547170648,CSE 293,041,119538,Zhou; Yuan-Yuan,9999,0,9999,0
1668547170648,CSE 293,042,119539,Gao; Sicun,9999,0,9999,0
1668547170648,CSE 293,043,119540,Weibel; Nadir,9999,0,9999,0
1668547170648,CSE 293,044,119541,Gupta; Rajesh K.,9999,0,9999,0
1668547170648,CSE 293,045,126410,Vaccaro; Kristen Marie,9999,0,9999,0
1668547170648,CSE 293,046,126411,Klemke; Richard,9999,0,9999,0
1668547171078,CSE 294,A00,102459,Voelker; Geoffrey M.,0,2,0,0
1668547171078,CSE 294,B00,111322,Orailoglu; Alex,0,2,0,0
1668547171505,DSE 201,A00,096914,Deutsch; Alin Bernard,30,0,30,0
1668547171934,DSE 210,A00,096915,Dasgupta; Sanjoy,30,0,30,0
1668547172368,DSE 260A,A00,096916,Altintas De Callaf; Ilkay,30,0,30,0
1668547172817,ECE 200,001,103586,Antipa; Nicholas A,9999,0,9999,0
1668547172817,ECE 200,002,103587,Atanasov; Nikolay A.,9999,0,9999,0
1668547172817,ECE 200,003,103588,Bharadia; Dinesh,9999,0,9999,0
1668547172817,ECE 200,004,103589,Cheng; Chung Kuan,9999,0,9999,0
1668547172817,ECE 200,005,103590,Cosman; Pamela C.,9999,0,9999,0
1668547172817,ECE 200,006,103591,Dayeh; Shadi Ahmad,9999,0,9999,0
1668547172817,ECE 200,007,103592,Fainman; Yeshaiahu,9999,0,9999,0
1668547172817,ECE 200,008,103593,Ford; Joseph Earl,9999,0,9999,0
1668547172817,ECE 200,009,103594,Franceschetti; Massimo,9999,0,9999,0
1668547172817,ECE 200,010,103595,Fullerton; Eric E,9999,0,9999,0
1668547172817,ECE 200,011,103596,Galton; Ian A,9999,0,9999,0
1668547172817,ECE 200,012,103597,Gilja; Vikash,9999,0,9999,0
1668547172817,ECE 200,013,103598,Hall; Drew A.,9999,0,9999,0
1668547172817,ECE 200,014,103599,Hsueh; Tzu-Chien,9999,0,9999,0
1668547172817,ECE 200,015,103600,Javidi; Tara,9999,0,9999,0
1668547172817,ECE 200,016,103601,Kahng; Andrew Byun,9999,0,9999,0
1668547172817,ECE 200,017,103602,Kim; Young-Han,9999,0,9999,0
1668547172817,ECE 200,018,103603,Koushanfar; Farinaz,9999,0,9999,0
1668547172817,ECE 200,019,103604,Kuzum; Duygu,9999,0,9999,0
1668547172817,ECE 200,020,103605,Le; Hanh-Phuc,9999,0,9999,0
1668547172817,ECE 200,021,103606,Lin; Bill,9999,0,9999,0
1668547172817,ECE 200,022,103607,Liu; Zhaowei,9998,0,9999,1
1668547172817,ECE 200,023,103608,Lo; Yu-Hwa,9999,0,9999,0
1668547172817,ECE 200,024,103609,Lomakin; Vitaliy,9999,0,9999,0
1668547172817,ECE 200,025,103610,Mercier; Patrick Philip,9999,0,9999,0
1668547172817,ECE 200,026,103611,Meyer; Florian,9999,0,9999,0
1668547172817,ECE 200,027,103612,Milstein; Laurence B.,9999,0,9999,0
1668547172817,ECE 200,028,103613,Mir Arabbaygi; Siavash,9999,0,9999,0
1668547172817,ECE 200,029,103614,Mookherjea; Shayan,9999,0,9999,0
1668547172817,ECE 200,030,103615,Morris; Karcher William,9999,0,9999,0
1668547172817,ECE 200,031,103616,Ng; Tse Nga,9999,0,9999,0
1668547172817,ECE 200,032,103617,Nguyen; Truong Quang,9999,0,9999,0
1668547172817,ECE 200,033,103618,Nomura; Kenji,9999,0,9999,0
1668547172817,ECE 200,034,103619,Orlitsky; Alon,9999,0,9999,0
1668547172817,ECE 200,035,103620,Pal; Piya,9999,0,9999,0
1668547172817,ECE 200,036,103621,Papen; George C.,9999,0,9999,0
1668547172817,ECE 200,037,103622,Radic; Stojan,9999,0,9999,0
1668547172817,ECE 200,038,103623,Rao; Bhaskar D.,9999,0,9999,0
1668547172817,ECE 200,039,103624,Rao; Ramesh R,9999,0,9999,0
1668547172817,ECE 200,040,103625,Rebeiz; Gabriel,9999,0,9999,0
1668547172817,ECE 200,041,103626,Sanford; John R,9999,0,9999,0
1668547172817,ECE 200,042,103627,Siegel; Paul H.,9999,0,9999,0
1668547172817,ECE 200,043,103628,Sievenpiper; Daniel F.,9999,0,9999,0
1668547172817,ECE 200,044,103629,Sworder; David D.,9999,0,9999,0
1668547172817,ECE 200,045,103630,Taur; Yuan,9999,0,9999,0
1668547172817,ECE 200,046,103631,Touri; Behrouz,9999,0,9999,0
1668547172817,ECE 200,047,103632,Trivedi; Mohan M.,9999,0,9999,0
1668547172817,ECE 200,048,103633,Vasconcelos; Nuno,9999,0,9999,0
1668547172817,ECE 200,049,103634,Wang; Xiaolong,9999,0,9999,0
1668547172817,ECE 200,050,103635,Xie; Pengtao,9999,0,9999,0
1668547172817,ECE 200,051,103636,Yip; Michael,9999,0,9999,0
1668547172817,ECE 200,052,103637,Zeger; Kenneth A.,999,0,999,0
1668547172817,ECE 200,053,103638,Zhang; Xinyu,9999,0,9999,0
1668547172817,ECE 200,054,103639,Turakhia; Yatish Girish,9999,0,9999,0
1668547172817,ECE 200,055,103640,Kang; Mingu,9999,0,9999,0
1668547172817,ECE 200,056,103641,Shi; Yuanyuan,9999,0,9999,0
1668547172817,ECE 200,057,103642,Wang; Edward Jay,9999,0,9999,0
1668547172817,ECE 200,058,103643,Zheng; Yang,9999,0,9999,0
1668547173255,ECE 202,A00,103644,Kuzum; Duygu,0,45,0,0
1668547173677,ECE 212BN,A00,103646,Ng; Tse Nga,0,9,0,0
1668547174110,ECE 221,A00,111493,Staff,0,0,0,0
1668547174534,ECE 222B,A00,103647,Lomakin; Vitaliy,0,20,0,0
1668547174964,ECE 230B,A00,103648,Taur; Yuan,0,3,0,0
1668547175397,ECE 238B,A00,103649,Garay; Javier,0,0,0,0
1668547175828,ECE 240B,A00,112900,Fainman; Yeshaiahu,0,7,0,0
1668547176254,ECE 247A,A00,103650,Jokerst; Jesse Vincent,0,6,0,0
1668547176692,ECE 247B,A00,103651,Wang; Joseph,0,14,0,0
1668547177115,ECE 250,A00,103652,Siegel; Paul H.,0,82,0,0
1668547177546,ECE 251A,A00,103654,Rao; Bhaskar D.,0,63,0,0
1668547177974,ECE 257B,A00,103655,Bharadia; Dinesh,0,33,0,0
1668547178396,ECE 258A,A00,103656,Milstein; Laurence B.,0,29,0,0
1668547178827,ECE 260B,A00,103658,Kang; Mingu,0,123,0,0
1668547179254,ECE 264A,A00,103659,Galton; Ian A,0,72,0,0
1668547179785,ECE 265A,A00,103661,Gudem; Prasad S.S.,0,73,0,0
1668547180221,ECE 265D,A00,103662,Gudem; Prasad S.S.,0,26,0,0
1668547180649,ECE 268,A00,103663,Koushanfar; Farinaz,0,43,0,0
1668547181073,ECE 269,A01,103665,Pal; Piya,0,219,0,0
1668547181496,ECE 271B,A00,103666,Vasconcelos; Manuela,0,78,0,0
1668547181939,ECE 276A,A00,103667,Atanasov; Nikolay A.,0,127,0,0
1668547182365,ECE 277,A00,103668,An; Cheolhong,0,151,0,0
1668547182802,ECE 279,A00,117947,Hall; Drew A.,0,22,0,0
1668547183677,ECE 283,A00,103670,Hsueh; Tzu-Chien,0,57,0,0
1668547184106,ECE 284,A00,103671,Turakhia; Yatish Girish,0,40,0,0
1668547184536,ECE 285,A00,103672,Zheng; Yang,0,41,0,0
1668547184536,ECE 285,B00,103673,Sworder; David D.,0,61,0,0
1668547184958,ECE 287,A00,103676,Javidi; Tara,0,9,0,0
1668547185382,MATH 200B,A00,098023,Salehi Golsefidy; Alireza,10,0,15,5
1668547185813,MATH 202B,A00,098024,Rhoades; Brendon Patrick,7,0,15,8
1668547186243,MATH 203B,A00,098025,Oprea; Dragos N.,9,0,15,6
1668547186669,MATH 204B,A00,098026,Sorensen; Claus M,13,0,15,2
1668547187096,MATH 208,A00,098027,Izadi; Elham,7,0,10,3
1668547187527,MATH 209,A00,098028,Pollack; Aaron,10,0,10,0
1668547187961,MATH 211A,A00,112919,Rogalski; Daniel,8,0,10,2
1668547188398,MATH 211B,A00,112920,Seward; Brandon M.,9,0,10,1
1668547188827,MATH 218,A00,098029,Li; Bo,10,0,10,0
1668547189252,MATH 220B,A00,098030,Novak; Jonathan I,11,0,15,4
1668547189684,MATH 221A,A00,098031,Ebenfelt; Peter F,12,0,15,3
1668547190113,MATH 231B,A00,098032,Zlatos; Andrej,10,0,15,5
1668547190539,MATH 240B,A00,098033,Ni; Lei,7,0,15,8
1668547190963,MATH 243,A00,098034,Jekel; David Andrew,10,0,10,0
1668547191389,MATH 245A,A00,098035,Nie; Jiawang,0,5,15,18
1668547191818,MATH 248,A00,098036,Bejenaru; Ioan,10,0,10,0
1668547192244,MATH 250B,A00,098037,Spolaor; Luca,14,0,15,1
1668547192682,MATH 258,A00,098038,Ni; Lei,9,0,10,1
1668547193112,MATH 264B,A00,098041,Rhoades; Brendon Patrick,8,0,15,7
1668547193544,MATH 268,A00,098042,Buss; Samuel R,10,0,10,0
1668547193978,MATH 269,A00,098043,Rhoades; Brendon Patrick,10,0,10,0
1668547194403,MATH 270B,A00,098044,Li; Bo,6,0,15,9
1668547194836,MATH 272B,A00,098045,Holst; Michael J,13,0,15,2
1668547195261,MATH 273A,A00,098046,Tian; Xiaochuan,10,0,15,5
1668547195692,MATH 275,A01,098048,Tian; Xiaochuan,6,0,10,4
1668547196126,MATH 278A,A00,098049,Holst; Michael J,6,0,10,4
1668547196552,MATH 278B,A00,098050,Cloninger; Alexander,10,0,10,0
1668547196974,MATH 278C,A00,098051,Nie; Jiawang,5,0,10,5
1668547197407,MATH 280B,A00,098052,Zheng; Tianyi,7,0,15,8
1668547197845,MATH 281B,A00,098053,Bradic; Jelena,0,2,15,15
1668547198284,MATH 282B,A00,098054,Arias-Castro; Ery,0,1,15,15
1668547198710,MATH 285,A00,098055,Fitzsimmons; Patrick J,0,4,15,17
1668547199134,MATH 287B,A00,098056,Arias-Castro; Ery,1,0,15,14
1668547199558,MATH 288,A00,098057,Agarwal; Pooja,9,0,10,1
1668547199558,MATH 288,B00,098058,Zhang; Danna,8,0,10,2
1668547199558,MATH 288,C00,098059,Williams; Ruth J,9,0,10,1
1668547199983,MATH 290B,A00,098060,Roberts; Justin Deritter,12,0,15,3
1668547200432,MATH 292,A00,098061,Belmont; Eva Kinoshita,10,0,10,0
1668547200874,MATH 295,A00,098062,Suk; Andrew Hoon,47,0,50,3
1668547201304,MATH 296,A00,098063,Novak; Jonathan I,20,0,20,0
1668547201733,MATH 297,001,098064,Gamst; Anthony Collins,9997,0,9999,2
1668547707397,COGS 205,A00,101395,Chiba; Andrea,19,0,20,1
1668547707824,COGS 210B,001,101404,Greene; Deanna Jacquelyn,9998,0,9999,1
1668547707824,COGS 210B,002,101417,Xia; Haijun,9999,0,9999,0
1668547707824,COGS 210B,003,101422,Nitz; Douglas A.,9999,0,9999,0
1668547707824,COGS 210B,004,101423,Hollan; James D.,9998,0,9999,1
1668547707824,COGS 210B,005,101424,Deak; Gedeon O.,9998,0,9999,1
1668547707824,COGS 210B,006,101425,Rossano; Federico,9999,0,9999,0
1668547708250,COGS 211B,A00,101427,Coulson; Seana M,9996,0,9999,3
1668547708683,COGS 220,A00,101428,Hollan; James D.,0,14,25,25
1668547709105,COGS 229,A00,101429,Dow; Steven P,17,0,25,8
1668547709539,COGS 230,A00,101430,Klemmer; Scott R,6,0,17,11
1668547709963,COGS 234,A00,101431,Xia; Haijun,0,1,25,25
1668547710397,COGS 260,A00,101432,Kiyonaga; Anastasia,21,0,25,4
1668547710397,COGS 260,B00,101433,Kirsh; David Joel,15,0,25,10
1668547710827,CSE 202,A00,102371,Impagliazzo; Russell,0,69,0,0
1668547711250,CSE 203B,A01,102373,Cheng; Chung Kuan,0,63,0,0
1668547711671,CSE 208,A00,102374,Micciancio; Daniele,0,5,0,0
1668547712111,CSE 209A,A00,112895,Impagliazzo; Russell,0,13,15,15
1668547712533,CSE 209B,A00,108005,Bellare; Mihir,0,7,0,0
1668547712967,CSE 210,A00,113163,Coblenz; Michael J,0,90,0,0
1668547713397,CSE 219,A00,106111,Dow; Steven P,0,8,20,20
1668547713825,CSE 221,A00,102376,Voelker; Geoffrey M.,0,75,0,0
1668547714249,CSE 224,A01,102378,Porter; George M,0,173,0,0
1668547714687,CSE 229A,A00,102379,Savage; Stefan,0,11,0,0
1668547715113,CSE 229C,A00,102380,Munyaka; Imani N. S.,0,10,0,0
1668547715543,CSE 232B,A00,102382,Deutsch; Alin Bernard,0,37,0,0
1668547715967,CSE 234,A01,112904,Kumar; Arun Kumar,0,0,0,0
1668547716393,CSE 237A,A00,102383,Rosing; Tajana Simunic,0,56,0,0
1668547716815,CSE 239A,A00,102384,Deutsch; Alin Bernard,0,16,0,0
1668547717241,CSE 239B,A00,102385,Polikarpova; Nadezhda,0,11,0,0
1668547717667,CSE 240A,A00,102386,Pannuto; Patrick William,0,47,0,0
1668547718098,CSE 240B,A00,102387,Zhao; Jishen,0,50,0,0
1668547718530,CSE 241A,A00,106406,Kang; Mingu,0,9,0,0
1668547718953,CSE 249B,A00,102388,Kahng; Andrew Byun,0,5,8,8
1668547719377,CSE 251B,A01,102392,Cottrell; Garrison W,0,52,0,0
1668547719377,CSE 251B,A02,102393,Cottrell; Garrison W,0,35,0,0
1668547719814,CSE 252B,A00,102394,Ochoa; Benjamin Lawrence,0,61,0,0
1668547720243,CSE 257,A01,102396,Gao; Sicun,0,149,0,0
1668547720667,CSE 272,A00,102397,Li; Tzumao,0,19,0,0
1668547721090,CSE 274,A00,111323,Chern; Albert Ren-Haur,0,15,0,0
1668547721515,CSE 282,A00,102398,Pevzner; Pavel Arkadjevich,0,0,0,0
1668547721946,CSE 284,A00,114175,Gymrek; Melissa Ann,0,28,0,0
1668547722373,CSE 290,A00,102399,Chandraker; Manmohan Krishna,0,11,0,0
1668547722373,CSE 290,B00,102400,Vaccaro; Kristen Marie,0,8,25,25
1668547722373,CSE 290,C00,102414,Pannuto; Patrick William,0,1,25,25
1668547722373,CSE 290,D00,102427,Pevzner; Pavel Arkadjevich,0,0,0,0
1668547722373,CSE 290,E00,102429,Zhao; Jishen,0,6,0,0
1668547722373,CSE 290,F00,102436,Tullsen; Dean Michael,0,6,0,0
1668547722373,CSE 290,G00,102440,Christensen; Henrik I,0,6,20,20
1668547722798,CSE 291,A00,102443,Su; Hao,0,0,0,0
1668547722798,CSE 291,B00,102448,Polikarpova; Nadezhda,0,0,0,0
1668547722798,CSE 291,C00,102453,Vaccaro; Kristen Marie,0,0,0,0
1668547722798,CSE 291,D00,111343,Savage; Stefan,0,0,0,0
1668547722798,CSE 291,E00,116474,Claffy; Kimberly Claire,0,0,0,0
1668547722798,CSE 291,F00,116479,Pasquale; Joseph,0,0,0,0
1668547723246,CSE 293,001,119111,Bafna; Vineet,9999,0,9999,0
1668547723246,CSE 293,002,119118,Bellare; Mihir,9999,0,9999,0
1668547723246,CSE 293,003,119122,Berg-Kirkpatrick; Taylor D,9999,0,9999,0
1668547723246,CSE 293,004,119135,Christensen; Henrik I,9999,0,9999,0
1668547723246,CSE 293,005,119142,Cottrell; Garrison W,9999,0,9999,0
1668547723246,CSE 293,006,119146,Deutsch; Alin Bernard,9999,0,9999,0
1668547723246,CSE 293,007,119159,Esmaeilzadeh; Hadi,9999,0,9999,0
1668547723246,CSE 293,008,119166,Freund; Yoav,9999,0,9999,0
1668547723246,CSE 293,009,119170,Griswold; William G.,9999,0,9999,0
1668547723246,CSE 293,010,119183,Gymrek; Melissa Ann,9999,0,9999,0
1668547723246,CSE 293,011,119190,Heninger; Nadia A,9999,0,9999,0
1668547723246,CSE 293,012,119230,Impagliazzo; Russell,9999,0,9999,0
1668547723246,CSE 293,013,119232,Jhala; Ranjit,9999,0,9999,0
1668547723246,CSE 293,014,119233,Kahng; Andrew Byun,9999,0,9999,0
1668547723246,CSE 293,015,119298,Kane; Daniel Mertz,9999,0,9999,0
1668547723246,CSE 293,016,119299,Kriegman; David J,9999,0,9999,0
1668547723246,CSE 293,017,119300,Kumar; Arun Kumar,9999,0,9999,0
1668547723246,CSE 293,018,119301,Lerner; Sorin,9999,0,9999,0
1668547723246,CSE 293,019,119302,Lovett; Shachar,9999,0,9999,0
1668547723246,CSE 293,020,119303,McAuley; Julian John,9999,0,9999,0
1668547723246,CSE 293,021,119304,Micciancio; Daniele,9999,0,9999,0
1668547723246,CSE 293,022,119367,Orailoglu; Alex,9999,0,9999,0
1668547723246,CSE 293,023,119382,Paturi; Ramamohan,9999,0,9999,0
1668547723246,CSE 293,024,119404,Polikarpova; Nadezhda,9999,0,9999,0
1668547723246,CSE 293,025,119406,Politz; Joseph Gibbs,9999,0,9999,0
1668547723246,CSE 293,026,119411,Porter; George M,9999,0,9999,0
1668547723246,CSE 293,027,119414,Porter; Leonard Emerson,9999,0,9999,0
1668547723246,CSE 293,028,119416,Ramamoorthi; Ravi,9999,0,9999,0
1668547723246,CSE 293,029,119417,Sahoo; Debashis,9999,0,9999,0
1668547723246,CSE 293,030,119420,Saul; Lawrence,9999,0,9999,0
1668547723246,CSE 293,031,119421,Savage; Stefan,9999,0,9999,0
1668547723246,CSE 293,032,119425,Schulze; Jurgen P.,9999,0,9999,0
1668547723246,CSE 293,033,119426,Snoeren; Alex C.,9999,0,9999,0
1668547723246,CSE 293,034,119428,Shang; Jingbo,9999,0,9999,0
1668547723246,CSE 293,035,119430,Stefan; Deian,9999,0,9999,0
1668547723246,CSE 293,036,119431,Su; Hao,9999,0,9999,0
1668547723246,CSE 293,037,119433,Swanson; Steven James,9999,0,9999,0
1668547723246,CSE 293,038,119435,Tullsen; Dean Michael,9999,0,9999,0
1668547723246,CSE 293,039,119483,Voelker; Geoffrey M.,9999,0,9999,0
1668547723246,CSE 293,040,119537,Zhao; Jishen,9999,0,9999,0
1668547723246,CSE 293,041,119538,Zhou; Yuan-Yuan,9999,0,9999,0
1668547723246,CSE 293,042,119539,Gao; Sicun,9999,0,9999,0
1668547723246,CSE 293,043,119540,Weibel; Nadir,9999,0,9999,0
1668547723246,CSE 293,044,119541,Gupta; Rajesh K.,9999,0,9999,0
1668547723246,CSE 293,045,126410,Vaccaro; Kristen Marie,9999,0,9999,0
1668547723246,CSE 293,046,126411,Klemke; Richard,9999,0,9999,0
1668547723674,CSE 294,A00,102459,Voelker; Geoffrey M.,0,2,0,0
1668547723674,CSE 294,B00,111322,Orailoglu; Alex,0,2,0,0
1668547724098,DSE 201,A00,096914,Deutsch; Alin Bernard,30,0,30,0
1668547724526,DSE 210,A00,096915,Dasgupta; Sanjoy,30,0,30,0
1668547724949,DSE 260A,A00,096916,Altintas De Callaf; Ilkay,30,0,30,0
1668547725379,ECE 200,001,103586,Antipa; Nicholas A,9999,0,9999,0
1668547725379,ECE 200,002,103587,Atanasov; Nikolay A.,9999,0,9999,0
1668547725379,ECE 200,003,103588,Bharadia; Dinesh,9999,0,9999,0
1668547725379,ECE 200,004,103589,Cheng; Chung Kuan,9999,0,9999,0
1668547725379,ECE 200,005,103590,Cosman; Pamela C.,9999,0,9999,0
1668547725379,ECE 200,006,103591,Dayeh; Shadi Ahmad,9999,0,9999,0
1668547725379,ECE 200,007,103592,Fainman; Yeshaiahu,9999,0,9999,0
1668547725379,ECE 200,008,103593,Ford; Joseph Earl,9999,0,9999,0
1668547725379,ECE 200,009,103594,Franceschetti; Massimo,9999,0,9999,0
1668547725379,ECE 200,010,103595,Fullerton; Eric E,9999,0,9999,0
1668547725379,ECE 200,011,103596,Galton; Ian A,9999,0,9999,0
1668547725379,ECE 200,012,103597,Gilja; Vikash,9999,0,9999,0
1668547725379,ECE 200,013,103598,Hall; Drew A.,9999,0,9999,0
1668547725379,ECE 200,014,103599,Hsueh; Tzu-Chien,9999,0,9999,0
1668547725379,ECE 200,015,103600,Javidi; Tara,9999,0,9999,0
1668547725379,ECE 200,016,103601,Kahng; Andrew Byun,9999,0,9999,0
1668547725379,ECE 200,017,103602,Kim; Young-Han,9999,0,9999,0
1668547725379,ECE 200,018,103603,Koushanfar; Farinaz,9999,0,9999,0
1668547725379,ECE 200,019,103604,Kuzum; Duygu,9999,0,9999,0
1668547725379,ECE 200,020,103605,Le; Hanh-Phuc,9999,0,9999,0
1668547725379,ECE 200,021,103606,Lin; Bill,9999,0,9999,0
1668547725379,ECE 200,022,103607,Liu; Zhaowei,9998,0,9999,1
1668547725379,ECE 200,023,103608,Lo; Yu-Hwa,9999,0,9999,0
1668547725379,ECE 200,024,103609,Lomakin; Vitaliy,9999,0,9999,0
1668547725379,ECE 200,025,103610,Mercier; Patrick Philip,9999,0,9999,0
1668547725379,ECE 200,026,103611,Meyer; Florian,9999,0,9999,0
1668547725379,ECE 200,027,103612,Milstein; Laurence B.,9999,0,9999,0
1668547725379,ECE 200,028,103613,Mir Arabbaygi; Siavash,9999,0,9999,0
1668547725379,ECE 200,029,103614,Mookherjea; Shayan,9999,0,9999,0
1668547725379,ECE 200,030,103615,Morris; Karcher William,9999,0,9999,0
1668547725379,ECE 200,031,103616,Ng; Tse Nga,9999,0,9999,0
1668547725379,ECE 200,032,103617,Nguyen; Truong Quang,9999,0,9999,0
1668547725379,ECE 200,033,103618,Nomura; Kenji,9999,0,9999,0
1668547725379,ECE 200,034,103619,Orlitsky; Alon,9999,0,9999,0
1668547725379,ECE 200,035,103620,Pal; Piya,9999,0,9999,0
1668547725379,ECE 200,036,103621,Papen; George C.,9999,0,9999,0
1668547725379,ECE 200,037,103622,Radic; Stojan,9999,0,9999,0
1668547725379,ECE 200,038,103623,Rao; Bhaskar D.,9999,0,9999,0
1668547725379,ECE 200,039,103624,Rao; Ramesh R,9999,0,9999,0
1668547725379,ECE 200,040,103625,Rebeiz; Gabriel,9999,0,9999,0
1668547725379,ECE 200,041,103626,Sanford; John R,9999,0,9999,0
1668547725379,ECE 200,042,103627,Siegel; Paul H.,9999,0,9999,0
1668547725379,ECE 200,043,103628,Sievenpiper; Daniel F.,9999,0,9999,0
1668547725379,ECE 200,044,103629,Sworder; David D.,9999,0,9999,0
1668547725379,ECE 200,045,103630,Taur; Yuan,9999,0,9999,0
1668547725379,ECE 200,046,103631,Touri; Behrouz,9999,0,9999,0
1668547725379,ECE 200,047,103632,Trivedi; Mohan M.,9999,0,9999,0
1668547725379,ECE 200,048,103633,Vasconcelos; Nuno,9999,0,9999,0
1668547725379,ECE 200,049,103634,Wang; Xiaolong,9999,0,9999,0
1668547725379,ECE 200,050,103635,Xie; Pengtao,9999,0,9999,0
1668547725379,ECE 200,051,103636,Yip; Michael,9999,0,9999,0
1668547725379,ECE 200,052,103637,Zeger; Kenneth A.,999,0,999,0
1668547725379,ECE 200,053,103638,Zhang; Xinyu,9999,0,9999,0
1668547725379,ECE 200,054,103639,Turakhia; Yatish Girish,9999,0,9999,0
1668547725379,ECE 200,055,103640,Kang; Mingu,9999,0,9999,0
1668547725379,ECE 200,056,103641,Shi; Yuanyuan,9999,0,9999,0
1668547725379,ECE 200,057,103642,Wang; Edward Jay,9999,0,9999,0
1668547725379,ECE 200,058,103643,Zheng; Yang,9999,0,9999,0
1668547725807,ECE 202,A00,103644,Kuzum; Duygu,0,45,0,0
1668547726243,ECE 212BN,A00,103646,Ng; Tse Nga,0,9,0,0
1668547726675,ECE 221,A00,111493,Staff,0,0,0,0
1668547727111,ECE 222B,A00,103647,Lomakin; Vitaliy,0,20,0,0
1668547727538,ECE 230B,A00,103648,Taur; Yuan,0,3,0,0
1668547727968,ECE 238B,A00,103649,Garay; Javier,0,0,0,0
1668547728402,ECE 240B,A00,112900,Fainman; Yeshaiahu,0,7,0,0
1668547728825,ECE 247A,A00,103650,Jokerst; Jesse Vincent,0,6,0,0
1668547729252,ECE 247B,A00,103651,Wang; Joseph,0,14,0,0
1668547729684,ECE 250,A00,103652,Siegel; Paul H.,0,82,0,0
1668547730107,ECE 251A,A00,103654,Rao; Bhaskar D.,0,63,0,0
1668547730537,ECE 257B,A00,103655,Bharadia; Dinesh,0,33,0,0
1668547730971,ECE 258A,A00,103656,Milstein; Laurence B.,0,29,0,0
1668547731403,ECE 260B,A00,103658,Kang; Mingu,0,123,0,0
1668547731828,ECE 264A,A00,103659,Galton; Ian A,0,72,0,0
1668547732263,ECE 265A,A00,103661,Gudem; Prasad S.S.,0,73,0,0
1668547732688,ECE 265D,A00,103662,Gudem; Prasad S.S.,0,26,0,0
1668547733120,ECE 268,A00,103663,Koushanfar; Farinaz,0,43,0,0
1668547733550,ECE 269,A01,103665,Pal; Piya,0,219,0,0
1668547733973,ECE 271B,A00,103666,Vasconcelos; Manuela,0,78,0,0
1668547734420,ECE 276A,A00,103667,Atanasov; Nikolay A.,0,127,0,0
1668547734848,ECE 277,A00,103668,An; Cheolhong,0,151,0,0
1668547735284,ECE 279,A00,117947,Hall; Drew A.,0,22,0,0
1668547736148,ECE 283,A00,103670,Hsueh; Tzu-Chien,0,57,0,0
1668547736580,ECE 284,A00,103671,Turakhia; Yatish Girish,0,40,0,0
1668547737013,ECE 285,A00,103672,Zheng; Yang,0,41,0,0
1668547737013,ECE 285,B00,103673,Sworder; David D.,0,61,0,0
1668547737442,ECE 287,A00,103676,Javidi; Tara,0,9,0,0
1668547737877,MATH 200B,A00,098023,Salehi Golsefidy; Alireza,10,0,15,5
1668547738354,MATH 202B,A00,098024,Rhoades; Brendon Patrick,7,0,15,8
1668547738780,MATH 203B,A00,098025,Oprea; Dragos N.,9,0,15,6
1668547739223,MATH 204B,A00,098026,Sorensen; Claus M,13,0,15,2
1668547739663,MATH 208,A00,098027,Izadi; Elham,7,0,10,3
1668547740098,MATH 209,A00,098028,Pollack; Aaron,10,0,10,0
1668547740522,MATH 211A,A00,112919,Rogalski; Daniel,8,0,10,2
1668547740946,MATH 211B,A00,112920,Seward; Brandon M.,9,0,10,1
1668547741392,MATH 218,A00,098029,Li; Bo,10,0,10,0
1668547741817,MATH 220B,A00,098030,Novak; Jonathan I,11,0,15,4
1668547742241,MATH 221A,A00,098031,Ebenfelt; Peter F,12,0,15,3
1668547742668,MATH 231B,A00,098032,Zlatos; Andrej,10,0,15,5
1668547743092,MATH 240B,A00,098033,Ni; Lei,7,0,15,8
1668547743581,MATH 243,A00,098034,Jekel; David Andrew,10,0,10,0
1668547744007,MATH 245A,A00,098035,Nie; Jiawang,0,5,15,18
1668547744432,MATH 248,A00,098036,Bejenaru; Ioan,10,0,10,0
1668547744857,MATH 250B,A00,098037,Spolaor; Luca,14,0,15,1
1668547745282,MATH 258,A00,098038,Ni; Lei,9,0,10,1
1668547745717,MATH 264B,A00,098041,Rhoades; Brendon Patrick,8,0,15,7
1668547746150,MATH 268,A00,098042,Buss; Samuel R,10,0,10,0
1668547746575,MATH 269,A00,098043,Rhoades; Brendon Patrick,10,0,10,0
1668547747002,MATH 270B,A00,098044,Li; Bo,6,0,15,9
1668547747529,MATH 272B,A00,098045,Holst; Michael J,13,0,15,2
1668547747958,MATH 273A,A00,098046,Tian; Xiaochuan,10,0,15,5
1668547748387,MATH 275,A01,098048,Tian; Xiaochuan,6,0,10,4
1668547748815,MATH 278A,A00,098049,Holst; Michael J,6,0,10,4
1668547749241,MATH 278B,A00,098050,Cloninger; Alexander,10,0,10,0
1668547749691,MATH 278C,A00,098051,Nie; Jiawang,5,0,10,5
1668547750118,MATH 280B,A00,098052,Zheng; Tianyi,7,0,15,8
1668547750544,MATH 281B,A00,098053,Bradic; Jelena,0,2,15,15
1668547750985,MATH 282B,A00,098054,Arias-Castro; Ery,0,1,15,15
1668547751418,MATH 285,A00,098055,Fitzsimmons; Patrick J,0,4,15,17
1668547751839,MATH 287B,A00,098056,Arias-Castro; Ery,1,0,15,14
1668547752265,MATH 288,A00,098057,Agarwal; Pooja,9,0,10,1
1668547752265,MATH 288,B00,098058,Zhang; Danna,8,0,10,2
1668547752265,MATH 288,C00,098059,Williams; Ruth J,9,0,10,1
1668547752688,MATH 290B,A00,098060,Roberts; Justin Deritter,12,0,15,3
1668547753119,MATH 292,A00,098061,Belmont; Eva Kinoshita,10,0,10,0
1668547753549,MATH 295,A00,098062,Suk; Andrew Hoon,47,0,50,3
1668547754053,MATH 296,A00,098063,Novak; Jonathan I,20,0,20,0
1668547754478,MATH 297,001,098064,Gamst; Anthony Collins,9997,0,9999,2
1668548259409,COGS 205,A00,101395,Chiba; Andrea,19,0,20,1
1668548259838,COGS 210B,001,101404,Greene; Deanna Jacquelyn,9998,0,9999,1
1668548259838,COGS 210B,002,101417,Xia; Haijun,9999,0,9999,0
1668548259838,COGS 210B,003,101422,Nitz; Douglas A.,9999,0,9999,0
1668548259838,COGS 210B,004,101423,Hollan; James D.,9998,0,9999,1
1668548259838,COGS 210B,005,101424,Deak; Gedeon O.,9998,0,9999,1
1668548259838,COGS 210B,006,101425,Rossano; Federico,9999,0,9999,0
1668548260261,COGS 211B,A00,101427,Coulson; Seana M,9996,0,9999,3
1668548260685,COGS 220,A00,101428,Hollan; James D.,0,14,25,25
1668548261120,COGS 229,A00,101429,Dow; Steven P,17,0,25,8
1668548261543,COGS 230,A00,101430,Klemmer; Scott R,6,0,17,11
1668548261965,COGS 234,A00,101431,Xia; Haijun,0,1,25,25
1668548262407,COGS 260,A00,101432,Kiyonaga; Anastasia,21,0,25,4
1668548262407,COGS 260,B00,101433,Kirsh; David Joel,15,0,25,10
1668548262829,CSE 202,A00,102371,Impagliazzo; Russell,0,69,0,0
1668548263270,CSE 203B,A01,102373,Cheng; Chung Kuan,0,63,0,0
1668548263695,CSE 208,A00,102374,Micciancio; Daniele,0,5,0,0
1668548264126,CSE 209A,A00,112895,Impagliazzo; Russell,0,13,15,15
1668548264549,CSE 209B,A00,108005,Bellare; Mihir,0,7,0,0
1668548264983,CSE 210,A00,113163,Coblenz; Michael J,0,90,0,0
1668548265407,CSE 219,A00,106111,Dow; Steven P,0,8,20,20
1668548265841,CSE 221,A00,102376,Voelker; Geoffrey M.,0,75,0,0
1668548266263,CSE 224,A01,102378,Porter; George M,0,173,0,0
1668548266688,CSE 229A,A00,102379,Savage; Stefan,0,11,0,0
1668548267113,CSE 229C,A00,102380,Munyaka; Imani N. S.,0,10,0,0
1668548267539,CSE 232B,A00,102382,Deutsch; Alin Bernard,0,38,0,0
1668548267961,CSE 234,A01,112904,Kumar; Arun Kumar,0,0,0,0
1668548268393,CSE 237A,A00,102383,Rosing; Tajana Simunic,0,56,0,0
1668548268823,CSE 239A,A00,102384,Deutsch; Alin Bernard,0,16,0,0
1668548269246,CSE 239B,A00,102385,Polikarpova; Nadezhda,0,11,0,0
1668548269676,CSE 240A,A00,102386,Pannuto; Patrick William,0,47,0,0
1668548270109,CSE 240B,A00,102387,Zhao; Jishen,0,50,0,0
1668548270538,CSE 241A,A00,106406,Kang; Mingu,0,9,0,0
1668548271060,CSE 249B,A00,102388,Kahng; Andrew Byun,0,5,8,8
1668548271486,CSE 251B,A01,102392,Cottrell; Garrison W,0,52,0,0
1668548271486,CSE 251B,A02,102393,Cottrell; Garrison W,0,35,0,0
1668548271918,CSE 252B,A00,102394,Ochoa; Benjamin Lawrence,0,61,0,0
1668548272340,CSE 257,A01,102396,Gao; Sicun,0,149,0,0
1668548272763,CSE 272,A00,102397,Li; Tzumao,0,19,0,0
1668548273187,CSE 274,A00,111323,Chern; Albert Ren-Haur,0,15,0,0
1668548273616,CSE 282,A00,102398,Pevzner; Pavel Arkadjevich,0,0,0,0
1668548274038,CSE 284,A00,114175,Gymrek; Melissa Ann,0,28,0,0
1668548274479,CSE 290,A00,102399,Chandraker; Manmohan Krishna,0,11,0,0
1668548274479,CSE 290,B00,102400,Vaccaro; Kristen Marie,0,8,25,25
1668548274479,CSE 290,C00,102414,Pannuto; Patrick William,0,1,25,25
1668548274479,CSE 290,D00,102427,Pevzner; Pavel Arkadjevich,0,0,0,0
1668548274479,CSE 290,E00,102429,Zhao; Jishen,0,6,0,0
1668548274479,CSE 290,F00,102436,Tullsen; Dean Michael,0,6,0,0
1668548274479,CSE 290,G00,102440,Christensen; Henrik I,0,6,20,20
1668548274923,CSE 291,A00,102443,Su; Hao,0,0,0,0
1668548274923,CSE 291,B00,102448,Polikarpova; Nadezhda,0,0,0,0
1668548274923,CSE 291,C00,102453,Vaccaro; Kristen Marie,0,0,0,0
1668548274923,CSE 291,D00,111343,Savage; Stefan,0,0,0,0
1668548274923,CSE 291,E00,116474,Claffy; Kimberly Claire,0,0,0,0
1668548274923,CSE 291,F00,116479,Pasquale; Joseph,0,0,0,0
1668548275351,CSE 293,001,119111,Bafna; Vineet,9999,0,9999,0
1668548275351,CSE 293,002,119118,Bellare; Mihir,9999,0,9999,0
1668548275351,CSE 293,003,119122,Berg-Kirkpatrick; Taylor D,9999,0,9999,0
1668548275351,CSE 293,004,119135,Christensen; Henrik I,9999,0,9999,0
1668548275351,CSE 293,005,119142,Cottrell; Garrison W,9999,0,9999,0
1668548275351,CSE 293,006,119146,Deutsch; Alin Bernard,9999,0,9999,0
1668548275351,CSE 293,007,119159,Esmaeilzadeh; Hadi,9999,0,9999,0
1668548275351,CSE 293,008,119166,Freund; Yoav,9999,0,9999,0
1668548275351,CSE 293,009,119170,Griswold; William G.,9999,0,9999,0
1668548275351,CSE 293,010,119183,Gymrek; Melissa Ann,9999,0,9999,0
1668548275351,CSE 293,011,119190,Heninger; Nadia A,9999,0,9999,0
1668548275351,CSE 293,012,119230,Impagliazzo; Russell,9999,0,9999,0
1668548275351,CSE 293,013,119232,Jhala; Ranjit,9999,0,9999,0
1668548275351,CSE 293,014,119233,Kahng; Andrew Byun,9999,0,9999,0
1668548275351,CSE 293,015,119298,Kane; Daniel Mertz,9999,0,9999,0
1668548275351,CSE 293,016,119299,Kriegman; David J,9999,0,9999,0
1668548275351,CSE 293,017,119300,Kumar; Arun Kumar,9999,0,9999,0
1668548275351,CSE 293,018,119301,Lerner; Sorin,9999,0,9999,0
1668548275351,CSE 293,019,119302,Lovett; Shachar,9999,0,9999,0
1668548275351,CSE 293,020,119303,McAuley; Julian John,9999,0,9999,0
1668548275351,CSE 293,021,119304,Micciancio; Daniele,9999,0,9999,0
1668548275351,CSE 293,022,119367,Orailoglu; Alex,9999,0,9999,0
1668548275351,CSE 293,023,119382,Paturi; Ramamohan,9999,0,9999,0
1668548275351,CSE 293,024,119404,Polikarpova; Nadezhda,9999,0,9999,0
1668548275351,CSE 293,025,119406,Politz; Joseph Gibbs,9999,0,9999,0
1668548275351,CSE 293,026,119411,Porter; George M,9999,0,9999,0
1668548275351,CSE 293,027,119414,Porter; Leonard Emerson,9999,0,9999,0
1668548275351,CSE 293,028,119416,Ramamoorthi; Ravi,9999,0,9999,0
1668548275351,CSE 293,029,119417,Sahoo; Debashis,9999,0,9999,0
1668548275351,CSE 293,030,119420,Saul; Lawrence,9999,0,9999,0
1668548275351,CSE 293,031,119421,Savage; Stefan,9999,0,9999,0
1668548275351,CSE 293,032,119425,Schulze; Jurgen P.,9999,0,9999,0
1668548275351,CSE 293,033,119426,Snoeren; Alex C.,9999,0,9999,0
1668548275351,CSE 293,034,119428,Shang; Jingbo,9999,0,9999,0
1668548275351,CSE 293,035,119430,Stefan; Deian,9999,0,9999,0
1668548275351,CSE 293,036,119431,Su; Hao,9999,0,9999,0
1668548275351,CSE 293,037,119433,Swanson; Steven James,9999,0,9999,0
1668548275351,CSE 293,038,119435,Tullsen; Dean Michael,9999,0,9999,0
1668548275351,CSE 293,039,119483,Voelker; Geoffrey M.,9999,0,9999,0
1668548275351,CSE 293,040,119537,Zhao; Jishen,9999,0,9999,0
1668548275351,CSE 293,041,119538,Zhou; Yuan-Yuan,9999,0,9999,0
1668548275351,CSE 293,042,119539,Gao; Sicun,9999,0,9999,0
1668548275351,CSE 293,043,119540,Weibel; Nadir,9999,0,9999,0
1668548275351,CSE 293,044,119541,Gupta; Rajesh K.,9999,0,9999,0
1668548275351,CSE 293,045,126410,Vaccaro; Kristen Marie,9999,0,9999,0
1668548275351,CSE 293,046,126411,Klemke; Richard,9999,0,9999,0
1668548275778,CSE 294,A00,102459,Voelker; Geoffrey M.,0,2,0,0
1668548275778,CSE 294,B00,111322,Orailoglu; Alex,0,2,0,0
1668548276201,DSE 201,A00,096914,Deutsch; Alin Bernard,30,0,30,0
1668548276626,DSE 210,A00,096915,Dasgupta; Sanjoy,30,0,30,0
1668548277053,DSE 260A,A00,096916,Altintas De Callaf; Ilkay,30,0,30,0
1668548277487,ECE 200,001,103586,Antipa; Nicholas A,9999,0,9999,0
1668548277487,ECE 200,002,103587,Atanasov; Nikolay A.,9999,0,9999,0
1668548277487,ECE 200,003,103588,Bharadia; Dinesh,9999,0,9999,0
1668548277487,ECE 200,004,103589,Cheng; Chung Kuan,9999,0,9999,0
1668548277487,ECE 200,005,103590,Cosman; Pamela C.,9999,0,9999,0
1668548277487,ECE 200,006,103591,Dayeh; Shadi Ahmad,9999,0,9999,0
1668548277487,ECE 200,007,103592,Fainman; Yeshaiahu,9999,0,9999,0
1668548277487,ECE 200,008,103593,Ford; Joseph Earl,9999,0,9999,0
1668548277487,ECE 200,009,103594,Franceschetti; Massimo,9999,0,9999,0
1668548277487,ECE 200,010,103595,Fullerton; Eric E,9999,0,9999,0
1668548277487,ECE 200,011,103596,Galton; Ian A,9999,0,9999,0
1668548277487,ECE 200,012,103597,Gilja; Vikash,9999,0,9999,0
1668548277487,ECE 200,013,103598,Hall; Drew A.,9999,0,9999,0
1668548277487,ECE 200,014,103599,Hsueh; Tzu-Chien,9999,0,9999,0
1668548277487,ECE 200,015,103600,Javidi; Tara,9999,0,9999,0
1668548277487,ECE 200,016,103601,Kahng; Andrew Byun,9999,0,9999,0
1668548277487,ECE 200,017,103602,Kim; Young-Han,9999,0,9999,0
1668548277487,ECE 200,018,103603,Koushanfar; Farinaz,9999,0,9999,0
1668548277487,ECE 200,019,103604,Kuzum; Duygu,9999,0,9999,0
1668548277487,ECE 200,020,103605,Le; Hanh-Phuc,9999,0,9999,0
1668548277487,ECE 200,021,103606,Lin; Bill,9999,0,9999,0
1668548277487,ECE 200,022,103607,Liu; Zhaowei,9998,0,9999,1
1668548277487,ECE 200,023,103608,Lo; Yu-Hwa,9999,0,9999,0
1668548277487,ECE 200,024,103609,Lomakin; Vitaliy,9999,0,9999,0
1668548277487,ECE 200,025,103610,Mercier; Patrick Philip,9999,0,9999,0
1668548277487,ECE 200,026,103611,Meyer; Florian,9999,0,9999,0
1668548277487,ECE 200,027,103612,Milstein; Laurence B.,9999,0,9999,0
1668548277487,ECE 200,028,103613,Mir Arabbaygi; Siavash,9999,0,9999,0
1668548277487,ECE 200,029,103614,Mookherjea; Shayan,9999,0,9999,0
1668548277487,ECE 200,030,103615,Morris; Karcher William,9999,0,9999,0
1668548277487,ECE 200,031,103616,Ng; Tse Nga,9999,0,9999,0
1668548277487,ECE 200,032,103617,Nguyen; Truong Quang,9999,0,9999,0
1668548277487,ECE 200,033,103618,Nomura; Kenji,9999,0,9999,0
1668548277487,ECE 200,034,103619,Orlitsky; Alon,9999,0,9999,0
1668548277487,ECE 200,035,103620,Pal; Piya,9999,0,9999,0
1668548277487,ECE 200,036,103621,Papen; George C.,9999,0,9999,0
1668548277487,ECE 200,037,103622,Radic; Stojan,9999,0,9999,0
1668548277487,ECE 200,038,103623,Rao; Bhaskar D.,9999,0,9999,0
1668548277487,ECE 200,039,103624,Rao; Ramesh R,9999,0,9999,0
1668548277487,ECE 200,040,103625,Rebeiz; Gabriel,9999,0,9999,0
1668548277487,ECE 200,041,103626,Sanford; John R,9999,0,9999,0
1668548277487,ECE 200,042,103627,Siegel; Paul H.,9999,0,9999,0
1668548277487,ECE 200,043,103628,Sievenpiper; Daniel F.,9999,0,9999,0
1668548277487,ECE 200,044,103629,Sworder; David D.,9999,0,9999,0
1668548277487,ECE 200,045,103630,Taur; Yuan,9999,0,9999,0
1668548277487,ECE 200,046,103631,Touri; Behrouz,9999,0,9999,0
1668548277487,ECE 200,047,103632,Trivedi; Mohan M.,9999,0,9999,0
1668548277487,ECE 200,048,103633,Vasconcelos; Nuno,9999,0,9999,0
1668548277487,ECE 200,049,103634,Wang; Xiaolong,9999,0,9999,0
1668548277487,ECE 200,050,103635,Xie; Pengtao,9999,0,9999,0
1668548277487,ECE 200,051,103636,Yip; Michael,9999,0,9999,0
1668548277487,ECE 200,052,103637,Zeger; Kenneth A.,999,0,999,0
1668548277487,ECE 200,053,103638,Zhang; Xinyu,9999,0,9999,0
1668548277487,ECE 200,054,103639,Turakhia; Yatish Girish,9999,0,9999,0
1668548277487,ECE 200,055,103640,Kang; Mingu,9999,0,9999,0
1668548277487,ECE 200,056,103641,Shi; Yuanyuan,9999,0,9999,0
1668548277487,ECE 200,057,103642,Wang; Edward Jay,9999,0,9999,0
1668548277487,ECE 200,058,103643,Zheng; Yang,9999,0,9999,0
1668548277912,ECE 202,A00,103644,Kuzum; Duygu,0,45,0,0
1668548278339,ECE 212BN,A00,103646,Ng; Tse Nga,0,9,0,0
1668548278762,ECE 221,A00,111493,Staff,0,0,0,0
1668548279189,ECE 222B,A00,103647,Lomakin; Vitaliy,0,20,0,0
1668548279627,ECE 230B,A00,103648,Taur; Yuan,0,3,0,0
1668548280051,ECE 238B,A00,103649,Garay; Javier,0,0,0,0
1668548280477,ECE 240B,A00,112900,Fainman; Yeshaiahu,0,7,0,0
1668548280907,ECE 247A,A00,103650,Jokerst; Jesse Vincent,0,6,0,0
1668548281332,ECE 247B,A00,103651,Wang; Joseph,0,14,0,0
1668548281765,ECE 250,A00,103652,Siegel; Paul H.,0,82,0,0
1668548282190,ECE 251A,A00,103654,Rao; Bhaskar D.,0,63,0,0
1668548282615,ECE 257B,A00,103655,Bharadia; Dinesh,0,33,0,0
1668548283041,ECE 258A,A00,103656,Milstein; Laurence B.,0,29,0,0
1668548283466,ECE 260B,A00,103658,Kang; Mingu,0,123,0,0
1668548283889,ECE 264A,A00,103659,Galton; Ian A,0,72,0,0
1668548284324,ECE 265A,A00,103661,Gudem; Prasad S.S.,0,73,0,0
1668548284761,ECE 265D,A00,103662,Gudem; Prasad S.S.,0,26,0,0
1668548285189,ECE 268,A00,103663,Koushanfar; Farinaz,0,43,0,0
1668548285614,ECE 269,A01,103665,Pal; Piya,0,219,0,0
1668548286045,ECE 271B,A00,103666,Vasconcelos; Manuela,0,78,0,0
1668548286467,ECE 276A,A00,103667,Atanasov; Nikolay A.,0,126,0,0
1668548286891,ECE 277,A00,103668,An; Cheolhong,0,151,0,0
1668548287315,ECE 279,A00,117947,Hall; Drew A.,0,22,0,0
1668548288179,ECE 283,A00,103670,Hsueh; Tzu-Chien,0,57,0,0
1668548288603,ECE 284,A00,103671,Turakhia; Yatish Girish,0,40,0,0
1668548289029,ECE 285,A00,103672,Zheng; Yang,0,41,0,0
1668548289029,ECE 285,B00,103673,Sworder; David D.,0,61,0,0
1668548289459,ECE 287,A00,103676,Javidi; Tara,0,9,0,0
1668548289882,MATH 200B,A00,098023,Salehi Golsefidy; Alireza,10,0,15,5
1668548290317,MATH 202B,A00,098024,Rhoades; Brendon Patrick,7,0,15,8
1668548290753,MATH 203B,A00,098025,Oprea; Dragos N.,9,0,15,6
1668548291176,MATH 204B,A00,098026,Sorensen; Claus M,13,0,15,2
1668548291608,MATH 208,A00,098027,Izadi; Elham,7,0,10,3
1668548292034,MATH 209,A00,098028,Pollack; Aaron,10,0,10,0
1668548292479,MATH 211A,A00,112919,Rogalski; Daniel,8,0,10,2
1668548292914,MATH 211B,A00,112920,Seward; Brandon M.,9,0,10,1
1668548293342,MATH 218,A00,098029,Li; Bo,10,0,10,0
1668548293765,MATH 220B,A00,098030,Novak; Jonathan I,11,0,15,4
1668548294193,MATH 221A,A00,098031,Ebenfelt; Peter F,12,0,15,3
1668548294619,MATH 231B,A00,098032,Zlatos; Andrej,10,0,15,5
1668548295045,MATH 240B,A00,098033,Ni; Lei,7,0,15,8
1668548295478,MATH 243,A00,098034,Jekel; David Andrew,10,0,10,0
1668548295905,MATH 245A,A00,098035,Nie; Jiawang,0,5,15,18
1668548296354,MATH 248,A00,098036,Bejenaru; Ioan,10,0,10,0
1668548296777,MATH 250B,A00,098037,Spolaor; Luca,14,0,15,1
1668548297209,MATH 258,A00,098038,Ni; Lei,9,0,10,1
1668548297637,MATH 264B,A00,098041,Rhoades; Brendon Patrick,8,0,15,7
1668548298062,MATH 268,A00,098042,Buss; Samuel R,10,0,10,0
1668548298492,MATH 269,A00,098043,Rhoades; Brendon Patrick,10,0,10,0
1668548298920,MATH 270B,A00,098044,Li; Bo,6,0,15,9
1668548299345,MATH 272B,A00,098045,Holst; Michael J,13,0,15,2
1668548299775,MATH 273A,A00,098046,Tian; Xiaochuan,10,0,15,5
1668548300209,MATH 275,A01,098048,Tian; Xiaochuan,6,0,10,4
1668548300633,MATH 278A,A00,098049,Holst; Michael J,6,0,10,4
1668548301067,MATH 278B,A00,098050,Cloninger; Alexander,10,0,10,0
1668548301493,MATH 278C,A00,098051,Nie; Jiawang,5,0,10,5
1668548301921,MATH 280B,A00,098052,Zheng; Tianyi,7,0,15,8
1668548302347,MATH 281B,A00,098053,Bradic; Jelena,0,2,15,15
1668548302774,MATH 282B,A00,098054,Arias-Castro; Ery,0,1,15,15
1668548303196,MATH 285,A00,098055,Fitzsimmons; Patrick J,0,4,15,17
1668548303625,MATH 287B,A00,098056,Arias-Castro; Ery,1,0,15,14
1668548304061,MATH 288,A00,098057,Agarwal; Pooja,9,0,10,1
1668548304061,MATH 288,B00,098058,Zhang; Danna,8,0,10,2
1668548304061,MATH 288,C00,098059,Williams; Ruth J,9,0,10,1
1668548304486,MATH 290B,A00,098060,Roberts; Justin Deritter,12,0,15,3
1668548304910,MATH 292,A00,098061,Belmont; Eva Kinoshita,10,0,10,0
1668548305334,MATH 295,A00,098062,Suk; Andrew Hoon,47,0,50,3
1668548305758,MATH 296,A00,098063,Novak; Jonathan I,20,0,20,0
1668548306181,MATH 297,001,098064,Gamst; Anthony Collins,9997,0,9999,2
1668548823381,COGS 205,A00,101395,Chiba; Andrea,19,0,20,1
1668548823810,COGS 210B,001,101404,Greene; Deanna Jacquelyn,9998,0,9999,1
1668548823810,COGS 210B,002,101417,Xia; Haijun,9999,0,9999,0
1668548823810,COGS 210B,003,101422,Nitz; Douglas A.,9999,0,9999,0
1668548823810,COGS 210B,004,101423,Hollan; James D.,9998,0,9999,1
1668548823810,COGS 210B,005,101424,Deak; Gedeon O.,9998,0,9999,1
1668548823810,COGS 210B,006,101425,Rossano; Federico,9999,0,9999,0
1668548824235,COGS 211B,A00,101427,Coulson; Seana M,9996,0,9999,3
1668548824663,COGS 220,A00,101428,Hollan; James D.,0,14,25,25
1668548825089,COGS 229,A00,101429,Dow; Steven P,17,0,25,8
1668548825515,COGS 230,A00,101430,Klemmer; Scott R,6,0,17,11
1668548825940,COGS 234,A00,101431,Xia; Haijun,0,1,25,25
1668548826374,COGS 260,A00,101432,Kiyonaga; Anastasia,21,0,25,4
1668548826374,COGS 260,B00,101433,Kirsh; David Joel,15,0,25,10
1668548826805,CSE 202,A00,102371,Impagliazzo; Russell,0,69,0,0
1668548827250,CSE 203B,A01,102373,Cheng; Chung Kuan,0,63,0,0
1668548827679,CSE 208,A00,102374,Micciancio; Daniele,0,5,0,0
1668548828105,CSE 209A,A00,112895,Impagliazzo; Russell,0,13,15,15
1668548828530,CSE 209B,A00,108005,Bellare; Mihir,0,7,0,0
1668548828960,CSE 210,A00,113163,Coblenz; Michael J,0,91,0,0
1668548829390,CSE 219,A00,106111,Dow; Steven P,0,8,20,20
1668548829814,CSE 221,A00,102376,Voelker; Geoffrey M.,0,76,0,0
1668548830239,CSE 224,A01,102378,Porter; George M,0,173,0,0
1668548830668,CSE 229A,A00,102379,Savage; Stefan,0,11,0,0
1668548831092,CSE 229C,A00,102380,Munyaka; Imani N. S.,0,10,0,0
1668548831524,CSE 232B,A00,102382,Deutsch; Alin Bernard,0,38,0,0
1668548831947,CSE 234,A01,112904,Kumar; Arun Kumar,0,0,0,0
1668548832377,CSE 237A,A00,102383,Rosing; Tajana Simunic,0,56,0,0
1668548832824,CSE 239A,A00,102384,Deutsch; Alin Bernard,0,16,0,0
1668548833262,CSE 239B,A00,102385,Polikarpova; Nadezhda,0,11,0,0
1668548833698,CSE 240A,A00,102386,Pannuto; Patrick William,0,47,0,0
1668548834123,CSE 240B,A00,102387,Zhao; Jishen,0,50,0,0
1668548834552,CSE 241A,A00,106406,Kang; Mingu,0,9,0,0
1668548834987,CSE 249B,A00,102388,Kahng; Andrew Byun,0,5,8,8
1668548835427,CSE 251B,A01,102392,Cottrell; Garrison W,0,52,0,0
1668548835427,CSE 251B,A02,102393,Cottrell; Garrison W,0,35,0,0
1668548835863,CSE 252B,A00,102394,Ochoa; Benjamin Lawrence,0,62,0,0
1668548836303,CSE 257,A01,102396,Gao; Sicun,0,150,0,0
1668548836737,CSE 272,A00,102397,Li; Tzumao,0,20,0,0
1668548837169,CSE 274,A00,111323,Chern; Albert Ren-Haur,0,15,0,0
1668548837615,CSE 282,A00,102398,Pevzner; Pavel Arkadjevich,0,0,0,0
1668548838041,CSE 284,A00,114175,Gymrek; Melissa Ann,0,28,0,0
1668548838466,CSE 290,A00,102399,Chandraker; Manmohan Krishna,0,11,0,0
1668548838466,CSE 290,B00,102400,Vaccaro; Kristen Marie,0,8,25,25
1668548838466,CSE 290,C00,102414,Pannuto; Patrick William,0,1,25,25
1668548838466,CSE 290,D00,102427,Pevzner; Pavel Arkadjevich,0,0,0,0
1668548838466,CSE 290,E00,102429,Zhao; Jishen,0,6,0,0
1668548838466,CSE 290,F00,102436,Tullsen; Dean Michael,0,6,0,0
1668548838466,CSE 290,G00,102440,Christensen; Henrik I,0,6,20,20
1668548838903,CSE 291,A00,102443,Su; Hao,0,0,0,0
1668548838903,CSE 291,B00,102448,Polikarpova; Nadezhda,0,0,0,0
1668548838903,CSE 291,C00,102453,Vaccaro; Kristen Marie,0,0,0,0
1668548838903,CSE 291,D00,111343,Savage; Stefan,0,0,0,0
1668548838903,CSE 291,E00,116474,Claffy; Kimberly Claire,0,0,0,0
1668548838903,CSE 291,F00,116479,Pasquale; Joseph,0,0,0,0
1668548839360,CSE 293,001,119111,Bafna; Vineet,9999,0,9999,0
1668548839360,CSE 293,002,119118,Bellare; Mihir,9999,0,9999,0
1668548839360,CSE 293,003,119122,Berg-Kirkpatrick; Taylor D,9999,0,9999,0
1668548839360,CSE 293,004,119135,Christensen; Henrik I,9999,0,9999,0
1668548839360,CSE 293,005,119142,Cottrell; Garrison W,9999,0,9999,0
1668548839360,CSE 293,006,119146,Deutsch; Alin Bernard,9999,0,9999,0
1668548839360,CSE 293,007,119159,Esmaeilzadeh; Hadi,9999,0,9999,0
1668548839360,CSE 293,008,119166,Freund; Yoav,9999,0,9999,0
1668548839360,CSE 293,009,119170,Griswold; William G.,9999,0,9999,0
1668548839360,CSE 293,010,119183,Gymrek; Melissa Ann,9999,0,9999,0
1668548839360,CSE 293,011,119190,Heninger; Nadia A,9999,0,9999,0
1668548839360,CSE 293,012,119230,Impagliazzo; Russell,9999,0,9999,0
1668548839360,CSE 293,013,119232,Jhala; Ranjit,9999,0,9999,0
1668548839360,CSE 293,014,119233,Kahng; Andrew Byun,9999,0,9999,0
1668548839360,CSE 293,015,119298,Kane; Daniel Mertz,9999,0,9999,0
1668548839360,CSE 293,016,119299,Kriegman; David J,9999,0,9999,0
1668548839360,CSE 293,017,119300,Kumar; Arun Kumar,9999,0,9999,0
1668548839360,CSE 293,018,119301,Lerner; Sorin,9999,0,9999,0
1668548839360,CSE 293,019,119302,Lovett; Shachar,9999,0,9999,0
1668548839360,CSE 293,020,119303,McAuley; Julian John,9999,0,9999,0
1668548839360,CSE 293,021,119304,Micciancio; Daniele,9999,0,9999,0
1668548839360,CSE 293,022,119367,Orailoglu; Alex,9999,0,9999,0
1668548839360,CSE 293,023,119382,Paturi; Ramamohan,9999,0,9999,0
1668548839360,CSE 293,024,119404,Polikarpova; Nadezhda,9999,0,9999,0
1668548839360,CSE 293,025,119406,Politz; Joseph Gibbs,9999,0,9999,0
1668548839360,CSE 293,026,119411,Porter; George M,9999,0,9999,0
1668548839360,CSE 293,027,119414,Porter; Leonard Emerson,9999,0,9999,0
1668548839360,CSE 293,028,119416,Ramamoorthi; Ravi,9999,0,9999,0
1668548839360,CSE 293,029,119417,Sahoo; Debashis,9999,0,9999,0
1668548839360,CSE 293,030,119420,Saul; Lawrence,9999,0,9999,0
1668548839360,CSE 293,031,119421,Savage; Stefan,9999,0,9999,0
1668548839360,CSE 293,032,119425,Schulze; Jurgen P.,9999,0,9999,0
1668548839360,CSE 293,033,119426,Snoeren; Alex C.,9999,0,9999,0
1668548839360,CSE 293,034,119428,Shang; Jingbo,9999,0,9999,0
1668548839360,CSE 293,035,119430,Stefan; Deian,9999,0,9999,0
1668548839360,CSE 293,036,119431,Su; Hao,9999,0,9999,0
1668548839360,CSE 293,037,119433,Swanson; Steven James,9999,0,9999,0
1668548839360,CSE 293,038,119435,Tullsen; Dean Michael,9999,0,9999,0
1668548839360,CSE 293,039,119483,Voelker; Geoffrey M.,9999,0,9999,0
1668548839360,CSE 293,040,119537,Zhao; Jishen,9999,0,9999,0
1668548839360,CSE 293,041,119538,Zhou; Yuan-Yuan,9999,0,9999,0
1668548839360,CSE 293,042,119539,Gao; Sicun,9999,0,9999,0
1668548839360,CSE 293,043,119540,Weibel; Nadir,9999,0,9999,0
1668548839360,CSE 293,044,119541,Gupta; Rajesh K.,9999,0,9999,0
1668548839360,CSE 293,045,126410,Vaccaro; Kristen Marie,9999,0,9999,0
1668548839360,CSE 293,046,126411,Klemke; Richard,9999,0,9999,0
1668548839789,CSE 294,A00,102459,Voelker; Geoffrey M.,0,2,0,0
1668548839789,CSE 294,B00,111322,Orailoglu; Alex,0,2,0,0
1668548840224,DSE 201,A00,096914,Deutsch; Alin Bernard,30,0,30,0
1668548840650,DSE 210,A00,096915,Dasgupta; Sanjoy,30,0,30,0
1668548841074,DSE 260A,A00,096916,Altintas De Callaf; Ilkay,30,0,30,0
1668548841537,ECE 200,001,103586,Antipa; Nicholas A,9999,0,9999,0
1668548841537,ECE 200,002,103587,Atanasov; Nikolay A.,9999,0,9999,0
1668548841537,ECE 200,003,103588,Bharadia; Dinesh,9999,0,9999,0
1668548841537,ECE 200,004,103589,Cheng; Chung Kuan,9999,0,9999,0
1668548841537,ECE 200,005,103590,Cosman; Pamela C.,9999,0,9999,0
1668548841537,ECE 200,006,103591,Dayeh; Shadi Ahmad,9999,0,9999,0
1668548841537,ECE 200,007,103592,Fainman; Yeshaiahu,9999,0,9999,0
1668548841537,ECE 200,008,103593,Ford; Joseph Earl,9999,0,9999,0
1668548841537,ECE 200,009,103594,Franceschetti; Massimo,9999,0,9999,0
1668548841537,ECE 200,010,103595,Fullerton; Eric E,9999,0,9999,0
1668548841537,ECE 200,011,103596,Galton; Ian A,9999,0,9999,0
1668548841537,ECE 200,012,103597,Gilja; Vikash,9999,0,9999,0
1668548841537,ECE 200,013,103598,Hall; Drew A.,9999,0,9999,0
1668548841537,ECE 200,014,103599,Hsueh; Tzu-Chien,9999,0,9999,0
1668548841537,ECE 200,015,103600,Javidi; Tara,9999,0,9999,0
1668548841537,ECE 200,016,103601,Kahng; Andrew Byun,9999,0,9999,0
1668548841537,ECE 200,017,103602,Kim; Young-Han,9999,0,9999,0
1668548841537,ECE 200,018,103603,Koushanfar; Farinaz,9999,0,9999,0
1668548841537,ECE 200,019,103604,Kuzum; Duygu,9999,0,9999,0
1668548841537,ECE 200,020,103605,Le; Hanh-Phuc,9999,0,9999,0
1668548841537,ECE 200,021,103606,Lin; Bill,9999,0,9999,0
1668548841537,ECE 200,022,103607,Liu; Zhaowei,9998,0,9999,1
1668548841537,ECE 200,023,103608,Lo; Yu-Hwa,9999,0,9999,0
1668548841537,ECE 200,024,103609,Lomakin; Vitaliy,9999,0,9999,0
1668548841537,ECE 200,025,103610,Mercier; Patrick Philip,9999,0,9999,0
1668548841537,ECE 200,026,103611,Meyer; Florian,9999,0,9999,0
1668548841537,ECE 200,027,103612,Milstein; Laurence B.,9999,0,9999,0
1668548841537,ECE 200,028,103613,Mir Arabbaygi; Siavash,9999,0,9999,0
1668548841537,ECE 200,029,103614,Mookherjea; Shayan,9999,0,9999,0
1668548841537,ECE 200,030,103615,Morris; Karcher William,9999,0,9999,0
1668548841537,ECE 200,031,103616,Ng; Tse Nga,9999,0,9999,0
1668548841537,ECE 200,032,103617,Nguyen; Truong Quang,9999,0,9999,0
1668548841537,ECE 200,033,103618,Nomura; Kenji,9999,0,9999,0
1668548841537,ECE 200,034,103619,Orlitsky; Alon,9999,0,9999,0
1668548841537,ECE 200,035,103620,Pal; Piya,9999,0,9999,0
1668548841537,ECE 200,036,103621,Papen; George C.,9999,0,9999,0
1668548841537,ECE 200,037,103622,Radic; Stojan,9999,0,9999,0
1668548841537,ECE 200,038,103623,Rao; Bhaskar D.,9999,0,9999,0
1668548841537,ECE 200,039,103624,Rao; Ramesh R,9999,0,9999,0
1668548841537,ECE 200,040,103625,Rebeiz; Gabriel,9999,0,9999,0
1668548841537,ECE 200,041,103626,Sanford; John R,9999,0,9999,0
1668548841537,ECE 200,042,103627,Siegel; Paul H.,9999,0,9999,0
1668548841537,ECE 200,043,103628,Sievenpiper; Daniel F.,9999,0,9999,0
1668548841537,ECE 200,044,103629,Sworder; David D.,9999,0,9999,0
1668548841537,ECE 200,045,103630,Taur; Yuan,9999,0,9999,0
1668548841537,ECE 200,046,103631,Touri; Behrouz,9999,0,9999,0
1668548841537,ECE 200,047,103632,Trivedi; Mohan M.,9999,0,9999,0
1668548841537,ECE 200,048,103633,Vasconcelos; Nuno,9999,0,9999,0
1668548841537,ECE 200,049,103634,Wang; Xiaolong,9999,0,9999,0
1668548841537,ECE 200,050,103635,Xie; Pengtao,9999,0,9999,0
1668548841537,ECE 200,051,103636,Yip; Michael,9999,0,9999,0
1668548841537,ECE 200,052,103637,Zeger; Kenneth A.,999,0,999,0
1668548841537,ECE 200,053,103638,Zhang; Xinyu,9999,0,9999,0
1668548841537,ECE 200,054,103639,Turakhia; Yatish Girish,9999,0,9999,0
1668548841537,ECE 200,055,103640,Kang; Mingu,9999,0,9999,0
1668548841537,ECE 200,056,103641,Shi; Yuanyuan,9999,0,9999,0
1668548841537,ECE 200,057,103642,Wang; Edward Jay,9999,0,9999,0
1668548841537,ECE 200,058,103643,Zheng; Yang,9999,0,9999,0
1668548841986,ECE 202,A00,103644,Kuzum; Duygu,0,45,0,0
1668548842416,ECE 212BN,A00,103646,Ng; Tse Nga,0,9,0,0
1668548842852,ECE 221,A00,111493,Staff,0,0,0,0
1668548843277,ECE 222B,A00,103647,Lomakin; Vitaliy,0,20,0,0
1668548843702,ECE 230B,A00,103648,Taur; Yuan,0,3,0,0
1668548844128,ECE 238B,A00,103649,Garay; Javier,0,0,0,0
1668548844563,ECE 240B,A00,112900,Fainman; Yeshaiahu,0,7,0,0
1668548844986,ECE 247A,A00,103650,Jokerst; Jesse Vincent,0,6,0,0
1668548845408,ECE 247B,A00,103651,Wang; Joseph,0,14,0,0
1668548845840,ECE 250,A00,103652,Siegel; Paul H.,0,82,0,0
1668548846277,ECE 251A,A00,103654,Rao; Bhaskar D.,0,63,0,0
1668548846704,ECE 257B,A00,103655,Bharadia; Dinesh,0,33,0,0
1668548847140,ECE 258A,A00,103656,Milstein; Laurence B.,0,29,0,0
1668548847593,ECE 260B,A00,103658,Kang; Mingu,0,123,0,0
1668548848022,ECE 264A,A00,103659,Galton; Ian A,0,72,0,0
1668548848449,ECE 265A,A00,103661,Gudem; Prasad S.S.,0,74,0,0
1668548848874,ECE 265D,A00,103662,Gudem; Prasad S.S.,0,26,0,0
1668548849299,ECE 268,A00,103663,Koushanfar; Farinaz,0,43,0,0
1668548849729,ECE 269,A01,103665,Pal; Piya,0,219,0,0
1668548850232,ECE 271B,A00,103666,Vasconcelos; Manuela,0,78,0,0
1668548850655,ECE 276A,A00,103667,Atanasov; Nikolay A.,0,126,0,0
1668548851077,ECE 277,A00,103668,An; Cheolhong,0,151,0,0
1668548851524,ECE 279,A00,117947,Hall; Drew A.,0,22,0,0
1668548852370,ECE 283,A00,103670,Hsueh; Tzu-Chien,0,57,0,0
1668548852806,ECE 284,A00,103671,Turakhia; Yatish Girish,0,40,0,0
1668548853246,ECE 285,A00,103672,Zheng; Yang,0,41,0,0
1668548853246,ECE 285,B00,103673,Sworder; David D.,0,61,0,0
1668548853670,ECE 287,A00,103676,Javidi; Tara,0,9,0,0
1668548854105,MATH 200B,A00,098023,Salehi Golsefidy; Alireza,10,0,15,5
1668548854549,MATH 202B,A00,098024,Rhoades; Brendon Patrick,7,0,15,8
1668548854978,MATH 203B,A00,098025,Oprea; Dragos N.,9,0,15,6
1668548855403,MATH 204B,A00,098026,Sorensen; Claus M,13,0,15,2
1668548855840,MATH 208,A00,098027,Izadi; Elham,7,0,10,3
1668548856278,MATH 209,A00,098028,Pollack; Aaron,10,0,10,0
1668548856704,MATH 211A,A00,112919,Rogalski; Daniel,8,0,10,2
1668548857150,MATH 211B,A00,112920,Seward; Brandon M.,9,0,10,1
1668548857617,MATH 218,A00,098029,Li; Bo,10,0,10,0
1668548858044,MATH 220B,A00,098030,Novak; Jonathan I,11,0,15,4
1668548858477,MATH 221A,A00,098031,Ebenfelt; Peter F,12,0,15,3
1668548858911,MATH 231B,A00,098032,Zlatos; Andrej,10,0,15,5
1668548859335,MATH 240B,A00,098033,Ni; Lei,7,0,15,8
1668548859765,MATH 243,A00,098034,Jekel; David Andrew,10,0,10,0
1668548860203,MATH 245A,A00,098035,Nie; Jiawang,0,5,15,18
1668548860647,MATH 248,A00,098036,Bejenaru; Ioan,10,0,10,0
1668548861071,MATH 250B,A00,098037,Spolaor; Luca,14,0,15,1
1668548861494,MATH 258,A00,098038,Ni; Lei,9,0,10,1
1668548861919,MATH 264B,A00,098041,Rhoades; Brendon Patrick,8,0,15,7
1668548862352,MATH 268,A00,098042,Buss; Samuel R,10,0,10,0
1668548862783,MATH 269,A00,098043,Rhoades; Brendon Patrick,10,0,10,0
1668548863216,MATH 270B,A00,098044,Li; Bo,6,0,15,9
1668548863658,MATH 272B,A00,098045,Holst; Michael J,13,0,15,2
1668548864112,MATH 273A,A00,098046,Tian; Xiaochuan,10,0,15,5
1668548864549,MATH 275,A01,098048,Tian; Xiaochuan,6,0,10,4
1668548864988,MATH 278A,A00,098049,Holst; Michael J,6,0,10,4
1668548865415,MATH 278B,A00,098050,Cloninger; Alexander,10,0,10,0
1668548865842,MATH 278C,A00,098051,Nie; Jiawang,5,0,10,5
1668548866280,MATH 280B,A00,098052,Zheng; Tianyi,7,0,15,8
1668548866710,MATH 281B,A00,098053,Bradic; Jelena,0,2,15,15
1668548867136,MATH 282B,A00,098054,Arias-Castro; Ery,0,1,15,15
1668548867602,MATH 285,A00,098055,Fitzsimmons; Patrick J,0,4,15,17
1668548868036,MATH 287B,A00,098056,Arias-Castro; Ery,1,0,15,14
1668548868462,MATH 288,A00,098057,Agarwal; Pooja,9,0,10,1
1668548868462,MATH 288,B00,098058,Zhang; Danna,8,0,10,2
1668548868462,MATH 288,C00,098059,Williams; Ruth J,9,0,10,1
1668548868893,MATH 290B,A00,098060,Roberts; Justin Deritter,12,0,15,3
1668548869321,MATH 292,A00,098061,Belmont; Eva Kinoshita,10,0,10,0
1668548869749,MATH 295,A00,098062,Suk; Andrew Hoon,47,0,50,3
1668548870173,MATH 296,A00,098063,Novak; Jonathan I,20,0,20,0
1668548870609,MATH 297,001,098064,Gamst; Anthony Collins,9997,0,9999,2
1668549376515,COGS 205,A00,101395,Chiba; Andrea,19,0,20,1
1668549376937,COGS 210B,001,101404,Greene; Deanna Jacquelyn,9998,0,9999,1
1668549376937,COGS 210B,002,101417,Xia; Haijun,9999,0,9999,0
1668549376937,COGS 210B,003,101422,Nitz; Douglas A.,9999,0,9999,0
1668549376937,COGS 210B,004,101423,Hollan; James D.,9998,0,9999,1
1668549376937,COGS 210B,005,101424,Deak; Gedeon O.,9998,0,9999,1
1668549376937,COGS 210B,006,101425,Rossano; Federico,9999,0,9999,0
1668549377369,COGS 211B,A00,101427,Coulson; Seana M,9996,0,9999,3
1668549377805,COGS 220,A00,101428,Hollan; James D.,0,14,25,25
1668549378230,COGS 229,A00,101429,Dow; Steven P,17,0,25,8
1668549378670,COGS 230,A00,101430,Klemmer; Scott R,6,0,17,11
1668549379100,COGS 234,A00,101431,Xia; Haijun,0,1,25,25
1668549379526,COGS 260,A00,101432,Kiyonaga; Anastasia,21,0,25,4
1668549379526,COGS 260,B00,101433,Kirsh; David Joel,15,0,25,10
1668549379956,CSE 202,A00,102371,Impagliazzo; Russell,0,69,0,0
1668549380383,CSE 203B,A01,102373,Cheng; Chung Kuan,0,63,0,0
1668549380812,CSE 208,A00,102374,Micciancio; Daniele,0,5,0,0
1668549381245,CSE 209A,A00,112895,Impagliazzo; Russell,0,13,15,15
1668549381671,CSE 209B,A00,108005,Bellare; Mihir,0,7,0,0
1668549382095,CSE 210,A00,113163,Coblenz; Michael J,0,91,0,0
1668549382518,CSE 219,A00,106111,Dow; Steven P,0,8,20,20
1668549382945,CSE 221,A00,102376,Voelker; Geoffrey M.,0,76,0,0
1668549383368,CSE 224,A01,102378,Porter; George M,0,173,0,0
1668549383802,CSE 229A,A00,102379,Savage; Stefan,0,11,0,0
1668549384238,CSE 229C,A00,102380,Munyaka; Imani N. S.,0,10,0,0
1668549384674,CSE 232B,A00,102382,Deutsch; Alin Bernard,0,38,0,0
1668549385098,CSE 234,A01,112904,Kumar; Arun Kumar,0,0,0,0
1668549385530,CSE 237A,A00,102383,Rosing; Tajana Simunic,0,56,0,0
1668549385956,CSE 239A,A00,102384,Deutsch; Alin Bernard,0,16,0,0
1668549386386,CSE 239B,A00,102385,Polikarpova; Nadezhda,0,11,0,0
1668549386812,CSE 240A,A00,102386,Pannuto; Patrick William,0,47,0,0
1668549387234,CSE 240B,A00,102387,Zhao; Jishen,0,50,0,0
1668549387669,CSE 241A,A00,106406,Kang; Mingu,0,9,0,0
1668549388092,CSE 249B,A00,102388,Kahng; Andrew Byun,0,5,8,8
1668549388515,CSE 251B,A01,102392,Cottrell; Garrison W,0,52,0,0
1668549388515,CSE 251B,A02,102393,Cottrell; Garrison W,0,35,0,0
1668549388951,CSE 252B,A00,102394,Ochoa; Benjamin Lawrence,0,62,0,0
1668549389401,CSE 257,A01,102396,Gao; Sicun,0,150,0,0
1668549389823,CSE 272,A00,102397,Li; Tzumao,0,20,0,0
1668549390267,CSE 274,A00,111323,Chern; Albert Ren-Haur,0,15,0,0
1668549390693,CSE 282,A00,102398,Pevzner; Pavel Arkadjevich,0,0,0,0
1668549391117,CSE 284,A00,114175,Gymrek; Melissa Ann,0,28,0,0
1668549391539,CSE 290,A00,102399,Chandraker; Manmohan Krishna,0,11,0,0
1668549391539,CSE 290,B00,102400,Vaccaro; Kristen Marie,0,8,25,25
1668549391539,CSE 290,C00,102414,Pannuto; Patrick William,0,1,25,25
1668549391539,CSE 290,D00,102427,Pevzner; Pavel Arkadjevich,0,0,0,0
1668549391539,CSE 290,E00,102429,Zhao; Jishen,0,6,0,0
1668549391539,CSE 290,F00,102436,Tullsen; Dean Michael,0,6,0,0
1668549391539,CSE 290,G00,102440,Christensen; Henrik I,0,6,20,20
1668549391965,CSE 291,A00,102443,Su; Hao,0,0,0,0
1668549391965,CSE 291,B00,102448,Polikarpova; Nadezhda,0,0,0,0
1668549391965,CSE 291,C00,102453,Vaccaro; Kristen Marie,0,0,0,0
1668549391965,CSE 291,D00,111343,Savage; Stefan,0,0,0,0
1668549391965,CSE 291,E00,116474,Claffy; Kimberly Claire,0,0,0,0
1668549391965,CSE 291,F00,116479,Pasquale; Joseph,0,0,0,0
1668549392429,CSE 293,001,119111,Bafna; Vineet,9999,0,9999,0
1668549392429,CSE 293,002,119118,Bellare; Mihir,9999,0,9999,0
1668549392429,CSE 293,003,119122,Berg-Kirkpatrick; Taylor D,9999,0,9999,0
1668549392429,CSE 293,004,119135,Christensen; Henrik I,9999,0,9999,0
1668549392429,CSE 293,005,119142,Cottrell; Garrison W,9999,0,9999,0
1668549392429,CSE 293,006,119146,Deutsch; Alin Bernard,9999,0,9999,0
1668549392429,CSE 293,007,119159,Esmaeilzadeh; Hadi,9999,0,9999,0
1668549392429,CSE 293,008,119166,Freund; Yoav,9999,0,9999,0
1668549392429,CSE 293,009,119170,Griswold; William G.,9999,0,9999,0
1668549392429,CSE 293,010,119183,Gymrek; Melissa Ann,9999,0,9999,0
1668549392429,CSE 293,011,119190,Heninger; Nadia A,9999,0,9999,0
1668549392429,CSE 293,012,119230,Impagliazzo; Russell,9999,0,9999,0
1668549392429,CSE 293,013,119232,Jhala; Ranjit,9999,0,9999,0
1668549392429,CSE 293,014,119233,Kahng; Andrew Byun,9999,0,9999,0
1668549392429,CSE 293,015,119298,Kane; Daniel Mertz,9999,0,9999,0
1668549392429,CSE 293,016,119299,Kriegman; David J,9999,0,9999,0
1668549392429,CSE 293,017,119300,Kumar; Arun Kumar,9999,0,9999,0
1668549392429,CSE 293,018,119301,Lerner; Sorin,9999,0,9999,0
1668549392429,CSE 293,019,119302,Lovett; Shachar,9999,0,9999,0
1668549392429,CSE 293,020,119303,McAuley; Julian John,9999,0,9999,0
1668549392429,CSE 293,021,119304,Micciancio; Daniele,9999,0,9999,0
1668549392429,CSE 293,022,119367,Orailoglu; Alex,9999,0,9999,0
1668549392429,CSE 293,023,119382,Paturi; Ramamohan,9999,0,9999,0
1668549392429,CSE 293,024,119404,Polikarpova; Nadezhda,9999,0,9999,0
1668549392429,CSE 293,025,119406,Politz; Joseph Gibbs,9999,0,9999,0
1668549392429,CSE 293,026,119411,Porter; George M,9999,0,9999,0
1668549392429,CSE 293,027,119414,Porter; Leonard Emerson,9999,0,9999,0
1668549392429,CSE 293,028,119416,Ramamoorthi; Ravi,9999,0,9999,0
1668549392429,CSE 293,029,119417,Sahoo; Debashis,9999,0,9999,0
1668549392429,CSE 293,030,119420,Saul; Lawrence,9999,0,9999,0
1668549392429,CSE 293,031,119421,Savage; Stefan,9999,0,9999,0
1668549392429,CSE 293,032,119425,Schulze; Jurgen P.,9999,0,9999,0
1668549392429,CSE 293,033,119426,Snoeren; Alex C.,9999,0,9999,0
1668549392429,CSE 293,034,119428,Shang; Jingbo,9999,0,9999,0
1668549392429,CSE 293,035,119430,Stefan; Deian,9999,0,9999,0
1668549392429,CSE 293,036,119431,Su; Hao,9999,0,9999,0
1668549392429,CSE 293,037,119433,Swanson; Steven James,9999,0,9999,0
1668549392429,CSE 293,038,119435,Tullsen; Dean Michael,9999,0,9999,0
1668549392429,CSE 293,039,119483,Voelker; Geoffrey M.,9999,0,9999,0
1668549392429,CSE 293,040,119537,Zhao; Jishen,9999,0,9999,0
1668549392429,CSE 293,041,119538,Zhou; Yuan-Yuan,9999,0,9999,0
1668549392429,CSE 293,042,119539,Gao; Sicun,9999,0,9999,0
1668549392429,CSE 293,043,119540,Weibel; Nadir,9999,0,9999,0
1668549392429,CSE 293,044,119541,Gupta; Rajesh K.,9999,0,9999,0
1668549392429,CSE 293,045,126410,Vaccaro; Kristen Marie,9999,0,9999,0
1668549392429,CSE 293,046,126411,Klemke; Richard,9999,0,9999,0
1668549392860,CSE 294,A00,102459,Voelker; Geoffrey M.,0,2,0,0
1668549392860,CSE 294,B00,111322,Orailoglu; Alex,0,2,0,0
1668549393298,DSE 201,A00,096914,Deutsch; Alin Bernard,30,0,30,0
1668549393727,DSE 210,A00,096915,Dasgupta; Sanjoy,30,0,30,0
1668549394150,DSE 260A,A00,096916,Altintas De Callaf; Ilkay,30,0,30,0
1668549394606,ECE 200,001,103586,Antipa; Nicholas A,9999,0,9999,0
1668549394606,ECE 200,002,103587,Atanasov; Nikolay A.,9999,0,9999,0
1668549394606,ECE 200,003,103588,Bharadia; Dinesh,9999,0,9999,0
1668549394606,ECE 200,004,103589,Cheng; Chung Kuan,9999,0,9999,0
1668549394606,ECE 200,005,103590,Cosman; Pamela C.,9999,0,9999,0
1668549394606,ECE 200,006,103591,Dayeh; Shadi Ahmad,9999,0,9999,0
1668549394606,ECE 200,007,103592,Fainman; Yeshaiahu,9999,0,9999,0
1668549394606,ECE 200,008,103593,Ford; Joseph Earl,9999,0,9999,0
1668549394606,ECE 200,009,103594,Franceschetti; Massimo,9999,0,9999,0
1668549394606,ECE 200,010,103595,Fullerton; Eric E,9999,0,9999,0
1668549394606,ECE 200,011,103596,Galton; Ian A,9999,0,9999,0
1668549394606,ECE 200,012,103597,Gilja; Vikash,9999,0,9999,0
1668549394606,ECE 200,013,103598,Hall; Drew A.,9999,0,9999,0
1668549394606,ECE 200,014,103599,Hsueh; Tzu-Chien,9999,0,9999,0
1668549394606,ECE 200,015,103600,Javidi; Tara,9999,0,9999,0
1668549394606,ECE 200,016,103601,Kahng; Andrew Byun,9999,0,9999,0
1668549394606,ECE 200,017,103602,Kim; Young-Han,9999,0,9999,0
1668549394606,ECE 200,018,103603,Koushanfar; Farinaz,9999,0,9999,0
1668549394606,ECE 200,019,103604,Kuzum; Duygu,9999,0,9999,0
1668549394606,ECE 200,020,103605,Le; Hanh-Phuc,9999,0,9999,0
1668549394606,ECE 200,021,103606,Lin; Bill,9999,0,9999,0
1668549394606,ECE 200,022,103607,Liu; Zhaowei,9998,0,9999,1
1668549394606,ECE 200,023,103608,Lo; Yu-Hwa,9999,0,9999,0
1668549394606,ECE 200,024,103609,Lomakin; Vitaliy,9999,0,9999,0
1668549394606,ECE 200,025,103610,Mercier; Patrick Philip,9999,0,9999,0
1668549394606,ECE 200,026,103611,Meyer; Florian,9999,0,9999,0
1668549394606,ECE 200,027,103612,Milstein; Laurence B.,9999,0,9999,0
1668549394606,ECE 200,028,103613,Mir Arabbaygi; Siavash,9999,0,9999,0
1668549394606,ECE 200,029,103614,Mookherjea; Shayan,9999,0,9999,0
1668549394606,ECE 200,030,103615,Morris; Karcher William,9999,0,9999,0
1668549394606,ECE 200,031,103616,Ng; Tse Nga,9999,0,9999,0
1668549394606,ECE 200,032,103617,Nguyen; Truong Quang,9999,0,9999,0
1668549394606,ECE 200,033,103618,Nomura; Kenji,9999,0,9999,0
1668549394606,ECE 200,034,103619,Orlitsky; Alon,9999,0,9999,0
1668549394606,ECE 200,035,103620,Pal; Piya,9999,0,9999,0
1668549394606,ECE 200,036,103621,Papen; George C.,9999,0,9999,0
1668549394606,ECE 200,037,103622,Radic; Stojan,9999,0,9999,0
1668549394606,ECE 200,038,103623,Rao; Bhaskar D.,9999,0,9999,0
1668549394606,ECE 200,039,103624,Rao; Ramesh R,9999,0,9999,0
1668549394606,ECE 200,040,103625,Rebeiz; Gabriel,9999,0,9999,0
1668549394606,ECE 200,041,103626,Sanford; John R,9999,0,9999,0
1668549394606,ECE 200,042,103627,Siegel; Paul H.,9999,0,9999,0
1668549394606,ECE 200,043,103628,Sievenpiper; Daniel F.,9999,0,9999,0
1668549394606,ECE 200,044,103629,Sworder; David D.,9999,0,9999,0
1668549394606,ECE 200,045,103630,Taur; Yuan,9999,0,9999,0
1668549394606,ECE 200,046,103631,Touri; Behrouz,9999,0,9999,0
1668549394606,ECE 200,047,103632,Trivedi; Mohan M.,9999,0,9999,0
1668549394606,ECE 200,048,103633,Vasconcelos; Nuno,9999,0,9999,0
1668549394606,ECE 200,049,103634,Wang; Xiaolong,9999,0,9999,0
1668549394606,ECE 200,050,103635,Xie; Pengtao,9999,0,9999,0
1668549394606,ECE 200,051,103636,Yip; Michael,9999,0,9999,0
1668549394606,ECE 200,052,103637,Zeger; Kenneth A.,999,0,999,0
1668549394606,ECE 200,053,103638,Zhang; Xinyu,9999,0,9999,0
1668549394606,ECE 200,054,103639,Turakhia; Yatish Girish,9999,0,9999,0
1668549394606,ECE 200,055,103640,Kang; Mingu,9999,0,9999,0
1668549394606,ECE 200,056,103641,Shi; Yuanyuan,9999,0,9999,0
1668549394606,ECE 200,057,103642,Wang; Edward Jay,9999,0,9999,0
1668549394606,ECE 200,058,103643,Zheng; Yang,9999,0,9999,0
1668549395034,ECE 202,A00,103644,Kuzum; Duygu,0,45,0,0
1668549395457,ECE 212BN,A00,103646,Ng; Tse Nga,0,9,0,0
1668549395892,ECE 221,A00,111493,Staff,0,0,0,0
1668549396317,ECE 222B,A00,103647,Lomakin; Vitaliy,0,20,0,0
1668549396749,ECE 230B,A00,103648,Taur; Yuan,0,3,0,0
1668549397190,ECE 238B,A00,103649,Garay; Javier,0,0,0,0
1668549397629,ECE 240B,A00,112900,Fainman; Yeshaiahu,0,7,0,0
1668549398051,ECE 247A,A00,103650,Jokerst; Jesse Vincent,0,6,0,0
1668549398482,ECE 247B,A00,103651,Wang; Joseph,0,14,0,0
1668549398908,ECE 250,A00,103652,Siegel; Paul H.,0,82,0,0
1668549399339,ECE 251A,A00,103654,Rao; Bhaskar D.,0,63,0,0
1668549399768,ECE 257B,A00,103655,Bharadia; Dinesh,0,33,0,0
1668549400191,ECE 258A,A00,103656,Milstein; Laurence B.,0,29,0,0
1668549400639,ECE 260B,A00,103658,Kang; Mingu,0,123,0,0
1668549401071,ECE 264A,A00,103659,Galton; Ian A,0,72,0,0
1668549401499,ECE 265A,A00,103661,Gudem; Prasad S.S.,0,74,0,0
1668549401936,ECE 265D,A00,103662,Gudem; Prasad S.S.,0,26,0,0
1668549402369,ECE 268,A00,103663,Koushanfar; Farinaz,0,43,0,0
1668549402793,ECE 269,A01,103665,Pal; Piya,0,219,0,0
1668549403229,ECE 271B,A00,103666,Vasconcelos; Manuela,0,78,0,0
1668549403668,ECE 276A,A00,103667,Atanasov; Nikolay A.,0,126,0,0
1668549404107,ECE 277,A00,103668,An; Cheolhong,0,151,0,0
1668549404533,ECE 279,A00,117947,Hall; Drew A.,0,22,0,0
1668549405384,ECE 283,A00,103670,Hsueh; Tzu-Chien,0,57,0,0
1668549405808,ECE 284,A00,103671,Turakhia; Yatish Girish,0,40,0,0
1668549406235,ECE 285,A00,103672,Zheng; Yang,0,41,0,0
1668549406235,ECE 285,B00,103673,Sworder; David D.,0,61,0,0
1668549406661,ECE 287,A00,103676,Javidi; Tara,0,9,0,0
1668549407084,MATH 200B,A00,098023,Salehi Golsefidy; Alireza,10,0,15,5
1668549407513,MATH 202B,A00,098024,Rhoades; Brendon Patrick,7,0,15,8
1668549407952,MATH 203B,A00,098025,Oprea; Dragos N.,9,0,15,6
1668549408382,MATH 204B,A00,098026,Sorensen; Claus M,13,0,15,2
1668549408807,MATH 208,A00,098027,Izadi; Elham,7,0,10,3
1668549409232,MATH 209,A00,098028,Pollack; Aaron,10,0,10,0
1668549409655,MATH 211A,A00,112919,Rogalski; Daniel,8,0,10,2
1668549410078,MATH 211B,A00,112920,Seward; Brandon M.,9,0,10,1
1668549410512,MATH 218,A00,098029,Li; Bo,10,0,10,0
1668549410949,MATH 220B,A00,098030,Novak; Jonathan I,11,0,15,4
1668549411373,MATH 221A,A00,098031,Ebenfelt; Peter F,12,0,15,3
1668549411809,MATH 231B,A00,098032,Zlatos; Andrej,10,0,15,5
1668549412234,MATH 240B,A00,098033,Ni; Lei,7,0,15,8
1668549412657,MATH 243,A00,098034,Jekel; David Andrew,10,0,10,0
1668549413081,MATH 245A,A00,098035,Nie; Jiawang,0,5,15,18
1668549413503,MATH 248,A00,098036,Bejenaru; Ioan,10,0,10,0
1668549413929,MATH 250B,A00,098037,Spolaor; Luca,14,0,15,1
1668549414370,MATH 258,A00,098038,Ni; Lei,9,0,10,1
1668549414803,MATH 264B,A00,098041,Rhoades; Brendon Patrick,8,0,15,7
1668549415225,MATH 268,A00,098042,Buss; Samuel R,10,0,10,0
1668549415649,MATH 269,A00,098043,Rhoades; Brendon Patrick,10,0,10,0
1668549416077,MATH 270B,A00,098044,Li; Bo,6,0,15,9
1668549416502,MATH 272B,A00,098045,Holst; Michael J,13,0,15,2
1668549416923,MATH 273A,A00,098046,Tian; Xiaochuan,10,0,15,5
1668549417353,MATH 275,A01,098048,Tian; Xiaochuan,6,0,10,4
1668549417783,MATH 278A,A00,098049,Holst; Michael J,6,0,10,4
1668549418304,MATH 278B,A00,098050,Cloninger; Alexander,10,0,10,0
1668549418735,MATH 278C,A00,098051,Nie; Jiawang,5,0,10,5
1668549419173,MATH 280B,A00,098052,Zheng; Tianyi,7,0,15,8
1668549419597,MATH 281B,A00,098053,Bradic; Jelena,0,2,15,15
1668549420020,MATH 282B,A00,098054,Arias-Castro; Ery,0,1,15,15
1668549420469,MATH 285,A00,098055,Fitzsimmons; Patrick J,0,4,15,17
1668549420891,MATH 287B,A00,098056,Arias-Castro; Ery,1,0,15,14
1668549421328,MATH 288,A00,098057,Agarwal; Pooja,9,0,10,1
1668549421328,MATH 288,B00,098058,Zhang; Danna,8,0,10,2
1668549421328,MATH 288,C00,098059,Williams; Ruth J,9,0,10,1
1668549421753,MATH 290B,A00,098060,Roberts; Justin Deritter,12,0,15,3
1668549422182,MATH 292,A00,098061,Belmont; Eva Kinoshita,10,0,10,0
1668549422613,MATH 295,A00,098062,Suk; Andrew Hoon,47,0,50,3
1668549423039,MATH 296,A00,098063,Novak; Jonathan I,20,0,20,0
1668549423494,MATH 297,001,098064,Gamst; Anthony Collins,9997,0,9999,2
1668549929084,COGS 205,A00,101395,Chiba; Andrea,19,0,20,1
1668549929506,COGS 210B,001,101404,Greene; Deanna Jacquelyn,9998,0,9999,1
1668549929506,COGS 210B,002,101417,Xia; Haijun,9999,0,9999,0
1668549929506,COGS 210B,003,101422,Nitz; Douglas A.,9999,0,9999,0
1668549929506,COGS 210B,004,101423,Hollan; James D.,9998,0,9999,1
1668549929506,COGS 210B,005,101424,Deak; Gedeon O.,9998,0,9999,1
1668549929506,COGS 210B,006,101425,Rossano; Federico,9999,0,9999,0
1668549929945,COGS 211B,A00,101427,Coulson; Seana M,9996,0,9999,3
1668549930375,COGS 220,A00,101428,Hollan; James D.,0,15,25,25
1668549930797,COGS 229,A00,101429,Dow; Steven P,17,0,25,8
1668549931220,COGS 230,A00,101430,Klemmer; Scott R,6,0,17,11
1668549931650,COGS 234,A00,101431,Xia; Haijun,0,1,25,25
1668549932081,COGS 260,A00,101432,Kiyonaga; Anastasia,21,0,25,4
1668549932081,COGS 260,B00,101433,Kirsh; David Joel,15,0,25,10
1668549932503,CSE 202,A00,102371,Impagliazzo; Russell,0,69,0,0
1668549932939,CSE 203B,A01,102373,Cheng; Chung Kuan,0,64,0,0
1668549933363,CSE 208,A00,102374,Micciancio; Daniele,0,5,0,0
1668549933785,CSE 209A,A00,112895,Impagliazzo; Russell,0,13,15,15
1668549934209,CSE 209B,A00,108005,Bellare; Mihir,0,7,0,0
1668549934634,CSE 210,A00,113163,Coblenz; Michael J,0,91,0,0
1668549935067,CSE 219,A00,106111,Dow; Steven P,0,8,20,20
1668549935492,CSE 221,A00,102376,Voelker; Geoffrey M.,0,76,0,0
1668549935953,CSE 224,A01,102378,Porter; George M,0,174,0,0
1668549936381,CSE 229A,A00,102379,Savage; Stefan,0,11,0,0
1668549936806,CSE 229C,A00,102380,Munyaka; Imani N. S.,0,10,0,0
1668549937242,CSE 232B,A00,102382,Deutsch; Alin Bernard,0,38,0,0
1668549937665,CSE 234,A01,112904,Kumar; Arun Kumar,0,0,0,0
1668549938091,CSE 237A,A00,102383,Rosing; Tajana Simunic,0,56,0,0
1668549938515,CSE 239A,A00,102384,Deutsch; Alin Bernard,0,16,0,0
1668549938938,CSE 239B,A00,102385,Polikarpova; Nadezhda,0,11,0,0
1668549939372,CSE 240A,A00,102386,Pannuto; Patrick William,0,47,0,0
1668549939794,CSE 240B,A00,102387,Zhao; Jishen,0,50,0,0
1668549940227,CSE 241A,A00,106406,Kang; Mingu,0,9,0,0
1668549940651,CSE 249B,A00,102388,Kahng; Andrew Byun,0,5,8,8
1668549941077,CSE 251B,A01,102392,Cottrell; Garrison W,0,52,0,0
1668549941077,CSE 251B,A02,102393,Cottrell; Garrison W,0,35,0,0
1668549941502,CSE 252B,A00,102394,Ochoa; Benjamin Lawrence,0,62,0,0
1668549941924,CSE 257,A01,102396,Gao; Sicun,0,151,0,0
1668549942424,CSE 272,A00,102397,Li; Tzumao,0,20,0,0
1668549942853,CSE 274,A00,111323,Chern; Albert Ren-Haur,0,15,0,0
1668549943279,CSE 282,A00,102398,Pevzner; Pavel Arkadjevich,0,0,0,0
1668549943701,CSE 284,A00,114175,Gymrek; Melissa Ann,0,28,0,0
1668549944130,CSE 290,A00,102399,Chandraker; Manmohan Krishna,0,11,0,0
1668549944130,CSE 290,B00,102400,Vaccaro; Kristen Marie,0,8,25,25
1668549944130,CSE 290,C00,102414,Pannuto; Patrick William,0,1,25,25
1668549944130,CSE 290,D00,102427,Pevzner; Pavel Arkadjevich,0,0,0,0
1668549944130,CSE 290,E00,102429,Zhao; Jishen,0,6,0,0
1668549944130,CSE 290,F00,102436,Tullsen; Dean Michael,0,6,0,0
1668549944130,CSE 290,G00,102440,Christensen; Henrik I,0,6,20,20
1668549944555,CSE 291,A00,102443,Su; Hao,0,0,0,0
1668549944555,CSE 291,B00,102448,Polikarpova; Nadezhda,0,0,0,0
1668549944555,CSE 291,C00,102453,Vaccaro; Kristen Marie,0,0,0,0
1668549944555,CSE 291,D00,111343,Savage; Stefan,0,0,0,0
1668549944555,CSE 291,E00,116474,Claffy; Kimberly Claire,0,0,0,0
1668549944555,CSE 291,F00,116479,Pasquale; Joseph,0,0,0,0
1668549944983,CSE 293,001,119111,Bafna; Vineet,9999,0,9999,0
1668549944983,CSE 293,002,119118,Bellare; Mihir,9999,0,9999,0
1668549944983,CSE 293,003,119122,Berg-Kirkpatrick; Taylor D,9999,0,9999,0
1668549944983,CSE 293,004,119135,Christensen; Henrik I,9999,0,9999,0
1668549944983,CSE 293,005,119142,Cottrell; Garrison W,9999,0,9999,0
1668549944983,CSE 293,006,119146,Deutsch; Alin Bernard,9999,0,9999,0
1668549944983,CSE 293,007,119159,Esmaeilzadeh; Hadi,9999,0,9999,0
1668549944983,CSE 293,008,119166,Freund; Yoav,9999,0,9999,0
1668549944983,CSE 293,009,119170,Griswold; William G.,9999,0,9999,0
1668549944983,CSE 293,010,119183,Gymrek; Melissa Ann,9999,0,9999,0
1668549944983,CSE 293,011,119190,Heninger; Nadia A,9999,0,9999,0
1668549944983,CSE 293,012,119230,Impagliazzo; Russell,9999,0,9999,0
1668549944983,CSE 293,013,119232,Jhala; Ranjit,9999,0,9999,0
1668549944983,CSE 293,014,119233,Kahng; Andrew Byun,9999,0,9999,0
1668549944983,CSE 293,015,119298,Kane; Daniel Mertz,9999,0,9999,0
1668549944983,CSE 293,016,119299,Kriegman; David J,9999,0,9999,0
1668549944983,CSE 293,017,119300,Kumar; Arun Kumar,9999,0,9999,0
1668549944983,CSE 293,018,119301,Lerner; Sorin,9999,0,9999,0
1668549944983,CSE 293,019,119302,Lovett; Shachar,9999,0,9999,0
1668549944983,CSE 293,020,119303,McAuley; Julian John,9999,0,9999,0
1668549944983,CSE 293,021,119304,Micciancio; Daniele,9999,0,9999,0
1668549944983,CSE 293,022,119367,Orailoglu; Alex,9999,0,9999,0
1668549944983,CSE 293,023,119382,Paturi; Ramamohan,9999,0,9999,0
1668549944983,CSE 293,024,119404,Polikarpova; Nadezhda,9999,0,9999,0
1668549944983,CSE 293,025,119406,Politz; Joseph Gibbs,9999,0,9999,0
1668549944983,CSE 293,026,119411,Porter; George M,9999,0,9999,0
1668549944983,CSE 293,027,119414,Porter; Leonard Emerson,9999,0,9999,0
1668549944983,CSE 293,028,119416,Ramamoorthi; Ravi,9999,0,9999,0
1668549944983,CSE 293,029,119417,Sahoo; Debashis,9999,0,9999,0
1668549944983,CSE 293,030,119420,Saul; Lawrence,9999,0,9999,0
1668549944983,CSE 293,031,119421,Savage; Stefan,9999,0,9999,0
1668549944983,CSE 293,032,119425,Schulze; Jurgen P.,9999,0,9999,0
1668549944983,CSE 293,033,119426,Snoeren; Alex C.,9999,0,9999,0
1668549944983,CSE 293,034,119428,Shang; Jingbo,9999,0,9999,0
1668549944983,CSE 293,035,119430,Stefan; Deian,9999,0,9999,0
1668549944983,CSE 293,036,119431,Su; Hao,9999,0,9999,0
1668549944983,CSE 293,037,119433,Swanson; Steven James,9999,0,9999,0
1668549944983,CSE 293,038,119435,Tullsen; Dean Michael,9999,0,9999,0
1668549944983,CSE 293,039,119483,Voelker; Geoffrey M.,9999,0,9999,0
1668549944983,CSE 293,040,119537,Zhao; Jishen,9999,0,9999,0
1668549944983,CSE 293,041,119538,Zhou; Yuan-Yuan,9999,0,9999,0
1668549944983,CSE 293,042,119539,Gao; Sicun,9999,0,9999,0
1668549944983,CSE 293,043,119540,Weibel; Nadir,9999,0,9999,0
1668549944983,CSE 293,044,119541,Gupta; Rajesh K.,9999,0,9999,0
1668549944983,CSE 293,045,126410,Vaccaro; Kristen Marie,9999,0,9999,0
1668549944983,CSE 293,046,126411,Klemke; Richard,9999,0,9999,0
1668549945410,CSE 294,A00,102459,Voelker; Geoffrey M.,0,2,0,0
1668549945410,CSE 294,B00,111322,Orailoglu; Alex,0,2,0,0
1668549945836,DSE 201,A00,096914,Deutsch; Alin Bernard,30,0,30,0
1668549946262,DSE 210,A00,096915,Dasgupta; Sanjoy,30,0,30,0
1668549946700,DSE 260A,A00,096916,Altintas De Callaf; Ilkay,30,0,30,0
1668549947139,ECE 200,001,103586,Antipa; Nicholas A,9999,0,9999,0
1668549947139,ECE 200,002,103587,Atanasov; Nikolay A.,9999,0,9999,0
1668549947139,ECE 200,003,103588,Bharadia; Dinesh,9999,0,9999,0
1668549947139,ECE 200,004,103589,Cheng; Chung Kuan,9999,0,9999,0
1668549947139,ECE 200,005,103590,Cosman; Pamela C.,9999,0,9999,0
1668549947139,ECE 200,006,103591,Dayeh; Shadi Ahmad,9999,0,9999,0
1668549947139,ECE 200,007,103592,Fainman; Yeshaiahu,9999,0,9999,0
1668549947139,ECE 200,008,103593,Ford; Joseph Earl,9999,0,9999,0
1668549947139,ECE 200,009,103594,Franceschetti; Massimo,9999,0,9999,0
1668549947139,ECE 200,010,103595,Fullerton; Eric E,9999,0,9999,0
1668549947139,ECE 200,011,103596,Galton; Ian A,9999,0,9999,0
1668549947139,ECE 200,012,103597,Gilja; Vikash,9999,0,9999,0
1668549947139,ECE 200,013,103598,Hall; Drew A.,9999,0,9999,0
1668549947139,ECE 200,014,103599,Hsueh; Tzu-Chien,9999,0,9999,0
1668549947139,ECE 200,015,103600,Javidi; Tara,9999,0,9999,0
1668549947139,ECE 200,016,103601,Kahng; Andrew Byun,9999,0,9999,0
1668549947139,ECE 200,017,103602,Kim; Young-Han,9999,0,9999,0
1668549947139,ECE 200,018,103603,Koushanfar; Farinaz,9999,0,9999,0
1668549947139,ECE 200,019,103604,Kuzum; Duygu,9999,0,9999,0
1668549947139,ECE 200,020,103605,Le; Hanh-Phuc,9999,0,9999,0
1668549947139,ECE 200,021,103606,Lin; Bill,9999,0,9999,0
1668549947139,ECE 200,022,103607,Liu; Zhaowei,9998,0,9999,1
1668549947139,ECE 200,023,103608,Lo; Yu-Hwa,9999,0,9999,0
1668549947139,ECE 200,024,103609,Lomakin; Vitaliy,9999,0,9999,0
1668549947139,ECE 200,025,103610,Mercier; Patrick Philip,9999,0,9999,0
1668549947139,ECE 200,026,103611,Meyer; Florian,9999,0,9999,0
1668549947139,ECE 200,027,103612,Milstein; Laurence B.,9999,0,9999,0
1668549947139,ECE 200,028,103613,Mir Arabbaygi; Siavash,9999,0,9999,0
1668549947139,ECE 200,029,103614,Mookherjea; Shayan,9999,0,9999,0
1668549947139,ECE 200,030,103615,Morris; Karcher William,9999,0,9999,0
1668549947139,ECE 200,031,103616,Ng; Tse Nga,9999,0,9999,0
1668549947139,ECE 200,032,103617,Nguyen; Truong Quang,9999,0,9999,0
1668549947139,ECE 200,033,103618,Nomura; Kenji,9999,0,9999,0
1668549947139,ECE 200,034,103619,Orlitsky; Alon,9999,0,9999,0
1668549947139,ECE 200,035,103620,Pal; Piya,9999,0,9999,0
1668549947139,ECE 200,036,103621,Papen; George C.,9999,0,9999,0
1668549947139,ECE 200,037,103622,Radic; Stojan,9999,0,9999,0
1668549947139,ECE 200,038,103623,Rao; Bhaskar D.,9999,0,9999,0
1668549947139,ECE 200,039,103624,Rao; Ramesh R,9999,0,9999,0
1668549947139,ECE 200,040,103625,Rebeiz; Gabriel,9999,0,9999,0
1668549947139,ECE 200,041,103626,Sanford; John R,9999,0,9999,0
1668549947139,ECE 200,042,103627,Siegel; Paul H.,9999,0,9999,0
1668549947139,ECE 200,043,103628,Sievenpiper; Daniel F.,9999,0,9999,0
1668549947139,ECE 200,044,103629,Sworder; David D.,9999,0,9999,0
1668549947139,ECE 200,045,103630,Taur; Yuan,9999,0,9999,0
1668549947139,ECE 200,046,103631,Touri; Behrouz,9999,0,9999,0
1668549947139,ECE 200,047,103632,Trivedi; Mohan M.,9999,0,9999,0
1668549947139,ECE 200,048,103633,Vasconcelos; Nuno,9999,0,9999,0
1668549947139,ECE 200,049,103634,Wang; Xiaolong,9999,0,9999,0
1668549947139,ECE 200,050,103635,Xie; Pengtao,9999,0,9999,0
1668549947139,ECE 200,051,103636,Yip; Michael,9999,0,9999,0
1668549947139,ECE 200,052,103637,Zeger; Kenneth A.,999,0,999,0
1668549947139,ECE 200,053,103638,Zhang; Xinyu,9999,0,9999,0
1668549947139,ECE 200,054,103639,Turakhia; Yatish Girish,9999,0,9999,0
1668549947139,ECE 200,055,103640,Kang; Mingu,9999,0,9999,0
1668549947139,ECE 200,056,103641,Shi; Yuanyuan,9999,0,9999,0
1668549947139,ECE 200,057,103642,Wang; Edward Jay,9999,0,9999,0
1668549947139,ECE 200,058,103643,Zheng; Yang,9999,0,9999,0
1668549947563,ECE 202,A00,103644,Kuzum; Duygu,0,45,0,0
1668549947987,ECE 212BN,A00,103646,Ng; Tse Nga,0,9,0,0
1668549948418,ECE 221,A00,111493,Staff,0,0,0,0
1668549948841,ECE 222B,A00,103647,Lomakin; Vitaliy,0,20,0,0
1668549949274,ECE 230B,A00,103648,Taur; Yuan,0,3,0,0
1668549949703,ECE 238B,A00,103649,Garay; Javier,0,0,0,0
1668549950125,ECE 240B,A00,112900,Fainman; Yeshaiahu,0,7,0,0
1668549950561,ECE 247A,A00,103650,Jokerst; Jesse Vincent,0,6,0,0
1668549950991,ECE 247B,A00,103651,Wang; Joseph,0,14,0,0
1668549951427,ECE 250,A00,103652,Siegel; Paul H.,0,82,0,0
1668549951854,ECE 251A,A00,103654,Rao; Bhaskar D.,0,63,0,0
1668549952309,ECE 257B,A00,103655,Bharadia; Dinesh,0,33,0,0
1668549952736,ECE 258A,A00,103656,Milstein; Laurence B.,0,29,0,0
1668549953163,ECE 260B,A00,103658,Kang; Mingu,0,123,0,0
1668549953601,ECE 264A,A00,103659,Galton; Ian A,0,72,0,0
1668549954029,ECE 265A,A00,103661,Gudem; Prasad S.S.,0,74,0,0
1668549954463,ECE 265D,A00,103662,Gudem; Prasad S.S.,0,26,0,0
1668549954887,ECE 268,A00,103663,Koushanfar; Farinaz,0,43,0,0
1668549955311,ECE 269,A01,103665,Pal; Piya,0,219,0,0
1668549955734,ECE 271B,A00,103666,Vasconcelos; Manuela,0,78,0,0
1668549956157,ECE 276A,A00,103667,Atanasov; Nikolay A.,0,126,0,0
1668549956584,ECE 277,A00,103668,An; Cheolhong,0,151,0,0
1668549957010,ECE 279,A00,117947,Hall; Drew A.,0,22,0,0
1668549957865,ECE 283,A00,103670,Hsueh; Tzu-Chien,0,57,0,0
1668549958287,ECE 284,A00,103671,Turakhia; Yatish Girish,0,40,0,0
1668549958710,ECE 285,A00,103672,Zheng; Yang,0,41,0,0
1668549958710,ECE 285,B00,103673,Sworder; David D.,0,61,0,0
1668549959137,ECE 287,A00,103676,Javidi; Tara,0,9,0,0
1668549959562,MATH 200B,A00,098023,Salehi Golsefidy; Alireza,10,0,15,5
1668549959987,MATH 202B,A00,098024,Rhoades; Brendon Patrick,7,0,15,8
1668549960412,MATH 203B,A00,098025,Oprea; Dragos N.,9,0,15,6
1668549960844,MATH 204B,A00,098026,Sorensen; Claus M,13,0,15,2
1668549961275,MATH 208,A00,098027,Izadi; Elham,7,0,10,3
1668549961698,MATH 209,A00,098028,Pollack; Aaron,10,0,10,0
1668549962123,MATH 211A,A00,112919,Rogalski; Daniel,8,0,10,2
1668549962550,MATH 211B,A00,112920,Seward; Brandon M.,9,0,10,1
1668549962973,MATH 218,A00,098029,Li; Bo,10,0,10,0
1668549963411,MATH 220B,A00,098030,Novak; Jonathan I,11,0,15,4
1668549963834,MATH 221A,A00,098031,Ebenfelt; Peter F,12,0,15,3
1668549964262,MATH 231B,A00,098032,Zlatos; Andrej,10,0,15,5
1668549964685,MATH 240B,A00,098033,Ni; Lei,7,0,15,8
1668549965109,MATH 243,A00,098034,Jekel; David Andrew,10,0,10,0
1668549965532,MATH 245A,A00,098035,Nie; Jiawang,0,5,15,18
1668549965956,MATH 248,A00,098036,Bejenaru; Ioan,10,0,10,0
1668549966389,MATH 250B,A00,098037,Spolaor; Luca,14,0,15,1
1668549966821,MATH 258,A00,098038,Ni; Lei,9,0,10,1
1668549967246,MATH 264B,A00,098041,Rhoades; Brendon Patrick,8,0,15,7
1668549967671,MATH 268,A00,098042,Buss; Samuel R,10,0,10,0
1668549968095,MATH 269,A00,098043,Rhoades; Brendon Patrick,10,0,10,0
1668549968523,MATH 270B,A00,098044,Li; Bo,6,0,15,9
1668549968957,MATH 272B,A00,098045,Holst; Michael J,13,0,15,2
1668549969382,MATH 273A,A00,098046,Tian; Xiaochuan,10,0,15,5
1668549969805,MATH 275,A01,098048,Tian; Xiaochuan,6,0,10,4
1668549970242,MATH 278A,A00,098049,Holst; Michael J,6,0,10,4
1668549970664,MATH 278B,A00,098050,Cloninger; Alexander,10,0,10,0
1668549971091,MATH 278C,A00,098051,Nie; Jiawang,5,0,10,5
1668549971515,MATH 280B,A00,098052,Zheng; Tianyi,7,0,15,8
1668549971947,MATH 281B,A00,098053,Bradic; Jelena,0,2,15,15
1668549972373,MATH 282B,A00,098054,Arias-Castro; Ery,0,1,15,15
1668549972797,MATH 285,A00,098055,Fitzsimmons; Patrick J,0,4,15,17
1668549973231,MATH 287B,A00,098056,Arias-Castro; Ery,1,0,15,14
1668549973659,MATH 288,A00,098057,Agarwal; Pooja,9,0,10,1
1668549973659,MATH 288,B00,098058,Zhang; Danna,8,0,10,2
1668549973659,MATH 288,C00,098059,Williams; Ruth J,9,0,10,1
1668549974084,MATH 290B,A00,098060,Roberts; Justin Deritter,12,0,15,3
1668549974511,MATH 292,A00,098061,Belmont; Eva Kinoshita,10,0,10,0
1668549974934,MATH 295,A00,098062,Suk; Andrew Hoon,47,0,50,3
1668549975365,MATH 296,A00,098063,Novak; Jonathan I,20,0,20,0
1668549975796,MATH 297,001,098064,Gamst; Anthony Collins,9997,0,9999,2
1668550481485,COGS 205,A00,101395,Chiba; Andrea,19,0,20,1
1668550481922,COGS 210B,001,101404,Greene; Deanna Jacquelyn,9998,0,9999,1
1668550481922,COGS 210B,002,101417,Xia; Haijun,9999,0,9999,0
1668550481922,COGS 210B,003,101422,Nitz; Douglas A.,9999,0,9999,0
1668550481922,COGS 210B,004,101423,Hollan; James D.,9998,0,9999,1
1668550481922,COGS 210B,005,101424,Deak; Gedeon O.,9998,0,9999,1
1668550481922,COGS 210B,006,101425,Rossano; Federico,9999,0,9999,0
1668550482349,COGS 211B,A00,101427,Coulson; Seana M,9996,0,9999,3
1668550482777,COGS 220,A00,101428,Hollan; James D.,0,15,25,25
1668550483201,COGS 229,A00,101429,Dow; Steven P,17,0,25,8
1668550483627,COGS 230,A00,101430,Klemmer; Scott R,6,0,17,11
1668550484049,COGS 234,A00,101431,Xia; Haijun,0,1,25,25
1668550484483,COGS 260,A00,101432,Kiyonaga; Anastasia,21,0,25,4
1668550484483,COGS 260,B00,101433,Kirsh; David Joel,15,0,25,10
1668550484914,CSE 202,A00,102371,Impagliazzo; Russell,0,70,0,0
1668550485357,CSE 203B,A01,102373,Cheng; Chung Kuan,0,64,0,0
1668550485793,CSE 208,A00,102374,Micciancio; Daniele,0,5,0,0
1668550486228,CSE 209A,A00,112895,Impagliazzo; Russell,0,13,15,15
1668550486651,CSE 209B,A00,108005,Bellare; Mihir,0,7,0,0
1668550487075,CSE 210,A00,113163,Coblenz; Michael J,0,91,0,0
1668550487509,CSE 219,A00,106111,Dow; Steven P,0,8,20,20
1668550487933,CSE 221,A00,102376,Voelker; Geoffrey M.,0,76,0,0
1668550488360,CSE 224,A01,102378,Porter; George M,0,174,0,0
1668550488785,CSE 229A,A00,102379,Savage; Stefan,0,11,0,0
1668550489208,CSE 229C,A00,102380,Munyaka; Imani N. S.,0,10,0,0
1668550489632,CSE 232B,A00,102382,Deutsch; Alin Bernard,0,38,0,0
1668550490056,CSE 234,A01,112904,Kumar; Arun Kumar,0,0,0,0
1668550490486,CSE 237A,A00,102383,Rosing; Tajana Simunic,0,56,0,0
1668550490922,CSE 239A,A00,102384,Deutsch; Alin Bernard,0,16,0,0
1668550491347,CSE 239B,A00,102385,Polikarpova; Nadezhda,0,11,0,0
1668550491773,CSE 240A,A00,102386,Pannuto; Patrick William,0,47,0,0
1668550492203,CSE 240B,A00,102387,Zhao; Jishen,0,50,0,0
1668550492643,CSE 241A,A00,106406,Kang; Mingu,0,9,0,0
1668550493069,CSE 249B,A00,102388,Kahng; Andrew Byun,0,5,8,8
1668550493495,CSE 251B,A01,102392,Cottrell; Garrison W,0,52,0,0
1668550493495,CSE 251B,A02,102393,Cottrell; Garrison W,0,35,0,0
1668550493936,CSE 252B,A00,102394,Ochoa; Benjamin Lawrence,0,62,0,0
1668550494358,CSE 257,A01,102396,Gao; Sicun,0,152,0,0
1668550494790,CSE 272,A00,102397,Li; Tzumao,0,20,0,0
1668550495214,CSE 274,A00,111323,Chern; Albert Ren-Haur,0,15,0,0
1668550495642,CSE 282,A00,102398,Pevzner; Pavel Arkadjevich,0,0,0,0
1668550496074,CSE 284,A00,114175,Gymrek; Melissa Ann,0,29,0,0
1668550496497,CSE 290,A00,102399,Chandraker; Manmohan Krishna,0,11,0,0
1668550496497,CSE 290,B00,102400,Vaccaro; Kristen Marie,0,8,25,25
1668550496497,CSE 290,C00,102414,Pannuto; Patrick William,0,1,25,25
1668550496497,CSE 290,D00,102427,Pevzner; Pavel Arkadjevich,0,0,0,0
1668550496497,CSE 290,E00,102429,Zhao; Jishen,0,6,0,0
1668550496497,CSE 290,F00,102436,Tullsen; Dean Michael,0,6,0,0
1668550496497,CSE 290,G00,102440,Christensen; Henrik I,0,6,20,20
1668550496926,CSE 291,A00,102443,Su; Hao,0,0,0,0
1668550496926,CSE 291,B00,102448,Polikarpova; Nadezhda,0,0,0,0
1668550496926,CSE 291,C00,102453,Vaccaro; Kristen Marie,0,0,0,0
1668550496926,CSE 291,D00,111343,Savage; Stefan,0,0,0,0
1668550496926,CSE 291,E00,116474,Claffy; Kimberly Claire,0,0,0,0
1668550496926,CSE 291,F00,116479,Pasquale; Joseph,0,0,0,0
1668550497351,CSE 293,001,119111,Bafna; Vineet,9999,0,9999,0
1668550497351,CSE 293,002,119118,Bellare; Mihir,9999,0,9999,0
1668550497351,CSE 293,003,119122,Berg-Kirkpatrick; Taylor D,9999,0,9999,0
1668550497351,CSE 293,004,119135,Christensen; Henrik I,9999,0,9999,0
1668550497351,CSE 293,005,119142,Cottrell; Garrison W,9999,0,9999,0
1668550497351,CSE 293,006,119146,Deutsch; Alin Bernard,9999,0,9999,0
1668550497351,CSE 293,007,119159,Esmaeilzadeh; Hadi,9999,0,9999,0
1668550497351,CSE 293,008,119166,Freund; Yoav,9999,0,9999,0
1668550497351,CSE 293,009,119170,Griswold; William G.,9999,0,9999,0
1668550497351,CSE 293,010,119183,Gymrek; Melissa Ann,9999,0,9999,0
1668550497351,CSE 293,011,119190,Heninger; Nadia A,9999,0,9999,0
1668550497351,CSE 293,012,119230,Impagliazzo; Russell,9999,0,9999,0
1668550497351,CSE 293,013,119232,Jhala; Ranjit,9999,0,9999,0
1668550497351,CSE 293,014,119233,Kahng; Andrew Byun,9999,0,9999,0
1668550497351,CSE 293,015,119298,Kane; Daniel Mertz,9999,0,9999,0
1668550497351,CSE 293,016,119299,Kriegman; David J,9999,0,9999,0
1668550497351,CSE 293,017,119300,Kumar; Arun Kumar,9999,0,9999,0
1668550497351,CSE 293,018,119301,Lerner; Sorin,9999,0,9999,0
1668550497351,CSE 293,019,119302,Lovett; Shachar,9999,0,9999,0
1668550497351,CSE 293,020,119303,McAuley; Julian John,9999,0,9999,0
1668550497351,CSE 293,021,119304,Micciancio; Daniele,9999,0,9999,0
1668550497351,CSE 293,022,119367,Orailoglu; Alex,9999,0,9999,0
1668550497351,CSE 293,023,119382,Paturi; Ramamohan,9999,0,9999,0
1668550497351,CSE 293,024,119404,Polikarpova; Nadezhda,9999,0,9999,0
1668550497351,CSE 293,025,119406,Politz; Joseph Gibbs,9999,0,9999,0
1668550497351,CSE 293,026,119411,Porter; George M,9999,0,9999,0
1668550497351,CSE 293,027,119414,Porter; Leonard Emerson,9999,0,9999,0
1668550497351,CSE 293,028,119416,Ramamoorthi; Ravi,9999,0,9999,0
1668550497351,CSE 293,029,119417,Sahoo; Debashis,9999,0,9999,0
1668550497351,CSE 293,030,119420,Saul; Lawrence,9999,0,9999,0
1668550497351,CSE 293,031,119421,Savage; Stefan,9999,0,9999,0
1668550497351,CSE 293,032,119425,Schulze; Jurgen P.,9999,0,9999,0
1668550497351,CSE 293,033,119426,Snoeren; Alex C.,9999,0,9999,0
1668550497351,CSE 293,034,119428,Shang; Jingbo,9999,0,9999,0
1668550497351,CSE 293,035,119430,Stefan; Deian,9999,0,9999,0
1668550497351,CSE 293,036,119431,Su; Hao,9999,0,9999,0
1668550497351,CSE 293,037,119433,Swanson; Steven James,9999,0,9999,0
1668550497351,CSE 293,038,119435,Tullsen; Dean Michael,9999,0,9999,0
1668550497351,CSE 293,039,119483,Voelker; Geoffrey M.,9999,0,9999,0
1668550497351,CSE 293,040,119537,Zhao; Jishen,9999,0,9999,0
1668550497351,CSE 293,041,119538,Zhou; Yuan-Yuan,9999,0,9999,0
1668550497351,CSE 293,042,119539,Gao; Sicun,9999,0,9999,0
1668550497351,CSE 293,043,119540,Weibel; Nadir,9999,0,9999,0
1668550497351,CSE 293,044,119541,Gupta; Rajesh K.,9999,0,9999,0
1668550497351,CSE 293,045,126410,Vaccaro; Kristen Marie,9999,0,9999,0
1668550497351,CSE 293,046,126411,Klemke; Richard,9999,0,9999,0
1668550497792,CSE 294,A00,102459,Voelker; Geoffrey M.,0,2,0,0
1668550497792,CSE 294,B00,111322,Orailoglu; Alex,0,2,0,0
1668550498217,DSE 201,A00,096914,Deutsch; Alin Bernard,30,0,30,0
1668550498641,DSE 210,A00,096915,Dasgupta; Sanjoy,30,0,30,0
1668550499066,DSE 260A,A00,096916,Altintas De Callaf; Ilkay,30,0,30,0
1668550499498,ECE 200,001,103586,Antipa; Nicholas A,9999,0,9999,0
1668550499498,ECE 200,002,103587,Atanasov; Nikolay A.,9999,0,9999,0
1668550499498,ECE 200,003,103588,Bharadia; Dinesh,9999,0,9999,0
1668550499498,ECE 200,004,103589,Cheng; Chung Kuan,9999,0,9999,0
1668550499498,ECE 200,005,103590,Cosman; Pamela C.,9999,0,9999,0
1668550499498,ECE 200,006,103591,Dayeh; Shadi Ahmad,9999,0,9999,0
1668550499498,ECE 200,007,103592,Fainman; Yeshaiahu,9999,0,9999,0
1668550499498,ECE 200,008,103593,Ford; Joseph Earl,9999,0,9999,0
1668550499498,ECE 200,009,103594,Franceschetti; Massimo,9999,0,9999,0
1668550499498,ECE 200,010,103595,Fullerton; Eric E,9999,0,9999,0
1668550499498,ECE 200,011,103596,Galton; Ian A,9999,0,9999,0
1668550499498,ECE 200,012,103597,Gilja; Vikash,9999,0,9999,0
1668550499498,ECE 200,013,103598,Hall; Drew A.,9999,0,9999,0
1668550499498,ECE 200,014,103599,Hsueh; Tzu-Chien,9999,0,9999,0
1668550499498,ECE 200,015,103600,Javidi; Tara,9999,0,9999,0
1668550499498,ECE 200,016,103601,Kahng; Andrew Byun,9999,0,9999,0
1668550499498,ECE 200,017,103602,Kim; Young-Han,9999,0,9999,0
1668550499498,ECE 200,018,103603,Koushanfar; Farinaz,9999,0,9999,0
1668550499498,ECE 200,019,103604,Kuzum; Duygu,9999,0,9999,0
1668550499498,ECE 200,020,103605,Le; Hanh-Phuc,9999,0,9999,0
1668550499498,ECE 200,021,103606,Lin; Bill,9999,0,9999,0
1668550499498,ECE 200,022,103607,Liu; Zhaowei,9998,0,9999,1
1668550499498,ECE 200,023,103608,Lo; Yu-Hwa,9999,0,9999,0
1668550499498,ECE 200,024,103609,Lomakin; Vitaliy,9999,0,9999,0
1668550499498,ECE 200,025,103610,Mercier; Patrick Philip,9999,0,9999,0
1668550499498,ECE 200,026,103611,Meyer; Florian,9999,0,9999,0
1668550499498,ECE 200,027,103612,Milstein; Laurence B.,9999,0,9999,0
1668550499498,ECE 200,028,103613,Mir Arabbaygi; Siavash,9999,0,9999,0
1668550499498,ECE 200,029,103614,Mookherjea; Shayan,9999,0,9999,0
1668550499498,ECE 200,030,103615,Morris; Karcher William,9999,0,9999,0
1668550499498,ECE 200,031,103616,Ng; Tse Nga,9999,0,9999,0
1668550499498,ECE 200,032,103617,Nguyen; Truong Quang,9999,0,9999,0
1668550499498,ECE 200,033,103618,Nomura; Kenji,9999,0,9999,0
1668550499498,ECE 200,034,103619,Orlitsky; Alon,9999,0,9999,0
1668550499498,ECE 200,035,103620,Pal; Piya,9999,0,9999,0
1668550499498,ECE 200,036,103621,Papen; George C.,9999,0,9999,0
1668550499498,ECE 200,037,103622,Radic; Stojan,9999,0,9999,0
1668550499498,ECE 200,038,103623,Rao; Bhaskar D.,9999,0,9999,0
1668550499498,ECE 200,039,103624,Rao; Ramesh R,9999,0,9999,0
1668550499498,ECE 200,040,103625,Rebeiz; Gabriel,9999,0,9999,0
1668550499498,ECE 200,041,103626,Sanford; John R,9999,0,9999,0
1668550499498,ECE 200,042,103627,Siegel; Paul H.,9999,0,9999,0
1668550499498,ECE 200,043,103628,Sievenpiper; Daniel F.,9999,0,9999,0
1668550499498,ECE 200,044,103629,Sworder; David D.,9999,0,9999,0
1668550499498,ECE 200,045,103630,Taur; Yuan,9999,0,9999,0
1668550499498,ECE 200,046,103631,Touri; Behrouz,9999,0,9999,0
1668550499498,ECE 200,047,103632,Trivedi; Mohan M.,9999,0,9999,0
1668550499498,ECE 200,048,103633,Vasconcelos; Nuno,9999,0,9999,0
1668550499498,ECE 200,049,103634,Wang; Xiaolong,9999,0,9999,0
1668550499498,ECE 200,050,103635,Xie; Pengtao,9999,0,9999,0
1668550499498,ECE 200,051,103636,Yip; Michael,9999,0,9999,0
1668550499498,ECE 200,052,103637,Zeger; Kenneth A.,999,0,999,0
1668550499498,ECE 200,053,103638,Zhang; Xinyu,9999,0,9999,0
1668550499498,ECE 200,054,103639,Turakhia; Yatish Girish,9999,0,9999,0
1668550499498,ECE 200,055,103640,Kang; Mingu,9999,0,9999,0
1668550499498,ECE 200,056,103641,Shi; Yuanyuan,9999,0,9999,0
1668550499498,ECE 200,057,103642,Wang; Edward Jay,9999,0,9999,0
1668550499498,ECE 200,058,103643,Zheng; Yang,9999,0,9999,0
1668550499928,ECE 202,A00,103644,Kuzum; Duygu,0,45,0,0
1668550500361,ECE 212BN,A00,103646,Ng; Tse Nga,0,9,0,0
1668550500790,ECE 221,A00,111493,Staff,0,0,0,0
1668550501225,ECE 222B,A00,103647,Lomakin; Vitaliy,0,20,0,0
1668550501647,ECE 230B,A00,103648,Taur; Yuan,0,4,0,0
1668550502074,ECE 238B,A00,103649,Garay; Javier,0,0,0,0
1668550502499,ECE 240B,A00,112900,Fainman; Yeshaiahu,0,7,0,0
1668550502923,ECE 247A,A00,103650,Jokerst; Jesse Vincent,0,6,0,0
1668550503356,ECE 247B,A00,103651,Wang; Joseph,0,14,0,0
1668550503778,ECE 250,A00,103652,Siegel; Paul H.,0,82,0,0
1668550504216,ECE 251A,A00,103654,Rao; Bhaskar D.,0,63,0,0
1668550504651,ECE 257B,A00,103655,Bharadia; Dinesh,0,33,0,0
1668550505079,ECE 258A,A00,103656,Milstein; Laurence B.,0,28,0,0
1668550505511,ECE 260B,A00,103658,Kang; Mingu,0,123,0,0
1668550505932,ECE 264A,A00,103659,Galton; Ian A,0,72,0,0
1668550506359,ECE 265A,A00,103661,Gudem; Prasad S.S.,0,74,0,0
1668550506781,ECE 265D,A00,103662,Gudem; Prasad S.S.,0,26,0,0
1668550507204,ECE 268,A00,103663,Koushanfar; Farinaz,0,43,0,0
1668550507629,ECE 269,A01,103665,Pal; Piya,0,219,0,0
1668550508052,ECE 271B,A00,103666,Vasconcelos; Manuela,0,78,0,0
1668550508496,ECE 276A,A00,103667,Atanasov; Nikolay A.,0,126,0,0
1668550508929,ECE 277,A00,103668,An; Cheolhong,0,151,0,0
1668550509368,ECE 279,A00,117947,Hall; Drew A.,0,22,0,0
1668550510339,ECE 283,A00,103670,Hsueh; Tzu-Chien,0,57,0,0
1668550510762,ECE 284,A00,103671,Turakhia; Yatish Girish,0,40,0,0
1668550511195,ECE 285,A00,103672,Zheng; Yang,0,40,0,0
1668550511195,ECE 285,B00,103673,Sworder; David D.,0,61,0,0
1668550511630,ECE 287,A00,103676,Javidi; Tara,0,8,0,0
1668550512058,MATH 200B,A00,098023,Salehi Golsefidy; Alireza,10,0,15,5
1668550512483,MATH 202B,A00,098024,Rhoades; Brendon Patrick,7,0,15,8
1668550512929,MATH 203B,A00,098025,Oprea; Dragos N.,9,0,15,6
1668550513355,MATH 204B,A00,098026,Sorensen; Claus M,13,0,15,2
1668550513777,MATH 208,A00,098027,Izadi; Elham,7,0,10,3
1668550514203,MATH 209,A00,098028,Pollack; Aaron,10,0,10,0
1668550514640,MATH 211A,A00,112919,Rogalski; Daniel,8,0,10,2
1668550515061,MATH 211B,A00,112920,Seward; Brandon M.,9,0,10,1
1668550515488,MATH 218,A00,098029,Li; Bo,10,0,10,0
1668550515919,MATH 220B,A00,098030,Novak; Jonathan I,11,0,15,4
1668550516357,MATH 221A,A00,098031,Ebenfelt; Peter F,12,0,15,3
1668550516784,MATH 231B,A00,098032,Zlatos; Andrej,10,0,15,5
1668550517208,MATH 240B,A00,098033,Ni; Lei,7,0,15,8
1668550517636,MATH 243,A00,098034,Jekel; David Andrew,10,0,10,0
1668550518070,MATH 245A,A00,098035,Nie; Jiawang,0,5,15,18
1668550518502,MATH 248,A00,098036,Bejenaru; Ioan,10,0,10,0
1668550518929,MATH 250B,A00,098037,Spolaor; Luca,14,0,15,1
1668550519353,MATH 258,A00,098038,Ni; Lei,9,0,10,1
1668550519777,MATH 264B,A00,098041,Rhoades; Brendon Patrick,8,0,15,7
1668550520220,MATH 268,A00,098042,Buss; Samuel R,10,0,10,0
1668550520646,MATH 269,A00,098043,Rhoades; Brendon Patrick,10,0,10,0
1668550521079,MATH 270B,A00,098044,Li; Bo,6,0,15,9
1668550521507,MATH 272B,A00,098045,Holst; Michael J,13,0,15,2
1668550521930,MATH 273A,A00,098046,Tian; Xiaochuan,10,0,15,5
1668550522360,MATH 275,A01,098048,Tian; Xiaochuan,6,0,10,4
1668550522793,MATH 278A,A00,098049,Holst; Michael J,6,0,10,4
1668550523225,MATH 278B,A00,098050,Cloninger; Alexander,10,0,10,0
1668550523649,MATH 278C,A00,098051,Nie; Jiawang,5,0,10,5
1668550524077,MATH 280B,A00,098052,Zheng; Tianyi,7,0,15,8
1668550524501,MATH 281B,A00,098053,Bradic; Jelena,0,2,15,15
1668550524928,MATH 282B,A00,098054,Arias-Castro; Ery,0,1,15,15
1668550525357,MATH 285,A00,098055,Fitzsimmons; Patrick J,0,4,15,17
1668550525786,MATH 287B,A00,098056,Arias-Castro; Ery,1,0,15,14
1668550526212,MATH 288,A00,098057,Agarwal; Pooja,9,0,10,1
1668550526212,MATH 288,B00,098058,Zhang; Danna,8,0,10,2
1668550526212,MATH 288,C00,098059,Williams; Ruth J,9,0,10,1
1668550526648,MATH 290B,A00,098060,Roberts; Justin Deritter,12,0,15,3
1668550527086,MATH 292,A00,098061,Belmont; Eva Kinoshita,10,0,10,0
1668550527511,MATH 295,A00,098062,Suk; Andrew Hoon,47,0,50,3
1668550527934,MATH 296,A00,098063,Novak; Jonathan I,20,0,20,0
1668550528362,MATH 297,001,098064,Gamst; Anthony Collins,9997,0,9999,2
1668551044888,COGS 205,A00,101395,Chiba; Andrea,19,0,20,1
1668551045313,COGS 210B,001,101404,Greene; Deanna Jacquelyn,9998,0,9999,1
1668551045313,COGS 210B,002,101417,Xia; Haijun,9999,0,9999,0
1668551045313,COGS 210B,003,101422,Nitz; Douglas A.,9999,0,9999,0
1668551045313,COGS 210B,004,101423,Hollan; James D.,9998,0,9999,1
1668551045313,COGS 210B,005,101424,Deak; Gedeon O.,9998,0,9999,1
1668551045313,COGS 210B,006,101425,Rossano; Federico,9999,0,9999,0
1668551045746,COGS 211B,A00,101427,Coulson; Seana M,9996,0,9999,3
1668551046169,COGS 220,A00,101428,Hollan; James D.,0,15,25,25
1668551046592,COGS 229,A00,101429,Dow; Steven P,17,0,25,8
1668551047016,COGS 230,A00,101430,Klemmer; Scott R,6,0,17,11
1668551047438,COGS 234,A00,101431,Xia; Haijun,0,1,25,25
1668551047862,COGS 260,A00,101432,Kiyonaga; Anastasia,21,0,25,4
1668551047862,COGS 260,B00,101433,Kirsh; David Joel,15,0,25,10
1668551048288,CSE 202,A00,102371,Impagliazzo; Russell,0,70,0,0
1668551048712,CSE 203B,A01,102373,Cheng; Chung Kuan,0,64,0,0
1668551049135,CSE 208,A00,102374,Micciancio; Daniele,0,5,0,0
1668551049558,CSE 209A,A00,112895,Impagliazzo; Russell,0,13,15,15
1668551049984,CSE 209B,A00,108005,Bellare; Mihir,0,7,0,0
1668551050407,CSE 210,A00,113163,Coblenz; Michael J,0,91,0,0
1668551050839,CSE 219,A00,106111,Dow; Steven P,0,8,20,20
1668551051264,CSE 221,A00,102376,Voelker; Geoffrey M.,0,76,0,0
1668551051689,CSE 224,A01,102378,Porter; George M,0,174,0,0
1668551052115,CSE 229A,A00,102379,Savage; Stefan,0,11,0,0
1668551052539,CSE 229C,A00,102380,Munyaka; Imani N. S.,0,10,0,0
1668551052963,CSE 232B,A00,102382,Deutsch; Alin Bernard,0,38,0,0
1668551053391,CSE 234,A01,112904,Kumar; Arun Kumar,0,0,0,0
1668551053818,CSE 237A,A00,102383,Rosing; Tajana Simunic,0,56,0,0
1668551054240,CSE 239A,A00,102384,Deutsch; Alin Bernard,0,16,0,0
1668551054666,CSE 239B,A00,102385,Polikarpova; Nadezhda,0,11,0,0
1668551055092,CSE 240A,A00,102386,Pannuto; Patrick William,0,47,0,0
1668551055517,CSE 240B,A00,102387,Zhao; Jishen,0,50,0,0
1668551055939,CSE 241A,A00,106406,Kang; Mingu,0,9,0,0
1668551056377,CSE 249B,A00,102388,Kahng; Andrew Byun,0,5,8,8
1668551056819,CSE 251B,A01,102392,Cottrell; Garrison W,0,52,0,0
1668551056819,CSE 251B,A02,102393,Cottrell; Garrison W,0,35,0,0
1668551057248,CSE 252B,A00,102394,Ochoa; Benjamin Lawrence,0,63,0,0
1668551057681,CSE 257,A01,102396,Gao; Sicun,0,153,0,0
1668551058106,CSE 272,A00,102397,Li; Tzumao,0,20,0,0
1668551058532,CSE 274,A00,111323,Chern; Albert Ren-Haur,0,16,0,0
1668551058959,CSE 282,A00,102398,Pevzner; Pavel Arkadjevich,0,0,0,0
1668551059383,CSE 284,A00,114175,Gymrek; Melissa Ann,0,29,0,0
1668551059812,CSE 290,A00,102399,Chandraker; Manmohan Krishna,0,11,0,0
1668551059812,CSE 290,B00,102400,Vaccaro; Kristen Marie,0,8,25,25
1668551059812,CSE 290,C00,102414,Pannuto; Patrick William,0,1,25,25
1668551059812,CSE 290,D00,102427,Pevzner; Pavel Arkadjevich,0,0,0,0
1668551059812,CSE 290,E00,102429,Zhao; Jishen,0,6,0,0
1668551059812,CSE 290,F00,102436,Tullsen; Dean Michael,0,6,0,0
1668551059812,CSE 290,G00,102440,Christensen; Henrik I,0,6,20,20
1668551060246,CSE 291,A00,102443,Su; Hao,0,0,0,0
1668551060246,CSE 291,B00,102448,Polikarpova; Nadezhda,0,0,0,0
1668551060246,CSE 291,C00,102453,Vaccaro; Kristen Marie,0,0,0,0
1668551060246,CSE 291,D00,111343,Savage; Stefan,0,0,0,0
1668551060246,CSE 291,E00,116474,Claffy; Kimberly Claire,0,0,0,0
1668551060246,CSE 291,F00,116479,Pasquale; Joseph,0,0,0,0
1668551060680,CSE 293,001,119111,Bafna; Vineet,9999,0,9999,0
1668551060680,CSE 293,002,119118,Bellare; Mihir,9999,0,9999,0
1668551060680,CSE 293,003,119122,Berg-Kirkpatrick; Taylor D,9999,0,9999,0
1668551060680,CSE 293,004,119135,Christensen; Henrik I,9999,0,9999,0
1668551060680,CSE 293,005,119142,Cottrell; Garrison W,9999,0,9999,0
1668551060680,CSE 293,006,119146,Deutsch; Alin Bernard,9999,0,9999,0
1668551060680,CSE 293,007,119159,Esmaeilzadeh; Hadi,9999,0,9999,0
1668551060680,CSE 293,008,119166,Freund; Yoav,9999,0,9999,0
1668551060680,CSE 293,009,119170,Griswold; William G.,9999,0,9999,0
1668551060680,CSE 293,010,119183,Gymrek; Melissa Ann,9999,0,9999,0
1668551060680,CSE 293,011,119190,Heninger; Nadia A,9999,0,9999,0
1668551060680,CSE 293,012,119230,Impagliazzo; Russell,9999,0,9999,0
1668551060680,CSE 293,013,119232,Jhala; Ranjit,9999,0,9999,0
1668551060680,CSE 293,014,119233,Kahng; Andrew Byun,9999,0,9999,0
1668551060680,CSE 293,015,119298,Kane; Daniel Mertz,9999,0,9999,0
1668551060680,CSE 293,016,119299,Kriegman; David J,9999,0,9999,0
1668551060680,CSE 293,017,119300,Kumar; Arun Kumar,9999,0,9999,0
1668551060680,CSE 293,018,119301,Lerner; Sorin,9999,0,9999,0
1668551060680,CSE 293,019,119302,Lovett; Shachar,9999,0,9999,0
1668551060680,CSE 293,020,119303,McAuley; Julian John,9999,0,9999,0
1668551060680,CSE 293,021,119304,Micciancio; Daniele,9999,0,9999,0
1668551060680,CSE 293,022,119367,Orailoglu; Alex,9999,0,9999,0
1668551060680,CSE 293,023,119382,Paturi; Ramamohan,9999,0,9999,0
1668551060680,CSE 293,024,119404,Polikarpova; Nadezhda,9999,0,9999,0
1668551060680,CSE 293,025,119406,Politz; Joseph Gibbs,9999,0,9999,0
1668551060680,CSE 293,026,119411,Porter; George M,9999,0,9999,0
1668551060680,CSE 293,027,119414,Porter; Leonard Emerson,9999,0,9999,0
1668551060680,CSE 293,028,119416,Ramamoorthi; Ravi,9999,0,9999,0
1668551060680,CSE 293,029,119417,Sahoo; Debashis,9999,0,9999,0
1668551060680,CSE 293,030,119420,Saul; Lawrence,9999,0,9999,0
1668551060680,CSE 293,031,119421,Savage; Stefan,9999,0,9999,0
1668551060680,CSE 293,032,119425,Schulze; Jurgen P.,9999,0,9999,0
1668551060680,CSE 293,033,119426,Snoeren; Alex C.,9999,0,9999,0
1668551060680,CSE 293,034,119428,Shang; Jingbo,9999,0,9999,0
1668551060680,CSE 293,035,119430,Stefan; Deian,9999,0,9999,0
1668551060680,CSE 293,036,119431,Su; Hao,9999,0,9999,0
1668551060680,CSE 293,037,119433,Swanson; Steven James,9999,0,9999,0
1668551060680,CSE 293,038,119435,Tullsen; Dean Michael,9999,0,9999,0
1668551060680,CSE 293,039,119483,Voelker; Geoffrey M.,9999,0,9999,0
1668551060680,CSE 293,040,119537,Zhao; Jishen,9999,0,9999,0
1668551060680,CSE 293,041,119538,Zhou; Yuan-Yuan,9999,0,9999,0
1668551060680,CSE 293,042,119539,Gao; Sicun,9999,0,9999,0
1668551060680,CSE 293,043,119540,Weibel; Nadir,9999,0,9999,0
1668551060680,CSE 293,044,119541,Gupta; Rajesh K.,9999,0,9999,0
1668551060680,CSE 293,045,126410,Vaccaro; Kristen Marie,9999,0,9999,0
1668551060680,CSE 293,046,126411,Klemke; Richard,9999,0,9999,0
1668551061105,CSE 294,A00,102459,Voelker; Geoffrey M.,0,2,0,0
1668551061105,CSE 294,B00,111322,Orailoglu; Alex,0,2,0,0
1668551061543,DSE 201,A00,096914,Deutsch; Alin Bernard,30,0,30,0
1668551061974,DSE 210,A00,096915,Dasgupta; Sanjoy,30,0,30,0
1668551062397,DSE 260A,A00,096916,Altintas De Callaf; Ilkay,30,0,30,0
1668551062833,ECE 200,001,103586,Antipa; Nicholas A,9999,0,9999,0
1668551062833,ECE 200,002,103587,Atanasov; Nikolay A.,9999,0,9999,0
1668551062833,ECE 200,003,103588,Bharadia; Dinesh,9999,0,9999,0
1668551062833,ECE 200,004,103589,Cheng; Chung Kuan,9999,0,9999,0
1668551062833,ECE 200,005,103590,Cosman; Pamela C.,9999,0,9999,0
1668551062833,ECE 200,006,103591,Dayeh; Shadi Ahmad,9999,0,9999,0
1668551062833,ECE 200,007,103592,Fainman; Yeshaiahu,9999,0,9999,0
1668551062833,ECE 200,008,103593,Ford; Joseph Earl,9999,0,9999,0
1668551062833,ECE 200,009,103594,Franceschetti; Massimo,9999,0,9999,0
1668551062833,ECE 200,010,103595,Fullerton; Eric E,9999,0,9999,0
1668551062833,ECE 200,011,103596,Galton; Ian A,9999,0,9999,0
1668551062833,ECE 200,012,103597,Gilja; Vikash,9999,0,9999,0
1668551062833,ECE 200,013,103598,Hall; Drew A.,9999,0,9999,0
1668551062833,ECE 200,014,103599,Hsueh; Tzu-Chien,9999,0,9999,0
1668551062833,ECE 200,015,103600,Javidi; Tara,9999,0,9999,0
1668551062833,ECE 200,016,103601,Kahng; Andrew Byun,9999,0,9999,0
1668551062833,ECE 200,017,103602,Kim; Young-Han,9999,0,9999,0
1668551062833,ECE 200,018,103603,Koushanfar; Farinaz,9999,0,9999,0
1668551062833,ECE 200,019,103604,Kuzum; Duygu,9999,0,9999,0
1668551062833,ECE 200,020,103605,Le; Hanh-Phuc,9999,0,9999,0
1668551062833,ECE 200,021,103606,Lin; Bill,9999,0,9999,0
1668551062833,ECE 200,022,103607,Liu; Zhaowei,9998,0,9999,1
1668551062833,ECE 200,023,103608,Lo; Yu-Hwa,9999,0,9999,0
1668551062833,ECE 200,024,103609,Lomakin; Vitaliy,9999,0,9999,0
1668551062833,ECE 200,025,103610,Mercier; Patrick Philip,9999,0,9999,0
1668551062833,ECE 200,026,103611,Meyer; Florian,9999,0,9999,0
1668551062833,ECE 200,027,103612,Milstein; Laurence B.,9999,0,9999,0
1668551062833,ECE 200,028,103613,Mir Arabbaygi; Siavash,9999,0,9999,0
1668551062833,ECE 200,029,103614,Mookherjea; Shayan,9999,0,9999,0
1668551062833,ECE 200,030,103615,Morris; Karcher William,9999,0,9999,0
1668551062833,ECE 200,031,103616,Ng; Tse Nga,9999,0,9999,0
1668551062833,ECE 200,032,103617,Nguyen; Truong Quang,9999,0,9999,0
1668551062833,ECE 200,033,103618,Nomura; Kenji,9999,0,9999,0
1668551062833,ECE 200,034,103619,Orlitsky; Alon,9999,0,9999,0
1668551062833,ECE 200,035,103620,Pal; Piya,9999,0,9999,0
1668551062833,ECE 200,036,103621,Papen; George C.,9999,0,9999,0
1668551062833,ECE 200,037,103622,Radic; Stojan,9999,0,9999,0
1668551062833,ECE 200,038,103623,Rao; Bhaskar D.,9999,0,9999,0
1668551062833,ECE 200,039,103624,Rao; Ramesh R,9999,0,9999,0
1668551062833,ECE 200,040,103625,Rebeiz; Gabriel,9999,0,9999,0
1668551062833,ECE 200,041,103626,Sanford; John R,9999,0,9999,0
1668551062833,ECE 200,042,103627,Siegel; Paul H.,9999,0,9999,0
1668551062833,ECE 200,043,103628,Sievenpiper; Daniel F.,9999,0,9999,0
1668551062833,ECE 200,044,103629,Sworder; David D.,9999,0,9999,0
1668551062833,ECE 200,045,103630,Taur; Yuan,9999,0,9999,0
1668551062833,ECE 200,046,103631,Touri; Behrouz,9999,0,9999,0
1668551062833,ECE 200,047,103632,Trivedi; Mohan M.,9999,0,9999,0
1668551062833,ECE 200,048,103633,Vasconcelos; Nuno,9999,0,9999,0
1668551062833,ECE 200,049,103634,Wang; Xiaolong,9999,0,9999,0
1668551062833,ECE 200,050,103635,Xie; Pengtao,9999,0,9999,0
1668551062833,ECE 200,051,103636,Yip; Michael,9999,0,9999,0
1668551062833,ECE 200,052,103637,Zeger; Kenneth A.,999,0,999,0
1668551062833,ECE 200,053,103638,Zhang; Xinyu,9999,0,9999,0
1668551062833,ECE 200,054,103639,Turakhia; Yatish Girish,9999,0,9999,0
1668551062833,ECE 200,055,103640,Kang; Mingu,9999,0,9999,0
1668551062833,ECE 200,056,103641,Shi; Yuanyuan,9999,0,9999,0
1668551062833,ECE 200,057,103642,Wang; Edward Jay,9999,0,9999,0
1668551062833,ECE 200,058,103643,Zheng; Yang,9999,0,9999,0
1668551063275,ECE 202,A00,103644,Kuzum; Duygu,0,45,0,0
1668551063708,ECE 212BN,A00,103646,Ng; Tse Nga,0,9,0,0
1668551064142,ECE 221,A00,111493,Staff,0,0,0,0
1668551064567,ECE 222B,A00,103647,Lomakin; Vitaliy,0,20,0,0
1668551064991,ECE 230B,A00,103648,Taur; Yuan,0,4,0,0
1668551065413,ECE 238B,A00,103649,Garay; Javier,0,0,0,0
1668551065845,ECE 240B,A00,112900,Fainman; Yeshaiahu,0,7,0,0
1668551066269,ECE 247A,A00,103650,Jokerst; Jesse Vincent,0,6,0,0
1668551066691,ECE 247B,A00,103651,Wang; Joseph,0,14,0,0
1668551067118,ECE 250,A00,103652,Siegel; Paul H.,0,82,0,0
1668551067549,ECE 251A,A00,103654,Rao; Bhaskar D.,0,63,0,0
1668551067975,ECE 257B,A00,103655,Bharadia; Dinesh,0,33,0,0
1668551068407,ECE 258A,A00,103656,Milstein; Laurence B.,0,28,0,0
1668551068830,ECE 260B,A00,103658,Kang; Mingu,0,123,0,0
1668551069265,ECE 264A,A00,103659,Galton; Ian A,0,72,0,0
1668551069707,ECE 265A,A00,103661,Gudem; Prasad S.S.,0,74,0,0
1668551070129,ECE 265D,A00,103662,Gudem; Prasad S.S.,0,26,0,0
1668551070554,ECE 268,A00,103663,Koushanfar; Farinaz,0,43,0,0
1668551070991,ECE 269,A01,103665,Pal; Piya,0,220,0,0
1668551071418,ECE 271B,A00,103666,Vasconcelos; Manuela,0,78,0,0
1668551071841,ECE 276A,A00,103667,Atanasov; Nikolay A.,0,126,0,0
1668551072268,ECE 277,A00,103668,An; Cheolhong,0,151,0,0
1668551072693,ECE 279,A00,117947,Hall; Drew A.,0,22,0,0
1668551073560,ECE 283,A00,103670,Hsueh; Tzu-Chien,0,57,0,0
1668551073999,ECE 284,A00,103671,Turakhia; Yatish Girish,0,40,0,0
1668551074422,ECE 285,A00,103672,Zheng; Yang,0,40,0,0
1668551074422,ECE 285,B00,103673,Sworder; David D.,0,61,0,0
1668551074850,ECE 287,A00,103676,Javidi; Tara,0,8,0,0
1668551075282,MATH 200B,A00,098023,Salehi Golsefidy; Alireza,10,0,15,5
1668551075717,MATH 202B,A00,098024,Rhoades; Brendon Patrick,7,0,15,8
1668551076139,MATH 203B,A00,098025,Oprea; Dragos N.,9,0,15,6
1668551076571,MATH 204B,A00,098026,Sorensen; Claus M,13,0,15,2
1668551077010,MATH 208,A00,098027,Izadi; Elham,7,0,10,3
1668551077452,MATH 209,A00,098028,Pollack; Aaron,10,0,10,0
1668551077879,MATH 211A,A00,112919,Rogalski; Daniel,8,0,10,2
1668551078304,MATH 211B,A00,112920,Seward; Brandon M.,9,0,10,1
1668551078735,MATH 218,A00,098029,Li; Bo,10,0,10,0
1668551079159,MATH 220B,A00,098030,Novak; Jonathan I,11,0,15,4
1668551079584,MATH 221A,A00,098031,Ebenfelt; Peter F,12,0,15,3
1668551080013,MATH 231B,A00,098032,Zlatos; Andrej,10,0,15,5
1668551080441,MATH 240B,A00,098033,Ni; Lei,7,0,15,8
1668551080866,MATH 243,A00,098034,Jekel; David Andrew,10,0,10,0
1668551081294,MATH 245A,A00,098035,Nie; Jiawang,0,5,15,18
1668551081726,MATH 248,A00,098036,Bejenaru; Ioan,10,0,10,0
1668551082159,MATH 250B,A00,098037,Spolaor; Luca,14,0,15,1
1668551082594,MATH 258,A00,098038,Ni; Lei,9,0,10,1
1668551083028,MATH 264B,A00,098041,Rhoades; Brendon Patrick,8,0,15,7
1668551083464,MATH 268,A00,098042,Buss; Samuel R,10,0,10,0
1668551083896,MATH 269,A00,098043,Rhoades; Brendon Patrick,10,0,10,0
1668551084322,MATH 270B,A00,098044,Li; Bo,6,0,15,9
1668551084743,MATH 272B,A00,098045,Holst; Michael J,13,0,15,2
1668551085171,MATH 273A,A00,098046,Tian; Xiaochuan,10,0,15,5
1668551085598,MATH 275,A01,098048,Tian; Xiaochuan,6,0,10,4
1668551086027,MATH 278A,A00,098049,Holst; Michael J,6,0,10,4
1668551086458,MATH 278B,A00,098050,Cloninger; Alexander,10,0,10,0
1668551086896,MATH 278C,A00,098051,Nie; Jiawang,5,0,10,5
1668551087319,MATH 280B,A00,098052,Zheng; Tianyi,7,0,15,8
1668551087742,MATH 281B,A00,098053,Bradic; Jelena,0,2,15,15
1668551088294,MATH 282B,A00,098054,Arias-Castro; Ery,0,1,15,15
1668551088717,MATH 285,A00,098055,Fitzsimmons; Patrick J,0,4,15,17
1668551089154,MATH 287B,A00,098056,Arias-Castro; Ery,1,0,15,14
1668551089579,MATH 288,A00,098057,Agarwal; Pooja,9,0,10,1
1668551089579,MATH 288,B00,098058,Zhang; Danna,8,0,10,2
1668551089579,MATH 288,C00,098059,Williams; Ruth J,9,0,10,1
1668551090019,MATH 290B,A00,098060,Roberts; Justin Deritter,12,0,15,3
1668551090447,MATH 292,A00,098061,Belmont; Eva Kinoshita,10,0,10,0
1668551090878,MATH 295,A00,098062,Suk; Andrew Hoon,47,0,50,3
1668551091312,MATH 296,A00,098063,Novak; Jonathan I,20,0,20,0
1668551091741,MATH 297,001,098064,Gamst; Anthony Collins,9997,0,9999,2
1668551596286,COGS 205,A00,101395,Chiba; Andrea,19,0,20,1
1668551596717,COGS 210B,001,101404,Greene; Deanna Jacquelyn,9998,0,9999,1
1668551596717,COGS 210B,002,101417,Xia; Haijun,9999,0,9999,0
1668551596717,COGS 210B,003,101422,Nitz; Douglas A.,9999,0,9999,0
1668551596717,COGS 210B,004,101423,Hollan; James D.,9998,0,9999,1
1668551596717,COGS 210B,005,101424,Deak; Gedeon O.,9998,0,9999,1
1668551596717,COGS 210B,006,101425,Rossano; Federico,9999,0,9999,0
1668551597143,COGS 211B,A00,101427,Coulson; Seana M,9996,0,9999,3
1668551597573,COGS 220,A00,101428,Hollan; James D.,0,15,25,25
1668551597996,COGS 229,A00,101429,Dow; Steven P,17,0,25,8
1668551598420,COGS 230,A00,101430,Klemmer; Scott R,6,0,17,11
1668551598845,COGS 234,A00,101431,Xia; Haijun,0,1,25,25
1668551599279,COGS 260,A00,101432,Kiyonaga; Anastasia,21,0,25,4
1668551599279,COGS 260,B00,101433,Kirsh; David Joel,15,0,25,10
1668551599725,CSE 202,A00,102371,Impagliazzo; Russell,0,70,0,0
1668551600150,CSE 203B,A01,102373,Cheng; Chung Kuan,0,64,0,0
1668551600576,CSE 208,A00,102374,Micciancio; Daniele,0,5,0,0
1668551600999,CSE 209A,A00,112895,Impagliazzo; Russell,0,13,15,15
1668551601429,CSE 209B,A00,108005,Bellare; Mihir,0,7,0,0
1668551601853,CSE 210,A00,113163,Coblenz; Michael J,0,91,0,0
1668551602278,CSE 219,A00,106111,Dow; Steven P,0,8,20,20
1668551602700,CSE 221,A00,102376,Voelker; Geoffrey M.,0,76,0,0
1668551603134,CSE 224,A01,102378,Porter; George M,0,174,0,0
1668551603560,CSE 229A,A00,102379,Savage; Stefan,0,11,0,0
1668551603995,CSE 229C,A00,102380,Munyaka; Imani N. S.,0,10,0,0
1668551604431,CSE 232B,A00,102382,Deutsch; Alin Bernard,0,38,0,0
1668551604861,CSE 234,A01,112904,Kumar; Arun Kumar,0,0,0,0
1668551605284,CSE 237A,A00,102383,Rosing; Tajana Simunic,0,56,0,0
1668551605718,CSE 239A,A00,102384,Deutsch; Alin Bernard,0,16,0,0
1668551606139,CSE 239B,A00,102385,Polikarpova; Nadezhda,0,11,0,0
1668551606562,CSE 240A,A00,102386,Pannuto; Patrick William,0,47,0,0
1668551606986,CSE 240B,A00,102387,Zhao; Jishen,0,50,0,0
1668551607425,CSE 241A,A00,106406,Kang; Mingu,0,9,0,0
1668551607856,CSE 249B,A00,102388,Kahng; Andrew Byun,0,5,8,8
1668551608284,CSE 251B,A01,102392,Cottrell; Garrison W,0,52,0,0
1668551608284,CSE 251B,A02,102393,Cottrell; Garrison W,0,35,0,0
1668551608707,CSE 252B,A00,102394,Ochoa; Benjamin Lawrence,0,63,0,0
1668551609138,CSE 257,A01,102396,Gao; Sicun,0,153,0,0
1668551609565,CSE 272,A00,102397,Li; Tzumao,0,21,0,0
1668551609993,CSE 274,A00,111323,Chern; Albert Ren-Haur,0,16,0,0
1668551610419,CSE 282,A00,102398,Pevzner; Pavel Arkadjevich,0,0,0,0
1668551610850,CSE 284,A00,114175,Gymrek; Melissa Ann,0,29,0,0
1668551611366,CSE 290,A00,102399,Chandraker; Manmohan Krishna,0,11,0,0
1668551611366,CSE 290,B00,102400,Vaccaro; Kristen Marie,0,8,25,25
1668551611366,CSE 290,C00,102414,Pannuto; Patrick William,0,1,25,25
1668551611366,CSE 290,D00,102427,Pevzner; Pavel Arkadjevich,0,0,0,0
1668551611366,CSE 290,E00,102429,Zhao; Jishen,0,6,0,0
1668551611366,CSE 290,F00,102436,Tullsen; Dean Michael,0,6,0,0
1668551611366,CSE 290,G00,102440,Christensen; Henrik I,0,6,20,20
1668551611791,CSE 291,A00,102443,Su; Hao,0,0,0,0
1668551611791,CSE 291,B00,102448,Polikarpova; Nadezhda,0,0,0,0
1668551611791,CSE 291,C00,102453,Vaccaro; Kristen Marie,0,0,0,0
1668551611791,CSE 291,D00,111343,Savage; Stefan,0,0,0,0
1668551611791,CSE 291,E00,116474,Claffy; Kimberly Claire,0,0,0,0
1668551611791,CSE 291,F00,116479,Pasquale; Joseph,0,0,0,0
1668551612239,CSE 293,001,119111,Bafna; Vineet,9999,0,9999,0
1668551612239,CSE 293,002,119118,Bellare; Mihir,9999,0,9999,0
1668551612239,CSE 293,003,119122,Berg-Kirkpatrick; Taylor D,9999,0,9999,0
1668551612239,CSE 293,004,119135,Christensen; Henrik I,9999,0,9999,0
1668551612239,CSE 293,005,119142,Cottrell; Garrison W,9999,0,9999,0
1668551612239,CSE 293,006,119146,Deutsch; Alin Bernard,9999,0,9999,0
1668551612239,CSE 293,007,119159,Esmaeilzadeh; Hadi,9999,0,9999,0
1668551612239,CSE 293,008,119166,Freund; Yoav,9999,0,9999,0
1668551612239,CSE 293,009,119170,Griswold; William G.,9999,0,9999,0
1668551612239,CSE 293,010,119183,Gymrek; Melissa Ann,9999,0,9999,0
1668551612239,CSE 293,011,119190,Heninger; Nadia A,9999,0,9999,0
1668551612239,CSE 293,012,119230,Impagliazzo; Russell,9999,0,9999,0
1668551612239,CSE 293,013,119232,Jhala; Ranjit,9999,0,9999,0
1668551612239,CSE 293,014,119233,Kahng; Andrew Byun,9999,0,9999,0
1668551612239,CSE 293,015,119298,Kane; Daniel Mertz,9999,0,9999,0
1668551612239,CSE 293,016,119299,Kriegman; David J,9999,0,9999,0
1668551612239,CSE 293,017,119300,Kumar; Arun Kumar,9999,0,9999,0
1668551612239,CSE 293,018,119301,Lerner; Sorin,9999,0,9999,0
1668551612239,CSE 293,019,119302,Lovett; Shachar,9999,0,9999,0
1668551612239,CSE 293,020,119303,McAuley; Julian John,9999,0,9999,0
1668551612239,CSE 293,021,119304,Micciancio; Daniele,9999,0,9999,0
1668551612239,CSE 293,022,119367,Orailoglu; Alex,9999,0,9999,0
1668551612239,CSE 293,023,119382,Paturi; Ramamohan,9999,0,9999,0
1668551612239,CSE 293,024,119404,Polikarpova; Nadezhda,9999,0,9999,0
1668551612239,CSE 293,025,119406,Politz; Joseph Gibbs,9999,0,9999,0
1668551612239,CSE 293,026,119411,Porter; George M,9999,0,9999,0
1668551612239,CSE 293,027,119414,Porter; Leonard Emerson,9999,0,9999,0
1668551612239,CSE 293,028,119416,Ramamoorthi; Ravi,9999,0,9999,0
1668551612239,CSE 293,029,119417,Sahoo; Debashis,9999,0,9999,0
1668551612239,CSE 293,030,119420,Saul; Lawrence,9999,0,9999,0
1668551612239,CSE 293,031,119421,Savage; Stefan,9999,0,9999,0
1668551612239,CSE 293,032,119425,Schulze; Jurgen P.,9999,0,9999,0
1668551612239,CSE 293,033,119426,Snoeren; Alex C.,9999,0,9999,0
1668551612239,CSE 293,034,119428,Shang; Jingbo,9999,0,9999,0
1668551612239,CSE 293,035,119430,Stefan; Deian,9999,0,9999,0
1668551612239,CSE 293,036,119431,Su; Hao,9999,0,9999,0
1668551612239,CSE 293,037,119433,Swanson; Steven James,9999,0,9999,0
1668551612239,CSE 293,038,119435,Tullsen; Dean Michael,9999,0,9999,0
1668551612239,CSE 293,039,119483,Voelker; Geoffrey M.,9999,0,9999,0
1668551612239,CSE 293,040,119537,Zhao; Jishen,9999,0,9999,0
1668551612239,CSE 293,041,119538,Zhou; Yuan-Yuan,9999,0,9999,0
1668551612239,CSE 293,042,119539,Gao; Sicun,9999,0,9999,0
1668551612239,CSE 293,043,119540,Weibel; Nadir,9999,0,9999,0
1668551612239,CSE 293,044,119541,Gupta; Rajesh K.,9999,0,9999,0
1668551612239,CSE 293,045,126410,Vaccaro; Kristen Marie,9999,0,9999,0
1668551612239,CSE 293,046,126411,Klemke; Richard,9999,0,9999,0
1668551612662,CSE 294,A00,102459,Voelker; Geoffrey M.,0,2,0,0
1668551612662,CSE 294,B00,111322,Orailoglu; Alex,0,2,0,0
1668551613094,DSE 201,A00,096914,Deutsch; Alin Bernard,30,0,30,0
1668551613518,DSE 210,A00,096915,Dasgupta; Sanjoy,30,0,30,0
1668551613993,DSE 260A,A00,096916,Altintas De Callaf; Ilkay,30,0,30,0
1668551614430,ECE 200,001,103586,Antipa; Nicholas A,9999,0,9999,0
1668551614430,ECE 200,002,103587,Atanasov; Nikolay A.,9999,0,9999,0
1668551614430,ECE 200,003,103588,Bharadia; Dinesh,9999,0,9999,0
1668551614430,ECE 200,004,103589,Cheng; Chung Kuan,9999,0,9999,0
1668551614430,ECE 200,005,103590,Cosman; Pamela C.,9999,0,9999,0
1668551614430,ECE 200,006,103591,Dayeh; Shadi Ahmad,9999,0,9999,0
1668551614430,ECE 200,007,103592,Fainman; Yeshaiahu,9999,0,9999,0
1668551614430,ECE 200,008,103593,Ford; Joseph Earl,9999,0,9999,0
1668551614430,ECE 200,009,103594,Franceschetti; Massimo,9999,0,9999,0
1668551614430,ECE 200,010,103595,Fullerton; Eric E,9999,0,9999,0
1668551614430,ECE 200,011,103596,Galton; Ian A,9999,0,9999,0
1668551614430,ECE 200,012,103597,Gilja; Vikash,9999,0,9999,0
1668551614430,ECE 200,013,103598,Hall; Drew A.,9999,0,9999,0
1668551614430,ECE 200,014,103599,Hsueh; Tzu-Chien,9999,0,9999,0
1668551614430,ECE 200,015,103600,Javidi; Tara,9999,0,9999,0
1668551614430,ECE 200,016,103601,Kahng; Andrew Byun,9999,0,9999,0
1668551614430,ECE 200,017,103602,Kim; Young-Han,9999,0,9999,0
1668551614430,ECE 200,018,103603,Koushanfar; Farinaz,9999,0,9999,0
1668551614430,ECE 200,019,103604,Kuzum; Duygu,9999,0,9999,0
1668551614430,ECE 200,020,103605,Le; Hanh-Phuc,9999,0,9999,0
1668551614430,ECE 200,021,103606,Lin; Bill,9999,0,9999,0
1668551614430,ECE 200,022,103607,Liu; Zhaowei,9998,0,9999,1
1668551614430,ECE 200,023,103608,Lo; Yu-Hwa,9999,0,9999,0
1668551614430,ECE 200,024,103609,Lomakin; Vitaliy,9999,0,9999,0
1668551614430,ECE 200,025,103610,Mercier; Patrick Philip,9999,0,9999,0
1668551614430,ECE 200,026,103611,Meyer; Florian,9999,0,9999,0
1668551614430,ECE 200,027,103612,Milstein; Laurence B.,9999,0,9999,0
1668551614430,ECE 200,028,103613,Mir Arabbaygi; Siavash,9999,0,9999,0
1668551614430,ECE 200,029,103614,Mookherjea; Shayan,9999,0,9999,0
1668551614430,ECE 200,030,103615,Morris; Karcher William,9999,0,9999,0
1668551614430,ECE 200,031,103616,Ng; Tse Nga,9999,0,9999,0
1668551614430,ECE 200,032,103617,Nguyen; Truong Quang,9999,0,9999,0
1668551614430,ECE 200,033,103618,Nomura; Kenji,9999,0,9999,0
1668551614430,ECE 200,034,103619,Orlitsky; Alon,9999,0,9999,0
1668551614430,ECE 200,035,103620,Pal; Piya,9999,0,9999,0
1668551614430,ECE 200,036,103621,Papen; George C.,9999,0,9999,0
1668551614430,ECE 200,037,103622,Radic; Stojan,9999,0,9999,0
1668551614430,ECE 200,038,103623,Rao; Bhaskar D.,9999,0,9999,0
1668551614430,ECE 200,039,103624,Rao; Ramesh R,9999,0,9999,0
1668551614430,ECE 200,040,103625,Rebeiz; Gabriel,9999,0,9999,0
1668551614430,ECE 200,041,103626,Sanford; John R,9999,0,9999,0
1668551614430,ECE 200,042,103627,Siegel; Paul H.,9999,0,9999,0
1668551614430,ECE 200,043,103628,Sievenpiper; Daniel F.,9999,0,9999,0
1668551614430,ECE 200,044,103629,Sworder; David D.,9999,0,9999,0
1668551614430,ECE 200,045,103630,Taur; Yuan,9999,0,9999,0
1668551614430,ECE 200,046,103631,Touri; Behrouz,9999,0,9999,0
1668551614430,ECE 200,047,103632,Trivedi; Mohan M.,9999,0,9999,0
1668551614430,ECE 200,048,103633,Vasconcelos; Nuno,9999,0,9999,0
1668551614430,ECE 200,049,103634,Wang; Xiaolong,9999,0,9999,0
1668551614430,ECE 200,050,103635,Xie; Pengtao,9999,0,9999,0
1668551614430,ECE 200,051,103636,Yip; Michael,9999,0,9999,0
1668551614430,ECE 200,052,103637,Zeger; Kenneth A.,999,0,999,0
1668551614430,ECE 200,053,103638,Zhang; Xinyu,9999,0,9999,0
1668551614430,ECE 200,054,103639,Turakhia; Yatish Girish,9999,0,9999,0
1668551614430,ECE 200,055,103640,Kang; Mingu,9999,0,9999,0
1668551614430,ECE 200,056,103641,Shi; Yuanyuan,9999,0,9999,0
1668551614430,ECE 200,057,103642,Wang; Edward Jay,9999,0,9999,0
1668551614430,ECE 200,058,103643,Zheng; Yang,9999,0,9999,0
1668551614865,ECE 202,A00,103644,Kuzum; Duygu,0,45,0,0
1668551615291,ECE 212BN,A00,103646,Ng; Tse Nga,0,9,0,0
1668551615719,ECE 221,A00,111493,Staff,0,0,0,0
1668551616142,ECE 222B,A00,103647,Lomakin; Vitaliy,0,20,0,0
1668551616575,ECE 230B,A00,103648,Taur; Yuan,0,4,0,0
1668551616997,ECE 238B,A00,103649,Garay; Javier,0,0,0,0
1668551617430,ECE 240B,A00,112900,Fainman; Yeshaiahu,0,7,0,0
1668551617870,ECE 247A,A00,103650,Jokerst; Jesse Vincent,0,6,0,0
1668551618302,ECE 247B,A00,103651,Wang; Joseph,0,14,0,0
1668551618725,ECE 250,A00,103652,Siegel; Paul H.,0,82,0,0
1668551619156,ECE 251A,A00,103654,Rao; Bhaskar D.,0,63,0,0
1668551619579,ECE 257B,A00,103655,Bharadia; Dinesh,0,33,0,0
1668551620014,ECE 258A,A00,103656,Milstein; Laurence B.,0,28,0,0
1668551620443,ECE 260B,A00,103658,Kang; Mingu,0,123,0,0
1668551620870,ECE 264A,A00,103659,Galton; Ian A,0,72,0,0
1668551621304,ECE 265A,A00,103661,Gudem; Prasad S.S.,0,74,0,0
1668551621727,ECE 265D,A00,103662,Gudem; Prasad S.S.,0,26,0,0
1668551622162,ECE 268,A00,103663,Koushanfar; Farinaz,0,43,0,0
1668551622592,ECE 269,A01,103665,Pal; Piya,0,220,0,0
1668551623019,ECE 271B,A00,103666,Vasconcelos; Manuela,0,78,0,0
1668551623455,ECE 276A,A00,103667,Atanasov; Nikolay A.,0,126,0,0
1668551623892,ECE 277,A00,103668,An; Cheolhong,0,151,0,0
1668551624317,ECE 279,A00,117947,Hall; Drew A.,0,22,0,0
1668551625169,ECE 283,A00,103670,Hsueh; Tzu-Chien,0,57,0,0
1668551625600,ECE 284,A00,103671,Turakhia; Yatish Girish,0,40,0,0
1668551626022,ECE 285,A00,103672,Zheng; Yang,0,40,0,0
1668551626022,ECE 285,B00,103673,Sworder; David D.,0,61,0,0
1668551626448,ECE 287,A00,103676,Javidi; Tara,0,8,0,0
1668551626883,MATH 200B,A00,098023,Salehi Golsefidy; Alireza,10,0,15,5
1668551627311,MATH 202B,A00,098024,Rhoades; Brendon Patrick,7,0,15,8
1668551627742,MATH 203B,A00,098025,Oprea; Dragos N.,9,0,15,6
1668551628172,MATH 204B,A00,098026,Sorensen; Claus M,13,0,15,2
1668551628594,MATH 208,A00,098027,Izadi; Elham,7,0,10,3
1668551629021,MATH 209,A00,098028,Pollack; Aaron,10,0,10,0
1668551629442,MATH 211A,A00,112919,Rogalski; Daniel,8,0,10,2
1668551629867,MATH 211B,A00,112920,Seward; Brandon M.,9,0,10,1
1668551630291,MATH 218,A00,098029,Li; Bo,10,0,10,0
1668551630718,MATH 220B,A00,098030,Novak; Jonathan I,11,0,15,4
1668551631142,MATH 221A,A00,098031,Ebenfelt; Peter F,12,0,15,3
1668551631567,MATH 231B,A00,098032,Zlatos; Andrej,10,0,15,5
1668551632003,MATH 240B,A00,098033,Ni; Lei,7,0,15,8
1668551632430,MATH 243,A00,098034,Jekel; David Andrew,10,0,10,0
1668551632858,MATH 245A,A00,098035,Nie; Jiawang,0,5,15,18
1668551633281,MATH 248,A00,098036,Bejenaru; Ioan,10,0,10,0
1668551633707,MATH 250B,A00,098037,Spolaor; Luca,14,0,15,1
1668551634135,MATH 258,A00,098038,Ni; Lei,9,0,10,1
1668551634560,MATH 264B,A00,098041,Rhoades; Brendon Patrick,8,0,15,7
1668551634986,MATH 268,A00,098042,Buss; Samuel R,10,0,10,0
1668551635408,MATH 269,A00,098043,Rhoades; Brendon Patrick,10,0,10,0
1668551635838,MATH 270B,A00,098044,Li; Bo,6,0,15,9
1668551636272,MATH 272B,A00,098045,Holst; Michael J,13,0,15,2
1668551636698,MATH 273A,A00,098046,Tian; Xiaochuan,10,0,15,5
1668551637121,MATH 275,A01,098048,Tian; Xiaochuan,6,0,10,4
1668551637544,MATH 278A,A00,098049,Holst; Michael J,6,0,10,4
1668551637966,MATH 278B,A00,098050,Cloninger; Alexander,10,0,10,0
1668551638391,MATH 278C,A00,098051,Nie; Jiawang,5,0,10,5
1668551638819,MATH 280B,A00,098052,Zheng; Tianyi,7,0,15,8
1668551639243,MATH 281B,A00,098053,Bradic; Jelena,0,2,15,15
1668551639670,MATH 282B,A00,098054,Arias-Castro; Ery,0,1,15,15
1668551640099,MATH 285,A00,098055,Fitzsimmons; Patrick J,0,4,15,17
1668551640526,MATH 287B,A00,098056,Arias-Castro; Ery,1,0,15,14
1668551640957,MATH 288,A00,098057,Agarwal; Pooja,9,0,10,1
1668551640957,MATH 288,B00,098058,Zhang; Danna,8,0,10,2
1668551640957,MATH 288,C00,098059,Williams; Ruth J,9,0,10,1
1668551641380,MATH 290B,A00,098060,Roberts; Justin Deritter,12,0,15,3
1668551641807,MATH 292,A00,098061,Belmont; Eva Kinoshita,10,0,10,0
1668551642230,MATH 295,A00,098062,Suk; Andrew Hoon,47,0,50,3
1668551642654,MATH 296,A00,098063,Novak; Jonathan I,20,0,20,0
1668551643078,MATH 297,001,098064,Gamst; Anthony Collins,9997,0,9999,2
1668552149997,COGS 205,A00,101395,Chiba; Andrea,19,0,20,1
1668552150425,COGS 210B,001,101404,Greene; Deanna Jacquelyn,9998,0,9999,1
1668552150425,COGS 210B,002,101417,Xia; Haijun,9999,0,9999,0
1668552150425,COGS 210B,003,101422,Nitz; Douglas A.,9999,0,9999,0
1668552150425,COGS 210B,004,101423,Hollan; James D.,9998,0,9999,1
1668552150425,COGS 210B,005,101424,Deak; Gedeon O.,9998,0,9999,1
1668552150425,COGS 210B,006,101425,Rossano; Federico,9999,0,9999,0
1668552150848,COGS 211B,A00,101427,Coulson; Seana M,9996,0,9999,3
1668552151274,COGS 220,A00,101428,Hollan; James D.,0,16,25,25
1668552151706,COGS 229,A00,101429,Dow; Steven P,17,0,25,8
1668552152136,COGS 230,A00,101430,Klemmer; Scott R,6,0,17,11
1668552152559,COGS 234,A00,101431,Xia; Haijun,0,1,25,25
1668552153000,COGS 260,A00,101432,Kiyonaga; Anastasia,21,0,25,4
1668552153000,COGS 260,B00,101433,Kirsh; David Joel,15,0,25,10
1668552153441,CSE 202,A00,102371,Impagliazzo; Russell,0,70,0,0
1668552153887,CSE 203B,A01,102373,Cheng; Chung Kuan,0,64,0,0
1668552154323,CSE 208,A00,102374,Micciancio; Daniele,0,5,0,0
1668552154758,CSE 209A,A00,112895,Impagliazzo; Russell,0,13,15,15
1668552155180,CSE 209B,A00,108005,Bellare; Mihir,0,7,0,0
1668552155614,CSE 210,A00,113163,Coblenz; Michael J,0,91,0,0
1668552156038,CSE 219,A00,106111,Dow; Steven P,0,8,20,20
1668552156462,CSE 221,A00,102376,Voelker; Geoffrey M.,0,76,0,0
1668552156890,CSE 224,A01,102378,Porter; George M,0,174,0,0
1668552157325,CSE 229A,A00,102379,Savage; Stefan,0,11,0,0
1668552157761,CSE 229C,A00,102380,Munyaka; Imani N. S.,0,10,0,0
1668552158190,CSE 232B,A00,102382,Deutsch; Alin Bernard,0,38,0,0
1668552158617,CSE 234,A01,112904,Kumar; Arun Kumar,0,0,0,0
1668552159049,CSE 237A,A00,102383,Rosing; Tajana Simunic,0,56,0,0
1668552159488,CSE 239A,A00,102384,Deutsch; Alin Bernard,0,16,0,0
1668552159931,CSE 239B,A00,102385,Polikarpova; Nadezhda,0,11,0,0
1668552160369,CSE 240A,A00,102386,Pannuto; Patrick William,0,47,0,0
1668552160793,CSE 240B,A00,102387,Zhao; Jishen,0,50,0,0
1668552161216,CSE 241A,A00,106406,Kang; Mingu,0,9,0,0
1668552161642,CSE 249B,A00,102388,Kahng; Andrew Byun,0,5,8,8
1668552162076,CSE 251B,A01,102392,Cottrell; Garrison W,0,52,0,0
1668552162076,CSE 251B,A02,102393,Cottrell; Garrison W,0,35,0,0
1668552162504,CSE 252B,A00,102394,Ochoa; Benjamin Lawrence,0,63,0,0
1668552162932,CSE 257,A01,102396,Gao; Sicun,0,153,0,0
1668552163357,CSE 272,A00,102397,Li; Tzumao,0,21,0,0
1668552163781,CSE 274,A00,111323,Chern; Albert Ren-Haur,0,16,0,0
1668552164206,CSE 282,A00,102398,Pevzner; Pavel Arkadjevich,0,0,0,0
1668552164641,CSE 284,A00,114175,Gymrek; Melissa Ann,0,29,0,0
1668552165073,CSE 290,A00,102399,Chandraker; Manmohan Krishna,0,11,0,0
1668552165073,CSE 290,B00,102400,Vaccaro; Kristen Marie,0,8,25,25
1668552165073,CSE 290,C00,102414,Pannuto; Patrick William,0,1,25,25
1668552165073,CSE 290,D00,102427,Pevzner; Pavel Arkadjevich,0,0,0,0
1668552165073,CSE 290,E00,102429,Zhao; Jishen,0,6,0,0
1668552165073,CSE 290,F00,102436,Tullsen; Dean Michael,0,6,0,0
1668552165073,CSE 290,G00,102440,Christensen; Henrik I,0,6,20,20
1668552165505,CSE 291,A00,102443,Su; Hao,0,0,0,0
1668552165505,CSE 291,B00,102448,Polikarpova; Nadezhda,0,0,0,0
1668552165505,CSE 291,C00,102453,Vaccaro; Kristen Marie,0,0,0,0
1668552165505,CSE 291,D00,111343,Savage; Stefan,0,0,0,0
1668552165505,CSE 291,E00,116474,Claffy; Kimberly Claire,0,0,0,0
1668552165505,CSE 291,F00,116479,Pasquale; Joseph,0,0,0,0
1668552165934,CSE 293,001,119111,Bafna; Vineet,9999,0,9999,0
1668552165934,CSE 293,002,119118,Bellare; Mihir,9999,0,9999,0
1668552165934,CSE 293,003,119122,Berg-Kirkpatrick; Taylor D,9999,0,9999,0
1668552165934,CSE 293,004,119135,Christensen; Henrik I,9999,0,9999,0
1668552165934,CSE 293,005,119142,Cottrell; Garrison W,9999,0,9999,0
1668552165934,CSE 293,006,119146,Deutsch; Alin Bernard,9999,0,9999,0
1668552165934,CSE 293,007,119159,Esmaeilzadeh; Hadi,9999,0,9999,0
1668552165934,CSE 293,008,119166,Freund; Yoav,9999,0,9999,0
1668552165934,CSE 293,009,119170,Griswold; William G.,9999,0,9999,0
1668552165934,CSE 293,010,119183,Gymrek; Melissa Ann,9999,0,9999,0
1668552165934,CSE 293,011,119190,Heninger; Nadia A,9999,0,9999,0
1668552165934,CSE 293,012,119230,Impagliazzo; Russell,9999,0,9999,0
1668552165934,CSE 293,013,119232,Jhala; Ranjit,9999,0,9999,0
1668552165934,CSE 293,014,119233,Kahng; Andrew Byun,9999,0,9999,0
1668552165934,CSE 293,015,119298,Kane; Daniel Mertz,9999,0,9999,0
1668552165934,CSE 293,016,119299,Kriegman; David J,9999,0,9999,0
1668552165934,CSE 293,017,119300,Kumar; Arun Kumar,9999,0,9999,0
1668552165934,CSE 293,018,119301,Lerner; Sorin,9999,0,9999,0
1668552165934,CSE 293,019,119302,Lovett; Shachar,9999,0,9999,0
1668552165934,CSE 293,020,119303,McAuley; Julian John,9999,0,9999,0
1668552165934,CSE 293,021,119304,Micciancio; Daniele,9999,0,9999,0
1668552165934,CSE 293,022,119367,Orailoglu; Alex,9999,0,9999,0
1668552165934,CSE 293,023,119382,Paturi; Ramamohan,9999,0,9999,0
1668552165934,CSE 293,024,119404,Polikarpova; Nadezhda,9999,0,9999,0
1668552165934,CSE 293,025,119406,Politz; Joseph Gibbs,9999,0,9999,0
1668552165934,CSE 293,026,119411,Porter; George M,9999,0,9999,0
1668552165934,CSE 293,027,119414,Porter; Leonard Emerson,9999,0,9999,0
1668552165934,CSE 293,028,119416,Ramamoorthi; Ravi,9999,0,9999,0
1668552165934,CSE 293,029,119417,Sahoo; Debashis,9999,0,9999,0
1668552165934,CSE 293,030,119420,Saul; Lawrence,9999,0,9999,0
1668552165934,CSE 293,031,119421,Savage; Stefan,9999,0,9999,0
1668552165934,CSE 293,032,119425,Schulze; Jurgen P.,9999,0,9999,0
1668552165934,CSE 293,033,119426,Snoeren; Alex C.,9999,0,9999,0
1668552165934,CSE 293,034,119428,Shang; Jingbo,9999,0,9999,0
1668552165934,CSE 293,035,119430,Stefan; Deian,9999,0,9999,0
1668552165934,CSE 293,036,119431,Su; Hao,9999,0,9999,0
1668552165934,CSE 293,037,119433,Swanson; Steven James,9999,0,9999,0
1668552165934,CSE 293,038,119435,Tullsen; Dean Michael,9999,0,9999,0
1668552165934,CSE 293,039,119483,Voelker; Geoffrey M.,9999,0,9999,0
1668552165934,CSE 293,040,119537,Zhao; Jishen,9999,0,9999,0
1668552165934,CSE 293,041,119538,Zhou; Yuan-Yuan,9999,0,9999,0
1668552165934,CSE 293,042,119539,Gao; Sicun,9999,0,9999,0
1668552165934,CSE 293,043,119540,Weibel; Nadir,9999,0,9999,0
1668552165934,CSE 293,044,119541,Gupta; Rajesh K.,9999,0,9999,0
1668552165934,CSE 293,045,126410,Vaccaro; Kristen Marie,9999,0,9999,0
1668552165934,CSE 293,046,126411,Klemke; Richard,9999,0,9999,0
1668552166371,CSE 294,A00,102459,Voelker; Geoffrey M.,0,2,0,0
1668552166371,CSE 294,B00,111322,Orailoglu; Alex,0,2,0,0
1668552166804,DSE 201,A00,096914,Deutsch; Alin Bernard,30,0,30,0
1668552167228,DSE 210,A00,096915,Dasgupta; Sanjoy,30,0,30,0
1668552167661,DSE 260A,A00,096916,Altintas De Callaf; Ilkay,30,0,30,0
1668552168116,ECE 200,001,103586,Antipa; Nicholas A,9999,0,9999,0
1668552168116,ECE 200,002,103587,Atanasov; Nikolay A.,9999,0,9999,0
1668552168116,ECE 200,003,103588,Bharadia; Dinesh,9999,0,9999,0
1668552168116,ECE 200,004,103589,Cheng; Chung Kuan,9999,0,9999,0
1668552168116,ECE 200,005,103590,Cosman; Pamela C.,9999,0,9999,0
1668552168116,ECE 200,006,103591,Dayeh; Shadi Ahmad,9999,0,9999,0
1668552168116,ECE 200,007,103592,Fainman; Yeshaiahu,9999,0,9999,0
1668552168116,ECE 200,008,103593,Ford; Joseph Earl,9999,0,9999,0
1668552168116,ECE 200,009,103594,Franceschetti; Massimo,9999,0,9999,0
1668552168116,ECE 200,010,103595,Fullerton; Eric E,9999,0,9999,0
1668552168116,ECE 200,011,103596,Galton; Ian A,9999,0,9999,0
1668552168116,ECE 200,012,103597,Gilja; Vikash,9999,0,9999,0
1668552168116,ECE 200,013,103598,Hall; Drew A.,9999,0,9999,0
1668552168116,ECE 200,014,103599,Hsueh; Tzu-Chien,9999,0,9999,0
1668552168116,ECE 200,015,103600,Javidi; Tara,9999,0,9999,0
1668552168116,ECE 200,016,103601,Kahng; Andrew Byun,9999,0,9999,0
1668552168116,ECE 200,017,103602,Kim; Young-Han,9999,0,9999,0
1668552168116,ECE 200,018,103603,Koushanfar; Farinaz,9999,0,9999,0
1668552168116,ECE 200,019,103604,Kuzum; Duygu,9999,0,9999,0
1668552168116,ECE 200,020,103605,Le; Hanh-Phuc,9999,0,9999,0
1668552168116,ECE 200,021,103606,Lin; Bill,9999,0,9999,0
1668552168116,ECE 200,022,103607,Liu; Zhaowei,9998,0,9999,1
1668552168116,ECE 200,023,103608,Lo; Yu-Hwa,9999,0,9999,0
1668552168116,ECE 200,024,103609,Lomakin; Vitaliy,9999,0,9999,0
1668552168116,ECE 200,025,103610,Mercier; Patrick Philip,9999,0,9999,0
1668552168116,ECE 200,026,103611,Meyer; Florian,9999,0,9999,0
1668552168116,ECE 200,027,103612,Milstein; Laurence B.,9999,0,9999,0
1668552168116,ECE 200,028,103613,Mir Arabbaygi; Siavash,9999,0,9999,0
1668552168116,ECE 200,029,103614,Mookherjea; Shayan,9999,0,9999,0
1668552168116,ECE 200,030,103615,Morris; Karcher William,9999,0,9999,0
1668552168116,ECE 200,031,103616,Ng; Tse Nga,9999,0,9999,0
1668552168116,ECE 200,032,103617,Nguyen; Truong Quang,9999,0,9999,0
1668552168116,ECE 200,033,103618,Nomura; Kenji,9999,0,9999,0
1668552168116,ECE 200,034,103619,Orlitsky; Alon,9999,0,9999,0
1668552168116,ECE 200,035,103620,Pal; Piya,9999,0,9999,0
1668552168116,ECE 200,036,103621,Papen; George C.,9999,0,9999,0
1668552168116,ECE 200,037,103622,Radic; Stojan,9999,0,9999,0
1668552168116,ECE 200,038,103623,Rao; Bhaskar D.,9999,0,9999,0
1668552168116,ECE 200,039,103624,Rao; Ramesh R,9999,0,9999,0
1668552168116,ECE 200,040,103625,Rebeiz; Gabriel,9999,0,9999,0
1668552168116,ECE 200,041,103626,Sanford; John R,9999,0,9999,0
1668552168116,ECE 200,042,103627,Siegel; Paul H.,9999,0,9999,0
1668552168116,ECE 200,043,103628,Sievenpiper; Daniel F.,9999,0,9999,0
1668552168116,ECE 200,044,103629,Sworder; David D.,9999,0,9999,0
1668552168116,ECE 200,045,103630,Taur; Yuan,9999,0,9999,0
1668552168116,ECE 200,046,103631,Touri; Behrouz,9999,0,9999,0
1668552168116,ECE 200,047,103632,Trivedi; Mohan M.,9999,0,9999,0
1668552168116,ECE 200,048,103633,Vasconcelos; Nuno,9999,0,9999,0
1668552168116,ECE 200,049,103634,Wang; Xiaolong,9999,0,9999,0
1668552168116,ECE 200,050,103635,Xie; Pengtao,9999,0,9999,0
1668552168116,ECE 200,051,103636,Yip; Michael,9999,0,9999,0
1668552168116,ECE 200,052,103637,Zeger; Kenneth A.,999,0,999,0
1668552168116,ECE 200,053,103638,Zhang; Xinyu,9999,0,9999,0
1668552168116,ECE 200,054,103639,Turakhia; Yatish Girish,9999,0,9999,0
1668552168116,ECE 200,055,103640,Kang; Mingu,9999,0,9999,0
1668552168116,ECE 200,056,103641,Shi; Yuanyuan,9999,0,9999,0
1668552168116,ECE 200,057,103642,Wang; Edward Jay,9999,0,9999,0
1668552168116,ECE 200,058,103643,Zheng; Yang,9999,0,9999,0
1668552168543,ECE 202,A00,103644,Kuzum; Duygu,0,45,0,0
1668552168980,ECE 212BN,A00,103646,Ng; Tse Nga,0,9,0,0
1668552169411,ECE 221,A00,111493,Staff,0,0,0,0
1668552169837,ECE 222B,A00,103647,Lomakin; Vitaliy,0,20,0,0
1668552170279,ECE 230B,A00,103648,Taur; Yuan,0,4,0,0
1668552170732,ECE 238B,A00,103649,Garay; Javier,0,0,0,0
1668552171173,ECE 240B,A00,112900,Fainman; Yeshaiahu,0,7,0,0
1668552171599,ECE 247A,A00,103650,Jokerst; Jesse Vincent,0,6,0,0
1668552172035,ECE 247B,A00,103651,Wang; Joseph,0,14,0,0
1668552172459,ECE 250,A00,103652,Siegel; Paul H.,0,82,0,0
1668552172884,ECE 251A,A00,103654,Rao; Bhaskar D.,0,63,0,0
1668552173314,ECE 257B,A00,103655,Bharadia; Dinesh,0,33,0,0
1668552173737,ECE 258A,A00,103656,Milstein; Laurence B.,0,28,0,0
1668552174177,ECE 260B,A00,103658,Kang; Mingu,0,123,0,0
1668552174602,ECE 264A,A00,103659,Galton; Ian A,0,72,0,0
1668552175049,ECE 265A,A00,103661,Gudem; Prasad S.S.,0,74,0,0
1668552175485,ECE 265D,A00,103662,Gudem; Prasad S.S.,0,26,0,0
1668552175910,ECE 268,A00,103663,Koushanfar; Farinaz,0,43,0,0
1668552176347,ECE 269,A01,103665,Pal; Piya,0,220,0,0
1668552176769,ECE 271B,A00,103666,Vasconcelos; Manuela,0,78,0,0
1668552177197,ECE 276A,A00,103667,Atanasov; Nikolay A.,0,126,0,0
1668552177623,ECE 277,A00,103668,An; Cheolhong,0,151,0,0
1668552178047,ECE 279,A00,117947,Hall; Drew A.,0,22,0,0
1668552178895,ECE 283,A00,103670,Hsueh; Tzu-Chien,0,57,0,0
1668552179325,ECE 284,A00,103671,Turakhia; Yatish Girish,0,40,0,0
1668552179759,ECE 285,A00,103672,Zheng; Yang,0,40,0,0
1668552179759,ECE 285,B00,103673,Sworder; David D.,0,61,0,0
1668552180289,ECE 287,A00,103676,Javidi; Tara,0,8,0,0
1668552180718,MATH 200B,A00,098023,Salehi Golsefidy; Alireza,10,0,15,5
1668552181142,MATH 202B,A00,098024,Rhoades; Brendon Patrick,7,0,15,8
1668552181570,MATH 203B,A00,098025,Oprea; Dragos N.,9,0,15,6
1668552182000,MATH 204B,A00,098026,Sorensen; Claus M,13,0,15,2
1668552182431,MATH 208,A00,098027,Izadi; Elham,7,0,10,3
1668552182855,MATH 209,A00,098028,Pollack; Aaron,10,0,10,0
1668552183282,MATH 211A,A00,112919,Rogalski; Daniel,8,0,10,2
1668552183707,MATH 211B,A00,112920,Seward; Brandon M.,9,0,10,1
1668552184139,MATH 218,A00,098029,Li; Bo,10,0,10,0
1668552184565,MATH 220B,A00,098030,Novak; Jonathan I,11,0,15,4
1668552184992,MATH 221A,A00,098031,Ebenfelt; Peter F,12,0,15,3
1668552185422,MATH 231B,A00,098032,Zlatos; Andrej,10,0,15,5
1668552185873,MATH 240B,A00,098033,Ni; Lei,7,0,15,8
1668552186303,MATH 243,A00,098034,Jekel; David Andrew,10,0,10,0
1668552186729,MATH 245A,A00,098035,Nie; Jiawang,0,5,15,18
1668552187159,MATH 248,A00,098036,Bejenaru; Ioan,10,0,10,0
1668552187585,MATH 250B,A00,098037,Spolaor; Luca,14,0,15,1
1668552188009,MATH 258,A00,098038,Ni; Lei,9,0,10,1
1668552188436,MATH 264B,A00,098041,Rhoades; Brendon Patrick,8,0,15,7
1668552188865,MATH 268,A00,098042,Buss; Samuel R,10,0,10,0
1668552189297,MATH 269,A00,098043,Rhoades; Brendon Patrick,10,0,10,0
1668552189736,MATH 270B,A00,098044,Li; Bo,6,0,15,9
1668552190163,MATH 272B,A00,098045,Holst; Michael J,13,0,15,2
1668552190596,MATH 273A,A00,098046,Tian; Xiaochuan,10,0,15,5
1668552191024,MATH 275,A01,098048,Tian; Xiaochuan,6,0,10,4
1668552191451,MATH 278A,A00,098049,Holst; Michael J,6,0,10,4
1668552191886,MATH 278B,A00,098050,Cloninger; Alexander,10,0,10,0
1668552192313,MATH 278C,A00,098051,Nie; Jiawang,5,0,10,5
1668552192739,MATH 280B,A00,098052,Zheng; Tianyi,7,0,15,8
1668552193173,MATH 281B,A00,098053,Bradic; Jelena,0,2,15,15
1668552193605,MATH 282B,A00,098054,Arias-Castro; Ery,0,1,15,15
1668552194029,MATH 285,A00,098055,Fitzsimmons; Patrick J,0,4,15,17
1668552194459,MATH 287B,A00,098056,Arias-Castro; Ery,1,0,15,14
1668552194895,MATH 288,A00,098057,Agarwal; Pooja,9,0,10,1
1668552194895,MATH 288,B00,098058,Zhang; Danna,8,0,10,2
1668552194895,MATH 288,C00,098059,Williams; Ruth J,9,0,10,1
1668552195331,MATH 290B,A00,098060,Roberts; Justin Deritter,12,0,15,3
1668552195757,MATH 292,A00,098061,Belmont; Eva Kinoshita,10,0,10,0
1668552196187,MATH 295,A00,098062,Suk; Andrew Hoon,47,0,50,3
1668552196613,MATH 296,A00,098063,Novak; Jonathan I,20,0,20,0
1668552197046,MATH 297,001,098064,Gamst; Anthony Collins,9997,0,9999,2
1668552704053,COGS 205,A00,101395,Chiba; Andrea,19,0,20,1
1668552704477,COGS 210B,001,101404,Greene; Deanna Jacquelyn,9998,0,9999,1
1668552704477,COGS 210B,002,101417,Xia; Haijun,9999,0,9999,0
1668552704477,COGS 210B,003,101422,Nitz; Douglas A.,9999,0,9999,0
1668552704477,COGS 210B,004,101423,Hollan; James D.,9998,0,9999,1
1668552704477,COGS 210B,005,101424,Deak; Gedeon O.,9998,0,9999,1
1668552704477,COGS 210B,006,101425,Rossano; Federico,9999,0,9999,0
1668552704903,COGS 211B,A00,101427,Coulson; Seana M,9996,0,9999,3
1668552705328,COGS 220,A00,101428,Hollan; James D.,0,16,25,25
1668552705825,COGS 229,A00,101429,Dow; Steven P,17,0,25,8
1668552706249,COGS 230,A00,101430,Klemmer; Scott R,6,0,17,11
1668552706684,COGS 234,A00,101431,Xia; Haijun,0,1,25,25
1668552707111,COGS 260,A00,101432,Kiyonaga; Anastasia,21,0,25,4
1668552707111,COGS 260,B00,101433,Kirsh; David Joel,15,0,25,10
1668552707542,CSE 202,A00,102371,Impagliazzo; Russell,0,70,0,0
1668552707964,CSE 203B,A01,102373,Cheng; Chung Kuan,0,64,0,0
1668552708389,CSE 208,A00,102374,Micciancio; Daniele,0,5,0,0
1668552708811,CSE 209A,A00,112895,Impagliazzo; Russell,0,13,15,15
1668552709244,CSE 209B,A00,108005,Bellare; Mihir,0,7,0,0
1668552709669,CSE 210,A00,113163,Coblenz; Michael J,0,91,0,0
1668552710097,CSE 219,A00,106111,Dow; Steven P,0,8,20,20
1668552710601,CSE 221,A00,102376,Voelker; Geoffrey M.,0,76,0,0
1668552711025,CSE 224,A01,102378,Porter; George M,0,174,0,0
1668552711460,CSE 229A,A00,102379,Savage; Stefan,0,11,0,0
1668552711887,CSE 229C,A00,102380,Munyaka; Imani N. S.,0,10,0,0
1668552712317,CSE 232B,A00,102382,Deutsch; Alin Bernard,0,38,0,0
1668552712748,CSE 234,A01,112904,Kumar; Arun Kumar,0,0,0,0
1668552713182,CSE 237A,A00,102383,Rosing; Tajana Simunic,0,56,0,0
1668552713605,CSE 239A,A00,102384,Deutsch; Alin Bernard,0,16,0,0
1668552714027,CSE 239B,A00,102385,Polikarpova; Nadezhda,0,11,0,0
1668552714452,CSE 240A,A00,102386,Pannuto; Patrick William,0,47,0,0
1668552714876,CSE 240B,A00,102387,Zhao; Jishen,0,50,0,0
1668552715310,CSE 241A,A00,106406,Kang; Mingu,0,9,0,0
1668552715736,CSE 249B,A00,102388,Kahng; Andrew Byun,0,5,8,8
1668552716159,CSE 251B,A01,102392,Cottrell; Garrison W,0,52,0,0
1668552716159,CSE 251B,A02,102393,Cottrell; Garrison W,0,35,0,0
1668552716587,CSE 252B,A00,102394,Ochoa; Benjamin Lawrence,0,63,0,0
1668552717008,CSE 257,A01,102396,Gao; Sicun,0,153,0,0
1668552717434,CSE 272,A00,102397,Li; Tzumao,0,21,0,0
1668552717865,CSE 274,A00,111323,Chern; Albert Ren-Haur,0,16,0,0
1668552718288,CSE 282,A00,102398,Pevzner; Pavel Arkadjevich,0,0,0,0
1668552718720,CSE 284,A00,114175,Gymrek; Melissa Ann,0,29,0,0
1668552719147,CSE 290,A00,102399,Chandraker; Manmohan Krishna,0,11,0,0
1668552719147,CSE 290,B00,102400,Vaccaro; Kristen Marie,0,8,25,25
1668552719147,CSE 290,C00,102414,Pannuto; Patrick William,0,1,25,25
1668552719147,CSE 290,D00,102427,Pevzner; Pavel Arkadjevich,0,0,0,0
1668552719147,CSE 290,E00,102429,Zhao; Jishen,0,6,0,0
1668552719147,CSE 290,F00,102436,Tullsen; Dean Michael,0,6,0,0
1668552719147,CSE 290,G00,102440,Christensen; Henrik I,0,6,20,20
1668552719578,CSE 291,A00,102443,Su; Hao,0,0,0,0
1668552719578,CSE 291,B00,102448,Polikarpova; Nadezhda,0,0,0,0
1668552719578,CSE 291,C00,102453,Vaccaro; Kristen Marie,0,0,0,0
1668552719578,CSE 291,D00,111343,Savage; Stefan,0,0,0,0
1668552719578,CSE 291,E00,116474,Claffy; Kimberly Claire,0,0,0,0
1668552719578,CSE 291,F00,116479,Pasquale; Joseph,0,0,0,0
1668552720005,CSE 293,001,119111,Bafna; Vineet,9999,0,9999,0
1668552720005,CSE 293,002,119118,Bellare; Mihir,9999,0,9999,0
1668552720005,CSE 293,003,119122,Berg-Kirkpatrick; Taylor D,9999,0,9999,0
1668552720005,CSE 293,004,119135,Christensen; Henrik I,9999,0,9999,0
1668552720005,CSE 293,005,119142,Cottrell; Garrison W,9999,0,9999,0
1668552720005,CSE 293,006,119146,Deutsch; Alin Bernard,9999,0,9999,0
1668552720005,CSE 293,007,119159,Esmaeilzadeh; Hadi,9999,0,9999,0
1668552720005,CSE 293,008,119166,Freund; Yoav,9999,0,9999,0
1668552720005,CSE 293,009,119170,Griswold; William G.,9999,0,9999,0
1668552720005,CSE 293,010,119183,Gymrek; Melissa Ann,9999,0,9999,0
1668552720005,CSE 293,011,119190,Heninger; Nadia A,9999,0,9999,0
1668552720005,CSE 293,012,119230,Impagliazzo; Russell,9999,0,9999,0
1668552720005,CSE 293,013,119232,Jhala; Ranjit,9999,0,9999,0
1668552720005,CSE 293,014,119233,Kahng; Andrew Byun,9999,0,9999,0
1668552720005,CSE 293,015,119298,Kane; Daniel Mertz,9999,0,9999,0
1668552720005,CSE 293,016,119299,Kriegman; David J,9999,0,9999,0
1668552720005,CSE 293,017,119300,Kumar; Arun Kumar,9999,0,9999,0
1668552720005,CSE 293,018,119301,Lerner; Sorin,9999,0,9999,0
1668552720005,CSE 293,019,119302,Lovett; Shachar,9999,0,9999,0
1668552720005,CSE 293,020,119303,McAuley; Julian John,9999,0,9999,0
1668552720005,CSE 293,021,119304,Micciancio; Daniele,9999,0,9999,0
1668552720005,CSE 293,022,119367,Orailoglu; Alex,9999,0,9999,0
1668552720005,CSE 293,023,119382,Paturi; Ramamohan,9999,0,9999,0
1668552720005,CSE 293,024,119404,Polikarpova; Nadezhda,9999,0,9999,0
1668552720005,CSE 293,025,119406,Politz; Joseph Gibbs,9999,0,9999,0
1668552720005,CSE 293,026,119411,Porter; George M,9999,0,9999,0
1668552720005,CSE 293,027,119414,Porter; Leonard Emerson,9999,0,9999,0
1668552720005,CSE 293,028,119416,Ramamoorthi; Ravi,9999,0,9999,0
1668552720005,CSE 293,029,119417,Sahoo; Debashis,9999,0,9999,0
1668552720005,CSE 293,030,119420,Saul; Lawrence,9999,0,9999,0
1668552720005,CSE 293,031,119421,Savage; Stefan,9999,0,9999,0
1668552720005,CSE 293,032,119425,Schulze; Jurgen P.,9999,0,9999,0
1668552720005,CSE 293,033,119426,Snoeren; Alex C.,9999,0,9999,0
1668552720005,CSE 293,034,119428,Shang; Jingbo,9999,0,9999,0
1668552720005,CSE 293,035,119430,Stefan; Deian,9999,0,9999,0
1668552720005,CSE 293,036,119431,Su; Hao,9999,0,9999,0
1668552720005,CSE 293,037,119433,Swanson; Steven James,9999,0,9999,0
1668552720005,CSE 293,038,119435,Tullsen; Dean Michael,9999,0,9999,0
1668552720005,CSE 293,039,119483,Voelker; Geoffrey M.,9999,0,9999,0
1668552720005,CSE 293,040,119537,Zhao; Jishen,9999,0,9999,0
1668552720005,CSE 293,041,119538,Zhou; Yuan-Yuan,9999,0,9999,0
1668552720005,CSE 293,042,119539,Gao; Sicun,9999,0,9999,0
1668552720005,CSE 293,043,119540,Weibel; Nadir,9999,0,9999,0
1668552720005,CSE 293,044,119541,Gupta; Rajesh K.,9999,0,9999,0
1668552720005,CSE 293,045,126410,Vaccaro; Kristen Marie,9999,0,9999,0
1668552720005,CSE 293,046,126411,Klemke; Richard,9999,0,9999,0
1668552720438,CSE 294,A00,102459,Voelker; Geoffrey M.,0,2,0,0
1668552720438,CSE 294,B00,111322,Orailoglu; Alex,0,2,0,0
1668552720869,DSE 201,A00,096914,Deutsch; Alin Bernard,30,0,30,0
1668552721297,DSE 210,A00,096915,Dasgupta; Sanjoy,30,0,30,0
1668552721724,DSE 260A,A00,096916,Altintas De Callaf; Ilkay,30,0,30,0
1668552722163,ECE 200,001,103586,Antipa; Nicholas A,9999,0,9999,0
1668552722163,ECE 200,002,103587,Atanasov; Nikolay A.,9999,0,9999,0
1668552722163,ECE 200,003,103588,Bharadia; Dinesh,9999,0,9999,0
1668552722163,ECE 200,004,103589,Cheng; Chung Kuan,9999,0,9999,0
1668552722163,ECE 200,005,103590,Cosman; Pamela C.,9999,0,9999,0
1668552722163,ECE 200,006,103591,Dayeh; Shadi Ahmad,9999,0,9999,0
1668552722163,ECE 200,007,103592,Fainman; Yeshaiahu,9999,0,9999,0
1668552722163,ECE 200,008,103593,Ford; Joseph Earl,9999,0,9999,0
1668552722163,ECE 200,009,103594,Franceschetti; Massimo,9999,0,9999,0
1668552722163,ECE 200,010,103595,Fullerton; Eric E,9999,0,9999,0
1668552722163,ECE 200,011,103596,Galton; Ian A,9999,0,9999,0
1668552722163,ECE 200,012,103597,Gilja; Vikash,9999,0,9999,0
1668552722163,ECE 200,013,103598,Hall; Drew A.,9999,0,9999,0
1668552722163,ECE 200,014,103599,Hsueh; Tzu-Chien,9999,0,9999,0
1668552722163,ECE 200,015,103600,Javidi; Tara,9999,0,9999,0
1668552722163,ECE 200,016,103601,Kahng; Andrew Byun,9999,0,9999,0
1668552722163,ECE 200,017,103602,Kim; Young-Han,9999,0,9999,0
1668552722163,ECE 200,018,103603,Koushanfar; Farinaz,9999,0,9999,0
1668552722163,ECE 200,019,103604,Kuzum; Duygu,9999,0,9999,0
1668552722163,ECE 200,020,103605,Le; Hanh-Phuc,9999,0,9999,0
1668552722163,ECE 200,021,103606,Lin; Bill,9999,0,9999,0
1668552722163,ECE 200,022,103607,Liu; Zhaowei,9998,0,9999,1
1668552722163,ECE 200,023,103608,Lo; Yu-Hwa,9999,0,9999,0
1668552722163,ECE 200,024,103609,Lomakin; Vitaliy,9999,0,9999,0
1668552722163,ECE 200,025,103610,Mercier; Patrick Philip,9999,0,9999,0
1668552722163,ECE 200,026,103611,Meyer; Florian,9999,0,9999,0
1668552722163,ECE 200,027,103612,Milstein; Laurence B.,9999,0,9999,0
1668552722163,ECE 200,028,103613,Mir Arabbaygi; Siavash,9999,0,9999,0
1668552722163,ECE 200,029,103614,Mookherjea; Shayan,9999,0,9999,0
1668552722163,ECE 200,030,103615,Morris; Karcher William,9999,0,9999,0
1668552722163,ECE 200,031,103616,Ng; Tse Nga,9999,0,9999,0
1668552722163,ECE 200,032,103617,Nguyen; Truong Quang,9999,0,9999,0
1668552722163,ECE 200,033,103618,Nomura; Kenji,9999,0,9999,0
1668552722163,ECE 200,034,103619,Orlitsky; Alon,9999,0,9999,0
1668552722163,ECE 200,035,103620,Pal; Piya,9999,0,9999,0
1668552722163,ECE 200,036,103621,Papen; George C.,9999,0,9999,0
1668552722163,ECE 200,037,103622,Radic; Stojan,9999,0,9999,0
1668552722163,ECE 200,038,103623,Rao; Bhaskar D.,9999,0,9999,0
1668552722163,ECE 200,039,103624,Rao; Ramesh R,9999,0,9999,0
1668552722163,ECE 200,040,103625,Rebeiz; Gabriel,9999,0,9999,0
1668552722163,ECE 200,041,103626,Sanford; John R,9999,0,9999,0
1668552722163,ECE 200,042,103627,Siegel; Paul H.,9999,0,9999,0
1668552722163,ECE 200,043,103628,Sievenpiper; Daniel F.,9999,0,9999,0
1668552722163,ECE 200,044,103629,Sworder; David D.,9999,0,9999,0
1668552722163,ECE 200,045,103630,Taur; Yuan,9999,0,9999,0
1668552722163,ECE 200,046,103631,Touri; Behrouz,9999,0,9999,0
1668552722163,ECE 200,047,103632,Trivedi; Mohan M.,9999,0,9999,0
1668552722163,ECE 200,048,103633,Vasconcelos; Nuno,9999,0,9999,0
1668552722163,ECE 200,049,103634,Wang; Xiaolong,9999,0,9999,0
1668552722163,ECE 200,050,103635,Xie; Pengtao,9999,0,9999,0
1668552722163,ECE 200,051,103636,Yip; Michael,9999,0,9999,0
1668552722163,ECE 200,052,103637,Zeger; Kenneth A.,999,0,999,0
1668552722163,ECE 200,053,103638,Zhang; Xinyu,9999,0,9999,0
1668552722163,ECE 200,054,103639,Turakhia; Yatish Girish,9999,0,9999,0
1668552722163,ECE 200,055,103640,Kang; Mingu,9999,0,9999,0
1668552722163,ECE 200,056,103641,Shi; Yuanyuan,9999,0,9999,0
1668552722163,ECE 200,057,103642,Wang; Edward Jay,9999,0,9999,0
1668552722163,ECE 200,058,103643,Zheng; Yang,9999,0,9999,0
1668552722588,ECE 202,A00,103644,Kuzum; Duygu,0,45,0,0
1668552723018,ECE 212BN,A00,103646,Ng; Tse Nga,0,9,0,0
1668552723445,ECE 221,A00,111493,Staff,0,0,0,0
1668552723871,ECE 222B,A00,103647,Lomakin; Vitaliy,0,20,0,0
1668552724311,ECE 230B,A00,103648,Taur; Yuan,0,4,0,0
1668552724747,ECE 238B,A00,103649,Garay; Javier,0,0,0,0
1668552725170,ECE 240B,A00,112900,Fainman; Yeshaiahu,0,7,0,0
1668552725601,ECE 247A,A00,103650,Jokerst; Jesse Vincent,0,6,0,0
1668552726022,ECE 247B,A00,103651,Wang; Joseph,0,14,0,0
1668552726459,ECE 250,A00,103652,Siegel; Paul H.,0,82,0,0
1668552726890,ECE 251A,A00,103654,Rao; Bhaskar D.,0,63,0,0
1668552727323,ECE 257B,A00,103655,Bharadia; Dinesh,0,33,0,0
1668552727751,ECE 258A,A00,103656,Milstein; Laurence B.,0,28,0,0
1668552728185,ECE 260B,A00,103658,Kang; Mingu,0,123,0,0
1668552728621,ECE 264A,A00,103659,Galton; Ian A,0,72,0,0
1668552729058,ECE 265A,A00,103661,Gudem; Prasad S.S.,0,74,0,0
1668552729492,ECE 265D,A00,103662,Gudem; Prasad S.S.,0,26,0,0
1668552729929,ECE 268,A00,103663,Koushanfar; Farinaz,0,43,0,0
1668552730365,ECE 269,A01,103665,Pal; Piya,0,220,0,0
1668552730812,ECE 271B,A00,103666,Vasconcelos; Manuela,0,78,0,0
1668552731239,ECE 276A,A00,103667,Atanasov; Nikolay A.,0,126,0,0
1668552731666,ECE 277,A00,103668,An; Cheolhong,0,151,0,0
1668552732108,ECE 279,A00,117947,Hall; Drew A.,0,22,0,0
1668552732956,ECE 283,A00,103670,Hsueh; Tzu-Chien,0,57,0,0
1668552733388,ECE 284,A00,103671,Turakhia; Yatish Girish,0,40,0,0
1668552733835,ECE 285,A00,103672,Zheng; Yang,0,40,0,0
1668552733835,ECE 285,B00,103673,Sworder; David D.,0,61,0,0
1668552734265,ECE 287,A00,103676,Javidi; Tara,0,8,0,0
1668552734694,MATH 200B,A00,098023,Salehi Golsefidy; Alireza,10,0,15,5
1668552735125,MATH 202B,A00,098024,Rhoades; Brendon Patrick,7,0,15,8
1668552735561,MATH 203B,A00,098025,Oprea; Dragos N.,9,0,15,6
1668552735999,MATH 204B,A00,098026,Sorensen; Claus M,13,0,15,2
1668552736429,MATH 208,A00,098027,Izadi; Elham,7,0,10,3
1668552736862,MATH 209,A00,098028,Pollack; Aaron,10,0,10,0
1668552737300,MATH 211A,A00,112919,Rogalski; Daniel,8,0,10,2
1668552737724,MATH 211B,A00,112920,Seward; Brandon M.,9,0,10,1
1668552738228,MATH 218,A00,098029,Li; Bo,10,0,10,0
1668552738662,MATH 220B,A00,098030,Novak; Jonathan I,11,0,15,4
1668552739088,MATH 221A,A00,098031,Ebenfelt; Peter F,12,0,15,3
1668552739515,MATH 231B,A00,098032,Zlatos; Andrej,10,0,15,5
1668552739947,MATH 240B,A00,098033,Ni; Lei,7,0,15,8
1668552740382,MATH 243,A00,098034,Jekel; David Andrew,10,0,10,0
1668552740807,MATH 245A,A00,098035,Nie; Jiawang,0,5,15,18
1668552741231,MATH 248,A00,098036,Bejenaru; Ioan,10,0,10,0
1668552741653,MATH 250B,A00,098037,Spolaor; Luca,14,0,15,1
1668552742079,MATH 258,A00,098038,Ni; Lei,9,0,10,1
1668552742509,MATH 264B,A00,098041,Rhoades; Brendon Patrick,8,0,15,7
1668552742935,MATH 268,A00,098042,Buss; Samuel R,10,0,10,0
1668552743359,MATH 269,A00,098043,Rhoades; Brendon Patrick,10,0,10,0
1668552743792,MATH 270B,A00,098044,Li; Bo,6,0,15,9
1668552744216,MATH 272B,A00,098045,Holst; Michael J,13,0,15,2
1668552744654,MATH 273A,A00,098046,Tian; Xiaochuan,10,0,15,5
1668552745092,MATH 275,A01,098048,Tian; Xiaochuan,6,0,10,4
1668552745531,MATH 278A,A00,098049,Holst; Michael J,6,0,10,4
1668552745966,MATH 278B,A00,098050,Cloninger; Alexander,10,0,10,0
1668552746391,MATH 278C,A00,098051,Nie; Jiawang,5,0,10,5
1668552746819,MATH 280B,A00,098052,Zheng; Tianyi,7,0,15,8
1668552747243,MATH 281B,A00,098053,Bradic; Jelena,0,2,15,15
1668552747671,MATH 282B,A00,098054,Arias-Castro; Ery,0,1,15,15
1668552748096,MATH 285,A00,098055,Fitzsimmons; Patrick J,0,4,15,17
1668552748517,MATH 287B,A00,098056,Arias-Castro; Ery,1,0,15,14
1668552748939,MATH 288,A00,098057,Agarwal; Pooja,9,0,10,1
1668552748939,MATH 288,B00,098058,Zhang; Danna,8,0,10,2
1668552748939,MATH 288,C00,098059,Williams; Ruth J,9,0,10,1
1668552749472,MATH 290B,A00,098060,Roberts; Justin Deritter,12,0,15,3
1668552749908,MATH 292,A00,098061,Belmont; Eva Kinoshita,10,0,10,0
1668552750330,MATH 295,A00,098062,Suk; Andrew Hoon,47,0,50,3
1668552750754,MATH 296,A00,098063,Novak; Jonathan I,20,0,20,0
1668552751183,MATH 297,001,098064,Gamst; Anthony Collins,9997,0,9999,2
1668553268587,COGS 205,A00,101395,Chiba; Andrea,19,0,20,1
1668553269021,COGS 210B,001,101404,Greene; Deanna Jacquelyn,9998,0,9999,1
1668553269021,COGS 210B,002,101417,Xia; Haijun,9999,0,9999,0
1668553269021,COGS 210B,003,101422,Nitz; Douglas A.,9999,0,9999,0
1668553269021,COGS 210B,004,101423,Hollan; James D.,9998,0,9999,1
1668553269021,COGS 210B,005,101424,Deak; Gedeon O.,9998,0,9999,1
1668553269021,COGS 210B,006,101425,Rossano; Federico,9999,0,9999,0
1668553269446,COGS 211B,A00,101427,Coulson; Seana M,9996,0,9999,3
1668553269867,COGS 220,A00,101428,Hollan; James D.,0,16,25,25
1668553270300,COGS 229,A00,101429,Dow; Steven P,17,0,25,8
1668553270729,COGS 230,A00,101430,Klemmer; Scott R,6,0,17,11
1668553271156,COGS 234,A00,101431,Xia; Haijun,0,1,25,25
1668553271579,COGS 260,A00,101432,Kiyonaga; Anastasia,21,0,25,4
1668553271579,COGS 260,B00,101433,Kirsh; David Joel,15,0,25,10
1668553272017,CSE 202,A00,102371,Impagliazzo; Russell,0,70,0,0
1668553272440,CSE 203B,A01,102373,Cheng; Chung Kuan,0,66,0,0
1668553272880,CSE 208,A00,102374,Micciancio; Daniele,0,5,0,0
1668553273302,CSE 209A,A00,112895,Impagliazzo; Russell,0,13,15,15
1668553273727,CSE 209B,A00,108005,Bellare; Mihir,0,7,0,0
1668553274155,CSE 210,A00,113163,Coblenz; Michael J,0,92,0,0
1668553274578,CSE 219,A00,106111,Dow; Steven P,0,8,20,20
1668553275003,CSE 221,A00,102376,Voelker; Geoffrey M.,0,76,0,0
1668553275430,CSE 224,A01,102378,Porter; George M,0,176,0,0
1668553275854,CSE 229A,A00,102379,Savage; Stefan,0,11,0,0
1668553276282,CSE 229C,A00,102380,Munyaka; Imani N. S.,0,10,0,0
1668553276705,CSE 232B,A00,102382,Deutsch; Alin Bernard,0,38,0,0
1668553277131,CSE 234,A01,112904,Kumar; Arun Kumar,0,0,0,0
1668553277558,CSE 237A,A00,102383,Rosing; Tajana Simunic,0,56,0,0
1668553277980,CSE 239A,A00,102384,Deutsch; Alin Bernard,0,16,0,0
1668553278409,CSE 239B,A00,102385,Polikarpova; Nadezhda,0,11,0,0
1668553278833,CSE 240A,A00,102386,Pannuto; Patrick William,0,48,0,0
1668553279266,CSE 240B,A00,102387,Zhao; Jishen,0,50,0,0
1668553279690,CSE 241A,A00,106406,Kang; Mingu,0,9,0,0
1668553280129,CSE 249B,A00,102388,Kahng; Andrew Byun,0,5,8,8
1668553280558,CSE 251B,A01,102392,Cottrell; Garrison W,0,52,0,0
1668553280558,CSE 251B,A02,102393,Cottrell; Garrison W,0,35,0,0
1668553280982,CSE 252B,A00,102394,Ochoa; Benjamin Lawrence,0,63,0,0
1668553281407,CSE 257,A01,102396,Gao; Sicun,0,154,0,0
1668553281834,CSE 272,A00,102397,Li; Tzumao,0,22,0,0
1668553282260,CSE 274,A00,111323,Chern; Albert Ren-Haur,0,16,0,0
1668553282685,CSE 282,A00,102398,Pevzner; Pavel Arkadjevich,0,0,0,0
1668553283112,CSE 284,A00,114175,Gymrek; Melissa Ann,0,30,0,0
1668553283543,CSE 290,A00,102399,Chandraker; Manmohan Krishna,0,11,0,0
1668553283543,CSE 290,B00,102400,Vaccaro; Kristen Marie,0,8,25,25
1668553283543,CSE 290,C00,102414,Pannuto; Patrick William,0,1,25,25
1668553283543,CSE 290,D00,102427,Pevzner; Pavel Arkadjevich,0,0,0,0
1668553283543,CSE 290,E00,102429,Zhao; Jishen,0,6,0,0
1668553283543,CSE 290,F00,102436,Tullsen; Dean Michael,0,6,0,0
1668553283543,CSE 290,G00,102440,Christensen; Henrik I,0,6,20,20
1668553283977,CSE 291,A00,102443,Su; Hao,0,0,0,0
1668553283977,CSE 291,B00,102448,Polikarpova; Nadezhda,0,0,0,0
1668553283977,CSE 291,C00,102453,Vaccaro; Kristen Marie,0,0,0,0
1668553283977,CSE 291,D00,111343,Savage; Stefan,0,0,0,0
1668553283977,CSE 291,E00,116474,Claffy; Kimberly Claire,0,0,0,0
1668553283977,CSE 291,F00,116479,Pasquale; Joseph,0,0,0,0
1668553284405,CSE 293,001,119111,Bafna; Vineet,9999,0,9999,0
1668553284405,CSE 293,002,119118,Bellare; Mihir,9999,0,9999,0
1668553284405,CSE 293,003,119122,Berg-Kirkpatrick; Taylor D,9999,0,9999,0
1668553284405,CSE 293,004,119135,Christensen; Henrik I,9999,0,9999,0
1668553284405,CSE 293,005,119142,Cottrell; Garrison W,9999,0,9999,0
1668553284405,CSE 293,006,119146,Deutsch; Alin Bernard,9999,0,9999,0
1668553284405,CSE 293,007,119159,Esmaeilzadeh; Hadi,9999,0,9999,0
1668553284405,CSE 293,008,119166,Freund; Yoav,9999,0,9999,0
1668553284405,CSE 293,009,119170,Griswold; William G.,9999,0,9999,0
1668553284405,CSE 293,010,119183,Gymrek; Melissa Ann,9999,0,9999,0
1668553284405,CSE 293,011,119190,Heninger; Nadia A,9999,0,9999,0
1668553284405,CSE 293,012,119230,Impagliazzo; Russell,9999,0,9999,0
1668553284405,CSE 293,013,119232,Jhala; Ranjit,9999,0,9999,0
1668553284405,CSE 293,014,119233,Kahng; Andrew Byun,9999,0,9999,0
1668553284405,CSE 293,015,119298,Kane; Daniel Mertz,9999,0,9999,0
1668553284405,CSE 293,016,119299,Kriegman; David J,9999,0,9999,0
1668553284405,CSE 293,017,119300,Kumar; Arun Kumar,9999,0,9999,0
1668553284405,CSE 293,018,119301,Lerner; Sorin,9999,0,9999,0
1668553284405,CSE 293,019,119302,Lovett; Shachar,9999,0,9999,0
1668553284405,CSE 293,020,119303,McAuley; Julian John,9999,0,9999,0
1668553284405,CSE 293,021,119304,Micciancio; Daniele,9999,0,9999,0
1668553284405,CSE 293,022,119367,Orailoglu; Alex,9999,0,9999,0
1668553284405,CSE 293,023,119382,Paturi; Ramamohan,9999,0,9999,0
1668553284405,CSE 293,024,119404,Polikarpova; Nadezhda,9999,0,9999,0
1668553284405,CSE 293,025,119406,Politz; Joseph Gibbs,9999,0,9999,0
1668553284405,CSE 293,026,119411,Porter; George M,9999,0,9999,0
1668553284405,CSE 293,027,119414,Porter; Leonard Emerson,9999,0,9999,0
1668553284405,CSE 293,028,119416,Ramamoorthi; Ravi,9999,0,9999,0
1668553284405,CSE 293,029,119417,Sahoo; Debashis,9999,0,9999,0
1668553284405,CSE 293,030,119420,Saul; Lawrence,9999,0,9999,0
1668553284405,CSE 293,031,119421,Savage; Stefan,9999,0,9999,0
1668553284405,CSE 293,032,119425,Schulze; Jurgen P.,9999,0,9999,0
1668553284405,CSE 293,033,119426,Snoeren; Alex C.,9999,0,9999,0
1668553284405,CSE 293,034,119428,Shang; Jingbo,9999,0,9999,0
1668553284405,CSE 293,035,119430,Stefan; Deian,9999,0,9999,0
1668553284405,CSE 293,036,119431,Su; Hao,9999,0,9999,0
1668553284405,CSE 293,037,119433,Swanson; Steven James,9999,0,9999,0
1668553284405,CSE 293,038,119435,Tullsen; Dean Michael,9999,0,9999,0
1668553284405,CSE 293,039,119483,Voelker; Geoffrey M.,9999,0,9999,0
1668553284405,CSE 293,040,119537,Zhao; Jishen,9999,0,9999,0
1668553284405,CSE 293,041,119538,Zhou; Yuan-Yuan,9999,0,9999,0
1668553284405,CSE 293,042,119539,Gao; Sicun,9999,0,9999,0
1668553284405,CSE 293,043,119540,Weibel; Nadir,9999,0,9999,0
1668553284405,CSE 293,044,119541,Gupta; Rajesh K.,9999,0,9999,0
1668553284405,CSE 293,045,126410,Vaccaro; Kristen Marie,9999,0,9999,0
1668553284405,CSE 293,046,126411,Klemke; Richard,9999,0,9999,0
1668553284828,CSE 294,A00,102459,Voelker; Geoffrey M.,0,2,0,0
1668553284828,CSE 294,B00,111322,Orailoglu; Alex,0,2,0,0
1668553285348,DSE 201,A00,096914,Deutsch; Alin Bernard,30,0,30,0
1668553285776,DSE 210,A00,096915,Dasgupta; Sanjoy,30,0,30,0
1668553286205,DSE 260A,A00,096916,Altintas De Callaf; Ilkay,30,0,30,0
1668553286684,ECE 200,001,103586,Antipa; Nicholas A,9999,0,9999,0
1668553286684,ECE 200,002,103587,Atanasov; Nikolay A.,9999,0,9999,0
1668553286684,ECE 200,003,103588,Bharadia; Dinesh,9999,0,9999,0
1668553286684,ECE 200,004,103589,Cheng; Chung Kuan,9999,0,9999,0
1668553286684,ECE 200,005,103590,Cosman; Pamela C.,9999,0,9999,0
1668553286684,ECE 200,006,103591,Dayeh; Shadi Ahmad,9999,0,9999,0
1668553286684,ECE 200,007,103592,Fainman; Yeshaiahu,9999,0,9999,0
1668553286684,ECE 200,008,103593,Ford; Joseph Earl,9999,0,9999,0
1668553286684,ECE 200,009,103594,Franceschetti; Massimo,9999,0,9999,0
1668553286684,ECE 200,010,103595,Fullerton; Eric E,9999,0,9999,0
1668553286684,ECE 200,011,103596,Galton; Ian A,9999,0,9999,0
1668553286684,ECE 200,012,103597,Gilja; Vikash,9999,0,9999,0
1668553286684,ECE 200,013,103598,Hall; Drew A.,9999,0,9999,0
1668553286684,ECE 200,014,103599,Hsueh; Tzu-Chien,9999,0,9999,0
1668553286684,ECE 200,015,103600,Javidi; Tara,9999,0,9999,0
1668553286684,ECE 200,016,103601,Kahng; Andrew Byun,9999,0,9999,0
1668553286684,ECE 200,017,103602,Kim; Young-Han,9999,0,9999,0
1668553286684,ECE 200,018,103603,Koushanfar; Farinaz,9999,0,9999,0
1668553286684,ECE 200,019,103604,Kuzum; Duygu,9999,0,9999,0
1668553286684,ECE 200,020,103605,Le; Hanh-Phuc,9999,0,9999,0
1668553286684,ECE 200,021,103606,Lin; Bill,9999,0,9999,0
1668553286684,ECE 200,022,103607,Liu; Zhaowei,9998,0,9999,1
1668553286684,ECE 200,023,103608,Lo; Yu-Hwa,9999,0,9999,0
1668553286684,ECE 200,024,103609,Lomakin; Vitaliy,9999,0,9999,0
1668553286684,ECE 200,025,103610,Mercier; Patrick Philip,9999,0,9999,0
1668553286684,ECE 200,026,103611,Meyer; Florian,9999,0,9999,0
1668553286684,ECE 200,027,103612,Milstein; Laurence B.,9999,0,9999,0
1668553286684,ECE 200,028,103613,Mir Arabbaygi; Siavash,9999,0,9999,0
1668553286684,ECE 200,029,103614,Mookherjea; Shayan,9999,0,9999,0
1668553286684,ECE 200,030,103615,Morris; Karcher William,9999,0,9999,0
1668553286684,ECE 200,031,103616,Ng; Tse Nga,9999,0,9999,0
1668553286684,ECE 200,032,103617,Nguyen; Truong Quang,9999,0,9999,0
1668553286684,ECE 200,033,103618,Nomura; Kenji,9999,0,9999,0
1668553286684,ECE 200,034,103619,Orlitsky; Alon,9999,0,9999,0
1668553286684,ECE 200,035,103620,Pal; Piya,9999,0,9999,0
1668553286684,ECE 200,036,103621,Papen; George C.,9999,0,9999,0
1668553286684,ECE 200,037,103622,Radic; Stojan,9999,0,9999,0
1668553286684,ECE 200,038,103623,Rao; Bhaskar D.,9999,0,9999,0
1668553286684,ECE 200,039,103624,Rao; Ramesh R,9999,0,9999,0
1668553286684,ECE 200,040,103625,Rebeiz; Gabriel,9999,0,9999,0
1668553286684,ECE 200,041,103626,Sanford; John R,9999,0,9999,0
1668553286684,ECE 200,042,103627,Siegel; Paul H.,9999,0,9999,0
1668553286684,ECE 200,043,103628,Sievenpiper; Daniel F.,9999,0,9999,0
1668553286684,ECE 200,044,103629,Sworder; David D.,9999,0,9999,0
1668553286684,ECE 200,045,103630,Taur; Yuan,9999,0,9999,0
1668553286684,ECE 200,046,103631,Touri; Behrouz,9999,0,9999,0
1668553286684,ECE 200,047,103632,Trivedi; Mohan M.,9999,0,9999,0
1668553286684,ECE 200,048,103633,Vasconcelos; Nuno,9999,0,9999,0
1668553286684,ECE 200,049,103634,Wang; Xiaolong,9999,0,9999,0
1668553286684,ECE 200,050,103635,Xie; Pengtao,9999,0,9999,0
1668553286684,ECE 200,051,103636,Yip; Michael,9999,0,9999,0
1668553286684,ECE 200,052,103637,Zeger; Kenneth A.,999,0,999,0
1668553286684,ECE 200,053,103638,Zhang; Xinyu,9999,0,9999,0
1668553286684,ECE 200,054,103639,Turakhia; Yatish Girish,9999,0,9999,0
1668553286684,ECE 200,055,103640,Kang; Mingu,9999,0,9999,0
1668553286684,ECE 200,056,103641,Shi; Yuanyuan,9999,0,9999,0
1668553286684,ECE 200,057,103642,Wang; Edward Jay,9999,0,9999,0
1668553286684,ECE 200,058,103643,Zheng; Yang,9999,0,9999,0
1668553287115,ECE 202,A00,103644,Kuzum; Duygu,0,45,0,0
1668553287559,ECE 212BN,A00,103646,Ng; Tse Nga,0,9,0,0
1668553287991,ECE 221,A00,111493,Staff,0,0,0,0
1668553288419,ECE 222B,A00,103647,Lomakin; Vitaliy,0,20,0,0
1668553288860,ECE 230B,A00,103648,Taur; Yuan,0,4,0,0
1668553289296,ECE 238B,A00,103649,Garay; Javier,0,0,0,0
1668553289731,ECE 240B,A00,112900,Fainman; Yeshaiahu,0,7,0,0
1668553290157,ECE 247A,A00,103650,Jokerst; Jesse Vincent,0,6,0,0
1668553290593,ECE 247B,A00,103651,Wang; Joseph,0,14,0,0
1668553291034,ECE 250,A00,103652,Siegel; Paul H.,0,82,0,0
1668553291460,ECE 251A,A00,103654,Rao; Bhaskar D.,0,63,0,0
1668553291887,ECE 257B,A00,103655,Bharadia; Dinesh,0,33,0,0
1668553292310,ECE 258A,A00,103656,Milstein; Laurence B.,0,28,0,0
1668553292736,ECE 260B,A00,103658,Kang; Mingu,0,123,0,0
1668553293179,ECE 264A,A00,103659,Galton; Ian A,0,73,0,0
1668553293606,ECE 265A,A00,103661,Gudem; Prasad S.S.,0,74,0,0
1668553294032,ECE 265D,A00,103662,Gudem; Prasad S.S.,0,26,0,0
1668553294459,ECE 268,A00,103663,Koushanfar; Farinaz,0,43,0,0
1668553294889,ECE 269,A01,103665,Pal; Piya,0,220,0,0
1668553295320,ECE 271B,A00,103666,Vasconcelos; Manuela,0,78,0,0
1668553295742,ECE 276A,A00,103667,Atanasov; Nikolay A.,0,126,0,0
1668553296172,ECE 277,A00,103668,An; Cheolhong,0,151,0,0
1668553296602,ECE 279,A00,117947,Hall; Drew A.,0,22,0,0
1668553297461,ECE 283,A00,103670,Hsueh; Tzu-Chien,0,57,0,0
1668553297889,ECE 284,A00,103671,Turakhia; Yatish Girish,0,41,0,0
1668553298312,ECE 285,A00,103672,Zheng; Yang,0,40,0,0
1668553298312,ECE 285,B00,103673,Sworder; David D.,0,61,0,0
1668553298742,ECE 287,A00,103676,Javidi; Tara,0,8,0,0
1668553299164,MATH 200B,A00,098023,Salehi Golsefidy; Alireza,10,0,15,5
1668553299589,MATH 202B,A00,098024,Rhoades; Brendon Patrick,7,0,15,8
1668553300014,MATH 203B,A00,098025,Oprea; Dragos N.,9,0,15,6
1668553300437,MATH 204B,A00,098026,Sorensen; Claus M,13,0,15,2
1668553300863,MATH 208,A00,098027,Izadi; Elham,7,0,10,3
1668553301288,MATH 209,A00,098028,Pollack; Aaron,10,0,10,0
1668553301711,MATH 211A,A00,112919,Rogalski; Daniel,8,0,10,2
1668553302177,MATH 211B,A00,112920,Seward; Brandon M.,9,0,10,1
1668553302605,MATH 218,A00,098029,Li; Bo,10,0,10,0
1668553303036,MATH 220B,A00,098030,Novak; Jonathan I,11,0,15,4
1668553303459,MATH 221A,A00,098031,Ebenfelt; Peter F,12,0,15,3
1668553303882,MATH 231B,A00,098032,Zlatos; Andrej,10,0,15,5
1668553304320,MATH 240B,A00,098033,Ni; Lei,7,0,15,8
1668553304743,MATH 243,A00,098034,Jekel; David Andrew,10,0,10,0
1668553305186,MATH 245A,A00,098035,Nie; Jiawang,0,5,15,18
1668553305617,MATH 248,A00,098036,Bejenaru; Ioan,10,0,10,0
1668553306043,MATH 250B,A00,098037,Spolaor; Luca,14,0,15,1
1668553306472,MATH 258,A00,098038,Ni; Lei,9,0,10,1
1668553306896,MATH 264B,A00,098041,Rhoades; Brendon Patrick,8,0,15,7
1668553307321,MATH 268,A00,098042,Buss; Samuel R,10,0,10,0
1668553307743,MATH 269,A00,098043,Rhoades; Brendon Patrick,10,0,10,0
1668553308166,MATH 270B,A00,098044,Li; Bo,6,0,15,9
1668553308597,MATH 272B,A00,098045,Holst; Michael J,13,0,15,2
1668553309028,MATH 273A,A00,098046,Tian; Xiaochuan,10,0,15,5
1668553309496,MATH 275,A01,098048,Tian; Xiaochuan,6,0,10,4
1668553309919,MATH 278A,A00,098049,Holst; Michael J,6,0,10,4
1668553310346,MATH 278B,A00,098050,Cloninger; Alexander,10,0,10,0
1668553310768,MATH 278C,A00,098051,Nie; Jiawang,5,0,10,5
1668553311200,MATH 280B,A00,098052,Zheng; Tianyi,7,0,15,8
1668553311621,MATH 281B,A00,098053,Bradic; Jelena,0,2,15,15
1668553312050,MATH 282B,A00,098054,Arias-Castro; Ery,0,1,15,15
1668553312484,MATH 285,A00,098055,Fitzsimmons; Patrick J,0,4,15,17
1668553312915,MATH 287B,A00,098056,Arias-Castro; Ery,1,0,15,14
1668553313342,MATH 288,A00,098057,Agarwal; Pooja,9,0,10,1
1668553313342,MATH 288,B00,098058,Zhang; Danna,8,0,10,2
1668553313342,MATH 288,C00,098059,Williams; Ruth J,9,0,10,1
1668553313764,MATH 290B,A00,098060,Roberts; Justin Deritter,12,0,15,3
1668553314189,MATH 292,A00,098061,Belmont; Eva Kinoshita,10,0,10,0
1668553314613,MATH 295,A00,098062,Suk; Andrew Hoon,47,0,50,3
1668553315038,MATH 296,A00,098063,Novak; Jonathan I,20,0,20,0
1668553315472,MATH 297,001,098064,Gamst; Anthony Collins,9997,0,9999,2
1668553820607,COGS 205,A00,101395,Chiba; Andrea,19,0,20,1
1668553821036,COGS 210B,001,101404,Greene; Deanna Jacquelyn,9998,0,9999,1
1668553821036,COGS 210B,002,101417,Xia; Haijun,9999,0,9999,0
1668553821036,COGS 210B,003,101422,Nitz; Douglas A.,9999,0,9999,0
1668553821036,COGS 210B,004,101423,Hollan; James D.,9998,0,9999,1
1668553821036,COGS 210B,005,101424,Deak; Gedeon O.,9998,0,9999,1
1668553821036,COGS 210B,006,101425,Rossano; Federico,9999,0,9999,0
1668553821467,COGS 211B,A00,101427,Coulson; Seana M,9996,0,9999,3
1668553821895,COGS 220,A00,101428,Hollan; James D.,0,16,25,25
1668553822324,COGS 229,A00,101429,Dow; Steven P,17,0,25,8
1668553822766,COGS 230,A00,101430,Klemmer; Scott R,6,0,17,11
1668553823208,COGS 234,A00,101431,Xia; Haijun,0,1,25,25
1668553823632,COGS 260,A00,101432,Kiyonaga; Anastasia,21,0,25,4
1668553823632,COGS 260,B00,101433,Kirsh; David Joel,15,0,25,10
1668553824069,CSE 202,A00,102371,Impagliazzo; Russell,0,70,0,0
1668553824494,CSE 203B,A01,102373,Cheng; Chung Kuan,0,65,0,0
1668553824917,CSE 208,A00,102374,Micciancio; Daniele,0,5,0,0
1668553825368,CSE 209A,A00,112895,Impagliazzo; Russell,0,13,15,15
1668553825792,CSE 209B,A00,108005,Bellare; Mihir,0,7,0,0
1668553826219,CSE 210,A00,113163,Coblenz; Michael J,0,92,0,0
1668553826645,CSE 219,A00,106111,Dow; Steven P,0,8,20,20
1668553827070,CSE 221,A00,102376,Voelker; Geoffrey M.,0,76,0,0
1668553827494,CSE 224,A01,102378,Porter; George M,0,176,0,0
1668553827925,CSE 229A,A00,102379,Savage; Stefan,0,11,0,0
1668553828349,CSE 229C,A00,102380,Munyaka; Imani N. S.,0,10,0,0
1668553828775,CSE 232B,A00,102382,Deutsch; Alin Bernard,0,38,0,0
1668553829197,CSE 234,A01,112904,Kumar; Arun Kumar,0,0,0,0
1668553829638,CSE 237A,A00,102383,Rosing; Tajana Simunic,0,57,0,0
1668553830063,CSE 239A,A00,102384,Deutsch; Alin Bernard,0,16,0,0
1668553830486,CSE 239B,A00,102385,Polikarpova; Nadezhda,0,11,0,0
1668553830909,CSE 240A,A00,102386,Pannuto; Patrick William,0,48,0,0
1668553831332,CSE 240B,A00,102387,Zhao; Jishen,0,51,0,0
1668553831755,CSE 241A,A00,106406,Kang; Mingu,0,9,0,0
1668553832189,CSE 249B,A00,102388,Kahng; Andrew Byun,0,5,8,8
1668553832615,CSE 251B,A01,102392,Cottrell; Garrison W,0,52,0,0
1668553832615,CSE 251B,A02,102393,Cottrell; Garrison W,0,35,0,0
1668553833051,CSE 252B,A00,102394,Ochoa; Benjamin Lawrence,0,63,0,0
1668553833483,CSE 257,A01,102396,Gao; Sicun,0,154,0,0
1668553833917,CSE 272,A00,102397,Li; Tzumao,0,22,0,0
1668553834343,CSE 274,A00,111323,Chern; Albert Ren-Haur,0,16,0,0
1668553834782,CSE 282,A00,102398,Pevzner; Pavel Arkadjevich,0,0,0,0
1668553835205,CSE 284,A00,114175,Gymrek; Melissa Ann,0,31,0,0
1668553835630,CSE 290,A00,102399,Chandraker; Manmohan Krishna,0,11,0,0
1668553835630,CSE 290,B00,102400,Vaccaro; Kristen Marie,0,8,25,25
1668553835630,CSE 290,C00,102414,Pannuto; Patrick William,0,1,25,25
1668553835630,CSE 290,D00,102427,Pevzner; Pavel Arkadjevich,0,0,0,0
1668553835630,CSE 290,E00,102429,Zhao; Jishen,0,6,0,0
1668553835630,CSE 290,F00,102436,Tullsen; Dean Michael,0,6,0,0
1668553835630,CSE 290,G00,102440,Christensen; Henrik I,0,6,20,20
1668553836069,CSE 291,A00,102443,Su; Hao,0,0,0,0
1668553836069,CSE 291,B00,102448,Polikarpova; Nadezhda,0,0,0,0
1668553836069,CSE 291,C00,102453,Vaccaro; Kristen Marie,0,0,0,0
1668553836069,CSE 291,D00,111343,Savage; Stefan,0,0,0,0
1668553836069,CSE 291,E00,116474,Claffy; Kimberly Claire,0,0,0,0
1668553836069,CSE 291,F00,116479,Pasquale; Joseph,0,0,0,0
1668553836499,CSE 293,001,119111,Bafna; Vineet,9999,0,9999,0
1668553836499,CSE 293,002,119118,Bellare; Mihir,9999,0,9999,0
1668553836499,CSE 293,003,119122,Berg-Kirkpatrick; Taylor D,9999,0,9999,0
1668553836499,CSE 293,004,119135,Christensen; Henrik I,9999,0,9999,0
1668553836499,CSE 293,005,119142,Cottrell; Garrison W,9999,0,9999,0
1668553836499,CSE 293,006,119146,Deutsch; Alin Bernard,9999,0,9999,0
1668553836499,CSE 293,007,119159,Esmaeilzadeh; Hadi,9999,0,9999,0
1668553836499,CSE 293,008,119166,Freund; Yoav,9999,0,9999,0
1668553836499,CSE 293,009,119170,Griswold; William G.,9999,0,9999,0
1668553836499,CSE 293,010,119183,Gymrek; Melissa Ann,9999,0,9999,0
1668553836499,CSE 293,011,119190,Heninger; Nadia A,9999,0,9999,0
1668553836499,CSE 293,012,119230,Impagliazzo; Russell,9999,0,9999,0
1668553836499,CSE 293,013,119232,Jhala; Ranjit,9999,0,9999,0
1668553836499,CSE 293,014,119233,Kahng; Andrew Byun,9999,0,9999,0
1668553836499,CSE 293,015,119298,Kane; Daniel Mertz,9999,0,9999,0
1668553836499,CSE 293,016,119299,Kriegman; David J,9999,0,9999,0
1668553836499,CSE 293,017,119300,Kumar; Arun Kumar,9999,0,9999,0
1668553836499,CSE 293,018,119301,Lerner; Sorin,9999,0,9999,0
1668553836499,CSE 293,019,119302,Lovett; Shachar,9999,0,9999,0
1668553836499,CSE 293,020,119303,McAuley; Julian John,9999,0,9999,0
1668553836499,CSE 293,021,119304,Micciancio; Daniele,9999,0,9999,0
1668553836499,CSE 293,022,119367,Orailoglu; Alex,9999,0,9999,0
1668553836499,CSE 293,023,119382,Paturi; Ramamohan,9999,0,9999,0
1668553836499,CSE 293,024,119404,Polikarpova; Nadezhda,9999,0,9999,0
1668553836499,CSE 293,025,119406,Politz; Joseph Gibbs,9999,0,9999,0
1668553836499,CSE 293,026,119411,Porter; George M,9999,0,9999,0
1668553836499,CSE 293,027,119414,Porter; Leonard Emerson,9999,0,9999,0
1668553836499,CSE 293,028,119416,Ramamoorthi; Ravi,9999,0,9999,0
1668553836499,CSE 293,029,119417,Sahoo; Debashis,9999,0,9999,0
1668553836499,CSE 293,030,119420,Saul; Lawrence,9999,0,9999,0
1668553836499,CSE 293,031,119421,Savage; Stefan,9999,0,9999,0
1668553836499,CSE 293,032,119425,Schulze; Jurgen P.,9999,0,9999,0
1668553836499,CSE 293,033,119426,Snoeren; Alex C.,9999,0,9999,0
1668553836499,CSE 293,034,119428,Shang; Jingbo,9999,0,9999,0
1668553836499,CSE 293,035,119430,Stefan; Deian,9999,0,9999,0
1668553836499,CSE 293,036,119431,Su; Hao,9999,0,9999,0
1668553836499,CSE 293,037,119433,Swanson; Steven James,9999,0,9999,0
1668553836499,CSE 293,038,119435,Tullsen; Dean Michael,9999,0,9999,0
1668553836499,CSE 293,039,119483,Voelker; Geoffrey M.,9999,0,9999,0
1668553836499,CSE 293,040,119537,Zhao; Jishen,9999,0,9999,0
1668553836499,CSE 293,041,119538,Zhou; Yuan-Yuan,9999,0,9999,0
1668553836499,CSE 293,042,119539,Gao; Sicun,9999,0,9999,0
1668553836499,CSE 293,043,119540,Weibel; Nadir,9999,0,9999,0
1668553836499,CSE 293,044,119541,Gupta; Rajesh K.,9999,0,9999,0
1668553836499,CSE 293,045,126410,Vaccaro; Kristen Marie,9999,0,9999,0
1668553836499,CSE 293,046,126411,Klemke; Richard,9999,0,9999,0
1668553836937,CSE 294,A00,102459,Voelker; Geoffrey M.,0,2,0,0
1668553836937,CSE 294,B00,111322,Orailoglu; Alex,0,2,0,0
1668553837375,DSE 201,A00,096914,Deutsch; Alin Bernard,30,0,30,0
1668553837802,DSE 210,A00,096915,Dasgupta; Sanjoy,30,0,30,0
1668553838225,DSE 260A,A00,096916,Altintas De Callaf; Ilkay,30,0,30,0
1668553838655,ECE 200,001,103586,Antipa; Nicholas A,9999,0,9999,0
1668553838655,ECE 200,002,103587,Atanasov; Nikolay A.,9999,0,9999,0
1668553838655,ECE 200,003,103588,Bharadia; Dinesh,9999,0,9999,0
1668553838655,ECE 200,004,103589,Cheng; Chung Kuan,9999,0,9999,0
1668553838655,ECE 200,005,103590,Cosman; Pamela C.,9999,0,9999,0
1668553838655,ECE 200,006,103591,Dayeh; Shadi Ahmad,9999,0,9999,0
1668553838655,ECE 200,007,103592,Fainman; Yeshaiahu,9999,0,9999,0
1668553838655,ECE 200,008,103593,Ford; Joseph Earl,9999,0,9999,0
1668553838655,ECE 200,009,103594,Franceschetti; Massimo,9999,0,9999,0
1668553838655,ECE 200,010,103595,Fullerton; Eric E,9999,0,9999,0
1668553838655,ECE 200,011,103596,Galton; Ian A,9999,0,9999,0
1668553838655,ECE 200,012,103597,Gilja; Vikash,9999,0,9999,0
1668553838655,ECE 200,013,103598,Hall; Drew A.,9999,0,9999,0
1668553838655,ECE 200,014,103599,Hsueh; Tzu-Chien,9999,0,9999,0
1668553838655,ECE 200,015,103600,Javidi; Tara,9999,0,9999,0
1668553838655,ECE 200,016,103601,Kahng; Andrew Byun,9999,0,9999,0
1668553838655,ECE 200,017,103602,Kim; Young-Han,9999,0,9999,0
1668553838655,ECE 200,018,103603,Koushanfar; Farinaz,9999,0,9999,0
1668553838655,ECE 200,019,103604,Kuzum; Duygu,9999,0,9999,0
1668553838655,ECE 200,020,103605,Le; Hanh-Phuc,9999,0,9999,0
1668553838655,ECE 200,021,103606,Lin; Bill,9999,0,9999,0
1668553838655,ECE 200,022,103607,Liu; Zhaowei,9998,0,9999,1
1668553838655,ECE 200,023,103608,Lo; Yu-Hwa,9999,0,9999,0
1668553838655,ECE 200,024,103609,Lomakin; Vitaliy,9999,0,9999,0
1668553838655,ECE 200,025,103610,Mercier; Patrick Philip,9999,0,9999,0
1668553838655,ECE 200,026,103611,Meyer; Florian,9999,0,9999,0
1668553838655,ECE 200,027,103612,Milstein; Laurence B.,9999,0,9999,0
1668553838655,ECE 200,028,103613,Mir Arabbaygi; Siavash,9999,0,9999,0
1668553838655,ECE 200,029,103614,Mookherjea; Shayan,9999,0,9999,0
1668553838655,ECE 200,030,103615,Morris; Karcher William,9999,0,9999,0
1668553838655,ECE 200,031,103616,Ng; Tse Nga,9999,0,9999,0
1668553838655,ECE 200,032,103617,Nguyen; Truong Quang,9999,0,9999,0
1668553838655,ECE 200,033,103618,Nomura; Kenji,9999,0,9999,0
1668553838655,ECE 200,034,103619,Orlitsky; Alon,9999,0,9999,0
1668553838655,ECE 200,035,103620,Pal; Piya,9999,0,9999,0
1668553838655,ECE 200,036,103621,Papen; George C.,9999,0,9999,0
1668553838655,ECE 200,037,103622,Radic; Stojan,9999,0,9999,0
1668553838655,ECE 200,038,103623,Rao; Bhaskar D.,9999,0,9999,0
1668553838655,ECE 200,039,103624,Rao; Ramesh R,9999,0,9999,0
1668553838655,ECE 200,040,103625,Rebeiz; Gabriel,9999,0,9999,0
1668553838655,ECE 200,041,103626,Sanford; John R,9999,0,9999,0
1668553838655,ECE 200,042,103627,Siegel; Paul H.,9999,0,9999,0
1668553838655,ECE 200,043,103628,Sievenpiper; Daniel F.,9999,0,9999,0
1668553838655,ECE 200,044,103629,Sworder; David D.,9999,0,9999,0
1668553838655,ECE 200,045,103630,Taur; Yuan,9999,0,9999,0
1668553838655,ECE 200,046,103631,Touri; Behrouz,9999,0,9999,0
1668553838655,ECE 200,047,103632,Trivedi; Mohan M.,9999,0,9999,0
1668553838655,ECE 200,048,103633,Vasconcelos; Nuno,9999,0,9999,0
1668553838655,ECE 200,049,103634,Wang; Xiaolong,9999,0,9999,0
1668553838655,ECE 200,050,103635,Xie; Pengtao,9999,0,9999,0
1668553838655,ECE 200,051,103636,Yip; Michael,9999,0,9999,0
1668553838655,ECE 200,052,103637,Zeger; Kenneth A.,999,0,999,0
1668553838655,ECE 200,053,103638,Zhang; Xinyu,9999,0,9999,0
1668553838655,ECE 200,054,103639,Turakhia; Yatish Girish,9999,0,9999,0
1668553838655,ECE 200,055,103640,Kang; Mingu,9999,0,9999,0
1668553838655,ECE 200,056,103641,Shi; Yuanyuan,9999,0,9999,0
1668553838655,ECE 200,057,103642,Wang; Edward Jay,9999,0,9999,0
1668553838655,ECE 200,058,103643,Zheng; Yang,9999,0,9999,0
1668553839085,ECE 202,A00,103644,Kuzum; Duygu,0,45,0,0
1668553839515,ECE 212BN,A00,103646,Ng; Tse Nga,0,9,0,0
1668553839945,ECE 221,A00,111493,Staff,0,0,0,0
1668553840369,ECE 222B,A00,103647,Lomakin; Vitaliy,0,20,0,0
1668553840799,ECE 230B,A00,103648,Taur; Yuan,0,4,0,0
1668553841222,ECE 238B,A00,103649,Garay; Javier,0,0,0,0
1668553841650,ECE 240B,A00,112900,Fainman; Yeshaiahu,0,7,0,0
1668553842072,ECE 247A,A00,103650,Jokerst; Jesse Vincent,0,6,0,0
1668553842510,ECE 247B,A00,103651,Wang; Joseph,0,14,0,0
1668553842934,ECE 250,A00,103652,Siegel; Paul H.,0,83,0,0
1668553843370,ECE 251A,A00,103654,Rao; Bhaskar D.,0,63,0,0
1668553843795,ECE 257B,A00,103655,Bharadia; Dinesh,0,33,0,0
1668553844222,ECE 258A,A00,103656,Milstein; Laurence B.,0,28,0,0
1668553844663,ECE 260B,A00,103658,Kang; Mingu,0,123,0,0
1668553845092,ECE 264A,A00,103659,Galton; Ian A,0,73,0,0
1668553845520,ECE 265A,A00,103661,Gudem; Prasad S.S.,0,74,0,0
1668553845943,ECE 265D,A00,103662,Gudem; Prasad S.S.,0,26,0,0
1668553846372,ECE 268,A00,103663,Koushanfar; Farinaz,0,43,0,0
1668553846799,ECE 269,A01,103665,Pal; Piya,0,220,0,0
1668553847229,ECE 271B,A00,103666,Vasconcelos; Manuela,0,78,0,0
1668553847657,ECE 276A,A00,103667,Atanasov; Nikolay A.,0,126,0,0
1668553848088,ECE 277,A00,103668,An; Cheolhong,0,151,0,0
1668553848520,ECE 279,A00,117947,Hall; Drew A.,0,22,0,0
1668553849380,ECE 283,A00,103670,Hsueh; Tzu-Chien,0,57,0,0
1668553849805,ECE 284,A00,103671,Turakhia; Yatish Girish,0,41,0,0
1668553850246,ECE 285,A00,103672,Zheng; Yang,0,40,0,0
1668553850246,ECE 285,B00,103673,Sworder; David D.,0,61,0,0
1668553850670,ECE 287,A00,103676,Javidi; Tara,0,8,0,0
1668553851096,MATH 200B,A00,098023,Salehi Golsefidy; Alireza,10,0,15,5
1668553851520,MATH 202B,A00,098024,Rhoades; Brendon Patrick,7,0,15,8
1668553851948,MATH 203B,A00,098025,Oprea; Dragos N.,9,0,15,6
1668553852462,MATH 204B,A00,098026,Sorensen; Claus M,13,0,15,2
1668553852888,MATH 208,A00,098027,Izadi; Elham,7,0,10,3
1668553853314,MATH 209,A00,098028,Pollack; Aaron,10,0,10,0
1668553853736,MATH 211A,A00,112919,Rogalski; Daniel,8,0,10,2
1668553854165,MATH 211B,A00,112920,Seward; Brandon M.,9,0,10,1
1668553854591,MATH 218,A00,098029,Li; Bo,10,0,10,0
1668553855015,MATH 220B,A00,098030,Novak; Jonathan I,11,0,15,4
1668553855451,MATH 221A,A00,098031,Ebenfelt; Peter F,12,0,15,3
1668553855878,MATH 231B,A00,098032,Zlatos; Andrej,10,0,15,5
1668553856301,MATH 240B,A00,098033,Ni; Lei,7,0,15,8
1668553856725,MATH 243,A00,098034,Jekel; David Andrew,10,0,10,0
1668553857151,MATH 245A,A00,098035,Nie; Jiawang,0,6,15,18
1668553857572,MATH 248,A00,098036,Bejenaru; Ioan,10,0,10,0
1668553857995,MATH 250B,A00,098037,Spolaor; Luca,14,0,15,1
1668553858425,MATH 258,A00,098038,Ni; Lei,9,0,10,1
1668553858860,MATH 264B,A00,098041,Rhoades; Brendon Patrick,8,0,15,7
1668553859298,MATH 268,A00,098042,Buss; Samuel R,10,0,10,0
1668553859733,MATH 269,A00,098043,Rhoades; Brendon Patrick,10,0,10,0
1668553860167,MATH 270B,A00,098044,Li; Bo,6,0,15,9
1668553860604,MATH 272B,A00,098045,Holst; Michael J,13,0,15,2
1668553861037,MATH 273A,A00,098046,Tian; Xiaochuan,10,0,15,5
1668553861463,MATH 275,A01,098048,Tian; Xiaochuan,6,0,10,4
1668553861888,MATH 278A,A00,098049,Holst; Michael J,6,0,10,4
1668553862311,MATH 278B,A00,098050,Cloninger; Alexander,10,0,10,0
1668553862733,MATH 278C,A00,098051,Nie; Jiawang,5,0,10,5
1668553863164,MATH 280B,A00,098052,Zheng; Tianyi,7,0,15,8
1668553863596,MATH 281B,A00,098053,Bradic; Jelena,0,2,15,15
1668553864024,MATH 282B,A00,098054,Arias-Castro; Ery,0,1,15,15
1668553864447,MATH 285,A00,098055,Fitzsimmons; Patrick J,0,4,15,17
1668553864870,MATH 287B,A00,098056,Arias-Castro; Ery,1,0,15,14
1668553865293,MATH 288,A00,098057,Agarwal; Pooja,9,0,10,1
1668553865293,MATH 288,B00,098058,Zhang; Danna,8,0,10,2
1668553865293,MATH 288,C00,098059,Williams; Ruth J,9,0,10,1
1668553865718,MATH 290B,A00,098060,Roberts; Justin Deritter,12,0,15,3
1668553866156,MATH 292,A00,098061,Belmont; Eva Kinoshita,10,0,10,0
1668553866580,MATH 295,A00,098062,Suk; Andrew Hoon,47,0,50,3
1668553867016,MATH 296,A00,098063,Novak; Jonathan I,20,0,20,0
1668553867438,MATH 297,001,098064,Gamst; Anthony Collins,9997,0,9999,2
1668554371706,COGS 205,A00,101395,Chiba; Andrea,19,0,20,1
1668554372131,COGS 210B,001,101404,Greene; Deanna Jacquelyn,9998,0,9999,1
1668554372131,COGS 210B,002,101417,Xia; Haijun,9999,0,9999,0
1668554372131,COGS 210B,003,101422,Nitz; Douglas A.,9999,0,9999,0
1668554372131,COGS 210B,004,101423,Hollan; James D.,9998,0,9999,1
1668554372131,COGS 210B,005,101424,Deak; Gedeon O.,9998,0,9999,1
1668554372131,COGS 210B,006,101425,Rossano; Federico,9999,0,9999,0
1668554372563,COGS 211B,A00,101427,Coulson; Seana M,9996,0,9999,3
1668554372992,COGS 220,A00,101428,Hollan; James D.,0,16,25,25
1668554373420,COGS 229,A00,101429,Dow; Steven P,17,0,25,8
1668554373855,COGS 230,A00,101430,Klemmer; Scott R,6,0,17,11
1668554374286,COGS 234,A00,101431,Xia; Haijun,0,1,25,25
1668554374708,COGS 260,A00,101432,Kiyonaga; Anastasia,21,0,25,4
1668554374708,COGS 260,B00,101433,Kirsh; David Joel,15,0,25,10
1668554375233,CSE 202,A00,102371,Impagliazzo; Russell,0,70,0,0
1668554375735,CSE 203B,A01,102373,Cheng; Chung Kuan,0,65,0,0
1668554376168,CSE 208,A00,102374,Micciancio; Daniele,0,5,0,0
1668554376627,CSE 209A,A00,112895,Impagliazzo; Russell,0,13,15,15
1668554377057,CSE 209B,A00,108005,Bellare; Mihir,0,7,0,0
1668554377484,CSE 210,A00,113163,Coblenz; Michael J,0,92,0,0
1668554377918,CSE 219,A00,106111,Dow; Steven P,0,8,20,20
1668554378342,CSE 221,A00,102376,Voelker; Geoffrey M.,0,76,0,0
1668554378767,CSE 224,A01,102378,Porter; George M,0,176,0,0
1668554379202,CSE 229A,A00,102379,Savage; Stefan,0,11,0,0
1668554379627,CSE 229C,A00,102380,Munyaka; Imani N. S.,0,10,0,0
1668554380056,CSE 232B,A00,102382,Deutsch; Alin Bernard,0,39,0,0
1668554380478,CSE 234,A01,112904,Kumar; Arun Kumar,0,0,0,0
1668554380915,CSE 237A,A00,102383,Rosing; Tajana Simunic,0,57,0,0
1668554381348,CSE 239A,A00,102384,Deutsch; Alin Bernard,0,16,0,0
1668554381772,CSE 239B,A00,102385,Polikarpova; Nadezhda,0,11,0,0
1668554382198,CSE 240A,A00,102386,Pannuto; Patrick William,0,48,0,0
1668554382629,CSE 240B,A00,102387,Zhao; Jishen,0,51,0,0
1668554383060,CSE 241A,A00,106406,Kang; Mingu,0,9,0,0
1668554383482,CSE 249B,A00,102388,Kahng; Andrew Byun,0,5,8,8
1668554383909,CSE 251B,A01,102392,Cottrell; Garrison W,0,52,0,0
1668554383909,CSE 251B,A02,102393,Cottrell; Garrison W,0,35,0,0
1668554384341,CSE 252B,A00,102394,Ochoa; Benjamin Lawrence,0,64,0,0
1668554384764,CSE 257,A01,102396,Gao; Sicun,0,155,0,0
1668554385189,CSE 272,A00,102397,Li; Tzumao,0,22,0,0
1668554385612,CSE 274,A00,111323,Chern; Albert Ren-Haur,0,16,0,0
1668554386035,CSE 282,A00,102398,Pevzner; Pavel Arkadjevich,0,0,0,0
1668554386470,CSE 284,A00,114175,Gymrek; Melissa Ann,0,30,0,0
1668554386906,CSE 290,A00,102399,Chandraker; Manmohan Krishna,0,11,0,0
1668554386906,CSE 290,B00,102400,Vaccaro; Kristen Marie,0,8,25,25
1668554386906,CSE 290,C00,102414,Pannuto; Patrick William,0,1,25,25
1668554386906,CSE 290,D00,102427,Pevzner; Pavel Arkadjevich,0,0,0,0
1668554386906,CSE 290,E00,102429,Zhao; Jishen,0,6,0,0
1668554386906,CSE 290,F00,102436,Tullsen; Dean Michael,0,6,0,0
1668554386906,CSE 290,G00,102440,Christensen; Henrik I,0,6,20,20
1668554387331,CSE 291,A00,102443,Su; Hao,0,0,0,0
1668554387331,CSE 291,B00,102448,Polikarpova; Nadezhda,0,0,0,0
1668554387331,CSE 291,C00,102453,Vaccaro; Kristen Marie,0,0,0,0
1668554387331,CSE 291,D00,111343,Savage; Stefan,0,0,0,0
1668554387331,CSE 291,E00,116474,Claffy; Kimberly Claire,0,0,0,0
1668554387331,CSE 291,F00,116479,Pasquale; Joseph,0,0,0,0
1668554387807,CSE 293,001,119111,Bafna; Vineet,9999,0,9999,0
1668554387807,CSE 293,002,119118,Bellare; Mihir,9999,0,9999,0
1668554387807,CSE 293,003,119122,Berg-Kirkpatrick; Taylor D,9999,0,9999,0
1668554387807,CSE 293,004,119135,Christensen; Henrik I,9999,0,9999,0
1668554387807,CSE 293,005,119142,Cottrell; Garrison W,9999,0,9999,0
1668554387807,CSE 293,006,119146,Deutsch; Alin Bernard,9999,0,9999,0
1668554387807,CSE 293,007,119159,Esmaeilzadeh; Hadi,9999,0,9999,0
1668554387807,CSE 293,008,119166,Freund; Yoav,9999,0,9999,0
1668554387807,CSE 293,009,119170,Griswold; William G.,9999,0,9999,0
1668554387807,CSE 293,010,119183,Gymrek; Melissa Ann,9999,0,9999,0
1668554387807,CSE 293,011,119190,Heninger; Nadia A,9999,0,9999,0
1668554387807,CSE 293,012,119230,Impagliazzo; Russell,9999,0,9999,0
1668554387807,CSE 293,013,119232,Jhala; Ranjit,9999,0,9999,0
1668554387807,CSE 293,014,119233,Kahng; Andrew Byun,9999,0,9999,0
1668554387807,CSE 293,015,119298,Kane; Daniel Mertz,9999,0,9999,0
1668554387807,CSE 293,016,119299,Kriegman; David J,9999,0,9999,0
1668554387807,CSE 293,017,119300,Kumar; Arun Kumar,9999,0,9999,0
1668554387807,CSE 293,018,119301,Lerner; Sorin,9999,0,9999,0
1668554387807,CSE 293,019,119302,Lovett; Shachar,9999,0,9999,0
1668554387807,CSE 293,020,119303,McAuley; Julian John,9999,0,9999,0
1668554387807,CSE 293,021,119304,Micciancio; Daniele,9999,0,9999,0
1668554387807,CSE 293,022,119367,Orailoglu; Alex,9999,0,9999,0
1668554387807,CSE 293,023,119382,Paturi; Ramamohan,9999,0,9999,0
1668554387807,CSE 293,024,119404,Polikarpova; Nadezhda,9999,0,9999,0
1668554387807,CSE 293,025,119406,Politz; Joseph Gibbs,9999,0,9999,0
1668554387807,CSE 293,026,119411,Porter; George M,9999,0,9999,0
1668554387807,CSE 293,027,119414,Porter; Leonard Emerson,9999,0,9999,0
1668554387807,CSE 293,028,119416,Ramamoorthi; Ravi,9999,0,9999,0
1668554387807,CSE 293,029,119417,Sahoo; Debashis,9999,0,9999,0
1668554387807,CSE 293,030,119420,Saul; Lawrence,9999,0,9999,0
1668554387807,CSE 293,031,119421,Savage; Stefan,9999,0,9999,0
1668554387807,CSE 293,032,119425,Schulze; Jurgen P.,9999,0,9999,0
1668554387807,CSE 293,033,119426,Snoeren; Alex C.,9999,0,9999,0
1668554387807,CSE 293,034,119428,Shang; Jingbo,9999,0,9999,0
1668554387807,CSE 293,035,119430,Stefan; Deian,9999,0,9999,0
1668554387807,CSE 293,036,119431,Su; Hao,9999,0,9999,0
1668554387807,CSE 293,037,119433,Swanson; Steven James,9999,0,9999,0
1668554387807,CSE 293,038,119435,Tullsen; Dean Michael,9999,0,9999,0
1668554387807,CSE 293,039,119483,Voelker; Geoffrey M.,9999,0,9999,0
1668554387807,CSE 293,040,119537,Zhao; Jishen,9999,0,9999,0
1668554387807,CSE 293,041,119538,Zhou; Yuan-Yuan,9999,0,9999,0
1668554387807,CSE 293,042,119539,Gao; Sicun,9999,0,9999,0
1668554387807,CSE 293,043,119540,Weibel; Nadir,9999,0,9999,0
1668554387807,CSE 293,044,119541,Gupta; Rajesh K.,9999,0,9999,0
1668554387807,CSE 293,045,126410,Vaccaro; Kristen Marie,9999,0,9999,0
1668554387807,CSE 293,046,126411,Klemke; Richard,9999,0,9999,0
1668554388235,CSE 294,A00,102459,Voelker; Geoffrey M.,0,2,0,0
1668554388235,CSE 294,B00,111322,Orailoglu; Alex,0,2,0,0
1668554388661,DSE 201,A00,096914,Deutsch; Alin Bernard,30,0,30,0
1668554389087,DSE 210,A00,096915,Dasgupta; Sanjoy,30,0,30,0
1668554389521,DSE 260A,A00,096916,Altintas De Callaf; Ilkay,30,0,30,0
1668554389968,ECE 200,001,103586,Antipa; Nicholas A,9999,0,9999,0
1668554389968,ECE 200,002,103587,Atanasov; Nikolay A.,9999,0,9999,0
1668554389968,ECE 200,003,103588,Bharadia; Dinesh,9999,0,9999,0
1668554389968,ECE 200,004,103589,Cheng; Chung Kuan,9999,0,9999,0
1668554389968,ECE 200,005,103590,Cosman; Pamela C.,9999,0,9999,0
1668554389968,ECE 200,006,103591,Dayeh; Shadi Ahmad,9999,0,9999,0
1668554389968,ECE 200,007,103592,Fainman; Yeshaiahu,9999,0,9999,0
1668554389968,ECE 200,008,103593,Ford; Joseph Earl,9999,0,9999,0
1668554389968,ECE 200,009,103594,Franceschetti; Massimo,9999,0,9999,0
1668554389968,ECE 200,010,103595,Fullerton; Eric E,9999,0,9999,0
1668554389968,ECE 200,011,103596,Galton; Ian A,9999,0,9999,0
1668554389968,ECE 200,012,103597,Gilja; Vikash,9999,0,9999,0
1668554389968,ECE 200,013,103598,Hall; Drew A.,9999,0,9999,0
1668554389968,ECE 200,014,103599,Hsueh; Tzu-Chien,9999,0,9999,0
1668554389968,ECE 200,015,103600,Javidi; Tara,9999,0,9999,0
1668554389968,ECE 200,016,103601,Kahng; Andrew Byun,9999,0,9999,0
1668554389968,ECE 200,017,103602,Kim; Young-Han,9999,0,9999,0
1668554389968,ECE 200,018,103603,Koushanfar; Farinaz,9999,0,9999,0
1668554389968,ECE 200,019,103604,Kuzum; Duygu,9999,0,9999,0
1668554389968,ECE 200,020,103605,Le; Hanh-Phuc,9999,0,9999,0
1668554389968,ECE 200,021,103606,Lin; Bill,9999,0,9999,0
1668554389968,ECE 200,022,103607,Liu; Zhaowei,9998,0,9999,1
1668554389968,ECE 200,023,103608,Lo; Yu-Hwa,9999,0,9999,0
1668554389968,ECE 200,024,103609,Lomakin; Vitaliy,9999,0,9999,0
1668554389968,ECE 200,025,103610,Mercier; Patrick Philip,9999,0,9999,0
1668554389968,ECE 200,026,103611,Meyer; Florian,9999,0,9999,0
1668554389968,ECE 200,027,103612,Milstein; Laurence B.,9999,0,9999,0
1668554389968,ECE 200,028,103613,Mir Arabbaygi; Siavash,9999,0,9999,0
1668554389968,ECE 200,029,103614,Mookherjea; Shayan,9999,0,9999,0
1668554389968,ECE 200,030,103615,Morris; Karcher William,9999,0,9999,0
1668554389968,ECE 200,031,103616,Ng; Tse Nga,9999,0,9999,0
1668554389968,ECE 200,032,103617,Nguyen; Truong Quang,9999,0,9999,0
1668554389968,ECE 200,033,103618,Nomura; Kenji,9999,0,9999,0
1668554389968,ECE 200,034,103619,Orlitsky; Alon,9999,0,9999,0
1668554389968,ECE 200,035,103620,Pal; Piya,9999,0,9999,0
1668554389968,ECE 200,036,103621,Papen; George C.,9999,0,9999,0
1668554389968,ECE 200,037,103622,Radic; Stojan,9999,0,9999,0
1668554389968,ECE 200,038,103623,Rao; Bhaskar D.,9999,0,9999,0
1668554389968,ECE 200,039,103624,Rao; Ramesh R,9999,0,9999,0
1668554389968,ECE 200,040,103625,Rebeiz; Gabriel,9999,0,9999,0
1668554389968,ECE 200,041,103626,Sanford; John R,9999,0,9999,0
1668554389968,ECE 200,042,103627,Siegel; Paul H.,9999,0,9999,0
1668554389968,ECE 200,043,103628,Sievenpiper; Daniel F.,9999,0,9999,0
1668554389968,ECE 200,044,103629,Sworder; David D.,9999,0,9999,0
1668554389968,ECE 200,045,103630,Taur; Yuan,9999,0,9999,0
1668554389968,ECE 200,046,103631,Touri; Behrouz,9999,0,9999,0
1668554389968,ECE 200,047,103632,Trivedi; Mohan M.,9999,0,9999,0
1668554389968,ECE 200,048,103633,Vasconcelos; Nuno,9999,0,9999,0
1668554389968,ECE 200,049,103634,Wang; Xiaolong,9999,0,9999,0
1668554389968,ECE 200,050,103635,Xie; Pengtao,9999,0,9999,0
1668554389968,ECE 200,051,103636,Yip; Michael,9999,0,9999,0
1668554389968,ECE 200,052,103637,Zeger; Kenneth A.,999,0,999,0
1668554389968,ECE 200,053,103638,Zhang; Xinyu,9999,0,9999,0
1668554389968,ECE 200,054,103639,Turakhia; Yatish Girish,9999,0,9999,0
1668554389968,ECE 200,055,103640,Kang; Mingu,9999,0,9999,0
1668554389968,ECE 200,056,103641,Shi; Yuanyuan,9999,0,9999,0
1668554389968,ECE 200,057,103642,Wang; Edward Jay,9999,0,9999,0
1668554389968,ECE 200,058,103643,Zheng; Yang,9999,0,9999,0
1668554390393,ECE 202,A00,103644,Kuzum; Duygu,0,45,0,0
1668554390823,ECE 212BN,A00,103646,Ng; Tse Nga,0,9,0,0
1668554391254,ECE 221,A00,111493,Staff,0,0,0,0
1668554391678,ECE 222B,A00,103647,Lomakin; Vitaliy,0,20,0,0
1668554392103,ECE 230B,A00,103648,Taur; Yuan,0,4,0,0
1668554392537,ECE 238B,A00,103649,Garay; Javier,0,0,0,0
1668554392960,ECE 240B,A00,112900,Fainman; Yeshaiahu,0,7,0,0
1668554393387,ECE 247A,A00,103650,Jokerst; Jesse Vincent,0,6,0,0
1668554393815,ECE 247B,A00,103651,Wang; Joseph,0,14,0,0
1668554394241,ECE 250,A00,103652,Siegel; Paul H.,0,83,0,0
1668554394678,ECE 251A,A00,103654,Rao; Bhaskar D.,0,63,0,0
1668554395101,ECE 257B,A00,103655,Bharadia; Dinesh,0,33,0,0
1668554395524,ECE 258A,A00,103656,Milstein; Laurence B.,0,28,0,0
1668554395958,ECE 260B,A00,103658,Kang; Mingu,0,123,0,0
1668554396385,ECE 264A,A00,103659,Galton; Ian A,0,73,0,0
1668554396806,ECE 265A,A00,103661,Gudem; Prasad S.S.,0,74,0,0
1668554397230,ECE 265D,A00,103662,Gudem; Prasad S.S.,0,26,0,0
1668554397661,ECE 268,A00,103663,Koushanfar; Farinaz,0,43,0,0
1668554398088,ECE 269,A01,103665,Pal; Piya,0,221,0,0
1668554398514,ECE 271B,A00,103666,Vasconcelos; Manuela,0,78,0,0
1668554398953,ECE 276A,A00,103667,Atanasov; Nikolay A.,0,127,0,0
1668554399377,ECE 277,A00,103668,An; Cheolhong,0,151,0,0
1668554399813,ECE 279,A00,117947,Hall; Drew A.,0,22,0,0
1668554400705,ECE 283,A00,103670,Hsueh; Tzu-Chien,0,57,0,0
1668554401133,ECE 284,A00,103671,Turakhia; Yatish Girish,0,41,0,0
1668554401569,ECE 285,A00,103672,Zheng; Yang,0,40,0,0
1668554401569,ECE 285,B00,103673,Sworder; David D.,0,61,0,0
1668554401991,ECE 287,A00,103676,Javidi; Tara,0,8,0,0
1668554402416,MATH 200B,A00,098023,Salehi Golsefidy; Alireza,10,0,15,5
1668554402849,MATH 202B,A00,098024,Rhoades; Brendon Patrick,7,0,15,8
1668554403278,MATH 203B,A00,098025,Oprea; Dragos N.,9,0,15,6
1668554403715,MATH 204B,A00,098026,Sorensen; Claus M,13,0,15,2
1668554404140,MATH 208,A00,098027,Izadi; Elham,7,0,10,3
1668554404563,MATH 209,A00,098028,Pollack; Aaron,10,0,10,0
1668554404992,MATH 211A,A00,112919,Rogalski; Daniel,8,0,10,2
1668554405418,MATH 211B,A00,112920,Seward; Brandon M.,9,0,10,1
1668554405845,MATH 218,A00,098029,Li; Bo,10,0,10,0
1668554406273,MATH 220B,A00,098030,Novak; Jonathan I,11,0,15,4
1668554406700,MATH 221A,A00,098031,Ebenfelt; Peter F,12,0,15,3
1668554407129,MATH 231B,A00,098032,Zlatos; Andrej,9,0,15,6
1668554407557,MATH 240B,A00,098033,Ni; Lei,7,0,15,8
1668554407981,MATH 243,A00,098034,Jekel; David Andrew,10,0,10,0
1668554408404,MATH 245A,A00,098035,Nie; Jiawang,0,7,15,18
1668554408829,MATH 248,A00,098036,Bejenaru; Ioan,10,0,10,0
1668554409261,MATH 250B,A00,098037,Spolaor; Luca,13,0,15,2
1668554409689,MATH 258,A00,098038,Ni; Lei,8,0,10,2
1668554410113,MATH 264B,A00,098041,Rhoades; Brendon Patrick,8,0,15,7
1668554410542,MATH 268,A00,098042,Buss; Samuel R,10,0,10,0
1668554410968,MATH 269,A00,098043,Rhoades; Brendon Patrick,10,0,10,0
1668554411396,MATH 270B,A00,098044,Li; Bo,6,0,15,9
1668554411821,MATH 272B,A00,098045,Holst; Michael J,13,0,15,2
1668554412269,MATH 273A,A00,098046,Tian; Xiaochuan,10,0,15,5
1668554412707,MATH 275,A01,098048,Tian; Xiaochuan,6,0,10,4
1668554413132,MATH 278A,A00,098049,Holst; Michael J,6,0,10,4
1668554413571,MATH 278B,A00,098050,Cloninger; Alexander,10,0,10,0
1668554414006,MATH 278C,A00,098051,Nie; Jiawang,5,0,10,5
1668554414450,MATH 280B,A00,098052,Zheng; Tianyi,7,0,15,8
1668554414872,MATH 281B,A00,098053,Bradic; Jelena,0,2,15,15
1668554415309,MATH 282B,A00,098054,Arias-Castro; Ery,0,1,15,15
1668554415748,MATH 285,A00,098055,Fitzsimmons; Patrick J,0,4,15,17
1668554416183,MATH 287B,A00,098056,Arias-Castro; Ery,1,0,15,14
1668554416606,MATH 288,A00,098057,Agarwal; Pooja,9,0,10,1
1668554416606,MATH 288,B00,098058,Zhang; Danna,8,0,10,2
1668554416606,MATH 288,C00,098059,Williams; Ruth J,9,0,10,1
1668554417030,MATH 290B,A00,098060,Roberts; Justin Deritter,12,0,15,3
1668554417453,MATH 292,A00,098061,Belmont; Eva Kinoshita,10,0,10,0
1668554417878,MATH 295,A00,098062,Suk; Andrew Hoon,47,0,50,3
1668554418307,MATH 296,A00,098063,Novak; Jonathan I,20,0,20,0
1668554418926,MATH 297,001,098064,Gamst; Anthony Collins,9997,0,9999,2
1668554926011,COGS 205,A00,101395,Chiba; Andrea,19,0,20,1
1668554926436,COGS 210B,001,101404,Greene; Deanna Jacquelyn,9998,0,9999,1
1668554926436,COGS 210B,002,101417,Xia; Haijun,9999,0,9999,0
1668554926436,COGS 210B,003,101422,Nitz; Douglas A.,9999,0,9999,0
1668554926436,COGS 210B,004,101423,Hollan; James D.,9998,0,9999,1
1668554926436,COGS 210B,005,101424,Deak; Gedeon O.,9998,0,9999,1
1668554926436,COGS 210B,006,101425,Rossano; Federico,9999,0,9999,0
1668554926859,COGS 211B,A00,101427,Coulson; Seana M,9996,0,9999,3
1668554927288,COGS 220,A00,101428,Hollan; James D.,0,16,25,25
1668554927714,COGS 229,A00,101429,Dow; Steven P,17,0,25,8
1668554928152,COGS 230,A00,101430,Klemmer; Scott R,6,0,17,11
1668554928578,COGS 234,A00,101431,Xia; Haijun,0,1,25,25
1668554929004,COGS 260,A00,101432,Kiyonaga; Anastasia,21,0,25,4
1668554929004,COGS 260,B00,101433,Kirsh; David Joel,15,0,25,10
1668554929438,CSE 202,A00,102371,Impagliazzo; Russell,0,70,0,0
1668554929863,CSE 203B,A01,102373,Cheng; Chung Kuan,0,65,0,0
1668554930289,CSE 208,A00,102374,Micciancio; Daniele,0,5,0,0
1668554930715,CSE 209A,A00,112895,Impagliazzo; Russell,0,13,15,15
1668554931155,CSE 209B,A00,108005,Bellare; Mihir,0,7,0,0
1668554931578,CSE 210,A00,113163,Coblenz; Michael J,0,92,0,0
1668554932003,CSE 219,A00,106111,Dow; Steven P,0,8,20,20
1668554932431,CSE 221,A00,102376,Voelker; Geoffrey M.,0,76,0,0
1668554932856,CSE 224,A01,102378,Porter; George M,0,176,0,0
1668554933279,CSE 229A,A00,102379,Savage; Stefan,0,11,0,0
1668554933709,CSE 229C,A00,102380,Munyaka; Imani N. S.,0,10,0,0
1668554934171,CSE 232B,A00,102382,Deutsch; Alin Bernard,0,39,0,0
1668554934602,CSE 234,A01,112904,Kumar; Arun Kumar,0,0,0,0
1668554935034,CSE 237A,A00,102383,Rosing; Tajana Simunic,0,57,0,0
1668554935458,CSE 239A,A00,102384,Deutsch; Alin Bernard,0,16,0,0
1668554935885,CSE 239B,A00,102385,Polikarpova; Nadezhda,0,11,0,0
1668554936323,CSE 240A,A00,102386,Pannuto; Patrick William,0,48,0,0
1668554936753,CSE 240B,A00,102387,Zhao; Jishen,0,51,0,0
1668554937185,CSE 241A,A00,106406,Kang; Mingu,0,9,0,0
1668554937616,CSE 249B,A00,102388,Kahng; Andrew Byun,0,5,8,8
1668554938049,CSE 251B,A01,102392,Cottrell; Garrison W,0,52,0,0
1668554938049,CSE 251B,A02,102393,Cottrell; Garrison W,0,35,0,0
1668554938487,CSE 252B,A00,102394,Ochoa; Benjamin Lawrence,0,64,0,0
1668554938919,CSE 257,A01,102396,Gao; Sicun,0,155,0,0
1668554939349,CSE 272,A00,102397,Li; Tzumao,0,22,0,0
1668554939785,CSE 274,A00,111323,Chern; Albert Ren-Haur,0,16,0,0
1668554940222,CSE 282,A00,102398,Pevzner; Pavel Arkadjevich,0,0,0,0
1668554940657,CSE 284,A00,114175,Gymrek; Melissa Ann,0,30,0,0
1668554941080,CSE 290,A00,102399,Chandraker; Manmohan Krishna,0,11,0,0
1668554941080,CSE 290,B00,102400,Vaccaro; Kristen Marie,0,8,25,25
1668554941080,CSE 290,C00,102414,Pannuto; Patrick William,0,1,25,25
1668554941080,CSE 290,D00,102427,Pevzner; Pavel Arkadjevich,0,0,0,0
1668554941080,CSE 290,E00,102429,Zhao; Jishen,0,6,0,0
1668554941080,CSE 290,F00,102436,Tullsen; Dean Michael,0,6,0,0
1668554941080,CSE 290,G00,102440,Christensen; Henrik I,0,6,20,20
1668554941506,CSE 291,A00,102443,Su; Hao,0,0,0,0
1668554941506,CSE 291,B00,102448,Polikarpova; Nadezhda,0,0,0,0
1668554941506,CSE 291,C00,102453,Vaccaro; Kristen Marie,0,0,0,0
1668554941506,CSE 291,D00,111343,Savage; Stefan,0,0,0,0
1668554941506,CSE 291,E00,116474,Claffy; Kimberly Claire,0,0,0,0
1668554941506,CSE 291,F00,116479,Pasquale; Joseph,0,0,0,0
1668554941938,CSE 293,001,119111,Bafna; Vineet,9999,0,9999,0
1668554941938,CSE 293,002,119118,Bellare; Mihir,9999,0,9999,0
1668554941938,CSE 293,003,119122,Berg-Kirkpatrick; Taylor D,9999,0,9999,0
1668554941938,CSE 293,004,119135,Christensen; Henrik I,9999,0,9999,0
1668554941938,CSE 293,005,119142,Cottrell; Garrison W,9999,0,9999,0
1668554941938,CSE 293,006,119146,Deutsch; Alin Bernard,9999,0,9999,0
1668554941938,CSE 293,007,119159,Esmaeilzadeh; Hadi,9999,0,9999,0
1668554941938,CSE 293,008,119166,Freund; Yoav,9999,0,9999,0
1668554941938,CSE 293,009,119170,Griswold; William G.,9999,0,9999,0
1668554941938,CSE 293,010,119183,Gymrek; Melissa Ann,9999,0,9999,0
1668554941938,CSE 293,011,119190,Heninger; Nadia A,9999,0,9999,0
1668554941938,CSE 293,012,119230,Impagliazzo; Russell,9999,0,9999,0
1668554941938,CSE 293,013,119232,Jhala; Ranjit,9999,0,9999,0
1668554941938,CSE 293,014,119233,Kahng; Andrew Byun,9999,0,9999,0
1668554941938,CSE 293,015,119298,Kane; Daniel Mertz,9999,0,9999,0
1668554941938,CSE 293,016,119299,Kriegman; David J,9999,0,9999,0
1668554941938,CSE 293,017,119300,Kumar; Arun Kumar,9999,0,9999,0
1668554941938,CSE 293,018,119301,Lerner; Sorin,9999,0,9999,0
1668554941938,CSE 293,019,119302,Lovett; Shachar,9999,0,9999,0
1668554941938,CSE 293,020,119303,McAuley; Julian John,9999,0,9999,0
1668554941938,CSE 293,021,119304,Micciancio; Daniele,9999,0,9999,0
1668554941938,CSE 293,022,119367,Orailoglu; Alex,9999,0,9999,0
1668554941938,CSE 293,023,119382,Paturi; Ramamohan,9999,0,9999,0
1668554941938,CSE 293,024,119404,Polikarpova; Nadezhda,9999,0,9999,0
1668554941938,CSE 293,025,119406,Politz; Joseph Gibbs,9999,0,9999,0
1668554941938,CSE 293,026,119411,Porter; George M,9999,0,9999,0
1668554941938,CSE 293,027,119414,Porter; Leonard Emerson,9999,0,9999,0
1668554941938,CSE 293,028,119416,Ramamoorthi; Ravi,9999,0,9999,0
1668554941938,CSE 293,029,119417,Sahoo; Debashis,9999,0,9999,0
1668554941938,CSE 293,030,119420,Saul; Lawrence,9999,0,9999,0
1668554941938,CSE 293,031,119421,Savage; Stefan,9999,0,9999,0
1668554941938,CSE 293,032,119425,Schulze; Jurgen P.,9999,0,9999,0
1668554941938,CSE 293,033,119426,Snoeren; Alex C.,9999,0,9999,0
1668554941938,CSE 293,034,119428,Shang; Jingbo,9999,0,9999,0
1668554941938,CSE 293,035,119430,Stefan; Deian,9999,0,9999,0
1668554941938,CSE 293,036,119431,Su; Hao,9999,0,9999,0
1668554941938,CSE 293,037,119433,Swanson; Steven James,9999,0,9999,0
1668554941938,CSE 293,038,119435,Tullsen; Dean Michael,9999,0,9999,0
1668554941938,CSE 293,039,119483,Voelker; Geoffrey M.,9999,0,9999,0
1668554941938,CSE 293,040,119537,Zhao; Jishen,9999,0,9999,0
1668554941938,CSE 293,041,119538,Zhou; Yuan-Yuan,9999,0,9999,0
1668554941938,CSE 293,042,119539,Gao; Sicun,9999,0,9999,0
1668554941938,CSE 293,043,119540,Weibel; Nadir,9999,0,9999,0
1668554941938,CSE 293,044,119541,Gupta; Rajesh K.,9999,0,9999,0
1668554941938,CSE 293,045,126410,Vaccaro; Kristen Marie,9999,0,9999,0
1668554941938,CSE 293,046,126411,Klemke; Richard,9999,0,9999,0
1668554942367,CSE 294,A00,102459,Voelker; Geoffrey M.,0,2,0,0
1668554942367,CSE 294,B00,111322,Orailoglu; Alex,0,2,0,0
1668554942803,DSE 201,A00,096914,Deutsch; Alin Bernard,30,0,30,0
1668554943228,DSE 210,A00,096915,Dasgupta; Sanjoy,30,0,30,0
1668554943660,DSE 260A,A00,096916,Altintas De Callaf; Ilkay,30,0,30,0
1668554944113,ECE 200,001,103586,Antipa; Nicholas A,9999,0,9999,0
1668554944113,ECE 200,002,103587,Atanasov; Nikolay A.,9999,0,9999,0
1668554944113,ECE 200,003,103588,Bharadia; Dinesh,9999,0,9999,0
1668554944113,ECE 200,004,103589,Cheng; Chung Kuan,9999,0,9999,0
1668554944113,ECE 200,005,103590,Cosman; Pamela C.,9999,0,9999,0
1668554944113,ECE 200,006,103591,Dayeh; Shadi Ahmad,9999,0,9999,0
1668554944113,ECE 200,007,103592,Fainman; Yeshaiahu,9999,0,9999,0
1668554944113,ECE 200,008,103593,Ford; Joseph Earl,9999,0,9999,0
1668554944113,ECE 200,009,103594,Franceschetti; Massimo,9999,0,9999,0
1668554944113,ECE 200,010,103595,Fullerton; Eric E,9999,0,9999,0
1668554944113,ECE 200,011,103596,Galton; Ian A,9999,0,9999,0
1668554944113,ECE 200,012,103597,Gilja; Vikash,9999,0,9999,0
1668554944113,ECE 200,013,103598,Hall; Drew A.,9999,0,9999,0
1668554944113,ECE 200,014,103599,Hsueh; Tzu-Chien,9999,0,9999,0
1668554944113,ECE 200,015,103600,Javidi; Tara,9999,0,9999,0
1668554944113,ECE 200,016,103601,Kahng; Andrew Byun,9999,0,9999,0
1668554944113,ECE 200,017,103602,Kim; Young-Han,9999,0,9999,0
1668554944113,ECE 200,018,103603,Koushanfar; Farinaz,9999,0,9999,0
1668554944113,ECE 200,019,103604,Kuzum; Duygu,9999,0,9999,0
1668554944113,ECE 200,020,103605,Le; Hanh-Phuc,9999,0,9999,0
1668554944113,ECE 200,021,103606,Lin; Bill,9999,0,9999,0
1668554944113,ECE 200,022,103607,Liu; Zhaowei,9998,0,9999,1
1668554944113,ECE 200,023,103608,Lo; Yu-Hwa,9999,0,9999,0
1668554944113,ECE 200,024,103609,Lomakin; Vitaliy,9999,0,9999,0
1668554944113,ECE 200,025,103610,Mercier; Patrick Philip,9999,0,9999,0
1668554944113,ECE 200,026,103611,Meyer; Florian,9999,0,9999,0
1668554944113,ECE 200,027,103612,Milstein; Laurence B.,9999,0,9999,0
1668554944113,ECE 200,028,103613,Mir Arabbaygi; Siavash,9999,0,9999,0
1668554944113,ECE 200,029,103614,Mookherjea; Shayan,9999,0,9999,0
1668554944113,ECE 200,030,103615,Morris; Karcher William,9999,0,9999,0
1668554944113,ECE 200,031,103616,Ng; Tse Nga,9999,0,9999,0
1668554944113,ECE 200,032,103617,Nguyen; Truong Quang,9999,0,9999,0
1668554944113,ECE 200,033,103618,Nomura; Kenji,9999,0,9999,0
1668554944113,ECE 200,034,103619,Orlitsky; Alon,9999,0,9999,0
1668554944113,ECE 200,035,103620,Pal; Piya,9999,0,9999,0
1668554944113,ECE 200,036,103621,Papen; George C.,9999,0,9999,0
1668554944113,ECE 200,037,103622,Radic; Stojan,9999,0,9999,0
1668554944113,ECE 200,038,103623,Rao; Bhaskar D.,9999,0,9999,0
1668554944113,ECE 200,039,103624,Rao; Ramesh R,9999,0,9999,0
1668554944113,ECE 200,040,103625,Rebeiz; Gabriel,9999,0,9999,0
1668554944113,ECE 200,041,103626,Sanford; John R,9999,0,9999,0
1668554944113,ECE 200,042,103627,Siegel; Paul H.,9999,0,9999,0
1668554944113,ECE 200,043,103628,Sievenpiper; Daniel F.,9999,0,9999,0
1668554944113,ECE 200,044,103629,Sworder; David D.,9999,0,9999,0
1668554944113,ECE 200,045,103630,Taur; Yuan,9999,0,9999,0
1668554944113,ECE 200,046,103631,Touri; Behrouz,9999,0,9999,0
1668554944113,ECE 200,047,103632,Trivedi; Mohan M.,9999,0,9999,0
1668554944113,ECE 200,048,103633,Vasconcelos; Nuno,9999,0,9999,0
1668554944113,ECE 200,049,103634,Wang; Xiaolong,9999,0,9999,0
1668554944113,ECE 200,050,103635,Xie; Pengtao,9999,0,9999,0
1668554944113,ECE 200,051,103636,Yip; Michael,9999,0,9999,0
1668554944113,ECE 200,052,103637,Zeger; Kenneth A.,999,0,999,0
1668554944113,ECE 200,053,103638,Zhang; Xinyu,9999,0,9999,0
1668554944113,ECE 200,054,103639,Turakhia; Yatish Girish,9999,0,9999,0
1668554944113,ECE 200,055,103640,Kang; Mingu,9999,0,9999,0
1668554944113,ECE 200,056,103641,Shi; Yuanyuan,9999,0,9999,0
1668554944113,ECE 200,057,103642,Wang; Edward Jay,9999,0,9999,0
1668554944113,ECE 200,058,103643,Zheng; Yang,9999,0,9999,0
1668554944636,ECE 202,A00,103644,Kuzum; Duygu,0,45,0,0
1668554945071,ECE 212BN,A00,103646,Ng; Tse Nga,0,9,0,0
1668554945498,ECE 221,A00,111493,Staff,0,0,0,0
1668554945924,ECE 222B,A00,103647,Lomakin; Vitaliy,0,20,0,0
1668554946352,ECE 230B,A00,103648,Taur; Yuan,0,4,0,0
1668554946787,ECE 238B,A00,103649,Garay; Javier,0,0,0,0
1668554947223,ECE 240B,A00,112900,Fainman; Yeshaiahu,0,8,0,0
1668554947654,ECE 247A,A00,103650,Jokerst; Jesse Vincent,0,6,0,0
1668554948084,ECE 247B,A00,103651,Wang; Joseph,0,14,0,0
1668554948514,ECE 250,A00,103652,Siegel; Paul H.,0,84,0,0
1668554948947,ECE 251A,A00,103654,Rao; Bhaskar D.,0,63,0,0
1668554949372,ECE 257B,A00,103655,Bharadia; Dinesh,0,33,0,0
1668554949794,ECE 258A,A00,103656,Milstein; Laurence B.,0,29,0,0
1668554950238,ECE 260B,A00,103658,Kang; Mingu,0,123,0,0
1668554950669,ECE 264A,A00,103659,Galton; Ian A,0,73,0,0
1668554951100,ECE 265A,A00,103661,Gudem; Prasad S.S.,0,74,0,0
1668554951525,ECE 265D,A00,103662,Gudem; Prasad S.S.,0,26,0,0
1668554951953,ECE 268,A00,103663,Koushanfar; Farinaz,0,43,0,0
1668554952376,ECE 269,A01,103665,Pal; Piya,0,221,0,0
1668554952803,ECE 271B,A00,103666,Vasconcelos; Manuela,0,78,0,0
1668554953227,ECE 276A,A00,103667,Atanasov; Nikolay A.,0,127,0,0
1668554953651,ECE 277,A00,103668,An; Cheolhong,0,151,0,0
1668554954087,ECE 279,A00,117947,Hall; Drew A.,0,22,0,0
1668554954940,ECE 283,A00,103670,Hsueh; Tzu-Chien,0,57,0,0
1668554955368,ECE 284,A00,103671,Turakhia; Yatish Girish,0,41,0,0
1668554955792,ECE 285,A00,103672,Zheng; Yang,0,40,0,0
1668554955792,ECE 285,B00,103673,Sworder; David D.,0,61,0,0
1668554956215,ECE 287,A00,103676,Javidi; Tara,0,8,0,0
1668554956642,MATH 200B,A00,098023,Salehi Golsefidy; Alireza,10,0,15,5
1668554957068,MATH 202B,A00,098024,Rhoades; Brendon Patrick,7,0,15,8
1668554957499,MATH 203B,A00,098025,Oprea; Dragos N.,9,0,15,6
1668554957923,MATH 204B,A00,098026,Sorensen; Claus M,13,0,15,2
1668554958361,MATH 208,A00,098027,Izadi; Elham,7,0,10,3
1668554958796,MATH 209,A00,098028,Pollack; Aaron,10,0,10,0
1668554959244,MATH 211A,A00,112919,Rogalski; Daniel,8,0,10,2
1668554959671,MATH 211B,A00,112920,Seward; Brandon M.,9,0,10,1
1668554960098,MATH 218,A00,098029,Li; Bo,10,0,10,0
1668554960534,MATH 220B,A00,098030,Novak; Jonathan I,11,0,15,4
1668554960962,MATH 221A,A00,098031,Ebenfelt; Peter F,12,0,15,3
1668554961393,MATH 231B,A00,098032,Zlatos; Andrej,9,0,15,6
1668554961821,MATH 240B,A00,098033,Ni; Lei,7,0,15,8
1668554962244,MATH 243,A00,098034,Jekel; David Andrew,10,0,10,0
1668554962670,MATH 245A,A00,098035,Nie; Jiawang,0,7,15,18
1668554963094,MATH 248,A00,098036,Bejenaru; Ioan,10,0,10,0
1668554963520,MATH 250B,A00,098037,Spolaor; Luca,13,0,15,2
1668554963942,MATH 258,A00,098038,Ni; Lei,8,0,10,2
1668554964370,MATH 264B,A00,098041,Rhoades; Brendon Patrick,8,0,15,7
1668554964796,MATH 268,A00,098042,Buss; Samuel R,10,0,10,0
1668554965232,MATH 269,A00,098043,Rhoades; Brendon Patrick,10,0,10,0
1668554965656,MATH 270B,A00,098044,Li; Bo,6,0,15,9
1668554966099,MATH 272B,A00,098045,Holst; Michael J,13,0,15,2
1668554966524,MATH 273A,A00,098046,Tian; Xiaochuan,10,0,15,5
1668554966949,MATH 275,A01,098048,Tian; Xiaochuan,6,0,10,4
1668554967382,MATH 278A,A00,098049,Holst; Michael J,6,0,10,4
1668554967813,MATH 278B,A00,098050,Cloninger; Alexander,10,0,10,0
1668554968242,MATH 278C,A00,098051,Nie; Jiawang,5,0,10,5
1668554968678,MATH 280B,A00,098052,Zheng; Tianyi,7,0,15,8
1668554969102,MATH 281B,A00,098053,Bradic; Jelena,0,2,15,15
1668554969528,MATH 282B,A00,098054,Arias-Castro; Ery,0,1,15,15
1668554969953,MATH 285,A00,098055,Fitzsimmons; Patrick J,0,4,15,17
1668554970383,MATH 287B,A00,098056,Arias-Castro; Ery,1,0,15,14
1668554970816,MATH 288,A00,098057,Agarwal; Pooja,9,0,10,1
1668554970816,MATH 288,B00,098058,Zhang; Danna,8,0,10,2
1668554970816,MATH 288,C00,098059,Williams; Ruth J,9,0,10,1
1668554971239,MATH 290B,A00,098060,Roberts; Justin Deritter,12,0,15,3
1668554971675,MATH 292,A00,098061,Belmont; Eva Kinoshita,10,0,10,0
1668554972098,MATH 295,A00,098062,Suk; Andrew Hoon,47,0,50,3
1668554972522,MATH 296,A00,098063,Novak; Jonathan I,20,0,20,0
1668554972959,MATH 297,001,098064,Gamst; Anthony Collins,9997,0,9999,2
1668555489457,COGS 205,A00,101395,Chiba; Andrea,19,0,20,1
1668555489891,COGS 210B,001,101404,Greene; Deanna Jacquelyn,9998,0,9999,1
1668555489891,COGS 210B,002,101417,Xia; Haijun,9999,0,9999,0
1668555489891,COGS 210B,003,101422,Nitz; Douglas A.,9999,0,9999,0
1668555489891,COGS 210B,004,101423,Hollan; James D.,9998,0,9999,1
1668555489891,COGS 210B,005,101424,Deak; Gedeon O.,9998,0,9999,1
1668555489891,COGS 210B,006,101425,Rossano; Federico,9999,0,9999,0
1668555490318,COGS 211B,A00,101427,Coulson; Seana M,9996,0,9999,3
1668555490741,COGS 220,A00,101428,Hollan; James D.,0,16,25,25
1668555491166,COGS 229,A00,101429,Dow; Steven P,17,0,25,8
1668555491596,COGS 230,A00,101430,Klemmer; Scott R,6,0,17,11
1668555492023,COGS 234,A00,101431,Xia; Haijun,0,1,25,25
1668555492448,COGS 260,A00,101432,Kiyonaga; Anastasia,21,0,25,4
1668555492448,COGS 260,B00,101433,Kirsh; David Joel,15,0,25,10
1668555492873,CSE 202,A00,102371,Impagliazzo; Russell,0,70,0,0
1668555493300,CSE 203B,A01,102373,Cheng; Chung Kuan,0,65,0,0
1668555493723,CSE 208,A00,102374,Micciancio; Daniele,0,5,0,0
1668555494148,CSE 209A,A00,112895,Impagliazzo; Russell,0,13,15,15
1668555494632,CSE 209B,A00,108005,Bellare; Mihir,0,7,0,0
1668555495059,CSE 210,A00,113163,Coblenz; Michael J,0,92,0,0
1668555495485,CSE 219,A00,106111,Dow; Steven P,0,8,20,20
1668555495913,CSE 221,A00,102376,Voelker; Geoffrey M.,0,76,0,0
1668555496342,CSE 224,A01,102378,Porter; George M,0,176,0,0
1668555496769,CSE 229A,A00,102379,Savage; Stefan,0,11,0,0
1668555497193,CSE 229C,A00,102380,Munyaka; Imani N. S.,0,10,0,0
1668555497620,CSE 232B,A00,102382,Deutsch; Alin Bernard,0,39,0,0
1668555498044,CSE 234,A01,112904,Kumar; Arun Kumar,0,0,0,0
1668555498479,CSE 237A,A00,102383,Rosing; Tajana Simunic,0,57,0,0
1668555498906,CSE 239A,A00,102384,Deutsch; Alin Bernard,0,16,0,0
1668555499332,CSE 239B,A00,102385,Polikarpova; Nadezhda,0,11,0,0
1668555499760,CSE 240A,A00,102386,Pannuto; Patrick William,0,48,0,0
1668555500189,CSE 240B,A00,102387,Zhao; Jishen,0,51,0,0
1668555500612,CSE 241A,A00,106406,Kang; Mingu,0,9,0,0
1668555501043,CSE 249B,A00,102388,Kahng; Andrew Byun,0,5,8,8
1668555501471,CSE 251B,A01,102392,Cottrell; Garrison W,0,52,0,0
1668555501471,CSE 251B,A02,102393,Cottrell; Garrison W,0,35,0,0
1668555501898,CSE 252B,A00,102394,Ochoa; Benjamin Lawrence,0,64,0,0
1668555502329,CSE 257,A01,102396,Gao; Sicun,0,155,0,0
1668555502756,CSE 272,A00,102397,Li; Tzumao,0,22,0,0
1668555503186,CSE 274,A00,111323,Chern; Albert Ren-Haur,0,16,0,0
1668555503609,CSE 282,A00,102398,Pevzner; Pavel Arkadjevich,0,0,0,0
1668555504035,CSE 284,A00,114175,Gymrek; Melissa Ann,0,30,0,0
1668555504468,CSE 290,A00,102399,Chandraker; Manmohan Krishna,0,11,0,0
1668555504468,CSE 290,B00,102400,Vaccaro; Kristen Marie,0,8,25,25
1668555504468,CSE 290,C00,102414,Pannuto; Patrick William,0,1,25,25
1668555504468,CSE 290,D00,102427,Pevzner; Pavel Arkadjevich,0,0,0,0
1668555504468,CSE 290,E00,102429,Zhao; Jishen,0,6,0,0
1668555504468,CSE 290,F00,102436,Tullsen; Dean Michael,0,6,0,0
1668555504468,CSE 290,G00,102440,Christensen; Henrik I,0,6,20,20
1668555504895,CSE 291,A00,102443,Su; Hao,0,0,0,0
1668555504895,CSE 291,B00,102448,Polikarpova; Nadezhda,0,0,0,0
1668555504895,CSE 291,C00,102453,Vaccaro; Kristen Marie,0,0,0,0
1668555504895,CSE 291,D00,111343,Savage; Stefan,0,0,0,0
1668555504895,CSE 291,E00,116474,Claffy; Kimberly Claire,0,0,0,0
1668555504895,CSE 291,F00,116479,Pasquale; Joseph,0,0,0,0
1668555505350,CSE 293,001,119111,Bafna; Vineet,9999,0,9999,0
1668555505350,CSE 293,002,119118,Bellare; Mihir,9999,0,9999,0
1668555505350,CSE 293,003,119122,Berg-Kirkpatrick; Taylor D,9999,0,9999,0
1668555505350,CSE 293,004,119135,Christensen; Henrik I,9999,0,9999,0
1668555505350,CSE 293,005,119142,Cottrell; Garrison W,9999,0,9999,0
1668555505350,CSE 293,006,119146,Deutsch; Alin Bernard,9999,0,9999,0
1668555505350,CSE 293,007,119159,Esmaeilzadeh; Hadi,9999,0,9999,0
1668555505350,CSE 293,008,119166,Freund; Yoav,9999,0,9999,0
1668555505350,CSE 293,009,119170,Griswold; William G.,9999,0,9999,0
1668555505350,CSE 293,010,119183,Gymrek; Melissa Ann,9999,0,9999,0
1668555505350,CSE 293,011,119190,Heninger; Nadia A,9999,0,9999,0
1668555505350,CSE 293,012,119230,Impagliazzo; Russell,9999,0,9999,0
1668555505350,CSE 293,013,119232,Jhala; Ranjit,9999,0,9999,0
1668555505350,CSE 293,014,119233,Kahng; Andrew Byun,9999,0,9999,0
1668555505350,CSE 293,015,119298,Kane; Daniel Mertz,9999,0,9999,0
1668555505350,CSE 293,016,119299,Kriegman; David J,9999,0,9999,0
1668555505350,CSE 293,017,119300,Kumar; Arun Kumar,9999,0,9999,0
1668555505350,CSE 293,018,119301,Lerner; Sorin,9999,0,9999,0
1668555505350,CSE 293,019,119302,Lovett; Shachar,9999,0,9999,0
1668555505350,CSE 293,020,119303,McAuley; Julian John,9999,0,9999,0
1668555505350,CSE 293,021,119304,Micciancio; Daniele,9999,0,9999,0
1668555505350,CSE 293,022,119367,Orailoglu; Alex,9999,0,9999,0
1668555505350,CSE 293,023,119382,Paturi; Ramamohan,9999,0,9999,0
1668555505350,CSE 293,024,119404,Polikarpova; Nadezhda,9999,0,9999,0
1668555505350,CSE 293,025,119406,Politz; Joseph Gibbs,9999,0,9999,0
1668555505350,CSE 293,026,119411,Porter; George M,9999,0,9999,0
1668555505350,CSE 293,027,119414,Porter; Leonard Emerson,9999,0,9999,0
1668555505350,CSE 293,028,119416,Ramamoorthi; Ravi,9999,0,9999,0
1668555505350,CSE 293,029,119417,Sahoo; Debashis,9999,0,9999,0
1668555505350,CSE 293,030,119420,Saul; Lawrence,9999,0,9999,0
1668555505350,CSE 293,031,119421,Savage; Stefan,9999,0,9999,0
1668555505350,CSE 293,032,119425,Schulze; Jurgen P.,9999,0,9999,0
1668555505350,CSE 293,033,119426,Snoeren; Alex C.,9999,0,9999,0
1668555505350,CSE 293,034,119428,Shang; Jingbo,9999,0,9999,0
1668555505350,CSE 293,035,119430,Stefan; Deian,9999,0,9999,0
1668555505350,CSE 293,036,119431,Su; Hao,9999,0,9999,0
1668555505350,CSE 293,037,119433,Swanson; Steven James,9999,0,9999,0
1668555505350,CSE 293,038,119435,Tullsen; Dean Michael,9999,0,9999,0
1668555505350,CSE 293,039,119483,Voelker; Geoffrey M.,9999,0,9999,0
1668555505350,CSE 293,040,119537,Zhao; Jishen,9999,0,9999,0
1668555505350,CSE 293,041,119538,Zhou; Yuan-Yuan,9999,0,9999,0
1668555505350,CSE 293,042,119539,Gao; Sicun,9999,0,9999,0
1668555505350,CSE 293,043,119540,Weibel; Nadir,9999,0,9999,0
1668555505350,CSE 293,044,119541,Gupta; Rajesh K.,9999,0,9999,0
1668555505350,CSE 293,045,126410,Vaccaro; Kristen Marie,9999,0,9999,0
1668555505350,CSE 293,046,126411,Klemke; Richard,9999,0,9999,0
1668555505778,CSE 294,A00,102459,Voelker; Geoffrey M.,0,2,0,0
1668555505778,CSE 294,B00,111322,Orailoglu; Alex,0,2,0,0
1668555506201,DSE 201,A00,096914,Deutsch; Alin Bernard,30,0,30,0
1668555506626,DSE 210,A00,096915,Dasgupta; Sanjoy,30,0,30,0
1668555507057,DSE 260A,A00,096916,Altintas De Callaf; Ilkay,30,0,30,0
1668555507490,ECE 200,001,103586,Antipa; Nicholas A,9999,0,9999,0
1668555507490,ECE 200,002,103587,Atanasov; Nikolay A.,9999,0,9999,0
1668555507490,ECE 200,003,103588,Bharadia; Dinesh,9999,0,9999,0
1668555507490,ECE 200,004,103589,Cheng; Chung Kuan,9999,0,9999,0
1668555507490,ECE 200,005,103590,Cosman; Pamela C.,9999,0,9999,0
1668555507490,ECE 200,006,103591,Dayeh; Shadi Ahmad,9999,0,9999,0
1668555507490,ECE 200,007,103592,Fainman; Yeshaiahu,9999,0,9999,0
1668555507490,ECE 200,008,103593,Ford; Joseph Earl,9999,0,9999,0
1668555507490,ECE 200,009,103594,Franceschetti; Massimo,9999,0,9999,0
1668555507490,ECE 200,010,103595,Fullerton; Eric E,9999,0,9999,0
1668555507490,ECE 200,011,103596,Galton; Ian A,9999,0,9999,0
1668555507490,ECE 200,012,103597,Gilja; Vikash,9999,0,9999,0
1668555507490,ECE 200,013,103598,Hall; Drew A.,9999,0,9999,0
1668555507490,ECE 200,014,103599,Hsueh; Tzu-Chien,9999,0,9999,0
1668555507490,ECE 200,015,103600,Javidi; Tara,9999,0,9999,0
1668555507490,ECE 200,016,103601,Kahng; Andrew Byun,9999,0,9999,0
1668555507490,ECE 200,017,103602,Kim; Young-Han,9999,0,9999,0
1668555507490,ECE 200,018,103603,Koushanfar; Farinaz,9999,0,9999,0
1668555507490,ECE 200,019,103604,Kuzum; Duygu,9999,0,9999,0
1668555507490,ECE 200,020,103605,Le; Hanh-Phuc,9999,0,9999,0
1668555507490,ECE 200,021,103606,Lin; Bill,9999,0,9999,0
1668555507490,ECE 200,022,103607,Liu; Zhaowei,9998,0,9999,1
1668555507490,ECE 200,023,103608,Lo; Yu-Hwa,9999,0,9999,0
1668555507490,ECE 200,024,103609,Lomakin; Vitaliy,9999,0,9999,0
1668555507490,ECE 200,025,103610,Mercier; Patrick Philip,9999,0,9999,0
1668555507490,ECE 200,026,103611,Meyer; Florian,9999,0,9999,0
1668555507490,ECE 200,027,103612,Milstein; Laurence B.,9999,0,9999,0
1668555507490,ECE 200,028,103613,Mir Arabbaygi; Siavash,9999,0,9999,0
1668555507490,ECE 200,029,103614,Mookherjea; Shayan,9999,0,9999,0
1668555507490,ECE 200,030,103615,Morris; Karcher William,9999,0,9999,0
1668555507490,ECE 200,031,103616,Ng; Tse Nga,9999,0,9999,0
1668555507490,ECE 200,032,103617,Nguyen; Truong Quang,9999,0,9999,0
1668555507490,ECE 200,033,103618,Nomura; Kenji,9999,0,9999,0
1668555507490,ECE 200,034,103619,Orlitsky; Alon,9999,0,9999,0
1668555507490,ECE 200,035,103620,Pal; Piya,9999,0,9999,0
1668555507490,ECE 200,036,103621,Papen; George C.,9999,0,9999,0
1668555507490,ECE 200,037,103622,Radic; Stojan,9999,0,9999,0
1668555507490,ECE 200,038,103623,Rao; Bhaskar D.,9999,0,9999,0
1668555507490,ECE 200,039,103624,Rao; Ramesh R,9999,0,9999,0
1668555507490,ECE 200,040,103625,Rebeiz; Gabriel,9999,0,9999,0
1668555507490,ECE 200,041,103626,Sanford; John R,9999,0,9999,0
1668555507490,ECE 200,042,103627,Siegel; Paul H.,9999,0,9999,0
1668555507490,ECE 200,043,103628,Sievenpiper; Daniel F.,9999,0,9999,0
1668555507490,ECE 200,044,103629,Sworder; David D.,9999,0,9999,0
1668555507490,ECE 200,045,103630,Taur; Yuan,9999,0,9999,0
1668555507490,ECE 200,046,103631,Touri; Behrouz,9999,0,9999,0
1668555507490,ECE 200,047,103632,Trivedi; Mohan M.,9999,0,9999,0
1668555507490,ECE 200,048,103633,Vasconcelos; Nuno,9999,0,9999,0
1668555507490,ECE 200,049,103634,Wang; Xiaolong,9999,0,9999,0
1668555507490,ECE 200,050,103635,Xie; Pengtao,9999,0,9999,0
1668555507490,ECE 200,051,103636,Yip; Michael,9999,0,9999,0
1668555507490,ECE 200,052,103637,Zeger; Kenneth A.,999,0,999,0
1668555507490,ECE 200,053,103638,Zhang; Xinyu,9999,0,9999,0
1668555507490,ECE 200,054,103639,Turakhia; Yatish Girish,9999,0,9999,0
1668555507490,ECE 200,055,103640,Kang; Mingu,9999,0,9999,0
1668555507490,ECE 200,056,103641,Shi; Yuanyuan,9999,0,9999,0
1668555507490,ECE 200,057,103642,Wang; Edward Jay,9999,0,9999,0
1668555507490,ECE 200,058,103643,Zheng; Yang,9999,0,9999,0
1668555507931,ECE 202,A00,103644,Kuzum; Duygu,0,45,0,0
1668555508355,ECE 212BN,A00,103646,Ng; Tse Nga,0,9,0,0
1668555508781,ECE 221,A00,111493,Staff,0,0,0,0
1668555509212,ECE 222B,A00,103647,Lomakin; Vitaliy,0,20,0,0
1668555509649,ECE 230B,A00,103648,Taur; Yuan,0,4,0,0
1668555510073,ECE 238B,A00,103649,Garay; Javier,0,0,0,0
1668555510519,ECE 240B,A00,112900,Fainman; Yeshaiahu,0,8,0,0
1668555510943,ECE 247A,A00,103650,Jokerst; Jesse Vincent,0,6,0,0
1668555511375,ECE 247B,A00,103651,Wang; Joseph,0,14,0,0
1668555511809,ECE 250,A00,103652,Siegel; Paul H.,0,84,0,0
1668555512246,ECE 251A,A00,103654,Rao; Bhaskar D.,0,63,0,0
1668555512672,ECE 257B,A00,103655,Bharadia; Dinesh,0,33,0,0
1668555513098,ECE 258A,A00,103656,Milstein; Laurence B.,0,29,0,0
1668555513526,ECE 260B,A00,103658,Kang; Mingu,0,123,0,0
1668555513948,ECE 264A,A00,103659,Galton; Ian A,0,73,0,0
1668555514383,ECE 265A,A00,103661,Gudem; Prasad S.S.,0,74,0,0
1668555514807,ECE 265D,A00,103662,Gudem; Prasad S.S.,0,26,0,0
1668555515233,ECE 268,A00,103663,Koushanfar; Farinaz,0,43,0,0
1668555515663,ECE 269,A01,103665,Pal; Piya,0,221,0,0
1668555516092,ECE 271B,A00,103666,Vasconcelos; Manuela,0,78,0,0
1668555516531,ECE 276A,A00,103667,Atanasov; Nikolay A.,0,127,0,0
1668555516957,ECE 277,A00,103668,An; Cheolhong,0,151,0,0
1668555517383,ECE 279,A00,117947,Hall; Drew A.,0,22,0,0
1668555518249,ECE 283,A00,103670,Hsueh; Tzu-Chien,0,57,0,0
1668555518672,ECE 284,A00,103671,Turakhia; Yatish Girish,0,41,0,0
1668555519112,ECE 285,A00,103672,Zheng; Yang,0,40,0,0
1668555519112,ECE 285,B00,103673,Sworder; David D.,0,61,0,0
1668555519544,ECE 287,A00,103676,Javidi; Tara,0,8,0,0
1668555519968,MATH 200B,A00,098023,Salehi Golsefidy; Alireza,10,0,15,5
1668555520392,MATH 202B,A00,098024,Rhoades; Brendon Patrick,7,0,15,8
1668555520820,MATH 203B,A00,098025,Oprea; Dragos N.,9,0,15,6
1668555521246,MATH 204B,A00,098026,Sorensen; Claus M,13,0,15,2
1668555521670,MATH 208,A00,098027,Izadi; Elham,7,0,10,3
1668555522107,MATH 209,A00,098028,Pollack; Aaron,10,0,10,0
1668555522540,MATH 211A,A00,112919,Rogalski; Daniel,8,0,10,2
1668555523053,MATH 211B,A00,112920,Seward; Brandon M.,9,0,10,1
1668555523478,MATH 218,A00,098029,Li; Bo,10,0,10,0
1668555523901,MATH 220B,A00,098030,Novak; Jonathan I,11,0,15,4
1668555524326,MATH 221A,A00,098031,Ebenfelt; Peter F,12,0,15,3
1668555524749,MATH 231B,A00,098032,Zlatos; Andrej,9,0,15,6
1668555525190,MATH 240B,A00,098033,Ni; Lei,7,0,15,8
1668555525617,MATH 243,A00,098034,Jekel; David Andrew,10,0,10,0
1668555526050,MATH 245A,A00,098035,Nie; Jiawang,0,7,15,18
1668555526487,MATH 248,A00,098036,Bejenaru; Ioan,10,0,10,0
1668555526920,MATH 250B,A00,098037,Spolaor; Luca,13,0,15,2
1668555527343,MATH 258,A00,098038,Ni; Lei,8,0,10,2
1668555527777,MATH 264B,A00,098041,Rhoades; Brendon Patrick,8,0,15,7
1668555528207,MATH 268,A00,098042,Buss; Samuel R,10,0,10,0
1668555528632,MATH 269,A00,098043,Rhoades; Brendon Patrick,10,0,10,0
1668555529058,MATH 270B,A00,098044,Li; Bo,6,0,15,9
1668555529482,MATH 272B,A00,098045,Holst; Michael J,13,0,15,2
1668555529906,MATH 273A,A00,098046,Tian; Xiaochuan,10,0,15,5
1668555530341,MATH 275,A01,098048,Tian; Xiaochuan,6,0,10,4
1668555530763,MATH 278A,A00,098049,Holst; Michael J,6,0,10,4
1668555531196,MATH 278B,A00,098050,Cloninger; Alexander,10,0,10,0
1668555531635,MATH 278C,A00,098051,Nie; Jiawang,5,0,10,5
1668555532058,MATH 280B,A00,098052,Zheng; Tianyi,7,0,15,8
1668555532489,MATH 281B,A00,098053,Bradic; Jelena,0,2,15,15
1668555532915,MATH 282B,A00,098054,Arias-Castro; Ery,0,1,15,15
1668555533344,MATH 285,A00,098055,Fitzsimmons; Patrick J,0,4,15,17
1668555533776,MATH 287B,A00,098056,Arias-Castro; Ery,1,0,15,14
1668555534202,MATH 288,A00,098057,Agarwal; Pooja,9,0,10,1
1668555534202,MATH 288,B00,098058,Zhang; Danna,8,0,10,2
1668555534202,MATH 288,C00,098059,Williams; Ruth J,9,0,10,1
1668555534631,MATH 290B,A00,098060,Roberts; Justin Deritter,12,0,15,3
1668555535057,MATH 292,A00,098061,Belmont; Eva Kinoshita,10,0,10,0
1668555535490,MATH 295,A00,098062,Suk; Andrew Hoon,47,0,50,3
1668555535919,MATH 296,A00,098063,Novak; Jonathan I,20,0,20,0
1668555536344,MATH 297,001,098064,Gamst; Anthony Collins,9997,0,9999,2
1668556041203,COGS 205,A00,101395,Chiba; Andrea,19,0,20,1
1668556041635,COGS 210B,001,101404,Greene; Deanna Jacquelyn,9998,0,9999,1
1668556041635,COGS 210B,002,101417,Xia; Haijun,9999,0,9999,0
1668556041635,COGS 210B,003,101422,Nitz; Douglas A.,9999,0,9999,0
1668556041635,COGS 210B,004,101423,Hollan; James D.,9998,0,9999,1
1668556041635,COGS 210B,005,101424,Deak; Gedeon O.,9998,0,9999,1
1668556041635,COGS 210B,006,101425,Rossano; Federico,9999,0,9999,0
1668556042075,COGS 211B,A00,101427,Coulson; Seana M,9996,0,9999,3
1668556042571,COGS 220,A00,101428,Hollan; James D.,0,16,25,25
1668556042996,COGS 229,A00,101429,Dow; Steven P,17,0,25,8
1668556043423,COGS 230,A00,101430,Klemmer; Scott R,6,0,17,11
1668556043848,COGS 234,A00,101431,Xia; Haijun,0,1,25,25
1668556044272,COGS 260,A00,101432,Kiyonaga; Anastasia,21,0,25,4
1668556044272,COGS 260,B00,101433,Kirsh; David Joel,15,0,25,10
1668556044696,CSE 202,A00,102371,Impagliazzo; Russell,0,70,0,0
1668556045120,CSE 203B,A01,102373,Cheng; Chung Kuan,0,65,0,0
1668556045554,CSE 208,A00,102374,Micciancio; Daniele,0,5,0,0
1668556045995,CSE 209A,A00,112895,Impagliazzo; Russell,0,13,15,15
1668556046511,CSE 209B,A00,108005,Bellare; Mihir,0,7,0,0
1668556046935,CSE 210,A00,113163,Coblenz; Michael J,0,92,0,0
1668556047370,CSE 219,A00,106111,Dow; Steven P,0,8,20,20
1668556047802,CSE 221,A00,102376,Voelker; Geoffrey M.,0,76,0,0
1668556048233,CSE 224,A01,102378,Porter; George M,0,176,0,0
1668556048666,CSE 229A,A00,102379,Savage; Stefan,0,11,0,0
1668556049091,CSE 229C,A00,102380,Munyaka; Imani N. S.,0,10,0,0
1668556049518,CSE 232B,A00,102382,Deutsch; Alin Bernard,0,39,0,0
1668556049945,CSE 234,A01,112904,Kumar; Arun Kumar,0,0,0,0
1668556050368,CSE 237A,A00,102383,Rosing; Tajana Simunic,0,57,0,0
1668556050799,CSE 239A,A00,102384,Deutsch; Alin Bernard,0,16,0,0
1668556051227,CSE 239B,A00,102385,Polikarpova; Nadezhda,0,11,0,0
1668556051654,CSE 240A,A00,102386,Pannuto; Patrick William,0,48,0,0
1668556052078,CSE 240B,A00,102387,Zhao; Jishen,0,51,0,0
1668556052502,CSE 241A,A00,106406,Kang; Mingu,0,9,0,0
1668556052927,CSE 249B,A00,102388,Kahng; Andrew Byun,0,5,8,8
1668556053369,CSE 251B,A01,102392,Cottrell; Garrison W,0,52,0,0
1668556053369,CSE 251B,A02,102393,Cottrell; Garrison W,0,35,0,0
1668556053791,CSE 252B,A00,102394,Ochoa; Benjamin Lawrence,0,64,0,0
1668556054244,CSE 257,A01,102396,Gao; Sicun,0,155,0,0
1668556054669,CSE 272,A00,102397,Li; Tzumao,0,22,0,0
1668556055100,CSE 274,A00,111323,Chern; Albert Ren-Haur,0,16,0,0
1668556055533,CSE 282,A00,102398,Pevzner; Pavel Arkadjevich,0,0,0,0
1668556055962,CSE 284,A00,114175,Gymrek; Melissa Ann,0,30,0,0
1668556056395,CSE 290,A00,102399,Chandraker; Manmohan Krishna,0,11,0,0
1668556056395,CSE 290,B00,102400,Vaccaro; Kristen Marie,0,8,25,25
1668556056395,CSE 290,C00,102414,Pannuto; Patrick William,0,1,25,25
1668556056395,CSE 290,D00,102427,Pevzner; Pavel Arkadjevich,0,0,0,0
1668556056395,CSE 290,E00,102429,Zhao; Jishen,0,6,0,0
1668556056395,CSE 290,F00,102436,Tullsen; Dean Michael,0,6,0,0
1668556056395,CSE 290,G00,102440,Christensen; Henrik I,0,6,20,20
1668556056818,CSE 291,A00,102443,Su; Hao,0,0,0,0
1668556056818,CSE 291,B00,102448,Polikarpova; Nadezhda,0,0,0,0
1668556056818,CSE 291,C00,102453,Vaccaro; Kristen Marie,0,0,0,0
1668556056818,CSE 291,D00,111343,Savage; Stefan,0,0,0,0
1668556056818,CSE 291,E00,116474,Claffy; Kimberly Claire,0,0,0,0
1668556056818,CSE 291,F00,116479,Pasquale; Joseph,0,0,0,0
1668556057265,CSE 293,001,119111,Bafna; Vineet,9999,0,9999,0
1668556057265,CSE 293,002,119118,Bellare; Mihir,9999,0,9999,0
1668556057265,CSE 293,003,119122,Berg-Kirkpatrick; Taylor D,9999,0,9999,0
1668556057265,CSE 293,004,119135,Christensen; Henrik I,9999,0,9999,0
1668556057265,CSE 293,005,119142,Cottrell; Garrison W,9999,0,9999,0
1668556057265,CSE 293,006,119146,Deutsch; Alin Bernard,9999,0,9999,0
1668556057265,CSE 293,007,119159,Esmaeilzadeh; Hadi,9999,0,9999,0
1668556057265,CSE 293,008,119166,Freund; Yoav,9999,0,9999,0
1668556057265,CSE 293,009,119170,Griswold; William G.,9999,0,9999,0
1668556057265,CSE 293,010,119183,Gymrek; Melissa Ann,9999,0,9999,0
1668556057265,CSE 293,011,119190,Heninger; Nadia A,9999,0,9999,0
1668556057265,CSE 293,012,119230,Impagliazzo; Russell,9999,0,9999,0
1668556057265,CSE 293,013,119232,Jhala; Ranjit,9999,0,9999,0
1668556057265,CSE 293,014,119233,Kahng; Andrew Byun,9999,0,9999,0
1668556057265,CSE 293,015,119298,Kane; Daniel Mertz,9999,0,9999,0
1668556057265,CSE 293,016,119299,Kriegman; David J,9999,0,9999,0
1668556057265,CSE 293,017,119300,Kumar; Arun Kumar,9999,0,9999,0
1668556057265,CSE 293,018,119301,Lerner; Sorin,9999,0,9999,0
1668556057265,CSE 293,019,119302,Lovett; Shachar,9999,0,9999,0
1668556057265,CSE 293,020,119303,McAuley; Julian John,9999,0,9999,0
1668556057265,CSE 293,021,119304,Micciancio; Daniele,9999,0,9999,0
1668556057265,CSE 293,022,119367,Orailoglu; Alex,9999,0,9999,0
1668556057265,CSE 293,023,119382,Paturi; Ramamohan,9999,0,9999,0
1668556057265,CSE 293,024,119404,Polikarpova; Nadezhda,9999,0,9999,0
1668556057265,CSE 293,025,119406,Politz; Joseph Gibbs,9999,0,9999,0
1668556057265,CSE 293,026,119411,Porter; George M,9999,0,9999,0
1668556057265,CSE 293,027,119414,Porter; Leonard Emerson,9999,0,9999,0
1668556057265,CSE 293,028,119416,Ramamoorthi; Ravi,9999,0,9999,0
1668556057265,CSE 293,029,119417,Sahoo; Debashis,9999,0,9999,0
1668556057265,CSE 293,030,119420,Saul; Lawrence,9999,0,9999,0
1668556057265,CSE 293,031,119421,Savage; Stefan,9999,0,9999,0
1668556057265,CSE 293,032,119425,Schulze; Jurgen P.,9999,0,9999,0
1668556057265,CSE 293,033,119426,Snoeren; Alex C.,9999,0,9999,0
1668556057265,CSE 293,034,119428,Shang; Jingbo,9999,0,9999,0
1668556057265,CSE 293,035,119430,Stefan; Deian,9999,0,9999,0
1668556057265,CSE 293,036,119431,Su; Hao,9999,0,9999,0
1668556057265,CSE 293,037,119433,Swanson; Steven James,9999,0,9999,0
1668556057265,CSE 293,038,119435,Tullsen; Dean Michael,9999,0,9999,0
1668556057265,CSE 293,039,119483,Voelker; Geoffrey M.,9999,0,9999,0
1668556057265,CSE 293,040,119537,Zhao; Jishen,9999,0,9999,0
1668556057265,CSE 293,041,119538,Zhou; Yuan-Yuan,9999,0,9999,0
1668556057265,CSE 293,042,119539,Gao; Sicun,9999,0,9999,0
1668556057265,CSE 293,043,119540,Weibel; Nadir,9999,0,9999,0
1668556057265,CSE 293,044,119541,Gupta; Rajesh K.,9999,0,9999,0
1668556057265,CSE 293,045,126410,Vaccaro; Kristen Marie,9999,0,9999,0
1668556057265,CSE 293,046,126411,Klemke; Richard,9999,0,9999,0
1668556057691,CSE 294,A00,102459,Voelker; Geoffrey M.,0,2,0,0
1668556057691,CSE 294,B00,111322,Orailoglu; Alex,0,2,0,0
1668556058114,DSE 201,A00,096914,Deutsch; Alin Bernard,30,0,30,0
1668556058552,DSE 210,A00,096915,Dasgupta; Sanjoy,30,0,30,0
1668556058982,DSE 260A,A00,096916,Altintas De Callaf; Ilkay,30,0,30,0
1668556059415,ECE 200,001,103586,Antipa; Nicholas A,9999,0,9999,0
1668556059415,ECE 200,002,103587,Atanasov; Nikolay A.,9999,0,9999,0
1668556059415,ECE 200,003,103588,Bharadia; Dinesh,9999,0,9999,0
1668556059415,ECE 200,004,103589,Cheng; Chung Kuan,9999,0,9999,0
1668556059415,ECE 200,005,103590,Cosman; Pamela C.,9999,0,9999,0
1668556059415,ECE 200,006,103591,Dayeh; Shadi Ahmad,9999,0,9999,0
1668556059415,ECE 200,007,103592,Fainman; Yeshaiahu,9999,0,9999,0
1668556059415,ECE 200,008,103593,Ford; Joseph Earl,9999,0,9999,0
1668556059415,ECE 200,009,103594,Franceschetti; Massimo,9999,0,9999,0
1668556059415,ECE 200,010,103595,Fullerton; Eric E,9999,0,9999,0
1668556059415,ECE 200,011,103596,Galton; Ian A,9999,0,9999,0
1668556059415,ECE 200,012,103597,Gilja; Vikash,9999,0,9999,0
1668556059415,ECE 200,013,103598,Hall; Drew A.,9999,0,9999,0
1668556059415,ECE 200,014,103599,Hsueh; Tzu-Chien,9999,0,9999,0
1668556059415,ECE 200,015,103600,Javidi; Tara,9999,0,9999,0
1668556059415,ECE 200,016,103601,Kahng; Andrew Byun,9999,0,9999,0
1668556059415,ECE 200,017,103602,Kim; Young-Han,9999,0,9999,0
1668556059415,ECE 200,018,103603,Koushanfar; Farinaz,9999,0,9999,0
1668556059415,ECE 200,019,103604,Kuzum; Duygu,9999,0,9999,0
1668556059415,ECE 200,020,103605,Le; Hanh-Phuc,9999,0,9999,0
1668556059415,ECE 200,021,103606,Lin; Bill,9999,0,9999,0
1668556059415,ECE 200,022,103607,Liu; Zhaowei,9998,0,9999,1
1668556059415,ECE 200,023,103608,Lo; Yu-Hwa,9999,0,9999,0
1668556059415,ECE 200,024,103609,Lomakin; Vitaliy,9999,0,9999,0
1668556059415,ECE 200,025,103610,Mercier; Patrick Philip,9999,0,9999,0
1668556059415,ECE 200,026,103611,Meyer; Florian,9999,0,9999,0
1668556059415,ECE 200,027,103612,Milstein; Laurence B.,9999,0,9999,0
1668556059415,ECE 200,028,103613,Mir Arabbaygi; Siavash,9999,0,9999,0
1668556059415,ECE 200,029,103614,Mookherjea; Shayan,9999,0,9999,0
1668556059415,ECE 200,030,103615,Morris; Karcher William,9999,0,9999,0
1668556059415,ECE 200,031,103616,Ng; Tse Nga,9999,0,9999,0
1668556059415,ECE 200,032,103617,Nguyen; Truong Quang,9999,0,9999,0
1668556059415,ECE 200,033,103618,Nomura; Kenji,9999,0,9999,0
1668556059415,ECE 200,034,103619,Orlitsky; Alon,9999,0,9999,0
1668556059415,ECE 200,035,103620,Pal; Piya,9999,0,9999,0
1668556059415,ECE 200,036,103621,Papen; George C.,9999,0,9999,0
1668556059415,ECE 200,037,103622,Radic; Stojan,9999,0,9999,0
1668556059415,ECE 200,038,103623,Rao; Bhaskar D.,9999,0,9999,0
1668556059415,ECE 200,039,103624,Rao; Ramesh R,9999,0,9999,0
1668556059415,ECE 200,040,103625,Rebeiz; Gabriel,9999,0,9999,0
1668556059415,ECE 200,041,103626,Sanford; John R,9999,0,9999,0
1668556059415,ECE 200,042,103627,Siegel; Paul H.,9999,0,9999,0
1668556059415,ECE 200,043,103628,Sievenpiper; Daniel F.,9999,0,9999,0
1668556059415,ECE 200,044,103629,Sworder; David D.,9999,0,9999,0
1668556059415,ECE 200,045,103630,Taur; Yuan,9999,0,9999,0
1668556059415,ECE 200,046,103631,Touri; Behrouz,9999,0,9999,0
1668556059415,ECE 200,047,103632,Trivedi; Mohan M.,9999,0,9999,0
1668556059415,ECE 200,048,103633,Vasconcelos; Nuno,9999,0,9999,0
1668556059415,ECE 200,049,103634,Wang; Xiaolong,9999,0,9999,0
1668556059415,ECE 200,050,103635,Xie; Pengtao,9999,0,9999,0
1668556059415,ECE 200,051,103636,Yip; Michael,9999,0,9999,0
1668556059415,ECE 200,052,103637,Zeger; Kenneth A.,999,0,999,0
1668556059415,ECE 200,053,103638,Zhang; Xinyu,9999,0,9999,0
1668556059415,ECE 200,054,103639,Turakhia; Yatish Girish,9999,0,9999,0
1668556059415,ECE 200,055,103640,Kang; Mingu,9999,0,9999,0
1668556059415,ECE 200,056,103641,Shi; Yuanyuan,9999,0,9999,0
1668556059415,ECE 200,057,103642,Wang; Edward Jay,9999,0,9999,0
1668556059415,ECE 200,058,103643,Zheng; Yang,9999,0,9999,0
1668556059836,ECE 202,A00,103644,Kuzum; Duygu,0,45,0,0
1668556060270,ECE 212BN,A00,103646,Ng; Tse Nga,0,9,0,0
1668556060696,ECE 221,A00,111493,Staff,0,0,0,0
1668556061130,ECE 222B,A00,103647,Lomakin; Vitaliy,0,20,0,0
1668556061554,ECE 230B,A00,103648,Taur; Yuan,0,4,0,0
1668556061982,ECE 238B,A00,103649,Garay; Javier,0,0,0,0
1668556062415,ECE 240B,A00,112900,Fainman; Yeshaiahu,0,8,0,0
1668556062843,ECE 247A,A00,103650,Jokerst; Jesse Vincent,0,6,0,0
1668556063269,ECE 247B,A00,103651,Wang; Joseph,0,14,0,0
1668556063710,ECE 250,A00,103652,Siegel; Paul H.,0,84,0,0
1668556064147,ECE 251A,A00,103654,Rao; Bhaskar D.,0,63,0,0
1668556064570,ECE 257B,A00,103655,Bharadia; Dinesh,0,33,0,0
1668556065008,ECE 258A,A00,103656,Milstein; Laurence B.,0,29,0,0
1668556065431,ECE 260B,A00,103658,Kang; Mingu,0,123,0,0
1668556065857,ECE 264A,A00,103659,Galton; Ian A,0,73,0,0
1668556066281,ECE 265A,A00,103661,Gudem; Prasad S.S.,0,74,0,0
1668556066718,ECE 265D,A00,103662,Gudem; Prasad S.S.,0,26,0,0
1668556067147,ECE 268,A00,103663,Koushanfar; Farinaz,0,43,0,0
1668556067576,ECE 269,A01,103665,Pal; Piya,0,221,0,0
1668556068023,ECE 271B,A00,103666,Vasconcelos; Manuela,0,78,0,0
1668556068450,ECE 276A,A00,103667,Atanasov; Nikolay A.,0,127,0,0
1668556068890,ECE 277,A00,103668,An; Cheolhong,0,151,0,0
1668556069320,ECE 279,A00,117947,Hall; Drew A.,0,22,0,0
1668556070182,ECE 283,A00,103670,Hsueh; Tzu-Chien,0,57,0,0
1668556070605,ECE 284,A00,103671,Turakhia; Yatish Girish,0,41,0,0
1668556071028,ECE 285,A00,103672,Zheng; Yang,0,41,0,0
1668556071028,ECE 285,B00,103673,Sworder; David D.,0,61,0,0
1668556071456,ECE 287,A00,103676,Javidi; Tara,0,8,0,0
1668556071886,MATH 200B,A00,098023,Salehi Golsefidy; Alireza,10,0,15,5
1668556072314,MATH 202B,A00,098024,Rhoades; Brendon Patrick,7,0,15,8
1668556072745,MATH 203B,A00,098025,Oprea; Dragos N.,9,0,15,6
1668556073177,MATH 204B,A00,098026,Sorensen; Claus M,13,0,15,2
1668556073613,MATH 208,A00,098027,Izadi; Elham,7,0,10,3
1668556074057,MATH 209,A00,098028,Pollack; Aaron,10,0,10,0
1668556074482,MATH 211A,A00,112919,Rogalski; Daniel,8,0,10,2
1668556074909,MATH 211B,A00,112920,Seward; Brandon M.,9,0,10,1
1668556075333,MATH 218,A00,098029,Li; Bo,10,0,10,0
1668556075763,MATH 220B,A00,098030,Novak; Jonathan I,11,0,15,4
1668556076194,MATH 221A,A00,098031,Ebenfelt; Peter F,12,0,15,3
1668556076630,MATH 231B,A00,098032,Zlatos; Andrej,9,0,15,6
1668556077064,MATH 240B,A00,098033,Ni; Lei,7,0,15,8
1668556077488,MATH 243,A00,098034,Jekel; David Andrew,10,0,10,0
1668556077918,MATH 245A,A00,098035,Nie; Jiawang,0,7,15,18
1668556078355,MATH 248,A00,098036,Bejenaru; Ioan,10,0,10,0
1668556078786,MATH 250B,A00,098037,Spolaor; Luca,13,0,15,2
1668556079210,MATH 258,A00,098038,Ni; Lei,8,0,10,2
1668556079637,MATH 264B,A00,098041,Rhoades; Brendon Patrick,8,0,15,7
1668556080074,MATH 268,A00,098042,Buss; Samuel R,10,0,10,0
1668556080515,MATH 269,A00,098043,Rhoades; Brendon Patrick,10,0,10,0
1668556080944,MATH 270B,A00,098044,Li; Bo,6,0,15,9
1668556081375,MATH 272B,A00,098045,Holst; Michael J,13,0,15,2
1668556081805,MATH 273A,A00,098046,Tian; Xiaochuan,10,0,15,5
1668556082232,MATH 275,A01,098048,Tian; Xiaochuan,6,0,10,4
1668556082666,MATH 278A,A00,098049,Holst; Michael J,6,0,10,4
1668556083094,MATH 278B,A00,098050,Cloninger; Alexander,10,0,10,0
1668556083520,MATH 278C,A00,098051,Nie; Jiawang,5,0,10,5
1668556083945,MATH 280B,A00,098052,Zheng; Tianyi,7,0,15,8
1668556084370,MATH 281B,A00,098053,Bradic; Jelena,0,2,15,15
1668556084793,MATH 282B,A00,098054,Arias-Castro; Ery,0,1,15,15
1668556085216,MATH 285,A00,098055,Fitzsimmons; Patrick J,0,4,15,17
1668556085657,MATH 287B,A00,098056,Arias-Castro; Ery,1,0,15,14
1668556086091,MATH 288,A00,098057,Agarwal; Pooja,9,0,10,1
1668556086091,MATH 288,B00,098058,Zhang; Danna,8,0,10,2
1668556086091,MATH 288,C00,098059,Williams; Ruth J,9,0,10,1
1668556086515,MATH 290B,A00,098060,Roberts; Justin Deritter,12,0,15,3
1668556086950,MATH 292,A00,098061,Belmont; Eva Kinoshita,10,0,10,0
1668556087373,MATH 295,A00,098062,Suk; Andrew Hoon,47,0,50,3
1668556087808,MATH 296,A00,098063,Novak; Jonathan I,20,0,20,0
1668556088253,MATH 297,001,098064,Gamst; Anthony Collins,9997,0,9999,2
1668556593762,COGS 205,A00,101395,Chiba; Andrea,19,0,20,1
1668556594185,COGS 210B,001,101404,Greene; Deanna Jacquelyn,9998,0,9999,1
1668556594185,COGS 210B,002,101417,Xia; Haijun,9999,0,9999,0
1668556594185,COGS 210B,003,101422,Nitz; Douglas A.,9999,0,9999,0
1668556594185,COGS 210B,004,101423,Hollan; James D.,9998,0,9999,1
1668556594185,COGS 210B,005,101424,Deak; Gedeon O.,9998,0,9999,1
1668556594185,COGS 210B,006,101425,Rossano; Federico,9999,0,9999,0
1668556594611,COGS 211B,A00,101427,Coulson; Seana M,9996,0,9999,3
1668556595047,COGS 220,A00,101428,Hollan; James D.,0,16,25,25
1668556595472,COGS 229,A00,101429,Dow; Steven P,17,0,25,8
1668556595901,COGS 230,A00,101430,Klemmer; Scott R,6,0,17,11
1668556596329,COGS 234,A00,101431,Xia; Haijun,0,1,25,25
1668556596754,COGS 260,A00,101432,Kiyonaga; Anastasia,21,0,25,4
1668556596754,COGS 260,B00,101433,Kirsh; David Joel,15,0,25,10
1668556597176,CSE 202,A00,102371,Impagliazzo; Russell,0,70,0,0
1668556597610,CSE 203B,A01,102373,Cheng; Chung Kuan,0,65,0,0
1668556598035,CSE 208,A00,102374,Micciancio; Daniele,0,5,0,0
1668556598460,CSE 209A,A00,112895,Impagliazzo; Russell,0,13,15,15
1668556598885,CSE 209B,A00,108005,Bellare; Mihir,0,7,0,0
1668556599317,CSE 210,A00,113163,Coblenz; Michael J,0,92,0,0
1668556599754,CSE 219,A00,106111,Dow; Steven P,0,8,20,20
1668556600186,CSE 221,A00,102376,Voelker; Geoffrey M.,0,76,0,0
1668556600620,CSE 224,A01,102378,Porter; George M,0,176,0,0
1668556601051,CSE 229A,A00,102379,Savage; Stefan,0,11,0,0
1668556601482,CSE 229C,A00,102380,Munyaka; Imani N. S.,0,10,0,0
1668556601906,CSE 232B,A00,102382,Deutsch; Alin Bernard,0,39,0,0
1668556602330,CSE 234,A01,112904,Kumar; Arun Kumar,0,0,0,0
1668556602760,CSE 237A,A00,102383,Rosing; Tajana Simunic,0,57,0,0
1668556603212,CSE 239A,A00,102384,Deutsch; Alin Bernard,0,16,0,0
1668556603650,CSE 239B,A00,102385,Polikarpova; Nadezhda,0,11,0,0
1668556604073,CSE 240A,A00,102386,Pannuto; Patrick William,0,48,0,0
1668556604505,CSE 240B,A00,102387,Zhao; Jishen,0,51,0,0
1668556604936,CSE 241A,A00,106406,Kang; Mingu,0,9,0,0
1668556605368,CSE 249B,A00,102388,Kahng; Andrew Byun,0,5,8,8
1668556605794,CSE 251B,A01,102392,Cottrell; Garrison W,0,52,0,0
1668556605794,CSE 251B,A02,102393,Cottrell; Garrison W,0,35,0,0
1668556606221,CSE 252B,A00,102394,Ochoa; Benjamin Lawrence,0,64,0,0
1668556606644,CSE 257,A01,102396,Gao; Sicun,0,155,0,0
1668556607068,CSE 272,A00,102397,Li; Tzumao,0,22,0,0
1668556607495,CSE 274,A00,111323,Chern; Albert Ren-Haur,0,16,0,0
1668556607916,CSE 282,A00,102398,Pevzner; Pavel Arkadjevich,0,0,0,0
1668556608351,CSE 284,A00,114175,Gymrek; Melissa Ann,0,30,0,0
1668556608783,CSE 290,A00,102399,Chandraker; Manmohan Krishna,0,11,0,0
1668556608783,CSE 290,B00,102400,Vaccaro; Kristen Marie,0,8,25,25
1668556608783,CSE 290,C00,102414,Pannuto; Patrick William,0,1,25,25
1668556608783,CSE 290,D00,102427,Pevzner; Pavel Arkadjevich,0,0,0,0
1668556608783,CSE 290,E00,102429,Zhao; Jishen,0,6,0,0
1668556608783,CSE 290,F00,102436,Tullsen; Dean Michael,0,6,0,0
1668556608783,CSE 290,G00,102440,Christensen; Henrik I,0,6,20,20
1668556609208,CSE 291,A00,102443,Su; Hao,0,0,0,0
1668556609208,CSE 291,B00,102448,Polikarpova; Nadezhda,0,0,0,0
1668556609208,CSE 291,C00,102453,Vaccaro; Kristen Marie,0,0,0,0
1668556609208,CSE 291,D00,111343,Savage; Stefan,0,0,0,0
1668556609208,CSE 291,E00,116474,Claffy; Kimberly Claire,0,0,0,0
1668556609208,CSE 291,F00,116479,Pasquale; Joseph,0,0,0,0
1668556609637,CSE 293,001,119111,Bafna; Vineet,9999,0,9999,0
1668556609637,CSE 293,002,119118,Bellare; Mihir,9999,0,9999,0
1668556609637,CSE 293,003,119122,Berg-Kirkpatrick; Taylor D,9999,0,9999,0
1668556609637,CSE 293,004,119135,Christensen; Henrik I,9999,0,9999,0
1668556609637,CSE 293,005,119142,Cottrell; Garrison W,9999,0,9999,0
1668556609637,CSE 293,006,119146,Deutsch; Alin Bernard,9999,0,9999,0
1668556609637,CSE 293,007,119159,Esmaeilzadeh; Hadi,9999,0,9999,0
1668556609637,CSE 293,008,119166,Freund; Yoav,9999,0,9999,0
1668556609637,CSE 293,009,119170,Griswold; William G.,9999,0,9999,0
1668556609637,CSE 293,010,119183,Gymrek; Melissa Ann,9999,0,9999,0
1668556609637,CSE 293,011,119190,Heninger; Nadia A,9999,0,9999,0
1668556609637,CSE 293,012,119230,Impagliazzo; Russell,9999,0,9999,0
1668556609637,CSE 293,013,119232,Jhala; Ranjit,9999,0,9999,0
1668556609637,CSE 293,014,119233,Kahng; Andrew Byun,9999,0,9999,0
1668556609637,CSE 293,015,119298,Kane; Daniel Mertz,9999,0,9999,0
1668556609637,CSE 293,016,119299,Kriegman; David J,9999,0,9999,0
1668556609637,CSE 293,017,119300,Kumar; Arun Kumar,9999,0,9999,0
1668556609637,CSE 293,018,119301,Lerner; Sorin,9999,0,9999,0
1668556609637,CSE 293,019,119302,Lovett; Shachar,9999,0,9999,0
1668556609637,CSE 293,020,119303,McAuley; Julian John,9999,0,9999,0
1668556609637,CSE 293,021,119304,Micciancio; Daniele,9999,0,9999,0
1668556609637,CSE 293,022,119367,Orailoglu; Alex,9999,0,9999,0
1668556609637,CSE 293,023,119382,Paturi; Ramamohan,9999,0,9999,0
1668556609637,CSE 293,024,119404,Polikarpova; Nadezhda,9999,0,9999,0
1668556609637,CSE 293,025,119406,Politz; Joseph Gibbs,9999,0,9999,0
1668556609637,CSE 293,026,119411,Porter; George M,9999,0,9999,0
1668556609637,CSE 293,027,119414,Porter; Leonard Emerson,9999,0,9999,0
1668556609637,CSE 293,028,119416,Ramamoorthi; Ravi,9999,0,9999,0
1668556609637,CSE 293,029,119417,Sahoo; Debashis,9999,0,9999,0
1668556609637,CSE 293,030,119420,Saul; Lawrence,9999,0,9999,0
1668556609637,CSE 293,031,119421,Savage; Stefan,9999,0,9999,0
1668556609637,CSE 293,032,119425,Schulze; Jurgen P.,9999,0,9999,0
1668556609637,CSE 293,033,119426,Snoeren; Alex C.,9999,0,9999,0
1668556609637,CSE 293,034,119428,Shang; Jingbo,9999,0,9999,0
1668556609637,CSE 293,035,119430,Stefan; Deian,9999,0,9999,0
1668556609637,CSE 293,036,119431,Su; Hao,9999,0,9999,0
1668556609637,CSE 293,037,119433,Swanson; Steven James,9999,0,9999,0
1668556609637,CSE 293,038,119435,Tullsen; Dean Michael,9999,0,9999,0
1668556609637,CSE 293,039,119483,Voelker; Geoffrey M.,9999,0,9999,0
1668556609637,CSE 293,040,119537,Zhao; Jishen,9999,0,9999,0
1668556609637,CSE 293,041,119538,Zhou; Yuan-Yuan,9999,0,9999,0
1668556609637,CSE 293,042,119539,Gao; Sicun,9999,0,9999,0
1668556609637,CSE 293,043,119540,Weibel; Nadir,9999,0,9999,0
1668556609637,CSE 293,044,119541,Gupta; Rajesh K.,9999,0,9999,0
1668556609637,CSE 293,045,126410,Vaccaro; Kristen Marie,9999,0,9999,0
1668556609637,CSE 293,046,126411,Klemke; Richard,9999,0,9999,0
1668556610071,CSE 294,A00,102459,Voelker; Geoffrey M.,0,2,0,0
1668556610071,CSE 294,B00,111322,Orailoglu; Alex,0,2,0,0
1668556610494,DSE 201,A00,096914,Deutsch; Alin Bernard,30,0,30,0
1668556610919,DSE 210,A00,096915,Dasgupta; Sanjoy,30,0,30,0
1668556611342,DSE 260A,A00,096916,Altintas De Callaf; Ilkay,30,0,30,0
1668556611773,ECE 200,001,103586,Antipa; Nicholas A,9999,0,9999,0
1668556611773,ECE 200,002,103587,Atanasov; Nikolay A.,9999,0,9999,0
1668556611773,ECE 200,003,103588,Bharadia; Dinesh,9999,0,9999,0
1668556611773,ECE 200,004,103589,Cheng; Chung Kuan,9999,0,9999,0
1668556611773,ECE 200,005,103590,Cosman; Pamela C.,9999,0,9999,0
1668556611773,ECE 200,006,103591,Dayeh; Shadi Ahmad,9999,0,9999,0
1668556611773,ECE 200,007,103592,Fainman; Yeshaiahu,9999,0,9999,0
1668556611773,ECE 200,008,103593,Ford; Joseph Earl,9999,0,9999,0
1668556611773,ECE 200,009,103594,Franceschetti; Massimo,9999,0,9999,0
1668556611773,ECE 200,010,103595,Fullerton; Eric E,9999,0,9999,0
1668556611773,ECE 200,011,103596,Galton; Ian A,9999,0,9999,0
1668556611773,ECE 200,012,103597,Gilja; Vikash,9999,0,9999,0
1668556611773,ECE 200,013,103598,Hall; Drew A.,9999,0,9999,0
1668556611773,ECE 200,014,103599,Hsueh; Tzu-Chien,9999,0,9999,0
1668556611773,ECE 200,015,103600,Javidi; Tara,9999,0,9999,0
1668556611773,ECE 200,016,103601,Kahng; Andrew Byun,9999,0,9999,0
1668556611773,ECE 200,017,103602,Kim; Young-Han,9999,0,9999,0
1668556611773,ECE 200,018,103603,Koushanfar; Farinaz,9999,0,9999,0
1668556611773,ECE 200,019,103604,Kuzum; Duygu,9999,0,9999,0
1668556611773,ECE 200,020,103605,Le; Hanh-Phuc,9999,0,9999,0
1668556611773,ECE 200,021,103606,Lin; Bill,9999,0,9999,0
1668556611773,ECE 200,022,103607,Liu; Zhaowei,9998,0,9999,1
1668556611773,ECE 200,023,103608,Lo; Yu-Hwa,9999,0,9999,0
1668556611773,ECE 200,024,103609,Lomakin; Vitaliy,9999,0,9999,0
1668556611773,ECE 200,025,103610,Mercier; Patrick Philip,9999,0,9999,0
1668556611773,ECE 200,026,103611,Meyer; Florian,9999,0,9999,0
1668556611773,ECE 200,027,103612,Milstein; Laurence B.,9999,0,9999,0
1668556611773,ECE 200,028,103613,Mir Arabbaygi; Siavash,9999,0,9999,0
1668556611773,ECE 200,029,103614,Mookherjea; Shayan,9999,0,9999,0
1668556611773,ECE 200,030,103615,Morris; Karcher William,9999,0,9999,0
1668556611773,ECE 200,031,103616,Ng; Tse Nga,9999,0,9999,0
1668556611773,ECE 200,032,103617,Nguyen; Truong Quang,9999,0,9999,0
1668556611773,ECE 200,033,103618,Nomura; Kenji,9999,0,9999,0
1668556611773,ECE 200,034,103619,Orlitsky; Alon,9999,0,9999,0
1668556611773,ECE 200,035,103620,Pal; Piya,9999,0,9999,0
1668556611773,ECE 200,036,103621,Papen; George C.,9999,0,9999,0
1668556611773,ECE 200,037,103622,Radic; Stojan,9999,0,9999,0
1668556611773,ECE 200,038,103623,Rao; Bhaskar D.,9999,0,9999,0
1668556611773,ECE 200,039,103624,Rao; Ramesh R,9999,0,9999,0
1668556611773,ECE 200,040,103625,Rebeiz; Gabriel,9999,0,9999,0
1668556611773,ECE 200,041,103626,Sanford; John R,9999,0,9999,0
1668556611773,ECE 200,042,103627,Siegel; Paul H.,9999,0,9999,0
1668556611773,ECE 200,043,103628,Sievenpiper; Daniel F.,9999,0,9999,0
1668556611773,ECE 200,044,103629,Sworder; David D.,9999,0,9999,0
1668556611773,ECE 200,045,103630,Taur; Yuan,9999,0,9999,0
1668556611773,ECE 200,046,103631,Touri; Behrouz,9999,0,9999,0
1668556611773,ECE 200,047,103632,Trivedi; Mohan M.,9999,0,9999,0
1668556611773,ECE 200,048,103633,Vasconcelos; Nuno,9999,0,9999,0
1668556611773,ECE 200,049,103634,Wang; Xiaolong,9999,0,9999,0
1668556611773,ECE 200,050,103635,Xie; Pengtao,9999,0,9999,0
1668556611773,ECE 200,051,103636,Yip; Michael,9999,0,9999,0
1668556611773,ECE 200,052,103637,Zeger; Kenneth A.,999,0,999,0
1668556611773,ECE 200,053,103638,Zhang; Xinyu,9999,0,9999,0
1668556611773,ECE 200,054,103639,Turakhia; Yatish Girish,9999,0,9999,0
1668556611773,ECE 200,055,103640,Kang; Mingu,9999,0,9999,0
1668556611773,ECE 200,056,103641,Shi; Yuanyuan,9999,0,9999,0
1668556611773,ECE 200,057,103642,Wang; Edward Jay,9999,0,9999,0
1668556611773,ECE 200,058,103643,Zheng; Yang,9999,0,9999,0
1668556612197,ECE 202,A00,103644,Kuzum; Duygu,0,45,0,0
1668556612623,ECE 212BN,A00,103646,Ng; Tse Nga,0,9,0,0
1668556613048,ECE 221,A00,111493,Staff,0,0,0,0
1668556613478,ECE 222B,A00,103647,Lomakin; Vitaliy,0,20,0,0
1668556613994,ECE 230B,A00,103648,Taur; Yuan,0,4,0,0
1668556614417,ECE 238B,A00,103649,Garay; Javier,0,0,0,0
1668556614850,ECE 240B,A00,112900,Fainman; Yeshaiahu,0,8,0,0
1668556615276,ECE 247A,A00,103650,Jokerst; Jesse Vincent,0,6,0,0
1668556615710,ECE 247B,A00,103651,Wang; Joseph,0,14,0,0
1668556616137,ECE 250,A00,103652,Siegel; Paul H.,0,84,0,0
1668556616563,ECE 251A,A00,103654,Rao; Bhaskar D.,0,63,0,0
1668556616984,ECE 257B,A00,103655,Bharadia; Dinesh,0,33,0,0
1668556617410,ECE 258A,A00,103656,Milstein; Laurence B.,0,29,0,0
1668556617833,ECE 260B,A00,103658,Kang; Mingu,0,123,0,0
1668556618277,ECE 264A,A00,103659,Galton; Ian A,0,73,0,0
1668556618704,ECE 265A,A00,103661,Gudem; Prasad S.S.,0,74,0,0
1668556619127,ECE 265D,A00,103662,Gudem; Prasad S.S.,0,26,0,0
1668556619564,ECE 268,A00,103663,Koushanfar; Farinaz,0,43,0,0
1668556619991,ECE 269,A01,103665,Pal; Piya,0,221,0,0
1668556620422,ECE 271B,A00,103666,Vasconcelos; Manuela,0,78,0,0
1668556620854,ECE 276A,A00,103667,Atanasov; Nikolay A.,0,127,0,0
1668556621285,ECE 277,A00,103668,An; Cheolhong,0,151,0,0
1668556621708,ECE 279,A00,117947,Hall; Drew A.,0,22,0,0
1668556622563,ECE 283,A00,103670,Hsueh; Tzu-Chien,0,57,0,0
1668556622988,ECE 284,A00,103671,Turakhia; Yatish Girish,0,41,0,0
1668556623428,ECE 285,A00,103672,Zheng; Yang,0,41,0,0
1668556623428,ECE 285,B00,103673,Sworder; David D.,0,61,0,0
1668556623850,ECE 287,A00,103676,Javidi; Tara,0,8,0,0
1668556624277,MATH 200B,A00,098023,Salehi Golsefidy; Alireza,10,0,15,5
1668556624707,MATH 202B,A00,098024,Rhoades; Brendon Patrick,7,0,15,8
1668556625132,MATH 203B,A00,098025,Oprea; Dragos N.,9,0,15,6
1668556625556,MATH 204B,A00,098026,Sorensen; Claus M,13,0,15,2
1668556625996,MATH 208,A00,098027,Izadi; Elham,7,0,10,3
1668556626418,MATH 209,A00,098028,Pollack; Aaron,10,0,10,0
1668556626844,MATH 211A,A00,112919,Rogalski; Daniel,8,0,10,2
1668556627269,MATH 211B,A00,112920,Seward; Brandon M.,9,0,10,1
1668556627693,MATH 218,A00,098029,Li; Bo,10,0,10,0
1668556628117,MATH 220B,A00,098030,Novak; Jonathan I,11,0,15,4
1668556628571,MATH 221A,A00,098031,Ebenfelt; Peter F,12,0,15,3
1668556628996,MATH 231B,A00,098032,Zlatos; Andrej,9,0,15,6
1668556629421,MATH 240B,A00,098033,Ni; Lei,7,0,15,8
1668556629849,MATH 243,A00,098034,Jekel; David Andrew,10,0,10,0
1668556630284,MATH 245A,A00,098035,Nie; Jiawang,0,7,15,18
1668556630716,MATH 248,A00,098036,Bejenaru; Ioan,10,0,10,0
1668556631143,MATH 250B,A00,098037,Spolaor; Luca,13,0,15,2
1668556631569,MATH 258,A00,098038,Ni; Lei,8,0,10,2
1668556631992,MATH 264B,A00,098041,Rhoades; Brendon Patrick,8,0,15,7
1668556632416,MATH 268,A00,098042,Buss; Samuel R,10,0,10,0
1668556632847,MATH 269,A00,098043,Rhoades; Brendon Patrick,10,0,10,0
1668556633274,MATH 270B,A00,098044,Li; Bo,6,0,15,9
1668556633703,MATH 272B,A00,098045,Holst; Michael J,13,0,15,2
1668556634129,MATH 273A,A00,098046,Tian; Xiaochuan,10,0,15,5
1668556634552,MATH 275,A01,098048,Tian; Xiaochuan,6,0,10,4
1668556634979,MATH 278A,A00,098049,Holst; Michael J,6,0,10,4
1668556635405,MATH 278B,A00,098050,Cloninger; Alexander,10,0,10,0
1668556635830,MATH 278C,A00,098051,Nie; Jiawang,5,0,10,5
1668556636252,MATH 280B,A00,098052,Zheng; Tianyi,7,0,15,8
1668556636678,MATH 281B,A00,098053,Bradic; Jelena,0,2,15,15
1668556637108,MATH 282B,A00,098054,Arias-Castro; Ery,0,1,15,15
1668556637530,MATH 285,A00,098055,Fitzsimmons; Patrick J,0,4,15,17
1668556637953,MATH 287B,A00,098056,Arias-Castro; Ery,1,0,15,14
1668556638380,MATH 288,A00,098057,Agarwal; Pooja,9,0,10,1
1668556638380,MATH 288,B00,098058,Zhang; Danna,8,0,10,2
1668556638380,MATH 288,C00,098059,Williams; Ruth J,9,0,10,1
1668556638811,MATH 290B,A00,098060,Roberts; Justin Deritter,12,0,15,3
1668556639236,MATH 292,A00,098061,Belmont; Eva Kinoshita,10,0,10,0
1668556639666,MATH 295,A00,098062,Suk; Andrew Hoon,47,0,50,3
1668556640095,MATH 296,A00,098063,Novak; Jonathan I,20,0,20,0
1668556640518,MATH 297,001,098064,Gamst; Anthony Collins,9997,0,9999,2
1668557144949,COGS 205,A00,101395,Chiba; Andrea,19,0,20,1
1668557145374,COGS 210B,001,101404,Greene; Deanna Jacquelyn,9998,0,9999,1
1668557145374,COGS 210B,002,101417,Xia; Haijun,9999,0,9999,0
1668557145374,COGS 210B,003,101422,Nitz; Douglas A.,9999,0,9999,0
1668557145374,COGS 210B,004,101423,Hollan; James D.,9998,0,9999,1
1668557145374,COGS 210B,005,101424,Deak; Gedeon O.,9998,0,9999,1
1668557145374,COGS 210B,006,101425,Rossano; Federico,9999,0,9999,0
1668557145796,COGS 211B,A00,101427,Coulson; Seana M,9996,0,9999,3
1668557146227,COGS 220,A00,101428,Hollan; James D.,0,16,25,25
1668557146650,COGS 229,A00,101429,Dow; Steven P,17,0,25,8
1668557147072,COGS 230,A00,101430,Klemmer; Scott R,6,0,17,11
1668557147497,COGS 234,A00,101431,Xia; Haijun,0,1,25,25
1668557147923,COGS 260,A00,101432,Kiyonaga; Anastasia,21,0,25,4
1668557147923,COGS 260,B00,101433,Kirsh; David Joel,15,0,25,10
1668557148350,CSE 202,A00,102371,Impagliazzo; Russell,0,70,0,0
1668557148773,CSE 203B,A01,102373,Cheng; Chung Kuan,0,66,0,0
1668557149206,CSE 208,A00,102374,Micciancio; Daniele,0,5,0,0
1668557149628,CSE 209A,A00,112895,Impagliazzo; Russell,0,13,15,15
1668557150062,CSE 209B,A00,108005,Bellare; Mihir,0,7,0,0
1668557150490,CSE 210,A00,113163,Coblenz; Michael J,0,92,0,0
1668557150919,CSE 219,A00,106111,Dow; Steven P,0,8,20,20
1668557151354,CSE 221,A00,102376,Voelker; Geoffrey M.,0,76,0,0
1668557151779,CSE 224,A01,102378,Porter; George M,0,176,0,0
1668557152201,CSE 229A,A00,102379,Savage; Stefan,0,11,0,0
1668557152626,CSE 229C,A00,102380,Munyaka; Imani N. S.,0,10,0,0
1668557153049,CSE 232B,A00,102382,Deutsch; Alin Bernard,0,39,0,0
1668557153473,CSE 234,A01,112904,Kumar; Arun Kumar,0,0,0,0
1668557153895,CSE 237A,A00,102383,Rosing; Tajana Simunic,0,57,0,0
1668557154328,CSE 239A,A00,102384,Deutsch; Alin Bernard,0,16,0,0
1668557154758,CSE 239B,A00,102385,Polikarpova; Nadezhda,0,11,0,0
1668557155194,CSE 240A,A00,102386,Pannuto; Patrick William,0,48,0,0
1668557155620,CSE 240B,A00,102387,Zhao; Jishen,0,51,0,0
1668557156043,CSE 241A,A00,106406,Kang; Mingu,0,9,0,0
1668557156469,CSE 249B,A00,102388,Kahng; Andrew Byun,0,5,8,8
1668557156905,CSE 251B,A01,102392,Cottrell; Garrison W,0,52,0,0
1668557156905,CSE 251B,A02,102393,Cottrell; Garrison W,0,35,0,0
1668557157338,CSE 252B,A00,102394,Ochoa; Benjamin Lawrence,0,64,0,0
1668557157764,CSE 257,A01,102396,Gao; Sicun,0,155,0,0
1668557158212,CSE 272,A00,102397,Li; Tzumao,0,22,0,0
1668557158637,CSE 274,A00,111323,Chern; Albert Ren-Haur,0,16,0,0
1668557159060,CSE 282,A00,102398,Pevzner; Pavel Arkadjevich,0,0,0,0
1668557159484,CSE 284,A00,114175,Gymrek; Melissa Ann,0,30,0,0
1668557159907,CSE 290,A00,102399,Chandraker; Manmohan Krishna,0,11,0,0
1668557159907,CSE 290,B00,102400,Vaccaro; Kristen Marie,0,8,25,25
1668557159907,CSE 290,C00,102414,Pannuto; Patrick William,0,1,25,25
1668557159907,CSE 290,D00,102427,Pevzner; Pavel Arkadjevich,0,0,0,0
1668557159907,CSE 290,E00,102429,Zhao; Jishen,0,6,0,0
1668557159907,CSE 290,F00,102436,Tullsen; Dean Michael,0,6,0,0
1668557159907,CSE 290,G00,102440,Christensen; Henrik I,0,6,20,20
1668557160335,CSE 291,A00,102443,Su; Hao,0,0,0,0
1668557160335,CSE 291,B00,102448,Polikarpova; Nadezhda,0,0,0,0
1668557160335,CSE 291,C00,102453,Vaccaro; Kristen Marie,0,0,0,0
1668557160335,CSE 291,D00,111343,Savage; Stefan,0,0,0,0
1668557160335,CSE 291,E00,116474,Claffy; Kimberly Claire,0,0,0,0
1668557160335,CSE 291,F00,116479,Pasquale; Joseph,0,0,0,0
1668557160763,CSE 293,001,119111,Bafna; Vineet,9999,0,9999,0
1668557160763,CSE 293,002,119118,Bellare; Mihir,9999,0,9999,0
1668557160763,CSE 293,003,119122,Berg-Kirkpatrick; Taylor D,9999,0,9999,0
1668557160763,CSE 293,004,119135,Christensen; Henrik I,9999,0,9999,0
1668557160763,CSE 293,005,119142,Cottrell; Garrison W,9999,0,9999,0
1668557160763,CSE 293,006,119146,Deutsch; Alin Bernard,9999,0,9999,0
1668557160763,CSE 293,007,119159,Esmaeilzadeh; Hadi,9999,0,9999,0
1668557160763,CSE 293,008,119166,Freund; Yoav,9999,0,9999,0
1668557160763,CSE 293,009,119170,Griswold; William G.,9999,0,9999,0
1668557160763,CSE 293,010,119183,Gymrek; Melissa Ann,9999,0,9999,0
1668557160763,CSE 293,011,119190,Heninger; Nadia A,9999,0,9999,0
1668557160763,CSE 293,012,119230,Impagliazzo; Russell,9999,0,9999,0
1668557160763,CSE 293,013,119232,Jhala; Ranjit,9999,0,9999,0
1668557160763,CSE 293,014,119233,Kahng; Andrew Byun,9999,0,9999,0
1668557160763,CSE 293,015,119298,Kane; Daniel Mertz,9999,0,9999,0
1668557160763,CSE 293,016,119299,Kriegman; David J,9999,0,9999,0
1668557160763,CSE 293,017,119300,Kumar; Arun Kumar,9999,0,9999,0
1668557160763,CSE 293,018,119301,Lerner; Sorin,9999,0,9999,0
1668557160763,CSE 293,019,119302,Lovett; Shachar,9999,0,9999,0
1668557160763,CSE 293,020,119303,McAuley; Julian John,9999,0,9999,0
1668557160763,CSE 293,021,119304,Micciancio; Daniele,9999,0,9999,0
1668557160763,CSE 293,022,119367,Orailoglu; Alex,9999,0,9999,0
1668557160763,CSE 293,023,119382,Paturi; Ramamohan,9999,0,9999,0
1668557160763,CSE 293,024,119404,Polikarpova; Nadezhda,9999,0,9999,0
1668557160763,CSE 293,025,119406,Politz; Joseph Gibbs,9999,0,9999,0
1668557160763,CSE 293,026,119411,Porter; George M,9999,0,9999,0
1668557160763,CSE 293,027,119414,Porter; Leonard Emerson,9999,0,9999,0
1668557160763,CSE 293,028,119416,Ramamoorthi; Ravi,9999,0,9999,0
1668557160763,CSE 293,029,119417,Sahoo; Debashis,9999,0,9999,0
1668557160763,CSE 293,030,119420,Saul; Lawrence,9999,0,9999,0
1668557160763,CSE 293,031,119421,Savage; Stefan,9999,0,9999,0
1668557160763,CSE 293,032,119425,Schulze; Jurgen P.,9999,0,9999,0
1668557160763,CSE 293,033,119426,Snoeren; Alex C.,9999,0,9999,0
1668557160763,CSE 293,034,119428,Shang; Jingbo,9999,0,9999,0
1668557160763,CSE 293,035,119430,Stefan; Deian,9999,0,9999,0
1668557160763,CSE 293,036,119431,Su; Hao,9999,0,9999,0
1668557160763,CSE 293,037,119433,Swanson; Steven James,9999,0,9999,0
1668557160763,CSE 293,038,119435,Tullsen; Dean Michael,9999,0,9999,0
1668557160763,CSE 293,039,119483,Voelker; Geoffrey M.,9999,0,9999,0
1668557160763,CSE 293,040,119537,Zhao; Jishen,9999,0,9999,0
1668557160763,CSE 293,041,119538,Zhou; Yuan-Yuan,9999,0,9999,0
1668557160763,CSE 293,042,119539,Gao; Sicun,9999,0,9999,0
1668557160763,CSE 293,043,119540,Weibel; Nadir,9999,0,9999,0
1668557160763,CSE 293,044,119541,Gupta; Rajesh K.,9999,0,9999,0
1668557160763,CSE 293,045,126410,Vaccaro; Kristen Marie,9999,0,9999,0
1668557160763,CSE 293,046,126411,Klemke; Richard,9999,0,9999,0
1668557161190,CSE 294,A00,102459,Voelker; Geoffrey M.,0,2,0,0
1668557161190,CSE 294,B00,111322,Orailoglu; Alex,0,2,0,0
1668557161613,DSE 201,A00,096914,Deutsch; Alin Bernard,30,0,30,0
1668557162050,DSE 210,A00,096915,Dasgupta; Sanjoy,30,0,30,0
1668557162476,DSE 260A,A00,096916,Altintas De Callaf; Ilkay,30,0,30,0
1668557162906,ECE 200,001,103586,Antipa; Nicholas A,9999,0,9999,0
1668557162906,ECE 200,002,103587,Atanasov; Nikolay A.,9999,0,9999,0
1668557162906,ECE 200,003,103588,Bharadia; Dinesh,9999,0,9999,0
1668557162906,ECE 200,004,103589,Cheng; Chung Kuan,9999,0,9999,0
1668557162906,ECE 200,005,103590,Cosman; Pamela C.,9999,0,9999,0
1668557162906,ECE 200,006,103591,Dayeh; Shadi Ahmad,9999,0,9999,0
1668557162906,ECE 200,007,103592,Fainman; Yeshaiahu,9999,0,9999,0
1668557162906,ECE 200,008,103593,Ford; Joseph Earl,9999,0,9999,0
1668557162906,ECE 200,009,103594,Franceschetti; Massimo,9999,0,9999,0
1668557162906,ECE 200,010,103595,Fullerton; Eric E,9999,0,9999,0
1668557162906,ECE 200,011,103596,Galton; Ian A,9999,0,9999,0
1668557162906,ECE 200,012,103597,Gilja; Vikash,9999,0,9999,0
1668557162906,ECE 200,013,103598,Hall; Drew A.,9999,0,9999,0
1668557162906,ECE 200,014,103599,Hsueh; Tzu-Chien,9999,0,9999,0
1668557162906,ECE 200,015,103600,Javidi; Tara,9999,0,9999,0
1668557162906,ECE 200,016,103601,Kahng; Andrew Byun,9999,0,9999,0
1668557162906,ECE 200,017,103602,Kim; Young-Han,9999,0,9999,0
1668557162906,ECE 200,018,103603,Koushanfar; Farinaz,9999,0,9999,0
1668557162906,ECE 200,019,103604,Kuzum; Duygu,9999,0,9999,0
1668557162906,ECE 200,020,103605,Le; Hanh-Phuc,9999,0,9999,0
1668557162906,ECE 200,021,103606,Lin; Bill,9999,0,9999,0
1668557162906,ECE 200,022,103607,Liu; Zhaowei,9998,0,9999,1
1668557162906,ECE 200,023,103608,Lo; Yu-Hwa,9999,0,9999,0
1668557162906,ECE 200,024,103609,Lomakin; Vitaliy,9999,0,9999,0
1668557162906,ECE 200,025,103610,Mercier; Patrick Philip,9999,0,9999,0
1668557162906,ECE 200,026,103611,Meyer; Florian,9999,0,9999,0
1668557162906,ECE 200,027,103612,Milstein; Laurence B.,9999,0,9999,0
1668557162906,ECE 200,028,103613,Mir Arabbaygi; Siavash,9999,0,9999,0
1668557162906,ECE 200,029,103614,Mookherjea; Shayan,9999,0,9999,0
1668557162906,ECE 200,030,103615,Morris; Karcher William,9999,0,9999,0
1668557162906,ECE 200,031,103616,Ng; Tse Nga,9999,0,9999,0
1668557162906,ECE 200,032,103617,Nguyen; Truong Quang,9999,0,9999,0
1668557162906,ECE 200,033,103618,Nomura; Kenji,9999,0,9999,0
1668557162906,ECE 200,034,103619,Orlitsky; Alon,9999,0,9999,0
1668557162906,ECE 200,035,103620,Pal; Piya,9999,0,9999,0
1668557162906,ECE 200,036,103621,Papen; George C.,9999,0,9999,0
1668557162906,ECE 200,037,103622,Radic; Stojan,9999,0,9999,0
1668557162906,ECE 200,038,103623,Rao; Bhaskar D.,9999,0,9999,0
1668557162906,ECE 200,039,103624,Rao; Ramesh R,9999,0,9999,0
1668557162906,ECE 200,040,103625,Rebeiz; Gabriel,9999,0,9999,0
1668557162906,ECE 200,041,103626,Sanford; John R,9999,0,9999,0
1668557162906,ECE 200,042,103627,Siegel; Paul H.,9999,0,9999,0
1668557162906,ECE 200,043,103628,Sievenpiper; Daniel F.,9999,0,9999,0
1668557162906,ECE 200,044,103629,Sworder; David D.,9999,0,9999,0
1668557162906,ECE 200,045,103630,Taur; Yuan,9999,0,9999,0
1668557162906,ECE 200,046,103631,Touri; Behrouz,9999,0,9999,0
1668557162906,ECE 200,047,103632,Trivedi; Mohan M.,9999,0,9999,0
1668557162906,ECE 200,048,103633,Vasconcelos; Nuno,9999,0,9999,0
1668557162906,ECE 200,049,103634,Wang; Xiaolong,9999,0,9999,0
1668557162906,ECE 200,050,103635,Xie; Pengtao,9999,0,9999,0
1668557162906,ECE 200,051,103636,Yip; Michael,9999,0,9999,0
1668557162906,ECE 200,052,103637,Zeger; Kenneth A.,999,0,999,0
1668557162906,ECE 200,053,103638,Zhang; Xinyu,9999,0,9999,0
1668557162906,ECE 200,054,103639,Turakhia; Yatish Girish,9999,0,9999,0
1668557162906,ECE 200,055,103640,Kang; Mingu,9999,0,9999,0
1668557162906,ECE 200,056,103641,Shi; Yuanyuan,9999,0,9999,0
1668557162906,ECE 200,057,103642,Wang; Edward Jay,9999,0,9999,0
1668557162906,ECE 200,058,103643,Zheng; Yang,9999,0,9999,0
1668557163332,ECE 202,A00,103644,Kuzum; Duygu,0,45,0,0
1668557163758,ECE 212BN,A00,103646,Ng; Tse Nga,0,9,0,0
1668557164186,ECE 221,A00,111493,Staff,0,0,0,0
1668557164627,ECE 222B,A00,103647,Lomakin; Vitaliy,0,20,0,0
1668557165050,ECE 230B,A00,103648,Taur; Yuan,0,4,0,0
1668557165474,ECE 238B,A00,103649,Garay; Javier,0,0,0,0
1668557165896,ECE 240B,A00,112900,Fainman; Yeshaiahu,0,8,0,0
1668557166325,ECE 247A,A00,103650,Jokerst; Jesse Vincent,0,6,0,0
1668557166759,ECE 247B,A00,103651,Wang; Joseph,0,14,0,0
1668557167190,ECE 250,A00,103652,Siegel; Paul H.,0,84,0,0
1668557167613,ECE 251A,A00,103654,Rao; Bhaskar D.,0,63,0,0
1668557168039,ECE 257B,A00,103655,Bharadia; Dinesh,0,33,0,0
1668557168482,ECE 258A,A00,103656,Milstein; Laurence B.,0,29,0,0
1668557168914,ECE 260B,A00,103658,Kang; Mingu,0,123,0,0
1668557169339,ECE 264A,A00,103659,Galton; Ian A,0,73,0,0
1668557169775,ECE 265A,A00,103661,Gudem; Prasad S.S.,0,74,0,0
1668557170201,ECE 265D,A00,103662,Gudem; Prasad S.S.,0,26,0,0
1668557170624,ECE 268,A00,103663,Koushanfar; Farinaz,0,43,0,0
1668557171053,ECE 269,A01,103665,Pal; Piya,0,221,0,0
1668557171481,ECE 271B,A00,103666,Vasconcelos; Manuela,0,78,0,0
1668557171909,ECE 276A,A00,103667,Atanasov; Nikolay A.,0,127,0,0
1668557172340,ECE 277,A00,103668,An; Cheolhong,0,151,0,0
1668557172765,ECE 279,A00,117947,Hall; Drew A.,0,22,0,0
1668557173629,ECE 283,A00,103670,Hsueh; Tzu-Chien,0,57,0,0
1668557174062,ECE 284,A00,103671,Turakhia; Yatish Girish,0,41,0,0
1668557174489,ECE 285,A00,103672,Zheng; Yang,0,41,0,0
1668557174489,ECE 285,B00,103673,Sworder; David D.,0,61,0,0
1668557174920,ECE 287,A00,103676,Javidi; Tara,0,8,0,0
1668557175343,MATH 200B,A00,098023,Salehi Golsefidy; Alireza,10,0,15,5
1668557175774,MATH 202B,A00,098024,Rhoades; Brendon Patrick,7,0,15,8
1668557176201,MATH 203B,A00,098025,Oprea; Dragos N.,9,0,15,6
1668557176624,MATH 204B,A00,098026,Sorensen; Claus M,13,0,15,2
1668557177047,MATH 208,A00,098027,Izadi; Elham,7,0,10,3
1668557177469,MATH 209,A00,098028,Pollack; Aaron,10,0,10,0
1668557177892,MATH 211A,A00,112919,Rogalski; Daniel,8,0,10,2
1668557178323,MATH 211B,A00,112920,Seward; Brandon M.,9,0,10,1
1668557178759,MATH 218,A00,098029,Li; Bo,10,0,10,0
1668557179187,MATH 220B,A00,098030,Novak; Jonathan I,11,0,15,4
1668557179609,MATH 221A,A00,098031,Ebenfelt; Peter F,12,0,15,3
1668557180110,MATH 231B,A00,098032,Zlatos; Andrej,9,0,15,6
1668557180534,MATH 240B,A00,098033,Ni; Lei,7,0,15,8
1668557180959,MATH 243,A00,098034,Jekel; David Andrew,10,0,10,0
1668557181388,MATH 245A,A00,098035,Nie; Jiawang,0,7,15,18
1668557181819,MATH 248,A00,098036,Bejenaru; Ioan,10,0,10,0
1668557182245,MATH 250B,A00,098037,Spolaor; Luca,13,0,15,2
1668557182671,MATH 258,A00,098038,Ni; Lei,8,0,10,2
1668557183107,MATH 264B,A00,098041,Rhoades; Brendon Patrick,8,0,15,7
1668557183530,MATH 268,A00,098042,Buss; Samuel R,10,0,10,0
1668557183960,MATH 269,A00,098043,Rhoades; Brendon Patrick,10,0,10,0
1668557184387,MATH 270B,A00,098044,Li; Bo,6,0,15,9
1668557184811,MATH 272B,A00,098045,Holst; Michael J,13,0,15,2
1668557185233,MATH 273A,A00,098046,Tian; Xiaochuan,10,0,15,5
1668557185656,MATH 275,A01,098048,Tian; Xiaochuan,6,0,10,4
1668557186079,MATH 278A,A00,098049,Holst; Michael J,6,0,10,4
1668557186523,MATH 278B,A00,098050,Cloninger; Alexander,10,0,10,0
1668557186948,MATH 278C,A00,098051,Nie; Jiawang,5,0,10,5
1668557187380,MATH 280B,A00,098052,Zheng; Tianyi,7,0,15,8
1668557187811,MATH 281B,A00,098053,Bradic; Jelena,0,2,15,15
1668557188235,MATH 282B,A00,098054,Arias-Castro; Ery,0,1,15,15
1668557188658,MATH 285,A00,098055,Fitzsimmons; Patrick J,0,4,15,17
1668557189096,MATH 287B,A00,098056,Arias-Castro; Ery,1,0,15,14
1668557189520,MATH 288,A00,098057,Agarwal; Pooja,9,0,10,1
1668557189520,MATH 288,B00,098058,Zhang; Danna,8,0,10,2
1668557189520,MATH 288,C00,098059,Williams; Ruth J,9,0,10,1
1668557189944,MATH 290B,A00,098060,Roberts; Justin Deritter,12,0,15,3
1668557190370,MATH 292,A00,098061,Belmont; Eva Kinoshita,10,0,10,0
1668557190794,MATH 295,A00,098062,Suk; Andrew Hoon,47,0,50,3
1668557191222,MATH 296,A00,098063,Novak; Jonathan I,20,0,20,0
1668557191645,MATH 297,001,098064,Gamst; Anthony Collins,9997,0,9999,2
1668557698527,COGS 205,A00,101395,Chiba; Andrea,19,0,20,1
1668557698963,COGS 210B,001,101404,Greene; Deanna Jacquelyn,9998,0,9999,1
1668557698963,COGS 210B,002,101417,Xia; Haijun,9999,0,9999,0
1668557698963,COGS 210B,003,101422,Nitz; Douglas A.,9999,0,9999,0
1668557698963,COGS 210B,004,101423,Hollan; James D.,9998,0,9999,1
1668557698963,COGS 210B,005,101424,Deak; Gedeon O.,9998,0,9999,1
1668557698963,COGS 210B,006,101425,Rossano; Federico,9999,0,9999,0
1668557699392,COGS 211B,A00,101427,Coulson; Seana M,9996,0,9999,3
1668557699832,COGS 220,A00,101428,Hollan; James D.,0,16,25,25
1668557700254,COGS 229,A00,101429,Dow; Steven P,17,0,25,8
1668557700678,COGS 230,A00,101430,Klemmer; Scott R,6,0,17,11
1668557701101,COGS 234,A00,101431,Xia; Haijun,0,1,25,25
1668557701532,COGS 260,A00,101432,Kiyonaga; Anastasia,21,0,25,4
1668557701532,COGS 260,B00,101433,Kirsh; David Joel,15,0,25,10
1668557701964,CSE 202,A00,102371,Impagliazzo; Russell,0,70,0,0
1668557702390,CSE 203B,A01,102373,Cheng; Chung Kuan,0,66,0,0
1668557702814,CSE 208,A00,102374,Micciancio; Daniele,0,5,0,0
1668557703237,CSE 209A,A00,112895,Impagliazzo; Russell,0,13,15,15
1668557703665,CSE 209B,A00,108005,Bellare; Mihir,0,7,0,0
1668557704089,CSE 210,A00,113163,Coblenz; Michael J,0,92,0,0
1668557704511,CSE 219,A00,106111,Dow; Steven P,0,8,20,20
1668557704947,CSE 221,A00,102376,Voelker; Geoffrey M.,0,76,0,0
1668557705443,CSE 224,A01,102378,Porter; George M,0,176,0,0
1668557705878,CSE 229A,A00,102379,Savage; Stefan,0,11,0,0
1668557706300,CSE 229C,A00,102380,Munyaka; Imani N. S.,0,10,0,0
1668557706743,CSE 232B,A00,102382,Deutsch; Alin Bernard,0,39,0,0
1668557707169,CSE 234,A01,112904,Kumar; Arun Kumar,0,0,0,0
1668557707597,CSE 237A,A00,102383,Rosing; Tajana Simunic,0,57,0,0
1668557708024,CSE 239A,A00,102384,Deutsch; Alin Bernard,0,16,0,0
1668557708461,CSE 239B,A00,102385,Polikarpova; Nadezhda,0,11,0,0
1668557708888,CSE 240A,A00,102386,Pannuto; Patrick William,0,48,0,0
1668557709313,CSE 240B,A00,102387,Zhao; Jishen,0,51,0,0
1668557709738,CSE 241A,A00,106406,Kang; Mingu,0,9,0,0
1668557710165,CSE 249B,A00,102388,Kahng; Andrew Byun,0,5,8,8
1668557710600,CSE 251B,A01,102392,Cottrell; Garrison W,0,52,0,0
1668557710600,CSE 251B,A02,102393,Cottrell; Garrison W,0,35,0,0
1668557711023,CSE 252B,A00,102394,Ochoa; Benjamin Lawrence,0,64,0,0
1668557711447,CSE 257,A01,102396,Gao; Sicun,0,155,0,0
1668557711873,CSE 272,A00,102397,Li; Tzumao,0,22,0,0
1668557712298,CSE 274,A00,111323,Chern; Albert Ren-Haur,0,16,0,0
1668557712721,CSE 282,A00,102398,Pevzner; Pavel Arkadjevich,0,0,0,0
1668557713148,CSE 284,A00,114175,Gymrek; Melissa Ann,0,30,0,0
1668557713586,CSE 290,A00,102399,Chandraker; Manmohan Krishna,0,11,0,0
1668557713586,CSE 290,B00,102400,Vaccaro; Kristen Marie,0,8,25,25
1668557713586,CSE 290,C00,102414,Pannuto; Patrick William,0,1,25,25
1668557713586,CSE 290,D00,102427,Pevzner; Pavel Arkadjevich,0,0,0,0
1668557713586,CSE 290,E00,102429,Zhao; Jishen,0,6,0,0
1668557713586,CSE 290,F00,102436,Tullsen; Dean Michael,0,6,0,0
1668557713586,CSE 290,G00,102440,Christensen; Henrik I,0,6,20,20
1668557714027,CSE 291,A00,102443,Su; Hao,0,0,0,0
1668557714027,CSE 291,B00,102448,Polikarpova; Nadezhda,0,0,0,0
1668557714027,CSE 291,C00,102453,Vaccaro; Kristen Marie,0,0,0,0
1668557714027,CSE 291,D00,111343,Savage; Stefan,0,0,0,0
1668557714027,CSE 291,E00,116474,Claffy; Kimberly Claire,0,0,0,0
1668557714027,CSE 291,F00,116479,Pasquale; Joseph,0,0,0,0
1668557714453,CSE 293,001,119111,Bafna; Vineet,9999,0,9999,0
1668557714453,CSE 293,002,119118,Bellare; Mihir,9999,0,9999,0
1668557714453,CSE 293,003,119122,Berg-Kirkpatrick; Taylor D,9999,0,9999,0
1668557714453,CSE 293,004,119135,Christensen; Henrik I,9999,0,9999,0
1668557714453,CSE 293,005,119142,Cottrell; Garrison W,9999,0,9999,0
1668557714453,CSE 293,006,119146,Deutsch; Alin Bernard,9999,0,9999,0
1668557714453,CSE 293,007,119159,Esmaeilzadeh; Hadi,9999,0,9999,0
1668557714453,CSE 293,008,119166,Freund; Yoav,9999,0,9999,0
1668557714453,CSE 293,009,119170,Griswold; William G.,9999,0,9999,0
1668557714453,CSE 293,010,119183,Gymrek; Melissa Ann,9999,0,9999,0
1668557714453,CSE 293,011,119190,Heninger; Nadia A,9999,0,9999,0
1668557714453,CSE 293,012,119230,Impagliazzo; Russell,9999,0,9999,0
1668557714453,CSE 293,013,119232,Jhala; Ranjit,9999,0,9999,0
1668557714453,CSE 293,014,119233,Kahng; Andrew Byun,9999,0,9999,0
1668557714453,CSE 293,015,119298,Kane; Daniel Mertz,9999,0,9999,0
1668557714453,CSE 293,016,119299,Kriegman; David J,9999,0,9999,0
1668557714453,CSE 293,017,119300,Kumar; Arun Kumar,9999,0,9999,0
1668557714453,CSE 293,018,119301,Lerner; Sorin,9999,0,9999,0
1668557714453,CSE 293,019,119302,Lovett; Shachar,9999,0,9999,0
1668557714453,CSE 293,020,119303,McAuley; Julian John,9999,0,9999,0
1668557714453,CSE 293,021,119304,Micciancio; Daniele,9999,0,9999,0
1668557714453,CSE 293,022,119367,Orailoglu; Alex,9999,0,9999,0
1668557714453,CSE 293,023,119382,Paturi; Ramamohan,9999,0,9999,0
1668557714453,CSE 293,024,119404,Polikarpova; Nadezhda,9999,0,9999,0
1668557714453,CSE 293,025,119406,Politz; Joseph Gibbs,9999,0,9999,0
1668557714453,CSE 293,026,119411,Porter; George M,9999,0,9999,0
1668557714453,CSE 293,027,119414,Porter; Leonard Emerson,9999,0,9999,0
1668557714453,CSE 293,028,119416,Ramamoorthi; Ravi,9999,0,9999,0
1668557714453,CSE 293,029,119417,Sahoo; Debashis,9999,0,9999,0
1668557714453,CSE 293,030,119420,Saul; Lawrence,9999,0,9999,0
1668557714453,CSE 293,031,119421,Savage; Stefan,9999,0,9999,0
1668557714453,CSE 293,032,119425,Schulze; Jurgen P.,9999,0,9999,0
1668557714453,CSE 293,033,119426,Snoeren; Alex C.,9999,0,9999,0
1668557714453,CSE 293,034,119428,Shang; Jingbo,9999,0,9999,0
1668557714453,CSE 293,035,119430,Stefan; Deian,9999,0,9999,0
1668557714453,CSE 293,036,119431,Su; Hao,9999,0,9999,0
1668557714453,CSE 293,037,119433,Swanson; Steven James,9999,0,9999,0
1668557714453,CSE 293,038,119435,Tullsen; Dean Michael,9999,0,9999,0
1668557714453,CSE 293,039,119483,Voelker; Geoffrey M.,9999,0,9999,0
1668557714453,CSE 293,040,119537,Zhao; Jishen,9999,0,9999,0
1668557714453,CSE 293,041,119538,Zhou; Yuan-Yuan,9999,0,9999,0
1668557714453,CSE 293,042,119539,Gao; Sicun,9999,0,9999,0
1668557714453,CSE 293,043,119540,Weibel; Nadir,9999,0,9999,0
1668557714453,CSE 293,044,119541,Gupta; Rajesh K.,9999,0,9999,0
1668557714453,CSE 293,045,126410,Vaccaro; Kristen Marie,9999,0,9999,0
1668557714453,CSE 293,046,126411,Klemke; Richard,9999,0,9999,0
1668557714875,CSE 294,A00,102459,Voelker; Geoffrey M.,0,2,0,0
1668557714875,CSE 294,B00,111322,Orailoglu; Alex,0,2,0,0
1668557715306,DSE 201,A00,096914,Deutsch; Alin Bernard,30,0,30,0
1668557715735,DSE 210,A00,096915,Dasgupta; Sanjoy,30,0,30,0
1668557716161,DSE 260A,A00,096916,Altintas De Callaf; Ilkay,30,0,30,0
1668557716597,ECE 200,001,103586,Antipa; Nicholas A,9999,0,9999,0
1668557716597,ECE 200,002,103587,Atanasov; Nikolay A.,9999,0,9999,0
1668557716597,ECE 200,003,103588,Bharadia; Dinesh,9999,0,9999,0
1668557716597,ECE 200,004,103589,Cheng; Chung Kuan,9999,0,9999,0
1668557716597,ECE 200,005,103590,Cosman; Pamela C.,9999,0,9999,0
1668557716597,ECE 200,006,103591,Dayeh; Shadi Ahmad,9999,0,9999,0
1668557716597,ECE 200,007,103592,Fainman; Yeshaiahu,9999,0,9999,0
1668557716597,ECE 200,008,103593,Ford; Joseph Earl,9999,0,9999,0
1668557716597,ECE 200,009,103594,Franceschetti; Massimo,9999,0,9999,0
1668557716597,ECE 200,010,103595,Fullerton; Eric E,9999,0,9999,0
1668557716597,ECE 200,011,103596,Galton; Ian A,9999,0,9999,0
1668557716597,ECE 200,012,103597,Gilja; Vikash,9999,0,9999,0
1668557716597,ECE 200,013,103598,Hall; Drew A.,9999,0,9999,0
1668557716597,ECE 200,014,103599,Hsueh; Tzu-Chien,9999,0,9999,0
1668557716597,ECE 200,015,103600,Javidi; Tara,9999,0,9999,0
1668557716597,ECE 200,016,103601,Kahng; Andrew Byun,9999,0,9999,0
1668557716597,ECE 200,017,103602,Kim; Young-Han,9999,0,9999,0
1668557716597,ECE 200,018,103603,Koushanfar; Farinaz,9999,0,9999,0
1668557716597,ECE 200,019,103604,Kuzum; Duygu,9999,0,9999,0
1668557716597,ECE 200,020,103605,Le; Hanh-Phuc,9999,0,9999,0
1668557716597,ECE 200,021,103606,Lin; Bill,9999,0,9999,0
1668557716597,ECE 200,022,103607,Liu; Zhaowei,9998,0,9999,1
1668557716597,ECE 200,023,103608,Lo; Yu-Hwa,9999,0,9999,0
1668557716597,ECE 200,024,103609,Lomakin; Vitaliy,9999,0,9999,0
1668557716597,ECE 200,025,103610,Mercier; Patrick Philip,9999,0,9999,0
1668557716597,ECE 200,026,103611,Meyer; Florian,9999,0,9999,0
1668557716597,ECE 200,027,103612,Milstein; Laurence B.,9999,0,9999,0
1668557716597,ECE 200,028,103613,Mir Arabbaygi; Siavash,9999,0,9999,0
1668557716597,ECE 200,029,103614,Mookherjea; Shayan,9999,0,9999,0
1668557716597,ECE 200,030,103615,Morris; Karcher William,9999,0,9999,0
1668557716597,ECE 200,031,103616,Ng; Tse Nga,9999,0,9999,0
1668557716597,ECE 200,032,103617,Nguyen; Truong Quang,9999,0,9999,0
1668557716597,ECE 200,033,103618,Nomura; Kenji,9999,0,9999,0
1668557716597,ECE 200,034,103619,Orlitsky; Alon,9999,0,9999,0
1668557716597,ECE 200,035,103620,Pal; Piya,9999,0,9999,0
1668557716597,ECE 200,036,103621,Papen; George C.,9999,0,9999,0
1668557716597,ECE 200,037,103622,Radic; Stojan,9999,0,9999,0
1668557716597,ECE 200,038,103623,Rao; Bhaskar D.,9999,0,9999,0
1668557716597,ECE 200,039,103624,Rao; Ramesh R,9999,0,9999,0
1668557716597,ECE 200,040,103625,Rebeiz; Gabriel,9999,0,9999,0
1668557716597,ECE 200,041,103626,Sanford; John R,9999,0,9999,0
1668557716597,ECE 200,042,103627,Siegel; Paul H.,9999,0,9999,0
1668557716597,ECE 200,043,103628,Sievenpiper; Daniel F.,9999,0,9999,0
1668557716597,ECE 200,044,103629,Sworder; David D.,9999,0,9999,0
1668557716597,ECE 200,045,103630,Taur; Yuan,9999,0,9999,0
1668557716597,ECE 200,046,103631,Touri; Behrouz,9999,0,9999,0
1668557716597,ECE 200,047,103632,Trivedi; Mohan M.,9999,0,9999,0
1668557716597,ECE 200,048,103633,Vasconcelos; Nuno,9999,0,9999,0
1668557716597,ECE 200,049,103634,Wang; Xiaolong,9999,0,9999,0
1668557716597,ECE 200,050,103635,Xie; Pengtao,9999,0,9999,0
1668557716597,ECE 200,051,103636,Yip; Michael,9999,0,9999,0
1668557716597,ECE 200,052,103637,Zeger; Kenneth A.,999,0,999,0
1668557716597,ECE 200,053,103638,Zhang; Xinyu,9999,0,9999,0
1668557716597,ECE 200,054,103639,Turakhia; Yatish Girish,9999,0,9999,0
1668557716597,ECE 200,055,103640,Kang; Mingu,9999,0,9999,0
1668557716597,ECE 200,056,103641,Shi; Yuanyuan,9999,0,9999,0
1668557716597,ECE 200,057,103642,Wang; Edward Jay,9999,0,9999,0
1668557716597,ECE 200,058,103643,Zheng; Yang,9999,0,9999,0
1668557717021,ECE 202,A00,103644,Kuzum; Duygu,0,45,0,0
1668557717459,ECE 212BN,A00,103646,Ng; Tse Nga,0,9,0,0
1668557717891,ECE 221,A00,111493,Staff,0,0,0,0
1668557718321,ECE 222B,A00,103647,Lomakin; Vitaliy,0,21,0,0
1668557718744,ECE 230B,A00,103648,Taur; Yuan,0,4,0,0
1668557719177,ECE 238B,A00,103649,Garay; Javier,0,0,0,0
1668557719602,ECE 240B,A00,112900,Fainman; Yeshaiahu,0,8,0,0
1668557720033,ECE 247A,A00,103650,Jokerst; Jesse Vincent,0,6,0,0
1668557720456,ECE 247B,A00,103651,Wang; Joseph,0,14,0,0
1668557720882,ECE 250,A00,103652,Siegel; Paul H.,0,84,0,0
1668557721314,ECE 251A,A00,103654,Rao; Bhaskar D.,0,63,0,0
1668557721742,ECE 257B,A00,103655,Bharadia; Dinesh,0,33,0,0
1668557722174,ECE 258A,A00,103656,Milstein; Laurence B.,0,29,0,0
1668557722599,ECE 260B,A00,103658,Kang; Mingu,0,123,0,0
1668557723033,ECE 264A,A00,103659,Galton; Ian A,0,66,0,8
1668557723457,ECE 265A,A00,103661,Gudem; Prasad S.S.,0,75,0,0
1668557723884,ECE 265D,A00,103662,Gudem; Prasad S.S.,0,26,0,0
1668557724309,ECE 268,A00,103663,Koushanfar; Farinaz,0,43,0,0
1668557724732,ECE 269,A01,103665,Pal; Piya,0,221,0,0
1668557725158,ECE 271B,A00,103666,Vasconcelos; Manuela,0,78,0,0
1668557725589,ECE 276A,A00,103667,Atanasov; Nikolay A.,0,127,0,0
1668557726104,ECE 277,A00,103668,An; Cheolhong,0,151,0,0
1668557726530,ECE 279,A00,117947,Hall; Drew A.,0,22,0,0
1668557727383,ECE 283,A00,103670,Hsueh; Tzu-Chien,0,57,0,0
1668557727808,ECE 284,A00,103671,Turakhia; Yatish Girish,0,41,0,0
1668557728246,ECE 285,A00,103672,Zheng; Yang,0,41,0,0
1668557728246,ECE 285,B00,103673,Sworder; David D.,0,61,0,0
1668557728675,ECE 287,A00,103676,Javidi; Tara,0,8,0,0
1668557729110,MATH 200B,A00,098023,Salehi Golsefidy; Alireza,10,0,15,5
1668557729533,MATH 202B,A00,098024,Rhoades; Brendon Patrick,7,0,15,8
1668557729961,MATH 203B,A00,098025,Oprea; Dragos N.,9,0,15,6
1668557730383,MATH 204B,A00,098026,Sorensen; Claus M,13,0,15,2
1668557730807,MATH 208,A00,098027,Izadi; Elham,7,0,10,3
1668557731231,MATH 209,A00,098028,Pollack; Aaron,10,0,10,0
1668557731668,MATH 211A,A00,112919,Rogalski; Daniel,8,0,10,2
1668557732091,MATH 211B,A00,112920,Seward; Brandon M.,9,0,10,1
1668557732514,MATH 218,A00,098029,Li; Bo,10,0,10,0
1668557732937,MATH 220B,A00,098030,Novak; Jonathan I,11,0,15,4
1668557733362,MATH 221A,A00,098031,Ebenfelt; Peter F,12,0,15,3
1668557733784,MATH 231B,A00,098032,Zlatos; Andrej,9,0,15,6
1668557734222,MATH 240B,A00,098033,Ni; Lei,7,0,15,8
1668557734657,MATH 243,A00,098034,Jekel; David Andrew,10,0,10,0
1668557735081,MATH 245A,A00,098035,Nie; Jiawang,0,7,15,18
1668557735509,MATH 248,A00,098036,Bejenaru; Ioan,10,0,10,0
1668557735938,MATH 250B,A00,098037,Spolaor; Luca,13,0,15,2
1668557736361,MATH 258,A00,098038,Ni; Lei,8,0,10,2
1668557736786,MATH 264B,A00,098041,Rhoades; Brendon Patrick,8,0,15,7
1668557737210,MATH 268,A00,098042,Buss; Samuel R,10,0,10,0
1668557737640,MATH 269,A00,098043,Rhoades; Brendon Patrick,10,0,10,0
1668557738071,MATH 270B,A00,098044,Li; Bo,6,0,15,9
1668557738495,MATH 272B,A00,098045,Holst; Michael J,13,0,15,2
1668557738931,MATH 273A,A00,098046,Tian; Xiaochuan,10,0,15,5
1668557739359,MATH 275,A01,098048,Tian; Xiaochuan,6,0,10,4
1668557739786,MATH 278A,A00,098049,Holst; Michael J,6,0,10,4
1668557740221,MATH 278B,A00,098050,Cloninger; Alexander,10,0,10,0
1668557740646,MATH 278C,A00,098051,Nie; Jiawang,5,0,10,5
1668557741071,MATH 280B,A00,098052,Zheng; Tianyi,7,0,15,8
1668557741505,MATH 281B,A00,098053,Bradic; Jelena,0,2,15,15
1668557741933,MATH 282B,A00,098054,Arias-Castro; Ery,0,1,15,15
1668557742360,MATH 285,A00,098055,Fitzsimmons; Patrick J,0,4,15,17
1668557742785,MATH 287B,A00,098056,Arias-Castro; Ery,1,0,15,14
1668557743216,MATH 288,A00,098057,Agarwal; Pooja,9,0,10,1
1668557743216,MATH 288,B00,098058,Zhang; Danna,8,0,10,2
1668557743216,MATH 288,C00,098059,Williams; Ruth J,9,0,10,1
1668557743653,MATH 290B,A00,098060,Roberts; Justin Deritter,12,0,15,3
1668557744076,MATH 292,A00,098061,Belmont; Eva Kinoshita,10,0,10,0
1668557744501,MATH 295,A00,098062,Suk; Andrew Hoon,47,0,50,3
1668557744925,MATH 296,A00,098063,Novak; Jonathan I,20,0,20,0
1668557745347,MATH 297,001,098064,Gamst; Anthony Collins,9997,0,9999,2
1668558262035,COGS 205,A00,101395,Chiba; Andrea,19,0,20,1
1668558262461,COGS 210B,001,101404,Greene; Deanna Jacquelyn,9998,0,9999,1
1668558262461,COGS 210B,002,101417,Xia; Haijun,9999,0,9999,0
1668558262461,COGS 210B,003,101422,Nitz; Douglas A.,9999,0,9999,0
1668558262461,COGS 210B,004,101423,Hollan; James D.,9998,0,9999,1
1668558262461,COGS 210B,005,101424,Deak; Gedeon O.,9998,0,9999,1
1668558262461,COGS 210B,006,101425,Rossano; Federico,9999,0,9999,0
1668558262883,COGS 211B,A00,101427,Coulson; Seana M,9996,0,9999,3
1668558263309,COGS 220,A00,101428,Hollan; James D.,0,16,25,25
1668558263739,COGS 229,A00,101429,Dow; Steven P,17,0,25,8
1668558264166,COGS 230,A00,101430,Klemmer; Scott R,6,0,17,11
1668558264589,COGS 234,A00,101431,Xia; Haijun,0,1,25,25
1668558265016,COGS 260,A00,101432,Kiyonaga; Anastasia,21,0,25,4
1668558265016,COGS 260,B00,101433,Kirsh; David Joel,15,0,25,10
1668558265446,CSE 202,A00,102371,Impagliazzo; Russell,0,70,0,0
1668558265870,CSE 203B,A01,102373,Cheng; Chung Kuan,0,66,0,0
1668558266298,CSE 208,A00,102374,Micciancio; Daniele,0,5,0,0
1668558266721,CSE 209A,A00,112895,Impagliazzo; Russell,0,13,15,15
1668558267151,CSE 209B,A00,108005,Bellare; Mihir,0,7,0,0
1668558267586,CSE 210,A00,113163,Coblenz; Michael J,0,92,0,0
1668558268008,CSE 219,A00,106111,Dow; Steven P,0,8,20,20
1668558268440,CSE 221,A00,102376,Voelker; Geoffrey M.,0,76,0,0
1668558268868,CSE 224,A01,102378,Porter; George M,0,176,0,0
1668558269298,CSE 229A,A00,102379,Savage; Stefan,0,11,0,0
1668558269723,CSE 229C,A00,102380,Munyaka; Imani N. S.,0,10,0,0
1668558270148,CSE 232B,A00,102382,Deutsch; Alin Bernard,0,39,0,0
1668558270581,CSE 234,A01,112904,Kumar; Arun Kumar,0,0,0,0
1668558271004,CSE 237A,A00,102383,Rosing; Tajana Simunic,0,57,0,0
1668558271449,CSE 239A,A00,102384,Deutsch; Alin Bernard,0,16,0,0
1668558271876,CSE 239B,A00,102385,Polikarpova; Nadezhda,0,11,0,0
1668558272314,CSE 240A,A00,102386,Pannuto; Patrick William,0,48,0,0
1668558272742,CSE 240B,A00,102387,Zhao; Jishen,0,51,0,0
1668558273174,CSE 241A,A00,106406,Kang; Mingu,0,9,0,0
1668558273598,CSE 249B,A00,102388,Kahng; Andrew Byun,0,5,8,8
1668558274033,CSE 251B,A01,102392,Cottrell; Garrison W,0,52,0,0
1668558274033,CSE 251B,A02,102393,Cottrell; Garrison W,0,35,0,0
1668558274463,CSE 252B,A00,102394,Ochoa; Benjamin Lawrence,0,64,0,0
1668558274899,CSE 257,A01,102396,Gao; Sicun,0,155,0,0
1668558275327,CSE 272,A00,102397,Li; Tzumao,0,22,0,0
1668558275750,CSE 274,A00,111323,Chern; Albert Ren-Haur,0,16,0,0
1668558276183,CSE 282,A00,102398,Pevzner; Pavel Arkadjevich,0,0,0,0
1668558276607,CSE 284,A00,114175,Gymrek; Melissa Ann,0,30,0,0
1668558277032,CSE 290,A00,102399,Chandraker; Manmohan Krishna,0,11,0,0
1668558277032,CSE 290,B00,102400,Vaccaro; Kristen Marie,0,8,25,25
1668558277032,CSE 290,C00,102414,Pannuto; Patrick William,0,1,25,25
1668558277032,CSE 290,D00,102427,Pevzner; Pavel Arkadjevich,0,0,0,0
1668558277032,CSE 290,E00,102429,Zhao; Jishen,0,6,0,0
1668558277032,CSE 290,F00,102436,Tullsen; Dean Michael,0,6,0,0
1668558277032,CSE 290,G00,102440,Christensen; Henrik I,0,6,20,20
1668558277455,CSE 291,A00,102443,Su; Hao,0,0,0,0
1668558277455,CSE 291,B00,102448,Polikarpova; Nadezhda,0,0,0,0
1668558277455,CSE 291,C00,102453,Vaccaro; Kristen Marie,0,0,0,0
1668558277455,CSE 291,D00,111343,Savage; Stefan,0,0,0,0
1668558277455,CSE 291,E00,116474,Claffy; Kimberly Claire,0,0,0,0
1668558277455,CSE 291,F00,116479,Pasquale; Joseph,0,0,0,0
1668558277893,CSE 293,001,119111,Bafna; Vineet,9999,0,9999,0
1668558277893,CSE 293,002,119118,Bellare; Mihir,9999,0,9999,0
1668558277893,CSE 293,003,119122,Berg-Kirkpatrick; Taylor D,9999,0,9999,0
1668558277893,CSE 293,004,119135,Christensen; Henrik I,9999,0,9999,0
1668558277893,CSE 293,005,119142,Cottrell; Garrison W,9999,0,9999,0
1668558277893,CSE 293,006,119146,Deutsch; Alin Bernard,9999,0,9999,0
1668558277893,CSE 293,007,119159,Esmaeilzadeh; Hadi,9999,0,9999,0
1668558277893,CSE 293,008,119166,Freund; Yoav,9999,0,9999,0
1668558277893,CSE 293,009,119170,Griswold; William G.,9999,0,9999,0
1668558277893,CSE 293,010,119183,Gymrek; Melissa Ann,9999,0,9999,0
1668558277893,CSE 293,011,119190,Heninger; Nadia A,9999,0,9999,0
1668558277893,CSE 293,012,119230,Impagliazzo; Russell,9999,0,9999,0
1668558277893,CSE 293,013,119232,Jhala; Ranjit,9999,0,9999,0
1668558277893,CSE 293,014,119233,Kahng; Andrew Byun,9999,0,9999,0
1668558277893,CSE 293,015,119298,Kane; Daniel Mertz,9999,0,9999,0
1668558277893,CSE 293,016,119299,Kriegman; David J,9999,0,9999,0
1668558277893,CSE 293,017,119300,Kumar; Arun Kumar,9999,0,9999,0
1668558277893,CSE 293,018,119301,Lerner; Sorin,9999,0,9999,0
1668558277893,CSE 293,019,119302,Lovett; Shachar,9999,0,9999,0
1668558277893,CSE 293,020,119303,McAuley; Julian John,9999,0,9999,0
1668558277893,CSE 293,021,119304,Micciancio; Daniele,9999,0,9999,0
1668558277893,CSE 293,022,119367,Orailoglu; Alex,9999,0,9999,0
1668558277893,CSE 293,023,119382,Paturi; Ramamohan,9999,0,9999,0
1668558277893,CSE 293,024,119404,Polikarpova; Nadezhda,9999,0,9999,0
1668558277893,CSE 293,025,119406,Politz; Joseph Gibbs,9999,0,9999,0
1668558277893,CSE 293,026,119411,Porter; George M,9999,0,9999,0
1668558277893,CSE 293,027,119414,Porter; Leonard Emerson,9999,0,9999,0
1668558277893,CSE 293,028,119416,Ramamoorthi; Ravi,9999,0,9999,0
1668558277893,CSE 293,029,119417,Sahoo; Debashis,9999,0,9999,0
1668558277893,CSE 293,030,119420,Saul; Lawrence,9999,0,9999,0
1668558277893,CSE 293,031,119421,Savage; Stefan,9999,0,9999,0
1668558277893,CSE 293,032,119425,Schulze; Jurgen P.,9999,0,9999,0
1668558277893,CSE 293,033,119426,Snoeren; Alex C.,9999,0,9999,0
1668558277893,CSE 293,034,119428,Shang; Jingbo,9999,0,9999,0
1668558277893,CSE 293,035,119430,Stefan; Deian,9999,0,9999,0
1668558277893,CSE 293,036,119431,Su; Hao,9999,0,9999,0
1668558277893,CSE 293,037,119433,Swanson; Steven James,9999,0,9999,0
1668558277893,CSE 293,038,119435,Tullsen; Dean Michael,9999,0,9999,0
1668558277893,CSE 293,039,119483,Voelker; Geoffrey M.,9999,0,9999,0
1668558277893,CSE 293,040,119537,Zhao; Jishen,9999,0,9999,0
1668558277893,CSE 293,041,119538,Zhou; Yuan-Yuan,9999,0,9999,0
1668558277893,CSE 293,042,119539,Gao; Sicun,9999,0,9999,0
1668558277893,CSE 293,043,119540,Weibel; Nadir,9999,0,9999,0
1668558277893,CSE 293,044,119541,Gupta; Rajesh K.,9999,0,9999,0
1668558277893,CSE 293,045,126410,Vaccaro; Kristen Marie,9999,0,9999,0
1668558277893,CSE 293,046,126411,Klemke; Richard,9999,0,9999,0
1668558278328,CSE 294,A00,102459,Voelker; Geoffrey M.,0,2,0,0
1668558278328,CSE 294,B00,111322,Orailoglu; Alex,0,2,0,0
1668558278754,DSE 201,A00,096914,Deutsch; Alin Bernard,30,0,30,0
1668558279182,DSE 210,A00,096915,Dasgupta; Sanjoy,30,0,30,0
1668558279604,DSE 260A,A00,096916,Altintas De Callaf; Ilkay,30,0,30,0
1668558280043,ECE 200,001,103586,Antipa; Nicholas A,9999,0,9999,0
1668558280043,ECE 200,002,103587,Atanasov; Nikolay A.,9999,0,9999,0
1668558280043,ECE 200,003,103588,Bharadia; Dinesh,9999,0,9999,0
1668558280043,ECE 200,004,103589,Cheng; Chung Kuan,9999,0,9999,0
1668558280043,ECE 200,005,103590,Cosman; Pamela C.,9999,0,9999,0
1668558280043,ECE 200,006,103591,Dayeh; Shadi Ahmad,9999,0,9999,0
1668558280043,ECE 200,007,103592,Fainman; Yeshaiahu,9999,0,9999,0
1668558280043,ECE 200,008,103593,Ford; Joseph Earl,9999,0,9999,0
1668558280043,ECE 200,009,103594,Franceschetti; Massimo,9999,0,9999,0
1668558280043,ECE 200,010,103595,Fullerton; Eric E,9999,0,9999,0
1668558280043,ECE 200,011,103596,Galton; Ian A,9999,0,9999,0
1668558280043,ECE 200,012,103597,Gilja; Vikash,9999,0,9999,0
1668558280043,ECE 200,013,103598,Hall; Drew A.,9999,0,9999,0
1668558280043,ECE 200,014,103599,Hsueh; Tzu-Chien,9999,0,9999,0
1668558280043,ECE 200,015,103600,Javidi; Tara,9999,0,9999,0
1668558280043,ECE 200,016,103601,Kahng; Andrew Byun,9999,0,9999,0
1668558280043,ECE 200,017,103602,Kim; Young-Han,9999,0,9999,0
1668558280043,ECE 200,018,103603,Koushanfar; Farinaz,9999,0,9999,0
1668558280043,ECE 200,019,103604,Kuzum; Duygu,9999,0,9999,0
1668558280043,ECE 200,020,103605,Le; Hanh-Phuc,9999,0,9999,0
1668558280043,ECE 200,021,103606,Lin; Bill,9999,0,9999,0
1668558280043,ECE 200,022,103607,Liu; Zhaowei,9998,0,9999,1
1668558280043,ECE 200,023,103608,Lo; Yu-Hwa,9999,0,9999,0
1668558280043,ECE 200,024,103609,Lomakin; Vitaliy,9999,0,9999,0
1668558280043,ECE 200,025,103610,Mercier; Patrick Philip,9999,0,9999,0
1668558280043,ECE 200,026,103611,Meyer; Florian,9999,0,9999,0
1668558280043,ECE 200,027,103612,Milstein; Laurence B.,9999,0,9999,0
1668558280043,ECE 200,028,103613,Mir Arabbaygi; Siavash,9999,0,9999,0
1668558280043,ECE 200,029,103614,Mookherjea; Shayan,9999,0,9999,0
1668558280043,ECE 200,030,103615,Morris; Karcher William,9999,0,9999,0
1668558280043,ECE 200,031,103616,Ng; Tse Nga,9999,0,9999,0
1668558280043,ECE 200,032,103617,Nguyen; Truong Quang,9999,0,9999,0
1668558280043,ECE 200,033,103618,Nomura; Kenji,9999,0,9999,0
1668558280043,ECE 200,034,103619,Orlitsky; Alon,9999,0,9999,0
1668558280043,ECE 200,035,103620,Pal; Piya,9999,0,9999,0
1668558280043,ECE 200,036,103621,Papen; George C.,9999,0,9999,0
1668558280043,ECE 200,037,103622,Radic; Stojan,9999,0,9999,0
1668558280043,ECE 200,038,103623,Rao; Bhaskar D.,9999,0,9999,0
1668558280043,ECE 200,039,103624,Rao; Ramesh R,9999,0,9999,0
1668558280043,ECE 200,040,103625,Rebeiz; Gabriel,9999,0,9999,0
1668558280043,ECE 200,041,103626,Sanford; John R,9999,0,9999,0
1668558280043,ECE 200,042,103627,Siegel; Paul H.,9999,0,9999,0
1668558280043,ECE 200,043,103628,Sievenpiper; Daniel F.,9999,0,9999,0
1668558280043,ECE 200,044,103629,Sworder; David D.,9999,0,9999,0
1668558280043,ECE 200,045,103630,Taur; Yuan,9999,0,9999,0
1668558280043,ECE 200,046,103631,Touri; Behrouz,9999,0,9999,0
1668558280043,ECE 200,047,103632,Trivedi; Mohan M.,9999,0,9999,0
1668558280043,ECE 200,048,103633,Vasconcelos; Nuno,9999,0,9999,0
1668558280043,ECE 200,049,103634,Wang; Xiaolong,9999,0,9999,0
1668558280043,ECE 200,050,103635,Xie; Pengtao,9999,0,9999,0
1668558280043,ECE 200,051,103636,Yip; Michael,9999,0,9999,0
1668558280043,ECE 200,052,103637,Zeger; Kenneth A.,999,0,999,0
1668558280043,ECE 200,053,103638,Zhang; Xinyu,9999,0,9999,0
1668558280043,ECE 200,054,103639,Turakhia; Yatish Girish,9999,0,9999,0
1668558280043,ECE 200,055,103640,Kang; Mingu,9999,0,9999,0
1668558280043,ECE 200,056,103641,Shi; Yuanyuan,9999,0,9999,0
1668558280043,ECE 200,057,103642,Wang; Edward Jay,9999,0,9999,0
1668558280043,ECE 200,058,103643,Zheng; Yang,9999,0,9999,0
1668558280467,ECE 202,A00,103644,Kuzum; Duygu,0,46,0,0
1668558280896,ECE 212BN,A00,103646,Ng; Tse Nga,0,9,0,0
1668558281322,ECE 221,A00,111493,Staff,0,0,0,0
1668558281759,ECE 222B,A00,103647,Lomakin; Vitaliy,0,21,0,0
1668558282183,ECE 230B,A00,103648,Taur; Yuan,0,4,0,0
1668558282617,ECE 238B,A00,103649,Garay; Javier,0,0,0,0
1668558283042,ECE 240B,A00,112900,Fainman; Yeshaiahu,0,8,0,0
1668558283478,ECE 247A,A00,103650,Jokerst; Jesse Vincent,0,6,0,0
1668558283988,ECE 247B,A00,103651,Wang; Joseph,0,14,0,0
1668558284410,ECE 250,A00,103652,Siegel; Paul H.,0,84,0,0
1668558284838,ECE 251A,A00,103654,Rao; Bhaskar D.,0,64,0,0
1668558285264,ECE 257B,A00,103655,Bharadia; Dinesh,0,33,0,0
1668558285697,ECE 258A,A00,103656,Milstein; Laurence B.,0,29,0,0
1668558286123,ECE 260B,A00,103658,Kang; Mingu,0,123,0,0
1668558286550,ECE 264A,A00,103659,Galton; Ian A,0,60,0,14
1668558286974,ECE 265A,A00,103661,Gudem; Prasad S.S.,0,64,0,11
1668558287403,ECE 265D,A00,103662,Gudem; Prasad S.S.,0,26,0,0
1668558287827,ECE 268,A00,103663,Koushanfar; Farinaz,0,44,0,0
1668558288252,ECE 269,A01,103665,Pal; Piya,0,222,0,0
1668558288677,ECE 271B,A00,103666,Vasconcelos; Manuela,0,78,0,0
1668558289115,ECE 276A,A00,103667,Atanasov; Nikolay A.,0,127,0,0
1668558289547,ECE 277,A00,103668,An; Cheolhong,0,151,0,0
1668558289972,ECE 279,A00,117947,Hall; Drew A.,0,22,0,0
1668558290825,ECE 283,A00,103670,Hsueh; Tzu-Chien,0,57,0,0
1668558291251,ECE 284,A00,103671,Turakhia; Yatish Girish,0,41,0,0
1668558291673,ECE 285,A00,103672,Zheng; Yang,0,41,0,0
1668558291673,ECE 285,B00,103673,Sworder; David D.,0,61,0,0
1668558292100,ECE 287,A00,103676,Javidi; Tara,0,8,0,0
1668558292522,MATH 200B,A00,098023,Salehi Golsefidy; Alireza,10,0,15,5
1668558293032,MATH 202B,A00,098024,Rhoades; Brendon Patrick,7,0,15,8
1668558293458,MATH 203B,A00,098025,Oprea; Dragos N.,9,0,15,6
1668558293881,MATH 204B,A00,098026,Sorensen; Claus M,13,0,15,2
1668558294311,MATH 208,A00,098027,Izadi; Elham,7,0,10,3
1668558294734,MATH 209,A00,098028,Pollack; Aaron,10,0,10,0
1668558295158,MATH 211A,A00,112919,Rogalski; Daniel,8,0,10,2
1668558295591,MATH 211B,A00,112920,Seward; Brandon M.,9,0,10,1
1668558296016,MATH 218,A00,098029,Li; Bo,10,0,10,0
1668558296438,MATH 220B,A00,098030,Novak; Jonathan I,11,0,15,4
1668558296860,MATH 221A,A00,098031,Ebenfelt; Peter F,12,0,15,3
1668558297288,MATH 231B,A00,098032,Zlatos; Andrej,9,0,15,6
1668558297711,MATH 240B,A00,098033,Ni; Lei,7,0,15,8
1668558298133,MATH 243,A00,098034,Jekel; David Andrew,10,0,10,0
1668558298558,MATH 245A,A00,098035,Nie; Jiawang,0,7,15,18
1668558298989,MATH 248,A00,098036,Bejenaru; Ioan,10,0,10,0
1668558299422,MATH 250B,A00,098037,Spolaor; Luca,13,0,15,2
1668558299852,MATH 258,A00,098038,Ni; Lei,8,0,10,2
1668558300286,MATH 264B,A00,098041,Rhoades; Brendon Patrick,8,0,15,7
1668558300710,MATH 268,A00,098042,Buss; Samuel R,10,0,10,0
1668558301132,MATH 269,A00,098043,Rhoades; Brendon Patrick,10,0,10,0
1668558301558,MATH 270B,A00,098044,Li; Bo,6,0,15,9
1668558301980,MATH 272B,A00,098045,Holst; Michael J,13,0,15,2
1668558302408,MATH 273A,A00,098046,Tian; Xiaochuan,10,0,15,5
1668558302829,MATH 275,A01,098048,Tian; Xiaochuan,6,0,10,4
1668558303252,MATH 278A,A00,098049,Holst; Michael J,6,0,10,4
1668558303681,MATH 278B,A00,098050,Cloninger; Alexander,10,0,10,0
1668558304113,MATH 278C,A00,098051,Nie; Jiawang,5,0,10,5
1668558304539,MATH 280B,A00,098052,Zheng; Tianyi,7,0,15,8
1668558304963,MATH 281B,A00,098053,Bradic; Jelena,0,2,15,15
1668558305403,MATH 282B,A00,098054,Arias-Castro; Ery,0,1,15,15
1668558305842,MATH 285,A00,098055,Fitzsimmons; Patrick J,0,4,15,17
1668558306265,MATH 287B,A00,098056,Arias-Castro; Ery,1,0,15,14
1668558306689,MATH 288,A00,098057,Agarwal; Pooja,9,0,10,1
1668558306689,MATH 288,B00,098058,Zhang; Danna,8,0,10,2
1668558306689,MATH 288,C00,098059,Williams; Ruth J,9,0,10,1
1668558307114,MATH 290B,A00,098060,Roberts; Justin Deritter,12,0,15,3
1668558307548,MATH 292,A00,098061,Belmont; Eva Kinoshita,10,0,10,0
1668558307977,MATH 295,A00,098062,Suk; Andrew Hoon,47,0,50,3
1668558308404,MATH 296,A00,098063,Novak; Jonathan I,20,0,20,0
1668558308838,MATH 297,001,098064,Gamst; Anthony Collins,9997,0,9999,2
1668558812947,COGS 205,A00,101395,Chiba; Andrea,19,0,20,1
1668558813371,COGS 210B,001,101404,Greene; Deanna Jacquelyn,9998,0,9999,1
1668558813371,COGS 210B,002,101417,Xia; Haijun,9999,0,9999,0
1668558813371,COGS 210B,003,101422,Nitz; Douglas A.,9999,0,9999,0
1668558813371,COGS 210B,004,101423,Hollan; James D.,9998,0,9999,1
1668558813371,COGS 210B,005,101424,Deak; Gedeon O.,9998,0,9999,1
1668558813371,COGS 210B,006,101425,Rossano; Federico,9999,0,9999,0
1668558813793,COGS 211B,A00,101427,Coulson; Seana M,9996,0,9999,3
1668558814217,COGS 220,A00,101428,Hollan; James D.,0,16,25,25
1668558814640,COGS 229,A00,101429,Dow; Steven P,17,0,25,8
1668558815074,COGS 230,A00,101430,Klemmer; Scott R,6,0,17,11
1668558815506,COGS 234,A00,101431,Xia; Haijun,0,1,25,25
1668558815929,COGS 260,A00,101432,Kiyonaga; Anastasia,21,0,25,4
1668558815929,COGS 260,B00,101433,Kirsh; David Joel,15,0,25,10
1668558816362,CSE 202,A00,102371,Impagliazzo; Russell,0,70,0,0
1668558816787,CSE 203B,A01,102373,Cheng; Chung Kuan,0,66,0,0
1668558817213,CSE 208,A00,102374,Micciancio; Daniele,0,5,0,0
1668558817644,CSE 209A,A00,112895,Impagliazzo; Russell,0,13,15,15
1668558818067,CSE 209B,A00,108005,Bellare; Mihir,0,7,0,0
1668558818503,CSE 210,A00,113163,Coblenz; Michael J,0,92,0,0
1668558818925,CSE 219,A00,106111,Dow; Steven P,0,8,20,20
1668558819360,CSE 221,A00,102376,Voelker; Geoffrey M.,0,76,0,0
1668558819787,CSE 224,A01,102378,Porter; George M,0,176,0,0
1668558820215,CSE 229A,A00,102379,Savage; Stefan,0,11,0,0
1668558820645,CSE 229C,A00,102380,Munyaka; Imani N. S.,0,10,0,0
1668558821071,CSE 232B,A00,102382,Deutsch; Alin Bernard,0,39,0,0
1668558821496,CSE 234,A01,112904,Kumar; Arun Kumar,0,0,0,0
1668558821922,CSE 237A,A00,102383,Rosing; Tajana Simunic,0,57,0,0
1668558822348,CSE 239A,A00,102384,Deutsch; Alin Bernard,0,16,0,0
1668558822778,CSE 239B,A00,102385,Polikarpova; Nadezhda,0,11,0,0
1668558823206,CSE 240A,A00,102386,Pannuto; Patrick William,0,48,0,0
1668558823628,CSE 240B,A00,102387,Zhao; Jishen,0,51,0,0
1668558824051,CSE 241A,A00,106406,Kang; Mingu,0,9,0,0
1668558824477,CSE 249B,A00,102388,Kahng; Andrew Byun,0,5,8,8
1668558824903,CSE 251B,A01,102392,Cottrell; Garrison W,0,52,0,0
1668558824903,CSE 251B,A02,102393,Cottrell; Garrison W,0,35,0,0
1668558825341,CSE 252B,A00,102394,Ochoa; Benjamin Lawrence,0,64,0,0
1668558825770,CSE 257,A01,102396,Gao; Sicun,0,155,0,0
1668558826194,CSE 272,A00,102397,Li; Tzumao,0,22,0,0
1668558826616,CSE 274,A00,111323,Chern; Albert Ren-Haur,0,16,0,0
1668558827040,CSE 282,A00,102398,Pevzner; Pavel Arkadjevich,0,0,0,0
1668558827464,CSE 284,A00,114175,Gymrek; Melissa Ann,0,30,0,0
1668558827890,CSE 290,A00,102399,Chandraker; Manmohan Krishna,0,11,0,0
1668558827890,CSE 290,B00,102400,Vaccaro; Kristen Marie,0,8,25,25
1668558827890,CSE 290,C00,102414,Pannuto; Patrick William,0,1,25,25
1668558827890,CSE 290,D00,102427,Pevzner; Pavel Arkadjevich,0,0,0,0
1668558827890,CSE 290,E00,102429,Zhao; Jishen,0,6,0,0
1668558827890,CSE 290,F00,102436,Tullsen; Dean Michael,0,6,0,0
1668558827890,CSE 290,G00,102440,Christensen; Henrik I,0,6,20,20
1668558828325,CSE 291,A00,102443,Su; Hao,0,0,0,0
1668558828325,CSE 291,B00,102448,Polikarpova; Nadezhda,0,0,0,0
1668558828325,CSE 291,C00,102453,Vaccaro; Kristen Marie,0,0,0,0
1668558828325,CSE 291,D00,111343,Savage; Stefan,0,0,0,0
1668558828325,CSE 291,E00,116474,Claffy; Kimberly Claire,0,0,0,0
1668558828325,CSE 291,F00,116479,Pasquale; Joseph,0,0,0,0
1668558828767,CSE 293,001,119111,Bafna; Vineet,9999,0,9999,0
1668558828767,CSE 293,002,119118,Bellare; Mihir,9999,0,9999,0
1668558828767,CSE 293,003,119122,Berg-Kirkpatrick; Taylor D,9999,0,9999,0
1668558828767,CSE 293,004,119135,Christensen; Henrik I,9999,0,9999,0
1668558828767,CSE 293,005,119142,Cottrell; Garrison W,9999,0,9999,0
1668558828767,CSE 293,006,119146,Deutsch; Alin Bernard,9999,0,9999,0
1668558828767,CSE 293,007,119159,Esmaeilzadeh; Hadi,9999,0,9999,0
1668558828767,CSE 293,008,119166,Freund; Yoav,9999,0,9999,0
1668558828767,CSE 293,009,119170,Griswold; William G.,9999,0,9999,0
1668558828767,CSE 293,010,119183,Gymrek; Melissa Ann,9999,0,9999,0
1668558828767,CSE 293,011,119190,Heninger; Nadia A,9999,0,9999,0
1668558828767,CSE 293,012,119230,Impagliazzo; Russell,9999,0,9999,0
1668558828767,CSE 293,013,119232,Jhala; Ranjit,9999,0,9999,0
1668558828767,CSE 293,014,119233,Kahng; Andrew Byun,9999,0,9999,0
1668558828767,CSE 293,015,119298,Kane; Daniel Mertz,9999,0,9999,0
1668558828767,CSE 293,016,119299,Kriegman; David J,9999,0,9999,0
1668558828767,CSE 293,017,119300,Kumar; Arun Kumar,9999,0,9999,0
1668558828767,CSE 293,018,119301,Lerner; Sorin,9999,0,9999,0
1668558828767,CSE 293,019,119302,Lovett; Shachar,9999,0,9999,0
1668558828767,CSE 293,020,119303,McAuley; Julian John,9999,0,9999,0
1668558828767,CSE 293,021,119304,Micciancio; Daniele,9999,0,9999,0
1668558828767,CSE 293,022,119367,Orailoglu; Alex,9999,0,9999,0
1668558828767,CSE 293,023,119382,Paturi; Ramamohan,9999,0,9999,0
1668558828767,CSE 293,024,119404,Polikarpova; Nadezhda,9999,0,9999,0
1668558828767,CSE 293,025,119406,Politz; Joseph Gibbs,9999,0,9999,0
1668558828767,CSE 293,026,119411,Porter; George M,9999,0,9999,0
1668558828767,CSE 293,027,119414,Porter; Leonard Emerson,9999,0,9999,0
1668558828767,CSE 293,028,119416,Ramamoorthi; Ravi,9999,0,9999,0
1668558828767,CSE 293,029,119417,Sahoo; Debashis,9999,0,9999,0
1668558828767,CSE 293,030,119420,Saul; Lawrence,9999,0,9999,0
1668558828767,CSE 293,031,119421,Savage; Stefan,9999,0,9999,0
1668558828767,CSE 293,032,119425,Schulze; Jurgen P.,9999,0,9999,0
1668558828767,CSE 293,033,119426,Snoeren; Alex C.,9999,0,9999,0
1668558828767,CSE 293,034,119428,Shang; Jingbo,9999,0,9999,0
1668558828767,CSE 293,035,119430,Stefan; Deian,9999,0,9999,0
1668558828767,CSE 293,036,119431,Su; Hao,9999,0,9999,0
1668558828767,CSE 293,037,119433,Swanson; Steven James,9999,0,9999,0
1668558828767,CSE 293,038,119435,Tullsen; Dean Michael,9999,0,9999,0
1668558828767,CSE 293,039,119483,Voelker; Geoffrey M.,9999,0,9999,0
1668558828767,CSE 293,040,119537,Zhao; Jishen,9999,0,9999,0
1668558828767,CSE 293,041,119538,Zhou; Yuan-Yuan,9999,0,9999,0
1668558828767,CSE 293,042,119539,Gao; Sicun,9999,0,9999,0
1668558828767,CSE 293,043,119540,Weibel; Nadir,9999,0,9999,0
1668558828767,CSE 293,044,119541,Gupta; Rajesh K.,9999,0,9999,0
1668558828767,CSE 293,045,126410,Vaccaro; Kristen Marie,9999,0,9999,0
1668558828767,CSE 293,046,126411,Klemke; Richard,9999,0,9999,0
1668558829199,CSE 294,A00,102459,Voelker; Geoffrey M.,0,2,0,0
1668558829199,CSE 294,B00,111322,Orailoglu; Alex,0,2,0,0
1668558829626,DSE 201,A00,096914,Deutsch; Alin Bernard,30,0,30,0
1668558830050,DSE 210,A00,096915,Dasgupta; Sanjoy,30,0,30,0
1668558830472,DSE 260A,A00,096916,Altintas De Callaf; Ilkay,30,0,30,0
1668558830898,ECE 200,001,103586,Antipa; Nicholas A,9999,0,9999,0
1668558830898,ECE 200,002,103587,Atanasov; Nikolay A.,9999,0,9999,0
1668558830898,ECE 200,003,103588,Bharadia; Dinesh,9999,0,9999,0
1668558830898,ECE 200,004,103589,Cheng; Chung Kuan,9999,0,9999,0
1668558830898,ECE 200,005,103590,Cosman; Pamela C.,9999,0,9999,0
1668558830898,ECE 200,006,103591,Dayeh; Shadi Ahmad,9999,0,9999,0
1668558830898,ECE 200,007,103592,Fainman; Yeshaiahu,9999,0,9999,0
1668558830898,ECE 200,008,103593,Ford; Joseph Earl,9999,0,9999,0
1668558830898,ECE 200,009,103594,Franceschetti; Massimo,9999,0,9999,0
1668558830898,ECE 200,010,103595,Fullerton; Eric E,9999,0,9999,0
1668558830898,ECE 200,011,103596,Galton; Ian A,9999,0,9999,0
1668558830898,ECE 200,012,103597,Gilja; Vikash,9999,0,9999,0
1668558830898,ECE 200,013,103598,Hall; Drew A.,9999,0,9999,0
1668558830898,ECE 200,014,103599,Hsueh; Tzu-Chien,9999,0,9999,0
1668558830898,ECE 200,015,103600,Javidi; Tara,9999,0,9999,0
1668558830898,ECE 200,016,103601,Kahng; Andrew Byun,9999,0,9999,0
1668558830898,ECE 200,017,103602,Kim; Young-Han,9999,0,9999,0
1668558830898,ECE 200,018,103603,Koushanfar; Farinaz,9999,0,9999,0
1668558830898,ECE 200,019,103604,Kuzum; Duygu,9999,0,9999,0
1668558830898,ECE 200,020,103605,Le; Hanh-Phuc,9999,0,9999,0
1668558830898,ECE 200,021,103606,Lin; Bill,9999,0,9999,0
1668558830898,ECE 200,022,103607,Liu; Zhaowei,9998,0,9999,1
1668558830898,ECE 200,023,103608,Lo; Yu-Hwa,9999,0,9999,0
1668558830898,ECE 200,024,103609,Lomakin; Vitaliy,9999,0,9999,0
1668558830898,ECE 200,025,103610,Mercier; Patrick Philip,9999,0,9999,0
1668558830898,ECE 200,026,103611,Meyer; Florian,9999,0,9999,0
1668558830898,ECE 200,027,103612,Milstein; Laurence B.,9999,0,9999,0
1668558830898,ECE 200,028,103613,Mir Arabbaygi; Siavash,9999,0,9999,0
1668558830898,ECE 200,029,103614,Mookherjea; Shayan,9999,0,9999,0
1668558830898,ECE 200,030,103615,Morris; Karcher William,9999,0,9999,0
1668558830898,ECE 200,031,103616,Ng; Tse Nga,9999,0,9999,0
1668558830898,ECE 200,032,103617,Nguyen; Truong Quang,9999,0,9999,0
1668558830898,ECE 200,033,103618,Nomura; Kenji,9999,0,9999,0
1668558830898,ECE 200,034,103619,Orlitsky; Alon,9999,0,9999,0
1668558830898,ECE 200,035,103620,Pal; Piya,9999,0,9999,0
1668558830898,ECE 200,036,103621,Papen; George C.,9999,0,9999,0
1668558830898,ECE 200,037,103622,Radic; Stojan,9999,0,9999,0
1668558830898,ECE 200,038,103623,Rao; Bhaskar D.,9999,0,9999,0
1668558830898,ECE 200,039,103624,Rao; Ramesh R,9999,0,9999,0
1668558830898,ECE 200,040,103625,Rebeiz; Gabriel,9999,0,9999,0
1668558830898,ECE 200,041,103626,Sanford; John R,9999,0,9999,0
1668558830898,ECE 200,042,103627,Siegel; Paul H.,9999,0,9999,0
1668558830898,ECE 200,043,103628,Sievenpiper; Daniel F.,9999,0,9999,0
1668558830898,ECE 200,044,103629,Sworder; David D.,9999,0,9999,0
1668558830898,ECE 200,045,103630,Taur; Yuan,9999,0,9999,0
1668558830898,ECE 200,046,103631,Touri; Behrouz,9999,0,9999,0
1668558830898,ECE 200,047,103632,Trivedi; Mohan M.,9999,0,9999,0
1668558830898,ECE 200,048,103633,Vasconcelos; Nuno,9999,0,9999,0
1668558830898,ECE 200,049,103634,Wang; Xiaolong,9999,0,9999,0
1668558830898,ECE 200,050,103635,Xie; Pengtao,9999,0,9999,0
1668558830898,ECE 200,051,103636,Yip; Michael,9999,0,9999,0
1668558830898,ECE 200,052,103637,Zeger; Kenneth A.,999,0,999,0
1668558830898,ECE 200,053,103638,Zhang; Xinyu,9999,0,9999,0
1668558830898,ECE 200,054,103639,Turakhia; Yatish Girish,9999,0,9999,0
1668558830898,ECE 200,055,103640,Kang; Mingu,9999,0,9999,0
1668558830898,ECE 200,056,103641,Shi; Yuanyuan,9999,0,9999,0
1668558830898,ECE 200,057,103642,Wang; Edward Jay,9999,0,9999,0
1668558830898,ECE 200,058,103643,Zheng; Yang,9999,0,9999,0
1668558831327,ECE 202,A00,103644,Kuzum; Duygu,0,46,0,0
1668558831751,ECE 212BN,A00,103646,Ng; Tse Nga,0,9,0,0
1668558832185,ECE 221,A00,111493,Staff,0,0,0,0
1668558832614,ECE 222B,A00,103647,Lomakin; Vitaliy,0,21,0,0
1668558833049,ECE 230B,A00,103648,Taur; Yuan,0,4,0,0
1668558833474,ECE 238B,A00,103649,Garay; Javier,0,0,0,0
1668558833896,ECE 240B,A00,112900,Fainman; Yeshaiahu,0,8,0,0
1668558834317,ECE 247A,A00,103650,Jokerst; Jesse Vincent,0,6,0,0
1668558834748,ECE 247B,A00,103651,Wang; Joseph,0,14,0,0
1668558835172,ECE 250,A00,103652,Siegel; Paul H.,0,84,0,0
1668558835594,ECE 251A,A00,103654,Rao; Bhaskar D.,0,64,0,0
1668558836023,ECE 257B,A00,103655,Bharadia; Dinesh,0,33,0,0
1668558836455,ECE 258A,A00,103656,Milstein; Laurence B.,0,29,0,0
1668558836892,ECE 260B,A00,103658,Kang; Mingu,0,123,0,0
1668558837315,ECE 264A,A00,103659,Galton; Ian A,0,58,0,16
1668558837739,ECE 265A,A00,103661,Gudem; Prasad S.S.,0,61,0,14
1668558838162,ECE 265D,A00,103662,Gudem; Prasad S.S.,0,26,0,0
1668558838585,ECE 268,A00,103663,Koushanfar; Farinaz,0,44,0,0
1668558839009,ECE 269,A01,103665,Pal; Piya,0,222,0,0
1668558839431,ECE 271B,A00,103666,Vasconcelos; Manuela,0,78,0,0
1668558839854,ECE 276A,A00,103667,Atanasov; Nikolay A.,0,127,0,0
1668558840280,ECE 277,A00,103668,An; Cheolhong,0,151,0,0
1668558840704,ECE 279,A00,117947,Hall; Drew A.,0,22,0,0
1668558841552,ECE 283,A00,103670,Hsueh; Tzu-Chien,0,57,0,0
1668558841976,ECE 284,A00,103671,Turakhia; Yatish Girish,0,41,0,0
1668558842399,ECE 285,A00,103672,Zheng; Yang,0,41,0,0
1668558842399,ECE 285,B00,103673,Sworder; David D.,0,61,0,0
1668558842823,ECE 287,A00,103676,Javidi; Tara,0,8,0,0
1668558843249,MATH 200B,A00,098023,Salehi Golsefidy; Alireza,10,0,15,5
1668558843680,MATH 202B,A00,098024,Rhoades; Brendon Patrick,7,0,15,8
1668558844108,MATH 203B,A00,098025,Oprea; Dragos N.,9,0,15,6
1668558844530,MATH 204B,A00,098026,Sorensen; Claus M,13,0,15,2
1668558844959,MATH 208,A00,098027,Izadi; Elham,7,0,10,3
1668558845381,MATH 209,A00,098028,Pollack; Aaron,10,0,10,0
1668558845819,MATH 211A,A00,112919,Rogalski; Daniel,8,0,10,2
1668558846254,MATH 211B,A00,112920,Seward; Brandon M.,9,0,10,1
1668558846680,MATH 218,A00,098029,Li; Bo,10,0,10,0
1668558847116,MATH 220B,A00,098030,Novak; Jonathan I,11,0,15,4
1668558847540,MATH 221A,A00,098031,Ebenfelt; Peter F,12,0,15,3
1668558847967,MATH 231B,A00,098032,Zlatos; Andrej,9,0,15,6
1668558848399,MATH 240B,A00,098033,Ni; Lei,7,0,15,8
1668558848829,MATH 243,A00,098034,Jekel; David Andrew,10,0,10,0
1668558849252,MATH 245A,A00,098035,Nie; Jiawang,0,7,15,18
1668558849764,MATH 248,A00,098036,Bejenaru; Ioan,10,0,10,0
1668558850191,MATH 250B,A00,098037,Spolaor; Luca,13,0,15,2
1668558850615,MATH 258,A00,098038,Ni; Lei,8,0,10,2
1668558851045,MATH 264B,A00,098041,Rhoades; Brendon Patrick,8,0,15,7
1668558851469,MATH 268,A00,098042,Buss; Samuel R,10,0,10,0
1668558851891,MATH 269,A00,098043,Rhoades; Brendon Patrick,10,0,10,0
1668558852317,MATH 270B,A00,098044,Li; Bo,6,0,15,9
1668558852742,MATH 272B,A00,098045,Holst; Michael J,13,0,15,2
1668558853186,MATH 273A,A00,098046,Tian; Xiaochuan,10,0,15,5
1668558853613,MATH 275,A01,098048,Tian; Xiaochuan,6,0,10,4
1668558854038,MATH 278A,A00,098049,Holst; Michael J,6,0,10,4
1668558854481,MATH 278B,A00,098050,Cloninger; Alexander,10,0,10,0
1668558854913,MATH 278C,A00,098051,Nie; Jiawang,5,0,10,5
1668558855335,MATH 280B,A00,098052,Zheng; Tianyi,7,0,15,8
1668558855758,MATH 281B,A00,098053,Bradic; Jelena,0,2,15,15
1668558856184,MATH 282B,A00,098054,Arias-Castro; Ery,0,1,15,15
1668558856607,MATH 285,A00,098055,Fitzsimmons; Patrick J,0,4,15,17
1668558857031,MATH 287B,A00,098056,Arias-Castro; Ery,1,0,15,14
1668558857463,MATH 288,A00,098057,Agarwal; Pooja,9,0,10,1
1668558857463,MATH 288,B00,098058,Zhang; Danna,8,0,10,2
1668558857463,MATH 288,C00,098059,Williams; Ruth J,9,0,10,1
1668558857885,MATH 290B,A00,098060,Roberts; Justin Deritter,12,0,15,3
1668558858308,MATH 292,A00,098061,Belmont; Eva Kinoshita,10,0,10,0
1668558858735,MATH 295,A00,098062,Suk; Andrew Hoon,47,0,50,3
1668558859167,MATH 296,A00,098063,Novak; Jonathan I,20,0,20,0
1668558859598,MATH 297,001,098064,Gamst; Anthony Collins,9997,0,9999,2
1668559365534,COGS 205,A00,101395,Chiba; Andrea,19,0,20,1
1668559365959,COGS 210B,001,101404,Greene; Deanna Jacquelyn,9998,0,9999,1
1668559365959,COGS 210B,002,101417,Xia; Haijun,9999,0,9999,0
1668559365959,COGS 210B,003,101422,Nitz; Douglas A.,9999,0,9999,0
1668559365959,COGS 210B,004,101423,Hollan; James D.,9998,0,9999,1
1668559365959,COGS 210B,005,101424,Deak; Gedeon O.,9998,0,9999,1
1668559365959,COGS 210B,006,101425,Rossano; Federico,9999,0,9999,0
1668559366395,COGS 211B,A00,101427,Coulson; Seana M,9996,0,9999,3
1668559366819,COGS 220,A00,101428,Hollan; James D.,0,16,25,25
1668559367249,COGS 229,A00,101429,Dow; Steven P,17,0,25,8
1668559367671,COGS 230,A00,101430,Klemmer; Scott R,6,0,17,11
1668559368095,COGS 234,A00,101431,Xia; Haijun,0,1,25,25
1668559368518,COGS 260,A00,101432,Kiyonaga; Anastasia,21,0,25,4
1668559368518,COGS 260,B00,101433,Kirsh; David Joel,15,0,25,10
1668559368940,CSE 202,A00,102371,Impagliazzo; Russell,0,70,0,0
1668559369365,CSE 203B,A01,102373,Cheng; Chung Kuan,0,66,0,0
1668559369789,CSE 208,A00,102374,Micciancio; Daniele,0,5,0,0
1668559370226,CSE 209A,A00,112895,Impagliazzo; Russell,0,13,15,15
1668559370665,CSE 209B,A00,108005,Bellare; Mihir,0,7,0,0
1668559371087,CSE 210,A00,113163,Coblenz; Michael J,0,92,0,0
1668559371514,CSE 219,A00,106111,Dow; Steven P,0,8,20,20
1668559371936,CSE 221,A00,102376,Voelker; Geoffrey M.,0,76,0,0
1668559372371,CSE 224,A01,102378,Porter; George M,0,176,0,0
1668559372801,CSE 229A,A00,102379,Savage; Stefan,0,11,0,0
1668559373230,CSE 229C,A00,102380,Munyaka; Imani N. S.,0,10,0,0
1668559373659,CSE 232B,A00,102382,Deutsch; Alin Bernard,0,39,0,0
1668559374171,CSE 234,A01,112904,Kumar; Arun Kumar,0,0,0,0
1668559374604,CSE 237A,A00,102383,Rosing; Tajana Simunic,0,57,0,0
1668559375035,CSE 239A,A00,102384,Deutsch; Alin Bernard,0,16,0,0
1668559375459,CSE 239B,A00,102385,Polikarpova; Nadezhda,0,11,0,0
1668559375911,CSE 240A,A00,102386,Pannuto; Patrick William,0,48,0,0
1668559376337,CSE 240B,A00,102387,Zhao; Jishen,0,51,0,0
1668559376759,CSE 241A,A00,106406,Kang; Mingu,0,9,0,0
1668559377180,CSE 249B,A00,102388,Kahng; Andrew Byun,0,5,8,8
1668559377609,CSE 251B,A01,102392,Cottrell; Garrison W,0,52,0,0
1668559377609,CSE 251B,A02,102393,Cottrell; Garrison W,0,35,0,0
1668559378031,CSE 252B,A00,102394,Ochoa; Benjamin Lawrence,0,64,0,0
1668559378466,CSE 257,A01,102396,Gao; Sicun,0,155,0,0
1668559378897,CSE 272,A00,102397,Li; Tzumao,0,22,0,0
1668559379320,CSE 274,A00,111323,Chern; Albert Ren-Haur,0,16,0,0
1668559379743,CSE 282,A00,102398,Pevzner; Pavel Arkadjevich,0,0,0,0
1668559380184,CSE 284,A00,114175,Gymrek; Melissa Ann,0,30,0,0
1668559380608,CSE 290,A00,102399,Chandraker; Manmohan Krishna,0,11,0,0
1668559380608,CSE 290,B00,102400,Vaccaro; Kristen Marie,0,8,25,25
1668559380608,CSE 290,C00,102414,Pannuto; Patrick William,0,1,25,25
1668559380608,CSE 290,D00,102427,Pevzner; Pavel Arkadjevich,0,0,0,0
1668559380608,CSE 290,E00,102429,Zhao; Jishen,0,6,0,0
1668559380608,CSE 290,F00,102436,Tullsen; Dean Michael,0,6,0,0
1668559380608,CSE 290,G00,102440,Christensen; Henrik I,0,6,20,20
1668559381038,CSE 291,A00,102443,Su; Hao,0,0,0,0
1668559381038,CSE 291,B00,102448,Polikarpova; Nadezhda,0,0,0,0
1668559381038,CSE 291,C00,102453,Vaccaro; Kristen Marie,0,0,0,0
1668559381038,CSE 291,D00,111343,Savage; Stefan,0,0,0,0
1668559381038,CSE 291,E00,116474,Claffy; Kimberly Claire,0,0,0,0
1668559381038,CSE 291,F00,116479,Pasquale; Joseph,0,0,0,0
1668559381473,CSE 293,001,119111,Bafna; Vineet,9999,0,9999,0
1668559381473,CSE 293,002,119118,Bellare; Mihir,9999,0,9999,0
1668559381473,CSE 293,003,119122,Berg-Kirkpatrick; Taylor D,9999,0,9999,0
1668559381473,CSE 293,004,119135,Christensen; Henrik I,9999,0,9999,0
1668559381473,CSE 293,005,119142,Cottrell; Garrison W,9999,0,9999,0
1668559381473,CSE 293,006,119146,Deutsch; Alin Bernard,9999,0,9999,0
1668559381473,CSE 293,007,119159,Esmaeilzadeh; Hadi,9999,0,9999,0
1668559381473,CSE 293,008,119166,Freund; Yoav,9999,0,9999,0
1668559381473,CSE 293,009,119170,Griswold; William G.,9999,0,9999,0
1668559381473,CSE 293,010,119183,Gymrek; Melissa Ann,9999,0,9999,0
1668559381473,CSE 293,011,119190,Heninger; Nadia A,9999,0,9999,0
1668559381473,CSE 293,012,119230,Impagliazzo; Russell,9999,0,9999,0
1668559381473,CSE 293,013,119232,Jhala; Ranjit,9999,0,9999,0
1668559381473,CSE 293,014,119233,Kahng; Andrew Byun,9999,0,9999,0
1668559381473,CSE 293,015,119298,Kane; Daniel Mertz,9999,0,9999,0
1668559381473,CSE 293,016,119299,Kriegman; David J,9999,0,9999,0
1668559381473,CSE 293,017,119300,Kumar; Arun Kumar,9999,0,9999,0
1668559381473,CSE 293,018,119301,Lerner; Sorin,9999,0,9999,0
1668559381473,CSE 293,019,119302,Lovett; Shachar,9999,0,9999,0
1668559381473,CSE 293,020,119303,McAuley; Julian John,9999,0,9999,0
1668559381473,CSE 293,021,119304,Micciancio; Daniele,9999,0,9999,0
1668559381473,CSE 293,022,119367,Orailoglu; Alex,9999,0,9999,0
1668559381473,CSE 293,023,119382,Paturi; Ramamohan,9999,0,9999,0
1668559381473,CSE 293,024,119404,Polikarpova; Nadezhda,9999,0,9999,0
1668559381473,CSE 293,025,119406,Politz; Joseph Gibbs,9999,0,9999,0
1668559381473,CSE 293,026,119411,Porter; George M,9999,0,9999,0
1668559381473,CSE 293,027,119414,Porter; Leonard Emerson,9999,0,9999,0
1668559381473,CSE 293,028,119416,Ramamoorthi; Ravi,9999,0,9999,0
1668559381473,CSE 293,029,119417,Sahoo; Debashis,9999,0,9999,0
1668559381473,CSE 293,030,119420,Saul; Lawrence,9999,0,9999,0
1668559381473,CSE 293,031,119421,Savage; Stefan,9999,0,9999,0
1668559381473,CSE 293,032,119425,Schulze; Jurgen P.,9999,0,9999,0
1668559381473,CSE 293,033,119426,Snoeren; Alex C.,9999,0,9999,0
1668559381473,CSE 293,034,119428,Shang; Jingbo,9999,0,9999,0
1668559381473,CSE 293,035,119430,Stefan; Deian,9999,0,9999,0
1668559381473,CSE 293,036,119431,Su; Hao,9999,0,9999,0
1668559381473,CSE 293,037,119433,Swanson; Steven James,9999,0,9999,0
1668559381473,CSE 293,038,119435,Tullsen; Dean Michael,9999,0,9999,0
1668559381473,CSE 293,039,119483,Voelker; Geoffrey M.,9999,0,9999,0
1668559381473,CSE 293,040,119537,Zhao; Jishen,9999,0,9999,0
1668559381473,CSE 293,041,119538,Zhou; Yuan-Yuan,9999,0,9999,0
1668559381473,CSE 293,042,119539,Gao; Sicun,9999,0,9999,0
1668559381473,CSE 293,043,119540,Weibel; Nadir,9999,0,9999,0
1668559381473,CSE 293,044,119541,Gupta; Rajesh K.,9999,0,9999,0
1668559381473,CSE 293,045,126410,Vaccaro; Kristen Marie,9999,0,9999,0
1668559381473,CSE 293,046,126411,Klemke; Richard,9999,0,9999,0
1668559381896,CSE 294,A00,102459,Voelker; Geoffrey M.,0,2,0,0
1668559381896,CSE 294,B00,111322,Orailoglu; Alex,0,2,0,0
1668559382320,DSE 201,A00,096914,Deutsch; Alin Bernard,30,0,30,0
1668559382743,DSE 210,A00,096915,Dasgupta; Sanjoy,30,0,30,0
1668559383177,DSE 260A,A00,096916,Altintas De Callaf; Ilkay,30,0,30,0
1668559383616,ECE 200,001,103586,Antipa; Nicholas A,9999,0,9999,0
1668559383616,ECE 200,002,103587,Atanasov; Nikolay A.,9999,0,9999,0
1668559383616,ECE 200,003,103588,Bharadia; Dinesh,9999,0,9999,0
1668559383616,ECE 200,004,103589,Cheng; Chung Kuan,9999,0,9999,0
1668559383616,ECE 200,005,103590,Cosman; Pamela C.,9999,0,9999,0
1668559383616,ECE 200,006,103591,Dayeh; Shadi Ahmad,9999,0,9999,0
1668559383616,ECE 200,007,103592,Fainman; Yeshaiahu,9999,0,9999,0
1668559383616,ECE 200,008,103593,Ford; Joseph Earl,9999,0,9999,0
1668559383616,ECE 200,009,103594,Franceschetti; Massimo,9999,0,9999,0
1668559383616,ECE 200,010,103595,Fullerton; Eric E,9999,0,9999,0
1668559383616,ECE 200,011,103596,Galton; Ian A,9999,0,9999,0
1668559383616,ECE 200,012,103597,Gilja; Vikash,9999,0,9999,0
1668559383616,ECE 200,013,103598,Hall; Drew A.,9999,0,9999,0
1668559383616,ECE 200,014,103599,Hsueh; Tzu-Chien,9999,0,9999,0
1668559383616,ECE 200,015,103600,Javidi; Tara,9999,0,9999,0
1668559383616,ECE 200,016,103601,Kahng; Andrew Byun,9999,0,9999,0
1668559383616,ECE 200,017,103602,Kim; Young-Han,9999,0,9999,0
1668559383616,ECE 200,018,103603,Koushanfar; Farinaz,9999,0,9999,0
1668559383616,ECE 200,019,103604,Kuzum; Duygu,9999,0,9999,0
1668559383616,ECE 200,020,103605,Le; Hanh-Phuc,9999,0,9999,0
1668559383616,ECE 200,021,103606,Lin; Bill,9999,0,9999,0
1668559383616,ECE 200,022,103607,Liu; Zhaowei,9998,0,9999,1
1668559383616,ECE 200,023,103608,Lo; Yu-Hwa,9999,0,9999,0
1668559383616,ECE 200,024,103609,Lomakin; Vitaliy,9999,0,9999,0
1668559383616,ECE 200,025,103610,Mercier; Patrick Philip,9999,0,9999,0
1668559383616,ECE 200,026,103611,Meyer; Florian,9999,0,9999,0
1668559383616,ECE 200,027,103612,Milstein; Laurence B.,9999,0,9999,0
1668559383616,ECE 200,028,103613,Mir Arabbaygi; Siavash,9999,0,9999,0
1668559383616,ECE 200,029,103614,Mookherjea; Shayan,9999,0,9999,0
1668559383616,ECE 200,030,103615,Morris; Karcher William,9999,0,9999,0
1668559383616,ECE 200,031,103616,Ng; Tse Nga,9999,0,9999,0
1668559383616,ECE 200,032,103617,Nguyen; Truong Quang,9999,0,9999,0
1668559383616,ECE 200,033,103618,Nomura; Kenji,9999,0,9999,0
1668559383616,ECE 200,034,103619,Orlitsky; Alon,9999,0,9999,0
1668559383616,ECE 200,035,103620,Pal; Piya,9999,0,9999,0
1668559383616,ECE 200,036,103621,Papen; George C.,9999,0,9999,0
1668559383616,ECE 200,037,103622,Radic; Stojan,9999,0,9999,0
1668559383616,ECE 200,038,103623,Rao; Bhaskar D.,9999,0,9999,0
1668559383616,ECE 200,039,103624,Rao; Ramesh R,9999,0,9999,0
1668559383616,ECE 200,040,103625,Rebeiz; Gabriel,9999,0,9999,0
1668559383616,ECE 200,041,103626,Sanford; John R,9999,0,9999,0
1668559383616,ECE 200,042,103627,Siegel; Paul H.,9999,0,9999,0
1668559383616,ECE 200,043,103628,Sievenpiper; Daniel F.,9999,0,9999,0
1668559383616,ECE 200,044,103629,Sworder; David D.,9999,0,9999,0
1668559383616,ECE 200,045,103630,Taur; Yuan,9999,0,9999,0
1668559383616,ECE 200,046,103631,Touri; Behrouz,9999,0,9999,0
1668559383616,ECE 200,047,103632,Trivedi; Mohan M.,9999,0,9999,0
1668559383616,ECE 200,048,103633,Vasconcelos; Nuno,9999,0,9999,0
1668559383616,ECE 200,049,103634,Wang; Xiaolong,9999,0,9999,0
1668559383616,ECE 200,050,103635,Xie; Pengtao,9999,0,9999,0
1668559383616,ECE 200,051,103636,Yip; Michael,9999,0,9999,0
1668559383616,ECE 200,052,103637,Zeger; Kenneth A.,999,0,999,0
1668559383616,ECE 200,053,103638,Zhang; Xinyu,9999,0,9999,0
1668559383616,ECE 200,054,103639,Turakhia; Yatish Girish,9999,0,9999,0
1668559383616,ECE 200,055,103640,Kang; Mingu,9999,0,9999,0
1668559383616,ECE 200,056,103641,Shi; Yuanyuan,9999,0,9999,0
1668559383616,ECE 200,057,103642,Wang; Edward Jay,9999,0,9999,0
1668559383616,ECE 200,058,103643,Zheng; Yang,9999,0,9999,0
1668559384039,ECE 202,A00,103644,Kuzum; Duygu,0,46,0,0
1668559384468,ECE 212BN,A00,103646,Ng; Tse Nga,0,9,0,0
1668559384898,ECE 221,A00,111493,Staff,0,0,0,0
1668559385320,ECE 222B,A00,103647,Lomakin; Vitaliy,0,21,0,0
1668559385741,ECE 230B,A00,103648,Taur; Yuan,0,4,0,0
1668559386164,ECE 238B,A00,103649,Garay; Javier,0,0,0,0
1668559386594,ECE 240B,A00,112900,Fainman; Yeshaiahu,0,8,0,0
1668559387029,ECE 247A,A00,103650,Jokerst; Jesse Vincent,0,6,0,0
1668559387453,ECE 247B,A00,103651,Wang; Joseph,0,14,0,0
1668559387877,ECE 250,A00,103652,Siegel; Paul H.,0,84,0,0
1668559388300,ECE 251A,A00,103654,Rao; Bhaskar D.,0,64,0,0
1668559388722,ECE 257B,A00,103655,Bharadia; Dinesh,0,33,0,0
1668559389147,ECE 258A,A00,103656,Milstein; Laurence B.,0,29,0,0
1668559389569,ECE 260B,A00,103658,Kang; Mingu,0,123,0,0
1668559389996,ECE 264A,A00,103659,Galton; Ian A,0,57,0,17
1668559390420,ECE 265A,A00,103661,Gudem; Prasad S.S.,0,59,0,16
1668559390842,ECE 265D,A00,103662,Gudem; Prasad S.S.,0,26,0,0
1668559391263,ECE 268,A00,103663,Koushanfar; Farinaz,0,44,0,0
1668559391691,ECE 269,A01,103665,Pal; Piya,0,222,0,0
1668559392114,ECE 271B,A00,103666,Vasconcelos; Manuela,0,78,0,0
1668559392539,ECE 276A,A00,103667,Atanasov; Nikolay A.,0,127,0,0
1668559392965,ECE 277,A00,103668,An; Cheolhong,0,151,0,0
1668559393395,ECE 279,A00,117947,Hall; Drew A.,0,22,0,0
1668559394249,ECE 283,A00,103670,Hsueh; Tzu-Chien,0,57,0,0
1668559394672,ECE 284,A00,103671,Turakhia; Yatish Girish,0,41,0,0
1668559395107,ECE 285,A00,103672,Zheng; Yang,0,41,0,0
1668559395107,ECE 285,B00,103673,Sworder; David D.,0,61,0,0
1668559395530,ECE 287,A00,103676,Javidi; Tara,0,8,0,0
1668559395954,MATH 200B,A00,098023,Salehi Golsefidy; Alireza,9,0,15,6
1668559396379,MATH 202B,A00,098024,Rhoades; Brendon Patrick,7,0,15,8
1668559396814,MATH 203B,A00,098025,Oprea; Dragos N.,9,0,15,6
1668559397242,MATH 204B,A00,098026,Sorensen; Claus M,13,0,15,2
1668559397682,MATH 208,A00,098027,Izadi; Elham,7,0,10,3
1668559398107,MATH 209,A00,098028,Pollack; Aaron,10,0,10,0
1668559398546,MATH 211A,A00,112919,Rogalski; Daniel,8,0,10,2
1668559398973,MATH 211B,A00,112920,Seward; Brandon M.,9,0,10,1
1668559399398,MATH 218,A00,098029,Li; Bo,10,0,10,0
1668559399829,MATH 220B,A00,098030,Novak; Jonathan I,11,0,15,4
1668559400257,MATH 221A,A00,098031,Ebenfelt; Peter F,12,0,15,3
1668559400684,MATH 231B,A00,098032,Zlatos; Andrej,9,0,15,6
1668559401107,MATH 240B,A00,098033,Ni; Lei,7,0,15,8
1668559401544,MATH 243,A00,098034,Jekel; David Andrew,10,0,10,0
1668559401969,MATH 245A,A00,098035,Nie; Jiawang,0,7,15,18
1668559402393,MATH 248,A00,098036,Bejenaru; Ioan,10,0,10,0
1668559402817,MATH 250B,A00,098037,Spolaor; Luca,13,0,15,2
1668559403250,MATH 258,A00,098038,Ni; Lei,8,0,10,2
1668559403686,MATH 264B,A00,098041,Rhoades; Brendon Patrick,8,0,15,7
1668559404108,MATH 268,A00,098042,Buss; Samuel R,10,0,10,0
1668559404533,MATH 269,A00,098043,Rhoades; Brendon Patrick,10,0,10,0
1668559404966,MATH 270B,A00,098044,Li; Bo,6,0,15,9
1668559405402,MATH 272B,A00,098045,Holst; Michael J,13,0,15,2
1668559405839,MATH 273A,A00,098046,Tian; Xiaochuan,10,0,15,5
1668559406277,MATH 275,A01,098048,Tian; Xiaochuan,6,0,10,4
1668559406698,MATH 278A,A00,098049,Holst; Michael J,6,0,10,4
1668559407133,MATH 278B,A00,098050,Cloninger; Alexander,10,0,10,0
1668559407556,MATH 278C,A00,098051,Nie; Jiawang,5,0,10,5
1668559407979,MATH 280B,A00,098052,Zheng; Tianyi,6,0,15,9
1668559408404,MATH 281B,A00,098053,Bradic; Jelena,0,2,15,15
1668559408837,MATH 282B,A00,098054,Arias-Castro; Ery,0,1,15,15
1668559409263,MATH 285,A00,098055,Fitzsimmons; Patrick J,0,4,15,17
1668559409685,MATH 287B,A00,098056,Arias-Castro; Ery,1,0,15,14
1668559410110,MATH 288,A00,098057,Agarwal; Pooja,9,0,10,1
1668559410110,MATH 288,B00,098058,Zhang; Danna,8,0,10,2
1668559410110,MATH 288,C00,098059,Williams; Ruth J,9,0,10,1
1668559410540,MATH 290B,A00,098060,Roberts; Justin Deritter,11,0,15,4
1668559410966,MATH 292,A00,098061,Belmont; Eva Kinoshita,10,0,10,0
1668559411388,MATH 295,A00,098062,Suk; Andrew Hoon,47,0,50,3
1668559411825,MATH 296,A00,098063,Novak; Jonathan I,20,0,20,0
1668559412252,MATH 297,001,098064,Gamst; Anthony Collins,9997,0,9999,2
1668559915331,COGS 205,A00,101395,Chiba; Andrea,19,0,20,1
1668559915753,COGS 210B,001,101404,Greene; Deanna Jacquelyn,9998,0,9999,1
1668559915753,COGS 210B,002,101417,Xia; Haijun,9999,0,9999,0
1668559915753,COGS 210B,003,101422,Nitz; Douglas A.,9999,0,9999,0
1668559915753,COGS 210B,004,101423,Hollan; James D.,9998,0,9999,1
1668559915753,COGS 210B,005,101424,Deak; Gedeon O.,9998,0,9999,1
1668559915753,COGS 210B,006,101425,Rossano; Federico,9999,0,9999,0
1668559916177,COGS 211B,A00,101427,Coulson; Seana M,9996,0,9999,3
1668559916601,COGS 220,A00,101428,Hollan; James D.,0,16,25,25
1668559917039,COGS 229,A00,101429,Dow; Steven P,17,0,25,8
1668559917463,COGS 230,A00,101430,Klemmer; Scott R,6,0,17,11
1668559917889,COGS 234,A00,101431,Xia; Haijun,0,1,25,25
1668559918316,COGS 260,A00,101432,Kiyonaga; Anastasia,21,0,25,4
1668559918316,COGS 260,B00,101433,Kirsh; David Joel,15,0,25,10
1668559918743,CSE 202,A00,102371,Impagliazzo; Russell,0,70,0,0
1668559919168,CSE 203B,A01,102373,Cheng; Chung Kuan,0,66,0,0
1668559919591,CSE 208,A00,102374,Micciancio; Daniele,0,5,0,0
1668559920014,CSE 209A,A00,112895,Impagliazzo; Russell,0,14,15,15
1668559920445,CSE 209B,A00,108005,Bellare; Mihir,0,7,0,0
1668559920869,CSE 210,A00,113163,Coblenz; Michael J,0,92,0,0
1668559921291,CSE 219,A00,106111,Dow; Steven P,0,8,20,20
1668559921717,CSE 221,A00,102376,Voelker; Geoffrey M.,0,76,0,0
1668559922145,CSE 224,A01,102378,Porter; George M,0,176,0,0
1668559922602,CSE 229A,A00,102379,Savage; Stefan,0,11,0,0
1668559923028,CSE 229C,A00,102380,Munyaka; Imani N. S.,0,10,0,0
1668559923453,CSE 232B,A00,102382,Deutsch; Alin Bernard,0,39,0,0
1668559923882,CSE 234,A01,112904,Kumar; Arun Kumar,0,0,0,0
1668559924315,CSE 237A,A00,102383,Rosing; Tajana Simunic,0,57,0,0
1668559924741,CSE 239A,A00,102384,Deutsch; Alin Bernard,0,16,0,0
1668559925164,CSE 239B,A00,102385,Polikarpova; Nadezhda,0,11,0,0
1668559925595,CSE 240A,A00,102386,Pannuto; Patrick William,0,48,0,0
1668559926031,CSE 240B,A00,102387,Zhao; Jishen,0,51,0,0
1668559926468,CSE 241A,A00,106406,Kang; Mingu,0,9,0,0
1668559926894,CSE 249B,A00,102388,Kahng; Andrew Byun,0,5,8,8
1668559927323,CSE 251B,A01,102392,Cottrell; Garrison W,0,52,0,0
1668559927323,CSE 251B,A02,102393,Cottrell; Garrison W,0,35,0,0
1668559927752,CSE 252B,A00,102394,Ochoa; Benjamin Lawrence,0,64,0,0
1668559928177,CSE 257,A01,102396,Gao; Sicun,0,155,0,0
1668559928605,CSE 272,A00,102397,Li; Tzumao,0,22,0,0
1668559929034,CSE 274,A00,111323,Chern; Albert Ren-Haur,0,16,0,0
1668559929468,CSE 282,A00,102398,Pevzner; Pavel Arkadjevich,0,0,0,0
1668559929894,CSE 284,A00,114175,Gymrek; Melissa Ann,0,30,0,0
1668559930318,CSE 290,A00,102399,Chandraker; Manmohan Krishna,0,11,0,0
1668559930318,CSE 290,B00,102400,Vaccaro; Kristen Marie,0,8,25,25
1668559930318,CSE 290,C00,102414,Pannuto; Patrick William,0,1,25,25
1668559930318,CSE 290,D00,102427,Pevzner; Pavel Arkadjevich,0,0,0,0
1668559930318,CSE 290,E00,102429,Zhao; Jishen,0,6,0,0
1668559930318,CSE 290,F00,102436,Tullsen; Dean Michael,0,6,0,0
1668559930318,CSE 290,G00,102440,Christensen; Henrik I,0,7,20,20
1668559930743,CSE 291,A00,102443,Su; Hao,0,0,0,0
1668559930743,CSE 291,B00,102448,Polikarpova; Nadezhda,0,0,0,0
1668559930743,CSE 291,C00,102453,Vaccaro; Kristen Marie,0,0,0,0
1668559930743,CSE 291,D00,111343,Savage; Stefan,0,0,0,0
1668559930743,CSE 291,E00,116474,Claffy; Kimberly Claire,0,0,0,0
1668559930743,CSE 291,F00,116479,Pasquale; Joseph,0,0,0,0
1668559931184,CSE 293,001,119111,Bafna; Vineet,9999,0,9999,0
1668559931184,CSE 293,002,119118,Bellare; Mihir,9999,0,9999,0
1668559931184,CSE 293,003,119122,Berg-Kirkpatrick; Taylor D,9999,0,9999,0
1668559931184,CSE 293,004,119135,Christensen; Henrik I,9999,0,9999,0
1668559931184,CSE 293,005,119142,Cottrell; Garrison W,9999,0,9999,0
1668559931184,CSE 293,006,119146,Deutsch; Alin Bernard,9999,0,9999,0
1668559931184,CSE 293,007,119159,Esmaeilzadeh; Hadi,9999,0,9999,0
1668559931184,CSE 293,008,119166,Freund; Yoav,9999,0,9999,0
1668559931184,CSE 293,009,119170,Griswold; William G.,9999,0,9999,0
1668559931184,CSE 293,010,119183,Gymrek; Melissa Ann,9999,0,9999,0
1668559931184,CSE 293,011,119190,Heninger; Nadia A,9999,0,9999,0
1668559931184,CSE 293,012,119230,Impagliazzo; Russell,9999,0,9999,0
1668559931184,CSE 293,013,119232,Jhala; Ranjit,9999,0,9999,0
1668559931184,CSE 293,014,119233,Kahng; Andrew Byun,9999,0,9999,0
1668559931184,CSE 293,015,119298,Kane; Daniel Mertz,9999,0,9999,0
1668559931184,CSE 293,016,119299,Kriegman; David J,9999,0,9999,0
1668559931184,CSE 293,017,119300,Kumar; Arun Kumar,9999,0,9999,0
1668559931184,CSE 293,018,119301,Lerner; Sorin,9999,0,9999,0
1668559931184,CSE 293,019,119302,Lovett; Shachar,9999,0,9999,0
1668559931184,CSE 293,020,119303,McAuley; Julian John,9999,0,9999,0
1668559931184,CSE 293,021,119304,Micciancio; Daniele,9999,0,9999,0
1668559931184,CSE 293,022,119367,Orailoglu; Alex,9999,0,9999,0
1668559931184,CSE 293,023,119382,Paturi; Ramamohan,9999,0,9999,0
1668559931184,CSE 293,024,119404,Polikarpova; Nadezhda,9999,0,9999,0
1668559931184,CSE 293,025,119406,Politz; Joseph Gibbs,9999,0,9999,0
1668559931184,CSE 293,026,119411,Porter; George M,9999,0,9999,0
1668559931184,CSE 293,027,119414,Porter; Leonard Emerson,9999,0,9999,0
1668559931184,CSE 293,028,119416,Ramamoorthi; Ravi,9999,0,9999,0
1668559931184,CSE 293,029,119417,Sahoo; Debashis,9999,0,9999,0
1668559931184,CSE 293,030,119420,Saul; Lawrence,9999,0,9999,0
1668559931184,CSE 293,031,119421,Savage; Stefan,9999,0,9999,0
1668559931184,CSE 293,032,119425,Schulze; Jurgen P.,9999,0,9999,0
1668559931184,CSE 293,033,119426,Snoeren; Alex C.,9999,0,9999,0
1668559931184,CSE 293,034,119428,Shang; Jingbo,9999,0,9999,0
1668559931184,CSE 293,035,119430,Stefan; Deian,9999,0,9999,0
1668559931184,CSE 293,036,119431,Su; Hao,9999,0,9999,0
1668559931184,CSE 293,037,119433,Swanson; Steven James,9999,0,9999,0
1668559931184,CSE 293,038,119435,Tullsen; Dean Michael,9999,0,9999,0
1668559931184,CSE 293,039,119483,Voelker; Geoffrey M.,9999,0,9999,0
1668559931184,CSE 293,040,119537,Zhao; Jishen,9999,0,9999,0
1668559931184,CSE 293,041,119538,Zhou; Yuan-Yuan,9999,0,9999,0
1668559931184,CSE 293,042,119539,Gao; Sicun,9999,0,9999,0
1668559931184,CSE 293,043,119540,Weibel; Nadir,9999,0,9999,0
1668559931184,CSE 293,044,119541,Gupta; Rajesh K.,9999,0,9999,0
1668559931184,CSE 293,045,126410,Vaccaro; Kristen Marie,9999,0,9999,0
1668559931184,CSE 293,046,126411,Klemke; Richard,9999,0,9999,0
1668559931609,CSE 294,A00,102459,Voelker; Geoffrey M.,0,2,0,0
1668559931609,CSE 294,B00,111322,Orailoglu; Alex,0,2,0,0
1668559932034,DSE 201,A00,096914,Deutsch; Alin Bernard,30,0,30,0
1668559932458,DSE 210,A00,096915,Dasgupta; Sanjoy,30,0,30,0
1668559932894,DSE 260A,A00,096916,Altintas De Callaf; Ilkay,30,0,30,0
1668559933336,ECE 200,001,103586,Antipa; Nicholas A,9999,0,9999,0
1668559933336,ECE 200,002,103587,Atanasov; Nikolay A.,9999,0,9999,0
1668559933336,ECE 200,003,103588,Bharadia; Dinesh,9999,0,9999,0
1668559933336,ECE 200,004,103589,Cheng; Chung Kuan,9999,0,9999,0
1668559933336,ECE 200,005,103590,Cosman; Pamela C.,9999,0,9999,0
1668559933336,ECE 200,006,103591,Dayeh; Shadi Ahmad,9999,0,9999,0
1668559933336,ECE 200,007,103592,Fainman; Yeshaiahu,9999,0,9999,0
1668559933336,ECE 200,008,103593,Ford; Joseph Earl,9999,0,9999,0
1668559933336,ECE 200,009,103594,Franceschetti; Massimo,9999,0,9999,0
1668559933336,ECE 200,010,103595,Fullerton; Eric E,9999,0,9999,0
1668559933336,ECE 200,011,103596,Galton; Ian A,9999,0,9999,0
1668559933336,ECE 200,012,103597,Gilja; Vikash,9999,0,9999,0
1668559933336,ECE 200,013,103598,Hall; Drew A.,9999,0,9999,0
1668559933336,ECE 200,014,103599,Hsueh; Tzu-Chien,9999,0,9999,0
1668559933336,ECE 200,015,103600,Javidi; Tara,9999,0,9999,0
1668559933336,ECE 200,016,103601,Kahng; Andrew Byun,9999,0,9999,0
1668559933336,ECE 200,017,103602,Kim; Young-Han,9999,0,9999,0
1668559933336,ECE 200,018,103603,Koushanfar; Farinaz,9999,0,9999,0
1668559933336,ECE 200,019,103604,Kuzum; Duygu,9999,0,9999,0
1668559933336,ECE 200,020,103605,Le; Hanh-Phuc,9999,0,9999,0
1668559933336,ECE 200,021,103606,Lin; Bill,9999,0,9999,0
1668559933336,ECE 200,022,103607,Liu; Zhaowei,9998,0,9999,1
1668559933336,ECE 200,023,103608,Lo; Yu-Hwa,9999,0,9999,0
1668559933336,ECE 200,024,103609,Lomakin; Vitaliy,9999,0,9999,0
1668559933336,ECE 200,025,103610,Mercier; Patrick Philip,9999,0,9999,0
1668559933336,ECE 200,026,103611,Meyer; Florian,9999,0,9999,0
1668559933336,ECE 200,027,103612,Milstein; Laurence B.,9999,0,9999,0
1668559933336,ECE 200,028,103613,Mir Arabbaygi; Siavash,9999,0,9999,0
1668559933336,ECE 200,029,103614,Mookherjea; Shayan,9999,0,9999,0
1668559933336,ECE 200,030,103615,Morris; Karcher William,9999,0,9999,0
1668559933336,ECE 200,031,103616,Ng; Tse Nga,9999,0,9999,0
1668559933336,ECE 200,032,103617,Nguyen; Truong Quang,9999,0,9999,0
1668559933336,ECE 200,033,103618,Nomura; Kenji,9999,0,9999,0
1668559933336,ECE 200,034,103619,Orlitsky; Alon,9999,0,9999,0
1668559933336,ECE 200,035,103620,Pal; Piya,9999,0,9999,0
1668559933336,ECE 200,036,103621,Papen; George C.,9999,0,9999,0
1668559933336,ECE 200,037,103622,Radic; Stojan,9999,0,9999,0
1668559933336,ECE 200,038,103623,Rao; Bhaskar D.,9999,0,9999,0
1668559933336,ECE 200,039,103624,Rao; Ramesh R,9999,0,9999,0
1668559933336,ECE 200,040,103625,Rebeiz; Gabriel,9999,0,9999,0
1668559933336,ECE 200,041,103626,Sanford; John R,9999,0,9999,0
1668559933336,ECE 200,042,103627,Siegel; Paul H.,9999,0,9999,0
1668559933336,ECE 200,043,103628,Sievenpiper; Daniel F.,9999,0,9999,0
1668559933336,ECE 200,044,103629,Sworder; David D.,9999,0,9999,0
1668559933336,ECE 200,045,103630,Taur; Yuan,9999,0,9999,0
1668559933336,ECE 200,046,103631,Touri; Behrouz,9999,0,9999,0
1668559933336,ECE 200,047,103632,Trivedi; Mohan M.,9999,0,9999,0
1668559933336,ECE 200,048,103633,Vasconcelos; Nuno,9999,0,9999,0
1668559933336,ECE 200,049,103634,Wang; Xiaolong,9999,0,9999,0
1668559933336,ECE 200,050,103635,Xie; Pengtao,9999,0,9999,0
1668559933336,ECE 200,051,103636,Yip; Michael,9999,0,9999,0
1668559933336,ECE 200,052,103637,Zeger; Kenneth A.,999,0,999,0
1668559933336,ECE 200,053,103638,Zhang; Xinyu,9999,0,9999,0
1668559933336,ECE 200,054,103639,Turakhia; Yatish Girish,9999,0,9999,0
1668559933336,ECE 200,055,103640,Kang; Mingu,9999,0,9999,0
1668559933336,ECE 200,056,103641,Shi; Yuanyuan,9999,0,9999,0
1668559933336,ECE 200,057,103642,Wang; Edward Jay,9999,0,9999,0
1668559933336,ECE 200,058,103643,Zheng; Yang,9999,0,9999,0
1668559933775,ECE 202,A00,103644,Kuzum; Duygu,0,46,0,0
1668559934202,ECE 212BN,A00,103646,Ng; Tse Nga,0,9,0,0
1668559934626,ECE 221,A00,111493,Staff,0,0,0,0
1668559935060,ECE 222B,A00,103647,Lomakin; Vitaliy,0,21,0,0
1668559935496,ECE 230B,A00,103648,Taur; Yuan,0,4,0,0
1668559935925,ECE 238B,A00,103649,Garay; Javier,0,0,0,0
1668559936347,ECE 240B,A00,112900,Fainman; Yeshaiahu,0,8,0,0
1668559936774,ECE 247A,A00,103650,Jokerst; Jesse Vincent,0,6,0,0
1668559937198,ECE 247B,A00,103651,Wang; Joseph,0,14,0,0
1668559937634,ECE 250,A00,103652,Siegel; Paul H.,0,84,0,0
1668559938060,ECE 251A,A00,103654,Rao; Bhaskar D.,0,64,0,0
1668559938484,ECE 257B,A00,103655,Bharadia; Dinesh,0,33,0,0
1668559938982,ECE 258A,A00,103656,Milstein; Laurence B.,0,29,0,0
1668559939405,ECE 260B,A00,103658,Kang; Mingu,0,123,0,0
1668559939831,ECE 264A,A00,103659,Galton; Ian A,0,56,0,17
1668559940256,ECE 265A,A00,103661,Gudem; Prasad S.S.,0,58,0,17
1668559940682,ECE 265D,A00,103662,Gudem; Prasad S.S.,0,26,0,0
1668559941117,ECE 268,A00,103663,Koushanfar; Farinaz,0,44,0,0
1668559941542,ECE 269,A01,103665,Pal; Piya,0,222,0,0
1668559941970,ECE 271B,A00,103666,Vasconcelos; Manuela,0,78,0,0
1668559942406,ECE 276A,A00,103667,Atanasov; Nikolay A.,0,127,0,0
1668559942834,ECE 277,A00,103668,An; Cheolhong,0,151,0,0
1668559943260,ECE 279,A00,117947,Hall; Drew A.,0,22,0,0
1668559944109,ECE 283,A00,103670,Hsueh; Tzu-Chien,0,57,0,0
1668559944537,ECE 284,A00,103671,Turakhia; Yatish Girish,0,41,0,0
1668559944973,ECE 285,A00,103672,Zheng; Yang,0,41,0,0
1668559944973,ECE 285,B00,103673,Sworder; David D.,0,61,0,0
1668559945402,ECE 287,A00,103676,Javidi; Tara,0,8,0,0
1668559945825,MATH 200B,A00,098023,Salehi Golsefidy; Alireza,9,0,15,6
1668559946253,MATH 202B,A00,098024,Rhoades; Brendon Patrick,7,0,15,8
1668559946679,MATH 203B,A00,098025,Oprea; Dragos N.,9,0,15,6
1668559947102,MATH 204B,A00,098026,Sorensen; Claus M,13,0,15,2
1668559947528,MATH 208,A00,098027,Izadi; Elham,7,0,10,3
1668559947953,MATH 209,A00,098028,Pollack; Aaron,10,0,10,0
1668559948378,MATH 211A,A00,112919,Rogalski; Daniel,8,0,10,2
1668559948807,MATH 211B,A00,112920,Seward; Brandon M.,9,0,10,1
1668559949233,MATH 218,A00,098029,Li; Bo,10,0,10,0
1668559949660,MATH 220B,A00,098030,Novak; Jonathan I,11,0,15,4
1668559950088,MATH 221A,A00,098031,Ebenfelt; Peter F,12,0,15,3
1668559950512,MATH 231B,A00,098032,Zlatos; Andrej,9,0,15,6
1668559950942,MATH 240B,A00,098033,Ni; Lei,7,0,15,8
1668559951364,MATH 243,A00,098034,Jekel; David Andrew,10,0,10,0
1668559951788,MATH 245A,A00,098035,Nie; Jiawang,0,7,15,18
1668559952218,MATH 248,A00,098036,Bejenaru; Ioan,10,0,10,0
1668559952644,MATH 250B,A00,098037,Spolaor; Luca,13,0,15,2
1668559953068,MATH 258,A00,098038,Ni; Lei,8,0,10,2
1668559953492,MATH 264B,A00,098041,Rhoades; Brendon Patrick,8,0,15,7
1668559953933,MATH 268,A00,098042,Buss; Samuel R,10,0,10,0
1668559954355,MATH 269,A00,098043,Rhoades; Brendon Patrick,10,0,10,0
1668559954830,MATH 270B,A00,098044,Li; Bo,6,0,15,9
1668559955265,MATH 272B,A00,098045,Holst; Michael J,13,0,15,2
1668559955695,MATH 273A,A00,098046,Tian; Xiaochuan,10,0,15,5
1668559956128,MATH 275,A01,098048,Tian; Xiaochuan,6,0,10,4
1668559956555,MATH 278A,A00,098049,Holst; Michael J,6,0,10,4
1668559956983,MATH 278B,A00,098050,Cloninger; Alexander,10,0,10,0
1668559957413,MATH 278C,A00,098051,Nie; Jiawang,5,0,10,5
1668559957838,MATH 280B,A00,098052,Zheng; Tianyi,6,0,15,9
1668559958260,MATH 281B,A00,098053,Bradic; Jelena,0,2,15,15
1668559958701,MATH 282B,A00,098054,Arias-Castro; Ery,0,1,15,15
1668559959125,MATH 285,A00,098055,Fitzsimmons; Patrick J,0,4,15,17
1668559959552,MATH 287B,A00,098056,Arias-Castro; Ery,1,0,15,14
1668559959974,MATH 288,A00,098057,Agarwal; Pooja,9,0,10,1
1668559959974,MATH 288,B00,098058,Zhang; Danna,8,0,10,2
1668559959974,MATH 288,C00,098059,Williams; Ruth J,9,0,10,1
1668559960417,MATH 290B,A00,098060,Roberts; Justin Deritter,11,0,15,4
1668559960841,MATH 292,A00,098061,Belmont; Eva Kinoshita,10,0,10,0
1668559961270,MATH 295,A00,098062,Suk; Andrew Hoon,47,0,50,3
1668559961692,MATH 296,A00,098063,Novak; Jonathan I,20,0,20,0
1668559962130,MATH 297,001,098064,Gamst; Anthony Collins,9997,0,9999,2
1668560476280,COGS 205,A00,101395,Chiba; Andrea,19,0,20,1
1668560476707,COGS 210B,001,101404,Greene; Deanna Jacquelyn,9998,0,9999,1
1668560476707,COGS 210B,002,101417,Xia; Haijun,9999,0,9999,0
1668560476707,COGS 210B,003,101422,Nitz; Douglas A.,9999,0,9999,0
1668560476707,COGS 210B,004,101423,Hollan; James D.,9998,0,9999,1
1668560476707,COGS 210B,005,101424,Deak; Gedeon O.,9998,0,9999,1
1668560476707,COGS 210B,006,101425,Rossano; Federico,9999,0,9999,0
1668560477133,COGS 211B,A00,101427,Coulson; Seana M,9996,0,9999,3
1668560477559,COGS 220,A00,101428,Hollan; James D.,0,16,25,25
1668560477984,COGS 229,A00,101429,Dow; Steven P,17,0,25,8
1668560478406,COGS 230,A00,101430,Klemmer; Scott R,6,0,17,11
1668560478832,COGS 234,A00,101431,Xia; Haijun,0,1,25,25
1668560479256,COGS 260,A00,101432,Kiyonaga; Anastasia,21,0,25,4
1668560479256,COGS 260,B00,101433,Kirsh; David Joel,15,0,25,10
1668560479680,CSE 202,A00,102371,Impagliazzo; Russell,0,70,0,0
1668560480102,CSE 203B,A01,102373,Cheng; Chung Kuan,0,66,0,0
1668560480526,CSE 208,A00,102374,Micciancio; Daniele,0,5,0,0
1668560480953,CSE 209A,A00,112895,Impagliazzo; Russell,0,14,15,15
1668560481379,CSE 209B,A00,108005,Bellare; Mihir,0,7,0,0
1668560481802,CSE 210,A00,113163,Coblenz; Michael J,0,92,0,0
1668560482227,CSE 219,A00,106111,Dow; Steven P,0,8,20,20
1668560482650,CSE 221,A00,102376,Voelker; Geoffrey M.,0,76,0,0
1668560483078,CSE 224,A01,102378,Porter; George M,0,176,0,0
1668560483500,CSE 229A,A00,102379,Savage; Stefan,0,11,0,0
1668560483933,CSE 229C,A00,102380,Munyaka; Imani N. S.,0,10,0,0
1668560484362,CSE 232B,A00,102382,Deutsch; Alin Bernard,0,39,0,0
1668560484786,CSE 234,A01,112904,Kumar; Arun Kumar,0,0,0,0
1668560485218,CSE 237A,A00,102383,Rosing; Tajana Simunic,0,57,0,0
1668560485644,CSE 239A,A00,102384,Deutsch; Alin Bernard,0,16,0,0
1668560486069,CSE 239B,A00,102385,Polikarpova; Nadezhda,0,11,0,0
1668560486492,CSE 240A,A00,102386,Pannuto; Patrick William,0,48,0,0
1668560486915,CSE 240B,A00,102387,Zhao; Jishen,0,51,0,0
1668560487350,CSE 241A,A00,106406,Kang; Mingu,0,9,0,0
1668560487774,CSE 249B,A00,102388,Kahng; Andrew Byun,0,5,8,8
1668560488197,CSE 251B,A01,102392,Cottrell; Garrison W,0,53,0,0
1668560488197,CSE 251B,A02,102393,Cottrell; Garrison W,0,35,0,0
1668560488627,CSE 252B,A00,102394,Ochoa; Benjamin Lawrence,0,64,0,0
1668560489051,CSE 257,A01,102396,Gao; Sicun,0,155,0,0
1668560489480,CSE 272,A00,102397,Li; Tzumao,0,22,0,0
1668560489923,CSE 274,A00,111323,Chern; Albert Ren-Haur,0,16,0,0
1668560490346,CSE 282,A00,102398,Pevzner; Pavel Arkadjevich,0,0,0,0
1668560490768,CSE 284,A00,114175,Gymrek; Melissa Ann,0,30,0,0
1668560491193,CSE 290,A00,102399,Chandraker; Manmohan Krishna,0,11,0,0
1668560491193,CSE 290,B00,102400,Vaccaro; Kristen Marie,0,8,25,25
1668560491193,CSE 290,C00,102414,Pannuto; Patrick William,0,1,25,25
1668560491193,CSE 290,D00,102427,Pevzner; Pavel Arkadjevich,0,0,0,0
1668560491193,CSE 290,E00,102429,Zhao; Jishen,0,6,0,0
1668560491193,CSE 290,F00,102436,Tullsen; Dean Michael,0,6,0,0
1668560491193,CSE 290,G00,102440,Christensen; Henrik I,0,7,20,20
1668560491618,CSE 291,A00,102443,Su; Hao,0,0,0,0
1668560491618,CSE 291,B00,102448,Polikarpova; Nadezhda,0,0,0,0
1668560491618,CSE 291,C00,102453,Vaccaro; Kristen Marie,0,0,0,0
1668560491618,CSE 291,D00,111343,Savage; Stefan,0,0,0,0
1668560491618,CSE 291,E00,116474,Claffy; Kimberly Claire,0,0,0,0
1668560491618,CSE 291,F00,116479,Pasquale; Joseph,0,0,0,0
1668560492072,CSE 293,001,119111,Bafna; Vineet,9999,0,9999,0
1668560492072,CSE 293,002,119118,Bellare; Mihir,9999,0,9999,0
1668560492072,CSE 293,003,119122,Berg-Kirkpatrick; Taylor D,9999,0,9999,0
1668560492072,CSE 293,004,119135,Christensen; Henrik I,9999,0,9999,0
1668560492072,CSE 293,005,119142,Cottrell; Garrison W,9999,0,9999,0
1668560492072,CSE 293,006,119146,Deutsch; Alin Bernard,9999,0,9999,0
1668560492072,CSE 293,007,119159,Esmaeilzadeh; Hadi,9999,0,9999,0
1668560492072,CSE 293,008,119166,Freund; Yoav,9999,0,9999,0
1668560492072,CSE 293,009,119170,Griswold; William G.,9999,0,9999,0
1668560492072,CSE 293,010,119183,Gymrek; Melissa Ann,9999,0,9999,0
1668560492072,CSE 293,011,119190,Heninger; Nadia A,9999,0,9999,0
1668560492072,CSE 293,012,119230,Impagliazzo; Russell,9999,0,9999,0
1668560492072,CSE 293,013,119232,Jhala; Ranjit,9999,0,9999,0
1668560492072,CSE 293,014,119233,Kahng; Andrew Byun,9999,0,9999,0
1668560492072,CSE 293,015,119298,Kane; Daniel Mertz,9999,0,9999,0
1668560492072,CSE 293,016,119299,Kriegman; David J,9999,0,9999,0
1668560492072,CSE 293,017,119300,Kumar; Arun Kumar,9999,0,9999,0
1668560492072,CSE 293,018,119301,Lerner; Sorin,9999,0,9999,0
1668560492072,CSE 293,019,119302,Lovett; Shachar,9999,0,9999,0
1668560492072,CSE 293,020,119303,McAuley; Julian John,9999,0,9999,0
1668560492072,CSE 293,021,119304,Micciancio; Daniele,9999,0,9999,0
1668560492072,CSE 293,022,119367,Orailoglu; Alex,9999,0,9999,0
1668560492072,CSE 293,023,119382,Paturi; Ramamohan,9999,0,9999,0
1668560492072,CSE 293,024,119404,Polikarpova; Nadezhda,9999,0,9999,0
1668560492072,CSE 293,025,119406,Politz; Joseph Gibbs,9999,0,9999,0
1668560492072,CSE 293,026,119411,Porter; George M,9999,0,9999,0
1668560492072,CSE 293,027,119414,Porter; Leonard Emerson,9999,0,9999,0
1668560492072,CSE 293,028,119416,Ramamoorthi; Ravi,9999,0,9999,0
1668560492072,CSE 293,029,119417,Sahoo; Debashis,9999,0,9999,0
1668560492072,CSE 293,030,119420,Saul; Lawrence,9999,0,9999,0
1668560492072,CSE 293,031,119421,Savage; Stefan,9999,0,9999,0
1668560492072,CSE 293,032,119425,Schulze; Jurgen P.,9999,0,9999,0
1668560492072,CSE 293,033,119426,Snoeren; Alex C.,9999,0,9999,0
1668560492072,CSE 293,034,119428,Shang; Jingbo,9999,0,9999,0
1668560492072,CSE 293,035,119430,Stefan; Deian,9999,0,9999,0
1668560492072,CSE 293,036,119431,Su; Hao,9999,0,9999,0
1668560492072,CSE 293,037,119433,Swanson; Steven James,9999,0,9999,0
1668560492072,CSE 293,038,119435,Tullsen; Dean Michael,9999,0,9999,0
1668560492072,CSE 293,039,119483,Voelker; Geoffrey M.,9999,0,9999,0
1668560492072,CSE 293,040,119537,Zhao; Jishen,9999,0,9999,0
1668560492072,CSE 293,041,119538,Zhou; Yuan-Yuan,9999,0,9999,0
1668560492072,CSE 293,042,119539,Gao; Sicun,9999,0,9999,0
1668560492072,CSE 293,043,119540,Weibel; Nadir,9999,0,9999,0
1668560492072,CSE 293,044,119541,Gupta; Rajesh K.,9999,0,9999,0
1668560492072,CSE 293,045,126410,Vaccaro; Kristen Marie,9999,0,9999,0
1668560492072,CSE 293,046,126411,Klemke; Richard,9999,0,9999,0
1668560492493,CSE 294,A00,102459,Voelker; Geoffrey M.,0,2,0,0
1668560492493,CSE 294,B00,111322,Orailoglu; Alex,0,2,0,0
1668560492919,DSE 201,A00,096914,Deutsch; Alin Bernard,30,0,30,0
1668560493342,DSE 210,A00,096915,Dasgupta; Sanjoy,30,0,30,0
1668560493768,DSE 260A,A00,096916,Altintas De Callaf; Ilkay,30,0,30,0
1668560494225,ECE 200,001,103586,Antipa; Nicholas A,9999,0,9999,0
1668560494225,ECE 200,002,103587,Atanasov; Nikolay A.,9999,0,9999,0
1668560494225,ECE 200,003,103588,Bharadia; Dinesh,9999,0,9999,0
1668560494225,ECE 200,004,103589,Cheng; Chung Kuan,9999,0,9999,0
1668560494225,ECE 200,005,103590,Cosman; Pamela C.,9999,0,9999,0
1668560494225,ECE 200,006,103591,Dayeh; Shadi Ahmad,9999,0,9999,0
1668560494225,ECE 200,007,103592,Fainman; Yeshaiahu,9999,0,9999,0
1668560494225,ECE 200,008,103593,Ford; Joseph Earl,9999,0,9999,0
1668560494225,ECE 200,009,103594,Franceschetti; Massimo,9999,0,9999,0
1668560494225,ECE 200,010,103595,Fullerton; Eric E,9999,0,9999,0
1668560494225,ECE 200,011,103596,Galton; Ian A,9999,0,9999,0
1668560494225,ECE 200,012,103597,Gilja; Vikash,9999,0,9999,0
1668560494225,ECE 200,013,103598,Hall; Drew A.,9999,0,9999,0
1668560494225,ECE 200,014,103599,Hsueh; Tzu-Chien,9999,0,9999,0
1668560494225,ECE 200,015,103600,Javidi; Tara,9999,0,9999,0
1668560494225,ECE 200,016,103601,Kahng; Andrew Byun,9999,0,9999,0
1668560494225,ECE 200,017,103602,Kim; Young-Han,9999,0,9999,0
1668560494225,ECE 200,018,103603,Koushanfar; Farinaz,9999,0,9999,0
1668560494225,ECE 200,019,103604,Kuzum; Duygu,9999,0,9999,0
1668560494225,ECE 200,020,103605,Le; Hanh-Phuc,9999,0,9999,0
1668560494225,ECE 200,021,103606,Lin; Bill,9999,0,9999,0
1668560494225,ECE 200,022,103607,Liu; Zhaowei,9998,0,9999,1
1668560494225,ECE 200,023,103608,Lo; Yu-Hwa,9999,0,9999,0
1668560494225,ECE 200,024,103609,Lomakin; Vitaliy,9999,0,9999,0
1668560494225,ECE 200,025,103610,Mercier; Patrick Philip,9999,0,9999,0
1668560494225,ECE 200,026,103611,Meyer; Florian,9999,0,9999,0
1668560494225,ECE 200,027,103612,Milstein; Laurence B.,9999,0,9999,0
1668560494225,ECE 200,028,103613,Mir Arabbaygi; Siavash,9999,0,9999,0
1668560494225,ECE 200,029,103614,Mookherjea; Shayan,9999,0,9999,0
1668560494225,ECE 200,030,103615,Morris; Karcher William,9999,0,9999,0
1668560494225,ECE 200,031,103616,Ng; Tse Nga,9999,0,9999,0
1668560494225,ECE 200,032,103617,Nguyen; Truong Quang,9999,0,9999,0
1668560494225,ECE 200,033,103618,Nomura; Kenji,9999,0,9999,0
1668560494225,ECE 200,034,103619,Orlitsky; Alon,9999,0,9999,0
1668560494225,ECE 200,035,103620,Pal; Piya,9999,0,9999,0
1668560494225,ECE 200,036,103621,Papen; George C.,9999,0,9999,0
1668560494225,ECE 200,037,103622,Radic; Stojan,9999,0,9999,0
1668560494225,ECE 200,038,103623,Rao; Bhaskar D.,9999,0,9999,0
1668560494225,ECE 200,039,103624,Rao; Ramesh R,9999,0,9999,0
1668560494225,ECE 200,040,103625,Rebeiz; Gabriel,9999,0,9999,0
1668560494225,ECE 200,041,103626,Sanford; John R,9999,0,9999,0
1668560494225,ECE 200,042,103627,Siegel; Paul H.,9999,0,9999,0
1668560494225,ECE 200,043,103628,Sievenpiper; Daniel F.,9999,0,9999,0
1668560494225,ECE 200,044,103629,Sworder; David D.,9999,0,9999,0
1668560494225,ECE 200,045,103630,Taur; Yuan,9999,0,9999,0
1668560494225,ECE 200,046,103631,Touri; Behrouz,9999,0,9999,0
1668560494225,ECE 200,047,103632,Trivedi; Mohan M.,9999,0,9999,0
1668560494225,ECE 200,048,103633,Vasconcelos; Nuno,9999,0,9999,0
1668560494225,ECE 200,049,103634,Wang; Xiaolong,9999,0,9999,0
1668560494225,ECE 200,050,103635,Xie; Pengtao,9999,0,9999,0
1668560494225,ECE 200,051,103636,Yip; Michael,9999,0,9999,0
1668560494225,ECE 200,052,103637,Zeger; Kenneth A.,999,0,999,0
1668560494225,ECE 200,053,103638,Zhang; Xinyu,9999,0,9999,0
1668560494225,ECE 200,054,103639,Turakhia; Yatish Girish,9999,0,9999,0
1668560494225,ECE 200,055,103640,Kang; Mingu,9999,0,9999,0
1668560494225,ECE 200,056,103641,Shi; Yuanyuan,9999,0,9999,0
1668560494225,ECE 200,057,103642,Wang; Edward Jay,9999,0,9999,0
1668560494225,ECE 200,058,103643,Zheng; Yang,9999,0,9999,0
1668560494648,ECE 202,A00,103644,Kuzum; Duygu,0,46,0,0
1668560495070,ECE 212BN,A00,103646,Ng; Tse Nga,0,9,0,0
1668560495495,ECE 221,A00,111493,Staff,0,0,0,0
1668560495917,ECE 222B,A00,103647,Lomakin; Vitaliy,0,21,0,0
1668560496353,ECE 230B,A00,103648,Taur; Yuan,0,4,0,0
1668560496790,ECE 238B,A00,103649,Garay; Javier,0,0,0,0
1668560497215,ECE 240B,A00,112900,Fainman; Yeshaiahu,0,8,0,0
1668560497639,ECE 247A,A00,103650,Jokerst; Jesse Vincent,0,6,0,0
1668560498062,ECE 247B,A00,103651,Wang; Joseph,0,14,0,0
1668560498498,ECE 250,A00,103652,Siegel; Paul H.,0,84,0,0
1668560498922,ECE 251A,A00,103654,Rao; Bhaskar D.,0,64,0,0
1668560499348,ECE 257B,A00,103655,Bharadia; Dinesh,0,33,0,0
1668560499770,ECE 258A,A00,103656,Milstein; Laurence B.,0,29,0,0
1668560500199,ECE 260B,A00,103658,Kang; Mingu,0,123,0,0
1668560500625,ECE 264A,A00,103659,Galton; Ian A,0,56,0,18
1668560501052,ECE 265A,A00,103661,Gudem; Prasad S.S.,0,56,0,19
1668560501479,ECE 265D,A00,103662,Gudem; Prasad S.S.,0,26,0,0
1668560501901,ECE 268,A00,103663,Koushanfar; Farinaz,0,44,0,0
1668560502324,ECE 269,A01,103665,Pal; Piya,0,222,0,0
1668560502746,ECE 271B,A00,103666,Vasconcelos; Manuela,0,78,0,0
1668560503187,ECE 276A,A00,103667,Atanasov; Nikolay A.,0,127,0,0
1668560503616,ECE 277,A00,103668,An; Cheolhong,0,151,0,0
1668560504042,ECE 279,A00,117947,Hall; Drew A.,0,22,0,0
1668560504909,ECE 283,A00,103670,Hsueh; Tzu-Chien,0,57,0,0
1668560505337,ECE 284,A00,103671,Turakhia; Yatish Girish,0,41,0,0
1668560505759,ECE 285,A00,103672,Zheng; Yang,0,41,0,0
1668560505759,ECE 285,B00,103673,Sworder; David D.,0,61,0,0
1668560506197,ECE 287,A00,103676,Javidi; Tara,0,8,0,0
1668560506632,MATH 200B,A00,098023,Salehi Golsefidy; Alireza,8,0,15,7
1668560507065,MATH 202B,A00,098024,Rhoades; Brendon Patrick,7,0,15,8
1668560507499,MATH 203B,A00,098025,Oprea; Dragos N.,9,0,15,6
1668560507921,MATH 204B,A00,098026,Sorensen; Claus M,13,0,15,2
1668560508343,MATH 208,A00,098027,Izadi; Elham,7,0,10,3
1668560508766,MATH 209,A00,098028,Pollack; Aaron,10,0,10,0
1668560509189,MATH 211A,A00,112919,Rogalski; Daniel,8,0,10,2
1668560509617,MATH 211B,A00,112920,Seward; Brandon M.,9,0,10,1
1668560510041,MATH 218,A00,098029,Li; Bo,10,0,10,0
1668560510478,MATH 220B,A00,098030,Novak; Jonathan I,10,0,15,5
1668560510901,MATH 221A,A00,098031,Ebenfelt; Peter F,12,0,15,3
1668560511328,MATH 231B,A00,098032,Zlatos; Andrej,9,0,15,6
1668560511751,MATH 240B,A00,098033,Ni; Lei,7,0,15,8
1668560512189,MATH 243,A00,098034,Jekel; David Andrew,10,0,10,0
1668560512619,MATH 245A,A00,098035,Nie; Jiawang,0,7,15,18
1668560513045,MATH 248,A00,098036,Bejenaru; Ioan,10,0,10,0
1668560513472,MATH 250B,A00,098037,Spolaor; Luca,13,0,15,2
1668560513896,MATH 258,A00,098038,Ni; Lei,8,0,10,2
1668560514319,MATH 264B,A00,098041,Rhoades; Brendon Patrick,7,0,15,8
1668560514824,MATH 268,A00,098042,Buss; Samuel R,10,0,10,0
1668560515250,MATH 269,A00,098043,Rhoades; Brendon Patrick,10,0,10,0
1668560515678,MATH 270B,A00,098044,Li; Bo,6,0,15,9
1668560516100,MATH 272B,A00,098045,Holst; Michael J,13,0,15,2
1668560516529,MATH 273A,A00,098046,Tian; Xiaochuan,10,0,15,5
1668560516959,MATH 275,A01,098048,Tian; Xiaochuan,6,0,10,4
1668560517396,MATH 278A,A00,098049,Holst; Michael J,6,0,10,4
1668560517829,MATH 278B,A00,098050,Cloninger; Alexander,10,0,10,0
1668560518266,MATH 278C,A00,098051,Nie; Jiawang,5,0,10,5
1668560518698,MATH 280B,A00,098052,Zheng; Tianyi,6,0,15,9
1668560519123,MATH 281B,A00,098053,Bradic; Jelena,0,2,15,15
1668560519555,MATH 282B,A00,098054,Arias-Castro; Ery,0,1,15,15
1668560519977,MATH 285,A00,098055,Fitzsimmons; Patrick J,0,4,15,17
1668560520402,MATH 287B,A00,098056,Arias-Castro; Ery,1,0,15,14
1668560520838,MATH 288,A00,098057,Agarwal; Pooja,9,0,10,1
1668560520838,MATH 288,B00,098058,Zhang; Danna,8,0,10,2
1668560520838,MATH 288,C00,098059,Williams; Ruth J,9,0,10,1
1668560521263,MATH 290B,A00,098060,Roberts; Justin Deritter,11,0,15,4
1668560521688,MATH 292,A00,098061,Belmont; Eva Kinoshita,10,0,10,0
1668560522111,MATH 295,A00,098062,Suk; Andrew Hoon,47,0,50,3
1668560522544,MATH 296,A00,098063,Novak; Jonathan I,20,0,20,0
1668560522970,MATH 297,001,098064,Gamst; Anthony Collins,9997,0,9999,2
1668561028476,COGS 205,A00,101395,Chiba; Andrea,19,0,20,1
1668561028902,COGS 210B,001,101404,Greene; Deanna Jacquelyn,9998,0,9999,1
1668561028902,COGS 210B,002,101417,Xia; Haijun,9999,0,9999,0
1668561028902,COGS 210B,003,101422,Nitz; Douglas A.,9999,0,9999,0
1668561028902,COGS 210B,004,101423,Hollan; James D.,9998,0,9999,1
1668561028902,COGS 210B,005,101424,Deak; Gedeon O.,9998,0,9999,1
1668561028902,COGS 210B,006,101425,Rossano; Federico,9999,0,9999,0
1668561029326,COGS 211B,A00,101427,Coulson; Seana M,9996,0,9999,3
1668561029749,COGS 220,A00,101428,Hollan; James D.,0,16,25,25
1668561030174,COGS 229,A00,101429,Dow; Steven P,17,0,25,8
1668561030608,COGS 230,A00,101430,Klemmer; Scott R,6,0,17,11
1668561031123,COGS 234,A00,101431,Xia; Haijun,0,1,25,25
1668561031547,COGS 260,A00,101432,Kiyonaga; Anastasia,21,0,25,4
1668561031547,COGS 260,B00,101433,Kirsh; David Joel,15,0,25,10
1668561031975,CSE 202,A00,102371,Impagliazzo; Russell,0,70,0,0
1668561032440,CSE 203B,A01,102373,Cheng; Chung Kuan,0,66,0,0
1668561032868,CSE 208,A00,102374,Micciancio; Daniele,0,5,0,0
1668561033307,CSE 209A,A00,112895,Impagliazzo; Russell,0,14,15,15
1668561033735,CSE 209B,A00,108005,Bellare; Mihir,0,7,0,0
1668561034165,CSE 210,A00,113163,Coblenz; Michael J,0,92,0,0
1668561034588,CSE 219,A00,106111,Dow; Steven P,0,8,20,20
1668561035013,CSE 221,A00,102376,Voelker; Geoffrey M.,0,76,0,0
1668561035438,CSE 224,A01,102378,Porter; George M,0,176,0,0
1668561035875,CSE 229A,A00,102379,Savage; Stefan,0,12,0,0
1668561036698,CSE 229C,A00,102380,Munyaka; Imani N. S.,0,10,0,0
1668561037129,CSE 232B,A00,102382,Deutsch; Alin Bernard,0,39,0,0
1668561037639,CSE 234,A01,112904,Kumar; Arun Kumar,0,0,0,0
1668561038099,CSE 237A,A00,102383,Rosing; Tajana Simunic,0,57,0,0
1668561038534,CSE 239A,A00,102384,Deutsch; Alin Bernard,0,16,0,0
1668561038960,CSE 239B,A00,102385,Polikarpova; Nadezhda,0,11,0,0
1668561039474,CSE 240A,A00,102386,Pannuto; Patrick William,0,48,0,0
1668561039902,CSE 240B,A00,102387,Zhao; Jishen,0,51,0,0
1668561040325,CSE 241A,A00,106406,Kang; Mingu,0,9,0,0
1668561040759,CSE 249B,A00,102388,Kahng; Andrew Byun,0,5,8,8
1668561041198,CSE 251B,A01,102392,Cottrell; Garrison W,0,53,0,0
1668561041198,CSE 251B,A02,102393,Cottrell; Garrison W,0,35,0,0
1668561041646,CSE 252B,A00,102394,Ochoa; Benjamin Lawrence,0,64,0,0
1668561042085,CSE 257,A01,102396,Gao; Sicun,0,155,0,0
1668561042511,CSE 272,A00,102397,Li; Tzumao,0,22,0,0
1668561042944,CSE 274,A00,111323,Chern; Albert Ren-Haur,0,16,0,0
1668561043383,CSE 282,A00,102398,Pevzner; Pavel Arkadjevich,0,0,0,0
1668561043818,CSE 284,A00,114175,Gymrek; Melissa Ann,0,30,0,0
1668561044252,CSE 290,A00,102399,Chandraker; Manmohan Krishna,0,11,0,0
1668561044252,CSE 290,B00,102400,Vaccaro; Kristen Marie,0,8,25,25
1668561044252,CSE 290,C00,102414,Pannuto; Patrick William,0,1,25,25
1668561044252,CSE 290,D00,102427,Pevzner; Pavel Arkadjevich,0,0,0,0
1668561044252,CSE 290,E00,102429,Zhao; Jishen,0,6,0,0
1668561044252,CSE 290,F00,102436,Tullsen; Dean Michael,0,6,0,0
1668561044252,CSE 290,G00,102440,Christensen; Henrik I,0,7,20,20
1668561044679,CSE 291,A00,102443,Su; Hao,0,0,0,0
1668561044679,CSE 291,B00,102448,Polikarpova; Nadezhda,0,0,0,0
1668561044679,CSE 291,C00,102453,Vaccaro; Kristen Marie,0,0,0,0
1668561044679,CSE 291,D00,111343,Savage; Stefan,0,0,0,0
1668561044679,CSE 291,E00,116474,Claffy; Kimberly Claire,0,0,0,0
1668561044679,CSE 291,F00,116479,Pasquale; Joseph,0,0,0,0
1668561045137,CSE 293,001,119111,Bafna; Vineet,9999,0,9999,0
1668561045137,CSE 293,002,119118,Bellare; Mihir,9999,0,9999,0
1668561045137,CSE 293,003,119122,Berg-Kirkpatrick; Taylor D,9999,0,9999,0
1668561045137,CSE 293,004,119135,Christensen; Henrik I,9999,0,9999,0
1668561045137,CSE 293,005,119142,Cottrell; Garrison W,9999,0,9999,0
1668561045137,CSE 293,006,119146,Deutsch; Alin Bernard,9999,0,9999,0
1668561045137,CSE 293,007,119159,Esmaeilzadeh; Hadi,9999,0,9999,0
1668561045137,CSE 293,008,119166,Freund; Yoav,9999,0,9999,0
1668561045137,CSE 293,009,119170,Griswold; William G.,9999,0,9999,0
1668561045137,CSE 293,010,119183,Gymrek; Melissa Ann,9999,0,9999,0
1668561045137,CSE 293,011,119190,Heninger; Nadia A,9999,0,9999,0
1668561045137,CSE 293,012,119230,Impagliazzo; Russell,9999,0,9999,0
1668561045137,CSE 293,013,119232,Jhala; Ranjit,9999,0,9999,0
1668561045137,CSE 293,014,119233,Kahng; Andrew Byun,9999,0,9999,0
1668561045137,CSE 293,015,119298,Kane; Daniel Mertz,9999,0,9999,0
1668561045137,CSE 293,016,119299,Kriegman; David J,9999,0,9999,0
1668561045137,CSE 293,017,119300,Kumar; Arun Kumar,9999,0,9999,0
1668561045137,CSE 293,018,119301,Lerner; Sorin,9999,0,9999,0
1668561045137,CSE 293,019,119302,Lovett; Shachar,9999,0,9999,0
1668561045137,CSE 293,020,119303,McAuley; Julian John,9999,0,9999,0
1668561045137,CSE 293,021,119304,Micciancio; Daniele,9999,0,9999,0
1668561045137,CSE 293,022,119367,Orailoglu; Alex,9999,0,9999,0
1668561045137,CSE 293,023,119382,Paturi; Ramamohan,9999,0,9999,0
1668561045137,CSE 293,024,119404,Polikarpova; Nadezhda,9999,0,9999,0
1668561045137,CSE 293,025,119406,Politz; Joseph Gibbs,9999,0,9999,0
1668561045137,CSE 293,026,119411,Porter; George M,9999,0,9999,0
1668561045137,CSE 293,027,119414,Porter; Leonard Emerson,9999,0,9999,0
1668561045137,CSE 293,028,119416,Ramamoorthi; Ravi,9999,0,9999,0
1668561045137,CSE 293,029,119417,Sahoo; Debashis,9999,0,9999,0
1668561045137,CSE 293,030,119420,Saul; Lawrence,9999,0,9999,0
1668561045137,CSE 293,031,119421,Savage; Stefan,9999,0,9999,0
1668561045137,CSE 293,032,119425,Schulze; Jurgen P.,9999,0,9999,0
1668561045137,CSE 293,033,119426,Snoeren; Alex C.,9999,0,9999,0
1668561045137,CSE 293,034,119428,Shang; Jingbo,9999,0,9999,0
1668561045137,CSE 293,035,119430,Stefan; Deian,9999,0,9999,0
1668561045137,CSE 293,036,119431,Su; Hao,9999,0,9999,0
1668561045137,CSE 293,037,119433,Swanson; Steven James,9999,0,9999,0
1668561045137,CSE 293,038,119435,Tullsen; Dean Michael,9999,0,9999,0
1668561045137,CSE 293,039,119483,Voelker; Geoffrey M.,9999,0,9999,0
1668561045137,CSE 293,040,119537,Zhao; Jishen,9999,0,9999,0
1668561045137,CSE 293,041,119538,Zhou; Yuan-Yuan,9999,0,9999,0
1668561045137,CSE 293,042,119539,Gao; Sicun,9999,0,9999,0
1668561045137,CSE 293,043,119540,Weibel; Nadir,9999,0,9999,0
1668561045137,CSE 293,044,119541,Gupta; Rajesh K.,9999,0,9999,0
1668561045137,CSE 293,045,126410,Vaccaro; Kristen Marie,9999,0,9999,0
1668561045137,CSE 293,046,126411,Klemke; Richard,9999,0,9999,0
1668561045608,CSE 294,A00,102459,Voelker; Geoffrey M.,0,2,0,0
1668561045608,CSE 294,B00,111322,Orailoglu; Alex,0,2,0,0
1668561046043,DSE 201,A00,096914,Deutsch; Alin Bernard,30,0,30,0
1668561046466,DSE 210,A00,096915,Dasgupta; Sanjoy,30,0,30,0
1668561046892,DSE 260A,A00,096916,Altintas De Callaf; Ilkay,30,0,30,0
1668561047335,ECE 200,001,103586,Antipa; Nicholas A,9999,0,9999,0
1668561047335,ECE 200,002,103587,Atanasov; Nikolay A.,9999,0,9999,0
1668561047335,ECE 200,003,103588,Bharadia; Dinesh,9999,0,9999,0
1668561047335,ECE 200,004,103589,Cheng; Chung Kuan,9999,0,9999,0
1668561047335,ECE 200,005,103590,Cosman; Pamela C.,9999,0,9999,0
1668561047335,ECE 200,006,103591,Dayeh; Shadi Ahmad,9999,0,9999,0
1668561047335,ECE 200,007,103592,Fainman; Yeshaiahu,9999,0,9999,0
1668561047335,ECE 200,008,103593,Ford; Joseph Earl,9999,0,9999,0
1668561047335,ECE 200,009,103594,Franceschetti; Massimo,9999,0,9999,0
1668561047335,ECE 200,010,103595,Fullerton; Eric E,9999,0,9999,0
1668561047335,ECE 200,011,103596,Galton; Ian A,9999,0,9999,0
1668561047335,ECE 200,012,103597,Gilja; Vikash,9999,0,9999,0
1668561047335,ECE 200,013,103598,Hall; Drew A.,9999,0,9999,0
1668561047335,ECE 200,014,103599,Hsueh; Tzu-Chien,9999,0,9999,0
1668561047335,ECE 200,015,103600,Javidi; Tara,9999,0,9999,0
1668561047335,ECE 200,016,103601,Kahng; Andrew Byun,9999,0,9999,0
1668561047335,ECE 200,017,103602,Kim; Young-Han,9999,0,9999,0
1668561047335,ECE 200,018,103603,Koushanfar; Farinaz,9999,0,9999,0
1668561047335,ECE 200,019,103604,Kuzum; Duygu,9999,0,9999,0
1668561047335,ECE 200,020,103605,Le; Hanh-Phuc,9999,0,9999,0
1668561047335,ECE 200,021,103606,Lin; Bill,9999,0,9999,0
1668561047335,ECE 200,022,103607,Liu; Zhaowei,9998,0,9999,1
1668561047335,ECE 200,023,103608,Lo; Yu-Hwa,9999,0,9999,0
1668561047335,ECE 200,024,103609,Lomakin; Vitaliy,9999,0,9999,0
1668561047335,ECE 200,025,103610,Mercier; Patrick Philip,9999,0,9999,0
1668561047335,ECE 200,026,103611,Meyer; Florian,9999,0,9999,0
1668561047335,ECE 200,027,103612,Milstein; Laurence B.,9999,0,9999,0
1668561047335,ECE 200,028,103613,Mir Arabbaygi; Siavash,9999,0,9999,0
1668561047335,ECE 200,029,103614,Mookherjea; Shayan,9999,0,9999,0
1668561047335,ECE 200,030,103615,Morris; Karcher William,9999,0,9999,0
1668561047335,ECE 200,031,103616,Ng; Tse Nga,9999,0,9999,0
1668561047335,ECE 200,032,103617,Nguyen; Truong Quang,9999,0,9999,0
1668561047335,ECE 200,033,103618,Nomura; Kenji,9999,0,9999,0
1668561047335,ECE 200,034,103619,Orlitsky; Alon,9999,0,9999,0
1668561047335,ECE 200,035,103620,Pal; Piya,9999,0,9999,0
1668561047335,ECE 200,036,103621,Papen; George C.,9999,0,9999,0
1668561047335,ECE 200,037,103622,Radic; Stojan,9999,0,9999,0
1668561047335,ECE 200,038,103623,Rao; Bhaskar D.,9999,0,9999,0
1668561047335,ECE 200,039,103624,Rao; Ramesh R,9999,0,9999,0
1668561047335,ECE 200,040,103625,Rebeiz; Gabriel,9999,0,9999,0
1668561047335,ECE 200,041,103626,Sanford; John R,9999,0,9999,0
1668561047335,ECE 200,042,103627,Siegel; Paul H.,9999,0,9999,0
1668561047335,ECE 200,043,103628,Sievenpiper; Daniel F.,9999,0,9999,0
1668561047335,ECE 200,044,103629,Sworder; David D.,9999,0,9999,0
1668561047335,ECE 200,045,103630,Taur; Yuan,9999,0,9999,0
1668561047335,ECE 200,046,103631,Touri; Behrouz,9999,0,9999,0
1668561047335,ECE 200,047,103632,Trivedi; Mohan M.,9999,0,9999,0
1668561047335,ECE 200,048,103633,Vasconcelos; Nuno,9999,0,9999,0
1668561047335,ECE 200,049,103634,Wang; Xiaolong,9999,0,9999,0
1668561047335,ECE 200,050,103635,Xie; Pengtao,9999,0,9999,0
1668561047335,ECE 200,051,103636,Yip; Michael,9999,0,9999,0
1668561047335,ECE 200,052,103637,Zeger; Kenneth A.,999,0,999,0
1668561047335,ECE 200,053,103638,Zhang; Xinyu,9999,0,9999,0
1668561047335,ECE 200,054,103639,Turakhia; Yatish Girish,9999,0,9999,0
1668561047335,ECE 200,055,103640,Kang; Mingu,9999,0,9999,0
1668561047335,ECE 200,056,103641,Shi; Yuanyuan,9999,0,9999,0
1668561047335,ECE 200,057,103642,Wang; Edward Jay,9999,0,9999,0
1668561047335,ECE 200,058,103643,Zheng; Yang,9999,0,9999,0
1668561047760,ECE 202,A00,103644,Kuzum; Duygu,0,46,0,0
1668561048188,ECE 212BN,A00,103646,Ng; Tse Nga,0,9,0,0
1668561048613,ECE 221,A00,111493,Staff,0,0,0,0
1668561049039,ECE 222B,A00,103647,Lomakin; Vitaliy,0,21,0,0
1668561049463,ECE 230B,A00,103648,Taur; Yuan,0,4,0,0
1668561049892,ECE 238B,A00,103649,Garay; Javier,0,0,0,0
1668561050315,ECE 240B,A00,112900,Fainman; Yeshaiahu,0,8,0,0
1668561050739,ECE 247A,A00,103650,Jokerst; Jesse Vincent,0,6,0,0
1668561051172,ECE 247B,A00,103651,Wang; Joseph,0,14,0,0
1668561051609,ECE 250,A00,103652,Siegel; Paul H.,0,85,0,0
1668561052046,ECE 251A,A00,103654,Rao; Bhaskar D.,0,64,0,0
1668561052469,ECE 257B,A00,103655,Bharadia; Dinesh,0,33,0,0
1668561052896,ECE 258A,A00,103656,Milstein; Laurence B.,0,29,0,0
1668561053326,ECE 260B,A00,103658,Kang; Mingu,0,123,0,0
1668561053756,ECE 264A,A00,103659,Galton; Ian A,0,52,0,22
1668561054181,ECE 265A,A00,103661,Gudem; Prasad S.S.,0,53,0,22
1668561054622,ECE 265D,A00,103662,Gudem; Prasad S.S.,0,27,0,0
1668561055053,ECE 268,A00,103663,Koushanfar; Farinaz,0,44,0,0
1668561055485,ECE 269,A01,103665,Pal; Piya,0,222,0,0
1668561055909,ECE 271B,A00,103666,Vasconcelos; Manuela,0,78,0,0
1668561056337,ECE 276A,A00,103667,Atanasov; Nikolay A.,0,127,0,0
1668561056765,ECE 277,A00,103668,An; Cheolhong,0,151,0,0
1668561057195,ECE 279,A00,117947,Hall; Drew A.,0,22,0,0
1668561058044,ECE 283,A00,103670,Hsueh; Tzu-Chien,0,57,0,0
1668561058479,ECE 284,A00,103671,Turakhia; Yatish Girish,0,41,0,0
1668561058908,ECE 285,A00,103672,Zheng; Yang,0,41,0,0
1668561058908,ECE 285,B00,103673,Sworder; David D.,0,61,0,0
1668561059331,ECE 287,A00,103676,Javidi; Tara,0,8,0,0
1668561059755,MATH 200B,A00,098023,Salehi Golsefidy; Alireza,8,0,15,7
1668561060180,MATH 202B,A00,098024,Rhoades; Brendon Patrick,7,0,15,8
1668561060603,MATH 203B,A00,098025,Oprea; Dragos N.,9,0,15,6
1668561061026,MATH 204B,A00,098026,Sorensen; Claus M,13,0,15,2
1668561061458,MATH 208,A00,098027,Izadi; Elham,7,0,10,3
1668561061894,MATH 209,A00,098028,Pollack; Aaron,10,0,10,0
1668561062323,MATH 211A,A00,112919,Rogalski; Daniel,8,0,10,2
1668561062757,MATH 211B,A00,112920,Seward; Brandon M.,9,0,10,1
1668561063183,MATH 218,A00,098029,Li; Bo,10,0,10,0
1668561063618,MATH 220B,A00,098030,Novak; Jonathan I,10,0,15,5
1668561064047,MATH 221A,A00,098031,Ebenfelt; Peter F,12,0,15,3
1668561064478,MATH 231B,A00,098032,Zlatos; Andrej,9,0,15,6
1668561064905,MATH 240B,A00,098033,Ni; Lei,7,0,15,8
1668561065330,MATH 243,A00,098034,Jekel; David Andrew,10,0,10,0
1668561065752,MATH 245A,A00,098035,Nie; Jiawang,0,7,15,18
1668561066194,MATH 248,A00,098036,Bejenaru; Ioan,10,0,10,0
1668561066618,MATH 250B,A00,098037,Spolaor; Luca,13,0,15,2
1668561067042,MATH 258,A00,098038,Ni; Lei,8,0,10,2
1668561067468,MATH 264B,A00,098041,Rhoades; Brendon Patrick,7,0,15,8
1668561067898,MATH 268,A00,098042,Buss; Samuel R,10,0,10,0
1668561068320,MATH 269,A00,098043,Rhoades; Brendon Patrick,10,0,10,0
1668561068755,MATH 270B,A00,098044,Li; Bo,6,0,15,9
1668561069196,MATH 272B,A00,098045,Holst; Michael J,13,0,15,2
1668561069619,MATH 273A,A00,098046,Tian; Xiaochuan,10,0,15,5
1668561070042,MATH 275,A01,098048,Tian; Xiaochuan,6,0,10,4
1668561070467,MATH 278A,A00,098049,Holst; Michael J,6,0,10,4
1668561070894,MATH 278B,A00,098050,Cloninger; Alexander,10,0,10,0
1668561071320,MATH 278C,A00,098051,Nie; Jiawang,5,0,10,5
1668561071742,MATH 280B,A00,098052,Zheng; Tianyi,6,0,15,9
1668561072169,MATH 281B,A00,098053,Bradic; Jelena,0,2,15,15
1668561072606,MATH 282B,A00,098054,Arias-Castro; Ery,0,1,15,15
1668561073039,MATH 285,A00,098055,Fitzsimmons; Patrick J,0,4,15,17
1668561073464,MATH 287B,A00,098056,Arias-Castro; Ery,1,0,15,14
1668561073887,MATH 288,A00,098057,Agarwal; Pooja,9,0,10,1
1668561073887,MATH 288,B00,098058,Zhang; Danna,8,0,10,2
1668561073887,MATH 288,C00,098059,Williams; Ruth J,9,0,10,1
1668561074315,MATH 290B,A00,098060,Roberts; Justin Deritter,11,0,15,4
1668561074739,MATH 292,A00,098061,Belmont; Eva Kinoshita,10,0,10,0
1668561075160,MATH 295,A00,098062,Suk; Andrew Hoon,47,0,50,3
1668561075582,MATH 296,A00,098063,Novak; Jonathan I,20,0,20,0
1668561076004,MATH 297,001,098064,Gamst; Anthony Collins,9997,0,9999,2
1668561580328,COGS 205,A00,101395,Chiba; Andrea,19,0,20,1
1668561580757,COGS 210B,001,101404,Greene; Deanna Jacquelyn,9998,0,9999,1
1668561580757,COGS 210B,002,101417,Xia; Haijun,9999,0,9999,0
1668561580757,COGS 210B,003,101422,Nitz; Douglas A.,9999,0,9999,0
1668561580757,COGS 210B,004,101423,Hollan; James D.,9998,0,9999,1
1668561580757,COGS 210B,005,101424,Deak; Gedeon O.,9998,0,9999,1
1668561580757,COGS 210B,006,101425,Rossano; Federico,9999,0,9999,0
1668561581193,COGS 211B,A00,101427,Coulson; Seana M,9996,0,9999,3
1668561581618,COGS 220,A00,101428,Hollan; James D.,0,17,25,25
1668561582043,COGS 229,A00,101429,Dow; Steven P,17,0,25,8
1668561582465,COGS 230,A00,101430,Klemmer; Scott R,6,0,17,11
1668561582896,COGS 234,A00,101431,Xia; Haijun,0,1,25,25
1668561583320,COGS 260,A00,101432,Kiyonaga; Anastasia,21,0,25,4
1668561583320,COGS 260,B00,101433,Kirsh; David Joel,15,0,25,10
1668561583753,CSE 202,A00,102371,Impagliazzo; Russell,0,70,0,0
1668561584175,CSE 203B,A01,102373,Cheng; Chung Kuan,0,66,0,0
1668561584601,CSE 208,A00,102374,Micciancio; Daniele,0,5,0,0
1668561585026,CSE 209A,A00,112895,Impagliazzo; Russell,0,14,15,15
1668561585453,CSE 209B,A00,108005,Bellare; Mihir,0,7,0,0
1668561585875,CSE 210,A00,113163,Coblenz; Michael J,0,92,0,0
1668561586308,CSE 219,A00,106111,Dow; Steven P,0,8,20,20
1668561586742,CSE 221,A00,102376,Voelker; Geoffrey M.,0,76,0,0
1668561587168,CSE 224,A01,102378,Porter; George M,0,176,0,0
1668561587605,CSE 229A,A00,102379,Savage; Stefan,0,12,0,0
1668561588027,CSE 229C,A00,102380,Munyaka; Imani N. S.,0,10,0,0
1668561588458,CSE 232B,A00,102382,Deutsch; Alin Bernard,0,39,0,0
1668561588884,CSE 234,A01,112904,Kumar; Arun Kumar,0,0,0,0
1668561589310,CSE 237A,A00,102383,Rosing; Tajana Simunic,0,57,0,0
1668561589736,CSE 239A,A00,102384,Deutsch; Alin Bernard,0,16,0,0
1668561590161,CSE 239B,A00,102385,Polikarpova; Nadezhda,0,11,0,0
1668561590590,CSE 240A,A00,102386,Pannuto; Patrick William,0,48,0,0
1668561591014,CSE 240B,A00,102387,Zhao; Jishen,0,51,0,0
1668561591448,CSE 241A,A00,106406,Kang; Mingu,0,9,0,0
1668561591869,CSE 249B,A00,102388,Kahng; Andrew Byun,0,5,8,8
1668561592296,CSE 251B,A01,102392,Cottrell; Garrison W,0,53,0,0
1668561592296,CSE 251B,A02,102393,Cottrell; Garrison W,0,35,0,0
1668561592735,CSE 252B,A00,102394,Ochoa; Benjamin Lawrence,0,64,0,0
1668561593161,CSE 257,A01,102396,Gao; Sicun,0,155,0,0
1668561593593,CSE 272,A00,102397,Li; Tzumao,0,22,0,0
1668561594019,CSE 274,A00,111323,Chern; Albert Ren-Haur,0,16,0,0
1668561594447,CSE 282,A00,102398,Pevzner; Pavel Arkadjevich,0,0,0,0
1668561594884,CSE 284,A00,114175,Gymrek; Melissa Ann,0,30,0,0
1668561595318,CSE 290,A00,102399,Chandraker; Manmohan Krishna,0,11,0,0
1668561595318,CSE 290,B00,102400,Vaccaro; Kristen Marie,0,8,25,25
1668561595318,CSE 290,C00,102414,Pannuto; Patrick William,0,1,25,25
1668561595318,CSE 290,D00,102427,Pevzner; Pavel Arkadjevich,0,0,0,0
1668561595318,CSE 290,E00,102429,Zhao; Jishen,0,6,0,0
1668561595318,CSE 290,F00,102436,Tullsen; Dean Michael,0,6,0,0
1668561595318,CSE 290,G00,102440,Christensen; Henrik I,0,7,20,20
1668561595741,CSE 291,A00,102443,Su; Hao,0,0,0,0
1668561595741,CSE 291,B00,102448,Polikarpova; Nadezhda,0,0,0,0
1668561595741,CSE 291,C00,102453,Vaccaro; Kristen Marie,0,0,0,0
1668561595741,CSE 291,D00,111343,Savage; Stefan,0,0,0,0
1668561595741,CSE 291,E00,116474,Claffy; Kimberly Claire,0,0,0,0
1668561595741,CSE 291,F00,116479,Pasquale; Joseph,0,0,0,0
1668561596167,CSE 293,001,119111,Bafna; Vineet,9999,0,9999,0
1668561596167,CSE 293,002,119118,Bellare; Mihir,9999,0,9999,0
1668561596167,CSE 293,003,119122,Berg-Kirkpatrick; Taylor D,9999,0,9999,0
1668561596167,CSE 293,004,119135,Christensen; Henrik I,9999,0,9999,0
1668561596167,CSE 293,005,119142,Cottrell; Garrison W,9999,0,9999,0
1668561596167,CSE 293,006,119146,Deutsch; Alin Bernard,9999,0,9999,0
1668561596167,CSE 293,007,119159,Esmaeilzadeh; Hadi,9999,0,9999,0
1668561596167,CSE 293,008,119166,Freund; Yoav,9999,0,9999,0
1668561596167,CSE 293,009,119170,Griswold; William G.,9999,0,9999,0
1668561596167,CSE 293,010,119183,Gymrek; Melissa Ann,9999,0,9999,0
1668561596167,CSE 293,011,119190,Heninger; Nadia A,9999,0,9999,0
1668561596167,CSE 293,012,119230,Impagliazzo; Russell,9999,0,9999,0
1668561596167,CSE 293,013,119232,Jhala; Ranjit,9999,0,9999,0
1668561596167,CSE 293,014,119233,Kahng; Andrew Byun,9999,0,9999,0
1668561596167,CSE 293,015,119298,Kane; Daniel Mertz,9999,0,9999,0
1668561596167,CSE 293,016,119299,Kriegman; David J,9999,0,9999,0
1668561596167,CSE 293,017,119300,Kumar; Arun Kumar,9999,0,9999,0
1668561596167,CSE 293,018,119301,Lerner; Sorin,9999,0,9999,0
1668561596167,CSE 293,019,119302,Lovett; Shachar,9999,0,9999,0
1668561596167,CSE 293,020,119303,McAuley; Julian John,9999,0,9999,0
1668561596167,CSE 293,021,119304,Micciancio; Daniele,9999,0,9999,0
1668561596167,CSE 293,022,119367,Orailoglu; Alex,9999,0,9999,0
1668561596167,CSE 293,023,119382,Paturi; Ramamohan,9999,0,9999,0
1668561596167,CSE 293,024,119404,Polikarpova; Nadezhda,9999,0,9999,0
1668561596167,CSE 293,025,119406,Politz; Joseph Gibbs,9999,0,9999,0
1668561596167,CSE 293,026,119411,Porter; George M,9999,0,9999,0
1668561596167,CSE 293,027,119414,Porter; Leonard Emerson,9999,0,9999,0
1668561596167,CSE 293,028,119416,Ramamoorthi; Ravi,9999,0,9999,0
1668561596167,CSE 293,029,119417,Sahoo; Debashis,9999,0,9999,0
1668561596167,CSE 293,030,119420,Saul; Lawrence,9999,0,9999,0
1668561596167,CSE 293,031,119421,Savage; Stefan,9999,0,9999,0
1668561596167,CSE 293,032,119425,Schulze; Jurgen P.,9999,0,9999,0
1668561596167,CSE 293,033,119426,Snoeren; Alex C.,9999,0,9999,0
1668561596167,CSE 293,034,119428,Shang; Jingbo,9999,0,9999,0
1668561596167,CSE 293,035,119430,Stefan; Deian,9999,0,9999,0
1668561596167,CSE 293,036,119431,Su; Hao,9999,0,9999,0
1668561596167,CSE 293,037,119433,Swanson; Steven James,9999,0,9999,0
1668561596167,CSE 293,038,119435,Tullsen; Dean Michael,9999,0,9999,0
1668561596167,CSE 293,039,119483,Voelker; Geoffrey M.,9999,0,9999,0
1668561596167,CSE 293,040,119537,Zhao; Jishen,9999,0,9999,0
1668561596167,CSE 293,041,119538,Zhou; Yuan-Yuan,9999,0,9999,0
1668561596167,CSE 293,042,119539,Gao; Sicun,9999,0,9999,0
1668561596167,CSE 293,043,119540,Weibel; Nadir,9999,0,9999,0
1668561596167,CSE 293,044,119541,Gupta; Rajesh K.,9999,0,9999,0
1668561596167,CSE 293,045,126410,Vaccaro; Kristen Marie,9999,0,9999,0
1668561596167,CSE 293,046,126411,Klemke; Richard,9999,0,9999,0
1668561596596,CSE 294,A00,102459,Voelker; Geoffrey M.,0,2,0,0
1668561596596,CSE 294,B00,111322,Orailoglu; Alex,0,2,0,0
1668561597019,DSE 201,A00,096914,Deutsch; Alin Bernard,30,0,30,0
1668561597443,DSE 210,A00,096915,Dasgupta; Sanjoy,30,0,30,0
1668561597875,DSE 260A,A00,096916,Altintas De Callaf; Ilkay,30,0,30,0
1668561598311,ECE 200,001,103586,Antipa; Nicholas A,9999,0,9999,0
1668561598311,ECE 200,002,103587,Atanasov; Nikolay A.,9999,0,9999,0
1668561598311,ECE 200,003,103588,Bharadia; Dinesh,9999,0,9999,0
1668561598311,ECE 200,004,103589,Cheng; Chung Kuan,9999,0,9999,0
1668561598311,ECE 200,005,103590,Cosman; Pamela C.,9999,0,9999,0
1668561598311,ECE 200,006,103591,Dayeh; Shadi Ahmad,9999,0,9999,0
1668561598311,ECE 200,007,103592,Fainman; Yeshaiahu,9999,0,9999,0
1668561598311,ECE 200,008,103593,Ford; Joseph Earl,9999,0,9999,0
1668561598311,ECE 200,009,103594,Franceschetti; Massimo,9999,0,9999,0
1668561598311,ECE 200,010,103595,Fullerton; Eric E,9999,0,9999,0
1668561598311,ECE 200,011,103596,Galton; Ian A,9999,0,9999,0
1668561598311,ECE 200,012,103597,Gilja; Vikash,9999,0,9999,0
1668561598311,ECE 200,013,103598,Hall; Drew A.,9999,0,9999,0
1668561598311,ECE 200,014,103599,Hsueh; Tzu-Chien,9999,0,9999,0
1668561598311,ECE 200,015,103600,Javidi; Tara,9999,0,9999,0
1668561598311,ECE 200,016,103601,Kahng; Andrew Byun,9999,0,9999,0
1668561598311,ECE 200,017,103602,Kim; Young-Han,9999,0,9999,0
1668561598311,ECE 200,018,103603,Koushanfar; Farinaz,9999,0,9999,0
1668561598311,ECE 200,019,103604,Kuzum; Duygu,9999,0,9999,0
1668561598311,ECE 200,020,103605,Le; Hanh-Phuc,9999,0,9999,0
1668561598311,ECE 200,021,103606,Lin; Bill,9999,0,9999,0
1668561598311,ECE 200,022,103607,Liu; Zhaowei,9998,0,9999,1
1668561598311,ECE 200,023,103608,Lo; Yu-Hwa,9999,0,9999,0
1668561598311,ECE 200,024,103609,Lomakin; Vitaliy,9999,0,9999,0
1668561598311,ECE 200,025,103610,Mercier; Patrick Philip,9999,0,9999,0
1668561598311,ECE 200,026,103611,Meyer; Florian,9999,0,9999,0
1668561598311,ECE 200,027,103612,Milstein; Laurence B.,9999,0,9999,0
1668561598311,ECE 200,028,103613,Mir Arabbaygi; Siavash,9999,0,9999,0
1668561598311,ECE 200,029,103614,Mookherjea; Shayan,9999,0,9999,0
1668561598311,ECE 200,030,103615,Morris; Karcher William,9999,0,9999,0
1668561598311,ECE 200,031,103616,Ng; Tse Nga,9999,0,9999,0
1668561598311,ECE 200,032,103617,Nguyen; Truong Quang,9999,0,9999,0
1668561598311,ECE 200,033,103618,Nomura; Kenji,9999,0,9999,0
1668561598311,ECE 200,034,103619,Orlitsky; Alon,9999,0,9999,0
1668561598311,ECE 200,035,103620,Pal; Piya,9999,0,9999,0
1668561598311,ECE 200,036,103621,Papen; George C.,9999,0,9999,0
1668561598311,ECE 200,037,103622,Radic; Stojan,9999,0,9999,0
1668561598311,ECE 200,038,103623,Rao; Bhaskar D.,9999,0,9999,0
1668561598311,ECE 200,039,103624,Rao; Ramesh R,9999,0,9999,0
1668561598311,ECE 200,040,103625,Rebeiz; Gabriel,9999,0,9999,0
1668561598311,ECE 200,041,103626,Sanford; John R,9999,0,9999,0
1668561598311,ECE 200,042,103627,Siegel; Paul H.,9999,0,9999,0
1668561598311,ECE 200,043,103628,Sievenpiper; Daniel F.,9999,0,9999,0
1668561598311,ECE 200,044,103629,Sworder; David D.,9999,0,9999,0
1668561598311,ECE 200,045,103630,Taur; Yuan,9999,0,9999,0
1668561598311,ECE 200,046,103631,Touri; Behrouz,9999,0,9999,0
1668561598311,ECE 200,047,103632,Trivedi; Mohan M.,9999,0,9999,0
1668561598311,ECE 200,048,103633,Vasconcelos; Nuno,9999,0,9999,0
1668561598311,ECE 200,049,103634,Wang; Xiaolong,9999,0,9999,0
1668561598311,ECE 200,050,103635,Xie; Pengtao,9999,0,9999,0
1668561598311,ECE 200,051,103636,Yip; Michael,9999,0,9999,0
1668561598311,ECE 200,052,103637,Zeger; Kenneth A.,999,0,999,0
1668561598311,ECE 200,053,103638,Zhang; Xinyu,9999,0,9999,0
1668561598311,ECE 200,054,103639,Turakhia; Yatish Girish,9999,0,9999,0
1668561598311,ECE 200,055,103640,Kang; Mingu,9999,0,9999,0
1668561598311,ECE 200,056,103641,Shi; Yuanyuan,9999,0,9999,0
1668561598311,ECE 200,057,103642,Wang; Edward Jay,9999,0,9999,0
1668561598311,ECE 200,058,103643,Zheng; Yang,9999,0,9999,0
1668561598736,ECE 202,A00,103644,Kuzum; Duygu,0,46,0,0
1668561599175,ECE 212BN,A00,103646,Ng; Tse Nga,0,9,0,0
1668561599600,ECE 221,A00,111493,Staff,0,0,0,0
1668561600027,ECE 222B,A00,103647,Lomakin; Vitaliy,0,21,0,0
1668561600469,ECE 230B,A00,103648,Taur; Yuan,0,4,0,0
1668561600896,ECE 238B,A00,103649,Garay; Javier,0,0,0,0
1668561601319,ECE 240B,A00,112900,Fainman; Yeshaiahu,0,8,0,0
1668561601756,ECE 247A,A00,103650,Jokerst; Jesse Vincent,0,6,0,0
1668561602179,ECE 247B,A00,103651,Wang; Joseph,0,14,0,0
1668561602605,ECE 250,A00,103652,Siegel; Paul H.,0,85,0,0
1668561603031,ECE 251A,A00,103654,Rao; Bhaskar D.,0,64,0,0
1668561603467,ECE 257B,A00,103655,Bharadia; Dinesh,0,33,0,0
1668561603908,ECE 258A,A00,103656,Milstein; Laurence B.,0,29,0,0
1668561604335,ECE 260B,A00,103658,Kang; Mingu,0,122,0,0
1668561604763,ECE 264A,A00,103659,Galton; Ian A,0,52,0,22
1668561605197,ECE 265A,A00,103661,Gudem; Prasad S.S.,0,51,0,24
1668561605696,ECE 265D,A00,103662,Gudem; Prasad S.S.,0,27,0,0
1668561606119,ECE 268,A00,103663,Koushanfar; Farinaz,0,44,0,0
1668561606542,ECE 269,A01,103665,Pal; Piya,0,222,0,0
1668561606978,ECE 271B,A00,103666,Vasconcelos; Manuela,0,78,0,0
1668561607404,ECE 276A,A00,103667,Atanasov; Nikolay A.,0,127,0,0
1668561607828,ECE 277,A00,103668,An; Cheolhong,0,151,0,0
1668561608265,ECE 279,A00,117947,Hall; Drew A.,0,22,0,0
1668561609122,ECE 283,A00,103670,Hsueh; Tzu-Chien,0,57,0,0
1668561609550,ECE 284,A00,103671,Turakhia; Yatish Girish,0,41,0,0
1668561609980,ECE 285,A00,103672,Zheng; Yang,0,41,0,0
1668561609980,ECE 285,B00,103673,Sworder; David D.,0,61,0,0
1668561610409,ECE 287,A00,103676,Javidi; Tara,0,8,0,0
1668561610833,MATH 200B,A00,098023,Salehi Golsefidy; Alireza,8,0,15,7
1668561611258,MATH 202B,A00,098024,Rhoades; Brendon Patrick,7,0,15,8
1668561611690,MATH 203B,A00,098025,Oprea; Dragos N.,9,0,15,6
1668561612115,MATH 204B,A00,098026,Sorensen; Claus M,13,0,15,2
1668561612539,MATH 208,A00,098027,Izadi; Elham,7,0,10,3
1668561612960,MATH 209,A00,098028,Pollack; Aaron,10,0,10,0
1668561613382,MATH 211A,A00,112919,Rogalski; Daniel,8,0,10,2
1668561613818,MATH 211B,A00,112920,Seward; Brandon M.,9,0,10,1
1668561614243,MATH 218,A00,098029,Li; Bo,10,0,10,0
1668561614666,MATH 220B,A00,098030,Novak; Jonathan I,10,0,15,5
1668561615098,MATH 221A,A00,098031,Ebenfelt; Peter F,12,0,15,3
1668561615524,MATH 231B,A00,098032,Zlatos; Andrej,9,0,15,6
1668561615948,MATH 240B,A00,098033,Ni; Lei,7,0,15,8
1668561616376,MATH 243,A00,098034,Jekel; David Andrew,10,0,10,0
1668561616801,MATH 245A,A00,098035,Nie; Jiawang,0,7,15,18
1668561617224,MATH 248,A00,098036,Bejenaru; Ioan,10,0,10,0
1668561617654,MATH 250B,A00,098037,Spolaor; Luca,13,0,15,2
1668561618090,MATH 258,A00,098038,Ni; Lei,8,0,10,2
1668561618516,MATH 264B,A00,098041,Rhoades; Brendon Patrick,7,0,15,8
1668561618947,MATH 268,A00,098042,Buss; Samuel R,10,0,10,0
1668561619379,MATH 269,A00,098043,Rhoades; Brendon Patrick,10,0,10,0
1668561619804,MATH 270B,A00,098044,Li; Bo,6,0,15,9
1668561620227,MATH 272B,A00,098045,Holst; Michael J,13,0,15,2
1668561620664,MATH 273A,A00,098046,Tian; Xiaochuan,10,0,15,5
1668561621088,MATH 275,A01,098048,Tian; Xiaochuan,6,0,10,4
1668561621518,MATH 278A,A00,098049,Holst; Michael J,6,0,10,4
1668561621946,MATH 278B,A00,098050,Cloninger; Alexander,10,0,10,0
1668561622370,MATH 278C,A00,098051,Nie; Jiawang,5,0,10,5
1668561622794,MATH 280B,A00,098052,Zheng; Tianyi,6,0,15,9
1668561623216,MATH 281B,A00,098053,Bradic; Jelena,0,2,15,15
1668561623642,MATH 282B,A00,098054,Arias-Castro; Ery,0,1,15,15
1668561624065,MATH 285,A00,098055,Fitzsimmons; Patrick J,0,4,15,17
1668561624490,MATH 287B,A00,098056,Arias-Castro; Ery,1,0,15,14
1668561624914,MATH 288,A00,098057,Agarwal; Pooja,9,0,10,1
1668561624914,MATH 288,B00,098058,Zhang; Danna,8,0,10,2
1668561624914,MATH 288,C00,098059,Williams; Ruth J,9,0,10,1
1668561625336,MATH 290B,A00,098060,Roberts; Justin Deritter,11,0,15,4
1668561625759,MATH 292,A00,098061,Belmont; Eva Kinoshita,10,0,10,0
1668561626192,MATH 295,A00,098062,Suk; Andrew Hoon,47,0,50,3
1668561626618,MATH 296,A00,098063,Novak; Jonathan I,20,0,20,0
1668561627045,MATH 297,001,098064,Gamst; Anthony Collins,9997,0,9999,2
1668562129468,COGS 205,A00,101395,Chiba; Andrea,19,0,20,1
1668562129892,COGS 210B,001,101404,Greene; Deanna Jacquelyn,9998,0,9999,1
1668562129892,COGS 210B,002,101417,Xia; Haijun,9999,0,9999,0
1668562129892,COGS 210B,003,101422,Nitz; Douglas A.,9999,0,9999,0
1668562129892,COGS 210B,004,101423,Hollan; James D.,9998,0,9999,1
1668562129892,COGS 210B,005,101424,Deak; Gedeon O.,9998,0,9999,1
1668562129892,COGS 210B,006,101425,Rossano; Federico,9999,0,9999,0
1668562130317,COGS 211B,A00,101427,Coulson; Seana M,9996,0,9999,3
1668562130741,COGS 220,A00,101428,Hollan; James D.,0,17,25,25
1668562131168,COGS 229,A00,101429,Dow; Steven P,17,0,25,8
1668562131613,COGS 230,A00,101430,Klemmer; Scott R,6,0,17,11
1668562132036,COGS 234,A00,101431,Xia; Haijun,0,1,25,25
1668562132460,COGS 260,A00,101432,Kiyonaga; Anastasia,21,0,25,4
1668562132460,COGS 260,B00,101433,Kirsh; David Joel,15,0,25,10
1668562132888,CSE 202,A00,102371,Impagliazzo; Russell,0,70,0,0
1668562133311,CSE 203B,A01,102373,Cheng; Chung Kuan,0,66,0,0
1668562133739,CSE 208,A00,102374,Micciancio; Daniele,0,5,0,0
1668562134163,CSE 209A,A00,112895,Impagliazzo; Russell,0,14,15,15
1668562134587,CSE 209B,A00,108005,Bellare; Mihir,0,7,0,0
1668562135012,CSE 210,A00,113163,Coblenz; Michael J,0,92,0,0
1668562135437,CSE 219,A00,106111,Dow; Steven P,0,8,20,20
1668562135859,CSE 221,A00,102376,Voelker; Geoffrey M.,0,76,0,0
1668562136288,CSE 224,A01,102378,Porter; George M,0,176,0,0
1668562136714,CSE 229A,A00,102379,Savage; Stefan,0,12,0,0
1668562137152,CSE 229C,A00,102380,Munyaka; Imani N. S.,0,10,0,0
1668562137594,CSE 232B,A00,102382,Deutsch; Alin Bernard,0,39,0,0
1668562138017,CSE 234,A01,112904,Kumar; Arun Kumar,0,0,0,0
1668562138450,CSE 237A,A00,102383,Rosing; Tajana Simunic,0,57,0,0
1668562138888,CSE 239A,A00,102384,Deutsch; Alin Bernard,0,16,0,0
1668562139318,CSE 239B,A00,102385,Polikarpova; Nadezhda,0,11,0,0
1668562139743,CSE 240A,A00,102386,Pannuto; Patrick William,0,48,0,0
1668562140169,CSE 240B,A00,102387,Zhao; Jishen,0,51,0,0
1668562140594,CSE 241A,A00,106406,Kang; Mingu,0,9,0,0
1668562141018,CSE 249B,A00,102388,Kahng; Andrew Byun,0,5,8,8
1668562141444,CSE 251B,A01,102392,Cottrell; Garrison W,0,53,0,0
1668562141444,CSE 251B,A02,102393,Cottrell; Garrison W,0,35,0,0
1668562141874,CSE 252B,A00,102394,Ochoa; Benjamin Lawrence,0,64,0,0
1668562142298,CSE 257,A01,102396,Gao; Sicun,0,155,0,0
1668562142724,CSE 272,A00,102397,Li; Tzumao,0,22,0,0
1668562143149,CSE 274,A00,111323,Chern; Albert Ren-Haur,0,16,0,0
1668562143571,CSE 282,A00,102398,Pevzner; Pavel Arkadjevich,0,0,0,0
1668562144006,CSE 284,A00,114175,Gymrek; Melissa Ann,0,30,0,0
1668562144430,CSE 290,A00,102399,Chandraker; Manmohan Krishna,0,11,0,0
1668562144430,CSE 290,B00,102400,Vaccaro; Kristen Marie,0,8,25,25
1668562144430,CSE 290,C00,102414,Pannuto; Patrick William,0,1,25,25
1668562144430,CSE 290,D00,102427,Pevzner; Pavel Arkadjevich,0,0,0,0
1668562144430,CSE 290,E00,102429,Zhao; Jishen,0,6,0,0
1668562144430,CSE 290,F00,102436,Tullsen; Dean Michael,0,6,0,0
1668562144430,CSE 290,G00,102440,Christensen; Henrik I,0,7,20,20
1668562144862,CSE 291,A00,102443,Su; Hao,0,0,0,0
1668562144862,CSE 291,B00,102448,Polikarpova; Nadezhda,0,0,0,0
1668562144862,CSE 291,C00,102453,Vaccaro; Kristen Marie,0,0,0,0
1668562144862,CSE 291,D00,111343,Savage; Stefan,0,0,0,0
1668562144862,CSE 291,E00,116474,Claffy; Kimberly Claire,0,0,0,0
1668562144862,CSE 291,F00,116479,Pasquale; Joseph,0,0,0,0
1668562145295,CSE 293,001,119111,Bafna; Vineet,9999,0,9999,0
1668562145295,CSE 293,002,119118,Bellare; Mihir,9999,0,9999,0
1668562145295,CSE 293,003,119122,Berg-Kirkpatrick; Taylor D,9999,0,9999,0
1668562145295,CSE 293,004,119135,Christensen; Henrik I,9999,0,9999,0
1668562145295,CSE 293,005,119142,Cottrell; Garrison W,9999,0,9999,0
1668562145295,CSE 293,006,119146,Deutsch; Alin Bernard,9999,0,9999,0
1668562145295,CSE 293,007,119159,Esmaeilzadeh; Hadi,9999,0,9999,0
1668562145295,CSE 293,008,119166,Freund; Yoav,9999,0,9999,0
1668562145295,CSE 293,009,119170,Griswold; William G.,9999,0,9999,0
1668562145295,CSE 293,010,119183,Gymrek; Melissa Ann,9999,0,9999,0
1668562145295,CSE 293,011,119190,Heninger; Nadia A,9999,0,9999,0
1668562145295,CSE 293,012,119230,Impagliazzo; Russell,9999,0,9999,0
1668562145295,CSE 293,013,119232,Jhala; Ranjit,9999,0,9999,0
1668562145295,CSE 293,014,119233,Kahng; Andrew Byun,9999,0,9999,0
1668562145295,CSE 293,015,119298,Kane; Daniel Mertz,9999,0,9999,0
1668562145295,CSE 293,016,119299,Kriegman; David J,9999,0,9999,0
1668562145295,CSE 293,017,119300,Kumar; Arun Kumar,9999,0,9999,0
1668562145295,CSE 293,018,119301,Lerner; Sorin,9999,0,9999,0
1668562145295,CSE 293,019,119302,Lovett; Shachar,9999,0,9999,0
1668562145295,CSE 293,020,119303,McAuley; Julian John,9999,0,9999,0
1668562145295,CSE 293,021,119304,Micciancio; Daniele,9999,0,9999,0
1668562145295,CSE 293,022,119367,Orailoglu; Alex,9999,0,9999,0
1668562145295,CSE 293,023,119382,Paturi; Ramamohan,9999,0,9999,0
1668562145295,CSE 293,024,119404,Polikarpova; Nadezhda,9999,0,9999,0
1668562145295,CSE 293,025,119406,Politz; Joseph Gibbs,9999,0,9999,0
1668562145295,CSE 293,026,119411,Porter; George M,9999,0,9999,0
1668562145295,CSE 293,027,119414,Porter; Leonard Emerson,9999,0,9999,0
1668562145295,CSE 293,028,119416,Ramamoorthi; Ravi,9999,0,9999,0
1668562145295,CSE 293,029,119417,Sahoo; Debashis,9999,0,9999,0
1668562145295,CSE 293,030,119420,Saul; Lawrence,9999,0,9999,0
1668562145295,CSE 293,031,119421,Savage; Stefan,9999,0,9999,0
1668562145295,CSE 293,032,119425,Schulze; Jurgen P.,9999,0,9999,0
1668562145295,CSE 293,033,119426,Snoeren; Alex C.,9999,0,9999,0
1668562145295,CSE 293,034,119428,Shang; Jingbo,9999,0,9999,0
1668562145295,CSE 293,035,119430,Stefan; Deian,9999,0,9999,0
1668562145295,CSE 293,036,119431,Su; Hao,9999,0,9999,0
1668562145295,CSE 293,037,119433,Swanson; Steven James,9999,0,9999,0
1668562145295,CSE 293,038,119435,Tullsen; Dean Michael,9999,0,9999,0
1668562145295,CSE 293,039,119483,Voelker; Geoffrey M.,9999,0,9999,0
1668562145295,CSE 293,040,119537,Zhao; Jishen,9999,0,9999,0
1668562145295,CSE 293,041,119538,Zhou; Yuan-Yuan,9999,0,9999,0
1668562145295,CSE 293,042,119539,Gao; Sicun,9999,0,9999,0
1668562145295,CSE 293,043,119540,Weibel; Nadir,9999,0,9999,0
1668562145295,CSE 293,044,119541,Gupta; Rajesh K.,9999,0,9999,0
1668562145295,CSE 293,045,126410,Vaccaro; Kristen Marie,9999,0,9999,0
1668562145295,CSE 293,046,126411,Klemke; Richard,9999,0,9999,0
1668562145726,CSE 294,A00,102459,Voelker; Geoffrey M.,0,2,0,0
1668562145726,CSE 294,B00,111322,Orailoglu; Alex,0,2,0,0
1668562146150,DSE 201,A00,096914,Deutsch; Alin Bernard,30,0,30,0
1668562146575,DSE 210,A00,096915,Dasgupta; Sanjoy,30,0,30,0
1668562146998,DSE 260A,A00,096916,Altintas De Callaf; Ilkay,30,0,30,0
1668562147434,ECE 200,001,103586,Antipa; Nicholas A,9999,0,9999,0
1668562147434,ECE 200,002,103587,Atanasov; Nikolay A.,9999,0,9999,0
1668562147434,ECE 200,003,103588,Bharadia; Dinesh,9999,0,9999,0
1668562147434,ECE 200,004,103589,Cheng; Chung Kuan,9999,0,9999,0
1668562147434,ECE 200,005,103590,Cosman; Pamela C.,9999,0,9999,0
1668562147434,ECE 200,006,103591,Dayeh; Shadi Ahmad,9999,0,9999,0
1668562147434,ECE 200,007,103592,Fainman; Yeshaiahu,9999,0,9999,0
1668562147434,ECE 200,008,103593,Ford; Joseph Earl,9999,0,9999,0
1668562147434,ECE 200,009,103594,Franceschetti; Massimo,9999,0,9999,0
1668562147434,ECE 200,010,103595,Fullerton; Eric E,9999,0,9999,0
1668562147434,ECE 200,011,103596,Galton; Ian A,9999,0,9999,0
1668562147434,ECE 200,012,103597,Gilja; Vikash,9999,0,9999,0
1668562147434,ECE 200,013,103598,Hall; Drew A.,9999,0,9999,0
1668562147434,ECE 200,014,103599,Hsueh; Tzu-Chien,9999,0,9999,0
1668562147434,ECE 200,015,103600,Javidi; Tara,9999,0,9999,0
1668562147434,ECE 200,016,103601,Kahng; Andrew Byun,9999,0,9999,0
1668562147434,ECE 200,017,103602,Kim; Young-Han,9999,0,9999,0
1668562147434,ECE 200,018,103603,Koushanfar; Farinaz,9999,0,9999,0
1668562147434,ECE 200,019,103604,Kuzum; Duygu,9999,0,9999,0
1668562147434,ECE 200,020,103605,Le; Hanh-Phuc,9999,0,9999,0
1668562147434,ECE 200,021,103606,Lin; Bill,9999,0,9999,0
1668562147434,ECE 200,022,103607,Liu; Zhaowei,9998,0,9999,1
1668562147434,ECE 200,023,103608,Lo; Yu-Hwa,9999,0,9999,0
1668562147434,ECE 200,024,103609,Lomakin; Vitaliy,9999,0,9999,0
1668562147434,ECE 200,025,103610,Mercier; Patrick Philip,9999,0,9999,0
1668562147434,ECE 200,026,103611,Meyer; Florian,9999,0,9999,0
1668562147434,ECE 200,027,103612,Milstein; Laurence B.,9999,0,9999,0
1668562147434,ECE 200,028,103613,Mir Arabbaygi; Siavash,9999,0,9999,0
1668562147434,ECE 200,029,103614,Mookherjea; Shayan,9999,0,9999,0
1668562147434,ECE 200,030,103615,Morris; Karcher William,9999,0,9999,0
1668562147434,ECE 200,031,103616,Ng; Tse Nga,9999,0,9999,0
1668562147434,ECE 200,032,103617,Nguyen; Truong Quang,9999,0,9999,0
1668562147434,ECE 200,033,103618,Nomura; Kenji,9999,0,9999,0
1668562147434,ECE 200,034,103619,Orlitsky; Alon,9999,0,9999,0
1668562147434,ECE 200,035,103620,Pal; Piya,9999,0,9999,0
1668562147434,ECE 200,036,103621,Papen; George C.,9999,0,9999,0
1668562147434,ECE 200,037,103622,Radic; Stojan,9999,0,9999,0
1668562147434,ECE 200,038,103623,Rao; Bhaskar D.,9999,0,9999,0
1668562147434,ECE 200,039,103624,Rao; Ramesh R,9999,0,9999,0
1668562147434,ECE 200,040,103625,Rebeiz; Gabriel,9999,0,9999,0
1668562147434,ECE 200,041,103626,Sanford; John R,9999,0,9999,0
1668562147434,ECE 200,042,103627,Siegel; Paul H.,9999,0,9999,0
1668562147434,ECE 200,043,103628,Sievenpiper; Daniel F.,9999,0,9999,0
1668562147434,ECE 200,044,103629,Sworder; David D.,9999,0,9999,0
1668562147434,ECE 200,045,103630,Taur; Yuan,9999,0,9999,0
1668562147434,ECE 200,046,103631,Touri; Behrouz,9999,0,9999,0
1668562147434,ECE 200,047,103632,Trivedi; Mohan M.,9999,0,9999,0
1668562147434,ECE 200,048,103633,Vasconcelos; Nuno,9999,0,9999,0
1668562147434,ECE 200,049,103634,Wang; Xiaolong,9999,0,9999,0
1668562147434,ECE 200,050,103635,Xie; Pengtao,9999,0,9999,0
1668562147434,ECE 200,051,103636,Yip; Michael,9999,0,9999,0
1668562147434,ECE 200,052,103637,Zeger; Kenneth A.,999,0,999,0
1668562147434,ECE 200,053,103638,Zhang; Xinyu,9999,0,9999,0
1668562147434,ECE 200,054,103639,Turakhia; Yatish Girish,9999,0,9999,0
1668562147434,ECE 200,055,103640,Kang; Mingu,9999,0,9999,0
1668562147434,ECE 200,056,103641,Shi; Yuanyuan,9999,0,9999,0
1668562147434,ECE 200,057,103642,Wang; Edward Jay,9999,0,9999,0
1668562147434,ECE 200,058,103643,Zheng; Yang,9999,0,9999,0
1668562147858,ECE 202,A00,103644,Kuzum; Duygu,0,46,0,0
1668562148290,ECE 212BN,A00,103646,Ng; Tse Nga,0,9,0,0
1668562148729,ECE 221,A00,111493,Staff,0,0,0,0
1668562149153,ECE 222B,A00,103647,Lomakin; Vitaliy,0,21,0,0
1668562149576,ECE 230B,A00,103648,Taur; Yuan,0,4,0,0
1668562150004,ECE 238B,A00,103649,Garay; Javier,0,0,0,0
1668562150431,ECE 240B,A00,112900,Fainman; Yeshaiahu,0,8,0,0
1668562150858,ECE 247A,A00,103650,Jokerst; Jesse Vincent,0,6,0,0
1668562151280,ECE 247B,A00,103651,Wang; Joseph,0,14,0,0
1668562151710,ECE 250,A00,103652,Siegel; Paul H.,0,85,0,0
1668562152149,ECE 251A,A00,103654,Rao; Bhaskar D.,0,64,0,0
1668562152573,ECE 257B,A00,103655,Bharadia; Dinesh,0,33,0,0
1668562153014,ECE 258A,A00,103656,Milstein; Laurence B.,0,29,0,0
1668562153449,ECE 260B,A00,103658,Kang; Mingu,0,121,0,0
1668562153871,ECE 264A,A00,103659,Galton; Ian A,0,52,0,22
1668562154296,ECE 265A,A00,103661,Gudem; Prasad S.S.,0,51,0,24
1668562154720,ECE 265D,A00,103662,Gudem; Prasad S.S.,0,27,0,0
1668562155147,ECE 268,A00,103663,Koushanfar; Farinaz,0,44,0,0
1668562155574,ECE 269,A01,103665,Pal; Piya,0,222,0,0
1668562155999,ECE 271B,A00,103666,Vasconcelos; Manuela,0,78,0,0
1668562156432,ECE 276A,A00,103667,Atanasov; Nikolay A.,0,127,0,0
1668562156857,ECE 277,A00,103668,An; Cheolhong,0,151,0,0
1668562157280,ECE 279,A00,117947,Hall; Drew A.,0,22,0,0
1668562158127,ECE 283,A00,103670,Hsueh; Tzu-Chien,0,57,0,0
1668562158549,ECE 284,A00,103671,Turakhia; Yatish Girish,0,41,0,0
1668562158981,ECE 285,A00,103672,Zheng; Yang,0,41,0,0
1668562158981,ECE 285,B00,103673,Sworder; David D.,0,61,0,0
1668562159403,ECE 287,A00,103676,Javidi; Tara,0,8,0,0
1668562159834,MATH 200B,A00,098023,Salehi Golsefidy; Alireza,8,0,15,7
1668562160257,MATH 202B,A00,098024,Rhoades; Brendon Patrick,7,0,15,8
1668562160680,MATH 203B,A00,098025,Oprea; Dragos N.,9,0,15,6
1668562161106,MATH 204B,A00,098026,Sorensen; Claus M,13,0,15,2
1668562161538,MATH 208,A00,098027,Izadi; Elham,7,0,10,3
1668562161961,MATH 209,A00,098028,Pollack; Aaron,10,0,10,0
1668562162393,MATH 211A,A00,112919,Rogalski; Daniel,8,0,10,2
1668562162814,MATH 211B,A00,112920,Seward; Brandon M.,9,0,10,1
1668562163241,MATH 218,A00,098029,Li; Bo,10,0,10,0
1668562163670,MATH 220B,A00,098030,Novak; Jonathan I,10,0,15,5
1668562164093,MATH 221A,A00,098031,Ebenfelt; Peter F,12,0,15,3
1668562164524,MATH 231B,A00,098032,Zlatos; Andrej,9,0,15,6
1668562164950,MATH 240B,A00,098033,Ni; Lei,7,0,15,8
1668562165383,MATH 243,A00,098034,Jekel; David Andrew,10,0,10,0
1668562165811,MATH 245A,A00,098035,Nie; Jiawang,0,7,15,18
1668562166247,MATH 248,A00,098036,Bejenaru; Ioan,10,0,10,0
1668562166672,MATH 250B,A00,098037,Spolaor; Luca,13,0,15,2
1668562167099,MATH 258,A00,098038,Ni; Lei,8,0,10,2
1668562167522,MATH 264B,A00,098041,Rhoades; Brendon Patrick,7,0,15,8
1668562167953,MATH 268,A00,098042,Buss; Samuel R,10,0,10,0
1668562168380,MATH 269,A00,098043,Rhoades; Brendon Patrick,10,0,10,0
1668562168807,MATH 270B,A00,098044,Li; Bo,6,0,15,9
1668562169230,MATH 272B,A00,098045,Holst; Michael J,13,0,15,2
1668562169744,MATH 273A,A00,098046,Tian; Xiaochuan,10,0,15,5
1668562170171,MATH 275,A01,098048,Tian; Xiaochuan,6,0,10,4
1668562170594,MATH 278A,A00,098049,Holst; Michael J,6,0,10,4
1668562171019,MATH 278B,A00,098050,Cloninger; Alexander,10,0,10,0
1668562171445,MATH 278C,A00,098051,Nie; Jiawang,5,0,10,5
1668562171868,MATH 280B,A00,098052,Zheng; Tianyi,6,0,15,9
1668562172290,MATH 281B,A00,098053,Bradic; Jelena,0,2,15,15
1668562172714,MATH 282B,A00,098054,Arias-Castro; Ery,0,1,15,15
1668562173136,MATH 285,A00,098055,Fitzsimmons; Patrick J,0,4,15,17
1668562173563,MATH 287B,A00,098056,Arias-Castro; Ery,1,0,15,14
1668562173990,MATH 288,A00,098057,Agarwal; Pooja,9,0,10,1
1668562173990,MATH 288,B00,098058,Zhang; Danna,8,0,10,2
1668562173990,MATH 288,C00,098059,Williams; Ruth J,9,0,10,1
1668562174429,MATH 290B,A00,098060,Roberts; Justin Deritter,11,0,15,4
1668562174851,MATH 292,A00,098061,Belmont; Eva Kinoshita,10,0,10,0
1668562175272,MATH 295,A00,098062,Suk; Andrew Hoon,47,0,50,3
1668562175696,MATH 296,A00,098063,Novak; Jonathan I,20,0,20,0
1668562176119,MATH 297,001,098064,Gamst; Anthony Collins,9997,0,9999,2
1668562679226,COGS 205,A00,101395,Chiba; Andrea,19,0,20,1
1668562679648,COGS 210B,001,101404,Greene; Deanna Jacquelyn,9998,0,9999,1
1668562679648,COGS 210B,002,101417,Xia; Haijun,9999,0,9999,0
1668562679648,COGS 210B,003,101422,Nitz; Douglas A.,9999,0,9999,0
1668562679648,COGS 210B,004,101423,Hollan; James D.,9998,0,9999,1
1668562679648,COGS 210B,005,101424,Deak; Gedeon O.,9998,0,9999,1
1668562679648,COGS 210B,006,101425,Rossano; Federico,9999,0,9999,0
1668562680072,COGS 211B,A00,101427,Coulson; Seana M,9996,0,9999,3
1668562680504,COGS 220,A00,101428,Hollan; James D.,0,17,25,25
1668562680939,COGS 229,A00,101429,Dow; Steven P,17,0,25,8
1668562681385,COGS 230,A00,101430,Klemmer; Scott R,6,0,17,11
1668562681808,COGS 234,A00,101431,Xia; Haijun,0,1,25,25
1668562682230,COGS 260,A00,101432,Kiyonaga; Anastasia,21,0,25,4
1668562682230,COGS 260,B00,101433,Kirsh; David Joel,15,0,25,10
1668562682661,CSE 202,A00,102371,Impagliazzo; Russell,0,70,0,0
1668562683092,CSE 203B,A01,102373,Cheng; Chung Kuan,0,66,0,0
1668562683517,CSE 208,A00,102374,Micciancio; Daniele,0,5,0,0
1668562683940,CSE 209A,A00,112895,Impagliazzo; Russell,0,14,15,15
1668562684369,CSE 209B,A00,108005,Bellare; Mihir,0,7,0,0
1668562684793,CSE 210,A00,113163,Coblenz; Michael J,0,92,0,0
1668562685215,CSE 219,A00,106111,Dow; Steven P,0,8,20,20
1668562685639,CSE 221,A00,102376,Voelker; Geoffrey M.,0,76,0,0
1668562686075,CSE 224,A01,102378,Porter; George M,0,176,0,0
1668562686518,CSE 229A,A00,102379,Savage; Stefan,0,12,0,0
1668562686942,CSE 229C,A00,102380,Munyaka; Imani N. S.,0,10,0,0
1668562687375,CSE 232B,A00,102382,Deutsch; Alin Bernard,0,39,0,0
1668562687808,CSE 234,A01,112904,Kumar; Arun Kumar,0,0,0,0
1668562688232,CSE 237A,A00,102383,Rosing; Tajana Simunic,0,57,0,0
1668562688671,CSE 239A,A00,102384,Deutsch; Alin Bernard,0,16,0,0
1668562689099,CSE 239B,A00,102385,Polikarpova; Nadezhda,0,11,0,0
1668562689533,CSE 240A,A00,102386,Pannuto; Patrick William,0,48,0,0
1668562689954,CSE 240B,A00,102387,Zhao; Jishen,0,51,0,0
1668562690393,CSE 241A,A00,106406,Kang; Mingu,0,9,0,0
1668562690816,CSE 249B,A00,102388,Kahng; Andrew Byun,0,5,8,8
1668562691331,CSE 251B,A01,102392,Cottrell; Garrison W,0,53,0,0
1668562691331,CSE 251B,A02,102393,Cottrell; Garrison W,0,35,0,0
1668562691754,CSE 252B,A00,102394,Ochoa; Benjamin Lawrence,0,64,0,0
1668562692187,CSE 257,A01,102396,Gao; Sicun,0,155,0,0
1668562692612,CSE 272,A00,102397,Li; Tzumao,0,22,0,0
1668562693042,CSE 274,A00,111323,Chern; Albert Ren-Haur,0,16,0,0
1668562693465,CSE 282,A00,102398,Pevzner; Pavel Arkadjevich,0,0,0,0
1668562693890,CSE 284,A00,114175,Gymrek; Melissa Ann,0,30,0,0
1668562694318,CSE 290,A00,102399,Chandraker; Manmohan Krishna,0,11,0,0
1668562694318,CSE 290,B00,102400,Vaccaro; Kristen Marie,0,8,25,25
1668562694318,CSE 290,C00,102414,Pannuto; Patrick William,0,1,25,25
1668562694318,CSE 290,D00,102427,Pevzner; Pavel Arkadjevich,0,0,0,0
1668562694318,CSE 290,E00,102429,Zhao; Jishen,0,6,0,0
1668562694318,CSE 290,F00,102436,Tullsen; Dean Michael,0,6,0,0
1668562694318,CSE 290,G00,102440,Christensen; Henrik I,0,7,20,20
1668562694741,CSE 291,A00,102443,Su; Hao,0,0,0,0
1668562694741,CSE 291,B00,102448,Polikarpova; Nadezhda,0,0,0,0
1668562694741,CSE 291,C00,102453,Vaccaro; Kristen Marie,0,0,0,0
1668562694741,CSE 291,D00,111343,Savage; Stefan,0,0,0,0
1668562694741,CSE 291,E00,116474,Claffy; Kimberly Claire,0,0,0,0
1668562694741,CSE 291,F00,116479,Pasquale; Joseph,0,0,0,0
1668562695167,CSE 293,001,119111,Bafna; Vineet,9999,0,9999,0
1668562695167,CSE 293,002,119118,Bellare; Mihir,9999,0,9999,0
1668562695167,CSE 293,003,119122,Berg-Kirkpatrick; Taylor D,9999,0,9999,0
1668562695167,CSE 293,004,119135,Christensen; Henrik I,9999,0,9999,0
1668562695167,CSE 293,005,119142,Cottrell; Garrison W,9999,0,9999,0
1668562695167,CSE 293,006,119146,Deutsch; Alin Bernard,9999,0,9999,0
1668562695167,CSE 293,007,119159,Esmaeilzadeh; Hadi,9999,0,9999,0
1668562695167,CSE 293,008,119166,Freund; Yoav,9999,0,9999,0
1668562695167,CSE 293,009,119170,Griswold; William G.,9999,0,9999,0
1668562695167,CSE 293,010,119183,Gymrek; Melissa Ann,9999,0,9999,0
1668562695167,CSE 293,011,119190,Heninger; Nadia A,9999,0,9999,0
1668562695167,CSE 293,012,119230,Impagliazzo; Russell,9999,0,9999,0
1668562695167,CSE 293,013,119232,Jhala; Ranjit,9999,0,9999,0
1668562695167,CSE 293,014,119233,Kahng; Andrew Byun,9999,0,9999,0
1668562695167,CSE 293,015,119298,Kane; Daniel Mertz,9999,0,9999,0
1668562695167,CSE 293,016,119299,Kriegman; David J,9999,0,9999,0
1668562695167,CSE 293,017,119300,Kumar; Arun Kumar,9999,0,9999,0
1668562695167,CSE 293,018,119301,Lerner; Sorin,9999,0,9999,0
1668562695167,CSE 293,019,119302,Lovett; Shachar,9999,0,9999,0
1668562695167,CSE 293,020,119303,McAuley; Julian John,9999,0,9999,0
1668562695167,CSE 293,021,119304,Micciancio; Daniele,9999,0,9999,0
1668562695167,CSE 293,022,119367,Orailoglu; Alex,9999,0,9999,0
1668562695167,CSE 293,023,119382,Paturi; Ramamohan,9999,0,9999,0
1668562695167,CSE 293,024,119404,Polikarpova; Nadezhda,9999,0,9999,0
1668562695167,CSE 293,025,119406,Politz; Joseph Gibbs,9999,0,9999,0
1668562695167,CSE 293,026,119411,Porter; George M,9999,0,9999,0
1668562695167,CSE 293,027,119414,Porter; Leonard Emerson,9999,0,9999,0
1668562695167,CSE 293,028,119416,Ramamoorthi; Ravi,9999,0,9999,0
1668562695167,CSE 293,029,119417,Sahoo; Debashis,9999,0,9999,0
1668562695167,CSE 293,030,119420,Saul; Lawrence,9999,0,9999,0
1668562695167,CSE 293,031,119421,Savage; Stefan,9999,0,9999,0
1668562695167,CSE 293,032,119425,Schulze; Jurgen P.,9999,0,9999,0
1668562695167,CSE 293,033,119426,Snoeren; Alex C.,9999,0,9999,0
1668562695167,CSE 293,034,119428,Shang; Jingbo,9999,0,9999,0
1668562695167,CSE 293,035,119430,Stefan; Deian,9999,0,9999,0
1668562695167,CSE 293,036,119431,Su; Hao,9999,0,9999,0
1668562695167,CSE 293,037,119433,Swanson; Steven James,9999,0,9999,0
1668562695167,CSE 293,038,119435,Tullsen; Dean Michael,9999,0,9999,0
1668562695167,CSE 293,039,119483,Voelker; Geoffrey M.,9999,0,9999,0
1668562695167,CSE 293,040,119537,Zhao; Jishen,9999,0,9999,0
1668562695167,CSE 293,041,119538,Zhou; Yuan-Yuan,9999,0,9999,0
1668562695167,CSE 293,042,119539,Gao; Sicun,9999,0,9999,0
1668562695167,CSE 293,043,119540,Weibel; Nadir,9999,0,9999,0
1668562695167,CSE 293,044,119541,Gupta; Rajesh K.,9999,0,9999,0
1668562695167,CSE 293,045,126410,Vaccaro; Kristen Marie,9999,0,9999,0
1668562695167,CSE 293,046,126411,Klemke; Richard,9999,0,9999,0
1668562695593,CSE 294,A00,102459,Voelker; Geoffrey M.,0,2,0,0
1668562695593,CSE 294,B00,111322,Orailoglu; Alex,0,2,0,0
1668562696017,DSE 201,A00,096914,Deutsch; Alin Bernard,30,0,30,0
1668562696443,DSE 210,A00,096915,Dasgupta; Sanjoy,30,0,30,0
1668562696866,DSE 260A,A00,096916,Altintas De Callaf; Ilkay,30,0,30,0
1668562697295,ECE 200,001,103586,Antipa; Nicholas A,9999,0,9999,0
1668562697295,ECE 200,002,103587,Atanasov; Nikolay A.,9999,0,9999,0
1668562697295,ECE 200,003,103588,Bharadia; Dinesh,9999,0,9999,0
1668562697295,ECE 200,004,103589,Cheng; Chung Kuan,9999,0,9999,0
1668562697295,ECE 200,005,103590,Cosman; Pamela C.,9999,0,9999,0
1668562697295,ECE 200,006,103591,Dayeh; Shadi Ahmad,9999,0,9999,0
1668562697295,ECE 200,007,103592,Fainman; Yeshaiahu,9999,0,9999,0
1668562697295,ECE 200,008,103593,Ford; Joseph Earl,9999,0,9999,0
1668562697295,ECE 200,009,103594,Franceschetti; Massimo,9999,0,9999,0
1668562697295,ECE 200,010,103595,Fullerton; Eric E,9999,0,9999,0
1668562697295,ECE 200,011,103596,Galton; Ian A,9999,0,9999,0
1668562697295,ECE 200,012,103597,Gilja; Vikash,9999,0,9999,0
1668562697295,ECE 200,013,103598,Hall; Drew A.,9999,0,9999,0
1668562697295,ECE 200,014,103599,Hsueh; Tzu-Chien,9999,0,9999,0
1668562697295,ECE 200,015,103600,Javidi; Tara,9999,0,9999,0
1668562697295,ECE 200,016,103601,Kahng; Andrew Byun,9999,0,9999,0
1668562697295,ECE 200,017,103602,Kim; Young-Han,9999,0,9999,0
1668562697295,ECE 200,018,103603,Koushanfar; Farinaz,9999,0,9999,0
1668562697295,ECE 200,019,103604,Kuzum; Duygu,9999,0,9999,0
1668562697295,ECE 200,020,103605,Le; Hanh-Phuc,9999,0,9999,0
1668562697295,ECE 200,021,103606,Lin; Bill,9999,0,9999,0
1668562697295,ECE 200,022,103607,Liu; Zhaowei,9998,0,9999,1
1668562697295,ECE 200,023,103608,Lo; Yu-Hwa,9999,0,9999,0
1668562697295,ECE 200,024,103609,Lomakin; Vitaliy,9999,0,9999,0
1668562697295,ECE 200,025,103610,Mercier; Patrick Philip,9999,0,9999,0
1668562697295,ECE 200,026,103611,Meyer; Florian,9999,0,9999,0
1668562697295,ECE 200,027,103612,Milstein; Laurence B.,9999,0,9999,0
1668562697295,ECE 200,028,103613,Mir Arabbaygi; Siavash,9999,0,9999,0
1668562697295,ECE 200,029,103614,Mookherjea; Shayan,9999,0,9999,0
1668562697295,ECE 200,030,103615,Morris; Karcher William,9999,0,9999,0
1668562697295,ECE 200,031,103616,Ng; Tse Nga,9999,0,9999,0
1668562697295,ECE 200,032,103617,Nguyen; Truong Quang,9999,0,9999,0
1668562697295,ECE 200,033,103618,Nomura; Kenji,9999,0,9999,0
1668562697295,ECE 200,034,103619,Orlitsky; Alon,9999,0,9999,0
1668562697295,ECE 200,035,103620,Pal; Piya,9999,0,9999,0
1668562697295,ECE 200,036,103621,Papen; George C.,9999,0,9999,0
1668562697295,ECE 200,037,103622,Radic; Stojan,9999,0,9999,0
1668562697295,ECE 200,038,103623,Rao; Bhaskar D.,9999,0,9999,0
1668562697295,ECE 200,039,103624,Rao; Ramesh R,9999,0,9999,0
1668562697295,ECE 200,040,103625,Rebeiz; Gabriel,9999,0,9999,0
1668562697295,ECE 200,041,103626,Sanford; John R,9999,0,9999,0
1668562697295,ECE 200,042,103627,Siegel; Paul H.,9999,0,9999,0
1668562697295,ECE 200,043,103628,Sievenpiper; Daniel F.,9999,0,9999,0
1668562697295,ECE 200,044,103629,Sworder; David D.,9999,0,9999,0
1668562697295,ECE 200,045,103630,Taur; Yuan,9999,0,9999,0
1668562697295,ECE 200,046,103631,Touri; Behrouz,9999,0,9999,0
1668562697295,ECE 200,047,103632,Trivedi; Mohan M.,9999,0,9999,0
1668562697295,ECE 200,048,103633,Vasconcelos; Nuno,9999,0,9999,0
1668562697295,ECE 200,049,103634,Wang; Xiaolong,9999,0,9999,0
1668562697295,ECE 200,050,103635,Xie; Pengtao,9999,0,9999,0
1668562697295,ECE 200,051,103636,Yip; Michael,9999,0,9999,0
1668562697295,ECE 200,052,103637,Zeger; Kenneth A.,999,0,999,0
1668562697295,ECE 200,053,103638,Zhang; Xinyu,9999,0,9999,0
1668562697295,ECE 200,054,103639,Turakhia; Yatish Girish,9999,0,9999,0
1668562697295,ECE 200,055,103640,Kang; Mingu,9999,0,9999,0
1668562697295,ECE 200,056,103641,Shi; Yuanyuan,9999,0,9999,0
1668562697295,ECE 200,057,103642,Wang; Edward Jay,9999,0,9999,0
1668562697295,ECE 200,058,103643,Zheng; Yang,9999,0,9999,0
1668562697728,ECE 202,A00,103644,Kuzum; Duygu,0,46,0,0
1668562698156,ECE 212BN,A00,103646,Ng; Tse Nga,0,9,0,0
1668562698581,ECE 221,A00,111493,Staff,0,0,0,0
1668562699015,ECE 222B,A00,103647,Lomakin; Vitaliy,0,21,0,0
1668562699463,ECE 230B,A00,103648,Taur; Yuan,0,4,0,0
1668562699888,ECE 238B,A00,103649,Garay; Javier,0,0,0,0
1668562700311,ECE 240B,A00,112900,Fainman; Yeshaiahu,0,8,0,0
1668562700738,ECE 247A,A00,103650,Jokerst; Jesse Vincent,0,6,0,0
1668562701171,ECE 247B,A00,103651,Wang; Joseph,0,14,0,0
1668562701598,ECE 250,A00,103652,Siegel; Paul H.,0,85,0,0
1668562702020,ECE 251A,A00,103654,Rao; Bhaskar D.,0,64,0,0
1668562702446,ECE 257B,A00,103655,Bharadia; Dinesh,0,33,0,0
1668562702872,ECE 258A,A00,103656,Milstein; Laurence B.,0,29,0,0
1668562703302,ECE 260B,A00,103658,Kang; Mingu,0,121,0,0
1668562703726,ECE 264A,A00,103659,Galton; Ian A,0,49,0,25
1668562704156,ECE 265A,A00,103661,Gudem; Prasad S.S.,0,50,0,25
1668562704585,ECE 265D,A00,103662,Gudem; Prasad S.S.,0,27,0,0
1668562705012,ECE 268,A00,103663,Koushanfar; Farinaz,0,44,0,0
1668562705434,ECE 269,A01,103665,Pal; Piya,0,222,0,0
1668562705872,ECE 271B,A00,103666,Vasconcelos; Manuela,0,78,0,0
1668562706294,ECE 276A,A00,103667,Atanasov; Nikolay A.,0,127,0,0
1668562706722,ECE 277,A00,103668,An; Cheolhong,0,151,0,0
1668562707148,ECE 279,A00,117947,Hall; Drew A.,0,22,0,0
1668562708010,ECE 283,A00,103670,Hsueh; Tzu-Chien,0,57,0,0
1668562708446,ECE 284,A00,103671,Turakhia; Yatish Girish,0,41,0,0
1668562708887,ECE 285,A00,103672,Zheng; Yang,0,41,0,0
1668562708887,ECE 285,B00,103673,Sworder; David D.,0,61,0,0
1668562709311,ECE 287,A00,103676,Javidi; Tara,0,8,0,0
1668562709743,MATH 200B,A00,098023,Salehi Golsefidy; Alireza,7,0,15,8
1668562710168,MATH 202B,A00,098024,Rhoades; Brendon Patrick,7,0,15,8
1668562710589,MATH 203B,A00,098025,Oprea; Dragos N.,9,0,15,6
1668562711014,MATH 204B,A00,098026,Sorensen; Claus M,13,0,15,2
1668562711437,MATH 208,A00,098027,Izadi; Elham,7,0,10,3
1668562711858,MATH 209,A00,098028,Pollack; Aaron,10,0,10,0
1668562712282,MATH 211A,A00,112919,Rogalski; Daniel,8,0,10,2
1668562712705,MATH 211B,A00,112920,Seward; Brandon M.,9,0,10,1
1668562713128,MATH 218,A00,098029,Li; Bo,10,0,10,0
1668562713563,MATH 220B,A00,098030,Novak; Jonathan I,10,0,15,5
1668562713986,MATH 221A,A00,098031,Ebenfelt; Peter F,12,0,15,3
1668562714409,MATH 231B,A00,098032,Zlatos; Andrej,9,0,15,6
1668562714841,MATH 240B,A00,098033,Ni; Lei,7,0,15,8
1668562715268,MATH 243,A00,098034,Jekel; David Andrew,10,0,10,0
1668562715692,MATH 245A,A00,098035,Nie; Jiawang,0,7,15,18
1668562716116,MATH 248,A00,098036,Bejenaru; Ioan,10,0,10,0
1668562716547,MATH 250B,A00,098037,Spolaor; Luca,12,0,15,3
1668562716978,MATH 258,A00,098038,Ni; Lei,8,0,10,2
1668562717409,MATH 264B,A00,098041,Rhoades; Brendon Patrick,7,0,15,8
1668562717839,MATH 268,A00,098042,Buss; Samuel R,10,0,10,0
1668562718263,MATH 269,A00,098043,Rhoades; Brendon Patrick,10,0,10,0
1668562718700,MATH 270B,A00,098044,Li; Bo,6,0,15,9
1668562719122,MATH 272B,A00,098045,Holst; Michael J,13,0,15,2
1668562719547,MATH 273A,A00,098046,Tian; Xiaochuan,10,0,15,5
1668562719974,MATH 275,A01,098048,Tian; Xiaochuan,6,0,10,4
1668562720398,MATH 278A,A00,098049,Holst; Michael J,6,0,10,4
1668562720829,MATH 278B,A00,098050,Cloninger; Alexander,10,0,10,0
1668562721257,MATH 278C,A00,098051,Nie; Jiawang,5,0,10,5
1668562721682,MATH 280B,A00,098052,Zheng; Tianyi,6,0,15,9
1668562722107,MATH 281B,A00,098053,Bradic; Jelena,0,2,15,15
1668562722529,MATH 282B,A00,098054,Arias-Castro; Ery,0,1,15,15
1668562722953,MATH 285,A00,098055,Fitzsimmons; Patrick J,0,4,15,17
1668562723381,MATH 287B,A00,098056,Arias-Castro; Ery,1,0,15,14
1668562723807,MATH 288,A00,098057,Agarwal; Pooja,9,0,10,1
1668562723807,MATH 288,B00,098058,Zhang; Danna,8,0,10,2
1668562723807,MATH 288,C00,098059,Williams; Ruth J,9,0,10,1
1668562724231,MATH 290B,A00,098060,Roberts; Justin Deritter,11,0,15,4
1668562724655,MATH 292,A00,098061,Belmont; Eva Kinoshita,10,0,10,0
1668562725081,MATH 295,A00,098062,Suk; Andrew Hoon,47,0,50,3
1668562725504,MATH 296,A00,098063,Novak; Jonathan I,20,0,20,0
1668562725935,MATH 297,001,098064,Gamst; Anthony Collins,9997,0,9999,2
1668563228942,COGS 205,A00,101395,Chiba; Andrea,19,0,20,1
1668563229369,COGS 210B,001,101404,Greene; Deanna Jacquelyn,9998,0,9999,1
1668563229369,COGS 210B,002,101417,Xia; Haijun,9999,0,9999,0
1668563229369,COGS 210B,003,101422,Nitz; Douglas A.,9999,0,9999,0
1668563229369,COGS 210B,004,101423,Hollan; James D.,9998,0,9999,1
1668563229369,COGS 210B,005,101424,Deak; Gedeon O.,9998,0,9999,1
1668563229369,COGS 210B,006,101425,Rossano; Federico,9999,0,9999,0
1668563229800,COGS 211B,A00,101427,Coulson; Seana M,9996,0,9999,3
1668563230222,COGS 220,A00,101428,Hollan; James D.,0,17,25,25
1668563230645,COGS 229,A00,101429,Dow; Steven P,17,0,25,8
1668563231070,COGS 230,A00,101430,Klemmer; Scott R,6,0,17,11
1668563231496,COGS 234,A00,101431,Xia; Haijun,0,1,25,25
1668563231918,COGS 260,A00,101432,Kiyonaga; Anastasia,21,0,25,4
1668563231918,COGS 260,B00,101433,Kirsh; David Joel,15,0,25,10
1668563232343,CSE 202,A00,102371,Impagliazzo; Russell,0,70,0,0
1668563232767,CSE 203B,A01,102373,Cheng; Chung Kuan,0,66,0,0
1668563233193,CSE 208,A00,102374,Micciancio; Daniele,0,5,0,0
1668563233630,CSE 209A,A00,112895,Impagliazzo; Russell,0,14,15,15
1668563234055,CSE 209B,A00,108005,Bellare; Mihir,0,7,0,0
1668563234483,CSE 210,A00,113163,Coblenz; Michael J,0,92,0,0
1668563234909,CSE 219,A00,106111,Dow; Steven P,0,8,20,20
1668563235334,CSE 221,A00,102376,Voelker; Geoffrey M.,0,76,0,0
1668563235766,CSE 224,A01,102378,Porter; George M,0,176,0,0
1668563236189,CSE 229A,A00,102379,Savage; Stefan,0,12,0,0
1668563236612,CSE 229C,A00,102380,Munyaka; Imani N. S.,0,10,0,0
1668563237035,CSE 232B,A00,102382,Deutsch; Alin Bernard,0,39,0,0
1668563237458,CSE 234,A01,112904,Kumar; Arun Kumar,0,0,0,0
1668563237881,CSE 237A,A00,102383,Rosing; Tajana Simunic,0,57,0,0
1668563238321,CSE 239A,A00,102384,Deutsch; Alin Bernard,0,16,0,0
1668563238754,CSE 239B,A00,102385,Polikarpova; Nadezhda,0,11,0,0
1668563239192,CSE 240A,A00,102386,Pannuto; Patrick William,0,48,0,0
1668563250428,CSE 240B,A00,102387,Zhao; Jishen,0,51,0,0
1668563250865,CSE 241A,A00,106406,Kang; Mingu,0,9,0,0
1668563251291,CSE 249B,A00,102388,Kahng; Andrew Byun,0,5,8,8
1668563251722,CSE 251B,A01,102392,Cottrell; Garrison W,0,53,0,0
1668563251722,CSE 251B,A02,102393,Cottrell; Garrison W,0,35,0,0
1668563252146,CSE 252B,A00,102394,Ochoa; Benjamin Lawrence,0,64,0,0
1668563252572,CSE 257,A01,102396,Gao; Sicun,0,155,0,0
1668563252996,CSE 272,A00,102397,Li; Tzumao,0,22,0,0
1668563253418,CSE 274,A00,111323,Chern; Albert Ren-Haur,0,16,0,0
1668563253844,CSE 282,A00,102398,Pevzner; Pavel Arkadjevich,0,0,0,0
1668563254279,CSE 284,A00,114175,Gymrek; Melissa Ann,0,30,0,0
1668563254713,CSE 290,A00,102399,Chandraker; Manmohan Krishna,0,11,0,0
1668563254713,CSE 290,B00,102400,Vaccaro; Kristen Marie,0,8,25,25
1668563254713,CSE 290,C00,102414,Pannuto; Patrick William,0,1,25,25
1668563254713,CSE 290,D00,102427,Pevzner; Pavel Arkadjevich,0,0,0,0
1668563254713,CSE 290,E00,102429,Zhao; Jishen,0,6,0,0
1668563254713,CSE 290,F00,102436,Tullsen; Dean Michael,0,6,0,0
1668563254713,CSE 290,G00,102440,Christensen; Henrik I,0,7,20,20
1668563255151,CSE 291,A00,102443,Su; Hao,0,0,0,0
1668563255151,CSE 291,B00,102448,Polikarpova; Nadezhda,0,0,0,0
1668563255151,CSE 291,C00,102453,Vaccaro; Kristen Marie,0,0,0,0
1668563255151,CSE 291,D00,111343,Savage; Stefan,0,0,0,0
1668563255151,CSE 291,E00,116474,Claffy; Kimberly Claire,0,0,0,0
1668563255151,CSE 291,F00,116479,Pasquale; Joseph,0,0,0,0
1668563255618,CSE 293,001,119111,Bafna; Vineet,9999,0,9999,0
1668563255618,CSE 293,002,119118,Bellare; Mihir,9999,0,9999,0
1668563255618,CSE 293,003,119122,Berg-Kirkpatrick; Taylor D,9999,0,9999,0
1668563255618,CSE 293,004,119135,Christensen; Henrik I,9999,0,9999,0
1668563255618,CSE 293,005,119142,Cottrell; Garrison W,9999,0,9999,0
1668563255618,CSE 293,006,119146,Deutsch; Alin Bernard,9999,0,9999,0
1668563255618,CSE 293,007,119159,Esmaeilzadeh; Hadi,9999,0,9999,0
1668563255618,CSE 293,008,119166,Freund; Yoav,9999,0,9999,0
1668563255618,CSE 293,009,119170,Griswold; William G.,9999,0,9999,0
1668563255618,CSE 293,010,119183,Gymrek; Melissa Ann,9999,0,9999,0
1668563255618,CSE 293,011,119190,Heninger; Nadia A,9999,0,9999,0
1668563255618,CSE 293,012,119230,Impagliazzo; Russell,9999,0,9999,0
1668563255618,CSE 293,013,119232,Jhala; Ranjit,9999,0,9999,0
1668563255618,CSE 293,014,119233,Kahng; Andrew Byun,9999,0,9999,0
1668563255618,CSE 293,015,119298,Kane; Daniel Mertz,9999,0,9999,0
1668563255618,CSE 293,016,119299,Kriegman; David J,9999,0,9999,0
1668563255618,CSE 293,017,119300,Kumar; Arun Kumar,9999,0,9999,0
1668563255618,CSE 293,018,119301,Lerner; Sorin,9999,0,9999,0
1668563255618,CSE 293,019,119302,Lovett; Shachar,9999,0,9999,0
1668563255618,CSE 293,020,119303,McAuley; Julian John,9999,0,9999,0
1668563255618,CSE 293,021,119304,Micciancio; Daniele,9999,0,9999,0
1668563255618,CSE 293,022,119367,Orailoglu; Alex,9999,0,9999,0
1668563255618,CSE 293,023,119382,Paturi; Ramamohan,9999,0,9999,0
1668563255618,CSE 293,024,119404,Polikarpova; Nadezhda,9999,0,9999,0
1668563255618,CSE 293,025,119406,Politz; Joseph Gibbs,9999,0,9999,0
1668563255618,CSE 293,026,119411,Porter; George M,9999,0,9999,0
1668563255618,CSE 293,027,119414,Porter; Leonard Emerson,9999,0,9999,0
1668563255618,CSE 293,028,119416,Ramamoorthi; Ravi,9999,0,9999,0
1668563255618,CSE 293,029,119417,Sahoo; Debashis,9999,0,9999,0
1668563255618,CSE 293,030,119420,Saul; Lawrence,9999,0,9999,0
1668563255618,CSE 293,031,119421,Savage; Stefan,9999,0,9999,0
1668563255618,CSE 293,032,119425,Schulze; Jurgen P.,9999,0,9999,0
1668563255618,CSE 293,033,119426,Snoeren; Alex C.,9999,0,9999,0
1668563255618,CSE 293,034,119428,Shang; Jingbo,9999,0,9999,0
1668563255618,CSE 293,035,119430,Stefan; Deian,9999,0,9999,0
1668563255618,CSE 293,036,119431,Su; Hao,9999,0,9999,0
1668563255618,CSE 293,037,119433,Swanson; Steven James,9999,0,9999,0
1668563255618,CSE 293,038,119435,Tullsen; Dean Michael,9999,0,9999,0
1668563255618,CSE 293,039,119483,Voelker; Geoffrey M.,9999,0,9999,0
1668563255618,CSE 293,040,119537,Zhao; Jishen,9999,0,9999,0
1668563255618,CSE 293,041,119538,Zhou; Yuan-Yuan,9999,0,9999,0
1668563255618,CSE 293,042,119539,Gao; Sicun,9999,0,9999,0
1668563255618,CSE 293,043,119540,Weibel; Nadir,9999,0,9999,0
1668563255618,CSE 293,044,119541,Gupta; Rajesh K.,9999,0,9999,0
1668563255618,CSE 293,045,126410,Vaccaro; Kristen Marie,9999,0,9999,0
1668563255618,CSE 293,046,126411,Klemke; Richard,9999,0,9999,0
1668563256041,CSE 294,A00,102459,Voelker; Geoffrey M.,0,2,0,0
1668563256041,CSE 294,B00,111322,Orailoglu; Alex,0,2,0,0
1668563256467,DSE 201,A00,096914,Deutsch; Alin Bernard,30,0,30,0
1668563256891,DSE 210,A00,096915,Dasgupta; Sanjoy,30,0,30,0
1668563257313,DSE 260A,A00,096916,Altintas De Callaf; Ilkay,30,0,30,0
1668563257752,ECE 200,001,103586,Antipa; Nicholas A,9999,0,9999,0
1668563257752,ECE 200,002,103587,Atanasov; Nikolay A.,9999,0,9999,0
1668563257752,ECE 200,003,103588,Bharadia; Dinesh,9999,0,9999,0
1668563257752,ECE 200,004,103589,Cheng; Chung Kuan,9999,0,9999,0
1668563257752,ECE 200,005,103590,Cosman; Pamela C.,9999,0,9999,0
1668563257752,ECE 200,006,103591,Dayeh; Shadi Ahmad,9999,0,9999,0
1668563257752,ECE 200,007,103592,Fainman; Yeshaiahu,9999,0,9999,0
1668563257752,ECE 200,008,103593,Ford; Joseph Earl,9999,0,9999,0
1668563257752,ECE 200,009,103594,Franceschetti; Massimo,9999,0,9999,0
1668563257752,ECE 200,010,103595,Fullerton; Eric E,9999,0,9999,0
1668563257752,ECE 200,011,103596,Galton; Ian A,9999,0,9999,0
1668563257752,ECE 200,012,103597,Gilja; Vikash,9999,0,9999,0
1668563257752,ECE 200,013,103598,Hall; Drew A.,9999,0,9999,0
1668563257752,ECE 200,014,103599,Hsueh; Tzu-Chien,9999,0,9999,0
1668563257752,ECE 200,015,103600,Javidi; Tara,9999,0,9999,0
1668563257752,ECE 200,016,103601,Kahng; Andrew Byun,9999,0,9999,0
1668563257752,ECE 200,017,103602,Kim; Young-Han,9999,0,9999,0
1668563257752,ECE 200,018,103603,Koushanfar; Farinaz,9999,0,9999,0
1668563257752,ECE 200,019,103604,Kuzum; Duygu,9999,0,9999,0
1668563257752,ECE 200,020,103605,Le; Hanh-Phuc,9999,0,9999,0
1668563257752,ECE 200,021,103606,Lin; Bill,9999,0,9999,0
1668563257752,ECE 200,022,103607,Liu; Zhaowei,9998,0,9999,1
1668563257752,ECE 200,023,103608,Lo; Yu-Hwa,9999,0,9999,0
1668563257752,ECE 200,024,103609,Lomakin; Vitaliy,9999,0,9999,0
1668563257752,ECE 200,025,103610,Mercier; Patrick Philip,9999,0,9999,0
1668563257752,ECE 200,026,103611,Meyer; Florian,9999,0,9999,0
1668563257752,ECE 200,027,103612,Milstein; Laurence B.,9999,0,9999,0
1668563257752,ECE 200,028,103613,Mir Arabbaygi; Siavash,9999,0,9999,0
1668563257752,ECE 200,029,103614,Mookherjea; Shayan,9999,0,9999,0
1668563257752,ECE 200,030,103615,Morris; Karcher William,9999,0,9999,0
1668563257752,ECE 200,031,103616,Ng; Tse Nga,9999,0,9999,0
1668563257752,ECE 200,032,103617,Nguyen; Truong Quang,9999,0,9999,0
1668563257752,ECE 200,033,103618,Nomura; Kenji,9999,0,9999,0
1668563257752,ECE 200,034,103619,Orlitsky; Alon,9999,0,9999,0
1668563257752,ECE 200,035,103620,Pal; Piya,9999,0,9999,0
1668563257752,ECE 200,036,103621,Papen; George C.,9999,0,9999,0
1668563257752,ECE 200,037,103622,Radic; Stojan,9999,0,9999,0
1668563257752,ECE 200,038,103623,Rao; Bhaskar D.,9999,0,9999,0
1668563257752,ECE 200,039,103624,Rao; Ramesh R,9999,0,9999,0
1668563257752,ECE 200,040,103625,Rebeiz; Gabriel,9999,0,9999,0
1668563257752,ECE 200,041,103626,Sanford; John R,9999,0,9999,0
1668563257752,ECE 200,042,103627,Siegel; Paul H.,9999,0,9999,0
1668563257752,ECE 200,043,103628,Sievenpiper; Daniel F.,9999,0,9999,0
1668563257752,ECE 200,044,103629,Sworder; David D.,9999,0,9999,0
1668563257752,ECE 200,045,103630,Taur; Yuan,9999,0,9999,0
1668563257752,ECE 200,046,103631,Touri; Behrouz,9999,0,9999,0
1668563257752,ECE 200,047,103632,Trivedi; Mohan M.,9999,0,9999,0
1668563257752,ECE 200,048,103633,Vasconcelos; Nuno,9999,0,9999,0
1668563257752,ECE 200,049,103634,Wang; Xiaolong,9999,0,9999,0
1668563257752,ECE 200,050,103635,Xie; Pengtao,9999,0,9999,0
1668563257752,ECE 200,051,103636,Yip; Michael,9999,0,9999,0
1668563257752,ECE 200,052,103637,Zeger; Kenneth A.,999,0,999,0
1668563257752,ECE 200,053,103638,Zhang; Xinyu,9999,0,9999,0
1668563257752,ECE 200,054,103639,Turakhia; Yatish Girish,9999,0,9999,0
1668563257752,ECE 200,055,103640,Kang; Mingu,9999,0,9999,0
1668563257752,ECE 200,056,103641,Shi; Yuanyuan,9999,0,9999,0
1668563257752,ECE 200,057,103642,Wang; Edward Jay,9999,0,9999,0
1668563257752,ECE 200,058,103643,Zheng; Yang,9999,0,9999,0
1668563258178,ECE 202,A00,103644,Kuzum; Duygu,0,46,0,0
1668563258602,ECE 212BN,A00,103646,Ng; Tse Nga,0,9,0,0
1668563259027,ECE 221,A00,111493,Staff,0,0,0,0
1668563259449,ECE 222B,A00,103647,Lomakin; Vitaliy,0,21,0,0
1668563259874,ECE 230B,A00,103648,Taur; Yuan,0,4,0,0
1668563260300,ECE 238B,A00,103649,Garay; Javier,0,0,0,0
1668563260725,ECE 240B,A00,112900,Fainman; Yeshaiahu,0,8,0,0
1668563261151,ECE 247A,A00,103650,Jokerst; Jesse Vincent,0,6,0,0
1668563261582,ECE 247B,A00,103651,Wang; Joseph,0,14,0,0
1668563262012,ECE 250,A00,103652,Siegel; Paul H.,0,85,0,0
1668563262452,ECE 251A,A00,103654,Rao; Bhaskar D.,0,64,0,0
1668563262875,ECE 257B,A00,103655,Bharadia; Dinesh,0,33,0,0
1668563263310,ECE 258A,A00,103656,Milstein; Laurence B.,0,29,0,0
1668563263740,ECE 260B,A00,103658,Kang; Mingu,0,121,0,0
1668563264163,ECE 264A,A00,103659,Galton; Ian A,0,47,0,27
1668563264586,ECE 265A,A00,103661,Gudem; Prasad S.S.,0,48,0,27
1668563265013,ECE 265D,A00,103662,Gudem; Prasad S.S.,0,27,0,0
1668563265440,ECE 268,A00,103663,Koushanfar; Farinaz,0,44,0,0
1668563265865,ECE 269,A01,103665,Pal; Piya,0,222,0,0
1668563266293,ECE 271B,A00,103666,Vasconcelos; Manuela,0,78,0,0
1668563266806,ECE 276A,A00,103667,Atanasov; Nikolay A.,0,127,0,0
1668563267234,ECE 277,A00,103668,An; Cheolhong,0,151,0,0
1668563267656,ECE 279,A00,117947,Hall; Drew A.,0,22,0,0
1668563268519,ECE 283,A00,103670,Hsueh; Tzu-Chien,0,57,0,0
1668563268943,ECE 284,A00,103671,Turakhia; Yatish Girish,0,41,0,0
1668563269372,ECE 285,A00,103672,Zheng; Yang,0,41,0,0
1668563269372,ECE 285,B00,103673,Sworder; David D.,0,61,0,0
1668563269800,ECE 287,A00,103676,Javidi; Tara,0,8,0,0
1668563270232,MATH 200B,A00,098023,Salehi Golsefidy; Alireza,7,0,15,8
1668563270657,MATH 202B,A00,098024,Rhoades; Brendon Patrick,7,0,15,8
1668563271083,MATH 203B,A00,098025,Oprea; Dragos N.,9,0,15,6
1668563271508,MATH 204B,A00,098026,Sorensen; Claus M,13,0,15,2
1668563271934,MATH 208,A00,098027,Izadi; Elham,7,0,10,3
1668563272377,MATH 209,A00,098028,Pollack; Aaron,10,0,10,0
1668563272800,MATH 211A,A00,112919,Rogalski; Daniel,8,0,10,2
1668563273235,MATH 211B,A00,112920,Seward; Brandon M.,9,0,10,1
1668563273665,MATH 218,A00,098029,Li; Bo,10,0,10,0
1668563274087,MATH 220B,A00,098030,Novak; Jonathan I,10,0,15,5
1668563274511,MATH 221A,A00,098031,Ebenfelt; Peter F,12,0,15,3
1668563274938,MATH 231B,A00,098032,Zlatos; Andrej,9,0,15,6
1668563275361,MATH 240B,A00,098033,Ni; Lei,7,0,15,8
1668563275786,MATH 243,A00,098034,Jekel; David Andrew,10,0,10,0
1668563276209,MATH 245A,A00,098035,Nie; Jiawang,0,7,15,18
1668563276644,MATH 248,A00,098036,Bejenaru; Ioan,10,0,10,0
1668563277073,MATH 250B,A00,098037,Spolaor; Luca,12,0,15,3
1668563277510,MATH 258,A00,098038,Ni; Lei,8,0,10,2
1668563277931,MATH 264B,A00,098041,Rhoades; Brendon Patrick,7,0,15,8
1668563278365,MATH 268,A00,098042,Buss; Samuel R,10,0,10,0
1668563278787,MATH 269,A00,098043,Rhoades; Brendon Patrick,10,0,10,0
1668563279212,MATH 270B,A00,098044,Li; Bo,6,0,15,9
1668563279637,MATH 272B,A00,098045,Holst; Michael J,13,0,15,2
1668563280065,MATH 273A,A00,098046,Tian; Xiaochuan,10,0,15,5
1668563280493,MATH 275,A01,098048,Tian; Xiaochuan,6,0,10,4
1668563280914,MATH 278A,A00,098049,Holst; Michael J,6,0,10,4
1668563281338,MATH 278B,A00,098050,Cloninger; Alexander,10,0,10,0
1668563281762,MATH 278C,A00,098051,Nie; Jiawang,5,0,10,5
1668563282187,MATH 280B,A00,098052,Zheng; Tianyi,6,0,15,9
1668563282616,MATH 281B,A00,098053,Bradic; Jelena,0,2,15,15
1668563283040,MATH 282B,A00,098054,Arias-Castro; Ery,0,1,15,15
1668563283464,MATH 285,A00,098055,Fitzsimmons; Patrick J,0,4,15,17
1668563283886,MATH 287B,A00,098056,Arias-Castro; Ery,1,0,15,14
1668563284311,MATH 288,A00,098057,Agarwal; Pooja,9,0,10,1
1668563284311,MATH 288,B00,098058,Zhang; Danna,8,0,10,2
1668563284311,MATH 288,C00,098059,Williams; Ruth J,9,0,10,1
1668563284736,MATH 290B,A00,098060,Roberts; Justin Deritter,11,0,15,4
1668563285160,MATH 292,A00,098061,Belmont; Eva Kinoshita,10,0,10,0
1668563285585,MATH 295,A00,098062,Suk; Andrew Hoon,47,0,50,3
1668563286015,MATH 296,A00,098063,Novak; Jonathan I,20,0,20,0
1668563286448,MATH 297,001,098064,Gamst; Anthony Collins,9997,0,9999,2
1668563789061,COGS 205,A00,101395,Chiba; Andrea,19,0,20,1
1668563789494,COGS 210B,001,101404,Greene; Deanna Jacquelyn,9998,0,9999,1
1668563789494,COGS 210B,002,101417,Xia; Haijun,9999,0,9999,0
1668563789494,COGS 210B,003,101422,Nitz; Douglas A.,9999,0,9999,0
1668563789494,COGS 210B,004,101423,Hollan; James D.,9998,0,9999,1
1668563789494,COGS 210B,005,101424,Deak; Gedeon O.,9998,0,9999,1
1668563789494,COGS 210B,006,101425,Rossano; Federico,9999,0,9999,0
1668563789917,COGS 211B,A00,101427,Coulson; Seana M,9996,0,9999,3
1668563790349,COGS 220,A00,101428,Hollan; James D.,0,17,25,25
1668563790775,COGS 229,A00,101429,Dow; Steven P,17,0,25,8
1668563791202,COGS 230,A00,101430,Klemmer; Scott R,6,0,17,11
1668563791625,COGS 234,A00,101431,Xia; Haijun,0,1,25,25
1668563792046,COGS 260,A00,101432,Kiyonaga; Anastasia,21,0,25,4
1668563792046,COGS 260,B00,101433,Kirsh; David Joel,15,0,25,10
1668563792471,CSE 202,A00,102371,Impagliazzo; Russell,0,70,0,0
1668563792893,CSE 203B,A01,102373,Cheng; Chung Kuan,0,67,0,0
1668563793319,CSE 208,A00,102374,Micciancio; Daniele,0,5,0,0
1668563793761,CSE 209A,A00,112895,Impagliazzo; Russell,0,14,15,15
1668563794198,CSE 209B,A00,108005,Bellare; Mihir,0,7,0,0
1668563794629,CSE 210,A00,113163,Coblenz; Michael J,0,93,0,0
1668563795053,CSE 219,A00,106111,Dow; Steven P,0,8,20,20
1668563795485,CSE 221,A00,102376,Voelker; Geoffrey M.,0,76,0,0
1668563795908,CSE 224,A01,102378,Porter; George M,0,177,0,0
1668563796331,CSE 229A,A00,102379,Savage; Stefan,0,12,0,0
1668563796758,CSE 229C,A00,102380,Munyaka; Imani N. S.,0,10,0,0
1668563797185,CSE 232B,A00,102382,Deutsch; Alin Bernard,0,39,0,0
1668563797611,CSE 234,A01,112904,Kumar; Arun Kumar,0,0,0,0
1668563798042,CSE 237A,A00,102383,Rosing; Tajana Simunic,0,57,0,0
1668563798468,CSE 239A,A00,102384,Deutsch; Alin Bernard,0,16,0,0
1668563798892,CSE 239B,A00,102385,Polikarpova; Nadezhda,0,11,0,0
1668563799317,CSE 240A,A00,102386,Pannuto; Patrick William,0,48,0,0
1668563799739,CSE 240B,A00,102387,Zhao; Jishen,0,51,0,0
1668563800164,CSE 241A,A00,106406,Kang; Mingu,0,9,0,0
1668563800588,CSE 249B,A00,102388,Kahng; Andrew Byun,0,5,8,8
1668563801021,CSE 251B,A01,102392,Cottrell; Garrison W,0,53,0,0
1668563801021,CSE 251B,A02,102393,Cottrell; Garrison W,0,35,0,0
1668563801445,CSE 252B,A00,102394,Ochoa; Benjamin Lawrence,0,64,0,0
1668563801869,CSE 257,A01,102396,Gao; Sicun,0,155,0,0
1668563802303,CSE 272,A00,102397,Li; Tzumao,0,22,0,0
1668563802724,CSE 274,A00,111323,Chern; Albert Ren-Haur,0,16,0,0
1668563803147,CSE 282,A00,102398,Pevzner; Pavel Arkadjevich,0,0,0,0
1668563803574,CSE 284,A00,114175,Gymrek; Melissa Ann,0,30,0,0
1668563803997,CSE 290,A00,102399,Chandraker; Manmohan Krishna,0,11,0,0
1668563803997,CSE 290,B00,102400,Vaccaro; Kristen Marie,0,8,25,25
1668563803997,CSE 290,C00,102414,Pannuto; Patrick William,0,1,25,25
1668563803997,CSE 290,D00,102427,Pevzner; Pavel Arkadjevich,0,0,0,0
1668563803997,CSE 290,E00,102429,Zhao; Jishen,0,6,0,0
1668563803997,CSE 290,F00,102436,Tullsen; Dean Michael,0,6,0,0
1668563803997,CSE 290,G00,102440,Christensen; Henrik I,0,7,20,20
1668563804425,CSE 291,A00,102443,Su; Hao,0,0,0,0
1668563804425,CSE 291,B00,102448,Polikarpova; Nadezhda,0,0,0,0
1668563804425,CSE 291,C00,102453,Vaccaro; Kristen Marie,0,0,0,0
1668563804425,CSE 291,D00,111343,Savage; Stefan,0,0,0,0
1668563804425,CSE 291,E00,116474,Claffy; Kimberly Claire,0,0,0,0
1668563804425,CSE 291,F00,116479,Pasquale; Joseph,0,0,0,0
1668563804857,CSE 293,001,119111,Bafna; Vineet,9999,0,9999,0
1668563804857,CSE 293,002,119118,Bellare; Mihir,9999,0,9999,0
1668563804857,CSE 293,003,119122,Berg-Kirkpatrick; Taylor D,9999,0,9999,0
1668563804857,CSE 293,004,119135,Christensen; Henrik I,9999,0,9999,0
1668563804857,CSE 293,005,119142,Cottrell; Garrison W,9999,0,9999,0
1668563804857,CSE 293,006,119146,Deutsch; Alin Bernard,9999,0,9999,0
1668563804857,CSE 293,007,119159,Esmaeilzadeh; Hadi,9999,0,9999,0
1668563804857,CSE 293,008,119166,Freund; Yoav,9999,0,9999,0
1668563804857,CSE 293,009,119170,Griswold; William G.,9999,0,9999,0
1668563804857,CSE 293,010,119183,Gymrek; Melissa Ann,9999,0,9999,0
1668563804857,CSE 293,011,119190,Heninger; Nadia A,9999,0,9999,0
1668563804857,CSE 293,012,119230,Impagliazzo; Russell,9999,0,9999,0
1668563804857,CSE 293,013,119232,Jhala; Ranjit,9999,0,9999,0
1668563804857,CSE 293,014,119233,Kahng; Andrew Byun,9999,0,9999,0
1668563804857,CSE 293,015,119298,Kane; Daniel Mertz,9999,0,9999,0
1668563804857,CSE 293,016,119299,Kriegman; David J,9999,0,9999,0
1668563804857,CSE 293,017,119300,Kumar; Arun Kumar,9999,0,9999,0
1668563804857,CSE 293,018,119301,Lerner; Sorin,9999,0,9999,0
1668563804857,CSE 293,019,119302,Lovett; Shachar,9999,0,9999,0
1668563804857,CSE 293,020,119303,McAuley; Julian John,9999,0,9999,0
1668563804857,CSE 293,021,119304,Micciancio; Daniele,9999,0,9999,0
1668563804857,CSE 293,022,119367,Orailoglu; Alex,9999,0,9999,0
1668563804857,CSE 293,023,119382,Paturi; Ramamohan,9999,0,9999,0
1668563804857,CSE 293,024,119404,Polikarpova; Nadezhda,9999,0,9999,0
1668563804857,CSE 293,025,119406,Politz; Joseph Gibbs,9999,0,9999,0
1668563804857,CSE 293,026,119411,Porter; George M,9999,0,9999,0
1668563804857,CSE 293,027,119414,Porter; Leonard Emerson,9999,0,9999,0
1668563804857,CSE 293,028,119416,Ramamoorthi; Ravi,9999,0,9999,0
1668563804857,CSE 293,029,119417,Sahoo; Debashis,9999,0,9999,0
1668563804857,CSE 293,030,119420,Saul; Lawrence,9999,0,9999,0
1668563804857,CSE 293,031,119421,Savage; Stefan,9999,0,9999,0
1668563804857,CSE 293,032,119425,Schulze; Jurgen P.,9999,0,9999,0
1668563804857,CSE 293,033,119426,Snoeren; Alex C.,9999,0,9999,0
1668563804857,CSE 293,034,119428,Shang; Jingbo,9999,0,9999,0
1668563804857,CSE 293,035,119430,Stefan; Deian,9999,0,9999,0
1668563804857,CSE 293,036,119431,Su; Hao,9999,0,9999,0
1668563804857,CSE 293,037,119433,Swanson; Steven James,9999,0,9999,0
1668563804857,CSE 293,038,119435,Tullsen; Dean Michael,9999,0,9999,0
1668563804857,CSE 293,039,119483,Voelker; Geoffrey M.,9999,0,9999,0
1668563804857,CSE 293,040,119537,Zhao; Jishen,9999,0,9999,0
1668563804857,CSE 293,041,119538,Zhou; Yuan-Yuan,9999,0,9999,0
1668563804857,CSE 293,042,119539,Gao; Sicun,9999,0,9999,0
1668563804857,CSE 293,043,119540,Weibel; Nadir,9999,0,9999,0
1668563804857,CSE 293,044,119541,Gupta; Rajesh K.,9999,0,9999,0
1668563804857,CSE 293,045,126410,Vaccaro; Kristen Marie,9999,0,9999,0
1668563804857,CSE 293,046,126411,Klemke; Richard,9999,0,9999,0
1668563805281,CSE 294,A00,102459,Voelker; Geoffrey M.,0,2,0,0
1668563805281,CSE 294,B00,111322,Orailoglu; Alex,0,2,0,0
1668563805711,DSE 201,A00,096914,Deutsch; Alin Bernard,30,0,30,0
1668563806154,DSE 210,A00,096915,Dasgupta; Sanjoy,30,0,30,0
1668563806579,DSE 260A,A00,096916,Altintas De Callaf; Ilkay,30,0,30,0
1668563807018,ECE 200,001,103586,Antipa; Nicholas A,9999,0,9999,0
1668563807018,ECE 200,002,103587,Atanasov; Nikolay A.,9999,0,9999,0
1668563807018,ECE 200,003,103588,Bharadia; Dinesh,9999,0,9999,0
1668563807018,ECE 200,004,103589,Cheng; Chung Kuan,9999,0,9999,0
1668563807018,ECE 200,005,103590,Cosman; Pamela C.,9999,0,9999,0
1668563807018,ECE 200,006,103591,Dayeh; Shadi Ahmad,9999,0,9999,0
1668563807018,ECE 200,007,103592,Fainman; Yeshaiahu,9999,0,9999,0
1668563807018,ECE 200,008,103593,Ford; Joseph Earl,9999,0,9999,0
1668563807018,ECE 200,009,103594,Franceschetti; Massimo,9999,0,9999,0
1668563807018,ECE 200,010,103595,Fullerton; Eric E,9999,0,9999,0
1668563807018,ECE 200,011,103596,Galton; Ian A,9999,0,9999,0
1668563807018,ECE 200,012,103597,Gilja; Vikash,9999,0,9999,0
1668563807018,ECE 200,013,103598,Hall; Drew A.,9999,0,9999,0
1668563807018,ECE 200,014,103599,Hsueh; Tzu-Chien,9999,0,9999,0
1668563807018,ECE 200,015,103600,Javidi; Tara,9999,0,9999,0
1668563807018,ECE 200,016,103601,Kahng; Andrew Byun,9999,0,9999,0
1668563807018,ECE 200,017,103602,Kim; Young-Han,9999,0,9999,0
1668563807018,ECE 200,018,103603,Koushanfar; Farinaz,9999,0,9999,0
1668563807018,ECE 200,019,103604,Kuzum; Duygu,9999,0,9999,0
1668563807018,ECE 200,020,103605,Le; Hanh-Phuc,9999,0,9999,0
1668563807018,ECE 200,021,103606,Lin; Bill,9999,0,9999,0
1668563807018,ECE 200,022,103607,Liu; Zhaowei,9998,0,9999,1
1668563807018,ECE 200,023,103608,Lo; Yu-Hwa,9999,0,9999,0
1668563807018,ECE 200,024,103609,Lomakin; Vitaliy,9999,0,9999,0
1668563807018,ECE 200,025,103610,Mercier; Patrick Philip,9999,0,9999,0
1668563807018,ECE 200,026,103611,Meyer; Florian,9999,0,9999,0
1668563807018,ECE 200,027,103612,Milstein; Laurence B.,9999,0,9999,0
1668563807018,ECE 200,028,103613,Mir Arabbaygi; Siavash,9999,0,9999,0
1668563807018,ECE 200,029,103614,Mookherjea; Shayan,9999,0,9999,0
1668563807018,ECE 200,030,103615,Morris; Karcher William,9999,0,9999,0
1668563807018,ECE 200,031,103616,Ng; Tse Nga,9999,0,9999,0
1668563807018,ECE 200,032,103617,Nguyen; Truong Quang,9999,0,9999,0
1668563807018,ECE 200,033,103618,Nomura; Kenji,9999,0,9999,0
1668563807018,ECE 200,034,103619,Orlitsky; Alon,9999,0,9999,0
1668563807018,ECE 200,035,103620,Pal; Piya,9999,0,9999,0
1668563807018,ECE 200,036,103621,Papen; George C.,9999,0,9999,0
1668563807018,ECE 200,037,103622,Radic; Stojan,9999,0,9999,0
1668563807018,ECE 200,038,103623,Rao; Bhaskar D.,9999,0,9999,0
1668563807018,ECE 200,039,103624,Rao; Ramesh R,9999,0,9999,0
1668563807018,ECE 200,040,103625,Rebeiz; Gabriel,9999,0,9999,0
1668563807018,ECE 200,041,103626,Sanford; John R,9999,0,9999,0
1668563807018,ECE 200,042,103627,Siegel; Paul H.,9999,0,9999,0
1668563807018,ECE 200,043,103628,Sievenpiper; Daniel F.,9999,0,9999,0
1668563807018,ECE 200,044,103629,Sworder; David D.,9999,0,9999,0
1668563807018,ECE 200,045,103630,Taur; Yuan,9999,0,9999,0
1668563807018,ECE 200,046,103631,Touri; Behrouz,9999,0,9999,0
1668563807018,ECE 200,047,103632,Trivedi; Mohan M.,9999,0,9999,0
1668563807018,ECE 200,048,103633,Vasconcelos; Nuno,9999,0,9999,0
1668563807018,ECE 200,049,103634,Wang; Xiaolong,9999,0,9999,0
1668563807018,ECE 200,050,103635,Xie; Pengtao,9999,0,9999,0
1668563807018,ECE 200,051,103636,Yip; Michael,9999,0,9999,0
1668563807018,ECE 200,052,103637,Zeger; Kenneth A.,999,0,999,0
1668563807018,ECE 200,053,103638,Zhang; Xinyu,9999,0,9999,0
1668563807018,ECE 200,054,103639,Turakhia; Yatish Girish,9999,0,9999,0
1668563807018,ECE 200,055,103640,Kang; Mingu,9999,0,9999,0
1668563807018,ECE 200,056,103641,Shi; Yuanyuan,9999,0,9999,0
1668563807018,ECE 200,057,103642,Wang; Edward Jay,9999,0,9999,0
1668563807018,ECE 200,058,103643,Zheng; Yang,9999,0,9999,0
1668563807442,ECE 202,A00,103644,Kuzum; Duygu,0,46,0,0
1668563807867,ECE 212BN,A00,103646,Ng; Tse Nga,0,9,0,0
1668563808290,ECE 221,A00,111493,Staff,0,0,0,0
1668563808712,ECE 222B,A00,103647,Lomakin; Vitaliy,0,21,0,0
1668563809135,ECE 230B,A00,103648,Taur; Yuan,0,4,0,0
1668563809561,ECE 238B,A00,103649,Garay; Javier,0,0,0,0
1668563809985,ECE 240B,A00,112900,Fainman; Yeshaiahu,0,8,0,0
1668563810409,ECE 247A,A00,103650,Jokerst; Jesse Vincent,0,6,0,0
1668563810832,ECE 247B,A00,103651,Wang; Joseph,0,14,0,0
1668563811260,ECE 250,A00,103652,Siegel; Paul H.,0,85,0,0
1668563811684,ECE 251A,A00,103654,Rao; Bhaskar D.,0,64,0,0
1668563812115,ECE 257B,A00,103655,Bharadia; Dinesh,0,33,0,0
1668563812538,ECE 258A,A00,103656,Milstein; Laurence B.,0,29,0,0
1668563812961,ECE 260B,A00,103658,Kang; Mingu,0,121,0,0
1668563813389,ECE 264A,A00,103659,Galton; Ian A,0,47,0,28
1668563813818,ECE 265A,A00,103661,Gudem; Prasad S.S.,0,48,0,28
1668563814248,ECE 265D,A00,103662,Gudem; Prasad S.S.,0,27,0,0
1668563814674,ECE 268,A00,103663,Koushanfar; Farinaz,0,44,0,0
1668563815101,ECE 269,A01,103665,Pal; Piya,0,222,0,0
1668563815539,ECE 271B,A00,103666,Vasconcelos; Manuela,0,78,0,0
1668563815964,ECE 276A,A00,103667,Atanasov; Nikolay A.,0,126,0,0
1668563816390,ECE 277,A00,103668,An; Cheolhong,0,151,0,0
1668563816814,ECE 279,A00,117947,Hall; Drew A.,0,22,0,0
1668563817665,ECE 283,A00,103670,Hsueh; Tzu-Chien,0,57,0,0
1668563818088,ECE 284,A00,103671,Turakhia; Yatish Girish,0,41,0,0
1668563818526,ECE 285,A00,103672,Zheng; Yang,0,41,0,0
1668563818526,ECE 285,B00,103673,Sworder; David D.,0,61,0,0
1668563818950,ECE 287,A00,103676,Javidi; Tara,0,8,0,0
1668563819375,MATH 200B,A00,098023,Salehi Golsefidy; Alireza,7,0,15,8
1668563819797,MATH 202B,A00,098024,Rhoades; Brendon Patrick,7,0,15,8
1668563820225,MATH 203B,A00,098025,Oprea; Dragos N.,9,0,15,6
1668563820651,MATH 204B,A00,098026,Sorensen; Claus M,13,0,15,2
1668563821077,MATH 208,A00,098027,Izadi; Elham,7,0,10,3
1668563821501,MATH 209,A00,098028,Pollack; Aaron,10,0,10,0
1668563821939,MATH 211A,A00,112919,Rogalski; Daniel,8,0,10,2
1668563822380,MATH 211B,A00,112920,Seward; Brandon M.,9,0,10,1
1668563822804,MATH 218,A00,098029,Li; Bo,10,0,10,0
1668563823231,MATH 220B,A00,098030,Novak; Jonathan I,10,0,15,5
1668563823656,MATH 221A,A00,098031,Ebenfelt; Peter F,12,0,15,3
1668563824078,MATH 231B,A00,098032,Zlatos; Andrej,9,0,15,6
1668563824507,MATH 240B,A00,098033,Ni; Lei,7,0,15,8
1668563824930,MATH 243,A00,098034,Jekel; David Andrew,10,0,10,0
1668563825372,MATH 245A,A00,098035,Nie; Jiawang,0,7,15,18
1668563825804,MATH 248,A00,098036,Bejenaru; Ioan,10,0,10,0
1668563826228,MATH 250B,A00,098037,Spolaor; Luca,12,0,15,3
1668563826666,MATH 258,A00,098038,Ni; Lei,8,0,10,2
1668563827100,MATH 264B,A00,098041,Rhoades; Brendon Patrick,7,0,15,8
1668563827526,MATH 268,A00,098042,Buss; Samuel R,10,0,10,0
1668563827948,MATH 269,A00,098043,Rhoades; Brendon Patrick,10,0,10,0
1668563828387,MATH 270B,A00,098044,Li; Bo,6,0,15,9
1668563828813,MATH 272B,A00,098045,Holst; Michael J,13,0,15,2
1668563829236,MATH 273A,A00,098046,Tian; Xiaochuan,10,0,15,5
1668563829662,MATH 275,A01,098048,Tian; Xiaochuan,6,0,10,4
1668563830091,MATH 278A,A00,098049,Holst; Michael J,6,0,10,4
1668563830517,MATH 278B,A00,098050,Cloninger; Alexander,10,0,10,0
1668563831015,MATH 278C,A00,098051,Nie; Jiawang,5,0,10,5
1668563831439,MATH 280B,A00,098052,Zheng; Tianyi,6,0,15,9
1668563831862,MATH 281B,A00,098053,Bradic; Jelena,0,2,15,15
1668563832287,MATH 282B,A00,098054,Arias-Castro; Ery,0,1,15,15
1668563832710,MATH 285,A00,098055,Fitzsimmons; Patrick J,0,4,15,17
1668563833134,MATH 287B,A00,098056,Arias-Castro; Ery,1,0,15,14
1668563833556,MATH 288,A00,098057,Agarwal; Pooja,9,0,10,1
1668563833556,MATH 288,B00,098058,Zhang; Danna,8,0,10,2
1668563833556,MATH 288,C00,098059,Williams; Ruth J,9,0,10,1
1668563833985,MATH 290B,A00,098060,Roberts; Justin Deritter,11,0,15,4
1668563834409,MATH 292,A00,098061,Belmont; Eva Kinoshita,10,0,10,0
1668563834834,MATH 295,A00,098062,Suk; Andrew Hoon,47,0,50,3
1668563835260,MATH 296,A00,098063,Novak; Jonathan I,20,0,20,0
1668563835686,MATH 297,001,098064,Gamst; Anthony Collins,9997,0,9999,2
1668564338803,COGS 205,A00,101395,Chiba; Andrea,19,0,20,1
1668564339227,COGS 210B,001,101404,Greene; Deanna Jacquelyn,9998,0,9999,1
1668564339227,COGS 210B,002,101417,Xia; Haijun,9999,0,9999,0
1668564339227,COGS 210B,003,101422,Nitz; Douglas A.,9999,0,9999,0
1668564339227,COGS 210B,004,101423,Hollan; James D.,9998,0,9999,1
1668564339227,COGS 210B,005,101424,Deak; Gedeon O.,9998,0,9999,1
1668564339227,COGS 210B,006,101425,Rossano; Federico,9999,0,9999,0
1668564339656,COGS 211B,A00,101427,Coulson; Seana M,9996,0,9999,3
1668564340086,COGS 220,A00,101428,Hollan; James D.,0,17,25,25
1668564340509,COGS 229,A00,101429,Dow; Steven P,17,0,25,8
1668564340934,COGS 230,A00,101430,Klemmer; Scott R,6,0,17,11
1668564341361,COGS 234,A00,101431,Xia; Haijun,0,1,25,25
1668564341783,COGS 260,A00,101432,Kiyonaga; Anastasia,21,0,25,4
1668564341783,COGS 260,B00,101433,Kirsh; David Joel,15,0,25,10
1668564342218,CSE 202,A00,102371,Impagliazzo; Russell,0,70,0,0
1668564342656,CSE 203B,A01,102373,Cheng; Chung Kuan,0,67,0,0
1668564343083,CSE 208,A00,102374,Micciancio; Daniele,0,5,0,0
1668564343512,CSE 209A,A00,112895,Impagliazzo; Russell,0,14,15,15
1668564343934,CSE 209B,A00,108005,Bellare; Mihir,0,7,0,0
1668564344358,CSE 210,A00,113163,Coblenz; Michael J,0,93,0,0
1668564344782,CSE 219,A00,106111,Dow; Steven P,0,8,20,20
1668564345216,CSE 221,A00,102376,Voelker; Geoffrey M.,0,76,0,0
1668564345642,CSE 224,A01,102378,Porter; George M,0,177,0,0
1668564346073,CSE 229A,A00,102379,Savage; Stefan,0,12,0,0
1668564346499,CSE 229C,A00,102380,Munyaka; Imani N. S.,0,10,0,0
1668564346926,CSE 232B,A00,102382,Deutsch; Alin Bernard,0,39,0,0
1668564347356,CSE 234,A01,112904,Kumar; Arun Kumar,0,0,0,0
1668564347783,CSE 237A,A00,102383,Rosing; Tajana Simunic,0,57,0,0
1668564348211,CSE 239A,A00,102384,Deutsch; Alin Bernard,0,16,0,0
1668564348635,CSE 239B,A00,102385,Polikarpova; Nadezhda,0,11,0,0
1668564349068,CSE 240A,A00,102386,Pannuto; Patrick William,0,48,0,0
1668564349491,CSE 240B,A00,102387,Zhao; Jishen,0,51,0,0
1668564349921,CSE 241A,A00,106406,Kang; Mingu,0,9,0,0
1668564350360,CSE 249B,A00,102388,Kahng; Andrew Byun,0,5,8,8
1668564350784,CSE 251B,A01,102392,Cottrell; Garrison W,0,53,0,0
1668564350784,CSE 251B,A02,102393,Cottrell; Garrison W,0,35,0,0
1668564351213,CSE 252B,A00,102394,Ochoa; Benjamin Lawrence,0,64,0,0
1668564351650,CSE 257,A01,102396,Gao; Sicun,0,155,0,0
1668564352076,CSE 272,A00,102397,Li; Tzumao,0,22,0,0
1668564352591,CSE 274,A00,111323,Chern; Albert Ren-Haur,0,16,0,0
1668564353032,CSE 282,A00,102398,Pevzner; Pavel Arkadjevich,0,0,0,0
1668564353469,CSE 284,A00,114175,Gymrek; Melissa Ann,0,30,0,0
1668564353891,CSE 290,A00,102399,Chandraker; Manmohan Krishna,0,11,0,0
1668564353891,CSE 290,B00,102400,Vaccaro; Kristen Marie,0,8,25,25
1668564353891,CSE 290,C00,102414,Pannuto; Patrick William,0,1,25,25
1668564353891,CSE 290,D00,102427,Pevzner; Pavel Arkadjevich,0,0,0,0
1668564353891,CSE 290,E00,102429,Zhao; Jishen,0,6,0,0
1668564353891,CSE 290,F00,102436,Tullsen; Dean Michael,0,6,0,0
1668564353891,CSE 290,G00,102440,Christensen; Henrik I,0,7,20,20
1668564354321,CSE 291,A00,102443,Su; Hao,0,0,0,0
1668564354321,CSE 291,B00,102448,Polikarpova; Nadezhda,0,0,0,0
1668564354321,CSE 291,C00,102453,Vaccaro; Kristen Marie,0,0,0,0
1668564354321,CSE 291,D00,111343,Savage; Stefan,0,0,0,0
1668564354321,CSE 291,E00,116474,Claffy; Kimberly Claire,0,0,0,0
1668564354321,CSE 291,F00,116479,Pasquale; Joseph,0,0,0,0
1668564354780,CSE 293,001,119111,Bafna; Vineet,9999,0,9999,0
1668564354780,CSE 293,002,119118,Bellare; Mihir,9999,0,9999,0
1668564354780,CSE 293,003,119122,Berg-Kirkpatrick; Taylor D,9999,0,9999,0
1668564354780,CSE 293,004,119135,Christensen; Henrik I,9999,0,9999,0
1668564354780,CSE 293,005,119142,Cottrell; Garrison W,9999,0,9999,0
1668564354780,CSE 293,006,119146,Deutsch; Alin Bernard,9999,0,9999,0
1668564354780,CSE 293,007,119159,Esmaeilzadeh; Hadi,9999,0,9999,0
1668564354780,CSE 293,008,119166,Freund; Yoav,9999,0,9999,0
1668564354780,CSE 293,009,119170,Griswold; William G.,9999,0,9999,0
1668564354780,CSE 293,010,119183,Gymrek; Melissa Ann,9999,0,9999,0
1668564354780,CSE 293,011,119190,Heninger; Nadia A,9999,0,9999,0
1668564354780,CSE 293,012,119230,Impagliazzo; Russell,9999,0,9999,0
1668564354780,CSE 293,013,119232,Jhala; Ranjit,9999,0,9999,0
1668564354780,CSE 293,014,119233,Kahng; Andrew Byun,9999,0,9999,0
1668564354780,CSE 293,015,119298,Kane; Daniel Mertz,9999,0,9999,0
1668564354780,CSE 293,016,119299,Kriegman; David J,9999,0,9999,0
1668564354780,CSE 293,017,119300,Kumar; Arun Kumar,9999,0,9999,0
1668564354780,CSE 293,018,119301,Lerner; Sorin,9999,0,9999,0
1668564354780,CSE 293,019,119302,Lovett; Shachar,9999,0,9999,0
1668564354780,CSE 293,020,119303,McAuley; Julian John,9999,0,9999,0
1668564354780,CSE 293,021,119304,Micciancio; Daniele,9999,0,9999,0
1668564354780,CSE 293,022,119367,Orailoglu; Alex,9999,0,9999,0
1668564354780,CSE 293,023,119382,Paturi; Ramamohan,9999,0,9999,0
1668564354780,CSE 293,024,119404,Polikarpova; Nadezhda,9999,0,9999,0
1668564354780,CSE 293,025,119406,Politz; Joseph Gibbs,9999,0,9999,0
1668564354780,CSE 293,026,119411,Porter; George M,9999,0,9999,0
1668564354780,CSE 293,027,119414,Porter; Leonard Emerson,9999,0,9999,0
1668564354780,CSE 293,028,119416,Ramamoorthi; Ravi,9999,0,9999,0
1668564354780,CSE 293,029,119417,Sahoo; Debashis,9999,0,9999,0
1668564354780,CSE 293,030,119420,Saul; Lawrence,9999,0,9999,0
1668564354780,CSE 293,031,119421,Savage; Stefan,9999,0,9999,0
1668564354780,CSE 293,032,119425,Schulze; Jurgen P.,9999,0,9999,0
1668564354780,CSE 293,033,119426,Snoeren; Alex C.,9999,0,9999,0
1668564354780,CSE 293,034,119428,Shang; Jingbo,9999,0,9999,0
1668564354780,CSE 293,035,119430,Stefan; Deian,9999,0,9999,0
1668564354780,CSE 293,036,119431,Su; Hao,9999,0,9999,0
1668564354780,CSE 293,037,119433,Swanson; Steven James,9999,0,9999,0
1668564354780,CSE 293,038,119435,Tullsen; Dean Michael,9999,0,9999,0
1668564354780,CSE 293,039,119483,Voelker; Geoffrey M.,9999,0,9999,0
1668564354780,CSE 293,040,119537,Zhao; Jishen,9999,0,9999,0
1668564354780,CSE 293,041,119538,Zhou; Yuan-Yuan,9999,0,9999,0
1668564354780,CSE 293,042,119539,Gao; Sicun,9999,0,9999,0
1668564354780,CSE 293,043,119540,Weibel; Nadir,9999,0,9999,0
1668564354780,CSE 293,044,119541,Gupta; Rajesh K.,9999,0,9999,0
1668564354780,CSE 293,045,126410,Vaccaro; Kristen Marie,9999,0,9999,0
1668564354780,CSE 293,046,126411,Klemke; Richard,9999,0,9999,0
1668564355208,CSE 294,A00,102459,Voelker; Geoffrey M.,0,2,0,0
1668564355208,CSE 294,B00,111322,Orailoglu; Alex,0,2,0,0
1668564355632,DSE 201,A00,096914,Deutsch; Alin Bernard,30,0,30,0
1668564356062,DSE 210,A00,096915,Dasgupta; Sanjoy,30,0,30,0
1668564356485,DSE 260A,A00,096916,Altintas De Callaf; Ilkay,30,0,30,0
1668564356915,ECE 200,001,103586,Antipa; Nicholas A,9999,0,9999,0
1668564356915,ECE 200,002,103587,Atanasov; Nikolay A.,9999,0,9999,0
1668564356915,ECE 200,003,103588,Bharadia; Dinesh,9999,0,9999,0
1668564356915,ECE 200,004,103589,Cheng; Chung Kuan,9999,0,9999,0
1668564356915,ECE 200,005,103590,Cosman; Pamela C.,9999,0,9999,0
1668564356915,ECE 200,006,103591,Dayeh; Shadi Ahmad,9999,0,9999,0
1668564356915,ECE 200,007,103592,Fainman; Yeshaiahu,9999,0,9999,0
1668564356915,ECE 200,008,103593,Ford; Joseph Earl,9999,0,9999,0
1668564356915,ECE 200,009,103594,Franceschetti; Massimo,9999,0,9999,0
1668564356915,ECE 200,010,103595,Fullerton; Eric E,9999,0,9999,0
1668564356915,ECE 200,011,103596,Galton; Ian A,9999,0,9999,0
1668564356915,ECE 200,012,103597,Gilja; Vikash,9999,0,9999,0
1668564356915,ECE 200,013,103598,Hall; Drew A.,9999,0,9999,0
1668564356915,ECE 200,014,103599,Hsueh; Tzu-Chien,9999,0,9999,0
1668564356915,ECE 200,015,103600,Javidi; Tara,9999,0,9999,0
1668564356915,ECE 200,016,103601,Kahng; Andrew Byun,9999,0,9999,0
1668564356915,ECE 200,017,103602,Kim; Young-Han,9999,0,9999,0
1668564356915,ECE 200,018,103603,Koushanfar; Farinaz,9999,0,9999,0
1668564356915,ECE 200,019,103604,Kuzum; Duygu,9999,0,9999,0
1668564356915,ECE 200,020,103605,Le; Hanh-Phuc,9999,0,9999,0
1668564356915,ECE 200,021,103606,Lin; Bill,9999,0,9999,0
1668564356915,ECE 200,022,103607,Liu; Zhaowei,9998,0,9999,1
1668564356915,ECE 200,023,103608,Lo; Yu-Hwa,9999,0,9999,0
1668564356915,ECE 200,024,103609,Lomakin; Vitaliy,9999,0,9999,0
1668564356915,ECE 200,025,103610,Mercier; Patrick Philip,9999,0,9999,0
1668564356915,ECE 200,026,103611,Meyer; Florian,9999,0,9999,0
1668564356915,ECE 200,027,103612,Milstein; Laurence B.,9999,0,9999,0
1668564356915,ECE 200,028,103613,Mir Arabbaygi; Siavash,9999,0,9999,0
1668564356915,ECE 200,029,103614,Mookherjea; Shayan,9999,0,9999,0
1668564356915,ECE 200,030,103615,Morris; Karcher William,9999,0,9999,0
1668564356915,ECE 200,031,103616,Ng; Tse Nga,9999,0,9999,0
1668564356915,ECE 200,032,103617,Nguyen; Truong Quang,9999,0,9999,0
1668564356915,ECE 200,033,103618,Nomura; Kenji,9999,0,9999,0
1668564356915,ECE 200,034,103619,Orlitsky; Alon,9999,0,9999,0
1668564356915,ECE 200,035,103620,Pal; Piya,9999,0,9999,0
1668564356915,ECE 200,036,103621,Papen; George C.,9999,0,9999,0
1668564356915,ECE 200,037,103622,Radic; Stojan,9999,0,9999,0
1668564356915,ECE 200,038,103623,Rao; Bhaskar D.,9999,0,9999,0
1668564356915,ECE 200,039,103624,Rao; Ramesh R,9999,0,9999,0
1668564356915,ECE 200,040,103625,Rebeiz; Gabriel,9999,0,9999,0
1668564356915,ECE 200,041,103626,Sanford; John R,9999,0,9999,0
1668564356915,ECE 200,042,103627,Siegel; Paul H.,9999,0,9999,0
1668564356915,ECE 200,043,103628,Sievenpiper; Daniel F.,9999,0,9999,0
1668564356915,ECE 200,044,103629,Sworder; David D.,9999,0,9999,0
1668564356915,ECE 200,045,103630,Taur; Yuan,9999,0,9999,0
1668564356915,ECE 200,046,103631,Touri; Behrouz,9999,0,9999,0
1668564356915,ECE 200,047,103632,Trivedi; Mohan M.,9999,0,9999,0
1668564356915,ECE 200,048,103633,Vasconcelos; Nuno,9999,0,9999,0
1668564356915,ECE 200,049,103634,Wang; Xiaolong,9999,0,9999,0
1668564356915,ECE 200,050,103635,Xie; Pengtao,9999,0,9999,0
1668564356915,ECE 200,051,103636,Yip; Michael,9999,0,9999,0
1668564356915,ECE 200,052,103637,Zeger; Kenneth A.,999,0,999,0
1668564356915,ECE 200,053,103638,Zhang; Xinyu,9999,0,9999,0
1668564356915,ECE 200,054,103639,Turakhia; Yatish Girish,9999,0,9999,0
1668564356915,ECE 200,055,103640,Kang; Mingu,9999,0,9999,0
1668564356915,ECE 200,056,103641,Shi; Yuanyuan,9999,0,9999,0
1668564356915,ECE 200,057,103642,Wang; Edward Jay,9999,0,9999,0
1668564356915,ECE 200,058,103643,Zheng; Yang,9999,0,9999,0
1668564357338,ECE 202,A00,103644,Kuzum; Duygu,0,46,0,0
1668564357761,ECE 212BN,A00,103646,Ng; Tse Nga,0,9,0,0
1668564358198,ECE 221,A00,111493,Staff,0,0,0,0
1668564358626,ECE 222B,A00,103647,Lomakin; Vitaliy,0,21,0,0
1668564359062,ECE 230B,A00,103648,Taur; Yuan,0,4,0,0
1668564359488,ECE 238B,A00,103649,Garay; Javier,0,0,0,0
1668564359910,ECE 240B,A00,112900,Fainman; Yeshaiahu,0,8,0,0
1668564360333,ECE 247A,A00,103650,Jokerst; Jesse Vincent,0,6,0,0
1668564360759,ECE 247B,A00,103651,Wang; Joseph,0,14,0,0
1668564361187,ECE 250,A00,103652,Siegel; Paul H.,0,85,0,0
1668564361614,ECE 251A,A00,103654,Rao; Bhaskar D.,0,64,0,0
1668564362041,ECE 257B,A00,103655,Bharadia; Dinesh,0,33,0,0
1668564362470,ECE 258A,A00,103656,Milstein; Laurence B.,0,29,0,0
1668564362894,ECE 260B,A00,103658,Kang; Mingu,0,121,0,0
1668564363318,ECE 264A,A00,103659,Galton; Ian A,0,47,0,28
1668564363754,ECE 265A,A00,103661,Gudem; Prasad S.S.,0,48,0,28
1668564364176,ECE 265D,A00,103662,Gudem; Prasad S.S.,0,27,0,0
1668564364601,ECE 268,A00,103663,Koushanfar; Farinaz,0,44,0,0
1668564365032,ECE 269,A01,103665,Pal; Piya,0,222,0,0
1668564365467,ECE 271B,A00,103666,Vasconcelos; Manuela,0,78,0,0
1668564365890,ECE 276A,A00,103667,Atanasov; Nikolay A.,0,126,0,0
1668564366319,ECE 277,A00,103668,An; Cheolhong,0,151,0,0
1668564366750,ECE 279,A00,117947,Hall; Drew A.,0,22,0,0
1668564367610,ECE 283,A00,103670,Hsueh; Tzu-Chien,0,57,0,0
1668564368038,ECE 284,A00,103671,Turakhia; Yatish Girish,0,41,0,0
1668564368472,ECE 285,A00,103672,Zheng; Yang,0,41,0,0
1668564368472,ECE 285,B00,103673,Sworder; David D.,0,61,0,0
1668564368894,ECE 287,A00,103676,Javidi; Tara,0,8,0,0
1668564369318,MATH 200B,A00,098023,Salehi Golsefidy; Alireza,7,0,15,8
1668564369740,MATH 202B,A00,098024,Rhoades; Brendon Patrick,7,0,15,8
1668564370167,MATH 203B,A00,098025,Oprea; Dragos N.,9,0,15,6
1668564370594,MATH 204B,A00,098026,Sorensen; Claus M,13,0,15,2
1668564371026,MATH 208,A00,098027,Izadi; Elham,7,0,10,3
1668564371464,MATH 209,A00,098028,Pollack; Aaron,10,0,10,0
1668564371893,MATH 211A,A00,112919,Rogalski; Daniel,8,0,10,2
1668564372316,MATH 211B,A00,112920,Seward; Brandon M.,9,0,10,1
1668564372742,MATH 218,A00,098029,Li; Bo,10,0,10,0
1668564373170,MATH 220B,A00,098030,Novak; Jonathan I,10,0,15,5
1668564373605,MATH 221A,A00,098031,Ebenfelt; Peter F,12,0,15,3
1668564374031,MATH 231B,A00,098032,Zlatos; Andrej,9,0,15,6
1668564374456,MATH 240B,A00,098033,Ni; Lei,7,0,15,8
1668564374882,MATH 243,A00,098034,Jekel; David Andrew,10,0,10,0
1668564375306,MATH 245A,A00,098035,Nie; Jiawang,0,7,15,18
1668564375730,MATH 248,A00,098036,Bejenaru; Ioan,10,0,10,0
1668564376158,MATH 250B,A00,098037,Spolaor; Luca,12,0,15,3
1668564376591,MATH 258,A00,098038,Ni; Lei,8,0,10,2
1668564377015,MATH 264B,A00,098041,Rhoades; Brendon Patrick,7,0,15,8
1668564377440,MATH 268,A00,098042,Buss; Samuel R,10,0,10,0
1668564377862,MATH 269,A00,098043,Rhoades; Brendon Patrick,10,0,10,0
1668564378291,MATH 270B,A00,098044,Li; Bo,6,0,15,9
1668564378732,MATH 272B,A00,098045,Holst; Michael J,13,0,15,2
1668564379155,MATH 273A,A00,098046,Tian; Xiaochuan,10,0,15,5
1668564379578,MATH 275,A01,098048,Tian; Xiaochuan,6,0,10,4
1668564380011,MATH 278A,A00,098049,Holst; Michael J,6,0,10,4
1668564380436,MATH 278B,A00,098050,Cloninger; Alexander,10,0,10,0
1668564380867,MATH 278C,A00,098051,Nie; Jiawang,5,0,10,5
1668564381292,MATH 280B,A00,098052,Zheng; Tianyi,6,0,15,9
1668564381722,MATH 281B,A00,098053,Bradic; Jelena,0,2,15,15
1668564382148,MATH 282B,A00,098054,Arias-Castro; Ery,0,1,15,15
1668564382572,MATH 285,A00,098055,Fitzsimmons; Patrick J,0,4,15,17
1668564382998,MATH 287B,A00,098056,Arias-Castro; Ery,1,0,15,14
1668564383423,MATH 288,A00,098057,Agarwal; Pooja,9,0,10,1
1668564383423,MATH 288,B00,098058,Zhang; Danna,8,0,10,2
1668564383423,MATH 288,C00,098059,Williams; Ruth J,9,0,10,1
1668564383855,MATH 290B,A00,098060,Roberts; Justin Deritter,11,0,15,4
1668564384279,MATH 292,A00,098061,Belmont; Eva Kinoshita,10,0,10,0
1668564384774,MATH 295,A00,098062,Suk; Andrew Hoon,47,0,50,3
1668564385198,MATH 296,A00,098063,Novak; Jonathan I,20,0,20,0
1668564385621,MATH 297,001,098064,Gamst; Anthony Collins,9997,0,9999,2
1668564888940,COGS 205,A00,101395,Chiba; Andrea,19,0,20,1
1668564889362,COGS 210B,001,101404,Greene; Deanna Jacquelyn,9998,0,9999,1
1668564889362,COGS 210B,002,101417,Xia; Haijun,9999,0,9999,0
1668564889362,COGS 210B,003,101422,Nitz; Douglas A.,9999,0,9999,0
1668564889362,COGS 210B,004,101423,Hollan; James D.,9998,0,9999,1
1668564889362,COGS 210B,005,101424,Deak; Gedeon O.,9998,0,9999,1
1668564889362,COGS 210B,006,101425,Rossano; Federico,9999,0,9999,0
1668564889788,COGS 211B,A00,101427,Coulson; Seana M,9996,0,9999,3
1668564890215,COGS 220,A00,101428,Hollan; James D.,0,17,25,25
1668564890641,COGS 229,A00,101429,Dow; Steven P,17,0,25,8
1668564891077,COGS 230,A00,101430,Klemmer; Scott R,6,0,17,11
1668564891523,COGS 234,A00,101431,Xia; Haijun,0,1,25,25
1668564891947,COGS 260,A00,101432,Kiyonaga; Anastasia,21,0,25,4
1668564891947,COGS 260,B00,101433,Kirsh; David Joel,15,0,25,10
1668564892372,CSE 202,A00,102371,Impagliazzo; Russell,0,70,0,0
1668564892795,CSE 203B,A01,102373,Cheng; Chung Kuan,0,67,0,0
1668564893231,CSE 208,A00,102374,Micciancio; Daniele,0,5,0,0
1668564893661,CSE 209A,A00,112895,Impagliazzo; Russell,0,14,15,15
1668564894086,CSE 209B,A00,108005,Bellare; Mihir,0,7,0,0
1668564894527,CSE 210,A00,113163,Coblenz; Michael J,0,94,0,0
1668564894953,CSE 219,A00,106111,Dow; Steven P,0,8,20,20
1668564895377,CSE 221,A00,102376,Voelker; Geoffrey M.,0,77,0,0
1668564895799,CSE 224,A01,102378,Porter; George M,0,177,0,0
1668564896222,CSE 229A,A00,102379,Savage; Stefan,0,12,0,0
1668564896647,CSE 229C,A00,102380,Munyaka; Imani N. S.,0,10,0,0
1668564897074,CSE 232B,A00,102382,Deutsch; Alin Bernard,0,39,0,0
1668564897504,CSE 234,A01,112904,Kumar; Arun Kumar,0,0,0,0
1668564897937,CSE 237A,A00,102383,Rosing; Tajana Simunic,0,57,0,0
1668564898362,CSE 239A,A00,102384,Deutsch; Alin Bernard,0,16,0,0
1668564898787,CSE 239B,A00,102385,Polikarpova; Nadezhda,0,11,0,0
1668564899227,CSE 240A,A00,102386,Pannuto; Patrick William,0,48,0,0
1668564899666,CSE 240B,A00,102387,Zhao; Jishen,0,51,0,0
1668564900090,CSE 241A,A00,106406,Kang; Mingu,0,9,0,0
1668564900526,CSE 249B,A00,102388,Kahng; Andrew Byun,0,5,8,8
1668564900950,CSE 251B,A01,102392,Cottrell; Garrison W,0,53,0,0
1668564900950,CSE 251B,A02,102393,Cottrell; Garrison W,0,35,0,0
1668564901375,CSE 252B,A00,102394,Ochoa; Benjamin Lawrence,0,65,0,0
1668564901807,CSE 257,A01,102396,Gao; Sicun,0,155,0,0
1668564902233,CSE 272,A00,102397,Li; Tzumao,0,22,0,0
1668564902667,CSE 274,A00,111323,Chern; Albert Ren-Haur,0,16,0,0
1668564903093,CSE 282,A00,102398,Pevzner; Pavel Arkadjevich,0,0,0,0
1668564903517,CSE 284,A00,114175,Gymrek; Melissa Ann,0,30,0,0
1668564903951,CSE 290,A00,102399,Chandraker; Manmohan Krishna,0,11,0,0
1668564903951,CSE 290,B00,102400,Vaccaro; Kristen Marie,0,8,25,25
1668564903951,CSE 290,C00,102414,Pannuto; Patrick William,0,1,25,25
1668564903951,CSE 290,D00,102427,Pevzner; Pavel Arkadjevich,0,0,0,0
1668564903951,CSE 290,E00,102429,Zhao; Jishen,0,6,0,0
1668564903951,CSE 290,F00,102436,Tullsen; Dean Michael,0,6,0,0
1668564903951,CSE 290,G00,102440,Christensen; Henrik I,0,7,20,20
1668564904379,CSE 291,A00,102443,Su; Hao,0,0,0,0
1668564904379,CSE 291,B00,102448,Polikarpova; Nadezhda,0,0,0,0
1668564904379,CSE 291,C00,102453,Vaccaro; Kristen Marie,0,0,0,0
1668564904379,CSE 291,D00,111343,Savage; Stefan,0,0,0,0
1668564904379,CSE 291,E00,116474,Claffy; Kimberly Claire,0,0,0,0
1668564904379,CSE 291,F00,116479,Pasquale; Joseph,0,0,0,0
1668564904812,CSE 293,001,119111,Bafna; Vineet,9999,0,9999,0
1668564904812,CSE 293,002,119118,Bellare; Mihir,9999,0,9999,0
1668564904812,CSE 293,003,119122,Berg-Kirkpatrick; Taylor D,9999,0,9999,0
1668564904812,CSE 293,004,119135,Christensen; Henrik I,9999,0,9999,0
1668564904812,CSE 293,005,119142,Cottrell; Garrison W,9999,0,9999,0
1668564904812,CSE 293,006,119146,Deutsch; Alin Bernard,9999,0,9999,0
1668564904812,CSE 293,007,119159,Esmaeilzadeh; Hadi,9999,0,9999,0
1668564904812,CSE 293,008,119166,Freund; Yoav,9999,0,9999,0
1668564904812,CSE 293,009,119170,Griswold; William G.,9999,0,9999,0
1668564904812,CSE 293,010,119183,Gymrek; Melissa Ann,9999,0,9999,0
1668564904812,CSE 293,011,119190,Heninger; Nadia A,9999,0,9999,0
1668564904812,CSE 293,012,119230,Impagliazzo; Russell,9999,0,9999,0
1668564904812,CSE 293,013,119232,Jhala; Ranjit,9999,0,9999,0
1668564904812,CSE 293,014,119233,Kahng; Andrew Byun,9999,0,9999,0
1668564904812,CSE 293,015,119298,Kane; Daniel Mertz,9999,0,9999,0
1668564904812,CSE 293,016,119299,Kriegman; David J,9999,0,9999,0
1668564904812,CSE 293,017,119300,Kumar; Arun Kumar,9999,0,9999,0
1668564904812,CSE 293,018,119301,Lerner; Sorin,9999,0,9999,0
1668564904812,CSE 293,019,119302,Lovett; Shachar,9999,0,9999,0
1668564904812,CSE 293,020,119303,McAuley; Julian John,9999,0,9999,0
1668564904812,CSE 293,021,119304,Micciancio; Daniele,9999,0,9999,0
1668564904812,CSE 293,022,119367,Orailoglu; Alex,9999,0,9999,0
1668564904812,CSE 293,023,119382,Paturi; Ramamohan,9999,0,9999,0
1668564904812,CSE 293,024,119404,Polikarpova; Nadezhda,9999,0,9999,0
1668564904812,CSE 293,025,119406,Politz; Joseph Gibbs,9999,0,9999,0
1668564904812,CSE 293,026,119411,Porter; George M,9999,0,9999,0
1668564904812,CSE 293,027,119414,Porter; Leonard Emerson,9999,0,9999,0
1668564904812,CSE 293,028,119416,Ramamoorthi; Ravi,9999,0,9999,0
1668564904812,CSE 293,029,119417,Sahoo; Debashis,9999,0,9999,0
1668564904812,CSE 293,030,119420,Saul; Lawrence,9999,0,9999,0
1668564904812,CSE 293,031,119421,Savage; Stefan,9999,0,9999,0
1668564904812,CSE 293,032,119425,Schulze; Jurgen P.,9999,0,9999,0
1668564904812,CSE 293,033,119426,Snoeren; Alex C.,9999,0,9999,0
1668564904812,CSE 293,034,119428,Shang; Jingbo,9999,0,9999,0
1668564904812,CSE 293,035,119430,Stefan; Deian,9999,0,9999,0
1668564904812,CSE 293,036,119431,Su; Hao,9999,0,9999,0
1668564904812,CSE 293,037,119433,Swanson; Steven James,9999,0,9999,0
1668564904812,CSE 293,038,119435,Tullsen; Dean Michael,9999,0,9999,0
1668564904812,CSE 293,039,119483,Voelker; Geoffrey M.,9999,0,9999,0
1668564904812,CSE 293,040,119537,Zhao; Jishen,9999,0,9999,0
1668564904812,CSE 293,041,119538,Zhou; Yuan-Yuan,9999,0,9999,0
1668564904812,CSE 293,042,119539,Gao; Sicun,9999,0,9999,0
1668564904812,CSE 293,043,119540,Weibel; Nadir,9999,0,9999,0
1668564904812,CSE 293,044,119541,Gupta; Rajesh K.,9999,0,9999,0
1668564904812,CSE 293,045,126410,Vaccaro; Kristen Marie,9999,0,9999,0
1668564904812,CSE 293,046,126411,Klemke; Richard,9999,0,9999,0
1668564905247,CSE 294,A00,102459,Voelker; Geoffrey M.,0,2,0,0
1668564905247,CSE 294,B00,111322,Orailoglu; Alex,0,2,0,0
1668564905670,DSE 201,A00,096914,Deutsch; Alin Bernard,30,0,30,0
1668564906096,DSE 210,A00,096915,Dasgupta; Sanjoy,30,0,30,0
1668564906522,DSE 260A,A00,096916,Altintas De Callaf; Ilkay,30,0,30,0
1668564906961,ECE 200,001,103586,Antipa; Nicholas A,9999,0,9999,0
1668564906961,ECE 200,002,103587,Atanasov; Nikolay A.,9999,0,9999,0
1668564906961,ECE 200,003,103588,Bharadia; Dinesh,9999,0,9999,0
1668564906961,ECE 200,004,103589,Cheng; Chung Kuan,9999,0,9999,0
1668564906961,ECE 200,005,103590,Cosman; Pamela C.,9999,0,9999,0
1668564906961,ECE 200,006,103591,Dayeh; Shadi Ahmad,9999,0,9999,0
1668564906961,ECE 200,007,103592,Fainman; Yeshaiahu,9999,0,9999,0
1668564906961,ECE 200,008,103593,Ford; Joseph Earl,9999,0,9999,0
1668564906961,ECE 200,009,103594,Franceschetti; Massimo,9999,0,9999,0
1668564906961,ECE 200,010,103595,Fullerton; Eric E,9999,0,9999,0
1668564906961,ECE 200,011,103596,Galton; Ian A,9999,0,9999,0
1668564906961,ECE 200,012,103597,Gilja; Vikash,9999,0,9999,0
1668564906961,ECE 200,013,103598,Hall; Drew A.,9999,0,9999,0
1668564906961,ECE 200,014,103599,Hsueh; Tzu-Chien,9999,0,9999,0
1668564906961,ECE 200,015,103600,Javidi; Tara,9999,0,9999,0
1668564906961,ECE 200,016,103601,Kahng; Andrew Byun,9999,0,9999,0
1668564906961,ECE 200,017,103602,Kim; Young-Han,9999,0,9999,0
1668564906961,ECE 200,018,103603,Koushanfar; Farinaz,9999,0,9999,0
1668564906961,ECE 200,019,103604,Kuzum; Duygu,9999,0,9999,0
1668564906961,ECE 200,020,103605,Le; Hanh-Phuc,9999,0,9999,0
1668564906961,ECE 200,021,103606,Lin; Bill,9999,0,9999,0
1668564906961,ECE 200,022,103607,Liu; Zhaowei,9998,0,9999,1
1668564906961,ECE 200,023,103608,Lo; Yu-Hwa,9999,0,9999,0
1668564906961,ECE 200,024,103609,Lomakin; Vitaliy,9999,0,9999,0
1668564906961,ECE 200,025,103610,Mercier; Patrick Philip,9999,0,9999,0
1668564906961,ECE 200,026,103611,Meyer; Florian,9999,0,9999,0
1668564906961,ECE 200,027,103612,Milstein; Laurence B.,9999,0,9999,0
1668564906961,ECE 200,028,103613,Mir Arabbaygi; Siavash,9999,0,9999,0
1668564906961,ECE 200,029,103614,Mookherjea; Shayan,9999,0,9999,0
1668564906961,ECE 200,030,103615,Morris; Karcher William,9999,0,9999,0
1668564906961,ECE 200,031,103616,Ng; Tse Nga,9999,0,9999,0
1668564906961,ECE 200,032,103617,Nguyen; Truong Quang,9999,0,9999,0
1668564906961,ECE 200,033,103618,Nomura; Kenji,9999,0,9999,0
1668564906961,ECE 200,034,103619,Orlitsky; Alon,9999,0,9999,0
1668564906961,ECE 200,035,103620,Pal; Piya,9999,0,9999,0
1668564906961,ECE 200,036,103621,Papen; George C.,9999,0,9999,0
1668564906961,ECE 200,037,103622,Radic; Stojan,9999,0,9999,0
1668564906961,ECE 200,038,103623,Rao; Bhaskar D.,9999,0,9999,0
1668564906961,ECE 200,039,103624,Rao; Ramesh R,9999,0,9999,0
1668564906961,ECE 200,040,103625,Rebeiz; Gabriel,9999,0,9999,0
1668564906961,ECE 200,041,103626,Sanford; John R,9999,0,9999,0
1668564906961,ECE 200,042,103627,Siegel; Paul H.,9999,0,9999,0
1668564906961,ECE 200,043,103628,Sievenpiper; Daniel F.,9999,0,9999,0
1668564906961,ECE 200,044,103629,Sworder; David D.,9999,0,9999,0
1668564906961,ECE 200,045,103630,Taur; Yuan,9999,0,9999,0
1668564906961,ECE 200,046,103631,Touri; Behrouz,9999,0,9999,0
1668564906961,ECE 200,047,103632,Trivedi; Mohan M.,9999,0,9999,0
1668564906961,ECE 200,048,103633,Vasconcelos; Nuno,9999,0,9999,0
1668564906961,ECE 200,049,103634,Wang; Xiaolong,9999,0,9999,0
1668564906961,ECE 200,050,103635,Xie; Pengtao,9999,0,9999,0
1668564906961,ECE 200,051,103636,Yip; Michael,9999,0,9999,0
1668564906961,ECE 200,052,103637,Zeger; Kenneth A.,999,0,999,0
1668564906961,ECE 200,053,103638,Zhang; Xinyu,9999,0,9999,0
1668564906961,ECE 200,054,103639,Turakhia; Yatish Girish,9999,0,9999,0
1668564906961,ECE 200,055,103640,Kang; Mingu,9999,0,9999,0
1668564906961,ECE 200,056,103641,Shi; Yuanyuan,9999,0,9999,0
1668564906961,ECE 200,057,103642,Wang; Edward Jay,9999,0,9999,0
1668564906961,ECE 200,058,103643,Zheng; Yang,9999,0,9999,0
1668564907389,ECE 202,A00,103644,Kuzum; Duygu,0,46,0,0
1668564907816,ECE 212BN,A00,103646,Ng; Tse Nga,0,9,0,0
1668564908251,ECE 221,A00,111493,Staff,0,0,0,0
1668564908674,ECE 222B,A00,103647,Lomakin; Vitaliy,0,21,0,0
1668564909098,ECE 230B,A00,103648,Taur; Yuan,0,4,0,0
1668564909525,ECE 238B,A00,103649,Garay; Javier,0,0,0,0
1668564909947,ECE 240B,A00,112900,Fainman; Yeshaiahu,0,8,0,0
1668564910384,ECE 247A,A00,103650,Jokerst; Jesse Vincent,0,6,0,0
1668564910808,ECE 247B,A00,103651,Wang; Joseph,0,15,0,0
1668564911247,ECE 250,A00,103652,Siegel; Paul H.,0,85,0,0
1668564911678,ECE 251A,A00,103654,Rao; Bhaskar D.,0,64,0,0
1668564912101,ECE 257B,A00,103655,Bharadia; Dinesh,0,33,0,0
1668564912535,ECE 258A,A00,103656,Milstein; Laurence B.,0,29,0,0
1668564912962,ECE 260B,A00,103658,Kang; Mingu,0,121,0,0
1668564913389,ECE 264A,A00,103659,Galton; Ian A,0,47,0,28
1668564913815,ECE 265A,A00,103661,Gudem; Prasad S.S.,0,48,0,28
1668564914242,ECE 265D,A00,103662,Gudem; Prasad S.S.,0,27,0,0
1668564914664,ECE 268,A00,103663,Koushanfar; Farinaz,0,44,0,0
1668564915100,ECE 269,A01,103665,Pal; Piya,0,222,0,0
1668564915527,ECE 271B,A00,103666,Vasconcelos; Manuela,0,78,0,0
1668564915950,ECE 276A,A00,103667,Atanasov; Nikolay A.,0,126,0,0
1668564916385,ECE 277,A00,103668,An; Cheolhong,0,151,0,0
1668564916818,ECE 279,A00,117947,Hall; Drew A.,0,22,0,0
1668564917746,ECE 283,A00,103670,Hsueh; Tzu-Chien,0,57,0,0
1668564918167,ECE 284,A00,103671,Turakhia; Yatish Girish,0,41,0,0
1668564918590,ECE 285,A00,103672,Zheng; Yang,0,41,0,0
1668564918590,ECE 285,B00,103673,Sworder; David D.,0,61,0,0
1668564919014,ECE 287,A00,103676,Javidi; Tara,0,8,0,0
1668564919439,MATH 200B,A00,098023,Salehi Golsefidy; Alireza,7,0,15,8
1668564919863,MATH 202B,A00,098024,Rhoades; Brendon Patrick,7,0,15,8
1668564920286,MATH 203B,A00,098025,Oprea; Dragos N.,9,0,15,6
1668564920717,MATH 204B,A00,098026,Sorensen; Claus M,13,0,15,2
1668564921139,MATH 208,A00,098027,Izadi; Elham,7,0,10,3
1668564921572,MATH 209,A00,098028,Pollack; Aaron,10,0,10,0
1668564922004,MATH 211A,A00,112919,Rogalski; Daniel,8,0,10,2
1668564922426,MATH 211B,A00,112920,Seward; Brandon M.,9,0,10,1
1668564922853,MATH 218,A00,098029,Li; Bo,10,0,10,0
1668564923275,MATH 220B,A00,098030,Novak; Jonathan I,10,0,15,5
1668564923709,MATH 221A,A00,098031,Ebenfelt; Peter F,12,0,15,3
1668564924131,MATH 231B,A00,098032,Zlatos; Andrej,9,0,15,6
1668564924554,MATH 240B,A00,098033,Ni; Lei,7,0,15,8
1668564924981,MATH 243,A00,098034,Jekel; David Andrew,10,0,10,0
1668564925406,MATH 245A,A00,098035,Nie; Jiawang,0,7,15,18
1668564925834,MATH 248,A00,098036,Bejenaru; Ioan,10,0,10,0
1668564926268,MATH 250B,A00,098037,Spolaor; Luca,12,0,15,3
1668564926694,MATH 258,A00,098038,Ni; Lei,8,0,10,2
1668564927128,MATH 264B,A00,098041,Rhoades; Brendon Patrick,7,0,15,8
1668564927559,MATH 268,A00,098042,Buss; Samuel R,10,0,10,0
1668564927987,MATH 269,A00,098043,Rhoades; Brendon Patrick,10,0,10,0
1668564928413,MATH 270B,A00,098044,Li; Bo,6,0,15,9
1668564928838,MATH 272B,A00,098045,Holst; Michael J,13,0,15,2
1668564929261,MATH 273A,A00,098046,Tian; Xiaochuan,10,0,15,5
1668564929689,MATH 275,A01,098048,Tian; Xiaochuan,6,0,10,4
1668564930112,MATH 278A,A00,098049,Holst; Michael J,6,0,10,4
1668564930537,MATH 278B,A00,098050,Cloninger; Alexander,10,0,10,0
1668564930969,MATH 278C,A00,098051,Nie; Jiawang,5,0,10,5
1668564931396,MATH 280B,A00,098052,Zheng; Tianyi,6,0,15,9
1668564931822,MATH 281B,A00,098053,Bradic; Jelena,0,2,15,15
1668564932260,MATH 282B,A00,098054,Arias-Castro; Ery,0,1,15,15
1668564932683,MATH 285,A00,098055,Fitzsimmons; Patrick J,0,4,15,17
1668564933106,MATH 287B,A00,098056,Arias-Castro; Ery,1,0,15,14
1668564933540,MATH 288,A00,098057,Agarwal; Pooja,9,0,10,1
1668564933540,MATH 288,B00,098058,Zhang; Danna,8,0,10,2
1668564933540,MATH 288,C00,098059,Williams; Ruth J,9,0,10,1
1668564933967,MATH 290B,A00,098060,Roberts; Justin Deritter,11,0,15,4
1668564934393,MATH 292,A00,098061,Belmont; Eva Kinoshita,10,0,10,0
1668564934820,MATH 295,A00,098062,Suk; Andrew Hoon,47,0,50,3
1668564935246,MATH 296,A00,098063,Novak; Jonathan I,20,0,20,0
1668564935670,MATH 297,001,098064,Gamst; Anthony Collins,9997,0,9999,2
1668565440498,COGS 205,A00,101395,Chiba; Andrea,19,0,20,1
1668565441026,COGS 210B,001,101404,Greene; Deanna Jacquelyn,9998,0,9999,1
1668565441026,COGS 210B,002,101417,Xia; Haijun,9999,0,9999,0
1668565441026,COGS 210B,003,101422,Nitz; Douglas A.,9999,0,9999,0
1668565441026,COGS 210B,004,101423,Hollan; James D.,9998,0,9999,1
1668565441026,COGS 210B,005,101424,Deak; Gedeon O.,9998,0,9999,1
1668565441026,COGS 210B,006,101425,Rossano; Federico,9999,0,9999,0
1668565441449,COGS 211B,A00,101427,Coulson; Seana M,9996,0,9999,3
1668565441886,COGS 220,A00,101428,Hollan; James D.,0,17,25,25
1668565442320,COGS 229,A00,101429,Dow; Steven P,17,0,25,8
1668565442746,COGS 230,A00,101430,Klemmer; Scott R,6,0,17,11
1668565443168,COGS 234,A00,101431,Xia; Haijun,0,1,25,25
1668565443592,COGS 260,A00,101432,Kiyonaga; Anastasia,21,0,25,4
1668565443592,COGS 260,B00,101433,Kirsh; David Joel,15,0,25,10
1668565444014,CSE 202,A00,102371,Impagliazzo; Russell,0,70,0,0
1668565444440,CSE 203B,A01,102373,Cheng; Chung Kuan,0,67,0,0
1668565444870,CSE 208,A00,102374,Micciancio; Daniele,0,5,0,0
1668565445296,CSE 209A,A00,112895,Impagliazzo; Russell,0,14,15,15
1668565445720,CSE 209B,A00,108005,Bellare; Mihir,0,7,0,0
1668565446146,CSE 210,A00,113163,Coblenz; Michael J,0,94,0,0
1668565446572,CSE 219,A00,106111,Dow; Steven P,0,8,20,20
1668565447005,CSE 221,A00,102376,Voelker; Geoffrey M.,0,77,0,0
1668565447447,CSE 224,A01,102378,Porter; George M,0,177,0,0
1668565447889,CSE 229A,A00,102379,Savage; Stefan,0,12,0,0
1668565448316,CSE 229C,A00,102380,Munyaka; Imani N. S.,0,10,0,0
1668565448742,CSE 232B,A00,102382,Deutsch; Alin Bernard,0,39,0,0
1668565449166,CSE 234,A01,112904,Kumar; Arun Kumar,0,0,0,0
1668565449592,CSE 237A,A00,102383,Rosing; Tajana Simunic,0,57,0,0
1668565450023,CSE 239A,A00,102384,Deutsch; Alin Bernard,0,16,0,0
1668565450448,CSE 239B,A00,102385,Polikarpova; Nadezhda,0,11,0,0
1668565450882,CSE 240A,A00,102386,Pannuto; Patrick William,0,48,0,0
1668565451312,CSE 240B,A00,102387,Zhao; Jishen,0,51,0,0
1668565451735,CSE 241A,A00,106406,Kang; Mingu,0,9,0,0
1668565452162,CSE 249B,A00,102388,Kahng; Andrew Byun,0,5,8,8
1668565452585,CSE 251B,A01,102392,Cottrell; Garrison W,0,53,0,0
1668565452585,CSE 251B,A02,102393,Cottrell; Garrison W,0,35,0,0
1668565453008,CSE 252B,A00,102394,Ochoa; Benjamin Lawrence,0,65,0,0
1668565453435,CSE 257,A01,102396,Gao; Sicun,0,155,0,0
1668565453860,CSE 272,A00,102397,Li; Tzumao,0,22,0,0
1668565454286,CSE 274,A00,111323,Chern; Albert Ren-Haur,0,16,0,0
1668565454711,CSE 282,A00,102398,Pevzner; Pavel Arkadjevich,0,0,0,0
1668565455138,CSE 284,A00,114175,Gymrek; Melissa Ann,0,30,0,0
1668565455570,CSE 290,A00,102399,Chandraker; Manmohan Krishna,0,11,0,0
1668565455570,CSE 290,B00,102400,Vaccaro; Kristen Marie,0,8,25,25
1668565455570,CSE 290,C00,102414,Pannuto; Patrick William,0,1,25,25
1668565455570,CSE 290,D00,102427,Pevzner; Pavel Arkadjevich,0,0,0,0
1668565455570,CSE 290,E00,102429,Zhao; Jishen,0,6,0,0
1668565455570,CSE 290,F00,102436,Tullsen; Dean Michael,0,6,0,0
1668565455570,CSE 290,G00,102440,Christensen; Henrik I,0,7,20,20
1668565456004,CSE 291,A00,102443,Su; Hao,0,0,0,0
1668565456004,CSE 291,B00,102448,Polikarpova; Nadezhda,0,0,0,0
1668565456004,CSE 291,C00,102453,Vaccaro; Kristen Marie,0,0,0,0
1668565456004,CSE 291,D00,111343,Savage; Stefan,0,0,0,0
1668565456004,CSE 291,E00,116474,Claffy; Kimberly Claire,0,0,0,0
1668565456004,CSE 291,F00,116479,Pasquale; Joseph,0,0,0,0
1668565456445,CSE 293,001,119111,Bafna; Vineet,9999,0,9999,0
1668565456445,CSE 293,002,119118,Bellare; Mihir,9999,0,9999,0
1668565456445,CSE 293,003,119122,Berg-Kirkpatrick; Taylor D,9999,0,9999,0
1668565456445,CSE 293,004,119135,Christensen; Henrik I,9999,0,9999,0
1668565456445,CSE 293,005,119142,Cottrell; Garrison W,9999,0,9999,0
1668565456445,CSE 293,006,119146,Deutsch; Alin Bernard,9999,0,9999,0
1668565456445,CSE 293,007,119159,Esmaeilzadeh; Hadi,9999,0,9999,0
1668565456445,CSE 293,008,119166,Freund; Yoav,9999,0,9999,0
1668565456445,CSE 293,009,119170,Griswold; William G.,9999,0,9999,0
1668565456445,CSE 293,010,119183,Gymrek; Melissa Ann,9999,0,9999,0
1668565456445,CSE 293,011,119190,Heninger; Nadia A,9999,0,9999,0
1668565456445,CSE 293,012,119230,Impagliazzo; Russell,9999,0,9999,0
1668565456445,CSE 293,013,119232,Jhala; Ranjit,9999,0,9999,0
1668565456445,CSE 293,014,119233,Kahng; Andrew Byun,9999,0,9999,0
1668565456445,CSE 293,015,119298,Kane; Daniel Mertz,9999,0,9999,0
1668565456445,CSE 293,016,119299,Kriegman; David J,9999,0,9999,0
1668565456445,CSE 293,017,119300,Kumar; Arun Kumar,9999,0,9999,0
1668565456445,CSE 293,018,119301,Lerner; Sorin,9999,0,9999,0
1668565456445,CSE 293,019,119302,Lovett; Shachar,9999,0,9999,0
1668565456445,CSE 293,020,119303,McAuley; Julian John,9999,0,9999,0
1668565456445,CSE 293,021,119304,Micciancio; Daniele,9999,0,9999,0
1668565456445,CSE 293,022,119367,Orailoglu; Alex,9999,0,9999,0
1668565456445,CSE 293,023,119382,Paturi; Ramamohan,9999,0,9999,0
1668565456445,CSE 293,024,119404,Polikarpova; Nadezhda,9999,0,9999,0
1668565456445,CSE 293,025,119406,Politz; Joseph Gibbs,9999,0,9999,0
1668565456445,CSE 293,026,119411,Porter; George M,9999,0,9999,0
1668565456445,CSE 293,027,119414,Porter; Leonard Emerson,9999,0,9999,0
1668565456445,CSE 293,028,119416,Ramamoorthi; Ravi,9999,0,9999,0
1668565456445,CSE 293,029,119417,Sahoo; Debashis,9999,0,9999,0
1668565456445,CSE 293,030,119420,Saul; Lawrence,9999,0,9999,0
1668565456445,CSE 293,031,119421,Savage; Stefan,9999,0,9999,0
1668565456445,CSE 293,032,119425,Schulze; Jurgen P.,9999,0,9999,0
1668565456445,CSE 293,033,119426,Snoeren; Alex C.,9999,0,9999,0
1668565456445,CSE 293,034,119428,Shang; Jingbo,9999,0,9999,0
1668565456445,CSE 293,035,119430,Stefan; Deian,9999,0,9999,0
1668565456445,CSE 293,036,119431,Su; Hao,9999,0,9999,0
1668565456445,CSE 293,037,119433,Swanson; Steven James,9999,0,9999,0
1668565456445,CSE 293,038,119435,Tullsen; Dean Michael,9999,0,9999,0
1668565456445,CSE 293,039,119483,Voelker; Geoffrey M.,9999,0,9999,0
1668565456445,CSE 293,040,119537,Zhao; Jishen,9999,0,9999,0
1668565456445,CSE 293,041,119538,Zhou; Yuan-Yuan,9999,0,9999,0
1668565456445,CSE 293,042,119539,Gao; Sicun,9999,0,9999,0
1668565456445,CSE 293,043,119540,Weibel; Nadir,9999,0,9999,0
1668565456445,CSE 293,044,119541,Gupta; Rajesh K.,9999,0,9999,0
1668565456445,CSE 293,045,126410,Vaccaro; Kristen Marie,9999,0,9999,0
1668565456445,CSE 293,046,126411,Klemke; Richard,9999,0,9999,0
1668565456942,CSE 294,A00,102459,Voelker; Geoffrey M.,0,2,0,0
1668565456942,CSE 294,B00,111322,Orailoglu; Alex,0,2,0,0
1668565457375,DSE 201,A00,096914,Deutsch; Alin Bernard,30,0,30,0
1668565457801,DSE 210,A00,096915,Dasgupta; Sanjoy,30,0,30,0
1668565458224,DSE 260A,A00,096916,Altintas De Callaf; Ilkay,30,0,30,0
1668565458666,ECE 200,001,103586,Antipa; Nicholas A,9999,0,9999,0
1668565458666,ECE 200,002,103587,Atanasov; Nikolay A.,9999,0,9999,0
1668565458666,ECE 200,003,103588,Bharadia; Dinesh,9999,0,9999,0
1668565458666,ECE 200,004,103589,Cheng; Chung Kuan,9999,0,9999,0
1668565458666,ECE 200,005,103590,Cosman; Pamela C.,9999,0,9999,0
1668565458666,ECE 200,006,103591,Dayeh; Shadi Ahmad,9999,0,9999,0
1668565458666,ECE 200,007,103592,Fainman; Yeshaiahu,9999,0,9999,0
1668565458666,ECE 200,008,103593,Ford; Joseph Earl,9999,0,9999,0
1668565458666,ECE 200,009,103594,Franceschetti; Massimo,9999,0,9999,0
1668565458666,ECE 200,010,103595,Fullerton; Eric E,9999,0,9999,0
1668565458666,ECE 200,011,103596,Galton; Ian A,9999,0,9999,0
1668565458666,ECE 200,012,103597,Gilja; Vikash,9999,0,9999,0
1668565458666,ECE 200,013,103598,Hall; Drew A.,9999,0,9999,0
1668565458666,ECE 200,014,103599,Hsueh; Tzu-Chien,9999,0,9999,0
1668565458666,ECE 200,015,103600,Javidi; Tara,9999,0,9999,0
1668565458666,ECE 200,016,103601,Kahng; Andrew Byun,9999,0,9999,0
1668565458666,ECE 200,017,103602,Kim; Young-Han,9999,0,9999,0
1668565458666,ECE 200,018,103603,Koushanfar; Farinaz,9999,0,9999,0
1668565458666,ECE 200,019,103604,Kuzum; Duygu,9999,0,9999,0
1668565458666,ECE 200,020,103605,Le; Hanh-Phuc,9999,0,9999,0
1668565458666,ECE 200,021,103606,Lin; Bill,9999,0,9999,0
1668565458666,ECE 200,022,103607,Liu; Zhaowei,9998,0,9999,1
1668565458666,ECE 200,023,103608,Lo; Yu-Hwa,9999,0,9999,0
1668565458666,ECE 200,024,103609,Lomakin; Vitaliy,9999,0,9999,0
1668565458666,ECE 200,025,103610,Mercier; Patrick Philip,9999,0,9999,0
1668565458666,ECE 200,026,103611,Meyer; Florian,9999,0,9999,0
1668565458666,ECE 200,027,103612,Milstein; Laurence B.,9999,0,9999,0
1668565458666,ECE 200,028,103613,Mir Arabbaygi; Siavash,9999,0,9999,0
1668565458666,ECE 200,029,103614,Mookherjea; Shayan,9999,0,9999,0
1668565458666,ECE 200,030,103615,Morris; Karcher William,9999,0,9999,0
1668565458666,ECE 200,031,103616,Ng; Tse Nga,9999,0,9999,0
1668565458666,ECE 200,032,103617,Nguyen; Truong Quang,9999,0,9999,0
1668565458666,ECE 200,033,103618,Nomura; Kenji,9999,0,9999,0
1668565458666,ECE 200,034,103619,Orlitsky; Alon,9999,0,9999,0
1668565458666,ECE 200,035,103620,Pal; Piya,9999,0,9999,0
1668565458666,ECE 200,036,103621,Papen; George C.,9999,0,9999,0
1668565458666,ECE 200,037,103622,Radic; Stojan,9999,0,9999,0
1668565458666,ECE 200,038,103623,Rao; Bhaskar D.,9999,0,9999,0
1668565458666,ECE 200,039,103624,Rao; Ramesh R,9999,0,9999,0
1668565458666,ECE 200,040,103625,Rebeiz; Gabriel,9999,0,9999,0
1668565458666,ECE 200,041,103626,Sanford; John R,9999,0,9999,0
1668565458666,ECE 200,042,103627,Siegel; Paul H.,9999,0,9999,0
1668565458666,ECE 200,043,103628,Sievenpiper; Daniel F.,9999,0,9999,0
1668565458666,ECE 200,044,103629,Sworder; David D.,9999,0,9999,0
1668565458666,ECE 200,045,103630,Taur; Yuan,9999,0,9999,0
1668565458666,ECE 200,046,103631,Touri; Behrouz,9999,0,9999,0
1668565458666,ECE 200,047,103632,Trivedi; Mohan M.,9999,0,9999,0
1668565458666,ECE 200,048,103633,Vasconcelos; Nuno,9999,0,9999,0
1668565458666,ECE 200,049,103634,Wang; Xiaolong,9999,0,9999,0
1668565458666,ECE 200,050,103635,Xie; Pengtao,9999,0,9999,0
1668565458666,ECE 200,051,103636,Yip; Michael,9999,0,9999,0
1668565458666,ECE 200,052,103637,Zeger; Kenneth A.,999,0,999,0
1668565458666,ECE 200,053,103638,Zhang; Xinyu,9999,0,9999,0
1668565458666,ECE 200,054,103639,Turakhia; Yatish Girish,9999,0,9999,0
1668565458666,ECE 200,055,103640,Kang; Mingu,9999,0,9999,0
1668565458666,ECE 200,056,103641,Shi; Yuanyuan,9999,0,9999,0
1668565458666,ECE 200,057,103642,Wang; Edward Jay,9999,0,9999,0
1668565458666,ECE 200,058,103643,Zheng; Yang,9999,0,9999,0
1668565459111,ECE 202,A00,103644,Kuzum; Duygu,0,46,0,0
1668565459543,ECE 212BN,A00,103646,Ng; Tse Nga,0,9,0,0
1668565459967,ECE 221,A00,111493,Staff,0,0,0,0
1668565460390,ECE 222B,A00,103647,Lomakin; Vitaliy,0,21,0,0
1668565460814,ECE 230B,A00,103648,Taur; Yuan,0,4,0,0
1668565461239,ECE 238B,A00,103649,Garay; Javier,0,0,0,0
1668565461667,ECE 240B,A00,112900,Fainman; Yeshaiahu,0,8,0,0
1668565462109,ECE 247A,A00,103650,Jokerst; Jesse Vincent,0,6,0,0
1668565462533,ECE 247B,A00,103651,Wang; Joseph,0,15,0,0
1668565462956,ECE 250,A00,103652,Siegel; Paul H.,0,85,0,0
1668565463381,ECE 251A,A00,103654,Rao; Bhaskar D.,0,64,0,0
1668565463807,ECE 257B,A00,103655,Bharadia; Dinesh,0,33,0,0
1668565464232,ECE 258A,A00,103656,Milstein; Laurence B.,0,29,0,0
1668565464657,ECE 260B,A00,103658,Kang; Mingu,0,121,0,0
1668565465115,ECE 264A,A00,103659,Galton; Ian A,0,46,0,29
1668565465541,ECE 265A,A00,103661,Gudem; Prasad S.S.,0,48,0,28
1668565465970,ECE 265D,A00,103662,Gudem; Prasad S.S.,0,27,0,0
1668565466406,ECE 268,A00,103663,Koushanfar; Farinaz,0,44,0,0
1668565466833,ECE 269,A01,103665,Pal; Piya,0,222,0,0
1668565467259,ECE 271B,A00,103666,Vasconcelos; Manuela,0,78,0,0
1668565467699,ECE 276A,A00,103667,Atanasov; Nikolay A.,0,126,0,0
1668565468131,ECE 277,A00,103668,An; Cheolhong,0,151,0,0
1668565468562,ECE 279,A00,117947,Hall; Drew A.,0,22,0,0
1668565469419,ECE 283,A00,103670,Hsueh; Tzu-Chien,0,57,0,0
1668565469847,ECE 284,A00,103671,Turakhia; Yatish Girish,0,41,0,0
1668565470285,ECE 285,A00,103672,Zheng; Yang,0,41,0,0
1668565470285,ECE 285,B00,103673,Sworder; David D.,0,61,0,0
1668565470708,ECE 287,A00,103676,Javidi; Tara,0,8,0,0
1668565471137,MATH 200B,A00,098023,Salehi Golsefidy; Alireza,7,0,15,8
1668565471561,MATH 202B,A00,098024,Rhoades; Brendon Patrick,7,0,15,8
1668565471988,MATH 203B,A00,098025,Oprea; Dragos N.,9,0,15,6
1668565472411,MATH 204B,A00,098026,Sorensen; Claus M,13,0,15,2
1668565472844,MATH 208,A00,098027,Izadi; Elham,7,0,10,3
1668565473287,MATH 209,A00,098028,Pollack; Aaron,10,0,10,0
1668565473709,MATH 211A,A00,112919,Rogalski; Daniel,8,0,10,2
1668565474136,MATH 211B,A00,112920,Seward; Brandon M.,9,0,10,1
1668565474567,MATH 218,A00,098029,Li; Bo,10,0,10,0
1668565474992,MATH 220B,A00,098030,Novak; Jonathan I,10,0,15,5
1668565475417,MATH 221A,A00,098031,Ebenfelt; Peter F,12,0,15,3
1668565475841,MATH 231B,A00,098032,Zlatos; Andrej,9,0,15,6
1668565476273,MATH 240B,A00,098033,Ni; Lei,7,0,15,8
1668565476703,MATH 243,A00,098034,Jekel; David Andrew,10,0,10,0
1668565477137,MATH 245A,A00,098035,Nie; Jiawang,0,7,15,18
1668565477574,MATH 248,A00,098036,Bejenaru; Ioan,10,0,10,0
1668565478003,MATH 250B,A00,098037,Spolaor; Luca,12,0,15,3
1668565478428,MATH 258,A00,098038,Ni; Lei,8,0,10,2
1668565478860,MATH 264B,A00,098041,Rhoades; Brendon Patrick,7,0,15,8
1668565479286,MATH 268,A00,098042,Buss; Samuel R,10,0,10,0
1668565479709,MATH 269,A00,098043,Rhoades; Brendon Patrick,10,0,10,0
1668565480144,MATH 270B,A00,098044,Li; Bo,6,0,15,9
1668565480580,MATH 272B,A00,098045,Holst; Michael J,13,0,15,2
1668565481004,MATH 273A,A00,098046,Tian; Xiaochuan,10,0,15,5
1668565481440,MATH 275,A01,098048,Tian; Xiaochuan,6,0,10,4
1668565481864,MATH 278A,A00,098049,Holst; Michael J,6,0,10,4
1668565482293,MATH 278B,A00,098050,Cloninger; Alexander,10,0,10,0
1668565482723,MATH 278C,A00,098051,Nie; Jiawang,5,0,10,5
1668565483150,MATH 280B,A00,098052,Zheng; Tianyi,6,0,15,9
1668565483586,MATH 281B,A00,098053,Bradic; Jelena,0,2,15,15
1668565484014,MATH 282B,A00,098054,Arias-Castro; Ery,0,1,15,15
1668565484543,MATH 285,A00,098055,Fitzsimmons; Patrick J,0,4,15,17
1668565484967,MATH 287B,A00,098056,Arias-Castro; Ery,1,0,15,14
1668565485408,MATH 288,A00,098057,Agarwal; Pooja,9,0,10,1
1668565485408,MATH 288,B00,098058,Zhang; Danna,8,0,10,2
1668565485408,MATH 288,C00,098059,Williams; Ruth J,9,0,10,1
1668565485834,MATH 290B,A00,098060,Roberts; Justin Deritter,11,0,15,4
1668565486260,MATH 292,A00,098061,Belmont; Eva Kinoshita,10,0,10,0
1668565486684,MATH 295,A00,098062,Suk; Andrew Hoon,47,0,50,3
1668565487110,MATH 296,A00,098063,Novak; Jonathan I,20,0,20,0
1668565487543,MATH 297,001,098064,Gamst; Anthony Collins,9997,0,9999,2
1668565991805,COGS 205,A00,101395,Chiba; Andrea,19,0,20,1
1668565992236,COGS 210B,001,101404,Greene; Deanna Jacquelyn,9998,0,9999,1
1668565992236,COGS 210B,002,101417,Xia; Haijun,9999,0,9999,0
1668565992236,COGS 210B,003,101422,Nitz; Douglas A.,9999,0,9999,0
1668565992236,COGS 210B,004,101423,Hollan; James D.,9998,0,9999,1
1668565992236,COGS 210B,005,101424,Deak; Gedeon O.,9998,0,9999,1
1668565992236,COGS 210B,006,101425,Rossano; Federico,9999,0,9999,0
1668565992659,COGS 211B,A00,101427,Coulson; Seana M,9996,0,9999,3
1668565993086,COGS 220,A00,101428,Hollan; James D.,0,17,25,25
1668565993511,COGS 229,A00,101429,Dow; Steven P,17,0,25,8
1668565993941,COGS 230,A00,101430,Klemmer; Scott R,6,0,17,11
1668565994384,COGS 234,A00,101431,Xia; Haijun,0,1,25,25
1668565994808,COGS 260,A00,101432,Kiyonaga; Anastasia,21,0,25,4
1668565994808,COGS 260,B00,101433,Kirsh; David Joel,15,0,25,10
1668565995235,CSE 202,A00,102371,Impagliazzo; Russell,0,70,0,0
1668565995662,CSE 203B,A01,102373,Cheng; Chung Kuan,0,67,0,0
1668565996089,CSE 208,A00,102374,Micciancio; Daniele,0,5,0,0
1668565996515,CSE 209A,A00,112895,Impagliazzo; Russell,0,14,15,15
1668565996943,CSE 209B,A00,108005,Bellare; Mihir,0,7,0,0
1668565997385,CSE 210,A00,113163,Coblenz; Michael J,0,94,0,0
1668565997809,CSE 219,A00,106111,Dow; Steven P,0,8,20,20
1668565998237,CSE 221,A00,102376,Voelker; Geoffrey M.,0,77,0,0
1668565998668,CSE 224,A01,102378,Porter; George M,0,177,0,0
1668565999094,CSE 229A,A00,102379,Savage; Stefan,0,12,0,0
1668565999518,CSE 229C,A00,102380,Munyaka; Imani N. S.,0,10,0,0
1668565999941,CSE 232B,A00,102382,Deutsch; Alin Bernard,0,39,0,0
1668566000365,CSE 234,A01,112904,Kumar; Arun Kumar,0,0,0,0
1668566000801,CSE 237A,A00,102383,Rosing; Tajana Simunic,0,57,0,0
1668566001235,CSE 239A,A00,102384,Deutsch; Alin Bernard,0,16,0,0
1668566001658,CSE 239B,A00,102385,Polikarpova; Nadezhda,0,11,0,0
1668566002084,CSE 240A,A00,102386,Pannuto; Patrick William,0,48,0,0
1668566002507,CSE 240B,A00,102387,Zhao; Jishen,0,51,0,0
1668566002931,CSE 241A,A00,106406,Kang; Mingu,0,9,0,0
1668566003355,CSE 249B,A00,102388,Kahng; Andrew Byun,0,5,8,8
1668566003781,CSE 251B,A01,102392,Cottrell; Garrison W,0,53,0,0
1668566003781,CSE 251B,A02,102393,Cottrell; Garrison W,0,35,0,0
1668566004205,CSE 252B,A00,102394,Ochoa; Benjamin Lawrence,0,65,0,0
1668566004628,CSE 257,A01,102396,Gao; Sicun,0,155,0,0
1668566005052,CSE 272,A00,102397,Li; Tzumao,0,22,0,0
1668566005480,CSE 274,A00,111323,Chern; Albert Ren-Haur,0,16,0,0
1668566005903,CSE 282,A00,102398,Pevzner; Pavel Arkadjevich,0,0,0,0
1668566006328,CSE 284,A00,114175,Gymrek; Melissa Ann,0,30,0,0
1668566006754,CSE 290,A00,102399,Chandraker; Manmohan Krishna,0,11,0,0
1668566006754,CSE 290,B00,102400,Vaccaro; Kristen Marie,0,8,25,25
1668566006754,CSE 290,C00,102414,Pannuto; Patrick William,0,1,25,25
1668566006754,CSE 290,D00,102427,Pevzner; Pavel Arkadjevich,0,0,0,0
1668566006754,CSE 290,E00,102429,Zhao; Jishen,0,6,0,0
1668566006754,CSE 290,F00,102436,Tullsen; Dean Michael,0,6,0,0
1668566006754,CSE 290,G00,102440,Christensen; Henrik I,0,7,20,20
1668566007257,CSE 291,A00,102443,Su; Hao,0,0,0,0
1668566007257,CSE 291,B00,102448,Polikarpova; Nadezhda,0,0,0,0
1668566007257,CSE 291,C00,102453,Vaccaro; Kristen Marie,0,0,0,0
1668566007257,CSE 291,D00,111343,Savage; Stefan,0,0,0,0
1668566007257,CSE 291,E00,116474,Claffy; Kimberly Claire,0,0,0,0
1668566007257,CSE 291,F00,116479,Pasquale; Joseph,0,0,0,0
1668566007701,CSE 293,001,119111,Bafna; Vineet,9999,0,9999,0
1668566007701,CSE 293,002,119118,Bellare; Mihir,9999,0,9999,0
1668566007701,CSE 293,003,119122,Berg-Kirkpatrick; Taylor D,9999,0,9999,0
1668566007701,CSE 293,004,119135,Christensen; Henrik I,9999,0,9999,0
1668566007701,CSE 293,005,119142,Cottrell; Garrison W,9999,0,9999,0
1668566007701,CSE 293,006,119146,Deutsch; Alin Bernard,9999,0,9999,0
1668566007701,CSE 293,007,119159,Esmaeilzadeh; Hadi,9999,0,9999,0
1668566007701,CSE 293,008,119166,Freund; Yoav,9999,0,9999,0
1668566007701,CSE 293,009,119170,Griswold; William G.,9999,0,9999,0
1668566007701,CSE 293,010,119183,Gymrek; Melissa Ann,9999,0,9999,0
1668566007701,CSE 293,011,119190,Heninger; Nadia A,9999,0,9999,0
1668566007701,CSE 293,012,119230,Impagliazzo; Russell,9999,0,9999,0
1668566007701,CSE 293,013,119232,Jhala; Ranjit,9999,0,9999,0
1668566007701,CSE 293,014,119233,Kahng; Andrew Byun,9999,0,9999,0
1668566007701,CSE 293,015,119298,Kane; Daniel Mertz,9999,0,9999,0
1668566007701,CSE 293,016,119299,Kriegman; David J,9999,0,9999,0
1668566007701,CSE 293,017,119300,Kumar; Arun Kumar,9999,0,9999,0
1668566007701,CSE 293,018,119301,Lerner; Sorin,9999,0,9999,0
1668566007701,CSE 293,019,119302,Lovett; Shachar,9999,0,9999,0
1668566007701,CSE 293,020,119303,McAuley; Julian John,9999,0,9999,0
1668566007701,CSE 293,021,119304,Micciancio; Daniele,9999,0,9999,0
1668566007701,CSE 293,022,119367,Orailoglu; Alex,9999,0,9999,0
1668566007701,CSE 293,023,119382,Paturi; Ramamohan,9999,0,9999,0
1668566007701,CSE 293,024,119404,Polikarpova; Nadezhda,9999,0,9999,0
1668566007701,CSE 293,025,119406,Politz; Joseph Gibbs,9999,0,9999,0
1668566007701,CSE 293,026,119411,Porter; George M,9999,0,9999,0
1668566007701,CSE 293,027,119414,Porter; Leonard Emerson,9999,0,9999,0
1668566007701,CSE 293,028,119416,Ramamoorthi; Ravi,9999,0,9999,0
1668566007701,CSE 293,029,119417,Sahoo; Debashis,9999,0,9999,0
1668566007701,CSE 293,030,119420,Saul; Lawrence,9999,0,9999,0
1668566007701,CSE 293,031,119421,Savage; Stefan,9999,0,9999,0
1668566007701,CSE 293,032,119425,Schulze; Jurgen P.,9999,0,9999,0
1668566007701,CSE 293,033,119426,Snoeren; Alex C.,9999,0,9999,0
1668566007701,CSE 293,034,119428,Shang; Jingbo,9999,0,9999,0
1668566007701,CSE 293,035,119430,Stefan; Deian,9999,0,9999,0
1668566007701,CSE 293,036,119431,Su; Hao,9999,0,9999,0
1668566007701,CSE 293,037,119433,Swanson; Steven James,9999,0,9999,0
1668566007701,CSE 293,038,119435,Tullsen; Dean Michael,9999,0,9999,0
1668566007701,CSE 293,039,119483,Voelker; Geoffrey M.,9999,0,9999,0
1668566007701,CSE 293,040,119537,Zhao; Jishen,9999,0,9999,0
1668566007701,CSE 293,041,119538,Zhou; Yuan-Yuan,9999,0,9999,0
1668566007701,CSE 293,042,119539,Gao; Sicun,9999,0,9999,0
1668566007701,CSE 293,043,119540,Weibel; Nadir,9999,0,9999,0
1668566007701,CSE 293,044,119541,Gupta; Rajesh K.,9999,0,9999,0
1668566007701,CSE 293,045,126410,Vaccaro; Kristen Marie,9999,0,9999,0
1668566007701,CSE 293,046,126411,Klemke; Richard,9999,0,9999,0
1668566008132,CSE 294,A00,102459,Voelker; Geoffrey M.,0,2,0,0
1668566008132,CSE 294,B00,111322,Orailoglu; Alex,0,2,0,0
1668566008559,DSE 201,A00,096914,Deutsch; Alin Bernard,30,0,30,0
1668566008981,DSE 210,A00,096915,Dasgupta; Sanjoy,30,0,30,0
1668566009412,DSE 260A,A00,096916,Altintas De Callaf; Ilkay,30,0,30,0
1668566009850,ECE 200,001,103586,Antipa; Nicholas A,9999,0,9999,0
1668566009850,ECE 200,002,103587,Atanasov; Nikolay A.,9999,0,9999,0
1668566009850,ECE 200,003,103588,Bharadia; Dinesh,9999,0,9999,0
1668566009850,ECE 200,004,103589,Cheng; Chung Kuan,9999,0,9999,0
1668566009850,ECE 200,005,103590,Cosman; Pamela C.,9999,0,9999,0
1668566009850,ECE 200,006,103591,Dayeh; Shadi Ahmad,9999,0,9999,0
1668566009850,ECE 200,007,103592,Fainman; Yeshaiahu,9999,0,9999,0
1668566009850,ECE 200,008,103593,Ford; Joseph Earl,9999,0,9999,0
1668566009850,ECE 200,009,103594,Franceschetti; Massimo,9999,0,9999,0
1668566009850,ECE 200,010,103595,Fullerton; Eric E,9999,0,9999,0
1668566009850,ECE 200,011,103596,Galton; Ian A,9999,0,9999,0
1668566009850,ECE 200,012,103597,Gilja; Vikash,9999,0,9999,0
1668566009850,ECE 200,013,103598,Hall; Drew A.,9999,0,9999,0
1668566009850,ECE 200,014,103599,Hsueh; Tzu-Chien,9999,0,9999,0
1668566009850,ECE 200,015,103600,Javidi; Tara,9999,0,9999,0
1668566009850,ECE 200,016,103601,Kahng; Andrew Byun,9999,0,9999,0
1668566009850,ECE 200,017,103602,Kim; Young-Han,9999,0,9999,0
1668566009850,ECE 200,018,103603,Koushanfar; Farinaz,9999,0,9999,0
1668566009850,ECE 200,019,103604,Kuzum; Duygu,9999,0,9999,0
1668566009850,ECE 200,020,103605,Le; Hanh-Phuc,9999,0,9999,0
1668566009850,ECE 200,021,103606,Lin; Bill,9999,0,9999,0
1668566009850,ECE 200,022,103607,Liu; Zhaowei,9998,0,9999,1
1668566009850,ECE 200,023,103608,Lo; Yu-Hwa,9999,0,9999,0
1668566009850,ECE 200,024,103609,Lomakin; Vitaliy,9999,0,9999,0
1668566009850,ECE 200,025,103610,Mercier; Patrick Philip,9999,0,9999,0
1668566009850,ECE 200,026,103611,Meyer; Florian,9999,0,9999,0
1668566009850,ECE 200,027,103612,Milstein; Laurence B.,9999,0,9999,0
1668566009850,ECE 200,028,103613,Mir Arabbaygi; Siavash,9999,0,9999,0
1668566009850,ECE 200,029,103614,Mookherjea; Shayan,9999,0,9999,0
1668566009850,ECE 200,030,103615,Morris; Karcher William,9999,0,9999,0
1668566009850,ECE 200,031,103616,Ng; Tse Nga,9999,0,9999,0
1668566009850,ECE 200,032,103617,Nguyen; Truong Quang,9999,0,9999,0
1668566009850,ECE 200,033,103618,Nomura; Kenji,9999,0,9999,0
1668566009850,ECE 200,034,103619,Orlitsky; Alon,9999,0,9999,0
1668566009850,ECE 200,035,103620,Pal; Piya,9999,0,9999,0
1668566009850,ECE 200,036,103621,Papen; George C.,9999,0,9999,0
1668566009850,ECE 200,037,103622,Radic; Stojan,9999,0,9999,0
1668566009850,ECE 200,038,103623,Rao; Bhaskar D.,9999,0,9999,0
1668566009850,ECE 200,039,103624,Rao; Ramesh R,9999,0,9999,0
1668566009850,ECE 200,040,103625,Rebeiz; Gabriel,9999,0,9999,0
1668566009850,ECE 200,041,103626,Sanford; John R,9999,0,9999,0
1668566009850,ECE 200,042,103627,Siegel; Paul H.,9999,0,9999,0
1668566009850,ECE 200,043,103628,Sievenpiper; Daniel F.,9999,0,9999,0
1668566009850,ECE 200,044,103629,Sworder; David D.,9999,0,9999,0
1668566009850,ECE 200,045,103630,Taur; Yuan,9999,0,9999,0
1668566009850,ECE 200,046,103631,Touri; Behrouz,9999,0,9999,0
1668566009850,ECE 200,047,103632,Trivedi; Mohan M.,9999,0,9999,0
1668566009850,ECE 200,048,103633,Vasconcelos; Nuno,9999,0,9999,0
1668566009850,ECE 200,049,103634,Wang; Xiaolong,9999,0,9999,0
1668566009850,ECE 200,050,103635,Xie; Pengtao,9999,0,9999,0
1668566009850,ECE 200,051,103636,Yip; Michael,9999,0,9999,0
1668566009850,ECE 200,052,103637,Zeger; Kenneth A.,999,0,999,0
1668566009850,ECE 200,053,103638,Zhang; Xinyu,9999,0,9999,0
1668566009850,ECE 200,054,103639,Turakhia; Yatish Girish,9999,0,9999,0
1668566009850,ECE 200,055,103640,Kang; Mingu,9999,0,9999,0
1668566009850,ECE 200,056,103641,Shi; Yuanyuan,9999,0,9999,0
1668566009850,ECE 200,057,103642,Wang; Edward Jay,9999,0,9999,0
1668566009850,ECE 200,058,103643,Zheng; Yang,9999,0,9999,0
1668566010280,ECE 202,A00,103644,Kuzum; Duygu,0,46,0,0
1668566010704,ECE 212BN,A00,103646,Ng; Tse Nga,0,9,0,0
1668566011134,ECE 221,A00,111493,Staff,0,0,0,0
1668566011561,ECE 222B,A00,103647,Lomakin; Vitaliy,0,21,0,0
1668566011987,ECE 230B,A00,103648,Taur; Yuan,0,4,0,0
1668566012410,ECE 238B,A00,103649,Garay; Javier,0,0,0,0
1668566012841,ECE 240B,A00,112900,Fainman; Yeshaiahu,0,8,0,0
1668566013267,ECE 247A,A00,103650,Jokerst; Jesse Vincent,0,6,0,0
1668566013690,ECE 247B,A00,103651,Wang; Joseph,0,15,0,0
1668566014114,ECE 250,A00,103652,Siegel; Paul H.,0,85,0,0
1668566014549,ECE 251A,A00,103654,Rao; Bhaskar D.,0,64,0,0
1668566014976,ECE 257B,A00,103655,Bharadia; Dinesh,0,33,0,0
1668566015412,ECE 258A,A00,103656,Milstein; Laurence B.,0,29,0,0
1668566015840,ECE 260B,A00,103658,Kang; Mingu,0,121,0,0
1668566016264,ECE 264A,A00,103659,Galton; Ian A,0,46,0,29
1668566016689,ECE 265A,A00,103661,Gudem; Prasad S.S.,0,49,0,28
1668566017112,ECE 265D,A00,103662,Gudem; Prasad S.S.,0,27,0,0
1668566017536,ECE 268,A00,103663,Koushanfar; Farinaz,0,44,0,0
1668566017958,ECE 269,A01,103665,Pal; Piya,0,222,0,0
1668566018382,ECE 271B,A00,103666,Vasconcelos; Manuela,0,78,0,0
1668566018809,ECE 276A,A00,103667,Atanasov; Nikolay A.,0,126,0,0
1668566019230,ECE 277,A00,103668,An; Cheolhong,0,151,0,0
1668566019653,ECE 279,A00,117947,Hall; Drew A.,0,22,0,0
1668566020505,ECE 283,A00,103670,Hsueh; Tzu-Chien,0,57,0,0
1668566020929,ECE 284,A00,103671,Turakhia; Yatish Girish,0,41,0,0
1668566021366,ECE 285,A00,103672,Zheng; Yang,0,41,0,0
1668566021366,ECE 285,B00,103673,Sworder; David D.,0,61,0,0
1668566021787,ECE 287,A00,103676,Javidi; Tara,0,8,0,0
1668566022213,MATH 200B,A00,098023,Salehi Golsefidy; Alireza,7,0,15,8
1668566022636,MATH 202B,A00,098024,Rhoades; Brendon Patrick,7,0,15,8
1668566023069,MATH 203B,A00,098025,Oprea; Dragos N.,9,0,15,6
1668566023518,MATH 204B,A00,098026,Sorensen; Claus M,13,0,15,2
1668566023942,MATH 208,A00,098027,Izadi; Elham,7,0,10,3
1668566024366,MATH 209,A00,098028,Pollack; Aaron,10,0,10,0
1668566024800,MATH 211A,A00,112919,Rogalski; Daniel,8,0,10,2
1668566025229,MATH 211B,A00,112920,Seward; Brandon M.,9,0,10,1
1668566025657,MATH 218,A00,098029,Li; Bo,10,0,10,0
1668566026091,MATH 220B,A00,098030,Novak; Jonathan I,10,0,15,5
1668566026514,MATH 221A,A00,098031,Ebenfelt; Peter F,12,0,15,3
1668566026938,MATH 231B,A00,098032,Zlatos; Andrej,9,0,15,6
1668566027366,MATH 240B,A00,098033,Ni; Lei,7,0,15,8
1668566027804,MATH 243,A00,098034,Jekel; David Andrew,10,0,10,0
1668566028228,MATH 245A,A00,098035,Nie; Jiawang,0,7,15,18
1668566028654,MATH 248,A00,098036,Bejenaru; Ioan,10,0,10,0
1668566029078,MATH 250B,A00,098037,Spolaor; Luca,12,0,15,3
1668566029503,MATH 258,A00,098038,Ni; Lei,8,0,10,2
1668566029940,MATH 264B,A00,098041,Rhoades; Brendon Patrick,7,0,15,8
1668566030364,MATH 268,A00,098042,Buss; Samuel R,10,0,10,0
1668566030785,MATH 269,A00,098043,Rhoades; Brendon Patrick,10,0,10,0
1668566031211,MATH 270B,A00,098044,Li; Bo,6,0,15,9
1668566031632,MATH 272B,A00,098045,Holst; Michael J,13,0,15,2
1668566032062,MATH 273A,A00,098046,Tian; Xiaochuan,10,0,15,5
1668566032488,MATH 275,A01,098048,Tian; Xiaochuan,6,0,10,4
1668566032918,MATH 278A,A00,098049,Holst; Michael J,6,0,10,4
1668566033343,MATH 278B,A00,098050,Cloninger; Alexander,10,0,10,0
1668566033765,MATH 278C,A00,098051,Nie; Jiawang,5,0,10,5
1668566034198,MATH 280B,A00,098052,Zheng; Tianyi,6,0,15,9
1668566034622,MATH 281B,A00,098053,Bradic; Jelena,0,2,15,15
1668566035046,MATH 282B,A00,098054,Arias-Castro; Ery,0,1,15,15
1668566035470,MATH 285,A00,098055,Fitzsimmons; Patrick J,0,4,15,17
1668566035902,MATH 287B,A00,098056,Arias-Castro; Ery,1,0,15,14
1668566036342,MATH 288,A00,098057,Agarwal; Pooja,9,0,10,1
1668566036342,MATH 288,B00,098058,Zhang; Danna,8,0,10,2
1668566036342,MATH 288,C00,098059,Williams; Ruth J,9,0,10,1
1668566036767,MATH 290B,A00,098060,Roberts; Justin Deritter,11,0,15,4
1668566037201,MATH 292,A00,098061,Belmont; Eva Kinoshita,10,0,10,0
1668566037628,MATH 295,A00,098062,Suk; Andrew Hoon,47,0,50,3
1668566038054,MATH 296,A00,098063,Novak; Jonathan I,20,0,20,0
1668566038479,MATH 297,001,098064,Gamst; Anthony Collins,9997,0,9999,2
1668566553067,COGS 205,A00,101395,Chiba; Andrea,19,0,20,1
1668566553491,COGS 210B,001,101404,Greene; Deanna Jacquelyn,9998,0,9999,1
1668566553491,COGS 210B,002,101417,Xia; Haijun,9999,0,9999,0
1668566553491,COGS 210B,003,101422,Nitz; Douglas A.,9999,0,9999,0
1668566553491,COGS 210B,004,101423,Hollan; James D.,9998,0,9999,1
1668566553491,COGS 210B,005,101424,Deak; Gedeon O.,9998,0,9999,1
1668566553491,COGS 210B,006,101425,Rossano; Federico,9999,0,9999,0
1668566553914,COGS 211B,A00,101427,Coulson; Seana M,9996,0,9999,3
1668566554353,COGS 220,A00,101428,Hollan; James D.,0,17,25,25
1668566554789,COGS 229,A00,101429,Dow; Steven P,17,0,25,8
1668566555216,COGS 230,A00,101430,Klemmer; Scott R,6,0,17,11
1668566555643,COGS 234,A00,101431,Xia; Haijun,0,1,25,25
1668566556073,COGS 260,A00,101432,Kiyonaga; Anastasia,21,0,25,4
1668566556073,COGS 260,B00,101433,Kirsh; David Joel,15,0,25,10
1668566556502,CSE 202,A00,102371,Impagliazzo; Russell,0,70,0,0
1668566556926,CSE 203B,A01,102373,Cheng; Chung Kuan,0,67,0,0
1668566557352,CSE 208,A00,102374,Micciancio; Daniele,0,5,0,0
1668566557779,CSE 209A,A00,112895,Impagliazzo; Russell,0,14,15,15
1668566558203,CSE 209B,A00,108005,Bellare; Mihir,0,7,0,0
1668566558630,CSE 210,A00,113163,Coblenz; Michael J,0,94,0,0
1668566559064,CSE 219,A00,106111,Dow; Steven P,0,8,20,20
1668566559490,CSE 221,A00,102376,Voelker; Geoffrey M.,0,77,0,0
1668566559915,CSE 224,A01,102378,Porter; George M,0,177,0,0
1668566560346,CSE 229A,A00,102379,Savage; Stefan,0,12,0,0
1668566560770,CSE 229C,A00,102380,Munyaka; Imani N. S.,0,10,0,0
1668566561209,CSE 232B,A00,102382,Deutsch; Alin Bernard,0,39,0,0
1668566561647,CSE 234,A01,112904,Kumar; Arun Kumar,0,0,0,0
1668566562072,CSE 237A,A00,102383,Rosing; Tajana Simunic,0,57,0,0
1668566562509,CSE 239A,A00,102384,Deutsch; Alin Bernard,0,16,0,0
1668566562932,CSE 239B,A00,102385,Polikarpova; Nadezhda,0,11,0,0
1668566563361,CSE 240A,A00,102386,Pannuto; Patrick William,0,48,0,0
1668566563788,CSE 240B,A00,102387,Zhao; Jishen,0,51,0,0
1668566564223,CSE 241A,A00,106406,Kang; Mingu,0,9,0,0
1668566564648,CSE 249B,A00,102388,Kahng; Andrew Byun,0,5,8,8
1668566565074,CSE 251B,A01,102392,Cottrell; Garrison W,0,53,0,0
1668566565074,CSE 251B,A02,102393,Cottrell; Garrison W,0,35,0,0
1668566565506,CSE 252B,A00,102394,Ochoa; Benjamin Lawrence,0,65,0,0
1668566565940,CSE 257,A01,102396,Gao; Sicun,0,155,0,0
1668566566371,CSE 272,A00,102397,Li; Tzumao,0,22,0,0
1668566566796,CSE 274,A00,111323,Chern; Albert Ren-Haur,0,16,0,0
1668566567220,CSE 282,A00,102398,Pevzner; Pavel Arkadjevich,0,0,0,0
1668566567656,CSE 284,A00,114175,Gymrek; Melissa Ann,0,30,0,0
1668566568081,CSE 290,A00,102399,Chandraker; Manmohan Krishna,0,11,0,0
1668566568081,CSE 290,B00,102400,Vaccaro; Kristen Marie,0,8,25,25
1668566568081,CSE 290,C00,102414,Pannuto; Patrick William,0,1,25,25
1668566568081,CSE 290,D00,102427,Pevzner; Pavel Arkadjevich,0,0,0,0
1668566568081,CSE 290,E00,102429,Zhao; Jishen,0,6,0,0
1668566568081,CSE 290,F00,102436,Tullsen; Dean Michael,0,6,0,0
1668566568081,CSE 290,G00,102440,Christensen; Henrik I,0,7,20,20
1668566568509,CSE 291,A00,102443,Su; Hao,0,0,0,0
1668566568509,CSE 291,B00,102448,Polikarpova; Nadezhda,0,0,0,0
1668566568509,CSE 291,C00,102453,Vaccaro; Kristen Marie,0,0,0,0
1668566568509,CSE 291,D00,111343,Savage; Stefan,0,0,0,0
1668566568509,CSE 291,E00,116474,Claffy; Kimberly Claire,0,0,0,0
1668566568509,CSE 291,F00,116479,Pasquale; Joseph,0,0,0,0
1668566568939,CSE 293,001,119111,Bafna; Vineet,9999,0,9999,0
1668566568939,CSE 293,002,119118,Bellare; Mihir,9999,0,9999,0
1668566568939,CSE 293,003,119122,Berg-Kirkpatrick; Taylor D,9999,0,9999,0
1668566568939,CSE 293,004,119135,Christensen; Henrik I,9999,0,9999,0
1668566568939,CSE 293,005,119142,Cottrell; Garrison W,9999,0,9999,0
1668566568939,CSE 293,006,119146,Deutsch; Alin Bernard,9999,0,9999,0
1668566568939,CSE 293,007,119159,Esmaeilzadeh; Hadi,9999,0,9999,0
1668566568939,CSE 293,008,119166,Freund; Yoav,9999,0,9999,0
1668566568939,CSE 293,009,119170,Griswold; William G.,9999,0,9999,0
1668566568939,CSE 293,010,119183,Gymrek; Melissa Ann,9999,0,9999,0
1668566568939,CSE 293,011,119190,Heninger; Nadia A,9999,0,9999,0
1668566568939,CSE 293,012,119230,Impagliazzo; Russell,9999,0,9999,0
1668566568939,CSE 293,013,119232,Jhala; Ranjit,9999,0,9999,0
1668566568939,CSE 293,014,119233,Kahng; Andrew Byun,9999,0,9999,0
1668566568939,CSE 293,015,119298,Kane; Daniel Mertz,9999,0,9999,0
1668566568939,CSE 293,016,119299,Kriegman; David J,9999,0,9999,0
1668566568939,CSE 293,017,119300,Kumar; Arun Kumar,9999,0,9999,0
1668566568939,CSE 293,018,119301,Lerner; Sorin,9999,0,9999,0
1668566568939,CSE 293,019,119302,Lovett; Shachar,9999,0,9999,0
1668566568939,CSE 293,020,119303,McAuley; Julian John,9999,0,9999,0
1668566568939,CSE 293,021,119304,Micciancio; Daniele,9999,0,9999,0
1668566568939,CSE 293,022,119367,Orailoglu; Alex,9999,0,9999,0
1668566568939,CSE 293,023,119382,Paturi; Ramamohan,9999,0,9999,0
1668566568939,CSE 293,024,119404,Polikarpova; Nadezhda,9999,0,9999,0
1668566568939,CSE 293,025,119406,Politz; Joseph Gibbs,9999,0,9999,0
1668566568939,CSE 293,026,119411,Porter; George M,9999,0,9999,0
1668566568939,CSE 293,027,119414,Porter; Leonard Emerson,9999,0,9999,0
1668566568939,CSE 293,028,119416,Ramamoorthi; Ravi,9999,0,9999,0
1668566568939,CSE 293,029,119417,Sahoo; Debashis,9999,0,9999,0
1668566568939,CSE 293,030,119420,Saul; Lawrence,9999,0,9999,0
1668566568939,CSE 293,031,119421,Savage; Stefan,9999,0,9999,0
1668566568939,CSE 293,032,119425,Schulze; Jurgen P.,9999,0,9999,0
1668566568939,CSE 293,033,119426,Snoeren; Alex C.,9999,0,9999,0
1668566568939,CSE 293,034,119428,Shang; Jingbo,9999,0,9999,0
1668566568939,CSE 293,035,119430,Stefan; Deian,9999,0,9999,0
1668566568939,CSE 293,036,119431,Su; Hao,9999,0,9999,0
1668566568939,CSE 293,037,119433,Swanson; Steven James,9999,0,9999,0
1668566568939,CSE 293,038,119435,Tullsen; Dean Michael,9999,0,9999,0
1668566568939,CSE 293,039,119483,Voelker; Geoffrey M.,9999,0,9999,0
1668566568939,CSE 293,040,119537,Zhao; Jishen,9999,0,9999,0
1668566568939,CSE 293,041,119538,Zhou; Yuan-Yuan,9999,0,9999,0
1668566568939,CSE 293,042,119539,Gao; Sicun,9999,0,9999,0
1668566568939,CSE 293,043,119540,Weibel; Nadir,9999,0,9999,0
1668566568939,CSE 293,044,119541,Gupta; Rajesh K.,9999,0,9999,0
1668566568939,CSE 293,045,126410,Vaccaro; Kristen Marie,9999,0,9999,0
1668566568939,CSE 293,046,126411,Klemke; Richard,9999,0,9999,0
1668566569362,CSE 294,A00,102459,Voelker; Geoffrey M.,0,2,0,0
1668566569362,CSE 294,B00,111322,Orailoglu; Alex,0,2,0,0
1668566569789,DSE 201,A00,096914,Deutsch; Alin Bernard,30,0,30,0
1668566570228,DSE 210,A00,096915,Dasgupta; Sanjoy,30,0,30,0
1668566570653,DSE 260A,A00,096916,Altintas De Callaf; Ilkay,30,0,30,0
1668566571084,ECE 200,001,103586,Antipa; Nicholas A,9999,0,9999,0
1668566571084,ECE 200,002,103587,Atanasov; Nikolay A.,9999,0,9999,0
1668566571084,ECE 200,003,103588,Bharadia; Dinesh,9999,0,9999,0
1668566571084,ECE 200,004,103589,Cheng; Chung Kuan,9999,0,9999,0
1668566571084,ECE 200,005,103590,Cosman; Pamela C.,9999,0,9999,0
1668566571084,ECE 200,006,103591,Dayeh; Shadi Ahmad,9999,0,9999,0
1668566571084,ECE 200,007,103592,Fainman; Yeshaiahu,9999,0,9999,0
1668566571084,ECE 200,008,103593,Ford; Joseph Earl,9999,0,9999,0
1668566571084,ECE 200,009,103594,Franceschetti; Massimo,9999,0,9999,0
1668566571084,ECE 200,010,103595,Fullerton; Eric E,9999,0,9999,0
1668566571084,ECE 200,011,103596,Galton; Ian A,9999,0,9999,0
1668566571084,ECE 200,012,103597,Gilja; Vikash,9999,0,9999,0
1668566571084,ECE 200,013,103598,Hall; Drew A.,9999,0,9999,0
1668566571084,ECE 200,014,103599,Hsueh; Tzu-Chien,9999,0,9999,0
1668566571084,ECE 200,015,103600,Javidi; Tara,9999,0,9999,0
1668566571084,ECE 200,016,103601,Kahng; Andrew Byun,9999,0,9999,0
1668566571084,ECE 200,017,103602,Kim; Young-Han,9999,0,9999,0
1668566571084,ECE 200,018,103603,Koushanfar; Farinaz,9999,0,9999,0
1668566571084,ECE 200,019,103604,Kuzum; Duygu,9999,0,9999,0
1668566571084,ECE 200,020,103605,Le; Hanh-Phuc,9999,0,9999,0
1668566571084,ECE 200,021,103606,Lin; Bill,9999,0,9999,0
1668566571084,ECE 200,022,103607,Liu; Zhaowei,9998,0,9999,1
1668566571084,ECE 200,023,103608,Lo; Yu-Hwa,9999,0,9999,0
1668566571084,ECE 200,024,103609,Lomakin; Vitaliy,9999,0,9999,0
1668566571084,ECE 200,025,103610,Mercier; Patrick Philip,9999,0,9999,0
1668566571084,ECE 200,026,103611,Meyer; Florian,9999,0,9999,0
1668566571084,ECE 200,027,103612,Milstein; Laurence B.,9999,0,9999,0
1668566571084,ECE 200,028,103613,Mir Arabbaygi; Siavash,9999,0,9999,0
1668566571084,ECE 200,029,103614,Mookherjea; Shayan,9999,0,9999,0
1668566571084,ECE 200,030,103615,Morris; Karcher William,9999,0,9999,0
1668566571084,ECE 200,031,103616,Ng; Tse Nga,9999,0,9999,0
1668566571084,ECE 200,032,103617,Nguyen; Truong Quang,9999,0,9999,0
1668566571084,ECE 200,033,103618,Nomura; Kenji,9999,0,9999,0
1668566571084,ECE 200,034,103619,Orlitsky; Alon,9999,0,9999,0
1668566571084,ECE 200,035,103620,Pal; Piya,9999,0,9999,0
1668566571084,ECE 200,036,103621,Papen; George C.,9999,0,9999,0
1668566571084,ECE 200,037,103622,Radic; Stojan,9999,0,9999,0
1668566571084,ECE 200,038,103623,Rao; Bhaskar D.,9999,0,9999,0
1668566571084,ECE 200,039,103624,Rao; Ramesh R,9999,0,9999,0
1668566571084,ECE 200,040,103625,Rebeiz; Gabriel,9999,0,9999,0
1668566571084,ECE 200,041,103626,Sanford; John R,9999,0,9999,0
1668566571084,ECE 200,042,103627,Siegel; Paul H.,9999,0,9999,0
1668566571084,ECE 200,043,103628,Sievenpiper; Daniel F.,9999,0,9999,0
1668566571084,ECE 200,044,103629,Sworder; David D.,9999,0,9999,0
1668566571084,ECE 200,045,103630,Taur; Yuan,9999,0,9999,0
1668566571084,ECE 200,046,103631,Touri; Behrouz,9999,0,9999,0
1668566571084,ECE 200,047,103632,Trivedi; Mohan M.,9999,0,9999,0
1668566571084,ECE 200,048,103633,Vasconcelos; Nuno,9999,0,9999,0
1668566571084,ECE 200,049,103634,Wang; Xiaolong,9999,0,9999,0
1668566571084,ECE 200,050,103635,Xie; Pengtao,9999,0,9999,0
1668566571084,ECE 200,051,103636,Yip; Michael,9999,0,9999,0
1668566571084,ECE 200,052,103637,Zeger; Kenneth A.,999,0,999,0
1668566571084,ECE 200,053,103638,Zhang; Xinyu,9999,0,9999,0
1668566571084,ECE 200,054,103639,Turakhia; Yatish Girish,9999,0,9999,0
1668566571084,ECE 200,055,103640,Kang; Mingu,9999,0,9999,0
1668566571084,ECE 200,056,103641,Shi; Yuanyuan,9999,0,9999,0
1668566571084,ECE 200,057,103642,Wang; Edward Jay,9999,0,9999,0
1668566571084,ECE 200,058,103643,Zheng; Yang,9999,0,9999,0
1668566571516,ECE 202,A00,103644,Kuzum; Duygu,0,46,0,0
1668566571942,ECE 212BN,A00,103646,Ng; Tse Nga,0,9,0,0
1668566572366,ECE 221,A00,111493,Staff,0,0,0,0
1668566572790,ECE 222B,A00,103647,Lomakin; Vitaliy,0,21,0,0
1668566573216,ECE 230B,A00,103648,Taur; Yuan,0,4,0,0
1668566573646,ECE 238B,A00,103649,Garay; Javier,0,0,0,0
1668566574069,ECE 240B,A00,112900,Fainman; Yeshaiahu,0,8,0,0
1668566574505,ECE 247A,A00,103650,Jokerst; Jesse Vincent,0,6,0,0
1668566574934,ECE 247B,A00,103651,Wang; Joseph,0,15,0,0
1668566575373,ECE 250,A00,103652,Siegel; Paul H.,0,85,0,0
1668566575795,ECE 251A,A00,103654,Rao; Bhaskar D.,0,65,0,0
1668566576219,ECE 257B,A00,103655,Bharadia; Dinesh,0,33,0,0
1668566576643,ECE 258A,A00,103656,Milstein; Laurence B.,0,29,0,0
1668566577076,ECE 260B,A00,103658,Kang; Mingu,0,121,0,0
1668566577499,ECE 264A,A00,103659,Galton; Ian A,0,46,0,29
1668566577922,ECE 265A,A00,103661,Gudem; Prasad S.S.,0,49,0,28
1668566578346,ECE 265D,A00,103662,Gudem; Prasad S.S.,0,27,0,0
1668566578770,ECE 268,A00,103663,Koushanfar; Farinaz,0,44,0,0
1668566579198,ECE 269,A01,103665,Pal; Piya,0,222,0,0
1668566579630,ECE 271B,A00,103666,Vasconcelos; Manuela,0,78,0,0
1668566580059,ECE 276A,A00,103667,Atanasov; Nikolay A.,0,126,0,0
1668566580488,ECE 277,A00,103668,An; Cheolhong,0,151,0,0
1668566580915,ECE 279,A00,117947,Hall; Drew A.,0,22,0,0
1668566581772,ECE 283,A00,103670,Hsueh; Tzu-Chien,0,57,0,0
1668566582200,ECE 284,A00,103671,Turakhia; Yatish Girish,0,41,0,0
1668566582625,ECE 285,A00,103672,Zheng; Yang,0,40,0,0
1668566582625,ECE 285,B00,103673,Sworder; David D.,0,61,0,0
1668566583063,ECE 287,A00,103676,Javidi; Tara,0,8,0,0
1668566583580,MATH 200B,A00,098023,Salehi Golsefidy; Alireza,7,0,15,8
1668566584005,MATH 202B,A00,098024,Rhoades; Brendon Patrick,7,0,15,8
1668566584442,MATH 203B,A00,098025,Oprea; Dragos N.,9,0,15,6
1668566584863,MATH 204B,A00,098026,Sorensen; Claus M,13,0,15,2
1668566585288,MATH 208,A00,098027,Izadi; Elham,7,0,10,3
1668566585718,MATH 209,A00,098028,Pollack; Aaron,10,0,10,0
1668566586149,MATH 211A,A00,112919,Rogalski; Daniel,8,0,10,2
1668566586575,MATH 211B,A00,112920,Seward; Brandon M.,9,0,10,1
1668566587015,MATH 218,A00,098029,Li; Bo,10,0,10,0
1668566587453,MATH 220B,A00,098030,Novak; Jonathan I,10,0,15,5
1668566587883,MATH 221A,A00,098031,Ebenfelt; Peter F,12,0,15,3
1668566588307,MATH 231B,A00,098032,Zlatos; Andrej,9,0,15,6
1668566588730,MATH 240B,A00,098033,Ni; Lei,7,0,15,8
1668566589156,MATH 243,A00,098034,Jekel; David Andrew,10,0,10,0
1668566589587,MATH 245A,A00,098035,Nie; Jiawang,0,7,15,18
1668566590022,MATH 248,A00,098036,Bejenaru; Ioan,10,0,10,0
1668566590445,MATH 250B,A00,098037,Spolaor; Luca,12,0,15,3
1668566590870,MATH 258,A00,098038,Ni; Lei,8,0,10,2
1668566591307,MATH 264B,A00,098041,Rhoades; Brendon Patrick,7,0,15,8
1668566591740,MATH 268,A00,098042,Buss; Samuel R,10,0,10,0
1668566592164,MATH 269,A00,098043,Rhoades; Brendon Patrick,10,0,10,0
1668566592589,MATH 270B,A00,098044,Li; Bo,6,0,15,9
1668566593028,MATH 272B,A00,098045,Holst; Michael J,13,0,15,2
1668566593457,MATH 273A,A00,098046,Tian; Xiaochuan,10,0,15,5
1668566593880,MATH 275,A01,098048,Tian; Xiaochuan,6,0,10,4
1668566594314,MATH 278A,A00,098049,Holst; Michael J,6,0,10,4
1668566594757,MATH 278B,A00,098050,Cloninger; Alexander,10,0,10,0
1668566595183,MATH 278C,A00,098051,Nie; Jiawang,5,0,10,5
1668566595605,MATH 280B,A00,098052,Zheng; Tianyi,6,0,15,9
1668566596031,MATH 281B,A00,098053,Bradic; Jelena,0,2,15,15
1668566596459,MATH 282B,A00,098054,Arias-Castro; Ery,0,1,15,15
1668566596886,MATH 285,A00,098055,Fitzsimmons; Patrick J,0,4,15,17
1668566597309,MATH 287B,A00,098056,Arias-Castro; Ery,1,0,15,14
1668566597732,MATH 288,A00,098057,Agarwal; Pooja,9,0,10,1
1668566597732,MATH 288,B00,098058,Zhang; Danna,8,0,10,2
1668566597732,MATH 288,C00,098059,Williams; Ruth J,9,0,10,1
1668566598155,MATH 290B,A00,098060,Roberts; Justin Deritter,11,0,15,4
1668566598582,MATH 292,A00,098061,Belmont; Eva Kinoshita,10,0,10,0
1668566599015,MATH 295,A00,098062,Suk; Andrew Hoon,47,0,50,3
1668566599441,MATH 296,A00,098063,Novak; Jonathan I,20,0,20,0
1668566599866,MATH 297,001,098064,Gamst; Anthony Collins,9997,0,9999,2
1668567104336,COGS 205,A00,101395,Chiba; Andrea,19,0,20,1
1668567104769,COGS 210B,001,101404,Greene; Deanna Jacquelyn,9998,0,9999,1
1668567104769,COGS 210B,002,101417,Xia; Haijun,9999,0,9999,0
1668567104769,COGS 210B,003,101422,Nitz; Douglas A.,9999,0,9999,0
1668567104769,COGS 210B,004,101423,Hollan; James D.,9998,0,9999,1
1668567104769,COGS 210B,005,101424,Deak; Gedeon O.,9998,0,9999,1
1668567104769,COGS 210B,006,101425,Rossano; Federico,9999,0,9999,0
1668567105193,COGS 211B,A00,101427,Coulson; Seana M,9996,0,9999,3
1668567105616,COGS 220,A00,101428,Hollan; James D.,0,17,25,25
1668567106039,COGS 229,A00,101429,Dow; Steven P,17,0,25,8
1668567106553,COGS 230,A00,101430,Klemmer; Scott R,6,0,17,11
1668567106975,COGS 234,A00,101431,Xia; Haijun,0,1,25,25
1668567107399,COGS 260,A00,101432,Kiyonaga; Anastasia,21,0,25,4
1668567107399,COGS 260,B00,101433,Kirsh; David Joel,15,0,25,10
1668567107822,CSE 202,A00,102371,Impagliazzo; Russell,0,70,0,0
1668567108260,CSE 203B,A01,102373,Cheng; Chung Kuan,0,67,0,0
1668567108691,CSE 208,A00,102374,Micciancio; Daniele,0,5,0,0
1668567109113,CSE 209A,A00,112895,Impagliazzo; Russell,0,14,15,15
1668567109541,CSE 209B,A00,108005,Bellare; Mihir,0,7,0,0
1668567109966,CSE 210,A00,113163,Coblenz; Michael J,0,94,0,0
1668567110391,CSE 219,A00,106111,Dow; Steven P,0,8,20,20
1668567110818,CSE 221,A00,102376,Voelker; Geoffrey M.,0,77,0,0
1668567111253,CSE 224,A01,102378,Porter; George M,0,177,0,0
1668567111688,CSE 229A,A00,102379,Savage; Stefan,0,12,0,0
1668567112118,CSE 229C,A00,102380,Munyaka; Imani N. S.,0,10,0,0
1668567112555,CSE 232B,A00,102382,Deutsch; Alin Bernard,0,39,0,0
1668567112979,CSE 234,A01,112904,Kumar; Arun Kumar,0,0,0,0
1668567113401,CSE 237A,A00,102383,Rosing; Tajana Simunic,0,57,0,0
1668567113825,CSE 239A,A00,102384,Deutsch; Alin Bernard,0,16,0,0
1668567114249,CSE 239B,A00,102385,Polikarpova; Nadezhda,0,11,0,0
1668567114676,CSE 240A,A00,102386,Pannuto; Patrick William,0,48,0,0
1668567115100,CSE 240B,A00,102387,Zhao; Jishen,0,51,0,0
1668567115524,CSE 241A,A00,106406,Kang; Mingu,0,9,0,0
1668567115950,CSE 249B,A00,102388,Kahng; Andrew Byun,0,5,8,8
1668567116374,CSE 251B,A01,102392,Cottrell; Garrison W,0,53,0,0
1668567116374,CSE 251B,A02,102393,Cottrell; Garrison W,0,35,0,0
1668567116802,CSE 252B,A00,102394,Ochoa; Benjamin Lawrence,0,65,0,0
1668567117226,CSE 257,A01,102396,Gao; Sicun,0,155,0,0
1668567117653,CSE 272,A00,102397,Li; Tzumao,0,22,0,0
1668567118079,CSE 274,A00,111323,Chern; Albert Ren-Haur,0,16,0,0
1668567118503,CSE 282,A00,102398,Pevzner; Pavel Arkadjevich,0,0,0,0
1668567118928,CSE 284,A00,114175,Gymrek; Melissa Ann,0,30,0,0
1668567119356,CSE 290,A00,102399,Chandraker; Manmohan Krishna,0,11,0,0
1668567119356,CSE 290,B00,102400,Vaccaro; Kristen Marie,0,8,25,25
1668567119356,CSE 290,C00,102414,Pannuto; Patrick William,0,1,25,25
1668567119356,CSE 290,D00,102427,Pevzner; Pavel Arkadjevich,0,0,0,0
1668567119356,CSE 290,E00,102429,Zhao; Jishen,0,6,0,0
1668567119356,CSE 290,F00,102436,Tullsen; Dean Michael,0,6,0,0
1668567119356,CSE 290,G00,102440,Christensen; Henrik I,0,7,20,20
1668567119787,CSE 291,A00,102443,Su; Hao,0,0,0,0
1668567119787,CSE 291,B00,102448,Polikarpova; Nadezhda,0,0,0,0
1668567119787,CSE 291,C00,102453,Vaccaro; Kristen Marie,0,0,0,0
1668567119787,CSE 291,D00,111343,Savage; Stefan,0,0,0,0
1668567119787,CSE 291,E00,116474,Claffy; Kimberly Claire,0,0,0,0
1668567119787,CSE 291,F00,116479,Pasquale; Joseph,0,0,0,0
1668567120217,CSE 293,001,119111,Bafna; Vineet,9999,0,9999,0
1668567120217,CSE 293,002,119118,Bellare; Mihir,9999,0,9999,0
1668567120217,CSE 293,003,119122,Berg-Kirkpatrick; Taylor D,9999,0,9999,0
1668567120217,CSE 293,004,119135,Christensen; Henrik I,9999,0,9999,0
1668567120217,CSE 293,005,119142,Cottrell; Garrison W,9999,0,9999,0
1668567120217,CSE 293,006,119146,Deutsch; Alin Bernard,9999,0,9999,0
1668567120217,CSE 293,007,119159,Esmaeilzadeh; Hadi,9999,0,9999,0
1668567120217,CSE 293,008,119166,Freund; Yoav,9999,0,9999,0
1668567120217,CSE 293,009,119170,Griswold; William G.,9999,0,9999,0
1668567120217,CSE 293,010,119183,Gymrek; Melissa Ann,9999,0,9999,0
1668567120217,CSE 293,011,119190,Heninger; Nadia A,9999,0,9999,0
1668567120217,CSE 293,012,119230,Impagliazzo; Russell,9999,0,9999,0
1668567120217,CSE 293,013,119232,Jhala; Ranjit,9999,0,9999,0
1668567120217,CSE 293,014,119233,Kahng; Andrew Byun,9999,0,9999,0
1668567120217,CSE 293,015,119298,Kane; Daniel Mertz,9999,0,9999,0
1668567120217,CSE 293,016,119299,Kriegman; David J,9999,0,9999,0
1668567120217,CSE 293,017,119300,Kumar; Arun Kumar,9999,0,9999,0
1668567120217,CSE 293,018,119301,Lerner; Sorin,9999,0,9999,0
1668567120217,CSE 293,019,119302,Lovett; Shachar,9999,0,9999,0
1668567120217,CSE 293,020,119303,McAuley; Julian John,9999,0,9999,0
1668567120217,CSE 293,021,119304,Micciancio; Daniele,9999,0,9999,0
1668567120217,CSE 293,022,119367,Orailoglu; Alex,9999,0,9999,0
1668567120217,CSE 293,023,119382,Paturi; Ramamohan,9999,0,9999,0
1668567120217,CSE 293,024,119404,Polikarpova; Nadezhda,9999,0,9999,0
1668567120217,CSE 293,025,119406,Politz; Joseph Gibbs,9999,0,9999,0
1668567120217,CSE 293,026,119411,Porter; George M,9999,0,9999,0
1668567120217,CSE 293,027,119414,Porter; Leonard Emerson,9999,0,9999,0
1668567120217,CSE 293,028,119416,Ramamoorthi; Ravi,9999,0,9999,0
1668567120217,CSE 293,029,119417,Sahoo; Debashis,9999,0,9999,0
1668567120217,CSE 293,030,119420,Saul; Lawrence,9999,0,9999,0
1668567120217,CSE 293,031,119421,Savage; Stefan,9999,0,9999,0
1668567120217,CSE 293,032,119425,Schulze; Jurgen P.,9999,0,9999,0
1668567120217,CSE 293,033,119426,Snoeren; Alex C.,9999,0,9999,0
1668567120217,CSE 293,034,119428,Shang; Jingbo,9999,0,9999,0
1668567120217,CSE 293,035,119430,Stefan; Deian,9999,0,9999,0
1668567120217,CSE 293,036,119431,Su; Hao,9999,0,9999,0
1668567120217,CSE 293,037,119433,Swanson; Steven James,9999,0,9999,0
1668567120217,CSE 293,038,119435,Tullsen; Dean Michael,9999,0,9999,0
1668567120217,CSE 293,039,119483,Voelker; Geoffrey M.,9999,0,9999,0
1668567120217,CSE 293,040,119537,Zhao; Jishen,9999,0,9999,0
1668567120217,CSE 293,041,119538,Zhou; Yuan-Yuan,9999,0,9999,0
1668567120217,CSE 293,042,119539,Gao; Sicun,9999,0,9999,0
1668567120217,CSE 293,043,119540,Weibel; Nadir,9999,0,9999,0
1668567120217,CSE 293,044,119541,Gupta; Rajesh K.,9999,0,9999,0
1668567120217,CSE 293,045,126410,Vaccaro; Kristen Marie,9999,0,9999,0
1668567120217,CSE 293,046,126411,Klemke; Richard,9999,0,9999,0
1668567120642,CSE 294,A00,102459,Voelker; Geoffrey M.,0,2,0,0
1668567120642,CSE 294,B00,111322,Orailoglu; Alex,0,2,0,0
1668567121073,DSE 201,A00,096914,Deutsch; Alin Bernard,30,0,30,0
1668567121496,DSE 210,A00,096915,Dasgupta; Sanjoy,30,0,30,0
1668567121920,DSE 260A,A00,096916,Altintas De Callaf; Ilkay,30,0,30,0
1668567122361,ECE 200,001,103586,Antipa; Nicholas A,9999,0,9999,0
1668567122361,ECE 200,002,103587,Atanasov; Nikolay A.,9999,0,9999,0
1668567122361,ECE 200,003,103588,Bharadia; Dinesh,9999,0,9999,0
1668567122361,ECE 200,004,103589,Cheng; Chung Kuan,9999,0,9999,0
1668567122361,ECE 200,005,103590,Cosman; Pamela C.,9999,0,9999,0
1668567122361,ECE 200,006,103591,Dayeh; Shadi Ahmad,9999,0,9999,0
1668567122361,ECE 200,007,103592,Fainman; Yeshaiahu,9999,0,9999,0
1668567122361,ECE 200,008,103593,Ford; Joseph Earl,9999,0,9999,0
1668567122361,ECE 200,009,103594,Franceschetti; Massimo,9999,0,9999,0
1668567122361,ECE 200,010,103595,Fullerton; Eric E,9999,0,9999,0
1668567122361,ECE 200,011,103596,Galton; Ian A,9999,0,9999,0
1668567122361,ECE 200,012,103597,Gilja; Vikash,9999,0,9999,0
1668567122361,ECE 200,013,103598,Hall; Drew A.,9999,0,9999,0
1668567122361,ECE 200,014,103599,Hsueh; Tzu-Chien,9999,0,9999,0
1668567122361,ECE 200,015,103600,Javidi; Tara,9999,0,9999,0
1668567122361,ECE 200,016,103601,Kahng; Andrew Byun,9999,0,9999,0
1668567122361,ECE 200,017,103602,Kim; Young-Han,9999,0,9999,0
1668567122361,ECE 200,018,103603,Koushanfar; Farinaz,9999,0,9999,0
1668567122361,ECE 200,019,103604,Kuzum; Duygu,9999,0,9999,0
1668567122361,ECE 200,020,103605,Le; Hanh-Phuc,9999,0,9999,0
1668567122361,ECE 200,021,103606,Lin; Bill,9999,0,9999,0
1668567122361,ECE 200,022,103607,Liu; Zhaowei,9998,0,9999,1
1668567122361,ECE 200,023,103608,Lo; Yu-Hwa,9999,0,9999,0
1668567122361,ECE 200,024,103609,Lomakin; Vitaliy,9999,0,9999,0
1668567122361,ECE 200,025,103610,Mercier; Patrick Philip,9999,0,9999,0
1668567122361,ECE 200,026,103611,Meyer; Florian,9999,0,9999,0
1668567122361,ECE 200,027,103612,Milstein; Laurence B.,9999,0,9999,0
1668567122361,ECE 200,028,103613,Mir Arabbaygi; Siavash,9999,0,9999,0
1668567122361,ECE 200,029,103614,Mookherjea; Shayan,9999,0,9999,0
1668567122361,ECE 200,030,103615,Morris; Karcher William,9999,0,9999,0
1668567122361,ECE 200,031,103616,Ng; Tse Nga,9999,0,9999,0
1668567122361,ECE 200,032,103617,Nguyen; Truong Quang,9999,0,9999,0
1668567122361,ECE 200,033,103618,Nomura; Kenji,9999,0,9999,0
1668567122361,ECE 200,034,103619,Orlitsky; Alon,9999,0,9999,0
1668567122361,ECE 200,035,103620,Pal; Piya,9999,0,9999,0
1668567122361,ECE 200,036,103621,Papen; George C.,9999,0,9999,0
1668567122361,ECE 200,037,103622,Radic; Stojan,9999,0,9999,0
1668567122361,ECE 200,038,103623,Rao; Bhaskar D.,9999,0,9999,0
1668567122361,ECE 200,039,103624,Rao; Ramesh R,9999,0,9999,0
1668567122361,ECE 200,040,103625,Rebeiz; Gabriel,9999,0,9999,0
1668567122361,ECE 200,041,103626,Sanford; John R,9999,0,9999,0
1668567122361,ECE 200,042,103627,Siegel; Paul H.,9999,0,9999,0
1668567122361,ECE 200,043,103628,Sievenpiper; Daniel F.,9999,0,9999,0
1668567122361,ECE 200,044,103629,Sworder; David D.,9999,0,9999,0
1668567122361,ECE 200,045,103630,Taur; Yuan,9999,0,9999,0
1668567122361,ECE 200,046,103631,Touri; Behrouz,9999,0,9999,0
1668567122361,ECE 200,047,103632,Trivedi; Mohan M.,9999,0,9999,0
1668567122361,ECE 200,048,103633,Vasconcelos; Nuno,9999,0,9999,0
1668567122361,ECE 200,049,103634,Wang; Xiaolong,9999,0,9999,0
1668567122361,ECE 200,050,103635,Xie; Pengtao,9999,0,9999,0
1668567122361,ECE 200,051,103636,Yip; Michael,9999,0,9999,0
1668567122361,ECE 200,052,103637,Zeger; Kenneth A.,999,0,999,0
1668567122361,ECE 200,053,103638,Zhang; Xinyu,9999,0,9999,0
1668567122361,ECE 200,054,103639,Turakhia; Yatish Girish,9999,0,9999,0
1668567122361,ECE 200,055,103640,Kang; Mingu,9999,0,9999,0
1668567122361,ECE 200,056,103641,Shi; Yuanyuan,9999,0,9999,0
1668567122361,ECE 200,057,103642,Wang; Edward Jay,9999,0,9999,0
1668567122361,ECE 200,058,103643,Zheng; Yang,9999,0,9999,0
1668567122785,ECE 202,A00,103644,Kuzum; Duygu,0,46,0,0
1668567123212,ECE 212BN,A00,103646,Ng; Tse Nga,0,9,0,0
1668567123635,ECE 221,A00,111493,Staff,0,0,0,0
1668567124059,ECE 222B,A00,103647,Lomakin; Vitaliy,0,21,0,0
1668567124492,ECE 230B,A00,103648,Taur; Yuan,0,4,0,0
1668567124915,ECE 238B,A00,103649,Garay; Javier,0,0,0,0
1668567125354,ECE 240B,A00,112900,Fainman; Yeshaiahu,0,8,0,0
1668567125778,ECE 247A,A00,103650,Jokerst; Jesse Vincent,0,6,0,0
1668567126200,ECE 247B,A00,103651,Wang; Joseph,0,15,0,0
1668567126629,ECE 250,A00,103652,Siegel; Paul H.,0,85,0,0
1668567127053,ECE 251A,A00,103654,Rao; Bhaskar D.,0,65,0,0
1668567127476,ECE 257B,A00,103655,Bharadia; Dinesh,0,33,0,0
1668567127903,ECE 258A,A00,103656,Milstein; Laurence B.,0,29,0,0
1668567128330,ECE 260B,A00,103658,Kang; Mingu,0,121,0,0
1668567128772,ECE 264A,A00,103659,Galton; Ian A,0,46,0,29
1668567129194,ECE 265A,A00,103661,Gudem; Prasad S.S.,0,48,0,29
1668567129626,ECE 265D,A00,103662,Gudem; Prasad S.S.,0,27,0,0
1668567130061,ECE 268,A00,103663,Koushanfar; Farinaz,0,44,0,0
1668567130490,ECE 269,A01,103665,Pal; Piya,0,222,0,0
1668567130917,ECE 271B,A00,103666,Vasconcelos; Manuela,0,78,0,0
1668567131339,ECE 276A,A00,103667,Atanasov; Nikolay A.,0,126,0,0
1668567131767,ECE 277,A00,103668,An; Cheolhong,0,151,0,0
1668567132193,ECE 279,A00,117947,Hall; Drew A.,0,22,0,0
1668567133054,ECE 283,A00,103670,Hsueh; Tzu-Chien,0,57,0,0
1668567133495,ECE 284,A00,103671,Turakhia; Yatish Girish,0,41,0,0
1668567133928,ECE 285,A00,103672,Zheng; Yang,0,40,0,0
1668567133928,ECE 285,B00,103673,Sworder; David D.,0,61,0,0
1668567134359,ECE 287,A00,103676,Javidi; Tara,0,8,0,0
1668567134795,MATH 200B,A00,098023,Salehi Golsefidy; Alireza,7,0,15,8
1668567135221,MATH 202B,A00,098024,Rhoades; Brendon Patrick,7,0,15,8
1668567135650,MATH 203B,A00,098025,Oprea; Dragos N.,9,0,15,6
1668567136073,MATH 204B,A00,098026,Sorensen; Claus M,13,0,15,2
1668567136508,MATH 208,A00,098027,Izadi; Elham,7,0,10,3
1668567136933,MATH 209,A00,098028,Pollack; Aaron,10,0,10,0
1668567137365,MATH 211A,A00,112919,Rogalski; Daniel,8,0,10,2
1668567137788,MATH 211B,A00,112920,Seward; Brandon M.,9,0,10,1
1668567138217,MATH 218,A00,098029,Li; Bo,10,0,10,0
1668567138639,MATH 220B,A00,098030,Novak; Jonathan I,10,0,15,5
1668567139066,MATH 221A,A00,098031,Ebenfelt; Peter F,12,0,15,3
1668567139490,MATH 231B,A00,098032,Zlatos; Andrej,9,0,15,6
1668567139916,MATH 240B,A00,098033,Ni; Lei,7,0,15,8
1668567140343,MATH 243,A00,098034,Jekel; David Andrew,10,0,10,0
1668567140769,MATH 245A,A00,098035,Nie; Jiawang,0,7,15,18
1668567141202,MATH 248,A00,098036,Bejenaru; Ioan,10,0,10,0
1668567141641,MATH 250B,A00,098037,Spolaor; Luca,12,0,15,3
1668567142072,MATH 258,A00,098038,Ni; Lei,8,0,10,2
1668567142496,MATH 264B,A00,098041,Rhoades; Brendon Patrick,7,0,15,8
1668567142919,MATH 268,A00,098042,Buss; Samuel R,10,0,10,0
1668567143350,MATH 269,A00,098043,Rhoades; Brendon Patrick,10,0,10,0
1668567143783,MATH 270B,A00,098044,Li; Bo,6,0,15,9
1668567144211,MATH 272B,A00,098045,Holst; Michael J,13,0,15,2
1668567144638,MATH 273A,A00,098046,Tian; Xiaochuan,10,0,15,5
1668567145063,MATH 275,A01,098048,Tian; Xiaochuan,6,0,10,4
1668567145488,MATH 278A,A00,098049,Holst; Michael J,6,0,10,4
1668567145911,MATH 278B,A00,098050,Cloninger; Alexander,10,0,10,0
1668567146345,MATH 278C,A00,098051,Nie; Jiawang,5,0,10,5
1668567146789,MATH 280B,A00,098052,Zheng; Tianyi,6,0,15,9
1668567147223,MATH 281B,A00,098053,Bradic; Jelena,0,2,15,15
1668567147661,MATH 282B,A00,098054,Arias-Castro; Ery,0,1,15,15
1668567148087,MATH 285,A00,098055,Fitzsimmons; Patrick J,0,4,15,17
1668567148518,MATH 287B,A00,098056,Arias-Castro; Ery,1,0,15,14
1668567148943,MATH 288,A00,098057,Agarwal; Pooja,9,0,10,1
1668567148943,MATH 288,B00,098058,Zhang; Danna,8,0,10,2
1668567148943,MATH 288,C00,098059,Williams; Ruth J,9,0,10,1
1668567149373,MATH 290B,A00,098060,Roberts; Justin Deritter,11,0,15,4
1668567149894,MATH 292,A00,098061,Belmont; Eva Kinoshita,10,0,10,0
1668567150325,MATH 295,A00,098062,Suk; Andrew Hoon,47,0,50,3
1668567150749,MATH 296,A00,098063,Novak; Jonathan I,20,0,20,0
1668567151197,MATH 297,001,098064,Gamst; Anthony Collins,9997,0,9999,2
1668567654829,COGS 205,A00,101395,Chiba; Andrea,19,0,20,1
1668567655277,COGS 210B,001,101404,Greene; Deanna Jacquelyn,9998,0,9999,1
1668567655277,COGS 210B,002,101417,Xia; Haijun,9999,0,9999,0
1668567655277,COGS 210B,003,101422,Nitz; Douglas A.,9999,0,9999,0
1668567655277,COGS 210B,004,101423,Hollan; James D.,9998,0,9999,1
1668567655277,COGS 210B,005,101424,Deak; Gedeon O.,9998,0,9999,1
1668567655277,COGS 210B,006,101425,Rossano; Federico,9999,0,9999,0
1668567655699,COGS 211B,A00,101427,Coulson; Seana M,9996,0,9999,3
1668567656126,COGS 220,A00,101428,Hollan; James D.,0,17,25,25
1668567656550,COGS 229,A00,101429,Dow; Steven P,17,0,25,8
1668567656973,COGS 230,A00,101430,Klemmer; Scott R,6,0,17,11
1668567657401,COGS 234,A00,101431,Xia; Haijun,0,1,25,25
1668567657833,COGS 260,A00,101432,Kiyonaga; Anastasia,21,0,25,4
1668567657833,COGS 260,B00,101433,Kirsh; David Joel,15,0,25,10
1668567658284,CSE 202,A00,102371,Impagliazzo; Russell,0,70,0,0
1668567658714,CSE 203B,A01,102373,Cheng; Chung Kuan,0,67,0,0
1668567659138,CSE 208,A00,102374,Micciancio; Daniele,0,5,0,0
1668567659565,CSE 209A,A00,112895,Impagliazzo; Russell,0,14,15,15
1668567659989,CSE 209B,A00,108005,Bellare; Mihir,0,7,0,0
1668567660416,CSE 210,A00,113163,Coblenz; Michael J,0,94,0,0
1668567660852,CSE 219,A00,106111,Dow; Steven P,0,8,20,20
1668567661278,CSE 221,A00,102376,Voelker; Geoffrey M.,0,77,0,0
1668567661706,CSE 224,A01,102378,Porter; George M,0,177,0,0
1668567662129,CSE 229A,A00,102379,Savage; Stefan,0,12,0,0
1668567662570,CSE 229C,A00,102380,Munyaka; Imani N. S.,0,10,0,0
1668567663007,CSE 232B,A00,102382,Deutsch; Alin Bernard,0,39,0,0
1668567663434,CSE 234,A01,112904,Kumar; Arun Kumar,0,0,0,0
1668567663859,CSE 237A,A00,102383,Rosing; Tajana Simunic,0,57,0,0
1668567664284,CSE 239A,A00,102384,Deutsch; Alin Bernard,0,16,0,0
1668567664711,CSE 239B,A00,102385,Polikarpova; Nadezhda,0,11,0,0
1668567665139,CSE 240A,A00,102386,Pannuto; Patrick William,0,48,0,0
1668567665561,CSE 240B,A00,102387,Zhao; Jishen,0,51,0,0
1668567665987,CSE 241A,A00,106406,Kang; Mingu,0,9,0,0
1668567666415,CSE 249B,A00,102388,Kahng; Andrew Byun,0,5,8,8
1668567666840,CSE 251B,A01,102392,Cottrell; Garrison W,0,53,0,0
1668567666840,CSE 251B,A02,102393,Cottrell; Garrison W,0,35,0,0
1668567667263,CSE 252B,A00,102394,Ochoa; Benjamin Lawrence,0,65,0,0
1668567667693,CSE 257,A01,102396,Gao; Sicun,0,155,0,0
1668567668117,CSE 272,A00,102397,Li; Tzumao,0,22,0,0
1668567668544,CSE 274,A00,111323,Chern; Albert Ren-Haur,0,16,0,0
1668567668969,CSE 282,A00,102398,Pevzner; Pavel Arkadjevich,0,0,0,0
1668567669393,CSE 284,A00,114175,Gymrek; Melissa Ann,0,30,0,0
1668567669816,CSE 290,A00,102399,Chandraker; Manmohan Krishna,0,11,0,0
1668567669816,CSE 290,B00,102400,Vaccaro; Kristen Marie,0,8,25,25
1668567669816,CSE 290,C00,102414,Pannuto; Patrick William,0,1,25,25
1668567669816,CSE 290,D00,102427,Pevzner; Pavel Arkadjevich,0,0,0,0
1668567669816,CSE 290,E00,102429,Zhao; Jishen,0,6,0,0
1668567669816,CSE 290,F00,102436,Tullsen; Dean Michael,0,6,0,0
1668567669816,CSE 290,G00,102440,Christensen; Henrik I,0,7,20,20
1668567670242,CSE 291,A00,102443,Su; Hao,0,0,0,0
1668567670242,CSE 291,B00,102448,Polikarpova; Nadezhda,0,0,0,0
1668567670242,CSE 291,C00,102453,Vaccaro; Kristen Marie,0,0,0,0
1668567670242,CSE 291,D00,111343,Savage; Stefan,0,0,0,0
1668567670242,CSE 291,E00,116474,Claffy; Kimberly Claire,0,0,0,0
1668567670242,CSE 291,F00,116479,Pasquale; Joseph,0,0,0,0
1668567670688,CSE 293,001,119111,Bafna; Vineet,9999,0,9999,0
1668567670688,CSE 293,002,119118,Bellare; Mihir,9999,0,9999,0
1668567670688,CSE 293,003,119122,Berg-Kirkpatrick; Taylor D,9999,0,9999,0
1668567670688,CSE 293,004,119135,Christensen; Henrik I,9999,0,9999,0
1668567670688,CSE 293,005,119142,Cottrell; Garrison W,9999,0,9999,0
1668567670688,CSE 293,006,119146,Deutsch; Alin Bernard,9999,0,9999,0
1668567670688,CSE 293,007,119159,Esmaeilzadeh; Hadi,9999,0,9999,0
1668567670688,CSE 293,008,119166,Freund; Yoav,9999,0,9999,0
1668567670688,CSE 293,009,119170,Griswold; William G.,9999,0,9999,0
1668567670688,CSE 293,010,119183,Gymrek; Melissa Ann,9999,0,9999,0
1668567670688,CSE 293,011,119190,Heninger; Nadia A,9999,0,9999,0
1668567670688,CSE 293,012,119230,Impagliazzo; Russell,9999,0,9999,0
1668567670688,CSE 293,013,119232,Jhala; Ranjit,9999,0,9999,0
1668567670688,CSE 293,014,119233,Kahng; Andrew Byun,9999,0,9999,0
1668567670688,CSE 293,015,119298,Kane; Daniel Mertz,9999,0,9999,0
1668567670688,CSE 293,016,119299,Kriegman; David J,9999,0,9999,0
1668567670688,CSE 293,017,119300,Kumar; Arun Kumar,9999,0,9999,0
1668567670688,CSE 293,018,119301,Lerner; Sorin,9999,0,9999,0
1668567670688,CSE 293,019,119302,Lovett; Shachar,9999,0,9999,0
1668567670688,CSE 293,020,119303,McAuley; Julian John,9999,0,9999,0
1668567670688,CSE 293,021,119304,Micciancio; Daniele,9999,0,9999,0
1668567670688,CSE 293,022,119367,Orailoglu; Alex,9999,0,9999,0
1668567670688,CSE 293,023,119382,Paturi; Ramamohan,9999,0,9999,0
1668567670688,CSE 293,024,119404,Polikarpova; Nadezhda,9999,0,9999,0
1668567670688,CSE 293,025,119406,Politz; Joseph Gibbs,9999,0,9999,0
1668567670688,CSE 293,026,119411,Porter; George M,9999,0,9999,0
1668567670688,CSE 293,027,119414,Porter; Leonard Emerson,9999,0,9999,0
1668567670688,CSE 293,028,119416,Ramamoorthi; Ravi,9999,0,9999,0
1668567670688,CSE 293,029,119417,Sahoo; Debashis,9999,0,9999,0
1668567670688,CSE 293,030,119420,Saul; Lawrence,9999,0,9999,0
1668567670688,CSE 293,031,119421,Savage; Stefan,9999,0,9999,0
1668567670688,CSE 293,032,119425,Schulze; Jurgen P.,9999,0,9999,0
1668567670688,CSE 293,033,119426,Snoeren; Alex C.,9999,0,9999,0
1668567670688,CSE 293,034,119428,Shang; Jingbo,9999,0,9999,0
1668567670688,CSE 293,035,119430,Stefan; Deian,9999,0,9999,0
1668567670688,CSE 293,036,119431,Su; Hao,9999,0,9999,0
1668567670688,CSE 293,037,119433,Swanson; Steven James,9999,0,9999,0
1668567670688,CSE 293,038,119435,Tullsen; Dean Michael,9999,0,9999,0
1668567670688,CSE 293,039,119483,Voelker; Geoffrey M.,9999,0,9999,0
1668567670688,CSE 293,040,119537,Zhao; Jishen,9999,0,9999,0
1668567670688,CSE 293,041,119538,Zhou; Yuan-Yuan,9999,0,9999,0
1668567670688,CSE 293,042,119539,Gao; Sicun,9999,0,9999,0
1668567670688,CSE 293,043,119540,Weibel; Nadir,9999,0,9999,0
1668567670688,CSE 293,044,119541,Gupta; Rajesh K.,9999,0,9999,0
1668567670688,CSE 293,045,126410,Vaccaro; Kristen Marie,9999,0,9999,0
1668567670688,CSE 293,046,126411,Klemke; Richard,9999,0,9999,0
1668567671118,CSE 294,A00,102459,Voelker; Geoffrey M.,0,2,0,0
1668567671118,CSE 294,B00,111322,Orailoglu; Alex,0,2,0,0
1668567671541,DSE 201,A00,096914,Deutsch; Alin Bernard,30,0,30,0
1668567672064,DSE 210,A00,096915,Dasgupta; Sanjoy,30,0,30,0
1668567672489,DSE 260A,A00,096916,Altintas De Callaf; Ilkay,30,0,30,0
1668567672954,ECE 200,001,103586,Antipa; Nicholas A,9999,0,9999,0
1668567672954,ECE 200,002,103587,Atanasov; Nikolay A.,9999,0,9999,0
1668567672954,ECE 200,003,103588,Bharadia; Dinesh,9999,0,9999,0
1668567672954,ECE 200,004,103589,Cheng; Chung Kuan,9999,0,9999,0
1668567672954,ECE 200,005,103590,Cosman; Pamela C.,9999,0,9999,0
1668567672954,ECE 200,006,103591,Dayeh; Shadi Ahmad,9999,0,9999,0
1668567672954,ECE 200,007,103592,Fainman; Yeshaiahu,9999,0,9999,0
1668567672954,ECE 200,008,103593,Ford; Joseph Earl,9999,0,9999,0
1668567672954,ECE 200,009,103594,Franceschetti; Massimo,9999,0,9999,0
1668567672954,ECE 200,010,103595,Fullerton; Eric E,9999,0,9999,0
1668567672954,ECE 200,011,103596,Galton; Ian A,9999,0,9999,0
1668567672954,ECE 200,012,103597,Gilja; Vikash,9999,0,9999,0
1668567672954,ECE 200,013,103598,Hall; Drew A.,9999,0,9999,0
1668567672954,ECE 200,014,103599,Hsueh; Tzu-Chien,9999,0,9999,0
1668567672954,ECE 200,015,103600,Javidi; Tara,9999,0,9999,0
1668567672954,ECE 200,016,103601,Kahng; Andrew Byun,9999,0,9999,0
1668567672954,ECE 200,017,103602,Kim; Young-Han,9999,0,9999,0
1668567672954,ECE 200,018,103603,Koushanfar; Farinaz,9999,0,9999,0
1668567672954,ECE 200,019,103604,Kuzum; Duygu,9999,0,9999,0
1668567672954,ECE 200,020,103605,Le; Hanh-Phuc,9999,0,9999,0
1668567672954,ECE 200,021,103606,Lin; Bill,9999,0,9999,0
1668567672954,ECE 200,022,103607,Liu; Zhaowei,9998,0,9999,1
1668567672954,ECE 200,023,103608,Lo; Yu-Hwa,9999,0,9999,0
1668567672954,ECE 200,024,103609,Lomakin; Vitaliy,9999,0,9999,0
1668567672954,ECE 200,025,103610,Mercier; Patrick Philip,9999,0,9999,0
1668567672954,ECE 200,026,103611,Meyer; Florian,9999,0,9999,0
1668567672954,ECE 200,027,103612,Milstein; Laurence B.,9999,0,9999,0
1668567672954,ECE 200,028,103613,Mir Arabbaygi; Siavash,9999,0,9999,0
1668567672954,ECE 200,029,103614,Mookherjea; Shayan,9999,0,9999,0
1668567672954,ECE 200,030,103615,Morris; Karcher William,9999,0,9999,0
1668567672954,ECE 200,031,103616,Ng; Tse Nga,9999,0,9999,0
1668567672954,ECE 200,032,103617,Nguyen; Truong Quang,9999,0,9999,0
1668567672954,ECE 200,033,103618,Nomura; Kenji,9999,0,9999,0
1668567672954,ECE 200,034,103619,Orlitsky; Alon,9999,0,9999,0
1668567672954,ECE 200,035,103620,Pal; Piya,9999,0,9999,0
1668567672954,ECE 200,036,103621,Papen; George C.,9999,0,9999,0
1668567672954,ECE 200,037,103622,Radic; Stojan,9999,0,9999,0
1668567672954,ECE 200,038,103623,Rao; Bhaskar D.,9999,0,9999,0
1668567672954,ECE 200,039,103624,Rao; Ramesh R,9999,0,9999,0
1668567672954,ECE 200,040,103625,Rebeiz; Gabriel,9999,0,9999,0
1668567672954,ECE 200,041,103626,Sanford; John R,9999,0,9999,0
1668567672954,ECE 200,042,103627,Siegel; Paul H.,9999,0,9999,0
1668567672954,ECE 200,043,103628,Sievenpiper; Daniel F.,9999,0,9999,0
1668567672954,ECE 200,044,103629,Sworder; David D.,9999,0,9999,0
1668567672954,ECE 200,045,103630,Taur; Yuan,9999,0,9999,0
1668567672954,ECE 200,046,103631,Touri; Behrouz,9999,0,9999,0
1668567672954,ECE 200,047,103632,Trivedi; Mohan M.,9999,0,9999,0
1668567672954,ECE 200,048,103633,Vasconcelos; Nuno,9999,0,9999,0
1668567672954,ECE 200,049,103634,Wang; Xiaolong,9999,0,9999,0
1668567672954,ECE 200,050,103635,Xie; Pengtao,9999,0,9999,0
1668567672954,ECE 200,051,103636,Yip; Michael,9999,0,9999,0
1668567672954,ECE 200,052,103637,Zeger; Kenneth A.,999,0,999,0
1668567672954,ECE 200,053,103638,Zhang; Xinyu,9999,0,9999,0
1668567672954,ECE 200,054,103639,Turakhia; Yatish Girish,9999,0,9999,0
1668567672954,ECE 200,055,103640,Kang; Mingu,9999,0,9999,0
1668567672954,ECE 200,056,103641,Shi; Yuanyuan,9999,0,9999,0
1668567672954,ECE 200,057,103642,Wang; Edward Jay,9999,0,9999,0
1668567672954,ECE 200,058,103643,Zheng; Yang,9999,0,9999,0
1668567673388,ECE 202,A00,103644,Kuzum; Duygu,0,46,0,0
1668567673812,ECE 212BN,A00,103646,Ng; Tse Nga,0,9,0,0
1668567674239,ECE 221,A00,111493,Staff,0,0,0,0
1668567674662,ECE 222B,A00,103647,Lomakin; Vitaliy,0,21,0,0
1668567675085,ECE 230B,A00,103648,Taur; Yuan,0,4,0,0
1668567675511,ECE 238B,A00,103649,Garay; Javier,0,0,0,0
1668567675936,ECE 240B,A00,112900,Fainman; Yeshaiahu,0,8,0,0
1668567676359,ECE 247A,A00,103650,Jokerst; Jesse Vincent,0,6,0,0
1668567676791,ECE 247B,A00,103651,Wang; Joseph,0,15,0,0
1668567677216,ECE 250,A00,103652,Siegel; Paul H.,0,85,0,0
1668567677646,ECE 251A,A00,103654,Rao; Bhaskar D.,0,65,0,0
1668567678084,ECE 257B,A00,103655,Bharadia; Dinesh,0,33,0,0
1668567678514,ECE 258A,A00,103656,Milstein; Laurence B.,0,29,0,0
1668567678941,ECE 260B,A00,103658,Kang; Mingu,0,121,0,0
1668567679372,ECE 264A,A00,103659,Galton; Ian A,0,46,0,29
1668567679800,ECE 265A,A00,103661,Gudem; Prasad S.S.,0,48,0,29
1668567680225,ECE 265D,A00,103662,Gudem; Prasad S.S.,0,27,0,0
1668567680648,ECE 268,A00,103663,Koushanfar; Farinaz,0,44,0,0
1668567681071,ECE 269,A01,103665,Pal; Piya,0,222,0,0
1668567681506,ECE 271B,A00,103666,Vasconcelos; Manuela,0,78,0,0
1668567681930,ECE 276A,A00,103667,Atanasov; Nikolay A.,0,126,0,0
1668567682354,ECE 277,A00,103668,An; Cheolhong,0,151,0,0
1668567682781,ECE 279,A00,117947,Hall; Drew A.,0,22,0,0
1668567683650,ECE 283,A00,103670,Hsueh; Tzu-Chien,0,57,0,0
1668567684079,ECE 284,A00,103671,Turakhia; Yatish Girish,0,41,0,0
1668567684503,ECE 285,A00,103672,Zheng; Yang,0,40,0,0
1668567684503,ECE 285,B00,103673,Sworder; David D.,0,61,0,0
1668567684927,ECE 287,A00,103676,Javidi; Tara,0,8,0,0
1668567685370,MATH 200B,A00,098023,Salehi Golsefidy; Alireza,7,0,15,8
1668567685807,MATH 202B,A00,098024,Rhoades; Brendon Patrick,7,0,15,8
1668567686243,MATH 203B,A00,098025,Oprea; Dragos N.,9,0,15,6
1668567686676,MATH 204B,A00,098026,Sorensen; Claus M,13,0,15,2
1668567687109,MATH 208,A00,098027,Izadi; Elham,7,0,10,3
1668567687548,MATH 209,A00,098028,Pollack; Aaron,10,0,10,0
1668567687972,MATH 211A,A00,112919,Rogalski; Daniel,8,0,10,2
1668567688402,MATH 211B,A00,112920,Seward; Brandon M.,9,0,10,1
1668567688843,MATH 218,A00,098029,Li; Bo,10,0,10,0
1668567689277,MATH 220B,A00,098030,Novak; Jonathan I,10,0,15,5
1668567689711,MATH 221A,A00,098031,Ebenfelt; Peter F,12,0,15,3
1668567690148,MATH 231B,A00,098032,Zlatos; Andrej,9,0,15,6
1668567690625,MATH 240B,A00,098033,Ni; Lei,7,0,15,8
1668567691058,MATH 243,A00,098034,Jekel; David Andrew,10,0,10,0
1668567691487,MATH 245A,A00,098035,Nie; Jiawang,0,7,15,18
1668567691910,MATH 248,A00,098036,Bejenaru; Ioan,10,0,10,0
1668567692340,MATH 250B,A00,098037,Spolaor; Luca,12,0,15,3
1668567692765,MATH 258,A00,098038,Ni; Lei,8,0,10,2
1668567693189,MATH 264B,A00,098041,Rhoades; Brendon Patrick,7,0,15,8
1668567693615,MATH 268,A00,098042,Buss; Samuel R,10,0,10,0
1668567694041,MATH 269,A00,098043,Rhoades; Brendon Patrick,10,0,10,0
1668567694480,MATH 270B,A00,098044,Li; Bo,6,0,15,9
1668567694906,MATH 272B,A00,098045,Holst; Michael J,13,0,15,2
1668567695331,MATH 273A,A00,098046,Tian; Xiaochuan,10,0,15,5
1668567695757,MATH 275,A01,098048,Tian; Xiaochuan,6,0,10,4
1668567696180,MATH 278A,A00,098049,Holst; Michael J,6,0,10,4
1668567696606,MATH 278B,A00,098050,Cloninger; Alexander,10,0,10,0
1668567697039,MATH 278C,A00,098051,Nie; Jiawang,5,0,10,5
1668567697470,MATH 280B,A00,098052,Zheng; Tianyi,6,0,15,9
1668567697900,MATH 281B,A00,098053,Bradic; Jelena,0,2,15,15
1668567698328,MATH 282B,A00,098054,Arias-Castro; Ery,0,1,15,15
1668567698752,MATH 285,A00,098055,Fitzsimmons; Patrick J,0,4,15,17
1668567699180,MATH 287B,A00,098056,Arias-Castro; Ery,1,0,15,14
1668567699604,MATH 288,A00,098057,Agarwal; Pooja,9,0,10,1
1668567699604,MATH 288,B00,098058,Zhang; Danna,8,0,10,2
1668567699604,MATH 288,C00,098059,Williams; Ruth J,9,0,10,1
1668567700043,MATH 290B,A00,098060,Roberts; Justin Deritter,11,0,15,4
1668567700467,MATH 292,A00,098061,Belmont; Eva Kinoshita,10,0,10,0
1668567700892,MATH 295,A00,098062,Suk; Andrew Hoon,47,0,50,3
1668567701319,MATH 296,A00,098063,Novak; Jonathan I,20,0,20,0
1668567701743,MATH 297,001,098064,Gamst; Anthony Collins,9997,0,9999,2
1668568206171,COGS 205,A00,101395,Chiba; Andrea,19,0,20,1
1668568206602,COGS 210B,001,101404,Greene; Deanna Jacquelyn,9998,0,9999,1
1668568206602,COGS 210B,002,101417,Xia; Haijun,9999,0,9999,0
1668568206602,COGS 210B,003,101422,Nitz; Douglas A.,9999,0,9999,0
1668568206602,COGS 210B,004,101423,Hollan; James D.,9998,0,9999,1
1668568206602,COGS 210B,005,101424,Deak; Gedeon O.,9998,0,9999,1
1668568206602,COGS 210B,006,101425,Rossano; Federico,9999,0,9999,0
1668568207028,COGS 211B,A00,101427,Coulson; Seana M,9996,0,9999,3
1668568207452,COGS 220,A00,101428,Hollan; James D.,0,17,25,25
1668568207890,COGS 229,A00,101429,Dow; Steven P,17,0,25,8
1668568208344,COGS 230,A00,101430,Klemmer; Scott R,6,0,17,11
1668568208782,COGS 234,A00,101431,Xia; Haijun,0,1,25,25
1668568209211,COGS 260,A00,101432,Kiyonaga; Anastasia,21,0,25,4
1668568209211,COGS 260,B00,101433,Kirsh; David Joel,15,0,25,10
1668568209646,CSE 202,A00,102371,Impagliazzo; Russell,0,71,0,0
1668568210072,CSE 203B,A01,102373,Cheng; Chung Kuan,0,67,0,0
1668568210512,CSE 208,A00,102374,Micciancio; Daniele,0,5,0,0
1668568210940,CSE 209A,A00,112895,Impagliazzo; Russell,0,14,15,15
1668568211367,CSE 209B,A00,108005,Bellare; Mihir,0,7,0,0
1668568211791,CSE 210,A00,113163,Coblenz; Michael J,0,94,0,0
1668568212218,CSE 219,A00,106111,Dow; Steven P,0,8,20,20
1668568212650,CSE 221,A00,102376,Voelker; Geoffrey M.,0,77,0,0
1668568213076,CSE 224,A01,102378,Porter; George M,0,178,0,0
1668568213502,CSE 229A,A00,102379,Savage; Stefan,0,13,0,0
1668568213926,CSE 229C,A00,102380,Munyaka; Imani N. S.,0,11,0,0
1668568214352,CSE 232B,A00,102382,Deutsch; Alin Bernard,0,39,0,0
1668568214778,CSE 234,A01,112904,Kumar; Arun Kumar,0,0,0,0
1668568215208,CSE 237A,A00,102383,Rosing; Tajana Simunic,0,57,0,0
1668568215632,CSE 239A,A00,102384,Deutsch; Alin Bernard,0,17,0,0
1668568216056,CSE 239B,A00,102385,Polikarpova; Nadezhda,0,11,0,0
1668568216479,CSE 240A,A00,102386,Pannuto; Patrick William,0,49,0,0
1668568216911,CSE 240B,A00,102387,Zhao; Jishen,0,51,0,0
1668568217343,CSE 241A,A00,106406,Kang; Mingu,0,9,0,0
1668568217766,CSE 249B,A00,102388,Kahng; Andrew Byun,0,5,8,8
1668568218195,CSE 251B,A01,102392,Cottrell; Garrison W,0,53,0,0
1668568218195,CSE 251B,A02,102393,Cottrell; Garrison W,0,36,0,0
1668568218628,CSE 252B,A00,102394,Ochoa; Benjamin Lawrence,0,65,0,0
1668568219059,CSE 257,A01,102396,Gao; Sicun,0,156,0,0
1668568219489,CSE 272,A00,102397,Li; Tzumao,0,22,0,0
1668568219913,CSE 274,A00,111323,Chern; Albert Ren-Haur,0,16,0,0
1668568220339,CSE 282,A00,102398,Pevzner; Pavel Arkadjevich,0,0,0,0
1668568220765,CSE 284,A00,114175,Gymrek; Melissa Ann,0,31,0,0
1668568221201,CSE 290,A00,102399,Chandraker; Manmohan Krishna,0,11,0,0
1668568221201,CSE 290,B00,102400,Vaccaro; Kristen Marie,0,9,25,25
1668568221201,CSE 290,C00,102414,Pannuto; Patrick William,0,1,25,25
1668568221201,CSE 290,D00,102427,Pevzner; Pavel Arkadjevich,0,0,0,0
1668568221201,CSE 290,E00,102429,Zhao; Jishen,0,6,0,0
1668568221201,CSE 290,F00,102436,Tullsen; Dean Michael,0,6,0,0
1668568221201,CSE 290,G00,102440,Christensen; Henrik I,0,7,20,20
1668568221625,CSE 291,A00,102443,Su; Hao,0,0,0,0
1668568221625,CSE 291,B00,102448,Polikarpova; Nadezhda,0,0,0,0
1668568221625,CSE 291,C00,102453,Vaccaro; Kristen Marie,0,0,0,0
1668568221625,CSE 291,D00,111343,Savage; Stefan,0,0,0,0
1668568221625,CSE 291,E00,116474,Claffy; Kimberly Claire,0,0,0,0
1668568221625,CSE 291,F00,116479,Pasquale; Joseph,0,0,0,0
1668568222067,CSE 293,001,119111,Bafna; Vineet,9999,0,9999,0
1668568222067,CSE 293,002,119118,Bellare; Mihir,9999,0,9999,0
1668568222067,CSE 293,003,119122,Berg-Kirkpatrick; Taylor D,9999,0,9999,0
1668568222067,CSE 293,004,119135,Christensen; Henrik I,9999,0,9999,0
1668568222067,CSE 293,005,119142,Cottrell; Garrison W,9999,0,9999,0
1668568222067,CSE 293,006,119146,Deutsch; Alin Bernard,9999,0,9999,0
1668568222067,CSE 293,007,119159,Esmaeilzadeh; Hadi,9999,0,9999,0
1668568222067,CSE 293,008,119166,Freund; Yoav,9999,0,9999,0
1668568222067,CSE 293,009,119170,Griswold; William G.,9999,0,9999,0
1668568222067,CSE 293,010,119183,Gymrek; Melissa Ann,9999,0,9999,0
1668568222067,CSE 293,011,119190,Heninger; Nadia A,9999,0,9999,0
1668568222067,CSE 293,012,119230,Impagliazzo; Russell,9999,0,9999,0
1668568222067,CSE 293,013,119232,Jhala; Ranjit,9999,0,9999,0
1668568222067,CSE 293,014,119233,Kahng; Andrew Byun,9999,0,9999,0
1668568222067,CSE 293,015,119298,Kane; Daniel Mertz,9999,0,9999,0
1668568222067,CSE 293,016,119299,Kriegman; David J,9999,0,9999,0
1668568222067,CSE 293,017,119300,Kumar; Arun Kumar,9999,0,9999,0
1668568222067,CSE 293,018,119301,Lerner; Sorin,9999,0,9999,0
1668568222067,CSE 293,019,119302,Lovett; Shachar,9999,0,9999,0
1668568222067,CSE 293,020,119303,McAuley; Julian John,9999,0,9999,0
1668568222067,CSE 293,021,119304,Micciancio; Daniele,9999,0,9999,0
1668568222067,CSE 293,022,119367,Orailoglu; Alex,9999,0,9999,0
1668568222067,CSE 293,023,119382,Paturi; Ramamohan,9999,0,9999,0
1668568222067,CSE 293,024,119404,Polikarpova; Nadezhda,9999,0,9999,0
1668568222067,CSE 293,025,119406,Politz; Joseph Gibbs,9999,0,9999,0
1668568222067,CSE 293,026,119411,Porter; George M,9999,0,9999,0
1668568222067,CSE 293,027,119414,Porter; Leonard Emerson,9999,0,9999,0
1668568222067,CSE 293,028,119416,Ramamoorthi; Ravi,9999,0,9999,0
1668568222067,CSE 293,029,119417,Sahoo; Debashis,9999,0,9999,0
1668568222067,CSE 293,030,119420,Saul; Lawrence,9999,0,9999,0
1668568222067,CSE 293,031,119421,Savage; Stefan,9999,0,9999,0
1668568222067,CSE 293,032,119425,Schulze; Jurgen P.,9999,0,9999,0
1668568222067,CSE 293,033,119426,Snoeren; Alex C.,9999,0,9999,0
1668568222067,CSE 293,034,119428,Shang; Jingbo,9999,0,9999,0
1668568222067,CSE 293,035,119430,Stefan; Deian,9999,0,9999,0
1668568222067,CSE 293,036,119431,Su; Hao,9999,0,9999,0
1668568222067,CSE 293,037,119433,Swanson; Steven James,9999,0,9999,0
1668568222067,CSE 293,038,119435,Tullsen; Dean Michael,9999,0,9999,0
1668568222067,CSE 293,039,119483,Voelker; Geoffrey M.,9999,0,9999,0
1668568222067,CSE 293,040,119537,Zhao; Jishen,9999,0,9999,0
1668568222067,CSE 293,041,119538,Zhou; Yuan-Yuan,9999,0,9999,0
1668568222067,CSE 293,042,119539,Gao; Sicun,9999,0,9999,0
1668568222067,CSE 293,043,119540,Weibel; Nadir,9999,0,9999,0
1668568222067,CSE 293,044,119541,Gupta; Rajesh K.,9999,0,9999,0
1668568222067,CSE 293,045,126410,Vaccaro; Kristen Marie,9999,0,9999,0
1668568222067,CSE 293,046,126411,Klemke; Richard,9999,0,9999,0
1668568222491,CSE 294,A00,102459,Voelker; Geoffrey M.,0,2,0,0
1668568222491,CSE 294,B00,111322,Orailoglu; Alex,0,2,0,0
1668568222916,DSE 201,A00,096914,Deutsch; Alin Bernard,30,0,30,0
1668568223342,DSE 210,A00,096915,Dasgupta; Sanjoy,30,0,30,0
1668568223765,DSE 260A,A00,096916,Altintas De Callaf; Ilkay,30,0,30,0
1668568224215,ECE 200,001,103586,Antipa; Nicholas A,9999,0,9999,0
1668568224215,ECE 200,002,103587,Atanasov; Nikolay A.,9999,0,9999,0
1668568224215,ECE 200,003,103588,Bharadia; Dinesh,9999,0,9999,0
1668568224215,ECE 200,004,103589,Cheng; Chung Kuan,9999,0,9999,0
1668568224215,ECE 200,005,103590,Cosman; Pamela C.,9999,0,9999,0
1668568224215,ECE 200,006,103591,Dayeh; Shadi Ahmad,9999,0,9999,0
1668568224215,ECE 200,007,103592,Fainman; Yeshaiahu,9999,0,9999,0
1668568224215,ECE 200,008,103593,Ford; Joseph Earl,9999,0,9999,0
1668568224215,ECE 200,009,103594,Franceschetti; Massimo,9999,0,9999,0
1668568224215,ECE 200,010,103595,Fullerton; Eric E,9999,0,9999,0
1668568224215,ECE 200,011,103596,Galton; Ian A,9999,0,9999,0
1668568224215,ECE 200,012,103597,Gilja; Vikash,9999,0,9999,0
1668568224215,ECE 200,013,103598,Hall; Drew A.,9999,0,9999,0
1668568224215,ECE 200,014,103599,Hsueh; Tzu-Chien,9999,0,9999,0
1668568224215,ECE 200,015,103600,Javidi; Tara,9999,0,9999,0
1668568224215,ECE 200,016,103601,Kahng; Andrew Byun,9999,0,9999,0
1668568224215,ECE 200,017,103602,Kim; Young-Han,9999,0,9999,0
1668568224215,ECE 200,018,103603,Koushanfar; Farinaz,9999,0,9999,0
1668568224215,ECE 200,019,103604,Kuzum; Duygu,9999,0,9999,0
1668568224215,ECE 200,020,103605,Le; Hanh-Phuc,9999,0,9999,0
1668568224215,ECE 200,021,103606,Lin; Bill,9999,0,9999,0
1668568224215,ECE 200,022,103607,Liu; Zhaowei,9998,0,9999,1
1668568224215,ECE 200,023,103608,Lo; Yu-Hwa,9999,0,9999,0
1668568224215,ECE 200,024,103609,Lomakin; Vitaliy,9999,0,9999,0
1668568224215,ECE 200,025,103610,Mercier; Patrick Philip,9999,0,9999,0
1668568224215,ECE 200,026,103611,Meyer; Florian,9999,0,9999,0
1668568224215,ECE 200,027,103612,Milstein; Laurence B.,9999,0,9999,0
1668568224215,ECE 200,028,103613,Mir Arabbaygi; Siavash,9999,0,9999,0
1668568224215,ECE 200,029,103614,Mookherjea; Shayan,9999,0,9999,0
1668568224215,ECE 200,030,103615,Morris; Karcher William,9999,0,9999,0
1668568224215,ECE 200,031,103616,Ng; Tse Nga,9999,0,9999,0
1668568224215,ECE 200,032,103617,Nguyen; Truong Quang,9999,0,9999,0
1668568224215,ECE 200,033,103618,Nomura; Kenji,9999,0,9999,0
1668568224215,ECE 200,034,103619,Orlitsky; Alon,9999,0,9999,0
1668568224215,ECE 200,035,103620,Pal; Piya,9999,0,9999,0
1668568224215,ECE 200,036,103621,Papen; George C.,9999,0,9999,0
1668568224215,ECE 200,037,103622,Radic; Stojan,9999,0,9999,0
1668568224215,ECE 200,038,103623,Rao; Bhaskar D.,9999,0,9999,0
1668568224215,ECE 200,039,103624,Rao; Ramesh R,9999,0,9999,0
1668568224215,ECE 200,040,103625,Rebeiz; Gabriel,9999,0,9999,0
1668568224215,ECE 200,041,103626,Sanford; John R,9999,0,9999,0
1668568224215,ECE 200,042,103627,Siegel; Paul H.,9999,0,9999,0
1668568224215,ECE 200,043,103628,Sievenpiper; Daniel F.,9999,0,9999,0
1668568224215,ECE 200,044,103629,Sworder; David D.,9999,0,9999,0
1668568224215,ECE 200,045,103630,Taur; Yuan,9999,0,9999,0
1668568224215,ECE 200,046,103631,Touri; Behrouz,9999,0,9999,0
1668568224215,ECE 200,047,103632,Trivedi; Mohan M.,9999,0,9999,0
1668568224215,ECE 200,048,103633,Vasconcelos; Nuno,9999,0,9999,0
1668568224215,ECE 200,049,103634,Wang; Xiaolong,9999,0,9999,0
1668568224215,ECE 200,050,103635,Xie; Pengtao,9999,0,9999,0
1668568224215,ECE 200,051,103636,Yip; Michael,9999,0,9999,0
1668568224215,ECE 200,052,103637,Zeger; Kenneth A.,999,0,999,0
1668568224215,ECE 200,053,103638,Zhang; Xinyu,9999,0,9999,0
1668568224215,ECE 200,054,103639,Turakhia; Yatish Girish,9999,0,9999,0
1668568224215,ECE 200,055,103640,Kang; Mingu,9999,0,9999,0
1668568224215,ECE 200,056,103641,Shi; Yuanyuan,9999,0,9999,0
1668568224215,ECE 200,057,103642,Wang; Edward Jay,9999,0,9999,0
1668568224215,ECE 200,058,103643,Zheng; Yang,9999,0,9999,0
1668568224639,ECE 202,A00,103644,Kuzum; Duygu,0,46,0,0
1668568225074,ECE 212BN,A00,103646,Ng; Tse Nga,0,9,0,0
1668568225497,ECE 221,A00,111493,Staff,0,0,0,0
1668568225930,ECE 222B,A00,103647,Lomakin; Vitaliy,0,21,0,0
1668568226356,ECE 230B,A00,103648,Taur; Yuan,0,4,0,0
1668568226781,ECE 238B,A00,103649,Garay; Javier,0,0,0,0
1668568227206,ECE 240B,A00,112900,Fainman; Yeshaiahu,0,8,0,0
1668568227634,ECE 247A,A00,103650,Jokerst; Jesse Vincent,0,6,0,0
1668568228061,ECE 247B,A00,103651,Wang; Joseph,0,15,0,0
1668568228489,ECE 250,A00,103652,Siegel; Paul H.,0,85,0,0
1668568228914,ECE 251A,A00,103654,Rao; Bhaskar D.,0,65,0,0
1668568229337,ECE 257B,A00,103655,Bharadia; Dinesh,0,33,0,0
1668568229760,ECE 258A,A00,103656,Milstein; Laurence B.,0,29,0,0
1668568230200,ECE 260B,A00,103658,Kang; Mingu,0,121,0,0
1668568230624,ECE 264A,A00,103659,Galton; Ian A,0,45,0,30
1668568231049,ECE 265A,A00,103661,Gudem; Prasad S.S.,0,47,0,30
1668568231476,ECE 265D,A00,103662,Gudem; Prasad S.S.,0,27,0,0
1668568231899,ECE 268,A00,103663,Koushanfar; Farinaz,0,44,0,0
1668568232323,ECE 269,A01,103665,Pal; Piya,0,222,0,0
1668568232752,ECE 271B,A00,103666,Vasconcelos; Manuela,0,78,0,0
1668568233185,ECE 276A,A00,103667,Atanasov; Nikolay A.,0,126,0,0
1668568233614,ECE 277,A00,103668,An; Cheolhong,0,151,0,0
1668568234036,ECE 279,A00,117947,Hall; Drew A.,0,22,0,0
1668568234882,ECE 283,A00,103670,Hsueh; Tzu-Chien,0,57,0,0
1668568235306,ECE 284,A00,103671,Turakhia; Yatish Girish,0,41,0,0
1668568235733,ECE 285,A00,103672,Zheng; Yang,0,40,0,0
1668568235733,ECE 285,B00,103673,Sworder; David D.,0,61,0,0
1668568236157,ECE 287,A00,103676,Javidi; Tara,0,8,0,0
1668568236580,MATH 200B,A00,098023,Salehi Golsefidy; Alireza,7,0,15,8
1668568237023,MATH 202B,A00,098024,Rhoades; Brendon Patrick,7,0,15,8
1668568237450,MATH 203B,A00,098025,Oprea; Dragos N.,9,0,15,6
1668568237874,MATH 204B,A00,098026,Sorensen; Claus M,13,0,15,2
1668568239140,MATH 208,A00,098027,Izadi; Elham,7,0,10,3
1668568239563,MATH 209,A00,098028,Pollack; Aaron,10,0,10,0
1668568239987,MATH 211A,A00,112919,Rogalski; Daniel,8,0,10,2
1668568240410,MATH 211B,A00,112920,Seward; Brandon M.,9,0,10,1
1668568240845,MATH 218,A00,098029,Li; Bo,10,0,10,0
1668568241273,MATH 220B,A00,098030,Novak; Jonathan I,10,0,15,5
1668568241696,MATH 221A,A00,098031,Ebenfelt; Peter F,12,0,15,3
1668568242127,MATH 231B,A00,098032,Zlatos; Andrej,9,0,15,6
1668568242552,MATH 240B,A00,098033,Ni; Lei,7,0,15,8
1668568242977,MATH 243,A00,098034,Jekel; David Andrew,10,0,10,0
1668568243402,MATH 245A,A00,098035,Nie; Jiawang,0,7,15,18
1668568243829,MATH 248,A00,098036,Bejenaru; Ioan,10,0,10,0
1668568244254,MATH 250B,A00,098037,Spolaor; Luca,12,0,15,3
1668568244677,MATH 258,A00,098038,Ni; Lei,8,0,10,2
1668568245100,MATH 264B,A00,098041,Rhoades; Brendon Patrick,7,0,15,8
1668568245523,MATH 268,A00,098042,Buss; Samuel R,10,0,10,0
1668568245948,MATH 269,A00,098043,Rhoades; Brendon Patrick,10,0,10,0
1668568246371,MATH 270B,A00,098044,Li; Bo,6,0,15,9
1668568246795,MATH 272B,A00,098045,Holst; Michael J,13,0,15,2
1668568247219,MATH 273A,A00,098046,Tian; Xiaochuan,10,0,15,5
1668568247646,MATH 275,A01,098048,Tian; Xiaochuan,6,0,10,4
1668568248070,MATH 278A,A00,098049,Holst; Michael J,6,0,10,4
1668568248494,MATH 278B,A00,098050,Cloninger; Alexander,10,0,10,0
1668568248923,MATH 278C,A00,098051,Nie; Jiawang,5,0,10,5
1668568249346,MATH 280B,A00,098052,Zheng; Tianyi,6,0,15,9
1668568249771,MATH 281B,A00,098053,Bradic; Jelena,0,2,15,15
1668568250198,MATH 282B,A00,098054,Arias-Castro; Ery,0,1,15,15
1668568250621,MATH 285,A00,098055,Fitzsimmons; Patrick J,0,4,15,17
1668568251046,MATH 287B,A00,098056,Arias-Castro; Ery,1,0,15,14
1668568251477,MATH 288,A00,098057,Agarwal; Pooja,9,0,10,1
1668568251477,MATH 288,B00,098058,Zhang; Danna,8,0,10,2
1668568251477,MATH 288,C00,098059,Williams; Ruth J,9,0,10,1
1668568251902,MATH 290B,A00,098060,Roberts; Justin Deritter,11,0,15,4
1668568252328,MATH 292,A00,098061,Belmont; Eva Kinoshita,10,0,10,0
1668568252753,MATH 295,A00,098062,Suk; Andrew Hoon,47,0,50,3
1668568253177,MATH 296,A00,098063,Novak; Jonathan I,20,0,20,0
1668568253601,MATH 297,001,098064,Gamst; Anthony Collins,9997,0,9999,2
1668568756829,COGS 205,A00,101395,Chiba; Andrea,19,0,20,1
1668568757255,COGS 210B,001,101404,Greene; Deanna Jacquelyn,9998,0,9999,1
1668568757255,COGS 210B,002,101417,Xia; Haijun,9999,0,9999,0
1668568757255,COGS 210B,003,101422,Nitz; Douglas A.,9999,0,9999,0
1668568757255,COGS 210B,004,101423,Hollan; James D.,9998,0,9999,1
1668568757255,COGS 210B,005,101424,Deak; Gedeon O.,9998,0,9999,1
1668568757255,COGS 210B,006,101425,Rossano; Federico,9999,0,9999,0
1668568757680,COGS 211B,A00,101427,Coulson; Seana M,9996,0,9999,3
1668568758117,COGS 220,A00,101428,Hollan; James D.,0,17,25,25
1668568758542,COGS 229,A00,101429,Dow; Steven P,17,0,25,8
1668568758966,COGS 230,A00,101430,Klemmer; Scott R,6,0,17,11
1668568759388,COGS 234,A00,101431,Xia; Haijun,0,1,25,25
1668568759810,COGS 260,A00,101432,Kiyonaga; Anastasia,21,0,25,4
1668568759810,COGS 260,B00,101433,Kirsh; David Joel,15,0,25,10
1668568760237,CSE 202,A00,102371,Impagliazzo; Russell,0,71,0,0
1668568760734,CSE 203B,A01,102373,Cheng; Chung Kuan,0,67,0,0
1668568761165,CSE 208,A00,102374,Micciancio; Daniele,0,5,0,0
1668568761588,CSE 209A,A00,112895,Impagliazzo; Russell,0,14,15,15
1668568762013,CSE 209B,A00,108005,Bellare; Mihir,0,7,0,0
1668568762440,CSE 210,A00,113163,Coblenz; Michael J,0,94,0,0
1668568762869,CSE 219,A00,106111,Dow; Steven P,0,8,20,20
1668568763295,CSE 221,A00,102376,Voelker; Geoffrey M.,0,77,0,0
1668568763723,CSE 224,A01,102378,Porter; George M,0,178,0,0
1668568764151,CSE 229A,A00,102379,Savage; Stefan,0,14,0,0
1668568764585,CSE 229C,A00,102380,Munyaka; Imani N. S.,0,12,0,0
1668568765010,CSE 232B,A00,102382,Deutsch; Alin Bernard,0,39,0,0
1668568765435,CSE 234,A01,112904,Kumar; Arun Kumar,0,0,0,0
1668568765859,CSE 237A,A00,102383,Rosing; Tajana Simunic,0,57,0,0
1668568766283,CSE 239A,A00,102384,Deutsch; Alin Bernard,0,18,0,0
1668568766705,CSE 239B,A00,102385,Polikarpova; Nadezhda,0,11,0,0
1668568767137,CSE 240A,A00,102386,Pannuto; Patrick William,0,49,0,0
1668568767561,CSE 240B,A00,102387,Zhao; Jishen,0,51,0,0
1668568767988,CSE 241A,A00,106406,Kang; Mingu,0,9,0,0
1668568768417,CSE 249B,A00,102388,Kahng; Andrew Byun,0,5,8,8
1668568768843,CSE 251B,A01,102392,Cottrell; Garrison W,0,53,0,0
1668568768843,CSE 251B,A02,102393,Cottrell; Garrison W,0,36,0,0
1668568769266,CSE 252B,A00,102394,Ochoa; Benjamin Lawrence,0,65,0,0
1668568769699,CSE 257,A01,102396,Gao; Sicun,0,156,0,0
1668568770124,CSE 272,A00,102397,Li; Tzumao,0,22,0,0
1668568770553,CSE 274,A00,111323,Chern; Albert Ren-Haur,0,16,0,0
1668568770979,CSE 282,A00,102398,Pevzner; Pavel Arkadjevich,0,0,0,0
1668568771415,CSE 284,A00,114175,Gymrek; Melissa Ann,0,31,0,0
1668568771863,CSE 290,A00,102399,Chandraker; Manmohan Krishna,0,11,0,0
1668568771863,CSE 290,B00,102400,Vaccaro; Kristen Marie,0,10,25,25
1668568771863,CSE 290,C00,102414,Pannuto; Patrick William,0,1,25,25
1668568771863,CSE 290,D00,102427,Pevzner; Pavel Arkadjevich,0,0,0,0
1668568771863,CSE 290,E00,102429,Zhao; Jishen,0,6,0,0
1668568771863,CSE 290,F00,102436,Tullsen; Dean Michael,0,6,0,0
1668568771863,CSE 290,G00,102440,Christensen; Henrik I,0,7,20,20
1668568772304,CSE 291,A00,102443,Su; Hao,0,0,0,0
1668568772304,CSE 291,B00,102448,Polikarpova; Nadezhda,0,0,0,0
1668568772304,CSE 291,C00,102453,Vaccaro; Kristen Marie,0,0,0,0
1668568772304,CSE 291,D00,111343,Savage; Stefan,0,0,0,0
1668568772304,CSE 291,E00,116474,Claffy; Kimberly Claire,0,0,0,0
1668568772304,CSE 291,F00,116479,Pasquale; Joseph,0,0,0,0
1668568772734,CSE 293,001,119111,Bafna; Vineet,9999,0,9999,0
1668568772734,CSE 293,002,119118,Bellare; Mihir,9999,0,9999,0
1668568772734,CSE 293,003,119122,Berg-Kirkpatrick; Taylor D,9999,0,9999,0
1668568772734,CSE 293,004,119135,Christensen; Henrik I,9999,0,9999,0
1668568772734,CSE 293,005,119142,Cottrell; Garrison W,9999,0,9999,0
1668568772734,CSE 293,006,119146,Deutsch; Alin Bernard,9999,0,9999,0
1668568772734,CSE 293,007,119159,Esmaeilzadeh; Hadi,9999,0,9999,0
1668568772734,CSE 293,008,119166,Freund; Yoav,9999,0,9999,0
1668568772734,CSE 293,009,119170,Griswold; William G.,9999,0,9999,0
1668568772734,CSE 293,010,119183,Gymrek; Melissa Ann,9999,0,9999,0
1668568772734,CSE 293,011,119190,Heninger; Nadia A,9999,0,9999,0
1668568772734,CSE 293,012,119230,Impagliazzo; Russell,9999,0,9999,0
1668568772734,CSE 293,013,119232,Jhala; Ranjit,9999,0,9999,0
1668568772734,CSE 293,014,119233,Kahng; Andrew Byun,9999,0,9999,0
1668568772734,CSE 293,015,119298,Kane; Daniel Mertz,9999,0,9999,0
1668568772734,CSE 293,016,119299,Kriegman; David J,9999,0,9999,0
1668568772734,CSE 293,017,119300,Kumar; Arun Kumar,9999,0,9999,0
1668568772734,CSE 293,018,119301,Lerner; Sorin,9999,0,9999,0
1668568772734,CSE 293,019,119302,Lovett; Shachar,9999,0,9999,0
1668568772734,CSE 293,020,119303,McAuley; Julian John,9999,0,9999,0
1668568772734,CSE 293,021,119304,Micciancio; Daniele,9999,0,9999,0
1668568772734,CSE 293,022,119367,Orailoglu; Alex,9999,0,9999,0
1668568772734,CSE 293,023,119382,Paturi; Ramamohan,9999,0,9999,0
1668568772734,CSE 293,024,119404,Polikarpova; Nadezhda,9999,0,9999,0
1668568772734,CSE 293,025,119406,Politz; Joseph Gibbs,9999,0,9999,0
1668568772734,CSE 293,026,119411,Porter; George M,9999,0,9999,0
1668568772734,CSE 293,027,119414,Porter; Leonard Emerson,9999,0,9999,0
1668568772734,CSE 293,028,119416,Ramamoorthi; Ravi,9999,0,9999,0
1668568772734,CSE 293,029,119417,Sahoo; Debashis,9999,0,9999,0
1668568772734,CSE 293,030,119420,Saul; Lawrence,9999,0,9999,0
1668568772734,CSE 293,031,119421,Savage; Stefan,9999,0,9999,0
1668568772734,CSE 293,032,119425,Schulze; Jurgen P.,9999,0,9999,0
1668568772734,CSE 293,033,119426,Snoeren; Alex C.,9999,0,9999,0
1668568772734,CSE 293,034,119428,Shang; Jingbo,9999,0,9999,0
1668568772734,CSE 293,035,119430,Stefan; Deian,9999,0,9999,0
1668568772734,CSE 293,036,119431,Su; Hao,9999,0,9999,0
1668568772734,CSE 293,037,119433,Swanson; Steven James,9999,0,9999,0
1668568772734,CSE 293,038,119435,Tullsen; Dean Michael,9999,0,9999,0
1668568772734,CSE 293,039,119483,Voelker; Geoffrey M.,9999,0,9999,0
1668568772734,CSE 293,040,119537,Zhao; Jishen,9999,0,9999,0
1668568772734,CSE 293,041,119538,Zhou; Yuan-Yuan,9999,0,9999,0
1668568772734,CSE 293,042,119539,Gao; Sicun,9999,0,9999,0
1668568772734,CSE 293,043,119540,Weibel; Nadir,9999,0,9999,0
1668568772734,CSE 293,044,119541,Gupta; Rajesh K.,9999,0,9999,0
1668568772734,CSE 293,045,126410,Vaccaro; Kristen Marie,9999,0,9999,0
1668568772734,CSE 293,046,126411,Klemke; Richard,9999,0,9999,0
1668568773157,CSE 294,A00,102459,Voelker; Geoffrey M.,0,2,0,0
1668568773157,CSE 294,B00,111322,Orailoglu; Alex,0,2,0,0
1668568773589,DSE 201,A00,096914,Deutsch; Alin Bernard,30,0,30,0
1668568774013,DSE 210,A00,096915,Dasgupta; Sanjoy,30,0,30,0
1668568774443,DSE 260A,A00,096916,Altintas De Callaf; Ilkay,30,0,30,0
1668568774880,ECE 200,001,103586,Antipa; Nicholas A,9999,0,9999,0
1668568774880,ECE 200,002,103587,Atanasov; Nikolay A.,9999,0,9999,0
1668568774880,ECE 200,003,103588,Bharadia; Dinesh,9999,0,9999,0
1668568774880,ECE 200,004,103589,Cheng; Chung Kuan,9999,0,9999,0
1668568774880,ECE 200,005,103590,Cosman; Pamela C.,9999,0,9999,0
1668568774880,ECE 200,006,103591,Dayeh; Shadi Ahmad,9999,0,9999,0
1668568774880,ECE 200,007,103592,Fainman; Yeshaiahu,9999,0,9999,0
1668568774880,ECE 200,008,103593,Ford; Joseph Earl,9999,0,9999,0
1668568774880,ECE 200,009,103594,Franceschetti; Massimo,9999,0,9999,0
1668568774880,ECE 200,010,103595,Fullerton; Eric E,9999,0,9999,0
1668568774880,ECE 200,011,103596,Galton; Ian A,9999,0,9999,0
1668568774880,ECE 200,012,103597,Gilja; Vikash,9999,0,9999,0
1668568774880,ECE 200,013,103598,Hall; Drew A.,9999,0,9999,0
1668568774880,ECE 200,014,103599,Hsueh; Tzu-Chien,9999,0,9999,0
1668568774880,ECE 200,015,103600,Javidi; Tara,9999,0,9999,0
1668568774880,ECE 200,016,103601,Kahng; Andrew Byun,9999,0,9999,0
1668568774880,ECE 200,017,103602,Kim; Young-Han,9999,0,9999,0
1668568774880,ECE 200,018,103603,Koushanfar; Farinaz,9999,0,9999,0
1668568774880,ECE 200,019,103604,Kuzum; Duygu,9999,0,9999,0
1668568774880,ECE 200,020,103605,Le; Hanh-Phuc,9999,0,9999,0
1668568774880,ECE 200,021,103606,Lin; Bill,9999,0,9999,0
1668568774880,ECE 200,022,103607,Liu; Zhaowei,9998,0,9999,1
1668568774880,ECE 200,023,103608,Lo; Yu-Hwa,9999,0,9999,0
1668568774880,ECE 200,024,103609,Lomakin; Vitaliy,9999,0,9999,0
1668568774880,ECE 200,025,103610,Mercier; Patrick Philip,9999,0,9999,0
1668568774880,ECE 200,026,103611,Meyer; Florian,9999,0,9999,0
1668568774880,ECE 200,027,103612,Milstein; Laurence B.,9999,0,9999,0
1668568774880,ECE 200,028,103613,Mir Arabbaygi; Siavash,9999,0,9999,0
1668568774880,ECE 200,029,103614,Mookherjea; Shayan,9999,0,9999,0
1668568774880,ECE 200,030,103615,Morris; Karcher William,9999,0,9999,0
1668568774880,ECE 200,031,103616,Ng; Tse Nga,9999,0,9999,0
1668568774880,ECE 200,032,103617,Nguyen; Truong Quang,9999,0,9999,0
1668568774880,ECE 200,033,103618,Nomura; Kenji,9999,0,9999,0
1668568774880,ECE 200,034,103619,Orlitsky; Alon,9999,0,9999,0
1668568774880,ECE 200,035,103620,Pal; Piya,9999,0,9999,0
1668568774880,ECE 200,036,103621,Papen; George C.,9999,0,9999,0
1668568774880,ECE 200,037,103622,Radic; Stojan,9999,0,9999,0
1668568774880,ECE 200,038,103623,Rao; Bhaskar D.,9999,0,9999,0
1668568774880,ECE 200,039,103624,Rao; Ramesh R,9999,0,9999,0
1668568774880,ECE 200,040,103625,Rebeiz; Gabriel,9999,0,9999,0
1668568774880,ECE 200,041,103626,Sanford; John R,9999,0,9999,0
1668568774880,ECE 200,042,103627,Siegel; Paul H.,9999,0,9999,0
1668568774880,ECE 200,043,103628,Sievenpiper; Daniel F.,9999,0,9999,0
1668568774880,ECE 200,044,103629,Sworder; David D.,9999,0,9999,0
1668568774880,ECE 200,045,103630,Taur; Yuan,9999,0,9999,0
1668568774880,ECE 200,046,103631,Touri; Behrouz,9999,0,9999,0
1668568774880,ECE 200,047,103632,Trivedi; Mohan M.,9999,0,9999,0
1668568774880,ECE 200,048,103633,Vasconcelos; Nuno,9999,0,9999,0
1668568774880,ECE 200,049,103634,Wang; Xiaolong,9999,0,9999,0
1668568774880,ECE 200,050,103635,Xie; Pengtao,9999,0,9999,0
1668568774880,ECE 200,051,103636,Yip; Michael,9999,0,9999,0
1668568774880,ECE 200,052,103637,Zeger; Kenneth A.,999,0,999,0
1668568774880,ECE 200,053,103638,Zhang; Xinyu,9999,0,9999,0
1668568774880,ECE 200,054,103639,Turakhia; Yatish Girish,9999,0,9999,0
1668568774880,ECE 200,055,103640,Kang; Mingu,9999,0,9999,0
1668568774880,ECE 200,056,103641,Shi; Yuanyuan,9999,0,9999,0
1668568774880,ECE 200,057,103642,Wang; Edward Jay,9999,0,9999,0
1668568774880,ECE 200,058,103643,Zheng; Yang,9999,0,9999,0
1668568775309,ECE 202,A00,103644,Kuzum; Duygu,0,46,0,0
1668568775732,ECE 212BN,A00,103646,Ng; Tse Nga,0,9,0,0
1668568776171,ECE 221,A00,111493,Staff,0,0,0,0
1668568776600,ECE 222B,A00,103647,Lomakin; Vitaliy,0,21,0,0
1668568777029,ECE 230B,A00,103648,Taur; Yuan,0,4,0,0
1668568777455,ECE 238B,A00,103649,Garay; Javier,0,0,0,0
1668568777880,ECE 240B,A00,112900,Fainman; Yeshaiahu,0,8,0,0
1668568778307,ECE 247A,A00,103650,Jokerst; Jesse Vincent,0,6,0,0
1668568778732,ECE 247B,A00,103651,Wang; Joseph,0,15,0,0
1668568779173,ECE 250,A00,103652,Siegel; Paul H.,0,85,0,0
1668568779600,ECE 251A,A00,103654,Rao; Bhaskar D.,0,65,0,0
1668568780036,ECE 257B,A00,103655,Bharadia; Dinesh,0,33,0,0
1668568780460,ECE 258A,A00,103656,Milstein; Laurence B.,0,29,0,0
1668568780895,ECE 260B,A00,103658,Kang; Mingu,0,121,0,0
1668568781323,ECE 264A,A00,103659,Galton; Ian A,0,45,0,30
1668568781746,ECE 265A,A00,103661,Gudem; Prasad S.S.,0,47,0,30
1668568782173,ECE 265D,A00,103662,Gudem; Prasad S.S.,0,27,0,0
1668568782597,ECE 268,A00,103663,Koushanfar; Farinaz,0,44,0,0
1668568783022,ECE 269,A01,103665,Pal; Piya,0,222,0,0
1668568783445,ECE 271B,A00,103666,Vasconcelos; Manuela,0,78,0,0
1668568783875,ECE 276A,A00,103667,Atanasov; Nikolay A.,0,126,0,0
1668568784297,ECE 277,A00,103668,An; Cheolhong,0,151,0,0
1668568784725,ECE 279,A00,117947,Hall; Drew A.,0,22,0,0
1668568785573,ECE 283,A00,103670,Hsueh; Tzu-Chien,0,57,0,0
1668568785998,ECE 284,A00,103671,Turakhia; Yatish Girish,0,41,0,0
1668568786425,ECE 285,A00,103672,Zheng; Yang,0,40,0,0
1668568786425,ECE 285,B00,103673,Sworder; David D.,0,61,0,0
1668568786851,ECE 287,A00,103676,Javidi; Tara,0,8,0,0
1668568787301,MATH 200B,A00,098023,Salehi Golsefidy; Alireza,7,0,15,8
1668568787724,MATH 202B,A00,098024,Rhoades; Brendon Patrick,7,0,15,8
1668568788148,MATH 203B,A00,098025,Oprea; Dragos N.,9,0,15,6
1668568788577,MATH 204B,A00,098026,Sorensen; Claus M,13,0,15,2
1668568788999,MATH 208,A00,098027,Izadi; Elham,7,0,10,3
1668568789435,MATH 209,A00,098028,Pollack; Aaron,10,0,10,0
1668568789865,MATH 211A,A00,112919,Rogalski; Daniel,8,0,10,2
1668568790290,MATH 211B,A00,112920,Seward; Brandon M.,9,0,10,1
1668568790727,MATH 218,A00,098029,Li; Bo,10,0,10,0
1668568791150,MATH 220B,A00,098030,Novak; Jonathan I,10,0,15,5
1668568791574,MATH 221A,A00,098031,Ebenfelt; Peter F,12,0,15,3
1668568791998,MATH 231B,A00,098032,Zlatos; Andrej,9,0,15,6
1668568792422,MATH 240B,A00,098033,Ni; Lei,7,0,15,8
1668568792847,MATH 243,A00,098034,Jekel; David Andrew,10,0,10,0
1668568793273,MATH 245A,A00,098035,Nie; Jiawang,0,7,15,18
1668568793698,MATH 248,A00,098036,Bejenaru; Ioan,10,0,10,0
1668568794129,MATH 250B,A00,098037,Spolaor; Luca,12,0,15,3
1668568794554,MATH 258,A00,098038,Ni; Lei,8,0,10,2
1668568794980,MATH 264B,A00,098041,Rhoades; Brendon Patrick,7,0,15,8
1668568795405,MATH 268,A00,098042,Buss; Samuel R,10,0,10,0
1668568795829,MATH 269,A00,098043,Rhoades; Brendon Patrick,10,0,10,0
1668568796253,MATH 270B,A00,098044,Li; Bo,6,0,15,9
1668568796679,MATH 272B,A00,098045,Holst; Michael J,13,0,15,2
1668568797103,MATH 273A,A00,098046,Tian; Xiaochuan,10,0,15,5
1668568797527,MATH 275,A01,098048,Tian; Xiaochuan,6,0,10,4
1668568797951,MATH 278A,A00,098049,Holst; Michael J,6,0,10,4
1668568798374,MATH 278B,A00,098050,Cloninger; Alexander,10,0,10,0
1668568798806,MATH 278C,A00,098051,Nie; Jiawang,5,0,10,5
1668568799231,MATH 280B,A00,098052,Zheng; Tianyi,6,0,15,9
1668568799653,MATH 281B,A00,098053,Bradic; Jelena,0,2,15,15
1668568800075,MATH 282B,A00,098054,Arias-Castro; Ery,0,1,15,15
1668568800511,MATH 285,A00,098055,Fitzsimmons; Patrick J,0,4,15,17
1668568800935,MATH 287B,A00,098056,Arias-Castro; Ery,1,0,15,14
1668568801360,MATH 288,A00,098057,Agarwal; Pooja,9,0,10,1
1668568801360,MATH 288,B00,098058,Zhang; Danna,8,0,10,2
1668568801360,MATH 288,C00,098059,Williams; Ruth J,9,0,10,1
1668568801785,MATH 290B,A00,098060,Roberts; Justin Deritter,11,0,15,4
1668568802211,MATH 292,A00,098061,Belmont; Eva Kinoshita,10,0,10,0
1668568802635,MATH 295,A00,098062,Suk; Andrew Hoon,47,0,50,3
1668568803059,MATH 296,A00,098063,Novak; Jonathan I,20,0,20,0
1668568803485,MATH 297,001,098064,Gamst; Anthony Collins,9997,0,9999,2
1668569307560,COGS 205,A00,101395,Chiba; Andrea,19,0,20,1
1668569307987,COGS 210B,001,101404,Greene; Deanna Jacquelyn,9998,0,9999,1
1668569307987,COGS 210B,002,101417,Xia; Haijun,9999,0,9999,0
1668569307987,COGS 210B,003,101422,Nitz; Douglas A.,9999,0,9999,0
1668569307987,COGS 210B,004,101423,Hollan; James D.,9998,0,9999,1
1668569307987,COGS 210B,005,101424,Deak; Gedeon O.,9998,0,9999,1
1668569307987,COGS 210B,006,101425,Rossano; Federico,9999,0,9999,0
1668569308412,COGS 211B,A00,101427,Coulson; Seana M,9996,0,9999,3
1668569308844,COGS 220,A00,101428,Hollan; James D.,0,17,25,25
1668569309267,COGS 229,A00,101429,Dow; Steven P,17,0,25,8
1668569309693,COGS 230,A00,101430,Klemmer; Scott R,6,0,17,11
1668569310121,COGS 234,A00,101431,Xia; Haijun,0,1,25,25
1668569310546,COGS 260,A00,101432,Kiyonaga; Anastasia,21,0,25,4
1668569310546,COGS 260,B00,101433,Kirsh; David Joel,15,0,25,10
1668569310974,CSE 202,A00,102371,Impagliazzo; Russell,0,71,0,0
1668569311399,CSE 203B,A01,102373,Cheng; Chung Kuan,0,67,0,0
1668569311840,CSE 208,A00,102374,Micciancio; Daniele,0,5,0,0
1668569312263,CSE 209A,A00,112895,Impagliazzo; Russell,0,14,15,15
1668569312695,CSE 209B,A00,108005,Bellare; Mihir,0,7,0,0
1668569313122,CSE 210,A00,113163,Coblenz; Michael J,0,94,0,0
1668569313551,CSE 219,A00,106111,Dow; Steven P,0,8,20,20
1668569313975,CSE 221,A00,102376,Voelker; Geoffrey M.,0,77,0,0
1668569314407,CSE 224,A01,102378,Porter; George M,0,178,0,0
1668569314831,CSE 229A,A00,102379,Savage; Stefan,0,14,0,0
1668569315254,CSE 229C,A00,102380,Munyaka; Imani N. S.,0,12,0,0
1668569315683,CSE 232B,A00,102382,Deutsch; Alin Bernard,0,40,0,0
1668569316107,CSE 234,A01,112904,Kumar; Arun Kumar,0,0,0,0
1668569316536,CSE 237A,A00,102383,Rosing; Tajana Simunic,0,57,0,0
1668569316959,CSE 239A,A00,102384,Deutsch; Alin Bernard,0,18,0,0
1668569317391,CSE 239B,A00,102385,Polikarpova; Nadezhda,0,11,0,0
1668569317826,CSE 240A,A00,102386,Pannuto; Patrick William,0,49,0,0
1668569318259,CSE 240B,A00,102387,Zhao; Jishen,0,51,0,0
1668569318683,CSE 241A,A00,106406,Kang; Mingu,0,9,0,0
1668569319116,CSE 249B,A00,102388,Kahng; Andrew Byun,0,5,8,8
1668569319543,CSE 251B,A01,102392,Cottrell; Garrison W,0,53,0,0
1668569319543,CSE 251B,A02,102393,Cottrell; Garrison W,0,36,0,0
1668569319972,CSE 252B,A00,102394,Ochoa; Benjamin Lawrence,0,65,0,0
1668569320395,CSE 257,A01,102396,Gao; Sicun,0,156,0,0
1668569320821,CSE 272,A00,102397,Li; Tzumao,0,22,0,0
1668569321244,CSE 274,A00,111323,Chern; Albert Ren-Haur,0,16,0,0
1668569321669,CSE 282,A00,102398,Pevzner; Pavel Arkadjevich,0,0,0,0
1668569322098,CSE 284,A00,114175,Gymrek; Melissa Ann,0,31,0,0
1668569322528,CSE 290,A00,102399,Chandraker; Manmohan Krishna,0,11,0,0
1668569322528,CSE 290,B00,102400,Vaccaro; Kristen Marie,0,10,25,25
1668569322528,CSE 290,C00,102414,Pannuto; Patrick William,0,1,25,25
1668569322528,CSE 290,D00,102427,Pevzner; Pavel Arkadjevich,0,0,0,0
1668569322528,CSE 290,E00,102429,Zhao; Jishen,0,6,0,0
1668569322528,CSE 290,F00,102436,Tullsen; Dean Michael,0,6,0,0
1668569322528,CSE 290,G00,102440,Christensen; Henrik I,0,7,20,20
1668569322956,CSE 291,A00,102443,Su; Hao,0,0,0,0
1668569322956,CSE 291,B00,102448,Polikarpova; Nadezhda,0,0,0,0
1668569322956,CSE 291,C00,102453,Vaccaro; Kristen Marie,0,0,0,0
1668569322956,CSE 291,D00,111343,Savage; Stefan,0,0,0,0
1668569322956,CSE 291,E00,116474,Claffy; Kimberly Claire,0,0,0,0
1668569322956,CSE 291,F00,116479,Pasquale; Joseph,0,0,0,0
1668569323437,CSE 293,001,119111,Bafna; Vineet,9999,0,9999,0
1668569323437,CSE 293,002,119118,Bellare; Mihir,9999,0,9999,0
1668569323437,CSE 293,003,119122,Berg-Kirkpatrick; Taylor D,9999,0,9999,0
1668569323437,CSE 293,004,119135,Christensen; Henrik I,9999,0,9999,0
1668569323437,CSE 293,005,119142,Cottrell; Garrison W,9999,0,9999,0
1668569323437,CSE 293,006,119146,Deutsch; Alin Bernard,9999,0,9999,0
1668569323437,CSE 293,007,119159,Esmaeilzadeh; Hadi,9999,0,9999,0
1668569323437,CSE 293,008,119166,Freund; Yoav,9999,0,9999,0
1668569323437,CSE 293,009,119170,Griswold; William G.,9999,0,9999,0
1668569323437,CSE 293,010,119183,Gymrek; Melissa Ann,9999,0,9999,0
1668569323437,CSE 293,011,119190,Heninger; Nadia A,9999,0,9999,0
1668569323437,CSE 293,012,119230,Impagliazzo; Russell,9999,0,9999,0
1668569323437,CSE 293,013,119232,Jhala; Ranjit,9999,0,9999,0
1668569323437,CSE 293,014,119233,Kahng; Andrew Byun,9999,0,9999,0
1668569323437,CSE 293,015,119298,Kane; Daniel Mertz,9999,0,9999,0
1668569323437,CSE 293,016,119299,Kriegman; David J,9999,0,9999,0
1668569323437,CSE 293,017,119300,Kumar; Arun Kumar,9999,0,9999,0
1668569323437,CSE 293,018,119301,Lerner; Sorin,9999,0,9999,0
1668569323437,CSE 293,019,119302,Lovett; Shachar,9999,0,9999,0
1668569323437,CSE 293,020,119303,McAuley; Julian John,9999,0,9999,0
1668569323437,CSE 293,021,119304,Micciancio; Daniele,9999,0,9999,0
1668569323437,CSE 293,022,119367,Orailoglu; Alex,9999,0,9999,0
1668569323437,CSE 293,023,119382,Paturi; Ramamohan,9999,0,9999,0
1668569323437,CSE 293,024,119404,Polikarpova; Nadezhda,9999,0,9999,0
1668569323437,CSE 293,025,119406,Politz; Joseph Gibbs,9999,0,9999,0
1668569323437,CSE 293,026,119411,Porter; George M,9999,0,9999,0
1668569323437,CSE 293,027,119414,Porter; Leonard Emerson,9999,0,9999,0
1668569323437,CSE 293,028,119416,Ramamoorthi; Ravi,9999,0,9999,0
1668569323437,CSE 293,029,119417,Sahoo; Debashis,9999,0,9999,0
1668569323437,CSE 293,030,119420,Saul; Lawrence,9999,0,9999,0
1668569323437,CSE 293,031,119421,Savage; Stefan,9999,0,9999,0
1668569323437,CSE 293,032,119425,Schulze; Jurgen P.,9999,0,9999,0
1668569323437,CSE 293,033,119426,Snoeren; Alex C.,9999,0,9999,0
1668569323437,CSE 293,034,119428,Shang; Jingbo,9999,0,9999,0
1668569323437,CSE 293,035,119430,Stefan; Deian,9999,0,9999,0
1668569323437,CSE 293,036,119431,Su; Hao,9999,0,9999,0
1668569323437,CSE 293,037,119433,Swanson; Steven James,9999,0,9999,0
1668569323437,CSE 293,038,119435,Tullsen; Dean Michael,9999,0,9999,0
1668569323437,CSE 293,039,119483,Voelker; Geoffrey M.,9999,0,9999,0
1668569323437,CSE 293,040,119537,Zhao; Jishen,9999,0,9999,0
1668569323437,CSE 293,041,119538,Zhou; Yuan-Yuan,9999,0,9999,0
1668569323437,CSE 293,042,119539,Gao; Sicun,9999,0,9999,0
1668569323437,CSE 293,043,119540,Weibel; Nadir,9999,0,9999,0
1668569323437,CSE 293,044,119541,Gupta; Rajesh K.,9999,0,9999,0
1668569323437,CSE 293,045,126410,Vaccaro; Kristen Marie,9999,0,9999,0
1668569323437,CSE 293,046,126411,Klemke; Richard,9999,0,9999,0
1668569323859,CSE 294,A00,102459,Voelker; Geoffrey M.,0,2,0,0
1668569323859,CSE 294,B00,111322,Orailoglu; Alex,0,2,0,0
1668569324289,DSE 201,A00,096914,Deutsch; Alin Bernard,30,0,30,0
1668569324713,DSE 210,A00,096915,Dasgupta; Sanjoy,30,0,30,0
1668569325137,DSE 260A,A00,096916,Altintas De Callaf; Ilkay,30,0,30,0
1668569325569,ECE 200,001,103586,Antipa; Nicholas A,9999,0,9999,0
1668569325569,ECE 200,002,103587,Atanasov; Nikolay A.,9999,0,9999,0
1668569325569,ECE 200,003,103588,Bharadia; Dinesh,9999,0,9999,0
1668569325569,ECE 200,004,103589,Cheng; Chung Kuan,9999,0,9999,0
1668569325569,ECE 200,005,103590,Cosman; Pamela C.,9999,0,9999,0
1668569325569,ECE 200,006,103591,Dayeh; Shadi Ahmad,9999,0,9999,0
1668569325569,ECE 200,007,103592,Fainman; Yeshaiahu,9999,0,9999,0
1668569325569,ECE 200,008,103593,Ford; Joseph Earl,9999,0,9999,0
1668569325569,ECE 200,009,103594,Franceschetti; Massimo,9999,0,9999,0
1668569325569,ECE 200,010,103595,Fullerton; Eric E,9999,0,9999,0
1668569325569,ECE 200,011,103596,Galton; Ian A,9999,0,9999,0
1668569325569,ECE 200,012,103597,Gilja; Vikash,9999,0,9999,0
1668569325569,ECE 200,013,103598,Hall; Drew A.,9999,0,9999,0
1668569325569,ECE 200,014,103599,Hsueh; Tzu-Chien,9999,0,9999,0
1668569325569,ECE 200,015,103600,Javidi; Tara,9999,0,9999,0
1668569325569,ECE 200,016,103601,Kahng; Andrew Byun,9999,0,9999,0
1668569325569,ECE 200,017,103602,Kim; Young-Han,9999,0,9999,0
1668569325569,ECE 200,018,103603,Koushanfar; Farinaz,9999,0,9999,0
1668569325569,ECE 200,019,103604,Kuzum; Duygu,9999,0,9999,0
1668569325569,ECE 200,020,103605,Le; Hanh-Phuc,9999,0,9999,0
1668569325569,ECE 200,021,103606,Lin; Bill,9999,0,9999,0
1668569325569,ECE 200,022,103607,Liu; Zhaowei,9998,0,9999,1
1668569325569,ECE 200,023,103608,Lo; Yu-Hwa,9999,0,9999,0
1668569325569,ECE 200,024,103609,Lomakin; Vitaliy,9999,0,9999,0
1668569325569,ECE 200,025,103610,Mercier; Patrick Philip,9999,0,9999,0
1668569325569,ECE 200,026,103611,Meyer; Florian,9999,0,9999,0
1668569325569,ECE 200,027,103612,Milstein; Laurence B.,9999,0,9999,0
1668569325569,ECE 200,028,103613,Mir Arabbaygi; Siavash,9999,0,9999,0
1668569325569,ECE 200,029,103614,Mookherjea; Shayan,9999,0,9999,0
1668569325569,ECE 200,030,103615,Morris; Karcher William,9999,0,9999,0
1668569325569,ECE 200,031,103616,Ng; Tse Nga,9999,0,9999,0
1668569325569,ECE 200,032,103617,Nguyen; Truong Quang,9999,0,9999,0
1668569325569,ECE 200,033,103618,Nomura; Kenji,9999,0,9999,0
1668569325569,ECE 200,034,103619,Orlitsky; Alon,9999,0,9999,0
1668569325569,ECE 200,035,103620,Pal; Piya,9999,0,9999,0
1668569325569,ECE 200,036,103621,Papen; George C.,9999,0,9999,0
1668569325569,ECE 200,037,103622,Radic; Stojan,9999,0,9999,0
1668569325569,ECE 200,038,103623,Rao; Bhaskar D.,9999,0,9999,0
1668569325569,ECE 200,039,103624,Rao; Ramesh R,9999,0,9999,0
1668569325569,ECE 200,040,103625,Rebeiz; Gabriel,9999,0,9999,0
1668569325569,ECE 200,041,103626,Sanford; John R,9999,0,9999,0
1668569325569,ECE 200,042,103627,Siegel; Paul H.,9999,0,9999,0
1668569325569,ECE 200,043,103628,Sievenpiper; Daniel F.,9999,0,9999,0
1668569325569,ECE 200,044,103629,Sworder; David D.,9999,0,9999,0
1668569325569,ECE 200,045,103630,Taur; Yuan,9999,0,9999,0
1668569325569,ECE 200,046,103631,Touri; Behrouz,9999,0,9999,0
1668569325569,ECE 200,047,103632,Trivedi; Mohan M.,9999,0,9999,0
1668569325569,ECE 200,048,103633,Vasconcelos; Nuno,9999,0,9999,0
1668569325569,ECE 200,049,103634,Wang; Xiaolong,9999,0,9999,0
1668569325569,ECE 200,050,103635,Xie; Pengtao,9999,0,9999,0
1668569325569,ECE 200,051,103636,Yip; Michael,9999,0,9999,0
1668569325569,ECE 200,052,103637,Zeger; Kenneth A.,999,0,999,0
1668569325569,ECE 200,053,103638,Zhang; Xinyu,9999,0,9999,0
1668569325569,ECE 200,054,103639,Turakhia; Yatish Girish,9999,0,9999,0
1668569325569,ECE 200,055,103640,Kang; Mingu,9999,0,9999,0
1668569325569,ECE 200,056,103641,Shi; Yuanyuan,9999,0,9999,0
1668569325569,ECE 200,057,103642,Wang; Edward Jay,9999,0,9999,0
1668569325569,ECE 200,058,103643,Zheng; Yang,9999,0,9999,0
1668569325995,ECE 202,A00,103644,Kuzum; Duygu,0,46,0,0
1668569326512,ECE 212BN,A00,103646,Ng; Tse Nga,0,9,0,0
1668569326935,ECE 221,A00,111493,Staff,0,0,0,0
1668569327361,ECE 222B,A00,103647,Lomakin; Vitaliy,0,21,0,0
1668569327784,ECE 230B,A00,103648,Taur; Yuan,0,4,0,0
1668569328216,ECE 238B,A00,103649,Garay; Javier,0,0,0,0
1668569328650,ECE 240B,A00,112900,Fainman; Yeshaiahu,0,8,0,0
1668569329079,ECE 247A,A00,103650,Jokerst; Jesse Vincent,0,6,0,0
1668569329501,ECE 247B,A00,103651,Wang; Joseph,0,15,0,0
1668569329923,ECE 250,A00,103652,Siegel; Paul H.,0,85,0,0
1668569330345,ECE 251A,A00,103654,Rao; Bhaskar D.,0,65,0,0
1668569330772,ECE 257B,A00,103655,Bharadia; Dinesh,0,33,0,0
1668569331197,ECE 258A,A00,103656,Milstein; Laurence B.,0,29,0,0
1668569331620,ECE 260B,A00,103658,Kang; Mingu,0,121,0,0
1668569332043,ECE 264A,A00,103659,Galton; Ian A,0,45,0,30
1668569332468,ECE 265A,A00,103661,Gudem; Prasad S.S.,0,47,0,30
1668569332893,ECE 265D,A00,103662,Gudem; Prasad S.S.,0,27,0,0
1668569333321,ECE 268,A00,103663,Koushanfar; Farinaz,0,44,0,0
1668569333748,ECE 269,A01,103665,Pal; Piya,0,222,0,0
1668569334173,ECE 271B,A00,103666,Vasconcelos; Manuela,0,78,0,0
1668569334604,ECE 276A,A00,103667,Atanasov; Nikolay A.,0,126,0,0
1668569335041,ECE 277,A00,103668,An; Cheolhong,0,151,0,0
1668569335465,ECE 279,A00,117947,Hall; Drew A.,0,22,0,0
1668569336311,ECE 283,A00,103670,Hsueh; Tzu-Chien,0,57,0,0
1668569336736,ECE 284,A00,103671,Turakhia; Yatish Girish,0,41,0,0
1668569337161,ECE 285,A00,103672,Zheng; Yang,0,40,0,0
1668569337161,ECE 285,B00,103673,Sworder; David D.,0,61,0,0
1668569337589,ECE 287,A00,103676,Javidi; Tara,0,8,0,0
1668569338017,MATH 200B,A00,098023,Salehi Golsefidy; Alireza,7,0,15,8
1668569338442,MATH 202B,A00,098024,Rhoades; Brendon Patrick,7,0,15,8
1668569338868,MATH 203B,A00,098025,Oprea; Dragos N.,9,0,15,6
1668569339304,MATH 204B,A00,098026,Sorensen; Claus M,13,0,15,2
1668569339727,MATH 208,A00,098027,Izadi; Elham,7,0,10,3
1668569340152,MATH 209,A00,098028,Pollack; Aaron,10,0,10,0
1668569340589,MATH 211A,A00,112919,Rogalski; Daniel,8,0,10,2
1668569341011,MATH 211B,A00,112920,Seward; Brandon M.,9,0,10,1
1668569341439,MATH 218,A00,098029,Li; Bo,10,0,10,0
1668569341867,MATH 220B,A00,098030,Novak; Jonathan I,10,0,15,5
1668569342301,MATH 221A,A00,098031,Ebenfelt; Peter F,12,0,15,3
1668569342739,MATH 231B,A00,098032,Zlatos; Andrej,9,0,15,6
1668569343162,MATH 240B,A00,098033,Ni; Lei,7,0,15,8
1668569343588,MATH 243,A00,098034,Jekel; David Andrew,10,0,10,0
1668569344010,MATH 245A,A00,098035,Nie; Jiawang,0,7,15,18
1668569344435,MATH 248,A00,098036,Bejenaru; Ioan,10,0,10,0
1668569344858,MATH 250B,A00,098037,Spolaor; Luca,12,0,15,3
1668569345281,MATH 258,A00,098038,Ni; Lei,8,0,10,2
1668569345703,MATH 264B,A00,098041,Rhoades; Brendon Patrick,7,0,15,8
1668569346128,MATH 268,A00,098042,Buss; Samuel R,10,0,10,0
1668569346555,MATH 269,A00,098043,Rhoades; Brendon Patrick,10,0,10,0
1668569346995,MATH 270B,A00,098044,Li; Bo,6,0,15,9
1668569347438,MATH 272B,A00,098045,Holst; Michael J,13,0,15,2
1668569347873,MATH 273A,A00,098046,Tian; Xiaochuan,10,0,15,5
1668569348298,MATH 275,A01,098048,Tian; Xiaochuan,6,0,10,4
1668569348721,MATH 278A,A00,098049,Holst; Michael J,6,0,10,4
1668569349146,MATH 278B,A00,098050,Cloninger; Alexander,10,0,10,0
1668569349572,MATH 278C,A00,098051,Nie; Jiawang,5,0,10,5
1668569349998,MATH 280B,A00,098052,Zheng; Tianyi,6,0,15,9
1668569350424,MATH 281B,A00,098053,Bradic; Jelena,0,2,15,15
1668569350848,MATH 282B,A00,098054,Arias-Castro; Ery,0,1,15,15
1668569351275,MATH 285,A00,098055,Fitzsimmons; Patrick J,0,4,15,17
1668569351703,MATH 287B,A00,098056,Arias-Castro; Ery,1,0,15,14
1668569352133,MATH 288,A00,098057,Agarwal; Pooja,9,0,10,1
1668569352133,MATH 288,B00,098058,Zhang; Danna,8,0,10,2
1668569352133,MATH 288,C00,098059,Williams; Ruth J,9,0,10,1
1668569352556,MATH 290B,A00,098060,Roberts; Justin Deritter,11,0,15,4
1668569352982,MATH 292,A00,098061,Belmont; Eva Kinoshita,10,0,10,0
1668569353409,MATH 295,A00,098062,Suk; Andrew Hoon,47,0,50,3
1668569353840,MATH 296,A00,098063,Novak; Jonathan I,20,0,20,0
1668569354266,MATH 297,001,098064,Gamst; Anthony Collins,9997,0,9999,2
1668569869204,COGS 205,A00,101395,Chiba; Andrea,19,0,20,1
1668569869627,COGS 210B,001,101404,Greene; Deanna Jacquelyn,9998,0,9999,1
1668569869627,COGS 210B,002,101417,Xia; Haijun,9999,0,9999,0
1668569869627,COGS 210B,003,101422,Nitz; Douglas A.,9999,0,9999,0
1668569869627,COGS 210B,004,101423,Hollan; James D.,9998,0,9999,1
1668569869627,COGS 210B,005,101424,Deak; Gedeon O.,9998,0,9999,1
1668569869627,COGS 210B,006,101425,Rossano; Federico,9999,0,9999,0
1668569870049,COGS 211B,A00,101427,Coulson; Seana M,9996,0,9999,3
1668569870473,COGS 220,A00,101428,Hollan; James D.,0,17,25,25
1668569870902,COGS 229,A00,101429,Dow; Steven P,17,0,25,8
1668569871326,COGS 230,A00,101430,Klemmer; Scott R,6,0,17,11
1668569871752,COGS 234,A00,101431,Xia; Haijun,0,1,25,25
1668569872175,COGS 260,A00,101432,Kiyonaga; Anastasia,21,0,25,4
1668569872175,COGS 260,B00,101433,Kirsh; David Joel,15,0,25,10
1668569872601,CSE 202,A00,102371,Impagliazzo; Russell,0,71,0,0
1668569873025,CSE 203B,A01,102373,Cheng; Chung Kuan,0,68,0,0
1668569873462,CSE 208,A00,102374,Micciancio; Daniele,0,5,0,0
1668569873887,CSE 209A,A00,112895,Impagliazzo; Russell,0,14,15,15
1668569874332,CSE 209B,A00,108005,Bellare; Mihir,0,7,0,0
1668569874755,CSE 210,A00,113163,Coblenz; Michael J,0,95,0,0
1668569875178,CSE 219,A00,106111,Dow; Steven P,0,8,20,20
1668569875600,CSE 221,A00,102376,Voelker; Geoffrey M.,0,77,0,0
1668569876026,CSE 224,A01,102378,Porter; George M,0,177,0,0
1668569876453,CSE 229A,A00,102379,Savage; Stefan,0,14,0,0
1668569876876,CSE 229C,A00,102380,Munyaka; Imani N. S.,0,12,0,0
1668569877303,CSE 232B,A00,102382,Deutsch; Alin Bernard,0,39,0,0
1668569877726,CSE 234,A01,112904,Kumar; Arun Kumar,0,0,0,0
1668569878150,CSE 237A,A00,102383,Rosing; Tajana Simunic,0,57,0,0
1668569878574,CSE 239A,A00,102384,Deutsch; Alin Bernard,0,18,0,0
1668569878997,CSE 239B,A00,102385,Polikarpova; Nadezhda,0,11,0,0
1668569879427,CSE 240A,A00,102386,Pannuto; Patrick William,0,49,0,0
1668569879851,CSE 240B,A00,102387,Zhao; Jishen,0,51,0,0
1668569880277,CSE 241A,A00,106406,Kang; Mingu,0,9,0,0
1668569880700,CSE 249B,A00,102388,Kahng; Andrew Byun,0,5,8,8
1668569881132,CSE 251B,A01,102392,Cottrell; Garrison W,0,53,0,0
1668569881132,CSE 251B,A02,102393,Cottrell; Garrison W,0,36,0,0
1668569881556,CSE 252B,A00,102394,Ochoa; Benjamin Lawrence,0,64,0,0
1668569881978,CSE 257,A01,102396,Gao; Sicun,0,157,0,0
1668569882409,CSE 272,A00,102397,Li; Tzumao,0,22,0,0
1668569882835,CSE 274,A00,111323,Chern; Albert Ren-Haur,0,16,0,0
1668569883272,CSE 282,A00,102398,Pevzner; Pavel Arkadjevich,0,0,0,0
1668569883715,CSE 284,A00,114175,Gymrek; Melissa Ann,0,31,0,0
1668569884141,CSE 290,A00,102399,Chandraker; Manmohan Krishna,0,11,0,0
1668569884141,CSE 290,B00,102400,Vaccaro; Kristen Marie,0,10,25,25
1668569884141,CSE 290,C00,102414,Pannuto; Patrick William,0,1,25,25
1668569884141,CSE 290,D00,102427,Pevzner; Pavel Arkadjevich,0,0,0,0
1668569884141,CSE 290,E00,102429,Zhao; Jishen,0,6,0,0
1668569884141,CSE 290,F00,102436,Tullsen; Dean Michael,0,6,0,0
1668569884141,CSE 290,G00,102440,Christensen; Henrik I,0,7,20,20
1668569884565,CSE 291,A00,102443,Su; Hao,0,0,0,0
1668569884565,CSE 291,B00,102448,Polikarpova; Nadezhda,0,0,0,0
1668569884565,CSE 291,C00,102453,Vaccaro; Kristen Marie,0,0,0,0
1668569884565,CSE 291,D00,111343,Savage; Stefan,0,0,0,0
1668569884565,CSE 291,E00,116474,Claffy; Kimberly Claire,0,0,0,0
1668569884565,CSE 291,F00,116479,Pasquale; Joseph,0,0,0,0
1668569884992,CSE 293,001,119111,Bafna; Vineet,9999,0,9999,0
1668569884992,CSE 293,002,119118,Bellare; Mihir,9999,0,9999,0
1668569884992,CSE 293,003,119122,Berg-Kirkpatrick; Taylor D,9999,0,9999,0
1668569884992,CSE 293,004,119135,Christensen; Henrik I,9999,0,9999,0
1668569884992,CSE 293,005,119142,Cottrell; Garrison W,9999,0,9999,0
1668569884992,CSE 293,006,119146,Deutsch; Alin Bernard,9999,0,9999,0
1668569884992,CSE 293,007,119159,Esmaeilzadeh; Hadi,9999,0,9999,0
1668569884992,CSE 293,008,119166,Freund; Yoav,9999,0,9999,0
1668569884992,CSE 293,009,119170,Griswold; William G.,9999,0,9999,0
1668569884992,CSE 293,010,119183,Gymrek; Melissa Ann,9999,0,9999,0
1668569884992,CSE 293,011,119190,Heninger; Nadia A,9999,0,9999,0
1668569884992,CSE 293,012,119230,Impagliazzo; Russell,9999,0,9999,0
1668569884992,CSE 293,013,119232,Jhala; Ranjit,9999,0,9999,0
1668569884992,CSE 293,014,119233,Kahng; Andrew Byun,9999,0,9999,0
1668569884992,CSE 293,015,119298,Kane; Daniel Mertz,9999,0,9999,0
1668569884992,CSE 293,016,119299,Kriegman; David J,9999,0,9999,0
1668569884992,CSE 293,017,119300,Kumar; Arun Kumar,9999,0,9999,0
1668569884992,CSE 293,018,119301,Lerner; Sorin,9999,0,9999,0
1668569884992,CSE 293,019,119302,Lovett; Shachar,9999,0,9999,0
1668569884992,CSE 293,020,119303,McAuley; Julian John,9999,0,9999,0
1668569884992,CSE 293,021,119304,Micciancio; Daniele,9999,0,9999,0
1668569884992,CSE 293,022,119367,Orailoglu; Alex,9999,0,9999,0
1668569884992,CSE 293,023,119382,Paturi; Ramamohan,9999,0,9999,0
1668569884992,CSE 293,024,119404,Polikarpova; Nadezhda,9999,0,9999,0
1668569884992,CSE 293,025,119406,Politz; Joseph Gibbs,9999,0,9999,0
1668569884992,CSE 293,026,119411,Porter; George M,9999,0,9999,0
1668569884992,CSE 293,027,119414,Porter; Leonard Emerson,9999,0,9999,0
1668569884992,CSE 293,028,119416,Ramamoorthi; Ravi,9999,0,9999,0
1668569884992,CSE 293,029,119417,Sahoo; Debashis,9999,0,9999,0
1668569884992,CSE 293,030,119420,Saul; Lawrence,9999,0,9999,0
1668569884992,CSE 293,031,119421,Savage; Stefan,9999,0,9999,0
1668569884992,CSE 293,032,119425,Schulze; Jurgen P.,9999,0,9999,0
1668569884992,CSE 293,033,119426,Snoeren; Alex C.,9999,0,9999,0
1668569884992,CSE 293,034,119428,Shang; Jingbo,9999,0,9999,0
1668569884992,CSE 293,035,119430,Stefan; Deian,9999,0,9999,0
1668569884992,CSE 293,036,119431,Su; Hao,9999,0,9999,0
1668569884992,CSE 293,037,119433,Swanson; Steven James,9999,0,9999,0
1668569884992,CSE 293,038,119435,Tullsen; Dean Michael,9999,0,9999,0
1668569884992,CSE 293,039,119483,Voelker; Geoffrey M.,9999,0,9999,0
1668569884992,CSE 293,040,119537,Zhao; Jishen,9999,0,9999,0
1668569884992,CSE 293,041,119538,Zhou; Yuan-Yuan,9999,0,9999,0
1668569884992,CSE 293,042,119539,Gao; Sicun,9999,0,9999,0
1668569884992,CSE 293,043,119540,Weibel; Nadir,9999,0,9999,0
1668569884992,CSE 293,044,119541,Gupta; Rajesh K.,9999,0,9999,0
1668569884992,CSE 293,045,126410,Vaccaro; Kristen Marie,9999,0,9999,0
1668569884992,CSE 293,046,126411,Klemke; Richard,9999,0,9999,0
1668569885415,CSE 294,A00,102459,Voelker; Geoffrey M.,0,2,0,0
1668569885415,CSE 294,B00,111322,Orailoglu; Alex,0,2,0,0
1668569885853,DSE 201,A00,096914,Deutsch; Alin Bernard,30,0,30,0
1668569886281,DSE 210,A00,096915,Dasgupta; Sanjoy,30,0,30,0
1668569886719,DSE 260A,A00,096916,Altintas De Callaf; Ilkay,30,0,30,0
1668569887165,ECE 200,001,103586,Antipa; Nicholas A,9999,0,9999,0
1668569887165,ECE 200,002,103587,Atanasov; Nikolay A.,9999,0,9999,0
1668569887165,ECE 200,003,103588,Bharadia; Dinesh,9999,0,9999,0
1668569887165,ECE 200,004,103589,Cheng; Chung Kuan,9999,0,9999,0
1668569887165,ECE 200,005,103590,Cosman; Pamela C.,9999,0,9999,0
1668569887165,ECE 200,006,103591,Dayeh; Shadi Ahmad,9999,0,9999,0
1668569887165,ECE 200,007,103592,Fainman; Yeshaiahu,9999,0,9999,0
1668569887165,ECE 200,008,103593,Ford; Joseph Earl,9999,0,9999,0
1668569887165,ECE 200,009,103594,Franceschetti; Massimo,9999,0,9999,0
1668569887165,ECE 200,010,103595,Fullerton; Eric E,9999,0,9999,0
1668569887165,ECE 200,011,103596,Galton; Ian A,9999,0,9999,0
1668569887165,ECE 200,012,103597,Gilja; Vikash,9999,0,9999,0
1668569887165,ECE 200,013,103598,Hall; Drew A.,9999,0,9999,0
1668569887165,ECE 200,014,103599,Hsueh; Tzu-Chien,9999,0,9999,0
1668569887165,ECE 200,015,103600,Javidi; Tara,9999,0,9999,0
1668569887165,ECE 200,016,103601,Kahng; Andrew Byun,9999,0,9999,0
1668569887165,ECE 200,017,103602,Kim; Young-Han,9999,0,9999,0
1668569887165,ECE 200,018,103603,Koushanfar; Farinaz,9999,0,9999,0
1668569887165,ECE 200,019,103604,Kuzum; Duygu,9999,0,9999,0
1668569887165,ECE 200,020,103605,Le; Hanh-Phuc,9999,0,9999,0
1668569887165,ECE 200,021,103606,Lin; Bill,9999,0,9999,0
1668569887165,ECE 200,022,103607,Liu; Zhaowei,9998,0,9999,1
1668569887165,ECE 200,023,103608,Lo; Yu-Hwa,9999,0,9999,0
1668569887165,ECE 200,024,103609,Lomakin; Vitaliy,9999,0,9999,0
1668569887165,ECE 200,025,103610,Mercier; Patrick Philip,9999,0,9999,0
1668569887165,ECE 200,026,103611,Meyer; Florian,9999,0,9999,0
1668569887165,ECE 200,027,103612,Milstein; Laurence B.,9999,0,9999,0
1668569887165,ECE 200,028,103613,Mir Arabbaygi; Siavash,9999,0,9999,0
1668569887165,ECE 200,029,103614,Mookherjea; Shayan,9999,0,9999,0
1668569887165,ECE 200,030,103615,Morris; Karcher William,9999,0,9999,0
1668569887165,ECE 200,031,103616,Ng; Tse Nga,9999,0,9999,0
1668569887165,ECE 200,032,103617,Nguyen; Truong Quang,9999,0,9999,0
1668569887165,ECE 200,033,103618,Nomura; Kenji,9999,0,9999,0
1668569887165,ECE 200,034,103619,Orlitsky; Alon,9999,0,9999,0
1668569887165,ECE 200,035,103620,Pal; Piya,9999,0,9999,0
1668569887165,ECE 200,036,103621,Papen; George C.,9999,0,9999,0
1668569887165,ECE 200,037,103622,Radic; Stojan,9999,0,9999,0
1668569887165,ECE 200,038,103623,Rao; Bhaskar D.,9999,0,9999,0
1668569887165,ECE 200,039,103624,Rao; Ramesh R,9999,0,9999,0
1668569887165,ECE 200,040,103625,Rebeiz; Gabriel,9999,0,9999,0
1668569887165,ECE 200,041,103626,Sanford; John R,9999,0,9999,0
1668569887165,ECE 200,042,103627,Siegel; Paul H.,9999,0,9999,0
1668569887165,ECE 200,043,103628,Sievenpiper; Daniel F.,9999,0,9999,0
1668569887165,ECE 200,044,103629,Sworder; David D.,9999,0,9999,0
1668569887165,ECE 200,045,103630,Taur; Yuan,9999,0,9999,0
1668569887165,ECE 200,046,103631,Touri; Behrouz,9999,0,9999,0
1668569887165,ECE 200,047,103632,Trivedi; Mohan M.,9999,0,9999,0
1668569887165,ECE 200,048,103633,Vasconcelos; Nuno,9999,0,9999,0
1668569887165,ECE 200,049,103634,Wang; Xiaolong,9999,0,9999,0
1668569887165,ECE 200,050,103635,Xie; Pengtao,9999,0,9999,0
1668569887165,ECE 200,051,103636,Yip; Michael,9999,0,9999,0
1668569887165,ECE 200,052,103637,Zeger; Kenneth A.,999,0,999,0
1668569887165,ECE 200,053,103638,Zhang; Xinyu,9999,0,9999,0
1668569887165,ECE 200,054,103639,Turakhia; Yatish Girish,9999,0,9999,0
1668569887165,ECE 200,055,103640,Kang; Mingu,9999,0,9999,0
1668569887165,ECE 200,056,103641,Shi; Yuanyuan,9999,0,9999,0
1668569887165,ECE 200,057,103642,Wang; Edward Jay,9999,0,9999,0
1668569887165,ECE 200,058,103643,Zheng; Yang,9999,0,9999,0
1668569887595,ECE 202,A00,103644,Kuzum; Duygu,0,46,0,0
1668569888022,ECE 212BN,A00,103646,Ng; Tse Nga,0,9,0,0
1668569888452,ECE 221,A00,111493,Staff,0,0,0,0
1668569888876,ECE 222B,A00,103647,Lomakin; Vitaliy,0,21,0,0
1668569889307,ECE 230B,A00,103648,Taur; Yuan,0,4,0,0
1668569889728,ECE 238B,A00,103649,Garay; Javier,0,0,0,0
1668569890155,ECE 240B,A00,112900,Fainman; Yeshaiahu,0,8,0,0
1668569890580,ECE 247A,A00,103650,Jokerst; Jesse Vincent,0,6,0,0
1668569891004,ECE 247B,A00,103651,Wang; Joseph,0,15,0,0
1668569891434,ECE 250,A00,103652,Siegel; Paul H.,0,85,0,0
1668569891856,ECE 251A,A00,103654,Rao; Bhaskar D.,0,65,0,0
1668569892286,ECE 257B,A00,103655,Bharadia; Dinesh,0,33,0,0
1668569892723,ECE 258A,A00,103656,Milstein; Laurence B.,0,29,0,0
1668569893147,ECE 260B,A00,103658,Kang; Mingu,0,121,0,0
1668569893574,ECE 264A,A00,103659,Galton; Ian A,0,45,0,31
1668569893996,ECE 265A,A00,103661,Gudem; Prasad S.S.,0,47,0,30
1668569894419,ECE 265D,A00,103662,Gudem; Prasad S.S.,0,27,0,0
1668569894851,ECE 268,A00,103663,Koushanfar; Farinaz,0,44,0,0
1668569895274,ECE 269,A01,103665,Pal; Piya,0,222,0,0
1668569895704,ECE 271B,A00,103666,Vasconcelos; Manuela,0,78,0,0
1668569896131,ECE 276A,A00,103667,Atanasov; Nikolay A.,0,126,0,0
1668569896556,ECE 277,A00,103668,An; Cheolhong,0,151,0,0
1668569896980,ECE 279,A00,117947,Hall; Drew A.,0,22,0,0
1668569897836,ECE 283,A00,103670,Hsueh; Tzu-Chien,0,57,0,0
1668569898266,ECE 284,A00,103671,Turakhia; Yatish Girish,0,41,0,0
1668569898690,ECE 285,A00,103672,Zheng; Yang,0,40,0,0
1668569898690,ECE 285,B00,103673,Sworder; David D.,0,61,0,0
1668569899120,ECE 287,A00,103676,Javidi; Tara,0,8,0,0
1668569899546,MATH 200B,A00,098023,Salehi Golsefidy; Alireza,7,0,15,8
1668569899972,MATH 202B,A00,098024,Rhoades; Brendon Patrick,7,0,15,8
1668569900396,MATH 203B,A00,098025,Oprea; Dragos N.,9,0,15,6
1668569900821,MATH 204B,A00,098026,Sorensen; Claus M,13,0,15,2
1668569901243,MATH 208,A00,098027,Izadi; Elham,7,0,10,3
1668569901669,MATH 209,A00,098028,Pollack; Aaron,10,0,10,0
1668569902104,MATH 211A,A00,112919,Rogalski; Daniel,8,0,10,2
1668569902533,MATH 211B,A00,112920,Seward; Brandon M.,9,0,10,1
1668569903033,MATH 218,A00,098029,Li; Bo,10,0,10,0
1668569903458,MATH 220B,A00,098030,Novak; Jonathan I,10,0,15,5
1668569903883,MATH 221A,A00,098031,Ebenfelt; Peter F,12,0,15,3
1668569904312,MATH 231B,A00,098032,Zlatos; Andrej,9,0,15,6
1668569904736,MATH 240B,A00,098033,Ni; Lei,7,0,15,8
1668569905160,MATH 243,A00,098034,Jekel; David Andrew,10,0,10,0
1668569905583,MATH 245A,A00,098035,Nie; Jiawang,0,7,15,18
1668569906012,MATH 248,A00,098036,Bejenaru; Ioan,10,0,10,0
1668569906436,MATH 250B,A00,098037,Spolaor; Luca,12,0,15,3
1668569906861,MATH 258,A00,098038,Ni; Lei,8,0,10,2
1668569907286,MATH 264B,A00,098041,Rhoades; Brendon Patrick,7,0,15,8
1668569907710,MATH 268,A00,098042,Buss; Samuel R,10,0,10,0
1668569908132,MATH 269,A00,098043,Rhoades; Brendon Patrick,10,0,10,0
1668569908556,MATH 270B,A00,098044,Li; Bo,6,0,15,9
1668569908993,MATH 272B,A00,098045,Holst; Michael J,13,0,15,2
1668569909416,MATH 273A,A00,098046,Tian; Xiaochuan,10,0,15,5
1668569909841,MATH 275,A01,098048,Tian; Xiaochuan,6,0,10,4
1668569910265,MATH 278A,A00,098049,Holst; Michael J,6,0,10,4
1668569910700,MATH 278B,A00,098050,Cloninger; Alexander,10,0,10,0
1668569911125,MATH 278C,A00,098051,Nie; Jiawang,5,0,10,5
1668569911549,MATH 280B,A00,098052,Zheng; Tianyi,6,0,15,9
1668569911973,MATH 281B,A00,098053,Bradic; Jelena,0,2,15,15
1668569912397,MATH 282B,A00,098054,Arias-Castro; Ery,0,1,15,15
1668569912820,MATH 285,A00,098055,Fitzsimmons; Patrick J,0,4,15,17
1668569913245,MATH 287B,A00,098056,Arias-Castro; Ery,1,0,15,14
1668569913668,MATH 288,A00,098057,Agarwal; Pooja,9,0,10,1
1668569913668,MATH 288,B00,098058,Zhang; Danna,8,0,10,2
1668569913668,MATH 288,C00,098059,Williams; Ruth J,9,0,10,1
1668569914102,MATH 290B,A00,098060,Roberts; Justin Deritter,11,0,15,4
1668569914537,MATH 292,A00,098061,Belmont; Eva Kinoshita,10,0,10,0
1668569914961,MATH 295,A00,098062,Suk; Andrew Hoon,47,0,50,3
1668569915386,MATH 296,A00,098063,Novak; Jonathan I,20,0,20,0
1668569915817,MATH 297,001,098064,Gamst; Anthony Collins,9997,0,9999,2
1668570418661,COGS 205,A00,101395,Chiba; Andrea,19,0,20,1
1668570419087,COGS 210B,001,101404,Greene; Deanna Jacquelyn,9998,0,9999,1
1668570419087,COGS 210B,002,101417,Xia; Haijun,9999,0,9999,0
1668570419087,COGS 210B,003,101422,Nitz; Douglas A.,9999,0,9999,0
1668570419087,COGS 210B,004,101423,Hollan; James D.,9998,0,9999,1
1668570419087,COGS 210B,005,101424,Deak; Gedeon O.,9998,0,9999,1
1668570419087,COGS 210B,006,101425,Rossano; Federico,9999,0,9999,0
1668570419517,COGS 211B,A00,101427,Coulson; Seana M,9996,0,9999,3
1668570419938,COGS 220,A00,101428,Hollan; James D.,0,17,25,25
1668570420372,COGS 229,A00,101429,Dow; Steven P,17,0,25,8
1668570420812,COGS 230,A00,101430,Klemmer; Scott R,6,0,17,11
1668570421249,COGS 234,A00,101431,Xia; Haijun,0,1,25,25
1668570421674,COGS 260,A00,101432,Kiyonaga; Anastasia,21,0,25,4
1668570421674,COGS 260,B00,101433,Kirsh; David Joel,15,0,25,10
1668570422096,CSE 202,A00,102371,Impagliazzo; Russell,0,71,0,0
1668570422527,CSE 203B,A01,102373,Cheng; Chung Kuan,0,68,0,0
1668570422954,CSE 208,A00,102374,Micciancio; Daniele,0,5,0,0
1668570423381,CSE 209A,A00,112895,Impagliazzo; Russell,0,14,15,15
1668570423804,CSE 209B,A00,108005,Bellare; Mihir,0,7,0,0
1668570424308,CSE 210,A00,113163,Coblenz; Michael J,0,95,0,0
1668570424735,CSE 219,A00,106111,Dow; Steven P,0,8,20,20
1668570425157,CSE 221,A00,102376,Voelker; Geoffrey M.,0,77,0,0
1668570425595,CSE 224,A01,102378,Porter; George M,0,177,0,0
1668570426030,CSE 229A,A00,102379,Savage; Stefan,0,14,0,0
1668570426465,CSE 229C,A00,102380,Munyaka; Imani N. S.,0,12,0,0
1668570426889,CSE 232B,A00,102382,Deutsch; Alin Bernard,0,39,0,0
1668570427312,CSE 234,A01,112904,Kumar; Arun Kumar,0,0,0,0
1668570427739,CSE 237A,A00,102383,Rosing; Tajana Simunic,0,57,0,0
1668570428164,CSE 239A,A00,102384,Deutsch; Alin Bernard,0,18,0,0
1668570428588,CSE 239B,A00,102385,Polikarpova; Nadezhda,0,11,0,0
1668570429010,CSE 240A,A00,102386,Pannuto; Patrick William,0,49,0,0
1668570429440,CSE 240B,A00,102387,Zhao; Jishen,0,51,0,0
1668570429862,CSE 241A,A00,106406,Kang; Mingu,0,9,0,0
1668570430292,CSE 249B,A00,102388,Kahng; Andrew Byun,0,5,8,8
1668570430722,CSE 251B,A01,102392,Cottrell; Garrison W,0,53,0,0
1668570430722,CSE 251B,A02,102393,Cottrell; Garrison W,0,36,0,0
1668570431152,CSE 252B,A00,102394,Ochoa; Benjamin Lawrence,0,64,0,0
1668570431574,CSE 257,A01,102396,Gao; Sicun,0,157,0,0
1668570432001,CSE 272,A00,102397,Li; Tzumao,0,22,0,0
1668570432425,CSE 274,A00,111323,Chern; Albert Ren-Haur,0,16,0,0
1668570432852,CSE 282,A00,102398,Pevzner; Pavel Arkadjevich,0,0,0,0
1668570433285,CSE 284,A00,114175,Gymrek; Melissa Ann,0,31,0,0
1668570433724,CSE 290,A00,102399,Chandraker; Manmohan Krishna,0,11,0,0
1668570433724,CSE 290,B00,102400,Vaccaro; Kristen Marie,0,10,25,25
1668570433724,CSE 290,C00,102414,Pannuto; Patrick William,0,1,25,25
1668570433724,CSE 290,D00,102427,Pevzner; Pavel Arkadjevich,0,0,0,0
1668570433724,CSE 290,E00,102429,Zhao; Jishen,0,6,0,0
1668570433724,CSE 290,F00,102436,Tullsen; Dean Michael,0,6,0,0
1668570433724,CSE 290,G00,102440,Christensen; Henrik I,0,8,20,20
1668570434173,CSE 291,A00,102443,Su; Hao,0,0,0,0
1668570434173,CSE 291,B00,102448,Polikarpova; Nadezhda,0,0,0,0
1668570434173,CSE 291,C00,102453,Vaccaro; Kristen Marie,0,0,0,0
1668570434173,CSE 291,D00,111343,Savage; Stefan,0,0,0,0
1668570434173,CSE 291,E00,116474,Claffy; Kimberly Claire,0,0,0,0
1668570434173,CSE 291,F00,116479,Pasquale; Joseph,0,0,0,0
1668570434602,CSE 293,001,119111,Bafna; Vineet,9999,0,9999,0
1668570434602,CSE 293,002,119118,Bellare; Mihir,9999,0,9999,0
1668570434602,CSE 293,003,119122,Berg-Kirkpatrick; Taylor D,9999,0,9999,0
1668570434602,CSE 293,004,119135,Christensen; Henrik I,9999,0,9999,0
1668570434602,CSE 293,005,119142,Cottrell; Garrison W,9999,0,9999,0
1668570434602,CSE 293,006,119146,Deutsch; Alin Bernard,9999,0,9999,0
1668570434602,CSE 293,007,119159,Esmaeilzadeh; Hadi,9999,0,9999,0
1668570434602,CSE 293,008,119166,Freund; Yoav,9999,0,9999,0
1668570434602,CSE 293,009,119170,Griswold; William G.,9999,0,9999,0
1668570434602,CSE 293,010,119183,Gymrek; Melissa Ann,9999,0,9999,0
1668570434602,CSE 293,011,119190,Heninger; Nadia A,9999,0,9999,0
1668570434602,CSE 293,012,119230,Impagliazzo; Russell,9999,0,9999,0
1668570434602,CSE 293,013,119232,Jhala; Ranjit,9999,0,9999,0
1668570434602,CSE 293,014,119233,Kahng; Andrew Byun,9999,0,9999,0
1668570434602,CSE 293,015,119298,Kane; Daniel Mertz,9999,0,9999,0
1668570434602,CSE 293,016,119299,Kriegman; David J,9999,0,9999,0
1668570434602,CSE 293,017,119300,Kumar; Arun Kumar,9999,0,9999,0
1668570434602,CSE 293,018,119301,Lerner; Sorin,9999,0,9999,0
1668570434602,CSE 293,019,119302,Lovett; Shachar,9999,0,9999,0
1668570434602,CSE 293,020,119303,McAuley; Julian John,9999,0,9999,0
1668570434602,CSE 293,021,119304,Micciancio; Daniele,9999,0,9999,0
1668570434602,CSE 293,022,119367,Orailoglu; Alex,9999,0,9999,0
1668570434602,CSE 293,023,119382,Paturi; Ramamohan,9999,0,9999,0
1668570434602,CSE 293,024,119404,Polikarpova; Nadezhda,9999,0,9999,0
1668570434602,CSE 293,025,119406,Politz; Joseph Gibbs,9999,0,9999,0
1668570434602,CSE 293,026,119411,Porter; George M,9999,0,9999,0
1668570434602,CSE 293,027,119414,Porter; Leonard Emerson,9999,0,9999,0
1668570434602,CSE 293,028,119416,Ramamoorthi; Ravi,9999,0,9999,0
1668570434602,CSE 293,029,119417,Sahoo; Debashis,9999,0,9999,0
1668570434602,CSE 293,030,119420,Saul; Lawrence,9999,0,9999,0
1668570434602,CSE 293,031,119421,Savage; Stefan,9999,0,9999,0
1668570434602,CSE 293,032,119425,Schulze; Jurgen P.,9999,0,9999,0
1668570434602,CSE 293,033,119426,Snoeren; Alex C.,9999,0,9999,0
1668570434602,CSE 293,034,119428,Shang; Jingbo,9999,0,9999,0
1668570434602,CSE 293,035,119430,Stefan; Deian,9999,0,9999,0
1668570434602,CSE 293,036,119431,Su; Hao,9999,0,9999,0
1668570434602,CSE 293,037,119433,Swanson; Steven James,9999,0,9999,0
1668570434602,CSE 293,038,119435,Tullsen; Dean Michael,9999,0,9999,0
1668570434602,CSE 293,039,119483,Voelker; Geoffrey M.,9999,0,9999,0
1668570434602,CSE 293,040,119537,Zhao; Jishen,9999,0,9999,0
1668570434602,CSE 293,041,119538,Zhou; Yuan-Yuan,9999,0,9999,0
1668570434602,CSE 293,042,119539,Gao; Sicun,9999,0,9999,0
1668570434602,CSE 293,043,119540,Weibel; Nadir,9999,0,9999,0
1668570434602,CSE 293,044,119541,Gupta; Rajesh K.,9999,0,9999,0
1668570434602,CSE 293,045,126410,Vaccaro; Kristen Marie,9999,0,9999,0
1668570434602,CSE 293,046,126411,Klemke; Richard,9999,0,9999,0
1668570435023,CSE 294,A00,102459,Voelker; Geoffrey M.,0,2,0,0
1668570435023,CSE 294,B00,111322,Orailoglu; Alex,0,2,0,0
1668570435447,DSE 201,A00,096914,Deutsch; Alin Bernard,30,0,30,0
1668570435879,DSE 210,A00,096915,Dasgupta; Sanjoy,30,0,30,0
1668570436311,DSE 260A,A00,096916,Altintas De Callaf; Ilkay,30,0,30,0
1668570436739,ECE 200,001,103586,Antipa; Nicholas A,9999,0,9999,0
1668570436739,ECE 200,002,103587,Atanasov; Nikolay A.,9999,0,9999,0
1668570436739,ECE 200,003,103588,Bharadia; Dinesh,9999,0,9999,0
1668570436739,ECE 200,004,103589,Cheng; Chung Kuan,9999,0,9999,0
1668570436739,ECE 200,005,103590,Cosman; Pamela C.,9999,0,9999,0
1668570436739,ECE 200,006,103591,Dayeh; Shadi Ahmad,9999,0,9999,0
1668570436739,ECE 200,007,103592,Fainman; Yeshaiahu,9999,0,9999,0
1668570436739,ECE 200,008,103593,Ford; Joseph Earl,9999,0,9999,0
1668570436739,ECE 200,009,103594,Franceschetti; Massimo,9999,0,9999,0
1668570436739,ECE 200,010,103595,Fullerton; Eric E,9999,0,9999,0
1668570436739,ECE 200,011,103596,Galton; Ian A,9999,0,9999,0
1668570436739,ECE 200,012,103597,Gilja; Vikash,9999,0,9999,0
1668570436739,ECE 200,013,103598,Hall; Drew A.,9999,0,9999,0
1668570436739,ECE 200,014,103599,Hsueh; Tzu-Chien,9999,0,9999,0
1668570436739,ECE 200,015,103600,Javidi; Tara,9999,0,9999,0
1668570436739,ECE 200,016,103601,Kahng; Andrew Byun,9999,0,9999,0
1668570436739,ECE 200,017,103602,Kim; Young-Han,9999,0,9999,0
1668570436739,ECE 200,018,103603,Koushanfar; Farinaz,9999,0,9999,0
1668570436739,ECE 200,019,103604,Kuzum; Duygu,9999,0,9999,0
1668570436739,ECE 200,020,103605,Le; Hanh-Phuc,9999,0,9999,0
1668570436739,ECE 200,021,103606,Lin; Bill,9999,0,9999,0
1668570436739,ECE 200,022,103607,Liu; Zhaowei,9998,0,9999,1
1668570436739,ECE 200,023,103608,Lo; Yu-Hwa,9999,0,9999,0
1668570436739,ECE 200,024,103609,Lomakin; Vitaliy,9999,0,9999,0
1668570436739,ECE 200,025,103610,Mercier; Patrick Philip,9999,0,9999,0
1668570436739,ECE 200,026,103611,Meyer; Florian,9999,0,9999,0
1668570436739,ECE 200,027,103612,Milstein; Laurence B.,9999,0,9999,0
1668570436739,ECE 200,028,103613,Mir Arabbaygi; Siavash,9999,0,9999,0
1668570436739,ECE 200,029,103614,Mookherjea; Shayan,9999,0,9999,0
1668570436739,ECE 200,030,103615,Morris; Karcher William,9999,0,9999,0
1668570436739,ECE 200,031,103616,Ng; Tse Nga,9999,0,9999,0
1668570436739,ECE 200,032,103617,Nguyen; Truong Quang,9999,0,9999,0
1668570436739,ECE 200,033,103618,Nomura; Kenji,9999,0,9999,0
1668570436739,ECE 200,034,103619,Orlitsky; Alon,9999,0,9999,0
1668570436739,ECE 200,035,103620,Pal; Piya,9999,0,9999,0
1668570436739,ECE 200,036,103621,Papen; George C.,9999,0,9999,0
1668570436739,ECE 200,037,103622,Radic; Stojan,9999,0,9999,0
1668570436739,ECE 200,038,103623,Rao; Bhaskar D.,9999,0,9999,0
1668570436739,ECE 200,039,103624,Rao; Ramesh R,9999,0,9999,0
1668570436739,ECE 200,040,103625,Rebeiz; Gabriel,9999,0,9999,0
1668570436739,ECE 200,041,103626,Sanford; John R,9999,0,9999,0
1668570436739,ECE 200,042,103627,Siegel; Paul H.,9999,0,9999,0
1668570436739,ECE 200,043,103628,Sievenpiper; Daniel F.,9999,0,9999,0
1668570436739,ECE 200,044,103629,Sworder; David D.,9999,0,9999,0
1668570436739,ECE 200,045,103630,Taur; Yuan,9999,0,9999,0
1668570436739,ECE 200,046,103631,Touri; Behrouz,9999,0,9999,0
1668570436739,ECE 200,047,103632,Trivedi; Mohan M.,9999,0,9999,0
1668570436739,ECE 200,048,103633,Vasconcelos; Nuno,9999,0,9999,0
1668570436739,ECE 200,049,103634,Wang; Xiaolong,9999,0,9999,0
1668570436739,ECE 200,050,103635,Xie; Pengtao,9999,0,9999,0
1668570436739,ECE 200,051,103636,Yip; Michael,9999,0,9999,0
1668570436739,ECE 200,052,103637,Zeger; Kenneth A.,999,0,999,0
1668570436739,ECE 200,053,103638,Zhang; Xinyu,9999,0,9999,0
1668570436739,ECE 200,054,103639,Turakhia; Yatish Girish,9999,0,9999,0
1668570436739,ECE 200,055,103640,Kang; Mingu,9999,0,9999,0
1668570436739,ECE 200,056,103641,Shi; Yuanyuan,9999,0,9999,0
1668570436739,ECE 200,057,103642,Wang; Edward Jay,9999,0,9999,0
1668570436739,ECE 200,058,103643,Zheng; Yang,9999,0,9999,0
1668570437164,ECE 202,A00,103644,Kuzum; Duygu,0,46,0,0
1668570437590,ECE 212BN,A00,103646,Ng; Tse Nga,0,9,0,0
1668570438012,ECE 221,A00,111493,Staff,0,0,0,0
1668570438438,ECE 222B,A00,103647,Lomakin; Vitaliy,0,21,0,0
1668570438865,ECE 230B,A00,103648,Taur; Yuan,0,4,0,0
1668570439288,ECE 238B,A00,103649,Garay; Javier,0,0,0,0
1668570439712,ECE 240B,A00,112900,Fainman; Yeshaiahu,0,8,0,0
1668570440140,ECE 247A,A00,103650,Jokerst; Jesse Vincent,0,6,0,0
1668570440569,ECE 247B,A00,103651,Wang; Joseph,0,15,0,0
1668570440992,ECE 250,A00,103652,Siegel; Paul H.,0,85,0,0
1668570441425,ECE 251A,A00,103654,Rao; Bhaskar D.,0,65,0,0
1668570441914,ECE 257B,A00,103655,Bharadia; Dinesh,0,33,0,0
1668570442336,ECE 258A,A00,103656,Milstein; Laurence B.,0,29,0,0
1668570442774,ECE 260B,A00,103658,Kang; Mingu,0,121,0,0
1668570443215,ECE 264A,A00,103659,Galton; Ian A,0,45,0,31
1668570443642,ECE 265A,A00,103661,Gudem; Prasad S.S.,0,47,0,30
1668570444070,ECE 265D,A00,103662,Gudem; Prasad S.S.,0,27,0,0
1668570444495,ECE 268,A00,103663,Koushanfar; Farinaz,0,44,0,0
1668570444932,ECE 269,A01,103665,Pal; Piya,0,222,0,0
1668570445366,ECE 271B,A00,103666,Vasconcelos; Manuela,0,78,0,0
1668570445805,ECE 276A,A00,103667,Atanasov; Nikolay A.,0,126,0,0
1668570446233,ECE 277,A00,103668,An; Cheolhong,0,151,0,0
1668570446670,ECE 279,A00,117947,Hall; Drew A.,0,22,0,0
1668570447515,ECE 283,A00,103670,Hsueh; Tzu-Chien,0,57,0,0
1668570447944,ECE 284,A00,103671,Turakhia; Yatish Girish,0,41,0,0
1668570448367,ECE 285,A00,103672,Zheng; Yang,0,40,0,0
1668570448367,ECE 285,B00,103673,Sworder; David D.,0,61,0,0
1668570448792,ECE 287,A00,103676,Javidi; Tara,0,8,0,0
1668570449214,MATH 200B,A00,098023,Salehi Golsefidy; Alireza,7,0,15,8
1668570449640,MATH 202B,A00,098024,Rhoades; Brendon Patrick,7,0,15,8
1668570450076,MATH 203B,A00,098025,Oprea; Dragos N.,9,0,15,6
1668570450500,MATH 204B,A00,098026,Sorensen; Claus M,13,0,15,2
1668570450931,MATH 208,A00,098027,Izadi; Elham,7,0,10,3
1668570451355,MATH 209,A00,098028,Pollack; Aaron,10,0,10,0
1668570451779,MATH 211A,A00,112919,Rogalski; Daniel,8,0,10,2
1668570452204,MATH 211B,A00,112920,Seward; Brandon M.,9,0,10,1
1668570452626,MATH 218,A00,098029,Li; Bo,10,0,10,0
1668570453061,MATH 220B,A00,098030,Novak; Jonathan I,10,0,15,5
1668570453488,MATH 221A,A00,098031,Ebenfelt; Peter F,12,0,15,3
1668570453911,MATH 231B,A00,098032,Zlatos; Andrej,9,0,15,6
1668570454391,MATH 240B,A00,098033,Ni; Lei,7,0,15,8
1668570454817,MATH 243,A00,098034,Jekel; David Andrew,10,0,10,0
1668570455243,MATH 245A,A00,098035,Nie; Jiawang,0,7,15,18
1668570455666,MATH 248,A00,098036,Bejenaru; Ioan,10,0,10,0
1668570456087,MATH 250B,A00,098037,Spolaor; Luca,12,0,15,3
1668570456513,MATH 258,A00,098038,Ni; Lei,8,0,10,2
1668570456937,MATH 264B,A00,098041,Rhoades; Brendon Patrick,7,0,15,8
1668570457357,MATH 268,A00,098042,Buss; Samuel R,10,0,10,0
1668570457780,MATH 269,A00,098043,Rhoades; Brendon Patrick,10,0,10,0
1668570458202,MATH 270B,A00,098044,Li; Bo,6,0,15,9
1668570458634,MATH 272B,A00,098045,Holst; Michael J,13,0,15,2
1668570459064,MATH 273A,A00,098046,Tian; Xiaochuan,10,0,15,5
1668570459493,MATH 275,A01,098048,Tian; Xiaochuan,6,0,10,4
1668570459917,MATH 278A,A00,098049,Holst; Michael J,6,0,10,4
1668570460341,MATH 278B,A00,098050,Cloninger; Alexander,10,0,10,0
1668570460766,MATH 278C,A00,098051,Nie; Jiawang,5,0,10,5
1668570461193,MATH 280B,A00,098052,Zheng; Tianyi,6,0,15,9
1668570461617,MATH 281B,A00,098053,Bradic; Jelena,0,2,15,15
1668570462043,MATH 282B,A00,098054,Arias-Castro; Ery,0,1,15,15
1668570462468,MATH 285,A00,098055,Fitzsimmons; Patrick J,0,4,15,17
1668570462900,MATH 287B,A00,098056,Arias-Castro; Ery,1,0,15,14
1668570463325,MATH 288,A00,098057,Agarwal; Pooja,9,0,10,1
1668570463325,MATH 288,B00,098058,Zhang; Danna,8,0,10,2
1668570463325,MATH 288,C00,098059,Williams; Ruth J,9,0,10,1
1668570463756,MATH 290B,A00,098060,Roberts; Justin Deritter,11,0,15,4
1668570464178,MATH 292,A00,098061,Belmont; Eva Kinoshita,10,0,10,0
1668570464608,MATH 295,A00,098062,Suk; Andrew Hoon,47,0,50,3
1668570465034,MATH 296,A00,098063,Novak; Jonathan I,20,0,20,0
1668570465463,MATH 297,001,098064,Gamst; Anthony Collins,9997,0,9999,2
1668570968644,COGS 205,A00,101395,Chiba; Andrea,19,0,20,1
1668570969072,COGS 210B,001,101404,Greene; Deanna Jacquelyn,9998,0,9999,1
1668570969072,COGS 210B,002,101417,Xia; Haijun,9999,0,9999,0
1668570969072,COGS 210B,003,101422,Nitz; Douglas A.,9999,0,9999,0
1668570969072,COGS 210B,004,101423,Hollan; James D.,9998,0,9999,1
1668570969072,COGS 210B,005,101424,Deak; Gedeon O.,9998,0,9999,1
1668570969072,COGS 210B,006,101425,Rossano; Federico,9999,0,9999,0
1668570969495,COGS 211B,A00,101427,Coulson; Seana M,9996,0,9999,3
1668570969921,COGS 220,A00,101428,Hollan; James D.,0,17,25,25
1668570970351,COGS 229,A00,101429,Dow; Steven P,17,0,25,8
1668570970773,COGS 230,A00,101430,Klemmer; Scott R,6,0,17,11
1668570971197,COGS 234,A00,101431,Xia; Haijun,0,1,25,25
1668570971624,COGS 260,A00,101432,Kiyonaga; Anastasia,21,0,25,4
1668570971624,COGS 260,B00,101433,Kirsh; David Joel,15,0,25,10
1668570972051,CSE 202,A00,102371,Impagliazzo; Russell,0,71,0,0
1668570972478,CSE 203B,A01,102373,Cheng; Chung Kuan,0,68,0,0
1668570972900,CSE 208,A00,102374,Micciancio; Daniele,0,5,0,0
1668570973326,CSE 209A,A00,112895,Impagliazzo; Russell,0,14,15,15
1668570973749,CSE 209B,A00,108005,Bellare; Mihir,0,7,0,0
1668570974171,CSE 210,A00,113163,Coblenz; Michael J,0,95,0,0
1668570974595,CSE 219,A00,106111,Dow; Steven P,0,8,20,20
1668570975027,CSE 221,A00,102376,Voelker; Geoffrey M.,0,77,0,0
1668570975464,CSE 224,A01,102378,Porter; George M,0,177,0,0
1668570975893,CSE 229A,A00,102379,Savage; Stefan,0,14,0,0
1668570976315,CSE 229C,A00,102380,Munyaka; Imani N. S.,0,12,0,0
1668570976739,CSE 232B,A00,102382,Deutsch; Alin Bernard,0,39,0,0
1668570977162,CSE 234,A01,112904,Kumar; Arun Kumar,0,0,0,0
1668570977590,CSE 237A,A00,102383,Rosing; Tajana Simunic,0,57,0,0
1668570978019,CSE 239A,A00,102384,Deutsch; Alin Bernard,0,18,0,0
1668570978451,CSE 239B,A00,102385,Polikarpova; Nadezhda,0,11,0,0
1668570978873,CSE 240A,A00,102386,Pannuto; Patrick William,0,49,0,0
1668570979314,CSE 240B,A00,102387,Zhao; Jishen,0,51,0,0
1668570979738,CSE 241A,A00,106406,Kang; Mingu,0,9,0,0
1668570980177,CSE 249B,A00,102388,Kahng; Andrew Byun,0,5,8,8
1668570980605,CSE 251B,A01,102392,Cottrell; Garrison W,0,53,0,0
1668570980605,CSE 251B,A02,102393,Cottrell; Garrison W,0,36,0,0
1668570981038,CSE 252B,A00,102394,Ochoa; Benjamin Lawrence,0,64,0,0
1668570981465,CSE 257,A01,102396,Gao; Sicun,0,157,0,0
1668570981887,CSE 272,A00,102397,Li; Tzumao,0,22,0,0
1668570982329,CSE 274,A00,111323,Chern; Albert Ren-Haur,0,16,0,0
1668570982765,CSE 282,A00,102398,Pevzner; Pavel Arkadjevich,0,0,0,0
1668570983193,CSE 284,A00,114175,Gymrek; Melissa Ann,0,32,0,0
1668570983622,CSE 290,A00,102399,Chandraker; Manmohan Krishna,0,11,0,0
1668570983622,CSE 290,B00,102400,Vaccaro; Kristen Marie,0,10,25,25
1668570983622,CSE 290,C00,102414,Pannuto; Patrick William,0,1,25,25
1668570983622,CSE 290,D00,102427,Pevzner; Pavel Arkadjevich,0,0,0,0
1668570983622,CSE 290,E00,102429,Zhao; Jishen,0,6,0,0
1668570983622,CSE 290,F00,102436,Tullsen; Dean Michael,0,6,0,0
1668570983622,CSE 290,G00,102440,Christensen; Henrik I,0,8,20,20
1668570984046,CSE 291,A00,102443,Su; Hao,0,0,0,0
1668570984046,CSE 291,B00,102448,Polikarpova; Nadezhda,0,0,0,0
1668570984046,CSE 291,C00,102453,Vaccaro; Kristen Marie,0,0,0,0
1668570984046,CSE 291,D00,111343,Savage; Stefan,0,0,0,0
1668570984046,CSE 291,E00,116474,Claffy; Kimberly Claire,0,0,0,0
1668570984046,CSE 291,F00,116479,Pasquale; Joseph,0,0,0,0
1668570984472,CSE 293,001,119111,Bafna; Vineet,9999,0,9999,0
1668570984472,CSE 293,002,119118,Bellare; Mihir,9999,0,9999,0
1668570984472,CSE 293,003,119122,Berg-Kirkpatrick; Taylor D,9999,0,9999,0
1668570984472,CSE 293,004,119135,Christensen; Henrik I,9999,0,9999,0
1668570984472,CSE 293,005,119142,Cottrell; Garrison W,9999,0,9999,0
1668570984472,CSE 293,006,119146,Deutsch; Alin Bernard,9999,0,9999,0
1668570984472,CSE 293,007,119159,Esmaeilzadeh; Hadi,9999,0,9999,0
1668570984472,CSE 293,008,119166,Freund; Yoav,9999,0,9999,0
1668570984472,CSE 293,009,119170,Griswold; William G.,9999,0,9999,0
1668570984472,CSE 293,010,119183,Gymrek; Melissa Ann,9999,0,9999,0
1668570984472,CSE 293,011,119190,Heninger; Nadia A,9999,0,9999,0
1668570984472,CSE 293,012,119230,Impagliazzo; Russell,9999,0,9999,0
1668570984472,CSE 293,013,119232,Jhala; Ranjit,9999,0,9999,0
1668570984472,CSE 293,014,119233,Kahng; Andrew Byun,9999,0,9999,0
1668570984472,CSE 293,015,119298,Kane; Daniel Mertz,9999,0,9999,0
1668570984472,CSE 293,016,119299,Kriegman; David J,9999,0,9999,0
1668570984472,CSE 293,017,119300,Kumar; Arun Kumar,9999,0,9999,0
1668570984472,CSE 293,018,119301,Lerner; Sorin,9999,0,9999,0
1668570984472,CSE 293,019,119302,Lovett; Shachar,9999,0,9999,0
1668570984472,CSE 293,020,119303,McAuley; Julian John,9999,0,9999,0
1668570984472,CSE 293,021,119304,Micciancio; Daniele,9999,0,9999,0
1668570984472,CSE 293,022,119367,Orailoglu; Alex,9999,0,9999,0
1668570984472,CSE 293,023,119382,Paturi; Ramamohan,9999,0,9999,0
1668570984472,CSE 293,024,119404,Polikarpova; Nadezhda,9999,0,9999,0
1668570984472,CSE 293,025,119406,Politz; Joseph Gibbs,9999,0,9999,0
1668570984472,CSE 293,026,119411,Porter; George M,9999,0,9999,0
1668570984472,CSE 293,027,119414,Porter; Leonard Emerson,9999,0,9999,0
1668570984472,CSE 293,028,119416,Ramamoorthi; Ravi,9999,0,9999,0
1668570984472,CSE 293,029,119417,Sahoo; Debashis,9999,0,9999,0
1668570984472,CSE 293,030,119420,Saul; Lawrence,9999,0,9999,0
1668570984472,CSE 293,031,119421,Savage; Stefan,9999,0,9999,0
1668570984472,CSE 293,032,119425,Schulze; Jurgen P.,9999,0,9999,0
1668570984472,CSE 293,033,119426,Snoeren; Alex C.,9999,0,9999,0
1668570984472,CSE 293,034,119428,Shang; Jingbo,9999,0,9999,0
1668570984472,CSE 293,035,119430,Stefan; Deian,9999,0,9999,0
1668570984472,CSE 293,036,119431,Su; Hao,9999,0,9999,0
1668570984472,CSE 293,037,119433,Swanson; Steven James,9999,0,9999,0
1668570984472,CSE 293,038,119435,Tullsen; Dean Michael,9999,0,9999,0
1668570984472,CSE 293,039,119483,Voelker; Geoffrey M.,9999,0,9999,0
1668570984472,CSE 293,040,119537,Zhao; Jishen,9999,0,9999,0
1668570984472,CSE 293,041,119538,Zhou; Yuan-Yuan,9999,0,9999,0
1668570984472,CSE 293,042,119539,Gao; Sicun,9999,0,9999,0
1668570984472,CSE 293,043,119540,Weibel; Nadir,9999,0,9999,0
1668570984472,CSE 293,044,119541,Gupta; Rajesh K.,9999,0,9999,0
1668570984472,CSE 293,045,126410,Vaccaro; Kristen Marie,9999,0,9999,0
1668570984472,CSE 293,046,126411,Klemke; Richard,9999,0,9999,0
1668570984907,CSE 294,A00,102459,Voelker; Geoffrey M.,0,2,0,0
1668570984907,CSE 294,B00,111322,Orailoglu; Alex,0,2,0,0
1668570985333,DSE 201,A00,096914,Deutsch; Alin Bernard,30,0,30,0
1668570985758,DSE 210,A00,096915,Dasgupta; Sanjoy,30,0,30,0
1668570986184,DSE 260A,A00,096916,Altintas De Callaf; Ilkay,30,0,30,0
1668570986617,ECE 200,001,103586,Antipa; Nicholas A,9999,0,9999,0
1668570986617,ECE 200,002,103587,Atanasov; Nikolay A.,9999,0,9999,0
1668570986617,ECE 200,003,103588,Bharadia; Dinesh,9999,0,9999,0
1668570986617,ECE 200,004,103589,Cheng; Chung Kuan,9999,0,9999,0
1668570986617,ECE 200,005,103590,Cosman; Pamela C.,9999,0,9999,0
1668570986617,ECE 200,006,103591,Dayeh; Shadi Ahmad,9999,0,9999,0
1668570986617,ECE 200,007,103592,Fainman; Yeshaiahu,9999,0,9999,0
1668570986617,ECE 200,008,103593,Ford; Joseph Earl,9999,0,9999,0
1668570986617,ECE 200,009,103594,Franceschetti; Massimo,9999,0,9999,0
1668570986617,ECE 200,010,103595,Fullerton; Eric E,9999,0,9999,0
1668570986617,ECE 200,011,103596,Galton; Ian A,9999,0,9999,0
1668570986617,ECE 200,012,103597,Gilja; Vikash,9999,0,9999,0
1668570986617,ECE 200,013,103598,Hall; Drew A.,9999,0,9999,0
1668570986617,ECE 200,014,103599,Hsueh; Tzu-Chien,9999,0,9999,0
1668570986617,ECE 200,015,103600,Javidi; Tara,9999,0,9999,0
1668570986617,ECE 200,016,103601,Kahng; Andrew Byun,9999,0,9999,0
1668570986617,ECE 200,017,103602,Kim; Young-Han,9999,0,9999,0
1668570986617,ECE 200,018,103603,Koushanfar; Farinaz,9999,0,9999,0
1668570986617,ECE 200,019,103604,Kuzum; Duygu,9999,0,9999,0
1668570986617,ECE 200,020,103605,Le; Hanh-Phuc,9999,0,9999,0
1668570986617,ECE 200,021,103606,Lin; Bill,9999,0,9999,0
1668570986617,ECE 200,022,103607,Liu; Zhaowei,9998,0,9999,1
1668570986617,ECE 200,023,103608,Lo; Yu-Hwa,9999,0,9999,0
1668570986617,ECE 200,024,103609,Lomakin; Vitaliy,9999,0,9999,0
1668570986617,ECE 200,025,103610,Mercier; Patrick Philip,9999,0,9999,0
1668570986617,ECE 200,026,103611,Meyer; Florian,9999,0,9999,0
1668570986617,ECE 200,027,103612,Milstein; Laurence B.,9999,0,9999,0
1668570986617,ECE 200,028,103613,Mir Arabbaygi; Siavash,9999,0,9999,0
1668570986617,ECE 200,029,103614,Mookherjea; Shayan,9999,0,9999,0
1668570986617,ECE 200,030,103615,Morris; Karcher William,9999,0,9999,0
1668570986617,ECE 200,031,103616,Ng; Tse Nga,9999,0,9999,0
1668570986617,ECE 200,032,103617,Nguyen; Truong Quang,9999,0,9999,0
1668570986617,ECE 200,033,103618,Nomura; Kenji,9999,0,9999,0
1668570986617,ECE 200,034,103619,Orlitsky; Alon,9999,0,9999,0
1668570986617,ECE 200,035,103620,Pal; Piya,9999,0,9999,0
1668570986617,ECE 200,036,103621,Papen; George C.,9999,0,9999,0
1668570986617,ECE 200,037,103622,Radic; Stojan,9999,0,9999,0
1668570986617,ECE 200,038,103623,Rao; Bhaskar D.,9999,0,9999,0
1668570986617,ECE 200,039,103624,Rao; Ramesh R,9999,0,9999,0
1668570986617,ECE 200,040,103625,Rebeiz; Gabriel,9999,0,9999,0
1668570986617,ECE 200,041,103626,Sanford; John R,9999,0,9999,0
1668570986617,ECE 200,042,103627,Siegel; Paul H.,9999,0,9999,0
1668570986617,ECE 200,043,103628,Sievenpiper; Daniel F.,9999,0,9999,0
1668570986617,ECE 200,044,103629,Sworder; David D.,9999,0,9999,0
1668570986617,ECE 200,045,103630,Taur; Yuan,9999,0,9999,0
1668570986617,ECE 200,046,103631,Touri; Behrouz,9999,0,9999,0
1668570986617,ECE 200,047,103632,Trivedi; Mohan M.,9999,0,9999,0
1668570986617,ECE 200,048,103633,Vasconcelos; Nuno,9999,0,9999,0
1668570986617,ECE 200,049,103634,Wang; Xiaolong,9999,0,9999,0
1668570986617,ECE 200,050,103635,Xie; Pengtao,9999,0,9999,0
1668570986617,ECE 200,051,103636,Yip; Michael,9999,0,9999,0
1668570986617,ECE 200,052,103637,Zeger; Kenneth A.,999,0,999,0
1668570986617,ECE 200,053,103638,Zhang; Xinyu,9999,0,9999,0
1668570986617,ECE 200,054,103639,Turakhia; Yatish Girish,9999,0,9999,0
1668570986617,ECE 200,055,103640,Kang; Mingu,9999,0,9999,0
1668570986617,ECE 200,056,103641,Shi; Yuanyuan,9999,0,9999,0
1668570986617,ECE 200,057,103642,Wang; Edward Jay,9999,0,9999,0
1668570986617,ECE 200,058,103643,Zheng; Yang,9999,0,9999,0
1668570987043,ECE 202,A00,103644,Kuzum; Duygu,0,46,0,0
1668570987477,ECE 212BN,A00,103646,Ng; Tse Nga,0,9,0,0
1668570987903,ECE 221,A00,111493,Staff,0,0,0,0
1668570988330,ECE 222B,A00,103647,Lomakin; Vitaliy,0,21,0,0
1668570988757,ECE 230B,A00,103648,Taur; Yuan,0,4,0,0
1668570989293,ECE 238B,A00,103649,Garay; Javier,0,0,0,0
1668570989728,ECE 240B,A00,112900,Fainman; Yeshaiahu,0,8,0,0
1668570990160,ECE 247A,A00,103650,Jokerst; Jesse Vincent,0,6,0,0
1668570990585,ECE 247B,A00,103651,Wang; Joseph,0,15,0,0
1668570991012,ECE 250,A00,103652,Siegel; Paul H.,0,85,0,0
1668570991437,ECE 251A,A00,103654,Rao; Bhaskar D.,0,65,0,0
1668570991862,ECE 257B,A00,103655,Bharadia; Dinesh,0,33,0,0
1668570992286,ECE 258A,A00,103656,Milstein; Laurence B.,0,29,0,0
1668570992709,ECE 260B,A00,103658,Kang; Mingu,0,121,0,0
1668570993196,ECE 264A,A00,103659,Galton; Ian A,0,45,0,31
1668570993626,ECE 265A,A00,103661,Gudem; Prasad S.S.,0,46,0,31
1668570994053,ECE 265D,A00,103662,Gudem; Prasad S.S.,0,27,0,0
1668570994476,ECE 268,A00,103663,Koushanfar; Farinaz,0,44,0,0
1668570994908,ECE 269,A01,103665,Pal; Piya,0,222,0,0
1668570995339,ECE 271B,A00,103666,Vasconcelos; Manuela,0,78,0,0
1668570995773,ECE 276A,A00,103667,Atanasov; Nikolay A.,0,126,0,0
1668570996202,ECE 277,A00,103668,An; Cheolhong,0,151,0,0
1668570996626,ECE 279,A00,117947,Hall; Drew A.,0,22,0,0
1668570997478,ECE 283,A00,103670,Hsueh; Tzu-Chien,0,57,0,0
1668570997904,ECE 284,A00,103671,Turakhia; Yatish Girish,0,41,0,0
1668570998332,ECE 285,A00,103672,Zheng; Yang,0,40,0,0
1668570998332,ECE 285,B00,103673,Sworder; David D.,0,61,0,0
1668570998754,ECE 287,A00,103676,Javidi; Tara,0,8,0,0
1668570999188,MATH 200B,A00,098023,Salehi Golsefidy; Alireza,7,0,15,8
1668570999613,MATH 202B,A00,098024,Rhoades; Brendon Patrick,7,0,15,8
1668571000043,MATH 203B,A00,098025,Oprea; Dragos N.,9,0,15,6
1668571000473,MATH 204B,A00,098026,Sorensen; Claus M,13,0,15,2
1668571000899,MATH 208,A00,098027,Izadi; Elham,7,0,10,3
1668571001334,MATH 209,A00,098028,Pollack; Aaron,10,0,10,0
1668571001759,MATH 211A,A00,112919,Rogalski; Daniel,8,0,10,2
1668571002181,MATH 211B,A00,112920,Seward; Brandon M.,9,0,10,1
1668571002609,MATH 218,A00,098029,Li; Bo,10,0,10,0
1668571003033,MATH 220B,A00,098030,Novak; Jonathan I,10,0,15,5
1668571003478,MATH 221A,A00,098031,Ebenfelt; Peter F,12,0,15,3
1668571003910,MATH 231B,A00,098032,Zlatos; Andrej,9,0,15,6
1668571004335,MATH 240B,A00,098033,Ni; Lei,7,0,15,8
1668571004758,MATH 243,A00,098034,Jekel; David Andrew,10,0,10,0
1668571005181,MATH 245A,A00,098035,Nie; Jiawang,0,7,15,18
1668571005603,MATH 248,A00,098036,Bejenaru; Ioan,10,0,10,0
1668571006045,MATH 250B,A00,098037,Spolaor; Luca,12,0,15,3
1668571006479,MATH 258,A00,098038,Ni; Lei,8,0,10,2
1668571006902,MATH 264B,A00,098041,Rhoades; Brendon Patrick,7,0,15,8
1668571007326,MATH 268,A00,098042,Buss; Samuel R,10,0,10,0
1668571007777,MATH 269,A00,098043,Rhoades; Brendon Patrick,10,0,10,0
1668571008206,MATH 270B,A00,098044,Li; Bo,6,0,15,9
1668571008639,MATH 272B,A00,098045,Holst; Michael J,13,0,15,2
1668571009068,MATH 273A,A00,098046,Tian; Xiaochuan,10,0,15,5
1668571009494,MATH 275,A01,098048,Tian; Xiaochuan,6,0,10,4
1668571009919,MATH 278A,A00,098049,Holst; Michael J,6,0,10,4
1668571010352,MATH 278B,A00,098050,Cloninger; Alexander,10,0,10,0
1668571010777,MATH 278C,A00,098051,Nie; Jiawang,5,0,10,5
1668571011211,MATH 280B,A00,098052,Zheng; Tianyi,6,0,15,9
1668571011648,MATH 281B,A00,098053,Bradic; Jelena,0,2,15,15
1668571012095,MATH 282B,A00,098054,Arias-Castro; Ery,0,1,15,15
1668571012519,MATH 285,A00,098055,Fitzsimmons; Patrick J,0,4,15,17
1668571012945,MATH 287B,A00,098056,Arias-Castro; Ery,1,0,15,14
1668571013367,MATH 288,A00,098057,Agarwal; Pooja,9,0,10,1
1668571013367,MATH 288,B00,098058,Zhang; Danna,8,0,10,2
1668571013367,MATH 288,C00,098059,Williams; Ruth J,9,0,10,1
1668571013804,MATH 290B,A00,098060,Roberts; Justin Deritter,11,0,15,4
1668571014228,MATH 292,A00,098061,Belmont; Eva Kinoshita,10,0,10,0
1668571014651,MATH 295,A00,098062,Suk; Andrew Hoon,47,0,50,3
1668571015081,MATH 296,A00,098063,Novak; Jonathan I,20,0,20,0
1668571015512,MATH 297,001,098064,Gamst; Anthony Collins,9997,0,9999,2
1668571519504,COGS 205,A00,101395,Chiba; Andrea,19,0,20,1
1668571519929,COGS 210B,001,101404,Greene; Deanna Jacquelyn,9998,0,9999,1
1668571519929,COGS 210B,002,101417,Xia; Haijun,9999,0,9999,0
1668571519929,COGS 210B,003,101422,Nitz; Douglas A.,9999,0,9999,0
1668571519929,COGS 210B,004,101423,Hollan; James D.,9998,0,9999,1
1668571519929,COGS 210B,005,101424,Deak; Gedeon O.,9998,0,9999,1
1668571519929,COGS 210B,006,101425,Rossano; Federico,9999,0,9999,0
1668571520358,COGS 211B,A00,101427,Coulson; Seana M,9996,0,9999,3
1668571520781,COGS 220,A00,101428,Hollan; James D.,0,17,25,25
1668571521207,COGS 229,A00,101429,Dow; Steven P,17,0,25,8
1668571521641,COGS 230,A00,101430,Klemmer; Scott R,6,0,17,11
1668571522074,COGS 234,A00,101431,Xia; Haijun,0,1,25,25
1668571522501,COGS 260,A00,101432,Kiyonaga; Anastasia,21,0,25,4
1668571522501,COGS 260,B00,101433,Kirsh; David Joel,15,0,25,10
1668571522940,CSE 202,A00,102371,Impagliazzo; Russell,0,71,0,0
1668571523374,CSE 203B,A01,102373,Cheng; Chung Kuan,0,68,0,0
1668571523805,CSE 208,A00,102374,Micciancio; Daniele,0,5,0,0
1668571524242,CSE 209A,A00,112895,Impagliazzo; Russell,0,14,15,15
1668571524681,CSE 209B,A00,108005,Bellare; Mihir,0,7,0,0
1668571525125,CSE 210,A00,113163,Coblenz; Michael J,0,95,0,0
1668571525550,CSE 219,A00,106111,Dow; Steven P,0,8,20,20
1668571525975,CSE 221,A00,102376,Voelker; Geoffrey M.,0,77,0,0
1668571526410,CSE 224,A01,102378,Porter; George M,0,177,0,0
1668571526834,CSE 229A,A00,102379,Savage; Stefan,0,14,0,0
1668571527258,CSE 229C,A00,102380,Munyaka; Imani N. S.,0,12,0,0
1668571527681,CSE 232B,A00,102382,Deutsch; Alin Bernard,0,39,0,0
1668571528126,CSE 234,A01,112904,Kumar; Arun Kumar,0,0,0,0
1668571528569,CSE 237A,A00,102383,Rosing; Tajana Simunic,0,57,0,0
1668571528991,CSE 239A,A00,102384,Deutsch; Alin Bernard,0,18,0,0
1668571529417,CSE 239B,A00,102385,Polikarpova; Nadezhda,0,11,0,0
1668571529853,CSE 240A,A00,102386,Pannuto; Patrick William,0,49,0,0
1668571530276,CSE 240B,A00,102387,Zhao; Jishen,0,51,0,0
1668571530699,CSE 241A,A00,106406,Kang; Mingu,0,9,0,0
1668571531121,CSE 249B,A00,102388,Kahng; Andrew Byun,0,5,8,8
1668571531546,CSE 251B,A01,102392,Cottrell; Garrison W,0,53,0,0
1668571531546,CSE 251B,A02,102393,Cottrell; Garrison W,0,36,0,0
1668571531971,CSE 252B,A00,102394,Ochoa; Benjamin Lawrence,0,65,0,0
1668571532406,CSE 257,A01,102396,Gao; Sicun,0,157,0,0
1668571532835,CSE 272,A00,102397,Li; Tzumao,0,22,0,0
1668571533261,CSE 274,A00,111323,Chern; Albert Ren-Haur,0,16,0,0
1668571533688,CSE 282,A00,102398,Pevzner; Pavel Arkadjevich,0,0,0,0
1668571534116,CSE 284,A00,114175,Gymrek; Melissa Ann,0,32,0,0
1668571534541,CSE 290,A00,102399,Chandraker; Manmohan Krishna,0,11,0,0
1668571534541,CSE 290,B00,102400,Vaccaro; Kristen Marie,0,10,25,25
1668571534541,CSE 290,C00,102414,Pannuto; Patrick William,0,1,25,25
1668571534541,CSE 290,D00,102427,Pevzner; Pavel Arkadjevich,0,0,0,0
1668571534541,CSE 290,E00,102429,Zhao; Jishen,0,6,0,0
1668571534541,CSE 290,F00,102436,Tullsen; Dean Michael,0,6,0,0
1668571534541,CSE 290,G00,102440,Christensen; Henrik I,0,8,20,20
1668571534965,CSE 291,A00,102443,Su; Hao,0,0,0,0
1668571534965,CSE 291,B00,102448,Polikarpova; Nadezhda,0,0,0,0
1668571534965,CSE 291,C00,102453,Vaccaro; Kristen Marie,0,0,0,0
1668571534965,CSE 291,D00,111343,Savage; Stefan,0,0,0,0
1668571534965,CSE 291,E00,116474,Claffy; Kimberly Claire,0,0,0,0
1668571534965,CSE 291,F00,116479,Pasquale; Joseph,0,0,0,0
1668571535395,CSE 293,001,119111,Bafna; Vineet,9999,0,9999,0
1668571535395,CSE 293,002,119118,Bellare; Mihir,9999,0,9999,0
1668571535395,CSE 293,003,119122,Berg-Kirkpatrick; Taylor D,9999,0,9999,0
1668571535395,CSE 293,004,119135,Christensen; Henrik I,9999,0,9999,0
1668571535395,CSE 293,005,119142,Cottrell; Garrison W,9999,0,9999,0
1668571535395,CSE 293,006,119146,Deutsch; Alin Bernard,9999,0,9999,0
1668571535395,CSE 293,007,119159,Esmaeilzadeh; Hadi,9999,0,9999,0
1668571535395,CSE 293,008,119166,Freund; Yoav,9999,0,9999,0
1668571535395,CSE 293,009,119170,Griswold; William G.,9999,0,9999,0
1668571535395,CSE 293,010,119183,Gymrek; Melissa Ann,9999,0,9999,0
1668571535395,CSE 293,011,119190,Heninger; Nadia A,9999,0,9999,0
1668571535395,CSE 293,012,119230,Impagliazzo; Russell,9999,0,9999,0
1668571535395,CSE 293,013,119232,Jhala; Ranjit,9999,0,9999,0
1668571535395,CSE 293,014,119233,Kahng; Andrew Byun,9999,0,9999,0
1668571535395,CSE 293,015,119298,Kane; Daniel Mertz,9999,0,9999,0
1668571535395,CSE 293,016,119299,Kriegman; David J,9999,0,9999,0
1668571535395,CSE 293,017,119300,Kumar; Arun Kumar,9999,0,9999,0
1668571535395,CSE 293,018,119301,Lerner; Sorin,9999,0,9999,0
1668571535395,CSE 293,019,119302,Lovett; Shachar,9999,0,9999,0
1668571535395,CSE 293,020,119303,McAuley; Julian John,9999,0,9999,0
1668571535395,CSE 293,021,119304,Micciancio; Daniele,9999,0,9999,0
1668571535395,CSE 293,022,119367,Orailoglu; Alex,9999,0,9999,0
1668571535395,CSE 293,023,119382,Paturi; Ramamohan,9999,0,9999,0
1668571535395,CSE 293,024,119404,Polikarpova; Nadezhda,9999,0,9999,0
1668571535395,CSE 293,025,119406,Politz; Joseph Gibbs,9999,0,9999,0
1668571535395,CSE 293,026,119411,Porter; George M,9999,0,9999,0
1668571535395,CSE 293,027,119414,Porter; Leonard Emerson,9999,0,9999,0
1668571535395,CSE 293,028,119416,Ramamoorthi; Ravi,9999,0,9999,0
1668571535395,CSE 293,029,119417,Sahoo; Debashis,9999,0,9999,0
1668571535395,CSE 293,030,119420,Saul; Lawrence,9999,0,9999,0
1668571535395,CSE 293,031,119421,Savage; Stefan,9999,0,9999,0
1668571535395,CSE 293,032,119425,Schulze; Jurgen P.,9999,0,9999,0
1668571535395,CSE 293,033,119426,Snoeren; Alex C.,9999,0,9999,0
1668571535395,CSE 293,034,119428,Shang; Jingbo,9999,0,9999,0
1668571535395,CSE 293,035,119430,Stefan; Deian,9999,0,9999,0
1668571535395,CSE 293,036,119431,Su; Hao,9999,0,9999,0
1668571535395,CSE 293,037,119433,Swanson; Steven James,9999,0,9999,0
1668571535395,CSE 293,038,119435,Tullsen; Dean Michael,9999,0,9999,0
1668571535395,CSE 293,039,119483,Voelker; Geoffrey M.,9999,0,9999,0
1668571535395,CSE 293,040,119537,Zhao; Jishen,9999,0,9999,0
1668571535395,CSE 293,041,119538,Zhou; Yuan-Yuan,9999,0,9999,0
1668571535395,CSE 293,042,119539,Gao; Sicun,9999,0,9999,0
1668571535395,CSE 293,043,119540,Weibel; Nadir,9999,0,9999,0
1668571535395,CSE 293,044,119541,Gupta; Rajesh K.,9999,0,9999,0
1668571535395,CSE 293,045,126410,Vaccaro; Kristen Marie,9999,0,9999,0
1668571535395,CSE 293,046,126411,Klemke; Richard,9999,0,9999,0
1668571535823,CSE 294,A00,102459,Voelker; Geoffrey M.,0,2,0,0
1668571535823,CSE 294,B00,111322,Orailoglu; Alex,0,2,0,0
1668571536251,DSE 201,A00,096914,Deutsch; Alin Bernard,30,0,30,0
1668571536675,DSE 210,A00,096915,Dasgupta; Sanjoy,30,0,30,0
1668571537098,DSE 260A,A00,096916,Altintas De Callaf; Ilkay,30,0,30,0
1668571537531,ECE 200,001,103586,Antipa; Nicholas A,9999,0,9999,0
1668571537531,ECE 200,002,103587,Atanasov; Nikolay A.,9999,0,9999,0
1668571537531,ECE 200,003,103588,Bharadia; Dinesh,9999,0,9999,0
1668571537531,ECE 200,004,103589,Cheng; Chung Kuan,9999,0,9999,0
1668571537531,ECE 200,005,103590,Cosman; Pamela C.,9999,0,9999,0
1668571537531,ECE 200,006,103591,Dayeh; Shadi Ahmad,9999,0,9999,0
1668571537531,ECE 200,007,103592,Fainman; Yeshaiahu,9999,0,9999,0
1668571537531,ECE 200,008,103593,Ford; Joseph Earl,9999,0,9999,0
1668571537531,ECE 200,009,103594,Franceschetti; Massimo,9999,0,9999,0
1668571537531,ECE 200,010,103595,Fullerton; Eric E,9999,0,9999,0
1668571537531,ECE 200,011,103596,Galton; Ian A,9999,0,9999,0
1668571537531,ECE 200,012,103597,Gilja; Vikash,9999,0,9999,0
1668571537531,ECE 200,013,103598,Hall; Drew A.,9999,0,9999,0
1668571537531,ECE 200,014,103599,Hsueh; Tzu-Chien,9999,0,9999,0
1668571537531,ECE 200,015,103600,Javidi; Tara,9999,0,9999,0
1668571537531,ECE 200,016,103601,Kahng; Andrew Byun,9999,0,9999,0
1668571537531,ECE 200,017,103602,Kim; Young-Han,9999,0,9999,0
1668571537531,ECE 200,018,103603,Koushanfar; Farinaz,9999,0,9999,0
1668571537531,ECE 200,019,103604,Kuzum; Duygu,9999,0,9999,0
1668571537531,ECE 200,020,103605,Le; Hanh-Phuc,9999,0,9999,0
1668571537531,ECE 200,021,103606,Lin; Bill,9999,0,9999,0
1668571537531,ECE 200,022,103607,Liu; Zhaowei,9998,0,9999,1
1668571537531,ECE 200,023,103608,Lo; Yu-Hwa,9999,0,9999,0
1668571537531,ECE 200,024,103609,Lomakin; Vitaliy,9999,0,9999,0
1668571537531,ECE 200,025,103610,Mercier; Patrick Philip,9999,0,9999,0
1668571537531,ECE 200,026,103611,Meyer; Florian,9999,0,9999,0
1668571537531,ECE 200,027,103612,Milstein; Laurence B.,9999,0,9999,0
1668571537531,ECE 200,028,103613,Mir Arabbaygi; Siavash,9999,0,9999,0
1668571537531,ECE 200,029,103614,Mookherjea; Shayan,9999,0,9999,0
1668571537531,ECE 200,030,103615,Morris; Karcher William,9999,0,9999,0
1668571537531,ECE 200,031,103616,Ng; Tse Nga,9999,0,9999,0
1668571537531,ECE 200,032,103617,Nguyen; Truong Quang,9999,0,9999,0
1668571537531,ECE 200,033,103618,Nomura; Kenji,9999,0,9999,0
1668571537531,ECE 200,034,103619,Orlitsky; Alon,9999,0,9999,0
1668571537531,ECE 200,035,103620,Pal; Piya,9999,0,9999,0
1668571537531,ECE 200,036,103621,Papen; George C.,9999,0,9999,0
1668571537531,ECE 200,037,103622,Radic; Stojan,9999,0,9999,0
1668571537531,ECE 200,038,103623,Rao; Bhaskar D.,9999,0,9999,0
1668571537531,ECE 200,039,103624,Rao; Ramesh R,9999,0,9999,0
1668571537531,ECE 200,040,103625,Rebeiz; Gabriel,9999,0,9999,0
1668571537531,ECE 200,041,103626,Sanford; John R,9999,0,9999,0
1668571537531,ECE 200,042,103627,Siegel; Paul H.,9999,0,9999,0
1668571537531,ECE 200,043,103628,Sievenpiper; Daniel F.,9999,0,9999,0
1668571537531,ECE 200,044,103629,Sworder; David D.,9999,0,9999,0
1668571537531,ECE 200,045,103630,Taur; Yuan,9999,0,9999,0
1668571537531,ECE 200,046,103631,Touri; Behrouz,9999,0,9999,0
1668571537531,ECE 200,047,103632,Trivedi; Mohan M.,9999,0,9999,0
1668571537531,ECE 200,048,103633,Vasconcelos; Nuno,9999,0,9999,0
1668571537531,ECE 200,049,103634,Wang; Xiaolong,9999,0,9999,0
1668571537531,ECE 200,050,103635,Xie; Pengtao,9999,0,9999,0
1668571537531,ECE 200,051,103636,Yip; Michael,9999,0,9999,0
1668571537531,ECE 200,052,103637,Zeger; Kenneth A.,999,0,999,0
1668571537531,ECE 200,053,103638,Zhang; Xinyu,9999,0,9999,0
1668571537531,ECE 200,054,103639,Turakhia; Yatish Girish,9999,0,9999,0
1668571537531,ECE 200,055,103640,Kang; Mingu,9999,0,9999,0
1668571537531,ECE 200,056,103641,Shi; Yuanyuan,9999,0,9999,0
1668571537531,ECE 200,057,103642,Wang; Edward Jay,9999,0,9999,0
1668571537531,ECE 200,058,103643,Zheng; Yang,9999,0,9999,0
1668571537960,ECE 202,A00,103644,Kuzum; Duygu,0,46,0,0
1668571538385,ECE 212BN,A00,103646,Ng; Tse Nga,0,9,0,0
1668571538807,ECE 221,A00,111493,Staff,0,0,0,0
1668571539234,ECE 222B,A00,103647,Lomakin; Vitaliy,0,21,0,0
1668571539657,ECE 230B,A00,103648,Taur; Yuan,0,4,0,0
1668571540085,ECE 238B,A00,103649,Garay; Javier,0,0,0,0
1668571540509,ECE 240B,A00,112900,Fainman; Yeshaiahu,0,8,0,0
1668571540931,ECE 247A,A00,103650,Jokerst; Jesse Vincent,0,6,0,0
1668571541366,ECE 247B,A00,103651,Wang; Joseph,0,15,0,0
1668571541800,ECE 250,A00,103652,Siegel; Paul H.,0,85,0,0
1668571542226,ECE 251A,A00,103654,Rao; Bhaskar D.,0,65,0,0
1668571542661,ECE 257B,A00,103655,Bharadia; Dinesh,0,33,0,0
1668571543086,ECE 258A,A00,103656,Milstein; Laurence B.,0,29,0,0
1668571543512,ECE 260B,A00,103658,Kang; Mingu,0,121,0,0
1668571543935,ECE 264A,A00,103659,Galton; Ian A,0,45,0,31
1668571544367,ECE 265A,A00,103661,Gudem; Prasad S.S.,0,46,0,31
1668571544792,ECE 265D,A00,103662,Gudem; Prasad S.S.,0,27,0,0
1668571545219,ECE 268,A00,103663,Koushanfar; Farinaz,0,44,0,0
1668571545655,ECE 269,A01,103665,Pal; Piya,0,222,0,0
1668571546079,ECE 271B,A00,103666,Vasconcelos; Manuela,0,78,0,0
1668571546518,ECE 276A,A00,103667,Atanasov; Nikolay A.,0,126,0,0
1668571546956,ECE 277,A00,103668,An; Cheolhong,0,151,0,0
1668571547386,ECE 279,A00,117947,Hall; Drew A.,0,22,0,0
1668571548230,ECE 283,A00,103670,Hsueh; Tzu-Chien,0,57,0,0
1668571548651,ECE 284,A00,103671,Turakhia; Yatish Girish,0,41,0,0
1668571549073,ECE 285,A00,103672,Zheng; Yang,0,40,0,0
1668571549073,ECE 285,B00,103673,Sworder; David D.,0,61,0,0
1668571549495,ECE 287,A00,103676,Javidi; Tara,0,8,0,0
1668571549922,MATH 200B,A00,098023,Salehi Golsefidy; Alireza,7,0,15,8
1668571550345,MATH 202B,A00,098024,Rhoades; Brendon Patrick,7,0,15,8
1668571550769,MATH 203B,A00,098025,Oprea; Dragos N.,9,0,15,6
1668571551200,MATH 204B,A00,098026,Sorensen; Claus M,13,0,15,2
1668571551629,MATH 208,A00,098027,Izadi; Elham,7,0,10,3
1668571552061,MATH 209,A00,098028,Pollack; Aaron,10,0,10,0
1668571552484,MATH 211A,A00,112919,Rogalski; Daniel,8,0,10,2
1668571552912,MATH 211B,A00,112920,Seward; Brandon M.,9,0,10,1
1668571553347,MATH 218,A00,098029,Li; Bo,10,0,10,0
1668571553774,MATH 220B,A00,098030,Novak; Jonathan I,10,0,15,5
1668571554200,MATH 221A,A00,098031,Ebenfelt; Peter F,12,0,15,3
1668571554625,MATH 231B,A00,098032,Zlatos; Andrej,9,0,15,6
1668571555125,MATH 240B,A00,098033,Ni; Lei,7,0,15,8
1668571555547,MATH 243,A00,098034,Jekel; David Andrew,10,0,10,0
1668571555985,MATH 245A,A00,098035,Nie; Jiawang,0,7,15,18
1668571556409,MATH 248,A00,098036,Bejenaru; Ioan,10,0,10,0
1668571556833,MATH 250B,A00,098037,Spolaor; Luca,12,0,15,3
1668571557259,MATH 258,A00,098038,Ni; Lei,8,0,10,2
1668571557683,MATH 264B,A00,098041,Rhoades; Brendon Patrick,7,0,15,8
1668571558110,MATH 268,A00,098042,Buss; Samuel R,10,0,10,0
1668571558535,MATH 269,A00,098043,Rhoades; Brendon Patrick,10,0,10,0
1668571558962,MATH 270B,A00,098044,Li; Bo,6,0,15,9
1668571559386,MATH 272B,A00,098045,Holst; Michael J,13,0,15,2
1668571559811,MATH 273A,A00,098046,Tian; Xiaochuan,10,0,15,5
1668571560235,MATH 275,A01,098048,Tian; Xiaochuan,6,0,10,4
1668571560667,MATH 278A,A00,098049,Holst; Michael J,6,0,10,4
1668571561112,MATH 278B,A00,098050,Cloninger; Alexander,10,0,10,0
1668571561542,MATH 278C,A00,098051,Nie; Jiawang,5,0,10,5
1668571561973,MATH 280B,A00,098052,Zheng; Tianyi,6,0,15,9
1668571562402,MATH 281B,A00,098053,Bradic; Jelena,0,2,15,15
1668571562826,MATH 282B,A00,098054,Arias-Castro; Ery,0,1,15,15
1668571563248,MATH 285,A00,098055,Fitzsimmons; Patrick J,0,4,15,17
1668571563673,MATH 287B,A00,098056,Arias-Castro; Ery,1,0,15,14
1668571564096,MATH 288,A00,098057,Agarwal; Pooja,9,0,10,1
1668571564096,MATH 288,B00,098058,Zhang; Danna,8,0,10,2
1668571564096,MATH 288,C00,098059,Williams; Ruth J,9,0,10,1
1668571564521,MATH 290B,A00,098060,Roberts; Justin Deritter,11,0,15,4
1668571564943,MATH 292,A00,098061,Belmont; Eva Kinoshita,10,0,10,0
1668571565369,MATH 295,A00,098062,Suk; Andrew Hoon,47,0,50,3
1668571565791,MATH 296,A00,098063,Novak; Jonathan I,20,0,20,0
1668571566221,MATH 297,001,098064,Gamst; Anthony Collins,9997,0,9999,2
1668572069245,COGS 205,A00,101395,Chiba; Andrea,19,0,20,1
1668572069681,COGS 210B,001,101404,Greene; Deanna Jacquelyn,9998,0,9999,1
1668572069681,COGS 210B,002,101417,Xia; Haijun,9999,0,9999,0
1668572069681,COGS 210B,003,101422,Nitz; Douglas A.,9999,0,9999,0
1668572069681,COGS 210B,004,101423,Hollan; James D.,9998,0,9999,1
1668572069681,COGS 210B,005,101424,Deak; Gedeon O.,9998,0,9999,1
1668572069681,COGS 210B,006,101425,Rossano; Federico,9999,0,9999,0
1668572070109,COGS 211B,A00,101427,Coulson; Seana M,9996,0,9999,3
1668572070534,COGS 220,A00,101428,Hollan; James D.,0,17,25,25
1668572070962,COGS 229,A00,101429,Dow; Steven P,17,0,25,8
1668572071385,COGS 230,A00,101430,Klemmer; Scott R,6,0,17,11
1668572071806,COGS 234,A00,101431,Xia; Haijun,0,1,25,25
1668572072237,COGS 260,A00,101432,Kiyonaga; Anastasia,21,0,25,4
1668572072237,COGS 260,B00,101433,Kirsh; David Joel,15,0,25,10
1668572072660,CSE 202,A00,102371,Impagliazzo; Russell,0,70,0,0
1668572073085,CSE 203B,A01,102373,Cheng; Chung Kuan,0,70,0,0
1668572073510,CSE 208,A00,102374,Micciancio; Daniele,0,5,0,0
1668572073933,CSE 209A,A00,112895,Impagliazzo; Russell,0,14,15,15
1668572074359,CSE 209B,A00,108005,Bellare; Mihir,0,7,0,0
1668572074795,CSE 210,A00,113163,Coblenz; Michael J,0,95,0,0
1668572075225,CSE 219,A00,106111,Dow; Steven P,0,8,20,20
1668572075657,CSE 221,A00,102376,Voelker; Geoffrey M.,0,77,0,0
1668572076100,CSE 224,A01,102378,Porter; George M,0,180,0,0
1668572076604,CSE 229A,A00,102379,Savage; Stefan,0,14,0,0
1668572077030,CSE 229C,A00,102380,Munyaka; Imani N. S.,0,12,0,0
1668572077457,CSE 232B,A00,102382,Deutsch; Alin Bernard,0,39,0,0
1668572077893,CSE 234,A01,112904,Kumar; Arun Kumar,0,0,0,0
1668572078321,CSE 237A,A00,102383,Rosing; Tajana Simunic,0,57,0,0
1668572078754,CSE 239A,A00,102384,Deutsch; Alin Bernard,0,18,0,0
1668572079190,CSE 239B,A00,102385,Polikarpova; Nadezhda,0,11,0,0
1668572079614,CSE 240A,A00,102386,Pannuto; Patrick William,0,49,0,0
1668572080046,CSE 240B,A00,102387,Zhao; Jishen,0,51,0,0
1668572080469,CSE 241A,A00,106406,Kang; Mingu,0,9,0,0
1668572080891,CSE 249B,A00,102388,Kahng; Andrew Byun,0,7,8,8
1668572081324,CSE 251B,A01,102392,Cottrell; Garrison W,0,54,0,0
1668572081324,CSE 251B,A02,102393,Cottrell; Garrison W,0,36,0,0
1668572081747,CSE 252B,A00,102394,Ochoa; Benjamin Lawrence,0,65,0,0
1668572082173,CSE 257,A01,102396,Gao; Sicun,0,160,0,0
1668572082598,CSE 272,A00,102397,Li; Tzumao,0,22,0,0
1668572083022,CSE 274,A00,111323,Chern; Albert Ren-Haur,0,16,0,0
1668572083445,CSE 282,A00,102398,Pevzner; Pavel Arkadjevich,0,0,0,0
1668572083874,CSE 284,A00,114175,Gymrek; Melissa Ann,0,32,0,0
1668572084307,CSE 290,A00,102399,Chandraker; Manmohan Krishna,0,11,0,0
1668572084307,CSE 290,B00,102400,Vaccaro; Kristen Marie,0,10,25,25
1668572084307,CSE 290,C00,102414,Pannuto; Patrick William,0,1,25,25
1668572084307,CSE 290,D00,102427,Pevzner; Pavel Arkadjevich,0,0,0,0
1668572084307,CSE 290,E00,102429,Zhao; Jishen,0,6,0,0
1668572084307,CSE 290,F00,102436,Tullsen; Dean Michael,0,6,0,0
1668572084307,CSE 290,G00,102440,Christensen; Henrik I,0,8,20,20
1668572084732,CSE 291,A00,102443,Su; Hao,0,0,0,0
1668572084732,CSE 291,B00,102448,Polikarpova; Nadezhda,0,0,0,0
1668572084732,CSE 291,C00,102453,Vaccaro; Kristen Marie,0,0,0,0
1668572084732,CSE 291,D00,111343,Savage; Stefan,0,0,0,0
1668572084732,CSE 291,E00,116474,Claffy; Kimberly Claire,0,0,0,0
1668572084732,CSE 291,F00,116479,Pasquale; Joseph,0,0,0,0
1668572085166,CSE 293,001,119111,Bafna; Vineet,9999,0,9999,0
1668572085166,CSE 293,002,119118,Bellare; Mihir,9999,0,9999,0
1668572085166,CSE 293,003,119122,Berg-Kirkpatrick; Taylor D,9999,0,9999,0
1668572085166,CSE 293,004,119135,Christensen; Henrik I,9999,0,9999,0
1668572085166,CSE 293,005,119142,Cottrell; Garrison W,9999,0,9999,0
1668572085166,CSE 293,006,119146,Deutsch; Alin Bernard,9999,0,9999,0
1668572085166,CSE 293,007,119159,Esmaeilzadeh; Hadi,9999,0,9999,0
1668572085166,CSE 293,008,119166,Freund; Yoav,9999,0,9999,0
1668572085166,CSE 293,009,119170,Griswold; William G.,9999,0,9999,0
1668572085166,CSE 293,010,119183,Gymrek; Melissa Ann,9999,0,9999,0
1668572085166,CSE 293,011,119190,Heninger; Nadia A,9999,0,9999,0
1668572085166,CSE 293,012,119230,Impagliazzo; Russell,9999,0,9999,0
1668572085166,CSE 293,013,119232,Jhala; Ranjit,9999,0,9999,0
1668572085166,CSE 293,014,119233,Kahng; Andrew Byun,9999,0,9999,0
1668572085166,CSE 293,015,119298,Kane; Daniel Mertz,9999,0,9999,0
1668572085166,CSE 293,016,119299,Kriegman; David J,9999,0,9999,0
1668572085166,CSE 293,017,119300,Kumar; Arun Kumar,9999,0,9999,0
1668572085166,CSE 293,018,119301,Lerner; Sorin,9999,0,9999,0
1668572085166,CSE 293,019,119302,Lovett; Shachar,9999,0,9999,0
1668572085166,CSE 293,020,119303,McAuley; Julian John,9999,0,9999,0
1668572085166,CSE 293,021,119304,Micciancio; Daniele,9999,0,9999,0
1668572085166,CSE 293,022,119367,Orailoglu; Alex,9999,0,9999,0
1668572085166,CSE 293,023,119382,Paturi; Ramamohan,9999,0,9999,0
1668572085166,CSE 293,024,119404,Polikarpova; Nadezhda,9999,0,9999,0
1668572085166,CSE 293,025,119406,Politz; Joseph Gibbs,9999,0,9999,0
1668572085166,CSE 293,026,119411,Porter; George M,9999,0,9999,0
1668572085166,CSE 293,027,119414,Porter; Leonard Emerson,9999,0,9999,0
1668572085166,CSE 293,028,119416,Ramamoorthi; Ravi,9999,0,9999,0
1668572085166,CSE 293,029,119417,Sahoo; Debashis,9999,0,9999,0
1668572085166,CSE 293,030,119420,Saul; Lawrence,9999,0,9999,0
1668572085166,CSE 293,031,119421,Savage; Stefan,9999,0,9999,0
1668572085166,CSE 293,032,119425,Schulze; Jurgen P.,9999,0,9999,0
1668572085166,CSE 293,033,119426,Snoeren; Alex C.,9999,0,9999,0
1668572085166,CSE 293,034,119428,Shang; Jingbo,9999,0,9999,0
1668572085166,CSE 293,035,119430,Stefan; Deian,9999,0,9999,0
1668572085166,CSE 293,036,119431,Su; Hao,9999,0,9999,0
1668572085166,CSE 293,037,119433,Swanson; Steven James,9999,0,9999,0
1668572085166,CSE 293,038,119435,Tullsen; Dean Michael,9999,0,9999,0
1668572085166,CSE 293,039,119483,Voelker; Geoffrey M.,9999,0,9999,0
1668572085166,CSE 293,040,119537,Zhao; Jishen,9999,0,9999,0
1668572085166,CSE 293,041,119538,Zhou; Yuan-Yuan,9999,0,9999,0
1668572085166,CSE 293,042,119539,Gao; Sicun,9999,0,9999,0
1668572085166,CSE 293,043,119540,Weibel; Nadir,9999,0,9999,0
1668572085166,CSE 293,044,119541,Gupta; Rajesh K.,9999,0,9999,0
1668572085166,CSE 293,045,126410,Vaccaro; Kristen Marie,9999,0,9999,0
1668572085166,CSE 293,046,126411,Klemke; Richard,9999,0,9999,0
1668572085598,CSE 294,A00,102459,Voelker; Geoffrey M.,0,2,0,0
1668572085598,CSE 294,B00,111322,Orailoglu; Alex,0,2,0,0
1668572086023,DSE 201,A00,096914,Deutsch; Alin Bernard,30,0,30,0
1668572086448,DSE 210,A00,096915,Dasgupta; Sanjoy,30,0,30,0
1668572086878,DSE 260A,A00,096916,Altintas De Callaf; Ilkay,30,0,30,0
1668572087308,ECE 200,001,103586,Antipa; Nicholas A,9999,0,9999,0
1668572087308,ECE 200,002,103587,Atanasov; Nikolay A.,9999,0,9999,0
1668572087308,ECE 200,003,103588,Bharadia; Dinesh,9999,0,9999,0
1668572087308,ECE 200,004,103589,Cheng; Chung Kuan,9999,0,9999,0
1668572087308,ECE 200,005,103590,Cosman; Pamela C.,9999,0,9999,0
1668572087308,ECE 200,006,103591,Dayeh; Shadi Ahmad,9999,0,9999,0
1668572087308,ECE 200,007,103592,Fainman; Yeshaiahu,9999,0,9999,0
1668572087308,ECE 200,008,103593,Ford; Joseph Earl,9999,0,9999,0
1668572087308,ECE 200,009,103594,Franceschetti; Massimo,9999,0,9999,0
1668572087308,ECE 200,010,103595,Fullerton; Eric E,9999,0,9999,0
1668572087308,ECE 200,011,103596,Galton; Ian A,9999,0,9999,0
1668572087308,ECE 200,012,103597,Gilja; Vikash,9999,0,9999,0
1668572087308,ECE 200,013,103598,Hall; Drew A.,9999,0,9999,0
1668572087308,ECE 200,014,103599,Hsueh; Tzu-Chien,9999,0,9999,0
1668572087308,ECE 200,015,103600,Javidi; Tara,9999,0,9999,0
1668572087308,ECE 200,016,103601,Kahng; Andrew Byun,9999,0,9999,0
1668572087308,ECE 200,017,103602,Kim; Young-Han,9999,0,9999,0
1668572087308,ECE 200,018,103603,Koushanfar; Farinaz,9999,0,9999,0
1668572087308,ECE 200,019,103604,Kuzum; Duygu,9999,0,9999,0
1668572087308,ECE 200,020,103605,Le; Hanh-Phuc,9999,0,9999,0
1668572087308,ECE 200,021,103606,Lin; Bill,9999,0,9999,0
1668572087308,ECE 200,022,103607,Liu; Zhaowei,9998,0,9999,1
1668572087308,ECE 200,023,103608,Lo; Yu-Hwa,9999,0,9999,0
1668572087308,ECE 200,024,103609,Lomakin; Vitaliy,9999,0,9999,0
1668572087308,ECE 200,025,103610,Mercier; Patrick Philip,9999,0,9999,0
1668572087308,ECE 200,026,103611,Meyer; Florian,9999,0,9999,0
1668572087308,ECE 200,027,103612,Milstein; Laurence B.,9999,0,9999,0
1668572087308,ECE 200,028,103613,Mir Arabbaygi; Siavash,9999,0,9999,0
1668572087308,ECE 200,029,103614,Mookherjea; Shayan,9999,0,9999,0
1668572087308,ECE 200,030,103615,Morris; Karcher William,9999,0,9999,0
1668572087308,ECE 200,031,103616,Ng; Tse Nga,9999,0,9999,0
1668572087308,ECE 200,032,103617,Nguyen; Truong Quang,9999,0,9999,0
1668572087308,ECE 200,033,103618,Nomura; Kenji,9999,0,9999,0
1668572087308,ECE 200,034,103619,Orlitsky; Alon,9999,0,9999,0
1668572087308,ECE 200,035,103620,Pal; Piya,9999,0,9999,0
1668572087308,ECE 200,036,103621,Papen; George C.,9999,0,9999,0
1668572087308,ECE 200,037,103622,Radic; Stojan,9999,0,9999,0
1668572087308,ECE 200,038,103623,Rao; Bhaskar D.,9999,0,9999,0
1668572087308,ECE 200,039,103624,Rao; Ramesh R,9999,0,9999,0
1668572087308,ECE 200,040,103625,Rebeiz; Gabriel,9999,0,9999,0
1668572087308,ECE 200,041,103626,Sanford; John R,9999,0,9999,0
1668572087308,ECE 200,042,103627,Siegel; Paul H.,9999,0,9999,0
1668572087308,ECE 200,043,103628,Sievenpiper; Daniel F.,9999,0,9999,0
1668572087308,ECE 200,044,103629,Sworder; David D.,9999,0,9999,0
1668572087308,ECE 200,045,103630,Taur; Yuan,9999,0,9999,0
1668572087308,ECE 200,046,103631,Touri; Behrouz,9999,0,9999,0
1668572087308,ECE 200,047,103632,Trivedi; Mohan M.,9999,0,9999,0
1668572087308,ECE 200,048,103633,Vasconcelos; Nuno,9999,0,9999,0
1668572087308,ECE 200,049,103634,Wang; Xiaolong,9999,0,9999,0
1668572087308,ECE 200,050,103635,Xie; Pengtao,9999,0,9999,0
1668572087308,ECE 200,051,103636,Yip; Michael,9999,0,9999,0
1668572087308,ECE 200,052,103637,Zeger; Kenneth A.,999,0,999,0
1668572087308,ECE 200,053,103638,Zhang; Xinyu,9999,0,9999,0
1668572087308,ECE 200,054,103639,Turakhia; Yatish Girish,9999,0,9999,0
1668572087308,ECE 200,055,103640,Kang; Mingu,9999,0,9999,0
1668572087308,ECE 200,056,103641,Shi; Yuanyuan,9999,0,9999,0
1668572087308,ECE 200,057,103642,Wang; Edward Jay,9999,0,9999,0
1668572087308,ECE 200,058,103643,Zheng; Yang,9999,0,9999,0
1668572087742,ECE 202,A00,103644,Kuzum; Duygu,0,46,0,0
1668572088167,ECE 212BN,A00,103646,Ng; Tse Nga,0,9,0,0
1668572088590,ECE 221,A00,111493,Staff,0,0,0,0
1668572089015,ECE 222B,A00,103647,Lomakin; Vitaliy,0,21,0,0
1668572089438,ECE 230B,A00,103648,Taur; Yuan,0,4,0,0
1668572089864,ECE 238B,A00,103649,Garay; Javier,0,0,0,0
1668572090290,ECE 240B,A00,112900,Fainman; Yeshaiahu,0,8,0,0
1668572090723,ECE 247A,A00,103650,Jokerst; Jesse Vincent,0,6,0,0
1668572091155,ECE 247B,A00,103651,Wang; Joseph,0,15,0,0
1668572091582,ECE 250,A00,103652,Siegel; Paul H.,0,85,0,0
1668572092016,ECE 251A,A00,103654,Rao; Bhaskar D.,0,65,0,0
1668572092444,ECE 257B,A00,103655,Bharadia; Dinesh,0,33,0,0
1668572092867,ECE 258A,A00,103656,Milstein; Laurence B.,0,29,0,0
1668572093295,ECE 260B,A00,103658,Kang; Mingu,0,121,0,0
1668572093741,ECE 264A,A00,103659,Galton; Ian A,0,45,0,31
1668572094167,ECE 265A,A00,103661,Gudem; Prasad S.S.,0,46,0,31
1668572094593,ECE 265D,A00,103662,Gudem; Prasad S.S.,0,27,0,0
1668572095027,ECE 268,A00,103663,Koushanfar; Farinaz,0,44,0,0
1668572095452,ECE 269,A01,103665,Pal; Piya,0,222,0,0
1668572095879,ECE 271B,A00,103666,Vasconcelos; Manuela,0,78,0,0
1668572096309,ECE 276A,A00,103667,Atanasov; Nikolay A.,0,126,0,0
1668572096731,ECE 277,A00,103668,An; Cheolhong,0,151,0,0
1668572097155,ECE 279,A00,117947,Hall; Drew A.,0,22,0,0
1668572098004,ECE 283,A00,103670,Hsueh; Tzu-Chien,0,57,0,0
1668572098474,ECE 284,A00,103671,Turakhia; Yatish Girish,0,41,0,0
1668572098910,ECE 285,A00,103672,Zheng; Yang,0,40,0,0
1668572098910,ECE 285,B00,103673,Sworder; David D.,0,61,0,0
1668572099339,ECE 287,A00,103676,Javidi; Tara,0,8,0,0
1668572099770,MATH 200B,A00,098023,Salehi Golsefidy; Alireza,7,0,15,8
1668572100195,MATH 202B,A00,098024,Rhoades; Brendon Patrick,7,0,15,8
1668572100623,MATH 203B,A00,098025,Oprea; Dragos N.,9,0,15,6
1668572101048,MATH 204B,A00,098026,Sorensen; Claus M,13,0,15,2
1668572101472,MATH 208,A00,098027,Izadi; Elham,7,0,10,3
1668572101894,MATH 209,A00,098028,Pollack; Aaron,10,0,10,0
1668572102317,MATH 211A,A00,112919,Rogalski; Daniel,8,0,10,2
1668572102740,MATH 211B,A00,112920,Seward; Brandon M.,9,0,10,1
1668572103164,MATH 218,A00,098029,Li; Bo,10,0,10,0
1668572103590,MATH 220B,A00,098030,Novak; Jonathan I,10,0,15,5
1668572104017,MATH 221A,A00,098031,Ebenfelt; Peter F,12,0,15,3
1668572104440,MATH 231B,A00,098032,Zlatos; Andrej,9,0,15,6
1668572104864,MATH 240B,A00,098033,Ni; Lei,7,0,15,8
1668572105288,MATH 243,A00,098034,Jekel; David Andrew,10,0,10,0
1668572105714,MATH 245A,A00,098035,Nie; Jiawang,0,7,15,18
1668572106146,MATH 248,A00,098036,Bejenaru; Ioan,10,0,10,0
1668572106570,MATH 250B,A00,098037,Spolaor; Luca,12,0,15,3
1668572107005,MATH 258,A00,098038,Ni; Lei,8,0,10,2
1668572107442,MATH 264B,A00,098041,Rhoades; Brendon Patrick,7,0,15,8
1668572107869,MATH 268,A00,098042,Buss; Samuel R,10,0,10,0
1668572108290,MATH 269,A00,098043,Rhoades; Brendon Patrick,10,0,10,0
1668572108717,MATH 270B,A00,098044,Li; Bo,6,0,15,9
1668572109143,MATH 272B,A00,098045,Holst; Michael J,13,0,15,2
1668572109570,MATH 273A,A00,098046,Tian; Xiaochuan,10,0,15,5
1668572110005,MATH 275,A01,098048,Tian; Xiaochuan,6,0,10,4
1668572110427,MATH 278A,A00,098049,Holst; Michael J,6,0,10,4
1668572110854,MATH 278B,A00,098050,Cloninger; Alexander,10,0,10,0
1668572111279,MATH 278C,A00,098051,Nie; Jiawang,5,0,10,5
1668572111702,MATH 280B,A00,098052,Zheng; Tianyi,6,0,15,9
1668572112125,MATH 281B,A00,098053,Bradic; Jelena,0,2,15,15
1668572112551,MATH 282B,A00,098054,Arias-Castro; Ery,0,1,15,15
1668572112977,MATH 285,A00,098055,Fitzsimmons; Patrick J,0,4,15,17
1668572113406,MATH 287B,A00,098056,Arias-Castro; Ery,1,0,15,14
1668572113833,MATH 288,A00,098057,Agarwal; Pooja,9,0,10,1
1668572113833,MATH 288,B00,098058,Zhang; Danna,8,0,10,2
1668572113833,MATH 288,C00,098059,Williams; Ruth J,9,0,10,1
1668572114256,MATH 290B,A00,098060,Roberts; Justin Deritter,11,0,15,4
1668572114692,MATH 292,A00,098061,Belmont; Eva Kinoshita,10,0,10,0
1668572115118,MATH 295,A00,098062,Suk; Andrew Hoon,47,0,50,3
1668572115541,MATH 296,A00,098063,Novak; Jonathan I,20,0,20,0
1668572115971,MATH 297,001,098064,Gamst; Anthony Collins,9997,0,9999,2
1668572629961,COGS 205,A00,101395,Chiba; Andrea,19,0,20,1
1668572630396,COGS 210B,001,101404,Greene; Deanna Jacquelyn,9998,0,9999,1
1668572630396,COGS 210B,002,101417,Xia; Haijun,9999,0,9999,0
1668572630396,COGS 210B,003,101422,Nitz; Douglas A.,9999,0,9999,0
1668572630396,COGS 210B,004,101423,Hollan; James D.,9998,0,9999,1
1668572630396,COGS 210B,005,101424,Deak; Gedeon O.,9998,0,9999,1
1668572630396,COGS 210B,006,101425,Rossano; Federico,9999,0,9999,0
1668572630829,COGS 211B,A00,101427,Coulson; Seana M,9996,0,9999,3
1668572631252,COGS 220,A00,101428,Hollan; James D.,0,17,25,25
1668572631675,COGS 229,A00,101429,Dow; Steven P,17,0,25,8
1668572632102,COGS 230,A00,101430,Klemmer; Scott R,6,0,17,11
1668572632528,COGS 234,A00,101431,Xia; Haijun,0,1,25,25
1668572632954,COGS 260,A00,101432,Kiyonaga; Anastasia,21,0,25,4
1668572632954,COGS 260,B00,101433,Kirsh; David Joel,15,0,25,10
1668572633418,CSE 202,A00,102371,Impagliazzo; Russell,0,70,0,0
1668572633845,CSE 203B,A01,102373,Cheng; Chung Kuan,0,70,0,0
1668572634269,CSE 208,A00,102374,Micciancio; Daniele,0,5,0,0
1668572634695,CSE 209A,A00,112895,Impagliazzo; Russell,0,14,15,15
1668572635117,CSE 209B,A00,108005,Bellare; Mihir,0,7,0,0
1668572635541,CSE 210,A00,113163,Coblenz; Michael J,0,95,0,0
1668572635964,CSE 219,A00,106111,Dow; Steven P,0,8,20,20
1668572636400,CSE 221,A00,102376,Voelker; Geoffrey M.,0,77,0,0
1668572636826,CSE 224,A01,102378,Porter; George M,0,180,0,0
1668572637252,CSE 229A,A00,102379,Savage; Stefan,0,14,0,0
1668572637675,CSE 229C,A00,102380,Munyaka; Imani N. S.,0,12,0,0
1668572638099,CSE 232B,A00,102382,Deutsch; Alin Bernard,0,39,0,0
1668572638521,CSE 234,A01,112904,Kumar; Arun Kumar,0,0,0,0
1668572638951,CSE 237A,A00,102383,Rosing; Tajana Simunic,0,57,0,0
1668572639376,CSE 239A,A00,102384,Deutsch; Alin Bernard,0,18,0,0
1668572639809,CSE 239B,A00,102385,Polikarpova; Nadezhda,0,11,0,0
1668572640243,CSE 240A,A00,102386,Pannuto; Patrick William,0,49,0,0
1668572640672,CSE 240B,A00,102387,Zhao; Jishen,0,51,0,0
1668572641102,CSE 241A,A00,106406,Kang; Mingu,0,9,0,0
1668572641526,CSE 249B,A00,102388,Kahng; Andrew Byun,0,7,8,8
1668572641951,CSE 251B,A01,102392,Cottrell; Garrison W,0,54,0,0
1668572641951,CSE 251B,A02,102393,Cottrell; Garrison W,0,36,0,0
1668572642380,CSE 252B,A00,102394,Ochoa; Benjamin Lawrence,0,65,0,0
1668572642803,CSE 257,A01,102396,Gao; Sicun,0,160,0,0
1668572643246,CSE 272,A00,102397,Li; Tzumao,0,22,0,0
1668572643677,CSE 274,A00,111323,Chern; Albert Ren-Haur,0,16,0,0
1668572644098,CSE 282,A00,102398,Pevzner; Pavel Arkadjevich,0,0,0,0
1668572644523,CSE 284,A00,114175,Gymrek; Melissa Ann,0,32,0,0
1668572644949,CSE 290,A00,102399,Chandraker; Manmohan Krishna,0,11,0,0
1668572644949,CSE 290,B00,102400,Vaccaro; Kristen Marie,0,10,25,25
1668572644949,CSE 290,C00,102414,Pannuto; Patrick William,0,1,25,25
1668572644949,CSE 290,D00,102427,Pevzner; Pavel Arkadjevich,0,0,0,0
1668572644949,CSE 290,E00,102429,Zhao; Jishen,0,6,0,0
1668572644949,CSE 290,F00,102436,Tullsen; Dean Michael,0,6,0,0
1668572644949,CSE 290,G00,102440,Christensen; Henrik I,0,8,20,20
1668572645395,CSE 291,A00,102443,Su; Hao,0,0,0,0
1668572645395,CSE 291,B00,102448,Polikarpova; Nadezhda,0,0,0,0
1668572645395,CSE 291,C00,102453,Vaccaro; Kristen Marie,0,0,0,0
1668572645395,CSE 291,D00,111343,Savage; Stefan,0,0,0,0
1668572645395,CSE 291,E00,116474,Claffy; Kimberly Claire,0,0,0,0
1668572645395,CSE 291,F00,116479,Pasquale; Joseph,0,0,0,0
1668572645841,CSE 293,001,119111,Bafna; Vineet,9999,0,9999,0
1668572645841,CSE 293,002,119118,Bellare; Mihir,9999,0,9999,0
1668572645841,CSE 293,003,119122,Berg-Kirkpatrick; Taylor D,9999,0,9999,0
1668572645841,CSE 293,004,119135,Christensen; Henrik I,9999,0,9999,0
1668572645841,CSE 293,005,119142,Cottrell; Garrison W,9999,0,9999,0
1668572645841,CSE 293,006,119146,Deutsch; Alin Bernard,9999,0,9999,0
1668572645841,CSE 293,007,119159,Esmaeilzadeh; Hadi,9999,0,9999,0
1668572645841,CSE 293,008,119166,Freund; Yoav,9999,0,9999,0
1668572645841,CSE 293,009,119170,Griswold; William G.,9999,0,9999,0
1668572645841,CSE 293,010,119183,Gymrek; Melissa Ann,9999,0,9999,0
1668572645841,CSE 293,011,119190,Heninger; Nadia A,9999,0,9999,0
1668572645841,CSE 293,012,119230,Impagliazzo; Russell,9999,0,9999,0
1668572645841,CSE 293,013,119232,Jhala; Ranjit,9999,0,9999,0
1668572645841,CSE 293,014,119233,Kahng; Andrew Byun,9999,0,9999,0
1668572645841,CSE 293,015,119298,Kane; Daniel Mertz,9999,0,9999,0
1668572645841,CSE 293,016,119299,Kriegman; David J,9999,0,9999,0
1668572645841,CSE 293,017,119300,Kumar; Arun Kumar,9999,0,9999,0
1668572645841,CSE 293,018,119301,Lerner; Sorin,9999,0,9999,0
1668572645841,CSE 293,019,119302,Lovett; Shachar,9999,0,9999,0
1668572645841,CSE 293,020,119303,McAuley; Julian John,9999,0,9999,0
1668572645841,CSE 293,021,119304,Micciancio; Daniele,9999,0,9999,0
1668572645841,CSE 293,022,119367,Orailoglu; Alex,9999,0,9999,0
1668572645841,CSE 293,023,119382,Paturi; Ramamohan,9999,0,9999,0
1668572645841,CSE 293,024,119404,Polikarpova; Nadezhda,9999,0,9999,0
1668572645841,CSE 293,025,119406,Politz; Joseph Gibbs,9999,0,9999,0
1668572645841,CSE 293,026,119411,Porter; George M,9999,0,9999,0
1668572645841,CSE 293,027,119414,Porter; Leonard Emerson,9999,0,9999,0
1668572645841,CSE 293,028,119416,Ramamoorthi; Ravi,9999,0,9999,0
1668572645841,CSE 293,029,119417,Sahoo; Debashis,9999,0,9999,0
1668572645841,CSE 293,030,119420,Saul; Lawrence,9999,0,9999,0
1668572645841,CSE 293,031,119421,Savage; Stefan,9999,0,9999,0
1668572645841,CSE 293,032,119425,Schulze; Jurgen P.,9999,0,9999,0
1668572645841,CSE 293,033,119426,Snoeren; Alex C.,9999,0,9999,0
1668572645841,CSE 293,034,119428,Shang; Jingbo,9999,0,9999,0
1668572645841,CSE 293,035,119430,Stefan; Deian,9999,0,9999,0
1668572645841,CSE 293,036,119431,Su; Hao,9999,0,9999,0
1668572645841,CSE 293,037,119433,Swanson; Steven James,9999,0,9999,0
1668572645841,CSE 293,038,119435,Tullsen; Dean Michael,9999,0,9999,0
1668572645841,CSE 293,039,119483,Voelker; Geoffrey M.,9999,0,9999,0
1668572645841,CSE 293,040,119537,Zhao; Jishen,9999,0,9999,0
1668572645841,CSE 293,041,119538,Zhou; Yuan-Yuan,9999,0,9999,0
1668572645841,CSE 293,042,119539,Gao; Sicun,9999,0,9999,0
1668572645841,CSE 293,043,119540,Weibel; Nadir,9999,0,9999,0
1668572645841,CSE 293,044,119541,Gupta; Rajesh K.,9999,0,9999,0
1668572645841,CSE 293,045,126410,Vaccaro; Kristen Marie,9999,0,9999,0
1668572645841,CSE 293,046,126411,Klemke; Richard,9999,0,9999,0
1668572646267,CSE 294,A00,102459,Voelker; Geoffrey M.,0,2,0,0
1668572646267,CSE 294,B00,111322,Orailoglu; Alex,0,2,0,0
1668572646691,DSE 201,A00,096914,Deutsch; Alin Bernard,30,0,30,0
1668572647115,DSE 210,A00,096915,Dasgupta; Sanjoy,30,0,30,0
1668572647537,DSE 260A,A00,096916,Altintas De Callaf; Ilkay,30,0,30,0
1668572647965,ECE 200,001,103586,Antipa; Nicholas A,9999,0,9999,0
1668572647965,ECE 200,002,103587,Atanasov; Nikolay A.,9999,0,9999,0
1668572647965,ECE 200,003,103588,Bharadia; Dinesh,9999,0,9999,0
1668572647965,ECE 200,004,103589,Cheng; Chung Kuan,9999,0,9999,0
1668572647965,ECE 200,005,103590,Cosman; Pamela C.,9999,0,9999,0
1668572647965,ECE 200,006,103591,Dayeh; Shadi Ahmad,9999,0,9999,0
1668572647965,ECE 200,007,103592,Fainman; Yeshaiahu,9999,0,9999,0
1668572647965,ECE 200,008,103593,Ford; Joseph Earl,9999,0,9999,0
1668572647965,ECE 200,009,103594,Franceschetti; Massimo,9999,0,9999,0
1668572647965,ECE 200,010,103595,Fullerton; Eric E,9999,0,9999,0
1668572647965,ECE 200,011,103596,Galton; Ian A,9999,0,9999,0
1668572647965,ECE 200,012,103597,Gilja; Vikash,9999,0,9999,0
1668572647965,ECE 200,013,103598,Hall; Drew A.,9999,0,9999,0
1668572647965,ECE 200,014,103599,Hsueh; Tzu-Chien,9999,0,9999,0
1668572647965,ECE 200,015,103600,Javidi; Tara,9999,0,9999,0
1668572647965,ECE 200,016,103601,Kahng; Andrew Byun,9999,0,9999,0
1668572647965,ECE 200,017,103602,Kim; Young-Han,9999,0,9999,0
1668572647965,ECE 200,018,103603,Koushanfar; Farinaz,9999,0,9999,0
1668572647965,ECE 200,019,103604,Kuzum; Duygu,9999,0,9999,0
1668572647965,ECE 200,020,103605,Le; Hanh-Phuc,9999,0,9999,0
1668572647965,ECE 200,021,103606,Lin; Bill,9999,0,9999,0
1668572647965,ECE 200,022,103607,Liu; Zhaowei,9998,0,9999,1
1668572647965,ECE 200,023,103608,Lo; Yu-Hwa,9999,0,9999,0
1668572647965,ECE 200,024,103609,Lomakin; Vitaliy,9999,0,9999,0
1668572647965,ECE 200,025,103610,Mercier; Patrick Philip,9999,0,9999,0
1668572647965,ECE 200,026,103611,Meyer; Florian,9999,0,9999,0
1668572647965,ECE 200,027,103612,Milstein; Laurence B.,9999,0,9999,0
1668572647965,ECE 200,028,103613,Mir Arabbaygi; Siavash,9999,0,9999,0
1668572647965,ECE 200,029,103614,Mookherjea; Shayan,9999,0,9999,0
1668572647965,ECE 200,030,103615,Morris; Karcher William,9999,0,9999,0
1668572647965,ECE 200,031,103616,Ng; Tse Nga,9999,0,9999,0
1668572647965,ECE 200,032,103617,Nguyen; Truong Quang,9999,0,9999,0
1668572647965,ECE 200,033,103618,Nomura; Kenji,9999,0,9999,0
1668572647965,ECE 200,034,103619,Orlitsky; Alon,9999,0,9999,0
1668572647965,ECE 200,035,103620,Pal; Piya,9999,0,9999,0
1668572647965,ECE 200,036,103621,Papen; George C.,9999,0,9999,0
1668572647965,ECE 200,037,103622,Radic; Stojan,9999,0,9999,0
1668572647965,ECE 200,038,103623,Rao; Bhaskar D.,9999,0,9999,0
1668572647965,ECE 200,039,103624,Rao; Ramesh R,9999,0,9999,0
1668572647965,ECE 200,040,103625,Rebeiz; Gabriel,9999,0,9999,0
1668572647965,ECE 200,041,103626,Sanford; John R,9999,0,9999,0
1668572647965,ECE 200,042,103627,Siegel; Paul H.,9999,0,9999,0
1668572647965,ECE 200,043,103628,Sievenpiper; Daniel F.,9999,0,9999,0
1668572647965,ECE 200,044,103629,Sworder; David D.,9999,0,9999,0
1668572647965,ECE 200,045,103630,Taur; Yuan,9999,0,9999,0
1668572647965,ECE 200,046,103631,Touri; Behrouz,9999,0,9999,0
1668572647965,ECE 200,047,103632,Trivedi; Mohan M.,9999,0,9999,0
1668572647965,ECE 200,048,103633,Vasconcelos; Nuno,9999,0,9999,0
1668572647965,ECE 200,049,103634,Wang; Xiaolong,9999,0,9999,0
1668572647965,ECE 200,050,103635,Xie; Pengtao,9999,0,9999,0
1668572647965,ECE 200,051,103636,Yip; Michael,9999,0,9999,0
1668572647965,ECE 200,052,103637,Zeger; Kenneth A.,999,0,999,0
1668572647965,ECE 200,053,103638,Zhang; Xinyu,9999,0,9999,0
1668572647965,ECE 200,054,103639,Turakhia; Yatish Girish,9999,0,9999,0
1668572647965,ECE 200,055,103640,Kang; Mingu,9999,0,9999,0
1668572647965,ECE 200,056,103641,Shi; Yuanyuan,9999,0,9999,0
1668572647965,ECE 200,057,103642,Wang; Edward Jay,9999,0,9999,0
1668572647965,ECE 200,058,103643,Zheng; Yang,9999,0,9999,0
1668572648397,ECE 202,A00,103644,Kuzum; Duygu,0,46,0,0
1668572648829,ECE 212BN,A00,103646,Ng; Tse Nga,0,9,0,0
1668572649253,ECE 221,A00,111493,Staff,0,0,0,0
1668572649678,ECE 222B,A00,103647,Lomakin; Vitaliy,0,21,0,0
1668572650118,ECE 230B,A00,103648,Taur; Yuan,0,4,0,0
1668572650555,ECE 238B,A00,103649,Garay; Javier,0,0,0,0
1668572650992,ECE 240B,A00,112900,Fainman; Yeshaiahu,0,8,0,0
1668572651428,ECE 247A,A00,103650,Jokerst; Jesse Vincent,0,6,0,0
1668572651851,ECE 247B,A00,103651,Wang; Joseph,0,15,0,0
1668572652375,ECE 250,A00,103652,Siegel; Paul H.,0,85,0,0
1668572652801,ECE 251A,A00,103654,Rao; Bhaskar D.,0,65,0,0
1668572653224,ECE 257B,A00,103655,Bharadia; Dinesh,0,33,0,0
1668572653674,ECE 258A,A00,103656,Milstein; Laurence B.,0,29,0,0
1668572654103,ECE 260B,A00,103658,Kang; Mingu,0,121,0,0
1668572654545,ECE 264A,A00,103659,Galton; Ian A,0,45,0,31
1668572654986,ECE 265A,A00,103661,Gudem; Prasad S.S.,0,46,0,31
1668572655417,ECE 265D,A00,103662,Gudem; Prasad S.S.,0,27,0,0
1668572655840,ECE 268,A00,103663,Koushanfar; Farinaz,0,44,0,0
1668572656270,ECE 269,A01,103665,Pal; Piya,0,222,0,0
1668572656694,ECE 271B,A00,103666,Vasconcelos; Manuela,0,78,0,0
1668572657118,ECE 276A,A00,103667,Atanasov; Nikolay A.,0,126,0,0
1668572657545,ECE 277,A00,103668,An; Cheolhong,0,151,0,0
1668572657971,ECE 279,A00,117947,Hall; Drew A.,0,22,0,0
1668572658819,ECE 283,A00,103670,Hsueh; Tzu-Chien,0,57,0,0
1668572659253,ECE 284,A00,103671,Turakhia; Yatish Girish,0,41,0,0
1668572659683,ECE 285,A00,103672,Zheng; Yang,0,40,0,0
1668572659683,ECE 285,B00,103673,Sworder; David D.,0,61,0,0
1668572660108,ECE 287,A00,103676,Javidi; Tara,0,8,0,0
1668572660530,MATH 200B,A00,098023,Salehi Golsefidy; Alireza,7,0,15,8
1668572660953,MATH 202B,A00,098024,Rhoades; Brendon Patrick,7,0,15,8
1668572661376,MATH 203B,A00,098025,Oprea; Dragos N.,9,0,15,6
1668572661798,MATH 204B,A00,098026,Sorensen; Claus M,13,0,15,2
1668572662224,MATH 208,A00,098027,Izadi; Elham,7,0,10,3
1668572662647,MATH 209,A00,098028,Pollack; Aaron,10,0,10,0
1668572663073,MATH 211A,A00,112919,Rogalski; Daniel,8,0,10,2
1668572663497,MATH 211B,A00,112920,Seward; Brandon M.,9,0,10,1
1668572663935,MATH 218,A00,098029,Li; Bo,10,0,10,0
1668572664369,MATH 220B,A00,098030,Novak; Jonathan I,10,0,15,5
1668572664792,MATH 221A,A00,098031,Ebenfelt; Peter F,12,0,15,3
1668572665217,MATH 231B,A00,098032,Zlatos; Andrej,9,0,15,6
1668572665640,MATH 240B,A00,098033,Ni; Lei,7,0,15,8
1668572666064,MATH 243,A00,098034,Jekel; David Andrew,10,0,10,0
1668572666501,MATH 245A,A00,098035,Nie; Jiawang,0,7,15,18
1668572666924,MATH 248,A00,098036,Bejenaru; Ioan,10,0,10,0
1668572667352,MATH 250B,A00,098037,Spolaor; Luca,12,0,15,3
1668572667774,MATH 258,A00,098038,Ni; Lei,8,0,10,2
1668572668198,MATH 264B,A00,098041,Rhoades; Brendon Patrick,7,0,15,8
1668572668621,MATH 268,A00,098042,Buss; Samuel R,10,0,10,0
1668572669048,MATH 269,A00,098043,Rhoades; Brendon Patrick,10,0,10,0
1668572669474,MATH 270B,A00,098044,Li; Bo,6,0,15,9
1668572669905,MATH 272B,A00,098045,Holst; Michael J,13,0,15,2
1668572670340,MATH 273A,A00,098046,Tian; Xiaochuan,10,0,15,5
1668572670765,MATH 275,A01,098048,Tian; Xiaochuan,6,0,10,4
1668572671200,MATH 278A,A00,098049,Holst; Michael J,6,0,10,4
1668572671625,MATH 278B,A00,098050,Cloninger; Alexander,10,0,10,0
1668572672058,MATH 278C,A00,098051,Nie; Jiawang,5,0,10,5
1668572672481,MATH 280B,A00,098052,Zheng; Tianyi,6,0,15,9
1668572672908,MATH 281B,A00,098053,Bradic; Jelena,0,2,15,15
1668572673332,MATH 282B,A00,098054,Arias-Castro; Ery,0,1,15,15
1668572673758,MATH 285,A00,098055,Fitzsimmons; Patrick J,0,4,15,17
1668572674190,MATH 287B,A00,098056,Arias-Castro; Ery,1,0,15,14
1668572674620,MATH 288,A00,098057,Agarwal; Pooja,9,0,10,1
1668572674620,MATH 288,B00,098058,Zhang; Danna,8,0,10,2
1668572674620,MATH 288,C00,098059,Williams; Ruth J,9,0,10,1
1668572675046,MATH 290B,A00,098060,Roberts; Justin Deritter,11,0,15,4
1668572675472,MATH 292,A00,098061,Belmont; Eva Kinoshita,10,0,10,0
1668572675896,MATH 295,A00,098062,Suk; Andrew Hoon,47,0,50,3
1668572676321,MATH 296,A00,098063,Novak; Jonathan I,20,0,20,0
1668572676746,MATH 297,001,098064,Gamst; Anthony Collins,9997,0,9999,2
1668573180069,COGS 205,A00,101395,Chiba; Andrea,19,0,20,1
1668573180500,COGS 210B,001,101404,Greene; Deanna Jacquelyn,9998,0,9999,1
1668573180500,COGS 210B,002,101417,Xia; Haijun,9999,0,9999,0
1668573180500,COGS 210B,003,101422,Nitz; Douglas A.,9999,0,9999,0
1668573180500,COGS 210B,004,101423,Hollan; James D.,9998,0,9999,1
1668573180500,COGS 210B,005,101424,Deak; Gedeon O.,9998,0,9999,1
1668573180500,COGS 210B,006,101425,Rossano; Federico,9999,0,9999,0
1668573180926,COGS 211B,A00,101427,Coulson; Seana M,9996,0,9999,3
1668573181358,COGS 220,A00,101428,Hollan; James D.,0,17,25,25
1668573181802,COGS 229,A00,101429,Dow; Steven P,17,0,25,8
1668573182225,COGS 230,A00,101430,Klemmer; Scott R,6,0,17,11
1668573182648,COGS 234,A00,101431,Xia; Haijun,0,1,25,25
1668573183070,COGS 260,A00,101432,Kiyonaga; Anastasia,21,0,25,4
1668573183070,COGS 260,B00,101433,Kirsh; David Joel,15,0,25,10
1668573183495,CSE 202,A00,102371,Impagliazzo; Russell,0,70,0,0
1668573183919,CSE 203B,A01,102373,Cheng; Chung Kuan,0,70,0,0
1668573184348,CSE 208,A00,102374,Micciancio; Daniele,0,5,0,0
1668573184771,CSE 209A,A00,112895,Impagliazzo; Russell,0,14,15,15
1668573185195,CSE 209B,A00,108005,Bellare; Mihir,0,7,0,0
1668573185626,CSE 210,A00,113163,Coblenz; Michael J,0,95,0,0
1668573186056,CSE 219,A00,106111,Dow; Steven P,0,8,20,20
1668573186479,CSE 221,A00,102376,Voelker; Geoffrey M.,0,77,0,0
1668573186902,CSE 224,A01,102378,Porter; George M,0,180,0,0
1668573187329,CSE 229A,A00,102379,Savage; Stefan,0,14,0,0
1668573187771,CSE 229C,A00,102380,Munyaka; Imani N. S.,0,12,0,0
1668573188210,CSE 232B,A00,102382,Deutsch; Alin Bernard,0,39,0,0
1668573188636,CSE 234,A01,112904,Kumar; Arun Kumar,0,0,0,0
1668573189065,CSE 237A,A00,102383,Rosing; Tajana Simunic,0,57,0,0
1668573189488,CSE 239A,A00,102384,Deutsch; Alin Bernard,0,18,0,0
1668573189910,CSE 239B,A00,102385,Polikarpova; Nadezhda,0,11,0,0
1668573190341,CSE 240A,A00,102386,Pannuto; Patrick William,0,49,0,0
1668573190774,CSE 240B,A00,102387,Zhao; Jishen,0,51,0,0
1668573191199,CSE 241A,A00,106406,Kang; Mingu,0,9,0,0
1668573191622,CSE 249B,A00,102388,Kahng; Andrew Byun,0,7,8,8
1668573192050,CSE 251B,A01,102392,Cottrell; Garrison W,0,54,0,0
1668573192050,CSE 251B,A02,102393,Cottrell; Garrison W,0,36,0,0
1668573192473,CSE 252B,A00,102394,Ochoa; Benjamin Lawrence,0,65,0,0
1668573192907,CSE 257,A01,102396,Gao; Sicun,0,160,0,0
1668573193348,CSE 272,A00,102397,Li; Tzumao,0,22,0,0
1668573193772,CSE 274,A00,111323,Chern; Albert Ren-Haur,0,16,0,0
1668573194205,CSE 282,A00,102398,Pevzner; Pavel Arkadjevich,0,0,0,0
1668573194636,CSE 284,A00,114175,Gymrek; Melissa Ann,0,32,0,0
1668573195064,CSE 290,A00,102399,Chandraker; Manmohan Krishna,0,11,0,0
1668573195064,CSE 290,B00,102400,Vaccaro; Kristen Marie,0,10,25,25
1668573195064,CSE 290,C00,102414,Pannuto; Patrick William,0,1,25,25
1668573195064,CSE 290,D00,102427,Pevzner; Pavel Arkadjevich,0,0,0,0
1668573195064,CSE 290,E00,102429,Zhao; Jishen,0,6,0,0
1668573195064,CSE 290,F00,102436,Tullsen; Dean Michael,0,6,0,0
1668573195064,CSE 290,G00,102440,Christensen; Henrik I,0,8,20,20
1668573195494,CSE 291,A00,102443,Su; Hao,0,0,0,0
1668573195494,CSE 291,B00,102448,Polikarpova; Nadezhda,0,0,0,0
1668573195494,CSE 291,C00,102453,Vaccaro; Kristen Marie,0,0,0,0
1668573195494,CSE 291,D00,111343,Savage; Stefan,0,0,0,0
1668573195494,CSE 291,E00,116474,Claffy; Kimberly Claire,0,0,0,0
1668573195494,CSE 291,F00,116479,Pasquale; Joseph,0,0,0,0
1668573195924,CSE 293,001,119111,Bafna; Vineet,9999,0,9999,0
1668573195924,CSE 293,002,119118,Bellare; Mihir,9999,0,9999,0
1668573195924,CSE 293,003,119122,Berg-Kirkpatrick; Taylor D,9999,0,9999,0
1668573195924,CSE 293,004,119135,Christensen; Henrik I,9999,0,9999,0
1668573195924,CSE 293,005,119142,Cottrell; Garrison W,9999,0,9999,0
1668573195924,CSE 293,006,119146,Deutsch; Alin Bernard,9999,0,9999,0
1668573195924,CSE 293,007,119159,Esmaeilzadeh; Hadi,9999,0,9999,0
1668573195924,CSE 293,008,119166,Freund; Yoav,9999,0,9999,0
1668573195924,CSE 293,009,119170,Griswold; William G.,9999,0,9999,0
1668573195924,CSE 293,010,119183,Gymrek; Melissa Ann,9999,0,9999,0
1668573195924,CSE 293,011,119190,Heninger; Nadia A,9999,0,9999,0
1668573195924,CSE 293,012,119230,Impagliazzo; Russell,9999,0,9999,0
1668573195924,CSE 293,013,119232,Jhala; Ranjit,9999,0,9999,0
1668573195924,CSE 293,014,119233,Kahng; Andrew Byun,9999,0,9999,0
1668573195924,CSE 293,015,119298,Kane; Daniel Mertz,9999,0,9999,0
1668573195924,CSE 293,016,119299,Kriegman; David J,9999,0,9999,0
1668573195924,CSE 293,017,119300,Kumar; Arun Kumar,9999,0,9999,0
1668573195924,CSE 293,018,119301,Lerner; Sorin,9999,0,9999,0
1668573195924,CSE 293,019,119302,Lovett; Shachar,9999,0,9999,0
1668573195924,CSE 293,020,119303,McAuley; Julian John,9999,0,9999,0
1668573195924,CSE 293,021,119304,Micciancio; Daniele,9999,0,9999,0
1668573195924,CSE 293,022,119367,Orailoglu; Alex,9999,0,9999,0
1668573195924,CSE 293,023,119382,Paturi; Ramamohan,9999,0,9999,0
1668573195924,CSE 293,024,119404,Polikarpova; Nadezhda,9999,0,9999,0
1668573195924,CSE 293,025,119406,Politz; Joseph Gibbs,9999,0,9999,0
1668573195924,CSE 293,026,119411,Porter; George M,9999,0,9999,0
1668573195924,CSE 293,027,119414,Porter; Leonard Emerson,9999,0,9999,0
1668573195924,CSE 293,028,119416,Ramamoorthi; Ravi,9999,0,9999,0
1668573195924,CSE 293,029,119417,Sahoo; Debashis,9999,0,9999,0
1668573195924,CSE 293,030,119420,Saul; Lawrence,9999,0,9999,0
1668573195924,CSE 293,031,119421,Savage; Stefan,9999,0,9999,0
1668573195924,CSE 293,032,119425,Schulze; Jurgen P.,9999,0,9999,0
1668573195924,CSE 293,033,119426,Snoeren; Alex C.,9999,0,9999,0
1668573195924,CSE 293,034,119428,Shang; Jingbo,9999,0,9999,0
1668573195924,CSE 293,035,119430,Stefan; Deian,9999,0,9999,0
1668573195924,CSE 293,036,119431,Su; Hao,9999,0,9999,0
1668573195924,CSE 293,037,119433,Swanson; Steven James,9999,0,9999,0
1668573195924,CSE 293,038,119435,Tullsen; Dean Michael,9999,0,9999,0
1668573195924,CSE 293,039,119483,Voelker; Geoffrey M.,9999,0,9999,0
1668573195924,CSE 293,040,119537,Zhao; Jishen,9999,0,9999,0
1668573195924,CSE 293,041,119538,Zhou; Yuan-Yuan,9999,0,9999,0
1668573195924,CSE 293,042,119539,Gao; Sicun,9999,0,9999,0
1668573195924,CSE 293,043,119540,Weibel; Nadir,9999,0,9999,0
1668573195924,CSE 293,044,119541,Gupta; Rajesh K.,9999,0,9999,0
1668573195924,CSE 293,045,126410,Vaccaro; Kristen Marie,9999,0,9999,0
1668573195924,CSE 293,046,126411,Klemke; Richard,9999,0,9999,0
1668573196351,CSE 294,A00,102459,Voelker; Geoffrey M.,0,2,0,0
1668573196351,CSE 294,B00,111322,Orailoglu; Alex,0,2,0,0
1668573196777,DSE 201,A00,096914,Deutsch; Alin Bernard,30,0,30,0
1668573197205,DSE 210,A00,096915,Dasgupta; Sanjoy,30,0,30,0
1668573197636,DSE 260A,A00,096916,Altintas De Callaf; Ilkay,30,0,30,0
1668573198079,ECE 200,001,103586,Antipa; Nicholas A,9999,0,9999,0
1668573198079,ECE 200,002,103587,Atanasov; Nikolay A.,9999,0,9999,0
1668573198079,ECE 200,003,103588,Bharadia; Dinesh,9999,0,9999,0
1668573198079,ECE 200,004,103589,Cheng; Chung Kuan,9999,0,9999,0
1668573198079,ECE 200,005,103590,Cosman; Pamela C.,9999,0,9999,0
1668573198079,ECE 200,006,103591,Dayeh; Shadi Ahmad,9999,0,9999,0
1668573198079,ECE 200,007,103592,Fainman; Yeshaiahu,9999,0,9999,0
1668573198079,ECE 200,008,103593,Ford; Joseph Earl,9999,0,9999,0
1668573198079,ECE 200,009,103594,Franceschetti; Massimo,9999,0,9999,0
1668573198079,ECE 200,010,103595,Fullerton; Eric E,9999,0,9999,0
1668573198079,ECE 200,011,103596,Galton; Ian A,9999,0,9999,0
1668573198079,ECE 200,012,103597,Gilja; Vikash,9999,0,9999,0
1668573198079,ECE 200,013,103598,Hall; Drew A.,9999,0,9999,0
1668573198079,ECE 200,014,103599,Hsueh; Tzu-Chien,9999,0,9999,0
1668573198079,ECE 200,015,103600,Javidi; Tara,9999,0,9999,0
1668573198079,ECE 200,016,103601,Kahng; Andrew Byun,9999,0,9999,0
1668573198079,ECE 200,017,103602,Kim; Young-Han,9999,0,9999,0
1668573198079,ECE 200,018,103603,Koushanfar; Farinaz,9999,0,9999,0
1668573198079,ECE 200,019,103604,Kuzum; Duygu,9999,0,9999,0
1668573198079,ECE 200,020,103605,Le; Hanh-Phuc,9999,0,9999,0
1668573198079,ECE 200,021,103606,Lin; Bill,9999,0,9999,0
1668573198079,ECE 200,022,103607,Liu; Zhaowei,9998,0,9999,1
1668573198079,ECE 200,023,103608,Lo; Yu-Hwa,9999,0,9999,0
1668573198079,ECE 200,024,103609,Lomakin; Vitaliy,9999,0,9999,0
1668573198079,ECE 200,025,103610,Mercier; Patrick Philip,9999,0,9999,0
1668573198079,ECE 200,026,103611,Meyer; Florian,9999,0,9999,0
1668573198079,ECE 200,027,103612,Milstein; Laurence B.,9999,0,9999,0
1668573198079,ECE 200,028,103613,Mir Arabbaygi; Siavash,9999,0,9999,0
1668573198079,ECE 200,029,103614,Mookherjea; Shayan,9999,0,9999,0
1668573198079,ECE 200,030,103615,Morris; Karcher William,9999,0,9999,0
1668573198079,ECE 200,031,103616,Ng; Tse Nga,9999,0,9999,0
1668573198079,ECE 200,032,103617,Nguyen; Truong Quang,9999,0,9999,0
1668573198079,ECE 200,033,103618,Nomura; Kenji,9999,0,9999,0
1668573198079,ECE 200,034,103619,Orlitsky; Alon,9999,0,9999,0
1668573198079,ECE 200,035,103620,Pal; Piya,9999,0,9999,0
1668573198079,ECE 200,036,103621,Papen; George C.,9999,0,9999,0
1668573198079,ECE 200,037,103622,Radic; Stojan,9999,0,9999,0
1668573198079,ECE 200,038,103623,Rao; Bhaskar D.,9999,0,9999,0
1668573198079,ECE 200,039,103624,Rao; Ramesh R,9999,0,9999,0
1668573198079,ECE 200,040,103625,Rebeiz; Gabriel,9999,0,9999,0
1668573198079,ECE 200,041,103626,Sanford; John R,9999,0,9999,0
1668573198079,ECE 200,042,103627,Siegel; Paul H.,9999,0,9999,0
1668573198079,ECE 200,043,103628,Sievenpiper; Daniel F.,9999,0,9999,0
1668573198079,ECE 200,044,103629,Sworder; David D.,9999,0,9999,0
1668573198079,ECE 200,045,103630,Taur; Yuan,9999,0,9999,0
1668573198079,ECE 200,046,103631,Touri; Behrouz,9999,0,9999,0
1668573198079,ECE 200,047,103632,Trivedi; Mohan M.,9999,0,9999,0
1668573198079,ECE 200,048,103633,Vasconcelos; Nuno,9999,0,9999,0
1668573198079,ECE 200,049,103634,Wang; Xiaolong,9999,0,9999,0
1668573198079,ECE 200,050,103635,Xie; Pengtao,9999,0,9999,0
1668573198079,ECE 200,051,103636,Yip; Michael,9999,0,9999,0
1668573198079,ECE 200,052,103637,Zeger; Kenneth A.,999,0,999,0
1668573198079,ECE 200,053,103638,Zhang; Xinyu,9999,0,9999,0
1668573198079,ECE 200,054,103639,Turakhia; Yatish Girish,9999,0,9999,0
1668573198079,ECE 200,055,103640,Kang; Mingu,9999,0,9999,0
1668573198079,ECE 200,056,103641,Shi; Yuanyuan,9999,0,9999,0
1668573198079,ECE 200,057,103642,Wang; Edward Jay,9999,0,9999,0
1668573198079,ECE 200,058,103643,Zheng; Yang,9999,0,9999,0
1668573198501,ECE 202,A00,103644,Kuzum; Duygu,0,46,0,0
1668573198927,ECE 212BN,A00,103646,Ng; Tse Nga,0,10,0,0
1668573199359,ECE 221,A00,111493,Staff,0,0,0,0
1668573199784,ECE 222B,A00,103647,Lomakin; Vitaliy,0,21,0,0
1668573200211,ECE 230B,A00,103648,Taur; Yuan,0,4,0,0
1668573200637,ECE 238B,A00,103649,Garay; Javier,0,0,0,0
1668573201066,ECE 240B,A00,112900,Fainman; Yeshaiahu,0,8,0,0
1668573201497,ECE 247A,A00,103650,Jokerst; Jesse Vincent,0,6,0,0
1668573201924,ECE 247B,A00,103651,Wang; Joseph,0,15,0,0
1668573202362,ECE 250,A00,103652,Siegel; Paul H.,0,85,0,0
1668573202788,ECE 251A,A00,103654,Rao; Bhaskar D.,0,65,0,0
1668573203214,ECE 257B,A00,103655,Bharadia; Dinesh,0,33,0,0
1668573203641,ECE 258A,A00,103656,Milstein; Laurence B.,0,29,0,0
1668573204066,ECE 260B,A00,103658,Kang; Mingu,0,121,0,0
1668573204494,ECE 264A,A00,103659,Galton; Ian A,0,45,0,31
1668573204916,ECE 265A,A00,103661,Gudem; Prasad S.S.,0,46,0,31
1668573205351,ECE 265D,A00,103662,Gudem; Prasad S.S.,0,27,0,0
1668573205773,ECE 268,A00,103663,Koushanfar; Farinaz,0,44,0,0
1668573206200,ECE 269,A01,103665,Pal; Piya,0,222,0,0
1668573206623,ECE 271B,A00,103666,Vasconcelos; Manuela,0,78,0,0
1668573207047,ECE 276A,A00,103667,Atanasov; Nikolay A.,0,126,0,0
1668573207470,ECE 277,A00,103668,An; Cheolhong,0,151,0,0
1668573207893,ECE 279,A00,117947,Hall; Drew A.,0,22,0,0
1668573208742,ECE 283,A00,103670,Hsueh; Tzu-Chien,0,57,0,0
1668573209168,ECE 284,A00,103671,Turakhia; Yatish Girish,0,41,0,0
1668573209591,ECE 285,A00,103672,Zheng; Yang,0,40,0,0
1668573209591,ECE 285,B00,103673,Sworder; David D.,0,61,0,0
1668573210015,ECE 287,A00,103676,Javidi; Tara,0,8,0,0
1668573210448,MATH 200B,A00,098023,Salehi Golsefidy; Alireza,7,0,15,8
1668573210880,MATH 202B,A00,098024,Rhoades; Brendon Patrick,7,0,15,8
1668573211303,MATH 203B,A00,098025,Oprea; Dragos N.,9,0,15,6
1668573211725,MATH 204B,A00,098026,Sorensen; Claus M,13,0,15,2
1668573212164,MATH 208,A00,098027,Izadi; Elham,7,0,10,3
1668573212592,MATH 209,A00,098028,Pollack; Aaron,10,0,10,0
1668573213015,MATH 211A,A00,112919,Rogalski; Daniel,8,0,10,2
1668573213440,MATH 211B,A00,112920,Seward; Brandon M.,9,0,10,1
1668573213870,MATH 218,A00,098029,Li; Bo,10,0,10,0
1668573214296,MATH 220B,A00,098030,Novak; Jonathan I,10,0,15,5
1668573214719,MATH 221A,A00,098031,Ebenfelt; Peter F,12,0,15,3
1668573215141,MATH 231B,A00,098032,Zlatos; Andrej,9,0,15,6
1668573215565,MATH 240B,A00,098033,Ni; Lei,7,0,15,8
1668573215989,MATH 243,A00,098034,Jekel; David Andrew,10,0,10,0
1668573216424,MATH 245A,A00,098035,Nie; Jiawang,0,7,15,18
1668573216854,MATH 248,A00,098036,Bejenaru; Ioan,10,0,10,0
1668573217363,MATH 250B,A00,098037,Spolaor; Luca,12,0,15,3
1668573217787,MATH 258,A00,098038,Ni; Lei,8,0,10,2
1668573218214,MATH 264B,A00,098041,Rhoades; Brendon Patrick,7,0,15,8
1668573218638,MATH 268,A00,098042,Buss; Samuel R,10,0,10,0
1668573219069,MATH 269,A00,098043,Rhoades; Brendon Patrick,10,0,10,0
1668573219497,MATH 270B,A00,098044,Li; Bo,6,0,15,9
1668573219935,MATH 272B,A00,098045,Holst; Michael J,13,0,15,2
1668573220359,MATH 273A,A00,098046,Tian; Xiaochuan,10,0,15,5
1668573220782,MATH 275,A01,098048,Tian; Xiaochuan,6,0,10,4
1668573221211,MATH 278A,A00,098049,Holst; Michael J,6,0,10,4
1668573221635,MATH 278B,A00,098050,Cloninger; Alexander,10,0,10,0
1668573222059,MATH 278C,A00,098051,Nie; Jiawang,5,0,10,5
1668573222483,MATH 280B,A00,098052,Zheng; Tianyi,6,0,15,9
1668573222905,MATH 281B,A00,098053,Bradic; Jelena,0,2,15,15
1668573223330,MATH 282B,A00,098054,Arias-Castro; Ery,0,1,15,15
1668573223765,MATH 285,A00,098055,Fitzsimmons; Patrick J,0,4,15,17
1668573224191,MATH 287B,A00,098056,Arias-Castro; Ery,1,0,15,14
1668573224616,MATH 288,A00,098057,Agarwal; Pooja,9,0,10,1
1668573224616,MATH 288,B00,098058,Zhang; Danna,8,0,10,2
1668573224616,MATH 288,C00,098059,Williams; Ruth J,9,0,10,1
1668573225040,MATH 290B,A00,098060,Roberts; Justin Deritter,11,0,15,4
1668573225472,MATH 292,A00,098061,Belmont; Eva Kinoshita,10,0,10,0
1668573225910,MATH 295,A00,098062,Suk; Andrew Hoon,47,0,50,3
1668573226335,MATH 296,A00,098063,Novak; Jonathan I,20,0,20,0
1668573226767,MATH 297,001,098064,Gamst; Anthony Collins,9997,0,9999,2
1668573729751,COGS 205,A00,101395,Chiba; Andrea,19,0,20,1
1668573730187,COGS 210B,001,101404,Greene; Deanna Jacquelyn,9998,0,9999,1
1668573730187,COGS 210B,002,101417,Xia; Haijun,9999,0,9999,0
1668573730187,COGS 210B,003,101422,Nitz; Douglas A.,9999,0,9999,0
1668573730187,COGS 210B,004,101423,Hollan; James D.,9998,0,9999,1
1668573730187,COGS 210B,005,101424,Deak; Gedeon O.,9998,0,9999,1
1668573730187,COGS 210B,006,101425,Rossano; Federico,9999,0,9999,0
1668573730609,COGS 211B,A00,101427,Coulson; Seana M,9996,0,9999,3
1668573731034,COGS 220,A00,101428,Hollan; James D.,0,17,25,25
1668573731460,COGS 229,A00,101429,Dow; Steven P,17,0,25,8
1668573731895,COGS 230,A00,101430,Klemmer; Scott R,6,0,17,11
1668573732322,COGS 234,A00,101431,Xia; Haijun,0,1,25,25
1668573732758,COGS 260,A00,101432,Kiyonaga; Anastasia,21,0,25,4
1668573732758,COGS 260,B00,101433,Kirsh; David Joel,15,0,25,10
1668573733182,CSE 202,A00,102371,Impagliazzo; Russell,0,70,0,0
1668573733608,CSE 203B,A01,102373,Cheng; Chung Kuan,0,70,0,0
1668573734032,CSE 208,A00,102374,Micciancio; Daniele,0,5,0,0
1668573734456,CSE 209A,A00,112895,Impagliazzo; Russell,0,14,15,15
1668573734882,CSE 209B,A00,108005,Bellare; Mihir,0,7,0,0
1668573735311,CSE 210,A00,113163,Coblenz; Michael J,0,95,0,0
1668573735736,CSE 219,A00,106111,Dow; Steven P,0,8,20,20
1668573736167,CSE 221,A00,102376,Voelker; Geoffrey M.,0,77,0,0
1668573736604,CSE 224,A01,102378,Porter; George M,0,180,0,0
1668573737029,CSE 229A,A00,102379,Savage; Stefan,0,14,0,0
1668573737469,CSE 229C,A00,102380,Munyaka; Imani N. S.,0,12,0,0
1668573737894,CSE 232B,A00,102382,Deutsch; Alin Bernard,0,39,0,0
1668573738328,CSE 234,A01,112904,Kumar; Arun Kumar,0,0,0,0
1668573738863,CSE 237A,A00,102383,Rosing; Tajana Simunic,0,57,0,0
1668573739297,CSE 239A,A00,102384,Deutsch; Alin Bernard,0,18,0,0
1668573739730,CSE 239B,A00,102385,Polikarpova; Nadezhda,0,11,0,0
1668573740152,CSE 240A,A00,102386,Pannuto; Patrick William,0,49,0,0
1668573740576,CSE 240B,A00,102387,Zhao; Jishen,0,51,0,0
1668573741010,CSE 241A,A00,106406,Kang; Mingu,0,9,0,0
1668573741436,CSE 249B,A00,102388,Kahng; Andrew Byun,0,7,8,8
1668573741886,CSE 251B,A01,102392,Cottrell; Garrison W,0,54,0,0
1668573741886,CSE 251B,A02,102393,Cottrell; Garrison W,0,36,0,0
1668573742314,CSE 252B,A00,102394,Ochoa; Benjamin Lawrence,0,65,0,0
1668573742742,CSE 257,A01,102396,Gao; Sicun,0,160,0,0
1668573743166,CSE 272,A00,102397,Li; Tzumao,0,22,0,0
1668573743594,CSE 274,A00,111323,Chern; Albert Ren-Haur,0,16,0,0
1668573744016,CSE 282,A00,102398,Pevzner; Pavel Arkadjevich,0,0,0,0
1668573744443,CSE 284,A00,114175,Gymrek; Melissa Ann,0,32,0,0
1668573744869,CSE 290,A00,102399,Chandraker; Manmohan Krishna,0,11,0,0
1668573744869,CSE 290,B00,102400,Vaccaro; Kristen Marie,0,10,25,25
1668573744869,CSE 290,C00,102414,Pannuto; Patrick William,0,1,25,25
1668573744869,CSE 290,D00,102427,Pevzner; Pavel Arkadjevich,0,0,0,0
1668573744869,CSE 290,E00,102429,Zhao; Jishen,0,6,0,0
1668573744869,CSE 290,F00,102436,Tullsen; Dean Michael,0,6,0,0
1668573744869,CSE 290,G00,102440,Christensen; Henrik I,0,8,20,20
1668573745299,CSE 291,A00,102443,Su; Hao,0,0,0,0
1668573745299,CSE 291,B00,102448,Polikarpova; Nadezhda,0,0,0,0
1668573745299,CSE 291,C00,102453,Vaccaro; Kristen Marie,0,0,0,0
1668573745299,CSE 291,D00,111343,Savage; Stefan,0,0,0,0
1668573745299,CSE 291,E00,116474,Claffy; Kimberly Claire,0,0,0,0
1668573745299,CSE 291,F00,116479,Pasquale; Joseph,0,0,0,0
1668573745730,CSE 293,001,119111,Bafna; Vineet,9999,0,9999,0
1668573745730,CSE 293,002,119118,Bellare; Mihir,9999,0,9999,0
1668573745730,CSE 293,003,119122,Berg-Kirkpatrick; Taylor D,9999,0,9999,0
1668573745730,CSE 293,004,119135,Christensen; Henrik I,9999,0,9999,0
1668573745730,CSE 293,005,119142,Cottrell; Garrison W,9999,0,9999,0
1668573745730,CSE 293,006,119146,Deutsch; Alin Bernard,9999,0,9999,0
1668573745730,CSE 293,007,119159,Esmaeilzadeh; Hadi,9999,0,9999,0
1668573745730,CSE 293,008,119166,Freund; Yoav,9999,0,9999,0
1668573745730,CSE 293,009,119170,Griswold; William G.,9999,0,9999,0
1668573745730,CSE 293,010,119183,Gymrek; Melissa Ann,9999,0,9999,0
1668573745730,CSE 293,011,119190,Heninger; Nadia A,9999,0,9999,0
1668573745730,CSE 293,012,119230,Impagliazzo; Russell,9999,0,9999,0
1668573745730,CSE 293,013,119232,Jhala; Ranjit,9999,0,9999,0
1668573745730,CSE 293,014,119233,Kahng; Andrew Byun,9999,0,9999,0
1668573745730,CSE 293,015,119298,Kane; Daniel Mertz,9999,0,9999,0
1668573745730,CSE 293,016,119299,Kriegman; David J,9999,0,9999,0
1668573745730,CSE 293,017,119300,Kumar; Arun Kumar,9999,0,9999,0
1668573745730,CSE 293,018,119301,Lerner; Sorin,9999,0,9999,0
1668573745730,CSE 293,019,119302,Lovett; Shachar,9999,0,9999,0
1668573745730,CSE 293,020,119303,McAuley; Julian John,9999,0,9999,0
1668573745730,CSE 293,021,119304,Micciancio; Daniele,9999,0,9999,0
1668573745730,CSE 293,022,119367,Orailoglu; Alex,9999,0,9999,0
1668573745730,CSE 293,023,119382,Paturi; Ramamohan,9999,0,9999,0
1668573745730,CSE 293,024,119404,Polikarpova; Nadezhda,9999,0,9999,0
1668573745730,CSE 293,025,119406,Politz; Joseph Gibbs,9999,0,9999,0
1668573745730,CSE 293,026,119411,Porter; George M,9999,0,9999,0
1668573745730,CSE 293,027,119414,Porter; Leonard Emerson,9999,0,9999,0
1668573745730,CSE 293,028,119416,Ramamoorthi; Ravi,9999,0,9999,0
1668573745730,CSE 293,029,119417,Sahoo; Debashis,9999,0,9999,0
1668573745730,CSE 293,030,119420,Saul; Lawrence,9999,0,9999,0
1668573745730,CSE 293,031,119421,Savage; Stefan,9999,0,9999,0
1668573745730,CSE 293,032,119425,Schulze; Jurgen P.,9999,0,9999,0
1668573745730,CSE 293,033,119426,Snoeren; Alex C.,9999,0,9999,0
1668573745730,CSE 293,034,119428,Shang; Jingbo,9999,0,9999,0
1668573745730,CSE 293,035,119430,Stefan; Deian,9999,0,9999,0
1668573745730,CSE 293,036,119431,Su; Hao,9999,0,9999,0
1668573745730,CSE 293,037,119433,Swanson; Steven James,9999,0,9999,0
1668573745730,CSE 293,038,119435,Tullsen; Dean Michael,9999,0,9999,0
1668573745730,CSE 293,039,119483,Voelker; Geoffrey M.,9999,0,9999,0
1668573745730,CSE 293,040,119537,Zhao; Jishen,9999,0,9999,0
1668573745730,CSE 293,041,119538,Zhou; Yuan-Yuan,9999,0,9999,0
1668573745730,CSE 293,042,119539,Gao; Sicun,9999,0,9999,0
1668573745730,CSE 293,043,119540,Weibel; Nadir,9999,0,9999,0
1668573745730,CSE 293,044,119541,Gupta; Rajesh K.,9999,0,9999,0
1668573745730,CSE 293,045,126410,Vaccaro; Kristen Marie,9999,0,9999,0
1668573745730,CSE 293,046,126411,Klemke; Richard,9999,0,9999,0
1668573746166,CSE 294,A00,102459,Voelker; Geoffrey M.,0,2,0,0
1668573746166,CSE 294,B00,111322,Orailoglu; Alex,0,2,0,0
1668573746594,DSE 201,A00,096914,Deutsch; Alin Bernard,30,0,30,0
1668573747018,DSE 210,A00,096915,Dasgupta; Sanjoy,30,0,30,0
1668573747444,DSE 260A,A00,096916,Altintas De Callaf; Ilkay,30,0,30,0
1668573747877,ECE 200,001,103586,Antipa; Nicholas A,9999,0,9999,0
1668573747877,ECE 200,002,103587,Atanasov; Nikolay A.,9999,0,9999,0
1668573747877,ECE 200,003,103588,Bharadia; Dinesh,9999,0,9999,0
1668573747877,ECE 200,004,103589,Cheng; Chung Kuan,9999,0,9999,0
1668573747877,ECE 200,005,103590,Cosman; Pamela C.,9999,0,9999,0
1668573747877,ECE 200,006,103591,Dayeh; Shadi Ahmad,9999,0,9999,0
1668573747877,ECE 200,007,103592,Fainman; Yeshaiahu,9999,0,9999,0
1668573747877,ECE 200,008,103593,Ford; Joseph Earl,9999,0,9999,0
1668573747877,ECE 200,009,103594,Franceschetti; Massimo,9999,0,9999,0
1668573747877,ECE 200,010,103595,Fullerton; Eric E,9999,0,9999,0
1668573747877,ECE 200,011,103596,Galton; Ian A,9999,0,9999,0
1668573747877,ECE 200,012,103597,Gilja; Vikash,9999,0,9999,0
1668573747877,ECE 200,013,103598,Hall; Drew A.,9999,0,9999,0
1668573747877,ECE 200,014,103599,Hsueh; Tzu-Chien,9999,0,9999,0
1668573747877,ECE 200,015,103600,Javidi; Tara,9999,0,9999,0
1668573747877,ECE 200,016,103601,Kahng; Andrew Byun,9999,0,9999,0
1668573747877,ECE 200,017,103602,Kim; Young-Han,9999,0,9999,0
1668573747877,ECE 200,018,103603,Koushanfar; Farinaz,9999,0,9999,0
1668573747877,ECE 200,019,103604,Kuzum; Duygu,9999,0,9999,0
1668573747877,ECE 200,020,103605,Le; Hanh-Phuc,9999,0,9999,0
1668573747877,ECE 200,021,103606,Lin; Bill,9999,0,9999,0
1668573747877,ECE 200,022,103607,Liu; Zhaowei,9998,0,9999,1
1668573747877,ECE 200,023,103608,Lo; Yu-Hwa,9999,0,9999,0
1668573747877,ECE 200,024,103609,Lomakin; Vitaliy,9999,0,9999,0
1668573747877,ECE 200,025,103610,Mercier; Patrick Philip,9999,0,9999,0
1668573747877,ECE 200,026,103611,Meyer; Florian,9999,0,9999,0
1668573747877,ECE 200,027,103612,Milstein; Laurence B.,9999,0,9999,0
1668573747877,ECE 200,028,103613,Mir Arabbaygi; Siavash,9999,0,9999,0
1668573747877,ECE 200,029,103614,Mookherjea; Shayan,9999,0,9999,0
1668573747877,ECE 200,030,103615,Morris; Karcher William,9999,0,9999,0
1668573747877,ECE 200,031,103616,Ng; Tse Nga,9999,0,9999,0
1668573747877,ECE 200,032,103617,Nguyen; Truong Quang,9999,0,9999,0
1668573747877,ECE 200,033,103618,Nomura; Kenji,9999,0,9999,0
1668573747877,ECE 200,034,103619,Orlitsky; Alon,9999,0,9999,0
1668573747877,ECE 200,035,103620,Pal; Piya,9999,0,9999,0
1668573747877,ECE 200,036,103621,Papen; George C.,9999,0,9999,0
1668573747877,ECE 200,037,103622,Radic; Stojan,9999,0,9999,0
1668573747877,ECE 200,038,103623,Rao; Bhaskar D.,9999,0,9999,0
1668573747877,ECE 200,039,103624,Rao; Ramesh R,9999,0,9999,0
1668573747877,ECE 200,040,103625,Rebeiz; Gabriel,9999,0,9999,0
1668573747877,ECE 200,041,103626,Sanford; John R,9999,0,9999,0
1668573747877,ECE 200,042,103627,Siegel; Paul H.,9999,0,9999,0
1668573747877,ECE 200,043,103628,Sievenpiper; Daniel F.,9999,0,9999,0
1668573747877,ECE 200,044,103629,Sworder; David D.,9999,0,9999,0
1668573747877,ECE 200,045,103630,Taur; Yuan,9999,0,9999,0
1668573747877,ECE 200,046,103631,Touri; Behrouz,9999,0,9999,0
1668573747877,ECE 200,047,103632,Trivedi; Mohan M.,9999,0,9999,0
1668573747877,ECE 200,048,103633,Vasconcelos; Nuno,9999,0,9999,0
1668573747877,ECE 200,049,103634,Wang; Xiaolong,9999,0,9999,0
1668573747877,ECE 200,050,103635,Xie; Pengtao,9999,0,9999,0
1668573747877,ECE 200,051,103636,Yip; Michael,9999,0,9999,0
1668573747877,ECE 200,052,103637,Zeger; Kenneth A.,999,0,999,0
1668573747877,ECE 200,053,103638,Zhang; Xinyu,9999,0,9999,0
1668573747877,ECE 200,054,103639,Turakhia; Yatish Girish,9999,0,9999,0
1668573747877,ECE 200,055,103640,Kang; Mingu,9999,0,9999,0
1668573747877,ECE 200,056,103641,Shi; Yuanyuan,9999,0,9999,0
1668573747877,ECE 200,057,103642,Wang; Edward Jay,9999,0,9999,0
1668573747877,ECE 200,058,103643,Zheng; Yang,9999,0,9999,0
1668573748301,ECE 202,A00,103644,Kuzum; Duygu,0,46,0,0
1668573748737,ECE 212BN,A00,103646,Ng; Tse Nga,0,10,0,0
1668573749159,ECE 221,A00,111493,Staff,0,0,0,0
1668573749596,ECE 222B,A00,103647,Lomakin; Vitaliy,0,21,0,0
1668573750021,ECE 230B,A00,103648,Taur; Yuan,0,4,0,0
1668573750456,ECE 238B,A00,103649,Garay; Javier,0,0,0,0
1668573750885,ECE 240B,A00,112900,Fainman; Yeshaiahu,0,8,0,0
1668573751312,ECE 247A,A00,103650,Jokerst; Jesse Vincent,0,6,0,0
1668573751740,ECE 247B,A00,103651,Wang; Joseph,0,15,0,0
1668573752168,ECE 250,A00,103652,Siegel; Paul H.,0,84,0,0
1668573752602,ECE 251A,A00,103654,Rao; Bhaskar D.,0,65,0,0
1668573753027,ECE 257B,A00,103655,Bharadia; Dinesh,0,33,0,0
1668573753450,ECE 258A,A00,103656,Milstein; Laurence B.,0,29,0,0
1668573753874,ECE 260B,A00,103658,Kang; Mingu,0,121,0,0
1668573754314,ECE 264A,A00,103659,Galton; Ian A,0,45,0,31
1668573754737,ECE 265A,A00,103661,Gudem; Prasad S.S.,0,46,0,31
1668573755166,ECE 265D,A00,103662,Gudem; Prasad S.S.,0,27,0,0
1668573755591,ECE 268,A00,103663,Koushanfar; Farinaz,0,44,0,0
1668573756012,ECE 269,A01,103665,Pal; Piya,0,222,0,0
1668573756437,ECE 271B,A00,103666,Vasconcelos; Manuela,0,78,0,0
1668573756861,ECE 276A,A00,103667,Atanasov; Nikolay A.,0,125,0,0
1668573757297,ECE 277,A00,103668,An; Cheolhong,0,151,0,0
1668573757721,ECE 279,A00,117947,Hall; Drew A.,0,22,0,0
1668573758578,ECE 283,A00,103670,Hsueh; Tzu-Chien,0,57,0,0
1668573759004,ECE 284,A00,103671,Turakhia; Yatish Girish,0,41,0,0
1668573759429,ECE 285,A00,103672,Zheng; Yang,0,40,0,0
1668573759429,ECE 285,B00,103673,Sworder; David D.,0,61,0,0
1668573759852,ECE 287,A00,103676,Javidi; Tara,0,8,0,0
1668573760285,MATH 200B,A00,098023,Salehi Golsefidy; Alireza,7,0,15,8
1668573760709,MATH 202B,A00,098024,Rhoades; Brendon Patrick,7,0,15,8
1668573761132,MATH 203B,A00,098025,Oprea; Dragos N.,9,0,15,6
1668573761553,MATH 204B,A00,098026,Sorensen; Claus M,13,0,15,2
1668573762031,MATH 208,A00,098027,Izadi; Elham,7,0,10,3
1668573762454,MATH 209,A00,098028,Pollack; Aaron,10,0,10,0
1668573762876,MATH 211A,A00,112919,Rogalski; Daniel,8,0,10,2
1668573763297,MATH 211B,A00,112920,Seward; Brandon M.,9,0,10,1
1668573763721,MATH 218,A00,098029,Li; Bo,10,0,10,0
1668573764162,MATH 220B,A00,098030,Novak; Jonathan I,10,0,15,5
1668573764586,MATH 221A,A00,098031,Ebenfelt; Peter F,12,0,15,3
1668573765010,MATH 231B,A00,098032,Zlatos; Andrej,9,0,15,6
1668573765443,MATH 240B,A00,098033,Ni; Lei,7,0,15,8
1668573765866,MATH 243,A00,098034,Jekel; David Andrew,10,0,10,0
1668573766290,MATH 245A,A00,098035,Nie; Jiawang,0,7,15,18
1668573766726,MATH 248,A00,098036,Bejenaru; Ioan,10,0,10,0
1668573767154,MATH 250B,A00,098037,Spolaor; Luca,12,0,15,3
1668573767575,MATH 258,A00,098038,Ni; Lei,8,0,10,2
1668573768001,MATH 264B,A00,098041,Rhoades; Brendon Patrick,7,0,15,8
1668573768424,MATH 268,A00,098042,Buss; Samuel R,10,0,10,0
1668573768860,MATH 269,A00,098043,Rhoades; Brendon Patrick,10,0,10,0
1668573769284,MATH 270B,A00,098044,Li; Bo,6,0,15,9
1668573769712,MATH 272B,A00,098045,Holst; Michael J,13,0,15,2
1668573770140,MATH 273A,A00,098046,Tian; Xiaochuan,10,0,15,5
1668573770565,MATH 275,A01,098048,Tian; Xiaochuan,6,0,10,4
1668573770990,MATH 278A,A00,098049,Holst; Michael J,6,0,10,4
1668573771415,MATH 278B,A00,098050,Cloninger; Alexander,10,0,10,0
1668573771846,MATH 278C,A00,098051,Nie; Jiawang,5,0,10,5
1668573772268,MATH 280B,A00,098052,Zheng; Tianyi,6,0,15,9
1668573772691,MATH 281B,A00,098053,Bradic; Jelena,0,2,15,15
1668573773130,MATH 282B,A00,098054,Arias-Castro; Ery,0,1,15,15
1668573773556,MATH 285,A00,098055,Fitzsimmons; Patrick J,0,4,15,16
1668573773979,MATH 287B,A00,098056,Arias-Castro; Ery,1,0,15,14
1668573774402,MATH 288,A00,098057,Agarwal; Pooja,9,0,10,1
1668573774402,MATH 288,B00,098058,Zhang; Danna,8,0,10,2
1668573774402,MATH 288,C00,098059,Williams; Ruth J,9,0,10,1
1668573774824,MATH 290B,A00,098060,Roberts; Justin Deritter,11,0,15,4
1668573775248,MATH 292,A00,098061,Belmont; Eva Kinoshita,10,0,10,0
1668573775679,MATH 295,A00,098062,Suk; Andrew Hoon,47,0,50,3
1668573776105,MATH 296,A00,098063,Novak; Jonathan I,20,0,20,0
1668573776529,MATH 297,001,098064,Gamst; Anthony Collins,9997,0,9999,2
1668574279692,COGS 205,A00,101395,Chiba; Andrea,19,0,20,1
1668574280118,COGS 210B,001,101404,Greene; Deanna Jacquelyn,9998,0,9999,1
1668574280118,COGS 210B,002,101417,Xia; Haijun,9999,0,9999,0
1668574280118,COGS 210B,003,101422,Nitz; Douglas A.,9999,0,9999,0
1668574280118,COGS 210B,004,101423,Hollan; James D.,9998,0,9999,1
1668574280118,COGS 210B,005,101424,Deak; Gedeon O.,9998,0,9999,1
1668574280118,COGS 210B,006,101425,Rossano; Federico,9999,0,9999,0
1668574280541,COGS 211B,A00,101427,Coulson; Seana M,9996,0,9999,3
1668574280963,COGS 220,A00,101428,Hollan; James D.,0,17,25,25
1668574281389,COGS 229,A00,101429,Dow; Steven P,17,0,25,8
1668574281815,COGS 230,A00,101430,Klemmer; Scott R,6,0,17,11
1668574282241,COGS 234,A00,101431,Xia; Haijun,0,1,25,25
1668574282665,COGS 260,A00,101432,Kiyonaga; Anastasia,21,0,25,4
1668574282665,COGS 260,B00,101433,Kirsh; David Joel,15,0,25,10
1668574283089,CSE 202,A00,102371,Impagliazzo; Russell,0,70,0,0
1668574283517,CSE 203B,A01,102373,Cheng; Chung Kuan,0,70,0,0
1668574283942,CSE 208,A00,102374,Micciancio; Daniele,0,5,0,0
1668574284368,CSE 209A,A00,112895,Impagliazzo; Russell,0,14,15,15
1668574284795,CSE 209B,A00,108005,Bellare; Mihir,0,7,0,0
1668574285220,CSE 210,A00,113163,Coblenz; Michael J,0,95,0,0
1668574285644,CSE 219,A00,106111,Dow; Steven P,0,8,20,20
1668574286069,CSE 221,A00,102376,Voelker; Geoffrey M.,0,77,0,0
1668574286505,CSE 224,A01,102378,Porter; George M,0,180,0,0
1668574286946,CSE 229A,A00,102379,Savage; Stefan,0,14,0,0
1668574287370,CSE 229C,A00,102380,Munyaka; Imani N. S.,0,12,0,0
1668574287796,CSE 232B,A00,102382,Deutsch; Alin Bernard,0,39,0,0
1668574288230,CSE 234,A01,112904,Kumar; Arun Kumar,0,0,0,0
1668574288667,CSE 237A,A00,102383,Rosing; Tajana Simunic,0,57,0,0
1668574289089,CSE 239A,A00,102384,Deutsch; Alin Bernard,0,18,0,0
1668574289524,CSE 239B,A00,102385,Polikarpova; Nadezhda,0,11,0,0
1668574289950,CSE 240A,A00,102386,Pannuto; Patrick William,0,49,0,0
1668574290374,CSE 240B,A00,102387,Zhao; Jishen,0,51,0,0
1668574290802,CSE 241A,A00,106406,Kang; Mingu,0,9,0,0
1668574291243,CSE 249B,A00,102388,Kahng; Andrew Byun,0,7,8,8
1668574291670,CSE 251B,A01,102392,Cottrell; Garrison W,0,54,0,0
1668574291670,CSE 251B,A02,102393,Cottrell; Garrison W,0,36,0,0
1668574292095,CSE 252B,A00,102394,Ochoa; Benjamin Lawrence,0,65,0,0
1668574292521,CSE 257,A01,102396,Gao; Sicun,0,160,0,0
1668574292952,CSE 272,A00,102397,Li; Tzumao,0,22,0,0
1668574293382,CSE 274,A00,111323,Chern; Albert Ren-Haur,0,16,0,0
1668574293805,CSE 282,A00,102398,Pevzner; Pavel Arkadjevich,0,0,0,0
1668574294231,CSE 284,A00,114175,Gymrek; Melissa Ann,0,33,0,0
1668574294655,CSE 290,A00,102399,Chandraker; Manmohan Krishna,0,11,0,0
1668574294655,CSE 290,B00,102400,Vaccaro; Kristen Marie,0,10,25,25
1668574294655,CSE 290,C00,102414,Pannuto; Patrick William,0,1,25,25
1668574294655,CSE 290,D00,102427,Pevzner; Pavel Arkadjevich,0,0,0,0
1668574294655,CSE 290,E00,102429,Zhao; Jishen,0,6,0,0
1668574294655,CSE 290,F00,102436,Tullsen; Dean Michael,0,6,0,0
1668574294655,CSE 290,G00,102440,Christensen; Henrik I,0,8,20,20
1668574295078,CSE 291,A00,102443,Su; Hao,0,0,0,0
1668574295078,CSE 291,B00,102448,Polikarpova; Nadezhda,0,0,0,0
1668574295078,CSE 291,C00,102453,Vaccaro; Kristen Marie,0,0,0,0
1668574295078,CSE 291,D00,111343,Savage; Stefan,0,0,0,0
1668574295078,CSE 291,E00,116474,Claffy; Kimberly Claire,0,0,0,0
1668574295078,CSE 291,F00,116479,Pasquale; Joseph,0,0,0,0
1668574295508,CSE 293,001,119111,Bafna; Vineet,9999,0,9999,0
1668574295508,CSE 293,002,119118,Bellare; Mihir,9999,0,9999,0
1668574295508,CSE 293,003,119122,Berg-Kirkpatrick; Taylor D,9999,0,9999,0
1668574295508,CSE 293,004,119135,Christensen; Henrik I,9999,0,9999,0
1668574295508,CSE 293,005,119142,Cottrell; Garrison W,9999,0,9999,0
1668574295508,CSE 293,006,119146,Deutsch; Alin Bernard,9999,0,9999,0
1668574295508,CSE 293,007,119159,Esmaeilzadeh; Hadi,9999,0,9999,0
1668574295508,CSE 293,008,119166,Freund; Yoav,9999,0,9999,0
1668574295508,CSE 293,009,119170,Griswold; William G.,9999,0,9999,0
1668574295508,CSE 293,010,119183,Gymrek; Melissa Ann,9999,0,9999,0
1668574295508,CSE 293,011,119190,Heninger; Nadia A,9999,0,9999,0
1668574295508,CSE 293,012,119230,Impagliazzo; Russell,9999,0,9999,0
1668574295508,CSE 293,013,119232,Jhala; Ranjit,9999,0,9999,0
1668574295508,CSE 293,014,119233,Kahng; Andrew Byun,9999,0,9999,0
1668574295508,CSE 293,015,119298,Kane; Daniel Mertz,9999,0,9999,0
1668574295508,CSE 293,016,119299,Kriegman; David J,9999,0,9999,0
1668574295508,CSE 293,017,119300,Kumar; Arun Kumar,9999,0,9999,0
1668574295508,CSE 293,018,119301,Lerner; Sorin,9999,0,9999,0
1668574295508,CSE 293,019,119302,Lovett; Shachar,9999,0,9999,0
1668574295508,CSE 293,020,119303,McAuley; Julian John,9999,0,9999,0
1668574295508,CSE 293,021,119304,Micciancio; Daniele,9999,0,9999,0
1668574295508,CSE 293,022,119367,Orailoglu; Alex,9999,0,9999,0
1668574295508,CSE 293,023,119382,Paturi; Ramamohan,9999,0,9999,0
1668574295508,CSE 293,024,119404,Polikarpova; Nadezhda,9999,0,9999,0
1668574295508,CSE 293,025,119406,Politz; Joseph Gibbs,9999,0,9999,0
1668574295508,CSE 293,026,119411,Porter; George M,9999,0,9999,0
1668574295508,CSE 293,027,119414,Porter; Leonard Emerson,9999,0,9999,0
1668574295508,CSE 293,028,119416,Ramamoorthi; Ravi,9999,0,9999,0
1668574295508,CSE 293,029,119417,Sahoo; Debashis,9999,0,9999,0
1668574295508,CSE 293,030,119420,Saul; Lawrence,9999,0,9999,0
1668574295508,CSE 293,031,119421,Savage; Stefan,9999,0,9999,0
1668574295508,CSE 293,032,119425,Schulze; Jurgen P.,9999,0,9999,0
1668574295508,CSE 293,033,119426,Snoeren; Alex C.,9999,0,9999,0
1668574295508,CSE 293,034,119428,Shang; Jingbo,9999,0,9999,0
1668574295508,CSE 293,035,119430,Stefan; Deian,9999,0,9999,0
1668574295508,CSE 293,036,119431,Su; Hao,9999,0,9999,0
1668574295508,CSE 293,037,119433,Swanson; Steven James,9999,0,9999,0
1668574295508,CSE 293,038,119435,Tullsen; Dean Michael,9999,0,9999,0
1668574295508,CSE 293,039,119483,Voelker; Geoffrey M.,9999,0,9999,0
1668574295508,CSE 293,040,119537,Zhao; Jishen,9999,0,9999,0
1668574295508,CSE 293,041,119538,Zhou; Yuan-Yuan,9999,0,9999,0
1668574295508,CSE 293,042,119539,Gao; Sicun,9999,0,9999,0
1668574295508,CSE 293,043,119540,Weibel; Nadir,9999,0,9999,0
1668574295508,CSE 293,044,119541,Gupta; Rajesh K.,9999,0,9999,0
1668574295508,CSE 293,045,126410,Vaccaro; Kristen Marie,9999,0,9999,0
1668574295508,CSE 293,046,126411,Klemke; Richard,9999,0,9999,0
1668574295942,CSE 294,A00,102459,Voelker; Geoffrey M.,0,2,0,0
1668574295942,CSE 294,B00,111322,Orailoglu; Alex,0,2,0,0
1668574296381,DSE 201,A00,096914,Deutsch; Alin Bernard,30,0,30,0
1668574296805,DSE 210,A00,096915,Dasgupta; Sanjoy,30,0,30,0
1668574297240,DSE 260A,A00,096916,Altintas De Callaf; Ilkay,30,0,30,0
1668574297697,ECE 200,001,103586,Antipa; Nicholas A,9999,0,9999,0
1668574297697,ECE 200,002,103587,Atanasov; Nikolay A.,9999,0,9999,0
1668574297697,ECE 200,003,103588,Bharadia; Dinesh,9999,0,9999,0
1668574297697,ECE 200,004,103589,Cheng; Chung Kuan,9999,0,9999,0
1668574297697,ECE 200,005,103590,Cosman; Pamela C.,9999,0,9999,0
1668574297697,ECE 200,006,103591,Dayeh; Shadi Ahmad,9999,0,9999,0
1668574297697,ECE 200,007,103592,Fainman; Yeshaiahu,9999,0,9999,0
1668574297697,ECE 200,008,103593,Ford; Joseph Earl,9999,0,9999,0
1668574297697,ECE 200,009,103594,Franceschetti; Massimo,9999,0,9999,0
1668574297697,ECE 200,010,103595,Fullerton; Eric E,9999,0,9999,0
1668574297697,ECE 200,011,103596,Galton; Ian A,9999,0,9999,0
1668574297697,ECE 200,012,103597,Gilja; Vikash,9999,0,9999,0
1668574297697,ECE 200,013,103598,Hall; Drew A.,9999,0,9999,0
1668574297697,ECE 200,014,103599,Hsueh; Tzu-Chien,9999,0,9999,0
1668574297697,ECE 200,015,103600,Javidi; Tara,9999,0,9999,0
1668574297697,ECE 200,016,103601,Kahng; Andrew Byun,9999,0,9999,0
1668574297697,ECE 200,017,103602,Kim; Young-Han,9999,0,9999,0
1668574297697,ECE 200,018,103603,Koushanfar; Farinaz,9999,0,9999,0
1668574297697,ECE 200,019,103604,Kuzum; Duygu,9999,0,9999,0
1668574297697,ECE 200,020,103605,Le; Hanh-Phuc,9999,0,9999,0
1668574297697,ECE 200,021,103606,Lin; Bill,9999,0,9999,0
1668574297697,ECE 200,022,103607,Liu; Zhaowei,9998,0,9999,1
1668574297697,ECE 200,023,103608,Lo; Yu-Hwa,9999,0,9999,0
1668574297697,ECE 200,024,103609,Lomakin; Vitaliy,9999,0,9999,0
1668574297697,ECE 200,025,103610,Mercier; Patrick Philip,9999,0,9999,0
1668574297697,ECE 200,026,103611,Meyer; Florian,9999,0,9999,0
1668574297697,ECE 200,027,103612,Milstein; Laurence B.,9999,0,9999,0
1668574297697,ECE 200,028,103613,Mir Arabbaygi; Siavash,9999,0,9999,0
1668574297697,ECE 200,029,103614,Mookherjea; Shayan,9999,0,9999,0
1668574297697,ECE 200,030,103615,Morris; Karcher William,9999,0,9999,0
1668574297697,ECE 200,031,103616,Ng; Tse Nga,9999,0,9999,0
1668574297697,ECE 200,032,103617,Nguyen; Truong Quang,9999,0,9999,0
1668574297697,ECE 200,033,103618,Nomura; Kenji,9999,0,9999,0
1668574297697,ECE 200,034,103619,Orlitsky; Alon,9999,0,9999,0
1668574297697,ECE 200,035,103620,Pal; Piya,9999,0,9999,0
1668574297697,ECE 200,036,103621,Papen; George C.,9999,0,9999,0
1668574297697,ECE 200,037,103622,Radic; Stojan,9999,0,9999,0
1668574297697,ECE 200,038,103623,Rao; Bhaskar D.,9999,0,9999,0
1668574297697,ECE 200,039,103624,Rao; Ramesh R,9999,0,9999,0
1668574297697,ECE 200,040,103625,Rebeiz; Gabriel,9999,0,9999,0
1668574297697,ECE 200,041,103626,Sanford; John R,9999,0,9999,0
1668574297697,ECE 200,042,103627,Siegel; Paul H.,9999,0,9999,0
1668574297697,ECE 200,043,103628,Sievenpiper; Daniel F.,9999,0,9999,0
1668574297697,ECE 200,044,103629,Sworder; David D.,9999,0,9999,0
1668574297697,ECE 200,045,103630,Taur; Yuan,9999,0,9999,0
1668574297697,ECE 200,046,103631,Touri; Behrouz,9999,0,9999,0
1668574297697,ECE 200,047,103632,Trivedi; Mohan M.,9999,0,9999,0
1668574297697,ECE 200,048,103633,Vasconcelos; Nuno,9999,0,9999,0
1668574297697,ECE 200,049,103634,Wang; Xiaolong,9999,0,9999,0
1668574297697,ECE 200,050,103635,Xie; Pengtao,9999,0,9999,0
1668574297697,ECE 200,051,103636,Yip; Michael,9999,0,9999,0
1668574297697,ECE 200,052,103637,Zeger; Kenneth A.,999,0,999,0
1668574297697,ECE 200,053,103638,Zhang; Xinyu,9999,0,9999,0
1668574297697,ECE 200,054,103639,Turakhia; Yatish Girish,9999,0,9999,0
1668574297697,ECE 200,055,103640,Kang; Mingu,9999,0,9999,0
1668574297697,ECE 200,056,103641,Shi; Yuanyuan,9999,0,9999,0
1668574297697,ECE 200,057,103642,Wang; Edward Jay,9999,0,9999,0
1668574297697,ECE 200,058,103643,Zheng; Yang,9999,0,9999,0
1668574298120,ECE 202,A00,103644,Kuzum; Duygu,0,46,0,0
1668574298572,ECE 212BN,A00,103646,Ng; Tse Nga,0,10,0,0
1668574298998,ECE 221,A00,111493,Staff,0,0,0,0
1668574299427,ECE 222B,A00,103647,Lomakin; Vitaliy,0,21,0,0
1668574299855,ECE 230B,A00,103648,Taur; Yuan,0,4,0,0
1668574300281,ECE 238B,A00,103649,Garay; Javier,0,0,0,0
1668574300704,ECE 240B,A00,112900,Fainman; Yeshaiahu,0,8,0,0
1668574301137,ECE 247A,A00,103650,Jokerst; Jesse Vincent,0,6,0,0
1668574301565,ECE 247B,A00,103651,Wang; Joseph,0,15,0,0
1668574301995,ECE 250,A00,103652,Siegel; Paul H.,0,84,0,0
1668574302424,ECE 251A,A00,103654,Rao; Bhaskar D.,0,65,0,0
1668574302859,ECE 257B,A00,103655,Bharadia; Dinesh,0,33,0,0
1668574303287,ECE 258A,A00,103656,Milstein; Laurence B.,0,29,0,0
1668574303800,ECE 260B,A00,103658,Kang; Mingu,0,121,0,0
1668574304224,ECE 264A,A00,103659,Galton; Ian A,0,45,0,31
1668574304651,ECE 265A,A00,103661,Gudem; Prasad S.S.,0,46,0,31
1668574305074,ECE 265D,A00,103662,Gudem; Prasad S.S.,0,27,0,0
1668574305505,ECE 268,A00,103663,Koushanfar; Farinaz,0,44,0,0
1668574305932,ECE 269,A01,103665,Pal; Piya,0,222,0,0
1668574306356,ECE 271B,A00,103666,Vasconcelos; Manuela,0,78,0,0
1668574306779,ECE 276A,A00,103667,Atanasov; Nikolay A.,0,125,0,0
1668574307203,ECE 277,A00,103668,An; Cheolhong,0,151,0,0
1668574307627,ECE 279,A00,117947,Hall; Drew A.,0,22,0,0
1668574308486,ECE 283,A00,103670,Hsueh; Tzu-Chien,0,57,0,0
1668574308912,ECE 284,A00,103671,Turakhia; Yatish Girish,0,40,0,0
1668574309340,ECE 285,A00,103672,Zheng; Yang,0,41,0,0
1668574309340,ECE 285,B00,103673,Sworder; David D.,0,61,0,0
1668574309763,ECE 287,A00,103676,Javidi; Tara,0,8,0,0
1668574310186,MATH 200B,A00,098023,Salehi Golsefidy; Alireza,7,0,15,8
1668574310609,MATH 202B,A00,098024,Rhoades; Brendon Patrick,7,0,15,8
1668574311032,MATH 203B,A00,098025,Oprea; Dragos N.,9,0,15,6
1668574311466,MATH 204B,A00,098026,Sorensen; Claus M,13,0,15,2
1668574311888,MATH 208,A00,098027,Izadi; Elham,7,0,10,3
1668574312313,MATH 209,A00,098028,Pollack; Aaron,10,0,10,0
1668574312753,MATH 211A,A00,112919,Rogalski; Daniel,8,0,10,2
1668574313178,MATH 211B,A00,112920,Seward; Brandon M.,9,0,10,1
1668574313605,MATH 218,A00,098029,Li; Bo,10,0,10,0
1668574314032,MATH 220B,A00,098030,Novak; Jonathan I,10,0,15,5
1668574314454,MATH 221A,A00,098031,Ebenfelt; Peter F,12,0,15,3
1668574314880,MATH 231B,A00,098032,Zlatos; Andrej,9,0,15,6
1668574315302,MATH 240B,A00,098033,Ni; Lei,7,0,15,8
1668574315732,MATH 243,A00,098034,Jekel; David Andrew,10,0,10,0
1668574316157,MATH 245A,A00,098035,Nie; Jiawang,0,7,15,18
1668574316584,MATH 248,A00,098036,Bejenaru; Ioan,10,0,10,0
1668574317011,MATH 250B,A00,098037,Spolaor; Luca,12,0,15,3
1668574317436,MATH 258,A00,098038,Ni; Lei,8,0,10,2
1668574317859,MATH 264B,A00,098041,Rhoades; Brendon Patrick,7,0,15,8
1668574318284,MATH 268,A00,098042,Buss; Samuel R,10,0,10,0
1668574318708,MATH 269,A00,098043,Rhoades; Brendon Patrick,10,0,10,0
1668574319134,MATH 270B,A00,098044,Li; Bo,6,0,15,9
1668574319558,MATH 272B,A00,098045,Holst; Michael J,13,0,15,2
1668574319982,MATH 273A,A00,098046,Tian; Xiaochuan,10,0,15,5
1668574320410,MATH 275,A01,098048,Tian; Xiaochuan,6,0,10,4
1668574320835,MATH 278A,A00,098049,Holst; Michael J,6,0,10,4
1668574321261,MATH 278B,A00,098050,Cloninger; Alexander,10,0,10,0
1668574321706,MATH 278C,A00,098051,Nie; Jiawang,5,0,10,5
1668574322132,MATH 280B,A00,098052,Zheng; Tianyi,6,0,15,9
1668574322558,MATH 281B,A00,098053,Bradic; Jelena,0,2,15,15
1668574322982,MATH 282B,A00,098054,Arias-Castro; Ery,0,1,15,15
1668574323406,MATH 285,A00,098055,Fitzsimmons; Patrick J,0,4,15,16
1668574323828,MATH 287B,A00,098056,Arias-Castro; Ery,1,0,15,14
1668574324252,MATH 288,A00,098057,Agarwal; Pooja,9,0,10,1
1668574324252,MATH 288,B00,098058,Zhang; Danna,8,0,10,2
1668574324252,MATH 288,C00,098059,Williams; Ruth J,9,0,10,1
1668574324688,MATH 290B,A00,098060,Roberts; Justin Deritter,12,0,15,3
1668574325111,MATH 292,A00,098061,Belmont; Eva Kinoshita,10,0,10,0
1668574325534,MATH 295,A00,098062,Suk; Andrew Hoon,47,0,50,3
1668574325958,MATH 296,A00,098063,Novak; Jonathan I,20,0,20,0
1668574326382,MATH 297,001,098064,Gamst; Anthony Collins,9997,0,9999,2
1668574828622,COGS 205,A00,101395,Chiba; Andrea,19,0,20,1
1668574829046,COGS 210B,001,101404,Greene; Deanna Jacquelyn,9998,0,9999,1
1668574829046,COGS 210B,002,101417,Xia; Haijun,9999,0,9999,0
1668574829046,COGS 210B,003,101422,Nitz; Douglas A.,9999,0,9999,0
1668574829046,COGS 210B,004,101423,Hollan; James D.,9998,0,9999,1
1668574829046,COGS 210B,005,101424,Deak; Gedeon O.,9998,0,9999,1
1668574829046,COGS 210B,006,101425,Rossano; Federico,9999,0,9999,0
1668574829479,COGS 211B,A00,101427,Coulson; Seana M,9996,0,9999,3
1668574829905,COGS 220,A00,101428,Hollan; James D.,0,17,25,25
1668574830333,COGS 229,A00,101429,Dow; Steven P,17,0,25,8
1668574830757,COGS 230,A00,101430,Klemmer; Scott R,6,0,17,11
1668574831181,COGS 234,A00,101431,Xia; Haijun,0,1,25,25
1668574831605,COGS 260,A00,101432,Kiyonaga; Anastasia,21,0,25,4
1668574831605,COGS 260,B00,101433,Kirsh; David Joel,15,0,25,10
1668574832029,CSE 202,A00,102371,Impagliazzo; Russell,0,70,0,0
1668574832452,CSE 203B,A01,102373,Cheng; Chung Kuan,0,70,0,0
1668574832877,CSE 208,A00,102374,Micciancio; Daniele,0,5,0,0
1668574833300,CSE 209A,A00,112895,Impagliazzo; Russell,0,14,15,15
1668574833727,CSE 209B,A00,108005,Bellare; Mihir,0,7,0,0
1668574834153,CSE 210,A00,113163,Coblenz; Michael J,0,95,0,0
1668574834577,CSE 219,A00,106111,Dow; Steven P,0,8,20,20
1668574835000,CSE 221,A00,102376,Voelker; Geoffrey M.,0,77,0,0
1668574835428,CSE 224,A01,102378,Porter; George M,0,180,0,0
1668574835854,CSE 229A,A00,102379,Savage; Stefan,0,14,0,0
1668574836276,CSE 229C,A00,102380,Munyaka; Imani N. S.,0,12,0,0
1668574836700,CSE 232B,A00,102382,Deutsch; Alin Bernard,0,39,0,0
1668574837137,CSE 234,A01,112904,Kumar; Arun Kumar,0,0,0,0
1668574837570,CSE 237A,A00,102383,Rosing; Tajana Simunic,0,57,0,0
1668574837996,CSE 239A,A00,102384,Deutsch; Alin Bernard,0,18,0,0
1668574838419,CSE 239B,A00,102385,Polikarpova; Nadezhda,0,11,0,0
1668574838856,CSE 240A,A00,102386,Pannuto; Patrick William,0,49,0,0
1668574839282,CSE 240B,A00,102387,Zhao; Jishen,0,51,0,0
1668574839712,CSE 241A,A00,106406,Kang; Mingu,0,9,0,0
1668574840137,CSE 249B,A00,102388,Kahng; Andrew Byun,0,7,8,8
1668574840572,CSE 251B,A01,102392,Cottrell; Garrison W,0,54,0,0
1668574840572,CSE 251B,A02,102393,Cottrell; Garrison W,0,36,0,0
1668574841004,CSE 252B,A00,102394,Ochoa; Benjamin Lawrence,0,65,0,0
1668574841426,CSE 257,A01,102396,Gao; Sicun,0,160,0,0
1668574841852,CSE 272,A00,102397,Li; Tzumao,0,22,0,0
1668574842278,CSE 274,A00,111323,Chern; Albert Ren-Haur,0,16,0,0
1668574842703,CSE 282,A00,102398,Pevzner; Pavel Arkadjevich,0,0,0,0
1668574843142,CSE 284,A00,114175,Gymrek; Melissa Ann,0,33,0,0
1668574843566,CSE 290,A00,102399,Chandraker; Manmohan Krishna,0,11,0,0
1668574843566,CSE 290,B00,102400,Vaccaro; Kristen Marie,0,10,25,25
1668574843566,CSE 290,C00,102414,Pannuto; Patrick William,0,1,25,25
1668574843566,CSE 290,D00,102427,Pevzner; Pavel Arkadjevich,0,0,0,0
1668574843566,CSE 290,E00,102429,Zhao; Jishen,0,6,0,0
1668574843566,CSE 290,F00,102436,Tullsen; Dean Michael,0,6,0,0
1668574843566,CSE 290,G00,102440,Christensen; Henrik I,0,8,20,20
1668574843994,CSE 291,A00,102443,Su; Hao,0,0,0,0
1668574843994,CSE 291,B00,102448,Polikarpova; Nadezhda,0,0,0,0
1668574843994,CSE 291,C00,102453,Vaccaro; Kristen Marie,0,0,0,0
1668574843994,CSE 291,D00,111343,Savage; Stefan,0,0,0,0
1668574843994,CSE 291,E00,116474,Claffy; Kimberly Claire,0,0,0,0
1668574843994,CSE 291,F00,116479,Pasquale; Joseph,0,0,0,0
1668574844438,CSE 293,001,119111,Bafna; Vineet,9999,0,9999,0
1668574844438,CSE 293,002,119118,Bellare; Mihir,9999,0,9999,0
1668574844438,CSE 293,003,119122,Berg-Kirkpatrick; Taylor D,9999,0,9999,0
1668574844438,CSE 293,004,119135,Christensen; Henrik I,9999,0,9999,0
1668574844438,CSE 293,005,119142,Cottrell; Garrison W,9999,0,9999,0
1668574844438,CSE 293,006,119146,Deutsch; Alin Bernard,9999,0,9999,0
1668574844438,CSE 293,007,119159,Esmaeilzadeh; Hadi,9999,0,9999,0
1668574844438,CSE 293,008,119166,Freund; Yoav,9999,0,9999,0
1668574844438,CSE 293,009,119170,Griswold; William G.,9999,0,9999,0
1668574844438,CSE 293,010,119183,Gymrek; Melissa Ann,9999,0,9999,0
1668574844438,CSE 293,011,119190,Heninger; Nadia A,9999,0,9999,0
1668574844438,CSE 293,012,119230,Impagliazzo; Russell,9999,0,9999,0
1668574844438,CSE 293,013,119232,Jhala; Ranjit,9999,0,9999,0
1668574844438,CSE 293,014,119233,Kahng; Andrew Byun,9999,0,9999,0
1668574844438,CSE 293,015,119298,Kane; Daniel Mertz,9999,0,9999,0
1668574844438,CSE 293,016,119299,Kriegman; David J,9999,0,9999,0
1668574844438,CSE 293,017,119300,Kumar; Arun Kumar,9999,0,9999,0
1668574844438,CSE 293,018,119301,Lerner; Sorin,9999,0,9999,0
1668574844438,CSE 293,019,119302,Lovett; Shachar,9999,0,9999,0
1668574844438,CSE 293,020,119303,McAuley; Julian John,9999,0,9999,0
1668574844438,CSE 293,021,119304,Micciancio; Daniele,9999,0,9999,0
1668574844438,CSE 293,022,119367,Orailoglu; Alex,9999,0,9999,0
1668574844438,CSE 293,023,119382,Paturi; Ramamohan,9999,0,9999,0
1668574844438,CSE 293,024,119404,Polikarpova; Nadezhda,9999,0,9999,0
1668574844438,CSE 293,025,119406,Politz; Joseph Gibbs,9999,0,9999,0
1668574844438,CSE 293,026,119411,Porter; George M,9999,0,9999,0
1668574844438,CSE 293,027,119414,Porter; Leonard Emerson,9999,0,9999,0
1668574844438,CSE 293,028,119416,Ramamoorthi; Ravi,9999,0,9999,0
1668574844438,CSE 293,029,119417,Sahoo; Debashis,9999,0,9999,0
1668574844438,CSE 293,030,119420,Saul; Lawrence,9999,0,9999,0
1668574844438,CSE 293,031,119421,Savage; Stefan,9999,0,9999,0
1668574844438,CSE 293,032,119425,Schulze; Jurgen P.,9999,0,9999,0
1668574844438,CSE 293,033,119426,Snoeren; Alex C.,9999,0,9999,0
1668574844438,CSE 293,034,119428,Shang; Jingbo,9999,0,9999,0
1668574844438,CSE 293,035,119430,Stefan; Deian,9999,0,9999,0
1668574844438,CSE 293,036,119431,Su; Hao,9999,0,9999,0
1668574844438,CSE 293,037,119433,Swanson; Steven James,9999,0,9999,0
1668574844438,CSE 293,038,119435,Tullsen; Dean Michael,9999,0,9999,0
1668574844438,CSE 293,039,119483,Voelker; Geoffrey M.,9999,0,9999,0
1668574844438,CSE 293,040,119537,Zhao; Jishen,9999,0,9999,0
1668574844438,CSE 293,041,119538,Zhou; Yuan-Yuan,9999,0,9999,0
1668574844438,CSE 293,042,119539,Gao; Sicun,9999,0,9999,0
1668574844438,CSE 293,043,119540,Weibel; Nadir,9999,0,9999,0
1668574844438,CSE 293,044,119541,Gupta; Rajesh K.,9999,0,9999,0
1668574844438,CSE 293,045,126410,Vaccaro; Kristen Marie,9999,0,9999,0
1668574844438,CSE 293,046,126411,Klemke; Richard,9999,0,9999,0
1668574844861,CSE 294,A00,102459,Voelker; Geoffrey M.,0,2,0,0
1668574844861,CSE 294,B00,111322,Orailoglu; Alex,0,2,0,0
1668574845284,DSE 201,A00,096914,Deutsch; Alin Bernard,30,0,30,0
1668574845713,DSE 210,A00,096915,Dasgupta; Sanjoy,30,0,30,0
1668574846137,DSE 260A,A00,096916,Altintas De Callaf; Ilkay,30,0,30,0
1668574846573,ECE 200,001,103586,Antipa; Nicholas A,9999,0,9999,0
1668574846573,ECE 200,002,103587,Atanasov; Nikolay A.,9999,0,9999,0
1668574846573,ECE 200,003,103588,Bharadia; Dinesh,9999,0,9999,0
1668574846573,ECE 200,004,103589,Cheng; Chung Kuan,9999,0,9999,0
1668574846573,ECE 200,005,103590,Cosman; Pamela C.,9999,0,9999,0
1668574846573,ECE 200,006,103591,Dayeh; Shadi Ahmad,9999,0,9999,0
1668574846573,ECE 200,007,103592,Fainman; Yeshaiahu,9999,0,9999,0
1668574846573,ECE 200,008,103593,Ford; Joseph Earl,9999,0,9999,0
1668574846573,ECE 200,009,103594,Franceschetti; Massimo,9999,0,9999,0
1668574846573,ECE 200,010,103595,Fullerton; Eric E,9999,0,9999,0
1668574846573,ECE 200,011,103596,Galton; Ian A,9999,0,9999,0
1668574846573,ECE 200,012,103597,Gilja; Vikash,9999,0,9999,0
1668574846573,ECE 200,013,103598,Hall; Drew A.,9999,0,9999,0
1668574846573,ECE 200,014,103599,Hsueh; Tzu-Chien,9999,0,9999,0
1668574846573,ECE 200,015,103600,Javidi; Tara,9999,0,9999,0
1668574846573,ECE 200,016,103601,Kahng; Andrew Byun,9999,0,9999,0
1668574846573,ECE 200,017,103602,Kim; Young-Han,9999,0,9999,0
1668574846573,ECE 200,018,103603,Koushanfar; Farinaz,9999,0,9999,0
1668574846573,ECE 200,019,103604,Kuzum; Duygu,9999,0,9999,0
1668574846573,ECE 200,020,103605,Le; Hanh-Phuc,9999,0,9999,0
1668574846573,ECE 200,021,103606,Lin; Bill,9999,0,9999,0
1668574846573,ECE 200,022,103607,Liu; Zhaowei,9998,0,9999,1
1668574846573,ECE 200,023,103608,Lo; Yu-Hwa,9999,0,9999,0
1668574846573,ECE 200,024,103609,Lomakin; Vitaliy,9999,0,9999,0
1668574846573,ECE 200,025,103610,Mercier; Patrick Philip,9999,0,9999,0
1668574846573,ECE 200,026,103611,Meyer; Florian,9999,0,9999,0
1668574846573,ECE 200,027,103612,Milstein; Laurence B.,9999,0,9999,0
1668574846573,ECE 200,028,103613,Mir Arabbaygi; Siavash,9999,0,9999,0
1668574846573,ECE 200,029,103614,Mookherjea; Shayan,9999,0,9999,0
1668574846573,ECE 200,030,103615,Morris; Karcher William,9999,0,9999,0
1668574846573,ECE 200,031,103616,Ng; Tse Nga,9999,0,9999,0
1668574846573,ECE 200,032,103617,Nguyen; Truong Quang,9999,0,9999,0
1668574846573,ECE 200,033,103618,Nomura; Kenji,9999,0,9999,0
1668574846573,ECE 200,034,103619,Orlitsky; Alon,9999,0,9999,0
1668574846573,ECE 200,035,103620,Pal; Piya,9999,0,9999,0
1668574846573,ECE 200,036,103621,Papen; George C.,9999,0,9999,0
1668574846573,ECE 200,037,103622,Radic; Stojan,9999,0,9999,0
1668574846573,ECE 200,038,103623,Rao; Bhaskar D.,9999,0,9999,0
1668574846573,ECE 200,039,103624,Rao; Ramesh R,9999,0,9999,0
1668574846573,ECE 200,040,103625,Rebeiz; Gabriel,9999,0,9999,0
1668574846573,ECE 200,041,103626,Sanford; John R,9999,0,9999,0
1668574846573,ECE 200,042,103627,Siegel; Paul H.,9999,0,9999,0
1668574846573,ECE 200,043,103628,Sievenpiper; Daniel F.,9999,0,9999,0
1668574846573,ECE 200,044,103629,Sworder; David D.,9999,0,9999,0
1668574846573,ECE 200,045,103630,Taur; Yuan,9999,0,9999,0
1668574846573,ECE 200,046,103631,Touri; Behrouz,9999,0,9999,0
1668574846573,ECE 200,047,103632,Trivedi; Mohan M.,9999,0,9999,0
1668574846573,ECE 200,048,103633,Vasconcelos; Nuno,9999,0,9999,0
1668574846573,ECE 200,049,103634,Wang; Xiaolong,9999,0,9999,0
1668574846573,ECE 200,050,103635,Xie; Pengtao,9999,0,9999,0
1668574846573,ECE 200,051,103636,Yip; Michael,9999,0,9999,0
1668574846573,ECE 200,052,103637,Zeger; Kenneth A.,999,0,999,0
1668574846573,ECE 200,053,103638,Zhang; Xinyu,9999,0,9999,0
1668574846573,ECE 200,054,103639,Turakhia; Yatish Girish,9999,0,9999,0
1668574846573,ECE 200,055,103640,Kang; Mingu,9999,0,9999,0
1668574846573,ECE 200,056,103641,Shi; Yuanyuan,9999,0,9999,0
1668574846573,ECE 200,057,103642,Wang; Edward Jay,9999,0,9999,0
1668574846573,ECE 200,058,103643,Zheng; Yang,9999,0,9999,0
1668574847003,ECE 202,A00,103644,Kuzum; Duygu,0,46,0,0
1668574847427,ECE 212BN,A00,103646,Ng; Tse Nga,0,10,0,0
1668574847852,ECE 221,A00,111493,Staff,0,0,0,0
1668574848275,ECE 222B,A00,103647,Lomakin; Vitaliy,0,21,0,0
1668574848708,ECE 230B,A00,103648,Taur; Yuan,0,4,0,0
1668574849137,ECE 238B,A00,103649,Garay; Javier,0,0,0,0
1668574849560,ECE 240B,A00,112900,Fainman; Yeshaiahu,0,8,0,0
1668574849986,ECE 247A,A00,103650,Jokerst; Jesse Vincent,0,6,0,0
1668574850418,ECE 247B,A00,103651,Wang; Joseph,0,15,0,0
1668574850852,ECE 250,A00,103652,Siegel; Paul H.,0,84,0,0
1668574851288,ECE 251A,A00,103654,Rao; Bhaskar D.,0,65,0,0
1668574851710,ECE 257B,A00,103655,Bharadia; Dinesh,0,33,0,0
1668574852137,ECE 258A,A00,103656,Milstein; Laurence B.,0,29,0,0
1668574852569,ECE 260B,A00,103658,Kang; Mingu,0,121,0,0
1668574852994,ECE 264A,A00,103659,Galton; Ian A,0,45,0,31
1668574853417,ECE 265A,A00,103661,Gudem; Prasad S.S.,0,46,0,31
1668574853841,ECE 265D,A00,103662,Gudem; Prasad S.S.,0,27,0,0
1668574854267,ECE 268,A00,103663,Koushanfar; Farinaz,0,44,0,0
1668574854693,ECE 269,A01,103665,Pal; Piya,0,222,0,0
1668574855115,ECE 271B,A00,103666,Vasconcelos; Manuela,0,78,0,0
1668574855547,ECE 276A,A00,103667,Atanasov; Nikolay A.,0,125,0,0
1668574855975,ECE 277,A00,103668,An; Cheolhong,0,151,0,0
1668574856400,ECE 279,A00,117947,Hall; Drew A.,0,22,0,0
1668574857254,ECE 283,A00,103670,Hsueh; Tzu-Chien,0,57,0,0
1668574857676,ECE 284,A00,103671,Turakhia; Yatish Girish,0,40,0,0
1668574858100,ECE 285,A00,103672,Zheng; Yang,0,41,0,0
1668574858100,ECE 285,B00,103673,Sworder; David D.,0,61,0,0
1668574858525,ECE 287,A00,103676,Javidi; Tara,0,8,0,0
1668574858956,MATH 200B,A00,098023,Salehi Golsefidy; Alireza,7,0,15,8
1668574859387,MATH 202B,A00,098024,Rhoades; Brendon Patrick,7,0,15,8
1668574859830,MATH 203B,A00,098025,Oprea; Dragos N.,9,0,15,6
1668574860260,MATH 204B,A00,098026,Sorensen; Claus M,13,0,15,2
1668574860684,MATH 208,A00,098027,Izadi; Elham,7,0,10,3
1668574861109,MATH 209,A00,098028,Pollack; Aaron,10,0,10,0
1668574861545,MATH 211A,A00,112919,Rogalski; Daniel,8,0,10,2
1668574861989,MATH 211B,A00,112920,Seward; Brandon M.,9,0,10,1
1668574862414,MATH 218,A00,098029,Li; Bo,10,0,10,0
1668574862860,MATH 220B,A00,098030,Novak; Jonathan I,10,0,15,5
1668574863295,MATH 221A,A00,098031,Ebenfelt; Peter F,12,0,15,3
1668574863728,MATH 231B,A00,098032,Zlatos; Andrej,9,0,15,6
1668574864152,MATH 240B,A00,098033,Ni; Lei,7,0,15,8
1668574864591,MATH 243,A00,098034,Jekel; David Andrew,10,0,10,0
1668574865017,MATH 245A,A00,098035,Nie; Jiawang,0,7,15,18
1668574865441,MATH 248,A00,098036,Bejenaru; Ioan,10,0,10,0
1668574865864,MATH 250B,A00,098037,Spolaor; Luca,12,0,15,3
1668574866286,MATH 258,A00,098038,Ni; Lei,8,0,10,2
1668574866710,MATH 264B,A00,098041,Rhoades; Brendon Patrick,7,0,15,8
1668574867141,MATH 268,A00,098042,Buss; Samuel R,10,0,10,0
1668574867677,MATH 269,A00,098043,Rhoades; Brendon Patrick,10,0,10,0
1668574868104,MATH 270B,A00,098044,Li; Bo,6,0,15,9
1668574868529,MATH 272B,A00,098045,Holst; Michael J,13,0,15,2
1668574868964,MATH 273A,A00,098046,Tian; Xiaochuan,10,0,15,5
1668574869389,MATH 275,A01,098048,Tian; Xiaochuan,6,0,10,4
1668574869820,MATH 278A,A00,098049,Holst; Michael J,6,0,10,4
1668574870246,MATH 278B,A00,098050,Cloninger; Alexander,10,0,10,0
1668574870670,MATH 278C,A00,098051,Nie; Jiawang,5,0,10,5
1668574871101,MATH 280B,A00,098052,Zheng; Tianyi,6,0,15,9
1668574871535,MATH 281B,A00,098053,Bradic; Jelena,0,2,15,15
1668574871962,MATH 282B,A00,098054,Arias-Castro; Ery,0,1,15,15
1668574872385,MATH 285,A00,098055,Fitzsimmons; Patrick J,0,4,15,16
1668574872810,MATH 287B,A00,098056,Arias-Castro; Ery,1,0,15,14
1668574873238,MATH 288,A00,098057,Agarwal; Pooja,9,0,10,1
1668574873238,MATH 288,B00,098058,Zhang; Danna,8,0,10,2
1668574873238,MATH 288,C00,098059,Williams; Ruth J,9,0,10,1
1668574873665,MATH 290B,A00,098060,Roberts; Justin Deritter,12,0,15,3
1668574874097,MATH 292,A00,098061,Belmont; Eva Kinoshita,10,0,10,0
1668574874522,MATH 295,A00,098062,Suk; Andrew Hoon,47,0,50,3
1668574874944,MATH 296,A00,098063,Novak; Jonathan I,20,0,20,0
1668574875366,MATH 297,001,098064,Gamst; Anthony Collins,9997,0,9999,2
1668575378103,COGS 205,A00,101395,Chiba; Andrea,19,0,20,1
1668575378529,COGS 210B,001,101404,Greene; Deanna Jacquelyn,9998,0,9999,1
1668575378529,COGS 210B,002,101417,Xia; Haijun,9999,0,9999,0
1668575378529,COGS 210B,003,101422,Nitz; Douglas A.,9999,0,9999,0
1668575378529,COGS 210B,004,101423,Hollan; James D.,9998,0,9999,1
1668575378529,COGS 210B,005,101424,Deak; Gedeon O.,9998,0,9999,1
1668575378529,COGS 210B,006,101425,Rossano; Federico,9999,0,9999,0
1668575378962,COGS 211B,A00,101427,Coulson; Seana M,9996,0,9999,3
1668575379403,COGS 220,A00,101428,Hollan; James D.,0,17,25,25
1668575379840,COGS 229,A00,101429,Dow; Steven P,17,0,25,8
1668575380264,COGS 230,A00,101430,Klemmer; Scott R,6,0,17,11
1668575380688,COGS 234,A00,101431,Xia; Haijun,0,1,25,25
1668575381119,COGS 260,A00,101432,Kiyonaga; Anastasia,21,0,25,4
1668575381119,COGS 260,B00,101433,Kirsh; David Joel,15,0,25,10
1668575381545,CSE 202,A00,102371,Impagliazzo; Russell,0,70,0,0
1668575381972,CSE 203B,A01,102373,Cheng; Chung Kuan,0,70,0,0
1668575382398,CSE 208,A00,102374,Micciancio; Daniele,0,5,0,0
1668575382822,CSE 209A,A00,112895,Impagliazzo; Russell,0,14,15,15
1668575383249,CSE 209B,A00,108005,Bellare; Mihir,0,7,0,0
1668575383674,CSE 210,A00,113163,Coblenz; Michael J,0,96,0,0
1668575384101,CSE 219,A00,106111,Dow; Steven P,0,8,20,20
1668575384523,CSE 221,A00,102376,Voelker; Geoffrey M.,0,77,0,0
1668575384952,CSE 224,A01,102378,Porter; George M,0,180,0,0
1668575385377,CSE 229A,A00,102379,Savage; Stefan,0,14,0,0
1668575385800,CSE 229C,A00,102380,Munyaka; Imani N. S.,0,12,0,0
1668575386228,CSE 232B,A00,102382,Deutsch; Alin Bernard,0,39,0,0
1668575386651,CSE 234,A01,112904,Kumar; Arun Kumar,0,0,0,0
1668575387076,CSE 237A,A00,102383,Rosing; Tajana Simunic,0,57,0,0
1668575387501,CSE 239A,A00,102384,Deutsch; Alin Bernard,0,18,0,0
1668575387924,CSE 239B,A00,102385,Polikarpova; Nadezhda,0,11,0,0
1668575388348,CSE 240A,A00,102386,Pannuto; Patrick William,0,49,0,0
1668575388897,CSE 240B,A00,102387,Zhao; Jishen,0,51,0,0
1668575389329,CSE 241A,A00,106406,Kang; Mingu,0,9,0,0
1668575389753,CSE 249B,A00,102388,Kahng; Andrew Byun,0,7,8,8
1668575390177,CSE 251B,A01,102392,Cottrell; Garrison W,0,54,0,0
1668575390177,CSE 251B,A02,102393,Cottrell; Garrison W,0,36,0,0
1668575390603,CSE 252B,A00,102394,Ochoa; Benjamin Lawrence,0,65,0,0
1668575391027,CSE 257,A01,102396,Gao; Sicun,0,160,0,0
1668575391459,CSE 272,A00,102397,Li; Tzumao,0,22,0,0
1668575391881,CSE 274,A00,111323,Chern; Albert Ren-Haur,0,16,0,0
1668575392310,CSE 282,A00,102398,Pevzner; Pavel Arkadjevich,0,0,0,0
1668575392742,CSE 284,A00,114175,Gymrek; Melissa Ann,0,33,0,0
1668575393172,CSE 290,A00,102399,Chandraker; Manmohan Krishna,0,11,0,0
1668575393172,CSE 290,B00,102400,Vaccaro; Kristen Marie,0,10,25,25
1668575393172,CSE 290,C00,102414,Pannuto; Patrick William,0,1,25,25
1668575393172,CSE 290,D00,102427,Pevzner; Pavel Arkadjevich,0,0,0,0
1668575393172,CSE 290,E00,102429,Zhao; Jishen,0,6,0,0
1668575393172,CSE 290,F00,102436,Tullsen; Dean Michael,0,6,0,0
1668575393172,CSE 290,G00,102440,Christensen; Henrik I,0,8,20,20
1668575393601,CSE 291,A00,102443,Su; Hao,0,0,0,0
1668575393601,CSE 291,B00,102448,Polikarpova; Nadezhda,0,0,0,0
1668575393601,CSE 291,C00,102453,Vaccaro; Kristen Marie,0,0,0,0
1668575393601,CSE 291,D00,111343,Savage; Stefan,0,0,0,0
1668575393601,CSE 291,E00,116474,Claffy; Kimberly Claire,0,0,0,0
1668575393601,CSE 291,F00,116479,Pasquale; Joseph,0,0,0,0
1668575394028,CSE 293,001,119111,Bafna; Vineet,9999,0,9999,0
1668575394028,CSE 293,002,119118,Bellare; Mihir,9999,0,9999,0
1668575394028,CSE 293,003,119122,Berg-Kirkpatrick; Taylor D,9999,0,9999,0
1668575394028,CSE 293,004,119135,Christensen; Henrik I,9999,0,9999,0
1668575394028,CSE 293,005,119142,Cottrell; Garrison W,9999,0,9999,0
1668575394028,CSE 293,006,119146,Deutsch; Alin Bernard,9999,0,9999,0
1668575394028,CSE 293,007,119159,Esmaeilzadeh; Hadi,9999,0,9999,0
1668575394028,CSE 293,008,119166,Freund; Yoav,9999,0,9999,0
1668575394028,CSE 293,009,119170,Griswold; William G.,9999,0,9999,0
1668575394028,CSE 293,010,119183,Gymrek; Melissa Ann,9999,0,9999,0
1668575394028,CSE 293,011,119190,Heninger; Nadia A,9999,0,9999,0
1668575394028,CSE 293,012,119230,Impagliazzo; Russell,9999,0,9999,0
1668575394028,CSE 293,013,119232,Jhala; Ranjit,9999,0,9999,0
1668575394028,CSE 293,014,119233,Kahng; Andrew Byun,9999,0,9999,0
1668575394028,CSE 293,015,119298,Kane; Daniel Mertz,9999,0,9999,0
1668575394028,CSE 293,016,119299,Kriegman; David J,9999,0,9999,0
1668575394028,CSE 293,017,119300,Kumar; Arun Kumar,9999,0,9999,0
1668575394028,CSE 293,018,119301,Lerner; Sorin,9999,0,9999,0
1668575394028,CSE 293,019,119302,Lovett; Shachar,9999,0,9999,0
1668575394028,CSE 293,020,119303,McAuley; Julian John,9999,0,9999,0
1668575394028,CSE 293,021,119304,Micciancio; Daniele,9999,0,9999,0
1668575394028,CSE 293,022,119367,Orailoglu; Alex,9999,0,9999,0
1668575394028,CSE 293,023,119382,Paturi; Ramamohan,9999,0,9999,0
1668575394028,CSE 293,024,119404,Polikarpova; Nadezhda,9999,0,9999,0
1668575394028,CSE 293,025,119406,Politz; Joseph Gibbs,9999,0,9999,0
1668575394028,CSE 293,026,119411,Porter; George M,9999,0,9999,0
1668575394028,CSE 293,027,119414,Porter; Leonard Emerson,9999,0,9999,0
1668575394028,CSE 293,028,119416,Ramamoorthi; Ravi,9999,0,9999,0
1668575394028,CSE 293,029,119417,Sahoo; Debashis,9999,0,9999,0
1668575394028,CSE 293,030,119420,Saul; Lawrence,9999,0,9999,0
1668575394028,CSE 293,031,119421,Savage; Stefan,9999,0,9999,0
1668575394028,CSE 293,032,119425,Schulze; Jurgen P.,9999,0,9999,0
1668575394028,CSE 293,033,119426,Snoeren; Alex C.,9999,0,9999,0
1668575394028,CSE 293,034,119428,Shang; Jingbo,9999,0,9999,0
1668575394028,CSE 293,035,119430,Stefan; Deian,9999,0,9999,0
1668575394028,CSE 293,036,119431,Su; Hao,9999,0,9999,0
1668575394028,CSE 293,037,119433,Swanson; Steven James,9999,0,9999,0
1668575394028,CSE 293,038,119435,Tullsen; Dean Michael,9999,0,9999,0
1668575394028,CSE 293,039,119483,Voelker; Geoffrey M.,9999,0,9999,0
1668575394028,CSE 293,040,119537,Zhao; Jishen,9999,0,9999,0
1668575394028,CSE 293,041,119538,Zhou; Yuan-Yuan,9999,0,9999,0
1668575394028,CSE 293,042,119539,Gao; Sicun,9999,0,9999,0
1668575394028,CSE 293,043,119540,Weibel; Nadir,9999,0,9999,0
1668575394028,CSE 293,044,119541,Gupta; Rajesh K.,9999,0,9999,0
1668575394028,CSE 293,045,126410,Vaccaro; Kristen Marie,9999,0,9999,0
1668575394028,CSE 293,046,126411,Klemke; Richard,9999,0,9999,0
1668575394455,CSE 294,A00,102459,Voelker; Geoffrey M.,0,2,0,0
1668575394455,CSE 294,B00,111322,Orailoglu; Alex,0,2,0,0
1668575394878,DSE 201,A00,096914,Deutsch; Alin Bernard,30,0,30,0
1668575395303,DSE 210,A00,096915,Dasgupta; Sanjoy,30,0,30,0
1668575395736,DSE 260A,A00,096916,Altintas De Callaf; Ilkay,30,0,30,0
1668575396176,ECE 200,001,103586,Antipa; Nicholas A,9999,0,9999,0
1668575396176,ECE 200,002,103587,Atanasov; Nikolay A.,9999,0,9999,0
1668575396176,ECE 200,003,103588,Bharadia; Dinesh,9999,0,9999,0
1668575396176,ECE 200,004,103589,Cheng; Chung Kuan,9999,0,9999,0
1668575396176,ECE 200,005,103590,Cosman; Pamela C.,9999,0,9999,0
1668575396176,ECE 200,006,103591,Dayeh; Shadi Ahmad,9999,0,9999,0
1668575396176,ECE 200,007,103592,Fainman; Yeshaiahu,9999,0,9999,0
1668575396176,ECE 200,008,103593,Ford; Joseph Earl,9999,0,9999,0
1668575396176,ECE 200,009,103594,Franceschetti; Massimo,9999,0,9999,0
1668575396176,ECE 200,010,103595,Fullerton; Eric E,9999,0,9999,0
1668575396176,ECE 200,011,103596,Galton; Ian A,9999,0,9999,0
1668575396176,ECE 200,012,103597,Gilja; Vikash,9999,0,9999,0
1668575396176,ECE 200,013,103598,Hall; Drew A.,9999,0,9999,0
1668575396176,ECE 200,014,103599,Hsueh; Tzu-Chien,9999,0,9999,0
1668575396176,ECE 200,015,103600,Javidi; Tara,9999,0,9999,0
1668575396176,ECE 200,016,103601,Kahng; Andrew Byun,9999,0,9999,0
1668575396176,ECE 200,017,103602,Kim; Young-Han,9999,0,9999,0
1668575396176,ECE 200,018,103603,Koushanfar; Farinaz,9999,0,9999,0
1668575396176,ECE 200,019,103604,Kuzum; Duygu,9999,0,9999,0
1668575396176,ECE 200,020,103605,Le; Hanh-Phuc,9999,0,9999,0
1668575396176,ECE 200,021,103606,Lin; Bill,9999,0,9999,0
1668575396176,ECE 200,022,103607,Liu; Zhaowei,9998,0,9999,1
1668575396176,ECE 200,023,103608,Lo; Yu-Hwa,9999,0,9999,0
1668575396176,ECE 200,024,103609,Lomakin; Vitaliy,9999,0,9999,0
1668575396176,ECE 200,025,103610,Mercier; Patrick Philip,9999,0,9999,0
1668575396176,ECE 200,026,103611,Meyer; Florian,9999,0,9999,0
1668575396176,ECE 200,027,103612,Milstein; Laurence B.,9999,0,9999,0
1668575396176,ECE 200,028,103613,Mir Arabbaygi; Siavash,9999,0,9999,0
1668575396176,ECE 200,029,103614,Mookherjea; Shayan,9999,0,9999,0
1668575396176,ECE 200,030,103615,Morris; Karcher William,9999,0,9999,0
1668575396176,ECE 200,031,103616,Ng; Tse Nga,9999,0,9999,0
1668575396176,ECE 200,032,103617,Nguyen; Truong Quang,9999,0,9999,0
1668575396176,ECE 200,033,103618,Nomura; Kenji,9999,0,9999,0
1668575396176,ECE 200,034,103619,Orlitsky; Alon,9999,0,9999,0
1668575396176,ECE 200,035,103620,Pal; Piya,9999,0,9999,0
1668575396176,ECE 200,036,103621,Papen; George C.,9999,0,9999,0
1668575396176,ECE 200,037,103622,Radic; Stojan,9999,0,9999,0
1668575396176,ECE 200,038,103623,Rao; Bhaskar D.,9999,0,9999,0
1668575396176,ECE 200,039,103624,Rao; Ramesh R,9999,0,9999,0
1668575396176,ECE 200,040,103625,Rebeiz; Gabriel,9999,0,9999,0
1668575396176,ECE 200,041,103626,Sanford; John R,9999,0,9999,0
1668575396176,ECE 200,042,103627,Siegel; Paul H.,9999,0,9999,0
1668575396176,ECE 200,043,103628,Sievenpiper; Daniel F.,9999,0,9999,0
1668575396176,ECE 200,044,103629,Sworder; David D.,9999,0,9999,0
1668575396176,ECE 200,045,103630,Taur; Yuan,9999,0,9999,0
1668575396176,ECE 200,046,103631,Touri; Behrouz,9999,0,9999,0
1668575396176,ECE 200,047,103632,Trivedi; Mohan M.,9999,0,9999,0
1668575396176,ECE 200,048,103633,Vasconcelos; Nuno,9999,0,9999,0
1668575396176,ECE 200,049,103634,Wang; Xiaolong,9999,0,9999,0
1668575396176,ECE 200,050,103635,Xie; Pengtao,9999,0,9999,0
1668575396176,ECE 200,051,103636,Yip; Michael,9999,0,9999,0
1668575396176,ECE 200,052,103637,Zeger; Kenneth A.,999,0,999,0
1668575396176,ECE 200,053,103638,Zhang; Xinyu,9999,0,9999,0
1668575396176,ECE 200,054,103639,Turakhia; Yatish Girish,9999,0,9999,0
1668575396176,ECE 200,055,103640,Kang; Mingu,9999,0,9999,0
1668575396176,ECE 200,056,103641,Shi; Yuanyuan,9999,0,9999,0
1668575396176,ECE 200,057,103642,Wang; Edward Jay,9999,0,9999,0
1668575396176,ECE 200,058,103643,Zheng; Yang,9999,0,9999,0
1668575396611,ECE 202,A00,103644,Kuzum; Duygu,0,46,0,0
1668575397034,ECE 212BN,A00,103646,Ng; Tse Nga,0,10,0,0
1668575397458,ECE 221,A00,111493,Staff,0,0,0,0
1668575397886,ECE 222B,A00,103647,Lomakin; Vitaliy,0,21,0,0
1668575398310,ECE 230B,A00,103648,Taur; Yuan,0,4,0,0
1668575398734,ECE 238B,A00,103649,Garay; Javier,0,0,0,0
1668575399160,ECE 240B,A00,112900,Fainman; Yeshaiahu,0,8,0,0
1668575399584,ECE 247A,A00,103650,Jokerst; Jesse Vincent,0,6,0,0
1668575400012,ECE 247B,A00,103651,Wang; Joseph,0,15,0,0
1668575400440,ECE 250,A00,103652,Siegel; Paul H.,0,84,0,0
1668575400871,ECE 251A,A00,103654,Rao; Bhaskar D.,0,65,0,0
1668575401295,ECE 257B,A00,103655,Bharadia; Dinesh,0,33,0,0
1668575401726,ECE 258A,A00,103656,Milstein; Laurence B.,0,29,0,0
1668575402149,ECE 260B,A00,103658,Kang; Mingu,0,121,0,0
1668575402578,ECE 264A,A00,103659,Galton; Ian A,0,45,0,31
1668575403006,ECE 265A,A00,103661,Gudem; Prasad S.S.,0,46,0,31
1668575403430,ECE 265D,A00,103662,Gudem; Prasad S.S.,0,27,0,0
1668575403853,ECE 268,A00,103663,Koushanfar; Farinaz,0,44,0,0
1668575404276,ECE 269,A01,103665,Pal; Piya,0,222,0,0
1668575404699,ECE 271B,A00,103666,Vasconcelos; Manuela,0,78,0,0
1668575405130,ECE 276A,A00,103667,Atanasov; Nikolay A.,0,126,0,0
1668575405558,ECE 277,A00,103668,An; Cheolhong,0,151,0,0
1668575405983,ECE 279,A00,117947,Hall; Drew A.,0,22,0,0
1668575406836,ECE 283,A00,103670,Hsueh; Tzu-Chien,0,57,0,0
1668575407265,ECE 284,A00,103671,Turakhia; Yatish Girish,0,40,0,0
1668575407691,ECE 285,A00,103672,Zheng; Yang,0,41,0,0
1668575407691,ECE 285,B00,103673,Sworder; David D.,0,61,0,0
1668575408117,ECE 287,A00,103676,Javidi; Tara,0,8,0,0
1668575408540,MATH 200B,A00,098023,Salehi Golsefidy; Alireza,7,0,15,8
1668575408962,MATH 202B,A00,098024,Rhoades; Brendon Patrick,7,0,15,8
1668575409386,MATH 203B,A00,098025,Oprea; Dragos N.,9,0,15,6
1668575409813,MATH 204B,A00,098026,Sorensen; Claus M,13,0,15,2
1668575410236,MATH 208,A00,098027,Izadi; Elham,7,0,10,3
1668575410665,MATH 209,A00,098028,Pollack; Aaron,10,0,10,0
1668575411094,MATH 211A,A00,112919,Rogalski; Daniel,8,0,10,2
1668575411524,MATH 211B,A00,112920,Seward; Brandon M.,9,0,10,1
1668575411954,MATH 218,A00,098029,Li; Bo,10,0,10,0
1668575412378,MATH 220B,A00,098030,Novak; Jonathan I,10,0,15,5
1668575412800,MATH 221A,A00,098031,Ebenfelt; Peter F,12,0,15,3
1668575413226,MATH 231B,A00,098032,Zlatos; Andrej,9,0,15,6
1668575413660,MATH 240B,A00,098033,Ni; Lei,7,0,15,8
1668575414088,MATH 243,A00,098034,Jekel; David Andrew,10,0,10,0
1668575414520,MATH 245A,A00,098035,Nie; Jiawang,0,7,15,18
1668575414942,MATH 248,A00,098036,Bejenaru; Ioan,10,0,10,0
1668575415369,MATH 250B,A00,098037,Spolaor; Luca,12,0,15,3
1668575415793,MATH 258,A00,098038,Ni; Lei,8,0,10,2
1668575416217,MATH 264B,A00,098041,Rhoades; Brendon Patrick,7,0,15,8
1668575416641,MATH 268,A00,098042,Buss; Samuel R,10,0,10,0
1668575417065,MATH 269,A00,098043,Rhoades; Brendon Patrick,10,0,10,0
1668575417503,MATH 270B,A00,098044,Li; Bo,6,0,15,9
1668575417925,MATH 272B,A00,098045,Holst; Michael J,13,0,15,2
1668575418349,MATH 273A,A00,098046,Tian; Xiaochuan,10,0,15,5
1668575418775,MATH 275,A01,098048,Tian; Xiaochuan,6,0,10,4
1668575419199,MATH 278A,A00,098049,Holst; Michael J,6,0,10,4
1668575419625,MATH 278B,A00,098050,Cloninger; Alexander,10,0,10,0
1668575420051,MATH 278C,A00,098051,Nie; Jiawang,5,0,10,5
1668575420473,MATH 280B,A00,098052,Zheng; Tianyi,6,0,15,9
1668575420905,MATH 281B,A00,098053,Bradic; Jelena,0,2,15,15
1668575421328,MATH 282B,A00,098054,Arias-Castro; Ery,0,1,15,15
1668575421751,MATH 285,A00,098055,Fitzsimmons; Patrick J,0,4,15,16
1668575422174,MATH 287B,A00,098056,Arias-Castro; Ery,1,0,15,14
1668575422599,MATH 288,A00,098057,Agarwal; Pooja,9,0,10,1
1668575422599,MATH 288,B00,098058,Zhang; Danna,8,0,10,2
1668575422599,MATH 288,C00,098059,Williams; Ruth J,9,0,10,1
1668575423038,MATH 290B,A00,098060,Roberts; Justin Deritter,12,0,15,3
1668575423465,MATH 292,A00,098061,Belmont; Eva Kinoshita,10,0,10,0
1668575423889,MATH 295,A00,098062,Suk; Andrew Hoon,47,0,50,3
1668575424315,MATH 296,A00,098063,Novak; Jonathan I,20,0,20,0
1668575424740,MATH 297,001,098064,Gamst; Anthony Collins,9997,0,9999,2
1668575939155,COGS 205,A00,101395,Chiba; Andrea,19,0,20,1
1668575939591,COGS 210B,001,101404,Greene; Deanna Jacquelyn,9998,0,9999,1
1668575939591,COGS 210B,002,101417,Xia; Haijun,9999,0,9999,0
1668575939591,COGS 210B,003,101422,Nitz; Douglas A.,9999,0,9999,0
1668575939591,COGS 210B,004,101423,Hollan; James D.,9998,0,9999,1
1668575939591,COGS 210B,005,101424,Deak; Gedeon O.,9998,0,9999,1
1668575939591,COGS 210B,006,101425,Rossano; Federico,9999,0,9999,0
1668575940019,COGS 211B,A00,101427,Coulson; Seana M,9996,0,9999,3
1668575940446,COGS 220,A00,101428,Hollan; James D.,0,17,25,25
1668575940871,COGS 229,A00,101429,Dow; Steven P,17,0,25,8
1668575941297,COGS 230,A00,101430,Klemmer; Scott R,6,0,17,11
1668575941724,COGS 234,A00,101431,Xia; Haijun,0,1,25,25
1668575942161,COGS 260,A00,101432,Kiyonaga; Anastasia,21,0,25,4
1668575942161,COGS 260,B00,101433,Kirsh; David Joel,15,0,25,10
1668575942586,CSE 202,A00,102371,Impagliazzo; Russell,0,70,0,0
1668575943013,CSE 203B,A01,102373,Cheng; Chung Kuan,0,70,0,0
1668575943453,CSE 208,A00,102374,Micciancio; Daniele,0,5,0,0
1668575943887,CSE 209A,A00,112895,Impagliazzo; Russell,0,14,15,15
1668575944323,CSE 209B,A00,108005,Bellare; Mihir,0,7,0,0
1668575944747,CSE 210,A00,113163,Coblenz; Michael J,0,96,0,0
1668575945176,CSE 219,A00,106111,Dow; Steven P,0,8,20,20
1668575945601,CSE 221,A00,102376,Voelker; Geoffrey M.,0,77,0,0
1668575946024,CSE 224,A01,102378,Porter; George M,0,180,0,0
1668575946447,CSE 229A,A00,102379,Savage; Stefan,0,14,0,0
1668575946876,CSE 229C,A00,102380,Munyaka; Imani N. S.,0,12,0,0
1668575947305,CSE 232B,A00,102382,Deutsch; Alin Bernard,0,39,0,0
1668575947734,CSE 234,A01,112904,Kumar; Arun Kumar,0,0,0,0
1668575948157,CSE 237A,A00,102383,Rosing; Tajana Simunic,0,57,0,0
1668575948587,CSE 239A,A00,102384,Deutsch; Alin Bernard,0,18,0,0
1668575949013,CSE 239B,A00,102385,Polikarpova; Nadezhda,0,11,0,0
1668575949437,CSE 240A,A00,102386,Pannuto; Patrick William,0,49,0,0
1668575949868,CSE 240B,A00,102387,Zhao; Jishen,0,51,0,0
1668575950289,CSE 241A,A00,106406,Kang; Mingu,0,9,0,0
1668575950728,CSE 249B,A00,102388,Kahng; Andrew Byun,0,7,8,8
1668575951157,CSE 251B,A01,102392,Cottrell; Garrison W,0,54,0,0
1668575951157,CSE 251B,A02,102393,Cottrell; Garrison W,0,36,0,0
1668575951583,CSE 252B,A00,102394,Ochoa; Benjamin Lawrence,0,65,0,0
1668575952004,CSE 257,A01,102396,Gao; Sicun,0,160,0,0
1668575952432,CSE 272,A00,102397,Li; Tzumao,0,22,0,0
1668575952856,CSE 274,A00,111323,Chern; Albert Ren-Haur,0,16,0,0
1668575953283,CSE 282,A00,102398,Pevzner; Pavel Arkadjevich,0,0,0,0
1668575953713,CSE 284,A00,114175,Gymrek; Melissa Ann,0,33,0,0
1668575954137,CSE 290,A00,102399,Chandraker; Manmohan Krishna,0,11,0,0
1668575954137,CSE 290,B00,102400,Vaccaro; Kristen Marie,0,10,25,25
1668575954137,CSE 290,C00,102414,Pannuto; Patrick William,0,1,25,25
1668575954137,CSE 290,D00,102427,Pevzner; Pavel Arkadjevich,0,0,0,0
1668575954137,CSE 290,E00,102429,Zhao; Jishen,0,6,0,0
1668575954137,CSE 290,F00,102436,Tullsen; Dean Michael,0,6,0,0
1668575954137,CSE 290,G00,102440,Christensen; Henrik I,0,8,20,20
1668575954562,CSE 291,A00,102443,Su; Hao,0,0,0,0
1668575954562,CSE 291,B00,102448,Polikarpova; Nadezhda,0,0,0,0
1668575954562,CSE 291,C00,102453,Vaccaro; Kristen Marie,0,0,0,0
1668575954562,CSE 291,D00,111343,Savage; Stefan,0,0,0,0
1668575954562,CSE 291,E00,116474,Claffy; Kimberly Claire,0,0,0,0
1668575954562,CSE 291,F00,116479,Pasquale; Joseph,0,0,0,0
1668575954991,CSE 293,001,119111,Bafna; Vineet,9999,0,9999,0
1668575954991,CSE 293,002,119118,Bellare; Mihir,9999,0,9999,0
1668575954991,CSE 293,003,119122,Berg-Kirkpatrick; Taylor D,9999,0,9999,0
1668575954991,CSE 293,004,119135,Christensen; Henrik I,9999,0,9999,0
1668575954991,CSE 293,005,119142,Cottrell; Garrison W,9999,0,9999,0
1668575954991,CSE 293,006,119146,Deutsch; Alin Bernard,9999,0,9999,0
1668575954991,CSE 293,007,119159,Esmaeilzadeh; Hadi,9999,0,9999,0
1668575954991,CSE 293,008,119166,Freund; Yoav,9999,0,9999,0
1668575954991,CSE 293,009,119170,Griswold; William G.,9999,0,9999,0
1668575954991,CSE 293,010,119183,Gymrek; Melissa Ann,9999,0,9999,0
1668575954991,CSE 293,011,119190,Heninger; Nadia A,9999,0,9999,0
1668575954991,CSE 293,012,119230,Impagliazzo; Russell,9999,0,9999,0
1668575954991,CSE 293,013,119232,Jhala; Ranjit,9999,0,9999,0
1668575954991,CSE 293,014,119233,Kahng; Andrew Byun,9999,0,9999,0
1668575954991,CSE 293,015,119298,Kane; Daniel Mertz,9999,0,9999,0
1668575954991,CSE 293,016,119299,Kriegman; David J,9999,0,9999,0
1668575954991,CSE 293,017,119300,Kumar; Arun Kumar,9999,0,9999,0
1668575954991,CSE 293,018,119301,Lerner; Sorin,9999,0,9999,0
1668575954991,CSE 293,019,119302,Lovett; Shachar,9999,0,9999,0
1668575954991,CSE 293,020,119303,McAuley; Julian John,9999,0,9999,0
1668575954991,CSE 293,021,119304,Micciancio; Daniele,9999,0,9999,0
1668575954991,CSE 293,022,119367,Orailoglu; Alex,9999,0,9999,0
1668575954991,CSE 293,023,119382,Paturi; Ramamohan,9999,0,9999,0
1668575954991,CSE 293,024,119404,Polikarpova; Nadezhda,9999,0,9999,0
1668575954991,CSE 293,025,119406,Politz; Joseph Gibbs,9999,0,9999,0
1668575954991,CSE 293,026,119411,Porter; George M,9999,0,9999,0
1668575954991,CSE 293,027,119414,Porter; Leonard Emerson,9999,0,9999,0
1668575954991,CSE 293,028,119416,Ramamoorthi; Ravi,9999,0,9999,0
1668575954991,CSE 293,029,119417,Sahoo; Debashis,9999,0,9999,0
1668575954991,CSE 293,030,119420,Saul; Lawrence,9999,0,9999,0
1668575954991,CSE 293,031,119421,Savage; Stefan,9999,0,9999,0
1668575954991,CSE 293,032,119425,Schulze; Jurgen P.,9999,0,9999,0
1668575954991,CSE 293,033,119426,Snoeren; Alex C.,9999,0,9999,0
1668575954991,CSE 293,034,119428,Shang; Jingbo,9999,0,9999,0
1668575954991,CSE 293,035,119430,Stefan; Deian,9999,0,9999,0
1668575954991,CSE 293,036,119431,Su; Hao,9999,0,9999,0
1668575954991,CSE 293,037,119433,Swanson; Steven James,9999,0,9999,0
1668575954991,CSE 293,038,119435,Tullsen; Dean Michael,9999,0,9999,0
1668575954991,CSE 293,039,119483,Voelker; Geoffrey M.,9999,0,9999,0
1668575954991,CSE 293,040,119537,Zhao; Jishen,9999,0,9999,0
1668575954991,CSE 293,041,119538,Zhou; Yuan-Yuan,9999,0,9999,0
1668575954991,CSE 293,042,119539,Gao; Sicun,9999,0,9999,0
1668575954991,CSE 293,043,119540,Weibel; Nadir,9999,0,9999,0
1668575954991,CSE 293,044,119541,Gupta; Rajesh K.,9999,0,9999,0
1668575954991,CSE 293,045,126410,Vaccaro; Kristen Marie,9999,0,9999,0
1668575954991,CSE 293,046,126411,Klemke; Richard,9999,0,9999,0
1668575955425,CSE 294,A00,102459,Voelker; Geoffrey M.,0,2,0,0
1668575955425,CSE 294,B00,111322,Orailoglu; Alex,0,2,0,0
1668575955850,DSE 201,A00,096914,Deutsch; Alin Bernard,30,0,30,0
1668575956279,DSE 210,A00,096915,Dasgupta; Sanjoy,30,0,30,0
1668575956704,DSE 260A,A00,096916,Altintas De Callaf; Ilkay,30,0,30,0
1668575957134,ECE 200,001,103586,Antipa; Nicholas A,9999,0,9999,0
1668575957134,ECE 200,002,103587,Atanasov; Nikolay A.,9999,0,9999,0
1668575957134,ECE 200,003,103588,Bharadia; Dinesh,9999,0,9999,0
1668575957134,ECE 200,004,103589,Cheng; Chung Kuan,9999,0,9999,0
1668575957134,ECE 200,005,103590,Cosman; Pamela C.,9999,0,9999,0
1668575957134,ECE 200,006,103591,Dayeh; Shadi Ahmad,9999,0,9999,0
1668575957134,ECE 200,007,103592,Fainman; Yeshaiahu,9999,0,9999,0
1668575957134,ECE 200,008,103593,Ford; Joseph Earl,9999,0,9999,0
1668575957134,ECE 200,009,103594,Franceschetti; Massimo,9999,0,9999,0
1668575957134,ECE 200,010,103595,Fullerton; Eric E,9999,0,9999,0
1668575957134,ECE 200,011,103596,Galton; Ian A,9999,0,9999,0
1668575957134,ECE 200,012,103597,Gilja; Vikash,9999,0,9999,0
1668575957134,ECE 200,013,103598,Hall; Drew A.,9999,0,9999,0
1668575957134,ECE 200,014,103599,Hsueh; Tzu-Chien,9999,0,9999,0
1668575957134,ECE 200,015,103600,Javidi; Tara,9999,0,9999,0
1668575957134,ECE 200,016,103601,Kahng; Andrew Byun,9999,0,9999,0
1668575957134,ECE 200,017,103602,Kim; Young-Han,9999,0,9999,0
1668575957134,ECE 200,018,103603,Koushanfar; Farinaz,9999,0,9999,0
1668575957134,ECE 200,019,103604,Kuzum; Duygu,9999,0,9999,0
1668575957134,ECE 200,020,103605,Le; Hanh-Phuc,9999,0,9999,0
1668575957134,ECE 200,021,103606,Lin; Bill,9999,0,9999,0
1668575957134,ECE 200,022,103607,Liu; Zhaowei,9998,0,9999,1
1668575957134,ECE 200,023,103608,Lo; Yu-Hwa,9999,0,9999,0
1668575957134,ECE 200,024,103609,Lomakin; Vitaliy,9999,0,9999,0
1668575957134,ECE 200,025,103610,Mercier; Patrick Philip,9999,0,9999,0
1668575957134,ECE 200,026,103611,Meyer; Florian,9999,0,9999,0
1668575957134,ECE 200,027,103612,Milstein; Laurence B.,9999,0,9999,0
1668575957134,ECE 200,028,103613,Mir Arabbaygi; Siavash,9999,0,9999,0
1668575957134,ECE 200,029,103614,Mookherjea; Shayan,9999,0,9999,0
1668575957134,ECE 200,030,103615,Morris; Karcher William,9999,0,9999,0
1668575957134,ECE 200,031,103616,Ng; Tse Nga,9999,0,9999,0
1668575957134,ECE 200,032,103617,Nguyen; Truong Quang,9999,0,9999,0
1668575957134,ECE 200,033,103618,Nomura; Kenji,9999,0,9999,0
1668575957134,ECE 200,034,103619,Orlitsky; Alon,9999,0,9999,0
1668575957134,ECE 200,035,103620,Pal; Piya,9999,0,9999,0
1668575957134,ECE 200,036,103621,Papen; George C.,9999,0,9999,0
1668575957134,ECE 200,037,103622,Radic; Stojan,9999,0,9999,0
1668575957134,ECE 200,038,103623,Rao; Bhaskar D.,9999,0,9999,0
1668575957134,ECE 200,039,103624,Rao; Ramesh R,9999,0,9999,0
1668575957134,ECE 200,040,103625,Rebeiz; Gabriel,9999,0,9999,0
1668575957134,ECE 200,041,103626,Sanford; John R,9999,0,9999,0
1668575957134,ECE 200,042,103627,Siegel; Paul H.,9999,0,9999,0
1668575957134,ECE 200,043,103628,Sievenpiper; Daniel F.,9999,0,9999,0
1668575957134,ECE 200,044,103629,Sworder; David D.,9999,0,9999,0
1668575957134,ECE 200,045,103630,Taur; Yuan,9999,0,9999,0
1668575957134,ECE 200,046,103631,Touri; Behrouz,9999,0,9999,0
1668575957134,ECE 200,047,103632,Trivedi; Mohan M.,9999,0,9999,0
1668575957134,ECE 200,048,103633,Vasconcelos; Nuno,9999,0,9999,0
1668575957134,ECE 200,049,103634,Wang; Xiaolong,9999,0,9999,0
1668575957134,ECE 200,050,103635,Xie; Pengtao,9999,0,9999,0
1668575957134,ECE 200,051,103636,Yip; Michael,9999,0,9999,0
1668575957134,ECE 200,052,103637,Zeger; Kenneth A.,999,0,999,0
1668575957134,ECE 200,053,103638,Zhang; Xinyu,9999,0,9999,0
1668575957134,ECE 200,054,103639,Turakhia; Yatish Girish,9999,0,9999,0
1668575957134,ECE 200,055,103640,Kang; Mingu,9999,0,9999,0
1668575957134,ECE 200,056,103641,Shi; Yuanyuan,9999,0,9999,0
1668575957134,ECE 200,057,103642,Wang; Edward Jay,9999,0,9999,0
1668575957134,ECE 200,058,103643,Zheng; Yang,9999,0,9999,0
1668575957561,ECE 202,A00,103644,Kuzum; Duygu,0,46,0,0
1668575957990,ECE 212BN,A00,103646,Ng; Tse Nga,0,10,0,0
1668575958413,ECE 221,A00,111493,Staff,0,0,0,0
1668575958852,ECE 222B,A00,103647,Lomakin; Vitaliy,0,21,0,0
1668575959275,ECE 230B,A00,103648,Taur; Yuan,0,4,0,0
1668575959700,ECE 238B,A00,103649,Garay; Javier,0,0,0,0
1668575960126,ECE 240B,A00,112900,Fainman; Yeshaiahu,0,8,0,0
1668575960554,ECE 247A,A00,103650,Jokerst; Jesse Vincent,0,6,0,0
1668575960977,ECE 247B,A00,103651,Wang; Joseph,0,15,0,0
1668575961402,ECE 250,A00,103652,Siegel; Paul H.,0,84,0,0
1668575961825,ECE 251A,A00,103654,Rao; Bhaskar D.,0,65,0,0
1668575962251,ECE 257B,A00,103655,Bharadia; Dinesh,0,33,0,0
1668575962881,ECE 258A,A00,103656,Milstein; Laurence B.,0,29,0,0
1668575963312,ECE 260B,A00,103658,Kang; Mingu,0,121,0,0
1668575963735,ECE 264A,A00,103659,Galton; Ian A,0,45,0,31
1668575964162,ECE 265A,A00,103661,Gudem; Prasad S.S.,0,46,0,31
1668575964586,ECE 265D,A00,103662,Gudem; Prasad S.S.,0,27,0,0
1668575965091,ECE 268,A00,103663,Koushanfar; Farinaz,0,44,0,0
1668575965514,ECE 269,A01,103665,Pal; Piya,0,222,0,0
1668575965941,ECE 271B,A00,103666,Vasconcelos; Manuela,0,78,0,0
1668575966379,ECE 276A,A00,103667,Atanasov; Nikolay A.,0,126,0,0
1668575966813,ECE 277,A00,103668,An; Cheolhong,0,151,0,0
1668575967244,ECE 279,A00,117947,Hall; Drew A.,0,22,0,0
1668575968101,ECE 283,A00,103670,Hsueh; Tzu-Chien,0,57,0,0
1668575968528,ECE 284,A00,103671,Turakhia; Yatish Girish,0,40,0,0
1668575968956,ECE 285,A00,103672,Zheng; Yang,0,41,0,0
1668575968956,ECE 285,B00,103673,Sworder; David D.,0,61,0,0
1668575969382,ECE 287,A00,103676,Javidi; Tara,0,8,0,0
1668575969807,MATH 200B,A00,098023,Salehi Golsefidy; Alireza,7,0,15,8
1668575970230,MATH 202B,A00,098024,Rhoades; Brendon Patrick,7,0,15,8
1668575970654,MATH 203B,A00,098025,Oprea; Dragos N.,9,0,15,6
1668575971085,MATH 204B,A00,098026,Sorensen; Claus M,13,0,15,2
1668575971514,MATH 208,A00,098027,Izadi; Elham,7,0,10,3
1668575971962,MATH 209,A00,098028,Pollack; Aaron,10,0,10,0
1668575972386,MATH 211A,A00,112919,Rogalski; Daniel,8,0,10,2
1668575972808,MATH 211B,A00,112920,Seward; Brandon M.,9,0,10,1
1668575973233,MATH 218,A00,098029,Li; Bo,10,0,10,0
1668575973663,MATH 220B,A00,098030,Novak; Jonathan I,10,0,15,5
1668575974089,MATH 221A,A00,098031,Ebenfelt; Peter F,12,0,15,3
1668575974519,MATH 231B,A00,098032,Zlatos; Andrej,9,0,15,6
1668575974950,MATH 240B,A00,098033,Ni; Lei,7,0,15,8
1668575975376,MATH 243,A00,098034,Jekel; David Andrew,10,0,10,0
1668575975804,MATH 245A,A00,098035,Nie; Jiawang,0,7,15,18
1668575976229,MATH 248,A00,098036,Bejenaru; Ioan,10,0,10,0
1668575976654,MATH 250B,A00,098037,Spolaor; Luca,12,0,15,3
1668575977080,MATH 258,A00,098038,Ni; Lei,8,0,10,2
1668575977505,MATH 264B,A00,098041,Rhoades; Brendon Patrick,7,0,15,8
1668575977928,MATH 268,A00,098042,Buss; Samuel R,10,0,10,0
1668575978363,MATH 269,A00,098043,Rhoades; Brendon Patrick,10,0,10,0
1668575978799,MATH 270B,A00,098044,Li; Bo,6,0,15,9
1668575979227,MATH 272B,A00,098045,Holst; Michael J,13,0,15,2
1668575979653,MATH 273A,A00,098046,Tian; Xiaochuan,10,0,15,5
1668575980078,MATH 275,A01,098048,Tian; Xiaochuan,6,0,10,4
1668575980503,MATH 278A,A00,098049,Holst; Michael J,6,0,10,4
1668575980929,MATH 278B,A00,098050,Cloninger; Alexander,10,0,10,0
1668575981354,MATH 278C,A00,098051,Nie; Jiawang,5,0,10,5
1668575981782,MATH 280B,A00,098052,Zheng; Tianyi,6,0,15,9
1668575982221,MATH 281B,A00,098053,Bradic; Jelena,0,2,15,15
1668575982648,MATH 282B,A00,098054,Arias-Castro; Ery,0,1,15,15
1668575983071,MATH 285,A00,098055,Fitzsimmons; Patrick J,0,4,15,16
1668575983495,MATH 287B,A00,098056,Arias-Castro; Ery,1,0,15,14
1668575983925,MATH 288,A00,098057,Agarwal; Pooja,9,0,10,1
1668575983925,MATH 288,B00,098058,Zhang; Danna,8,0,10,2
1668575983925,MATH 288,C00,098059,Williams; Ruth J,9,0,10,1
1668575984348,MATH 290B,A00,098060,Roberts; Justin Deritter,12,0,15,3
1668575984771,MATH 292,A00,098061,Belmont; Eva Kinoshita,10,0,10,0
1668575985195,MATH 295,A00,098062,Suk; Andrew Hoon,47,0,50,3
1668575985621,MATH 296,A00,098063,Novak; Jonathan I,20,0,20,0
1668575986045,MATH 297,001,098064,Gamst; Anthony Collins,9997,0,9999,2
1668576501014,COGS 205,A00,101395,Chiba; Andrea,19,0,20,1
1668576501445,COGS 210B,001,101404,Greene; Deanna Jacquelyn,9998,0,9999,1
1668576501445,COGS 210B,002,101417,Xia; Haijun,9999,0,9999,0
1668576501445,COGS 210B,003,101422,Nitz; Douglas A.,9999,0,9999,0
1668576501445,COGS 210B,004,101423,Hollan; James D.,9998,0,9999,1
1668576501445,COGS 210B,005,101424,Deak; Gedeon O.,9998,0,9999,1
1668576501445,COGS 210B,006,101425,Rossano; Federico,9999,0,9999,0
1668576501870,COGS 211B,A00,101427,Coulson; Seana M,9996,0,9999,3
1668576502294,COGS 220,A00,101428,Hollan; James D.,0,17,25,25
1668576502720,COGS 229,A00,101429,Dow; Steven P,17,0,25,8
1668576503164,COGS 230,A00,101430,Klemmer; Scott R,6,0,17,11
1668576503589,COGS 234,A00,101431,Xia; Haijun,0,1,25,25
1668576504011,COGS 260,A00,101432,Kiyonaga; Anastasia,21,0,25,4
1668576504011,COGS 260,B00,101433,Kirsh; David Joel,15,0,25,10
1668576504435,CSE 202,A00,102371,Impagliazzo; Russell,0,70,0,0
1668576504863,CSE 203B,A01,102373,Cheng; Chung Kuan,0,70,0,0
1668576505287,CSE 208,A00,102374,Micciancio; Daniele,0,5,0,0
1668576505727,CSE 209A,A00,112895,Impagliazzo; Russell,0,14,15,15
1668576506153,CSE 209B,A00,108005,Bellare; Mihir,0,7,0,0
1668576506576,CSE 210,A00,113163,Coblenz; Michael J,0,96,0,0
1668576506999,CSE 219,A00,106111,Dow; Steven P,0,8,20,20
1668576507425,CSE 221,A00,102376,Voelker; Geoffrey M.,0,77,0,0
1668576507849,CSE 224,A01,102378,Porter; George M,0,180,0,0
1668576508278,CSE 229A,A00,102379,Savage; Stefan,0,14,0,0
1668576508716,CSE 229C,A00,102380,Munyaka; Imani N. S.,0,12,0,0
1668576509142,CSE 232B,A00,102382,Deutsch; Alin Bernard,0,39,0,0
1668576509571,CSE 234,A01,112904,Kumar; Arun Kumar,0,0,0,0
1668576509996,CSE 237A,A00,102383,Rosing; Tajana Simunic,0,57,0,0
1668576510425,CSE 239A,A00,102384,Deutsch; Alin Bernard,0,18,0,0
1668576510851,CSE 239B,A00,102385,Polikarpova; Nadezhda,0,11,0,0
1668576511285,CSE 240A,A00,102386,Pannuto; Patrick William,0,49,0,0
1668576511714,CSE 240B,A00,102387,Zhao; Jishen,0,51,0,0
1668576512138,CSE 241A,A00,106406,Kang; Mingu,0,9,0,0
1668576512578,CSE 249B,A00,102388,Kahng; Andrew Byun,0,7,8,8
1668576513015,CSE 251B,A01,102392,Cottrell; Garrison W,0,54,0,0
1668576513015,CSE 251B,A02,102393,Cottrell; Garrison W,0,36,0,0
1668576513449,CSE 252B,A00,102394,Ochoa; Benjamin Lawrence,0,65,0,0
1668576513875,CSE 257,A01,102396,Gao; Sicun,0,160,0,0
1668576514299,CSE 272,A00,102397,Li; Tzumao,0,22,0,0
1668576514732,CSE 274,A00,111323,Chern; Albert Ren-Haur,0,16,0,0
1668576515174,CSE 282,A00,102398,Pevzner; Pavel Arkadjevich,0,0,0,0
1668576515610,CSE 284,A00,114175,Gymrek; Melissa Ann,0,33,0,0
1668576516039,CSE 290,A00,102399,Chandraker; Manmohan Krishna,0,11,0,0
1668576516039,CSE 290,B00,102400,Vaccaro; Kristen Marie,0,10,25,25
1668576516039,CSE 290,C00,102414,Pannuto; Patrick William,0,1,25,25
1668576516039,CSE 290,D00,102427,Pevzner; Pavel Arkadjevich,0,0,0,0
1668576516039,CSE 290,E00,102429,Zhao; Jishen,0,6,0,0
1668576516039,CSE 290,F00,102436,Tullsen; Dean Michael,0,6,0,0
1668576516039,CSE 290,G00,102440,Christensen; Henrik I,0,8,20,20
1668576516473,CSE 291,A00,102443,Su; Hao,0,0,0,0
1668576516473,CSE 291,B00,102448,Polikarpova; Nadezhda,0,0,0,0
1668576516473,CSE 291,C00,102453,Vaccaro; Kristen Marie,0,0,0,0
1668576516473,CSE 291,D00,111343,Savage; Stefan,0,0,0,0
1668576516473,CSE 291,E00,116474,Claffy; Kimberly Claire,0,0,0,0
1668576516473,CSE 291,F00,116479,Pasquale; Joseph,0,0,0,0
1668576516913,CSE 293,001,119111,Bafna; Vineet,9999,0,9999,0
1668576516913,CSE 293,002,119118,Bellare; Mihir,9999,0,9999,0
1668576516913,CSE 293,003,119122,Berg-Kirkpatrick; Taylor D,9999,0,9999,0
1668576516913,CSE 293,004,119135,Christensen; Henrik I,9999,0,9999,0
1668576516913,CSE 293,005,119142,Cottrell; Garrison W,9999,0,9999,0
1668576516913,CSE 293,006,119146,Deutsch; Alin Bernard,9999,0,9999,0
1668576516913,CSE 293,007,119159,Esmaeilzadeh; Hadi,9999,0,9999,0
1668576516913,CSE 293,008,119166,Freund; Yoav,9999,0,9999,0
1668576516913,CSE 293,009,119170,Griswold; William G.,9999,0,9999,0
1668576516913,CSE 293,010,119183,Gymrek; Melissa Ann,9999,0,9999,0
1668576516913,CSE 293,011,119190,Heninger; Nadia A,9999,0,9999,0
1668576516913,CSE 293,012,119230,Impagliazzo; Russell,9999,0,9999,0
1668576516913,CSE 293,013,119232,Jhala; Ranjit,9999,0,9999,0
1668576516913,CSE 293,014,119233,Kahng; Andrew Byun,9999,0,9999,0
1668576516913,CSE 293,015,119298,Kane; Daniel Mertz,9999,0,9999,0
1668576516913,CSE 293,016,119299,Kriegman; David J,9999,0,9999,0
1668576516913,CSE 293,017,119300,Kumar; Arun Kumar,9999,0,9999,0
1668576516913,CSE 293,018,119301,Lerner; Sorin,9999,0,9999,0
1668576516913,CSE 293,019,119302,Lovett; Shachar,9999,0,9999,0
1668576516913,CSE 293,020,119303,McAuley; Julian John,9999,0,9999,0
1668576516913,CSE 293,021,119304,Micciancio; Daniele,9999,0,9999,0
1668576516913,CSE 293,022,119367,Orailoglu; Alex,9999,0,9999,0
1668576516913,CSE 293,023,119382,Paturi; Ramamohan,9999,0,9999,0
1668576516913,CSE 293,024,119404,Polikarpova; Nadezhda,9999,0,9999,0
1668576516913,CSE 293,025,119406,Politz; Joseph Gibbs,9999,0,9999,0
1668576516913,CSE 293,026,119411,Porter; George M,9999,0,9999,0
1668576516913,CSE 293,027,119414,Porter; Leonard Emerson,9999,0,9999,0
1668576516913,CSE 293,028,119416,Ramamoorthi; Ravi,9999,0,9999,0
1668576516913,CSE 293,029,119417,Sahoo; Debashis,9999,0,9999,0
1668576516913,CSE 293,030,119420,Saul; Lawrence,9999,0,9999,0
1668576516913,CSE 293,031,119421,Savage; Stefan,9999,0,9999,0
1668576516913,CSE 293,032,119425,Schulze; Jurgen P.,9999,0,9999,0
1668576516913,CSE 293,033,119426,Snoeren; Alex C.,9999,0,9999,0
1668576516913,CSE 293,034,119428,Shang; Jingbo,9999,0,9999,0
1668576516913,CSE 293,035,119430,Stefan; Deian,9999,0,9999,0
1668576516913,CSE 293,036,119431,Su; Hao,9999,0,9999,0
1668576516913,CSE 293,037,119433,Swanson; Steven James,9999,0,9999,0
1668576516913,CSE 293,038,119435,Tullsen; Dean Michael,9999,0,9999,0
1668576516913,CSE 293,039,119483,Voelker; Geoffrey M.,9999,0,9999,0
1668576516913,CSE 293,040,119537,Zhao; Jishen,9999,0,9999,0
1668576516913,CSE 293,041,119538,Zhou; Yuan-Yuan,9999,0,9999,0
1668576516913,CSE 293,042,119539,Gao; Sicun,9999,0,9999,0
1668576516913,CSE 293,043,119540,Weibel; Nadir,9999,0,9999,0
1668576516913,CSE 293,044,119541,Gupta; Rajesh K.,9999,0,9999,0
1668576516913,CSE 293,045,126410,Vaccaro; Kristen Marie,9999,0,9999,0
1668576516913,CSE 293,046,126411,Klemke; Richard,9999,0,9999,0
1668576517338,CSE 294,A00,102459,Voelker; Geoffrey M.,0,2,0,0
1668576517338,CSE 294,B00,111322,Orailoglu; Alex,0,2,0,0
1668576517763,DSE 201,A00,096914,Deutsch; Alin Bernard,30,0,30,0
1668576518195,DSE 210,A00,096915,Dasgupta; Sanjoy,30,0,30,0
1668576518629,DSE 260A,A00,096916,Altintas De Callaf; Ilkay,30,0,30,0
1668576519081,ECE 200,001,103586,Antipa; Nicholas A,9999,0,9999,0
1668576519081,ECE 200,002,103587,Atanasov; Nikolay A.,9999,0,9999,0
1668576519081,ECE 200,003,103588,Bharadia; Dinesh,9999,0,9999,0
1668576519081,ECE 200,004,103589,Cheng; Chung Kuan,9999,0,9999,0
1668576519081,ECE 200,005,103590,Cosman; Pamela C.,9999,0,9999,0
1668576519081,ECE 200,006,103591,Dayeh; Shadi Ahmad,9999,0,9999,0
1668576519081,ECE 200,007,103592,Fainman; Yeshaiahu,9999,0,9999,0
1668576519081,ECE 200,008,103593,Ford; Joseph Earl,9999,0,9999,0
1668576519081,ECE 200,009,103594,Franceschetti; Massimo,9999,0,9999,0
1668576519081,ECE 200,010,103595,Fullerton; Eric E,9999,0,9999,0
1668576519081,ECE 200,011,103596,Galton; Ian A,9999,0,9999,0
1668576519081,ECE 200,012,103597,Gilja; Vikash,9999,0,9999,0
1668576519081,ECE 200,013,103598,Hall; Drew A.,9999,0,9999,0
1668576519081,ECE 200,014,103599,Hsueh; Tzu-Chien,9999,0,9999,0
1668576519081,ECE 200,015,103600,Javidi; Tara,9999,0,9999,0
1668576519081,ECE 200,016,103601,Kahng; Andrew Byun,9999,0,9999,0
1668576519081,ECE 200,017,103602,Kim; Young-Han,9999,0,9999,0
1668576519081,ECE 200,018,103603,Koushanfar; Farinaz,9999,0,9999,0
1668576519081,ECE 200,019,103604,Kuzum; Duygu,9999,0,9999,0
1668576519081,ECE 200,020,103605,Le; Hanh-Phuc,9999,0,9999,0
1668576519081,ECE 200,021,103606,Lin; Bill,9999,0,9999,0
1668576519081,ECE 200,022,103607,Liu; Zhaowei,9998,0,9999,1
1668576519081,ECE 200,023,103608,Lo; Yu-Hwa,9999,0,9999,0
1668576519081,ECE 200,024,103609,Lomakin; Vitaliy,9999,0,9999,0
1668576519081,ECE 200,025,103610,Mercier; Patrick Philip,9999,0,9999,0
1668576519081,ECE 200,026,103611,Meyer; Florian,9999,0,9999,0
1668576519081,ECE 200,027,103612,Milstein; Laurence B.,9999,0,9999,0
1668576519081,ECE 200,028,103613,Mir Arabbaygi; Siavash,9999,0,9999,0
1668576519081,ECE 200,029,103614,Mookherjea; Shayan,9999,0,9999,0
1668576519081,ECE 200,030,103615,Morris; Karcher William,9999,0,9999,0
1668576519081,ECE 200,031,103616,Ng; Tse Nga,9999,0,9999,0
1668576519081,ECE 200,032,103617,Nguyen; Truong Quang,9999,0,9999,0
1668576519081,ECE 200,033,103618,Nomura; Kenji,9999,0,9999,0
1668576519081,ECE 200,034,103619,Orlitsky; Alon,9999,0,9999,0
1668576519081,ECE 200,035,103620,Pal; Piya,9999,0,9999,0
1668576519081,ECE 200,036,103621,Papen; George C.,9999,0,9999,0
1668576519081,ECE 200,037,103622,Radic; Stojan,9999,0,9999,0
1668576519081,ECE 200,038,103623,Rao; Bhaskar D.,9999,0,9999,0
1668576519081,ECE 200,039,103624,Rao; Ramesh R,9999,0,9999,0
1668576519081,ECE 200,040,103625,Rebeiz; Gabriel,9999,0,9999,0
1668576519081,ECE 200,041,103626,Sanford; John R,9999,0,9999,0
1668576519081,ECE 200,042,103627,Siegel; Paul H.,9999,0,9999,0
1668576519081,ECE 200,043,103628,Sievenpiper; Daniel F.,9999,0,9999,0
1668576519081,ECE 200,044,103629,Sworder; David D.,9999,0,9999,0
1668576519081,ECE 200,045,103630,Taur; Yuan,9999,0,9999,0
1668576519081,ECE 200,046,103631,Touri; Behrouz,9999,0,9999,0
1668576519081,ECE 200,047,103632,Trivedi; Mohan M.,9999,0,9999,0
1668576519081,ECE 200,048,103633,Vasconcelos; Nuno,9999,0,9999,0
1668576519081,ECE 200,049,103634,Wang; Xiaolong,9999,0,9999,0
1668576519081,ECE 200,050,103635,Xie; Pengtao,9999,0,9999,0
1668576519081,ECE 200,051,103636,Yip; Michael,9999,0,9999,0
1668576519081,ECE 200,052,103637,Zeger; Kenneth A.,999,0,999,0
1668576519081,ECE 200,053,103638,Zhang; Xinyu,9999,0,9999,0
1668576519081,ECE 200,054,103639,Turakhia; Yatish Girish,9999,0,9999,0
1668576519081,ECE 200,055,103640,Kang; Mingu,9999,0,9999,0
1668576519081,ECE 200,056,103641,Shi; Yuanyuan,9999,0,9999,0
1668576519081,ECE 200,057,103642,Wang; Edward Jay,9999,0,9999,0
1668576519081,ECE 200,058,103643,Zheng; Yang,9999,0,9999,0
1668576519601,ECE 202,A00,103644,Kuzum; Duygu,0,46,0,0
1668576520037,ECE 212BN,A00,103646,Ng; Tse Nga,0,10,0,0
1668576520462,ECE 221,A00,111493,Staff,0,0,0,0
1668576520886,ECE 222B,A00,103647,Lomakin; Vitaliy,0,21,0,0
1668576521310,ECE 230B,A00,103648,Taur; Yuan,0,4,0,0
1668576521737,ECE 238B,A00,103649,Garay; Javier,0,0,0,0
1668576522165,ECE 240B,A00,112900,Fainman; Yeshaiahu,0,8,0,0
1668576522590,ECE 247A,A00,103650,Jokerst; Jesse Vincent,0,6,0,0
1668576523015,ECE 247B,A00,103651,Wang; Joseph,0,15,0,0
1668576523438,ECE 250,A00,103652,Siegel; Paul H.,0,84,0,0
1668576523862,ECE 251A,A00,103654,Rao; Bhaskar D.,0,65,0,0
1668576524290,ECE 257B,A00,103655,Bharadia; Dinesh,0,33,0,0
1668576524721,ECE 258A,A00,103656,Milstein; Laurence B.,0,29,0,0
1668576525149,ECE 260B,A00,103658,Kang; Mingu,0,121,0,0
1668576525578,ECE 264A,A00,103659,Galton; Ian A,0,45,0,31
1668576526002,ECE 265A,A00,103661,Gudem; Prasad S.S.,0,45,0,32
1668576526425,ECE 265D,A00,103662,Gudem; Prasad S.S.,0,27,0,0
1668576526850,ECE 268,A00,103663,Koushanfar; Farinaz,0,44,0,0
1668576527281,ECE 269,A01,103665,Pal; Piya,0,222,0,0
1668576527703,ECE 271B,A00,103666,Vasconcelos; Manuela,0,78,0,0
1668576528132,ECE 276A,A00,103667,Atanasov; Nikolay A.,0,126,0,0
1668576528560,ECE 277,A00,103668,An; Cheolhong,0,151,0,0
1668576528999,ECE 279,A00,117947,Hall; Drew A.,0,22,0,0
1668576529865,ECE 283,A00,103670,Hsueh; Tzu-Chien,0,57,0,0
1668576530289,ECE 284,A00,103671,Turakhia; Yatish Girish,0,40,0,0
1668576530732,ECE 285,A00,103672,Zheng; Yang,0,41,0,0
1668576530732,ECE 285,B00,103673,Sworder; David D.,0,61,0,0
1668576531157,ECE 287,A00,103676,Javidi; Tara,0,8,0,0
1668576531589,MATH 200B,A00,098023,Salehi Golsefidy; Alireza,7,0,15,8
1668576532012,MATH 202B,A00,098024,Rhoades; Brendon Patrick,7,0,15,8
1668576532435,MATH 203B,A00,098025,Oprea; Dragos N.,9,0,15,6
1668576532858,MATH 204B,A00,098026,Sorensen; Claus M,13,0,15,2
1668576533291,MATH 208,A00,098027,Izadi; Elham,7,0,10,3
1668576533715,MATH 209,A00,098028,Pollack; Aaron,10,0,10,0
1668576534141,MATH 211A,A00,112919,Rogalski; Daniel,8,0,10,2
1668576534566,MATH 211B,A00,112920,Seward; Brandon M.,9,0,10,1
1668576534991,MATH 218,A00,098029,Li; Bo,10,0,10,0
1668576535418,MATH 220B,A00,098030,Novak; Jonathan I,10,0,15,5
1668576535850,MATH 221A,A00,098031,Ebenfelt; Peter F,12,0,15,3
1668576536278,MATH 231B,A00,098032,Zlatos; Andrej,9,0,15,6
1668576536706,MATH 240B,A00,098033,Ni; Lei,7,0,15,8
1668576537137,MATH 243,A00,098034,Jekel; David Andrew,10,0,10,0
1668576537562,MATH 245A,A00,098035,Nie; Jiawang,0,7,15,18
1668576537986,MATH 248,A00,098036,Bejenaru; Ioan,10,0,10,0
1668576538413,MATH 250B,A00,098037,Spolaor; Luca,12,0,15,3
1668576538837,MATH 258,A00,098038,Ni; Lei,8,0,10,2
1668576539261,MATH 264B,A00,098041,Rhoades; Brendon Patrick,7,0,15,8
1668576539687,MATH 268,A00,098042,Buss; Samuel R,10,0,10,0
1668576540111,MATH 269,A00,098043,Rhoades; Brendon Patrick,10,0,10,0
1668576540534,MATH 270B,A00,098044,Li; Bo,6,0,15,9
1668576540980,MATH 272B,A00,098045,Holst; Michael J,13,0,15,2
1668576541408,MATH 273A,A00,098046,Tian; Xiaochuan,10,0,15,5
1668576541841,MATH 275,A01,098048,Tian; Xiaochuan,6,0,10,4
1668576542277,MATH 278A,A00,098049,Holst; Michael J,6,0,10,4
1668576542699,MATH 278B,A00,098050,Cloninger; Alexander,10,0,10,0
1668576543125,MATH 278C,A00,098051,Nie; Jiawang,5,0,10,5
1668576543547,MATH 280B,A00,098052,Zheng; Tianyi,6,0,15,9
1668576543971,MATH 281B,A00,098053,Bradic; Jelena,0,2,15,15
1668576544397,MATH 282B,A00,098054,Arias-Castro; Ery,0,1,15,15
1668576544824,MATH 285,A00,098055,Fitzsimmons; Patrick J,0,4,15,16
1668576545251,MATH 287B,A00,098056,Arias-Castro; Ery,1,0,15,14
1668576545674,MATH 288,A00,098057,Agarwal; Pooja,9,0,10,1
1668576545674,MATH 288,B00,098058,Zhang; Danna,8,0,10,2
1668576545674,MATH 288,C00,098059,Williams; Ruth J,9,0,10,1
1668576546097,MATH 290B,A00,098060,Roberts; Justin Deritter,12,0,15,3
1668576546520,MATH 292,A00,098061,Belmont; Eva Kinoshita,10,0,10,0
1668576546948,MATH 295,A00,098062,Suk; Andrew Hoon,47,0,50,3
1668576547369,MATH 296,A00,098063,Novak; Jonathan I,20,0,20,0
1668576547795,MATH 297,001,098064,Gamst; Anthony Collins,9997,0,9999,2
1668577051111,COGS 205,A00,101395,Chiba; Andrea,19,0,20,1
1668577051535,COGS 210B,001,101404,Greene; Deanna Jacquelyn,9998,0,9999,1
1668577051535,COGS 210B,002,101417,Xia; Haijun,9999,0,9999,0
1668577051535,COGS 210B,003,101422,Nitz; Douglas A.,9999,0,9999,0
1668577051535,COGS 210B,004,101423,Hollan; James D.,9998,0,9999,1
1668577051535,COGS 210B,005,101424,Deak; Gedeon O.,9998,0,9999,1
1668577051535,COGS 210B,006,101425,Rossano; Federico,9999,0,9999,0
1668577051957,COGS 211B,A00,101427,Coulson; Seana M,9996,0,9999,3
1668577052383,COGS 220,A00,101428,Hollan; James D.,0,17,25,25
1668577052808,COGS 229,A00,101429,Dow; Steven P,17,0,25,8
1668577053230,COGS 230,A00,101430,Klemmer; Scott R,6,0,17,11
1668577053658,COGS 234,A00,101431,Xia; Haijun,0,1,25,25
1668577054094,COGS 260,A00,101432,Kiyonaga; Anastasia,21,0,25,4
1668577054094,COGS 260,B00,101433,Kirsh; David Joel,15,0,25,10
1668577054529,CSE 202,A00,102371,Impagliazzo; Russell,0,70,0,0
1668577054955,CSE 203B,A01,102373,Cheng; Chung Kuan,0,70,0,0
1668577055379,CSE 208,A00,102374,Micciancio; Daniele,0,5,0,0
1668577055803,CSE 209A,A00,112895,Impagliazzo; Russell,0,14,15,15
1668577056227,CSE 209B,A00,108005,Bellare; Mihir,0,7,0,0
1668577056653,CSE 210,A00,113163,Coblenz; Michael J,0,96,0,0
1668577057082,CSE 219,A00,106111,Dow; Steven P,0,8,20,20
1668577057522,CSE 221,A00,102376,Voelker; Geoffrey M.,0,77,0,0
1668577057945,CSE 224,A01,102378,Porter; George M,0,180,0,0
1668577058372,CSE 229A,A00,102379,Savage; Stefan,0,14,0,0
1668577058795,CSE 229C,A00,102380,Munyaka; Imani N. S.,0,12,0,0
1668577059218,CSE 232B,A00,102382,Deutsch; Alin Bernard,0,39,0,0
1668577059642,CSE 234,A01,112904,Kumar; Arun Kumar,0,0,0,0
1668577060070,CSE 237A,A00,102383,Rosing; Tajana Simunic,0,57,0,0
1668577060508,CSE 239A,A00,102384,Deutsch; Alin Bernard,0,18,0,0
1668577060934,CSE 239B,A00,102385,Polikarpova; Nadezhda,0,11,0,0
1668577061359,CSE 240A,A00,102386,Pannuto; Patrick William,0,49,0,0
1668577061785,CSE 240B,A00,102387,Zhao; Jishen,0,51,0,0
1668577062215,CSE 241A,A00,106406,Kang; Mingu,0,9,0,0
1668577062640,CSE 249B,A00,102388,Kahng; Andrew Byun,0,7,8,8
1668577063064,CSE 251B,A01,102392,Cottrell; Garrison W,0,54,0,0
1668577063064,CSE 251B,A02,102393,Cottrell; Garrison W,0,36,0,0
1668577063492,CSE 252B,A00,102394,Ochoa; Benjamin Lawrence,0,64,0,0
1668577063918,CSE 257,A01,102396,Gao; Sicun,0,160,0,0
1668577064351,CSE 272,A00,102397,Li; Tzumao,0,22,0,0
1668577064773,CSE 274,A00,111323,Chern; Albert Ren-Haur,0,16,0,0
1668577065201,CSE 282,A00,102398,Pevzner; Pavel Arkadjevich,0,0,0,0
1668577065625,CSE 284,A00,114175,Gymrek; Melissa Ann,0,33,0,0
1668577066055,CSE 290,A00,102399,Chandraker; Manmohan Krishna,0,11,0,0
1668577066055,CSE 290,B00,102400,Vaccaro; Kristen Marie,0,10,25,25
1668577066055,CSE 290,C00,102414,Pannuto; Patrick William,0,1,25,25
1668577066055,CSE 290,D00,102427,Pevzner; Pavel Arkadjevich,0,0,0,0
1668577066055,CSE 290,E00,102429,Zhao; Jishen,0,6,0,0
1668577066055,CSE 290,F00,102436,Tullsen; Dean Michael,0,6,0,0
1668577066055,CSE 290,G00,102440,Christensen; Henrik I,0,8,20,20
1668577066482,CSE 291,A00,102443,Su; Hao,0,0,0,0
1668577066482,CSE 291,B00,102448,Polikarpova; Nadezhda,0,0,0,0
1668577066482,CSE 291,C00,102453,Vaccaro; Kristen Marie,0,0,0,0
1668577066482,CSE 291,D00,111343,Savage; Stefan,0,0,0,0
1668577066482,CSE 291,E00,116474,Claffy; Kimberly Claire,0,0,0,0
1668577066482,CSE 291,F00,116479,Pasquale; Joseph,0,0,0,0
1668577066909,CSE 293,001,119111,Bafna; Vineet,9999,0,9999,0
1668577066909,CSE 293,002,119118,Bellare; Mihir,9999,0,9999,0
1668577066909,CSE 293,003,119122,Berg-Kirkpatrick; Taylor D,9999,0,9999,0
1668577066909,CSE 293,004,119135,Christensen; Henrik I,9999,0,9999,0
1668577066909,CSE 293,005,119142,Cottrell; Garrison W,9999,0,9999,0
1668577066909,CSE 293,006,119146,Deutsch; Alin Bernard,9999,0,9999,0
1668577066909,CSE 293,007,119159,Esmaeilzadeh; Hadi,9999,0,9999,0
1668577066909,CSE 293,008,119166,Freund; Yoav,9999,0,9999,0
1668577066909,CSE 293,009,119170,Griswold; William G.,9999,0,9999,0
1668577066909,CSE 293,010,119183,Gymrek; Melissa Ann,9999,0,9999,0
1668577066909,CSE 293,011,119190,Heninger; Nadia A,9999,0,9999,0
1668577066909,CSE 293,012,119230,Impagliazzo; Russell,9999,0,9999,0
1668577066909,CSE 293,013,119232,Jhala; Ranjit,9999,0,9999,0
1668577066909,CSE 293,014,119233,Kahng; Andrew Byun,9999,0,9999,0
1668577066909,CSE 293,015,119298,Kane; Daniel Mertz,9999,0,9999,0
1668577066909,CSE 293,016,119299,Kriegman; David J,9999,0,9999,0
1668577066909,CSE 293,017,119300,Kumar; Arun Kumar,9999,0,9999,0
1668577066909,CSE 293,018,119301,Lerner; Sorin,9999,0,9999,0
1668577066909,CSE 293,019,119302,Lovett; Shachar,9999,0,9999,0
1668577066909,CSE 293,020,119303,McAuley; Julian John,9999,0,9999,0
1668577066909,CSE 293,021,119304,Micciancio; Daniele,9999,0,9999,0
1668577066909,CSE 293,022,119367,Orailoglu; Alex,9999,0,9999,0
1668577066909,CSE 293,023,119382,Paturi; Ramamohan,9999,0,9999,0
1668577066909,CSE 293,024,119404,Polikarpova; Nadezhda,9999,0,9999,0
1668577066909,CSE 293,025,119406,Politz; Joseph Gibbs,9999,0,9999,0
1668577066909,CSE 293,026,119411,Porter; George M,9999,0,9999,0
1668577066909,CSE 293,027,119414,Porter; Leonard Emerson,9999,0,9999,0
1668577066909,CSE 293,028,119416,Ramamoorthi; Ravi,9999,0,9999,0
1668577066909,CSE 293,029,119417,Sahoo; Debashis,9999,0,9999,0
1668577066909,CSE 293,030,119420,Saul; Lawrence,9999,0,9999,0
1668577066909,CSE 293,031,119421,Savage; Stefan,9999,0,9999,0
1668577066909,CSE 293,032,119425,Schulze; Jurgen P.,9999,0,9999,0
1668577066909,CSE 293,033,119426,Snoeren; Alex C.,9999,0,9999,0
1668577066909,CSE 293,034,119428,Shang; Jingbo,9999,0,9999,0
1668577066909,CSE 293,035,119430,Stefan; Deian,9999,0,9999,0
1668577066909,CSE 293,036,119431,Su; Hao,9999,0,9999,0
1668577066909,CSE 293,037,119433,Swanson; Steven James,9999,0,9999,0
1668577066909,CSE 293,038,119435,Tullsen; Dean Michael,9999,0,9999,0
1668577066909,CSE 293,039,119483,Voelker; Geoffrey M.,9999,0,9999,0
1668577066909,CSE 293,040,119537,Zhao; Jishen,9999,0,9999,0
1668577066909,CSE 293,041,119538,Zhou; Yuan-Yuan,9999,0,9999,0
1668577066909,CSE 293,042,119539,Gao; Sicun,9999,0,9999,0
1668577066909,CSE 293,043,119540,Weibel; Nadir,9999,0,9999,0
1668577066909,CSE 293,044,119541,Gupta; Rajesh K.,9999,0,9999,0
1668577066909,CSE 293,045,126410,Vaccaro; Kristen Marie,9999,0,9999,0
1668577066909,CSE 293,046,126411,Klemke; Richard,9999,0,9999,0
1668577067341,CSE 294,A00,102459,Voelker; Geoffrey M.,0,2,0,0
1668577067341,CSE 294,B00,111322,Orailoglu; Alex,0,2,0,0
1668577067769,DSE 201,A00,096914,Deutsch; Alin Bernard,30,0,30,0
1668577068193,DSE 210,A00,096915,Dasgupta; Sanjoy,30,0,30,0
1668577068616,DSE 260A,A00,096916,Altintas De Callaf; Ilkay,30,0,30,0
1668577069090,ECE 200,001,103586,Antipa; Nicholas A,9999,0,9999,0
1668577069090,ECE 200,002,103587,Atanasov; Nikolay A.,9999,0,9999,0
1668577069090,ECE 200,003,103588,Bharadia; Dinesh,9999,0,9999,0
1668577069090,ECE 200,004,103589,Cheng; Chung Kuan,9999,0,9999,0
1668577069090,ECE 200,005,103590,Cosman; Pamela C.,9999,0,9999,0
1668577069090,ECE 200,006,103591,Dayeh; Shadi Ahmad,9999,0,9999,0
1668577069090,ECE 200,007,103592,Fainman; Yeshaiahu,9999,0,9999,0
1668577069090,ECE 200,008,103593,Ford; Joseph Earl,9999,0,9999,0
1668577069090,ECE 200,009,103594,Franceschetti; Massimo,9999,0,9999,0
1668577069090,ECE 200,010,103595,Fullerton; Eric E,9999,0,9999,0
1668577069090,ECE 200,011,103596,Galton; Ian A,9999,0,9999,0
1668577069090,ECE 200,012,103597,Gilja; Vikash,9999,0,9999,0
1668577069090,ECE 200,013,103598,Hall; Drew A.,9999,0,9999,0
1668577069090,ECE 200,014,103599,Hsueh; Tzu-Chien,9999,0,9999,0
1668577069090,ECE 200,015,103600,Javidi; Tara,9999,0,9999,0
1668577069090,ECE 200,016,103601,Kahng; Andrew Byun,9999,0,9999,0
1668577069090,ECE 200,017,103602,Kim; Young-Han,9999,0,9999,0
1668577069090,ECE 200,018,103603,Koushanfar; Farinaz,9999,0,9999,0
1668577069090,ECE 200,019,103604,Kuzum; Duygu,9999,0,9999,0
1668577069090,ECE 200,020,103605,Le; Hanh-Phuc,9999,0,9999,0
1668577069090,ECE 200,021,103606,Lin; Bill,9999,0,9999,0
1668577069090,ECE 200,022,103607,Liu; Zhaowei,9998,0,9999,1
1668577069090,ECE 200,023,103608,Lo; Yu-Hwa,9999,0,9999,0
1668577069090,ECE 200,024,103609,Lomakin; Vitaliy,9999,0,9999,0
1668577069090,ECE 200,025,103610,Mercier; Patrick Philip,9999,0,9999,0
1668577069090,ECE 200,026,103611,Meyer; Florian,9999,0,9999,0
1668577069090,ECE 200,027,103612,Milstein; Laurence B.,9999,0,9999,0
1668577069090,ECE 200,028,103613,Mir Arabbaygi; Siavash,9999,0,9999,0
1668577069090,ECE 200,029,103614,Mookherjea; Shayan,9999,0,9999,0
1668577069090,ECE 200,030,103615,Morris; Karcher William,9999,0,9999,0
1668577069090,ECE 200,031,103616,Ng; Tse Nga,9999,0,9999,0
1668577069090,ECE 200,032,103617,Nguyen; Truong Quang,9999,0,9999,0
1668577069090,ECE 200,033,103618,Nomura; Kenji,9999,0,9999,0
1668577069090,ECE 200,034,103619,Orlitsky; Alon,9999,0,9999,0
1668577069090,ECE 200,035,103620,Pal; Piya,9999,0,9999,0
1668577069090,ECE 200,036,103621,Papen; George C.,9999,0,9999,0
1668577069090,ECE 200,037,103622,Radic; Stojan,9999,0,9999,0
1668577069090,ECE 200,038,103623,Rao; Bhaskar D.,9999,0,9999,0
1668577069090,ECE 200,039,103624,Rao; Ramesh R,9999,0,9999,0
1668577069090,ECE 200,040,103625,Rebeiz; Gabriel,9999,0,9999,0
1668577069090,ECE 200,041,103626,Sanford; John R,9999,0,9999,0
1668577069090,ECE 200,042,103627,Siegel; Paul H.,9999,0,9999,0
1668577069090,ECE 200,043,103628,Sievenpiper; Daniel F.,9999,0,9999,0
1668577069090,ECE 200,044,103629,Sworder; David D.,9999,0,9999,0
1668577069090,ECE 200,045,103630,Taur; Yuan,9999,0,9999,0
1668577069090,ECE 200,046,103631,Touri; Behrouz,9999,0,9999,0
1668577069090,ECE 200,047,103632,Trivedi; Mohan M.,9999,0,9999,0
1668577069090,ECE 200,048,103633,Vasconcelos; Nuno,9999,0,9999,0
1668577069090,ECE 200,049,103634,Wang; Xiaolong,9999,0,9999,0
1668577069090,ECE 200,050,103635,Xie; Pengtao,9999,0,9999,0
1668577069090,ECE 200,051,103636,Yip; Michael,9999,0,9999,0
1668577069090,ECE 200,052,103637,Zeger; Kenneth A.,999,0,999,0
1668577069090,ECE 200,053,103638,Zhang; Xinyu,9999,0,9999,0
1668577069090,ECE 200,054,103639,Turakhia; Yatish Girish,9999,0,9999,0
1668577069090,ECE 200,055,103640,Kang; Mingu,9999,0,9999,0
1668577069090,ECE 200,056,103641,Shi; Yuanyuan,9999,0,9999,0
1668577069090,ECE 200,057,103642,Wang; Edward Jay,9999,0,9999,0
1668577069090,ECE 200,058,103643,Zheng; Yang,9999,0,9999,0
1668577069525,ECE 202,A00,103644,Kuzum; Duygu,0,46,0,0
1668577069951,ECE 212BN,A00,103646,Ng; Tse Nga,0,10,0,0
1668577070373,ECE 221,A00,111493,Staff,0,0,0,0
1668577070797,ECE 222B,A00,103647,Lomakin; Vitaliy,0,21,0,0
1668577071224,ECE 230B,A00,103648,Taur; Yuan,0,4,0,0
1668577071648,ECE 238B,A00,103649,Garay; Javier,0,0,0,0
1668577072071,ECE 240B,A00,112900,Fainman; Yeshaiahu,0,8,0,0
1668577072500,ECE 247A,A00,103650,Jokerst; Jesse Vincent,0,6,0,0
1668577072925,ECE 247B,A00,103651,Wang; Joseph,0,15,0,0
1668577073352,ECE 250,A00,103652,Siegel; Paul H.,0,84,0,0
1668577073773,ECE 251A,A00,103654,Rao; Bhaskar D.,0,65,0,0
1668577074200,ECE 257B,A00,103655,Bharadia; Dinesh,0,33,0,0
1668577074628,ECE 258A,A00,103656,Milstein; Laurence B.,0,29,0,0
1668577075061,ECE 260B,A00,103658,Kang; Mingu,0,121,0,0
1668577075486,ECE 264A,A00,103659,Galton; Ian A,0,45,0,31
1668577075909,ECE 265A,A00,103661,Gudem; Prasad S.S.,0,45,0,32
1668577076334,ECE 265D,A00,103662,Gudem; Prasad S.S.,0,27,0,0
1668577076761,ECE 268,A00,103663,Koushanfar; Farinaz,0,44,0,0
1668577077185,ECE 269,A01,103665,Pal; Piya,0,222,0,0
1668577077620,ECE 271B,A00,103666,Vasconcelos; Manuela,0,78,0,0
1668577078048,ECE 276A,A00,103667,Atanasov; Nikolay A.,0,127,0,0
1668577078477,ECE 277,A00,103668,An; Cheolhong,0,151,0,0
1668577078902,ECE 279,A00,117947,Hall; Drew A.,0,22,0,0
1668577079749,ECE 283,A00,103670,Hsueh; Tzu-Chien,0,57,0,0
1668577080193,ECE 284,A00,103671,Turakhia; Yatish Girish,0,40,0,0
1668577080616,ECE 285,A00,103672,Zheng; Yang,0,41,0,0
1668577080616,ECE 285,B00,103673,Sworder; David D.,0,61,0,0
1668577081046,ECE 287,A00,103676,Javidi; Tara,0,8,0,0
1668577081470,MATH 200B,A00,098023,Salehi Golsefidy; Alireza,7,0,15,8
1668577081902,MATH 202B,A00,098024,Rhoades; Brendon Patrick,7,0,15,8
1668577082327,MATH 203B,A00,098025,Oprea; Dragos N.,9,0,15,6
1668577082749,MATH 204B,A00,098026,Sorensen; Claus M,13,0,15,2
1668577083172,MATH 208,A00,098027,Izadi; Elham,7,0,10,3
1668577083597,MATH 209,A00,098028,Pollack; Aaron,10,0,10,0
1668577084021,MATH 211A,A00,112919,Rogalski; Daniel,8,0,10,2
1668577084545,MATH 211B,A00,112920,Seward; Brandon M.,9,0,10,1
1668577084982,MATH 218,A00,098029,Li; Bo,10,0,10,0
1668577085406,MATH 220B,A00,098030,Novak; Jonathan I,10,0,15,5
1668577085833,MATH 221A,A00,098031,Ebenfelt; Peter F,12,0,15,3
1668577086259,MATH 231B,A00,098032,Zlatos; Andrej,9,0,15,6
1668577086694,MATH 240B,A00,098033,Ni; Lei,7,0,15,8
1668577087119,MATH 243,A00,098034,Jekel; David Andrew,10,0,10,0
1668577087542,MATH 245A,A00,098035,Nie; Jiawang,0,7,15,18
1668577087966,MATH 248,A00,098036,Bejenaru; Ioan,10,0,10,0
1668577088388,MATH 250B,A00,098037,Spolaor; Luca,12,0,15,3
1668577088813,MATH 258,A00,098038,Ni; Lei,8,0,10,2
1668577089237,MATH 264B,A00,098041,Rhoades; Brendon Patrick,7,0,15,8
1668577089662,MATH 268,A00,098042,Buss; Samuel R,10,0,10,0
1668577090092,MATH 269,A00,098043,Rhoades; Brendon Patrick,10,0,10,0
1668577090522,MATH 270B,A00,098044,Li; Bo,6,0,15,9
1668577090949,MATH 272B,A00,098045,Holst; Michael J,13,0,15,2
1668577091374,MATH 273A,A00,098046,Tian; Xiaochuan,10,0,15,5
1668577091807,MATH 275,A01,098048,Tian; Xiaochuan,6,0,10,4
1668577092234,MATH 278A,A00,098049,Holst; Michael J,6,0,10,4
1668577092657,MATH 278B,A00,098050,Cloninger; Alexander,10,0,10,0
1668577093081,MATH 278C,A00,098051,Nie; Jiawang,5,0,10,5
1668577093504,MATH 280B,A00,098052,Zheng; Tianyi,6,0,15,9
1668577093925,MATH 281B,A00,098053,Bradic; Jelena,0,2,15,15
1668577094351,MATH 282B,A00,098054,Arias-Castro; Ery,0,1,15,15
1668577094773,MATH 285,A00,098055,Fitzsimmons; Patrick J,0,4,15,16
1668577095200,MATH 287B,A00,098056,Arias-Castro; Ery,1,0,15,14
1668577095630,MATH 288,A00,098057,Agarwal; Pooja,9,0,10,1
1668577095630,MATH 288,B00,098058,Zhang; Danna,8,0,10,2
1668577095630,MATH 288,C00,098059,Williams; Ruth J,9,0,10,1
1668577096053,MATH 290B,A00,098060,Roberts; Justin Deritter,12,0,15,3
1668577096476,MATH 292,A00,098061,Belmont; Eva Kinoshita,10,0,10,0
1668577096900,MATH 295,A00,098062,Suk; Andrew Hoon,47,0,50,3
1668577097333,MATH 296,A00,098063,Novak; Jonathan I,20,0,20,0
1668577097756,MATH 297,001,098064,Gamst; Anthony Collins,9997,0,9999,2
1668577600087,COGS 205,A00,101395,Chiba; Andrea,19,0,20,1
1668577600510,COGS 210B,001,101404,Greene; Deanna Jacquelyn,9998,0,9999,1
1668577600510,COGS 210B,002,101417,Xia; Haijun,9999,0,9999,0
1668577600510,COGS 210B,003,101422,Nitz; Douglas A.,9999,0,9999,0
1668577600510,COGS 210B,004,101423,Hollan; James D.,9998,0,9999,1
1668577600510,COGS 210B,005,101424,Deak; Gedeon O.,9998,0,9999,1
1668577600510,COGS 210B,006,101425,Rossano; Federico,9999,0,9999,0
1668577600935,COGS 211B,A00,101427,Coulson; Seana M,9996,0,9999,3
1668577601359,COGS 220,A00,101428,Hollan; James D.,0,17,25,25
1668577601782,COGS 229,A00,101429,Dow; Steven P,17,0,25,8
1668577602208,COGS 230,A00,101430,Klemmer; Scott R,6,0,17,11
1668577602633,COGS 234,A00,101431,Xia; Haijun,0,1,25,25
1668577603062,COGS 260,A00,101432,Kiyonaga; Anastasia,21,0,25,4
1668577603062,COGS 260,B00,101433,Kirsh; David Joel,15,0,25,10
1668577603496,CSE 202,A00,102371,Impagliazzo; Russell,0,70,0,0
1668577603922,CSE 203B,A01,102373,Cheng; Chung Kuan,0,70,0,0
1668577604344,CSE 208,A00,102374,Micciancio; Daniele,0,5,0,0
1668577604770,CSE 209A,A00,112895,Impagliazzo; Russell,0,14,15,15
1668577605289,CSE 209B,A00,108005,Bellare; Mihir,0,7,0,0
1668577605715,CSE 210,A00,113163,Coblenz; Michael J,0,96,0,0
1668577606147,CSE 219,A00,106111,Dow; Steven P,0,8,20,20
1668577606574,CSE 221,A00,102376,Voelker; Geoffrey M.,0,77,0,0
1668577607010,CSE 224,A01,102378,Porter; George M,0,180,0,0
1668577607432,CSE 229A,A00,102379,Savage; Stefan,0,14,0,0
1668577607854,CSE 229C,A00,102380,Munyaka; Imani N. S.,0,12,0,0
1668577608284,CSE 232B,A00,102382,Deutsch; Alin Bernard,0,39,0,0
1668577608711,CSE 234,A01,112904,Kumar; Arun Kumar,0,0,0,0
1668577609136,CSE 237A,A00,102383,Rosing; Tajana Simunic,0,57,0,0
1668577609564,CSE 239A,A00,102384,Deutsch; Alin Bernard,0,18,0,0
1668577609988,CSE 239B,A00,102385,Polikarpova; Nadezhda,0,11,0,0
1668577610417,CSE 240A,A00,102386,Pannuto; Patrick William,0,49,0,0
1668577610841,CSE 240B,A00,102387,Zhao; Jishen,0,51,0,0
1668577611267,CSE 241A,A00,106406,Kang; Mingu,0,9,0,0
1668577611695,CSE 249B,A00,102388,Kahng; Andrew Byun,0,7,8,8
1668577612117,CSE 251B,A01,102392,Cottrell; Garrison W,0,54,0,0
1668577612117,CSE 251B,A02,102393,Cottrell; Garrison W,0,36,0,0
1668577612541,CSE 252B,A00,102394,Ochoa; Benjamin Lawrence,0,64,0,0
1668577612979,CSE 257,A01,102396,Gao; Sicun,0,160,0,0
1668577613407,CSE 272,A00,102397,Li; Tzumao,0,22,0,0
1668577613833,CSE 274,A00,111323,Chern; Albert Ren-Haur,0,16,0,0
1668577614259,CSE 282,A00,102398,Pevzner; Pavel Arkadjevich,0,0,0,0
1668577614688,CSE 284,A00,114175,Gymrek; Melissa Ann,0,33,0,0
1668577615111,CSE 290,A00,102399,Chandraker; Manmohan Krishna,0,11,0,0
1668577615111,CSE 290,B00,102400,Vaccaro; Kristen Marie,0,10,25,25
1668577615111,CSE 290,C00,102414,Pannuto; Patrick William,0,1,25,25
1668577615111,CSE 290,D00,102427,Pevzner; Pavel Arkadjevich,0,0,0,0
1668577615111,CSE 290,E00,102429,Zhao; Jishen,0,6,0,0
1668577615111,CSE 290,F00,102436,Tullsen; Dean Michael,0,6,0,0
1668577615111,CSE 290,G00,102440,Christensen; Henrik I,0,8,20,20
1668577615544,CSE 291,A00,102443,Su; Hao,0,0,0,0
1668577615544,CSE 291,B00,102448,Polikarpova; Nadezhda,0,0,0,0
1668577615544,CSE 291,C00,102453,Vaccaro; Kristen Marie,0,0,0,0
1668577615544,CSE 291,D00,111343,Savage; Stefan,0,0,0,0
1668577615544,CSE 291,E00,116474,Claffy; Kimberly Claire,0,0,0,0
1668577615544,CSE 291,F00,116479,Pasquale; Joseph,0,0,0,0
1668577615997,CSE 293,001,119111,Bafna; Vineet,9999,0,9999,0
1668577615997,CSE 293,002,119118,Bellare; Mihir,9999,0,9999,0
1668577615997,CSE 293,003,119122,Berg-Kirkpatrick; Taylor D,9999,0,9999,0
1668577615997,CSE 293,004,119135,Christensen; Henrik I,9999,0,9999,0
1668577615997,CSE 293,005,119142,Cottrell; Garrison W,9999,0,9999,0
1668577615997,CSE 293,006,119146,Deutsch; Alin Bernard,9999,0,9999,0
1668577615997,CSE 293,007,119159,Esmaeilzadeh; Hadi,9999,0,9999,0
1668577615997,CSE 293,008,119166,Freund; Yoav,9999,0,9999,0
1668577615997,CSE 293,009,119170,Griswold; William G.,9999,0,9999,0
1668577615997,CSE 293,010,119183,Gymrek; Melissa Ann,9999,0,9999,0
1668577615997,CSE 293,011,119190,Heninger; Nadia A,9999,0,9999,0
1668577615997,CSE 293,012,119230,Impagliazzo; Russell,9999,0,9999,0
1668577615997,CSE 293,013,119232,Jhala; Ranjit,9999,0,9999,0
1668577615997,CSE 293,014,119233,Kahng; Andrew Byun,9999,0,9999,0
1668577615997,CSE 293,015,119298,Kane; Daniel Mertz,9999,0,9999,0
1668577615997,CSE 293,016,119299,Kriegman; David J,9999,0,9999,0
1668577615997,CSE 293,017,119300,Kumar; Arun Kumar,9999,0,9999,0
1668577615997,CSE 293,018,119301,Lerner; Sorin,9999,0,9999,0
1668577615997,CSE 293,019,119302,Lovett; Shachar,9999,0,9999,0
1668577615997,CSE 293,020,119303,McAuley; Julian John,9999,0,9999,0
1668577615997,CSE 293,021,119304,Micciancio; Daniele,9999,0,9999,0
1668577615997,CSE 293,022,119367,Orailoglu; Alex,9999,0,9999,0
1668577615997,CSE 293,023,119382,Paturi; Ramamohan,9999,0,9999,0
1668577615997,CSE 293,024,119404,Polikarpova; Nadezhda,9999,0,9999,0
1668577615997,CSE 293,025,119406,Politz; Joseph Gibbs,9999,0,9999,0
1668577615997,CSE 293,026,119411,Porter; George M,9999,0,9999,0
1668577615997,CSE 293,027,119414,Porter; Leonard Emerson,9999,0,9999,0
1668577615997,CSE 293,028,119416,Ramamoorthi; Ravi,9999,0,9999,0
1668577615997,CSE 293,029,119417,Sahoo; Debashis,9999,0,9999,0
1668577615997,CSE 293,030,119420,Saul; Lawrence,9999,0,9999,0
1668577615997,CSE 293,031,119421,Savage; Stefan,9999,0,9999,0
1668577615997,CSE 293,032,119425,Schulze; Jurgen P.,9999,0,9999,0
1668577615997,CSE 293,033,119426,Snoeren; Alex C.,9999,0,9999,0
1668577615997,CSE 293,034,119428,Shang; Jingbo,9999,0,9999,0
1668577615997,CSE 293,035,119430,Stefan; Deian,9999,0,9999,0
1668577615997,CSE 293,036,119431,Su; Hao,9999,0,9999,0
1668577615997,CSE 293,037,119433,Swanson; Steven James,9999,0,9999,0
1668577615997,CSE 293,038,119435,Tullsen; Dean Michael,9999,0,9999,0
1668577615997,CSE 293,039,119483,Voelker; Geoffrey M.,9999,0,9999,0
1668577615997,CSE 293,040,119537,Zhao; Jishen,9999,0,9999,0
1668577615997,CSE 293,041,119538,Zhou; Yuan-Yuan,9999,0,9999,0
1668577615997,CSE 293,042,119539,Gao; Sicun,9999,0,9999,0
1668577615997,CSE 293,043,119540,Weibel; Nadir,9999,0,9999,0
1668577615997,CSE 293,044,119541,Gupta; Rajesh K.,9999,0,9999,0
1668577615997,CSE 293,045,126410,Vaccaro; Kristen Marie,9999,0,9999,0
1668577615997,CSE 293,046,126411,Klemke; Richard,9999,0,9999,0
1668577616418,CSE 294,A00,102459,Voelker; Geoffrey M.,0,2,0,0
1668577616418,CSE 294,B00,111322,Orailoglu; Alex,0,2,0,0
1668577616850,DSE 201,A00,096914,Deutsch; Alin Bernard,30,0,30,0
1668577617277,DSE 210,A00,096915,Dasgupta; Sanjoy,30,0,30,0
1668577617711,DSE 260A,A00,096916,Altintas De Callaf; Ilkay,30,0,30,0
1668577618148,ECE 200,001,103586,Antipa; Nicholas A,9999,0,9999,0
1668577618148,ECE 200,002,103587,Atanasov; Nikolay A.,9999,0,9999,0
1668577618148,ECE 200,003,103588,Bharadia; Dinesh,9999,0,9999,0
1668577618148,ECE 200,004,103589,Cheng; Chung Kuan,9999,0,9999,0
1668577618148,ECE 200,005,103590,Cosman; Pamela C.,9999,0,9999,0
1668577618148,ECE 200,006,103591,Dayeh; Shadi Ahmad,9999,0,9999,0
1668577618148,ECE 200,007,103592,Fainman; Yeshaiahu,9999,0,9999,0
1668577618148,ECE 200,008,103593,Ford; Joseph Earl,9999,0,9999,0
1668577618148,ECE 200,009,103594,Franceschetti; Massimo,9999,0,9999,0
1668577618148,ECE 200,010,103595,Fullerton; Eric E,9999,0,9999,0
1668577618148,ECE 200,011,103596,Galton; Ian A,9999,0,9999,0
1668577618148,ECE 200,012,103597,Gilja; Vikash,9999,0,9999,0
1668577618148,ECE 200,013,103598,Hall; Drew A.,9999,0,9999,0
1668577618148,ECE 200,014,103599,Hsueh; Tzu-Chien,9999,0,9999,0
1668577618148,ECE 200,015,103600,Javidi; Tara,9999,0,9999,0
1668577618148,ECE 200,016,103601,Kahng; Andrew Byun,9999,0,9999,0
1668577618148,ECE 200,017,103602,Kim; Young-Han,9999,0,9999,0
1668577618148,ECE 200,018,103603,Koushanfar; Farinaz,9999,0,9999,0
1668577618148,ECE 200,019,103604,Kuzum; Duygu,9999,0,9999,0
1668577618148,ECE 200,020,103605,Le; Hanh-Phuc,9999,0,9999,0
1668577618148,ECE 200,021,103606,Lin; Bill,9999,0,9999,0
1668577618148,ECE 200,022,103607,Liu; Zhaowei,9998,0,9999,1
1668577618148,ECE 200,023,103608,Lo; Yu-Hwa,9999,0,9999,0
1668577618148,ECE 200,024,103609,Lomakin; Vitaliy,9999,0,9999,0
1668577618148,ECE 200,025,103610,Mercier; Patrick Philip,9999,0,9999,0
1668577618148,ECE 200,026,103611,Meyer; Florian,9999,0,9999,0
1668577618148,ECE 200,027,103612,Milstein; Laurence B.,9999,0,9999,0
1668577618148,ECE 200,028,103613,Mir Arabbaygi; Siavash,9999,0,9999,0
1668577618148,ECE 200,029,103614,Mookherjea; Shayan,9999,0,9999,0
1668577618148,ECE 200,030,103615,Morris; Karcher William,9999,0,9999,0
1668577618148,ECE 200,031,103616,Ng; Tse Nga,9999,0,9999,0
1668577618148,ECE 200,032,103617,Nguyen; Truong Quang,9999,0,9999,0
1668577618148,ECE 200,033,103618,Nomura; Kenji,9999,0,9999,0
1668577618148,ECE 200,034,103619,Orlitsky; Alon,9999,0,9999,0
1668577618148,ECE 200,035,103620,Pal; Piya,9999,0,9999,0
1668577618148,ECE 200,036,103621,Papen; George C.,9999,0,9999,0
1668577618148,ECE 200,037,103622,Radic; Stojan,9999,0,9999,0
1668577618148,ECE 200,038,103623,Rao; Bhaskar D.,9999,0,9999,0
1668577618148,ECE 200,039,103624,Rao; Ramesh R,9999,0,9999,0
1668577618148,ECE 200,040,103625,Rebeiz; Gabriel,9999,0,9999,0
1668577618148,ECE 200,041,103626,Sanford; John R,9999,0,9999,0
1668577618148,ECE 200,042,103627,Siegel; Paul H.,9999,0,9999,0
1668577618148,ECE 200,043,103628,Sievenpiper; Daniel F.,9999,0,9999,0
1668577618148,ECE 200,044,103629,Sworder; David D.,9999,0,9999,0
1668577618148,ECE 200,045,103630,Taur; Yuan,9999,0,9999,0
1668577618148,ECE 200,046,103631,Touri; Behrouz,9999,0,9999,0
1668577618148,ECE 200,047,103632,Trivedi; Mohan M.,9999,0,9999,0
1668577618148,ECE 200,048,103633,Vasconcelos; Nuno,9999,0,9999,0
1668577618148,ECE 200,049,103634,Wang; Xiaolong,9999,0,9999,0
1668577618148,ECE 200,050,103635,Xie; Pengtao,9999,0,9999,0
1668577618148,ECE 200,051,103636,Yip; Michael,9999,0,9999,0
1668577618148,ECE 200,052,103637,Zeger; Kenneth A.,999,0,999,0
1668577618148,ECE 200,053,103638,Zhang; Xinyu,9999,0,9999,0
1668577618148,ECE 200,054,103639,Turakhia; Yatish Girish,9999,0,9999,0
1668577618148,ECE 200,055,103640,Kang; Mingu,9999,0,9999,0
1668577618148,ECE 200,056,103641,Shi; Yuanyuan,9999,0,9999,0
1668577618148,ECE 200,057,103642,Wang; Edward Jay,9999,0,9999,0
1668577618148,ECE 200,058,103643,Zheng; Yang,9999,0,9999,0
1668577618573,ECE 202,A00,103644,Kuzum; Duygu,0,46,0,0
1668577618996,ECE 212BN,A00,103646,Ng; Tse Nga,0,10,0,0
1668577619420,ECE 221,A00,111493,Staff,0,0,0,0
1668577619842,ECE 222B,A00,103647,Lomakin; Vitaliy,0,21,0,0
1668577620273,ECE 230B,A00,103648,Taur; Yuan,0,4,0,0
1668577620699,ECE 238B,A00,103649,Garay; Javier,0,0,0,0
1668577621123,ECE 240B,A00,112900,Fainman; Yeshaiahu,0,8,0,0
1668577621545,ECE 247A,A00,103650,Jokerst; Jesse Vincent,0,6,0,0
1668577621975,ECE 247B,A00,103651,Wang; Joseph,0,15,0,0
1668577622398,ECE 250,A00,103652,Siegel; Paul H.,0,84,0,0
1668577622825,ECE 251A,A00,103654,Rao; Bhaskar D.,0,66,0,0
1668577623256,ECE 257B,A00,103655,Bharadia; Dinesh,0,33,0,0
1668577623678,ECE 258A,A00,103656,Milstein; Laurence B.,0,29,0,0
1668577624100,ECE 260B,A00,103658,Kang; Mingu,0,121,0,0
1668577624526,ECE 264A,A00,103659,Galton; Ian A,0,45,0,31
1668577624950,ECE 265A,A00,103661,Gudem; Prasad S.S.,0,45,0,32
1668577625377,ECE 265D,A00,103662,Gudem; Prasad S.S.,0,27,0,0
1668577625802,ECE 268,A00,103663,Koushanfar; Farinaz,0,44,0,0
1668577626227,ECE 269,A01,103665,Pal; Piya,0,223,0,0
1668577626651,ECE 271B,A00,103666,Vasconcelos; Manuela,0,79,0,0
1668577627073,ECE 276A,A00,103667,Atanasov; Nikolay A.,0,127,0,0
1668577627497,ECE 277,A00,103668,An; Cheolhong,0,151,0,0
1668577627918,ECE 279,A00,117947,Hall; Drew A.,0,22,0,0
1668577628779,ECE 283,A00,103670,Hsueh; Tzu-Chien,0,57,0,0
1668577629202,ECE 284,A00,103671,Turakhia; Yatish Girish,0,40,0,0
1668577629625,ECE 285,A00,103672,Zheng; Yang,0,41,0,0
1668577629625,ECE 285,B00,103673,Sworder; David D.,0,61,0,0
1668577630057,ECE 287,A00,103676,Javidi; Tara,0,8,0,0
1668577630481,MATH 200B,A00,098023,Salehi Golsefidy; Alireza,7,0,15,8
1668577630907,MATH 202B,A00,098024,Rhoades; Brendon Patrick,7,0,15,8
1668577631333,MATH 203B,A00,098025,Oprea; Dragos N.,9,0,15,6
1668577631759,MATH 204B,A00,098026,Sorensen; Claus M,13,0,15,2
1668577632183,MATH 208,A00,098027,Izadi; Elham,7,0,10,3
1668577632608,MATH 209,A00,098028,Pollack; Aaron,10,0,10,0
1668577633032,MATH 211A,A00,112919,Rogalski; Daniel,8,0,10,2
1668577633455,MATH 211B,A00,112920,Seward; Brandon M.,9,0,10,1
1668577633878,MATH 218,A00,098029,Li; Bo,10,0,10,0
1668577634301,MATH 220B,A00,098030,Novak; Jonathan I,10,0,15,5
1668577634730,MATH 221A,A00,098031,Ebenfelt; Peter F,12,0,15,3
1668577635155,MATH 231B,A00,098032,Zlatos; Andrej,9,0,15,6
1668577635584,MATH 240B,A00,098033,Ni; Lei,7,0,15,8
1668577636007,MATH 243,A00,098034,Jekel; David Andrew,10,0,10,0
1668577636469,MATH 245A,A00,098035,Nie; Jiawang,0,7,15,18
1668577636911,MATH 248,A00,098036,Bejenaru; Ioan,10,0,10,0
1668577637338,MATH 250B,A00,098037,Spolaor; Luca,12,0,15,3
1668577637767,MATH 258,A00,098038,Ni; Lei,8,0,10,2
1668577638193,MATH 264B,A00,098041,Rhoades; Brendon Patrick,7,0,15,8
1668577638617,MATH 268,A00,098042,Buss; Samuel R,10,0,10,0
1668577639042,MATH 269,A00,098043,Rhoades; Brendon Patrick,10,0,10,0
1668577639465,MATH 270B,A00,098044,Li; Bo,6,0,15,9
1668577639902,MATH 272B,A00,098045,Holst; Michael J,13,0,15,2
1668577640340,MATH 273A,A00,098046,Tian; Xiaochuan,10,0,15,5
1668577640774,MATH 275,A01,098048,Tian; Xiaochuan,6,0,10,4
1668577641200,MATH 278A,A00,098049,Holst; Michael J,6,0,10,4
1668577641622,MATH 278B,A00,098050,Cloninger; Alexander,10,0,10,0
1668577642057,MATH 278C,A00,098051,Nie; Jiawang,5,0,10,5
1668577642495,MATH 280B,A00,098052,Zheng; Tianyi,6,0,15,9
1668577642917,MATH 281B,A00,098053,Bradic; Jelena,0,2,15,15
1668577643342,MATH 282B,A00,098054,Arias-Castro; Ery,0,1,15,15
1668577643764,MATH 285,A00,098055,Fitzsimmons; Patrick J,0,4,15,16
1668577644197,MATH 287B,A00,098056,Arias-Castro; Ery,1,0,15,14
1668577644619,MATH 288,A00,098057,Agarwal; Pooja,9,0,10,1
1668577644619,MATH 288,B00,098058,Zhang; Danna,8,0,10,2
1668577644619,MATH 288,C00,098059,Williams; Ruth J,9,0,10,1
1668577645045,MATH 290B,A00,098060,Roberts; Justin Deritter,12,0,15,3
1668577645467,MATH 292,A00,098061,Belmont; Eva Kinoshita,10,0,10,0
1668577645892,MATH 295,A00,098062,Suk; Andrew Hoon,47,0,50,3
1668577646323,MATH 296,A00,098063,Novak; Jonathan I,20,0,20,0
1668577646745,MATH 297,001,098064,Gamst; Anthony Collins,9997,0,9999,2
1668578149269,COGS 205,A00,101395,Chiba; Andrea,19,0,20,1
1668578149692,COGS 210B,001,101404,Greene; Deanna Jacquelyn,9998,0,9999,1
1668578149692,COGS 210B,002,101417,Xia; Haijun,9999,0,9999,0
1668578149692,COGS 210B,003,101422,Nitz; Douglas A.,9999,0,9999,0
1668578149692,COGS 210B,004,101423,Hollan; James D.,9998,0,9999,1
1668578149692,COGS 210B,005,101424,Deak; Gedeon O.,9998,0,9999,1
1668578149692,COGS 210B,006,101425,Rossano; Federico,9999,0,9999,0
1668578150133,COGS 211B,A00,101427,Coulson; Seana M,9996,0,9999,3
1668578150562,COGS 220,A00,101428,Hollan; James D.,0,17,25,25
1668578150991,COGS 229,A00,101429,Dow; Steven P,17,0,25,8
1668578151421,COGS 230,A00,101430,Klemmer; Scott R,6,0,17,11
1668578151848,COGS 234,A00,101431,Xia; Haijun,0,1,25,25
1668578152272,COGS 260,A00,101432,Kiyonaga; Anastasia,21,0,25,4
1668578152272,COGS 260,B00,101433,Kirsh; David Joel,15,0,25,10
1668578152698,CSE 202,A00,102371,Impagliazzo; Russell,0,70,0,0
1668578153127,CSE 203B,A01,102373,Cheng; Chung Kuan,0,70,0,0
1668578153552,CSE 208,A00,102374,Micciancio; Daniele,0,5,0,0
1668578153977,CSE 209A,A00,112895,Impagliazzo; Russell,0,14,15,15
1668578154403,CSE 209B,A00,108005,Bellare; Mihir,0,7,0,0
1668578154835,CSE 210,A00,113163,Coblenz; Michael J,0,96,0,0
1668578155260,CSE 219,A00,106111,Dow; Steven P,0,8,20,20
1668578155689,CSE 221,A00,102376,Voelker; Geoffrey M.,0,77,0,0
1668578156111,CSE 224,A01,102378,Porter; George M,0,180,0,0
1668578156538,CSE 229A,A00,102379,Savage; Stefan,0,14,0,0
1668578156962,CSE 229C,A00,102380,Munyaka; Imani N. S.,0,12,0,0
1668578157389,CSE 232B,A00,102382,Deutsch; Alin Bernard,0,39,0,0
1668578157822,CSE 234,A01,112904,Kumar; Arun Kumar,0,0,0,0
1668578158245,CSE 237A,A00,102383,Rosing; Tajana Simunic,0,57,0,0
1668578158667,CSE 239A,A00,102384,Deutsch; Alin Bernard,0,18,0,0
1668578159091,CSE 239B,A00,102385,Polikarpova; Nadezhda,0,11,0,0
1668578159513,CSE 240A,A00,102386,Pannuto; Patrick William,0,49,0,0
1668578159945,CSE 240B,A00,102387,Zhao; Jishen,0,51,0,0
1668578160368,CSE 241A,A00,106406,Kang; Mingu,0,9,0,0
1668578160796,CSE 249B,A00,102388,Kahng; Andrew Byun,0,7,8,8
1668578161227,CSE 251B,A01,102392,Cottrell; Garrison W,0,54,0,0
1668578161227,CSE 251B,A02,102393,Cottrell; Garrison W,0,36,0,0
1668578161652,CSE 252B,A00,102394,Ochoa; Benjamin Lawrence,0,64,0,0
1668578162080,CSE 257,A01,102396,Gao; Sicun,0,160,0,0
1668578162504,CSE 272,A00,102397,Li; Tzumao,0,22,0,0
1668578162928,CSE 274,A00,111323,Chern; Albert Ren-Haur,0,16,0,0
1668578163352,CSE 282,A00,102398,Pevzner; Pavel Arkadjevich,0,0,0,0
1668578163776,CSE 284,A00,114175,Gymrek; Melissa Ann,0,33,0,0
1668578164212,CSE 290,A00,102399,Chandraker; Manmohan Krishna,0,11,0,0
1668578164212,CSE 290,B00,102400,Vaccaro; Kristen Marie,0,10,25,25
1668578164212,CSE 290,C00,102414,Pannuto; Patrick William,0,1,25,25
1668578164212,CSE 290,D00,102427,Pevzner; Pavel Arkadjevich,0,0,0,0
1668578164212,CSE 290,E00,102429,Zhao; Jishen,0,6,0,0
1668578164212,CSE 290,F00,102436,Tullsen; Dean Michael,0,6,0,0
1668578164212,CSE 290,G00,102440,Christensen; Henrik I,0,8,20,20
1668578164644,CSE 291,A00,102443,Su; Hao,0,0,0,0
1668578164644,CSE 291,B00,102448,Polikarpova; Nadezhda,0,0,0,0
1668578164644,CSE 291,C00,102453,Vaccaro; Kristen Marie,0,0,0,0
1668578164644,CSE 291,D00,111343,Savage; Stefan,0,0,0,0
1668578164644,CSE 291,E00,116474,Claffy; Kimberly Claire,0,0,0,0
1668578164644,CSE 291,F00,116479,Pasquale; Joseph,0,0,0,0
1668578165075,CSE 293,001,119111,Bafna; Vineet,9999,0,9999,0
1668578165075,CSE 293,002,119118,Bellare; Mihir,9999,0,9999,0
1668578165075,CSE 293,003,119122,Berg-Kirkpatrick; Taylor D,9999,0,9999,0
1668578165075,CSE 293,004,119135,Christensen; Henrik I,9999,0,9999,0
1668578165075,CSE 293,005,119142,Cottrell; Garrison W,9999,0,9999,0
1668578165075,CSE 293,006,119146,Deutsch; Alin Bernard,9999,0,9999,0
1668578165075,CSE 293,007,119159,Esmaeilzadeh; Hadi,9999,0,9999,0
1668578165075,CSE 293,008,119166,Freund; Yoav,9999,0,9999,0
1668578165075,CSE 293,009,119170,Griswold; William G.,9999,0,9999,0
1668578165075,CSE 293,010,119183,Gymrek; Melissa Ann,9999,0,9999,0
1668578165075,CSE 293,011,119190,Heninger; Nadia A,9999,0,9999,0
1668578165075,CSE 293,012,119230,Impagliazzo; Russell,9999,0,9999,0
1668578165075,CSE 293,013,119232,Jhala; Ranjit,9999,0,9999,0
1668578165075,CSE 293,014,119233,Kahng; Andrew Byun,9999,0,9999,0
1668578165075,CSE 293,015,119298,Kane; Daniel Mertz,9999,0,9999,0
1668578165075,CSE 293,016,119299,Kriegman; David J,9999,0,9999,0
1668578165075,CSE 293,017,119300,Kumar; Arun Kumar,9999,0,9999,0
1668578165075,CSE 293,018,119301,Lerner; Sorin,9999,0,9999,0
1668578165075,CSE 293,019,119302,Lovett; Shachar,9999,0,9999,0
1668578165075,CSE 293,020,119303,McAuley; Julian John,9999,0,9999,0
1668578165075,CSE 293,021,119304,Micciancio; Daniele,9999,0,9999,0
1668578165075,CSE 293,022,119367,Orailoglu; Alex,9999,0,9999,0
1668578165075,CSE 293,023,119382,Paturi; Ramamohan,9999,0,9999,0
1668578165075,CSE 293,024,119404,Polikarpova; Nadezhda,9999,0,9999,0
1668578165075,CSE 293,025,119406,Politz; Joseph Gibbs,9999,0,9999,0
1668578165075,CSE 293,026,119411,Porter; George M,9999,0,9999,0
1668578165075,CSE 293,027,119414,Porter; Leonard Emerson,9999,0,9999,0
1668578165075,CSE 293,028,119416,Ramamoorthi; Ravi,9999,0,9999,0
1668578165075,CSE 293,029,119417,Sahoo; Debashis,9999,0,9999,0
1668578165075,CSE 293,030,119420,Saul; Lawrence,9999,0,9999,0
1668578165075,CSE 293,031,119421,Savage; Stefan,9999,0,9999,0
1668578165075,CSE 293,032,119425,Schulze; Jurgen P.,9999,0,9999,0
1668578165075,CSE 293,033,119426,Snoeren; Alex C.,9999,0,9999,0
1668578165075,CSE 293,034,119428,Shang; Jingbo,9999,0,9999,0
1668578165075,CSE 293,035,119430,Stefan; Deian,9999,0,9999,0
1668578165075,CSE 293,036,119431,Su; Hao,9999,0,9999,0
1668578165075,CSE 293,037,119433,Swanson; Steven James,9999,0,9999,0
1668578165075,CSE 293,038,119435,Tullsen; Dean Michael,9999,0,9999,0
1668578165075,CSE 293,039,119483,Voelker; Geoffrey M.,9999,0,9999,0
1668578165075,CSE 293,040,119537,Zhao; Jishen,9999,0,9999,0
1668578165075,CSE 293,041,119538,Zhou; Yuan-Yuan,9999,0,9999,0
1668578165075,CSE 293,042,119539,Gao; Sicun,9999,0,9999,0
1668578165075,CSE 293,043,119540,Weibel; Nadir,9999,0,9999,0
1668578165075,CSE 293,044,119541,Gupta; Rajesh K.,9999,0,9999,0
1668578165075,CSE 293,045,126410,Vaccaro; Kristen Marie,9999,0,9999,0
1668578165075,CSE 293,046,126411,Klemke; Richard,9999,0,9999,0
1668578165498,CSE 294,A00,102459,Voelker; Geoffrey M.,0,2,0,0
1668578165498,CSE 294,B00,111322,Orailoglu; Alex,0,2,0,0
1668578165920,DSE 201,A00,096914,Deutsch; Alin Bernard,30,0,30,0
1668578166342,DSE 210,A00,096915,Dasgupta; Sanjoy,30,0,30,0
1668578166765,DSE 260A,A00,096916,Altintas De Callaf; Ilkay,30,0,30,0
1668578167201,ECE 200,001,103586,Antipa; Nicholas A,9999,0,9999,0
1668578167201,ECE 200,002,103587,Atanasov; Nikolay A.,9999,0,9999,0
1668578167201,ECE 200,003,103588,Bharadia; Dinesh,9999,0,9999,0
1668578167201,ECE 200,004,103589,Cheng; Chung Kuan,9999,0,9999,0
1668578167201,ECE 200,005,103590,Cosman; Pamela C.,9999,0,9999,0
1668578167201,ECE 200,006,103591,Dayeh; Shadi Ahmad,9999,0,9999,0
1668578167201,ECE 200,007,103592,Fainman; Yeshaiahu,9999,0,9999,0
1668578167201,ECE 200,008,103593,Ford; Joseph Earl,9999,0,9999,0
1668578167201,ECE 200,009,103594,Franceschetti; Massimo,9999,0,9999,0
1668578167201,ECE 200,010,103595,Fullerton; Eric E,9999,0,9999,0
1668578167201,ECE 200,011,103596,Galton; Ian A,9999,0,9999,0
1668578167201,ECE 200,012,103597,Gilja; Vikash,9999,0,9999,0
1668578167201,ECE 200,013,103598,Hall; Drew A.,9999,0,9999,0
1668578167201,ECE 200,014,103599,Hsueh; Tzu-Chien,9999,0,9999,0
1668578167201,ECE 200,015,103600,Javidi; Tara,9999,0,9999,0
1668578167201,ECE 200,016,103601,Kahng; Andrew Byun,9999,0,9999,0
1668578167201,ECE 200,017,103602,Kim; Young-Han,9999,0,9999,0
1668578167201,ECE 200,018,103603,Koushanfar; Farinaz,9999,0,9999,0
1668578167201,ECE 200,019,103604,Kuzum; Duygu,9999,0,9999,0
1668578167201,ECE 200,020,103605,Le; Hanh-Phuc,9999,0,9999,0
1668578167201,ECE 200,021,103606,Lin; Bill,9999,0,9999,0
1668578167201,ECE 200,022,103607,Liu; Zhaowei,9998,0,9999,1
1668578167201,ECE 200,023,103608,Lo; Yu-Hwa,9999,0,9999,0
1668578167201,ECE 200,024,103609,Lomakin; Vitaliy,9999,0,9999,0
1668578167201,ECE 200,025,103610,Mercier; Patrick Philip,9999,0,9999,0
1668578167201,ECE 200,026,103611,Meyer; Florian,9999,0,9999,0
1668578167201,ECE 200,027,103612,Milstein; Laurence B.,9999,0,9999,0
1668578167201,ECE 200,028,103613,Mir Arabbaygi; Siavash,9999,0,9999,0
1668578167201,ECE 200,029,103614,Mookherjea; Shayan,9999,0,9999,0
1668578167201,ECE 200,030,103615,Morris; Karcher William,9999,0,9999,0
1668578167201,ECE 200,031,103616,Ng; Tse Nga,9999,0,9999,0
1668578167201,ECE 200,032,103617,Nguyen; Truong Quang,9999,0,9999,0
1668578167201,ECE 200,033,103618,Nomura; Kenji,9999,0,9999,0
1668578167201,ECE 200,034,103619,Orlitsky; Alon,9999,0,9999,0
1668578167201,ECE 200,035,103620,Pal; Piya,9999,0,9999,0
1668578167201,ECE 200,036,103621,Papen; George C.,9999,0,9999,0
1668578167201,ECE 200,037,103622,Radic; Stojan,9999,0,9999,0
1668578167201,ECE 200,038,103623,Rao; Bhaskar D.,9999,0,9999,0
1668578167201,ECE 200,039,103624,Rao; Ramesh R,9999,0,9999,0
1668578167201,ECE 200,040,103625,Rebeiz; Gabriel,9999,0,9999,0
1668578167201,ECE 200,041,103626,Sanford; John R,9999,0,9999,0
1668578167201,ECE 200,042,103627,Siegel; Paul H.,9999,0,9999,0
1668578167201,ECE 200,043,103628,Sievenpiper; Daniel F.,9999,0,9999,0
1668578167201,ECE 200,044,103629,Sworder; David D.,9999,0,9999,0
1668578167201,ECE 200,045,103630,Taur; Yuan,9999,0,9999,0
1668578167201,ECE 200,046,103631,Touri; Behrouz,9999,0,9999,0
1668578167201,ECE 200,047,103632,Trivedi; Mohan M.,9999,0,9999,0
1668578167201,ECE 200,048,103633,Vasconcelos; Nuno,9999,0,9999,0
1668578167201,ECE 200,049,103634,Wang; Xiaolong,9999,0,9999,0
1668578167201,ECE 200,050,103635,Xie; Pengtao,9999,0,9999,0
1668578167201,ECE 200,051,103636,Yip; Michael,9999,0,9999,0
1668578167201,ECE 200,052,103637,Zeger; Kenneth A.,999,0,999,0
1668578167201,ECE 200,053,103638,Zhang; Xinyu,9999,0,9999,0
1668578167201,ECE 200,054,103639,Turakhia; Yatish Girish,9999,0,9999,0
1668578167201,ECE 200,055,103640,Kang; Mingu,9999,0,9999,0
1668578167201,ECE 200,056,103641,Shi; Yuanyuan,9999,0,9999,0
1668578167201,ECE 200,057,103642,Wang; Edward Jay,9999,0,9999,0
1668578167201,ECE 200,058,103643,Zheng; Yang,9999,0,9999,0
1668578167626,ECE 202,A00,103644,Kuzum; Duygu,0,46,0,0
1668578168050,ECE 212BN,A00,103646,Ng; Tse Nga,0,10,0,0
1668578168473,ECE 221,A00,111493,Staff,0,0,0,0
1668578168896,ECE 222B,A00,103647,Lomakin; Vitaliy,0,21,0,0
1668578169410,ECE 230B,A00,103648,Taur; Yuan,0,4,0,0
1668578169836,ECE 238B,A00,103649,Garay; Javier,0,0,0,0
1668578170267,ECE 240B,A00,112900,Fainman; Yeshaiahu,0,8,0,0
1668578170694,ECE 247A,A00,103650,Jokerst; Jesse Vincent,0,6,0,0
1668578171121,ECE 247B,A00,103651,Wang; Joseph,0,15,0,0
1668578171551,ECE 250,A00,103652,Siegel; Paul H.,0,84,0,0
1668578171976,ECE 251A,A00,103654,Rao; Bhaskar D.,0,65,0,0
1668578172403,ECE 257B,A00,103655,Bharadia; Dinesh,0,33,0,0
1668578172825,ECE 258A,A00,103656,Milstein; Laurence B.,0,29,0,0
1668578173253,ECE 260B,A00,103658,Kang; Mingu,0,121,0,0
1668578173680,ECE 264A,A00,103659,Galton; Ian A,0,45,0,31
1668578174109,ECE 265A,A00,103661,Gudem; Prasad S.S.,0,45,0,32
1668578174547,ECE 265D,A00,103662,Gudem; Prasad S.S.,0,27,0,0
1668578174969,ECE 268,A00,103663,Koushanfar; Farinaz,0,44,0,0
1668578175400,ECE 269,A01,103665,Pal; Piya,0,223,0,0
1668578175826,ECE 271B,A00,103666,Vasconcelos; Manuela,0,79,0,0
1668578176252,ECE 276A,A00,103667,Atanasov; Nikolay A.,0,127,0,0
1668578176675,ECE 277,A00,103668,An; Cheolhong,0,151,0,0
1668578177098,ECE 279,A00,117947,Hall; Drew A.,0,22,0,0
1668578177946,ECE 283,A00,103670,Hsueh; Tzu-Chien,0,57,0,0
1668578178373,ECE 284,A00,103671,Turakhia; Yatish Girish,0,40,0,0
1668578178812,ECE 285,A00,103672,Zheng; Yang,0,40,0,0
1668578178812,ECE 285,B00,103673,Sworder; David D.,0,61,0,0
1668578179238,ECE 287,A00,103676,Javidi; Tara,0,7,0,0
1668578179663,MATH 200B,A00,098023,Salehi Golsefidy; Alireza,7,0,15,8
1668578180090,MATH 202B,A00,098024,Rhoades; Brendon Patrick,7,0,15,8
1668578180517,MATH 203B,A00,098025,Oprea; Dragos N.,9,0,15,6
1668578180945,MATH 204B,A00,098026,Sorensen; Claus M,13,0,15,2
1668578181374,MATH 208,A00,098027,Izadi; Elham,7,0,10,3
1668578181802,MATH 209,A00,098028,Pollack; Aaron,10,0,10,0
1668578182233,MATH 211A,A00,112919,Rogalski; Daniel,8,0,10,2
1668578182656,MATH 211B,A00,112920,Seward; Brandon M.,9,0,10,1
1668578183088,MATH 218,A00,098029,Li; Bo,10,0,10,0
1668578183518,MATH 220B,A00,098030,Novak; Jonathan I,10,0,15,5
1668578183941,MATH 221A,A00,098031,Ebenfelt; Peter F,12,0,15,3
1668578184367,MATH 231B,A00,098032,Zlatos; Andrej,9,0,15,6
1668578184801,MATH 240B,A00,098033,Ni; Lei,7,0,15,8
1668578185224,MATH 243,A00,098034,Jekel; David Andrew,10,0,10,0
1668578185647,MATH 245A,A00,098035,Nie; Jiawang,0,7,15,18
1668578186078,MATH 248,A00,098036,Bejenaru; Ioan,10,0,10,0
1668578186513,MATH 250B,A00,098037,Spolaor; Luca,12,0,15,3
1668578186938,MATH 258,A00,098038,Ni; Lei,8,0,10,2
1668578187364,MATH 264B,A00,098041,Rhoades; Brendon Patrick,7,0,15,8
1668578187787,MATH 268,A00,098042,Buss; Samuel R,10,0,10,0
1668578188213,MATH 269,A00,098043,Rhoades; Brendon Patrick,10,0,10,0
1668578188637,MATH 270B,A00,098044,Li; Bo,6,0,15,9
1668578189061,MATH 272B,A00,098045,Holst; Michael J,13,0,15,2
1668578189489,MATH 273A,A00,098046,Tian; Xiaochuan,10,0,15,5
1668578189914,MATH 275,A01,098048,Tian; Xiaochuan,6,0,10,4
1668578190335,MATH 278A,A00,098049,Holst; Michael J,6,0,10,4
1668578190770,MATH 278B,A00,098050,Cloninger; Alexander,10,0,10,0
1668578191196,MATH 278C,A00,098051,Nie; Jiawang,5,0,10,5
1668578191619,MATH 280B,A00,098052,Zheng; Tianyi,6,0,15,9
1668578192045,MATH 281B,A00,098053,Bradic; Jelena,0,2,15,15
1668578192469,MATH 282B,A00,098054,Arias-Castro; Ery,0,1,15,15
1668578192892,MATH 285,A00,098055,Fitzsimmons; Patrick J,0,4,15,16
1668578193317,MATH 287B,A00,098056,Arias-Castro; Ery,1,0,15,14
1668578193743,MATH 288,A00,098057,Agarwal; Pooja,9,0,10,1
1668578193743,MATH 288,B00,098058,Zhang; Danna,8,0,10,2
1668578193743,MATH 288,C00,098059,Williams; Ruth J,9,0,10,1
1668578194168,MATH 290B,A00,098060,Roberts; Justin Deritter,12,0,15,3
1668578194593,MATH 292,A00,098061,Belmont; Eva Kinoshita,10,0,10,0
1668578195027,MATH 295,A00,098062,Suk; Andrew Hoon,47,0,50,3
1668578195458,MATH 296,A00,098063,Novak; Jonathan I,20,0,20,0
1668578195878,MATH 297,001,098064,Gamst; Anthony Collins,9997,0,9999,2
1668578698874,COGS 205,A00,101395,Chiba; Andrea,19,0,20,1
1668578699324,COGS 210B,001,101404,Greene; Deanna Jacquelyn,9998,0,9999,1
1668578699324,COGS 210B,002,101417,Xia; Haijun,9999,0,9999,0
1668578699324,COGS 210B,003,101422,Nitz; Douglas A.,9999,0,9999,0
1668578699324,COGS 210B,004,101423,Hollan; James D.,9998,0,9999,1
1668578699324,COGS 210B,005,101424,Deak; Gedeon O.,9998,0,9999,1
1668578699324,COGS 210B,006,101425,Rossano; Federico,9999,0,9999,0
1668578699746,COGS 211B,A00,101427,Coulson; Seana M,9996,0,9999,3
1668578700181,COGS 220,A00,101428,Hollan; James D.,0,17,25,25
1668578700619,COGS 229,A00,101429,Dow; Steven P,17,0,25,8
1668578701043,COGS 230,A00,101430,Klemmer; Scott R,6,0,17,11
1668578701469,COGS 234,A00,101431,Xia; Haijun,0,1,25,25
1668578701891,COGS 260,A00,101432,Kiyonaga; Anastasia,21,0,25,4
1668578701891,COGS 260,B00,101433,Kirsh; David Joel,15,0,25,10
1668578702320,CSE 202,A00,102371,Impagliazzo; Russell,0,70,0,0
1668578702747,CSE 203B,A01,102373,Cheng; Chung Kuan,0,70,0,0
1668578703169,CSE 208,A00,102374,Micciancio; Daniele,0,5,0,0
1668578703593,CSE 209A,A00,112895,Impagliazzo; Russell,0,14,15,15
1668578704032,CSE 209B,A00,108005,Bellare; Mihir,0,7,0,0
1668578704458,CSE 210,A00,113163,Coblenz; Michael J,0,96,0,0
1668578704882,CSE 219,A00,106111,Dow; Steven P,0,8,20,20
1668578705315,CSE 221,A00,102376,Voelker; Geoffrey M.,0,77,0,0
1668578705756,CSE 224,A01,102378,Porter; George M,0,180,0,0
1668578706181,CSE 229A,A00,102379,Savage; Stefan,0,14,0,0
1668578706610,CSE 229C,A00,102380,Munyaka; Imani N. S.,0,12,0,0
1668578707034,CSE 232B,A00,102382,Deutsch; Alin Bernard,0,39,0,0
1668578707475,CSE 234,A01,112904,Kumar; Arun Kumar,0,0,0,0
1668578707901,CSE 237A,A00,102383,Rosing; Tajana Simunic,0,57,0,0
1668578708323,CSE 239A,A00,102384,Deutsch; Alin Bernard,0,18,0,0
1668578708750,CSE 239B,A00,102385,Polikarpova; Nadezhda,0,11,0,0
1668578709189,CSE 240A,A00,102386,Pannuto; Patrick William,0,49,0,0
1668578709621,CSE 240B,A00,102387,Zhao; Jishen,0,51,0,0
1668578710044,CSE 241A,A00,106406,Kang; Mingu,0,9,0,0
1668578710469,CSE 249B,A00,102388,Kahng; Andrew Byun,0,7,8,8
1668578710905,CSE 251B,A01,102392,Cottrell; Garrison W,0,54,0,0
1668578710905,CSE 251B,A02,102393,Cottrell; Garrison W,0,36,0,0
1668578711343,CSE 252B,A00,102394,Ochoa; Benjamin Lawrence,0,64,0,0
1668578711766,CSE 257,A01,102396,Gao; Sicun,0,160,0,0
1668578712191,CSE 272,A00,102397,Li; Tzumao,0,22,0,0
1668578712614,CSE 274,A00,111323,Chern; Albert Ren-Haur,0,16,0,0
1668578713044,CSE 282,A00,102398,Pevzner; Pavel Arkadjevich,0,0,0,0
1668578713477,CSE 284,A00,114175,Gymrek; Melissa Ann,0,33,0,0
1668578713919,CSE 290,A00,102399,Chandraker; Manmohan Krishna,0,11,0,0
1668578713919,CSE 290,B00,102400,Vaccaro; Kristen Marie,0,10,25,25
1668578713919,CSE 290,C00,102414,Pannuto; Patrick William,0,1,25,25
1668578713919,CSE 290,D00,102427,Pevzner; Pavel Arkadjevich,0,0,0,0
1668578713919,CSE 290,E00,102429,Zhao; Jishen,0,6,0,0
1668578713919,CSE 290,F00,102436,Tullsen; Dean Michael,0,6,0,0
1668578713919,CSE 290,G00,102440,Christensen; Henrik I,0,8,20,20
1668578714354,CSE 291,A00,102443,Su; Hao,0,0,0,0
1668578714354,CSE 291,B00,102448,Polikarpova; Nadezhda,0,0,0,0
1668578714354,CSE 291,C00,102453,Vaccaro; Kristen Marie,0,0,0,0
1668578714354,CSE 291,D00,111343,Savage; Stefan,0,0,0,0
1668578714354,CSE 291,E00,116474,Claffy; Kimberly Claire,0,0,0,0
1668578714354,CSE 291,F00,116479,Pasquale; Joseph,0,0,0,0
1668578714792,CSE 293,001,119111,Bafna; Vineet,9999,0,9999,0
1668578714792,CSE 293,002,119118,Bellare; Mihir,9999,0,9999,0
1668578714792,CSE 293,003,119122,Berg-Kirkpatrick; Taylor D,9999,0,9999,0
1668578714792,CSE 293,004,119135,Christensen; Henrik I,9999,0,9999,0
1668578714792,CSE 293,005,119142,Cottrell; Garrison W,9999,0,9999,0
1668578714792,CSE 293,006,119146,Deutsch; Alin Bernard,9999,0,9999,0
1668578714792,CSE 293,007,119159,Esmaeilzadeh; Hadi,9999,0,9999,0
1668578714792,CSE 293,008,119166,Freund; Yoav,9999,0,9999,0
1668578714792,CSE 293,009,119170,Griswold; William G.,9999,0,9999,0
1668578714792,CSE 293,010,119183,Gymrek; Melissa Ann,9999,0,9999,0
1668578714792,CSE 293,011,119190,Heninger; Nadia A,9999,0,9999,0
1668578714792,CSE 293,012,119230,Impagliazzo; Russell,9999,0,9999,0
1668578714792,CSE 293,013,119232,Jhala; Ranjit,9999,0,9999,0
1668578714792,CSE 293,014,119233,Kahng; Andrew Byun,9999,0,9999,0
1668578714792,CSE 293,015,119298,Kane; Daniel Mertz,9999,0,9999,0
1668578714792,CSE 293,016,119299,Kriegman; David J,9999,0,9999,0
1668578714792,CSE 293,017,119300,Kumar; Arun Kumar,9999,0,9999,0
1668578714792,CSE 293,018,119301,Lerner; Sorin,9999,0,9999,0
1668578714792,CSE 293,019,119302,Lovett; Shachar,9999,0,9999,0
1668578714792,CSE 293,020,119303,McAuley; Julian John,9999,0,9999,0
1668578714792,CSE 293,021,119304,Micciancio; Daniele,9999,0,9999,0
1668578714792,CSE 293,022,119367,Orailoglu; Alex,9999,0,9999,0
1668578714792,CSE 293,023,119382,Paturi; Ramamohan,9999,0,9999,0
1668578714792,CSE 293,024,119404,Polikarpova; Nadezhda,9999,0,9999,0
1668578714792,CSE 293,025,119406,Politz; Joseph Gibbs,9999,0,9999,0
1668578714792,CSE 293,026,119411,Porter; George M,9999,0,9999,0
1668578714792,CSE 293,027,119414,Porter; Leonard Emerson,9999,0,9999,0
1668578714792,CSE 293,028,119416,Ramamoorthi; Ravi,9999,0,9999,0
1668578714792,CSE 293,029,119417,Sahoo; Debashis,9999,0,9999,0
1668578714792,CSE 293,030,119420,Saul; Lawrence,9999,0,9999,0
1668578714792,CSE 293,031,119421,Savage; Stefan,9999,0,9999,0
1668578714792,CSE 293,032,119425,Schulze; Jurgen P.,9999,0,9999,0
1668578714792,CSE 293,033,119426,Snoeren; Alex C.,9999,0,9999,0
1668578714792,CSE 293,034,119428,Shang; Jingbo,9999,0,9999,0
1668578714792,CSE 293,035,119430,Stefan; Deian,9999,0,9999,0
1668578714792,CSE 293,036,119431,Su; Hao,9999,0,9999,0
1668578714792,CSE 293,037,119433,Swanson; Steven James,9999,0,9999,0
1668578714792,CSE 293,038,119435,Tullsen; Dean Michael,9999,0,9999,0
1668578714792,CSE 293,039,119483,Voelker; Geoffrey M.,9999,0,9999,0
1668578714792,CSE 293,040,119537,Zhao; Jishen,9999,0,9999,0
1668578714792,CSE 293,041,119538,Zhou; Yuan-Yuan,9999,0,9999,0
1668578714792,CSE 293,042,119539,Gao; Sicun,9999,0,9999,0
1668578714792,CSE 293,043,119540,Weibel; Nadir,9999,0,9999,0
1668578714792,CSE 293,044,119541,Gupta; Rajesh K.,9999,0,9999,0
1668578714792,CSE 293,045,126410,Vaccaro; Kristen Marie,9999,0,9999,0
1668578714792,CSE 293,046,126411,Klemke; Richard,9999,0,9999,0
1668578715214,CSE 294,A00,102459,Voelker; Geoffrey M.,0,2,0,0
1668578715214,CSE 294,B00,111322,Orailoglu; Alex,0,2,0,0
1668578715639,DSE 201,A00,096914,Deutsch; Alin Bernard,30,0,30,0
1668578716061,DSE 210,A00,096915,Dasgupta; Sanjoy,30,0,30,0
1668578716486,DSE 260A,A00,096916,Altintas De Callaf; Ilkay,30,0,30,0
1668578716922,ECE 200,001,103586,Antipa; Nicholas A,9999,0,9999,0
1668578716922,ECE 200,002,103587,Atanasov; Nikolay A.,9999,0,9999,0
1668578716922,ECE 200,003,103588,Bharadia; Dinesh,9999,0,9999,0
1668578716922,ECE 200,004,103589,Cheng; Chung Kuan,9999,0,9999,0
1668578716922,ECE 200,005,103590,Cosman; Pamela C.,9999,0,9999,0
1668578716922,ECE 200,006,103591,Dayeh; Shadi Ahmad,9999,0,9999,0
1668578716922,ECE 200,007,103592,Fainman; Yeshaiahu,9999,0,9999,0
1668578716922,ECE 200,008,103593,Ford; Joseph Earl,9999,0,9999,0
1668578716922,ECE 200,009,103594,Franceschetti; Massimo,9999,0,9999,0
1668578716922,ECE 200,010,103595,Fullerton; Eric E,9999,0,9999,0
1668578716922,ECE 200,011,103596,Galton; Ian A,9999,0,9999,0
1668578716922,ECE 200,012,103597,Gilja; Vikash,9999,0,9999,0
1668578716922,ECE 200,013,103598,Hall; Drew A.,9999,0,9999,0
1668578716922,ECE 200,014,103599,Hsueh; Tzu-Chien,9999,0,9999,0
1668578716922,ECE 200,015,103600,Javidi; Tara,9999,0,9999,0
1668578716922,ECE 200,016,103601,Kahng; Andrew Byun,9999,0,9999,0
1668578716922,ECE 200,017,103602,Kim; Young-Han,9999,0,9999,0
1668578716922,ECE 200,018,103603,Koushanfar; Farinaz,9999,0,9999,0
1668578716922,ECE 200,019,103604,Kuzum; Duygu,9999,0,9999,0
1668578716922,ECE 200,020,103605,Le; Hanh-Phuc,9999,0,9999,0
1668578716922,ECE 200,021,103606,Lin; Bill,9999,0,9999,0
1668578716922,ECE 200,022,103607,Liu; Zhaowei,9998,0,9999,1
1668578716922,ECE 200,023,103608,Lo; Yu-Hwa,9999,0,9999,0
1668578716922,ECE 200,024,103609,Lomakin; Vitaliy,9999,0,9999,0
1668578716922,ECE 200,025,103610,Mercier; Patrick Philip,9999,0,9999,0
1668578716922,ECE 200,026,103611,Meyer; Florian,9999,0,9999,0
1668578716922,ECE 200,027,103612,Milstein; Laurence B.,9999,0,9999,0
1668578716922,ECE 200,028,103613,Mir Arabbaygi; Siavash,9999,0,9999,0
1668578716922,ECE 200,029,103614,Mookherjea; Shayan,9999,0,9999,0
1668578716922,ECE 200,030,103615,Morris; Karcher William,9999,0,9999,0
1668578716922,ECE 200,031,103616,Ng; Tse Nga,9999,0,9999,0
1668578716922,ECE 200,032,103617,Nguyen; Truong Quang,9999,0,9999,0
1668578716922,ECE 200,033,103618,Nomura; Kenji,9999,0,9999,0
1668578716922,ECE 200,034,103619,Orlitsky; Alon,9999,0,9999,0
1668578716922,ECE 200,035,103620,Pal; Piya,9999,0,9999,0
1668578716922,ECE 200,036,103621,Papen; George C.,9999,0,9999,0
1668578716922,ECE 200,037,103622,Radic; Stojan,9999,0,9999,0
1668578716922,ECE 200,038,103623,Rao; Bhaskar D.,9999,0,9999,0
1668578716922,ECE 200,039,103624,Rao; Ramesh R,9999,0,9999,0
1668578716922,ECE 200,040,103625,Rebeiz; Gabriel,9999,0,9999,0
1668578716922,ECE 200,041,103626,Sanford; John R,9999,0,9999,0
1668578716922,ECE 200,042,103627,Siegel; Paul H.,9999,0,9999,0
1668578716922,ECE 200,043,103628,Sievenpiper; Daniel F.,9999,0,9999,0
1668578716922,ECE 200,044,103629,Sworder; David D.,9999,0,9999,0
1668578716922,ECE 200,045,103630,Taur; Yuan,9999,0,9999,0
1668578716922,ECE 200,046,103631,Touri; Behrouz,9999,0,9999,0
1668578716922,ECE 200,047,103632,Trivedi; Mohan M.,9999,0,9999,0
1668578716922,ECE 200,048,103633,Vasconcelos; Nuno,9999,0,9999,0
1668578716922,ECE 200,049,103634,Wang; Xiaolong,9999,0,9999,0
1668578716922,ECE 200,050,103635,Xie; Pengtao,9999,0,9999,0
1668578716922,ECE 200,051,103636,Yip; Michael,9999,0,9999,0
1668578716922,ECE 200,052,103637,Zeger; Kenneth A.,999,0,999,0
1668578716922,ECE 200,053,103638,Zhang; Xinyu,9999,0,9999,0
1668578716922,ECE 200,054,103639,Turakhia; Yatish Girish,9999,0,9999,0
1668578716922,ECE 200,055,103640,Kang; Mingu,9999,0,9999,0
1668578716922,ECE 200,056,103641,Shi; Yuanyuan,9999,0,9999,0
1668578716922,ECE 200,057,103642,Wang; Edward Jay,9999,0,9999,0
1668578716922,ECE 200,058,103643,Zheng; Yang,9999,0,9999,0
1668578717353,ECE 202,A00,103644,Kuzum; Duygu,0,46,0,0
1668578717777,ECE 212BN,A00,103646,Ng; Tse Nga,0,10,0,0
1668578718211,ECE 221,A00,111493,Staff,0,0,0,0
1668578718650,ECE 222B,A00,103647,Lomakin; Vitaliy,0,21,0,0
1668578719081,ECE 230B,A00,103648,Taur; Yuan,0,4,0,0
1668578719518,ECE 238B,A00,103649,Garay; Javier,0,0,0,0
1668578719944,ECE 240B,A00,112900,Fainman; Yeshaiahu,0,8,0,0
1668578720377,ECE 247A,A00,103650,Jokerst; Jesse Vincent,0,6,0,0
1668578720801,ECE 247B,A00,103651,Wang; Joseph,0,14,0,0
1668578721223,ECE 250,A00,103652,Siegel; Paul H.,0,84,0,0
1668578721649,ECE 251A,A00,103654,Rao; Bhaskar D.,0,65,0,0
1668578722073,ECE 257B,A00,103655,Bharadia; Dinesh,0,33,0,0
1668578722496,ECE 258A,A00,103656,Milstein; Laurence B.,0,29,0,0
1668578722922,ECE 260B,A00,103658,Kang; Mingu,0,121,0,0
1668578723346,ECE 264A,A00,103659,Galton; Ian A,0,44,0,32
1668578723770,ECE 265A,A00,103661,Gudem; Prasad S.S.,0,43,0,34
1668578724197,ECE 265D,A00,103662,Gudem; Prasad S.S.,0,27,0,0
1668578724622,ECE 268,A00,103663,Koushanfar; Farinaz,0,44,0,0
1668578725045,ECE 269,A01,103665,Pal; Piya,0,223,0,0
1668578725471,ECE 271B,A00,103666,Vasconcelos; Manuela,0,79,0,0
1668578725895,ECE 276A,A00,103667,Atanasov; Nikolay A.,0,127,0,0
1668578726319,ECE 277,A00,103668,An; Cheolhong,0,151,0,0
1668578726741,ECE 279,A00,117947,Hall; Drew A.,0,22,0,0
1668578727588,ECE 283,A00,103670,Hsueh; Tzu-Chien,0,57,0,0
1668578728026,ECE 284,A00,103671,Turakhia; Yatish Girish,0,40,0,0
1668578728457,ECE 285,A00,103672,Zheng; Yang,0,40,0,0
1668578728457,ECE 285,B00,103673,Sworder; David D.,0,61,0,0
1668578728882,ECE 287,A00,103676,Javidi; Tara,0,7,0,0
1668578729306,MATH 200B,A00,098023,Salehi Golsefidy; Alireza,7,0,15,8
1668578729732,MATH 202B,A00,098024,Rhoades; Brendon Patrick,7,0,15,8
1668578730158,MATH 203B,A00,098025,Oprea; Dragos N.,9,0,15,6
1668578730588,MATH 204B,A00,098026,Sorensen; Claus M,13,0,15,2
1668578731011,MATH 208,A00,098027,Izadi; Elham,7,0,10,3
1668578731437,MATH 209,A00,098028,Pollack; Aaron,10,0,10,0
1668578731861,MATH 211A,A00,112919,Rogalski; Daniel,8,0,10,2
1668578732285,MATH 211B,A00,112920,Seward; Brandon M.,9,0,10,1
1668578732709,MATH 218,A00,098029,Li; Bo,10,0,10,0
1668578733151,MATH 220B,A00,098030,Novak; Jonathan I,10,0,15,5
1668578733585,MATH 221A,A00,098031,Ebenfelt; Peter F,12,0,15,3
1668578734106,MATH 231B,A00,098032,Zlatos; Andrej,9,0,15,6
1668578734547,MATH 240B,A00,098033,Ni; Lei,7,0,15,8
1668578734971,MATH 243,A00,098034,Jekel; David Andrew,10,0,10,0
1668578735393,MATH 245A,A00,098035,Nie; Jiawang,0,7,15,18
1668578735818,MATH 248,A00,098036,Bejenaru; Ioan,10,0,10,0
1668578736249,MATH 250B,A00,098037,Spolaor; Luca,12,0,15,3
1668578736673,MATH 258,A00,098038,Ni; Lei,8,0,10,2
1668578737100,MATH 264B,A00,098041,Rhoades; Brendon Patrick,7,0,15,8
1668578737527,MATH 268,A00,098042,Buss; Samuel R,10,0,10,0
1668578737953,MATH 269,A00,098043,Rhoades; Brendon Patrick,10,0,10,0
1668578738380,MATH 270B,A00,098044,Li; Bo,6,0,15,9
1668578738802,MATH 272B,A00,098045,Holst; Michael J,13,0,15,2
1668578739233,MATH 273A,A00,098046,Tian; Xiaochuan,10,0,15,5
1668578739658,MATH 275,A01,098048,Tian; Xiaochuan,6,0,10,4
1668578740082,MATH 278A,A00,098049,Holst; Michael J,6,0,10,4
1668578740513,MATH 278B,A00,098050,Cloninger; Alexander,10,0,10,0
1668578740942,MATH 278C,A00,098051,Nie; Jiawang,5,0,10,5
1668578741377,MATH 280B,A00,098052,Zheng; Tianyi,6,0,15,9
1668578741802,MATH 281B,A00,098053,Bradic; Jelena,0,2,15,15
1668578742237,MATH 282B,A00,098054,Arias-Castro; Ery,0,1,15,15
1668578742672,MATH 285,A00,098055,Fitzsimmons; Patrick J,0,4,15,16
1668578743099,MATH 287B,A00,098056,Arias-Castro; Ery,1,0,15,14
1668578743523,MATH 288,A00,098057,Agarwal; Pooja,9,0,10,1
1668578743523,MATH 288,B00,098058,Zhang; Danna,8,0,10,2
1668578743523,MATH 288,C00,098059,Williams; Ruth J,9,0,10,1
1668578743947,MATH 290B,A00,098060,Roberts; Justin Deritter,12,0,15,3
1668578744392,MATH 292,A00,098061,Belmont; Eva Kinoshita,10,0,10,0
1668578744826,MATH 295,A00,098062,Suk; Andrew Hoon,47,0,50,3
1668578745250,MATH 296,A00,098063,Novak; Jonathan I,20,0,20,0
1668578745676,MATH 297,001,098064,Gamst; Anthony Collins,9997,0,9999,2
1668579259238,COGS 205,A00,101395,Chiba; Andrea,19,0,20,1
1668579259662,COGS 210B,001,101404,Greene; Deanna Jacquelyn,9998,0,9999,1
1668579259662,COGS 210B,002,101417,Xia; Haijun,9999,0,9999,0
1668579259662,COGS 210B,003,101422,Nitz; Douglas A.,9999,0,9999,0
1668579259662,COGS 210B,004,101423,Hollan; James D.,9998,0,9999,1
1668579259662,COGS 210B,005,101424,Deak; Gedeon O.,9998,0,9999,1
1668579259662,COGS 210B,006,101425,Rossano; Federico,9999,0,9999,0
1668579260086,COGS 211B,A00,101427,Coulson; Seana M,9996,0,9999,3
1668579260511,COGS 220,A00,101428,Hollan; James D.,0,17,25,25
1668579260936,COGS 229,A00,101429,Dow; Steven P,17,0,25,8
1668579261359,COGS 230,A00,101430,Klemmer; Scott R,6,0,17,11
1668579261785,COGS 234,A00,101431,Xia; Haijun,0,1,25,25
1668579262212,COGS 260,A00,101432,Kiyonaga; Anastasia,21,0,25,4
1668579262212,COGS 260,B00,101433,Kirsh; David Joel,15,0,25,10
1668579262649,CSE 202,A00,102371,Impagliazzo; Russell,0,70,0,0
1668579263073,CSE 203B,A01,102373,Cheng; Chung Kuan,0,70,0,0
1668579263495,CSE 208,A00,102374,Micciancio; Daniele,0,5,0,0
1668579263922,CSE 209A,A00,112895,Impagliazzo; Russell,0,14,15,15
1668579264349,CSE 209B,A00,108005,Bellare; Mihir,0,7,0,0
1668579264773,CSE 210,A00,113163,Coblenz; Michael J,0,96,0,0
1668579265203,CSE 219,A00,106111,Dow; Steven P,0,8,20,20
1668579265626,CSE 221,A00,102376,Voelker; Geoffrey M.,0,77,0,0
1668579266150,CSE 224,A01,102378,Porter; George M,0,180,0,0
1668579266577,CSE 229A,A00,102379,Savage; Stefan,0,14,0,0
1668579267003,CSE 229C,A00,102380,Munyaka; Imani N. S.,0,12,0,0
1668579267436,CSE 232B,A00,102382,Deutsch; Alin Bernard,0,39,0,0
1668579267861,CSE 234,A01,112904,Kumar; Arun Kumar,0,0,0,0
1668579268288,CSE 237A,A00,102383,Rosing; Tajana Simunic,0,57,0,0
1668579268711,CSE 239A,A00,102384,Deutsch; Alin Bernard,0,18,0,0
1668579269136,CSE 239B,A00,102385,Polikarpova; Nadezhda,0,11,0,0
1668579269562,CSE 240A,A00,102386,Pannuto; Patrick William,0,49,0,0
1668579269985,CSE 240B,A00,102387,Zhao; Jishen,0,51,0,0
1668579270410,CSE 241A,A00,106406,Kang; Mingu,0,9,0,0
1668579270837,CSE 249B,A00,102388,Kahng; Andrew Byun,0,7,8,8
1668579271260,CSE 251B,A01,102392,Cottrell; Garrison W,0,54,0,0
1668579271260,CSE 251B,A02,102393,Cottrell; Garrison W,0,36,0,0
1668579271685,CSE 252B,A00,102394,Ochoa; Benjamin Lawrence,0,64,0,0
1668579272115,CSE 257,A01,102396,Gao; Sicun,0,160,0,0
1668579272541,CSE 272,A00,102397,Li; Tzumao,0,22,0,0
1668579272966,CSE 274,A00,111323,Chern; Albert Ren-Haur,0,16,0,0
1668579273394,CSE 282,A00,102398,Pevzner; Pavel Arkadjevich,0,0,0,0
1668579273819,CSE 284,A00,114175,Gymrek; Melissa Ann,0,33,0,0
1668579274242,CSE 290,A00,102399,Chandraker; Manmohan Krishna,0,11,0,0
1668579274242,CSE 290,B00,102400,Vaccaro; Kristen Marie,0,10,25,25
1668579274242,CSE 290,C00,102414,Pannuto; Patrick William,0,1,25,25
1668579274242,CSE 290,D00,102427,Pevzner; Pavel Arkadjevich,0,0,0,0
1668579274242,CSE 290,E00,102429,Zhao; Jishen,0,6,0,0
1668579274242,CSE 290,F00,102436,Tullsen; Dean Michael,0,6,0,0
1668579274242,CSE 290,G00,102440,Christensen; Henrik I,0,8,20,20
1668579274673,CSE 291,A00,102443,Su; Hao,0,0,0,0
1668579274673,CSE 291,B00,102448,Polikarpova; Nadezhda,0,0,0,0
1668579274673,CSE 291,C00,102453,Vaccaro; Kristen Marie,0,0,0,0
1668579274673,CSE 291,D00,111343,Savage; Stefan,0,0,0,0
1668579274673,CSE 291,E00,116474,Claffy; Kimberly Claire,0,0,0,0
1668579274673,CSE 291,F00,116479,Pasquale; Joseph,0,0,0,0
1668579275105,CSE 293,001,119111,Bafna; Vineet,9999,0,9999,0
1668579275105,CSE 293,002,119118,Bellare; Mihir,9999,0,9999,0
1668579275105,CSE 293,003,119122,Berg-Kirkpatrick; Taylor D,9999,0,9999,0
1668579275105,CSE 293,004,119135,Christensen; Henrik I,9999,0,9999,0
1668579275105,CSE 293,005,119142,Cottrell; Garrison W,9999,0,9999,0
1668579275105,CSE 293,006,119146,Deutsch; Alin Bernard,9999,0,9999,0
1668579275105,CSE 293,007,119159,Esmaeilzadeh; Hadi,9999,0,9999,0
1668579275105,CSE 293,008,119166,Freund; Yoav,9999,0,9999,0
1668579275105,CSE 293,009,119170,Griswold; William G.,9999,0,9999,0
1668579275105,CSE 293,010,119183,Gymrek; Melissa Ann,9999,0,9999,0
1668579275105,CSE 293,011,119190,Heninger; Nadia A,9999,0,9999,0
1668579275105,CSE 293,012,119230,Impagliazzo; Russell,9999,0,9999,0
1668579275105,CSE 293,013,119232,Jhala; Ranjit,9999,0,9999,0
1668579275105,CSE 293,014,119233,Kahng; Andrew Byun,9999,0,9999,0
1668579275105,CSE 293,015,119298,Kane; Daniel Mertz,9999,0,9999,0
1668579275105,CSE 293,016,119299,Kriegman; David J,9999,0,9999,0
1668579275105,CSE 293,017,119300,Kumar; Arun Kumar,9999,0,9999,0
1668579275105,CSE 293,018,119301,Lerner; Sorin,9999,0,9999,0
1668579275105,CSE 293,019,119302,Lovett; Shachar,9999,0,9999,0
1668579275105,CSE 293,020,119303,McAuley; Julian John,9999,0,9999,0
1668579275105,CSE 293,021,119304,Micciancio; Daniele,9999,0,9999,0
1668579275105,CSE 293,022,119367,Orailoglu; Alex,9999,0,9999,0
1668579275105,CSE 293,023,119382,Paturi; Ramamohan,9999,0,9999,0
1668579275105,CSE 293,024,119404,Polikarpova; Nadezhda,9999,0,9999,0
1668579275105,CSE 293,025,119406,Politz; Joseph Gibbs,9999,0,9999,0
1668579275105,CSE 293,026,119411,Porter; George M,9999,0,9999,0
1668579275105,CSE 293,027,119414,Porter; Leonard Emerson,9999,0,9999,0
1668579275105,CSE 293,028,119416,Ramamoorthi; Ravi,9999,0,9999,0
1668579275105,CSE 293,029,119417,Sahoo; Debashis,9999,0,9999,0
1668579275105,CSE 293,030,119420,Saul; Lawrence,9999,0,9999,0
1668579275105,CSE 293,031,119421,Savage; Stefan,9999,0,9999,0
1668579275105,CSE 293,032,119425,Schulze; Jurgen P.,9999,0,9999,0
1668579275105,CSE 293,033,119426,Snoeren; Alex C.,9999,0,9999,0
1668579275105,CSE 293,034,119428,Shang; Jingbo,9999,0,9999,0
1668579275105,CSE 293,035,119430,Stefan; Deian,9999,0,9999,0
1668579275105,CSE 293,036,119431,Su; Hao,9999,0,9999,0
1668579275105,CSE 293,037,119433,Swanson; Steven James,9999,0,9999,0
1668579275105,CSE 293,038,119435,Tullsen; Dean Michael,9999,0,9999,0
1668579275105,CSE 293,039,119483,Voelker; Geoffrey M.,9999,0,9999,0
1668579275105,CSE 293,040,119537,Zhao; Jishen,9999,0,9999,0
1668579275105,CSE 293,041,119538,Zhou; Yuan-Yuan,9999,0,9999,0
1668579275105,CSE 293,042,119539,Gao; Sicun,9999,0,9999,0
1668579275105,CSE 293,043,119540,Weibel; Nadir,9999,0,9999,0
1668579275105,CSE 293,044,119541,Gupta; Rajesh K.,9999,0,9999,0
1668579275105,CSE 293,045,126410,Vaccaro; Kristen Marie,9999,0,9999,0
1668579275105,CSE 293,046,126411,Klemke; Richard,9999,0,9999,0
1668579275529,CSE 294,A00,102459,Voelker; Geoffrey M.,0,2,0,0
1668579275529,CSE 294,B00,111322,Orailoglu; Alex,0,2,0,0
1668579275954,DSE 201,A00,096914,Deutsch; Alin Bernard,30,0,30,0
1668579276376,DSE 210,A00,096915,Dasgupta; Sanjoy,30,0,30,0
1668579276799,DSE 260A,A00,096916,Altintas De Callaf; Ilkay,30,0,30,0
1668579277242,ECE 200,001,103586,Antipa; Nicholas A,9999,0,9999,0
1668579277242,ECE 200,002,103587,Atanasov; Nikolay A.,9999,0,9999,0
1668579277242,ECE 200,003,103588,Bharadia; Dinesh,9999,0,9999,0
1668579277242,ECE 200,004,103589,Cheng; Chung Kuan,9999,0,9999,0
1668579277242,ECE 200,005,103590,Cosman; Pamela C.,9999,0,9999,0
1668579277242,ECE 200,006,103591,Dayeh; Shadi Ahmad,9999,0,9999,0
1668579277242,ECE 200,007,103592,Fainman; Yeshaiahu,9999,0,9999,0
1668579277242,ECE 200,008,103593,Ford; Joseph Earl,9999,0,9999,0
1668579277242,ECE 200,009,103594,Franceschetti; Massimo,9999,0,9999,0
1668579277242,ECE 200,010,103595,Fullerton; Eric E,9999,0,9999,0
1668579277242,ECE 200,011,103596,Galton; Ian A,9999,0,9999,0
1668579277242,ECE 200,012,103597,Gilja; Vikash,9999,0,9999,0
1668579277242,ECE 200,013,103598,Hall; Drew A.,9999,0,9999,0
1668579277242,ECE 200,014,103599,Hsueh; Tzu-Chien,9999,0,9999,0
1668579277242,ECE 200,015,103600,Javidi; Tara,9999,0,9999,0
1668579277242,ECE 200,016,103601,Kahng; Andrew Byun,9999,0,9999,0
1668579277242,ECE 200,017,103602,Kim; Young-Han,9999,0,9999,0
1668579277242,ECE 200,018,103603,Koushanfar; Farinaz,9999,0,9999,0
1668579277242,ECE 200,019,103604,Kuzum; Duygu,9999,0,9999,0
1668579277242,ECE 200,020,103605,Le; Hanh-Phuc,9999,0,9999,0
1668579277242,ECE 200,021,103606,Lin; Bill,9999,0,9999,0
1668579277242,ECE 200,022,103607,Liu; Zhaowei,9998,0,9999,1
1668579277242,ECE 200,023,103608,Lo; Yu-Hwa,9999,0,9999,0
1668579277242,ECE 200,024,103609,Lomakin; Vitaliy,9999,0,9999,0
1668579277242,ECE 200,025,103610,Mercier; Patrick Philip,9999,0,9999,0
1668579277242,ECE 200,026,103611,Meyer; Florian,9999,0,9999,0
1668579277242,ECE 200,027,103612,Milstein; Laurence B.,9999,0,9999,0
1668579277242,ECE 200,028,103613,Mir Arabbaygi; Siavash,9999,0,9999,0
1668579277242,ECE 200,029,103614,Mookherjea; Shayan,9999,0,9999,0
1668579277242,ECE 200,030,103615,Morris; Karcher William,9999,0,9999,0
1668579277242,ECE 200,031,103616,Ng; Tse Nga,9999,0,9999,0
1668579277242,ECE 200,032,103617,Nguyen; Truong Quang,9999,0,9999,0
1668579277242,ECE 200,033,103618,Nomura; Kenji,9999,0,9999,0
1668579277242,ECE 200,034,103619,Orlitsky; Alon,9999,0,9999,0
1668579277242,ECE 200,035,103620,Pal; Piya,9999,0,9999,0
1668579277242,ECE 200,036,103621,Papen; George C.,9999,0,9999,0
1668579277242,ECE 200,037,103622,Radic; Stojan,9999,0,9999,0
1668579277242,ECE 200,038,103623,Rao; Bhaskar D.,9999,0,9999,0
1668579277242,ECE 200,039,103624,Rao; Ramesh R,9999,0,9999,0
1668579277242,ECE 200,040,103625,Rebeiz; Gabriel,9999,0,9999,0
1668579277242,ECE 200,041,103626,Sanford; John R,9999,0,9999,0
1668579277242,ECE 200,042,103627,Siegel; Paul H.,9999,0,9999,0
1668579277242,ECE 200,043,103628,Sievenpiper; Daniel F.,9999,0,9999,0
1668579277242,ECE 200,044,103629,Sworder; David D.,9999,0,9999,0
1668579277242,ECE 200,045,103630,Taur; Yuan,9999,0,9999,0
1668579277242,ECE 200,046,103631,Touri; Behrouz,9999,0,9999,0
1668579277242,ECE 200,047,103632,Trivedi; Mohan M.,9999,0,9999,0
1668579277242,ECE 200,048,103633,Vasconcelos; Nuno,9999,0,9999,0
1668579277242,ECE 200,049,103634,Wang; Xiaolong,9999,0,9999,0
1668579277242,ECE 200,050,103635,Xie; Pengtao,9999,0,9999,0
1668579277242,ECE 200,051,103636,Yip; Michael,9999,0,9999,0
1668579277242,ECE 200,052,103637,Zeger; Kenneth A.,999,0,999,0
1668579277242,ECE 200,053,103638,Zhang; Xinyu,9999,0,9999,0
1668579277242,ECE 200,054,103639,Turakhia; Yatish Girish,9999,0,9999,0
1668579277242,ECE 200,055,103640,Kang; Mingu,9999,0,9999,0
1668579277242,ECE 200,056,103641,Shi; Yuanyuan,9999,0,9999,0
1668579277242,ECE 200,057,103642,Wang; Edward Jay,9999,0,9999,0
1668579277242,ECE 200,058,103643,Zheng; Yang,9999,0,9999,0
1668579277670,ECE 202,A00,103644,Kuzum; Duygu,0,46,0,0
1668579278095,ECE 212BN,A00,103646,Ng; Tse Nga,0,10,0,0
1668579278517,ECE 221,A00,111493,Staff,0,0,0,0
1668579278946,ECE 222B,A00,103647,Lomakin; Vitaliy,0,21,0,0
1668579279374,ECE 230B,A00,103648,Taur; Yuan,0,4,0,0
1668579279800,ECE 238B,A00,103649,Garay; Javier,0,0,0,0
1668579280236,ECE 240B,A00,112900,Fainman; Yeshaiahu,0,8,0,0
1668579280660,ECE 247A,A00,103650,Jokerst; Jesse Vincent,0,6,0,0
1668579281083,ECE 247B,A00,103651,Wang; Joseph,0,14,0,0
1668579281509,ECE 250,A00,103652,Siegel; Paul H.,0,84,0,0
1668579281937,ECE 251A,A00,103654,Rao; Bhaskar D.,0,65,0,0
1668579282361,ECE 257B,A00,103655,Bharadia; Dinesh,0,33,0,0
1668579282784,ECE 258A,A00,103656,Milstein; Laurence B.,0,29,0,0
1668579283209,ECE 260B,A00,103658,Kang; Mingu,0,121,0,0
1668579283633,ECE 264A,A00,103659,Galton; Ian A,0,42,0,34
1668579284056,ECE 265A,A00,103661,Gudem; Prasad S.S.,0,43,0,35
1668579284480,ECE 265D,A00,103662,Gudem; Prasad S.S.,0,27,0,0
1668579284902,ECE 268,A00,103663,Koushanfar; Farinaz,0,44,0,0
1668579285327,ECE 269,A01,103665,Pal; Piya,0,223,0,0
1668579285754,ECE 271B,A00,103666,Vasconcelos; Manuela,0,79,0,0
1668579286180,ECE 276A,A00,103667,Atanasov; Nikolay A.,0,127,0,0
1668579286611,ECE 277,A00,103668,An; Cheolhong,0,151,0,0
1668579287035,ECE 279,A00,117947,Hall; Drew A.,0,22,0,0
1668579287899,ECE 283,A00,103670,Hsueh; Tzu-Chien,0,57,0,0
1668579288324,ECE 284,A00,103671,Turakhia; Yatish Girish,0,40,0,0
1668579288749,ECE 285,A00,103672,Zheng; Yang,0,40,0,0
1668579288749,ECE 285,B00,103673,Sworder; David D.,0,61,0,0
1668579289179,ECE 287,A00,103676,Javidi; Tara,0,7,0,0
1668579289608,MATH 200B,A00,098023,Salehi Golsefidy; Alireza,7,0,15,8
1668579290042,MATH 202B,A00,098024,Rhoades; Brendon Patrick,7,0,15,8
1668579290473,MATH 203B,A00,098025,Oprea; Dragos N.,9,0,15,6
1668579290903,MATH 204B,A00,098026,Sorensen; Claus M,13,0,15,2
1668579291325,MATH 208,A00,098027,Izadi; Elham,7,0,10,3
1668579291748,MATH 209,A00,098028,Pollack; Aaron,10,0,10,0
1668579292177,MATH 211A,A00,112919,Rogalski; Daniel,8,0,10,2
1668579292601,MATH 211B,A00,112920,Seward; Brandon M.,9,0,10,1
1668579293027,MATH 218,A00,098029,Li; Bo,10,0,10,0
1668579293453,MATH 220B,A00,098030,Novak; Jonathan I,10,0,15,5
1668579293888,MATH 221A,A00,098031,Ebenfelt; Peter F,12,0,15,3
1668579294315,MATH 231B,A00,098032,Zlatos; Andrej,9,0,15,6
1668579294746,MATH 240B,A00,098033,Ni; Lei,7,0,15,8
1668579295167,MATH 243,A00,098034,Jekel; David Andrew,10,0,10,0
1668579295595,MATH 245A,A00,098035,Nie; Jiawang,0,7,15,18
1668579296021,MATH 248,A00,098036,Bejenaru; Ioan,10,0,10,0
1668579296443,MATH 250B,A00,098037,Spolaor; Luca,12,0,15,3
1668579296866,MATH 258,A00,098038,Ni; Lei,8,0,10,2
1668579297289,MATH 264B,A00,098041,Rhoades; Brendon Patrick,7,0,15,8
1668579297714,MATH 268,A00,098042,Buss; Samuel R,10,0,10,0
1668579298139,MATH 269,A00,098043,Rhoades; Brendon Patrick,10,0,10,0
1668579298566,MATH 270B,A00,098044,Li; Bo,6,0,15,9
1668579298991,MATH 272B,A00,098045,Holst; Michael J,13,0,15,2
1668579299417,MATH 273A,A00,098046,Tian; Xiaochuan,10,0,15,5
1668579299847,MATH 275,A01,098048,Tian; Xiaochuan,6,0,10,4
1668579300271,MATH 278A,A00,098049,Holst; Michael J,6,0,10,4
1668579300694,MATH 278B,A00,098050,Cloninger; Alexander,10,0,10,0
1668579301121,MATH 278C,A00,098051,Nie; Jiawang,5,0,10,5
1668579301547,MATH 280B,A00,098052,Zheng; Tianyi,6,0,15,9
1668579301974,MATH 281B,A00,098053,Bradic; Jelena,0,2,15,15
1668579302397,MATH 282B,A00,098054,Arias-Castro; Ery,0,1,15,15
1668579302819,MATH 285,A00,098055,Fitzsimmons; Patrick J,0,4,15,16
1668579303256,MATH 287B,A00,098056,Arias-Castro; Ery,1,0,15,14
1668579303680,MATH 288,A00,098057,Agarwal; Pooja,9,0,10,1
1668579303680,MATH 288,B00,098058,Zhang; Danna,8,0,10,2
1668579303680,MATH 288,C00,098059,Williams; Ruth J,9,0,10,1
1668579304109,MATH 290B,A00,098060,Roberts; Justin Deritter,12,0,15,3
1668579304531,MATH 292,A00,098061,Belmont; Eva Kinoshita,10,0,10,0
1668579304958,MATH 295,A00,098062,Suk; Andrew Hoon,47,0,50,3
1668579305381,MATH 296,A00,098063,Novak; Jonathan I,20,0,20,0
1668579305802,MATH 297,001,098064,Gamst; Anthony Collins,9997,0,9999,2
1668579808951,COGS 205,A00,101395,Chiba; Andrea,19,0,20,1
1668579809381,COGS 210B,001,101404,Greene; Deanna Jacquelyn,9998,0,9999,1
1668579809381,COGS 210B,002,101417,Xia; Haijun,9999,0,9999,0
1668579809381,COGS 210B,003,101422,Nitz; Douglas A.,9999,0,9999,0
1668579809381,COGS 210B,004,101423,Hollan; James D.,9998,0,9999,1
1668579809381,COGS 210B,005,101424,Deak; Gedeon O.,9998,0,9999,1
1668579809381,COGS 210B,006,101425,Rossano; Federico,9999,0,9999,0
1668579809803,COGS 211B,A00,101427,Coulson; Seana M,9996,0,9999,3
1668579810232,COGS 220,A00,101428,Hollan; James D.,0,17,25,25
1668579810656,COGS 229,A00,101429,Dow; Steven P,17,0,25,8
1668579811078,COGS 230,A00,101430,Klemmer; Scott R,6,0,17,11
1668579811503,COGS 234,A00,101431,Xia; Haijun,0,1,25,25
1668579811938,COGS 260,A00,101432,Kiyonaga; Anastasia,21,0,25,4
1668579811938,COGS 260,B00,101433,Kirsh; David Joel,15,0,25,10
1668579812359,CSE 202,A00,102371,Impagliazzo; Russell,0,70,0,0
1668579812791,CSE 203B,A01,102373,Cheng; Chung Kuan,0,70,0,0
1668579813214,CSE 208,A00,102374,Micciancio; Daniele,0,5,0,0
1668579813656,CSE 209A,A00,112895,Impagliazzo; Russell,0,14,15,15
1668579814095,CSE 209B,A00,108005,Bellare; Mihir,0,7,0,0
1668579814527,CSE 210,A00,113163,Coblenz; Michael J,0,96,0,0
1668579814950,CSE 219,A00,106111,Dow; Steven P,0,8,20,20
1668579815395,CSE 221,A00,102376,Voelker; Geoffrey M.,0,77,0,0
1668579815833,CSE 224,A01,102378,Porter; George M,0,180,0,0
1668579816255,CSE 229A,A00,102379,Savage; Stefan,0,14,0,0
1668579816681,CSE 229C,A00,102380,Munyaka; Imani N. S.,0,12,0,0
1668579817105,CSE 232B,A00,102382,Deutsch; Alin Bernard,0,39,0,0
1668579817576,CSE 234,A01,112904,Kumar; Arun Kumar,0,0,0,0
1668579818003,CSE 237A,A00,102383,Rosing; Tajana Simunic,0,57,0,0
1668579818425,CSE 239A,A00,102384,Deutsch; Alin Bernard,0,18,0,0
1668579818851,CSE 239B,A00,102385,Polikarpova; Nadezhda,0,11,0,0
1668579819275,CSE 240A,A00,102386,Pannuto; Patrick William,0,49,0,0
1668579819706,CSE 240B,A00,102387,Zhao; Jishen,0,51,0,0
1668579820141,CSE 241A,A00,106406,Kang; Mingu,0,9,0,0
1668579820567,CSE 249B,A00,102388,Kahng; Andrew Byun,0,7,8,8
1668579820993,CSE 251B,A01,102392,Cottrell; Garrison W,0,54,0,0
1668579820993,CSE 251B,A02,102393,Cottrell; Garrison W,0,36,0,0
1668579821418,CSE 252B,A00,102394,Ochoa; Benjamin Lawrence,0,64,0,0
1668579821843,CSE 257,A01,102396,Gao; Sicun,0,160,0,0
1668579822271,CSE 272,A00,102397,Li; Tzumao,0,22,0,0
1668579822703,CSE 274,A00,111323,Chern; Albert Ren-Haur,0,16,0,0
1668579823140,CSE 282,A00,102398,Pevzner; Pavel Arkadjevich,0,0,0,0
1668579823592,CSE 284,A00,114175,Gymrek; Melissa Ann,0,33,0,0
1668579824016,CSE 290,A00,102399,Chandraker; Manmohan Krishna,0,11,0,0
1668579824016,CSE 290,B00,102400,Vaccaro; Kristen Marie,0,10,25,25
1668579824016,CSE 290,C00,102414,Pannuto; Patrick William,0,1,25,25
1668579824016,CSE 290,D00,102427,Pevzner; Pavel Arkadjevich,0,0,0,0
1668579824016,CSE 290,E00,102429,Zhao; Jishen,0,6,0,0
1668579824016,CSE 290,F00,102436,Tullsen; Dean Michael,0,6,0,0
1668579824016,CSE 290,G00,102440,Christensen; Henrik I,0,8,20,20
1668579824441,CSE 291,A00,102443,Su; Hao,0,0,0,0
1668579824441,CSE 291,B00,102448,Polikarpova; Nadezhda,0,0,0,0
1668579824441,CSE 291,C00,102453,Vaccaro; Kristen Marie,0,0,0,0
1668579824441,CSE 291,D00,111343,Savage; Stefan,0,0,0,0
1668579824441,CSE 291,E00,116474,Claffy; Kimberly Claire,0,0,0,0
1668579824441,CSE 291,F00,116479,Pasquale; Joseph,0,0,0,0
1668579824889,CSE 293,001,119111,Bafna; Vineet,9999,0,9999,0
1668579824889,CSE 293,002,119118,Bellare; Mihir,9999,0,9999,0
1668579824889,CSE 293,003,119122,Berg-Kirkpatrick; Taylor D,9999,0,9999,0
1668579824889,CSE 293,004,119135,Christensen; Henrik I,9999,0,9999,0
1668579824889,CSE 293,005,119142,Cottrell; Garrison W,9999,0,9999,0
1668579824889,CSE 293,006,119146,Deutsch; Alin Bernard,9999,0,9999,0
1668579824889,CSE 293,007,119159,Esmaeilzadeh; Hadi,9999,0,9999,0
1668579824889,CSE 293,008,119166,Freund; Yoav,9999,0,9999,0
1668579824889,CSE 293,009,119170,Griswold; William G.,9999,0,9999,0
1668579824889,CSE 293,010,119183,Gymrek; Melissa Ann,9999,0,9999,0
1668579824889,CSE 293,011,119190,Heninger; Nadia A,9999,0,9999,0
1668579824889,CSE 293,012,119230,Impagliazzo; Russell,9999,0,9999,0
1668579824889,CSE 293,013,119232,Jhala; Ranjit,9999,0,9999,0
1668579824889,CSE 293,014,119233,Kahng; Andrew Byun,9999,0,9999,0
1668579824889,CSE 293,015,119298,Kane; Daniel Mertz,9999,0,9999,0
1668579824889,CSE 293,016,119299,Kriegman; David J,9999,0,9999,0
1668579824889,CSE 293,017,119300,Kumar; Arun Kumar,9999,0,9999,0
1668579824889,CSE 293,018,119301,Lerner; Sorin,9999,0,9999,0
1668579824889,CSE 293,019,119302,Lovett; Shachar,9999,0,9999,0
1668579824889,CSE 293,020,119303,McAuley; Julian John,9999,0,9999,0
1668579824889,CSE 293,021,119304,Micciancio; Daniele,9999,0,9999,0
1668579824889,CSE 293,022,119367,Orailoglu; Alex,9999,0,9999,0
1668579824889,CSE 293,023,119382,Paturi; Ramamohan,9999,0,9999,0
1668579824889,CSE 293,024,119404,Polikarpova; Nadezhda,9999,0,9999,0
1668579824889,CSE 293,025,119406,Politz; Joseph Gibbs,9999,0,9999,0
1668579824889,CSE 293,026,119411,Porter; George M,9999,0,9999,0
1668579824889,CSE 293,027,119414,Porter; Leonard Emerson,9999,0,9999,0
1668579824889,CSE 293,028,119416,Ramamoorthi; Ravi,9999,0,9999,0
1668579824889,CSE 293,029,119417,Sahoo; Debashis,9999,0,9999,0
1668579824889,CSE 293,030,119420,Saul; Lawrence,9999,0,9999,0
1668579824889,CSE 293,031,119421,Savage; Stefan,9999,0,9999,0
1668579824889,CSE 293,032,119425,Schulze; Jurgen P.,9999,0,9999,0
1668579824889,CSE 293,033,119426,Snoeren; Alex C.,9999,0,9999,0
1668579824889,CSE 293,034,119428,Shang; Jingbo,9999,0,9999,0
1668579824889,CSE 293,035,119430,Stefan; Deian,9999,0,9999,0
1668579824889,CSE 293,036,119431,Su; Hao,9999,0,9999,0
1668579824889,CSE 293,037,119433,Swanson; Steven James,9999,0,9999,0
1668579824889,CSE 293,038,119435,Tullsen; Dean Michael,9999,0,9999,0
1668579824889,CSE 293,039,119483,Voelker; Geoffrey M.,9999,0,9999,0
1668579824889,CSE 293,040,119537,Zhao; Jishen,9999,0,9999,0
1668579824889,CSE 293,041,119538,Zhou; Yuan-Yuan,9999,0,9999,0
1668579824889,CSE 293,042,119539,Gao; Sicun,9999,0,9999,0
1668579824889,CSE 293,043,119540,Weibel; Nadir,9999,0,9999,0
1668579824889,CSE 293,044,119541,Gupta; Rajesh K.,9999,0,9999,0
1668579824889,CSE 293,045,126410,Vaccaro; Kristen Marie,9999,0,9999,0
1668579824889,CSE 293,046,126411,Klemke; Richard,9999,0,9999,0
1668579825316,CSE 294,A00,102459,Voelker; Geoffrey M.,0,2,0,0
1668579825316,CSE 294,B00,111322,Orailoglu; Alex,0,2,0,0
1668579825740,DSE 201,A00,096914,Deutsch; Alin Bernard,30,0,30,0
1668579826162,DSE 210,A00,096915,Dasgupta; Sanjoy,30,0,30,0
1668579826590,DSE 260A,A00,096916,Altintas De Callaf; Ilkay,30,0,30,0
1668579827026,ECE 200,001,103586,Antipa; Nicholas A,9999,0,9999,0
1668579827026,ECE 200,002,103587,Atanasov; Nikolay A.,9999,0,9999,0
1668579827026,ECE 200,003,103588,Bharadia; Dinesh,9999,0,9999,0
1668579827026,ECE 200,004,103589,Cheng; Chung Kuan,9999,0,9999,0
1668579827026,ECE 200,005,103590,Cosman; Pamela C.,9999,0,9999,0
1668579827026,ECE 200,006,103591,Dayeh; Shadi Ahmad,9999,0,9999,0
1668579827026,ECE 200,007,103592,Fainman; Yeshaiahu,9999,0,9999,0
1668579827026,ECE 200,008,103593,Ford; Joseph Earl,9999,0,9999,0
1668579827026,ECE 200,009,103594,Franceschetti; Massimo,9999,0,9999,0
1668579827026,ECE 200,010,103595,Fullerton; Eric E,9999,0,9999,0
1668579827026,ECE 200,011,103596,Galton; Ian A,9999,0,9999,0
1668579827026,ECE 200,012,103597,Gilja; Vikash,9999,0,9999,0
1668579827026,ECE 200,013,103598,Hall; Drew A.,9999,0,9999,0
1668579827026,ECE 200,014,103599,Hsueh; Tzu-Chien,9999,0,9999,0
1668579827026,ECE 200,015,103600,Javidi; Tara,9999,0,9999,0
1668579827026,ECE 200,016,103601,Kahng; Andrew Byun,9999,0,9999,0
1668579827026,ECE 200,017,103602,Kim; Young-Han,9999,0,9999,0
1668579827026,ECE 200,018,103603,Koushanfar; Farinaz,9999,0,9999,0
1668579827026,ECE 200,019,103604,Kuzum; Duygu,9999,0,9999,0
1668579827026,ECE 200,020,103605,Le; Hanh-Phuc,9999,0,9999,0
1668579827026,ECE 200,021,103606,Lin; Bill,9999,0,9999,0
1668579827026,ECE 200,022,103607,Liu; Zhaowei,9998,0,9999,1
1668579827026,ECE 200,023,103608,Lo; Yu-Hwa,9999,0,9999,0
1668579827026,ECE 200,024,103609,Lomakin; Vitaliy,9999,0,9999,0
1668579827026,ECE 200,025,103610,Mercier; Patrick Philip,9999,0,9999,0
1668579827026,ECE 200,026,103611,Meyer; Florian,9999,0,9999,0
1668579827026,ECE 200,027,103612,Milstein; Laurence B.,9999,0,9999,0
1668579827026,ECE 200,028,103613,Mir Arabbaygi; Siavash,9999,0,9999,0
1668579827026,ECE 200,029,103614,Mookherjea; Shayan,9999,0,9999,0
1668579827026,ECE 200,030,103615,Morris; Karcher William,9999,0,9999,0
1668579827026,ECE 200,031,103616,Ng; Tse Nga,9999,0,9999,0
1668579827026,ECE 200,032,103617,Nguyen; Truong Quang,9999,0,9999,0
1668579827026,ECE 200,033,103618,Nomura; Kenji,9999,0,9999,0
1668579827026,ECE 200,034,103619,Orlitsky; Alon,9999,0,9999,0
1668579827026,ECE 200,035,103620,Pal; Piya,9999,0,9999,0
1668579827026,ECE 200,036,103621,Papen; George C.,9999,0,9999,0
1668579827026,ECE 200,037,103622,Radic; Stojan,9999,0,9999,0
1668579827026,ECE 200,038,103623,Rao; Bhaskar D.,9999,0,9999,0
1668579827026,ECE 200,039,103624,Rao; Ramesh R,9999,0,9999,0
1668579827026,ECE 200,040,103625,Rebeiz; Gabriel,9999,0,9999,0
1668579827026,ECE 200,041,103626,Sanford; John R,9999,0,9999,0
1668579827026,ECE 200,042,103627,Siegel; Paul H.,9999,0,9999,0
1668579827026,ECE 200,043,103628,Sievenpiper; Daniel F.,9999,0,9999,0
1668579827026,ECE 200,044,103629,Sworder; David D.,9999,0,9999,0
1668579827026,ECE 200,045,103630,Taur; Yuan,9999,0,9999,0
1668579827026,ECE 200,046,103631,Touri; Behrouz,9999,0,9999,0
1668579827026,ECE 200,047,103632,Trivedi; Mohan M.,9999,0,9999,0
1668579827026,ECE 200,048,103633,Vasconcelos; Nuno,9999,0,9999,0
1668579827026,ECE 200,049,103634,Wang; Xiaolong,9999,0,9999,0
1668579827026,ECE 200,050,103635,Xie; Pengtao,9999,0,9999,0
1668579827026,ECE 200,051,103636,Yip; Michael,9999,0,9999,0
1668579827026,ECE 200,052,103637,Zeger; Kenneth A.,999,0,999,0
1668579827026,ECE 200,053,103638,Zhang; Xinyu,9999,0,9999,0
1668579827026,ECE 200,054,103639,Turakhia; Yatish Girish,9999,0,9999,0
1668579827026,ECE 200,055,103640,Kang; Mingu,9999,0,9999,0
1668579827026,ECE 200,056,103641,Shi; Yuanyuan,9999,0,9999,0
1668579827026,ECE 200,057,103642,Wang; Edward Jay,9999,0,9999,0
1668579827026,ECE 200,058,103643,Zheng; Yang,9999,0,9999,0
1668579827460,ECE 202,A00,103644,Kuzum; Duygu,0,46,0,0
1668579827887,ECE 212BN,A00,103646,Ng; Tse Nga,0,10,0,0
1668579828321,ECE 221,A00,111493,Staff,0,0,0,0
1668579828753,ECE 222B,A00,103647,Lomakin; Vitaliy,0,21,0,0
1668579829178,ECE 230B,A00,103648,Taur; Yuan,0,4,0,0
1668579829604,ECE 238B,A00,103649,Garay; Javier,0,0,0,0
1668579830029,ECE 240B,A00,112900,Fainman; Yeshaiahu,0,8,0,0
1668579830452,ECE 247A,A00,103650,Jokerst; Jesse Vincent,0,6,0,0
1668579830959,ECE 247B,A00,103651,Wang; Joseph,0,14,0,0
1668579831399,ECE 250,A00,103652,Siegel; Paul H.,0,84,0,0
1668579831823,ECE 251A,A00,103654,Rao; Bhaskar D.,0,65,0,0
1668579832247,ECE 257B,A00,103655,Bharadia; Dinesh,0,33,0,0
1668579832671,ECE 258A,A00,103656,Milstein; Laurence B.,0,29,0,0
1668579833093,ECE 260B,A00,103658,Kang; Mingu,0,121,0,0
1668579833519,ECE 264A,A00,103659,Galton; Ian A,0,42,0,34
1668579833944,ECE 265A,A00,103661,Gudem; Prasad S.S.,0,43,0,35
1668579834366,ECE 265D,A00,103662,Gudem; Prasad S.S.,0,27,0,0
1668579834793,ECE 268,A00,103663,Koushanfar; Farinaz,0,44,0,0
1668579835219,ECE 269,A01,103665,Pal; Piya,0,223,0,0
1668579835644,ECE 271B,A00,103666,Vasconcelos; Manuela,0,79,0,0
1668579836071,ECE 276A,A00,103667,Atanasov; Nikolay A.,0,127,0,0
1668579836498,ECE 277,A00,103668,An; Cheolhong,0,151,0,0
1668579836920,ECE 279,A00,117947,Hall; Drew A.,0,22,0,0
1668579837775,ECE 283,A00,103670,Hsueh; Tzu-Chien,0,57,0,0
1668579838202,ECE 284,A00,103671,Turakhia; Yatish Girish,0,40,0,0
1668579838625,ECE 285,A00,103672,Zheng; Yang,0,40,0,0
1668579838625,ECE 285,B00,103673,Sworder; David D.,0,61,0,0
1668579839049,ECE 287,A00,103676,Javidi; Tara,0,7,0,0
1668579839483,MATH 200B,A00,098023,Salehi Golsefidy; Alireza,7,0,15,8
1668579839904,MATH 202B,A00,098024,Rhoades; Brendon Patrick,7,0,15,8
1668579840328,MATH 203B,A00,098025,Oprea; Dragos N.,9,0,15,6
1668579840755,MATH 204B,A00,098026,Sorensen; Claus M,13,0,15,2
1668579841178,MATH 208,A00,098027,Izadi; Elham,7,0,10,3
1668579841609,MATH 209,A00,098028,Pollack; Aaron,10,0,10,0
1668579842031,MATH 211A,A00,112919,Rogalski; Daniel,8,0,10,2
1668579842455,MATH 211B,A00,112920,Seward; Brandon M.,9,0,10,1
1668579842877,MATH 218,A00,098029,Li; Bo,10,0,10,0
1668579843312,MATH 220B,A00,098030,Novak; Jonathan I,10,0,15,5
1668579843736,MATH 221A,A00,098031,Ebenfelt; Peter F,12,0,15,3
1668579844158,MATH 231B,A00,098032,Zlatos; Andrej,9,0,15,6
1668579844580,MATH 240B,A00,098033,Ni; Lei,7,0,15,8
1668579845003,MATH 243,A00,098034,Jekel; David Andrew,10,0,10,0
1668579845429,MATH 245A,A00,098035,Nie; Jiawang,0,7,15,18
1668579845856,MATH 248,A00,098036,Bejenaru; Ioan,10,0,10,0
1668579846301,MATH 250B,A00,098037,Spolaor; Luca,12,0,15,3
1668579846735,MATH 258,A00,098038,Ni; Lei,8,0,10,2
1668579847164,MATH 264B,A00,098041,Rhoades; Brendon Patrick,7,0,15,8
1668579847590,MATH 268,A00,098042,Buss; Samuel R,10,0,10,0
1668579848026,MATH 269,A00,098043,Rhoades; Brendon Patrick,10,0,10,0
1668579848453,MATH 270B,A00,098044,Li; Bo,6,0,15,9
1668579848876,MATH 272B,A00,098045,Holst; Michael J,13,0,15,2
1668579849314,MATH 273A,A00,098046,Tian; Xiaochuan,10,0,15,5
1668579849737,MATH 275,A01,098048,Tian; Xiaochuan,6,0,10,4
1668579850170,MATH 278A,A00,098049,Holst; Michael J,6,0,10,4
1668579850595,MATH 278B,A00,098050,Cloninger; Alexander,10,0,10,0
1668579851018,MATH 278C,A00,098051,Nie; Jiawang,5,0,10,5
1668579851444,MATH 280B,A00,098052,Zheng; Tianyi,6,0,15,9
1668579851866,MATH 281B,A00,098053,Bradic; Jelena,0,2,15,15
1668579852290,MATH 282B,A00,098054,Arias-Castro; Ery,0,1,15,15
1668579852714,MATH 285,A00,098055,Fitzsimmons; Patrick J,0,4,15,16
1668579853144,MATH 287B,A00,098056,Arias-Castro; Ery,1,0,15,14
1668579853578,MATH 288,A00,098057,Agarwal; Pooja,9,0,10,1
1668579853578,MATH 288,B00,098058,Zhang; Danna,8,0,10,2
1668579853578,MATH 288,C00,098059,Williams; Ruth J,9,0,10,1
1668579854012,MATH 290B,A00,098060,Roberts; Justin Deritter,12,0,15,3
1668579854445,MATH 292,A00,098061,Belmont; Eva Kinoshita,10,0,10,0
1668579854876,MATH 295,A00,098062,Suk; Andrew Hoon,47,0,50,3
1668579855297,MATH 296,A00,098063,Novak; Jonathan I,20,0,20,0
1668579855723,MATH 297,001,098064,Gamst; Anthony Collins,9997,0,9999,2
1668580358746,COGS 205,A00,101395,Chiba; Andrea,19,0,20,1
1668580359180,COGS 210B,001,101404,Greene; Deanna Jacquelyn,9998,0,9999,1
1668580359180,COGS 210B,002,101417,Xia; Haijun,9999,0,9999,0
1668580359180,COGS 210B,003,101422,Nitz; Douglas A.,9999,0,9999,0
1668580359180,COGS 210B,004,101423,Hollan; James D.,9998,0,9999,1
1668580359180,COGS 210B,005,101424,Deak; Gedeon O.,9998,0,9999,1
1668580359180,COGS 210B,006,101425,Rossano; Federico,9999,0,9999,0
1668580359607,COGS 211B,A00,101427,Coulson; Seana M,9996,0,9999,3
1668580360032,COGS 220,A00,101428,Hollan; James D.,0,17,25,25
1668580360461,COGS 229,A00,101429,Dow; Steven P,17,0,25,8
1668580360887,COGS 230,A00,101430,Klemmer; Scott R,6,0,17,11
1668580361311,COGS 234,A00,101431,Xia; Haijun,0,1,25,25
1668580361747,COGS 260,A00,101432,Kiyonaga; Anastasia,21,0,25,4
1668580361747,COGS 260,B00,101433,Kirsh; David Joel,15,0,25,10
1668580362171,CSE 202,A00,102371,Impagliazzo; Russell,0,70,0,0
1668580362599,CSE 203B,A01,102373,Cheng; Chung Kuan,0,70,0,0
1668580363023,CSE 208,A00,102374,Micciancio; Daniele,0,5,0,0
1668580363455,CSE 209A,A00,112895,Impagliazzo; Russell,0,14,15,15
1668580363879,CSE 209B,A00,108005,Bellare; Mihir,0,7,0,0
1668580364303,CSE 210,A00,113163,Coblenz; Michael J,0,96,0,0
1668580364726,CSE 219,A00,106111,Dow; Steven P,0,8,20,20
1668580365163,CSE 221,A00,102376,Voelker; Geoffrey M.,0,77,0,0
1668580365588,CSE 224,A01,102378,Porter; George M,0,180,0,0
1668580366015,CSE 229A,A00,102379,Savage; Stefan,0,14,0,0
1668580366443,CSE 229C,A00,102380,Munyaka; Imani N. S.,0,12,0,0
1668580366868,CSE 232B,A00,102382,Deutsch; Alin Bernard,0,39,0,0
1668580367304,CSE 234,A01,112904,Kumar; Arun Kumar,0,0,0,0
1668580367729,CSE 237A,A00,102383,Rosing; Tajana Simunic,0,57,0,0
1668580368157,CSE 239A,A00,102384,Deutsch; Alin Bernard,0,18,0,0
1668580368585,CSE 239B,A00,102385,Polikarpova; Nadezhda,0,11,0,0
1668580369016,CSE 240A,A00,102386,Pannuto; Patrick William,0,49,0,0
1668580369449,CSE 240B,A00,102387,Zhao; Jishen,0,51,0,0
1668580369876,CSE 241A,A00,106406,Kang; Mingu,0,9,0,0
1668580370320,CSE 249B,A00,102388,Kahng; Andrew Byun,0,7,8,8
1668580370768,CSE 251B,A01,102392,Cottrell; Garrison W,0,54,0,0
1668580370768,CSE 251B,A02,102393,Cottrell; Garrison W,0,36,0,0
1668580371193,CSE 252B,A00,102394,Ochoa; Benjamin Lawrence,0,64,0,0
1668580371617,CSE 257,A01,102396,Gao; Sicun,0,160,0,0
1668580372049,CSE 272,A00,102397,Li; Tzumao,0,22,0,0
1668580372476,CSE 274,A00,111323,Chern; Albert Ren-Haur,0,16,0,0
1668580372900,CSE 282,A00,102398,Pevzner; Pavel Arkadjevich,0,0,0,0
1668580373326,CSE 284,A00,114175,Gymrek; Melissa Ann,0,33,0,0
1668580373758,CSE 290,A00,102399,Chandraker; Manmohan Krishna,0,11,0,0
1668580373758,CSE 290,B00,102400,Vaccaro; Kristen Marie,0,10,25,25
1668580373758,CSE 290,C00,102414,Pannuto; Patrick William,0,1,25,25
1668580373758,CSE 290,D00,102427,Pevzner; Pavel Arkadjevich,0,0,0,0
1668580373758,CSE 290,E00,102429,Zhao; Jishen,0,6,0,0
1668580373758,CSE 290,F00,102436,Tullsen; Dean Michael,0,6,0,0
1668580373758,CSE 290,G00,102440,Christensen; Henrik I,0,8,20,20
1668580374199,CSE 291,A00,102443,Su; Hao,0,0,0,0
1668580374199,CSE 291,B00,102448,Polikarpova; Nadezhda,0,0,0,0
1668580374199,CSE 291,C00,102453,Vaccaro; Kristen Marie,0,0,0,0
1668580374199,CSE 291,D00,111343,Savage; Stefan,0,0,0,0
1668580374199,CSE 291,E00,116474,Claffy; Kimberly Claire,0,0,0,0
1668580374199,CSE 291,F00,116479,Pasquale; Joseph,0,0,0,0
1668580374625,CSE 293,001,119111,Bafna; Vineet,9999,0,9999,0
1668580374625,CSE 293,002,119118,Bellare; Mihir,9999,0,9999,0
1668580374625,CSE 293,003,119122,Berg-Kirkpatrick; Taylor D,9999,0,9999,0
1668580374625,CSE 293,004,119135,Christensen; Henrik I,9999,0,9999,0
1668580374625,CSE 293,005,119142,Cottrell; Garrison W,9999,0,9999,0
1668580374625,CSE 293,006,119146,Deutsch; Alin Bernard,9999,0,9999,0
1668580374625,CSE 293,007,119159,Esmaeilzadeh; Hadi,9999,0,9999,0
1668580374625,CSE 293,008,119166,Freund; Yoav,9999,0,9999,0
1668580374625,CSE 293,009,119170,Griswold; William G.,9999,0,9999,0
1668580374625,CSE 293,010,119183,Gymrek; Melissa Ann,9999,0,9999,0
1668580374625,CSE 293,011,119190,Heninger; Nadia A,9999,0,9999,0
1668580374625,CSE 293,012,119230,Impagliazzo; Russell,9999,0,9999,0
1668580374625,CSE 293,013,119232,Jhala; Ranjit,9999,0,9999,0
1668580374625,CSE 293,014,119233,Kahng; Andrew Byun,9999,0,9999,0
1668580374625,CSE 293,015,119298,Kane; Daniel Mertz,9999,0,9999,0
1668580374625,CSE 293,016,119299,Kriegman; David J,9999,0,9999,0
1668580374625,CSE 293,017,119300,Kumar; Arun Kumar,9999,0,9999,0
1668580374625,CSE 293,018,119301,Lerner; Sorin,9999,0,9999,0
1668580374625,CSE 293,019,119302,Lovett; Shachar,9999,0,9999,0
1668580374625,CSE 293,020,119303,McAuley; Julian John,9999,0,9999,0
1668580374625,CSE 293,021,119304,Micciancio; Daniele,9999,0,9999,0
1668580374625,CSE 293,022,119367,Orailoglu; Alex,9999,0,9999,0
1668580374625,CSE 293,023,119382,Paturi; Ramamohan,9999,0,9999,0
1668580374625,CSE 293,024,119404,Polikarpova; Nadezhda,9999,0,9999,0
1668580374625,CSE 293,025,119406,Politz; Joseph Gibbs,9999,0,9999,0
1668580374625,CSE 293,026,119411,Porter; George M,9999,0,9999,0
1668580374625,CSE 293,027,119414,Porter; Leonard Emerson,9999,0,9999,0
1668580374625,CSE 293,028,119416,Ramamoorthi; Ravi,9999,0,9999,0
1668580374625,CSE 293,029,119417,Sahoo; Debashis,9999,0,9999,0
1668580374625,CSE 293,030,119420,Saul; Lawrence,9999,0,9999,0
1668580374625,CSE 293,031,119421,Savage; Stefan,9999,0,9999,0
1668580374625,CSE 293,032,119425,Schulze; Jurgen P.,9999,0,9999,0
1668580374625,CSE 293,033,119426,Snoeren; Alex C.,9999,0,9999,0
1668580374625,CSE 293,034,119428,Shang; Jingbo,9999,0,9999,0
1668580374625,CSE 293,035,119430,Stefan; Deian,9999,0,9999,0
1668580374625,CSE 293,036,119431,Su; Hao,9999,0,9999,0
1668580374625,CSE 293,037,119433,Swanson; Steven James,9999,0,9999,0
1668580374625,CSE 293,038,119435,Tullsen; Dean Michael,9999,0,9999,0
1668580374625,CSE 293,039,119483,Voelker; Geoffrey M.,9999,0,9999,0
1668580374625,CSE 293,040,119537,Zhao; Jishen,9999,0,9999,0
1668580374625,CSE 293,041,119538,Zhou; Yuan-Yuan,9999,0,9999,0
1668580374625,CSE 293,042,119539,Gao; Sicun,9999,0,9999,0
1668580374625,CSE 293,043,119540,Weibel; Nadir,9999,0,9999,0
1668580374625,CSE 293,044,119541,Gupta; Rajesh K.,9999,0,9999,0
1668580374625,CSE 293,045,126410,Vaccaro; Kristen Marie,9999,0,9999,0
1668580374625,CSE 293,046,126411,Klemke; Richard,9999,0,9999,0
1668580375052,CSE 294,A00,102459,Voelker; Geoffrey M.,0,2,0,0
1668580375052,CSE 294,B00,111322,Orailoglu; Alex,0,2,0,0
1668580375476,DSE 201,A00,096914,Deutsch; Alin Bernard,30,0,30,0
1668580375902,DSE 210,A00,096915,Dasgupta; Sanjoy,30,0,30,0
1668580376352,DSE 260A,A00,096916,Altintas De Callaf; Ilkay,30,0,30,0
1668580376789,ECE 200,001,103586,Antipa; Nicholas A,9999,0,9999,0
1668580376789,ECE 200,002,103587,Atanasov; Nikolay A.,9999,0,9999,0
1668580376789,ECE 200,003,103588,Bharadia; Dinesh,9999,0,9999,0
1668580376789,ECE 200,004,103589,Cheng; Chung Kuan,9999,0,9999,0
1668580376789,ECE 200,005,103590,Cosman; Pamela C.,9999,0,9999,0
1668580376789,ECE 200,006,103591,Dayeh; Shadi Ahmad,9999,0,9999,0
1668580376789,ECE 200,007,103592,Fainman; Yeshaiahu,9999,0,9999,0
1668580376789,ECE 200,008,103593,Ford; Joseph Earl,9999,0,9999,0
1668580376789,ECE 200,009,103594,Franceschetti; Massimo,9999,0,9999,0
1668580376789,ECE 200,010,103595,Fullerton; Eric E,9999,0,9999,0
1668580376789,ECE 200,011,103596,Galton; Ian A,9999,0,9999,0
1668580376789,ECE 200,012,103597,Gilja; Vikash,9999,0,9999,0
1668580376789,ECE 200,013,103598,Hall; Drew A.,9999,0,9999,0
1668580376789,ECE 200,014,103599,Hsueh; Tzu-Chien,9999,0,9999,0
1668580376789,ECE 200,015,103600,Javidi; Tara,9999,0,9999,0
1668580376789,ECE 200,016,103601,Kahng; Andrew Byun,9999,0,9999,0
1668580376789,ECE 200,017,103602,Kim; Young-Han,9999,0,9999,0
1668580376789,ECE 200,018,103603,Koushanfar; Farinaz,9999,0,9999,0
1668580376789,ECE 200,019,103604,Kuzum; Duygu,9999,0,9999,0
1668580376789,ECE 200,020,103605,Le; Hanh-Phuc,9999,0,9999,0
1668580376789,ECE 200,021,103606,Lin; Bill,9999,0,9999,0
1668580376789,ECE 200,022,103607,Liu; Zhaowei,9998,0,9999,1
1668580376789,ECE 200,023,103608,Lo; Yu-Hwa,9999,0,9999,0
1668580376789,ECE 200,024,103609,Lomakin; Vitaliy,9999,0,9999,0
1668580376789,ECE 200,025,103610,Mercier; Patrick Philip,9999,0,9999,0
1668580376789,ECE 200,026,103611,Meyer; Florian,9999,0,9999,0
1668580376789,ECE 200,027,103612,Milstein; Laurence B.,9999,0,9999,0
1668580376789,ECE 200,028,103613,Mir Arabbaygi; Siavash,9999,0,9999,0
1668580376789,ECE 200,029,103614,Mookherjea; Shayan,9999,0,9999,0
1668580376789,ECE 200,030,103615,Morris; Karcher William,9999,0,9999,0
1668580376789,ECE 200,031,103616,Ng; Tse Nga,9999,0,9999,0
1668580376789,ECE 200,032,103617,Nguyen; Truong Quang,9999,0,9999,0
1668580376789,ECE 200,033,103618,Nomura; Kenji,9999,0,9999,0
1668580376789,ECE 200,034,103619,Orlitsky; Alon,9999,0,9999,0
1668580376789,ECE 200,035,103620,Pal; Piya,9999,0,9999,0
1668580376789,ECE 200,036,103621,Papen; George C.,9999,0,9999,0
1668580376789,ECE 200,037,103622,Radic; Stojan,9999,0,9999,0
1668580376789,ECE 200,038,103623,Rao; Bhaskar D.,9999,0,9999,0
1668580376789,ECE 200,039,103624,Rao; Ramesh R,9999,0,9999,0
1668580376789,ECE 200,040,103625,Rebeiz; Gabriel,9999,0,9999,0
1668580376789,ECE 200,041,103626,Sanford; John R,9999,0,9999,0
1668580376789,ECE 200,042,103627,Siegel; Paul H.,9999,0,9999,0
1668580376789,ECE 200,043,103628,Sievenpiper; Daniel F.,9999,0,9999,0
1668580376789,ECE 200,044,103629,Sworder; David D.,9999,0,9999,0
1668580376789,ECE 200,045,103630,Taur; Yuan,9999,0,9999,0
1668580376789,ECE 200,046,103631,Touri; Behrouz,9999,0,9999,0
1668580376789,ECE 200,047,103632,Trivedi; Mohan M.,9999,0,9999,0
1668580376789,ECE 200,048,103633,Vasconcelos; Nuno,9999,0,9999,0
1668580376789,ECE 200,049,103634,Wang; Xiaolong,9999,0,9999,0
1668580376789,ECE 200,050,103635,Xie; Pengtao,9999,0,9999,0
1668580376789,ECE 200,051,103636,Yip; Michael,9999,0,9999,0
1668580376789,ECE 200,052,103637,Zeger; Kenneth A.,999,0,999,0
1668580376789,ECE 200,053,103638,Zhang; Xinyu,9999,0,9999,0
1668580376789,ECE 200,054,103639,Turakhia; Yatish Girish,9999,0,9999,0
1668580376789,ECE 200,055,103640,Kang; Mingu,9999,0,9999,0
1668580376789,ECE 200,056,103641,Shi; Yuanyuan,9999,0,9999,0
1668580376789,ECE 200,057,103642,Wang; Edward Jay,9999,0,9999,0
1668580376789,ECE 200,058,103643,Zheng; Yang,9999,0,9999,0
1668580377216,ECE 202,A00,103644,Kuzum; Duygu,0,47,0,0
1668580377654,ECE 212BN,A00,103646,Ng; Tse Nga,0,10,0,0
1668580378079,ECE 221,A00,111493,Staff,0,0,0,0
1668580378505,ECE 222B,A00,103647,Lomakin; Vitaliy,0,21,0,0
1668580378928,ECE 230B,A00,103648,Taur; Yuan,0,4,0,0
1668580379352,ECE 238B,A00,103649,Garay; Javier,0,0,0,0
1668580379774,ECE 240B,A00,112900,Fainman; Yeshaiahu,0,8,0,0
1668580380207,ECE 247A,A00,103650,Jokerst; Jesse Vincent,0,6,0,0
1668580380632,ECE 247B,A00,103651,Wang; Joseph,0,14,0,0
1668580381063,ECE 250,A00,103652,Siegel; Paul H.,0,84,0,0
1668580381500,ECE 251A,A00,103654,Rao; Bhaskar D.,0,65,0,0
1668580381932,ECE 257B,A00,103655,Bharadia; Dinesh,0,33,0,0
1668580382363,ECE 258A,A00,103656,Milstein; Laurence B.,0,29,0,0
1668580382787,ECE 260B,A00,103658,Kang; Mingu,0,121,0,0
1668580383209,ECE 264A,A00,103659,Galton; Ian A,0,42,0,34
1668580383638,ECE 265A,A00,103661,Gudem; Prasad S.S.,0,43,0,35
1668580384063,ECE 265D,A00,103662,Gudem; Prasad S.S.,0,27,0,0
1668580384495,ECE 268,A00,103663,Koushanfar; Farinaz,0,44,0,0
1668580384918,ECE 269,A01,103665,Pal; Piya,0,223,0,0
1668580385346,ECE 271B,A00,103666,Vasconcelos; Manuela,0,80,0,0
1668580385785,ECE 276A,A00,103667,Atanasov; Nikolay A.,0,127,0,0
1668580386220,ECE 277,A00,103668,An; Cheolhong,0,151,0,0
1668580386656,ECE 279,A00,117947,Hall; Drew A.,0,22,0,0
1668580387503,ECE 283,A00,103670,Hsueh; Tzu-Chien,0,57,0,0
1668580387927,ECE 284,A00,103671,Turakhia; Yatish Girish,0,40,0,0
1668580388356,ECE 285,A00,103672,Zheng; Yang,0,40,0,0
1668580388356,ECE 285,B00,103673,Sworder; David D.,0,61,0,0
1668580388781,ECE 287,A00,103676,Javidi; Tara,0,7,0,0
1668580389205,MATH 200B,A00,098023,Salehi Golsefidy; Alireza,7,0,15,8
1668580389630,MATH 202B,A00,098024,Rhoades; Brendon Patrick,7,0,15,8
1668580390055,MATH 203B,A00,098025,Oprea; Dragos N.,9,0,15,6
1668580390485,MATH 204B,A00,098026,Sorensen; Claus M,13,0,15,2
1668580390911,MATH 208,A00,098027,Izadi; Elham,7,0,10,3
1668580391332,MATH 209,A00,098028,Pollack; Aaron,10,0,10,0
1668580391760,MATH 211A,A00,112919,Rogalski; Daniel,8,0,10,2
1668580392183,MATH 211B,A00,112920,Seward; Brandon M.,9,0,10,1
1668580392604,MATH 218,A00,098029,Li; Bo,10,0,10,0
1668580393030,MATH 220B,A00,098030,Novak; Jonathan I,10,0,15,5
1668580393459,MATH 221A,A00,098031,Ebenfelt; Peter F,12,0,15,3
1668580393881,MATH 231B,A00,098032,Zlatos; Andrej,9,0,15,6
1668580394307,MATH 240B,A00,098033,Ni; Lei,7,0,15,8
1668580394729,MATH 243,A00,098034,Jekel; David Andrew,10,0,10,0
1668580395151,MATH 245A,A00,098035,Nie; Jiawang,0,7,15,18
1668580395666,MATH 248,A00,098036,Bejenaru; Ioan,10,0,10,0
1668580396100,MATH 250B,A00,098037,Spolaor; Luca,12,0,15,3
1668580396534,MATH 258,A00,098038,Ni; Lei,8,0,10,2
1668580396960,MATH 264B,A00,098041,Rhoades; Brendon Patrick,7,0,15,8
1668580397383,MATH 268,A00,098042,Buss; Samuel R,10,0,10,0
1668580397806,MATH 269,A00,098043,Rhoades; Brendon Patrick,10,0,10,0
1668580398231,MATH 270B,A00,098044,Li; Bo,6,0,15,9
1668580398665,MATH 272B,A00,098045,Holst; Michael J,13,0,15,2
1668580399089,MATH 273A,A00,098046,Tian; Xiaochuan,10,0,15,5
1668580399513,MATH 275,A01,098048,Tian; Xiaochuan,6,0,10,4
1668580399937,MATH 278A,A00,098049,Holst; Michael J,6,0,10,4
1668580400369,MATH 278B,A00,098050,Cloninger; Alexander,10,0,10,0
1668580400791,MATH 278C,A00,098051,Nie; Jiawang,5,0,10,5
1668580401214,MATH 280B,A00,098052,Zheng; Tianyi,6,0,15,9
1668580401643,MATH 281B,A00,098053,Bradic; Jelena,0,2,15,15
1668580402080,MATH 282B,A00,098054,Arias-Castro; Ery,0,1,15,15
1668580402504,MATH 285,A00,098055,Fitzsimmons; Patrick J,0,4,15,16
1668580402930,MATH 287B,A00,098056,Arias-Castro; Ery,1,0,15,14
1668580403356,MATH 288,A00,098057,Agarwal; Pooja,9,0,10,1
1668580403356,MATH 288,B00,098058,Zhang; Danna,8,0,10,2
1668580403356,MATH 288,C00,098059,Williams; Ruth J,9,0,10,1
1668580403780,MATH 290B,A00,098060,Roberts; Justin Deritter,12,0,15,3
1668580404208,MATH 292,A00,098061,Belmont; Eva Kinoshita,10,0,10,0
1668580404630,MATH 295,A00,098062,Suk; Andrew Hoon,47,0,50,3
1668580405060,MATH 296,A00,098063,Novak; Jonathan I,20,0,20,0
1668580405486,MATH 297,001,098064,Gamst; Anthony Collins,9997,0,9999,2
1668580908184,COGS 205,A00,101395,Chiba; Andrea,19,0,20,1
1668580908609,COGS 210B,001,101404,Greene; Deanna Jacquelyn,9998,0,9999,1
1668580908609,COGS 210B,002,101417,Xia; Haijun,9999,0,9999,0
1668580908609,COGS 210B,003,101422,Nitz; Douglas A.,9999,0,9999,0
1668580908609,COGS 210B,004,101423,Hollan; James D.,9998,0,9999,1
1668580908609,COGS 210B,005,101424,Deak; Gedeon O.,9998,0,9999,1
1668580908609,COGS 210B,006,101425,Rossano; Federico,9999,0,9999,0
1668580909035,COGS 211B,A00,101427,Coulson; Seana M,9996,0,9999,3
1668580909459,COGS 220,A00,101428,Hollan; James D.,0,17,25,25
1668580909882,COGS 229,A00,101429,Dow; Steven P,17,0,25,8
1668580910318,COGS 230,A00,101430,Klemmer; Scott R,6,0,17,11
1668580910741,COGS 234,A00,101431,Xia; Haijun,0,1,25,25
1668580911168,COGS 260,A00,101432,Kiyonaga; Anastasia,21,0,25,4
1668580911168,COGS 260,B00,101433,Kirsh; David Joel,15,0,25,10
1668580911596,CSE 202,A00,102371,Impagliazzo; Russell,0,70,0,0
1668580912020,CSE 203B,A01,102373,Cheng; Chung Kuan,0,70,0,0
1668580912449,CSE 208,A00,102374,Micciancio; Daniele,0,5,0,0
1668580912873,CSE 209A,A00,112895,Impagliazzo; Russell,0,14,15,15
1668580913297,CSE 209B,A00,108005,Bellare; Mihir,0,7,0,0
1668580913720,CSE 210,A00,113163,Coblenz; Michael J,0,96,0,0
1668580914145,CSE 219,A00,106111,Dow; Steven P,0,8,20,20
1668580914575,CSE 221,A00,102376,Voelker; Geoffrey M.,0,77,0,0
1668580915005,CSE 224,A01,102378,Porter; George M,0,180,0,0
1668580915429,CSE 229A,A00,102379,Savage; Stefan,0,14,0,0
1668580915854,CSE 229C,A00,102380,Munyaka; Imani N. S.,0,12,0,0
1668580916290,CSE 232B,A00,102382,Deutsch; Alin Bernard,0,39,0,0
1668580916799,CSE 234,A01,112904,Kumar; Arun Kumar,0,0,0,0
1668580917222,CSE 237A,A00,102383,Rosing; Tajana Simunic,0,57,0,0
1668580917647,CSE 239A,A00,102384,Deutsch; Alin Bernard,0,18,0,0
1668580918095,CSE 239B,A00,102385,Polikarpova; Nadezhda,0,11,0,0
1668580918519,CSE 240A,A00,102386,Pannuto; Patrick William,0,49,0,0
1668580918944,CSE 240B,A00,102387,Zhao; Jishen,0,51,0,0
1668580919368,CSE 241A,A00,106406,Kang; Mingu,0,9,0,0
1668580919799,CSE 249B,A00,102388,Kahng; Andrew Byun,0,7,8,8
1668580920232,CSE 251B,A01,102392,Cottrell; Garrison W,0,54,0,0
1668580920232,CSE 251B,A02,102393,Cottrell; Garrison W,0,36,0,0
1668580920663,CSE 252B,A00,102394,Ochoa; Benjamin Lawrence,0,64,0,0
1668580921087,CSE 257,A01,102396,Gao; Sicun,0,160,0,0
1668580921510,CSE 272,A00,102397,Li; Tzumao,0,22,0,0
1668580921938,CSE 274,A00,111323,Chern; Albert Ren-Haur,0,16,0,0
1668580922367,CSE 282,A00,102398,Pevzner; Pavel Arkadjevich,0,0,0,0
1668580922803,CSE 284,A00,114175,Gymrek; Melissa Ann,0,33,0,0
1668580923245,CSE 290,A00,102399,Chandraker; Manmohan Krishna,0,11,0,0
1668580923245,CSE 290,B00,102400,Vaccaro; Kristen Marie,0,10,25,25
1668580923245,CSE 290,C00,102414,Pannuto; Patrick William,0,1,25,25
1668580923245,CSE 290,D00,102427,Pevzner; Pavel Arkadjevich,0,0,0,0
1668580923245,CSE 290,E00,102429,Zhao; Jishen,0,6,0,0
1668580923245,CSE 290,F00,102436,Tullsen; Dean Michael,0,6,0,0
1668580923245,CSE 290,G00,102440,Christensen; Henrik I,0,8,20,20
1668580923668,CSE 291,A00,102443,Su; Hao,0,0,0,0
1668580923668,CSE 291,B00,102448,Polikarpova; Nadezhda,0,0,0,0
1668580923668,CSE 291,C00,102453,Vaccaro; Kristen Marie,0,0,0,0
1668580923668,CSE 291,D00,111343,Savage; Stefan,0,0,0,0
1668580923668,CSE 291,E00,116474,Claffy; Kimberly Claire,0,0,0,0
1668580923668,CSE 291,F00,116479,Pasquale; Joseph,0,0,0,0
1668580924100,CSE 293,001,119111,Bafna; Vineet,9999,0,9999,0
1668580924100,CSE 293,002,119118,Bellare; Mihir,9999,0,9999,0
1668580924100,CSE 293,003,119122,Berg-Kirkpatrick; Taylor D,9999,0,9999,0
1668580924100,CSE 293,004,119135,Christensen; Henrik I,9999,0,9999,0
1668580924100,CSE 293,005,119142,Cottrell; Garrison W,9999,0,9999,0
1668580924100,CSE 293,006,119146,Deutsch; Alin Bernard,9999,0,9999,0
1668580924100,CSE 293,007,119159,Esmaeilzadeh; Hadi,9999,0,9999,0
1668580924100,CSE 293,008,119166,Freund; Yoav,9999,0,9999,0
1668580924100,CSE 293,009,119170,Griswold; William G.,9999,0,9999,0
1668580924100,CSE 293,010,119183,Gymrek; Melissa Ann,9999,0,9999,0
1668580924100,CSE 293,011,119190,Heninger; Nadia A,9999,0,9999,0
1668580924100,CSE 293,012,119230,Impagliazzo; Russell,9999,0,9999,0
1668580924100,CSE 293,013,119232,Jhala; Ranjit,9999,0,9999,0
1668580924100,CSE 293,014,119233,Kahng; Andrew Byun,9999,0,9999,0
1668580924100,CSE 293,015,119298,Kane; Daniel Mertz,9999,0,9999,0
1668580924100,CSE 293,016,119299,Kriegman; David J,9999,0,9999,0
1668580924100,CSE 293,017,119300,Kumar; Arun Kumar,9999,0,9999,0
1668580924100,CSE 293,018,119301,Lerner; Sorin,9999,0,9999,0
1668580924100,CSE 293,019,119302,Lovett; Shachar,9999,0,9999,0
1668580924100,CSE 293,020,119303,McAuley; Julian John,9999,0,9999,0
1668580924100,CSE 293,021,119304,Micciancio; Daniele,9999,0,9999,0
1668580924100,CSE 293,022,119367,Orailoglu; Alex,9999,0,9999,0
1668580924100,CSE 293,023,119382,Paturi; Ramamohan,9999,0,9999,0
1668580924100,CSE 293,024,119404,Polikarpova; Nadezhda,9999,0,9999,0
1668580924100,CSE 293,025,119406,Politz; Joseph Gibbs,9999,0,9999,0
1668580924100,CSE 293,026,119411,Porter; George M,9999,0,9999,0
1668580924100,CSE 293,027,119414,Porter; Leonard Emerson,9999,0,9999,0
1668580924100,CSE 293,028,119416,Ramamoorthi; Ravi,9999,0,9999,0
1668580924100,CSE 293,029,119417,Sahoo; Debashis,9999,0,9999,0
1668580924100,CSE 293,030,119420,Saul; Lawrence,9999,0,9999,0
1668580924100,CSE 293,031,119421,Savage; Stefan,9999,0,9999,0
1668580924100,CSE 293,032,119425,Schulze; Jurgen P.,9999,0,9999,0
1668580924100,CSE 293,033,119426,Snoeren; Alex C.,9999,0,9999,0
1668580924100,CSE 293,034,119428,Shang; Jingbo,9999,0,9999,0
1668580924100,CSE 293,035,119430,Stefan; Deian,9999,0,9999,0
1668580924100,CSE 293,036,119431,Su; Hao,9999,0,9999,0
1668580924100,CSE 293,037,119433,Swanson; Steven James,9999,0,9999,0
1668580924100,CSE 293,038,119435,Tullsen; Dean Michael,9999,0,9999,0
1668580924100,CSE 293,039,119483,Voelker; Geoffrey M.,9999,0,9999,0
1668580924100,CSE 293,040,119537,Zhao; Jishen,9999,0,9999,0
1668580924100,CSE 293,041,119538,Zhou; Yuan-Yuan,9999,0,9999,0
1668580924100,CSE 293,042,119539,Gao; Sicun,9999,0,9999,0
1668580924100,CSE 293,043,119540,Weibel; Nadir,9999,0,9999,0
1668580924100,CSE 293,044,119541,Gupta; Rajesh K.,9999,0,9999,0
1668580924100,CSE 293,045,126410,Vaccaro; Kristen Marie,9999,0,9999,0
1668580924100,CSE 293,046,126411,Klemke; Richard,9999,0,9999,0
1668580924525,CSE 294,A00,102459,Voelker; Geoffrey M.,0,2,0,0
1668580924525,CSE 294,B00,111322,Orailoglu; Alex,0,2,0,0
1668580924960,DSE 201,A00,096914,Deutsch; Alin Bernard,30,0,30,0
1668580925388,DSE 210,A00,096915,Dasgupta; Sanjoy,30,0,30,0
1668580925812,DSE 260A,A00,096916,Altintas De Callaf; Ilkay,30,0,30,0
1668580926243,ECE 200,001,103586,Antipa; Nicholas A,9999,0,9999,0
1668580926243,ECE 200,002,103587,Atanasov; Nikolay A.,9999,0,9999,0
1668580926243,ECE 200,003,103588,Bharadia; Dinesh,9999,0,9999,0
1668580926243,ECE 200,004,103589,Cheng; Chung Kuan,9999,0,9999,0
1668580926243,ECE 200,005,103590,Cosman; Pamela C.,9999,0,9999,0
1668580926243,ECE 200,006,103591,Dayeh; Shadi Ahmad,9999,0,9999,0
1668580926243,ECE 200,007,103592,Fainman; Yeshaiahu,9999,0,9999,0
1668580926243,ECE 200,008,103593,Ford; Joseph Earl,9999,0,9999,0
1668580926243,ECE 200,009,103594,Franceschetti; Massimo,9999,0,9999,0
1668580926243,ECE 200,010,103595,Fullerton; Eric E,9999,0,9999,0
1668580926243,ECE 200,011,103596,Galton; Ian A,9999,0,9999,0
1668580926243,ECE 200,012,103597,Gilja; Vikash,9999,0,9999,0
1668580926243,ECE 200,013,103598,Hall; Drew A.,9999,0,9999,0
1668580926243,ECE 200,014,103599,Hsueh; Tzu-Chien,9999,0,9999,0
1668580926243,ECE 200,015,103600,Javidi; Tara,9999,0,9999,0
1668580926243,ECE 200,016,103601,Kahng; Andrew Byun,9999,0,9999,0
1668580926243,ECE 200,017,103602,Kim; Young-Han,9999,0,9999,0
1668580926243,ECE 200,018,103603,Koushanfar; Farinaz,9999,0,9999,0
1668580926243,ECE 200,019,103604,Kuzum; Duygu,9999,0,9999,0
1668580926243,ECE 200,020,103605,Le; Hanh-Phuc,9999,0,9999,0
1668580926243,ECE 200,021,103606,Lin; Bill,9999,0,9999,0
1668580926243,ECE 200,022,103607,Liu; Zhaowei,9998,0,9999,1
1668580926243,ECE 200,023,103608,Lo; Yu-Hwa,9999,0,9999,0
1668580926243,ECE 200,024,103609,Lomakin; Vitaliy,9999,0,9999,0
1668580926243,ECE 200,025,103610,Mercier; Patrick Philip,9999,0,9999,0
1668580926243,ECE 200,026,103611,Meyer; Florian,9999,0,9999,0
1668580926243,ECE 200,027,103612,Milstein; Laurence B.,9999,0,9999,0
1668580926243,ECE 200,028,103613,Mir Arabbaygi; Siavash,9999,0,9999,0
1668580926243,ECE 200,029,103614,Mookherjea; Shayan,9999,0,9999,0
1668580926243,ECE 200,030,103615,Morris; Karcher William,9999,0,9999,0
1668580926243,ECE 200,031,103616,Ng; Tse Nga,9999,0,9999,0
1668580926243,ECE 200,032,103617,Nguyen; Truong Quang,9999,0,9999,0
1668580926243,ECE 200,033,103618,Nomura; Kenji,9999,0,9999,0
1668580926243,ECE 200,034,103619,Orlitsky; Alon,9999,0,9999,0
1668580926243,ECE 200,035,103620,Pal; Piya,9999,0,9999,0
1668580926243,ECE 200,036,103621,Papen; George C.,9999,0,9999,0
1668580926243,ECE 200,037,103622,Radic; Stojan,9999,0,9999,0
1668580926243,ECE 200,038,103623,Rao; Bhaskar D.,9999,0,9999,0
1668580926243,ECE 200,039,103624,Rao; Ramesh R,9999,0,9999,0
1668580926243,ECE 200,040,103625,Rebeiz; Gabriel,9999,0,9999,0
1668580926243,ECE 200,041,103626,Sanford; John R,9999,0,9999,0
1668580926243,ECE 200,042,103627,Siegel; Paul H.,9999,0,9999,0
1668580926243,ECE 200,043,103628,Sievenpiper; Daniel F.,9999,0,9999,0
1668580926243,ECE 200,044,103629,Sworder; David D.,9999,0,9999,0
1668580926243,ECE 200,045,103630,Taur; Yuan,9999,0,9999,0
1668580926243,ECE 200,046,103631,Touri; Behrouz,9999,0,9999,0
1668580926243,ECE 200,047,103632,Trivedi; Mohan M.,9999,0,9999,0
1668580926243,ECE 200,048,103633,Vasconcelos; Nuno,9999,0,9999,0
1668580926243,ECE 200,049,103634,Wang; Xiaolong,9999,0,9999,0
1668580926243,ECE 200,050,103635,Xie; Pengtao,9999,0,9999,0
1668580926243,ECE 200,051,103636,Yip; Michael,9999,0,9999,0
1668580926243,ECE 200,052,103637,Zeger; Kenneth A.,999,0,999,0
1668580926243,ECE 200,053,103638,Zhang; Xinyu,9999,0,9999,0
1668580926243,ECE 200,054,103639,Turakhia; Yatish Girish,9999,0,9999,0
1668580926243,ECE 200,055,103640,Kang; Mingu,9999,0,9999,0
1668580926243,ECE 200,056,103641,Shi; Yuanyuan,9999,0,9999,0
1668580926243,ECE 200,057,103642,Wang; Edward Jay,9999,0,9999,0
1668580926243,ECE 200,058,103643,Zheng; Yang,9999,0,9999,0
1668580926673,ECE 202,A00,103644,Kuzum; Duygu,0,47,0,0
1668580927095,ECE 212BN,A00,103646,Ng; Tse Nga,0,10,0,0
1668580927519,ECE 221,A00,111493,Staff,0,0,0,0
1668580927949,ECE 222B,A00,103647,Lomakin; Vitaliy,0,22,0,0
1668580928373,ECE 230B,A00,103648,Taur; Yuan,0,4,0,0
1668580928799,ECE 238B,A00,103649,Garay; Javier,0,0,0,0
1668580929224,ECE 240B,A00,112900,Fainman; Yeshaiahu,0,8,0,0
1668580929649,ECE 247A,A00,103650,Jokerst; Jesse Vincent,0,6,0,0
1668580930073,ECE 247B,A00,103651,Wang; Joseph,0,14,0,0
1668580930499,ECE 250,A00,103652,Siegel; Paul H.,0,85,0,0
1668580930927,ECE 251A,A00,103654,Rao; Bhaskar D.,0,65,0,0
1668580931353,ECE 257B,A00,103655,Bharadia; Dinesh,0,33,0,0
1668580931787,ECE 258A,A00,103656,Milstein; Laurence B.,0,29,0,0
1668580932215,ECE 260B,A00,103658,Kang; Mingu,0,121,0,0
1668580932646,ECE 264A,A00,103659,Galton; Ian A,0,42,0,34
1668580933076,ECE 265A,A00,103661,Gudem; Prasad S.S.,0,43,0,35
1668580933503,ECE 265D,A00,103662,Gudem; Prasad S.S.,0,27,0,0
1668580933929,ECE 268,A00,103663,Koushanfar; Farinaz,0,44,0,0
1668580934358,ECE 269,A01,103665,Pal; Piya,0,223,0,0
1668580934783,ECE 271B,A00,103666,Vasconcelos; Manuela,0,80,0,0
1668580935219,ECE 276A,A00,103667,Atanasov; Nikolay A.,0,127,0,0
1668580935652,ECE 277,A00,103668,An; Cheolhong,0,151,0,0
1668580936076,ECE 279,A00,117947,Hall; Drew A.,0,22,0,0
1668580936938,ECE 283,A00,103670,Hsueh; Tzu-Chien,0,57,0,0
1668580937361,ECE 284,A00,103671,Turakhia; Yatish Girish,0,40,0,0
1668580937785,ECE 285,A00,103672,Zheng; Yang,0,40,0,0
1668580937785,ECE 285,B00,103673,Sworder; David D.,0,61,0,0
1668580938208,ECE 287,A00,103676,Javidi; Tara,0,7,0,0
1668580938640,MATH 200B,A00,098023,Salehi Golsefidy; Alireza,7,0,15,8
1668580939067,MATH 202B,A00,098024,Rhoades; Brendon Patrick,7,0,15,8
1668580939492,MATH 203B,A00,098025,Oprea; Dragos N.,9,0,15,6
1668580939920,MATH 204B,A00,098026,Sorensen; Claus M,13,0,15,2
1668580940358,MATH 208,A00,098027,Izadi; Elham,7,0,10,3
1668580940780,MATH 209,A00,098028,Pollack; Aaron,10,0,10,0
1668580941203,MATH 211A,A00,112919,Rogalski; Daniel,8,0,10,2
1668580941628,MATH 211B,A00,112920,Seward; Brandon M.,9,0,10,1
1668580942054,MATH 218,A00,098029,Li; Bo,10,0,10,0
1668580942480,MATH 220B,A00,098030,Novak; Jonathan I,10,0,15,5
1668580942905,MATH 221A,A00,098031,Ebenfelt; Peter F,12,0,15,3
1668580943334,MATH 231B,A00,098032,Zlatos; Andrej,9,0,15,6
1668580943757,MATH 240B,A00,098033,Ni; Lei,7,0,15,8
1668580944180,MATH 243,A00,098034,Jekel; David Andrew,10,0,10,0
1668580944604,MATH 245A,A00,098035,Nie; Jiawang,0,7,15,18
1668580945038,MATH 248,A00,098036,Bejenaru; Ioan,10,0,10,0
1668580945464,MATH 250B,A00,098037,Spolaor; Luca,12,0,15,3
1668580945892,MATH 258,A00,098038,Ni; Lei,8,0,10,2
1668580946319,MATH 264B,A00,098041,Rhoades; Brendon Patrick,7,0,15,8
1668580946741,MATH 268,A00,098042,Buss; Samuel R,10,0,10,0
1668580947168,MATH 269,A00,098043,Rhoades; Brendon Patrick,10,0,10,0
1668580947599,MATH 270B,A00,098044,Li; Bo,6,0,15,9
1668580948023,MATH 272B,A00,098045,Holst; Michael J,13,0,15,2
1668580948452,MATH 273A,A00,098046,Tian; Xiaochuan,10,0,15,5
1668580948876,MATH 275,A01,098048,Tian; Xiaochuan,6,0,10,4
1668580949298,MATH 278A,A00,098049,Holst; Michael J,6,0,10,4
1668580949721,MATH 278B,A00,098050,Cloninger; Alexander,10,0,10,0
1668580950149,MATH 278C,A00,098051,Nie; Jiawang,5,0,10,5
1668580950591,MATH 280B,A00,098052,Zheng; Tianyi,6,0,15,9
1668580951015,MATH 281B,A00,098053,Bradic; Jelena,0,2,15,15
1668580951444,MATH 282B,A00,098054,Arias-Castro; Ery,0,1,15,15
1668580951881,MATH 285,A00,098055,Fitzsimmons; Patrick J,0,4,15,16
1668580952303,MATH 287B,A00,098056,Arias-Castro; Ery,1,0,15,14
1668580952725,MATH 288,A00,098057,Agarwal; Pooja,9,0,10,1
1668580952725,MATH 288,B00,098058,Zhang; Danna,8,0,10,2
1668580952725,MATH 288,C00,098059,Williams; Ruth J,9,0,10,1
1668580953151,MATH 290B,A00,098060,Roberts; Justin Deritter,12,0,15,3
1668580953578,MATH 292,A00,098061,Belmont; Eva Kinoshita,10,0,10,0
1668580954012,MATH 295,A00,098062,Suk; Andrew Hoon,47,0,50,3
1668580954449,MATH 296,A00,098063,Novak; Jonathan I,20,0,20,0
1668580954872,MATH 297,001,098064,Gamst; Anthony Collins,9997,0,9999,2
1668581457634,COGS 205,A00,101395,Chiba; Andrea,19,0,20,1
1668581458058,COGS 210B,001,101404,Greene; Deanna Jacquelyn,9998,0,9999,1
1668581458058,COGS 210B,002,101417,Xia; Haijun,9999,0,9999,0
1668581458058,COGS 210B,003,101422,Nitz; Douglas A.,9999,0,9999,0
1668581458058,COGS 210B,004,101423,Hollan; James D.,9998,0,9999,1
1668581458058,COGS 210B,005,101424,Deak; Gedeon O.,9998,0,9999,1
1668581458058,COGS 210B,006,101425,Rossano; Federico,9999,0,9999,0
1668581458483,COGS 211B,A00,101427,Coulson; Seana M,9996,0,9999,3
1668581458907,COGS 220,A00,101428,Hollan; James D.,0,17,25,25
1668581459330,COGS 229,A00,101429,Dow; Steven P,17,0,25,8
1668581459754,COGS 230,A00,101430,Klemmer; Scott R,6,0,17,11
1668581460188,COGS 234,A00,101431,Xia; Haijun,0,1,25,25
1668581460628,COGS 260,A00,101432,Kiyonaga; Anastasia,21,0,25,4
1668581460628,COGS 260,B00,101433,Kirsh; David Joel,15,0,25,10
1668581461055,CSE 202,A00,102371,Impagliazzo; Russell,0,70,0,0
1668581461486,CSE 203B,A01,102373,Cheng; Chung Kuan,0,70,0,0
1668581461912,CSE 208,A00,102374,Micciancio; Daniele,0,5,0,0
1668581462339,CSE 209A,A00,112895,Impagliazzo; Russell,0,14,15,15
1668581462768,CSE 209B,A00,108005,Bellare; Mihir,0,7,0,0
1668581463205,CSE 210,A00,113163,Coblenz; Michael J,0,96,0,0
1668581463628,CSE 219,A00,106111,Dow; Steven P,0,8,20,20
1668581464054,CSE 221,A00,102376,Voelker; Geoffrey M.,0,77,0,0
1668581464492,CSE 224,A01,102378,Porter; George M,0,180,0,0
1668581464922,CSE 229A,A00,102379,Savage; Stefan,0,14,0,0
1668581465349,CSE 229C,A00,102380,Munyaka; Imani N. S.,0,12,0,0
1668581465770,CSE 232B,A00,102382,Deutsch; Alin Bernard,0,39,0,0
1668581466193,CSE 234,A01,112904,Kumar; Arun Kumar,0,0,0,0
1668581466620,CSE 237A,A00,102383,Rosing; Tajana Simunic,0,57,0,0
1668581467042,CSE 239A,A00,102384,Deutsch; Alin Bernard,0,18,0,0
1668581467466,CSE 239B,A00,102385,Polikarpova; Nadezhda,0,11,0,0
1668581467889,CSE 240A,A00,102386,Pannuto; Patrick William,0,49,0,0
1668581468321,CSE 240B,A00,102387,Zhao; Jishen,0,51,0,0
1668581468743,CSE 241A,A00,106406,Kang; Mingu,0,9,0,0
1668581469166,CSE 249B,A00,102388,Kahng; Andrew Byun,0,7,8,8
1668581469594,CSE 251B,A01,102392,Cottrell; Garrison W,0,54,0,0
1668581469594,CSE 251B,A02,102393,Cottrell; Garrison W,0,36,0,0
1668581470032,CSE 252B,A00,102394,Ochoa; Benjamin Lawrence,0,64,0,0
1668581470478,CSE 257,A01,102396,Gao; Sicun,0,160,0,0
1668581470910,CSE 272,A00,102397,Li; Tzumao,0,22,0,0
1668581471346,CSE 274,A00,111323,Chern; Albert Ren-Haur,0,16,0,0
1668581471771,CSE 282,A00,102398,Pevzner; Pavel Arkadjevich,0,0,0,0
1668581472201,CSE 284,A00,114175,Gymrek; Melissa Ann,0,33,0,0
1668581472626,CSE 290,A00,102399,Chandraker; Manmohan Krishna,0,11,0,0
1668581472626,CSE 290,B00,102400,Vaccaro; Kristen Marie,0,10,25,25
1668581472626,CSE 290,C00,102414,Pannuto; Patrick William,0,1,25,25
1668581472626,CSE 290,D00,102427,Pevzner; Pavel Arkadjevich,0,0,0,0
1668581472626,CSE 290,E00,102429,Zhao; Jishen,0,6,0,0
1668581472626,CSE 290,F00,102436,Tullsen; Dean Michael,0,6,0,0
1668581472626,CSE 290,G00,102440,Christensen; Henrik I,0,8,20,20
1668581473054,CSE 291,A00,102443,Su; Hao,0,0,0,0
1668581473054,CSE 291,B00,102448,Polikarpova; Nadezhda,0,0,0,0
1668581473054,CSE 291,C00,102453,Vaccaro; Kristen Marie,0,0,0,0
1668581473054,CSE 291,D00,111343,Savage; Stefan,0,0,0,0
1668581473054,CSE 291,E00,116474,Claffy; Kimberly Claire,0,0,0,0
1668581473054,CSE 291,F00,116479,Pasquale; Joseph,0,0,0,0
1668581473508,CSE 293,001,119111,Bafna; Vineet,9999,0,9999,0
1668581473508,CSE 293,002,119118,Bellare; Mihir,9999,0,9999,0
1668581473508,CSE 293,003,119122,Berg-Kirkpatrick; Taylor D,9999,0,9999,0
1668581473508,CSE 293,004,119135,Christensen; Henrik I,9999,0,9999,0
1668581473508,CSE 293,005,119142,Cottrell; Garrison W,9999,0,9999,0
1668581473508,CSE 293,006,119146,Deutsch; Alin Bernard,9999,0,9999,0
1668581473508,CSE 293,007,119159,Esmaeilzadeh; Hadi,9999,0,9999,0
1668581473508,CSE 293,008,119166,Freund; Yoav,9999,0,9999,0
1668581473508,CSE 293,009,119170,Griswold; William G.,9999,0,9999,0
1668581473508,CSE 293,010,119183,Gymrek; Melissa Ann,9999,0,9999,0
1668581473508,CSE 293,011,119190,Heninger; Nadia A,9999,0,9999,0
1668581473508,CSE 293,012,119230,Impagliazzo; Russell,9999,0,9999,0
1668581473508,CSE 293,013,119232,Jhala; Ranjit,9999,0,9999,0
1668581473508,CSE 293,014,119233,Kahng; Andrew Byun,9999,0,9999,0
1668581473508,CSE 293,015,119298,Kane; Daniel Mertz,9999,0,9999,0
1668581473508,CSE 293,016,119299,Kriegman; David J,9999,0,9999,0
1668581473508,CSE 293,017,119300,Kumar; Arun Kumar,9999,0,9999,0
1668581473508,CSE 293,018,119301,Lerner; Sorin,9999,0,9999,0
1668581473508,CSE 293,019,119302,Lovett; Shachar,9999,0,9999,0
1668581473508,CSE 293,020,119303,McAuley; Julian John,9999,0,9999,0
1668581473508,CSE 293,021,119304,Micciancio; Daniele,9999,0,9999,0
1668581473508,CSE 293,022,119367,Orailoglu; Alex,9999,0,9999,0
1668581473508,CSE 293,023,119382,Paturi; Ramamohan,9999,0,9999,0
1668581473508,CSE 293,024,119404,Polikarpova; Nadezhda,9999,0,9999,0
1668581473508,CSE 293,025,119406,Politz; Joseph Gibbs,9999,0,9999,0
1668581473508,CSE 293,026,119411,Porter; George M,9999,0,9999,0
1668581473508,CSE 293,027,119414,Porter; Leonard Emerson,9999,0,9999,0
1668581473508,CSE 293,028,119416,Ramamoorthi; Ravi,9999,0,9999,0
1668581473508,CSE 293,029,119417,Sahoo; Debashis,9999,0,9999,0
1668581473508,CSE 293,030,119420,Saul; Lawrence,9999,0,9999,0
1668581473508,CSE 293,031,119421,Savage; Stefan,9999,0,9999,0
1668581473508,CSE 293,032,119425,Schulze; Jurgen P.,9999,0,9999,0
1668581473508,CSE 293,033,119426,Snoeren; Alex C.,9999,0,9999,0
1668581473508,CSE 293,034,119428,Shang; Jingbo,9999,0,9999,0
1668581473508,CSE 293,035,119430,Stefan; Deian,9999,0,9999,0
1668581473508,CSE 293,036,119431,Su; Hao,9999,0,9999,0
1668581473508,CSE 293,037,119433,Swanson; Steven James,9999,0,9999,0
1668581473508,CSE 293,038,119435,Tullsen; Dean Michael,9999,0,9999,0
1668581473508,CSE 293,039,119483,Voelker; Geoffrey M.,9999,0,9999,0
1668581473508,CSE 293,040,119537,Zhao; Jishen,9999,0,9999,0
1668581473508,CSE 293,041,119538,Zhou; Yuan-Yuan,9999,0,9999,0
1668581473508,CSE 293,042,119539,Gao; Sicun,9999,0,9999,0
1668581473508,CSE 293,043,119540,Weibel; Nadir,9999,0,9999,0
1668581473508,CSE 293,044,119541,Gupta; Rajesh K.,9999,0,9999,0
1668581473508,CSE 293,045,126410,Vaccaro; Kristen Marie,9999,0,9999,0
1668581473508,CSE 293,046,126411,Klemke; Richard,9999,0,9999,0
1668581473957,CSE 294,A00,102459,Voelker; Geoffrey M.,0,2,0,0
1668581473957,CSE 294,B00,111322,Orailoglu; Alex,0,2,0,0
1668581474382,DSE 201,A00,096914,Deutsch; Alin Bernard,30,0,30,0
1668581474806,DSE 210,A00,096915,Dasgupta; Sanjoy,30,0,30,0
1668581475232,DSE 260A,A00,096916,Altintas De Callaf; Ilkay,30,0,30,0
1668581475661,ECE 200,001,103586,Antipa; Nicholas A,9999,0,9999,0
1668581475661,ECE 200,002,103587,Atanasov; Nikolay A.,9999,0,9999,0
1668581475661,ECE 200,003,103588,Bharadia; Dinesh,9999,0,9999,0
1668581475661,ECE 200,004,103589,Cheng; Chung Kuan,9999,0,9999,0
1668581475661,ECE 200,005,103590,Cosman; Pamela C.,9999,0,9999,0
1668581475661,ECE 200,006,103591,Dayeh; Shadi Ahmad,9999,0,9999,0
1668581475661,ECE 200,007,103592,Fainman; Yeshaiahu,9999,0,9999,0
1668581475661,ECE 200,008,103593,Ford; Joseph Earl,9999,0,9999,0
1668581475661,ECE 200,009,103594,Franceschetti; Massimo,9999,0,9999,0
1668581475661,ECE 200,010,103595,Fullerton; Eric E,9999,0,9999,0
1668581475661,ECE 200,011,103596,Galton; Ian A,9999,0,9999,0
1668581475661,ECE 200,012,103597,Gilja; Vikash,9999,0,9999,0
1668581475661,ECE 200,013,103598,Hall; Drew A.,9999,0,9999,0
1668581475661,ECE 200,014,103599,Hsueh; Tzu-Chien,9999,0,9999,0
1668581475661,ECE 200,015,103600,Javidi; Tara,9999,0,9999,0
1668581475661,ECE 200,016,103601,Kahng; Andrew Byun,9999,0,9999,0
1668581475661,ECE 200,017,103602,Kim; Young-Han,9999,0,9999,0
1668581475661,ECE 200,018,103603,Koushanfar; Farinaz,9999,0,9999,0
1668581475661,ECE 200,019,103604,Kuzum; Duygu,9999,0,9999,0
1668581475661,ECE 200,020,103605,Le; Hanh-Phuc,9999,0,9999,0
1668581475661,ECE 200,021,103606,Lin; Bill,9999,0,9999,0
1668581475661,ECE 200,022,103607,Liu; Zhaowei,9998,0,9999,1
1668581475661,ECE 200,023,103608,Lo; Yu-Hwa,9999,0,9999,0
1668581475661,ECE 200,024,103609,Lomakin; Vitaliy,9999,0,9999,0
1668581475661,ECE 200,025,103610,Mercier; Patrick Philip,9999,0,9999,0
1668581475661,ECE 200,026,103611,Meyer; Florian,9999,0,9999,0
1668581475661,ECE 200,027,103612,Milstein; Laurence B.,9999,0,9999,0
1668581475661,ECE 200,028,103613,Mir Arabbaygi; Siavash,9999,0,9999,0
1668581475661,ECE 200,029,103614,Mookherjea; Shayan,9999,0,9999,0
1668581475661,ECE 200,030,103615,Morris; Karcher William,9999,0,9999,0
1668581475661,ECE 200,031,103616,Ng; Tse Nga,9999,0,9999,0
1668581475661,ECE 200,032,103617,Nguyen; Truong Quang,9999,0,9999,0
1668581475661,ECE 200,033,103618,Nomura; Kenji,9999,0,9999,0
1668581475661,ECE 200,034,103619,Orlitsky; Alon,9999,0,9999,0
1668581475661,ECE 200,035,103620,Pal; Piya,9999,0,9999,0
1668581475661,ECE 200,036,103621,Papen; George C.,9999,0,9999,0
1668581475661,ECE 200,037,103622,Radic; Stojan,9999,0,9999,0
1668581475661,ECE 200,038,103623,Rao; Bhaskar D.,9999,0,9999,0
1668581475661,ECE 200,039,103624,Rao; Ramesh R,9999,0,9999,0
1668581475661,ECE 200,040,103625,Rebeiz; Gabriel,9999,0,9999,0
1668581475661,ECE 200,041,103626,Sanford; John R,9999,0,9999,0
1668581475661,ECE 200,042,103627,Siegel; Paul H.,9999,0,9999,0
1668581475661,ECE 200,043,103628,Sievenpiper; Daniel F.,9999,0,9999,0
1668581475661,ECE 200,044,103629,Sworder; David D.,9999,0,9999,0
1668581475661,ECE 200,045,103630,Taur; Yuan,9999,0,9999,0
1668581475661,ECE 200,046,103631,Touri; Behrouz,9999,0,9999,0
1668581475661,ECE 200,047,103632,Trivedi; Mohan M.,9999,0,9999,0
1668581475661,ECE 200,048,103633,Vasconcelos; Nuno,9999,0,9999,0
1668581475661,ECE 200,049,103634,Wang; Xiaolong,9999,0,9999,0
1668581475661,ECE 200,050,103635,Xie; Pengtao,9999,0,9999,0
1668581475661,ECE 200,051,103636,Yip; Michael,9999,0,9999,0
1668581475661,ECE 200,052,103637,Zeger; Kenneth A.,999,0,999,0
1668581475661,ECE 200,053,103638,Zhang; Xinyu,9999,0,9999,0
1668581475661,ECE 200,054,103639,Turakhia; Yatish Girish,9999,0,9999,0
1668581475661,ECE 200,055,103640,Kang; Mingu,9999,0,9999,0
1668581475661,ECE 200,056,103641,Shi; Yuanyuan,9999,0,9999,0
1668581475661,ECE 200,057,103642,Wang; Edward Jay,9999,0,9999,0
1668581475661,ECE 200,058,103643,Zheng; Yang,9999,0,9999,0
1668581476085,ECE 202,A00,103644,Kuzum; Duygu,0,47,0,0
1668581476511,ECE 212BN,A00,103646,Ng; Tse Nga,0,10,0,0
1668581476942,ECE 221,A00,111493,Staff,0,0,0,0
1668581477364,ECE 222B,A00,103647,Lomakin; Vitaliy,0,22,0,0
1668581477786,ECE 230B,A00,103648,Taur; Yuan,0,4,0,0
1668581478219,ECE 238B,A00,103649,Garay; Javier,0,0,0,0
1668581478647,ECE 240B,A00,112900,Fainman; Yeshaiahu,0,8,0,0
1668581479075,ECE 247A,A00,103650,Jokerst; Jesse Vincent,0,6,0,0
1668581479497,ECE 247B,A00,103651,Wang; Joseph,0,14,0,0
1668581479925,ECE 250,A00,103652,Siegel; Paul H.,0,85,0,0
1668581480347,ECE 251A,A00,103654,Rao; Bhaskar D.,0,65,0,0
1668581480773,ECE 257B,A00,103655,Bharadia; Dinesh,0,33,0,0
1668581481285,ECE 258A,A00,103656,Milstein; Laurence B.,0,29,0,0
1668581481707,ECE 260B,A00,103658,Kang; Mingu,0,121,0,0
1668581482138,ECE 264A,A00,103659,Galton; Ian A,0,42,0,34
1668581482560,ECE 265A,A00,103661,Gudem; Prasad S.S.,0,43,0,35
1668581482986,ECE 265D,A00,103662,Gudem; Prasad S.S.,0,27,0,0
1668581483419,ECE 268,A00,103663,Koushanfar; Farinaz,0,44,0,0
1668581483850,ECE 269,A01,103665,Pal; Piya,0,223,0,0
1668581484279,ECE 271B,A00,103666,Vasconcelos; Manuela,0,80,0,0
1668581484702,ECE 276A,A00,103667,Atanasov; Nikolay A.,0,127,0,0
1668581485124,ECE 277,A00,103668,An; Cheolhong,0,151,0,0
1668581485556,ECE 279,A00,117947,Hall; Drew A.,0,22,0,0
1668581486404,ECE 283,A00,103670,Hsueh; Tzu-Chien,0,57,0,0
1668581486848,ECE 284,A00,103671,Turakhia; Yatish Girish,0,40,0,0
1668581487271,ECE 285,A00,103672,Zheng; Yang,0,40,0,0
1668581487271,ECE 285,B00,103673,Sworder; David D.,0,61,0,0
1668581487697,ECE 287,A00,103676,Javidi; Tara,0,7,0,0
1668581488124,MATH 200B,A00,098023,Salehi Golsefidy; Alireza,7,0,15,8
1668581488547,MATH 202B,A00,098024,Rhoades; Brendon Patrick,7,0,15,8
1668581488974,MATH 203B,A00,098025,Oprea; Dragos N.,9,0,15,6
1668581489398,MATH 204B,A00,098026,Sorensen; Claus M,13,0,15,2
1668581489823,MATH 208,A00,098027,Izadi; Elham,7,0,10,3
1668581490247,MATH 209,A00,098028,Pollack; Aaron,10,0,10,0
1668581490676,MATH 211A,A00,112919,Rogalski; Daniel,8,0,10,2
1668581491099,MATH 211B,A00,112920,Seward; Brandon M.,9,0,10,1
1668581491521,MATH 218,A00,098029,Li; Bo,10,0,10,0
1668581491950,MATH 220B,A00,098030,Novak; Jonathan I,10,0,15,5
1668581492372,MATH 221A,A00,098031,Ebenfelt; Peter F,12,0,15,3
1668581492794,MATH 231B,A00,098032,Zlatos; Andrej,9,0,15,6
1668581493221,MATH 240B,A00,098033,Ni; Lei,7,0,15,8
1668581493646,MATH 243,A00,098034,Jekel; David Andrew,10,0,10,0
1668581494069,MATH 245A,A00,098035,Nie; Jiawang,0,7,15,18
1668581494497,MATH 248,A00,098036,Bejenaru; Ioan,10,0,10,0
1668581494922,MATH 250B,A00,098037,Spolaor; Luca,12,0,15,3
1668581495346,MATH 258,A00,098038,Ni; Lei,8,0,10,2
1668581495771,MATH 264B,A00,098041,Rhoades; Brendon Patrick,7,0,15,8
1668581496198,MATH 268,A00,098042,Buss; Samuel R,10,0,10,0
1668581496620,MATH 269,A00,098043,Rhoades; Brendon Patrick,10,0,10,0
1668581497050,MATH 270B,A00,098044,Li; Bo,6,0,15,9
1668581497477,MATH 272B,A00,098045,Holst; Michael J,13,0,15,2
1668581497901,MATH 273A,A00,098046,Tian; Xiaochuan,10,0,15,5
1668581498354,MATH 275,A01,098048,Tian; Xiaochuan,6,0,10,4
1668581498779,MATH 278A,A00,098049,Holst; Michael J,6,0,10,4
1668581499209,MATH 278B,A00,098050,Cloninger; Alexander,10,0,10,0
1668581499634,MATH 278C,A00,098051,Nie; Jiawang,5,0,10,5
1668581500056,MATH 280B,A00,098052,Zheng; Tianyi,6,0,15,9
1668581500486,MATH 281B,A00,098053,Bradic; Jelena,0,2,15,15
1668581500911,MATH 282B,A00,098054,Arias-Castro; Ery,0,1,15,15
1668581501333,MATH 285,A00,098055,Fitzsimmons; Patrick J,0,4,15,16
1668581501758,MATH 287B,A00,098056,Arias-Castro; Ery,1,0,15,14
1668581502182,MATH 288,A00,098057,Agarwal; Pooja,9,0,10,1
1668581502182,MATH 288,B00,098058,Zhang; Danna,8,0,10,2
1668581502182,MATH 288,C00,098059,Williams; Ruth J,9,0,10,1
1668581502606,MATH 290B,A00,098060,Roberts; Justin Deritter,12,0,15,3
1668581503036,MATH 292,A00,098061,Belmont; Eva Kinoshita,10,0,10,0
1668581503472,MATH 295,A00,098062,Suk; Andrew Hoon,47,0,50,3
1668581503896,MATH 296,A00,098063,Novak; Jonathan I,20,0,20,0
1668581504327,MATH 297,001,098064,Gamst; Anthony Collins,9997,0,9999,2
1668582007805,COGS 205,A00,101395,Chiba; Andrea,19,0,20,1
1668582008233,COGS 210B,001,101404,Greene; Deanna Jacquelyn,9998,0,9999,1
1668582008233,COGS 210B,002,101417,Xia; Haijun,9999,0,9999,0
1668582008233,COGS 210B,003,101422,Nitz; Douglas A.,9999,0,9999,0
1668582008233,COGS 210B,004,101423,Hollan; James D.,9998,0,9999,1
1668582008233,COGS 210B,005,101424,Deak; Gedeon O.,9998,0,9999,1
1668582008233,COGS 210B,006,101425,Rossano; Federico,9999,0,9999,0
1668582008660,COGS 211B,A00,101427,Coulson; Seana M,9996,0,9999,3
1668582009085,COGS 220,A00,101428,Hollan; James D.,0,17,25,25
1668582009509,COGS 229,A00,101429,Dow; Steven P,17,0,25,8
1668582009936,COGS 230,A00,101430,Klemmer; Scott R,6,0,17,11
1668582010361,COGS 234,A00,101431,Xia; Haijun,0,1,25,25
1668582010785,COGS 260,A00,101432,Kiyonaga; Anastasia,21,0,25,4
1668582010785,COGS 260,B00,101433,Kirsh; David Joel,15,0,25,10
1668582011212,CSE 202,A00,102371,Impagliazzo; Russell,0,70,0,0
1668582011635,CSE 203B,A01,102373,Cheng; Chung Kuan,0,70,0,0
1668582012062,CSE 208,A00,102374,Micciancio; Daniele,0,5,0,0
1668582012496,CSE 209A,A00,112895,Impagliazzo; Russell,0,14,15,15
1668582012921,CSE 209B,A00,108005,Bellare; Mihir,0,7,0,0
1668582013348,CSE 210,A00,113163,Coblenz; Michael J,0,96,0,0
1668582013775,CSE 219,A00,106111,Dow; Steven P,0,8,20,20
1668582014199,CSE 221,A00,102376,Voelker; Geoffrey M.,0,77,0,0
1668582014629,CSE 224,A01,102378,Porter; George M,0,180,0,0
1668582015056,CSE 229A,A00,102379,Savage; Stefan,0,14,0,0
1668582015489,CSE 229C,A00,102380,Munyaka; Imani N. S.,0,12,0,0
1668582015913,CSE 232B,A00,102382,Deutsch; Alin Bernard,0,39,0,0
1668582016336,CSE 234,A01,112904,Kumar; Arun Kumar,0,0,0,0
1668582016762,CSE 237A,A00,102383,Rosing; Tajana Simunic,0,57,0,0
1668582017187,CSE 239A,A00,102384,Deutsch; Alin Bernard,0,18,0,0
1668582017614,CSE 239B,A00,102385,Polikarpova; Nadezhda,0,11,0,0
1668582018048,CSE 240A,A00,102386,Pannuto; Patrick William,0,49,0,0
1668582018475,CSE 240B,A00,102387,Zhao; Jishen,0,51,0,0
1668582018905,CSE 241A,A00,106406,Kang; Mingu,0,9,0,0
1668582019330,CSE 249B,A00,102388,Kahng; Andrew Byun,0,7,8,8
1668582019766,CSE 251B,A01,102392,Cottrell; Garrison W,0,54,0,0
1668582019766,CSE 251B,A02,102393,Cottrell; Garrison W,0,36,0,0
1668582020192,CSE 252B,A00,102394,Ochoa; Benjamin Lawrence,0,64,0,0
1668582020625,CSE 257,A01,102396,Gao; Sicun,0,160,0,0
1668582021052,CSE 272,A00,102397,Li; Tzumao,0,22,0,0
1668582021475,CSE 274,A00,111323,Chern; Albert Ren-Haur,0,16,0,0
1668582021898,CSE 282,A00,102398,Pevzner; Pavel Arkadjevich,0,0,0,0
1668582022323,CSE 284,A00,114175,Gymrek; Melissa Ann,0,33,0,0
1668582022768,CSE 290,A00,102399,Chandraker; Manmohan Krishna,0,11,0,0
1668582022768,CSE 290,B00,102400,Vaccaro; Kristen Marie,0,10,25,25
1668582022768,CSE 290,C00,102414,Pannuto; Patrick William,0,1,25,25
1668582022768,CSE 290,D00,102427,Pevzner; Pavel Arkadjevich,0,0,0,0
1668582022768,CSE 290,E00,102429,Zhao; Jishen,0,6,0,0
1668582022768,CSE 290,F00,102436,Tullsen; Dean Michael,0,6,0,0
1668582022768,CSE 290,G00,102440,Christensen; Henrik I,0,8,20,20
1668582023191,CSE 291,A00,102443,Su; Hao,0,0,0,0
1668582023191,CSE 291,B00,102448,Polikarpova; Nadezhda,0,0,0,0
1668582023191,CSE 291,C00,102453,Vaccaro; Kristen Marie,0,0,0,0
1668582023191,CSE 291,D00,111343,Savage; Stefan,0,0,0,0
1668582023191,CSE 291,E00,116474,Claffy; Kimberly Claire,0,0,0,0
1668582023191,CSE 291,F00,116479,Pasquale; Joseph,0,0,0,0
1668582023632,CSE 293,001,119111,Bafna; Vineet,9999,0,9999,0
1668582023632,CSE 293,002,119118,Bellare; Mihir,9999,0,9999,0
1668582023632,CSE 293,003,119122,Berg-Kirkpatrick; Taylor D,9999,0,9999,0
1668582023632,CSE 293,004,119135,Christensen; Henrik I,9999,0,9999,0
1668582023632,CSE 293,005,119142,Cottrell; Garrison W,9999,0,9999,0
1668582023632,CSE 293,006,119146,Deutsch; Alin Bernard,9999,0,9999,0
1668582023632,CSE 293,007,119159,Esmaeilzadeh; Hadi,9999,0,9999,0
1668582023632,CSE 293,008,119166,Freund; Yoav,9999,0,9999,0
1668582023632,CSE 293,009,119170,Griswold; William G.,9999,0,9999,0
1668582023632,CSE 293,010,119183,Gymrek; Melissa Ann,9999,0,9999,0
1668582023632,CSE 293,011,119190,Heninger; Nadia A,9999,0,9999,0
1668582023632,CSE 293,012,119230,Impagliazzo; Russell,9999,0,9999,0
1668582023632,CSE 293,013,119232,Jhala; Ranjit,9999,0,9999,0
1668582023632,CSE 293,014,119233,Kahng; Andrew Byun,9999,0,9999,0
1668582023632,CSE 293,015,119298,Kane; Daniel Mertz,9999,0,9999,0
1668582023632,CSE 293,016,119299,Kriegman; David J,9999,0,9999,0
1668582023632,CSE 293,017,119300,Kumar; Arun Kumar,9999,0,9999,0
1668582023632,CSE 293,018,119301,Lerner; Sorin,9999,0,9999,0
1668582023632,CSE 293,019,119302,Lovett; Shachar,9999,0,9999,0
1668582023632,CSE 293,020,119303,McAuley; Julian John,9999,0,9999,0
1668582023632,CSE 293,021,119304,Micciancio; Daniele,9999,0,9999,0
1668582023632,CSE 293,022,119367,Orailoglu; Alex,9999,0,9999,0
1668582023632,CSE 293,023,119382,Paturi; Ramamohan,9999,0,9999,0
1668582023632,CSE 293,024,119404,Polikarpova; Nadezhda,9999,0,9999,0
1668582023632,CSE 293,025,119406,Politz; Joseph Gibbs,9999,0,9999,0
1668582023632,CSE 293,026,119411,Porter; George M,9999,0,9999,0
1668582023632,CSE 293,027,119414,Porter; Leonard Emerson,9999,0,9999,0
1668582023632,CSE 293,028,119416,Ramamoorthi; Ravi,9999,0,9999,0
1668582023632,CSE 293,029,119417,Sahoo; Debashis,9999,0,9999,0
1668582023632,CSE 293,030,119420,Saul; Lawrence,9999,0,9999,0
1668582023632,CSE 293,031,119421,Savage; Stefan,9999,0,9999,0
1668582023632,CSE 293,032,119425,Schulze; Jurgen P.,9999,0,9999,0
1668582023632,CSE 293,033,119426,Snoeren; Alex C.,9999,0,9999,0
1668582023632,CSE 293,034,119428,Shang; Jingbo,9999,0,9999,0
1668582023632,CSE 293,035,119430,Stefan; Deian,9999,0,9999,0
1668582023632,CSE 293,036,119431,Su; Hao,9999,0,9999,0
1668582023632,CSE 293,037,119433,Swanson; Steven James,9999,0,9999,0
1668582023632,CSE 293,038,119435,Tullsen; Dean Michael,9999,0,9999,0
1668582023632,CSE 293,039,119483,Voelker; Geoffrey M.,9999,0,9999,0
1668582023632,CSE 293,040,119537,Zhao; Jishen,9999,0,9999,0
1668582023632,CSE 293,041,119538,Zhou; Yuan-Yuan,9999,0,9999,0
1668582023632,CSE 293,042,119539,Gao; Sicun,9999,0,9999,0
1668582023632,CSE 293,043,119540,Weibel; Nadir,9999,0,9999,0
1668582023632,CSE 293,044,119541,Gupta; Rajesh K.,9999,0,9999,0
1668582023632,CSE 293,045,126410,Vaccaro; Kristen Marie,9999,0,9999,0
1668582023632,CSE 293,046,126411,Klemke; Richard,9999,0,9999,0
1668582024065,CSE 294,A00,102459,Voelker; Geoffrey M.,0,2,0,0
1668582024065,CSE 294,B00,111322,Orailoglu; Alex,0,2,0,0
1668582024489,DSE 201,A00,096914,Deutsch; Alin Bernard,30,0,30,0
1668582024915,DSE 210,A00,096915,Dasgupta; Sanjoy,30,0,30,0
1668582025339,DSE 260A,A00,096916,Altintas De Callaf; Ilkay,30,0,30,0
1668582025773,ECE 200,001,103586,Antipa; Nicholas A,9999,0,9999,0
1668582025773,ECE 200,002,103587,Atanasov; Nikolay A.,9999,0,9999,0
1668582025773,ECE 200,003,103588,Bharadia; Dinesh,9999,0,9999,0
1668582025773,ECE 200,004,103589,Cheng; Chung Kuan,9999,0,9999,0
1668582025773,ECE 200,005,103590,Cosman; Pamela C.,9999,0,9999,0
1668582025773,ECE 200,006,103591,Dayeh; Shadi Ahmad,9999,0,9999,0
1668582025773,ECE 200,007,103592,Fainman; Yeshaiahu,9999,0,9999,0
1668582025773,ECE 200,008,103593,Ford; Joseph Earl,9999,0,9999,0
1668582025773,ECE 200,009,103594,Franceschetti; Massimo,9999,0,9999,0
1668582025773,ECE 200,010,103595,Fullerton; Eric E,9999,0,9999,0
1668582025773,ECE 200,011,103596,Galton; Ian A,9999,0,9999,0
1668582025773,ECE 200,012,103597,Gilja; Vikash,9999,0,9999,0
1668582025773,ECE 200,013,103598,Hall; Drew A.,9999,0,9999,0
1668582025773,ECE 200,014,103599,Hsueh; Tzu-Chien,9999,0,9999,0
1668582025773,ECE 200,015,103600,Javidi; Tara,9999,0,9999,0
1668582025773,ECE 200,016,103601,Kahng; Andrew Byun,9999,0,9999,0
1668582025773,ECE 200,017,103602,Kim; Young-Han,9999,0,9999,0
1668582025773,ECE 200,018,103603,Koushanfar; Farinaz,9999,0,9999,0
1668582025773,ECE 200,019,103604,Kuzum; Duygu,9999,0,9999,0
1668582025773,ECE 200,020,103605,Le; Hanh-Phuc,9999,0,9999,0
1668582025773,ECE 200,021,103606,Lin; Bill,9999,0,9999,0
1668582025773,ECE 200,022,103607,Liu; Zhaowei,9998,0,9999,1
1668582025773,ECE 200,023,103608,Lo; Yu-Hwa,9999,0,9999,0
1668582025773,ECE 200,024,103609,Lomakin; Vitaliy,9999,0,9999,0
1668582025773,ECE 200,025,103610,Mercier; Patrick Philip,9999,0,9999,0
1668582025773,ECE 200,026,103611,Meyer; Florian,9999,0,9999,0
1668582025773,ECE 200,027,103612,Milstein; Laurence B.,9999,0,9999,0
1668582025773,ECE 200,028,103613,Mir Arabbaygi; Siavash,9999,0,9999,0
1668582025773,ECE 200,029,103614,Mookherjea; Shayan,9999,0,9999,0
1668582025773,ECE 200,030,103615,Morris; Karcher William,9999,0,9999,0
1668582025773,ECE 200,031,103616,Ng; Tse Nga,9999,0,9999,0
1668582025773,ECE 200,032,103617,Nguyen; Truong Quang,9999,0,9999,0
1668582025773,ECE 200,033,103618,Nomura; Kenji,9999,0,9999,0
1668582025773,ECE 200,034,103619,Orlitsky; Alon,9999,0,9999,0
1668582025773,ECE 200,035,103620,Pal; Piya,9999,0,9999,0
1668582025773,ECE 200,036,103621,Papen; George C.,9999,0,9999,0
1668582025773,ECE 200,037,103622,Radic; Stojan,9999,0,9999,0
1668582025773,ECE 200,038,103623,Rao; Bhaskar D.,9999,0,9999,0
1668582025773,ECE 200,039,103624,Rao; Ramesh R,9999,0,9999,0
1668582025773,ECE 200,040,103625,Rebeiz; Gabriel,9999,0,9999,0
1668582025773,ECE 200,041,103626,Sanford; John R,9999,0,9999,0
1668582025773,ECE 200,042,103627,Siegel; Paul H.,9999,0,9999,0
1668582025773,ECE 200,043,103628,Sievenpiper; Daniel F.,9999,0,9999,0
1668582025773,ECE 200,044,103629,Sworder; David D.,9999,0,9999,0
1668582025773,ECE 200,045,103630,Taur; Yuan,9999,0,9999,0
1668582025773,ECE 200,046,103631,Touri; Behrouz,9999,0,9999,0
1668582025773,ECE 200,047,103632,Trivedi; Mohan M.,9999,0,9999,0
1668582025773,ECE 200,048,103633,Vasconcelos; Nuno,9999,0,9999,0
1668582025773,ECE 200,049,103634,Wang; Xiaolong,9999,0,9999,0
1668582025773,ECE 200,050,103635,Xie; Pengtao,9999,0,9999,0
1668582025773,ECE 200,051,103636,Yip; Michael,9999,0,9999,0
1668582025773,ECE 200,052,103637,Zeger; Kenneth A.,999,0,999,0
1668582025773,ECE 200,053,103638,Zhang; Xinyu,9999,0,9999,0
1668582025773,ECE 200,054,103639,Turakhia; Yatish Girish,9999,0,9999,0
1668582025773,ECE 200,055,103640,Kang; Mingu,9999,0,9999,0
1668582025773,ECE 200,056,103641,Shi; Yuanyuan,9999,0,9999,0
1668582025773,ECE 200,057,103642,Wang; Edward Jay,9999,0,9999,0
1668582025773,ECE 200,058,103643,Zheng; Yang,9999,0,9999,0
1668582026197,ECE 202,A00,103644,Kuzum; Duygu,0,47,0,0
1668582026624,ECE 212BN,A00,103646,Ng; Tse Nga,0,10,0,0
1668582027050,ECE 221,A00,111493,Staff,0,0,0,0
1668582027476,ECE 222B,A00,103647,Lomakin; Vitaliy,0,22,0,0
1668582027911,ECE 230B,A00,103648,Taur; Yuan,0,4,0,0
1668582028335,ECE 238B,A00,103649,Garay; Javier,0,0,0,0
1668582028783,ECE 240B,A00,112900,Fainman; Yeshaiahu,0,8,0,0
1668582029218,ECE 247A,A00,103650,Jokerst; Jesse Vincent,0,6,0,0
1668582029649,ECE 247B,A00,103651,Wang; Joseph,0,14,0,0
1668582030076,ECE 250,A00,103652,Siegel; Paul H.,0,85,0,0
1668582030538,ECE 251A,A00,103654,Rao; Bhaskar D.,0,65,0,0
1668582030961,ECE 257B,A00,103655,Bharadia; Dinesh,0,33,0,0
1668582031388,ECE 258A,A00,103656,Milstein; Laurence B.,0,29,0,0
1668582031812,ECE 260B,A00,103658,Kang; Mingu,0,121,0,0
1668582032245,ECE 264A,A00,103659,Galton; Ian A,0,42,0,34
1668582032671,ECE 265A,A00,103661,Gudem; Prasad S.S.,0,43,0,35
1668582033109,ECE 265D,A00,103662,Gudem; Prasad S.S.,0,27,0,0
1668582033549,ECE 268,A00,103663,Koushanfar; Farinaz,0,44,0,0
1668582033974,ECE 269,A01,103665,Pal; Piya,0,223,0,0
1668582034397,ECE 271B,A00,103666,Vasconcelos; Manuela,0,80,0,0
1668582034822,ECE 276A,A00,103667,Atanasov; Nikolay A.,0,127,0,0
1668582035247,ECE 277,A00,103668,An; Cheolhong,0,151,0,0
1668582035679,ECE 279,A00,117947,Hall; Drew A.,0,22,0,0
1668582036529,ECE 283,A00,103670,Hsueh; Tzu-Chien,0,57,0,0
1668582036955,ECE 284,A00,103671,Turakhia; Yatish Girish,0,40,0,0
1668582037383,ECE 285,A00,103672,Zheng; Yang,0,40,0,0
1668582037383,ECE 285,B00,103673,Sworder; David D.,0,61,0,0
1668582037808,ECE 287,A00,103676,Javidi; Tara,0,7,0,0
1668582038235,MATH 200B,A00,098023,Salehi Golsefidy; Alireza,7,0,15,8
1668582038662,MATH 202B,A00,098024,Rhoades; Brendon Patrick,7,0,15,8
1668582039087,MATH 203B,A00,098025,Oprea; Dragos N.,9,0,15,6
1668582039513,MATH 204B,A00,098026,Sorensen; Claus M,13,0,15,2
1668582039941,MATH 208,A00,098027,Izadi; Elham,7,0,10,3
1668582040367,MATH 209,A00,098028,Pollack; Aaron,10,0,10,0
1668582040807,MATH 211A,A00,112919,Rogalski; Daniel,8,0,10,2
1668582041274,MATH 211B,A00,112920,Seward; Brandon M.,9,0,10,1
1668582041705,MATH 218,A00,098029,Li; Bo,10,0,10,0
1668582042127,MATH 220B,A00,098030,Novak; Jonathan I,10,0,15,5
1668582042565,MATH 221A,A00,098031,Ebenfelt; Peter F,12,0,15,3
1668582042989,MATH 231B,A00,098032,Zlatos; Andrej,9,0,15,6
1668582043411,MATH 240B,A00,098033,Ni; Lei,7,0,15,8
1668582043835,MATH 243,A00,098034,Jekel; David Andrew,10,0,10,0
1668582044259,MATH 245A,A00,098035,Nie; Jiawang,0,7,15,18
1668582044681,MATH 248,A00,098036,Bejenaru; Ioan,10,0,10,0
1668582045115,MATH 250B,A00,098037,Spolaor; Luca,12,0,15,3
1668582045538,MATH 258,A00,098038,Ni; Lei,8,0,10,2
1668582045968,MATH 264B,A00,098041,Rhoades; Brendon Patrick,7,0,15,8
1668582046492,MATH 268,A00,098042,Buss; Samuel R,10,0,10,0
1668582046916,MATH 269,A00,098043,Rhoades; Brendon Patrick,10,0,10,0
1668582047339,MATH 270B,A00,098044,Li; Bo,6,0,15,9
1668582047772,MATH 272B,A00,098045,Holst; Michael J,13,0,15,2
1668582048203,MATH 273A,A00,098046,Tian; Xiaochuan,10,0,15,5
1668582048627,MATH 275,A01,098048,Tian; Xiaochuan,6,0,10,4
1668582049057,MATH 278A,A00,098049,Holst; Michael J,6,0,10,4
1668582049480,MATH 278B,A00,098050,Cloninger; Alexander,10,0,10,0
1668582049906,MATH 278C,A00,098051,Nie; Jiawang,5,0,10,5
1668582050336,MATH 280B,A00,098052,Zheng; Tianyi,6,0,15,9
1668582050759,MATH 281B,A00,098053,Bradic; Jelena,0,2,15,15
1668582051181,MATH 282B,A00,098054,Arias-Castro; Ery,0,1,15,15
1668582051605,MATH 285,A00,098055,Fitzsimmons; Patrick J,0,4,15,16
1668582052028,MATH 287B,A00,098056,Arias-Castro; Ery,1,0,15,14
1668582052451,MATH 288,A00,098057,Agarwal; Pooja,9,0,10,1
1668582052451,MATH 288,B00,098058,Zhang; Danna,8,0,10,2
1668582052451,MATH 288,C00,098059,Williams; Ruth J,9,0,10,1
1668582052878,MATH 290B,A00,098060,Roberts; Justin Deritter,12,0,15,3
1668582053301,MATH 292,A00,098061,Belmont; Eva Kinoshita,10,0,10,0
1668582053725,MATH 295,A00,098062,Suk; Andrew Hoon,47,0,50,3
1668582054152,MATH 296,A00,098063,Novak; Jonathan I,20,0,20,0
1668582054577,MATH 297,001,098064,Gamst; Anthony Collins,9997,0,9999,2
1668582567744,COGS 205,A00,101395,Chiba; Andrea,19,0,20,1
1668582568168,COGS 210B,001,101404,Greene; Deanna Jacquelyn,9998,0,9999,1
1668582568168,COGS 210B,002,101417,Xia; Haijun,9999,0,9999,0
1668582568168,COGS 210B,003,101422,Nitz; Douglas A.,9999,0,9999,0
1668582568168,COGS 210B,004,101423,Hollan; James D.,9998,0,9999,1
1668582568168,COGS 210B,005,101424,Deak; Gedeon O.,9998,0,9999,1
1668582568168,COGS 210B,006,101425,Rossano; Federico,9999,0,9999,0
1668582568591,COGS 211B,A00,101427,Coulson; Seana M,9996,0,9999,3
1668582569016,COGS 220,A00,101428,Hollan; James D.,0,17,25,25
1668582569441,COGS 229,A00,101429,Dow; Steven P,17,0,25,8
1668582569864,COGS 230,A00,101430,Klemmer; Scott R,6,0,17,11
1668582570309,COGS 234,A00,101431,Xia; Haijun,0,1,25,25
1668582570744,COGS 260,A00,101432,Kiyonaga; Anastasia,21,0,25,4
1668582570744,COGS 260,B00,101433,Kirsh; David Joel,15,0,25,10
1668582571171,CSE 202,A00,102371,Impagliazzo; Russell,0,70,0,0
1668582571608,CSE 203B,A01,102373,Cheng; Chung Kuan,0,70,0,0
1668582572032,CSE 208,A00,102374,Micciancio; Daniele,0,5,0,0
1668582572455,CSE 209A,A00,112895,Impagliazzo; Russell,0,14,15,15
1668582572878,CSE 209B,A00,108005,Bellare; Mihir,0,7,0,0
1668582573301,CSE 210,A00,113163,Coblenz; Michael J,0,96,0,0
1668582573727,CSE 219,A00,106111,Dow; Steven P,0,8,20,20
1668582574164,CSE 221,A00,102376,Voelker; Geoffrey M.,0,77,0,0
1668582574589,CSE 224,A01,102378,Porter; George M,0,180,0,0
1668582575016,CSE 229A,A00,102379,Savage; Stefan,0,14,0,0
1668582575441,CSE 229C,A00,102380,Munyaka; Imani N. S.,0,12,0,0
1668582575862,CSE 232B,A00,102382,Deutsch; Alin Bernard,0,39,0,0
1668582576286,CSE 234,A01,112904,Kumar; Arun Kumar,0,0,0,0
1668582576709,CSE 237A,A00,102383,Rosing; Tajana Simunic,0,57,0,0
1668582577154,CSE 239A,A00,102384,Deutsch; Alin Bernard,0,18,0,0
1668582577579,CSE 239B,A00,102385,Polikarpova; Nadezhda,0,11,0,0
1668582578113,CSE 240A,A00,102386,Pannuto; Patrick William,0,49,0,0
1668582578551,CSE 240B,A00,102387,Zhao; Jishen,0,51,0,0
1668582578993,CSE 241A,A00,106406,Kang; Mingu,0,9,0,0
1668582579416,CSE 249B,A00,102388,Kahng; Andrew Byun,0,7,8,8
1668582579839,CSE 251B,A01,102392,Cottrell; Garrison W,0,54,0,0
1668582579839,CSE 251B,A02,102393,Cottrell; Garrison W,0,36,0,0
1668582580266,CSE 252B,A00,102394,Ochoa; Benjamin Lawrence,0,64,0,0
1668582580691,CSE 257,A01,102396,Gao; Sicun,0,160,0,0
1668582581114,CSE 272,A00,102397,Li; Tzumao,0,22,0,0
1668582581539,CSE 274,A00,111323,Chern; Albert Ren-Haur,0,16,0,0
1668582581961,CSE 282,A00,102398,Pevzner; Pavel Arkadjevich,0,0,0,0
1668582582386,CSE 284,A00,114175,Gymrek; Melissa Ann,0,33,0,0
1668582582814,CSE 290,A00,102399,Chandraker; Manmohan Krishna,0,11,0,0
1668582582814,CSE 290,B00,102400,Vaccaro; Kristen Marie,0,10,25,25
1668582582814,CSE 290,C00,102414,Pannuto; Patrick William,0,1,25,25
1668582582814,CSE 290,D00,102427,Pevzner; Pavel Arkadjevich,0,0,0,0
1668582582814,CSE 290,E00,102429,Zhao; Jishen,0,6,0,0
1668582582814,CSE 290,F00,102436,Tullsen; Dean Michael,0,6,0,0
1668582582814,CSE 290,G00,102440,Christensen; Henrik I,0,8,20,20
1668582583244,CSE 291,A00,102443,Su; Hao,0,0,0,0
1668582583244,CSE 291,B00,102448,Polikarpova; Nadezhda,0,0,0,0
1668582583244,CSE 291,C00,102453,Vaccaro; Kristen Marie,0,0,0,0
1668582583244,CSE 291,D00,111343,Savage; Stefan,0,0,0,0
1668582583244,CSE 291,E00,116474,Claffy; Kimberly Claire,0,0,0,0
1668582583244,CSE 291,F00,116479,Pasquale; Joseph,0,0,0,0
1668582583673,CSE 293,001,119111,Bafna; Vineet,9999,0,9999,0
1668582583673,CSE 293,002,119118,Bellare; Mihir,9999,0,9999,0
1668582583673,CSE 293,003,119122,Berg-Kirkpatrick; Taylor D,9999,0,9999,0
1668582583673,CSE 293,004,119135,Christensen; Henrik I,9999,0,9999,0
1668582583673,CSE 293,005,119142,Cottrell; Garrison W,9999,0,9999,0
1668582583673,CSE 293,006,119146,Deutsch; Alin Bernard,9999,0,9999,0
1668582583673,CSE 293,007,119159,Esmaeilzadeh; Hadi,9999,0,9999,0
1668582583673,CSE 293,008,119166,Freund; Yoav,9999,0,9999,0
1668582583673,CSE 293,009,119170,Griswold; William G.,9999,0,9999,0
1668582583673,CSE 293,010,119183,Gymrek; Melissa Ann,9999,0,9999,0
1668582583673,CSE 293,011,119190,Heninger; Nadia A,9999,0,9999,0
1668582583673,CSE 293,012,119230,Impagliazzo; Russell,9999,0,9999,0
1668582583673,CSE 293,013,119232,Jhala; Ranjit,9999,0,9999,0
1668582583673,CSE 293,014,119233,Kahng; Andrew Byun,9999,0,9999,0
1668582583673,CSE 293,015,119298,Kane; Daniel Mertz,9999,0,9999,0
1668582583673,CSE 293,016,119299,Kriegman; David J,9999,0,9999,0
1668582583673,CSE 293,017,119300,Kumar; Arun Kumar,9999,0,9999,0
1668582583673,CSE 293,018,119301,Lerner; Sorin,9999,0,9999,0
1668582583673,CSE 293,019,119302,Lovett; Shachar,9999,0,9999,0
1668582583673,CSE 293,020,119303,McAuley; Julian John,9999,0,9999,0
1668582583673,CSE 293,021,119304,Micciancio; Daniele,9999,0,9999,0
1668582583673,CSE 293,022,119367,Orailoglu; Alex,9999,0,9999,0
1668582583673,CSE 293,023,119382,Paturi; Ramamohan,9999,0,9999,0
1668582583673,CSE 293,024,119404,Polikarpova; Nadezhda,9999,0,9999,0
1668582583673,CSE 293,025,119406,Politz; Joseph Gibbs,9999,0,9999,0
1668582583673,CSE 293,026,119411,Porter; George M,9999,0,9999,0
1668582583673,CSE 293,027,119414,Porter; Leonard Emerson,9999,0,9999,0
1668582583673,CSE 293,028,119416,Ramamoorthi; Ravi,9999,0,9999,0
1668582583673,CSE 293,029,119417,Sahoo; Debashis,9999,0,9999,0
1668582583673,CSE 293,030,119420,Saul; Lawrence,9999,0,9999,0
1668582583673,CSE 293,031,119421,Savage; Stefan,9999,0,9999,0
1668582583673,CSE 293,032,119425,Schulze; Jurgen P.,9999,0,9999,0
1668582583673,CSE 293,033,119426,Snoeren; Alex C.,9999,0,9999,0
1668582583673,CSE 293,034,119428,Shang; Jingbo,9999,0,9999,0
1668582583673,CSE 293,035,119430,Stefan; Deian,9999,0,9999,0
1668582583673,CSE 293,036,119431,Su; Hao,9999,0,9999,0
1668582583673,CSE 293,037,119433,Swanson; Steven James,9999,0,9999,0
1668582583673,CSE 293,038,119435,Tullsen; Dean Michael,9999,0,9999,0
1668582583673,CSE 293,039,119483,Voelker; Geoffrey M.,9999,0,9999,0
1668582583673,CSE 293,040,119537,Zhao; Jishen,9999,0,9999,0
1668582583673,CSE 293,041,119538,Zhou; Yuan-Yuan,9999,0,9999,0
1668582583673,CSE 293,042,119539,Gao; Sicun,9999,0,9999,0
1668582583673,CSE 293,043,119540,Weibel; Nadir,9999,0,9999,0
1668582583673,CSE 293,044,119541,Gupta; Rajesh K.,9999,0,9999,0
1668582583673,CSE 293,045,126410,Vaccaro; Kristen Marie,9999,0,9999,0
1668582583673,CSE 293,046,126411,Klemke; Richard,9999,0,9999,0
1668582584108,CSE 294,A00,102459,Voelker; Geoffrey M.,0,2,0,0
1668582584108,CSE 294,B00,111322,Orailoglu; Alex,0,2,0,0
1668582584535,DSE 201,A00,096914,Deutsch; Alin Bernard,30,0,30,0
1668582584976,DSE 210,A00,096915,Dasgupta; Sanjoy,30,0,30,0
1668582585413,DSE 260A,A00,096916,Altintas De Callaf; Ilkay,30,0,30,0
1668582585844,ECE 200,001,103586,Antipa; Nicholas A,9999,0,9999,0
1668582585844,ECE 200,002,103587,Atanasov; Nikolay A.,9999,0,9999,0
1668582585844,ECE 200,003,103588,Bharadia; Dinesh,9999,0,9999,0
1668582585844,ECE 200,004,103589,Cheng; Chung Kuan,9999,0,9999,0
1668582585844,ECE 200,005,103590,Cosman; Pamela C.,9999,0,9999,0
1668582585844,ECE 200,006,103591,Dayeh; Shadi Ahmad,9999,0,9999,0
1668582585844,ECE 200,007,103592,Fainman; Yeshaiahu,9999,0,9999,0
1668582585844,ECE 200,008,103593,Ford; Joseph Earl,9999,0,9999,0
1668582585844,ECE 200,009,103594,Franceschetti; Massimo,9999,0,9999,0
1668582585844,ECE 200,010,103595,Fullerton; Eric E,9999,0,9999,0
1668582585844,ECE 200,011,103596,Galton; Ian A,9999,0,9999,0
1668582585844,ECE 200,012,103597,Gilja; Vikash,9999,0,9999,0
1668582585844,ECE 200,013,103598,Hall; Drew A.,9999,0,9999,0
1668582585844,ECE 200,014,103599,Hsueh; Tzu-Chien,9999,0,9999,0
1668582585844,ECE 200,015,103600,Javidi; Tara,9999,0,9999,0
1668582585844,ECE 200,016,103601,Kahng; Andrew Byun,9999,0,9999,0
1668582585844,ECE 200,017,103602,Kim; Young-Han,9999,0,9999,0
1668582585844,ECE 200,018,103603,Koushanfar; Farinaz,9999,0,9999,0
1668582585844,ECE 200,019,103604,Kuzum; Duygu,9999,0,9999,0
1668582585844,ECE 200,020,103605,Le; Hanh-Phuc,9999,0,9999,0
1668582585844,ECE 200,021,103606,Lin; Bill,9999,0,9999,0
1668582585844,ECE 200,022,103607,Liu; Zhaowei,9998,0,9999,1
1668582585844,ECE 200,023,103608,Lo; Yu-Hwa,9999,0,9999,0
1668582585844,ECE 200,024,103609,Lomakin; Vitaliy,9999,0,9999,0
1668582585844,ECE 200,025,103610,Mercier; Patrick Philip,9999,0,9999,0
1668582585844,ECE 200,026,103611,Meyer; Florian,9999,0,9999,0
1668582585844,ECE 200,027,103612,Milstein; Laurence B.,9999,0,9999,0
1668582585844,ECE 200,028,103613,Mir Arabbaygi; Siavash,9999,0,9999,0
1668582585844,ECE 200,029,103614,Mookherjea; Shayan,9999,0,9999,0
1668582585844,ECE 200,030,103615,Morris; Karcher William,9999,0,9999,0
1668582585844,ECE 200,031,103616,Ng; Tse Nga,9999,0,9999,0
1668582585844,ECE 200,032,103617,Nguyen; Truong Quang,9999,0,9999,0
1668582585844,ECE 200,033,103618,Nomura; Kenji,9999,0,9999,0
1668582585844,ECE 200,034,103619,Orlitsky; Alon,9999,0,9999,0
1668582585844,ECE 200,035,103620,Pal; Piya,9999,0,9999,0
1668582585844,ECE 200,036,103621,Papen; George C.,9999,0,9999,0
1668582585844,ECE 200,037,103622,Radic; Stojan,9999,0,9999,0
1668582585844,ECE 200,038,103623,Rao; Bhaskar D.,9999,0,9999,0
1668582585844,ECE 200,039,103624,Rao; Ramesh R,9999,0,9999,0
1668582585844,ECE 200,040,103625,Rebeiz; Gabriel,9999,0,9999,0
1668582585844,ECE 200,041,103626,Sanford; John R,9999,0,9999,0
1668582585844,ECE 200,042,103627,Siegel; Paul H.,9999,0,9999,0
1668582585844,ECE 200,043,103628,Sievenpiper; Daniel F.,9999,0,9999,0
1668582585844,ECE 200,044,103629,Sworder; David D.,9999,0,9999,0
1668582585844,ECE 200,045,103630,Taur; Yuan,9999,0,9999,0
1668582585844,ECE 200,046,103631,Touri; Behrouz,9999,0,9999,0
1668582585844,ECE 200,047,103632,Trivedi; Mohan M.,9999,0,9999,0
1668582585844,ECE 200,048,103633,Vasconcelos; Nuno,9999,0,9999,0
1668582585844,ECE 200,049,103634,Wang; Xiaolong,9999,0,9999,0
1668582585844,ECE 200,050,103635,Xie; Pengtao,9999,0,9999,0
1668582585844,ECE 200,051,103636,Yip; Michael,9999,0,9999,0
1668582585844,ECE 200,052,103637,Zeger; Kenneth A.,999,0,999,0
1668582585844,ECE 200,053,103638,Zhang; Xinyu,9999,0,9999,0
1668582585844,ECE 200,054,103639,Turakhia; Yatish Girish,9999,0,9999,0
1668582585844,ECE 200,055,103640,Kang; Mingu,9999,0,9999,0
1668582585844,ECE 200,056,103641,Shi; Yuanyuan,9999,0,9999,0
1668582585844,ECE 200,057,103642,Wang; Edward Jay,9999,0,9999,0
1668582585844,ECE 200,058,103643,Zheng; Yang,9999,0,9999,0
1668582586268,ECE 202,A00,103644,Kuzum; Duygu,0,47,0,0
1668582586695,ECE 212BN,A00,103646,Ng; Tse Nga,0,10,0,0
1668582587119,ECE 221,A00,111493,Staff,0,0,0,0
1668582587549,ECE 222B,A00,103647,Lomakin; Vitaliy,0,22,0,0
1668582587974,ECE 230B,A00,103648,Taur; Yuan,0,4,0,0
1668582588397,ECE 238B,A00,103649,Garay; Javier,0,0,0,0
1668582588827,ECE 240B,A00,112900,Fainman; Yeshaiahu,0,8,0,0
1668582589257,ECE 247A,A00,103650,Jokerst; Jesse Vincent,0,6,0,0
1668582589694,ECE 247B,A00,103651,Wang; Joseph,0,14,0,0
1668582590117,ECE 250,A00,103652,Siegel; Paul H.,0,85,0,0
1668582590541,ECE 251A,A00,103654,Rao; Bhaskar D.,0,65,0,0
1668582590965,ECE 257B,A00,103655,Bharadia; Dinesh,0,33,0,0
1668582591394,ECE 258A,A00,103656,Milstein; Laurence B.,0,29,0,0
1668582591817,ECE 260B,A00,103658,Kang; Mingu,0,121,0,0
1668582592246,ECE 264A,A00,103659,Galton; Ian A,0,42,0,34
1668582592669,ECE 265A,A00,103661,Gudem; Prasad S.S.,0,43,0,35
1668582593095,ECE 265D,A00,103662,Gudem; Prasad S.S.,0,27,0,0
1668582593519,ECE 268,A00,103663,Koushanfar; Farinaz,0,44,0,0
1668582593942,ECE 269,A01,103665,Pal; Piya,0,223,0,0
1668582594364,ECE 271B,A00,103666,Vasconcelos; Manuela,0,80,0,0
1668582594791,ECE 276A,A00,103667,Atanasov; Nikolay A.,0,127,0,0
1668582595216,ECE 277,A00,103668,An; Cheolhong,0,151,0,0
1668582595639,ECE 279,A00,117947,Hall; Drew A.,0,22,0,0
1668582596491,ECE 283,A00,103670,Hsueh; Tzu-Chien,0,57,0,0
1668582596915,ECE 284,A00,103671,Turakhia; Yatish Girish,0,40,0,0
1668582597348,ECE 285,A00,103672,Zheng; Yang,0,40,0,0
1668582597348,ECE 285,B00,103673,Sworder; David D.,0,61,0,0
1668582597776,ECE 287,A00,103676,Javidi; Tara,0,7,0,0
1668582598202,MATH 200B,A00,098023,Salehi Golsefidy; Alireza,7,0,15,8
1668582598628,MATH 202B,A00,098024,Rhoades; Brendon Patrick,7,0,15,8
1668582599051,MATH 203B,A00,098025,Oprea; Dragos N.,9,0,15,6
1668582599474,MATH 204B,A00,098026,Sorensen; Claus M,13,0,15,2
1668582599895,MATH 208,A00,098027,Izadi; Elham,7,0,10,3
1668582600324,MATH 209,A00,098028,Pollack; Aaron,10,0,10,0
1668582600748,MATH 211A,A00,112919,Rogalski; Daniel,8,0,10,2
1668582601184,MATH 211B,A00,112920,Seward; Brandon M.,9,0,10,1
1668582601611,MATH 218,A00,098029,Li; Bo,10,0,10,0
1668582602037,MATH 220B,A00,098030,Novak; Jonathan I,10,0,15,5
1668582602475,MATH 221A,A00,098031,Ebenfelt; Peter F,12,0,15,3
1668582602904,MATH 231B,A00,098032,Zlatos; Andrej,9,0,15,6
1668582603331,MATH 240B,A00,098033,Ni; Lei,7,0,15,8
1668582603753,MATH 243,A00,098034,Jekel; David Andrew,10,0,10,0
1668582604179,MATH 245A,A00,098035,Nie; Jiawang,0,7,15,18
1668582604615,MATH 248,A00,098036,Bejenaru; Ioan,10,0,10,0
1668582605050,MATH 250B,A00,098037,Spolaor; Luca,12,0,15,3
1668582605486,MATH 258,A00,098038,Ni; Lei,8,0,10,2
1668582605925,MATH 264B,A00,098041,Rhoades; Brendon Patrick,7,0,15,8
1668582606361,MATH 268,A00,098042,Buss; Samuel R,10,0,10,0
1668582606787,MATH 269,A00,098043,Rhoades; Brendon Patrick,10,0,10,0
1668582607212,MATH 270B,A00,098044,Li; Bo,6,0,15,9
1668582607644,MATH 272B,A00,098045,Holst; Michael J,13,0,15,2
1668582608082,MATH 273A,A00,098046,Tian; Xiaochuan,10,0,15,5
1668582608521,MATH 275,A01,098048,Tian; Xiaochuan,6,0,10,4
1668582608948,MATH 278A,A00,098049,Holst; Michael J,6,0,10,4
1668582609373,MATH 278B,A00,098050,Cloninger; Alexander,10,0,10,0
1668582609794,MATH 278C,A00,098051,Nie; Jiawang,5,0,10,5
1668582610223,MATH 280B,A00,098052,Zheng; Tianyi,6,0,15,9
1668582610648,MATH 281B,A00,098053,Bradic; Jelena,0,2,15,15
1668582611075,MATH 282B,A00,098054,Arias-Castro; Ery,0,1,15,15
1668582611506,MATH 285,A00,098055,Fitzsimmons; Patrick J,0,4,15,16
1668582611936,MATH 287B,A00,098056,Arias-Castro; Ery,1,0,15,14
1668582612361,MATH 288,A00,098057,Agarwal; Pooja,9,0,10,1
1668582612361,MATH 288,B00,098058,Zhang; Danna,8,0,10,2
1668582612361,MATH 288,C00,098059,Williams; Ruth J,9,0,10,1
1668582612792,MATH 290B,A00,098060,Roberts; Justin Deritter,12,0,15,3
1668582613215,MATH 292,A00,098061,Belmont; Eva Kinoshita,10,0,10,0
1668582613639,MATH 295,A00,098062,Suk; Andrew Hoon,47,0,50,3
1668582614078,MATH 296,A00,098063,Novak; Jonathan I,20,0,20,0
1668582614503,MATH 297,001,098064,Gamst; Anthony Collins,9997,0,9999,2
1668583116955,COGS 205,A00,101395,Chiba; Andrea,19,0,20,1
1668583117377,COGS 210B,001,101404,Greene; Deanna Jacquelyn,9998,0,9999,1
1668583117377,COGS 210B,002,101417,Xia; Haijun,9999,0,9999,0
1668583117377,COGS 210B,003,101422,Nitz; Douglas A.,9999,0,9999,0
1668583117377,COGS 210B,004,101423,Hollan; James D.,9998,0,9999,1
1668583117377,COGS 210B,005,101424,Deak; Gedeon O.,9998,0,9999,1
1668583117377,COGS 210B,006,101425,Rossano; Federico,9999,0,9999,0
1668583117810,COGS 211B,A00,101427,Coulson; Seana M,9996,0,9999,3
1668583118238,COGS 220,A00,101428,Hollan; James D.,0,17,25,25
1668583118660,COGS 229,A00,101429,Dow; Steven P,17,0,25,8
1668583119083,COGS 230,A00,101430,Klemmer; Scott R,6,0,17,11
1668583119512,COGS 234,A00,101431,Xia; Haijun,0,1,25,25
1668583119939,COGS 260,A00,101432,Kiyonaga; Anastasia,21,0,25,4
1668583119939,COGS 260,B00,101433,Kirsh; David Joel,15,0,25,10
1668583120362,CSE 202,A00,102371,Impagliazzo; Russell,0,70,0,0
1668583120798,CSE 203B,A01,102373,Cheng; Chung Kuan,0,70,0,0
1668583121229,CSE 208,A00,102374,Micciancio; Daniele,0,5,0,0
1668583121654,CSE 209A,A00,112895,Impagliazzo; Russell,0,14,15,15
1668583122082,CSE 209B,A00,108005,Bellare; Mihir,0,7,0,0
1668583122506,CSE 210,A00,113163,Coblenz; Michael J,0,96,0,0
1668583122930,CSE 219,A00,106111,Dow; Steven P,0,8,20,20
1668583123352,CSE 221,A00,102376,Voelker; Geoffrey M.,0,77,0,0
1668583123776,CSE 224,A01,102378,Porter; George M,0,180,0,0
1668583124205,CSE 229A,A00,102379,Savage; Stefan,0,14,0,0
1668583124630,CSE 229C,A00,102380,Munyaka; Imani N. S.,0,12,0,0
1668583125063,CSE 232B,A00,102382,Deutsch; Alin Bernard,0,39,0,0
1668583125485,CSE 234,A01,112904,Kumar; Arun Kumar,0,0,0,0
1668583125919,CSE 237A,A00,102383,Rosing; Tajana Simunic,0,57,0,0
1668583126341,CSE 239A,A00,102384,Deutsch; Alin Bernard,0,18,0,0
1668583126767,CSE 239B,A00,102385,Polikarpova; Nadezhda,0,11,0,0
1668583127194,CSE 240A,A00,102386,Pannuto; Patrick William,0,49,0,0
1668583127622,CSE 240B,A00,102387,Zhao; Jishen,0,51,0,0
1668583128046,CSE 241A,A00,106406,Kang; Mingu,0,9,0,0
1668583128474,CSE 249B,A00,102388,Kahng; Andrew Byun,0,7,8,8
1668583128898,CSE 251B,A01,102392,Cottrell; Garrison W,0,54,0,0
1668583128898,CSE 251B,A02,102393,Cottrell; Garrison W,0,36,0,0
1668583129328,CSE 252B,A00,102394,Ochoa; Benjamin Lawrence,0,64,0,0
1668583129766,CSE 257,A01,102396,Gao; Sicun,0,160,0,0
1668583130194,CSE 272,A00,102397,Li; Tzumao,0,22,0,0
1668583130617,CSE 274,A00,111323,Chern; Albert Ren-Haur,0,16,0,0
1668583131040,CSE 282,A00,102398,Pevzner; Pavel Arkadjevich,0,0,0,0
1668583131465,CSE 284,A00,114175,Gymrek; Melissa Ann,0,33,0,0
1668583131888,CSE 290,A00,102399,Chandraker; Manmohan Krishna,0,11,0,0
1668583131888,CSE 290,B00,102400,Vaccaro; Kristen Marie,0,10,25,25
1668583131888,CSE 290,C00,102414,Pannuto; Patrick William,0,1,25,25
1668583131888,CSE 290,D00,102427,Pevzner; Pavel Arkadjevich,0,0,0,0
1668583131888,CSE 290,E00,102429,Zhao; Jishen,0,6,0,0
1668583131888,CSE 290,F00,102436,Tullsen; Dean Michael,0,6,0,0
1668583131888,CSE 290,G00,102440,Christensen; Henrik I,0,8,20,20
1668583132317,CSE 291,A00,102443,Su; Hao,0,0,0,0
1668583132317,CSE 291,B00,102448,Polikarpova; Nadezhda,0,0,0,0
1668583132317,CSE 291,C00,102453,Vaccaro; Kristen Marie,0,0,0,0
1668583132317,CSE 291,D00,111343,Savage; Stefan,0,0,0,0
1668583132317,CSE 291,E00,116474,Claffy; Kimberly Claire,0,0,0,0
1668583132317,CSE 291,F00,116479,Pasquale; Joseph,0,0,0,0
1668583132752,CSE 293,001,119111,Bafna; Vineet,9999,0,9999,0
1668583132752,CSE 293,002,119118,Bellare; Mihir,9999,0,9999,0
1668583132752,CSE 293,003,119122,Berg-Kirkpatrick; Taylor D,9999,0,9999,0
1668583132752,CSE 293,004,119135,Christensen; Henrik I,9999,0,9999,0
1668583132752,CSE 293,005,119142,Cottrell; Garrison W,9999,0,9999,0
1668583132752,CSE 293,006,119146,Deutsch; Alin Bernard,9999,0,9999,0
1668583132752,CSE 293,007,119159,Esmaeilzadeh; Hadi,9999,0,9999,0
1668583132752,CSE 293,008,119166,Freund; Yoav,9999,0,9999,0
1668583132752,CSE 293,009,119170,Griswold; William G.,9999,0,9999,0
1668583132752,CSE 293,010,119183,Gymrek; Melissa Ann,9999,0,9999,0
1668583132752,CSE 293,011,119190,Heninger; Nadia A,9999,0,9999,0
1668583132752,CSE 293,012,119230,Impagliazzo; Russell,9999,0,9999,0
1668583132752,CSE 293,013,119232,Jhala; Ranjit,9999,0,9999,0
1668583132752,CSE 293,014,119233,Kahng; Andrew Byun,9999,0,9999,0
1668583132752,CSE 293,015,119298,Kane; Daniel Mertz,9999,0,9999,0
1668583132752,CSE 293,016,119299,Kriegman; David J,9999,0,9999,0
1668583132752,CSE 293,017,119300,Kumar; Arun Kumar,9999,0,9999,0
1668583132752,CSE 293,018,119301,Lerner; Sorin,9999,0,9999,0
1668583132752,CSE 293,019,119302,Lovett; Shachar,9999,0,9999,0
1668583132752,CSE 293,020,119303,McAuley; Julian John,9999,0,9999,0
1668583132752,CSE 293,021,119304,Micciancio; Daniele,9999,0,9999,0
1668583132752,CSE 293,022,119367,Orailoglu; Alex,9999,0,9999,0
1668583132752,CSE 293,023,119382,Paturi; Ramamohan,9999,0,9999,0
1668583132752,CSE 293,024,119404,Polikarpova; Nadezhda,9999,0,9999,0
1668583132752,CSE 293,025,119406,Politz; Joseph Gibbs,9999,0,9999,0
1668583132752,CSE 293,026,119411,Porter; George M,9999,0,9999,0
1668583132752,CSE 293,027,119414,Porter; Leonard Emerson,9999,0,9999,0
1668583132752,CSE 293,028,119416,Ramamoorthi; Ravi,9999,0,9999,0
1668583132752,CSE 293,029,119417,Sahoo; Debashis,9999,0,9999,0
1668583132752,CSE 293,030,119420,Saul; Lawrence,9999,0,9999,0
1668583132752,CSE 293,031,119421,Savage; Stefan,9999,0,9999,0
1668583132752,CSE 293,032,119425,Schulze; Jurgen P.,9999,0,9999,0
1668583132752,CSE 293,033,119426,Snoeren; Alex C.,9999,0,9999,0
1668583132752,CSE 293,034,119428,Shang; Jingbo,9999,0,9999,0
1668583132752,CSE 293,035,119430,Stefan; Deian,9999,0,9999,0
1668583132752,CSE 293,036,119431,Su; Hao,9999,0,9999,0
1668583132752,CSE 293,037,119433,Swanson; Steven James,9999,0,9999,0
1668583132752,CSE 293,038,119435,Tullsen; Dean Michael,9999,0,9999,0
1668583132752,CSE 293,039,119483,Voelker; Geoffrey M.,9999,0,9999,0
1668583132752,CSE 293,040,119537,Zhao; Jishen,9999,0,9999,0
1668583132752,CSE 293,041,119538,Zhou; Yuan-Yuan,9999,0,9999,0
1668583132752,CSE 293,042,119539,Gao; Sicun,9999,0,9999,0
1668583132752,CSE 293,043,119540,Weibel; Nadir,9999,0,9999,0
1668583132752,CSE 293,044,119541,Gupta; Rajesh K.,9999,0,9999,0
1668583132752,CSE 293,045,126410,Vaccaro; Kristen Marie,9999,0,9999,0
1668583132752,CSE 293,046,126411,Klemke; Richard,9999,0,9999,0
1668583133174,CSE 294,A00,102459,Voelker; Geoffrey M.,0,2,0,0
1668583133174,CSE 294,B00,111322,Orailoglu; Alex,0,2,0,0
1668583133600,DSE 201,A00,096914,Deutsch; Alin Bernard,30,0,30,0
1668583134023,DSE 210,A00,096915,Dasgupta; Sanjoy,30,0,30,0
1668583134448,DSE 241,A00,144528,Smith; Neil Gordon,30,0,30,0
1668583134873,DSE 260A,A00,096916,Altintas De Callaf; Ilkay,30,0,30,0
1668583135314,ECE 200,001,103586,Antipa; Nicholas A,9999,0,9999,0
1668583135314,ECE 200,002,103587,Atanasov; Nikolay A.,9999,0,9999,0
1668583135314,ECE 200,003,103588,Bharadia; Dinesh,9999,0,9999,0
1668583135314,ECE 200,004,103589,Cheng; Chung Kuan,9999,0,9999,0
1668583135314,ECE 200,005,103590,Cosman; Pamela C.,9999,0,9999,0
1668583135314,ECE 200,006,103591,Dayeh; Shadi Ahmad,9999,0,9999,0
1668583135314,ECE 200,007,103592,Fainman; Yeshaiahu,9999,0,9999,0
1668583135314,ECE 200,008,103593,Ford; Joseph Earl,9999,0,9999,0
1668583135314,ECE 200,009,103594,Franceschetti; Massimo,9999,0,9999,0
1668583135314,ECE 200,010,103595,Fullerton; Eric E,9999,0,9999,0
1668583135314,ECE 200,011,103596,Galton; Ian A,9999,0,9999,0
1668583135314,ECE 200,012,103597,Gilja; Vikash,9999,0,9999,0
1668583135314,ECE 200,013,103598,Hall; Drew A.,9999,0,9999,0
1668583135314,ECE 200,014,103599,Hsueh; Tzu-Chien,9999,0,9999,0
1668583135314,ECE 200,015,103600,Javidi; Tara,9999,0,9999,0
1668583135314,ECE 200,016,103601,Kahng; Andrew Byun,9999,0,9999,0
1668583135314,ECE 200,017,103602,Kim; Young-Han,9999,0,9999,0
1668583135314,ECE 200,018,103603,Koushanfar; Farinaz,9999,0,9999,0
1668583135314,ECE 200,019,103604,Kuzum; Duygu,9999,0,9999,0
1668583135314,ECE 200,020,103605,Le; Hanh-Phuc,9999,0,9999,0
1668583135314,ECE 200,021,103606,Lin; Bill,9999,0,9999,0
1668583135314,ECE 200,022,103607,Liu; Zhaowei,9998,0,9999,1
1668583135314,ECE 200,023,103608,Lo; Yu-Hwa,9999,0,9999,0
1668583135314,ECE 200,024,103609,Lomakin; Vitaliy,9999,0,9999,0
1668583135314,ECE 200,025,103610,Mercier; Patrick Philip,9999,0,9999,0
1668583135314,ECE 200,026,103611,Meyer; Florian,9999,0,9999,0
1668583135314,ECE 200,027,103612,Milstein; Laurence B.,9999,0,9999,0
1668583135314,ECE 200,028,103613,Mir Arabbaygi; Siavash,9999,0,9999,0
1668583135314,ECE 200,029,103614,Mookherjea; Shayan,9999,0,9999,0
1668583135314,ECE 200,030,103615,Morris; Karcher William,9999,0,9999,0
1668583135314,ECE 200,031,103616,Ng; Tse Nga,9999,0,9999,0
1668583135314,ECE 200,032,103617,Nguyen; Truong Quang,9999,0,9999,0
1668583135314,ECE 200,033,103618,Nomura; Kenji,9999,0,9999,0
1668583135314,ECE 200,034,103619,Orlitsky; Alon,9999,0,9999,0
1668583135314,ECE 200,035,103620,Pal; Piya,9999,0,9999,0
1668583135314,ECE 200,036,103621,Papen; George C.,9999,0,9999,0
1668583135314,ECE 200,037,103622,Radic; Stojan,9999,0,9999,0
1668583135314,ECE 200,038,103623,Rao; Bhaskar D.,9999,0,9999,0
1668583135314,ECE 200,039,103624,Rao; Ramesh R,9999,0,9999,0
1668583135314,ECE 200,040,103625,Rebeiz; Gabriel,9999,0,9999,0
1668583135314,ECE 200,041,103626,Sanford; John R,9999,0,9999,0
1668583135314,ECE 200,042,103627,Siegel; Paul H.,9999,0,9999,0
1668583135314,ECE 200,043,103628,Sievenpiper; Daniel F.,9999,0,9999,0
1668583135314,ECE 200,044,103629,Sworder; David D.,9999,0,9999,0
1668583135314,ECE 200,045,103630,Taur; Yuan,9999,0,9999,0
1668583135314,ECE 200,046,103631,Touri; Behrouz,9999,0,9999,0
1668583135314,ECE 200,047,103632,Trivedi; Mohan M.,9999,0,9999,0
1668583135314,ECE 200,048,103633,Vasconcelos; Nuno,9999,0,9999,0
1668583135314,ECE 200,049,103634,Wang; Xiaolong,9999,0,9999,0
1668583135314,ECE 200,050,103635,Xie; Pengtao,9999,0,9999,0
1668583135314,ECE 200,051,103636,Yip; Michael,9999,0,9999,0
1668583135314,ECE 200,052,103637,Zeger; Kenneth A.,999,0,999,0
1668583135314,ECE 200,053,103638,Zhang; Xinyu,9999,0,9999,0
1668583135314,ECE 200,054,103639,Turakhia; Yatish Girish,9999,0,9999,0
1668583135314,ECE 200,055,103640,Kang; Mingu,9999,0,9999,0
1668583135314,ECE 200,056,103641,Shi; Yuanyuan,9999,0,9999,0
1668583135314,ECE 200,057,103642,Wang; Edward Jay,9999,0,9999,0
1668583135314,ECE 200,058,103643,Zheng; Yang,9999,0,9999,0
1668583135748,ECE 202,A00,103644,Kuzum; Duygu,0,47,0,0
1668583136178,ECE 212BN,A00,103646,Ng; Tse Nga,0,10,0,0
1668583136606,ECE 221,A00,111493,Staff,0,0,0,0
1668583137047,ECE 222B,A00,103647,Lomakin; Vitaliy,0,22,0,0
1668583137472,ECE 230B,A00,103648,Taur; Yuan,0,4,0,0
1668583137894,ECE 238B,A00,103649,Garay; Javier,0,0,0,0
1668583138318,ECE 240B,A00,112900,Fainman; Yeshaiahu,0,8,0,0
1668583138743,ECE 247A,A00,103650,Jokerst; Jesse Vincent,0,6,0,0
1668583139167,ECE 247B,A00,103651,Wang; Joseph,0,14,0,0
1668583139590,ECE 250,A00,103652,Siegel; Paul H.,0,85,0,0
1668583140016,ECE 251A,A00,103654,Rao; Bhaskar D.,0,65,0,0
1668583140450,ECE 257B,A00,103655,Bharadia; Dinesh,0,33,0,0
1668583140877,ECE 258A,A00,103656,Milstein; Laurence B.,0,29,0,0
1668583141305,ECE 260B,A00,103658,Kang; Mingu,0,121,0,0
1668583141729,ECE 264A,A00,103659,Galton; Ian A,0,42,0,34
1668583142255,ECE 265A,A00,103661,Gudem; Prasad S.S.,0,42,0,36
1668583142679,ECE 265D,A00,103662,Gudem; Prasad S.S.,0,27,0,0
1668583143103,ECE 268,A00,103663,Koushanfar; Farinaz,0,44,0,0
1668583143527,ECE 269,A01,103665,Pal; Piya,0,223,0,0
1668583143980,ECE 271B,A00,103666,Vasconcelos; Manuela,0,80,0,0
1668583144408,ECE 276A,A00,103667,Atanasov; Nikolay A.,0,127,0,0
1668583144832,ECE 277,A00,103668,An; Cheolhong,0,151,0,0
1668583145257,ECE 279,A00,117947,Hall; Drew A.,0,22,0,0
1668583146117,ECE 283,A00,103670,Hsueh; Tzu-Chien,0,57,0,0
1668583146548,ECE 284,A00,103671,Turakhia; Yatish Girish,0,40,0,0
1668583146983,ECE 285,A00,103672,Zheng; Yang,0,40,0,0
1668583146983,ECE 285,B00,103673,Sworder; David D.,0,61,0,0
1668583147411,ECE 287,A00,103676,Javidi; Tara,0,7,0,0
1668583147835,MATH 200B,A00,098023,Salehi Golsefidy; Alireza,7,0,15,8
1668583148261,MATH 202B,A00,098024,Rhoades; Brendon Patrick,7,0,15,8
1668583148688,MATH 203B,A00,098025,Oprea; Dragos N.,9,0,15,6
1668583149116,MATH 204B,A00,098026,Sorensen; Claus M,13,0,15,2
1668583149544,MATH 208,A00,098027,Izadi; Elham,7,0,10,3
1668583149970,MATH 209,A00,098028,Pollack; Aaron,10,0,10,0
1668583150392,MATH 211A,A00,112919,Rogalski; Daniel,8,0,10,2
1668583150815,MATH 211B,A00,112920,Seward; Brandon M.,9,0,10,1
1668583151240,MATH 218,A00,098029,Li; Bo,10,0,10,0
1668583151663,MATH 220B,A00,098030,Novak; Jonathan I,10,0,15,5
1668583152085,MATH 221A,A00,098031,Ebenfelt; Peter F,12,0,15,3
1668583152512,MATH 231B,A00,098032,Zlatos; Andrej,9,0,15,6
1668583152942,MATH 240B,A00,098033,Ni; Lei,7,0,15,8
1668583153365,MATH 243,A00,098034,Jekel; David Andrew,10,0,10,0
1668583153787,MATH 245A,A00,098035,Nie; Jiawang,0,7,15,18
1668583154209,MATH 248,A00,098036,Bejenaru; Ioan,10,0,10,0
1668583154636,MATH 250B,A00,098037,Spolaor; Luca,12,0,15,3
1668583155060,MATH 258,A00,098038,Ni; Lei,8,0,10,2
1668583155482,MATH 264B,A00,098041,Rhoades; Brendon Patrick,7,0,15,8
1668583155915,MATH 268,A00,098042,Buss; Samuel R,10,0,10,0
1668583156340,MATH 269,A00,098043,Rhoades; Brendon Patrick,10,0,10,0
1668583156764,MATH 270B,A00,098044,Li; Bo,6,0,15,9
1668583157198,MATH 272B,A00,098045,Holst; Michael J,13,0,15,2
1668583157627,MATH 273A,A00,098046,Tian; Xiaochuan,10,0,15,5
1668583158070,MATH 275,A01,098048,Tian; Xiaochuan,6,0,10,4
1668583158513,MATH 278A,A00,098049,Holst; Michael J,6,0,10,4
1668583158941,MATH 278B,A00,098050,Cloninger; Alexander,10,0,10,0
1668583159365,MATH 278C,A00,098051,Nie; Jiawang,5,0,10,5
1668583159787,MATH 280B,A00,098052,Zheng; Tianyi,6,0,15,9
1668583160227,MATH 281B,A00,098053,Bradic; Jelena,0,2,15,15
1668583160650,MATH 282B,A00,098054,Arias-Castro; Ery,0,1,15,15
1668583161073,MATH 285,A00,098055,Fitzsimmons; Patrick J,0,4,15,16
1668583161499,MATH 287B,A00,098056,Arias-Castro; Ery,1,0,15,14
1668583161925,MATH 288,A00,098057,Agarwal; Pooja,9,0,10,1
1668583161925,MATH 288,B00,098058,Zhang; Danna,8,0,10,2
1668583161925,MATH 288,C00,098059,Williams; Ruth J,9,0,10,1
1668583162351,MATH 290B,A00,098060,Roberts; Justin Deritter,12,0,15,3
1668583162775,MATH 292,A00,098061,Belmont; Eva Kinoshita,10,0,10,0
1668583163199,MATH 295,A00,098062,Suk; Andrew Hoon,47,0,50,3
1668583163623,MATH 296,A00,098063,Novak; Jonathan I,20,0,20,0
1668583164052,MATH 297,001,098064,Gamst; Anthony Collins,9997,0,9999,2
1668583666239,COGS 205,A00,101395,Chiba; Andrea,19,0,20,1
1668583666667,COGS 210B,001,101404,Greene; Deanna Jacquelyn,9998,0,9999,1
1668583666667,COGS 210B,002,101417,Xia; Haijun,9999,0,9999,0
1668583666667,COGS 210B,003,101422,Nitz; Douglas A.,9999,0,9999,0
1668583666667,COGS 210B,004,101423,Hollan; James D.,9998,0,9999,1
1668583666667,COGS 210B,005,101424,Deak; Gedeon O.,9998,0,9999,1
1668583666667,COGS 210B,006,101425,Rossano; Federico,9999,0,9999,0
1668583667091,COGS 211B,A00,101427,Coulson; Seana M,9996,0,9999,3
1668583667516,COGS 220,A00,101428,Hollan; James D.,0,17,25,25
1668583667939,COGS 229,A00,101429,Dow; Steven P,17,0,25,8
1668583668363,COGS 230,A00,101430,Klemmer; Scott R,6,0,17,11
1668583668787,COGS 234,A00,101431,Xia; Haijun,0,1,25,25
1668583669210,COGS 260,A00,101432,Kiyonaga; Anastasia,21,0,25,4
1668583669210,COGS 260,B00,101433,Kirsh; David Joel,15,0,25,10
1668583669651,CSE 202,A00,102371,Impagliazzo; Russell,0,70,0,0
1668583670078,CSE 203B,A01,102373,Cheng; Chung Kuan,0,70,0,0
1668583670499,CSE 208,A00,102374,Micciancio; Daniele,0,5,0,0
1668583670923,CSE 209A,A00,112895,Impagliazzo; Russell,0,14,15,15
1668583671347,CSE 209B,A00,108005,Bellare; Mihir,0,7,0,0
1668583671775,CSE 210,A00,113163,Coblenz; Michael J,0,96,0,0
1668583672203,CSE 219,A00,106111,Dow; Steven P,0,8,20,20
1668583672628,CSE 221,A00,102376,Voelker; Geoffrey M.,0,77,0,0
1668583673051,CSE 224,A01,102378,Porter; George M,0,180,0,0
1668583673479,CSE 229A,A00,102379,Savage; Stefan,0,14,0,0
1668583673902,CSE 229C,A00,102380,Munyaka; Imani N. S.,0,12,0,0
1668583674327,CSE 232B,A00,102382,Deutsch; Alin Bernard,0,39,0,0
1668583674754,CSE 234,A01,112904,Kumar; Arun Kumar,0,0,0,0
1668583675179,CSE 237A,A00,102383,Rosing; Tajana Simunic,0,57,0,0
1668583675609,CSE 239A,A00,102384,Deutsch; Alin Bernard,0,18,0,0
1668583676031,CSE 239B,A00,102385,Polikarpova; Nadezhda,0,11,0,0
1668583676457,CSE 240A,A00,102386,Pannuto; Patrick William,0,49,0,0
1668583676883,CSE 240B,A00,102387,Zhao; Jishen,0,51,0,0
1668583677307,CSE 241A,A00,106406,Kang; Mingu,0,9,0,0
1668583677730,CSE 249B,A00,102388,Kahng; Andrew Byun,0,7,8,8
1668583678155,CSE 251B,A01,102392,Cottrell; Garrison W,0,54,0,0
1668583678155,CSE 251B,A02,102393,Cottrell; Garrison W,0,36,0,0
1668583678580,CSE 252B,A00,102394,Ochoa; Benjamin Lawrence,0,64,0,0
1668583679004,CSE 257,A01,102396,Gao; Sicun,0,160,0,0
1668583679427,CSE 272,A00,102397,Li; Tzumao,0,22,0,0
1668583679853,CSE 274,A00,111323,Chern; Albert Ren-Haur,0,16,0,0
1668583680287,CSE 282,A00,102398,Pevzner; Pavel Arkadjevich,0,0,0,0
1668583680711,CSE 284,A00,114175,Gymrek; Melissa Ann,0,33,0,0
1668583681142,CSE 290,A00,102399,Chandraker; Manmohan Krishna,0,11,0,0
1668583681142,CSE 290,B00,102400,Vaccaro; Kristen Marie,0,10,25,25
1668583681142,CSE 290,C00,102414,Pannuto; Patrick William,0,1,25,25
1668583681142,CSE 290,D00,102427,Pevzner; Pavel Arkadjevich,0,0,0,0
1668583681142,CSE 290,E00,102429,Zhao; Jishen,0,6,0,0
1668583681142,CSE 290,F00,102436,Tullsen; Dean Michael,0,6,0,0
1668583681142,CSE 290,G00,102440,Christensen; Henrik I,0,8,20,20
1668583681568,CSE 291,A00,102443,Su; Hao,0,0,0,0
1668583681568,CSE 291,B00,102448,Polikarpova; Nadezhda,0,0,0,0
1668583681568,CSE 291,C00,102453,Vaccaro; Kristen Marie,0,0,0,0
1668583681568,CSE 291,D00,111343,Savage; Stefan,0,0,0,0
1668583681568,CSE 291,E00,116474,Claffy; Kimberly Claire,0,0,0,0
1668583681568,CSE 291,F00,116479,Pasquale; Joseph,0,0,0,0
1668583682004,CSE 293,001,119111,Bafna; Vineet,9999,0,9999,0
1668583682004,CSE 293,002,119118,Bellare; Mihir,9999,0,9999,0
1668583682004,CSE 293,003,119122,Berg-Kirkpatrick; Taylor D,9999,0,9999,0
1668583682004,CSE 293,004,119135,Christensen; Henrik I,9999,0,9999,0
1668583682004,CSE 293,005,119142,Cottrell; Garrison W,9999,0,9999,0
1668583682004,CSE 293,006,119146,Deutsch; Alin Bernard,9999,0,9999,0
1668583682004,CSE 293,007,119159,Esmaeilzadeh; Hadi,9999,0,9999,0
1668583682004,CSE 293,008,119166,Freund; Yoav,9999,0,9999,0
1668583682004,CSE 293,009,119170,Griswold; William G.,9999,0,9999,0
1668583682004,CSE 293,010,119183,Gymrek; Melissa Ann,9999,0,9999,0
1668583682004,CSE 293,011,119190,Heninger; Nadia A,9999,0,9999,0
1668583682004,CSE 293,012,119230,Impagliazzo; Russell,9999,0,9999,0
1668583682004,CSE 293,013,119232,Jhala; Ranjit,9999,0,9999,0
1668583682004,CSE 293,014,119233,Kahng; Andrew Byun,9999,0,9999,0
1668583682004,CSE 293,015,119298,Kane; Daniel Mertz,9999,0,9999,0
1668583682004,CSE 293,016,119299,Kriegman; David J,9999,0,9999,0
1668583682004,CSE 293,017,119300,Kumar; Arun Kumar,9999,0,9999,0
1668583682004,CSE 293,018,119301,Lerner; Sorin,9999,0,9999,0
1668583682004,CSE 293,019,119302,Lovett; Shachar,9999,0,9999,0
1668583682004,CSE 293,020,119303,McAuley; Julian John,9999,0,9999,0
1668583682004,CSE 293,021,119304,Micciancio; Daniele,9999,0,9999,0
1668583682004,CSE 293,022,119367,Orailoglu; Alex,9999,0,9999,0
1668583682004,CSE 293,023,119382,Paturi; Ramamohan,9999,0,9999,0
1668583682004,CSE 293,024,119404,Polikarpova; Nadezhda,9999,0,9999,0
1668583682004,CSE 293,025,119406,Politz; Joseph Gibbs,9999,0,9999,0
1668583682004,CSE 293,026,119411,Porter; George M,9999,0,9999,0
1668583682004,CSE 293,027,119414,Porter; Leonard Emerson,9999,0,9999,0
1668583682004,CSE 293,028,119416,Ramamoorthi; Ravi,9999,0,9999,0
1668583682004,CSE 293,029,119417,Sahoo; Debashis,9999,0,9999,0
1668583682004,CSE 293,030,119420,Saul; Lawrence,9999,0,9999,0
1668583682004,CSE 293,031,119421,Savage; Stefan,9999,0,9999,0
1668583682004,CSE 293,032,119425,Schulze; Jurgen P.,9999,0,9999,0
1668583682004,CSE 293,033,119426,Snoeren; Alex C.,9999,0,9999,0
1668583682004,CSE 293,034,119428,Shang; Jingbo,9999,0,9999,0
1668583682004,CSE 293,035,119430,Stefan; Deian,9999,0,9999,0
1668583682004,CSE 293,036,119431,Su; Hao,9999,0,9999,0
1668583682004,CSE 293,037,119433,Swanson; Steven James,9999,0,9999,0
1668583682004,CSE 293,038,119435,Tullsen; Dean Michael,9999,0,9999,0
1668583682004,CSE 293,039,119483,Voelker; Geoffrey M.,9999,0,9999,0
1668583682004,CSE 293,040,119537,Zhao; Jishen,9999,0,9999,0
1668583682004,CSE 293,041,119538,Zhou; Yuan-Yuan,9999,0,9999,0
1668583682004,CSE 293,042,119539,Gao; Sicun,9999,0,9999,0
1668583682004,CSE 293,043,119540,Weibel; Nadir,9999,0,9999,0
1668583682004,CSE 293,044,119541,Gupta; Rajesh K.,9999,0,9999,0
1668583682004,CSE 293,045,126410,Vaccaro; Kristen Marie,9999,0,9999,0
1668583682004,CSE 293,046,126411,Klemke; Richard,9999,0,9999,0
1668583682427,CSE 294,A00,102459,Voelker; Geoffrey M.,0,2,0,0
1668583682427,CSE 294,B00,111322,Orailoglu; Alex,0,2,0,0
1668583682852,DSE 201,A00,096914,Deutsch; Alin Bernard,30,0,30,0
1668583683276,DSE 210,A00,096915,Dasgupta; Sanjoy,30,0,30,0
1668583683712,DSE 241,A00,144528,Smith; Neil Gordon,30,0,30,0
1668583684141,DSE 260A,A00,096916,Altintas De Callaf; Ilkay,30,0,30,0
1668583684575,ECE 200,001,103586,Antipa; Nicholas A,9999,0,9999,0
1668583684575,ECE 200,002,103587,Atanasov; Nikolay A.,9999,0,9999,0
1668583684575,ECE 200,003,103588,Bharadia; Dinesh,9999,0,9999,0
1668583684575,ECE 200,004,103589,Cheng; Chung Kuan,9999,0,9999,0
1668583684575,ECE 200,005,103590,Cosman; Pamela C.,9999,0,9999,0
1668583684575,ECE 200,006,103591,Dayeh; Shadi Ahmad,9999,0,9999,0
1668583684575,ECE 200,007,103592,Fainman; Yeshaiahu,9999,0,9999,0
1668583684575,ECE 200,008,103593,Ford; Joseph Earl,9999,0,9999,0
1668583684575,ECE 200,009,103594,Franceschetti; Massimo,9999,0,9999,0
1668583684575,ECE 200,010,103595,Fullerton; Eric E,9999,0,9999,0
1668583684575,ECE 200,011,103596,Galton; Ian A,9999,0,9999,0
1668583684575,ECE 200,012,103597,Gilja; Vikash,9999,0,9999,0
1668583684575,ECE 200,013,103598,Hall; Drew A.,9999,0,9999,0
1668583684575,ECE 200,014,103599,Hsueh; Tzu-Chien,9999,0,9999,0
1668583684575,ECE 200,015,103600,Javidi; Tara,9999,0,9999,0
1668583684575,ECE 200,016,103601,Kahng; Andrew Byun,9999,0,9999,0
1668583684575,ECE 200,017,103602,Kim; Young-Han,9999,0,9999,0
1668583684575,ECE 200,018,103603,Koushanfar; Farinaz,9999,0,9999,0
1668583684575,ECE 200,019,103604,Kuzum; Duygu,9999,0,9999,0
1668583684575,ECE 200,020,103605,Le; Hanh-Phuc,9999,0,9999,0
1668583684575,ECE 200,021,103606,Lin; Bill,9999,0,9999,0
1668583684575,ECE 200,022,103607,Liu; Zhaowei,9998,0,9999,1
1668583684575,ECE 200,023,103608,Lo; Yu-Hwa,9999,0,9999,0
1668583684575,ECE 200,024,103609,Lomakin; Vitaliy,9999,0,9999,0
1668583684575,ECE 200,025,103610,Mercier; Patrick Philip,9999,0,9999,0
1668583684575,ECE 200,026,103611,Meyer; Florian,9999,0,9999,0
1668583684575,ECE 200,027,103612,Milstein; Laurence B.,9999,0,9999,0
1668583684575,ECE 200,028,103613,Mir Arabbaygi; Siavash,9999,0,9999,0
1668583684575,ECE 200,029,103614,Mookherjea; Shayan,9999,0,9999,0
1668583684575,ECE 200,030,103615,Morris; Karcher William,9999,0,9999,0
1668583684575,ECE 200,031,103616,Ng; Tse Nga,9999,0,9999,0
1668583684575,ECE 200,032,103617,Nguyen; Truong Quang,9999,0,9999,0
1668583684575,ECE 200,033,103618,Nomura; Kenji,9999,0,9999,0
1668583684575,ECE 200,034,103619,Orlitsky; Alon,9999,0,9999,0
1668583684575,ECE 200,035,103620,Pal; Piya,9999,0,9999,0
1668583684575,ECE 200,036,103621,Papen; George C.,9999,0,9999,0
1668583684575,ECE 200,037,103622,Radic; Stojan,9999,0,9999,0
1668583684575,ECE 200,038,103623,Rao; Bhaskar D.,9999,0,9999,0
1668583684575,ECE 200,039,103624,Rao; Ramesh R,9999,0,9999,0
1668583684575,ECE 200,040,103625,Rebeiz; Gabriel,9999,0,9999,0
1668583684575,ECE 200,041,103626,Sanford; John R,9999,0,9999,0
1668583684575,ECE 200,042,103627,Siegel; Paul H.,9999,0,9999,0
1668583684575,ECE 200,043,103628,Sievenpiper; Daniel F.,9999,0,9999,0
1668583684575,ECE 200,044,103629,Sworder; David D.,9999,0,9999,0
1668583684575,ECE 200,045,103630,Taur; Yuan,9999,0,9999,0
1668583684575,ECE 200,046,103631,Touri; Behrouz,9999,0,9999,0
1668583684575,ECE 200,047,103632,Trivedi; Mohan M.,9999,0,9999,0
1668583684575,ECE 200,048,103633,Vasconcelos; Nuno,9999,0,9999,0
1668583684575,ECE 200,049,103634,Wang; Xiaolong,9999,0,9999,0
1668583684575,ECE 200,050,103635,Xie; Pengtao,9999,0,9999,0
1668583684575,ECE 200,051,103636,Yip; Michael,9999,0,9999,0
1668583684575,ECE 200,052,103637,Zeger; Kenneth A.,999,0,999,0
1668583684575,ECE 200,053,103638,Zhang; Xinyu,9999,0,9999,0
1668583684575,ECE 200,054,103639,Turakhia; Yatish Girish,9999,0,9999,0
1668583684575,ECE 200,055,103640,Kang; Mingu,9999,0,9999,0
1668583684575,ECE 200,056,103641,Shi; Yuanyuan,9999,0,9999,0
1668583684575,ECE 200,057,103642,Wang; Edward Jay,9999,0,9999,0
1668583684575,ECE 200,058,103643,Zheng; Yang,9999,0,9999,0
1668583685012,ECE 202,A00,103644,Kuzum; Duygu,0,47,0,0
1668583685449,ECE 212BN,A00,103646,Ng; Tse Nga,0,10,0,0
1668583685872,ECE 221,A00,111493,Staff,0,0,0,0
1668583686297,ECE 222B,A00,103647,Lomakin; Vitaliy,0,22,0,0
1668583686725,ECE 230B,A00,103648,Taur; Yuan,0,4,0,0
1668583687148,ECE 238B,A00,103649,Garay; Javier,0,0,0,0
1668583687578,ECE 240B,A00,112900,Fainman; Yeshaiahu,0,8,0,0
1668583688002,ECE 247A,A00,103650,Jokerst; Jesse Vincent,0,6,0,0
1668583688428,ECE 247B,A00,103651,Wang; Joseph,0,14,0,0
1668583688850,ECE 250,A00,103652,Siegel; Paul H.,0,85,0,0
1668583689274,ECE 251A,A00,103654,Rao; Bhaskar D.,0,65,0,0
1668583689703,ECE 257B,A00,103655,Bharadia; Dinesh,0,33,0,0
1668583690128,ECE 258A,A00,103656,Milstein; Laurence B.,0,29,0,0
1668583690551,ECE 260B,A00,103658,Kang; Mingu,0,121,0,0
1668583690984,ECE 264A,A00,103659,Galton; Ian A,0,42,0,34
1668583691421,ECE 265A,A00,103661,Gudem; Prasad S.S.,0,42,0,36
1668583691849,ECE 265D,A00,103662,Gudem; Prasad S.S.,0,27,0,0
1668583692273,ECE 268,A00,103663,Koushanfar; Farinaz,0,44,0,0
1668583692721,ECE 269,A01,103665,Pal; Piya,0,223,0,0
1668583693147,ECE 271B,A00,103666,Vasconcelos; Manuela,0,80,0,0
1668583693571,ECE 276A,A00,103667,Atanasov; Nikolay A.,0,127,0,0
1668583693995,ECE 277,A00,103668,An; Cheolhong,0,151,0,0
1668583694419,ECE 279,A00,117947,Hall; Drew A.,0,22,0,0
1668583695274,ECE 283,A00,103670,Hsueh; Tzu-Chien,0,57,0,0
1668583695722,ECE 284,A00,103671,Turakhia; Yatish Girish,0,40,0,0
1668583696146,ECE 285,A00,103672,Zheng; Yang,0,40,0,0
1668583696146,ECE 285,B00,103673,Sworder; David D.,0,61,0,0
1668583696570,ECE 287,A00,103676,Javidi; Tara,0,7,0,0
1668583697002,MATH 200B,A00,098023,Salehi Golsefidy; Alireza,7,0,15,8
1668583697431,MATH 202B,A00,098024,Rhoades; Brendon Patrick,7,0,15,8
1668583697854,MATH 203B,A00,098025,Oprea; Dragos N.,9,0,15,6
1668583698291,MATH 204B,A00,098026,Sorensen; Claus M,13,0,15,2
1668583698713,MATH 208,A00,098027,Izadi; Elham,7,0,10,3
1668583699137,MATH 209,A00,098028,Pollack; Aaron,10,0,10,0
1668583699561,MATH 211A,A00,112919,Rogalski; Daniel,8,0,10,2
1668583699985,MATH 211B,A00,112920,Seward; Brandon M.,9,0,10,1
1668583700410,MATH 218,A00,098029,Li; Bo,10,0,10,0
1668583700846,MATH 220B,A00,098030,Novak; Jonathan I,10,0,15,5
1668583701274,MATH 221A,A00,098031,Ebenfelt; Peter F,12,0,15,3
1668583701698,MATH 231B,A00,098032,Zlatos; Andrej,9,0,15,6
1668583702123,MATH 240B,A00,098033,Ni; Lei,7,0,15,8
1668583702549,MATH 243,A00,098034,Jekel; David Andrew,10,0,10,0
1668583702975,MATH 245A,A00,098035,Nie; Jiawang,0,7,15,18
1668583703399,MATH 248,A00,098036,Bejenaru; Ioan,10,0,10,0
1668583703823,MATH 250B,A00,098037,Spolaor; Luca,12,0,15,3
1668583704249,MATH 258,A00,098038,Ni; Lei,8,0,10,2
1668583704673,MATH 264B,A00,098041,Rhoades; Brendon Patrick,7,0,15,8
1668583705096,MATH 268,A00,098042,Buss; Samuel R,10,0,10,0
1668583705520,MATH 269,A00,098043,Rhoades; Brendon Patrick,10,0,10,0
1668583706040,MATH 270B,A00,098044,Li; Bo,6,0,15,9
1668583706466,MATH 272B,A00,098045,Holst; Michael J,13,0,15,2
1668583706892,MATH 273A,A00,098046,Tian; Xiaochuan,10,0,15,5
1668583707314,MATH 275,A01,098048,Tian; Xiaochuan,6,0,10,4
1668583707749,MATH 278A,A00,098049,Holst; Michael J,6,0,10,4
1668583708172,MATH 278B,A00,098050,Cloninger; Alexander,10,0,10,0
1668583708595,MATH 278C,A00,098051,Nie; Jiawang,5,0,10,5
1668583709021,MATH 280B,A00,098052,Zheng; Tianyi,6,0,15,9
1668583709446,MATH 281B,A00,098053,Bradic; Jelena,0,2,15,15
1668583709870,MATH 282B,A00,098054,Arias-Castro; Ery,0,1,15,15
1668583710294,MATH 285,A00,098055,Fitzsimmons; Patrick J,0,4,15,16
1668583710719,MATH 287B,A00,098056,Arias-Castro; Ery,1,0,15,14
1668583711163,MATH 288,A00,098057,Agarwal; Pooja,9,0,10,1
1668583711163,MATH 288,B00,098058,Zhang; Danna,8,0,10,2
1668583711163,MATH 288,C00,098059,Williams; Ruth J,9,0,10,1
1668583711599,MATH 290B,A00,098060,Roberts; Justin Deritter,12,0,15,3
1668583712028,MATH 292,A00,098061,Belmont; Eva Kinoshita,10,0,10,0
1668583712453,MATH 295,A00,098062,Suk; Andrew Hoon,47,0,50,3
1668583712876,MATH 296,A00,098063,Novak; Jonathan I,20,0,20,0
1668583713304,MATH 297,001,098064,Gamst; Anthony Collins,9997,0,9999,2
1668584215422,COGS 205,A00,101395,Chiba; Andrea,19,0,20,1
1668584215848,COGS 210B,001,101404,Greene; Deanna Jacquelyn,9998,0,9999,1
1668584215848,COGS 210B,002,101417,Xia; Haijun,9999,0,9999,0
1668584215848,COGS 210B,003,101422,Nitz; Douglas A.,9999,0,9999,0
1668584215848,COGS 210B,004,101423,Hollan; James D.,9998,0,9999,1
1668584215848,COGS 210B,005,101424,Deak; Gedeon O.,9998,0,9999,1
1668584215848,COGS 210B,006,101425,Rossano; Federico,9999,0,9999,0
1668584216270,COGS 211B,A00,101427,Coulson; Seana M,9996,0,9999,3
1668584216694,COGS 220,A00,101428,Hollan; James D.,0,17,25,25
1668584217117,COGS 229,A00,101429,Dow; Steven P,17,0,25,8
1668584217541,COGS 230,A00,101430,Klemmer; Scott R,6,0,17,11
1668584217964,COGS 234,A00,101431,Xia; Haijun,0,1,25,25
1668584218388,COGS 260,A00,101432,Kiyonaga; Anastasia,21,0,25,4
1668584218388,COGS 260,B00,101433,Kirsh; David Joel,15,0,25,10
1668584218813,CSE 202,A00,102371,Impagliazzo; Russell,0,70,0,0
1668584219239,CSE 203B,A01,102373,Cheng; Chung Kuan,0,70,0,0
1668584219661,CSE 208,A00,102374,Micciancio; Daniele,0,5,0,0
1668584220085,CSE 209A,A00,112895,Impagliazzo; Russell,0,14,15,15
1668584220512,CSE 209B,A00,108005,Bellare; Mihir,0,7,0,0
1668584220937,CSE 210,A00,113163,Coblenz; Michael J,0,96,0,0
1668584221361,CSE 219,A00,106111,Dow; Steven P,0,8,20,20
1668584221797,CSE 221,A00,102376,Voelker; Geoffrey M.,0,77,0,0
1668584222230,CSE 224,A01,102378,Porter; George M,0,180,0,0
1668584222653,CSE 229A,A00,102379,Savage; Stefan,0,14,0,0
1668584223077,CSE 229C,A00,102380,Munyaka; Imani N. S.,0,12,0,0
1668584223501,CSE 232B,A00,102382,Deutsch; Alin Bernard,0,39,0,0
1668584223927,CSE 234,A01,112904,Kumar; Arun Kumar,0,0,0,0
1668584224351,CSE 237A,A00,102383,Rosing; Tajana Simunic,0,57,0,0
1668584224774,CSE 239A,A00,102384,Deutsch; Alin Bernard,0,18,0,0
1668584225201,CSE 239B,A00,102385,Polikarpova; Nadezhda,0,11,0,0
1668584225625,CSE 240A,A00,102386,Pannuto; Patrick William,0,49,0,0
1668584226051,CSE 240B,A00,102387,Zhao; Jishen,0,51,0,0
1668584226593,CSE 241A,A00,106406,Kang; Mingu,0,9,0,0
1668584227019,CSE 249B,A00,102388,Kahng; Andrew Byun,0,7,8,8
1668584227446,CSE 251B,A01,102392,Cottrell; Garrison W,0,54,0,0
1668584227446,CSE 251B,A02,102393,Cottrell; Garrison W,0,36,0,0
1668584227871,CSE 252B,A00,102394,Ochoa; Benjamin Lawrence,0,64,0,0
1668584228300,CSE 257,A01,102396,Gao; Sicun,0,160,0,0
1668584228723,CSE 272,A00,102397,Li; Tzumao,0,22,0,0
1668584229145,CSE 274,A00,111323,Chern; Albert Ren-Haur,0,16,0,0
1668584229568,CSE 282,A00,102398,Pevzner; Pavel Arkadjevich,0,0,0,0
1668584229996,CSE 284,A00,114175,Gymrek; Melissa Ann,0,33,0,0
1668584230419,CSE 290,A00,102399,Chandraker; Manmohan Krishna,0,11,0,0
1668584230419,CSE 290,B00,102400,Vaccaro; Kristen Marie,0,10,25,25
1668584230419,CSE 290,C00,102414,Pannuto; Patrick William,0,1,25,25
1668584230419,CSE 290,D00,102427,Pevzner; Pavel Arkadjevich,0,0,0,0
1668584230419,CSE 290,E00,102429,Zhao; Jishen,0,6,0,0
1668584230419,CSE 290,F00,102436,Tullsen; Dean Michael,0,6,0,0
1668584230419,CSE 290,G00,102440,Christensen; Henrik I,0,8,20,20
1668584230850,CSE 291,A00,102443,Su; Hao,0,0,0,0
1668584230850,CSE 291,B00,102448,Polikarpova; Nadezhda,0,0,0,0
1668584230850,CSE 291,C00,102453,Vaccaro; Kristen Marie,0,0,0,0
1668584230850,CSE 291,D00,111343,Savage; Stefan,0,0,0,0
1668584230850,CSE 291,E00,116474,Claffy; Kimberly Claire,0,0,0,0
1668584230850,CSE 291,F00,116479,Pasquale; Joseph,0,0,0,0
1668584231286,CSE 293,001,119111,Bafna; Vineet,9999,0,9999,0
1668584231286,CSE 293,002,119118,Bellare; Mihir,9999,0,9999,0
1668584231286,CSE 293,003,119122,Berg-Kirkpatrick; Taylor D,9999,0,9999,0
1668584231286,CSE 293,004,119135,Christensen; Henrik I,9999,0,9999,0
1668584231286,CSE 293,005,119142,Cottrell; Garrison W,9999,0,9999,0
1668584231286,CSE 293,006,119146,Deutsch; Alin Bernard,9999,0,9999,0
1668584231286,CSE 293,007,119159,Esmaeilzadeh; Hadi,9999,0,9999,0
1668584231286,CSE 293,008,119166,Freund; Yoav,9999,0,9999,0
1668584231286,CSE 293,009,119170,Griswold; William G.,9999,0,9999,0
1668584231286,CSE 293,010,119183,Gymrek; Melissa Ann,9999,0,9999,0
1668584231286,CSE 293,011,119190,Heninger; Nadia A,9999,0,9999,0
1668584231286,CSE 293,012,119230,Impagliazzo; Russell,9999,0,9999,0
1668584231286,CSE 293,013,119232,Jhala; Ranjit,9999,0,9999,0
1668584231286,CSE 293,014,119233,Kahng; Andrew Byun,9999,0,9999,0
1668584231286,CSE 293,015,119298,Kane; Daniel Mertz,9999,0,9999,0
1668584231286,CSE 293,016,119299,Kriegman; David J,9999,0,9999,0
1668584231286,CSE 293,017,119300,Kumar; Arun Kumar,9999,0,9999,0
1668584231286,CSE 293,018,119301,Lerner; Sorin,9999,0,9999,0
1668584231286,CSE 293,019,119302,Lovett; Shachar,9999,0,9999,0
1668584231286,CSE 293,020,119303,McAuley; Julian John,9999,0,9999,0
1668584231286,CSE 293,021,119304,Micciancio; Daniele,9999,0,9999,0
1668584231286,CSE 293,022,119367,Orailoglu; Alex,9999,0,9999,0
1668584231286,CSE 293,023,119382,Paturi; Ramamohan,9999,0,9999,0
1668584231286,CSE 293,024,119404,Polikarpova; Nadezhda,9999,0,9999,0
1668584231286,CSE 293,025,119406,Politz; Joseph Gibbs,9999,0,9999,0
1668584231286,CSE 293,026,119411,Porter; George M,9999,0,9999,0
1668584231286,CSE 293,027,119414,Porter; Leonard Emerson,9999,0,9999,0
1668584231286,CSE 293,028,119416,Ramamoorthi; Ravi,9999,0,9999,0
1668584231286,CSE 293,029,119417,Sahoo; Debashis,9999,0,9999,0
1668584231286,CSE 293,030,119420,Saul; Lawrence,9999,0,9999,0
1668584231286,CSE 293,031,119421,Savage; Stefan,9999,0,9999,0
1668584231286,CSE 293,032,119425,Schulze; Jurgen P.,9999,0,9999,0
1668584231286,CSE 293,033,119426,Snoeren; Alex C.,9999,0,9999,0
1668584231286,CSE 293,034,119428,Shang; Jingbo,9999,0,9999,0
1668584231286,CSE 293,035,119430,Stefan; Deian,9999,0,9999,0
1668584231286,CSE 293,036,119431,Su; Hao,9999,0,9999,0
1668584231286,CSE 293,037,119433,Swanson; Steven James,9999,0,9999,0
1668584231286,CSE 293,038,119435,Tullsen; Dean Michael,9999,0,9999,0
1668584231286,CSE 293,039,119483,Voelker; Geoffrey M.,9999,0,9999,0
1668584231286,CSE 293,040,119537,Zhao; Jishen,9999,0,9999,0
1668584231286,CSE 293,041,119538,Zhou; Yuan-Yuan,9999,0,9999,0
1668584231286,CSE 293,042,119539,Gao; Sicun,9999,0,9999,0
1668584231286,CSE 293,043,119540,Weibel; Nadir,9999,0,9999,0
1668584231286,CSE 293,044,119541,Gupta; Rajesh K.,9999,0,9999,0
1668584231286,CSE 293,045,126410,Vaccaro; Kristen Marie,9999,0,9999,0
1668584231286,CSE 293,046,126411,Klemke; Richard,9999,0,9999,0
1668584231712,CSE 294,A00,102459,Voelker; Geoffrey M.,0,2,0,0
1668584231712,CSE 294,B00,111322,Orailoglu; Alex,0,2,0,0
1668584232135,DSE 201,A00,096914,Deutsch; Alin Bernard,30,0,30,0
1668584232561,DSE 210,A00,096915,Dasgupta; Sanjoy,30,0,30,0
1668584232987,DSE 241,A00,144528,Smith; Neil Gordon,30,0,30,0
1668584233409,DSE 260A,A00,096916,Altintas De Callaf; Ilkay,30,0,30,0
1668584233838,ECE 200,001,103586,Antipa; Nicholas A,9999,0,9999,0
1668584233838,ECE 200,002,103587,Atanasov; Nikolay A.,9999,0,9999,0
1668584233838,ECE 200,003,103588,Bharadia; Dinesh,9999,0,9999,0
1668584233838,ECE 200,004,103589,Cheng; Chung Kuan,9999,0,9999,0
1668584233838,ECE 200,005,103590,Cosman; Pamela C.,9999,0,9999,0
1668584233838,ECE 200,006,103591,Dayeh; Shadi Ahmad,9999,0,9999,0
1668584233838,ECE 200,007,103592,Fainman; Yeshaiahu,9999,0,9999,0
1668584233838,ECE 200,008,103593,Ford; Joseph Earl,9999,0,9999,0
1668584233838,ECE 200,009,103594,Franceschetti; Massimo,9999,0,9999,0
1668584233838,ECE 200,010,103595,Fullerton; Eric E,9999,0,9999,0
1668584233838,ECE 200,011,103596,Galton; Ian A,9999,0,9999,0
1668584233838,ECE 200,012,103597,Gilja; Vikash,9999,0,9999,0
1668584233838,ECE 200,013,103598,Hall; Drew A.,9999,0,9999,0
1668584233838,ECE 200,014,103599,Hsueh; Tzu-Chien,9999,0,9999,0
1668584233838,ECE 200,015,103600,Javidi; Tara,9999,0,9999,0
1668584233838,ECE 200,016,103601,Kahng; Andrew Byun,9999,0,9999,0
1668584233838,ECE 200,017,103602,Kim; Young-Han,9999,0,9999,0
1668584233838,ECE 200,018,103603,Koushanfar; Farinaz,9999,0,9999,0
1668584233838,ECE 200,019,103604,Kuzum; Duygu,9999,0,9999,0
1668584233838,ECE 200,020,103605,Le; Hanh-Phuc,9999,0,9999,0
1668584233838,ECE 200,021,103606,Lin; Bill,9999,0,9999,0
1668584233838,ECE 200,022,103607,Liu; Zhaowei,9998,0,9999,1
1668584233838,ECE 200,023,103608,Lo; Yu-Hwa,9999,0,9999,0
1668584233838,ECE 200,024,103609,Lomakin; Vitaliy,9999,0,9999,0
1668584233838,ECE 200,025,103610,Mercier; Patrick Philip,9999,0,9999,0
1668584233838,ECE 200,026,103611,Meyer; Florian,9999,0,9999,0
1668584233838,ECE 200,027,103612,Milstein; Laurence B.,9999,0,9999,0
1668584233838,ECE 200,028,103613,Mir Arabbaygi; Siavash,9999,0,9999,0
1668584233838,ECE 200,029,103614,Mookherjea; Shayan,9999,0,9999,0
1668584233838,ECE 200,030,103615,Morris; Karcher William,9999,0,9999,0
1668584233838,ECE 200,031,103616,Ng; Tse Nga,9999,0,9999,0
1668584233838,ECE 200,032,103617,Nguyen; Truong Quang,9999,0,9999,0
1668584233838,ECE 200,033,103618,Nomura; Kenji,9999,0,9999,0
1668584233838,ECE 200,034,103619,Orlitsky; Alon,9999,0,9999,0
1668584233838,ECE 200,035,103620,Pal; Piya,9999,0,9999,0
1668584233838,ECE 200,036,103621,Papen; George C.,9999,0,9999,0
1668584233838,ECE 200,037,103622,Radic; Stojan,9999,0,9999,0
1668584233838,ECE 200,038,103623,Rao; Bhaskar D.,9999,0,9999,0
1668584233838,ECE 200,039,103624,Rao; Ramesh R,9999,0,9999,0
1668584233838,ECE 200,040,103625,Rebeiz; Gabriel,9999,0,9999,0
1668584233838,ECE 200,041,103626,Sanford; John R,9999,0,9999,0
1668584233838,ECE 200,042,103627,Siegel; Paul H.,9999,0,9999,0
1668584233838,ECE 200,043,103628,Sievenpiper; Daniel F.,9999,0,9999,0
1668584233838,ECE 200,044,103629,Sworder; David D.,9999,0,9999,0
1668584233838,ECE 200,045,103630,Taur; Yuan,9999,0,9999,0
1668584233838,ECE 200,046,103631,Touri; Behrouz,9999,0,9999,0
1668584233838,ECE 200,047,103632,Trivedi; Mohan M.,9999,0,9999,0
1668584233838,ECE 200,048,103633,Vasconcelos; Nuno,9999,0,9999,0
1668584233838,ECE 200,049,103634,Wang; Xiaolong,9999,0,9999,0
1668584233838,ECE 200,050,103635,Xie; Pengtao,9999,0,9999,0
1668584233838,ECE 200,051,103636,Yip; Michael,9999,0,9999,0
1668584233838,ECE 200,052,103637,Zeger; Kenneth A.,999,0,999,0
1668584233838,ECE 200,053,103638,Zhang; Xinyu,9999,0,9999,0
1668584233838,ECE 200,054,103639,Turakhia; Yatish Girish,9999,0,9999,0
1668584233838,ECE 200,055,103640,Kang; Mingu,9999,0,9999,0
1668584233838,ECE 200,056,103641,Shi; Yuanyuan,9999,0,9999,0
1668584233838,ECE 200,057,103642,Wang; Edward Jay,9999,0,9999,0
1668584233838,ECE 200,058,103643,Zheng; Yang,9999,0,9999,0
1668584234266,ECE 202,A00,103644,Kuzum; Duygu,0,47,0,0
1668584234689,ECE 212BN,A00,103646,Ng; Tse Nga,0,10,0,0
1668584235115,ECE 221,A00,111493,Staff,0,0,0,0
1668584235541,ECE 222B,A00,103647,Lomakin; Vitaliy,0,22,0,0
1668584235965,ECE 230B,A00,103648,Taur; Yuan,0,4,0,0
1668584236398,ECE 238B,A00,103649,Garay; Javier,0,0,0,0
1668584236826,ECE 240B,A00,112900,Fainman; Yeshaiahu,0,8,0,0
1668584237250,ECE 247A,A00,103650,Jokerst; Jesse Vincent,0,6,0,0
1668584237674,ECE 247B,A00,103651,Wang; Joseph,0,14,0,0
1668584238112,ECE 250,A00,103652,Siegel; Paul H.,0,85,0,0
1668584238555,ECE 251A,A00,103654,Rao; Bhaskar D.,0,65,0,0
1668584238978,ECE 257B,A00,103655,Bharadia; Dinesh,0,33,0,0
1668584239402,ECE 258A,A00,103656,Milstein; Laurence B.,0,29,0,0
1668584239837,ECE 260B,A00,103658,Kang; Mingu,0,121,0,0
1668584240276,ECE 264A,A00,103659,Galton; Ian A,0,42,0,34
1668584240702,ECE 265A,A00,103661,Gudem; Prasad S.S.,0,42,0,36
1668584241133,ECE 265D,A00,103662,Gudem; Prasad S.S.,0,27,0,0
1668584241561,ECE 268,A00,103663,Koushanfar; Farinaz,0,44,0,0
1668584241993,ECE 269,A01,103665,Pal; Piya,0,223,0,0
1668584242421,ECE 271B,A00,103666,Vasconcelos; Manuela,0,80,0,0
1668584242860,ECE 276A,A00,103667,Atanasov; Nikolay A.,0,127,0,0
1668584243286,ECE 277,A00,103668,An; Cheolhong,0,151,0,0
1668584243716,ECE 279,A00,117947,Hall; Drew A.,0,22,0,0
1668584244569,ECE 283,A00,103670,Hsueh; Tzu-Chien,0,57,0,0
1668584244994,ECE 284,A00,103671,Turakhia; Yatish Girish,0,40,0,0
1668584245429,ECE 285,A00,103672,Zheng; Yang,0,40,0,0
1668584245429,ECE 285,B00,103673,Sworder; David D.,0,61,0,0
1668584245858,ECE 287,A00,103676,Javidi; Tara,0,7,0,0
1668584246283,MATH 200B,A00,098023,Salehi Golsefidy; Alireza,7,0,15,8
1668584246706,MATH 202B,A00,098024,Rhoades; Brendon Patrick,7,0,15,8
1668584247133,MATH 203B,A00,098025,Oprea; Dragos N.,9,0,15,6
1668584247555,MATH 204B,A00,098026,Sorensen; Claus M,13,0,15,2
1668584247990,MATH 208,A00,098027,Izadi; Elham,7,0,10,3
1668584248425,MATH 209,A00,098028,Pollack; Aaron,10,0,10,0
1668584248863,MATH 211A,A00,112919,Rogalski; Daniel,8,0,10,2
1668584249287,MATH 211B,A00,112920,Seward; Brandon M.,9,0,10,1
1668584249711,MATH 218,A00,098029,Li; Bo,10,0,10,0
1668584250133,MATH 220B,A00,098030,Novak; Jonathan I,10,0,15,5
1668584250582,MATH 221A,A00,098031,Ebenfelt; Peter F,12,0,15,3
1668584251013,MATH 231B,A00,098032,Zlatos; Andrej,9,0,15,6
1668584251437,MATH 240B,A00,098033,Ni; Lei,7,0,15,8
1668584251859,MATH 243,A00,098034,Jekel; David Andrew,10,0,10,0
1668584252285,MATH 245A,A00,098035,Nie; Jiawang,0,7,15,18
1668584252707,MATH 248,A00,098036,Bejenaru; Ioan,10,0,10,0
1668584253133,MATH 250B,A00,098037,Spolaor; Luca,12,0,15,3
1668584253559,MATH 258,A00,098038,Ni; Lei,8,0,10,2
1668584253990,MATH 264B,A00,098041,Rhoades; Brendon Patrick,6,0,15,9
1668584254422,MATH 268,A00,098042,Buss; Samuel R,10,0,10,0
1668584254852,MATH 269,A00,098043,Rhoades; Brendon Patrick,10,0,10,0
1668584255275,MATH 270B,A00,098044,Li; Bo,6,0,15,9
1668584255698,MATH 272B,A00,098045,Holst; Michael J,13,0,15,2
1668584256123,MATH 273A,A00,098046,Tian; Xiaochuan,10,0,15,5
1668584256547,MATH 275,A01,098048,Tian; Xiaochuan,6,0,10,4
1668584256973,MATH 278A,A00,098049,Holst; Michael J,6,0,10,4
1668584257397,MATH 278B,A00,098050,Cloninger; Alexander,10,0,10,0
1668584257821,MATH 278C,A00,098051,Nie; Jiawang,5,0,10,5
1668584258245,MATH 280B,A00,098052,Zheng; Tianyi,6,0,15,9
1668584258671,MATH 281B,A00,098053,Bradic; Jelena,0,2,15,15
1668584259105,MATH 282B,A00,098054,Arias-Castro; Ery,0,1,15,15
1668584259530,MATH 285,A00,098055,Fitzsimmons; Patrick J,0,4,15,16
1668584259954,MATH 287B,A00,098056,Arias-Castro; Ery,1,0,15,14
1668584260380,MATH 288,A00,098057,Agarwal; Pooja,9,0,10,1
1668584260380,MATH 288,B00,098058,Zhang; Danna,8,0,10,2
1668584260380,MATH 288,C00,098059,Williams; Ruth J,9,0,10,1
1668584260803,MATH 290B,A00,098060,Roberts; Justin Deritter,12,0,15,3
1668584261226,MATH 292,A00,098061,Belmont; Eva Kinoshita,10,0,10,0
1668584261652,MATH 295,A00,098062,Suk; Andrew Hoon,47,0,50,3
1668584262076,MATH 296,A00,098063,Novak; Jonathan I,20,0,20,0
1668584262499,MATH 297,001,098064,Gamst; Anthony Collins,9997,0,9999,2
1668584764882,COGS 205,A00,101395,Chiba; Andrea,19,0,20,1
1668584765308,COGS 210B,001,101404,Greene; Deanna Jacquelyn,9998,0,9999,1
1668584765308,COGS 210B,002,101417,Xia; Haijun,9999,0,9999,0
1668584765308,COGS 210B,003,101422,Nitz; Douglas A.,9999,0,9999,0
1668584765308,COGS 210B,004,101423,Hollan; James D.,9998,0,9999,1
1668584765308,COGS 210B,005,101424,Deak; Gedeon O.,9998,0,9999,1
1668584765308,COGS 210B,006,101425,Rossano; Federico,9999,0,9999,0
1668584765729,COGS 211B,A00,101427,Coulson; Seana M,9996,0,9999,3
1668584766152,COGS 220,A00,101428,Hollan; James D.,0,17,25,25
1668584766575,COGS 229,A00,101429,Dow; Steven P,17,0,25,8
1668584766998,COGS 230,A00,101430,Klemmer; Scott R,6,0,17,11
1668584767425,COGS 234,A00,101431,Xia; Haijun,0,1,25,25
1668584767851,COGS 260,A00,101432,Kiyonaga; Anastasia,21,0,25,4
1668584767851,COGS 260,B00,101433,Kirsh; David Joel,15,0,25,10
1668584768278,CSE 202,A00,102371,Impagliazzo; Russell,0,70,0,0
1668584768704,CSE 203B,A01,102373,Cheng; Chung Kuan,0,70,0,0
1668584769127,CSE 208,A00,102374,Micciancio; Daniele,0,5,0,0
1668584769551,CSE 209A,A00,112895,Impagliazzo; Russell,0,14,15,15
1668584769979,CSE 209B,A00,108005,Bellare; Mihir,0,7,0,0
1668584770401,CSE 210,A00,113163,Coblenz; Michael J,0,96,0,0
1668584770826,CSE 219,A00,106111,Dow; Steven P,0,8,20,20
1668584771250,CSE 221,A00,102376,Voelker; Geoffrey M.,0,77,0,0
1668584771676,CSE 224,A01,102378,Porter; George M,0,180,0,0
1668584772102,CSE 229A,A00,102379,Savage; Stefan,0,14,0,0
1668584772524,CSE 229C,A00,102380,Munyaka; Imani N. S.,0,12,0,0
1668584772948,CSE 232B,A00,102382,Deutsch; Alin Bernard,0,39,0,0
1668584773377,CSE 234,A01,112904,Kumar; Arun Kumar,0,0,0,0
1668584773803,CSE 237A,A00,102383,Rosing; Tajana Simunic,0,57,0,0
1668584774227,CSE 239A,A00,102384,Deutsch; Alin Bernard,0,18,0,0
1668584774653,CSE 239B,A00,102385,Polikarpova; Nadezhda,0,11,0,0
1668584775076,CSE 240A,A00,102386,Pannuto; Patrick William,0,49,0,0
1668584775499,CSE 240B,A00,102387,Zhao; Jishen,0,51,0,0
1668584775921,CSE 241A,A00,106406,Kang; Mingu,0,9,0,0
1668584776346,CSE 249B,A00,102388,Kahng; Andrew Byun,0,7,8,8
1668584776773,CSE 251B,A01,102392,Cottrell; Garrison W,0,54,0,0
1668584776773,CSE 251B,A02,102393,Cottrell; Garrison W,0,36,0,0
1668584777206,CSE 252B,A00,102394,Ochoa; Benjamin Lawrence,0,64,0,0
1668584777645,CSE 257,A01,102396,Gao; Sicun,0,160,0,0
1668584778072,CSE 272,A00,102397,Li; Tzumao,0,22,0,0
1668584778495,CSE 274,A00,111323,Chern; Albert Ren-Haur,0,16,0,0
1668584778917,CSE 282,A00,102398,Pevzner; Pavel Arkadjevich,0,0,0,0
1668584779346,CSE 284,A00,114175,Gymrek; Melissa Ann,0,33,0,0
1668584779769,CSE 290,A00,102399,Chandraker; Manmohan Krishna,0,11,0,0
1668584779769,CSE 290,B00,102400,Vaccaro; Kristen Marie,0,10,25,25
1668584779769,CSE 290,C00,102414,Pannuto; Patrick William,0,1,25,25
1668584779769,CSE 290,D00,102427,Pevzner; Pavel Arkadjevich,0,0,0,0
1668584779769,CSE 290,E00,102429,Zhao; Jishen,0,6,0,0
1668584779769,CSE 290,F00,102436,Tullsen; Dean Michael,0,6,0,0
1668584779769,CSE 290,G00,102440,Christensen; Henrik I,0,8,20,20
1668584780198,CSE 291,A00,102443,Su; Hao,0,0,0,0
1668584780198,CSE 291,B00,102448,Polikarpova; Nadezhda,0,0,0,0
1668584780198,CSE 291,C00,102453,Vaccaro; Kristen Marie,0,0,0,0
1668584780198,CSE 291,D00,111343,Savage; Stefan,0,0,0,0
1668584780198,CSE 291,E00,116474,Claffy; Kimberly Claire,0,0,0,0
1668584780198,CSE 291,F00,116479,Pasquale; Joseph,0,0,0,0
1668584780633,CSE 293,001,119111,Bafna; Vineet,9999,0,9999,0
1668584780633,CSE 293,002,119118,Bellare; Mihir,9999,0,9999,0
1668584780633,CSE 293,003,119122,Berg-Kirkpatrick; Taylor D,9999,0,9999,0
1668584780633,CSE 293,004,119135,Christensen; Henrik I,9999,0,9999,0
1668584780633,CSE 293,005,119142,Cottrell; Garrison W,9999,0,9999,0
1668584780633,CSE 293,006,119146,Deutsch; Alin Bernard,9999,0,9999,0
1668584780633,CSE 293,007,119159,Esmaeilzadeh; Hadi,9999,0,9999,0
1668584780633,CSE 293,008,119166,Freund; Yoav,9999,0,9999,0
1668584780633,CSE 293,009,119170,Griswold; William G.,9999,0,9999,0
1668584780633,CSE 293,010,119183,Gymrek; Melissa Ann,9999,0,9999,0
1668584780633,CSE 293,011,119190,Heninger; Nadia A,9999,0,9999,0
1668584780633,CSE 293,012,119230,Impagliazzo; Russell,9999,0,9999,0
1668584780633,CSE 293,013,119232,Jhala; Ranjit,9999,0,9999,0
1668584780633,CSE 293,014,119233,Kahng; Andrew Byun,9999,0,9999,0
1668584780633,CSE 293,015,119298,Kane; Daniel Mertz,9999,0,9999,0
1668584780633,CSE 293,016,119299,Kriegman; David J,9999,0,9999,0
1668584780633,CSE 293,017,119300,Kumar; Arun Kumar,9999,0,9999,0
1668584780633,CSE 293,018,119301,Lerner; Sorin,9999,0,9999,0
1668584780633,CSE 293,019,119302,Lovett; Shachar,9999,0,9999,0
1668584780633,CSE 293,020,119303,McAuley; Julian John,9999,0,9999,0
1668584780633,CSE 293,021,119304,Micciancio; Daniele,9999,0,9999,0
1668584780633,CSE 293,022,119367,Orailoglu; Alex,9999,0,9999,0
1668584780633,CSE 293,023,119382,Paturi; Ramamohan,9999,0,9999,0
1668584780633,CSE 293,024,119404,Polikarpova; Nadezhda,9999,0,9999,0
1668584780633,CSE 293,025,119406,Politz; Joseph Gibbs,9999,0,9999,0
1668584780633,CSE 293,026,119411,Porter; George M,9999,0,9999,0
1668584780633,CSE 293,027,119414,Porter; Leonard Emerson,9999,0,9999,0
1668584780633,CSE 293,028,119416,Ramamoorthi; Ravi,9999,0,9999,0
1668584780633,CSE 293,029,119417,Sahoo; Debashis,9999,0,9999,0
1668584780633,CSE 293,030,119420,Saul; Lawrence,9999,0,9999,0
1668584780633,CSE 293,031,119421,Savage; Stefan,9999,0,9999,0
1668584780633,CSE 293,032,119425,Schulze; Jurgen P.,9999,0,9999,0
1668584780633,CSE 293,033,119426,Snoeren; Alex C.,9999,0,9999,0
1668584780633,CSE 293,034,119428,Shang; Jingbo,9999,0,9999,0
1668584780633,CSE 293,035,119430,Stefan; Deian,9999,0,9999,0
1668584780633,CSE 293,036,119431,Su; Hao,9999,0,9999,0
1668584780633,CSE 293,037,119433,Swanson; Steven James,9999,0,9999,0
1668584780633,CSE 293,038,119435,Tullsen; Dean Michael,9999,0,9999,0
1668584780633,CSE 293,039,119483,Voelker; Geoffrey M.,9999,0,9999,0
1668584780633,CSE 293,040,119537,Zhao; Jishen,9999,0,9999,0
1668584780633,CSE 293,041,119538,Zhou; Yuan-Yuan,9999,0,9999,0
1668584780633,CSE 293,042,119539,Gao; Sicun,9999,0,9999,0
1668584780633,CSE 293,043,119540,Weibel; Nadir,9999,0,9999,0
1668584780633,CSE 293,044,119541,Gupta; Rajesh K.,9999,0,9999,0
1668584780633,CSE 293,045,126410,Vaccaro; Kristen Marie,9999,0,9999,0
1668584780633,CSE 293,046,126411,Klemke; Richard,9999,0,9999,0
1668584781059,CSE 294,A00,102459,Voelker; Geoffrey M.,0,2,0,0
1668584781059,CSE 294,B00,111322,Orailoglu; Alex,0,2,0,0
1668584781483,DSE 201,A00,096914,Deutsch; Alin Bernard,30,0,30,0
1668584781906,DSE 210,A00,096915,Dasgupta; Sanjoy,30,0,30,0
1668584782332,DSE 241,A00,144528,Smith; Neil Gordon,30,0,30,0
1668584782756,DSE 260A,A00,096916,Altintas De Callaf; Ilkay,30,0,30,0
1668584783184,ECE 200,001,103586,Antipa; Nicholas A,9999,0,9999,0
1668584783184,ECE 200,002,103587,Atanasov; Nikolay A.,9999,0,9999,0
1668584783184,ECE 200,003,103588,Bharadia; Dinesh,9999,0,9999,0
1668584783184,ECE 200,004,103589,Cheng; Chung Kuan,9999,0,9999,0
1668584783184,ECE 200,005,103590,Cosman; Pamela C.,9999,0,9999,0
1668584783184,ECE 200,006,103591,Dayeh; Shadi Ahmad,9999,0,9999,0
1668584783184,ECE 200,007,103592,Fainman; Yeshaiahu,9999,0,9999,0
1668584783184,ECE 200,008,103593,Ford; Joseph Earl,9999,0,9999,0
1668584783184,ECE 200,009,103594,Franceschetti; Massimo,9999,0,9999,0
1668584783184,ECE 200,010,103595,Fullerton; Eric E,9999,0,9999,0
1668584783184,ECE 200,011,103596,Galton; Ian A,9999,0,9999,0
1668584783184,ECE 200,012,103597,Gilja; Vikash,9999,0,9999,0
1668584783184,ECE 200,013,103598,Hall; Drew A.,9999,0,9999,0
1668584783184,ECE 200,014,103599,Hsueh; Tzu-Chien,9999,0,9999,0
1668584783184,ECE 200,015,103600,Javidi; Tara,9999,0,9999,0
1668584783184,ECE 200,016,103601,Kahng; Andrew Byun,9999,0,9999,0
1668584783184,ECE 200,017,103602,Kim; Young-Han,9999,0,9999,0
1668584783184,ECE 200,018,103603,Koushanfar; Farinaz,9999,0,9999,0
1668584783184,ECE 200,019,103604,Kuzum; Duygu,9999,0,9999,0
1668584783184,ECE 200,020,103605,Le; Hanh-Phuc,9999,0,9999,0
1668584783184,ECE 200,021,103606,Lin; Bill,9999,0,9999,0
1668584783184,ECE 200,022,103607,Liu; Zhaowei,9998,0,9999,1
1668584783184,ECE 200,023,103608,Lo; Yu-Hwa,9999,0,9999,0
1668584783184,ECE 200,024,103609,Lomakin; Vitaliy,9999,0,9999,0
1668584783184,ECE 200,025,103610,Mercier; Patrick Philip,9999,0,9999,0
1668584783184,ECE 200,026,103611,Meyer; Florian,9999,0,9999,0
1668584783184,ECE 200,027,103612,Milstein; Laurence B.,9999,0,9999,0
1668584783184,ECE 200,028,103613,Mir Arabbaygi; Siavash,9999,0,9999,0
1668584783184,ECE 200,029,103614,Mookherjea; Shayan,9999,0,9999,0
1668584783184,ECE 200,030,103615,Morris; Karcher William,9999,0,9999,0
1668584783184,ECE 200,031,103616,Ng; Tse Nga,9999,0,9999,0
1668584783184,ECE 200,032,103617,Nguyen; Truong Quang,9999,0,9999,0
1668584783184,ECE 200,033,103618,Nomura; Kenji,9999,0,9999,0
1668584783184,ECE 200,034,103619,Orlitsky; Alon,9999,0,9999,0
1668584783184,ECE 200,035,103620,Pal; Piya,9999,0,9999,0
1668584783184,ECE 200,036,103621,Papen; George C.,9999,0,9999,0
1668584783184,ECE 200,037,103622,Radic; Stojan,9999,0,9999,0
1668584783184,ECE 200,038,103623,Rao; Bhaskar D.,9999,0,9999,0
1668584783184,ECE 200,039,103624,Rao; Ramesh R,9999,0,9999,0
1668584783184,ECE 200,040,103625,Rebeiz; Gabriel,9999,0,9999,0
1668584783184,ECE 200,041,103626,Sanford; John R,9999,0,9999,0
1668584783184,ECE 200,042,103627,Siegel; Paul H.,9999,0,9999,0
1668584783184,ECE 200,043,103628,Sievenpiper; Daniel F.,9999,0,9999,0
1668584783184,ECE 200,044,103629,Sworder; David D.,9999,0,9999,0
1668584783184,ECE 200,045,103630,Taur; Yuan,9999,0,9999,0
1668584783184,ECE 200,046,103631,Touri; Behrouz,9999,0,9999,0
1668584783184,ECE 200,047,103632,Trivedi; Mohan M.,9999,0,9999,0
1668584783184,ECE 200,048,103633,Vasconcelos; Nuno,9999,0,9999,0
1668584783184,ECE 200,049,103634,Wang; Xiaolong,9999,0,9999,0
1668584783184,ECE 200,050,103635,Xie; Pengtao,9999,0,9999,0
1668584783184,ECE 200,051,103636,Yip; Michael,9999,0,9999,0
1668584783184,ECE 200,052,103637,Zeger; Kenneth A.,999,0,999,0
1668584783184,ECE 200,053,103638,Zhang; Xinyu,9999,0,9999,0
1668584783184,ECE 200,054,103639,Turakhia; Yatish Girish,9999,0,9999,0
1668584783184,ECE 200,055,103640,Kang; Mingu,9999,0,9999,0
1668584783184,ECE 200,056,103641,Shi; Yuanyuan,9999,0,9999,0
1668584783184,ECE 200,057,103642,Wang; Edward Jay,9999,0,9999,0
1668584783184,ECE 200,058,103643,Zheng; Yang,9999,0,9999,0
1668584783613,ECE 202,A00,103644,Kuzum; Duygu,0,47,0,0
1668584784036,ECE 212BN,A00,103646,Ng; Tse Nga,0,10,0,0
1668584784461,ECE 221,A00,111493,Staff,0,0,0,0
1668584784886,ECE 222B,A00,103647,Lomakin; Vitaliy,0,22,0,0
1668584785311,ECE 230B,A00,103648,Taur; Yuan,0,4,0,0
1668584785738,ECE 238B,A00,103649,Garay; Javier,0,0,0,0
1668584786166,ECE 240B,A00,112900,Fainman; Yeshaiahu,0,8,0,0
1668584786589,ECE 247A,A00,103650,Jokerst; Jesse Vincent,0,6,0,0
1668584787012,ECE 247B,A00,103651,Wang; Joseph,0,14,0,0
1668584787436,ECE 250,A00,103652,Siegel; Paul H.,0,85,0,0
1668584787863,ECE 251A,A00,103654,Rao; Bhaskar D.,0,65,0,0
1668584788285,ECE 257B,A00,103655,Bharadia; Dinesh,0,33,0,0
1668584788710,ECE 258A,A00,103656,Milstein; Laurence B.,0,29,0,0
1668584789133,ECE 260B,A00,103658,Kang; Mingu,0,121,0,0
1668584789556,ECE 264A,A00,103659,Galton; Ian A,0,42,0,34
1668584789983,ECE 265A,A00,103661,Gudem; Prasad S.S.,0,42,0,36
1668584790484,ECE 265D,A00,103662,Gudem; Prasad S.S.,0,27,0,0
1668584790910,ECE 268,A00,103663,Koushanfar; Farinaz,0,44,0,0
1668584791332,ECE 269,A01,103665,Pal; Piya,0,223,0,0
1668584791756,ECE 271B,A00,103666,Vasconcelos; Manuela,0,80,0,0
1668584792191,ECE 276A,A00,103667,Atanasov; Nikolay A.,0,127,0,0
1668584792620,ECE 277,A00,103668,An; Cheolhong,0,151,0,0
1668584793045,ECE 279,A00,117947,Hall; Drew A.,0,22,0,0
1668584793915,ECE 283,A00,103670,Hsueh; Tzu-Chien,0,57,0,0
1668584794338,ECE 284,A00,103671,Turakhia; Yatish Girish,0,40,0,0
1668584794762,ECE 285,A00,103672,Zheng; Yang,0,40,0,0
1668584794762,ECE 285,B00,103673,Sworder; David D.,0,61,0,0
1668584795190,ECE 287,A00,103676,Javidi; Tara,0,7,0,0
1668584795618,MATH 200B,A00,098023,Salehi Golsefidy; Alireza,7,0,15,8
1668584796042,MATH 202B,A00,098024,Rhoades; Brendon Patrick,7,0,15,8
1668584796467,MATH 203B,A00,098025,Oprea; Dragos N.,9,0,15,6
1668584796892,MATH 204B,A00,098026,Sorensen; Claus M,13,0,15,2
1668584797314,MATH 208,A00,098027,Izadi; Elham,7,0,10,3
1668584797738,MATH 209,A00,098028,Pollack; Aaron,10,0,10,0
1668584798160,MATH 211A,A00,112919,Rogalski; Daniel,8,0,10,2
1668584798592,MATH 211B,A00,112920,Seward; Brandon M.,9,0,10,1
1668584799017,MATH 218,A00,098029,Li; Bo,10,0,10,0
1668584799447,MATH 220B,A00,098030,Novak; Jonathan I,10,0,15,5
1668584799876,MATH 221A,A00,098031,Ebenfelt; Peter F,12,0,15,3
1668584800302,MATH 231B,A00,098032,Zlatos; Andrej,9,0,15,6
1668584800725,MATH 240B,A00,098033,Ni; Lei,7,0,15,8
1668584801150,MATH 243,A00,098034,Jekel; David Andrew,10,0,10,0
1668584801580,MATH 245A,A00,098035,Nie; Jiawang,0,7,15,18
1668584802011,MATH 248,A00,098036,Bejenaru; Ioan,10,0,10,0
1668584802435,MATH 250B,A00,098037,Spolaor; Luca,12,0,15,3
1668584802859,MATH 258,A00,098038,Ni; Lei,8,0,10,2
1668584803287,MATH 264B,A00,098041,Rhoades; Brendon Patrick,6,0,15,9
1668584803709,MATH 268,A00,098042,Buss; Samuel R,10,0,10,0
1668584804135,MATH 269,A00,098043,Rhoades; Brendon Patrick,10,0,10,0
1668584804571,MATH 270B,A00,098044,Li; Bo,6,0,15,9
1668584804997,MATH 272B,A00,098045,Holst; Michael J,13,0,15,2
1668584805424,MATH 273A,A00,098046,Tian; Xiaochuan,10,0,15,5
1668584805848,MATH 275,A01,098048,Tian; Xiaochuan,6,0,10,4
1668584806282,MATH 278A,A00,098049,Holst; Michael J,6,0,10,4
1668584806707,MATH 278B,A00,098050,Cloninger; Alexander,10,0,10,0
1668584807131,MATH 278C,A00,098051,Nie; Jiawang,5,0,10,5
1668584807555,MATH 280B,A00,098052,Zheng; Tianyi,6,0,15,9
1668584807989,MATH 281B,A00,098053,Bradic; Jelena,0,2,15,15
1668584808414,MATH 282B,A00,098054,Arias-Castro; Ery,0,1,15,15
1668584808840,MATH 285,A00,098055,Fitzsimmons; Patrick J,0,4,15,16
1668584809269,MATH 287B,A00,098056,Arias-Castro; Ery,1,0,15,14
1668584809691,MATH 288,A00,098057,Agarwal; Pooja,9,0,10,1
1668584809691,MATH 288,B00,098058,Zhang; Danna,8,0,10,2
1668584809691,MATH 288,C00,098059,Williams; Ruth J,9,0,10,1
1668584810115,MATH 290B,A00,098060,Roberts; Justin Deritter,12,0,15,3
1668584810550,MATH 292,A00,098061,Belmont; Eva Kinoshita,10,0,10,0
1668584810974,MATH 295,A00,098062,Suk; Andrew Hoon,47,0,50,3
1668584811410,MATH 296,A00,098063,Novak; Jonathan I,20,0,20,0
1668584811836,MATH 297,001,098064,Gamst; Anthony Collins,9997,0,9999,2
1668585313691,COGS 205,A00,101395,Chiba; Andrea,19,0,20,1
1668585314116,COGS 210B,001,101404,Greene; Deanna Jacquelyn,9998,0,9999,1
1668585314116,COGS 210B,002,101417,Xia; Haijun,9999,0,9999,0
1668585314116,COGS 210B,003,101422,Nitz; Douglas A.,9999,0,9999,0
1668585314116,COGS 210B,004,101423,Hollan; James D.,9998,0,9999,1
1668585314116,COGS 210B,005,101424,Deak; Gedeon O.,9998,0,9999,1
1668585314116,COGS 210B,006,101425,Rossano; Federico,9999,0,9999,0
1668585314539,COGS 211B,A00,101427,Coulson; Seana M,9996,0,9999,3
1668585314961,COGS 220,A00,101428,Hollan; James D.,0,17,25,25
1668585315387,COGS 229,A00,101429,Dow; Steven P,17,0,25,8
1668585315814,COGS 230,A00,101430,Klemmer; Scott R,6,0,17,11
1668585316241,COGS 234,A00,101431,Xia; Haijun,0,1,25,25
1668585316667,COGS 260,A00,101432,Kiyonaga; Anastasia,21,0,25,4
1668585316667,COGS 260,B00,101433,Kirsh; David Joel,15,0,25,10
1668585317090,CSE 202,A00,102371,Impagliazzo; Russell,0,70,0,0
1668585317518,CSE 203B,A01,102373,Cheng; Chung Kuan,0,70,0,0
1668585317971,CSE 208,A00,102374,Micciancio; Daniele,0,5,0,0
1668585318394,CSE 209A,A00,112895,Impagliazzo; Russell,0,14,15,15
1668585318818,CSE 209B,A00,108005,Bellare; Mihir,0,7,0,0
1668585319242,CSE 210,A00,113163,Coblenz; Michael J,0,96,0,0
1668585319668,CSE 219,A00,106111,Dow; Steven P,0,8,20,20
1668585320096,CSE 221,A00,102376,Voelker; Geoffrey M.,0,77,0,0
1668585320522,CSE 224,A01,102378,Porter; George M,0,180,0,0
1668585320945,CSE 229A,A00,102379,Savage; Stefan,0,14,0,0
1668585321370,CSE 229C,A00,102380,Munyaka; Imani N. S.,0,12,0,0
1668585321794,CSE 232B,A00,102382,Deutsch; Alin Bernard,0,39,0,0
1668585322231,CSE 234,A01,112904,Kumar; Arun Kumar,0,0,0,0
1668585322654,CSE 237A,A00,102383,Rosing; Tajana Simunic,0,57,0,0
1668585323077,CSE 239A,A00,102384,Deutsch; Alin Bernard,0,18,0,0
1668585323503,CSE 239B,A00,102385,Polikarpova; Nadezhda,0,11,0,0
1668585323928,CSE 240A,A00,102386,Pannuto; Patrick William,0,49,0,0
1668585324362,CSE 240B,A00,102387,Zhao; Jishen,0,51,0,0
1668585324792,CSE 241A,A00,106406,Kang; Mingu,0,9,0,0
1668585325227,CSE 249B,A00,102388,Kahng; Andrew Byun,0,7,8,8
1668585325655,CSE 251B,A01,102392,Cottrell; Garrison W,0,54,0,0
1668585325655,CSE 251B,A02,102393,Cottrell; Garrison W,0,36,0,0
1668585326080,CSE 252B,A00,102394,Ochoa; Benjamin Lawrence,0,64,0,0
1668585326501,CSE 257,A01,102396,Gao; Sicun,0,160,0,0
1668585326926,CSE 272,A00,102397,Li; Tzumao,0,22,0,0
1668585327354,CSE 274,A00,111323,Chern; Albert Ren-Haur,0,16,0,0
1668585327778,CSE 282,A00,102398,Pevzner; Pavel Arkadjevich,0,0,0,0
1668585328202,CSE 284,A00,114175,Gymrek; Melissa Ann,0,33,0,0
1668585328637,CSE 290,A00,102399,Chandraker; Manmohan Krishna,0,11,0,0
1668585328637,CSE 290,B00,102400,Vaccaro; Kristen Marie,0,10,25,25
1668585328637,CSE 290,C00,102414,Pannuto; Patrick William,0,1,25,25
1668585328637,CSE 290,D00,102427,Pevzner; Pavel Arkadjevich,0,0,0,0
1668585328637,CSE 290,E00,102429,Zhao; Jishen,0,6,0,0
1668585328637,CSE 290,F00,102436,Tullsen; Dean Michael,0,6,0,0
1668585328637,CSE 290,G00,102440,Christensen; Henrik I,0,8,20,20
1668585329075,CSE 291,A00,102443,Su; Hao,0,0,0,0
1668585329075,CSE 291,B00,102448,Polikarpova; Nadezhda,0,0,0,0
1668585329075,CSE 291,C00,102453,Vaccaro; Kristen Marie,0,0,0,0
1668585329075,CSE 291,D00,111343,Savage; Stefan,0,0,0,0
1668585329075,CSE 291,E00,116474,Claffy; Kimberly Claire,0,0,0,0
1668585329075,CSE 291,F00,116479,Pasquale; Joseph,0,0,0,0
1668585329502,CSE 293,001,119111,Bafna; Vineet,9999,0,9999,0
1668585329502,CSE 293,002,119118,Bellare; Mihir,9999,0,9999,0
1668585329502,CSE 293,003,119122,Berg-Kirkpatrick; Taylor D,9999,0,9999,0
1668585329502,CSE 293,004,119135,Christensen; Henrik I,9999,0,9999,0
1668585329502,CSE 293,005,119142,Cottrell; Garrison W,9999,0,9999,0
1668585329502,CSE 293,006,119146,Deutsch; Alin Bernard,9999,0,9999,0
1668585329502,CSE 293,007,119159,Esmaeilzadeh; Hadi,9999,0,9999,0
1668585329502,CSE 293,008,119166,Freund; Yoav,9999,0,9999,0
1668585329502,CSE 293,009,119170,Griswold; William G.,9999,0,9999,0
1668585329502,CSE 293,010,119183,Gymrek; Melissa Ann,9999,0,9999,0
1668585329502,CSE 293,011,119190,Heninger; Nadia A,9999,0,9999,0
1668585329502,CSE 293,012,119230,Impagliazzo; Russell,9999,0,9999,0
1668585329502,CSE 293,013,119232,Jhala; Ranjit,9999,0,9999,0
1668585329502,CSE 293,014,119233,Kahng; Andrew Byun,9999,0,9999,0
1668585329502,CSE 293,015,119298,Kane; Daniel Mertz,9999,0,9999,0
1668585329502,CSE 293,016,119299,Kriegman; David J,9999,0,9999,0
1668585329502,CSE 293,017,119300,Kumar; Arun Kumar,9999,0,9999,0
1668585329502,CSE 293,018,119301,Lerner; Sorin,9999,0,9999,0
1668585329502,CSE 293,019,119302,Lovett; Shachar,9999,0,9999,0
1668585329502,CSE 293,020,119303,McAuley; Julian John,9999,0,9999,0
1668585329502,CSE 293,021,119304,Micciancio; Daniele,9999,0,9999,0
1668585329502,CSE 293,022,119367,Orailoglu; Alex,9999,0,9999,0
1668585329502,CSE 293,023,119382,Paturi; Ramamohan,9999,0,9999,0
1668585329502,CSE 293,024,119404,Polikarpova; Nadezhda,9999,0,9999,0
1668585329502,CSE 293,025,119406,Politz; Joseph Gibbs,9999,0,9999,0
1668585329502,CSE 293,026,119411,Porter; George M,9999,0,9999,0
1668585329502,CSE 293,027,119414,Porter; Leonard Emerson,9999,0,9999,0
1668585329502,CSE 293,028,119416,Ramamoorthi; Ravi,9999,0,9999,0
1668585329502,CSE 293,029,119417,Sahoo; Debashis,9999,0,9999,0
1668585329502,CSE 293,030,119420,Saul; Lawrence,9999,0,9999,0
1668585329502,CSE 293,031,119421,Savage; Stefan,9999,0,9999,0
1668585329502,CSE 293,032,119425,Schulze; Jurgen P.,9999,0,9999,0
1668585329502,CSE 293,033,119426,Snoeren; Alex C.,9999,0,9999,0
1668585329502,CSE 293,034,119428,Shang; Jingbo,9999,0,9999,0
1668585329502,CSE 293,035,119430,Stefan; Deian,9999,0,9999,0
1668585329502,CSE 293,036,119431,Su; Hao,9999,0,9999,0
1668585329502,CSE 293,037,119433,Swanson; Steven James,9999,0,9999,0
1668585329502,CSE 293,038,119435,Tullsen; Dean Michael,9999,0,9999,0
1668585329502,CSE 293,039,119483,Voelker; Geoffrey M.,9999,0,9999,0
1668585329502,CSE 293,040,119537,Zhao; Jishen,9999,0,9999,0
1668585329502,CSE 293,041,119538,Zhou; Yuan-Yuan,9999,0,9999,0
1668585329502,CSE 293,042,119539,Gao; Sicun,9999,0,9999,0
1668585329502,CSE 293,043,119540,Weibel; Nadir,9999,0,9999,0
1668585329502,CSE 293,044,119541,Gupta; Rajesh K.,9999,0,9999,0
1668585329502,CSE 293,045,126410,Vaccaro; Kristen Marie,9999,0,9999,0
1668585329502,CSE 293,046,126411,Klemke; Richard,9999,0,9999,0
1668585329928,CSE 294,A00,102459,Voelker; Geoffrey M.,0,2,0,0
1668585329928,CSE 294,B00,111322,Orailoglu; Alex,0,2,0,0
1668585330354,DSE 201,A00,096914,Deutsch; Alin Bernard,30,0,30,0
1668585330780,DSE 210,A00,096915,Dasgupta; Sanjoy,30,0,30,0
1668585331206,DSE 241,A00,144528,Smith; Neil Gordon,30,0,30,0
1668585331632,DSE 260A,A00,096916,Altintas De Callaf; Ilkay,30,0,30,0
1668585332068,ECE 200,001,103586,Antipa; Nicholas A,9999,0,9999,0
1668585332068,ECE 200,002,103587,Atanasov; Nikolay A.,9999,0,9999,0
1668585332068,ECE 200,003,103588,Bharadia; Dinesh,9999,0,9999,0
1668585332068,ECE 200,004,103589,Cheng; Chung Kuan,9999,0,9999,0
1668585332068,ECE 200,005,103590,Cosman; Pamela C.,9999,0,9999,0
1668585332068,ECE 200,006,103591,Dayeh; Shadi Ahmad,9999,0,9999,0
1668585332068,ECE 200,007,103592,Fainman; Yeshaiahu,9999,0,9999,0
1668585332068,ECE 200,008,103593,Ford; Joseph Earl,9999,0,9999,0
1668585332068,ECE 200,009,103594,Franceschetti; Massimo,9999,0,9999,0
1668585332068,ECE 200,010,103595,Fullerton; Eric E,9999,0,9999,0
1668585332068,ECE 200,011,103596,Galton; Ian A,9999,0,9999,0
1668585332068,ECE 200,012,103597,Gilja; Vikash,9999,0,9999,0
1668585332068,ECE 200,013,103598,Hall; Drew A.,9999,0,9999,0
1668585332068,ECE 200,014,103599,Hsueh; Tzu-Chien,9999,0,9999,0
1668585332068,ECE 200,015,103600,Javidi; Tara,9999,0,9999,0
1668585332068,ECE 200,016,103601,Kahng; Andrew Byun,9999,0,9999,0
1668585332068,ECE 200,017,103602,Kim; Young-Han,9999,0,9999,0
1668585332068,ECE 200,018,103603,Koushanfar; Farinaz,9999,0,9999,0
1668585332068,ECE 200,019,103604,Kuzum; Duygu,9999,0,9999,0
1668585332068,ECE 200,020,103605,Le; Hanh-Phuc,9999,0,9999,0
1668585332068,ECE 200,021,103606,Lin; Bill,9999,0,9999,0
1668585332068,ECE 200,022,103607,Liu; Zhaowei,9998,0,9999,1
1668585332068,ECE 200,023,103608,Lo; Yu-Hwa,9999,0,9999,0
1668585332068,ECE 200,024,103609,Lomakin; Vitaliy,9999,0,9999,0
1668585332068,ECE 200,025,103610,Mercier; Patrick Philip,9999,0,9999,0
1668585332068,ECE 200,026,103611,Meyer; Florian,9999,0,9999,0
1668585332068,ECE 200,027,103612,Milstein; Laurence B.,9999,0,9999,0
1668585332068,ECE 200,028,103613,Mir Arabbaygi; Siavash,9999,0,9999,0
1668585332068,ECE 200,029,103614,Mookherjea; Shayan,9999,0,9999,0
1668585332068,ECE 200,030,103615,Morris; Karcher William,9999,0,9999,0
1668585332068,ECE 200,031,103616,Ng; Tse Nga,9999,0,9999,0
1668585332068,ECE 200,032,103617,Nguyen; Truong Quang,9999,0,9999,0
1668585332068,ECE 200,033,103618,Nomura; Kenji,9999,0,9999,0
1668585332068,ECE 200,034,103619,Orlitsky; Alon,9999,0,9999,0
1668585332068,ECE 200,035,103620,Pal; Piya,9999,0,9999,0
1668585332068,ECE 200,036,103621,Papen; George C.,9999,0,9999,0
1668585332068,ECE 200,037,103622,Radic; Stojan,9999,0,9999,0
1668585332068,ECE 200,038,103623,Rao; Bhaskar D.,9999,0,9999,0
1668585332068,ECE 200,039,103624,Rao; Ramesh R,9999,0,9999,0
1668585332068,ECE 200,040,103625,Rebeiz; Gabriel,9999,0,9999,0
1668585332068,ECE 200,041,103626,Sanford; John R,9999,0,9999,0
1668585332068,ECE 200,042,103627,Siegel; Paul H.,9999,0,9999,0
1668585332068,ECE 200,043,103628,Sievenpiper; Daniel F.,9999,0,9999,0
1668585332068,ECE 200,044,103629,Sworder; David D.,9999,0,9999,0
1668585332068,ECE 200,045,103630,Taur; Yuan,9999,0,9999,0
1668585332068,ECE 200,046,103631,Touri; Behrouz,9999,0,9999,0
1668585332068,ECE 200,047,103632,Trivedi; Mohan M.,9999,0,9999,0
1668585332068,ECE 200,048,103633,Vasconcelos; Nuno,9999,0,9999,0
1668585332068,ECE 200,049,103634,Wang; Xiaolong,9999,0,9999,0
1668585332068,ECE 200,050,103635,Xie; Pengtao,9999,0,9999,0
1668585332068,ECE 200,051,103636,Yip; Michael,9999,0,9999,0
1668585332068,ECE 200,052,103637,Zeger; Kenneth A.,999,0,999,0
1668585332068,ECE 200,053,103638,Zhang; Xinyu,9999,0,9999,0
1668585332068,ECE 200,054,103639,Turakhia; Yatish Girish,9999,0,9999,0
1668585332068,ECE 200,055,103640,Kang; Mingu,9999,0,9999,0
1668585332068,ECE 200,056,103641,Shi; Yuanyuan,9999,0,9999,0
1668585332068,ECE 200,057,103642,Wang; Edward Jay,9999,0,9999,0
1668585332068,ECE 200,058,103643,Zheng; Yang,9999,0,9999,0
1668585332492,ECE 202,A00,103644,Kuzum; Duygu,0,47,0,0
1668585332918,ECE 212BN,A00,103646,Ng; Tse Nga,0,10,0,0
1668585333352,ECE 221,A00,111493,Staff,0,0,0,0
1668585333791,ECE 222B,A00,103647,Lomakin; Vitaliy,0,22,0,0
1668585334227,ECE 230B,A00,103648,Taur; Yuan,0,4,0,0
1668585334651,ECE 238B,A00,103649,Garay; Javier,0,0,0,0
1668585335075,ECE 240B,A00,112900,Fainman; Yeshaiahu,0,8,0,0
1668585335500,ECE 247A,A00,103650,Jokerst; Jesse Vincent,0,6,0,0
1668585335924,ECE 247B,A00,103651,Wang; Joseph,0,14,0,0
1668585336348,ECE 250,A00,103652,Siegel; Paul H.,0,85,0,0
1668585336772,ECE 251A,A00,103654,Rao; Bhaskar D.,0,65,0,0
1668585337212,ECE 257B,A00,103655,Bharadia; Dinesh,0,33,0,0
1668585337637,ECE 258A,A00,103656,Milstein; Laurence B.,0,29,0,0
1668585338072,ECE 260B,A00,103658,Kang; Mingu,0,121,0,0
1668585338499,ECE 264A,A00,103659,Galton; Ian A,0,42,0,34
1668585338923,ECE 265A,A00,103661,Gudem; Prasad S.S.,0,42,0,36
1668585339347,ECE 265D,A00,103662,Gudem; Prasad S.S.,0,27,0,0
1668585339772,ECE 268,A00,103663,Koushanfar; Farinaz,0,44,0,0
1668585340197,ECE 269,A01,103665,Pal; Piya,0,223,0,0
1668585340621,ECE 271B,A00,103666,Vasconcelos; Manuela,0,80,0,0
1668585341047,ECE 276A,A00,103667,Atanasov; Nikolay A.,0,127,0,0
1668585341475,ECE 277,A00,103668,An; Cheolhong,0,151,0,0
1668585341897,ECE 279,A00,117947,Hall; Drew A.,0,22,0,0
1668585342747,ECE 283,A00,103670,Hsueh; Tzu-Chien,0,57,0,0
1668585343171,ECE 284,A00,103671,Turakhia; Yatish Girish,0,40,0,0
1668585343599,ECE 285,A00,103672,Zheng; Yang,0,40,0,0
1668585343599,ECE 285,B00,103673,Sworder; David D.,0,61,0,0
1668585344035,ECE 287,A00,103676,Javidi; Tara,0,7,0,0
1668585344458,MATH 200B,A00,098023,Salehi Golsefidy; Alireza,7,0,15,8
1668585344885,MATH 202B,A00,098024,Rhoades; Brendon Patrick,7,0,15,8
1668585345315,MATH 203B,A00,098025,Oprea; Dragos N.,9,0,15,6
1668585345740,MATH 204B,A00,098026,Sorensen; Claus M,13,0,15,2
1668585346183,MATH 208,A00,098027,Izadi; Elham,7,0,10,3
1668585346610,MATH 209,A00,098028,Pollack; Aaron,10,0,10,0
1668585347034,MATH 211A,A00,112919,Rogalski; Daniel,8,0,10,2
1668585347459,MATH 211B,A00,112920,Seward; Brandon M.,9,0,10,1
1668585347899,MATH 218,A00,098029,Li; Bo,10,0,10,0
1668585348323,MATH 220B,A00,098030,Novak; Jonathan I,10,0,15,5
1668585348755,MATH 221A,A00,098031,Ebenfelt; Peter F,12,0,15,3
1668585349178,MATH 231B,A00,098032,Zlatos; Andrej,9,0,15,6
1668585349601,MATH 240B,A00,098033,Ni; Lei,7,0,15,8
1668585350028,MATH 243,A00,098034,Jekel; David Andrew,10,0,10,0
1668585350452,MATH 245A,A00,098035,Nie; Jiawang,0,7,15,18
1668585350906,MATH 248,A00,098036,Bejenaru; Ioan,10,0,10,0
1668585351338,MATH 250B,A00,098037,Spolaor; Luca,12,0,15,3
1668585351770,MATH 258,A00,098038,Ni; Lei,8,0,10,2
1668585352199,MATH 264B,A00,098041,Rhoades; Brendon Patrick,6,0,15,9
1668585352622,MATH 268,A00,098042,Buss; Samuel R,10,0,10,0
1668585353045,MATH 269,A00,098043,Rhoades; Brendon Patrick,10,0,10,0
1668585353477,MATH 270B,A00,098044,Li; Bo,6,0,15,9
1668585353975,MATH 272B,A00,098045,Holst; Michael J,13,0,15,2
1668585354399,MATH 273A,A00,098046,Tian; Xiaochuan,10,0,15,5
1668585354823,MATH 275,A01,098048,Tian; Xiaochuan,6,0,10,4
1668585355257,MATH 278A,A00,098049,Holst; Michael J,6,0,10,4
1668585355681,MATH 278B,A00,098050,Cloninger; Alexander,10,0,10,0
1668585356106,MATH 278C,A00,098051,Nie; Jiawang,5,0,10,5
1668585356530,MATH 280B,A00,098052,Zheng; Tianyi,6,0,15,9
1668585356953,MATH 281B,A00,098053,Bradic; Jelena,0,2,15,15
1668585357381,MATH 282B,A00,098054,Arias-Castro; Ery,0,1,15,15
1668585357805,MATH 285,A00,098055,Fitzsimmons; Patrick J,0,4,15,16
1668585358227,MATH 287B,A00,098056,Arias-Castro; Ery,1,0,15,14
1668585358651,MATH 288,A00,098057,Agarwal; Pooja,9,0,10,1
1668585358651,MATH 288,B00,098058,Zhang; Danna,8,0,10,2
1668585358651,MATH 288,C00,098059,Williams; Ruth J,9,0,10,1
1668585359092,MATH 290B,A00,098060,Roberts; Justin Deritter,12,0,15,3
1668585359525,MATH 292,A00,098061,Belmont; Eva Kinoshita,10,0,10,0
1668585359949,MATH 295,A00,098062,Suk; Andrew Hoon,47,0,50,3
1668585360372,MATH 296,A00,098063,Novak; Jonathan I,20,0,20,0
1668585360797,MATH 297,001,098064,Gamst; Anthony Collins,9997,0,9999,2
1668585864183,COGS 205,A00,101395,Chiba; Andrea,19,0,20,1
1668585864608,COGS 210B,001,101404,Greene; Deanna Jacquelyn,9998,0,9999,1
1668585864608,COGS 210B,002,101417,Xia; Haijun,9999,0,9999,0
1668585864608,COGS 210B,003,101422,Nitz; Douglas A.,9999,0,9999,0
1668585864608,COGS 210B,004,101423,Hollan; James D.,9998,0,9999,1
1668585864608,COGS 210B,005,101424,Deak; Gedeon O.,9998,0,9999,1
1668585864608,COGS 210B,006,101425,Rossano; Federico,9999,0,9999,0
1668585865034,COGS 211B,A00,101427,Coulson; Seana M,9996,0,9999,3
1668585865457,COGS 220,A00,101428,Hollan; James D.,0,17,25,25
1668585865885,COGS 229,A00,101429,Dow; Steven P,17,0,25,8
1668585866307,COGS 230,A00,101430,Klemmer; Scott R,6,0,17,11
1668585866737,COGS 234,A00,101431,Xia; Haijun,0,1,25,25
1668585867166,COGS 260,A00,101432,Kiyonaga; Anastasia,21,0,25,4
1668585867166,COGS 260,B00,101433,Kirsh; David Joel,15,0,25,10
1668585867600,CSE 202,A00,102371,Impagliazzo; Russell,0,70,0,0
1668585868032,CSE 203B,A01,102373,Cheng; Chung Kuan,0,70,0,0
1668585868470,CSE 208,A00,102374,Micciancio; Daniele,0,5,0,0
1668585868893,CSE 209A,A00,112895,Impagliazzo; Russell,0,14,15,15
1668585869331,CSE 209B,A00,108005,Bellare; Mihir,0,7,0,0
1668585869768,CSE 210,A00,113163,Coblenz; Michael J,0,96,0,0
1668585870193,CSE 219,A00,106111,Dow; Steven P,0,8,20,20
1668585870620,CSE 221,A00,102376,Voelker; Geoffrey M.,0,78,0,0
1668585871044,CSE 224,A01,102378,Porter; George M,0,181,0,0
1668585871470,CSE 229A,A00,102379,Savage; Stefan,0,14,0,0
1668585871894,CSE 229C,A00,102380,Munyaka; Imani N. S.,0,12,0,0
1668585872324,CSE 232B,A00,102382,Deutsch; Alin Bernard,0,39,0,0
1668585872748,CSE 234,A01,112904,Kumar; Arun Kumar,0,0,0,0
1668585873178,CSE 237A,A00,102383,Rosing; Tajana Simunic,0,57,0,0
1668585873715,CSE 239A,A00,102384,Deutsch; Alin Bernard,0,18,0,0
1668585874141,CSE 239B,A00,102385,Polikarpova; Nadezhda,0,11,0,0
1668585874571,CSE 240A,A00,102386,Pannuto; Patrick William,0,49,0,0
1668585874993,CSE 240B,A00,102387,Zhao; Jishen,0,51,0,0
1668585875428,CSE 241A,A00,106406,Kang; Mingu,0,9,0,0
1668585875943,CSE 249B,A00,102388,Kahng; Andrew Byun,0,7,8,8
1668585876367,CSE 251B,A01,102392,Cottrell; Garrison W,0,54,0,0
1668585876367,CSE 251B,A02,102393,Cottrell; Garrison W,0,36,0,0
1668585876794,CSE 252B,A00,102394,Ochoa; Benjamin Lawrence,0,64,0,0
1668585877223,CSE 257,A01,102396,Gao; Sicun,0,160,0,0
1668585877647,CSE 272,A00,102397,Li; Tzumao,0,22,0,0
1668585878075,CSE 274,A00,111323,Chern; Albert Ren-Haur,0,16,0,0
1668585878502,CSE 282,A00,102398,Pevzner; Pavel Arkadjevich,0,0,0,0
1668585878935,CSE 284,A00,114175,Gymrek; Melissa Ann,0,33,0,0
1668585879362,CSE 290,A00,102399,Chandraker; Manmohan Krishna,0,11,0,0
1668585879362,CSE 290,B00,102400,Vaccaro; Kristen Marie,0,10,25,25
1668585879362,CSE 290,C00,102414,Pannuto; Patrick William,0,1,25,25
1668585879362,CSE 290,D00,102427,Pevzner; Pavel Arkadjevich,0,0,0,0
1668585879362,CSE 290,E00,102429,Zhao; Jishen,0,6,0,0
1668585879362,CSE 290,F00,102436,Tullsen; Dean Michael,0,6,0,0
1668585879362,CSE 290,G00,102440,Christensen; Henrik I,0,8,20,20
1668585879788,CSE 291,A00,102443,Su; Hao,0,0,0,0
1668585879788,CSE 291,B00,102448,Polikarpova; Nadezhda,0,0,0,0
1668585879788,CSE 291,C00,102453,Vaccaro; Kristen Marie,0,0,0,0
1668585879788,CSE 291,D00,111343,Savage; Stefan,0,0,0,0
1668585879788,CSE 291,E00,116474,Claffy; Kimberly Claire,0,0,0,0
1668585879788,CSE 291,F00,116479,Pasquale; Joseph,0,0,0,0
1668585880217,CSE 293,001,119111,Bafna; Vineet,9999,0,9999,0
1668585880217,CSE 293,002,119118,Bellare; Mihir,9999,0,9999,0
1668585880217,CSE 293,003,119122,Berg-Kirkpatrick; Taylor D,9999,0,9999,0
1668585880217,CSE 293,004,119135,Christensen; Henrik I,9999,0,9999,0
1668585880217,CSE 293,005,119142,Cottrell; Garrison W,9999,0,9999,0
1668585880217,CSE 293,006,119146,Deutsch; Alin Bernard,9999,0,9999,0
1668585880217,CSE 293,007,119159,Esmaeilzadeh; Hadi,9999,0,9999,0
1668585880217,CSE 293,008,119166,Freund; Yoav,9999,0,9999,0
1668585880217,CSE 293,009,119170,Griswold; William G.,9999,0,9999,0
1668585880217,CSE 293,010,119183,Gymrek; Melissa Ann,9999,0,9999,0
1668585880217,CSE 293,011,119190,Heninger; Nadia A,9999,0,9999,0
1668585880217,CSE 293,012,119230,Impagliazzo; Russell,9999,0,9999,0
1668585880217,CSE 293,013,119232,Jhala; Ranjit,9999,0,9999,0
1668585880217,CSE 293,014,119233,Kahng; Andrew Byun,9999,0,9999,0
1668585880217,CSE 293,015,119298,Kane; Daniel Mertz,9999,0,9999,0
1668585880217,CSE 293,016,119299,Kriegman; David J,9999,0,9999,0
1668585880217,CSE 293,017,119300,Kumar; Arun Kumar,9999,0,9999,0
1668585880217,CSE 293,018,119301,Lerner; Sorin,9999,0,9999,0
1668585880217,CSE 293,019,119302,Lovett; Shachar,9999,0,9999,0
1668585880217,CSE 293,020,119303,McAuley; Julian John,9999,0,9999,0
1668585880217,CSE 293,021,119304,Micciancio; Daniele,9999,0,9999,0
1668585880217,CSE 293,022,119367,Orailoglu; Alex,9999,0,9999,0
1668585880217,CSE 293,023,119382,Paturi; Ramamohan,9999,0,9999,0
1668585880217,CSE 293,024,119404,Polikarpova; Nadezhda,9999,0,9999,0
1668585880217,CSE 293,025,119406,Politz; Joseph Gibbs,9999,0,9999,0
1668585880217,CSE 293,026,119411,Porter; George M,9999,0,9999,0
1668585880217,CSE 293,027,119414,Porter; Leonard Emerson,9999,0,9999,0
1668585880217,CSE 293,028,119416,Ramamoorthi; Ravi,9999,0,9999,0
1668585880217,CSE 293,029,119417,Sahoo; Debashis,9999,0,9999,0
1668585880217,CSE 293,030,119420,Saul; Lawrence,9999,0,9999,0
1668585880217,CSE 293,031,119421,Savage; Stefan,9999,0,9999,0
1668585880217,CSE 293,032,119425,Schulze; Jurgen P.,9999,0,9999,0
1668585880217,CSE 293,033,119426,Snoeren; Alex C.,9999,0,9999,0
1668585880217,CSE 293,034,119428,Shang; Jingbo,9999,0,9999,0
1668585880217,CSE 293,035,119430,Stefan; Deian,9999,0,9999,0
1668585880217,CSE 293,036,119431,Su; Hao,9999,0,9999,0
1668585880217,CSE 293,037,119433,Swanson; Steven James,9999,0,9999,0
1668585880217,CSE 293,038,119435,Tullsen; Dean Michael,9999,0,9999,0
1668585880217,CSE 293,039,119483,Voelker; Geoffrey M.,9999,0,9999,0
1668585880217,CSE 293,040,119537,Zhao; Jishen,9999,0,9999,0
1668585880217,CSE 293,041,119538,Zhou; Yuan-Yuan,9999,0,9999,0
1668585880217,CSE 293,042,119539,Gao; Sicun,9999,0,9999,0
1668585880217,CSE 293,043,119540,Weibel; Nadir,9999,0,9999,0
1668585880217,CSE 293,044,119541,Gupta; Rajesh K.,9999,0,9999,0
1668585880217,CSE 293,045,126410,Vaccaro; Kristen Marie,9999,0,9999,0
1668585880217,CSE 293,046,126411,Klemke; Richard,9999,0,9999,0
1668585880643,CSE 294,A00,102459,Voelker; Geoffrey M.,0,2,0,0
1668585880643,CSE 294,B00,111322,Orailoglu; Alex,0,2,0,0
1668585881066,DSE 201,A00,096914,Deutsch; Alin Bernard,30,0,30,0
1668585881493,DSE 210,A00,096915,Dasgupta; Sanjoy,30,0,30,0
1668585881918,DSE 241,A00,144528,Smith; Neil Gordon,30,0,30,0
1668585882346,DSE 260A,A00,096916,Altintas De Callaf; Ilkay,30,0,30,0
1668585882773,ECE 200,001,103586,Antipa; Nicholas A,9999,0,9999,0
1668585882773,ECE 200,002,103587,Atanasov; Nikolay A.,9999,0,9999,0
1668585882773,ECE 200,003,103588,Bharadia; Dinesh,9999,0,9999,0
1668585882773,ECE 200,004,103589,Cheng; Chung Kuan,9999,0,9999,0
1668585882773,ECE 200,005,103590,Cosman; Pamela C.,9999,0,9999,0
1668585882773,ECE 200,006,103591,Dayeh; Shadi Ahmad,9999,0,9999,0
1668585882773,ECE 200,007,103592,Fainman; Yeshaiahu,9999,0,9999,0
1668585882773,ECE 200,008,103593,Ford; Joseph Earl,9999,0,9999,0
1668585882773,ECE 200,009,103594,Franceschetti; Massimo,9999,0,9999,0
1668585882773,ECE 200,010,103595,Fullerton; Eric E,9999,0,9999,0
1668585882773,ECE 200,011,103596,Galton; Ian A,9999,0,9999,0
1668585882773,ECE 200,012,103597,Gilja; Vikash,9999,0,9999,0
1668585882773,ECE 200,013,103598,Hall; Drew A.,9999,0,9999,0
1668585882773,ECE 200,014,103599,Hsueh; Tzu-Chien,9999,0,9999,0
1668585882773,ECE 200,015,103600,Javidi; Tara,9999,0,9999,0
1668585882773,ECE 200,016,103601,Kahng; Andrew Byun,9999,0,9999,0
1668585882773,ECE 200,017,103602,Kim; Young-Han,9999,0,9999,0
1668585882773,ECE 200,018,103603,Koushanfar; Farinaz,9999,0,9999,0
1668585882773,ECE 200,019,103604,Kuzum; Duygu,9999,0,9999,0
1668585882773,ECE 200,020,103605,Le; Hanh-Phuc,9999,0,9999,0
1668585882773,ECE 200,021,103606,Lin; Bill,9999,0,9999,0
1668585882773,ECE 200,022,103607,Liu; Zhaowei,9998,0,9999,1
1668585882773,ECE 200,023,103608,Lo; Yu-Hwa,9999,0,9999,0
1668585882773,ECE 200,024,103609,Lomakin; Vitaliy,9999,0,9999,0
1668585882773,ECE 200,025,103610,Mercier; Patrick Philip,9999,0,9999,0
1668585882773,ECE 200,026,103611,Meyer; Florian,9999,0,9999,0
1668585882773,ECE 200,027,103612,Milstein; Laurence B.,9999,0,9999,0
1668585882773,ECE 200,028,103613,Mir Arabbaygi; Siavash,9999,0,9999,0
1668585882773,ECE 200,029,103614,Mookherjea; Shayan,9999,0,9999,0
1668585882773,ECE 200,030,103615,Morris; Karcher William,9999,0,9999,0
1668585882773,ECE 200,031,103616,Ng; Tse Nga,9999,0,9999,0
1668585882773,ECE 200,032,103617,Nguyen; Truong Quang,9999,0,9999,0
1668585882773,ECE 200,033,103618,Nomura; Kenji,9999,0,9999,0
1668585882773,ECE 200,034,103619,Orlitsky; Alon,9999,0,9999,0
1668585882773,ECE 200,035,103620,Pal; Piya,9999,0,9999,0
1668585882773,ECE 200,036,103621,Papen; George C.,9999,0,9999,0
1668585882773,ECE 200,037,103622,Radic; Stojan,9999,0,9999,0
1668585882773,ECE 200,038,103623,Rao; Bhaskar D.,9999,0,9999,0
1668585882773,ECE 200,039,103624,Rao; Ramesh R,9999,0,9999,0
1668585882773,ECE 200,040,103625,Rebeiz; Gabriel,9999,0,9999,0
1668585882773,ECE 200,041,103626,Sanford; John R,9999,0,9999,0
1668585882773,ECE 200,042,103627,Siegel; Paul H.,9999,0,9999,0
1668585882773,ECE 200,043,103628,Sievenpiper; Daniel F.,9999,0,9999,0
1668585882773,ECE 200,044,103629,Sworder; David D.,9999,0,9999,0
1668585882773,ECE 200,045,103630,Taur; Yuan,9999,0,9999,0
1668585882773,ECE 200,046,103631,Touri; Behrouz,9999,0,9999,0
1668585882773,ECE 200,047,103632,Trivedi; Mohan M.,9999,0,9999,0
1668585882773,ECE 200,048,103633,Vasconcelos; Nuno,9999,0,9999,0
1668585882773,ECE 200,049,103634,Wang; Xiaolong,9999,0,9999,0
1668585882773,ECE 200,050,103635,Xie; Pengtao,9999,0,9999,0
1668585882773,ECE 200,051,103636,Yip; Michael,9999,0,9999,0
1668585882773,ECE 200,052,103637,Zeger; Kenneth A.,999,0,999,0
1668585882773,ECE 200,053,103638,Zhang; Xinyu,9999,0,9999,0
1668585882773,ECE 200,054,103639,Turakhia; Yatish Girish,9999,0,9999,0
1668585882773,ECE 200,055,103640,Kang; Mingu,9999,0,9999,0
1668585882773,ECE 200,056,103641,Shi; Yuanyuan,9999,0,9999,0
1668585882773,ECE 200,057,103642,Wang; Edward Jay,9999,0,9999,0
1668585882773,ECE 200,058,103643,Zheng; Yang,9999,0,9999,0
1668585883209,ECE 202,A00,103644,Kuzum; Duygu,0,47,0,0
1668585883638,ECE 212BN,A00,103646,Ng; Tse Nga,0,10,0,0
1668585884070,ECE 221,A00,111493,Staff,0,0,0,0
1668585884497,ECE 222B,A00,103647,Lomakin; Vitaliy,0,22,0,0
1668585884923,ECE 230B,A00,103648,Taur; Yuan,0,4,0,0
1668585885350,ECE 238B,A00,103649,Garay; Javier,0,0,0,0
1668585885774,ECE 240B,A00,112900,Fainman; Yeshaiahu,0,8,0,0
1668585886203,ECE 247A,A00,103650,Jokerst; Jesse Vincent,0,6,0,0
1668585886629,ECE 247B,A00,103651,Wang; Joseph,0,14,0,0
1668585887058,ECE 250,A00,103652,Siegel; Paul H.,0,85,0,0
1668585887484,ECE 251A,A00,103654,Rao; Bhaskar D.,0,65,0,0
1668585887906,ECE 257B,A00,103655,Bharadia; Dinesh,0,33,0,0
1668585888344,ECE 258A,A00,103656,Milstein; Laurence B.,0,29,0,0
1668585888778,ECE 260B,A00,103658,Kang; Mingu,0,121,0,0
1668585889206,ECE 264A,A00,103659,Galton; Ian A,0,42,0,34
1668585889643,ECE 265A,A00,103661,Gudem; Prasad S.S.,0,42,0,36
1668585890065,ECE 265D,A00,103662,Gudem; Prasad S.S.,0,27,0,0
1668585890488,ECE 268,A00,103663,Koushanfar; Farinaz,0,44,0,0
1668585890929,ECE 269,A01,103665,Pal; Piya,0,223,0,0
1668585891351,ECE 271B,A00,103666,Vasconcelos; Manuela,0,80,0,0
1668585891780,ECE 276A,A00,103667,Atanasov; Nikolay A.,0,127,0,0
1668585892208,ECE 277,A00,103668,An; Cheolhong,0,151,0,0
1668585892648,ECE 279,A00,117947,Hall; Drew A.,0,22,0,0
1668585893498,ECE 283,A00,103670,Hsueh; Tzu-Chien,0,57,0,0
1668585893921,ECE 284,A00,103671,Turakhia; Yatish Girish,0,40,0,0
1668585894347,ECE 285,A00,103672,Zheng; Yang,0,40,0,0
1668585894347,ECE 285,B00,103673,Sworder; David D.,0,61,0,0
1668585894773,ECE 287,A00,103676,Javidi; Tara,0,7,0,0
1668585895201,MATH 200B,A00,098023,Salehi Golsefidy; Alireza,7,0,15,8
1668585895632,MATH 202B,A00,098024,Rhoades; Brendon Patrick,7,0,15,8
1668585896060,MATH 203B,A00,098025,Oprea; Dragos N.,9,0,15,6
1668585896483,MATH 204B,A00,098026,Sorensen; Claus M,13,0,15,2
1668585896913,MATH 208,A00,098027,Izadi; Elham,7,0,10,3
1668585897337,MATH 209,A00,098028,Pollack; Aaron,10,0,10,0
1668585897768,MATH 211A,A00,112919,Rogalski; Daniel,8,0,10,2
1668585898208,MATH 211B,A00,112920,Seward; Brandon M.,9,0,10,1
1668585898631,MATH 218,A00,098029,Li; Bo,10,0,10,0
1668585899054,MATH 220B,A00,098030,Novak; Jonathan I,10,0,15,5
1668585899491,MATH 221A,A00,098031,Ebenfelt; Peter F,12,0,15,3
1668585899926,MATH 231B,A00,098032,Zlatos; Andrej,9,0,15,6
1668585900350,MATH 240B,A00,098033,Ni; Lei,7,0,15,8
1668585900774,MATH 243,A00,098034,Jekel; David Andrew,10,0,10,0
1668585901203,MATH 245A,A00,098035,Nie; Jiawang,0,7,15,18
1668585901634,MATH 248,A00,098036,Bejenaru; Ioan,10,0,10,0
1668585902061,MATH 250B,A00,098037,Spolaor; Luca,12,0,15,3
1668585902486,MATH 258,A00,098038,Ni; Lei,8,0,10,2
1668585902918,MATH 264B,A00,098041,Rhoades; Brendon Patrick,6,0,15,9
1668585903346,MATH 268,A00,098042,Buss; Samuel R,10,0,10,0
1668585903770,MATH 269,A00,098043,Rhoades; Brendon Patrick,10,0,10,0
1668585904200,MATH 270B,A00,098044,Li; Bo,6,0,15,9
1668585904625,MATH 272B,A00,098045,Holst; Michael J,13,0,15,2
1668585905054,MATH 273A,A00,098046,Tian; Xiaochuan,10,0,15,5
1668585905490,MATH 275,A01,098048,Tian; Xiaochuan,6,0,10,4
1668585905928,MATH 278A,A00,098049,Holst; Michael J,6,0,10,4
1668585906352,MATH 278B,A00,098050,Cloninger; Alexander,10,0,10,0
1668585906776,MATH 278C,A00,098051,Nie; Jiawang,5,0,10,5
1668585907198,MATH 280B,A00,098052,Zheng; Tianyi,6,0,15,9
1668585907627,MATH 281B,A00,098053,Bradic; Jelena,0,2,15,15
1668585908051,MATH 282B,A00,098054,Arias-Castro; Ery,0,1,15,15
1668585908474,MATH 285,A00,098055,Fitzsimmons; Patrick J,0,4,15,16
1668585908899,MATH 287B,A00,098056,Arias-Castro; Ery,1,0,15,14
1668585909324,MATH 288,A00,098057,Agarwal; Pooja,9,0,10,1
1668585909324,MATH 288,B00,098058,Zhang; Danna,8,0,10,2
1668585909324,MATH 288,C00,098059,Williams; Ruth J,9,0,10,1
1668585909749,MATH 290B,A00,098060,Roberts; Justin Deritter,12,0,15,3
1668585910177,MATH 292,A00,098061,Belmont; Eva Kinoshita,10,0,10,0
1668585910608,MATH 295,A00,098062,Suk; Andrew Hoon,47,0,50,3
1668585911036,MATH 296,A00,098063,Novak; Jonathan I,20,0,20,0
1668585911468,MATH 297,001,098064,Gamst; Anthony Collins,9997,0,9999,2
1668586417651,COGS 205,A00,101395,Chiba; Andrea,19,0,20,1
1668586418079,COGS 210B,001,101404,Greene; Deanna Jacquelyn,9998,0,9999,1
1668586418079,COGS 210B,002,101417,Xia; Haijun,9999,0,9999,0
1668586418079,COGS 210B,003,101422,Nitz; Douglas A.,9999,0,9999,0
1668586418079,COGS 210B,004,101423,Hollan; James D.,9998,0,9999,1
1668586418079,COGS 210B,005,101424,Deak; Gedeon O.,9998,0,9999,1
1668586418079,COGS 210B,006,101425,Rossano; Federico,9999,0,9999,0
1668586418503,COGS 211B,A00,101427,Coulson; Seana M,9996,0,9999,3
1668586418925,COGS 220,A00,101428,Hollan; James D.,0,17,25,25
1668586419350,COGS 229,A00,101429,Dow; Steven P,17,0,25,8
1668586419790,COGS 230,A00,101430,Klemmer; Scott R,6,0,17,11
1668586420225,COGS 234,A00,101431,Xia; Haijun,0,1,25,25
1668586420654,COGS 260,A00,101432,Kiyonaga; Anastasia,21,0,25,4
1668586420654,COGS 260,B00,101433,Kirsh; David Joel,15,0,25,10
1668586421084,CSE 202,A00,102371,Impagliazzo; Russell,0,70,0,0
1668586421513,CSE 203B,A01,102373,Cheng; Chung Kuan,0,70,0,0
1668586421936,CSE 208,A00,102374,Micciancio; Daniele,0,5,0,0
1668586422360,CSE 209A,A00,112895,Impagliazzo; Russell,0,14,15,15
1668586422793,CSE 209B,A00,108005,Bellare; Mihir,0,7,0,0
1668586423218,CSE 210,A00,113163,Coblenz; Michael J,0,96,0,0
1668586423643,CSE 219,A00,106111,Dow; Steven P,0,8,20,20
1668586424068,CSE 221,A00,102376,Voelker; Geoffrey M.,0,78,0,0
1668586424491,CSE 224,A01,102378,Porter; George M,0,181,0,0
1668586424917,CSE 229A,A00,102379,Savage; Stefan,0,14,0,0
1668586425345,CSE 229C,A00,102380,Munyaka; Imani N. S.,0,12,0,0
1668586425771,CSE 232B,A00,102382,Deutsch; Alin Bernard,0,40,0,0
1668586426198,CSE 234,A01,112904,Kumar; Arun Kumar,0,0,0,0
1668586426628,CSE 237A,A00,102383,Rosing; Tajana Simunic,0,57,0,0
1668586427051,CSE 239A,A00,102384,Deutsch; Alin Bernard,0,18,0,0
1668586427474,CSE 239B,A00,102385,Polikarpova; Nadezhda,0,11,0,0
1668586427896,CSE 240A,A00,102386,Pannuto; Patrick William,0,49,0,0
1668586428334,CSE 240B,A00,102387,Zhao; Jishen,0,51,0,0
1668586428760,CSE 241A,A00,106406,Kang; Mingu,0,9,0,0
1668586429189,CSE 249B,A00,102388,Kahng; Andrew Byun,0,7,8,8
1668586429623,CSE 251B,A01,102392,Cottrell; Garrison W,0,54,0,0
1668586429623,CSE 251B,A02,102393,Cottrell; Garrison W,0,36,0,0
1668586430048,CSE 252B,A00,102394,Ochoa; Benjamin Lawrence,0,64,0,0
1668586430484,CSE 257,A01,102396,Gao; Sicun,0,160,0,0
1668586430910,CSE 272,A00,102397,Li; Tzumao,0,22,0,0
1668586431338,CSE 274,A00,111323,Chern; Albert Ren-Haur,0,16,0,0
1668586431762,CSE 282,A00,102398,Pevzner; Pavel Arkadjevich,0,0,0,0
1668586432187,CSE 284,A00,114175,Gymrek; Melissa Ann,0,33,0,0
1668586432612,CSE 290,A00,102399,Chandraker; Manmohan Krishna,0,11,0,0
1668586432612,CSE 290,B00,102400,Vaccaro; Kristen Marie,0,10,25,25
1668586432612,CSE 290,C00,102414,Pannuto; Patrick William,0,1,25,25
1668586432612,CSE 290,D00,102427,Pevzner; Pavel Arkadjevich,0,0,0,0
1668586432612,CSE 290,E00,102429,Zhao; Jishen,0,6,0,0
1668586432612,CSE 290,F00,102436,Tullsen; Dean Michael,0,6,0,0
1668586432612,CSE 290,G00,102440,Christensen; Henrik I,0,8,20,20
1668586433039,CSE 291,A00,102443,Su; Hao,0,0,0,0
1668586433039,CSE 291,B00,102448,Polikarpova; Nadezhda,0,0,0,0
1668586433039,CSE 291,C00,102453,Vaccaro; Kristen Marie,0,0,0,0
1668586433039,CSE 291,D00,111343,Savage; Stefan,0,0,0,0
1668586433039,CSE 291,E00,116474,Claffy; Kimberly Claire,0,0,0,0
1668586433039,CSE 291,F00,116479,Pasquale; Joseph,0,0,0,0
1668586433475,CSE 293,001,119111,Bafna; Vineet,9999,0,9999,0
1668586433475,CSE 293,002,119118,Bellare; Mihir,9999,0,9999,0
1668586433475,CSE 293,003,119122,Berg-Kirkpatrick; Taylor D,9999,0,9999,0
1668586433475,CSE 293,004,119135,Christensen; Henrik I,9999,0,9999,0
1668586433475,CSE 293,005,119142,Cottrell; Garrison W,9999,0,9999,0
1668586433475,CSE 293,006,119146,Deutsch; Alin Bernard,9999,0,9999,0
1668586433475,CSE 293,007,119159,Esmaeilzadeh; Hadi,9999,0,9999,0
1668586433475,CSE 293,008,119166,Freund; Yoav,9999,0,9999,0
1668586433475,CSE 293,009,119170,Griswold; William G.,9999,0,9999,0
1668586433475,CSE 293,010,119183,Gymrek; Melissa Ann,9999,0,9999,0
1668586433475,CSE 293,011,119190,Heninger; Nadia A,9999,0,9999,0
1668586433475,CSE 293,012,119230,Impagliazzo; Russell,9999,0,9999,0
1668586433475,CSE 293,013,119232,Jhala; Ranjit,9999,0,9999,0
1668586433475,CSE 293,014,119233,Kahng; Andrew Byun,9999,0,9999,0
1668586433475,CSE 293,015,119298,Kane; Daniel Mertz,9999,0,9999,0
1668586433475,CSE 293,016,119299,Kriegman; David J,9999,0,9999,0
1668586433475,CSE 293,017,119300,Kumar; Arun Kumar,9999,0,9999,0
1668586433475,CSE 293,018,119301,Lerner; Sorin,9999,0,9999,0
1668586433475,CSE 293,019,119302,Lovett; Shachar,9999,0,9999,0
1668586433475,CSE 293,020,119303,McAuley; Julian John,9999,0,9999,0
1668586433475,CSE 293,021,119304,Micciancio; Daniele,9999,0,9999,0
1668586433475,CSE 293,022,119367,Orailoglu; Alex,9999,0,9999,0
1668586433475,CSE 293,023,119382,Paturi; Ramamohan,9999,0,9999,0
1668586433475,CSE 293,024,119404,Polikarpova; Nadezhda,9999,0,9999,0
1668586433475,CSE 293,025,119406,Politz; Joseph Gibbs,9999,0,9999,0
1668586433475,CSE 293,026,119411,Porter; George M,9999,0,9999,0
1668586433475,CSE 293,027,119414,Porter; Leonard Emerson,9999,0,9999,0
1668586433475,CSE 293,028,119416,Ramamoorthi; Ravi,9999,0,9999,0
1668586433475,CSE 293,029,119417,Sahoo; Debashis,9999,0,9999,0
1668586433475,CSE 293,030,119420,Saul; Lawrence,9999,0,9999,0
1668586433475,CSE 293,031,119421,Savage; Stefan,9999,0,9999,0
1668586433475,CSE 293,032,119425,Schulze; Jurgen P.,9999,0,9999,0
1668586433475,CSE 293,033,119426,Snoeren; Alex C.,9999,0,9999,0
1668586433475,CSE 293,034,119428,Shang; Jingbo,9999,0,9999,0
1668586433475,CSE 293,035,119430,Stefan; Deian,9999,0,9999,0
1668586433475,CSE 293,036,119431,Su; Hao,9999,0,9999,0
1668586433475,CSE 293,037,119433,Swanson; Steven James,9999,0,9999,0
1668586433475,CSE 293,038,119435,Tullsen; Dean Michael,9999,0,9999,0
1668586433475,CSE 293,039,119483,Voelker; Geoffrey M.,9999,0,9999,0
1668586433475,CSE 293,040,119537,Zhao; Jishen,9999,0,9999,0
1668586433475,CSE 293,041,119538,Zhou; Yuan-Yuan,9999,0,9999,0
1668586433475,CSE 293,042,119539,Gao; Sicun,9999,0,9999,0
1668586433475,CSE 293,043,119540,Weibel; Nadir,9999,0,9999,0
1668586433475,CSE 293,044,119541,Gupta; Rajesh K.,9999,0,9999,0
1668586433475,CSE 293,045,126410,Vaccaro; Kristen Marie,9999,0,9999,0
1668586433475,CSE 293,046,126411,Klemke; Richard,9999,0,9999,0
1668586433900,CSE 294,A00,102459,Voelker; Geoffrey M.,0,2,0,0
1668586433900,CSE 294,B00,111322,Orailoglu; Alex,0,2,0,0
1668586434323,DSE 201,A00,096914,Deutsch; Alin Bernard,30,0,30,0
1668586434749,DSE 210,A00,096915,Dasgupta; Sanjoy,30,0,30,0
1668586435171,DSE 241,A00,144528,Smith; Neil Gordon,30,0,30,0
1668586435597,DSE 260A,A00,096916,Altintas De Callaf; Ilkay,30,0,30,0
1668586436045,ECE 200,001,103586,Antipa; Nicholas A,9999,0,9999,0
1668586436045,ECE 200,002,103587,Atanasov; Nikolay A.,9999,0,9999,0
1668586436045,ECE 200,003,103588,Bharadia; Dinesh,9999,0,9999,0
1668586436045,ECE 200,004,103589,Cheng; Chung Kuan,9999,0,9999,0
1668586436045,ECE 200,005,103590,Cosman; Pamela C.,9999,0,9999,0
1668586436045,ECE 200,006,103591,Dayeh; Shadi Ahmad,9999,0,9999,0
1668586436045,ECE 200,007,103592,Fainman; Yeshaiahu,9999,0,9999,0
1668586436045,ECE 200,008,103593,Ford; Joseph Earl,9999,0,9999,0
1668586436045,ECE 200,009,103594,Franceschetti; Massimo,9999,0,9999,0
1668586436045,ECE 200,010,103595,Fullerton; Eric E,9999,0,9999,0
1668586436045,ECE 200,011,103596,Galton; Ian A,9999,0,9999,0
1668586436045,ECE 200,012,103597,Gilja; Vikash,9999,0,9999,0
1668586436045,ECE 200,013,103598,Hall; Drew A.,9999,0,9999,0
1668586436045,ECE 200,014,103599,Hsueh; Tzu-Chien,9999,0,9999,0
1668586436045,ECE 200,015,103600,Javidi; Tara,9999,0,9999,0
1668586436045,ECE 200,016,103601,Kahng; Andrew Byun,9999,0,9999,0
1668586436045,ECE 200,017,103602,Kim; Young-Han,9999,0,9999,0
1668586436045,ECE 200,018,103603,Koushanfar; Farinaz,9999,0,9999,0
1668586436045,ECE 200,019,103604,Kuzum; Duygu,9999,0,9999,0
1668586436045,ECE 200,020,103605,Le; Hanh-Phuc,9999,0,9999,0
1668586436045,ECE 200,021,103606,Lin; Bill,9999,0,9999,0
1668586436045,ECE 200,022,103607,Liu; Zhaowei,9998,0,9999,1
1668586436045,ECE 200,023,103608,Lo; Yu-Hwa,9999,0,9999,0
1668586436045,ECE 200,024,103609,Lomakin; Vitaliy,9999,0,9999,0
1668586436045,ECE 200,025,103610,Mercier; Patrick Philip,9999,0,9999,0
1668586436045,ECE 200,026,103611,Meyer; Florian,9999,0,9999,0
1668586436045,ECE 200,027,103612,Milstein; Laurence B.,9999,0,9999,0
1668586436045,ECE 200,028,103613,Mir Arabbaygi; Siavash,9999,0,9999,0
1668586436045,ECE 200,029,103614,Mookherjea; Shayan,9999,0,9999,0
1668586436045,ECE 200,030,103615,Morris; Karcher William,9999,0,9999,0
1668586436045,ECE 200,031,103616,Ng; Tse Nga,9999,0,9999,0
1668586436045,ECE 200,032,103617,Nguyen; Truong Quang,9999,0,9999,0
1668586436045,ECE 200,033,103618,Nomura; Kenji,9999,0,9999,0
1668586436045,ECE 200,034,103619,Orlitsky; Alon,9999,0,9999,0
1668586436045,ECE 200,035,103620,Pal; Piya,9999,0,9999,0
1668586436045,ECE 200,036,103621,Papen; George C.,9999,0,9999,0
1668586436045,ECE 200,037,103622,Radic; Stojan,9999,0,9999,0
1668586436045,ECE 200,038,103623,Rao; Bhaskar D.,9999,0,9999,0
1668586436045,ECE 200,039,103624,Rao; Ramesh R,9999,0,9999,0
1668586436045,ECE 200,040,103625,Rebeiz; Gabriel,9999,0,9999,0
1668586436045,ECE 200,041,103626,Sanford; John R,9999,0,9999,0
1668586436045,ECE 200,042,103627,Siegel; Paul H.,9999,0,9999,0
1668586436045,ECE 200,043,103628,Sievenpiper; Daniel F.,9999,0,9999,0
1668586436045,ECE 200,044,103629,Sworder; David D.,9999,0,9999,0
1668586436045,ECE 200,045,103630,Taur; Yuan,9999,0,9999,0
1668586436045,ECE 200,046,103631,Touri; Behrouz,9999,0,9999,0
1668586436045,ECE 200,047,103632,Trivedi; Mohan M.,9999,0,9999,0
1668586436045,ECE 200,048,103633,Vasconcelos; Nuno,9999,0,9999,0
1668586436045,ECE 200,049,103634,Wang; Xiaolong,9999,0,9999,0
1668586436045,ECE 200,050,103635,Xie; Pengtao,9999,0,9999,0
1668586436045,ECE 200,051,103636,Yip; Michael,9999,0,9999,0
1668586436045,ECE 200,052,103637,Zeger; Kenneth A.,999,0,999,0
1668586436045,ECE 200,053,103638,Zhang; Xinyu,9999,0,9999,0
1668586436045,ECE 200,054,103639,Turakhia; Yatish Girish,9999,0,9999,0
1668586436045,ECE 200,055,103640,Kang; Mingu,9999,0,9999,0
1668586436045,ECE 200,056,103641,Shi; Yuanyuan,9999,0,9999,0
1668586436045,ECE 200,057,103642,Wang; Edward Jay,9999,0,9999,0
1668586436045,ECE 200,058,103643,Zheng; Yang,9999,0,9999,0
1668586436481,ECE 202,A00,103644,Kuzum; Duygu,0,47,0,0
1668586436904,ECE 212BN,A00,103646,Ng; Tse Nga,0,10,0,0
1668586437330,ECE 221,A00,111493,Staff,0,0,0,0
1668586437759,ECE 222B,A00,103647,Lomakin; Vitaliy,0,22,0,0
1668586438198,ECE 230B,A00,103648,Taur; Yuan,0,4,0,0
1668586438632,ECE 238B,A00,103649,Garay; Javier,0,0,0,0
1668586439057,ECE 240B,A00,112900,Fainman; Yeshaiahu,0,8,0,0
1668586439499,ECE 247A,A00,103650,Jokerst; Jesse Vincent,0,6,0,0
1668586439935,ECE 247B,A00,103651,Wang; Joseph,0,14,0,0
1668586440360,ECE 250,A00,103652,Siegel; Paul H.,0,85,0,0
1668586440783,ECE 251A,A00,103654,Rao; Bhaskar D.,0,65,0,0
1668586441213,ECE 257B,A00,103655,Bharadia; Dinesh,0,33,0,0
1668586441637,ECE 258A,A00,103656,Milstein; Laurence B.,0,29,0,0
1668586442060,ECE 260B,A00,103658,Kang; Mingu,0,121,0,0
1668586442486,ECE 264A,A00,103659,Galton; Ian A,0,42,0,34
1668586442914,ECE 265A,A00,103661,Gudem; Prasad S.S.,0,42,0,36
1668586443357,ECE 265D,A00,103662,Gudem; Prasad S.S.,0,27,0,0
1668586443888,ECE 268,A00,103663,Koushanfar; Farinaz,0,44,0,0
1668586444313,ECE 269,A01,103665,Pal; Piya,0,223,0,0
1668586444743,ECE 271B,A00,103666,Vasconcelos; Manuela,0,80,0,0
1668586445167,ECE 276A,A00,103667,Atanasov; Nikolay A.,0,127,0,0
1668586445598,ECE 277,A00,103668,An; Cheolhong,0,151,0,0
1668586446021,ECE 279,A00,117947,Hall; Drew A.,0,22,0,0
1668586446889,ECE 283,A00,103670,Hsueh; Tzu-Chien,0,57,0,0
1668586447323,ECE 284,A00,103671,Turakhia; Yatish Girish,0,40,0,0
1668586447751,ECE 285,A00,103672,Zheng; Yang,0,40,0,0
1668586447751,ECE 285,B00,103673,Sworder; David D.,0,61,0,0
1668586448182,ECE 287,A00,103676,Javidi; Tara,0,7,0,0
1668586448607,MATH 200B,A00,098023,Salehi Golsefidy; Alireza,7,0,15,8
1668586449041,MATH 202B,A00,098024,Rhoades; Brendon Patrick,7,0,15,8
1668586449467,MATH 203B,A00,098025,Oprea; Dragos N.,9,0,15,6
1668586449895,MATH 204B,A00,098026,Sorensen; Claus M,13,0,15,2
1668586450319,MATH 208,A00,098027,Izadi; Elham,7,0,10,3
1668586450742,MATH 209,A00,098028,Pollack; Aaron,10,0,10,0
1668586451165,MATH 211A,A00,112919,Rogalski; Daniel,8,0,10,2
1668586451587,MATH 211B,A00,112920,Seward; Brandon M.,9,0,10,1
1668586452012,MATH 218,A00,098029,Li; Bo,10,0,10,0
1668586452439,MATH 220B,A00,098030,Novak; Jonathan I,10,0,15,5
1668586452865,MATH 221A,A00,098031,Ebenfelt; Peter F,12,0,15,3
1668586453297,MATH 231B,A00,098032,Zlatos; Andrej,9,0,15,6
1668586453723,MATH 240B,A00,098033,Ni; Lei,7,0,15,8
1668586454147,MATH 243,A00,098034,Jekel; David Andrew,10,0,10,0
1668586454577,MATH 245A,A00,098035,Nie; Jiawang,0,7,15,18
1668586455001,MATH 248,A00,098036,Bejenaru; Ioan,10,0,10,0
1668586455433,MATH 250B,A00,098037,Spolaor; Luca,12,0,15,3
1668586455859,MATH 258,A00,098038,Ni; Lei,8,0,10,2
1668586456292,MATH 264B,A00,098041,Rhoades; Brendon Patrick,6,0,15,9
1668586456715,MATH 268,A00,098042,Buss; Samuel R,10,0,10,0
1668586457149,MATH 269,A00,098043,Rhoades; Brendon Patrick,10,0,10,0
1668586457574,MATH 270B,A00,098044,Li; Bo,6,0,15,9
1668586458016,MATH 272B,A00,098045,Holst; Michael J,13,0,15,2
1668586458439,MATH 273A,A00,098046,Tian; Xiaochuan,10,0,15,5
1668586458867,MATH 275,A01,098048,Tian; Xiaochuan,6,0,10,4
1668586459297,MATH 278A,A00,098049,Holst; Michael J,6,0,10,4
1668586459729,MATH 278B,A00,098050,Cloninger; Alexander,10,0,10,0
1668586460155,MATH 278C,A00,098051,Nie; Jiawang,5,0,10,5
1668586460585,MATH 280B,A00,098052,Zheng; Tianyi,6,0,15,9
1668586461008,MATH 281B,A00,098053,Bradic; Jelena,0,2,15,15
1668586461433,MATH 282B,A00,098054,Arias-Castro; Ery,0,1,15,15
1668586461855,MATH 285,A00,098055,Fitzsimmons; Patrick J,0,4,15,16
1668586462280,MATH 287B,A00,098056,Arias-Castro; Ery,1,0,15,14
1668586462704,MATH 288,A00,098057,Agarwal; Pooja,9,0,10,1
1668586462704,MATH 288,B00,098058,Zhang; Danna,8,0,10,2
1668586462704,MATH 288,C00,098059,Williams; Ruth J,9,0,10,1
1668586463137,MATH 290B,A00,098060,Roberts; Justin Deritter,12,0,15,3
1668586463559,MATH 292,A00,098061,Belmont; Eva Kinoshita,10,0,10,0
1668586463983,MATH 295,A00,098062,Suk; Andrew Hoon,47,0,50,3
1668586464414,MATH 296,A00,098063,Novak; Jonathan I,20,0,20,0
1668586464864,MATH 297,001,098064,Gamst; Anthony Collins,9997,0,9999,2
1668586971882,COGS 205,A00,101395,Chiba; Andrea,19,0,20,1
1668586972320,COGS 210B,001,101404,Greene; Deanna Jacquelyn,9998,0,9999,1
1668586972320,COGS 210B,002,101417,Xia; Haijun,9999,0,9999,0
1668586972320,COGS 210B,003,101422,Nitz; Douglas A.,9999,0,9999,0
1668586972320,COGS 210B,004,101423,Hollan; James D.,9998,0,9999,1
1668586972320,COGS 210B,005,101424,Deak; Gedeon O.,9998,0,9999,1
1668586972320,COGS 210B,006,101425,Rossano; Federico,9999,0,9999,0
1668586972748,COGS 211B,A00,101427,Coulson; Seana M,9996,0,9999,3
1668586973173,COGS 220,A00,101428,Hollan; James D.,0,17,25,25
1668586973610,COGS 229,A00,101429,Dow; Steven P,17,0,25,8
1668586974038,COGS 230,A00,101430,Klemmer; Scott R,6,0,17,11
1668586974461,COGS 234,A00,101431,Xia; Haijun,0,1,25,25
1668586974889,COGS 260,A00,101432,Kiyonaga; Anastasia,21,0,25,4
1668586974889,COGS 260,B00,101433,Kirsh; David Joel,15,0,25,10
1668586975317,CSE 202,A00,102371,Impagliazzo; Russell,0,70,0,0
1668586975741,CSE 203B,A01,102373,Cheng; Chung Kuan,0,70,0,0
1668586976167,CSE 208,A00,102374,Micciancio; Daniele,0,5,0,0
1668586976594,CSE 209A,A00,112895,Impagliazzo; Russell,0,14,15,15
1668586977019,CSE 209B,A00,108005,Bellare; Mihir,0,7,0,0
1668586977451,CSE 210,A00,113163,Coblenz; Michael J,0,96,0,0
1668586977878,CSE 219,A00,106111,Dow; Steven P,0,8,20,20
1668586978308,CSE 221,A00,102376,Voelker; Geoffrey M.,0,78,0,0
1668586978741,CSE 224,A01,102378,Porter; George M,0,181,0,0
1668586979168,CSE 229A,A00,102379,Savage; Stefan,0,14,0,0
1668586979596,CSE 229C,A00,102380,Munyaka; Imani N. S.,0,12,0,0
1668586980024,CSE 232B,A00,102382,Deutsch; Alin Bernard,0,40,0,0
1668586980450,CSE 234,A01,112904,Kumar; Arun Kumar,0,0,0,0
1668586980896,CSE 237A,A00,102383,Rosing; Tajana Simunic,0,57,0,0
1668586981322,CSE 239A,A00,102384,Deutsch; Alin Bernard,0,18,0,0
1668586981751,CSE 239B,A00,102385,Polikarpova; Nadezhda,0,11,0,0
1668586982175,CSE 240A,A00,102386,Pannuto; Patrick William,0,49,0,0
1668586982604,CSE 240B,A00,102387,Zhao; Jishen,0,51,0,0
1668586983032,CSE 241A,A00,106406,Kang; Mingu,0,9,0,0
1668586983457,CSE 249B,A00,102388,Kahng; Andrew Byun,0,7,8,8
1668586983885,CSE 251B,A01,102392,Cottrell; Garrison W,0,54,0,0
1668586983885,CSE 251B,A02,102393,Cottrell; Garrison W,0,36,0,0
1668586984318,CSE 252B,A00,102394,Ochoa; Benjamin Lawrence,0,64,0,0
1668586984744,CSE 257,A01,102396,Gao; Sicun,0,160,0,0
1668586985177,CSE 272,A00,102397,Li; Tzumao,0,22,0,0
1668586985604,CSE 274,A00,111323,Chern; Albert Ren-Haur,0,16,0,0
1668586986040,CSE 282,A00,102398,Pevzner; Pavel Arkadjevich,0,0,0,0
1668586986466,CSE 284,A00,114175,Gymrek; Melissa Ann,0,33,0,0
1668586986897,CSE 290,A00,102399,Chandraker; Manmohan Krishna,0,11,0,0
1668586986897,CSE 290,B00,102400,Vaccaro; Kristen Marie,0,10,25,25
1668586986897,CSE 290,C00,102414,Pannuto; Patrick William,0,1,25,25
1668586986897,CSE 290,D00,102427,Pevzner; Pavel Arkadjevich,0,0,0,0
1668586986897,CSE 290,E00,102429,Zhao; Jishen,0,6,0,0
1668586986897,CSE 290,F00,102436,Tullsen; Dean Michael,0,6,0,0
1668586986897,CSE 290,G00,102440,Christensen; Henrik I,0,8,20,20
1668586987323,CSE 291,A00,102443,Su; Hao,0,0,0,0
1668586987323,CSE 291,B00,102448,Polikarpova; Nadezhda,0,0,0,0
1668586987323,CSE 291,C00,102453,Vaccaro; Kristen Marie,0,0,0,0
1668586987323,CSE 291,D00,111343,Savage; Stefan,0,0,0,0
1668586987323,CSE 291,E00,116474,Claffy; Kimberly Claire,0,0,0,0
1668586987323,CSE 291,F00,116479,Pasquale; Joseph,0,0,0,0
1668586987758,CSE 293,001,119111,Bafna; Vineet,9999,0,9999,0
1668586987758,CSE 293,002,119118,Bellare; Mihir,9999,0,9999,0
1668586987758,CSE 293,003,119122,Berg-Kirkpatrick; Taylor D,9999,0,9999,0
1668586987758,CSE 293,004,119135,Christensen; Henrik I,9999,0,9999,0
1668586987758,CSE 293,005,119142,Cottrell; Garrison W,9999,0,9999,0
1668586987758,CSE 293,006,119146,Deutsch; Alin Bernard,9999,0,9999,0
1668586987758,CSE 293,007,119159,Esmaeilzadeh; Hadi,9999,0,9999,0
1668586987758,CSE 293,008,119166,Freund; Yoav,9999,0,9999,0
1668586987758,CSE 293,009,119170,Griswold; William G.,9999,0,9999,0
1668586987758,CSE 293,010,119183,Gymrek; Melissa Ann,9999,0,9999,0
1668586987758,CSE 293,011,119190,Heninger; Nadia A,9999,0,9999,0
1668586987758,CSE 293,012,119230,Impagliazzo; Russell,9999,0,9999,0
1668586987758,CSE 293,013,119232,Jhala; Ranjit,9999,0,9999,0
1668586987758,CSE 293,014,119233,Kahng; Andrew Byun,9999,0,9999,0
1668586987758,CSE 293,015,119298,Kane; Daniel Mertz,9999,0,9999,0
1668586987758,CSE 293,016,119299,Kriegman; David J,9999,0,9999,0
1668586987758,CSE 293,017,119300,Kumar; Arun Kumar,9999,0,9999,0
1668586987758,CSE 293,018,119301,Lerner; Sorin,9999,0,9999,0
1668586987758,CSE 293,019,119302,Lovett; Shachar,9999,0,9999,0
1668586987758,CSE 293,020,119303,McAuley; Julian John,9999,0,9999,0
1668586987758,CSE 293,021,119304,Micciancio; Daniele,9999,0,9999,0
1668586987758,CSE 293,022,119367,Orailoglu; Alex,9999,0,9999,0
1668586987758,CSE 293,023,119382,Paturi; Ramamohan,9999,0,9999,0
1668586987758,CSE 293,024,119404,Polikarpova; Nadezhda,9999,0,9999,0
1668586987758,CSE 293,025,119406,Politz; Joseph Gibbs,9999,0,9999,0
1668586987758,CSE 293,026,119411,Porter; George M,9999,0,9999,0
1668586987758,CSE 293,027,119414,Porter; Leonard Emerson,9999,0,9999,0
1668586987758,CSE 293,028,119416,Ramamoorthi; Ravi,9999,0,9999,0
1668586987758,CSE 293,029,119417,Sahoo; Debashis,9999,0,9999,0
1668586987758,CSE 293,030,119420,Saul; Lawrence,9999,0,9999,0
1668586987758,CSE 293,031,119421,Savage; Stefan,9999,0,9999,0
1668586987758,CSE 293,032,119425,Schulze; Jurgen P.,9999,0,9999,0
1668586987758,CSE 293,033,119426,Snoeren; Alex C.,9999,0,9999,0
1668586987758,CSE 293,034,119428,Shang; Jingbo,9999,0,9999,0
1668586987758,CSE 293,035,119430,Stefan; Deian,9999,0,9999,0
1668586987758,CSE 293,036,119431,Su; Hao,9999,0,9999,0
1668586987758,CSE 293,037,119433,Swanson; Steven James,9999,0,9999,0
1668586987758,CSE 293,038,119435,Tullsen; Dean Michael,9999,0,9999,0
1668586987758,CSE 293,039,119483,Voelker; Geoffrey M.,9999,0,9999,0
1668586987758,CSE 293,040,119537,Zhao; Jishen,9999,0,9999,0
1668586987758,CSE 293,041,119538,Zhou; Yuan-Yuan,9999,0,9999,0
1668586987758,CSE 293,042,119539,Gao; Sicun,9999,0,9999,0
1668586987758,CSE 293,043,119540,Weibel; Nadir,9999,0,9999,0
1668586987758,CSE 293,044,119541,Gupta; Rajesh K.,9999,0,9999,0
1668586987758,CSE 293,045,126410,Vaccaro; Kristen Marie,9999,0,9999,0
1668586987758,CSE 293,046,126411,Klemke; Richard,9999,0,9999,0
1668586988181,CSE 294,A00,102459,Voelker; Geoffrey M.,0,2,0,0
1668586988181,CSE 294,B00,111322,Orailoglu; Alex,0,2,0,0
1668586988607,DSE 201,A00,096914,Deutsch; Alin Bernard,30,0,30,0
1668586989034,DSE 210,A00,096915,Dasgupta; Sanjoy,30,0,30,0
1668586989465,DSE 241,A00,144528,Smith; Neil Gordon,30,0,30,0
1668586989893,DSE 260A,A00,096916,Altintas De Callaf; Ilkay,30,0,30,0
1668586990333,ECE 200,001,103586,Antipa; Nicholas A,9999,0,9999,0
1668586990333,ECE 200,002,103587,Atanasov; Nikolay A.,9999,0,9999,0
1668586990333,ECE 200,003,103588,Bharadia; Dinesh,9999,0,9999,0
1668586990333,ECE 200,004,103589,Cheng; Chung Kuan,9999,0,9999,0
1668586990333,ECE 200,005,103590,Cosman; Pamela C.,9999,0,9999,0
1668586990333,ECE 200,006,103591,Dayeh; Shadi Ahmad,9999,0,9999,0
1668586990333,ECE 200,007,103592,Fainman; Yeshaiahu,9999,0,9999,0
1668586990333,ECE 200,008,103593,Ford; Joseph Earl,9999,0,9999,0
1668586990333,ECE 200,009,103594,Franceschetti; Massimo,9999,0,9999,0
1668586990333,ECE 200,010,103595,Fullerton; Eric E,9999,0,9999,0
1668586990333,ECE 200,011,103596,Galton; Ian A,9999,0,9999,0
1668586990333,ECE 200,012,103597,Gilja; Vikash,9999,0,9999,0
1668586990333,ECE 200,013,103598,Hall; Drew A.,9999,0,9999,0
1668586990333,ECE 200,014,103599,Hsueh; Tzu-Chien,9999,0,9999,0
1668586990333,ECE 200,015,103600,Javidi; Tara,9999,0,9999,0
1668586990333,ECE 200,016,103601,Kahng; Andrew Byun,9999,0,9999,0
1668586990333,ECE 200,017,103602,Kim; Young-Han,9999,0,9999,0
1668586990333,ECE 200,018,103603,Koushanfar; Farinaz,9999,0,9999,0
1668586990333,ECE 200,019,103604,Kuzum; Duygu,9999,0,9999,0
1668586990333,ECE 200,020,103605,Le; Hanh-Phuc,9999,0,9999,0
1668586990333,ECE 200,021,103606,Lin; Bill,9999,0,9999,0
1668586990333,ECE 200,022,103607,Liu; Zhaowei,9998,0,9999,1
1668586990333,ECE 200,023,103608,Lo; Yu-Hwa,9999,0,9999,0
1668586990333,ECE 200,024,103609,Lomakin; Vitaliy,9999,0,9999,0
1668586990333,ECE 200,025,103610,Mercier; Patrick Philip,9999,0,9999,0
1668586990333,ECE 200,026,103611,Meyer; Florian,9999,0,9999,0
1668586990333,ECE 200,027,103612,Milstein; Laurence B.,9999,0,9999,0
1668586990333,ECE 200,028,103613,Mir Arabbaygi; Siavash,9999,0,9999,0
1668586990333,ECE 200,029,103614,Mookherjea; Shayan,9999,0,9999,0
1668586990333,ECE 200,030,103615,Morris; Karcher William,9999,0,9999,0
1668586990333,ECE 200,031,103616,Ng; Tse Nga,9999,0,9999,0
1668586990333,ECE 200,032,103617,Nguyen; Truong Quang,9999,0,9999,0
1668586990333,ECE 200,033,103618,Nomura; Kenji,9999,0,9999,0
1668586990333,ECE 200,034,103619,Orlitsky; Alon,9999,0,9999,0
1668586990333,ECE 200,035,103620,Pal; Piya,9999,0,9999,0
1668586990333,ECE 200,036,103621,Papen; George C.,9999,0,9999,0
1668586990333,ECE 200,037,103622,Radic; Stojan,9999,0,9999,0
1668586990333,ECE 200,038,103623,Rao; Bhaskar D.,9999,0,9999,0
1668586990333,ECE 200,039,103624,Rao; Ramesh R,9999,0,9999,0
1668586990333,ECE 200,040,103625,Rebeiz; Gabriel,9999,0,9999,0
1668586990333,ECE 200,041,103626,Sanford; John R,9999,0,9999,0
1668586990333,ECE 200,042,103627,Siegel; Paul H.,9999,0,9999,0
1668586990333,ECE 200,043,103628,Sievenpiper; Daniel F.,9999,0,9999,0
1668586990333,ECE 200,044,103629,Sworder; David D.,9999,0,9999,0
1668586990333,ECE 200,045,103630,Taur; Yuan,9999,0,9999,0
1668586990333,ECE 200,046,103631,Touri; Behrouz,9999,0,9999,0
1668586990333,ECE 200,047,103632,Trivedi; Mohan M.,9999,0,9999,0
1668586990333,ECE 200,048,103633,Vasconcelos; Nuno,9999,0,9999,0
1668586990333,ECE 200,049,103634,Wang; Xiaolong,9999,0,9999,0
1668586990333,ECE 200,050,103635,Xie; Pengtao,9999,0,9999,0
1668586990333,ECE 200,051,103636,Yip; Michael,9999,0,9999,0
1668586990333,ECE 200,052,103637,Zeger; Kenneth A.,999,0,999,0
1668586990333,ECE 200,053,103638,Zhang; Xinyu,9999,0,9999,0
1668586990333,ECE 200,054,103639,Turakhia; Yatish Girish,9999,0,9999,0
1668586990333,ECE 200,055,103640,Kang; Mingu,9999,0,9999,0
1668586990333,ECE 200,056,103641,Shi; Yuanyuan,9999,0,9999,0
1668586990333,ECE 200,057,103642,Wang; Edward Jay,9999,0,9999,0
1668586990333,ECE 200,058,103643,Zheng; Yang,9999,0,9999,0
1668586990758,ECE 202,A00,103644,Kuzum; Duygu,0,47,0,0
1668586991182,ECE 212BN,A00,103646,Ng; Tse Nga,0,10,0,0
1668586991606,ECE 221,A00,111493,Staff,0,0,0,0
1668586992033,ECE 222B,A00,103647,Lomakin; Vitaliy,0,22,0,0
1668586992457,ECE 230B,A00,103648,Taur; Yuan,0,4,0,0
1668586992881,ECE 238B,A00,103649,Garay; Javier,0,0,0,0
1668586993308,ECE 240B,A00,112900,Fainman; Yeshaiahu,0,8,0,0
1668586993733,ECE 247A,A00,103650,Jokerst; Jesse Vincent,0,6,0,0
1668586994156,ECE 247B,A00,103651,Wang; Joseph,0,14,0,0
1668586994579,ECE 250,A00,103652,Siegel; Paul H.,0,85,0,0
1668586995005,ECE 251A,A00,103654,Rao; Bhaskar D.,0,65,0,0
1668586995429,ECE 257B,A00,103655,Bharadia; Dinesh,0,33,0,0
1668586995853,ECE 258A,A00,103656,Milstein; Laurence B.,0,29,0,0
1668586996288,ECE 260B,A00,103658,Kang; Mingu,0,121,0,0
1668586996715,ECE 264A,A00,103659,Galton; Ian A,0,42,0,34
1668586997139,ECE 265A,A00,103661,Gudem; Prasad S.S.,0,42,0,36
1668586997566,ECE 265D,A00,103662,Gudem; Prasad S.S.,0,27,0,0
1668586997988,ECE 268,A00,103663,Koushanfar; Farinaz,0,44,0,0
1668586998412,ECE 269,A01,103665,Pal; Piya,0,223,0,0
1668586998845,ECE 271B,A00,103666,Vasconcelos; Manuela,0,80,0,0
1668586999272,ECE 276A,A00,103667,Atanasov; Nikolay A.,0,127,0,0
1668586999705,ECE 277,A00,103668,An; Cheolhong,0,151,0,0
1668587000128,ECE 279,A00,117947,Hall; Drew A.,0,22,0,0
1668587000975,ECE 283,A00,103670,Hsueh; Tzu-Chien,0,57,0,0
1668587001401,ECE 284,A00,103671,Turakhia; Yatish Girish,0,40,0,0
1668587001825,ECE 285,A00,103672,Zheng; Yang,0,40,0,0
1668587001825,ECE 285,B00,103673,Sworder; David D.,0,61,0,0
1668587002253,ECE 287,A00,103676,Javidi; Tara,0,7,0,0
1668587002677,MATH 200B,A00,098023,Salehi Golsefidy; Alireza,7,0,15,8
1668587003106,MATH 202B,A00,098024,Rhoades; Brendon Patrick,7,0,15,8
1668587003529,MATH 203B,A00,098025,Oprea; Dragos N.,9,0,15,6
1668587003956,MATH 204B,A00,098026,Sorensen; Claus M,13,0,15,2
1668587004385,MATH 208,A00,098027,Izadi; Elham,7,0,10,3
1668587004816,MATH 209,A00,098028,Pollack; Aaron,10,0,10,0
1668587005243,MATH 211A,A00,112919,Rogalski; Daniel,8,0,10,2
1668587005668,MATH 211B,A00,112920,Seward; Brandon M.,9,0,10,1
1668587006092,MATH 218,A00,098029,Li; Bo,10,0,10,0
1668587006516,MATH 220B,A00,098030,Novak; Jonathan I,10,0,15,5
1668587006944,MATH 221A,A00,098031,Ebenfelt; Peter F,12,0,15,3
1668587007379,MATH 231B,A00,098032,Zlatos; Andrej,9,0,15,6
1668587007815,MATH 240B,A00,098033,Ni; Lei,7,0,15,8
1668587008242,MATH 243,A00,098034,Jekel; David Andrew,10,0,10,0
1668587008670,MATH 245A,A00,098035,Nie; Jiawang,0,8,15,18
1668587009102,MATH 248,A00,098036,Bejenaru; Ioan,10,0,10,0
1668587009525,MATH 250B,A00,098037,Spolaor; Luca,12,0,15,3
1668587009946,MATH 258,A00,098038,Ni; Lei,8,0,10,2
1668587010374,MATH 264B,A00,098041,Rhoades; Brendon Patrick,6,0,15,9
1668587010801,MATH 268,A00,098042,Buss; Samuel R,10,0,10,0
1668587011224,MATH 269,A00,098043,Rhoades; Brendon Patrick,10,0,10,0
1668587011654,MATH 270B,A00,098044,Li; Bo,6,0,15,9
1668587012080,MATH 272B,A00,098045,Holst; Michael J,13,0,15,2
1668587012582,MATH 273A,A00,098046,Tian; Xiaochuan,10,0,15,5
1668587013009,MATH 275,A01,098048,Tian; Xiaochuan,6,0,10,4
1668587013433,MATH 278A,A00,098049,Holst; Michael J,6,0,10,4
1668587013862,MATH 278B,A00,098050,Cloninger; Alexander,10,0,10,0
1668587014299,MATH 278C,A00,098051,Nie; Jiawang,5,0,10,5
1668587014730,MATH 280B,A00,098052,Zheng; Tianyi,6,0,15,9
1668587015154,MATH 281B,A00,098053,Bradic; Jelena,0,2,15,15
1668587015583,MATH 282B,A00,098054,Arias-Castro; Ery,0,1,15,15
1668587016010,MATH 285,A00,098055,Fitzsimmons; Patrick J,0,4,15,16
1668587016436,MATH 287B,A00,098056,Arias-Castro; Ery,1,0,15,14
1668587016864,MATH 288,A00,098057,Agarwal; Pooja,9,0,10,1
1668587016864,MATH 288,B00,098058,Zhang; Danna,8,0,10,2
1668587016864,MATH 288,C00,098059,Williams; Ruth J,9,0,10,1
1668587017292,MATH 290B,A00,098060,Roberts; Justin Deritter,12,0,15,3
1668587017717,MATH 292,A00,098061,Belmont; Eva Kinoshita,10,0,10,0
1668587018158,MATH 295,A00,098062,Suk; Andrew Hoon,47,0,50,3
1668587018584,MATH 296,A00,098063,Novak; Jonathan I,20,0,20,0
1668587019009,MATH 297,001,098064,Gamst; Anthony Collins,9997,0,9999,2
1668587535065,COGS 205,A00,101395,Chiba; Andrea,19,0,20,1
1668587535498,COGS 210B,001,101404,Greene; Deanna Jacquelyn,9998,0,9999,1
1668587535498,COGS 210B,002,101417,Xia; Haijun,9999,0,9999,0
1668587535498,COGS 210B,003,101422,Nitz; Douglas A.,9999,0,9999,0
1668587535498,COGS 210B,004,101423,Hollan; James D.,9998,0,9999,1
1668587535498,COGS 210B,005,101424,Deak; Gedeon O.,9998,0,9999,1
1668587535498,COGS 210B,006,101425,Rossano; Federico,9999,0,9999,0
1668587535930,COGS 211B,A00,101427,Coulson; Seana M,9996,0,9999,3
1668587536356,COGS 220,A00,101428,Hollan; James D.,0,17,25,25
1668587536791,COGS 229,A00,101429,Dow; Steven P,17,0,25,8
1668587537219,COGS 230,A00,101430,Klemmer; Scott R,6,0,17,11
1668587537648,COGS 234,A00,101431,Xia; Haijun,0,1,25,25
1668587538086,COGS 260,A00,101432,Kiyonaga; Anastasia,21,0,25,4
1668587538086,COGS 260,B00,101433,Kirsh; David Joel,15,0,25,10
1668587538518,CSE 202,A00,102371,Impagliazzo; Russell,0,70,0,0
1668587538956,CSE 203B,A01,102373,Cheng; Chung Kuan,0,70,0,0
1668587539382,CSE 208,A00,102374,Micciancio; Daniele,0,5,0,0
1668587539808,CSE 209A,A00,112895,Impagliazzo; Russell,0,14,15,15
1668587540237,CSE 209B,A00,108005,Bellare; Mihir,0,7,0,0
1668587540674,CSE 210,A00,113163,Coblenz; Michael J,0,96,0,0
1668587541101,CSE 219,A00,106111,Dow; Steven P,0,8,20,20
1668587541526,CSE 221,A00,102376,Voelker; Geoffrey M.,0,78,0,0
1668587541950,CSE 224,A01,102378,Porter; George M,0,181,0,0
1668587542383,CSE 229A,A00,102379,Savage; Stefan,0,14,0,0
1668587542833,CSE 229C,A00,102380,Munyaka; Imani N. S.,0,12,0,0
1668587543261,CSE 232B,A00,102382,Deutsch; Alin Bernard,0,40,0,0
1668587543694,CSE 234,A01,112904,Kumar; Arun Kumar,0,0,0,0
1668587544122,CSE 237A,A00,102383,Rosing; Tajana Simunic,0,57,0,0
1668587544552,CSE 239A,A00,102384,Deutsch; Alin Bernard,0,18,0,0
1668587544977,CSE 239B,A00,102385,Polikarpova; Nadezhda,0,11,0,0
1668587545404,CSE 240A,A00,102386,Pannuto; Patrick William,0,49,0,0
1668587545833,CSE 240B,A00,102387,Zhao; Jishen,0,51,0,0
1668587546258,CSE 241A,A00,106406,Kang; Mingu,0,9,0,0
1668587546690,CSE 249B,A00,102388,Kahng; Andrew Byun,0,7,8,8
1668587547246,CSE 251B,A01,102392,Cottrell; Garrison W,0,54,0,0
1668587547246,CSE 251B,A02,102393,Cottrell; Garrison W,0,36,0,0
1668587547684,CSE 252B,A00,102394,Ochoa; Benjamin Lawrence,0,64,0,0
1668587548108,CSE 257,A01,102396,Gao; Sicun,0,160,0,0
1668587548545,CSE 272,A00,102397,Li; Tzumao,0,22,0,0
1668587548971,CSE 274,A00,111323,Chern; Albert Ren-Haur,0,16,0,0
1668587549400,CSE 282,A00,102398,Pevzner; Pavel Arkadjevich,0,0,0,0
1668587549825,CSE 284,A00,114175,Gymrek; Melissa Ann,0,33,0,0
1668587550258,CSE 290,A00,102399,Chandraker; Manmohan Krishna,0,11,0,0
1668587550258,CSE 290,B00,102400,Vaccaro; Kristen Marie,0,10,25,25
1668587550258,CSE 290,C00,102414,Pannuto; Patrick William,0,1,25,25
1668587550258,CSE 290,D00,102427,Pevzner; Pavel Arkadjevich,0,0,0,0
1668587550258,CSE 290,E00,102429,Zhao; Jishen,0,6,0,0
1668587550258,CSE 290,F00,102436,Tullsen; Dean Michael,0,6,0,0
1668587550258,CSE 290,G00,102440,Christensen; Henrik I,0,8,20,20
1668587550693,CSE 291,A00,102443,Su; Hao,0,0,0,0
1668587550693,CSE 291,B00,102448,Polikarpova; Nadezhda,0,0,0,0
1668587550693,CSE 291,C00,102453,Vaccaro; Kristen Marie,0,0,0,0
1668587550693,CSE 291,D00,111343,Savage; Stefan,0,0,0,0
1668587550693,CSE 291,E00,116474,Claffy; Kimberly Claire,0,0,0,0
1668587550693,CSE 291,F00,116479,Pasquale; Joseph,0,0,0,0
1668587551141,CSE 293,001,119111,Bafna; Vineet,9999,0,9999,0
1668587551141,CSE 293,002,119118,Bellare; Mihir,9999,0,9999,0
1668587551141,CSE 293,003,119122,Berg-Kirkpatrick; Taylor D,9999,0,9999,0
1668587551141,CSE 293,004,119135,Christensen; Henrik I,9999,0,9999,0
1668587551141,CSE 293,005,119142,Cottrell; Garrison W,9999,0,9999,0
1668587551141,CSE 293,006,119146,Deutsch; Alin Bernard,9999,0,9999,0
1668587551141,CSE 293,007,119159,Esmaeilzadeh; Hadi,9999,0,9999,0
1668587551141,CSE 293,008,119166,Freund; Yoav,9999,0,9999,0
1668587551141,CSE 293,009,119170,Griswold; William G.,9999,0,9999,0
1668587551141,CSE 293,010,119183,Gymrek; Melissa Ann,9999,0,9999,0
1668587551141,CSE 293,011,119190,Heninger; Nadia A,9999,0,9999,0
1668587551141,CSE 293,012,119230,Impagliazzo; Russell,9999,0,9999,0
1668587551141,CSE 293,013,119232,Jhala; Ranjit,9999,0,9999,0
1668587551141,CSE 293,014,119233,Kahng; Andrew Byun,9999,0,9999,0
1668587551141,CSE 293,015,119298,Kane; Daniel Mertz,9999,0,9999,0
1668587551141,CSE 293,016,119299,Kriegman; David J,9999,0,9999,0
1668587551141,CSE 293,017,119300,Kumar; Arun Kumar,9999,0,9999,0
1668587551141,CSE 293,018,119301,Lerner; Sorin,9999,0,9999,0
1668587551141,CSE 293,019,119302,Lovett; Shachar,9999,0,9999,0
1668587551141,CSE 293,020,119303,McAuley; Julian John,9999,0,9999,0
1668587551141,CSE 293,021,119304,Micciancio; Daniele,9999,0,9999,0
1668587551141,CSE 293,022,119367,Orailoglu; Alex,9999,0,9999,0
1668587551141,CSE 293,023,119382,Paturi; Ramamohan,9999,0,9999,0
1668587551141,CSE 293,024,119404,Polikarpova; Nadezhda,9999,0,9999,0
1668587551141,CSE 293,025,119406,Politz; Joseph Gibbs,9999,0,9999,0
1668587551141,CSE 293,026,119411,Porter; George M,9999,0,9999,0
1668587551141,CSE 293,027,119414,Porter; Leonard Emerson,9999,0,9999,0
1668587551141,CSE 293,028,119416,Ramamoorthi; Ravi,9999,0,9999,0
1668587551141,CSE 293,029,119417,Sahoo; Debashis,9999,0,9999,0
1668587551141,CSE 293,030,119420,Saul; Lawrence,9999,0,9999,0
1668587551141,CSE 293,031,119421,Savage; Stefan,9999,0,9999,0
1668587551141,CSE 293,032,119425,Schulze; Jurgen P.,9999,0,9999,0
1668587551141,CSE 293,033,119426,Snoeren; Alex C.,9999,0,9999,0
1668587551141,CSE 293,034,119428,Shang; Jingbo,9999,0,9999,0
1668587551141,CSE 293,035,119430,Stefan; Deian,9999,0,9999,0
1668587551141,CSE 293,036,119431,Su; Hao,9999,0,9999,0
1668587551141,CSE 293,037,119433,Swanson; Steven James,9999,0,9999,0
1668587551141,CSE 293,038,119435,Tullsen; Dean Michael,9999,0,9999,0
1668587551141,CSE 293,039,119483,Voelker; Geoffrey M.,9999,0,9999,0
1668587551141,CSE 293,040,119537,Zhao; Jishen,9999,0,9999,0
1668587551141,CSE 293,041,119538,Zhou; Yuan-Yuan,9999,0,9999,0
1668587551141,CSE 293,042,119539,Gao; Sicun,9999,0,9999,0
1668587551141,CSE 293,043,119540,Weibel; Nadir,9999,0,9999,0
1668587551141,CSE 293,044,119541,Gupta; Rajesh K.,9999,0,9999,0
1668587551141,CSE 293,045,126410,Vaccaro; Kristen Marie,9999,0,9999,0
1668587551141,CSE 293,046,126411,Klemke; Richard,9999,0,9999,0
1668587551578,CSE 294,A00,102459,Voelker; Geoffrey M.,0,2,0,0
1668587551578,CSE 294,B00,111322,Orailoglu; Alex,0,2,0,0
1668587552010,DSE 201,A00,096914,Deutsch; Alin Bernard,30,0,30,0
1668587552434,DSE 210,A00,096915,Dasgupta; Sanjoy,30,0,30,0
1668587552864,DSE 241,A00,144528,Smith; Neil Gordon,30,0,30,0
1668587553303,DSE 260A,A00,096916,Altintas De Callaf; Ilkay,30,0,30,0
1668587553759,ECE 200,001,103586,Antipa; Nicholas A,9999,0,9999,0
1668587553759,ECE 200,002,103587,Atanasov; Nikolay A.,9999,0,9999,0
1668587553759,ECE 200,003,103588,Bharadia; Dinesh,9999,0,9999,0
1668587553759,ECE 200,004,103589,Cheng; Chung Kuan,9999,0,9999,0
1668587553759,ECE 200,005,103590,Cosman; Pamela C.,9999,0,9999,0
1668587553759,ECE 200,006,103591,Dayeh; Shadi Ahmad,9999,0,9999,0
1668587553759,ECE 200,007,103592,Fainman; Yeshaiahu,9999,0,9999,0
1668587553759,ECE 200,008,103593,Ford; Joseph Earl,9999,0,9999,0
1668587553759,ECE 200,009,103594,Franceschetti; Massimo,9999,0,9999,0
1668587553759,ECE 200,010,103595,Fullerton; Eric E,9999,0,9999,0
1668587553759,ECE 200,011,103596,Galton; Ian A,9999,0,9999,0
1668587553759,ECE 200,012,103597,Gilja; Vikash,9999,0,9999,0
1668587553759,ECE 200,013,103598,Hall; Drew A.,9999,0,9999,0
1668587553759,ECE 200,014,103599,Hsueh; Tzu-Chien,9999,0,9999,0
1668587553759,ECE 200,015,103600,Javidi; Tara,9999,0,9999,0
1668587553759,ECE 200,016,103601,Kahng; Andrew Byun,9999,0,9999,0
1668587553759,ECE 200,017,103602,Kim; Young-Han,9999,0,9999,0
1668587553759,ECE 200,018,103603,Koushanfar; Farinaz,9999,0,9999,0
1668587553759,ECE 200,019,103604,Kuzum; Duygu,9999,0,9999,0
1668587553759,ECE 200,020,103605,Le; Hanh-Phuc,9999,0,9999,0
1668587553759,ECE 200,021,103606,Lin; Bill,9999,0,9999,0
1668587553759,ECE 200,022,103607,Liu; Zhaowei,9998,0,9999,1
1668587553759,ECE 200,023,103608,Lo; Yu-Hwa,9999,0,9999,0
1668587553759,ECE 200,024,103609,Lomakin; Vitaliy,9999,0,9999,0
1668587553759,ECE 200,025,103610,Mercier; Patrick Philip,9999,0,9999,0
1668587553759,ECE 200,026,103611,Meyer; Florian,9999,0,9999,0
1668587553759,ECE 200,027,103612,Milstein; Laurence B.,9999,0,9999,0
1668587553759,ECE 200,028,103613,Mir Arabbaygi; Siavash,9999,0,9999,0
1668587553759,ECE 200,029,103614,Mookherjea; Shayan,9999,0,9999,0
1668587553759,ECE 200,030,103615,Morris; Karcher William,9999,0,9999,0
1668587553759,ECE 200,031,103616,Ng; Tse Nga,9999,0,9999,0
1668587553759,ECE 200,032,103617,Nguyen; Truong Quang,9999,0,9999,0
1668587553759,ECE 200,033,103618,Nomura; Kenji,9999,0,9999,0
1668587553759,ECE 200,034,103619,Orlitsky; Alon,9999,0,9999,0
1668587553759,ECE 200,035,103620,Pal; Piya,9999,0,9999,0
1668587553759,ECE 200,036,103621,Papen; George C.,9999,0,9999,0
1668587553759,ECE 200,037,103622,Radic; Stojan,9999,0,9999,0
1668587553759,ECE 200,038,103623,Rao; Bhaskar D.,9999,0,9999,0
1668587553759,ECE 200,039,103624,Rao; Ramesh R,9999,0,9999,0
1668587553759,ECE 200,040,103625,Rebeiz; Gabriel,9999,0,9999,0
1668587553759,ECE 200,041,103626,Sanford; John R,9999,0,9999,0
1668587553759,ECE 200,042,103627,Siegel; Paul H.,9999,0,9999,0
1668587553759,ECE 200,043,103628,Sievenpiper; Daniel F.,9999,0,9999,0
1668587553759,ECE 200,044,103629,Sworder; David D.,9999,0,9999,0
1668587553759,ECE 200,045,103630,Taur; Yuan,9999,0,9999,0
1668587553759,ECE 200,046,103631,Touri; Behrouz,9999,0,9999,0
1668587553759,ECE 200,047,103632,Trivedi; Mohan M.,9999,0,9999,0
1668587553759,ECE 200,048,103633,Vasconcelos; Nuno,9999,0,9999,0
1668587553759,ECE 200,049,103634,Wang; Xiaolong,9999,0,9999,0
1668587553759,ECE 200,050,103635,Xie; Pengtao,9999,0,9999,0
1668587553759,ECE 200,051,103636,Yip; Michael,9999,0,9999,0
1668587553759,ECE 200,052,103637,Zeger; Kenneth A.,999,0,999,0
1668587553759,ECE 200,053,103638,Zhang; Xinyu,9999,0,9999,0
1668587553759,ECE 200,054,103639,Turakhia; Yatish Girish,9999,0,9999,0
1668587553759,ECE 200,055,103640,Kang; Mingu,9999,0,9999,0
1668587553759,ECE 200,056,103641,Shi; Yuanyuan,9999,0,9999,0
1668587553759,ECE 200,057,103642,Wang; Edward Jay,9999,0,9999,0
1668587553759,ECE 200,058,103643,Zheng; Yang,9999,0,9999,0
1668587554188,ECE 202,A00,103644,Kuzum; Duygu,0,47,0,0
1668587554611,ECE 212BN,A00,103646,Ng; Tse Nga,0,10,0,0
1668587555044,ECE 221,A00,111493,Staff,0,0,0,0
1668587555468,ECE 222B,A00,103647,Lomakin; Vitaliy,0,22,0,0
1668587555893,ECE 230B,A00,103648,Taur; Yuan,0,4,0,0
1668587556318,ECE 238B,A00,103649,Garay; Javier,0,0,0,0
1668587556746,ECE 240B,A00,112900,Fainman; Yeshaiahu,0,8,0,0
1668587557180,ECE 247A,A00,103650,Jokerst; Jesse Vincent,0,6,0,0
1668587557613,ECE 247B,A00,103651,Wang; Joseph,0,14,0,0
1668587558045,ECE 250,A00,103652,Siegel; Paul H.,0,85,0,0
1668587558483,ECE 251A,A00,103654,Rao; Bhaskar D.,0,65,0,0
1668587558907,ECE 257B,A00,103655,Bharadia; Dinesh,0,33,0,0
1668587559345,ECE 258A,A00,103656,Milstein; Laurence B.,0,29,0,0
1668587559769,ECE 260B,A00,103658,Kang; Mingu,0,121,0,0
1668587560206,ECE 264A,A00,103659,Galton; Ian A,0,42,0,34
1668587560629,ECE 265A,A00,103661,Gudem; Prasad S.S.,0,42,0,36
1668587561071,ECE 265D,A00,103662,Gudem; Prasad S.S.,0,27,0,0
1668587561507,ECE 268,A00,103663,Koushanfar; Farinaz,0,44,0,0
1668587561933,ECE 269,A01,103665,Pal; Piya,0,223,0,0
1668587562370,ECE 271B,A00,103666,Vasconcelos; Manuela,0,80,0,0
1668587562801,ECE 276A,A00,103667,Atanasov; Nikolay A.,0,127,0,0
1668587563226,ECE 277,A00,103668,An; Cheolhong,0,151,0,0
1668587563651,ECE 279,A00,117947,Hall; Drew A.,0,22,0,0
1668587564499,ECE 283,A00,103670,Hsueh; Tzu-Chien,0,57,0,0
1668587564927,ECE 284,A00,103671,Turakhia; Yatish Girish,0,40,0,0
1668587565355,ECE 285,A00,103672,Zheng; Yang,0,40,0,0
1668587565355,ECE 285,B00,103673,Sworder; David D.,0,61,0,0
1668587565781,ECE 287,A00,103676,Javidi; Tara,0,7,0,0
1668587566231,MATH 200B,A00,098023,Salehi Golsefidy; Alireza,7,0,15,8
1668587566660,MATH 202B,A00,098024,Rhoades; Brendon Patrick,7,0,15,8
1668587567093,MATH 203B,A00,098025,Oprea; Dragos N.,9,0,15,6
1668587567516,MATH 204B,A00,098026,Sorensen; Claus M,13,0,15,2
1668587567939,MATH 208,A00,098027,Izadi; Elham,7,0,10,3
1668587568379,MATH 209,A00,098028,Pollack; Aaron,10,0,10,0
1668587568803,MATH 211A,A00,112919,Rogalski; Daniel,8,0,10,2
1668587569228,MATH 211B,A00,112920,Seward; Brandon M.,9,0,10,1
1668587569663,MATH 218,A00,098029,Li; Bo,10,0,10,0
1668587570094,MATH 220B,A00,098030,Novak; Jonathan I,10,0,15,5
1668587570523,MATH 221A,A00,098031,Ebenfelt; Peter F,12,0,15,3
1668587570945,MATH 231B,A00,098032,Zlatos; Andrej,9,0,15,6
1668587571383,MATH 240B,A00,098033,Ni; Lei,7,0,15,8
1668587571808,MATH 243,A00,098034,Jekel; David Andrew,10,0,10,0
1668587572237,MATH 245A,A00,098035,Nie; Jiawang,0,8,15,18
1668587572662,MATH 248,A00,098036,Bejenaru; Ioan,10,0,10,0
1668587573100,MATH 250B,A00,098037,Spolaor; Luca,12,0,15,3
1668587573528,MATH 258,A00,098038,Ni; Lei,8,0,10,2
1668587573967,MATH 264B,A00,098041,Rhoades; Brendon Patrick,6,0,15,9
1668587574398,MATH 268,A00,098042,Buss; Samuel R,10,0,10,0
1668587574832,MATH 269,A00,098043,Rhoades; Brendon Patrick,10,0,10,0
1668587575275,MATH 270B,A00,098044,Li; Bo,6,0,15,9
1668587575704,MATH 272B,A00,098045,Holst; Michael J,13,0,15,2
1668587576141,MATH 273A,A00,098046,Tian; Xiaochuan,10,0,15,5
1668587576570,MATH 275,A01,098048,Tian; Xiaochuan,6,0,10,4
1668587576996,MATH 278A,A00,098049,Holst; Michael J,6,0,10,4
1668587577425,MATH 278B,A00,098050,Cloninger; Alexander,10,0,10,0
1668587577870,MATH 278C,A00,098051,Nie; Jiawang,5,0,10,5
1668587578317,MATH 280B,A00,098052,Zheng; Tianyi,6,0,15,9
1668587578753,MATH 281B,A00,098053,Bradic; Jelena,0,2,15,15
1668587579211,MATH 282B,A00,098054,Arias-Castro; Ery,0,1,15,15
1668587579636,MATH 285,A00,098055,Fitzsimmons; Patrick J,0,4,15,16
1668587580063,MATH 287B,A00,098056,Arias-Castro; Ery,1,0,15,14
1668587580498,MATH 288,A00,098057,Agarwal; Pooja,9,0,10,1
1668587580498,MATH 288,B00,098058,Zhang; Danna,8,0,10,2
1668587580498,MATH 288,C00,098059,Williams; Ruth J,9,0,10,1
1668587580925,MATH 290B,A00,098060,Roberts; Justin Deritter,12,0,15,3
1668587581357,MATH 292,A00,098061,Belmont; Eva Kinoshita,10,0,10,0
1668587581797,MATH 295,A00,098062,Suk; Andrew Hoon,47,0,50,3
1668587582222,MATH 296,A00,098063,Novak; Jonathan I,20,0,20,0
1668587582648,MATH 297,001,098064,Gamst; Anthony Collins,9997,0,9999,2
1668588087991,COGS 205,A00,101395,Chiba; Andrea,19,0,20,1
1668588088430,COGS 210B,001,101404,Greene; Deanna Jacquelyn,9998,0,9999,1
1668588088430,COGS 210B,002,101417,Xia; Haijun,9999,0,9999,0
1668588088430,COGS 210B,003,101422,Nitz; Douglas A.,9999,0,9999,0
1668588088430,COGS 210B,004,101423,Hollan; James D.,9998,0,9999,1
1668588088430,COGS 210B,005,101424,Deak; Gedeon O.,9998,0,9999,1
1668588088430,COGS 210B,006,101425,Rossano; Federico,9999,0,9999,0
1668588088855,COGS 211B,A00,101427,Coulson; Seana M,9996,0,9999,3
1668588089281,COGS 220,A00,101428,Hollan; James D.,0,17,25,25
1668588089712,COGS 229,A00,101429,Dow; Steven P,17,0,25,8
1668588090142,COGS 230,A00,101430,Klemmer; Scott R,6,0,17,11
1668588090574,COGS 234,A00,101431,Xia; Haijun,0,1,25,25
1668588091000,COGS 260,A00,101432,Kiyonaga; Anastasia,21,0,25,4
1668588091000,COGS 260,B00,101433,Kirsh; David Joel,15,0,25,10
1668588091430,CSE 202,A00,102371,Impagliazzo; Russell,0,70,0,0
1668588091860,CSE 203B,A01,102373,Cheng; Chung Kuan,0,70,0,0
1668588092284,CSE 208,A00,102374,Micciancio; Daniele,0,5,0,0
1668588092716,CSE 209A,A00,112895,Impagliazzo; Russell,0,14,15,15
1668588093146,CSE 209B,A00,108005,Bellare; Mihir,0,7,0,0
1668588093573,CSE 210,A00,113163,Coblenz; Michael J,0,96,0,0
1668588093997,CSE 219,A00,106111,Dow; Steven P,0,8,20,20
1668588094423,CSE 221,A00,102376,Voelker; Geoffrey M.,0,78,0,0
1668588094847,CSE 224,A01,102378,Porter; George M,0,181,0,0
1668588095270,CSE 229A,A00,102379,Savage; Stefan,0,14,0,0
1668588095694,CSE 229C,A00,102380,Munyaka; Imani N. S.,0,12,0,0
1668588096130,CSE 232B,A00,102382,Deutsch; Alin Bernard,0,40,0,0
1668588096558,CSE 234,A01,112904,Kumar; Arun Kumar,0,0,0,0
1668588096982,CSE 237A,A00,102383,Rosing; Tajana Simunic,0,57,0,0
1668588097408,CSE 239A,A00,102384,Deutsch; Alin Bernard,0,18,0,0
1668588097835,CSE 239B,A00,102385,Polikarpova; Nadezhda,0,11,0,0
1668588098264,CSE 240A,A00,102386,Pannuto; Patrick William,0,49,0,0
1668588098689,CSE 240B,A00,102387,Zhao; Jishen,0,51,0,0
1668588099113,CSE 241A,A00,106406,Kang; Mingu,0,9,0,0
1668588099542,CSE 249B,A00,102388,Kahng; Andrew Byun,0,7,8,8
1668588099966,CSE 251B,A01,102392,Cottrell; Garrison W,0,54,0,0
1668588099966,CSE 251B,A02,102393,Cottrell; Garrison W,0,36,0,0
1668588100395,CSE 252B,A00,102394,Ochoa; Benjamin Lawrence,0,64,0,0
1668588100820,CSE 257,A01,102396,Gao; Sicun,0,160,0,0
1668588101258,CSE 272,A00,102397,Li; Tzumao,0,22,0,0
1668588101687,CSE 274,A00,111323,Chern; Albert Ren-Haur,0,16,0,0
1668588102127,CSE 282,A00,102398,Pevzner; Pavel Arkadjevich,0,0,0,0
1668588102553,CSE 284,A00,114175,Gymrek; Melissa Ann,0,33,0,0
1668588102982,CSE 290,A00,102399,Chandraker; Manmohan Krishna,0,11,0,0
1668588102982,CSE 290,B00,102400,Vaccaro; Kristen Marie,0,10,25,25
1668588102982,CSE 290,C00,102414,Pannuto; Patrick William,0,1,25,25
1668588102982,CSE 290,D00,102427,Pevzner; Pavel Arkadjevich,0,0,0,0
1668588102982,CSE 290,E00,102429,Zhao; Jishen,0,6,0,0
1668588102982,CSE 290,F00,102436,Tullsen; Dean Michael,0,6,0,0
1668588102982,CSE 290,G00,102440,Christensen; Henrik I,0,8,20,20
1668588103419,CSE 291,A00,102443,Su; Hao,0,0,0,0
1668588103419,CSE 291,B00,102448,Polikarpova; Nadezhda,0,0,0,0
1668588103419,CSE 291,C00,102453,Vaccaro; Kristen Marie,0,0,0,0
1668588103419,CSE 291,D00,111343,Savage; Stefan,0,0,0,0
1668588103419,CSE 291,E00,116474,Claffy; Kimberly Claire,0,0,0,0
1668588103419,CSE 291,F00,116479,Pasquale; Joseph,0,0,0,0
1668588103867,CSE 293,001,119111,Bafna; Vineet,9999,0,9999,0
1668588103867,CSE 293,002,119118,Bellare; Mihir,9999,0,9999,0
1668588103867,CSE 293,003,119122,Berg-Kirkpatrick; Taylor D,9999,0,9999,0
1668588103867,CSE 293,004,119135,Christensen; Henrik I,9999,0,9999,0
1668588103867,CSE 293,005,119142,Cottrell; Garrison W,9999,0,9999,0
1668588103867,CSE 293,006,119146,Deutsch; Alin Bernard,9999,0,9999,0
1668588103867,CSE 293,007,119159,Esmaeilzadeh; Hadi,9999,0,9999,0
1668588103867,CSE 293,008,119166,Freund; Yoav,9999,0,9999,0
1668588103867,CSE 293,009,119170,Griswold; William G.,9999,0,9999,0
1668588103867,CSE 293,010,119183,Gymrek; Melissa Ann,9999,0,9999,0
1668588103867,CSE 293,011,119190,Heninger; Nadia A,9999,0,9999,0
1668588103867,CSE 293,012,119230,Impagliazzo; Russell,9999,0,9999,0
1668588103867,CSE 293,013,119232,Jhala; Ranjit,9999,0,9999,0
1668588103867,CSE 293,014,119233,Kahng; Andrew Byun,9999,0,9999,0
1668588103867,CSE 293,015,119298,Kane; Daniel Mertz,9999,0,9999,0
1668588103867,CSE 293,016,119299,Kriegman; David J,9999,0,9999,0
1668588103867,CSE 293,017,119300,Kumar; Arun Kumar,9999,0,9999,0
1668588103867,CSE 293,018,119301,Lerner; Sorin,9999,0,9999,0
1668588103867,CSE 293,019,119302,Lovett; Shachar,9999,0,9999,0
1668588103867,CSE 293,020,119303,McAuley; Julian John,9999,0,9999,0
1668588103867,CSE 293,021,119304,Micciancio; Daniele,9999,0,9999,0
1668588103867,CSE 293,022,119367,Orailoglu; Alex,9999,0,9999,0
1668588103867,CSE 293,023,119382,Paturi; Ramamohan,9999,0,9999,0
1668588103867,CSE 293,024,119404,Polikarpova; Nadezhda,9999,0,9999,0
1668588103867,CSE 293,025,119406,Politz; Joseph Gibbs,9999,0,9999,0
1668588103867,CSE 293,026,119411,Porter; George M,9999,0,9999,0
1668588103867,CSE 293,027,119414,Porter; Leonard Emerson,9999,0,9999,0
1668588103867,CSE 293,028,119416,Ramamoorthi; Ravi,9999,0,9999,0
1668588103867,CSE 293,029,119417,Sahoo; Debashis,9999,0,9999,0
1668588103867,CSE 293,030,119420,Saul; Lawrence,9999,0,9999,0
1668588103867,CSE 293,031,119421,Savage; Stefan,9999,0,9999,0
1668588103867,CSE 293,032,119425,Schulze; Jurgen P.,9999,0,9999,0
1668588103867,CSE 293,033,119426,Snoeren; Alex C.,9999,0,9999,0
1668588103867,CSE 293,034,119428,Shang; Jingbo,9999,0,9999,0
1668588103867,CSE 293,035,119430,Stefan; Deian,9999,0,9999,0
1668588103867,CSE 293,036,119431,Su; Hao,9999,0,9999,0
1668588103867,CSE 293,037,119433,Swanson; Steven James,9999,0,9999,0
1668588103867,CSE 293,038,119435,Tullsen; Dean Michael,9999,0,9999,0
1668588103867,CSE 293,039,119483,Voelker; Geoffrey M.,9999,0,9999,0
1668588103867,CSE 293,040,119537,Zhao; Jishen,9999,0,9999,0
1668588103867,CSE 293,041,119538,Zhou; Yuan-Yuan,9999,0,9999,0
1668588103867,CSE 293,042,119539,Gao; Sicun,9999,0,9999,0
1668588103867,CSE 293,043,119540,Weibel; Nadir,9999,0,9999,0
1668588103867,CSE 293,044,119541,Gupta; Rajesh K.,9999,0,9999,0
1668588103867,CSE 293,045,126410,Vaccaro; Kristen Marie,9999,0,9999,0
1668588103867,CSE 293,046,126411,Klemke; Richard,9999,0,9999,0
1668588104292,CSE 294,A00,102459,Voelker; Geoffrey M.,0,2,0,0
1668588104292,CSE 294,B00,111322,Orailoglu; Alex,0,2,0,0
1668588104727,DSE 201,A00,096914,Deutsch; Alin Bernard,30,0,30,0
1668588105154,DSE 210,A00,096915,Dasgupta; Sanjoy,30,0,30,0
1668588105592,DSE 241,A00,144528,Smith; Neil Gordon,30,0,30,0
1668588106023,DSE 260A,A00,096916,Altintas De Callaf; Ilkay,30,0,30,0
1668588106505,ECE 200,001,103586,Antipa; Nicholas A,9999,0,9999,0
1668588106505,ECE 200,002,103587,Atanasov; Nikolay A.,9999,0,9999,0
1668588106505,ECE 200,003,103588,Bharadia; Dinesh,9999,0,9999,0
1668588106505,ECE 200,004,103589,Cheng; Chung Kuan,9999,0,9999,0
1668588106505,ECE 200,005,103590,Cosman; Pamela C.,9999,0,9999,0
1668588106505,ECE 200,006,103591,Dayeh; Shadi Ahmad,9999,0,9999,0
1668588106505,ECE 200,007,103592,Fainman; Yeshaiahu,9999,0,9999,0
1668588106505,ECE 200,008,103593,Ford; Joseph Earl,9999,0,9999,0
1668588106505,ECE 200,009,103594,Franceschetti; Massimo,9999,0,9999,0
1668588106505,ECE 200,010,103595,Fullerton; Eric E,9999,0,9999,0
1668588106505,ECE 200,011,103596,Galton; Ian A,9999,0,9999,0
1668588106505,ECE 200,012,103597,Gilja; Vikash,9999,0,9999,0
1668588106505,ECE 200,013,103598,Hall; Drew A.,9999,0,9999,0
1668588106505,ECE 200,014,103599,Hsueh; Tzu-Chien,9999,0,9999,0
1668588106505,ECE 200,015,103600,Javidi; Tara,9999,0,9999,0
1668588106505,ECE 200,016,103601,Kahng; Andrew Byun,9999,0,9999,0
1668588106505,ECE 200,017,103602,Kim; Young-Han,9999,0,9999,0
1668588106505,ECE 200,018,103603,Koushanfar; Farinaz,9999,0,9999,0
1668588106505,ECE 200,019,103604,Kuzum; Duygu,9999,0,9999,0
1668588106505,ECE 200,020,103605,Le; Hanh-Phuc,9999,0,9999,0
1668588106505,ECE 200,021,103606,Lin; Bill,9999,0,9999,0
1668588106505,ECE 200,022,103607,Liu; Zhaowei,9998,0,9999,1
1668588106505,ECE 200,023,103608,Lo; Yu-Hwa,9999,0,9999,0
1668588106505,ECE 200,024,103609,Lomakin; Vitaliy,9999,0,9999,0
1668588106505,ECE 200,025,103610,Mercier; Patrick Philip,9999,0,9999,0
1668588106505,ECE 200,026,103611,Meyer; Florian,9999,0,9999,0
1668588106505,ECE 200,027,103612,Milstein; Laurence B.,9999,0,9999,0
1668588106505,ECE 200,028,103613,Mir Arabbaygi; Siavash,9999,0,9999,0
1668588106505,ECE 200,029,103614,Mookherjea; Shayan,9999,0,9999,0
1668588106505,ECE 200,030,103615,Morris; Karcher William,9999,0,9999,0
1668588106505,ECE 200,031,103616,Ng; Tse Nga,9999,0,9999,0
1668588106505,ECE 200,032,103617,Nguyen; Truong Quang,9999,0,9999,0
1668588106505,ECE 200,033,103618,Nomura; Kenji,9999,0,9999,0
1668588106505,ECE 200,034,103619,Orlitsky; Alon,9999,0,9999,0
1668588106505,ECE 200,035,103620,Pal; Piya,9999,0,9999,0
1668588106505,ECE 200,036,103621,Papen; George C.,9999,0,9999,0
1668588106505,ECE 200,037,103622,Radic; Stojan,9999,0,9999,0
1668588106505,ECE 200,038,103623,Rao; Bhaskar D.,9999,0,9999,0
1668588106505,ECE 200,039,103624,Rao; Ramesh R,9999,0,9999,0
1668588106505,ECE 200,040,103625,Rebeiz; Gabriel,9999,0,9999,0
1668588106505,ECE 200,041,103626,Sanford; John R,9999,0,9999,0
1668588106505,ECE 200,042,103627,Siegel; Paul H.,9999,0,9999,0
1668588106505,ECE 200,043,103628,Sievenpiper; Daniel F.,9999,0,9999,0
1668588106505,ECE 200,044,103629,Sworder; David D.,9999,0,9999,0
1668588106505,ECE 200,045,103630,Taur; Yuan,9999,0,9999,0
1668588106505,ECE 200,046,103631,Touri; Behrouz,9999,0,9999,0
1668588106505,ECE 200,047,103632,Trivedi; Mohan M.,9999,0,9999,0
1668588106505,ECE 200,048,103633,Vasconcelos; Nuno,9999,0,9999,0
1668588106505,ECE 200,049,103634,Wang; Xiaolong,9999,0,9999,0
1668588106505,ECE 200,050,103635,Xie; Pengtao,9999,0,9999,0
1668588106505,ECE 200,051,103636,Yip; Michael,9999,0,9999,0
1668588106505,ECE 200,052,103637,Zeger; Kenneth A.,999,0,999,0
1668588106505,ECE 200,053,103638,Zhang; Xinyu,9999,0,9999,0
1668588106505,ECE 200,054,103639,Turakhia; Yatish Girish,9999,0,9999,0
1668588106505,ECE 200,055,103640,Kang; Mingu,9999,0,9999,0
1668588106505,ECE 200,056,103641,Shi; Yuanyuan,9999,0,9999,0
1668588106505,ECE 200,057,103642,Wang; Edward Jay,9999,0,9999,0
1668588106505,ECE 200,058,103643,Zheng; Yang,9999,0,9999,0
1668588106931,ECE 202,A00,103644,Kuzum; Duygu,0,47,0,0
1668588107362,ECE 212BN,A00,103646,Ng; Tse Nga,0,10,0,0
1668588107791,ECE 221,A00,111493,Staff,0,0,0,0
1668588108216,ECE 222B,A00,103647,Lomakin; Vitaliy,0,22,0,0
1668588108656,ECE 230B,A00,103648,Taur; Yuan,0,4,0,0
1668588109086,ECE 238B,A00,103649,Garay; Javier,0,0,0,0
1668588109512,ECE 240B,A00,112900,Fainman; Yeshaiahu,0,8,0,0
1668588109935,ECE 247A,A00,103650,Jokerst; Jesse Vincent,0,6,0,0
1668588110378,ECE 247B,A00,103651,Wang; Joseph,0,14,0,0
1668588110805,ECE 250,A00,103652,Siegel; Paul H.,0,85,0,0
1668588111233,ECE 251A,A00,103654,Rao; Bhaskar D.,0,65,0,0
1668588111658,ECE 257B,A00,103655,Bharadia; Dinesh,0,33,0,0
1668588112097,ECE 258A,A00,103656,Milstein; Laurence B.,0,29,0,0
1668588112525,ECE 260B,A00,103658,Kang; Mingu,0,121,0,0
1668588112951,ECE 264A,A00,103659,Galton; Ian A,0,42,0,34
1668588113379,ECE 265A,A00,103661,Gudem; Prasad S.S.,0,42,0,36
1668588113804,ECE 265D,A00,103662,Gudem; Prasad S.S.,0,27,0,0
1668588114229,ECE 268,A00,103663,Koushanfar; Farinaz,0,44,0,0
1668588114754,ECE 269,A01,103665,Pal; Piya,0,223,0,0
1668588115186,ECE 271B,A00,103666,Vasconcelos; Manuela,0,80,0,0
1668588115614,ECE 276A,A00,103667,Atanasov; Nikolay A.,0,127,0,0
1668588116046,ECE 277,A00,103668,An; Cheolhong,0,151,0,0
1668588116473,ECE 279,A00,117947,Hall; Drew A.,0,22,0,0
1668588117326,ECE 283,A00,103670,Hsueh; Tzu-Chien,0,57,0,0
1668588117761,ECE 284,A00,103671,Turakhia; Yatish Girish,0,40,0,0
1668588118185,ECE 285,A00,103672,Zheng; Yang,0,40,0,0
1668588118185,ECE 285,B00,103673,Sworder; David D.,0,61,0,0
1668588118609,ECE 287,A00,103676,Javidi; Tara,0,7,0,0
1668588119035,MATH 200B,A00,098023,Salehi Golsefidy; Alireza,7,0,15,8
1668588119468,MATH 202B,A00,098024,Rhoades; Brendon Patrick,7,0,15,8
1668588119909,MATH 203B,A00,098025,Oprea; Dragos N.,9,0,15,6
1668588120341,MATH 204B,A00,098026,Sorensen; Claus M,13,0,15,2
1668588120775,MATH 208,A00,098027,Izadi; Elham,7,0,10,3
1668588121202,MATH 209,A00,098028,Pollack; Aaron,10,0,10,0
1668588121635,MATH 211A,A00,112919,Rogalski; Daniel,8,0,10,2
1668588122060,MATH 211B,A00,112920,Seward; Brandon M.,9,0,10,1
1668588122484,MATH 218,A00,098029,Li; Bo,10,0,10,0
1668588122915,MATH 220B,A00,098030,Novak; Jonathan I,10,0,15,5
1668588123338,MATH 221A,A00,098031,Ebenfelt; Peter F,12,0,15,3
1668588123767,MATH 231B,A00,098032,Zlatos; Andrej,9,0,15,6
1668588124195,MATH 240B,A00,098033,Ni; Lei,7,0,15,8
1668588124627,MATH 243,A00,098034,Jekel; David Andrew,10,0,10,0
1668588125059,MATH 245A,A00,098035,Nie; Jiawang,0,8,15,18
1668588125499,MATH 248,A00,098036,Bejenaru; Ioan,10,0,10,0
1668588125932,MATH 250B,A00,098037,Spolaor; Luca,12,0,15,3
1668588126367,MATH 258,A00,098038,Ni; Lei,8,0,10,2
1668588126808,MATH 264B,A00,098041,Rhoades; Brendon Patrick,6,0,15,9
1668588127235,MATH 268,A00,098042,Buss; Samuel R,10,0,10,0
1668588127660,MATH 269,A00,098043,Rhoades; Brendon Patrick,10,0,10,0
1668588128088,MATH 270B,A00,098044,Li; Bo,6,0,15,9
1668588128514,MATH 272B,A00,098045,Holst; Michael J,13,0,15,2
1668588128940,MATH 273A,A00,098046,Tian; Xiaochuan,10,0,15,5
1668588129366,MATH 275,A01,098048,Tian; Xiaochuan,6,0,10,4
1668588129793,MATH 278A,A00,098049,Holst; Michael J,6,0,10,4
1668588130221,MATH 278B,A00,098050,Cloninger; Alexander,10,0,10,0
1668588130650,MATH 278C,A00,098051,Nie; Jiawang,5,0,10,5
1668588131079,MATH 280B,A00,098052,Zheng; Tianyi,6,0,15,9
1668588131500,MATH 281B,A00,098053,Bradic; Jelena,0,2,15,15
1668588131924,MATH 282B,A00,098054,Arias-Castro; Ery,0,1,15,15
1668588132348,MATH 285,A00,098055,Fitzsimmons; Patrick J,0,4,15,16
1668588132777,MATH 287B,A00,098056,Arias-Castro; Ery,1,0,15,14
1668588133205,MATH 288,A00,098057,Agarwal; Pooja,9,0,10,1
1668588133205,MATH 288,B00,098058,Zhang; Danna,8,0,10,2
1668588133205,MATH 288,C00,098059,Williams; Ruth J,9,0,10,1
1668588133630,MATH 290B,A00,098060,Roberts; Justin Deritter,12,0,15,3
1668588134061,MATH 292,A00,098061,Belmont; Eva Kinoshita,10,0,10,0
1668588134491,MATH 295,A00,098062,Suk; Andrew Hoon,47,0,50,3
1668588134926,MATH 296,A00,098063,Novak; Jonathan I,20,0,20,0
1668588135365,MATH 297,001,098064,Gamst; Anthony Collins,9997,0,9999,2
1668588640343,COGS 205,A00,101395,Chiba; Andrea,19,0,20,1
1668588640780,COGS 210B,001,101404,Greene; Deanna Jacquelyn,9998,0,9999,1
1668588640780,COGS 210B,002,101417,Xia; Haijun,9999,0,9999,0
1668588640780,COGS 210B,003,101422,Nitz; Douglas A.,9999,0,9999,0
1668588640780,COGS 210B,004,101423,Hollan; James D.,9998,0,9999,1
1668588640780,COGS 210B,005,101424,Deak; Gedeon O.,9998,0,9999,1
1668588640780,COGS 210B,006,101425,Rossano; Federico,9999,0,9999,0
1668588641204,COGS 211B,A00,101427,Coulson; Seana M,9996,0,9999,3
1668588641633,COGS 220,A00,101428,Hollan; James D.,0,17,25,25
1668588642063,COGS 229,A00,101429,Dow; Steven P,17,0,25,8
1668588642492,COGS 230,A00,101430,Klemmer; Scott R,6,0,17,11
1668588642916,COGS 234,A00,101431,Xia; Haijun,0,1,25,25
1668588643346,COGS 260,A00,101432,Kiyonaga; Anastasia,21,0,25,4
1668588643346,COGS 260,B00,101433,Kirsh; David Joel,15,0,25,10
1668588643771,CSE 202,A00,102371,Impagliazzo; Russell,0,70,0,0
1668588644195,CSE 203B,A01,102373,Cheng; Chung Kuan,0,70,0,0
1668588644620,CSE 208,A00,102374,Micciancio; Daniele,0,5,0,0
1668588645045,CSE 209A,A00,112895,Impagliazzo; Russell,0,14,15,15
1668588645478,CSE 209B,A00,108005,Bellare; Mihir,0,7,0,0
1668588645903,CSE 210,A00,113163,Coblenz; Michael J,0,96,0,0
1668588646342,CSE 219,A00,106111,Dow; Steven P,0,8,20,20
1668588646770,CSE 221,A00,102376,Voelker; Geoffrey M.,0,78,0,0
1668588647195,CSE 224,A01,102378,Porter; George M,0,181,0,0
1668588647618,CSE 229A,A00,102379,Savage; Stefan,0,14,0,0
1668588648043,CSE 229C,A00,102380,Munyaka; Imani N. S.,0,12,0,0
1668588648471,CSE 232B,A00,102382,Deutsch; Alin Bernard,0,40,0,0
1668588648903,CSE 234,A01,112904,Kumar; Arun Kumar,0,0,0,0
1668588649326,CSE 237A,A00,102383,Rosing; Tajana Simunic,0,57,0,0
1668588649754,CSE 239A,A00,102384,Deutsch; Alin Bernard,0,18,0,0
1668588650179,CSE 239B,A00,102385,Polikarpova; Nadezhda,0,11,0,0
1668588650607,CSE 240A,A00,102386,Pannuto; Patrick William,0,49,0,0
1668588651032,CSE 240B,A00,102387,Zhao; Jishen,0,51,0,0
1668588651468,CSE 241A,A00,106406,Kang; Mingu,0,9,0,0
1668588651893,CSE 249B,A00,102388,Kahng; Andrew Byun,0,7,8,8
1668588652323,CSE 251B,A01,102392,Cottrell; Garrison W,0,54,0,0
1668588652323,CSE 251B,A02,102393,Cottrell; Garrison W,0,36,0,0
1668588652745,CSE 252B,A00,102394,Ochoa; Benjamin Lawrence,0,64,0,0
1668588653170,CSE 257,A01,102396,Gao; Sicun,0,160,0,0
1668588653603,CSE 272,A00,102397,Li; Tzumao,0,22,0,0
1668588654028,CSE 274,A00,111323,Chern; Albert Ren-Haur,0,16,0,0
1668588654472,CSE 282,A00,102398,Pevzner; Pavel Arkadjevich,0,0,0,0
1668588654895,CSE 284,A00,114175,Gymrek; Melissa Ann,0,33,0,0
1668588655319,CSE 290,A00,102399,Chandraker; Manmohan Krishna,0,11,0,0
1668588655319,CSE 290,B00,102400,Vaccaro; Kristen Marie,0,10,25,25
1668588655319,CSE 290,C00,102414,Pannuto; Patrick William,0,1,25,25
1668588655319,CSE 290,D00,102427,Pevzner; Pavel Arkadjevich,0,0,0,0
1668588655319,CSE 290,E00,102429,Zhao; Jishen,0,6,0,0
1668588655319,CSE 290,F00,102436,Tullsen; Dean Michael,0,6,0,0
1668588655319,CSE 290,G00,102440,Christensen; Henrik I,0,8,20,20
1668588655749,CSE 291,A00,102443,Su; Hao,0,0,0,0
1668588655749,CSE 291,B00,102448,Polikarpova; Nadezhda,0,0,0,0
1668588655749,CSE 291,C00,102453,Vaccaro; Kristen Marie,0,0,0,0
1668588655749,CSE 291,D00,111343,Savage; Stefan,0,0,0,0
1668588655749,CSE 291,E00,116474,Claffy; Kimberly Claire,0,0,0,0
1668588655749,CSE 291,F00,116479,Pasquale; Joseph,0,0,0,0
1668588656187,CSE 293,001,119111,Bafna; Vineet,9999,0,9999,0
1668588656187,CSE 293,002,119118,Bellare; Mihir,9999,0,9999,0
1668588656187,CSE 293,003,119122,Berg-Kirkpatrick; Taylor D,9999,0,9999,0
1668588656187,CSE 293,004,119135,Christensen; Henrik I,9999,0,9999,0
1668588656187,CSE 293,005,119142,Cottrell; Garrison W,9999,0,9999,0
1668588656187,CSE 293,006,119146,Deutsch; Alin Bernard,9999,0,9999,0
1668588656187,CSE 293,007,119159,Esmaeilzadeh; Hadi,9999,0,9999,0
1668588656187,CSE 293,008,119166,Freund; Yoav,9999,0,9999,0
1668588656187,CSE 293,009,119170,Griswold; William G.,9999,0,9999,0
1668588656187,CSE 293,010,119183,Gymrek; Melissa Ann,9999,0,9999,0
1668588656187,CSE 293,011,119190,Heninger; Nadia A,9999,0,9999,0
1668588656187,CSE 293,012,119230,Impagliazzo; Russell,9999,0,9999,0
1668588656187,CSE 293,013,119232,Jhala; Ranjit,9999,0,9999,0
1668588656187,CSE 293,014,119233,Kahng; Andrew Byun,9999,0,9999,0
1668588656187,CSE 293,015,119298,Kane; Daniel Mertz,9999,0,9999,0
1668588656187,CSE 293,016,119299,Kriegman; David J,9999,0,9999,0
1668588656187,CSE 293,017,119300,Kumar; Arun Kumar,9999,0,9999,0
1668588656187,CSE 293,018,119301,Lerner; Sorin,9999,0,9999,0
1668588656187,CSE 293,019,119302,Lovett; Shachar,9999,0,9999,0
1668588656187,CSE 293,020,119303,McAuley; Julian John,9999,0,9999,0
1668588656187,CSE 293,021,119304,Micciancio; Daniele,9999,0,9999,0
1668588656187,CSE 293,022,119367,Orailoglu; Alex,9999,0,9999,0
1668588656187,CSE 293,023,119382,Paturi; Ramamohan,9999,0,9999,0
1668588656187,CSE 293,024,119404,Polikarpova; Nadezhda,9999,0,9999,0
1668588656187,CSE 293,025,119406,Politz; Joseph Gibbs,9999,0,9999,0
1668588656187,CSE 293,026,119411,Porter; George M,9999,0,9999,0
1668588656187,CSE 293,027,119414,Porter; Leonard Emerson,9999,0,9999,0
1668588656187,CSE 293,028,119416,Ramamoorthi; Ravi,9999,0,9999,0
1668588656187,CSE 293,029,119417,Sahoo; Debashis,9999,0,9999,0
1668588656187,CSE 293,030,119420,Saul; Lawrence,9999,0,9999,0
1668588656187,CSE 293,031,119421,Savage; Stefan,9999,0,9999,0
1668588656187,CSE 293,032,119425,Schulze; Jurgen P.,9999,0,9999,0
1668588656187,CSE 293,033,119426,Snoeren; Alex C.,9999,0,9999,0
1668588656187,CSE 293,034,119428,Shang; Jingbo,9999,0,9999,0
1668588656187,CSE 293,035,119430,Stefan; Deian,9999,0,9999,0
1668588656187,CSE 293,036,119431,Su; Hao,9999,0,9999,0
1668588656187,CSE 293,037,119433,Swanson; Steven James,9999,0,9999,0
1668588656187,CSE 293,038,119435,Tullsen; Dean Michael,9999,0,9999,0
1668588656187,CSE 293,039,119483,Voelker; Geoffrey M.,9999,0,9999,0
1668588656187,CSE 293,040,119537,Zhao; Jishen,9999,0,9999,0
1668588656187,CSE 293,041,119538,Zhou; Yuan-Yuan,9999,0,9999,0
1668588656187,CSE 293,042,119539,Gao; Sicun,9999,0,9999,0
1668588656187,CSE 293,043,119540,Weibel; Nadir,9999,0,9999,0
1668588656187,CSE 293,044,119541,Gupta; Rajesh K.,9999,0,9999,0
1668588656187,CSE 293,045,126410,Vaccaro; Kristen Marie,9999,0,9999,0
1668588656187,CSE 293,046,126411,Klemke; Richard,9999,0,9999,0
1668588656616,CSE 294,A00,102459,Voelker; Geoffrey M.,0,2,0,0
1668588656616,CSE 294,B00,111322,Orailoglu; Alex,0,2,0,0
1668588657047,DSE 201,A00,096914,Deutsch; Alin Bernard,30,0,30,0
1668588657481,DSE 210,A00,096915,Dasgupta; Sanjoy,30,0,30,0
1668588657907,DSE 241,A00,144528,Smith; Neil Gordon,30,0,30,0
1668588658343,DSE 260A,A00,096916,Altintas De Callaf; Ilkay,30,0,30,0
1668588658821,ECE 200,001,103586,Antipa; Nicholas A,9999,0,9999,0
1668588658821,ECE 200,002,103587,Atanasov; Nikolay A.,9999,0,9999,0
1668588658821,ECE 200,003,103588,Bharadia; Dinesh,9999,0,9999,0
1668588658821,ECE 200,004,103589,Cheng; Chung Kuan,9999,0,9999,0
1668588658821,ECE 200,005,103590,Cosman; Pamela C.,9999,0,9999,0
1668588658821,ECE 200,006,103591,Dayeh; Shadi Ahmad,9999,0,9999,0
1668588658821,ECE 200,007,103592,Fainman; Yeshaiahu,9999,0,9999,0
1668588658821,ECE 200,008,103593,Ford; Joseph Earl,9999,0,9999,0
1668588658821,ECE 200,009,103594,Franceschetti; Massimo,9999,0,9999,0
1668588658821,ECE 200,010,103595,Fullerton; Eric E,9999,0,9999,0
1668588658821,ECE 200,011,103596,Galton; Ian A,9999,0,9999,0
1668588658821,ECE 200,012,103597,Gilja; Vikash,9999,0,9999,0
1668588658821,ECE 200,013,103598,Hall; Drew A.,9999,0,9999,0
1668588658821,ECE 200,014,103599,Hsueh; Tzu-Chien,9999,0,9999,0
1668588658821,ECE 200,015,103600,Javidi; Tara,9999,0,9999,0
1668588658821,ECE 200,016,103601,Kahng; Andrew Byun,9999,0,9999,0
1668588658821,ECE 200,017,103602,Kim; Young-Han,9999,0,9999,0
1668588658821,ECE 200,018,103603,Koushanfar; Farinaz,9999,0,9999,0
1668588658821,ECE 200,019,103604,Kuzum; Duygu,9999,0,9999,0
1668588658821,ECE 200,020,103605,Le; Hanh-Phuc,9999,0,9999,0
1668588658821,ECE 200,021,103606,Lin; Bill,9999,0,9999,0
1668588658821,ECE 200,022,103607,Liu; Zhaowei,9998,0,9999,1
1668588658821,ECE 200,023,103608,Lo; Yu-Hwa,9999,0,9999,0
1668588658821,ECE 200,024,103609,Lomakin; Vitaliy,9999,0,9999,0
1668588658821,ECE 200,025,103610,Mercier; Patrick Philip,9999,0,9999,0
1668588658821,ECE 200,026,103611,Meyer; Florian,9999,0,9999,0
1668588658821,ECE 200,027,103612,Milstein; Laurence B.,9999,0,9999,0
1668588658821,ECE 200,028,103613,Mir Arabbaygi; Siavash,9999,0,9999,0
1668588658821,ECE 200,029,103614,Mookherjea; Shayan,9999,0,9999,0
1668588658821,ECE 200,030,103615,Morris; Karcher William,9999,0,9999,0
1668588658821,ECE 200,031,103616,Ng; Tse Nga,9999,0,9999,0
1668588658821,ECE 200,032,103617,Nguyen; Truong Quang,9999,0,9999,0
1668588658821,ECE 200,033,103618,Nomura; Kenji,9999,0,9999,0
1668588658821,ECE 200,034,103619,Orlitsky; Alon,9999,0,9999,0
1668588658821,ECE 200,035,103620,Pal; Piya,9999,0,9999,0
1668588658821,ECE 200,036,103621,Papen; George C.,9999,0,9999,0
1668588658821,ECE 200,037,103622,Radic; Stojan,9999,0,9999,0
1668588658821,ECE 200,038,103623,Rao; Bhaskar D.,9999,0,9999,0
1668588658821,ECE 200,039,103624,Rao; Ramesh R,9999,0,9999,0
1668588658821,ECE 200,040,103625,Rebeiz; Gabriel,9999,0,9999,0
1668588658821,ECE 200,041,103626,Sanford; John R,9999,0,9999,0
1668588658821,ECE 200,042,103627,Siegel; Paul H.,9999,0,9999,0
1668588658821,ECE 200,043,103628,Sievenpiper; Daniel F.,9999,0,9999,0
1668588658821,ECE 200,044,103629,Sworder; David D.,9999,0,9999,0
1668588658821,ECE 200,045,103630,Taur; Yuan,9999,0,9999,0
1668588658821,ECE 200,046,103631,Touri; Behrouz,9999,0,9999,0
1668588658821,ECE 200,047,103632,Trivedi; Mohan M.,9999,0,9999,0
1668588658821,ECE 200,048,103633,Vasconcelos; Nuno,9999,0,9999,0
1668588658821,ECE 200,049,103634,Wang; Xiaolong,9999,0,9999,0
1668588658821,ECE 200,050,103635,Xie; Pengtao,9999,0,9999,0
1668588658821,ECE 200,051,103636,Yip; Michael,9999,0,9999,0
1668588658821,ECE 200,052,103637,Zeger; Kenneth A.,999,0,999,0
1668588658821,ECE 200,053,103638,Zhang; Xinyu,9999,0,9999,0
1668588658821,ECE 200,054,103639,Turakhia; Yatish Girish,9999,0,9999,0
1668588658821,ECE 200,055,103640,Kang; Mingu,9999,0,9999,0
1668588658821,ECE 200,056,103641,Shi; Yuanyuan,9999,0,9999,0
1668588658821,ECE 200,057,103642,Wang; Edward Jay,9999,0,9999,0
1668588658821,ECE 200,058,103643,Zheng; Yang,9999,0,9999,0
1668588659244,ECE 202,A00,103644,Kuzum; Duygu,0,47,0,0
1668588659677,ECE 212BN,A00,103646,Ng; Tse Nga,0,10,0,0
1668588660101,ECE 221,A00,111493,Staff,0,0,0,0
1668588660529,ECE 222B,A00,103647,Lomakin; Vitaliy,0,22,0,0
1668588660953,ECE 230B,A00,103648,Taur; Yuan,0,4,0,0
1668588661384,ECE 238B,A00,103649,Garay; Javier,0,0,0,0
1668588661809,ECE 240B,A00,112900,Fainman; Yeshaiahu,0,8,0,0
1668588662234,ECE 247A,A00,103650,Jokerst; Jesse Vincent,0,6,0,0
1668588662660,ECE 247B,A00,103651,Wang; Joseph,0,14,0,0
1668588663125,ECE 250,A00,103652,Siegel; Paul H.,0,85,0,0
1668588663558,ECE 251A,A00,103654,Rao; Bhaskar D.,0,65,0,0
1668588663988,ECE 257B,A00,103655,Bharadia; Dinesh,0,33,0,0
1668588664422,ECE 258A,A00,103656,Milstein; Laurence B.,0,29,0,0
1668588664852,ECE 260B,A00,103658,Kang; Mingu,0,121,0,0
1668588665282,ECE 264A,A00,103659,Galton; Ian A,0,42,0,34
1668588665707,ECE 265A,A00,103661,Gudem; Prasad S.S.,0,42,0,36
1668588666132,ECE 265D,A00,103662,Gudem; Prasad S.S.,0,27,0,0
1668588666557,ECE 268,A00,103663,Koushanfar; Farinaz,0,44,0,0
1668588666993,ECE 269,A01,103665,Pal; Piya,0,223,0,0
1668588667427,ECE 271B,A00,103666,Vasconcelos; Manuela,0,80,0,0
1668588667870,ECE 276A,A00,103667,Atanasov; Nikolay A.,0,127,0,0
1668588668294,ECE 277,A00,103668,An; Cheolhong,0,151,0,0
1668588668719,ECE 279,A00,117947,Hall; Drew A.,0,22,0,0
1668588669569,ECE 283,A00,103670,Hsueh; Tzu-Chien,0,57,0,0
1668588669995,ECE 284,A00,103671,Turakhia; Yatish Girish,0,40,0,0
1668588670425,ECE 285,A00,103672,Zheng; Yang,0,40,0,0
1668588670425,ECE 285,B00,103673,Sworder; David D.,0,61,0,0
1668588670853,ECE 287,A00,103676,Javidi; Tara,0,7,0,0
1668588671281,MATH 200B,A00,098023,Salehi Golsefidy; Alireza,7,0,15,8
1668588671706,MATH 202B,A00,098024,Rhoades; Brendon Patrick,7,0,15,8
1668588672138,MATH 203B,A00,098025,Oprea; Dragos N.,9,0,15,6
1668588672566,MATH 204B,A00,098026,Sorensen; Claus M,13,0,15,2
1668588673005,MATH 208,A00,098027,Izadi; Elham,7,0,10,3
1668588673432,MATH 209,A00,098028,Pollack; Aaron,10,0,10,0
1668588673875,MATH 211A,A00,112919,Rogalski; Daniel,8,0,10,2
1668588674304,MATH 211B,A00,112920,Seward; Brandon M.,9,0,10,1
1668588674731,MATH 218,A00,098029,Li; Bo,10,0,10,0
1668588675157,MATH 220B,A00,098030,Novak; Jonathan I,10,0,15,5
1668588675581,MATH 221A,A00,098031,Ebenfelt; Peter F,12,0,15,3
1668588676006,MATH 231B,A00,098032,Zlatos; Andrej,9,0,15,6
1668588676434,MATH 240B,A00,098033,Ni; Lei,7,0,15,8
1668588676860,MATH 243,A00,098034,Jekel; David Andrew,10,0,10,0
1668588677284,MATH 245A,A00,098035,Nie; Jiawang,0,8,15,18
1668588677709,MATH 248,A00,098036,Bejenaru; Ioan,10,0,10,0
1668588678134,MATH 250B,A00,098037,Spolaor; Luca,12,0,15,3
1668588678563,MATH 258,A00,098038,Ni; Lei,8,0,10,2
1668588678990,MATH 264B,A00,098041,Rhoades; Brendon Patrick,6,0,15,9
1668588679419,MATH 268,A00,098042,Buss; Samuel R,10,0,10,0
1668588679861,MATH 269,A00,098043,Rhoades; Brendon Patrick,10,0,10,0
1668588680286,MATH 270B,A00,098044,Li; Bo,6,0,15,9
1668588680714,MATH 272B,A00,098045,Holst; Michael J,13,0,15,2
1668588681146,MATH 273A,A00,098046,Tian; Xiaochuan,10,0,15,5
1668588681646,MATH 275,A01,098048,Tian; Xiaochuan,6,0,10,4
1668588682070,MATH 278A,A00,098049,Holst; Michael J,6,0,10,4
1668588682495,MATH 278B,A00,098050,Cloninger; Alexander,10,0,10,0
1668588682918,MATH 278C,A00,098051,Nie; Jiawang,5,0,10,5
1668588683347,MATH 280B,A00,098052,Zheng; Tianyi,6,0,15,9
1668588683776,MATH 281B,A00,098053,Bradic; Jelena,0,2,15,15
1668588684204,MATH 282B,A00,098054,Arias-Castro; Ery,0,1,15,15
1668588684633,MATH 285,A00,098055,Fitzsimmons; Patrick J,0,4,15,16
1668588685056,MATH 287B,A00,098056,Arias-Castro; Ery,1,0,15,14
1668588685485,MATH 288,A00,098057,Agarwal; Pooja,9,0,10,1
1668588685485,MATH 288,B00,098058,Zhang; Danna,8,0,10,2
1668588685485,MATH 288,C00,098059,Williams; Ruth J,9,0,10,1
1668588685911,MATH 290B,A00,098060,Roberts; Justin Deritter,12,0,15,3
1668588686336,MATH 292,A00,098061,Belmont; Eva Kinoshita,10,0,10,0
1668588686766,MATH 295,A00,098062,Suk; Andrew Hoon,47,0,50,3
1668588687207,MATH 296,A00,098063,Novak; Jonathan I,20,0,20,0
1668588687632,MATH 297,001,098064,Gamst; Anthony Collins,9997,0,9999,2
1668589191402,COGS 205,A00,101395,Chiba; Andrea,19,0,20,1
1668589191840,COGS 210B,001,101404,Greene; Deanna Jacquelyn,9998,0,9999,1
1668589191840,COGS 210B,002,101417,Xia; Haijun,9999,0,9999,0
1668589191840,COGS 210B,003,101422,Nitz; Douglas A.,9999,0,9999,0
1668589191840,COGS 210B,004,101423,Hollan; James D.,9998,0,9999,1
1668589191840,COGS 210B,005,101424,Deak; Gedeon O.,9998,0,9999,1
1668589191840,COGS 210B,006,101425,Rossano; Federico,9999,0,9999,0
1668589192265,COGS 211B,A00,101427,Coulson; Seana M,9996,0,9999,3
1668589192692,COGS 220,A00,101428,Hollan; James D.,0,17,25,25
1668589193116,COGS 229,A00,101429,Dow; Steven P,17,0,25,8
1668589193556,COGS 230,A00,101430,Klemmer; Scott R,6,0,17,11
1668589193981,COGS 234,A00,101431,Xia; Haijun,0,1,25,25
1668589194408,COGS 260,A00,101432,Kiyonaga; Anastasia,21,0,25,4
1668589194408,COGS 260,B00,101433,Kirsh; David Joel,15,0,25,10
1668589194841,CSE 202,A00,102371,Impagliazzo; Russell,0,70,0,0
1668589195270,CSE 203B,A01,102373,Cheng; Chung Kuan,0,70,0,0
1668589195698,CSE 208,A00,102374,Micciancio; Daniele,0,5,0,0
1668589196123,CSE 209A,A00,112895,Impagliazzo; Russell,0,14,15,15
1668589196546,CSE 209B,A00,108005,Bellare; Mihir,0,7,0,0
1668589196969,CSE 210,A00,113163,Coblenz; Michael J,0,96,0,0
1668589197393,CSE 219,A00,106111,Dow; Steven P,0,8,20,20
1668589197821,CSE 221,A00,102376,Voelker; Geoffrey M.,0,78,0,0
1668589198255,CSE 224,A01,102378,Porter; George M,0,181,0,0
1668589198689,CSE 229A,A00,102379,Savage; Stefan,0,14,0,0
1668589199123,CSE 229C,A00,102380,Munyaka; Imani N. S.,0,12,0,0
1668589199548,CSE 232B,A00,102382,Deutsch; Alin Bernard,0,40,0,0
1668589199978,CSE 234,A01,112904,Kumar; Arun Kumar,0,0,0,0
1668589200402,CSE 237A,A00,102383,Rosing; Tajana Simunic,0,57,0,0
1668589200852,CSE 239A,A00,102384,Deutsch; Alin Bernard,0,18,0,0
1668589201277,CSE 239B,A00,102385,Polikarpova; Nadezhda,0,11,0,0
1668589201701,CSE 240A,A00,102386,Pannuto; Patrick William,0,49,0,0
1668589202125,CSE 240B,A00,102387,Zhao; Jishen,0,51,0,0
1668589202552,CSE 241A,A00,106406,Kang; Mingu,0,9,0,0
1668589202978,CSE 249B,A00,102388,Kahng; Andrew Byun,0,7,8,8
1668589203403,CSE 251B,A01,102392,Cottrell; Garrison W,0,54,0,0
1668589203403,CSE 251B,A02,102393,Cottrell; Garrison W,0,36,0,0
1668589203918,CSE 252B,A00,102394,Ochoa; Benjamin Lawrence,0,64,0,0
1668589204346,CSE 257,A01,102396,Gao; Sicun,0,160,0,0
1668589204772,CSE 272,A00,102397,Li; Tzumao,0,22,0,0
1668589205197,CSE 274,A00,111323,Chern; Albert Ren-Haur,0,16,0,0
1668589205623,CSE 282,A00,102398,Pevzner; Pavel Arkadjevich,0,0,0,0
1668589206046,CSE 284,A00,114175,Gymrek; Melissa Ann,0,33,0,0
1668589206471,CSE 290,A00,102399,Chandraker; Manmohan Krishna,0,11,0,0
1668589206471,CSE 290,B00,102400,Vaccaro; Kristen Marie,0,10,25,25
1668589206471,CSE 290,C00,102414,Pannuto; Patrick William,0,1,25,25
1668589206471,CSE 290,D00,102427,Pevzner; Pavel Arkadjevich,0,0,0,0
1668589206471,CSE 290,E00,102429,Zhao; Jishen,0,6,0,0
1668589206471,CSE 290,F00,102436,Tullsen; Dean Michael,0,6,0,0
1668589206471,CSE 290,G00,102440,Christensen; Henrik I,0,8,20,20
1668589206898,CSE 291,A00,102443,Su; Hao,0,0,0,0
1668589206898,CSE 291,B00,102448,Polikarpova; Nadezhda,0,0,0,0
1668589206898,CSE 291,C00,102453,Vaccaro; Kristen Marie,0,0,0,0
1668589206898,CSE 291,D00,111343,Savage; Stefan,0,0,0,0
1668589206898,CSE 291,E00,116474,Claffy; Kimberly Claire,0,0,0,0
1668589206898,CSE 291,F00,116479,Pasquale; Joseph,0,0,0,0
1668589207366,CSE 293,001,119111,Bafna; Vineet,9999,0,9999,0
1668589207366,CSE 293,002,119118,Bellare; Mihir,9999,0,9999,0
1668589207366,CSE 293,003,119122,Berg-Kirkpatrick; Taylor D,9999,0,9999,0
1668589207366,CSE 293,004,119135,Christensen; Henrik I,9999,0,9999,0
1668589207366,CSE 293,005,119142,Cottrell; Garrison W,9999,0,9999,0
1668589207366,CSE 293,006,119146,Deutsch; Alin Bernard,9999,0,9999,0
1668589207366,CSE 293,007,119159,Esmaeilzadeh; Hadi,9999,0,9999,0
1668589207366,CSE 293,008,119166,Freund; Yoav,9999,0,9999,0
1668589207366,CSE 293,009,119170,Griswold; William G.,9999,0,9999,0
1668589207366,CSE 293,010,119183,Gymrek; Melissa Ann,9999,0,9999,0
1668589207366,CSE 293,011,119190,Heninger; Nadia A,9999,0,9999,0
1668589207366,CSE 293,012,119230,Impagliazzo; Russell,9999,0,9999,0
1668589207366,CSE 293,013,119232,Jhala; Ranjit,9999,0,9999,0
1668589207366,CSE 293,014,119233,Kahng; Andrew Byun,9999,0,9999,0
1668589207366,CSE 293,015,119298,Kane; Daniel Mertz,9999,0,9999,0
1668589207366,CSE 293,016,119299,Kriegman; David J,9999,0,9999,0
1668589207366,CSE 293,017,119300,Kumar; Arun Kumar,9999,0,9999,0
1668589207366,CSE 293,018,119301,Lerner; Sorin,9999,0,9999,0
1668589207366,CSE 293,019,119302,Lovett; Shachar,9999,0,9999,0
1668589207366,CSE 293,020,119303,McAuley; Julian John,9999,0,9999,0
1668589207366,CSE 293,021,119304,Micciancio; Daniele,9999,0,9999,0
1668589207366,CSE 293,022,119367,Orailoglu; Alex,9999,0,9999,0
1668589207366,CSE 293,023,119382,Paturi; Ramamohan,9999,0,9999,0
1668589207366,CSE 293,024,119404,Polikarpova; Nadezhda,9999,0,9999,0
1668589207366,CSE 293,025,119406,Politz; Joseph Gibbs,9999,0,9999,0
1668589207366,CSE 293,026,119411,Porter; George M,9999,0,9999,0
1668589207366,CSE 293,027,119414,Porter; Leonard Emerson,9999,0,9999,0
1668589207366,CSE 293,028,119416,Ramamoorthi; Ravi,9999,0,9999,0
1668589207366,CSE 293,029,119417,Sahoo; Debashis,9999,0,9999,0
1668589207366,CSE 293,030,119420,Saul; Lawrence,9999,0,9999,0
1668589207366,CSE 293,031,119421,Savage; Stefan,9999,0,9999,0
1668589207366,CSE 293,032,119425,Schulze; Jurgen P.,9999,0,9999,0
1668589207366,CSE 293,033,119426,Snoeren; Alex C.,9999,0,9999,0
1668589207366,CSE 293,034,119428,Shang; Jingbo,9999,0,9999,0
1668589207366,CSE 293,035,119430,Stefan; Deian,9999,0,9999,0
1668589207366,CSE 293,036,119431,Su; Hao,9999,0,9999,0
1668589207366,CSE 293,037,119433,Swanson; Steven James,9999,0,9999,0
1668589207366,CSE 293,038,119435,Tullsen; Dean Michael,9999,0,9999,0
1668589207366,CSE 293,039,119483,Voelker; Geoffrey M.,9999,0,9999,0
1668589207366,CSE 293,040,119537,Zhao; Jishen,9999,0,9999,0
1668589207366,CSE 293,041,119538,Zhou; Yuan-Yuan,9999,0,9999,0
1668589207366,CSE 293,042,119539,Gao; Sicun,9999,0,9999,0
1668589207366,CSE 293,043,119540,Weibel; Nadir,9999,0,9999,0
1668589207366,CSE 293,044,119541,Gupta; Rajesh K.,9999,0,9999,0
1668589207366,CSE 293,045,126410,Vaccaro; Kristen Marie,9999,0,9999,0
1668589207366,CSE 293,046,126411,Klemke; Richard,9999,0,9999,0
1668589207800,CSE 294,A00,102459,Voelker; Geoffrey M.,0,2,0,0
1668589207800,CSE 294,B00,111322,Orailoglu; Alex,0,2,0,0
1668589208231,DSE 201,A00,096914,Deutsch; Alin Bernard,30,0,30,0
1668589208663,DSE 210,A00,096915,Dasgupta; Sanjoy,30,0,30,0
1668589209087,DSE 241,A00,144528,Smith; Neil Gordon,30,0,30,0
1668589209517,DSE 260A,A00,096916,Altintas De Callaf; Ilkay,30,0,30,0
1668589209976,ECE 200,001,103586,Antipa; Nicholas A,9999,0,9999,0
1668589209976,ECE 200,002,103587,Atanasov; Nikolay A.,9999,0,9999,0
1668589209976,ECE 200,003,103588,Bharadia; Dinesh,9999,0,9999,0
1668589209976,ECE 200,004,103589,Cheng; Chung Kuan,9999,0,9999,0
1668589209976,ECE 200,005,103590,Cosman; Pamela C.,9999,0,9999,0
1668589209976,ECE 200,006,103591,Dayeh; Shadi Ahmad,9999,0,9999,0
1668589209976,ECE 200,007,103592,Fainman; Yeshaiahu,9999,0,9999,0
1668589209976,ECE 200,008,103593,Ford; Joseph Earl,9999,0,9999,0
1668589209976,ECE 200,009,103594,Franceschetti; Massimo,9999,0,9999,0
1668589209976,ECE 200,010,103595,Fullerton; Eric E,9999,0,9999,0
1668589209976,ECE 200,011,103596,Galton; Ian A,9999,0,9999,0
1668589209976,ECE 200,012,103597,Gilja; Vikash,9999,0,9999,0
1668589209976,ECE 200,013,103598,Hall; Drew A.,9999,0,9999,0
1668589209976,ECE 200,014,103599,Hsueh; Tzu-Chien,9999,0,9999,0
1668589209976,ECE 200,015,103600,Javidi; Tara,9999,0,9999,0
1668589209976,ECE 200,016,103601,Kahng; Andrew Byun,9999,0,9999,0
1668589209976,ECE 200,017,103602,Kim; Young-Han,9999,0,9999,0
1668589209976,ECE 200,018,103603,Koushanfar; Farinaz,9999,0,9999,0
1668589209976,ECE 200,019,103604,Kuzum; Duygu,9999,0,9999,0
1668589209976,ECE 200,020,103605,Le; Hanh-Phuc,9999,0,9999,0
1668589209976,ECE 200,021,103606,Lin; Bill,9999,0,9999,0
1668589209976,ECE 200,022,103607,Liu; Zhaowei,9998,0,9999,1
1668589209976,ECE 200,023,103608,Lo; Yu-Hwa,9999,0,9999,0
1668589209976,ECE 200,024,103609,Lomakin; Vitaliy,9999,0,9999,0
1668589209976,ECE 200,025,103610,Mercier; Patrick Philip,9999,0,9999,0
1668589209976,ECE 200,026,103611,Meyer; Florian,9999,0,9999,0
1668589209976,ECE 200,027,103612,Milstein; Laurence B.,9999,0,9999,0
1668589209976,ECE 200,028,103613,Mir Arabbaygi; Siavash,9999,0,9999,0
1668589209976,ECE 200,029,103614,Mookherjea; Shayan,9999,0,9999,0
1668589209976,ECE 200,030,103615,Morris; Karcher William,9999,0,9999,0
1668589209976,ECE 200,031,103616,Ng; Tse Nga,9999,0,9999,0
1668589209976,ECE 200,032,103617,Nguyen; Truong Quang,9999,0,9999,0
1668589209976,ECE 200,033,103618,Nomura; Kenji,9999,0,9999,0
1668589209976,ECE 200,034,103619,Orlitsky; Alon,9999,0,9999,0
1668589209976,ECE 200,035,103620,Pal; Piya,9999,0,9999,0
1668589209976,ECE 200,036,103621,Papen; George C.,9999,0,9999,0
1668589209976,ECE 200,037,103622,Radic; Stojan,9999,0,9999,0
1668589209976,ECE 200,038,103623,Rao; Bhaskar D.,9999,0,9999,0
1668589209976,ECE 200,039,103624,Rao; Ramesh R,9999,0,9999,0
1668589209976,ECE 200,040,103625,Rebeiz; Gabriel,9999,0,9999,0
1668589209976,ECE 200,041,103626,Sanford; John R,9999,0,9999,0
1668589209976,ECE 200,042,103627,Siegel; Paul H.,9999,0,9999,0
1668589209976,ECE 200,043,103628,Sievenpiper; Daniel F.,9999,0,9999,0
1668589209976,ECE 200,044,103629,Sworder; David D.,9999,0,9999,0
1668589209976,ECE 200,045,103630,Taur; Yuan,9999,0,9999,0
1668589209976,ECE 200,046,103631,Touri; Behrouz,9999,0,9999,0
1668589209976,ECE 200,047,103632,Trivedi; Mohan M.,9999,0,9999,0
1668589209976,ECE 200,048,103633,Vasconcelos; Nuno,9999,0,9999,0
1668589209976,ECE 200,049,103634,Wang; Xiaolong,9999,0,9999,0
1668589209976,ECE 200,050,103635,Xie; Pengtao,9999,0,9999,0
1668589209976,ECE 200,051,103636,Yip; Michael,9999,0,9999,0
1668589209976,ECE 200,052,103637,Zeger; Kenneth A.,999,0,999,0
1668589209976,ECE 200,053,103638,Zhang; Xinyu,9999,0,9999,0
1668589209976,ECE 200,054,103639,Turakhia; Yatish Girish,9999,0,9999,0
1668589209976,ECE 200,055,103640,Kang; Mingu,9999,0,9999,0
1668589209976,ECE 200,056,103641,Shi; Yuanyuan,9999,0,9999,0
1668589209976,ECE 200,057,103642,Wang; Edward Jay,9999,0,9999,0
1668589209976,ECE 200,058,103643,Zheng; Yang,9999,0,9999,0
1668589210402,ECE 202,A00,103644,Kuzum; Duygu,0,47,0,0
1668589210835,ECE 212BN,A00,103646,Ng; Tse Nga,0,10,0,0
1668589211265,ECE 221,A00,111493,Staff,0,0,0,0
1668589211689,ECE 222B,A00,103647,Lomakin; Vitaliy,0,22,0,0
1668589212118,ECE 230B,A00,103648,Taur; Yuan,0,4,0,0
1668589212549,ECE 238B,A00,103649,Garay; Javier,0,0,0,0
1668589212975,ECE 240B,A00,112900,Fainman; Yeshaiahu,0,8,0,0
1668589213419,ECE 247A,A00,103650,Jokerst; Jesse Vincent,0,6,0,0
1668589213849,ECE 247B,A00,103651,Wang; Joseph,0,14,0,0
1668589214302,ECE 250,A00,103652,Siegel; Paul H.,0,85,0,0
1668589214738,ECE 251A,A00,103654,Rao; Bhaskar D.,0,65,0,0
1668589215171,ECE 257B,A00,103655,Bharadia; Dinesh,0,33,0,0
1668589215612,ECE 258A,A00,103656,Milstein; Laurence B.,0,29,0,0
1668589216049,ECE 260B,A00,103658,Kang; Mingu,0,121,0,0
1668589216483,ECE 264A,A00,103659,Galton; Ian A,0,42,0,34
1668589216913,ECE 265A,A00,103661,Gudem; Prasad S.S.,0,42,0,36
1668589217338,ECE 265D,A00,103662,Gudem; Prasad S.S.,0,27,0,0
1668589217762,ECE 268,A00,103663,Koushanfar; Farinaz,0,44,0,0
1668589218186,ECE 269,A01,103665,Pal; Piya,0,223,0,0
1668589218611,ECE 271B,A00,103666,Vasconcelos; Manuela,0,80,0,0
1668589219041,ECE 276A,A00,103667,Atanasov; Nikolay A.,0,127,0,0
1668589219467,ECE 277,A00,103668,An; Cheolhong,0,151,0,0
1668589219893,ECE 279,A00,117947,Hall; Drew A.,0,22,0,0
1668589220754,ECE 283,A00,103670,Hsueh; Tzu-Chien,0,57,0,0
1668589221177,ECE 284,A00,103671,Turakhia; Yatish Girish,0,40,0,0
1668589221624,ECE 285,A00,103672,Zheng; Yang,0,40,0,0
1668589221624,ECE 285,B00,103673,Sworder; David D.,0,61,0,0
1668589222054,ECE 287,A00,103676,Javidi; Tara,0,7,0,0
1668589222479,MATH 200B,A00,098023,Salehi Golsefidy; Alireza,7,0,15,8
1668589222903,MATH 202B,A00,098024,Rhoades; Brendon Patrick,7,0,15,8
1668589223349,MATH 203B,A00,098025,Oprea; Dragos N.,9,0,15,6
1668589223792,MATH 204B,A00,098026,Sorensen; Claus M,13,0,15,2
1668589224215,MATH 208,A00,098027,Izadi; Elham,7,0,10,3
1668589224646,MATH 209,A00,098028,Pollack; Aaron,10,0,10,0
1668589225075,MATH 211A,A00,112919,Rogalski; Daniel,8,0,10,2
1668589225503,MATH 211B,A00,112920,Seward; Brandon M.,9,0,10,1
1668589225928,MATH 218,A00,098029,Li; Bo,10,0,10,0
1668589226355,MATH 220B,A00,098030,Novak; Jonathan I,10,0,15,5
1668589226779,MATH 221A,A00,098031,Ebenfelt; Peter F,12,0,15,3
1668589227208,MATH 231B,A00,098032,Zlatos; Andrej,9,0,15,6
1668589227643,MATH 240B,A00,098033,Ni; Lei,7,0,15,8
1668589228069,MATH 243,A00,098034,Jekel; David Andrew,10,0,10,0
1668589228500,MATH 245A,A00,098035,Nie; Jiawang,0,8,15,18
1668589228930,MATH 248,A00,098036,Bejenaru; Ioan,10,0,10,0
1668589229359,MATH 250B,A00,098037,Spolaor; Luca,12,0,15,3
1668589229784,MATH 258,A00,098038,Ni; Lei,8,0,10,2
1668589230218,MATH 264B,A00,098041,Rhoades; Brendon Patrick,6,0,15,9
1668589230641,MATH 268,A00,098042,Buss; Samuel R,10,0,10,0
1668589231065,MATH 269,A00,098043,Rhoades; Brendon Patrick,10,0,10,0
1668589231510,MATH 270B,A00,098044,Li; Bo,6,0,15,9
1668589231939,MATH 272B,A00,098045,Holst; Michael J,13,0,15,2
1668589232366,MATH 273A,A00,098046,Tian; Xiaochuan,10,0,15,5
1668589232796,MATH 275,A01,098048,Tian; Xiaochuan,6,0,10,4
1668589233221,MATH 278A,A00,098049,Holst; Michael J,6,0,10,4
1668589233661,MATH 278B,A00,098050,Cloninger; Alexander,10,0,10,0
1668589234097,MATH 278C,A00,098051,Nie; Jiawang,5,0,10,5
1668589234531,MATH 280B,A00,098052,Zheng; Tianyi,6,0,15,9
1668589234956,MATH 281B,A00,098053,Bradic; Jelena,0,2,15,15
1668589235385,MATH 282B,A00,098054,Arias-Castro; Ery,0,1,15,15
1668589235817,MATH 285,A00,098055,Fitzsimmons; Patrick J,0,4,15,16
1668589236240,MATH 287B,A00,098056,Arias-Castro; Ery,1,0,15,14
1668589236666,MATH 288,A00,098057,Agarwal; Pooja,9,0,10,1
1668589236666,MATH 288,B00,098058,Zhang; Danna,8,0,10,2
1668589236666,MATH 288,C00,098059,Williams; Ruth J,9,0,10,1
1668589237095,MATH 290B,A00,098060,Roberts; Justin Deritter,12,0,15,3
1668589237522,MATH 292,A00,098061,Belmont; Eva Kinoshita,10,0,10,0
1668589237951,MATH 295,A00,098062,Suk; Andrew Hoon,47,0,50,3
1668589238380,MATH 296,A00,098063,Novak; Jonathan I,20,0,20,0
1668589238807,MATH 297,001,098064,Gamst; Anthony Collins,9997,0,9999,2
1668589743801,COGS 205,A00,101395,Chiba; Andrea,19,0,20,1
1668589744238,COGS 210B,001,101404,Greene; Deanna Jacquelyn,9998,0,9999,1
1668589744238,COGS 210B,002,101417,Xia; Haijun,9999,0,9999,0
1668589744238,COGS 210B,003,101422,Nitz; Douglas A.,9999,0,9999,0
1668589744238,COGS 210B,004,101423,Hollan; James D.,9998,0,9999,1
1668589744238,COGS 210B,005,101424,Deak; Gedeon O.,9998,0,9999,1
1668589744238,COGS 210B,006,101425,Rossano; Federico,9999,0,9999,0
1668589744668,COGS 211B,A00,101427,Coulson; Seana M,9996,0,9999,3
1668589745093,COGS 220,A00,101428,Hollan; James D.,0,17,25,25
1668589745522,COGS 229,A00,101429,Dow; Steven P,17,0,25,8
1668589745948,COGS 230,A00,101430,Klemmer; Scott R,6,0,17,11
1668589746376,COGS 234,A00,101431,Xia; Haijun,0,1,25,25
1668589746805,COGS 260,A00,101432,Kiyonaga; Anastasia,21,0,25,4
1668589746805,COGS 260,B00,101433,Kirsh; David Joel,15,0,25,10
1668589747238,CSE 202,A00,102371,Impagliazzo; Russell,0,70,0,0
1668589747678,CSE 203B,A01,102373,Cheng; Chung Kuan,0,70,0,0
1668589748108,CSE 208,A00,102374,Micciancio; Daniele,0,5,0,0
1668589748544,CSE 209A,A00,112895,Impagliazzo; Russell,0,14,15,15
1668589748979,CSE 209B,A00,108005,Bellare; Mihir,0,7,0,0
1668589749419,CSE 210,A00,113163,Coblenz; Michael J,0,96,0,0
1668589749841,CSE 219,A00,106111,Dow; Steven P,0,8,20,20
1668589750265,CSE 221,A00,102376,Voelker; Geoffrey M.,0,78,0,0
1668589750696,CSE 224,A01,102378,Porter; George M,0,181,0,0
1668589751121,CSE 229A,A00,102379,Savage; Stefan,0,14,0,0
1668589751558,CSE 229C,A00,102380,Munyaka; Imani N. S.,0,12,0,0
1668589751981,CSE 232B,A00,102382,Deutsch; Alin Bernard,0,40,0,0
1668589752415,CSE 234,A01,112904,Kumar; Arun Kumar,0,0,0,0
1668589752840,CSE 237A,A00,102383,Rosing; Tajana Simunic,0,57,0,0
1668589753263,CSE 239A,A00,102384,Deutsch; Alin Bernard,0,18,0,0
1668589753692,CSE 239B,A00,102385,Polikarpova; Nadezhda,0,11,0,0
1668589754119,CSE 240A,A00,102386,Pannuto; Patrick William,0,49,0,0
1668589754545,CSE 240B,A00,102387,Zhao; Jishen,0,51,0,0
1668589754968,CSE 241A,A00,106406,Kang; Mingu,0,9,0,0
1668589755393,CSE 249B,A00,102388,Kahng; Andrew Byun,0,7,8,8
1668589755827,CSE 251B,A01,102392,Cottrell; Garrison W,0,54,0,0
1668589755827,CSE 251B,A02,102393,Cottrell; Garrison W,0,36,0,0
1668589756252,CSE 252B,A00,102394,Ochoa; Benjamin Lawrence,0,64,0,0
1668589756677,CSE 257,A01,102396,Gao; Sicun,0,160,0,0
1668589757102,CSE 272,A00,102397,Li; Tzumao,0,22,0,0
1668589757527,CSE 274,A00,111323,Chern; Albert Ren-Haur,0,16,0,0
1668589757961,CSE 282,A00,102398,Pevzner; Pavel Arkadjevich,0,0,0,0
1668589758389,CSE 284,A00,114175,Gymrek; Melissa Ann,0,33,0,0
1668589758829,CSE 290,A00,102399,Chandraker; Manmohan Krishna,0,11,0,0
1668589758829,CSE 290,B00,102400,Vaccaro; Kristen Marie,0,10,25,25
1668589758829,CSE 290,C00,102414,Pannuto; Patrick William,0,1,25,25
1668589758829,CSE 290,D00,102427,Pevzner; Pavel Arkadjevich,0,0,0,0
1668589758829,CSE 290,E00,102429,Zhao; Jishen,0,6,0,0
1668589758829,CSE 290,F00,102436,Tullsen; Dean Michael,0,6,0,0
1668589758829,CSE 290,G00,102440,Christensen; Henrik I,0,8,20,20
1668589759261,CSE 291,A00,102443,Su; Hao,0,0,0,0
1668589759261,CSE 291,B00,102448,Polikarpova; Nadezhda,0,0,0,0
1668589759261,CSE 291,C00,102453,Vaccaro; Kristen Marie,0,0,0,0
1668589759261,CSE 291,D00,111343,Savage; Stefan,0,0,0,0
1668589759261,CSE 291,E00,116474,Claffy; Kimberly Claire,0,0,0,0
1668589759261,CSE 291,F00,116479,Pasquale; Joseph,0,0,0,0
1668589759705,CSE 293,001,119111,Bafna; Vineet,9999,0,9999,0
1668589759705,CSE 293,002,119118,Bellare; Mihir,9999,0,9999,0
1668589759705,CSE 293,003,119122,Berg-Kirkpatrick; Taylor D,9999,0,9999,0
1668589759705,CSE 293,004,119135,Christensen; Henrik I,9999,0,9999,0
1668589759705,CSE 293,005,119142,Cottrell; Garrison W,9999,0,9999,0
1668589759705,CSE 293,006,119146,Deutsch; Alin Bernard,9999,0,9999,0
1668589759705,CSE 293,007,119159,Esmaeilzadeh; Hadi,9999,0,9999,0
1668589759705,CSE 293,008,119166,Freund; Yoav,9999,0,9999,0
1668589759705,CSE 293,009,119170,Griswold; William G.,9999,0,9999,0
1668589759705,CSE 293,010,119183,Gymrek; Melissa Ann,9999,0,9999,0
1668589759705,CSE 293,011,119190,Heninger; Nadia A,9999,0,9999,0
1668589759705,CSE 293,012,119230,Impagliazzo; Russell,9999,0,9999,0
1668589759705,CSE 293,013,119232,Jhala; Ranjit,9999,0,9999,0
1668589759705,CSE 293,014,119233,Kahng; Andrew Byun,9999,0,9999,0
1668589759705,CSE 293,015,119298,Kane; Daniel Mertz,9999,0,9999,0
1668589759705,CSE 293,016,119299,Kriegman; David J,9999,0,9999,0
1668589759705,CSE 293,017,119300,Kumar; Arun Kumar,9999,0,9999,0
1668589759705,CSE 293,018,119301,Lerner; Sorin,9999,0,9999,0
1668589759705,CSE 293,019,119302,Lovett; Shachar,9999,0,9999,0
1668589759705,CSE 293,020,119303,McAuley; Julian John,9999,0,9999,0
1668589759705,CSE 293,021,119304,Micciancio; Daniele,9999,0,9999,0
1668589759705,CSE 293,022,119367,Orailoglu; Alex,9999,0,9999,0
1668589759705,CSE 293,023,119382,Paturi; Ramamohan,9999,0,9999,0
1668589759705,CSE 293,024,119404,Polikarpova; Nadezhda,9999,0,9999,0
1668589759705,CSE 293,025,119406,Politz; Joseph Gibbs,9999,0,9999,0
1668589759705,CSE 293,026,119411,Porter; George M,9999,0,9999,0
1668589759705,CSE 293,027,119414,Porter; Leonard Emerson,9999,0,9999,0
1668589759705,CSE 293,028,119416,Ramamoorthi; Ravi,9999,0,9999,0
1668589759705,CSE 293,029,119417,Sahoo; Debashis,9999,0,9999,0
1668589759705,CSE 293,030,119420,Saul; Lawrence,9999,0,9999,0
1668589759705,CSE 293,031,119421,Savage; Stefan,9999,0,9999,0
1668589759705,CSE 293,032,119425,Schulze; Jurgen P.,9999,0,9999,0
1668589759705,CSE 293,033,119426,Snoeren; Alex C.,9999,0,9999,0
1668589759705,CSE 293,034,119428,Shang; Jingbo,9999,0,9999,0
1668589759705,CSE 293,035,119430,Stefan; Deian,9999,0,9999,0
1668589759705,CSE 293,036,119431,Su; Hao,9999,0,9999,0
1668589759705,CSE 293,037,119433,Swanson; Steven James,9999,0,9999,0
1668589759705,CSE 293,038,119435,Tullsen; Dean Michael,9999,0,9999,0
1668589759705,CSE 293,039,119483,Voelker; Geoffrey M.,9999,0,9999,0
1668589759705,CSE 293,040,119537,Zhao; Jishen,9999,0,9999,0
1668589759705,CSE 293,041,119538,Zhou; Yuan-Yuan,9999,0,9999,0
1668589759705,CSE 293,042,119539,Gao; Sicun,9999,0,9999,0
1668589759705,CSE 293,043,119540,Weibel; Nadir,9999,0,9999,0
1668589759705,CSE 293,044,119541,Gupta; Rajesh K.,9999,0,9999,0
1668589759705,CSE 293,045,126410,Vaccaro; Kristen Marie,9999,0,9999,0
1668589759705,CSE 293,046,126411,Klemke; Richard,9999,0,9999,0
1668589760133,CSE 294,A00,102459,Voelker; Geoffrey M.,0,2,0,0
1668589760133,CSE 294,B00,111322,Orailoglu; Alex,0,2,0,0
1668589760559,DSE 201,A00,096914,Deutsch; Alin Bernard,30,0,30,0
1668589760993,DSE 210,A00,096915,Dasgupta; Sanjoy,30,0,30,0
1668589761418,DSE 241,A00,144528,Smith; Neil Gordon,30,0,30,0
1668589761844,DSE 260A,A00,096916,Altintas De Callaf; Ilkay,30,0,30,0
1668589762304,ECE 200,001,103586,Antipa; Nicholas A,9999,0,9999,0
1668589762304,ECE 200,002,103587,Atanasov; Nikolay A.,9999,0,9999,0
1668589762304,ECE 200,003,103588,Bharadia; Dinesh,9999,0,9999,0
1668589762304,ECE 200,004,103589,Cheng; Chung Kuan,9999,0,9999,0
1668589762304,ECE 200,005,103590,Cosman; Pamela C.,9999,0,9999,0
1668589762304,ECE 200,006,103591,Dayeh; Shadi Ahmad,9999,0,9999,0
1668589762304,ECE 200,007,103592,Fainman; Yeshaiahu,9999,0,9999,0
1668589762304,ECE 200,008,103593,Ford; Joseph Earl,9999,0,9999,0
1668589762304,ECE 200,009,103594,Franceschetti; Massimo,9999,0,9999,0
1668589762304,ECE 200,010,103595,Fullerton; Eric E,9999,0,9999,0
1668589762304,ECE 200,011,103596,Galton; Ian A,9999,0,9999,0
1668589762304,ECE 200,012,103597,Gilja; Vikash,9999,0,9999,0
1668589762304,ECE 200,013,103598,Hall; Drew A.,9999,0,9999,0
1668589762304,ECE 200,014,103599,Hsueh; Tzu-Chien,9999,0,9999,0
1668589762304,ECE 200,015,103600,Javidi; Tara,9999,0,9999,0
1668589762304,ECE 200,016,103601,Kahng; Andrew Byun,9999,0,9999,0
1668589762304,ECE 200,017,103602,Kim; Young-Han,9999,0,9999,0
1668589762304,ECE 200,018,103603,Koushanfar; Farinaz,9999,0,9999,0
1668589762304,ECE 200,019,103604,Kuzum; Duygu,9999,0,9999,0
1668589762304,ECE 200,020,103605,Le; Hanh-Phuc,9999,0,9999,0
1668589762304,ECE 200,021,103606,Lin; Bill,9999,0,9999,0
1668589762304,ECE 200,022,103607,Liu; Zhaowei,9998,0,9999,1
1668589762304,ECE 200,023,103608,Lo; Yu-Hwa,9999,0,9999,0
1668589762304,ECE 200,024,103609,Lomakin; Vitaliy,9999,0,9999,0
1668589762304,ECE 200,025,103610,Mercier; Patrick Philip,9999,0,9999,0
1668589762304,ECE 200,026,103611,Meyer; Florian,9999,0,9999,0
1668589762304,ECE 200,027,103612,Milstein; Laurence B.,9999,0,9999,0
1668589762304,ECE 200,028,103613,Mir Arabbaygi; Siavash,9999,0,9999,0
1668589762304,ECE 200,029,103614,Mookherjea; Shayan,9999,0,9999,0
1668589762304,ECE 200,030,103615,Morris; Karcher William,9999,0,9999,0
1668589762304,ECE 200,031,103616,Ng; Tse Nga,9999,0,9999,0
1668589762304,ECE 200,032,103617,Nguyen; Truong Quang,9999,0,9999,0
1668589762304,ECE 200,033,103618,Nomura; Kenji,9999,0,9999,0
1668589762304,ECE 200,034,103619,Orlitsky; Alon,9999,0,9999,0
1668589762304,ECE 200,035,103620,Pal; Piya,9999,0,9999,0
1668589762304,ECE 200,036,103621,Papen; George C.,9999,0,9999,0
1668589762304,ECE 200,037,103622,Radic; Stojan,9999,0,9999,0
1668589762304,ECE 200,038,103623,Rao; Bhaskar D.,9999,0,9999,0
1668589762304,ECE 200,039,103624,Rao; Ramesh R,9999,0,9999,0
1668589762304,ECE 200,040,103625,Rebeiz; Gabriel,9999,0,9999,0
1668589762304,ECE 200,041,103626,Sanford; John R,9999,0,9999,0
1668589762304,ECE 200,042,103627,Siegel; Paul H.,9999,0,9999,0
1668589762304,ECE 200,043,103628,Sievenpiper; Daniel F.,9999,0,9999,0
1668589762304,ECE 200,044,103629,Sworder; David D.,9999,0,9999,0
1668589762304,ECE 200,045,103630,Taur; Yuan,9999,0,9999,0
1668589762304,ECE 200,046,103631,Touri; Behrouz,9999,0,9999,0
1668589762304,ECE 200,047,103632,Trivedi; Mohan M.,9999,0,9999,0
1668589762304,ECE 200,048,103633,Vasconcelos; Nuno,9999,0,9999,0
1668589762304,ECE 200,049,103634,Wang; Xiaolong,9999,0,9999,0
1668589762304,ECE 200,050,103635,Xie; Pengtao,9999,0,9999,0
1668589762304,ECE 200,051,103636,Yip; Michael,9999,0,9999,0
1668589762304,ECE 200,052,103637,Zeger; Kenneth A.,999,0,999,0
1668589762304,ECE 200,053,103638,Zhang; Xinyu,9999,0,9999,0
1668589762304,ECE 200,054,103639,Turakhia; Yatish Girish,9999,0,9999,0
1668589762304,ECE 200,055,103640,Kang; Mingu,9999,0,9999,0
1668589762304,ECE 200,056,103641,Shi; Yuanyuan,9999,0,9999,0
1668589762304,ECE 200,057,103642,Wang; Edward Jay,9999,0,9999,0
1668589762304,ECE 200,058,103643,Zheng; Yang,9999,0,9999,0
1668589762734,ECE 202,A00,103644,Kuzum; Duygu,0,47,0,0
1668589763163,ECE 212BN,A00,103646,Ng; Tse Nga,0,10,0,0
1668589763587,ECE 221,A00,111493,Staff,0,0,0,0
1668589764016,ECE 222B,A00,103647,Lomakin; Vitaliy,0,22,0,0
1668589764447,ECE 230B,A00,103648,Taur; Yuan,0,4,0,0
1668589764873,ECE 238B,A00,103649,Garay; Javier,0,0,0,0
1668589765299,ECE 240B,A00,112900,Fainman; Yeshaiahu,0,8,0,0
1668589765722,ECE 247A,A00,103650,Jokerst; Jesse Vincent,0,6,0,0
1668589766154,ECE 247B,A00,103651,Wang; Joseph,0,14,0,0
1668589766580,ECE 250,A00,103652,Siegel; Paul H.,0,85,0,0
1668589767005,ECE 251A,A00,103654,Rao; Bhaskar D.,0,65,0,0
1668589767428,ECE 257B,A00,103655,Bharadia; Dinesh,0,33,0,0
1668589767851,ECE 258A,A00,103656,Milstein; Laurence B.,0,29,0,0
1668589768279,ECE 260B,A00,103658,Kang; Mingu,0,121,0,0
1668589768704,ECE 264A,A00,103659,Galton; Ian A,0,42,0,34
1668589769127,ECE 265A,A00,103661,Gudem; Prasad S.S.,0,42,0,36
1668589769559,ECE 265D,A00,103662,Gudem; Prasad S.S.,0,27,0,0
1668589769987,ECE 268,A00,103663,Koushanfar; Farinaz,0,44,0,0
1668589770425,ECE 269,A01,103665,Pal; Piya,0,223,0,0
1668589770942,ECE 271B,A00,103666,Vasconcelos; Manuela,0,80,0,0
1668589771375,ECE 276A,A00,103667,Atanasov; Nikolay A.,0,127,0,0
1668589771800,ECE 277,A00,103668,An; Cheolhong,0,151,0,0
1668589772232,ECE 279,A00,117947,Hall; Drew A.,0,22,0,0
1668589773082,ECE 283,A00,103670,Hsueh; Tzu-Chien,0,57,0,0
1668589773506,ECE 284,A00,103671,Turakhia; Yatish Girish,0,40,0,0
1668589773937,ECE 285,A00,103672,Zheng; Yang,0,40,0,0
1668589773937,ECE 285,B00,103673,Sworder; David D.,0,61,0,0
1668589774362,ECE 287,A00,103676,Javidi; Tara,0,7,0,0
1668589774790,MATH 200B,A00,098023,Salehi Golsefidy; Alireza,7,0,15,8
1668589775236,MATH 202B,A00,098024,Rhoades; Brendon Patrick,7,0,15,8
1668589775661,MATH 203B,A00,098025,Oprea; Dragos N.,9,0,15,6
1668589776094,MATH 204B,A00,098026,Sorensen; Claus M,13,0,15,2
1668589776528,MATH 208,A00,098027,Izadi; Elham,7,0,10,3
1668589776964,MATH 209,A00,098028,Pollack; Aaron,10,0,10,0
1668589777394,MATH 211A,A00,112919,Rogalski; Daniel,8,0,10,2
1668589777831,MATH 211B,A00,112920,Seward; Brandon M.,9,0,10,1
1668589778259,MATH 218,A00,098029,Li; Bo,10,0,10,0
1668589778682,MATH 220B,A00,098030,Novak; Jonathan I,10,0,15,5
1668589779111,MATH 221A,A00,098031,Ebenfelt; Peter F,12,0,15,3
1668589779540,MATH 231B,A00,098032,Zlatos; Andrej,9,0,15,6
1668589779965,MATH 240B,A00,098033,Ni; Lei,7,0,15,8
1668589780392,MATH 243,A00,098034,Jekel; David Andrew,10,0,10,0
1668589780817,MATH 245A,A00,098035,Nie; Jiawang,0,8,15,18
1668589781246,MATH 248,A00,098036,Bejenaru; Ioan,10,0,10,0
1668589781670,MATH 250B,A00,098037,Spolaor; Luca,12,0,15,3
1668589782095,MATH 258,A00,098038,Ni; Lei,8,0,10,2
1668589782523,MATH 264B,A00,098041,Rhoades; Brendon Patrick,6,0,15,9
1668589782957,MATH 268,A00,098042,Buss; Samuel R,10,0,10,0
1668589783387,MATH 269,A00,098043,Rhoades; Brendon Patrick,10,0,10,0
1668589783827,MATH 270B,A00,098044,Li; Bo,6,0,15,9
1668589784255,MATH 272B,A00,098045,Holst; Michael J,13,0,15,2
1668589784683,MATH 273A,A00,098046,Tian; Xiaochuan,10,0,15,5
1668589785117,MATH 275,A01,098048,Tian; Xiaochuan,6,0,10,4
1668589785541,MATH 278A,A00,098049,Holst; Michael J,6,0,10,4
1668589785967,MATH 278B,A00,098050,Cloninger; Alexander,10,0,10,0
1668589786393,MATH 278C,A00,098051,Nie; Jiawang,5,0,10,5
1668589786819,MATH 280B,A00,098052,Zheng; Tianyi,6,0,15,9
1668589787244,MATH 281B,A00,098053,Bradic; Jelena,0,2,15,15
1668589787671,MATH 282B,A00,098054,Arias-Castro; Ery,0,1,15,15
1668589788101,MATH 285,A00,098055,Fitzsimmons; Patrick J,0,4,15,16
1668589788525,MATH 287B,A00,098056,Arias-Castro; Ery,1,0,15,14
1668589788953,MATH 288,A00,098057,Agarwal; Pooja,9,0,10,1
1668589788953,MATH 288,B00,098058,Zhang; Danna,8,0,10,2
1668589788953,MATH 288,C00,098059,Williams; Ruth J,9,0,10,1
1668589789383,MATH 290B,A00,098060,Roberts; Justin Deritter,12,0,15,3
1668589789810,MATH 292,A00,098061,Belmont; Eva Kinoshita,10,0,10,0
1668589790239,MATH 295,A00,098062,Suk; Andrew Hoon,47,0,50,3
1668589790662,MATH 296,A00,098063,Novak; Jonathan I,20,0,20,0
1668589791094,MATH 297,001,098064,Gamst; Anthony Collins,9997,0,9999,2
1668590296546,COGS 205,A00,101395,Chiba; Andrea,19,0,20,1
1668590296980,COGS 210B,001,101404,Greene; Deanna Jacquelyn,9998,0,9999,1
1668590296980,COGS 210B,002,101417,Xia; Haijun,9999,0,9999,0
1668590296980,COGS 210B,003,101422,Nitz; Douglas A.,9999,0,9999,0
1668590296980,COGS 210B,004,101423,Hollan; James D.,9998,0,9999,1
1668590296980,COGS 210B,005,101424,Deak; Gedeon O.,9998,0,9999,1
1668590296980,COGS 210B,006,101425,Rossano; Federico,9999,0,9999,0
1668590297408,COGS 211B,A00,101427,Coulson; Seana M,9996,0,9999,3
1668590297836,COGS 220,A00,101428,Hollan; James D.,0,17,25,25
1668590298262,COGS 229,A00,101429,Dow; Steven P,17,0,25,8
1668590298687,COGS 230,A00,101430,Klemmer; Scott R,6,0,17,11
1668590299111,COGS 234,A00,101431,Xia; Haijun,0,1,25,25
1668590299536,COGS 260,A00,101432,Kiyonaga; Anastasia,21,0,25,4
1668590299536,COGS 260,B00,101433,Kirsh; David Joel,15,0,25,10
1668590299961,CSE 202,A00,102371,Impagliazzo; Russell,0,70,0,0
1668590300394,CSE 203B,A01,102373,Cheng; Chung Kuan,0,70,0,0
1668590300824,CSE 208,A00,102374,Micciancio; Daniele,0,5,0,0
1668590301250,CSE 209A,A00,112895,Impagliazzo; Russell,0,14,15,15
1668590301678,CSE 209B,A00,108005,Bellare; Mihir,0,7,0,0
1668590302103,CSE 210,A00,113163,Coblenz; Michael J,0,96,0,0
1668590302528,CSE 219,A00,106111,Dow; Steven P,0,8,20,20
1668590302955,CSE 221,A00,102376,Voelker; Geoffrey M.,0,78,0,0
1668590303384,CSE 224,A01,102378,Porter; George M,0,181,0,0
1668590303811,CSE 229A,A00,102379,Savage; Stefan,0,14,0,0
1668590304238,CSE 229C,A00,102380,Munyaka; Imani N. S.,0,12,0,0
1668590304662,CSE 232B,A00,102382,Deutsch; Alin Bernard,0,40,0,0
1668590305090,CSE 234,A01,112904,Kumar; Arun Kumar,0,0,0,0
1668590305528,CSE 237A,A00,102383,Rosing; Tajana Simunic,0,57,0,0
1668590305952,CSE 239A,A00,102384,Deutsch; Alin Bernard,0,18,0,0
1668590306376,CSE 239B,A00,102385,Polikarpova; Nadezhda,0,11,0,0
1668590306799,CSE 240A,A00,102386,Pannuto; Patrick William,0,49,0,0
1668590307223,CSE 240B,A00,102387,Zhao; Jishen,0,51,0,0
1668590307654,CSE 241A,A00,106406,Kang; Mingu,0,9,0,0
1668590308079,CSE 249B,A00,102388,Kahng; Andrew Byun,0,7,8,8
1668590308515,CSE 251B,A01,102392,Cottrell; Garrison W,0,54,0,0
1668590308515,CSE 251B,A02,102393,Cottrell; Garrison W,0,36,0,0
1668590308948,CSE 252B,A00,102394,Ochoa; Benjamin Lawrence,0,64,0,0
1668590309372,CSE 257,A01,102396,Gao; Sicun,0,160,0,0
1668590309801,CSE 272,A00,102397,Li; Tzumao,0,22,0,0
1668590310236,CSE 274,A00,111323,Chern; Albert Ren-Haur,0,16,0,0
1668590310659,CSE 282,A00,102398,Pevzner; Pavel Arkadjevich,0,0,0,0
1668590311088,CSE 284,A00,114175,Gymrek; Melissa Ann,0,33,0,0
1668590311526,CSE 290,A00,102399,Chandraker; Manmohan Krishna,0,11,0,0
1668590311526,CSE 290,B00,102400,Vaccaro; Kristen Marie,0,10,25,25
1668590311526,CSE 290,C00,102414,Pannuto; Patrick William,0,1,25,25
1668590311526,CSE 290,D00,102427,Pevzner; Pavel Arkadjevich,0,0,0,0
1668590311526,CSE 290,E00,102429,Zhao; Jishen,0,6,0,0
1668590311526,CSE 290,F00,102436,Tullsen; Dean Michael,0,6,0,0
1668590311526,CSE 290,G00,102440,Christensen; Henrik I,0,8,20,20
1668590311955,CSE 291,A00,102443,Su; Hao,0,0,0,0
1668590311955,CSE 291,B00,102448,Polikarpova; Nadezhda,0,0,0,0
1668590311955,CSE 291,C00,102453,Vaccaro; Kristen Marie,0,0,0,0
1668590311955,CSE 291,D00,111343,Savage; Stefan,0,0,0,0
1668590311955,CSE 291,E00,116474,Claffy; Kimberly Claire,0,0,0,0
1668590311955,CSE 291,F00,116479,Pasquale; Joseph,0,0,0,0
1668590312395,CSE 293,001,119111,Bafna; Vineet,9999,0,9999,0
1668590312395,CSE 293,002,119118,Bellare; Mihir,9999,0,9999,0
1668590312395,CSE 293,003,119122,Berg-Kirkpatrick; Taylor D,9999,0,9999,0
1668590312395,CSE 293,004,119135,Christensen; Henrik I,9999,0,9999,0
1668590312395,CSE 293,005,119142,Cottrell; Garrison W,9999,0,9999,0
1668590312395,CSE 293,006,119146,Deutsch; Alin Bernard,9999,0,9999,0
1668590312395,CSE 293,007,119159,Esmaeilzadeh; Hadi,9999,0,9999,0
1668590312395,CSE 293,008,119166,Freund; Yoav,9999,0,9999,0
1668590312395,CSE 293,009,119170,Griswold; William G.,9999,0,9999,0
1668590312395,CSE 293,010,119183,Gymrek; Melissa Ann,9999,0,9999,0
1668590312395,CSE 293,011,119190,Heninger; Nadia A,9999,0,9999,0
1668590312395,CSE 293,012,119230,Impagliazzo; Russell,9999,0,9999,0
1668590312395,CSE 293,013,119232,Jhala; Ranjit,9999,0,9999,0
1668590312395,CSE 293,014,119233,Kahng; Andrew Byun,9999,0,9999,0
1668590312395,CSE 293,015,119298,Kane; Daniel Mertz,9999,0,9999,0
1668590312395,CSE 293,016,119299,Kriegman; David J,9999,0,9999,0
1668590312395,CSE 293,017,119300,Kumar; Arun Kumar,9999,0,9999,0
1668590312395,CSE 293,018,119301,Lerner; Sorin,9999,0,9999,0
1668590312395,CSE 293,019,119302,Lovett; Shachar,9999,0,9999,0
1668590312395,CSE 293,020,119303,McAuley; Julian John,9999,0,9999,0
1668590312395,CSE 293,021,119304,Micciancio; Daniele,9999,0,9999,0
1668590312395,CSE 293,022,119367,Orailoglu; Alex,9999,0,9999,0
1668590312395,CSE 293,023,119382,Paturi; Ramamohan,9999,0,9999,0
1668590312395,CSE 293,024,119404,Polikarpova; Nadezhda,9999,0,9999,0
1668590312395,CSE 293,025,119406,Politz; Joseph Gibbs,9999,0,9999,0
1668590312395,CSE 293,026,119411,Porter; George M,9999,0,9999,0
1668590312395,CSE 293,027,119414,Porter; Leonard Emerson,9999,0,9999,0
1668590312395,CSE 293,028,119416,Ramamoorthi; Ravi,9999,0,9999,0
1668590312395,CSE 293,029,119417,Sahoo; Debashis,9999,0,9999,0
1668590312395,CSE 293,030,119420,Saul; Lawrence,9999,0,9999,0
1668590312395,CSE 293,031,119421,Savage; Stefan,9999,0,9999,0
1668590312395,CSE 293,032,119425,Schulze; Jurgen P.,9999,0,9999,0
1668590312395,CSE 293,033,119426,Snoeren; Alex C.,9999,0,9999,0
1668590312395,CSE 293,034,119428,Shang; Jingbo,9999,0,9999,0
1668590312395,CSE 293,035,119430,Stefan; Deian,9999,0,9999,0
1668590312395,CSE 293,036,119431,Su; Hao,9999,0,9999,0
1668590312395,CSE 293,037,119433,Swanson; Steven James,9999,0,9999,0
1668590312395,CSE 293,038,119435,Tullsen; Dean Michael,9999,0,9999,0
1668590312395,CSE 293,039,119483,Voelker; Geoffrey M.,9999,0,9999,0
1668590312395,CSE 293,040,119537,Zhao; Jishen,9999,0,9999,0
1668590312395,CSE 293,041,119538,Zhou; Yuan-Yuan,9999,0,9999,0
1668590312395,CSE 293,042,119539,Gao; Sicun,9999,0,9999,0
1668590312395,CSE 293,043,119540,Weibel; Nadir,9999,0,9999,0
1668590312395,CSE 293,044,119541,Gupta; Rajesh K.,9999,0,9999,0
1668590312395,CSE 293,045,126410,Vaccaro; Kristen Marie,9999,0,9999,0
1668590312395,CSE 293,046,126411,Klemke; Richard,9999,0,9999,0
1668590312821,CSE 294,A00,102459,Voelker; Geoffrey M.,0,2,0,0
1668590312821,CSE 294,B00,111322,Orailoglu; Alex,0,2,0,0
1668590313246,DSE 201,A00,096914,Deutsch; Alin Bernard,30,0,30,0
1668590313671,DSE 210,A00,096915,Dasgupta; Sanjoy,30,0,30,0
1668590314096,DSE 241,A00,144528,Smith; Neil Gordon,30,0,30,0
1668590314533,DSE 260A,A00,096916,Altintas De Callaf; Ilkay,30,0,30,0
1668590314987,ECE 200,001,103586,Antipa; Nicholas A,9999,0,9999,0
1668590314987,ECE 200,002,103587,Atanasov; Nikolay A.,9999,0,9999,0
1668590314987,ECE 200,003,103588,Bharadia; Dinesh,9999,0,9999,0
1668590314987,ECE 200,004,103589,Cheng; Chung Kuan,9999,0,9999,0
1668590314987,ECE 200,005,103590,Cosman; Pamela C.,9999,0,9999,0
1668590314987,ECE 200,006,103591,Dayeh; Shadi Ahmad,9999,0,9999,0
1668590314987,ECE 200,007,103592,Fainman; Yeshaiahu,9999,0,9999,0
1668590314987,ECE 200,008,103593,Ford; Joseph Earl,9999,0,9999,0
1668590314987,ECE 200,009,103594,Franceschetti; Massimo,9999,0,9999,0
1668590314987,ECE 200,010,103595,Fullerton; Eric E,9999,0,9999,0
1668590314987,ECE 200,011,103596,Galton; Ian A,9999,0,9999,0
1668590314987,ECE 200,012,103597,Gilja; Vikash,9999,0,9999,0
1668590314987,ECE 200,013,103598,Hall; Drew A.,9999,0,9999,0
1668590314987,ECE 200,014,103599,Hsueh; Tzu-Chien,9999,0,9999,0
1668590314987,ECE 200,015,103600,Javidi; Tara,9999,0,9999,0
1668590314987,ECE 200,016,103601,Kahng; Andrew Byun,9999,0,9999,0
1668590314987,ECE 200,017,103602,Kim; Young-Han,9999,0,9999,0
1668590314987,ECE 200,018,103603,Koushanfar; Farinaz,9999,0,9999,0
1668590314987,ECE 200,019,103604,Kuzum; Duygu,9999,0,9999,0
1668590314987,ECE 200,020,103605,Le; Hanh-Phuc,9999,0,9999,0
1668590314987,ECE 200,021,103606,Lin; Bill,9999,0,9999,0
1668590314987,ECE 200,022,103607,Liu; Zhaowei,9998,0,9999,1
1668590314987,ECE 200,023,103608,Lo; Yu-Hwa,9999,0,9999,0
1668590314987,ECE 200,024,103609,Lomakin; Vitaliy,9999,0,9999,0
1668590314987,ECE 200,025,103610,Mercier; Patrick Philip,9999,0,9999,0
1668590314987,ECE 200,026,103611,Meyer; Florian,9999,0,9999,0
1668590314987,ECE 200,027,103612,Milstein; Laurence B.,9999,0,9999,0
1668590314987,ECE 200,028,103613,Mir Arabbaygi; Siavash,9999,0,9999,0
1668590314987,ECE 200,029,103614,Mookherjea; Shayan,9999,0,9999,0
1668590314987,ECE 200,030,103615,Morris; Karcher William,9999,0,9999,0
1668590314987,ECE 200,031,103616,Ng; Tse Nga,9999,0,9999,0
1668590314987,ECE 200,032,103617,Nguyen; Truong Quang,9999,0,9999,0
1668590314987,ECE 200,033,103618,Nomura; Kenji,9999,0,9999,0
1668590314987,ECE 200,034,103619,Orlitsky; Alon,9999,0,9999,0
1668590314987,ECE 200,035,103620,Pal; Piya,9999,0,9999,0
1668590314987,ECE 200,036,103621,Papen; George C.,9999,0,9999,0
1668590314987,ECE 200,037,103622,Radic; Stojan,9999,0,9999,0
1668590314987,ECE 200,038,103623,Rao; Bhaskar D.,9999,0,9999,0
1668590314987,ECE 200,039,103624,Rao; Ramesh R,9999,0,9999,0
1668590314987,ECE 200,040,103625,Rebeiz; Gabriel,9999,0,9999,0
1668590314987,ECE 200,041,103626,Sanford; John R,9999,0,9999,0
1668590314987,ECE 200,042,103627,Siegel; Paul H.,9999,0,9999,0
1668590314987,ECE 200,043,103628,Sievenpiper; Daniel F.,9999,0,9999,0
1668590314987,ECE 200,044,103629,Sworder; David D.,9999,0,9999,0
1668590314987,ECE 200,045,103630,Taur; Yuan,9999,0,9999,0
1668590314987,ECE 200,046,103631,Touri; Behrouz,9999,0,9999,0
1668590314987,ECE 200,047,103632,Trivedi; Mohan M.,9999,0,9999,0
1668590314987,ECE 200,048,103633,Vasconcelos; Nuno,9999,0,9999,0
1668590314987,ECE 200,049,103634,Wang; Xiaolong,9999,0,9999,0
1668590314987,ECE 200,050,103635,Xie; Pengtao,9999,0,9999,0
1668590314987,ECE 200,051,103636,Yip; Michael,9999,0,9999,0
1668590314987,ECE 200,052,103637,Zeger; Kenneth A.,999,0,999,0
1668590314987,ECE 200,053,103638,Zhang; Xinyu,9999,0,9999,0
1668590314987,ECE 200,054,103639,Turakhia; Yatish Girish,9999,0,9999,0
1668590314987,ECE 200,055,103640,Kang; Mingu,9999,0,9999,0
1668590314987,ECE 200,056,103641,Shi; Yuanyuan,9999,0,9999,0
1668590314987,ECE 200,057,103642,Wang; Edward Jay,9999,0,9999,0
1668590314987,ECE 200,058,103643,Zheng; Yang,9999,0,9999,0
1668590315417,ECE 202,A00,103644,Kuzum; Duygu,0,47,0,0
1668590315843,ECE 212BN,A00,103646,Ng; Tse Nga,0,10,0,0
1668590316269,ECE 221,A00,111493,Staff,0,0,0,0
1668590316697,ECE 222B,A00,103647,Lomakin; Vitaliy,0,22,0,0
1668590317122,ECE 230B,A00,103648,Taur; Yuan,0,4,0,0
1668590317552,ECE 238B,A00,103649,Garay; Javier,0,0,0,0
1668590317977,ECE 240B,A00,112900,Fainman; Yeshaiahu,0,8,0,0
1668590318404,ECE 247A,A00,103650,Jokerst; Jesse Vincent,0,6,0,0
1668590318833,ECE 247B,A00,103651,Wang; Joseph,0,14,0,0
1668590319263,ECE 250,A00,103652,Siegel; Paul H.,0,85,0,0
1668590319696,ECE 251A,A00,103654,Rao; Bhaskar D.,0,65,0,0
1668590320124,ECE 257B,A00,103655,Bharadia; Dinesh,0,33,0,0
1668590320552,ECE 258A,A00,103656,Milstein; Laurence B.,0,29,0,0
1668590320980,ECE 260B,A00,103658,Kang; Mingu,0,121,0,0
1668590321405,ECE 264A,A00,103659,Galton; Ian A,0,42,0,34
1668590321835,ECE 265A,A00,103661,Gudem; Prasad S.S.,0,42,0,36
1668590322259,ECE 265D,A00,103662,Gudem; Prasad S.S.,0,27,0,0
1668590322701,ECE 268,A00,103663,Koushanfar; Farinaz,0,44,0,0
1668590323138,ECE 269,A01,103665,Pal; Piya,0,223,0,0
1668590323570,ECE 271B,A00,103666,Vasconcelos; Manuela,0,80,0,0
1668590323995,ECE 276A,A00,103667,Atanasov; Nikolay A.,0,127,0,0
1668590324426,ECE 277,A00,103668,An; Cheolhong,0,151,0,0
1668590324849,ECE 279,A00,117947,Hall; Drew A.,0,22,0,0
1668590325702,ECE 283,A00,103670,Hsueh; Tzu-Chien,0,57,0,0
1668590326132,ECE 284,A00,103671,Turakhia; Yatish Girish,0,40,0,0
1668590326561,ECE 285,A00,103672,Zheng; Yang,0,40,0,0
1668590326561,ECE 285,B00,103673,Sworder; David D.,0,61,0,0
1668590326987,ECE 287,A00,103676,Javidi; Tara,0,7,0,0
1668590327421,MATH 200B,A00,098023,Salehi Golsefidy; Alireza,7,0,15,8
1668590327853,MATH 202B,A00,098024,Rhoades; Brendon Patrick,7,0,15,8
1668590328281,MATH 203B,A00,098025,Oprea; Dragos N.,9,0,15,6
1668590328706,MATH 204B,A00,098026,Sorensen; Claus M,13,0,15,2
1668590329131,MATH 208,A00,098027,Izadi; Elham,7,0,10,3
1668590329566,MATH 209,A00,098028,Pollack; Aaron,10,0,10,0
1668590329994,MATH 211A,A00,112919,Rogalski; Daniel,8,0,10,2
1668590330425,MATH 211B,A00,112920,Seward; Brandon M.,9,0,10,1
1668590330852,MATH 218,A00,098029,Li; Bo,10,0,10,0
1668590331282,MATH 220B,A00,098030,Novak; Jonathan I,10,0,15,5
1668590331711,MATH 221A,A00,098031,Ebenfelt; Peter F,12,0,15,3
1668590332135,MATH 231B,A00,098032,Zlatos; Andrej,9,0,15,6
1668590332562,MATH 240B,A00,098033,Ni; Lei,7,0,15,8
1668590332986,MATH 243,A00,098034,Jekel; David Andrew,10,0,10,0
1668590333411,MATH 245A,A00,098035,Nie; Jiawang,0,8,15,18
1668590333838,MATH 248,A00,098036,Bejenaru; Ioan,10,0,10,0
1668590334264,MATH 250B,A00,098037,Spolaor; Luca,12,0,15,3
1668590334688,MATH 258,A00,098038,Ni; Lei,8,0,10,2
1668590335123,MATH 264B,A00,098041,Rhoades; Brendon Patrick,6,0,15,9
1668590335558,MATH 268,A00,098042,Buss; Samuel R,10,0,10,0
1668590335991,MATH 269,A00,098043,Rhoades; Brendon Patrick,10,0,10,0
1668590336416,MATH 270B,A00,098044,Li; Bo,6,0,15,9
1668590336840,MATH 272B,A00,098045,Holst; Michael J,13,0,15,2
1668590337271,MATH 273A,A00,098046,Tian; Xiaochuan,10,0,15,5
1668590337709,MATH 275,A01,098048,Tian; Xiaochuan,6,0,10,4
1668590338211,MATH 278A,A00,098049,Holst; Michael J,6,0,10,4
1668590338637,MATH 278B,A00,098050,Cloninger; Alexander,10,0,10,0
1668590339062,MATH 278C,A00,098051,Nie; Jiawang,5,0,10,5
1668590339492,MATH 280B,A00,098052,Zheng; Tianyi,6,0,15,9
1668590339916,MATH 281B,A00,098053,Bradic; Jelena,0,2,15,15
1668590340347,MATH 282B,A00,098054,Arias-Castro; Ery,0,1,15,15
1668590340777,MATH 285,A00,098055,Fitzsimmons; Patrick J,0,4,15,16
1668590341205,MATH 287B,A00,098056,Arias-Castro; Ery,1,0,15,14
1668590341628,MATH 288,A00,098057,Agarwal; Pooja,9,0,10,1
1668590341628,MATH 288,B00,098058,Zhang; Danna,8,0,10,2
1668590341628,MATH 288,C00,098059,Williams; Ruth J,9,0,10,1
1668590342055,MATH 290B,A00,098060,Roberts; Justin Deritter,12,0,15,3
1668590342486,MATH 292,A00,098061,Belmont; Eva Kinoshita,10,0,10,0
1668590342909,MATH 295,A00,098062,Suk; Andrew Hoon,47,0,50,3
1668590343342,MATH 296,A00,098063,Novak; Jonathan I,20,0,20,0
1668590343767,MATH 297,001,098064,Gamst; Anthony Collins,9997,0,9999,2
1668590848822,COGS 205,A00,101395,Chiba; Andrea,19,0,20,1
1668590849267,COGS 210B,001,101404,Greene; Deanna Jacquelyn,9998,0,9999,1
1668590849267,COGS 210B,002,101417,Xia; Haijun,9999,0,9999,0
1668590849267,COGS 210B,003,101422,Nitz; Douglas A.,9999,0,9999,0
1668590849267,COGS 210B,004,101423,Hollan; James D.,9998,0,9999,1
1668590849267,COGS 210B,005,101424,Deak; Gedeon O.,9998,0,9999,1
1668590849267,COGS 210B,006,101425,Rossano; Federico,9999,0,9999,0
1668590849708,COGS 211B,A00,101427,Coulson; Seana M,9996,0,9999,3
1668590850133,COGS 220,A00,101428,Hollan; James D.,0,17,25,25
1668590850564,COGS 229,A00,101429,Dow; Steven P,17,0,25,8
1668590850999,COGS 230,A00,101430,Klemmer; Scott R,6,0,17,11
1668590851424,COGS 234,A00,101431,Xia; Haijun,0,1,25,25
1668590851865,COGS 260,A00,101432,Kiyonaga; Anastasia,21,0,25,4
1668590851865,COGS 260,B00,101433,Kirsh; David Joel,15,0,25,10
1668590852290,CSE 202,A00,102371,Impagliazzo; Russell,0,70,0,0
1668590852718,CSE 203B,A01,102373,Cheng; Chung Kuan,0,70,0,0
1668590853145,CSE 208,A00,102374,Micciancio; Daniele,0,5,0,0
1668590853574,CSE 209A,A00,112895,Impagliazzo; Russell,0,14,15,15
1668590854000,CSE 209B,A00,108005,Bellare; Mihir,0,7,0,0
1668590854438,CSE 210,A00,113163,Coblenz; Michael J,0,96,0,0
1668590854875,CSE 219,A00,106111,Dow; Steven P,0,8,20,20
1668590855310,CSE 221,A00,102376,Voelker; Geoffrey M.,0,78,0,0
1668590855742,CSE 224,A01,102378,Porter; George M,0,181,0,0
1668590856169,CSE 229A,A00,102379,Savage; Stefan,0,14,0,0
1668590856594,CSE 229C,A00,102380,Munyaka; Imani N. S.,0,12,0,0
1668590857024,CSE 232B,A00,102382,Deutsch; Alin Bernard,0,40,0,0
1668590857450,CSE 234,A01,112904,Kumar; Arun Kumar,0,0,0,0
1668590857877,CSE 237A,A00,102383,Rosing; Tajana Simunic,0,57,0,0
1668590858303,CSE 239A,A00,102384,Deutsch; Alin Bernard,0,18,0,0
1668590858735,CSE 239B,A00,102385,Polikarpova; Nadezhda,0,11,0,0
1668590859163,CSE 240A,A00,102386,Pannuto; Patrick William,0,49,0,0
1668590859587,CSE 240B,A00,102387,Zhao; Jishen,0,51,0,0
1668590860015,CSE 241A,A00,106406,Kang; Mingu,0,9,0,0
1668590860445,CSE 249B,A00,102388,Kahng; Andrew Byun,0,7,8,8
1668590860871,CSE 251B,A01,102392,Cottrell; Garrison W,0,54,0,0
1668590860871,CSE 251B,A02,102393,Cottrell; Garrison W,0,36,0,0
1668590861297,CSE 252B,A00,102394,Ochoa; Benjamin Lawrence,0,64,0,0
1668590861801,CSE 257,A01,102396,Gao; Sicun,0,160,0,0
1668590862226,CSE 272,A00,102397,Li; Tzumao,0,22,0,0
1668590862657,CSE 274,A00,111323,Chern; Albert Ren-Haur,0,16,0,0
1668590863084,CSE 282,A00,102398,Pevzner; Pavel Arkadjevich,0,0,0,0
1668590863519,CSE 284,A00,114175,Gymrek; Melissa Ann,0,33,0,0
1668590863953,CSE 290,A00,102399,Chandraker; Manmohan Krishna,0,11,0,0
1668590863953,CSE 290,B00,102400,Vaccaro; Kristen Marie,0,10,25,25
1668590863953,CSE 290,C00,102414,Pannuto; Patrick William,0,1,25,25
1668590863953,CSE 290,D00,102427,Pevzner; Pavel Arkadjevich,0,0,0,0
1668590863953,CSE 290,E00,102429,Zhao; Jishen,0,6,0,0
1668590863953,CSE 290,F00,102436,Tullsen; Dean Michael,0,6,0,0
1668590863953,CSE 290,G00,102440,Christensen; Henrik I,0,8,20,20
1668590864397,CSE 291,A00,102443,Su; Hao,0,0,0,0
1668590864397,CSE 291,B00,102448,Polikarpova; Nadezhda,0,0,0,0
1668590864397,CSE 291,C00,102453,Vaccaro; Kristen Marie,0,0,0,0
1668590864397,CSE 291,D00,111343,Savage; Stefan,0,0,0,0
1668590864397,CSE 291,E00,116474,Claffy; Kimberly Claire,0,0,0,0
1668590864397,CSE 291,F00,116479,Pasquale; Joseph,0,0,0,0
1668590864869,CSE 293,001,119111,Bafna; Vineet,9999,0,9999,0
1668590864869,CSE 293,002,119118,Bellare; Mihir,9999,0,9999,0
1668590864869,CSE 293,003,119122,Berg-Kirkpatrick; Taylor D,9999,0,9999,0
1668590864869,CSE 293,004,119135,Christensen; Henrik I,9999,0,9999,0
1668590864869,CSE 293,005,119142,Cottrell; Garrison W,9999,0,9999,0
1668590864869,CSE 293,006,119146,Deutsch; Alin Bernard,9999,0,9999,0
1668590864869,CSE 293,007,119159,Esmaeilzadeh; Hadi,9999,0,9999,0
1668590864869,CSE 293,008,119166,Freund; Yoav,9999,0,9999,0
1668590864869,CSE 293,009,119170,Griswold; William G.,9999,0,9999,0
1668590864869,CSE 293,010,119183,Gymrek; Melissa Ann,9999,0,9999,0
1668590864869,CSE 293,011,119190,Heninger; Nadia A,9999,0,9999,0
1668590864869,CSE 293,012,119230,Impagliazzo; Russell,9999,0,9999,0
1668590864869,CSE 293,013,119232,Jhala; Ranjit,9999,0,9999,0
1668590864869,CSE 293,014,119233,Kahng; Andrew Byun,9999,0,9999,0
1668590864869,CSE 293,015,119298,Kane; Daniel Mertz,9999,0,9999,0
1668590864869,CSE 293,016,119299,Kriegman; David J,9999,0,9999,0
1668590864869,CSE 293,017,119300,Kumar; Arun Kumar,9999,0,9999,0
1668590864869,CSE 293,018,119301,Lerner; Sorin,9999,0,9999,0
1668590864869,CSE 293,019,119302,Lovett; Shachar,9999,0,9999,0
1668590864869,CSE 293,020,119303,McAuley; Julian John,9999,0,9999,0
1668590864869,CSE 293,021,119304,Micciancio; Daniele,9999,0,9999,0
1668590864869,CSE 293,022,119367,Orailoglu; Alex,9999,0,9999,0
1668590864869,CSE 293,023,119382,Paturi; Ramamohan,9999,0,9999,0
1668590864869,CSE 293,024,119404,Polikarpova; Nadezhda,9999,0,9999,0
1668590864869,CSE 293,025,119406,Politz; Joseph Gibbs,9999,0,9999,0
1668590864869,CSE 293,026,119411,Porter; George M,9999,0,9999,0
1668590864869,CSE 293,027,119414,Porter; Leonard Emerson,9999,0,9999,0
1668590864869,CSE 293,028,119416,Ramamoorthi; Ravi,9999,0,9999,0
1668590864869,CSE 293,029,119417,Sahoo; Debashis,9999,0,9999,0
1668590864869,CSE 293,030,119420,Saul; Lawrence,9999,0,9999,0
1668590864869,CSE 293,031,119421,Savage; Stefan,9999,0,9999,0
1668590864869,CSE 293,032,119425,Schulze; Jurgen P.,9999,0,9999,0
1668590864869,CSE 293,033,119426,Snoeren; Alex C.,9999,0,9999,0
1668590864869,CSE 293,034,119428,Shang; Jingbo,9999,0,9999,0
1668590864869,CSE 293,035,119430,Stefan; Deian,9999,0,9999,0
1668590864869,CSE 293,036,119431,Su; Hao,9999,0,9999,0
1668590864869,CSE 293,037,119433,Swanson; Steven James,9999,0,9999,0
1668590864869,CSE 293,038,119435,Tullsen; Dean Michael,9999,0,9999,0
1668590864869,CSE 293,039,119483,Voelker; Geoffrey M.,9999,0,9999,0
1668590864869,CSE 293,040,119537,Zhao; Jishen,9999,0,9999,0
1668590864869,CSE 293,041,119538,Zhou; Yuan-Yuan,9999,0,9999,0
1668590864869,CSE 293,042,119539,Gao; Sicun,9999,0,9999,0
1668590864869,CSE 293,043,119540,Weibel; Nadir,9999,0,9999,0
1668590864869,CSE 293,044,119541,Gupta; Rajesh K.,9999,0,9999,0
1668590864869,CSE 293,045,126410,Vaccaro; Kristen Marie,9999,0,9999,0
1668590864869,CSE 293,046,126411,Klemke; Richard,9999,0,9999,0
1668590865298,CSE 294,A00,102459,Voelker; Geoffrey M.,0,2,0,0
1668590865298,CSE 294,B00,111322,Orailoglu; Alex,0,2,0,0
1668590865723,DSE 201,A00,096914,Deutsch; Alin Bernard,30,0,30,0
1668590866146,DSE 210,A00,096915,Dasgupta; Sanjoy,30,0,30,0
1668590866573,DSE 241,A00,144528,Smith; Neil Gordon,30,0,30,0
1668590867028,DSE 260A,A00,096916,Altintas De Callaf; Ilkay,30,0,30,0
1668590867487,ECE 200,001,103586,Antipa; Nicholas A,9999,0,9999,0
1668590867487,ECE 200,002,103587,Atanasov; Nikolay A.,9999,0,9999,0
1668590867487,ECE 200,003,103588,Bharadia; Dinesh,9999,0,9999,0
1668590867487,ECE 200,004,103589,Cheng; Chung Kuan,9999,0,9999,0
1668590867487,ECE 200,005,103590,Cosman; Pamela C.,9999,0,9999,0
1668590867487,ECE 200,006,103591,Dayeh; Shadi Ahmad,9999,0,9999,0
1668590867487,ECE 200,007,103592,Fainman; Yeshaiahu,9999,0,9999,0
1668590867487,ECE 200,008,103593,Ford; Joseph Earl,9999,0,9999,0
1668590867487,ECE 200,009,103594,Franceschetti; Massimo,9999,0,9999,0
1668590867487,ECE 200,010,103595,Fullerton; Eric E,9999,0,9999,0
1668590867487,ECE 200,011,103596,Galton; Ian A,9999,0,9999,0
1668590867487,ECE 200,012,103597,Gilja; Vikash,9999,0,9999,0
1668590867487,ECE 200,013,103598,Hall; Drew A.,9999,0,9999,0
1668590867487,ECE 200,014,103599,Hsueh; Tzu-Chien,9999,0,9999,0
1668590867487,ECE 200,015,103600,Javidi; Tara,9999,0,9999,0
1668590867487,ECE 200,016,103601,Kahng; Andrew Byun,9999,0,9999,0
1668590867487,ECE 200,017,103602,Kim; Young-Han,9999,0,9999,0
1668590867487,ECE 200,018,103603,Koushanfar; Farinaz,9999,0,9999,0
1668590867487,ECE 200,019,103604,Kuzum; Duygu,9999,0,9999,0
1668590867487,ECE 200,020,103605,Le; Hanh-Phuc,9999,0,9999,0
1668590867487,ECE 200,021,103606,Lin; Bill,9999,0,9999,0
1668590867487,ECE 200,022,103607,Liu; Zhaowei,9998,0,9999,1
1668590867487,ECE 200,023,103608,Lo; Yu-Hwa,9999,0,9999,0
1668590867487,ECE 200,024,103609,Lomakin; Vitaliy,9999,0,9999,0
1668590867487,ECE 200,025,103610,Mercier; Patrick Philip,9999,0,9999,0
1668590867487,ECE 200,026,103611,Meyer; Florian,9999,0,9999,0
1668590867487,ECE 200,027,103612,Milstein; Laurence B.,9999,0,9999,0
1668590867487,ECE 200,028,103613,Mir Arabbaygi; Siavash,9999,0,9999,0
1668590867487,ECE 200,029,103614,Mookherjea; Shayan,9999,0,9999,0
1668590867487,ECE 200,030,103615,Morris; Karcher William,9999,0,9999,0
1668590867487,ECE 200,031,103616,Ng; Tse Nga,9999,0,9999,0
1668590867487,ECE 200,032,103617,Nguyen; Truong Quang,9999,0,9999,0
1668590867487,ECE 200,033,103618,Nomura; Kenji,9999,0,9999,0
1668590867487,ECE 200,034,103619,Orlitsky; Alon,9999,0,9999,0
1668590867487,ECE 200,035,103620,Pal; Piya,9999,0,9999,0
1668590867487,ECE 200,036,103621,Papen; George C.,9999,0,9999,0
1668590867487,ECE 200,037,103622,Radic; Stojan,9999,0,9999,0
1668590867487,ECE 200,038,103623,Rao; Bhaskar D.,9999,0,9999,0
1668590867487,ECE 200,039,103624,Rao; Ramesh R,9999,0,9999,0
1668590867487,ECE 200,040,103625,Rebeiz; Gabriel,9999,0,9999,0
1668590867487,ECE 200,041,103626,Sanford; John R,9999,0,9999,0
1668590867487,ECE 200,042,103627,Siegel; Paul H.,9999,0,9999,0
1668590867487,ECE 200,043,103628,Sievenpiper; Daniel F.,9999,0,9999,0
1668590867487,ECE 200,044,103629,Sworder; David D.,9999,0,9999,0
1668590867487,ECE 200,045,103630,Taur; Yuan,9999,0,9999,0
1668590867487,ECE 200,046,103631,Touri; Behrouz,9999,0,9999,0
1668590867487,ECE 200,047,103632,Trivedi; Mohan M.,9999,0,9999,0
1668590867487,ECE 200,048,103633,Vasconcelos; Nuno,9999,0,9999,0
1668590867487,ECE 200,049,103634,Wang; Xiaolong,9999,0,9999,0
1668590867487,ECE 200,050,103635,Xie; Pengtao,9999,0,9999,0
1668590867487,ECE 200,051,103636,Yip; Michael,9999,0,9999,0
1668590867487,ECE 200,052,103637,Zeger; Kenneth A.,999,0,999,0
1668590867487,ECE 200,053,103638,Zhang; Xinyu,9999,0,9999,0
1668590867487,ECE 200,054,103639,Turakhia; Yatish Girish,9999,0,9999,0
1668590867487,ECE 200,055,103640,Kang; Mingu,9999,0,9999,0
1668590867487,ECE 200,056,103641,Shi; Yuanyuan,9999,0,9999,0
1668590867487,ECE 200,057,103642,Wang; Edward Jay,9999,0,9999,0
1668590867487,ECE 200,058,103643,Zheng; Yang,9999,0,9999,0
1668590867913,ECE 202,A00,103644,Kuzum; Duygu,0,47,0,0
1668590868340,ECE 212BN,A00,103646,Ng; Tse Nga,0,10,0,0
1668590868774,ECE 221,A00,111493,Staff,0,0,0,0
1668590869202,ECE 222B,A00,103647,Lomakin; Vitaliy,0,22,0,0
1668590869629,ECE 230B,A00,103648,Taur; Yuan,0,4,0,0
1668590870060,ECE 238B,A00,103649,Garay; Javier,0,0,0,0
1668590870486,ECE 240B,A00,112900,Fainman; Yeshaiahu,0,8,0,0
1668590870911,ECE 247A,A00,103650,Jokerst; Jesse Vincent,0,6,0,0
1668590871337,ECE 247B,A00,103651,Wang; Joseph,0,14,0,0
1668590871762,ECE 250,A00,103652,Siegel; Paul H.,0,85,0,0
1668590872190,ECE 251A,A00,103654,Rao; Bhaskar D.,0,65,0,0
1668590872614,ECE 257B,A00,103655,Bharadia; Dinesh,0,33,0,0
1668590873044,ECE 258A,A00,103656,Milstein; Laurence B.,0,29,0,0
1668590873474,ECE 260B,A00,103658,Kang; Mingu,0,121,0,0
1668590873900,ECE 264A,A00,103659,Galton; Ian A,0,42,0,34
1668590874330,ECE 265A,A00,103661,Gudem; Prasad S.S.,0,41,0,37
1668590874765,ECE 265D,A00,103662,Gudem; Prasad S.S.,0,27,0,0
1668590875189,ECE 268,A00,103663,Koushanfar; Farinaz,0,44,0,0
1668590875617,ECE 269,A01,103665,Pal; Piya,0,223,0,0
1668590876043,ECE 271B,A00,103666,Vasconcelos; Manuela,0,80,0,0
1668590876466,ECE 276A,A00,103667,Atanasov; Nikolay A.,0,127,0,0
1668590876897,ECE 277,A00,103668,An; Cheolhong,0,151,0,0
1668590877323,ECE 279,A00,117947,Hall; Drew A.,0,22,0,0
1668590878177,ECE 283,A00,103670,Hsueh; Tzu-Chien,0,57,0,0
1668590878607,ECE 284,A00,103671,Turakhia; Yatish Girish,0,40,0,0
1668590879032,ECE 285,A00,103672,Zheng; Yang,0,40,0,0
1668590879032,ECE 285,B00,103673,Sworder; David D.,0,61,0,0
1668590879457,ECE 287,A00,103676,Javidi; Tara,0,7,0,0
1668590879890,MATH 200B,A00,098023,Salehi Golsefidy; Alireza,7,0,15,8
1668590880318,MATH 202B,A00,098024,Rhoades; Brendon Patrick,7,0,15,8
1668590880747,MATH 203B,A00,098025,Oprea; Dragos N.,9,0,15,6
1668590881171,MATH 204B,A00,098026,Sorensen; Claus M,13,0,15,2
1668590881595,MATH 208,A00,098027,Izadi; Elham,7,0,10,3
1668590882022,MATH 209,A00,098028,Pollack; Aaron,10,0,10,0
1668590882448,MATH 211A,A00,112919,Rogalski; Daniel,8,0,10,2
1668590882876,MATH 211B,A00,112920,Seward; Brandon M.,9,0,10,1
1668590883304,MATH 218,A00,098029,Li; Bo,10,0,10,0
1668590883733,MATH 220B,A00,098030,Novak; Jonathan I,10,0,15,5
1668590884162,MATH 221A,A00,098031,Ebenfelt; Peter F,12,0,15,3
1668590884588,MATH 231B,A00,098032,Zlatos; Andrej,9,0,15,6
1668590885013,MATH 240B,A00,098033,Ni; Lei,7,0,15,8
1668590885440,MATH 243,A00,098034,Jekel; David Andrew,10,0,10,0
1668590885866,MATH 245A,A00,098035,Nie; Jiawang,0,8,15,18
1668590886290,MATH 248,A00,098036,Bejenaru; Ioan,10,0,10,0
1668590886718,MATH 250B,A00,098037,Spolaor; Luca,12,0,15,3
1668590887142,MATH 258,A00,098038,Ni; Lei,8,0,10,2
1668590887570,MATH 264B,A00,098041,Rhoades; Brendon Patrick,6,0,15,9
1668590887997,MATH 268,A00,098042,Buss; Samuel R,10,0,10,0
1668590888438,MATH 269,A00,098043,Rhoades; Brendon Patrick,10,0,10,0
1668590888865,MATH 270B,A00,098044,Li; Bo,6,0,15,9
1668590889290,MATH 272B,A00,098045,Holst; Michael J,13,0,15,2
1668590889714,MATH 273A,A00,098046,Tian; Xiaochuan,10,0,15,5
1668590890140,MATH 275,A01,098048,Tian; Xiaochuan,6,0,10,4
1668590890576,MATH 278A,A00,098049,Holst; Michael J,6,0,10,4
1668590891018,MATH 278B,A00,098050,Cloninger; Alexander,10,0,10,0
1668590891443,MATH 278C,A00,098051,Nie; Jiawang,5,0,10,5
1668590891866,MATH 280B,A00,098052,Zheng; Tianyi,6,0,15,9
1668590892295,MATH 281B,A00,098053,Bradic; Jelena,0,2,15,15
1668590892722,MATH 282B,A00,098054,Arias-Castro; Ery,0,1,15,15
1668590893162,MATH 285,A00,098055,Fitzsimmons; Patrick J,0,4,15,16
1668590893593,MATH 287B,A00,098056,Arias-Castro; Ery,1,0,15,14
1668590894032,MATH 288,A00,098057,Agarwal; Pooja,9,0,10,1
1668590894032,MATH 288,B00,098058,Zhang; Danna,8,0,10,2
1668590894032,MATH 288,C00,098059,Williams; Ruth J,9,0,10,1
1668590894464,MATH 290B,A00,098060,Roberts; Justin Deritter,12,0,15,3
1668590894902,MATH 292,A00,098061,Belmont; Eva Kinoshita,10,0,10,0
1668590895332,MATH 295,A00,098062,Suk; Andrew Hoon,47,0,50,3
1668590895758,MATH 296,A00,098063,Novak; Jonathan I,20,0,20,0
1668590896185,MATH 297,001,098064,Gamst; Anthony Collins,9997,0,9999,2
1668591401685,COGS 205,A00,101395,Chiba; Andrea,19,0,20,1
1668591402112,COGS 210B,001,101404,Greene; Deanna Jacquelyn,9998,0,9999,1
1668591402112,COGS 210B,002,101417,Xia; Haijun,9999,0,9999,0
1668591402112,COGS 210B,003,101422,Nitz; Douglas A.,9999,0,9999,0
1668591402112,COGS 210B,004,101423,Hollan; James D.,9998,0,9999,1
1668591402112,COGS 210B,005,101424,Deak; Gedeon O.,9998,0,9999,1
1668591402112,COGS 210B,006,101425,Rossano; Federico,9999,0,9999,0
1668591402535,COGS 211B,A00,101427,Coulson; Seana M,9996,0,9999,3
1668591402959,COGS 220,A00,101428,Hollan; James D.,0,17,25,25
1668591403381,COGS 229,A00,101429,Dow; Steven P,17,0,25,8
1668591403812,COGS 230,A00,101430,Klemmer; Scott R,6,0,17,11
1668591404241,COGS 234,A00,101431,Xia; Haijun,0,1,25,25
1668591404665,COGS 260,A00,101432,Kiyonaga; Anastasia,21,0,25,4
1668591404665,COGS 260,B00,101433,Kirsh; David Joel,15,0,25,10
1668591405111,CSE 202,A00,102371,Impagliazzo; Russell,0,70,0,0
1668591405542,CSE 203B,A01,102373,Cheng; Chung Kuan,0,70,0,0
1668591405966,CSE 208,A00,102374,Micciancio; Daniele,0,5,0,0
1668591406390,CSE 209A,A00,112895,Impagliazzo; Russell,0,14,15,15
1668591406816,CSE 209B,A00,108005,Bellare; Mihir,0,7,0,0
1668591407241,CSE 210,A00,113163,Coblenz; Michael J,0,96,0,0
1668591407681,CSE 219,A00,106111,Dow; Steven P,0,8,20,20
1668591408122,CSE 221,A00,102376,Voelker; Geoffrey M.,0,78,0,0
1668591408553,CSE 224,A01,102378,Porter; George M,0,181,0,0
1668591408977,CSE 229A,A00,102379,Savage; Stefan,0,14,0,0
1668591409409,CSE 229C,A00,102380,Munyaka; Imani N. S.,0,12,0,0
1668591409846,CSE 232B,A00,102382,Deutsch; Alin Bernard,0,40,0,0
1668591410279,CSE 234,A01,112904,Kumar; Arun Kumar,0,0,0,0
1668591410705,CSE 237A,A00,102383,Rosing; Tajana Simunic,0,57,0,0
1668591411128,CSE 239A,A00,102384,Deutsch; Alin Bernard,0,18,0,0
1668591411557,CSE 239B,A00,102385,Polikarpova; Nadezhda,0,11,0,0
1668591411981,CSE 240A,A00,102386,Pannuto; Patrick William,0,49,0,0
1668591412405,CSE 240B,A00,102387,Zhao; Jishen,0,51,0,0
1668591412843,CSE 241A,A00,106406,Kang; Mingu,0,9,0,0
1668591413271,CSE 249B,A00,102388,Kahng; Andrew Byun,0,7,8,8
1668591413697,CSE 251B,A01,102392,Cottrell; Garrison W,0,54,0,0
1668591413697,CSE 251B,A02,102393,Cottrell; Garrison W,0,36,0,0
1668591414122,CSE 252B,A00,102394,Ochoa; Benjamin Lawrence,0,64,0,0
1668591414560,CSE 257,A01,102396,Gao; Sicun,0,160,0,0
1668591414990,CSE 272,A00,102397,Li; Tzumao,0,22,0,0
1668591415419,CSE 274,A00,111323,Chern; Albert Ren-Haur,0,16,0,0
1668591415843,CSE 282,A00,102398,Pevzner; Pavel Arkadjevich,0,0,0,0
1668591416270,CSE 284,A00,114175,Gymrek; Melissa Ann,0,33,0,0
1668591416699,CSE 290,A00,102399,Chandraker; Manmohan Krishna,0,11,0,0
1668591416699,CSE 290,B00,102400,Vaccaro; Kristen Marie,0,10,25,25
1668591416699,CSE 290,C00,102414,Pannuto; Patrick William,0,1,25,25
1668591416699,CSE 290,D00,102427,Pevzner; Pavel Arkadjevich,0,0,0,0
1668591416699,CSE 290,E00,102429,Zhao; Jishen,0,6,0,0
1668591416699,CSE 290,F00,102436,Tullsen; Dean Michael,0,6,0,0
1668591416699,CSE 290,G00,102440,Christensen; Henrik I,0,8,20,20
1668591417135,CSE 291,A00,102443,Su; Hao,0,0,0,0
1668591417135,CSE 291,B00,102448,Polikarpova; Nadezhda,0,0,0,0
1668591417135,CSE 291,C00,102453,Vaccaro; Kristen Marie,0,0,0,0
1668591417135,CSE 291,D00,111343,Savage; Stefan,0,0,0,0
1668591417135,CSE 291,E00,116474,Claffy; Kimberly Claire,0,0,0,0
1668591417135,CSE 291,F00,116479,Pasquale; Joseph,0,0,0,0
1668591417625,CSE 293,001,119111,Bafna; Vineet,9999,0,9999,0
1668591417625,CSE 293,002,119118,Bellare; Mihir,9999,0,9999,0
1668591417625,CSE 293,003,119122,Berg-Kirkpatrick; Taylor D,9999,0,9999,0
1668591417625,CSE 293,004,119135,Christensen; Henrik I,9999,0,9999,0
1668591417625,CSE 293,005,119142,Cottrell; Garrison W,9999,0,9999,0
1668591417625,CSE 293,006,119146,Deutsch; Alin Bernard,9999,0,9999,0
1668591417625,CSE 293,007,119159,Esmaeilzadeh; Hadi,9999,0,9999,0
1668591417625,CSE 293,008,119166,Freund; Yoav,9999,0,9999,0
1668591417625,CSE 293,009,119170,Griswold; William G.,9999,0,9999,0
1668591417625,CSE 293,010,119183,Gymrek; Melissa Ann,9999,0,9999,0
1668591417625,CSE 293,011,119190,Heninger; Nadia A,9999,0,9999,0
1668591417625,CSE 293,012,119230,Impagliazzo; Russell,9999,0,9999,0
1668591417625,CSE 293,013,119232,Jhala; Ranjit,9999,0,9999,0
1668591417625,CSE 293,014,119233,Kahng; Andrew Byun,9999,0,9999,0
1668591417625,CSE 293,015,119298,Kane; Daniel Mertz,9999,0,9999,0
1668591417625,CSE 293,016,119299,Kriegman; David J,9999,0,9999,0
1668591417625,CSE 293,017,119300,Kumar; Arun Kumar,9999,0,9999,0
1668591417625,CSE 293,018,119301,Lerner; Sorin,9999,0,9999,0
1668591417625,CSE 293,019,119302,Lovett; Shachar,9999,0,9999,0
1668591417625,CSE 293,020,119303,McAuley; Julian John,9999,0,9999,0
1668591417625,CSE 293,021,119304,Micciancio; Daniele,9999,0,9999,0
1668591417625,CSE 293,022,119367,Orailoglu; Alex,9999,0,9999,0
1668591417625,CSE 293,023,119382,Paturi; Ramamohan,9999,0,9999,0
1668591417625,CSE 293,024,119404,Polikarpova; Nadezhda,9999,0,9999,0
1668591417625,CSE 293,025,119406,Politz; Joseph Gibbs,9999,0,9999,0
1668591417625,CSE 293,026,119411,Porter; George M,9999,0,9999,0
1668591417625,CSE 293,027,119414,Porter; Leonard Emerson,9999,0,9999,0
1668591417625,CSE 293,028,119416,Ramamoorthi; Ravi,9999,0,9999,0
1668591417625,CSE 293,029,119417,Sahoo; Debashis,9999,0,9999,0
1668591417625,CSE 293,030,119420,Saul; Lawrence,9999,0,9999,0
1668591417625,CSE 293,031,119421,Savage; Stefan,9999,0,9999,0
1668591417625,CSE 293,032,119425,Schulze; Jurgen P.,9999,0,9999,0
1668591417625,CSE 293,033,119426,Snoeren; Alex C.,9999,0,9999,0
1668591417625,CSE 293,034,119428,Shang; Jingbo,9999,0,9999,0
1668591417625,CSE 293,035,119430,Stefan; Deian,9999,0,9999,0
1668591417625,CSE 293,036,119431,Su; Hao,9999,0,9999,0
1668591417625,CSE 293,037,119433,Swanson; Steven James,9999,0,9999,0
1668591417625,CSE 293,038,119435,Tullsen; Dean Michael,9999,0,9999,0
1668591417625,CSE 293,039,119483,Voelker; Geoffrey M.,9999,0,9999,0
1668591417625,CSE 293,040,119537,Zhao; Jishen,9999,0,9999,0
1668591417625,CSE 293,041,119538,Zhou; Yuan-Yuan,9999,0,9999,0
1668591417625,CSE 293,042,119539,Gao; Sicun,9999,0,9999,0
1668591417625,CSE 293,043,119540,Weibel; Nadir,9999,0,9999,0
1668591417625,CSE 293,044,119541,Gupta; Rajesh K.,9999,0,9999,0
1668591417625,CSE 293,045,126410,Vaccaro; Kristen Marie,9999,0,9999,0
1668591417625,CSE 293,046,126411,Klemke; Richard,9999,0,9999,0
1668591418051,CSE 294,A00,102459,Voelker; Geoffrey M.,0,2,0,0
1668591418051,CSE 294,B00,111322,Orailoglu; Alex,0,2,0,0
1668591418487,DSE 201,A00,096914,Deutsch; Alin Bernard,30,0,30,0
1668591418912,DSE 210,A00,096915,Dasgupta; Sanjoy,30,0,30,0
1668591419342,DSE 241,A00,144528,Smith; Neil Gordon,30,0,30,0
1668591419767,DSE 260A,A00,096916,Altintas De Callaf; Ilkay,30,0,30,0
1668591420270,ECE 200,001,103586,Antipa; Nicholas A,9999,0,9999,0
1668591420270,ECE 200,002,103587,Atanasov; Nikolay A.,9999,0,9999,0
1668591420270,ECE 200,003,103588,Bharadia; Dinesh,9999,0,9999,0
1668591420270,ECE 200,004,103589,Cheng; Chung Kuan,9999,0,9999,0
1668591420270,ECE 200,005,103590,Cosman; Pamela C.,9999,0,9999,0
1668591420270,ECE 200,006,103591,Dayeh; Shadi Ahmad,9999,0,9999,0
1668591420270,ECE 200,007,103592,Fainman; Yeshaiahu,9999,0,9999,0
1668591420270,ECE 200,008,103593,Ford; Joseph Earl,9999,0,9999,0
1668591420270,ECE 200,009,103594,Franceschetti; Massimo,9999,0,9999,0
1668591420270,ECE 200,010,103595,Fullerton; Eric E,9999,0,9999,0
1668591420270,ECE 200,011,103596,Galton; Ian A,9999,0,9999,0
1668591420270,ECE 200,012,103597,Gilja; Vikash,9999,0,9999,0
1668591420270,ECE 200,013,103598,Hall; Drew A.,9999,0,9999,0
1668591420270,ECE 200,014,103599,Hsueh; Tzu-Chien,9999,0,9999,0
1668591420270,ECE 200,015,103600,Javidi; Tara,9999,0,9999,0
1668591420270,ECE 200,016,103601,Kahng; Andrew Byun,9999,0,9999,0
1668591420270,ECE 200,017,103602,Kim; Young-Han,9999,0,9999,0
1668591420270,ECE 200,018,103603,Koushanfar; Farinaz,9999,0,9999,0
1668591420270,ECE 200,019,103604,Kuzum; Duygu,9999,0,9999,0
1668591420270,ECE 200,020,103605,Le; Hanh-Phuc,9999,0,9999,0
1668591420270,ECE 200,021,103606,Lin; Bill,9999,0,9999,0
1668591420270,ECE 200,022,103607,Liu; Zhaowei,9998,0,9999,1
1668591420270,ECE 200,023,103608,Lo; Yu-Hwa,9999,0,9999,0
1668591420270,ECE 200,024,103609,Lomakin; Vitaliy,9999,0,9999,0
1668591420270,ECE 200,025,103610,Mercier; Patrick Philip,9999,0,9999,0
1668591420270,ECE 200,026,103611,Meyer; Florian,9999,0,9999,0
1668591420270,ECE 200,027,103612,Milstein; Laurence B.,9999,0,9999,0
1668591420270,ECE 200,028,103613,Mir Arabbaygi; Siavash,9999,0,9999,0
1668591420270,ECE 200,029,103614,Mookherjea; Shayan,9999,0,9999,0
1668591420270,ECE 200,030,103615,Morris; Karcher William,9999,0,9999,0
1668591420270,ECE 200,031,103616,Ng; Tse Nga,9999,0,9999,0
1668591420270,ECE 200,032,103617,Nguyen; Truong Quang,9999,0,9999,0
1668591420270,ECE 200,033,103618,Nomura; Kenji,9999,0,9999,0
1668591420270,ECE 200,034,103619,Orlitsky; Alon,9999,0,9999,0
1668591420270,ECE 200,035,103620,Pal; Piya,9999,0,9999,0
1668591420270,ECE 200,036,103621,Papen; George C.,9999,0,9999,0
1668591420270,ECE 200,037,103622,Radic; Stojan,9999,0,9999,0
1668591420270,ECE 200,038,103623,Rao; Bhaskar D.,9999,0,9999,0
1668591420270,ECE 200,039,103624,Rao; Ramesh R,9999,0,9999,0
1668591420270,ECE 200,040,103625,Rebeiz; Gabriel,9999,0,9999,0
1668591420270,ECE 200,041,103626,Sanford; John R,9999,0,9999,0
1668591420270,ECE 200,042,103627,Siegel; Paul H.,9999,0,9999,0
1668591420270,ECE 200,043,103628,Sievenpiper; Daniel F.,9999,0,9999,0
1668591420270,ECE 200,044,103629,Sworder; David D.,9999,0,9999,0
1668591420270,ECE 200,045,103630,Taur; Yuan,9999,0,9999,0
1668591420270,ECE 200,046,103631,Touri; Behrouz,9999,0,9999,0
1668591420270,ECE 200,047,103632,Trivedi; Mohan M.,9999,0,9999,0
1668591420270,ECE 200,048,103633,Vasconcelos; Nuno,9999,0,9999,0
1668591420270,ECE 200,049,103634,Wang; Xiaolong,9999,0,9999,0
1668591420270,ECE 200,050,103635,Xie; Pengtao,9999,0,9999,0
1668591420270,ECE 200,051,103636,Yip; Michael,9999,0,9999,0
1668591420270,ECE 200,052,103637,Zeger; Kenneth A.,999,0,999,0
1668591420270,ECE 200,053,103638,Zhang; Xinyu,9999,0,9999,0
1668591420270,ECE 200,054,103639,Turakhia; Yatish Girish,9999,0,9999,0
1668591420270,ECE 200,055,103640,Kang; Mingu,9999,0,9999,0
1668591420270,ECE 200,056,103641,Shi; Yuanyuan,9999,0,9999,0
1668591420270,ECE 200,057,103642,Wang; Edward Jay,9999,0,9999,0
1668591420270,ECE 200,058,103643,Zheng; Yang,9999,0,9999,0
1668591420709,ECE 202,A00,103644,Kuzum; Duygu,0,47,0,0
1668591421147,ECE 212BN,A00,103646,Ng; Tse Nga,0,10,0,0
1668591421570,ECE 221,A00,111493,Staff,0,0,0,0
1668591421998,ECE 222B,A00,103647,Lomakin; Vitaliy,0,22,0,0
1668591422427,ECE 230B,A00,103648,Taur; Yuan,0,4,0,0
1668591422851,ECE 238B,A00,103649,Garay; Javier,0,0,0,0
1668591423280,ECE 240B,A00,112900,Fainman; Yeshaiahu,0,8,0,0
1668591423709,ECE 247A,A00,103650,Jokerst; Jesse Vincent,0,6,0,0
1668591424134,ECE 247B,A00,103651,Wang; Joseph,0,14,0,0
1668591424565,ECE 250,A00,103652,Siegel; Paul H.,0,85,0,0
1668591424990,ECE 251A,A00,103654,Rao; Bhaskar D.,0,65,0,0
1668591425420,ECE 257B,A00,103655,Bharadia; Dinesh,0,33,0,0
1668591425849,ECE 258A,A00,103656,Milstein; Laurence B.,0,29,0,0
1668591426273,ECE 260B,A00,103658,Kang; Mingu,0,121,0,0
1668591426698,ECE 264A,A00,103659,Galton; Ian A,0,42,0,34
1668591427124,ECE 265A,A00,103661,Gudem; Prasad S.S.,0,41,0,37
1668591427549,ECE 265D,A00,103662,Gudem; Prasad S.S.,0,27,0,0
1668591427973,ECE 268,A00,103663,Koushanfar; Farinaz,0,44,0,0
1668591428399,ECE 269,A01,103665,Pal; Piya,0,223,0,0
1668591428833,ECE 271B,A00,103666,Vasconcelos; Manuela,0,80,0,0
1668591429354,ECE 276A,A00,103667,Atanasov; Nikolay A.,0,127,0,0
1668591429779,ECE 277,A00,103668,An; Cheolhong,0,151,0,0
1668591430205,ECE 279,A00,117947,Hall; Drew A.,0,22,0,0
1668591431068,ECE 283,A00,103670,Hsueh; Tzu-Chien,0,57,0,0
1668591431494,ECE 284,A00,103671,Turakhia; Yatish Girish,0,40,0,0
1668591431917,ECE 285,A00,103672,Zheng; Yang,0,40,0,0
1668591431917,ECE 285,B00,103673,Sworder; David D.,0,61,0,0
1668591432343,ECE 287,A00,103676,Javidi; Tara,0,7,0,0
1668591432783,MATH 200B,A00,098023,Salehi Golsefidy; Alireza,7,0,15,8
1668591433219,MATH 202B,A00,098024,Rhoades; Brendon Patrick,7,0,15,8
1668591433651,MATH 203B,A00,098025,Oprea; Dragos N.,9,0,15,6
1668591434085,MATH 204B,A00,098026,Sorensen; Claus M,13,0,15,2
1668591434514,MATH 208,A00,098027,Izadi; Elham,7,0,10,3
1668591434938,MATH 209,A00,098028,Pollack; Aaron,10,0,10,0
1668591435377,MATH 211A,A00,112919,Rogalski; Daniel,8,0,10,2
1668591435801,MATH 211B,A00,112920,Seward; Brandon M.,9,0,10,1
1668591436233,MATH 218,A00,098029,Li; Bo,10,0,10,0
1668591436659,MATH 220B,A00,098030,Novak; Jonathan I,10,0,15,5
1668591437084,MATH 221A,A00,098031,Ebenfelt; Peter F,12,0,15,3
1668591437509,MATH 231B,A00,098032,Zlatos; Andrej,9,0,15,6
1668591437943,MATH 240B,A00,098033,Ni; Lei,7,0,15,8
1668591438383,MATH 243,A00,098034,Jekel; David Andrew,10,0,10,0
1668591438807,MATH 245A,A00,098035,Nie; Jiawang,0,8,15,18
1668591439231,MATH 248,A00,098036,Bejenaru; Ioan,10,0,10,0
1668591439661,MATH 250B,A00,098037,Spolaor; Luca,12,0,15,3
1668591440093,MATH 258,A00,098038,Ni; Lei,8,0,10,2
1668591440518,MATH 264B,A00,098041,Rhoades; Brendon Patrick,6,0,15,9
1668591440950,MATH 268,A00,098042,Buss; Samuel R,10,0,10,0
1668591441384,MATH 269,A00,098043,Rhoades; Brendon Patrick,10,0,10,0
1668591441835,MATH 270B,A00,098044,Li; Bo,6,0,15,9
1668591442261,MATH 272B,A00,098045,Holst; Michael J,13,0,15,2
1668591442684,MATH 273A,A00,098046,Tian; Xiaochuan,10,0,15,5
1668591443137,MATH 275,A01,098048,Tian; Xiaochuan,6,0,10,4
1668591443569,MATH 278A,A00,098049,Holst; Michael J,6,0,10,4
1668591443999,MATH 278B,A00,098050,Cloninger; Alexander,10,0,10,0
1668591444426,MATH 278C,A00,098051,Nie; Jiawang,5,0,10,5
1668591444854,MATH 280B,A00,098052,Zheng; Tianyi,6,0,15,9
1668591445281,MATH 281B,A00,098053,Bradic; Jelena,0,2,15,15
1668591445706,MATH 282B,A00,098054,Arias-Castro; Ery,0,1,15,15
1668591446132,MATH 285,A00,098055,Fitzsimmons; Patrick J,0,4,15,16
1668591446556,MATH 287B,A00,098056,Arias-Castro; Ery,1,0,15,14
1668591446983,MATH 288,A00,098057,Agarwal; Pooja,9,0,10,1
1668591446983,MATH 288,B00,098058,Zhang; Danna,8,0,10,2
1668591446983,MATH 288,C00,098059,Williams; Ruth J,9,0,10,1
1668591447407,MATH 290B,A00,098060,Roberts; Justin Deritter,12,0,15,3
1668591447835,MATH 292,A00,098061,Belmont; Eva Kinoshita,10,0,10,0
1668591448262,MATH 295,A00,098062,Suk; Andrew Hoon,47,0,50,3
1668591448689,MATH 296,A00,098063,Novak; Jonathan I,20,0,20,0
1668591449126,MATH 297,001,098064,Gamst; Anthony Collins,9997,0,9999,2
1668591953993,COGS 205,A00,101395,Chiba; Andrea,19,0,20,1
1668591954420,COGS 210B,001,101404,Greene; Deanna Jacquelyn,9998,0,9999,1
1668591954420,COGS 210B,002,101417,Xia; Haijun,9999,0,9999,0
1668591954420,COGS 210B,003,101422,Nitz; Douglas A.,9999,0,9999,0
1668591954420,COGS 210B,004,101423,Hollan; James D.,9998,0,9999,1
1668591954420,COGS 210B,005,101424,Deak; Gedeon O.,9998,0,9999,1
1668591954420,COGS 210B,006,101425,Rossano; Federico,9999,0,9999,0
1668591954852,COGS 211B,A00,101427,Coulson; Seana M,9996,0,9999,3
1668591955279,COGS 220,A00,101428,Hollan; James D.,0,17,25,25
1668591955705,COGS 229,A00,101429,Dow; Steven P,17,0,25,8
1668591956130,COGS 230,A00,101430,Klemmer; Scott R,6,0,17,11
1668591956554,COGS 234,A00,101431,Xia; Haijun,0,1,25,25
1668591956979,COGS 260,A00,101432,Kiyonaga; Anastasia,21,0,25,4
1668591956979,COGS 260,B00,101433,Kirsh; David Joel,15,0,25,10
1668591957405,CSE 202,A00,102371,Impagliazzo; Russell,0,70,0,0
1668591957837,CSE 203B,A01,102373,Cheng; Chung Kuan,0,70,0,0
1668591958260,CSE 208,A00,102374,Micciancio; Daniele,0,5,0,0
1668591958689,CSE 209A,A00,112895,Impagliazzo; Russell,0,14,15,15
1668591959118,CSE 209B,A00,108005,Bellare; Mihir,0,7,0,0
1668591959550,CSE 210,A00,113163,Coblenz; Michael J,0,96,0,0
1668591959975,CSE 219,A00,106111,Dow; Steven P,0,8,20,20
1668591960402,CSE 221,A00,102376,Voelker; Geoffrey M.,0,78,0,0
1668591960833,CSE 224,A01,102378,Porter; George M,0,181,0,0
1668591961261,CSE 229A,A00,102379,Savage; Stefan,0,14,0,0
1668591961688,CSE 229C,A00,102380,Munyaka; Imani N. S.,0,12,0,0
1668591962119,CSE 232B,A00,102382,Deutsch; Alin Bernard,0,40,0,0
1668591962544,CSE 234,A01,112904,Kumar; Arun Kumar,0,0,0,0
1668591962983,CSE 237A,A00,102383,Rosing; Tajana Simunic,0,57,0,0
1668591963422,CSE 239A,A00,102384,Deutsch; Alin Bernard,0,18,0,0
1668591963874,CSE 239B,A00,102385,Polikarpova; Nadezhda,0,11,0,0
1668591964306,CSE 240A,A00,102386,Pannuto; Patrick William,0,49,0,0
1668591964743,CSE 240B,A00,102387,Zhao; Jishen,0,51,0,0
1668591965179,CSE 241A,A00,106406,Kang; Mingu,0,9,0,0
1668591965602,CSE 249B,A00,102388,Kahng; Andrew Byun,0,7,8,8
1668591966026,CSE 251B,A01,102392,Cottrell; Garrison W,0,54,0,0
1668591966026,CSE 251B,A02,102393,Cottrell; Garrison W,0,36,0,0
1668591966455,CSE 252B,A00,102394,Ochoa; Benjamin Lawrence,0,64,0,0
1668591966884,CSE 257,A01,102396,Gao; Sicun,0,160,0,0
1668591967313,CSE 272,A00,102397,Li; Tzumao,0,22,0,0
1668591967741,CSE 274,A00,111323,Chern; Albert Ren-Haur,0,16,0,0
1668591968180,CSE 282,A00,102398,Pevzner; Pavel Arkadjevich,0,0,0,0
1668591968607,CSE 284,A00,114175,Gymrek; Melissa Ann,0,33,0,0
1668591969035,CSE 290,A00,102399,Chandraker; Manmohan Krishna,0,11,0,0
1668591969035,CSE 290,B00,102400,Vaccaro; Kristen Marie,0,10,25,25
1668591969035,CSE 290,C00,102414,Pannuto; Patrick William,0,1,25,25
1668591969035,CSE 290,D00,102427,Pevzner; Pavel Arkadjevich,0,0,0,0
1668591969035,CSE 290,E00,102429,Zhao; Jishen,0,6,0,0
1668591969035,CSE 290,F00,102436,Tullsen; Dean Michael,0,6,0,0
1668591969035,CSE 290,G00,102440,Christensen; Henrik I,0,8,20,20
1668591969469,CSE 291,A00,102443,Su; Hao,0,0,0,0
1668591969469,CSE 291,B00,102448,Polikarpova; Nadezhda,0,0,0,0
1668591969469,CSE 291,C00,102453,Vaccaro; Kristen Marie,0,0,0,0
1668591969469,CSE 291,D00,111343,Savage; Stefan,0,0,0,0
1668591969469,CSE 291,E00,116474,Claffy; Kimberly Claire,0,0,0,0
1668591969469,CSE 291,F00,116479,Pasquale; Joseph,0,0,0,0
1668591969930,CSE 293,001,119111,Bafna; Vineet,9999,0,9999,0
1668591969930,CSE 293,002,119118,Bellare; Mihir,9999,0,9999,0
1668591969930,CSE 293,003,119122,Berg-Kirkpatrick; Taylor D,9999,0,9999,0
1668591969930,CSE 293,004,119135,Christensen; Henrik I,9999,0,9999,0
1668591969930,CSE 293,005,119142,Cottrell; Garrison W,9999,0,9999,0
1668591969930,CSE 293,006,119146,Deutsch; Alin Bernard,9999,0,9999,0
1668591969930,CSE 293,007,119159,Esmaeilzadeh; Hadi,9999,0,9999,0
1668591969930,CSE 293,008,119166,Freund; Yoav,9999,0,9999,0
1668591969930,CSE 293,009,119170,Griswold; William G.,9999,0,9999,0
1668591969930,CSE 293,010,119183,Gymrek; Melissa Ann,9999,0,9999,0
1668591969930,CSE 293,011,119190,Heninger; Nadia A,9999,0,9999,0
1668591969930,CSE 293,012,119230,Impagliazzo; Russell,9999,0,9999,0
1668591969930,CSE 293,013,119232,Jhala; Ranjit,9999,0,9999,0
1668591969930,CSE 293,014,119233,Kahng; Andrew Byun,9999,0,9999,0
1668591969930,CSE 293,015,119298,Kane; Daniel Mertz,9999,0,9999,0
1668591969930,CSE 293,016,119299,Kriegman; David J,9999,0,9999,0
1668591969930,CSE 293,017,119300,Kumar; Arun Kumar,9999,0,9999,0
1668591969930,CSE 293,018,119301,Lerner; Sorin,9999,0,9999,0
1668591969930,CSE 293,019,119302,Lovett; Shachar,9999,0,9999,0
1668591969930,CSE 293,020,119303,McAuley; Julian John,9999,0,9999,0
1668591969930,CSE 293,021,119304,Micciancio; Daniele,9999,0,9999,0
1668591969930,CSE 293,022,119367,Orailoglu; Alex,9999,0,9999,0
1668591969930,CSE 293,023,119382,Paturi; Ramamohan,9999,0,9999,0
1668591969930,CSE 293,024,119404,Polikarpova; Nadezhda,9999,0,9999,0
1668591969930,CSE 293,025,119406,Politz; Joseph Gibbs,9999,0,9999,0
1668591969930,CSE 293,026,119411,Porter; George M,9999,0,9999,0
1668591969930,CSE 293,027,119414,Porter; Leonard Emerson,9999,0,9999,0
1668591969930,CSE 293,028,119416,Ramamoorthi; Ravi,9999,0,9999,0
1668591969930,CSE 293,029,119417,Sahoo; Debashis,9999,0,9999,0
1668591969930,CSE 293,030,119420,Saul; Lawrence,9999,0,9999,0
1668591969930,CSE 293,031,119421,Savage; Stefan,9999,0,9999,0
1668591969930,CSE 293,032,119425,Schulze; Jurgen P.,9999,0,9999,0
1668591969930,CSE 293,033,119426,Snoeren; Alex C.,9999,0,9999,0
1668591969930,CSE 293,034,119428,Shang; Jingbo,9999,0,9999,0
1668591969930,CSE 293,035,119430,Stefan; Deian,9999,0,9999,0
1668591969930,CSE 293,036,119431,Su; Hao,9999,0,9999,0
1668591969930,CSE 293,037,119433,Swanson; Steven James,9999,0,9999,0
1668591969930,CSE 293,038,119435,Tullsen; Dean Michael,9999,0,9999,0
1668591969930,CSE 293,039,119483,Voelker; Geoffrey M.,9999,0,9999,0
1668591969930,CSE 293,040,119537,Zhao; Jishen,9999,0,9999,0
1668591969930,CSE 293,041,119538,Zhou; Yuan-Yuan,9999,0,9999,0
1668591969930,CSE 293,042,119539,Gao; Sicun,9999,0,9999,0
1668591969930,CSE 293,043,119540,Weibel; Nadir,9999,0,9999,0
1668591969930,CSE 293,044,119541,Gupta; Rajesh K.,9999,0,9999,0
1668591969930,CSE 293,045,126410,Vaccaro; Kristen Marie,9999,0,9999,0
1668591969930,CSE 293,046,126411,Klemke; Richard,9999,0,9999,0
1668591970366,CSE 294,A00,102459,Voelker; Geoffrey M.,0,2,0,0
1668591970366,CSE 294,B00,111322,Orailoglu; Alex,0,2,0,0
1668591970791,DSE 201,A00,096914,Deutsch; Alin Bernard,30,0,30,0
1668591971227,DSE 210,A00,096915,Dasgupta; Sanjoy,30,0,30,0
1668591971695,DSE 241,A00,144528,Smith; Neil Gordon,30,0,30,0
1668591972120,DSE 260A,A00,096916,Altintas De Callaf; Ilkay,30,0,30,0
1668591972604,ECE 200,001,103586,Antipa; Nicholas A,9999,0,9999,0
1668591972604,ECE 200,002,103587,Atanasov; Nikolay A.,9999,0,9999,0
1668591972604,ECE 200,003,103588,Bharadia; Dinesh,9999,0,9999,0
1668591972604,ECE 200,004,103589,Cheng; Chung Kuan,9999,0,9999,0
1668591972604,ECE 200,005,103590,Cosman; Pamela C.,9999,0,9999,0
1668591972604,ECE 200,006,103591,Dayeh; Shadi Ahmad,9999,0,9999,0
1668591972604,ECE 200,007,103592,Fainman; Yeshaiahu,9999,0,9999,0
1668591972604,ECE 200,008,103593,Ford; Joseph Earl,9999,0,9999,0
1668591972604,ECE 200,009,103594,Franceschetti; Massimo,9999,0,9999,0
1668591972604,ECE 200,010,103595,Fullerton; Eric E,9999,0,9999,0
1668591972604,ECE 200,011,103596,Galton; Ian A,9999,0,9999,0
1668591972604,ECE 200,012,103597,Gilja; Vikash,9999,0,9999,0
1668591972604,ECE 200,013,103598,Hall; Drew A.,9999,0,9999,0
1668591972604,ECE 200,014,103599,Hsueh; Tzu-Chien,9999,0,9999,0
1668591972604,ECE 200,015,103600,Javidi; Tara,9999,0,9999,0
1668591972604,ECE 200,016,103601,Kahng; Andrew Byun,9999,0,9999,0
1668591972604,ECE 200,017,103602,Kim; Young-Han,9999,0,9999,0
1668591972604,ECE 200,018,103603,Koushanfar; Farinaz,9999,0,9999,0
1668591972604,ECE 200,019,103604,Kuzum; Duygu,9999,0,9999,0
1668591972604,ECE 200,020,103605,Le; Hanh-Phuc,9999,0,9999,0
1668591972604,ECE 200,021,103606,Lin; Bill,9999,0,9999,0
1668591972604,ECE 200,022,103607,Liu; Zhaowei,9998,0,9999,1
1668591972604,ECE 200,023,103608,Lo; Yu-Hwa,9999,0,9999,0
1668591972604,ECE 200,024,103609,Lomakin; Vitaliy,9999,0,9999,0
1668591972604,ECE 200,025,103610,Mercier; Patrick Philip,9999,0,9999,0
1668591972604,ECE 200,026,103611,Meyer; Florian,9999,0,9999,0
1668591972604,ECE 200,027,103612,Milstein; Laurence B.,9999,0,9999,0
1668591972604,ECE 200,028,103613,Mir Arabbaygi; Siavash,9999,0,9999,0
1668591972604,ECE 200,029,103614,Mookherjea; Shayan,9999,0,9999,0
1668591972604,ECE 200,030,103615,Morris; Karcher William,9999,0,9999,0
1668591972604,ECE 200,031,103616,Ng; Tse Nga,9999,0,9999,0
1668591972604,ECE 200,032,103617,Nguyen; Truong Quang,9999,0,9999,0
1668591972604,ECE 200,033,103618,Nomura; Kenji,9999,0,9999,0
1668591972604,ECE 200,034,103619,Orlitsky; Alon,9999,0,9999,0
1668591972604,ECE 200,035,103620,Pal; Piya,9999,0,9999,0
1668591972604,ECE 200,036,103621,Papen; George C.,9999,0,9999,0
1668591972604,ECE 200,037,103622,Radic; Stojan,9999,0,9999,0
1668591972604,ECE 200,038,103623,Rao; Bhaskar D.,9999,0,9999,0
1668591972604,ECE 200,039,103624,Rao; Ramesh R,9999,0,9999,0
1668591972604,ECE 200,040,103625,Rebeiz; Gabriel,9999,0,9999,0
1668591972604,ECE 200,041,103626,Sanford; John R,9999,0,9999,0
1668591972604,ECE 200,042,103627,Siegel; Paul H.,9999,0,9999,0
1668591972604,ECE 200,043,103628,Sievenpiper; Daniel F.,9999,0,9999,0
1668591972604,ECE 200,044,103629,Sworder; David D.,9999,0,9999,0
1668591972604,ECE 200,045,103630,Taur; Yuan,9999,0,9999,0
1668591972604,ECE 200,046,103631,Touri; Behrouz,9999,0,9999,0
1668591972604,ECE 200,047,103632,Trivedi; Mohan M.,9999,0,9999,0
1668591972604,ECE 200,048,103633,Vasconcelos; Nuno,9999,0,9999,0
1668591972604,ECE 200,049,103634,Wang; Xiaolong,9999,0,9999,0
1668591972604,ECE 200,050,103635,Xie; Pengtao,9999,0,9999,0
1668591972604,ECE 200,051,103636,Yip; Michael,9999,0,9999,0
1668591972604,ECE 200,052,103637,Zeger; Kenneth A.,999,0,999,0
1668591972604,ECE 200,053,103638,Zhang; Xinyu,9999,0,9999,0
1668591972604,ECE 200,054,103639,Turakhia; Yatish Girish,9999,0,9999,0
1668591972604,ECE 200,055,103640,Kang; Mingu,9999,0,9999,0
1668591972604,ECE 200,056,103641,Shi; Yuanyuan,9999,0,9999,0
1668591972604,ECE 200,057,103642,Wang; Edward Jay,9999,0,9999,0
1668591972604,ECE 200,058,103643,Zheng; Yang,9999,0,9999,0
1668591973036,ECE 202,A00,103644,Kuzum; Duygu,0,47,0,0
1668591973461,ECE 212BN,A00,103646,Ng; Tse Nga,0,10,0,0
1668591973899,ECE 221,A00,111493,Staff,0,0,0,0
1668591974337,ECE 222B,A00,103647,Lomakin; Vitaliy,0,22,0,0
1668591974760,ECE 230B,A00,103648,Taur; Yuan,0,4,0,0
1668591975185,ECE 238B,A00,103649,Garay; Javier,0,0,0,0
1668591975613,ECE 240B,A00,112900,Fainman; Yeshaiahu,0,8,0,0
1668591976037,ECE 247A,A00,103650,Jokerst; Jesse Vincent,0,6,0,0
1668591976461,ECE 247B,A00,103651,Wang; Joseph,0,14,0,0
1668591976895,ECE 250,A00,103652,Siegel; Paul H.,0,85,0,0
1668591977324,ECE 251A,A00,103654,Rao; Bhaskar D.,0,65,0,0
1668591977746,ECE 257B,A00,103655,Bharadia; Dinesh,0,33,0,0
1668591978172,ECE 258A,A00,103656,Milstein; Laurence B.,0,29,0,0
1668591978599,ECE 260B,A00,103658,Kang; Mingu,0,121,0,0
1668591979027,ECE 264A,A00,103659,Galton; Ian A,0,42,0,34
1668591979452,ECE 265A,A00,103661,Gudem; Prasad S.S.,0,41,0,37
1668591979880,ECE 265D,A00,103662,Gudem; Prasad S.S.,0,27,0,0
1668591980301,ECE 268,A00,103663,Koushanfar; Farinaz,0,44,0,0
1668591980728,ECE 269,A01,103665,Pal; Piya,0,223,0,0
1668591981154,ECE 271B,A00,103666,Vasconcelos; Manuela,0,80,0,0
1668591981581,ECE 276A,A00,103667,Atanasov; Nikolay A.,0,127,0,0
1668591982009,ECE 277,A00,103668,An; Cheolhong,0,151,0,0
1668591982437,ECE 279,A00,117947,Hall; Drew A.,0,22,0,0
1668591983288,ECE 283,A00,103670,Hsueh; Tzu-Chien,0,57,0,0
1668591983711,ECE 284,A00,103671,Turakhia; Yatish Girish,0,40,0,0
1668591984151,ECE 285,A00,103672,Zheng; Yang,0,40,0,0
1668591984151,ECE 285,B00,103673,Sworder; David D.,0,61,0,0
1668591984574,ECE 287,A00,103676,Javidi; Tara,0,7,0,0
1668591985007,MATH 200B,A00,098023,Salehi Golsefidy; Alireza,7,0,15,8
1668591985434,MATH 202B,A00,098024,Rhoades; Brendon Patrick,7,0,15,8
1668591985859,MATH 203B,A00,098025,Oprea; Dragos N.,9,0,15,6
1668591986282,MATH 204B,A00,098026,Sorensen; Claus M,13,0,15,2
1668591986703,MATH 208,A00,098027,Izadi; Elham,7,0,10,3
1668591987141,MATH 209,A00,098028,Pollack; Aaron,10,0,10,0
1668591987576,MATH 211A,A00,112919,Rogalski; Daniel,8,0,10,2
1668591988002,MATH 211B,A00,112920,Seward; Brandon M.,9,0,10,1
1668591988427,MATH 218,A00,098029,Li; Bo,10,0,10,0
1668591988854,MATH 220B,A00,098030,Novak; Jonathan I,10,0,15,5
1668591989285,MATH 221A,A00,098031,Ebenfelt; Peter F,12,0,15,3
1668591989711,MATH 231B,A00,098032,Zlatos; Andrej,9,0,15,6
1668591990147,MATH 240B,A00,098033,Ni; Lei,7,0,15,8
1668591990574,MATH 243,A00,098034,Jekel; David Andrew,10,0,10,0
1668591991001,MATH 245A,A00,098035,Nie; Jiawang,0,8,15,18
1668591991426,MATH 248,A00,098036,Bejenaru; Ioan,10,0,10,0
1668591991849,MATH 250B,A00,098037,Spolaor; Luca,12,0,15,3
1668591992289,MATH 258,A00,098038,Ni; Lei,8,0,10,2
1668591992715,MATH 264B,A00,098041,Rhoades; Brendon Patrick,6,0,15,9
1668591993153,MATH 268,A00,098042,Buss; Samuel R,10,0,10,0
1668591993589,MATH 269,A00,098043,Rhoades; Brendon Patrick,10,0,10,0
1668591994039,MATH 270B,A00,098044,Li; Bo,6,0,15,9
1668591994470,MATH 272B,A00,098045,Holst; Michael J,13,0,15,2
1668591994895,MATH 273A,A00,098046,Tian; Xiaochuan,10,0,15,5
1668591995330,MATH 275,A01,098048,Tian; Xiaochuan,6,0,10,4
1668591995762,MATH 278A,A00,098049,Holst; Michael J,6,0,10,4
1668591996285,MATH 278B,A00,098050,Cloninger; Alexander,10,0,10,0
1668591996711,MATH 278C,A00,098051,Nie; Jiawang,5,0,10,5
1668591997139,MATH 280B,A00,098052,Zheng; Tianyi,6,0,15,9
1668591997565,MATH 281B,A00,098053,Bradic; Jelena,0,2,15,15
1668591997989,MATH 282B,A00,098054,Arias-Castro; Ery,0,1,15,15
1668591998415,MATH 285,A00,098055,Fitzsimmons; Patrick J,0,4,15,16
1668591998840,MATH 287B,A00,098056,Arias-Castro; Ery,1,0,15,14
1668591999268,MATH 288,A00,098057,Agarwal; Pooja,9,0,10,1
1668591999268,MATH 288,B00,098058,Zhang; Danna,8,0,10,2
1668591999268,MATH 288,C00,098059,Williams; Ruth J,9,0,10,1
1668591999691,MATH 290B,A00,098060,Roberts; Justin Deritter,12,0,15,3
1668592000116,MATH 292,A00,098061,Belmont; Eva Kinoshita,10,0,10,0
1668592000540,MATH 295,A00,098062,Suk; Andrew Hoon,47,0,50,3
1668592000966,MATH 296,A00,098063,Novak; Jonathan I,20,0,20,0
1668592001394,MATH 297,001,098064,Gamst; Anthony Collins,9997,0,9999,2
1668592505349,COGS 205,A00,101395,Chiba; Andrea,19,0,20,1
1668592505786,COGS 210B,001,101404,Greene; Deanna Jacquelyn,9998,0,9999,1
1668592505786,COGS 210B,002,101417,Xia; Haijun,9999,0,9999,0
1668592505786,COGS 210B,003,101422,Nitz; Douglas A.,9999,0,9999,0
1668592505786,COGS 210B,004,101423,Hollan; James D.,9998,0,9999,1
1668592505786,COGS 210B,005,101424,Deak; Gedeon O.,9998,0,9999,1
1668592505786,COGS 210B,006,101425,Rossano; Federico,9999,0,9999,0
1668592506209,COGS 211B,A00,101427,Coulson; Seana M,9996,0,9999,3
1668592506635,COGS 220,A00,101428,Hollan; James D.,0,17,25,25
1668592507064,COGS 229,A00,101429,Dow; Steven P,17,0,25,8
1668592507499,COGS 230,A00,101430,Klemmer; Scott R,6,0,17,11
1668592507923,COGS 234,A00,101431,Xia; Haijun,0,1,25,25
1668592508351,COGS 260,A00,101432,Kiyonaga; Anastasia,21,0,25,4
1668592508351,COGS 260,B00,101433,Kirsh; David Joel,15,0,25,10
1668592508775,CSE 202,A00,102371,Impagliazzo; Russell,0,70,0,0
1668592509206,CSE 203B,A01,102373,Cheng; Chung Kuan,0,70,0,0
1668592509633,CSE 208,A00,102374,Micciancio; Daniele,0,5,0,0
1668592510063,CSE 209A,A00,112895,Impagliazzo; Russell,0,14,15,15
1668592510487,CSE 209B,A00,108005,Bellare; Mihir,0,7,0,0
1668592510916,CSE 210,A00,113163,Coblenz; Michael J,0,96,0,0
1668592511342,CSE 219,A00,106111,Dow; Steven P,0,8,20,20
1668592511766,CSE 221,A00,102376,Voelker; Geoffrey M.,0,78,0,0
1668592512190,CSE 224,A01,102378,Porter; George M,0,181,0,0
1668592512632,CSE 229A,A00,102379,Savage; Stefan,0,14,0,0
1668592513059,CSE 229C,A00,102380,Munyaka; Imani N. S.,0,12,0,0
1668592513485,CSE 232B,A00,102382,Deutsch; Alin Bernard,0,40,0,0
1668592513915,CSE 234,A01,112904,Kumar; Arun Kumar,0,0,0,0
1668592514340,CSE 237A,A00,102383,Rosing; Tajana Simunic,0,57,0,0
1668592514764,CSE 239A,A00,102384,Deutsch; Alin Bernard,0,18,0,0
1668592515190,CSE 239B,A00,102385,Polikarpova; Nadezhda,0,11,0,0
1668592515616,CSE 240A,A00,102386,Pannuto; Patrick William,0,49,0,0
1668592516044,CSE 240B,A00,102387,Zhao; Jishen,0,51,0,0
1668592516470,CSE 241A,A00,106406,Kang; Mingu,0,9,0,0
1668592516903,CSE 249B,A00,102388,Kahng; Andrew Byun,0,7,8,8
1668592517332,CSE 251B,A01,102392,Cottrell; Garrison W,0,54,0,0
1668592517332,CSE 251B,A02,102393,Cottrell; Garrison W,0,36,0,0
1668592517759,CSE 252B,A00,102394,Ochoa; Benjamin Lawrence,0,64,0,0
1668592518188,CSE 257,A01,102396,Gao; Sicun,0,160,0,0
1668592518692,CSE 272,A00,102397,Li; Tzumao,0,22,0,0
1668592519115,CSE 274,A00,111323,Chern; Albert Ren-Haur,0,16,0,0
1668592519544,CSE 282,A00,102398,Pevzner; Pavel Arkadjevich,0,0,0,0
1668592519967,CSE 284,A00,114175,Gymrek; Melissa Ann,0,33,0,0
1668592520405,CSE 290,A00,102399,Chandraker; Manmohan Krishna,0,11,0,0
1668592520405,CSE 290,B00,102400,Vaccaro; Kristen Marie,0,10,25,25
1668592520405,CSE 290,C00,102414,Pannuto; Patrick William,0,1,25,25
1668592520405,CSE 290,D00,102427,Pevzner; Pavel Arkadjevich,0,0,0,0
1668592520405,CSE 290,E00,102429,Zhao; Jishen,0,6,0,0
1668592520405,CSE 290,F00,102436,Tullsen; Dean Michael,0,6,0,0
1668592520405,CSE 290,G00,102440,Christensen; Henrik I,0,8,20,20
1668592520838,CSE 291,A00,102443,Su; Hao,0,0,0,0
1668592520838,CSE 291,B00,102448,Polikarpova; Nadezhda,0,0,0,0
1668592520838,CSE 291,C00,102453,Vaccaro; Kristen Marie,0,0,0,0
1668592520838,CSE 291,D00,111343,Savage; Stefan,0,0,0,0
1668592520838,CSE 291,E00,116474,Claffy; Kimberly Claire,0,0,0,0
1668592520838,CSE 291,F00,116479,Pasquale; Joseph,0,0,0,0
1668592521314,CSE 293,001,119111,Bafna; Vineet,9999,0,9999,0
1668592521314,CSE 293,002,119118,Bellare; Mihir,9999,0,9999,0
1668592521314,CSE 293,003,119122,Berg-Kirkpatrick; Taylor D,9999,0,9999,0
1668592521314,CSE 293,004,119135,Christensen; Henrik I,9999,0,9999,0
1668592521314,CSE 293,005,119142,Cottrell; Garrison W,9999,0,9999,0
1668592521314,CSE 293,006,119146,Deutsch; Alin Bernard,9999,0,9999,0
1668592521314,CSE 293,007,119159,Esmaeilzadeh; Hadi,9999,0,9999,0
1668592521314,CSE 293,008,119166,Freund; Yoav,9999,0,9999,0
1668592521314,CSE 293,009,119170,Griswold; William G.,9999,0,9999,0
1668592521314,CSE 293,010,119183,Gymrek; Melissa Ann,9999,0,9999,0
1668592521314,CSE 293,011,119190,Heninger; Nadia A,9999,0,9999,0
1668592521314,CSE 293,012,119230,Impagliazzo; Russell,9999,0,9999,0
1668592521314,CSE 293,013,119232,Jhala; Ranjit,9999,0,9999,0
1668592521314,CSE 293,014,119233,Kahng; Andrew Byun,9999,0,9999,0
1668592521314,CSE 293,015,119298,Kane; Daniel Mertz,9999,0,9999,0
1668592521314,CSE 293,016,119299,Kriegman; David J,9999,0,9999,0
1668592521314,CSE 293,017,119300,Kumar; Arun Kumar,9999,0,9999,0
1668592521314,CSE 293,018,119301,Lerner; Sorin,9999,0,9999,0
1668592521314,CSE 293,019,119302,Lovett; Shachar,9999,0,9999,0
1668592521314,CSE 293,020,119303,McAuley; Julian John,9999,0,9999,0
1668592521314,CSE 293,021,119304,Micciancio; Daniele,9999,0,9999,0
1668592521314,CSE 293,022,119367,Orailoglu; Alex,9999,0,9999,0
1668592521314,CSE 293,023,119382,Paturi; Ramamohan,9999,0,9999,0
1668592521314,CSE 293,024,119404,Polikarpova; Nadezhda,9999,0,9999,0
1668592521314,CSE 293,025,119406,Politz; Joseph Gibbs,9999,0,9999,0
1668592521314,CSE 293,026,119411,Porter; George M,9999,0,9999,0
1668592521314,CSE 293,027,119414,Porter; Leonard Emerson,9999,0,9999,0
1668592521314,CSE 293,028,119416,Ramamoorthi; Ravi,9999,0,9999,0
1668592521314,CSE 293,029,119417,Sahoo; Debashis,9999,0,9999,0
1668592521314,CSE 293,030,119420,Saul; Lawrence,9999,0,9999,0
1668592521314,CSE 293,031,119421,Savage; Stefan,9999,0,9999,0
1668592521314,CSE 293,032,119425,Schulze; Jurgen P.,9999,0,9999,0
1668592521314,CSE 293,033,119426,Snoeren; Alex C.,9999,0,9999,0
1668592521314,CSE 293,034,119428,Shang; Jingbo,9999,0,9999,0
1668592521314,CSE 293,035,119430,Stefan; Deian,9999,0,9999,0
1668592521314,CSE 293,036,119431,Su; Hao,9999,0,9999,0
1668592521314,CSE 293,037,119433,Swanson; Steven James,9999,0,9999,0
1668592521314,CSE 293,038,119435,Tullsen; Dean Michael,9999,0,9999,0
1668592521314,CSE 293,039,119483,Voelker; Geoffrey M.,9999,0,9999,0
1668592521314,CSE 293,040,119537,Zhao; Jishen,9999,0,9999,0
1668592521314,CSE 293,041,119538,Zhou; Yuan-Yuan,9999,0,9999,0
1668592521314,CSE 293,042,119539,Gao; Sicun,9999,0,9999,0
1668592521314,CSE 293,043,119540,Weibel; Nadir,9999,0,9999,0
1668592521314,CSE 293,044,119541,Gupta; Rajesh K.,9999,0,9999,0
1668592521314,CSE 293,045,126410,Vaccaro; Kristen Marie,9999,0,9999,0
1668592521314,CSE 293,046,126411,Klemke; Richard,9999,0,9999,0
1668592521744,CSE 294,A00,102459,Voelker; Geoffrey M.,0,2,0,0
1668592521744,CSE 294,B00,111322,Orailoglu; Alex,0,2,0,0
1668592522180,DSE 201,A00,096914,Deutsch; Alin Bernard,30,0,30,0
1668592522609,DSE 210,A00,096915,Dasgupta; Sanjoy,30,0,30,0
1668592523039,DSE 241,A00,144528,Smith; Neil Gordon,30,0,30,0
1668592523465,DSE 260A,A00,096916,Altintas De Callaf; Ilkay,30,0,30,0
1668592523946,ECE 200,001,103586,Antipa; Nicholas A,9999,0,9999,0
1668592523946,ECE 200,002,103587,Atanasov; Nikolay A.,9999,0,9999,0
1668592523946,ECE 200,003,103588,Bharadia; Dinesh,9999,0,9999,0
1668592523946,ECE 200,004,103589,Cheng; Chung Kuan,9999,0,9999,0
1668592523946,ECE 200,005,103590,Cosman; Pamela C.,9999,0,9999,0
1668592523946,ECE 200,006,103591,Dayeh; Shadi Ahmad,9999,0,9999,0
1668592523946,ECE 200,007,103592,Fainman; Yeshaiahu,9999,0,9999,0
1668592523946,ECE 200,008,103593,Ford; Joseph Earl,9999,0,9999,0
1668592523946,ECE 200,009,103594,Franceschetti; Massimo,9999,0,9999,0
1668592523946,ECE 200,010,103595,Fullerton; Eric E,9999,0,9999,0
1668592523946,ECE 200,011,103596,Galton; Ian A,9999,0,9999,0
1668592523946,ECE 200,012,103597,Gilja; Vikash,9999,0,9999,0
1668592523946,ECE 200,013,103598,Hall; Drew A.,9999,0,9999,0
1668592523946,ECE 200,014,103599,Hsueh; Tzu-Chien,9999,0,9999,0
1668592523946,ECE 200,015,103600,Javidi; Tara,9999,0,9999,0
1668592523946,ECE 200,016,103601,Kahng; Andrew Byun,9999,0,9999,0
1668592523946,ECE 200,017,103602,Kim; Young-Han,9999,0,9999,0
1668592523946,ECE 200,018,103603,Koushanfar; Farinaz,9999,0,9999,0
1668592523946,ECE 200,019,103604,Kuzum; Duygu,9999,0,9999,0
1668592523946,ECE 200,020,103605,Le; Hanh-Phuc,9999,0,9999,0
1668592523946,ECE 200,021,103606,Lin; Bill,9999,0,9999,0
1668592523946,ECE 200,022,103607,Liu; Zhaowei,9998,0,9999,1
1668592523946,ECE 200,023,103608,Lo; Yu-Hwa,9999,0,9999,0
1668592523946,ECE 200,024,103609,Lomakin; Vitaliy,9999,0,9999,0
1668592523946,ECE 200,025,103610,Mercier; Patrick Philip,9999,0,9999,0
1668592523946,ECE 200,026,103611,Meyer; Florian,9999,0,9999,0
1668592523946,ECE 200,027,103612,Milstein; Laurence B.,9999,0,9999,0
1668592523946,ECE 200,028,103613,Mir Arabbaygi; Siavash,9999,0,9999,0
1668592523946,ECE 200,029,103614,Mookherjea; Shayan,9999,0,9999,0
1668592523946,ECE 200,030,103615,Morris; Karcher William,9999,0,9999,0
1668592523946,ECE 200,031,103616,Ng; Tse Nga,9999,0,9999,0
1668592523946,ECE 200,032,103617,Nguyen; Truong Quang,9999,0,9999,0
1668592523946,ECE 200,033,103618,Nomura; Kenji,9999,0,9999,0
1668592523946,ECE 200,034,103619,Orlitsky; Alon,9999,0,9999,0
1668592523946,ECE 200,035,103620,Pal; Piya,9999,0,9999,0
1668592523946,ECE 200,036,103621,Papen; George C.,9999,0,9999,0
1668592523946,ECE 200,037,103622,Radic; Stojan,9999,0,9999,0
1668592523946,ECE 200,038,103623,Rao; Bhaskar D.,9999,0,9999,0
1668592523946,ECE 200,039,103624,Rao; Ramesh R,9999,0,9999,0
1668592523946,ECE 200,040,103625,Rebeiz; Gabriel,9999,0,9999,0
1668592523946,ECE 200,041,103626,Sanford; John R,9999,0,9999,0
1668592523946,ECE 200,042,103627,Siegel; Paul H.,9999,0,9999,0
1668592523946,ECE 200,043,103628,Sievenpiper; Daniel F.,9999,0,9999,0
1668592523946,ECE 200,044,103629,Sworder; David D.,9999,0,9999,0
1668592523946,ECE 200,045,103630,Taur; Yuan,9999,0,9999,0
1668592523946,ECE 200,046,103631,Touri; Behrouz,9999,0,9999,0
1668592523946,ECE 200,047,103632,Trivedi; Mohan M.,9999,0,9999,0
1668592523946,ECE 200,048,103633,Vasconcelos; Nuno,9999,0,9999,0
1668592523946,ECE 200,049,103634,Wang; Xiaolong,9999,0,9999,0
1668592523946,ECE 200,050,103635,Xie; Pengtao,9999,0,9999,0
1668592523946,ECE 200,051,103636,Yip; Michael,9999,0,9999,0
1668592523946,ECE 200,052,103637,Zeger; Kenneth A.,999,0,999,0
1668592523946,ECE 200,053,103638,Zhang; Xinyu,9999,0,9999,0
1668592523946,ECE 200,054,103639,Turakhia; Yatish Girish,9999,0,9999,0
1668592523946,ECE 200,055,103640,Kang; Mingu,9999,0,9999,0
1668592523946,ECE 200,056,103641,Shi; Yuanyuan,9999,0,9999,0
1668592523946,ECE 200,057,103642,Wang; Edward Jay,9999,0,9999,0
1668592523946,ECE 200,058,103643,Zheng; Yang,9999,0,9999,0
1668592524374,ECE 202,A00,103644,Kuzum; Duygu,0,47,0,0
1668592524797,ECE 212BN,A00,103646,Ng; Tse Nga,0,10,0,0
1668592525223,ECE 221,A00,111493,Staff,0,0,0,0
1668592525651,ECE 222B,A00,103647,Lomakin; Vitaliy,0,22,0,0
1668592526078,ECE 230B,A00,103648,Taur; Yuan,0,4,0,0
1668592526502,ECE 238B,A00,103649,Garay; Javier,0,0,0,0
1668592526925,ECE 240B,A00,112900,Fainman; Yeshaiahu,0,8,0,0
1668592527351,ECE 247A,A00,103650,Jokerst; Jesse Vincent,0,6,0,0
1668592527777,ECE 247B,A00,103651,Wang; Joseph,0,14,0,0
1668592528206,ECE 250,A00,103652,Siegel; Paul H.,0,85,0,0
1668592528631,ECE 251A,A00,103654,Rao; Bhaskar D.,0,65,0,0
1668592529057,ECE 257B,A00,103655,Bharadia; Dinesh,0,33,0,0
1668592529482,ECE 258A,A00,103656,Milstein; Laurence B.,0,29,0,0
1668592529909,ECE 260B,A00,103658,Kang; Mingu,0,121,0,0
1668592530335,ECE 264A,A00,103659,Galton; Ian A,0,42,0,34
1668592530758,ECE 265A,A00,103661,Gudem; Prasad S.S.,0,41,0,37
1668592531183,ECE 265D,A00,103662,Gudem; Prasad S.S.,0,27,0,0
1668592531606,ECE 268,A00,103663,Koushanfar; Farinaz,0,44,0,0
1668592532035,ECE 269,A01,103665,Pal; Piya,0,223,0,0
1668592532467,ECE 271B,A00,103666,Vasconcelos; Manuela,0,80,0,0
1668592532890,ECE 276A,A00,103667,Atanasov; Nikolay A.,0,127,0,0
1668592533330,ECE 277,A00,103668,An; Cheolhong,0,151,0,0
1668592533756,ECE 279,A00,117947,Hall; Drew A.,0,22,0,0
1668592534619,ECE 283,A00,103670,Hsueh; Tzu-Chien,0,57,0,0
1668592535044,ECE 284,A00,103671,Turakhia; Yatish Girish,0,40,0,0
1668592535470,ECE 285,A00,103672,Zheng; Yang,0,40,0,0
1668592535470,ECE 285,B00,103673,Sworder; David D.,0,61,0,0
1668592535892,ECE 287,A00,103676,Javidi; Tara,0,7,0,0
1668592536318,MATH 200B,A00,098023,Salehi Golsefidy; Alireza,7,0,15,8
1668592536743,MATH 202B,A00,098024,Rhoades; Brendon Patrick,7,0,15,8
1668592537182,MATH 203B,A00,098025,Oprea; Dragos N.,9,0,15,6
1668592537607,MATH 204B,A00,098026,Sorensen; Claus M,13,0,15,2
1668592538036,MATH 208,A00,098027,Izadi; Elham,7,0,10,3
1668592538460,MATH 209,A00,098028,Pollack; Aaron,10,0,10,0
1668592538887,MATH 211A,A00,112919,Rogalski; Daniel,8,0,10,2
1668592539311,MATH 211B,A00,112920,Seward; Brandon M.,9,0,10,1
1668592539735,MATH 218,A00,098029,Li; Bo,10,0,10,0
1668592540181,MATH 220B,A00,098030,Novak; Jonathan I,10,0,15,5
1668592540617,MATH 221A,A00,098031,Ebenfelt; Peter F,12,0,15,3
1668592541056,MATH 231B,A00,098032,Zlatos; Andrej,9,0,15,6
1668592541488,MATH 240B,A00,098033,Ni; Lei,7,0,15,8
1668592541913,MATH 243,A00,098034,Jekel; David Andrew,10,0,10,0
1668592542342,MATH 245A,A00,098035,Nie; Jiawang,0,8,15,18
1668592542773,MATH 248,A00,098036,Bejenaru; Ioan,10,0,10,0
1668592543199,MATH 250B,A00,098037,Spolaor; Luca,12,0,15,3
1668592543622,MATH 258,A00,098038,Ni; Lei,8,0,10,2
1668592544050,MATH 264B,A00,098041,Rhoades; Brendon Patrick,6,0,15,9
1668592544475,MATH 268,A00,098042,Buss; Samuel R,10,0,10,0
1668592544899,MATH 269,A00,098043,Rhoades; Brendon Patrick,10,0,10,0
1668592545325,MATH 270B,A00,098044,Li; Bo,6,0,15,9
1668592545754,MATH 272B,A00,098045,Holst; Michael J,13,0,15,2
1668592546187,MATH 273A,A00,098046,Tian; Xiaochuan,10,0,15,5
1668592546611,MATH 275,A01,098048,Tian; Xiaochuan,6,0,10,4
1668592547034,MATH 278A,A00,098049,Holst; Michael J,6,0,10,4
1668592547460,MATH 278B,A00,098050,Cloninger; Alexander,10,0,10,0
1668592547882,MATH 278C,A00,098051,Nie; Jiawang,5,0,10,5
1668592548307,MATH 280B,A00,098052,Zheng; Tianyi,6,0,15,9
1668592548738,MATH 281B,A00,098053,Bradic; Jelena,0,2,15,15
1668592549166,MATH 282B,A00,098054,Arias-Castro; Ery,0,1,15,15
1668592549592,MATH 285,A00,098055,Fitzsimmons; Patrick J,0,4,15,16
1668592550017,MATH 287B,A00,098056,Arias-Castro; Ery,1,0,15,14
1668592550448,MATH 288,A00,098057,Agarwal; Pooja,9,0,10,1
1668592550448,MATH 288,B00,098058,Zhang; Danna,8,0,10,2
1668592550448,MATH 288,C00,098059,Williams; Ruth J,9,0,10,1
1668592550871,MATH 290B,A00,098060,Roberts; Justin Deritter,12,0,15,3
1668592551294,MATH 292,A00,098061,Belmont; Eva Kinoshita,10,0,10,0
1668592551730,MATH 295,A00,098062,Suk; Andrew Hoon,47,0,50,3
1668592552156,MATH 296,A00,098063,Novak; Jonathan I,20,0,20,0
1668592552584,MATH 297,001,098064,Gamst; Anthony Collins,9997,0,9999,2
1668593056486,COGS 205,A00,101395,Chiba; Andrea,19,0,20,1
1668593056913,COGS 210B,001,101404,Greene; Deanna Jacquelyn,9998,0,9999,1
1668593056913,COGS 210B,002,101417,Xia; Haijun,9999,0,9999,0
1668593056913,COGS 210B,003,101422,Nitz; Douglas A.,9999,0,9999,0
1668593056913,COGS 210B,004,101423,Hollan; James D.,9998,0,9999,1
1668593056913,COGS 210B,005,101424,Deak; Gedeon O.,9998,0,9999,1
1668593056913,COGS 210B,006,101425,Rossano; Federico,9999,0,9999,0
1668593057351,COGS 211B,A00,101427,Coulson; Seana M,9996,0,9999,3
1668593057773,COGS 220,A00,101428,Hollan; James D.,0,17,25,25
1668593058198,COGS 229,A00,101429,Dow; Steven P,17,0,25,8
1668593058626,COGS 230,A00,101430,Klemmer; Scott R,6,0,17,11
1668593059049,COGS 234,A00,101431,Xia; Haijun,0,1,25,25
1668593059474,COGS 260,A00,101432,Kiyonaga; Anastasia,21,0,25,4
1668593059474,COGS 260,B00,101433,Kirsh; David Joel,15,0,25,10
1668593059899,CSE 202,A00,102371,Impagliazzo; Russell,0,70,0,0
1668593060325,CSE 203B,A01,102373,Cheng; Chung Kuan,0,70,0,0
1668593060749,CSE 208,A00,102374,Micciancio; Daniele,0,5,0,0
1668593061175,CSE 209A,A00,112895,Impagliazzo; Russell,0,14,15,15
1668593061599,CSE 209B,A00,108005,Bellare; Mihir,0,7,0,0
1668593062029,CSE 210,A00,113163,Coblenz; Michael J,0,96,0,0
1668593062463,CSE 219,A00,106111,Dow; Steven P,0,8,20,20
1668593062890,CSE 221,A00,102376,Voelker; Geoffrey M.,0,78,0,0
1668593063315,CSE 224,A01,102378,Porter; George M,0,181,0,0
1668593063740,CSE 229A,A00,102379,Savage; Stefan,0,14,0,0
1668593064170,CSE 229C,A00,102380,Munyaka; Imani N. S.,0,12,0,0
1668593064593,CSE 232B,A00,102382,Deutsch; Alin Bernard,0,40,0,0
1668593065016,CSE 234,A01,112904,Kumar; Arun Kumar,0,0,0,0
1668593065446,CSE 237A,A00,102383,Rosing; Tajana Simunic,0,57,0,0
1668593065878,CSE 239A,A00,102384,Deutsch; Alin Bernard,0,18,0,0
1668593066302,CSE 239B,A00,102385,Polikarpova; Nadezhda,0,11,0,0
1668593066727,CSE 240A,A00,102386,Pannuto; Patrick William,0,49,0,0
1668593067152,CSE 240B,A00,102387,Zhao; Jishen,0,51,0,0
1668593067587,CSE 241A,A00,106406,Kang; Mingu,0,9,0,0
1668593068019,CSE 249B,A00,102388,Kahng; Andrew Byun,0,7,8,8
1668593068449,CSE 251B,A01,102392,Cottrell; Garrison W,0,54,0,0
1668593068449,CSE 251B,A02,102393,Cottrell; Garrison W,0,36,0,0
1668593068876,CSE 252B,A00,102394,Ochoa; Benjamin Lawrence,0,64,0,0
1668593069302,CSE 257,A01,102396,Gao; Sicun,0,160,0,0
1668593069727,CSE 272,A00,102397,Li; Tzumao,0,22,0,0
1668593070154,CSE 274,A00,111323,Chern; Albert Ren-Haur,0,16,0,0
1668593070595,CSE 282,A00,102398,Pevzner; Pavel Arkadjevich,0,0,0,0
1668593071025,CSE 284,A00,114175,Gymrek; Melissa Ann,0,33,0,0
1668593071451,CSE 290,A00,102399,Chandraker; Manmohan Krishna,0,11,0,0
1668593071451,CSE 290,B00,102400,Vaccaro; Kristen Marie,0,10,25,25
1668593071451,CSE 290,C00,102414,Pannuto; Patrick William,0,1,25,25
1668593071451,CSE 290,D00,102427,Pevzner; Pavel Arkadjevich,0,0,0,0
1668593071451,CSE 290,E00,102429,Zhao; Jishen,0,6,0,0
1668593071451,CSE 290,F00,102436,Tullsen; Dean Michael,0,6,0,0
1668593071451,CSE 290,G00,102440,Christensen; Henrik I,0,8,20,20
1668593071882,CSE 291,A00,102443,Su; Hao,0,0,0,0
1668593071882,CSE 291,B00,102448,Polikarpova; Nadezhda,0,0,0,0
1668593071882,CSE 291,C00,102453,Vaccaro; Kristen Marie,0,0,0,0
1668593071882,CSE 291,D00,111343,Savage; Stefan,0,0,0,0
1668593071882,CSE 291,E00,116474,Claffy; Kimberly Claire,0,0,0,0
1668593071882,CSE 291,F00,116479,Pasquale; Joseph,0,0,0,0
1668593072321,CSE 293,001,119111,Bafna; Vineet,9999,0,9999,0
1668593072321,CSE 293,002,119118,Bellare; Mihir,9999,0,9999,0
1668593072321,CSE 293,003,119122,Berg-Kirkpatrick; Taylor D,9999,0,9999,0
1668593072321,CSE 293,004,119135,Christensen; Henrik I,9999,0,9999,0
1668593072321,CSE 293,005,119142,Cottrell; Garrison W,9999,0,9999,0
1668593072321,CSE 293,006,119146,Deutsch; Alin Bernard,9999,0,9999,0
1668593072321,CSE 293,007,119159,Esmaeilzadeh; Hadi,9999,0,9999,0
1668593072321,CSE 293,008,119166,Freund; Yoav,9999,0,9999,0
1668593072321,CSE 293,009,119170,Griswold; William G.,9999,0,9999,0
1668593072321,CSE 293,010,119183,Gymrek; Melissa Ann,9999,0,9999,0
1668593072321,CSE 293,011,119190,Heninger; Nadia A,9999,0,9999,0
1668593072321,CSE 293,012,119230,Impagliazzo; Russell,9999,0,9999,0
1668593072321,CSE 293,013,119232,Jhala; Ranjit,9999,0,9999,0
1668593072321,CSE 293,014,119233,Kahng; Andrew Byun,9999,0,9999,0
1668593072321,CSE 293,015,119298,Kane; Daniel Mertz,9999,0,9999,0
1668593072321,CSE 293,016,119299,Kriegman; David J,9999,0,9999,0
1668593072321,CSE 293,017,119300,Kumar; Arun Kumar,9999,0,9999,0
1668593072321,CSE 293,018,119301,Lerner; Sorin,9999,0,9999,0
1668593072321,CSE 293,019,119302,Lovett; Shachar,9999,0,9999,0
1668593072321,CSE 293,020,119303,McAuley; Julian John,9999,0,9999,0
1668593072321,CSE 293,021,119304,Micciancio; Daniele,9999,0,9999,0
1668593072321,CSE 293,022,119367,Orailoglu; Alex,9999,0,9999,0
1668593072321,CSE 293,023,119382,Paturi; Ramamohan,9999,0,9999,0
1668593072321,CSE 293,024,119404,Polikarpova; Nadezhda,9999,0,9999,0
1668593072321,CSE 293,025,119406,Politz; Joseph Gibbs,9999,0,9999,0
1668593072321,CSE 293,026,119411,Porter; George M,9999,0,9999,0
1668593072321,CSE 293,027,119414,Porter; Leonard Emerson,9999,0,9999,0
1668593072321,CSE 293,028,119416,Ramamoorthi; Ravi,9999,0,9999,0
1668593072321,CSE 293,029,119417,Sahoo; Debashis,9999,0,9999,0
1668593072321,CSE 293,030,119420,Saul; Lawrence,9999,0,9999,0
1668593072321,CSE 293,031,119421,Savage; Stefan,9999,0,9999,0
1668593072321,CSE 293,032,119425,Schulze; Jurgen P.,9999,0,9999,0
1668593072321,CSE 293,033,119426,Snoeren; Alex C.,9999,0,9999,0
1668593072321,CSE 293,034,119428,Shang; Jingbo,9999,0,9999,0
1668593072321,CSE 293,035,119430,Stefan; Deian,9999,0,9999,0
1668593072321,CSE 293,036,119431,Su; Hao,9999,0,9999,0
1668593072321,CSE 293,037,119433,Swanson; Steven James,9999,0,9999,0
1668593072321,CSE 293,038,119435,Tullsen; Dean Michael,9999,0,9999,0
1668593072321,CSE 293,039,119483,Voelker; Geoffrey M.,9999,0,9999,0
1668593072321,CSE 293,040,119537,Zhao; Jishen,9999,0,9999,0
1668593072321,CSE 293,041,119538,Zhou; Yuan-Yuan,9999,0,9999,0
1668593072321,CSE 293,042,119539,Gao; Sicun,9999,0,9999,0
1668593072321,CSE 293,043,119540,Weibel; Nadir,9999,0,9999,0
1668593072321,CSE 293,044,119541,Gupta; Rajesh K.,9999,0,9999,0
1668593072321,CSE 293,045,126410,Vaccaro; Kristen Marie,9999,0,9999,0
1668593072321,CSE 293,046,126411,Klemke; Richard,9999,0,9999,0
1668593072744,CSE 294,A00,102459,Voelker; Geoffrey M.,0,2,0,0
1668593072744,CSE 294,B00,111322,Orailoglu; Alex,0,2,0,0
1668593073169,DSE 201,A00,096914,Deutsch; Alin Bernard,30,0,30,0
1668593073593,DSE 210,A00,096915,Dasgupta; Sanjoy,30,0,30,0
1668593074020,DSE 241,A00,144528,Smith; Neil Gordon,30,0,30,0
1668593074444,DSE 260A,A00,096916,Altintas De Callaf; Ilkay,30,0,30,0
1668593074895,ECE 200,001,103586,Antipa; Nicholas A,9999,0,9999,0
1668593074895,ECE 200,002,103587,Atanasov; Nikolay A.,9999,0,9999,0
1668593074895,ECE 200,003,103588,Bharadia; Dinesh,9999,0,9999,0
1668593074895,ECE 200,004,103589,Cheng; Chung Kuan,9999,0,9999,0
1668593074895,ECE 200,005,103590,Cosman; Pamela C.,9999,0,9999,0
1668593074895,ECE 200,006,103591,Dayeh; Shadi Ahmad,9999,0,9999,0
1668593074895,ECE 200,007,103592,Fainman; Yeshaiahu,9999,0,9999,0
1668593074895,ECE 200,008,103593,Ford; Joseph Earl,9999,0,9999,0
1668593074895,ECE 200,009,103594,Franceschetti; Massimo,9999,0,9999,0
1668593074895,ECE 200,010,103595,Fullerton; Eric E,9999,0,9999,0
1668593074895,ECE 200,011,103596,Galton; Ian A,9999,0,9999,0
1668593074895,ECE 200,012,103597,Gilja; Vikash,9999,0,9999,0
1668593074895,ECE 200,013,103598,Hall; Drew A.,9999,0,9999,0
1668593074895,ECE 200,014,103599,Hsueh; Tzu-Chien,9999,0,9999,0
1668593074895,ECE 200,015,103600,Javidi; Tara,9999,0,9999,0
1668593074895,ECE 200,016,103601,Kahng; Andrew Byun,9999,0,9999,0
1668593074895,ECE 200,017,103602,Kim; Young-Han,9999,0,9999,0
1668593074895,ECE 200,018,103603,Koushanfar; Farinaz,9999,0,9999,0
1668593074895,ECE 200,019,103604,Kuzum; Duygu,9999,0,9999,0
1668593074895,ECE 200,020,103605,Le; Hanh-Phuc,9999,0,9999,0
1668593074895,ECE 200,021,103606,Lin; Bill,9999,0,9999,0
1668593074895,ECE 200,022,103607,Liu; Zhaowei,9998,0,9999,1
1668593074895,ECE 200,023,103608,Lo; Yu-Hwa,9999,0,9999,0
1668593074895,ECE 200,024,103609,Lomakin; Vitaliy,9999,0,9999,0
1668593074895,ECE 200,025,103610,Mercier; Patrick Philip,9999,0,9999,0
1668593074895,ECE 200,026,103611,Meyer; Florian,9999,0,9999,0
1668593074895,ECE 200,027,103612,Milstein; Laurence B.,9999,0,9999,0
1668593074895,ECE 200,028,103613,Mir Arabbaygi; Siavash,9999,0,9999,0
1668593074895,ECE 200,029,103614,Mookherjea; Shayan,9999,0,9999,0
1668593074895,ECE 200,030,103615,Morris; Karcher William,9999,0,9999,0
1668593074895,ECE 200,031,103616,Ng; Tse Nga,9999,0,9999,0
1668593074895,ECE 200,032,103617,Nguyen; Truong Quang,9999,0,9999,0
1668593074895,ECE 200,033,103618,Nomura; Kenji,9999,0,9999,0
1668593074895,ECE 200,034,103619,Orlitsky; Alon,9999,0,9999,0
1668593074895,ECE 200,035,103620,Pal; Piya,9999,0,9999,0
1668593074895,ECE 200,036,103621,Papen; George C.,9999,0,9999,0
1668593074895,ECE 200,037,103622,Radic; Stojan,9999,0,9999,0
1668593074895,ECE 200,038,103623,Rao; Bhaskar D.,9999,0,9999,0
1668593074895,ECE 200,039,103624,Rao; Ramesh R,9999,0,9999,0
1668593074895,ECE 200,040,103625,Rebeiz; Gabriel,9999,0,9999,0
1668593074895,ECE 200,041,103626,Sanford; John R,9999,0,9999,0
1668593074895,ECE 200,042,103627,Siegel; Paul H.,9999,0,9999,0
1668593074895,ECE 200,043,103628,Sievenpiper; Daniel F.,9999,0,9999,0
1668593074895,ECE 200,044,103629,Sworder; David D.,9999,0,9999,0
1668593074895,ECE 200,045,103630,Taur; Yuan,9999,0,9999,0
1668593074895,ECE 200,046,103631,Touri; Behrouz,9999,0,9999,0
1668593074895,ECE 200,047,103632,Trivedi; Mohan M.,9999,0,9999,0
1668593074895,ECE 200,048,103633,Vasconcelos; Nuno,9999,0,9999,0
1668593074895,ECE 200,049,103634,Wang; Xiaolong,9999,0,9999,0
1668593074895,ECE 200,050,103635,Xie; Pengtao,9999,0,9999,0
1668593074895,ECE 200,051,103636,Yip; Michael,9999,0,9999,0
1668593074895,ECE 200,052,103637,Zeger; Kenneth A.,999,0,999,0
1668593074895,ECE 200,053,103638,Zhang; Xinyu,9999,0,9999,0
1668593074895,ECE 200,054,103639,Turakhia; Yatish Girish,9999,0,9999,0
1668593074895,ECE 200,055,103640,Kang; Mingu,9999,0,9999,0
1668593074895,ECE 200,056,103641,Shi; Yuanyuan,9999,0,9999,0
1668593074895,ECE 200,057,103642,Wang; Edward Jay,9999,0,9999,0
1668593074895,ECE 200,058,103643,Zheng; Yang,9999,0,9999,0
1668593075327,ECE 202,A00,103644,Kuzum; Duygu,0,47,0,0
1668593075765,ECE 212BN,A00,103646,Ng; Tse Nga,0,10,0,0
1668593076190,ECE 221,A00,111493,Staff,0,0,0,0
1668593076631,ECE 222B,A00,103647,Lomakin; Vitaliy,0,22,0,0
1668593077058,ECE 230B,A00,103648,Taur; Yuan,0,4,0,0
1668593077487,ECE 238B,A00,103649,Garay; Javier,0,0,0,0
1668593077913,ECE 240B,A00,112900,Fainman; Yeshaiahu,0,8,0,0
1668593078344,ECE 247A,A00,103650,Jokerst; Jesse Vincent,0,6,0,0
1668593078773,ECE 247B,A00,103651,Wang; Joseph,0,14,0,0
1668593079199,ECE 250,A00,103652,Siegel; Paul H.,0,85,0,0
1668593079627,ECE 251A,A00,103654,Rao; Bhaskar D.,0,65,0,0
1668593080067,ECE 257B,A00,103655,Bharadia; Dinesh,0,33,0,0
1668593080496,ECE 258A,A00,103656,Milstein; Laurence B.,0,29,0,0
1668593080920,ECE 260B,A00,103658,Kang; Mingu,0,121,0,0
1668593081347,ECE 264A,A00,103659,Galton; Ian A,0,42,0,34
1668593081795,ECE 265A,A00,103661,Gudem; Prasad S.S.,0,41,0,37
1668593082219,ECE 265D,A00,103662,Gudem; Prasad S.S.,0,27,0,0
1668593082644,ECE 268,A00,103663,Koushanfar; Farinaz,0,44,0,0
1668593083071,ECE 269,A01,103665,Pal; Piya,0,223,0,0
1668593083499,ECE 271B,A00,103666,Vasconcelos; Manuela,0,80,0,0
1668593083932,ECE 276A,A00,103667,Atanasov; Nikolay A.,0,127,0,0
1668593084449,ECE 277,A00,103668,An; Cheolhong,0,151,0,0
1668593084876,ECE 279,A00,117947,Hall; Drew A.,0,22,0,0
1668593085733,ECE 283,A00,103670,Hsueh; Tzu-Chien,0,57,0,0
1668593086185,ECE 284,A00,103671,Turakhia; Yatish Girish,0,40,0,0
1668593086614,ECE 285,A00,103672,Zheng; Yang,0,40,0,0
1668593086614,ECE 285,B00,103673,Sworder; David D.,0,61,0,0
1668593087040,ECE 287,A00,103676,Javidi; Tara,0,7,0,0
1668593087465,MATH 200B,A00,098023,Salehi Golsefidy; Alireza,7,0,15,8
1668593087889,MATH 202B,A00,098024,Rhoades; Brendon Patrick,7,0,15,8
1668593088313,MATH 203B,A00,098025,Oprea; Dragos N.,9,0,15,6
1668593088743,MATH 204B,A00,098026,Sorensen; Claus M,13,0,15,2
1668593089173,MATH 208,A00,098027,Izadi; Elham,7,0,10,3
1668593089608,MATH 209,A00,098028,Pollack; Aaron,10,0,10,0
1668593090039,MATH 211A,A00,112919,Rogalski; Daniel,8,0,10,2
1668593090464,MATH 211B,A00,112920,Seward; Brandon M.,9,0,10,1
1668593090890,MATH 218,A00,098029,Li; Bo,10,0,10,0
1668593091314,MATH 220B,A00,098030,Novak; Jonathan I,10,0,15,5
1668593091740,MATH 221A,A00,098031,Ebenfelt; Peter F,12,0,15,3
1668593092163,MATH 231B,A00,098032,Zlatos; Andrej,9,0,15,6
1668593092587,MATH 240B,A00,098033,Ni; Lei,7,0,15,8
1668593093016,MATH 243,A00,098034,Jekel; David Andrew,10,0,10,0
1668593093440,MATH 245A,A00,098035,Nie; Jiawang,0,8,15,18
1668593093863,MATH 248,A00,098036,Bejenaru; Ioan,10,0,10,0
1668593094286,MATH 250B,A00,098037,Spolaor; Luca,12,0,15,3
1668593094709,MATH 258,A00,098038,Ni; Lei,8,0,10,2
1668593095132,MATH 264B,A00,098041,Rhoades; Brendon Patrick,6,0,15,9
1668593095555,MATH 268,A00,098042,Buss; Samuel R,10,0,10,0
1668593095981,MATH 269,A00,098043,Rhoades; Brendon Patrick,10,0,10,0
1668593096404,MATH 270B,A00,098044,Li; Bo,6,0,15,9
1668593096830,MATH 272B,A00,098045,Holst; Michael J,13,0,15,2
1668593097258,MATH 273A,A00,098046,Tian; Xiaochuan,10,0,15,5
1668593097688,MATH 275,A01,098048,Tian; Xiaochuan,6,0,10,4
1668593098114,MATH 278A,A00,098049,Holst; Michael J,6,0,10,4
1668593098542,MATH 278B,A00,098050,Cloninger; Alexander,10,0,10,0
1668593098967,MATH 278C,A00,098051,Nie; Jiawang,5,0,10,5
1668593099393,MATH 280B,A00,098052,Zheng; Tianyi,6,0,15,9
1668593099818,MATH 281B,A00,098053,Bradic; Jelena,0,2,15,15
1668593100250,MATH 282B,A00,098054,Arias-Castro; Ery,0,1,15,15
1668593100689,MATH 285,A00,098055,Fitzsimmons; Patrick J,0,4,15,16
1668593101117,MATH 287B,A00,098056,Arias-Castro; Ery,1,0,15,14
1668593101554,MATH 288,A00,098057,Agarwal; Pooja,9,0,10,1
1668593101554,MATH 288,B00,098058,Zhang; Danna,8,0,10,2
1668593101554,MATH 288,C00,098059,Williams; Ruth J,9,0,10,1
1668593101981,MATH 290B,A00,098060,Roberts; Justin Deritter,12,0,15,3
1668593102406,MATH 292,A00,098061,Belmont; Eva Kinoshita,10,0,10,0
1668593102829,MATH 295,A00,098062,Suk; Andrew Hoon,47,0,50,3
1668593103255,MATH 296,A00,098063,Novak; Jonathan I,20,0,20,0
1668593103677,MATH 297,001,098064,Gamst; Anthony Collins,9997,0,9999,2
1668593609158,COGS 205,A00,101395,Chiba; Andrea,19,0,20,1
1668593609607,COGS 210B,001,101404,Greene; Deanna Jacquelyn,9998,0,9999,1
1668593609607,COGS 210B,002,101417,Xia; Haijun,9999,0,9999,0
1668593609607,COGS 210B,003,101422,Nitz; Douglas A.,9999,0,9999,0
1668593609607,COGS 210B,004,101423,Hollan; James D.,9998,0,9999,1
1668593609607,COGS 210B,005,101424,Deak; Gedeon O.,9998,0,9999,1
1668593609607,COGS 210B,006,101425,Rossano; Federico,9999,0,9999,0
1668593610037,COGS 211B,A00,101427,Coulson; Seana M,9996,0,9999,3
1668593610470,COGS 220,A00,101428,Hollan; James D.,0,17,25,25
1668593610895,COGS 229,A00,101429,Dow; Steven P,17,0,25,8
1668593611322,COGS 230,A00,101430,Klemmer; Scott R,6,0,17,11
1668593611752,COGS 234,A00,101431,Xia; Haijun,0,1,25,25
1668593612177,COGS 260,A00,101432,Kiyonaga; Anastasia,21,0,25,4
1668593612177,COGS 260,B00,101433,Kirsh; David Joel,15,0,25,10
1668593612608,CSE 202,A00,102371,Impagliazzo; Russell,0,70,0,0
1668593613034,CSE 203B,A01,102373,Cheng; Chung Kuan,0,70,0,0
1668593613465,CSE 208,A00,102374,Micciancio; Daniele,0,5,0,0
1668593613891,CSE 209A,A00,112895,Impagliazzo; Russell,0,14,15,15
1668593614321,CSE 209B,A00,108005,Bellare; Mihir,0,7,0,0
1668593614749,CSE 210,A00,113163,Coblenz; Michael J,0,96,0,0
1668593615173,CSE 219,A00,106111,Dow; Steven P,0,8,20,20
1668593615598,CSE 221,A00,102376,Voelker; Geoffrey M.,0,78,0,0
1668593616036,CSE 224,A01,102378,Porter; George M,0,181,0,0
1668593616462,CSE 229A,A00,102379,Savage; Stefan,0,14,0,0
1668593616886,CSE 229C,A00,102380,Munyaka; Imani N. S.,0,12,0,0
1668593617312,CSE 232B,A00,102382,Deutsch; Alin Bernard,0,40,0,0
1668593617743,CSE 234,A01,112904,Kumar; Arun Kumar,0,0,0,0
1668593618173,CSE 237A,A00,102383,Rosing; Tajana Simunic,0,57,0,0
1668593618601,CSE 239A,A00,102384,Deutsch; Alin Bernard,0,18,0,0
1668593619025,CSE 239B,A00,102385,Polikarpova; Nadezhda,0,11,0,0
1668593619454,CSE 240A,A00,102386,Pannuto; Patrick William,0,49,0,0
1668593619883,CSE 240B,A00,102387,Zhao; Jishen,0,51,0,0
1668593620308,CSE 241A,A00,106406,Kang; Mingu,0,9,0,0
1668593620745,CSE 249B,A00,102388,Kahng; Andrew Byun,0,7,8,8
1668593621174,CSE 251B,A01,102392,Cottrell; Garrison W,0,54,0,0
1668593621174,CSE 251B,A02,102393,Cottrell; Garrison W,0,36,0,0
1668593621600,CSE 252B,A00,102394,Ochoa; Benjamin Lawrence,0,64,0,0
1668593622033,CSE 257,A01,102396,Gao; Sicun,0,160,0,0
1668593622468,CSE 272,A00,102397,Li; Tzumao,0,22,0,0
1668593622899,CSE 274,A00,111323,Chern; Albert Ren-Haur,0,16,0,0
1668593623327,CSE 282,A00,102398,Pevzner; Pavel Arkadjevich,0,0,0,0
1668593623757,CSE 284,A00,114175,Gymrek; Melissa Ann,0,33,0,0
1668593624193,CSE 290,A00,102399,Chandraker; Manmohan Krishna,0,11,0,0
1668593624193,CSE 290,B00,102400,Vaccaro; Kristen Marie,0,10,25,25
1668593624193,CSE 290,C00,102414,Pannuto; Patrick William,0,1,25,25
1668593624193,CSE 290,D00,102427,Pevzner; Pavel Arkadjevich,0,0,0,0
1668593624193,CSE 290,E00,102429,Zhao; Jishen,0,6,0,0
1668593624193,CSE 290,F00,102436,Tullsen; Dean Michael,0,6,0,0
1668593624193,CSE 290,G00,102440,Christensen; Henrik I,0,8,20,20
1668593624628,CSE 291,A00,102443,Su; Hao,0,0,0,0
1668593624628,CSE 291,B00,102448,Polikarpova; Nadezhda,0,0,0,0
1668593624628,CSE 291,C00,102453,Vaccaro; Kristen Marie,0,0,0,0
1668593624628,CSE 291,D00,111343,Savage; Stefan,0,0,0,0
1668593624628,CSE 291,E00,116474,Claffy; Kimberly Claire,0,0,0,0
1668593624628,CSE 291,F00,116479,Pasquale; Joseph,0,0,0,0
1668593625097,CSE 293,001,119111,Bafna; Vineet,9999,0,9999,0
1668593625097,CSE 293,002,119118,Bellare; Mihir,9999,0,9999,0
1668593625097,CSE 293,003,119122,Berg-Kirkpatrick; Taylor D,9999,0,9999,0
1668593625097,CSE 293,004,119135,Christensen; Henrik I,9999,0,9999,0
1668593625097,CSE 293,005,119142,Cottrell; Garrison W,9999,0,9999,0
1668593625097,CSE 293,006,119146,Deutsch; Alin Bernard,9999,0,9999,0
1668593625097,CSE 293,007,119159,Esmaeilzadeh; Hadi,9999,0,9999,0
1668593625097,CSE 293,008,119166,Freund; Yoav,9999,0,9999,0
1668593625097,CSE 293,009,119170,Griswold; William G.,9999,0,9999,0
1668593625097,CSE 293,010,119183,Gymrek; Melissa Ann,9999,0,9999,0
1668593625097,CSE 293,011,119190,Heninger; Nadia A,9999,0,9999,0
1668593625097,CSE 293,012,119230,Impagliazzo; Russell,9999,0,9999,0
1668593625097,CSE 293,013,119232,Jhala; Ranjit,9999,0,9999,0
1668593625097,CSE 293,014,119233,Kahng; Andrew Byun,9999,0,9999,0
1668593625097,CSE 293,015,119298,Kane; Daniel Mertz,9999,0,9999,0
1668593625097,CSE 293,016,119299,Kriegman; David J,9999,0,9999,0
1668593625097,CSE 293,017,119300,Kumar; Arun Kumar,9999,0,9999,0
1668593625097,CSE 293,018,119301,Lerner; Sorin,9999,0,9999,0
1668593625097,CSE 293,019,119302,Lovett; Shachar,9999,0,9999,0
1668593625097,CSE 293,020,119303,McAuley; Julian John,9999,0,9999,0
1668593625097,CSE 293,021,119304,Micciancio; Daniele,9999,0,9999,0
1668593625097,CSE 293,022,119367,Orailoglu; Alex,9999,0,9999,0
1668593625097,CSE 293,023,119382,Paturi; Ramamohan,9999,0,9999,0
1668593625097,CSE 293,024,119404,Polikarpova; Nadezhda,9999,0,9999,0
1668593625097,CSE 293,025,119406,Politz; Joseph Gibbs,9999,0,9999,0
1668593625097,CSE 293,026,119411,Porter; George M,9999,0,9999,0
1668593625097,CSE 293,027,119414,Porter; Leonard Emerson,9999,0,9999,0
1668593625097,CSE 293,028,119416,Ramamoorthi; Ravi,9999,0,9999,0
1668593625097,CSE 293,029,119417,Sahoo; Debashis,9999,0,9999,0
1668593625097,CSE 293,030,119420,Saul; Lawrence,9999,0,9999,0
1668593625097,CSE 293,031,119421,Savage; Stefan,9999,0,9999,0
1668593625097,CSE 293,032,119425,Schulze; Jurgen P.,9999,0,9999,0
1668593625097,CSE 293,033,119426,Snoeren; Alex C.,9999,0,9999,0
1668593625097,CSE 293,034,119428,Shang; Jingbo,9999,0,9999,0
1668593625097,CSE 293,035,119430,Stefan; Deian,9999,0,9999,0
1668593625097,CSE 293,036,119431,Su; Hao,9999,0,9999,0
1668593625097,CSE 293,037,119433,Swanson; Steven James,9999,0,9999,0
1668593625097,CSE 293,038,119435,Tullsen; Dean Michael,9999,0,9999,0
1668593625097,CSE 293,039,119483,Voelker; Geoffrey M.,9999,0,9999,0
1668593625097,CSE 293,040,119537,Zhao; Jishen,9999,0,9999,0
1668593625097,CSE 293,041,119538,Zhou; Yuan-Yuan,9999,0,9999,0
1668593625097,CSE 293,042,119539,Gao; Sicun,9999,0,9999,0
1668593625097,CSE 293,043,119540,Weibel; Nadir,9999,0,9999,0
1668593625097,CSE 293,044,119541,Gupta; Rajesh K.,9999,0,9999,0
1668593625097,CSE 293,045,126410,Vaccaro; Kristen Marie,9999,0,9999,0
1668593625097,CSE 293,046,126411,Klemke; Richard,9999,0,9999,0
1668593625524,CSE 294,A00,102459,Voelker; Geoffrey M.,0,2,0,0
1668593625524,CSE 294,B00,111322,Orailoglu; Alex,0,2,0,0
1668593625949,DSE 201,A00,096914,Deutsch; Alin Bernard,30,0,30,0
1668593626373,DSE 210,A00,096915,Dasgupta; Sanjoy,30,0,30,0
1668593626799,DSE 241,A00,144528,Smith; Neil Gordon,30,0,30,0
1668593627227,DSE 260A,A00,096916,Altintas De Callaf; Ilkay,30,0,30,0
1668593627685,ECE 200,001,103586,Antipa; Nicholas A,9999,0,9999,0
1668593627685,ECE 200,002,103587,Atanasov; Nikolay A.,9999,0,9999,0
1668593627685,ECE 200,003,103588,Bharadia; Dinesh,9999,0,9999,0
1668593627685,ECE 200,004,103589,Cheng; Chung Kuan,9999,0,9999,0
1668593627685,ECE 200,005,103590,Cosman; Pamela C.,9999,0,9999,0
1668593627685,ECE 200,006,103591,Dayeh; Shadi Ahmad,9999,0,9999,0
1668593627685,ECE 200,007,103592,Fainman; Yeshaiahu,9999,0,9999,0
1668593627685,ECE 200,008,103593,Ford; Joseph Earl,9999,0,9999,0
1668593627685,ECE 200,009,103594,Franceschetti; Massimo,9999,0,9999,0
1668593627685,ECE 200,010,103595,Fullerton; Eric E,9999,0,9999,0
1668593627685,ECE 200,011,103596,Galton; Ian A,9999,0,9999,0
1668593627685,ECE 200,012,103597,Gilja; Vikash,9999,0,9999,0
1668593627685,ECE 200,013,103598,Hall; Drew A.,9999,0,9999,0
1668593627685,ECE 200,014,103599,Hsueh; Tzu-Chien,9999,0,9999,0
1668593627685,ECE 200,015,103600,Javidi; Tara,9999,0,9999,0
1668593627685,ECE 200,016,103601,Kahng; Andrew Byun,9999,0,9999,0
1668593627685,ECE 200,017,103602,Kim; Young-Han,9999,0,9999,0
1668593627685,ECE 200,018,103603,Koushanfar; Farinaz,9999,0,9999,0
1668593627685,ECE 200,019,103604,Kuzum; Duygu,9999,0,9999,0
1668593627685,ECE 200,020,103605,Le; Hanh-Phuc,9999,0,9999,0
1668593627685,ECE 200,021,103606,Lin; Bill,9999,0,9999,0
1668593627685,ECE 200,022,103607,Liu; Zhaowei,9998,0,9999,1
1668593627685,ECE 200,023,103608,Lo; Yu-Hwa,9999,0,9999,0
1668593627685,ECE 200,024,103609,Lomakin; Vitaliy,9999,0,9999,0
1668593627685,ECE 200,025,103610,Mercier; Patrick Philip,9999,0,9999,0
1668593627685,ECE 200,026,103611,Meyer; Florian,9999,0,9999,0
1668593627685,ECE 200,027,103612,Milstein; Laurence B.,9999,0,9999,0
1668593627685,ECE 200,028,103613,Mir Arabbaygi; Siavash,9999,0,9999,0
1668593627685,ECE 200,029,103614,Mookherjea; Shayan,9999,0,9999,0
1668593627685,ECE 200,030,103615,Morris; Karcher William,9999,0,9999,0
1668593627685,ECE 200,031,103616,Ng; Tse Nga,9999,0,9999,0
1668593627685,ECE 200,032,103617,Nguyen; Truong Quang,9999,0,9999,0
1668593627685,ECE 200,033,103618,Nomura; Kenji,9999,0,9999,0
1668593627685,ECE 200,034,103619,Orlitsky; Alon,9999,0,9999,0
1668593627685,ECE 200,035,103620,Pal; Piya,9999,0,9999,0
1668593627685,ECE 200,036,103621,Papen; George C.,9999,0,9999,0
1668593627685,ECE 200,037,103622,Radic; Stojan,9999,0,9999,0
1668593627685,ECE 200,038,103623,Rao; Bhaskar D.,9999,0,9999,0
1668593627685,ECE 200,039,103624,Rao; Ramesh R,9999,0,9999,0
1668593627685,ECE 200,040,103625,Rebeiz; Gabriel,9999,0,9999,0
1668593627685,ECE 200,041,103626,Sanford; John R,9999,0,9999,0
1668593627685,ECE 200,042,103627,Siegel; Paul H.,9999,0,9999,0
1668593627685,ECE 200,043,103628,Sievenpiper; Daniel F.,9999,0,9999,0
1668593627685,ECE 200,044,103629,Sworder; David D.,9999,0,9999,0
1668593627685,ECE 200,045,103630,Taur; Yuan,9999,0,9999,0
1668593627685,ECE 200,046,103631,Touri; Behrouz,9999,0,9999,0
1668593627685,ECE 200,047,103632,Trivedi; Mohan M.,9999,0,9999,0
1668593627685,ECE 200,048,103633,Vasconcelos; Nuno,9999,0,9999,0
1668593627685,ECE 200,049,103634,Wang; Xiaolong,9999,0,9999,0
1668593627685,ECE 200,050,103635,Xie; Pengtao,9999,0,9999,0
1668593627685,ECE 200,051,103636,Yip; Michael,9999,0,9999,0
1668593627685,ECE 200,052,103637,Zeger; Kenneth A.,999,0,999,0
1668593627685,ECE 200,053,103638,Zhang; Xinyu,9999,0,9999,0
1668593627685,ECE 200,054,103639,Turakhia; Yatish Girish,9999,0,9999,0
1668593627685,ECE 200,055,103640,Kang; Mingu,9999,0,9999,0
1668593627685,ECE 200,056,103641,Shi; Yuanyuan,9999,0,9999,0
1668593627685,ECE 200,057,103642,Wang; Edward Jay,9999,0,9999,0
1668593627685,ECE 200,058,103643,Zheng; Yang,9999,0,9999,0
1668593628138,ECE 202,A00,103644,Kuzum; Duygu,0,47,0,0
1668593628587,ECE 212BN,A00,103646,Ng; Tse Nga,0,10,0,0
1668593629022,ECE 221,A00,111493,Staff,0,0,0,0
1668593629449,ECE 222B,A00,103647,Lomakin; Vitaliy,0,22,0,0
1668593629874,ECE 230B,A00,103648,Taur; Yuan,0,4,0,0
1668593630302,ECE 238B,A00,103649,Garay; Javier,0,0,0,0
1668593630729,ECE 240B,A00,112900,Fainman; Yeshaiahu,0,8,0,0
1668593631168,ECE 247A,A00,103650,Jokerst; Jesse Vincent,0,6,0,0
1668593631607,ECE 247B,A00,103651,Wang; Joseph,0,14,0,0
1668593632040,ECE 250,A00,103652,Siegel; Paul H.,0,85,0,0
1668593632469,ECE 251A,A00,103654,Rao; Bhaskar D.,0,65,0,0
1668593632896,ECE 257B,A00,103655,Bharadia; Dinesh,0,33,0,0
1668593633325,ECE 258A,A00,103656,Milstein; Laurence B.,0,29,0,0
1668593633753,ECE 260B,A00,103658,Kang; Mingu,0,121,0,0
1668593634177,ECE 264A,A00,103659,Galton; Ian A,0,42,0,34
1668593634613,ECE 265A,A00,103661,Gudem; Prasad S.S.,0,41,0,37
1668593635037,ECE 265D,A00,103662,Gudem; Prasad S.S.,0,27,0,0
1668593635467,ECE 268,A00,103663,Koushanfar; Farinaz,0,44,0,0
1668593635897,ECE 269,A01,103665,Pal; Piya,0,223,0,0
1668593636324,ECE 271B,A00,103666,Vasconcelos; Manuela,0,80,0,0
1668593636747,ECE 276A,A00,103667,Atanasov; Nikolay A.,0,127,0,0
1668593637173,ECE 277,A00,103668,An; Cheolhong,0,151,0,0
1668593637602,ECE 279,A00,117947,Hall; Drew A.,0,22,0,0
1668593638456,ECE 283,A00,103670,Hsueh; Tzu-Chien,0,57,0,0
1668593638882,ECE 284,A00,103671,Turakhia; Yatish Girish,0,40,0,0
1668593639313,ECE 285,A00,103672,Zheng; Yang,0,40,0,0
1668593639313,ECE 285,B00,103673,Sworder; David D.,0,61,0,0
1668593639739,ECE 287,A00,103676,Javidi; Tara,0,7,0,0
1668593640189,MATH 200B,A00,098023,Salehi Golsefidy; Alireza,7,0,15,8
1668593640612,MATH 202B,A00,098024,Rhoades; Brendon Patrick,7,0,15,8
1668593641048,MATH 203B,A00,098025,Oprea; Dragos N.,9,0,15,6
1668593641475,MATH 204B,A00,098026,Sorensen; Claus M,13,0,15,2
1668593641904,MATH 208,A00,098027,Izadi; Elham,7,0,10,3
1668593642330,MATH 209,A00,098028,Pollack; Aaron,10,0,10,0
1668593642758,MATH 211A,A00,112919,Rogalski; Daniel,8,0,10,2
1668593643186,MATH 211B,A00,112920,Seward; Brandon M.,9,0,10,1
1668593643611,MATH 218,A00,098029,Li; Bo,10,0,10,0
1668593644047,MATH 220B,A00,098030,Novak; Jonathan I,10,0,15,5
1668593644475,MATH 221A,A00,098031,Ebenfelt; Peter F,12,0,15,3
1668593644906,MATH 231B,A00,098032,Zlatos; Andrej,9,0,15,6
1668593645334,MATH 240B,A00,098033,Ni; Lei,7,0,15,8
1668593645772,MATH 243,A00,098034,Jekel; David Andrew,10,0,10,0
1668593646215,MATH 245A,A00,098035,Nie; Jiawang,0,8,15,18
1668593646640,MATH 248,A00,098036,Bejenaru; Ioan,10,0,10,0
1668593647064,MATH 250B,A00,098037,Spolaor; Luca,12,0,15,3
1668593647490,MATH 258,A00,098038,Ni; Lei,8,0,10,2
1668593647915,MATH 264B,A00,098041,Rhoades; Brendon Patrick,6,0,15,9
1668593648339,MATH 268,A00,098042,Buss; Samuel R,10,0,10,0
1668593648766,MATH 269,A00,098043,Rhoades; Brendon Patrick,10,0,10,0
1668593649194,MATH 270B,A00,098044,Li; Bo,6,0,15,9
1668593649625,MATH 272B,A00,098045,Holst; Michael J,13,0,15,2
1668593650059,MATH 273A,A00,098046,Tian; Xiaochuan,10,0,15,5
1668593650486,MATH 275,A01,098048,Tian; Xiaochuan,6,0,10,4
1668593650916,MATH 278A,A00,098049,Holst; Michael J,6,0,10,4
1668593651340,MATH 278B,A00,098050,Cloninger; Alexander,10,0,10,0
1668593651867,MATH 278C,A00,098051,Nie; Jiawang,5,0,10,5
1668593652299,MATH 280B,A00,098052,Zheng; Tianyi,6,0,15,9
1668593652727,MATH 281B,A00,098053,Bradic; Jelena,0,2,15,15
1668593653156,MATH 282B,A00,098054,Arias-Castro; Ery,0,1,15,15
1668593653580,MATH 285,A00,098055,Fitzsimmons; Patrick J,0,4,15,16
1668593654005,MATH 287B,A00,098056,Arias-Castro; Ery,1,0,15,14
1668593654429,MATH 288,A00,098057,Agarwal; Pooja,9,0,10,1
1668593654429,MATH 288,B00,098058,Zhang; Danna,8,0,10,2
1668593654429,MATH 288,C00,098059,Williams; Ruth J,9,0,10,1
1668593654856,MATH 290B,A00,098060,Roberts; Justin Deritter,12,0,15,3
1668593655281,MATH 292,A00,098061,Belmont; Eva Kinoshita,10,0,10,0
1668593655711,MATH 295,A00,098062,Suk; Andrew Hoon,47,0,50,3
1668593656159,MATH 296,A00,098063,Novak; Jonathan I,20,0,20,0
1668593656596,MATH 297,001,098064,Gamst; Anthony Collins,9997,0,9999,2
1668594161573,COGS 205,A00,101395,Chiba; Andrea,19,0,20,1
1668594162016,COGS 210B,001,101404,Greene; Deanna Jacquelyn,9998,0,9999,1
1668594162016,COGS 210B,002,101417,Xia; Haijun,9999,0,9999,0
1668594162016,COGS 210B,003,101422,Nitz; Douglas A.,9999,0,9999,0
1668594162016,COGS 210B,004,101423,Hollan; James D.,9998,0,9999,1
1668594162016,COGS 210B,005,101424,Deak; Gedeon O.,9998,0,9999,1
1668594162016,COGS 210B,006,101425,Rossano; Federico,9999,0,9999,0
1668594162449,COGS 211B,A00,101427,Coulson; Seana M,9996,0,9999,3
1668594162882,COGS 220,A00,101428,Hollan; James D.,0,17,25,25
1668594163320,COGS 229,A00,101429,Dow; Steven P,17,0,25,8
1668594163752,COGS 230,A00,101430,Klemmer; Scott R,6,0,17,11
1668594164184,COGS 234,A00,101431,Xia; Haijun,0,1,25,25
1668594164614,COGS 260,A00,101432,Kiyonaga; Anastasia,21,0,25,4
1668594164614,COGS 260,B00,101433,Kirsh; David Joel,15,0,25,10
1668594165040,CSE 202,A00,102371,Impagliazzo; Russell,0,70,0,0
1668594165475,CSE 203B,A01,102373,Cheng; Chung Kuan,0,70,0,0
1668594165902,CSE 208,A00,102374,Micciancio; Daniele,0,5,0,0
1668594166334,CSE 209A,A00,112895,Impagliazzo; Russell,0,14,15,15
1668594166759,CSE 209B,A00,108005,Bellare; Mihir,0,7,0,0
1668594167197,CSE 210,A00,113163,Coblenz; Michael J,0,96,0,0
1668594167624,CSE 219,A00,106111,Dow; Steven P,0,8,20,20
1668594168050,CSE 221,A00,102376,Voelker; Geoffrey M.,0,78,0,0
1668594168476,CSE 224,A01,102378,Porter; George M,0,181,0,0
1668594168909,CSE 229A,A00,102379,Savage; Stefan,0,14,0,0
1668594169336,CSE 229C,A00,102380,Munyaka; Imani N. S.,0,12,0,0
1668594169764,CSE 232B,A00,102382,Deutsch; Alin Bernard,0,40,0,0
1668594170190,CSE 234,A01,112904,Kumar; Arun Kumar,0,0,0,0
1668594170615,CSE 237A,A00,102383,Rosing; Tajana Simunic,0,57,0,0
1668594171058,CSE 239A,A00,102384,Deutsch; Alin Bernard,0,18,0,0
1668594171483,CSE 239B,A00,102385,Polikarpova; Nadezhda,0,11,0,0
1668594171907,CSE 240A,A00,102386,Pannuto; Patrick William,0,49,0,0
1668594172334,CSE 240B,A00,102387,Zhao; Jishen,0,51,0,0
1668594172758,CSE 241A,A00,106406,Kang; Mingu,0,9,0,0
1668594173183,CSE 249B,A00,102388,Kahng; Andrew Byun,0,7,8,8
1668594173608,CSE 251B,A01,102392,Cottrell; Garrison W,0,54,0,0
1668594173608,CSE 251B,A02,102393,Cottrell; Garrison W,0,36,0,0
1668594174053,CSE 252B,A00,102394,Ochoa; Benjamin Lawrence,0,64,0,0
1668594174478,CSE 257,A01,102396,Gao; Sicun,0,160,0,0
1668594174910,CSE 272,A00,102397,Li; Tzumao,0,22,0,0
1668594175467,CSE 274,A00,111323,Chern; Albert Ren-Haur,0,16,0,0
1668594175894,CSE 282,A00,102398,Pevzner; Pavel Arkadjevich,0,0,0,0
1668594176321,CSE 284,A00,114175,Gymrek; Melissa Ann,0,33,0,0
1668594176749,CSE 290,A00,102399,Chandraker; Manmohan Krishna,0,11,0,0
1668594176749,CSE 290,B00,102400,Vaccaro; Kristen Marie,0,10,25,25
1668594176749,CSE 290,C00,102414,Pannuto; Patrick William,0,1,25,25
1668594176749,CSE 290,D00,102427,Pevzner; Pavel Arkadjevich,0,0,0,0
1668594176749,CSE 290,E00,102429,Zhao; Jishen,0,6,0,0
1668594176749,CSE 290,F00,102436,Tullsen; Dean Michael,0,6,0,0
1668594176749,CSE 290,G00,102440,Christensen; Henrik I,0,8,20,20
1668594177188,CSE 291,A00,102443,Su; Hao,0,0,0,0
1668594177188,CSE 291,B00,102448,Polikarpova; Nadezhda,0,0,0,0
1668594177188,CSE 291,C00,102453,Vaccaro; Kristen Marie,0,0,0,0
1668594177188,CSE 291,D00,111343,Savage; Stefan,0,0,0,0
1668594177188,CSE 291,E00,116474,Claffy; Kimberly Claire,0,0,0,0
1668594177188,CSE 291,F00,116479,Pasquale; Joseph,0,0,0,0
1668594177632,CSE 293,001,119111,Bafna; Vineet,9999,0,9999,0
1668594177632,CSE 293,002,119118,Bellare; Mihir,9999,0,9999,0
1668594177632,CSE 293,003,119122,Berg-Kirkpatrick; Taylor D,9999,0,9999,0
1668594177632,CSE 293,004,119135,Christensen; Henrik I,9999,0,9999,0
1668594177632,CSE 293,005,119142,Cottrell; Garrison W,9999,0,9999,0
1668594177632,CSE 293,006,119146,Deutsch; Alin Bernard,9999,0,9999,0
1668594177632,CSE 293,007,119159,Esmaeilzadeh; Hadi,9999,0,9999,0
1668594177632,CSE 293,008,119166,Freund; Yoav,9999,0,9999,0
1668594177632,CSE 293,009,119170,Griswold; William G.,9999,0,9999,0
1668594177632,CSE 293,010,119183,Gymrek; Melissa Ann,9999,0,9999,0
1668594177632,CSE 293,011,119190,Heninger; Nadia A,9999,0,9999,0
1668594177632,CSE 293,012,119230,Impagliazzo; Russell,9999,0,9999,0
1668594177632,CSE 293,013,119232,Jhala; Ranjit,9999,0,9999,0
1668594177632,CSE 293,014,119233,Kahng; Andrew Byun,9999,0,9999,0
1668594177632,CSE 293,015,119298,Kane; Daniel Mertz,9999,0,9999,0
1668594177632,CSE 293,016,119299,Kriegman; David J,9999,0,9999,0
1668594177632,CSE 293,017,119300,Kumar; Arun Kumar,9999,0,9999,0
1668594177632,CSE 293,018,119301,Lerner; Sorin,9999,0,9999,0
1668594177632,CSE 293,019,119302,Lovett; Shachar,9999,0,9999,0
1668594177632,CSE 293,020,119303,McAuley; Julian John,9999,0,9999,0
1668594177632,CSE 293,021,119304,Micciancio; Daniele,9999,0,9999,0
1668594177632,CSE 293,022,119367,Orailoglu; Alex,9999,0,9999,0
1668594177632,CSE 293,023,119382,Paturi; Ramamohan,9999,0,9999,0
1668594177632,CSE 293,024,119404,Polikarpova; Nadezhda,9999,0,9999,0
1668594177632,CSE 293,025,119406,Politz; Joseph Gibbs,9999,0,9999,0
1668594177632,CSE 293,026,119411,Porter; George M,9999,0,9999,0
1668594177632,CSE 293,027,119414,Porter; Leonard Emerson,9999,0,9999,0
1668594177632,CSE 293,028,119416,Ramamoorthi; Ravi,9999,0,9999,0
1668594177632,CSE 293,029,119417,Sahoo; Debashis,9999,0,9999,0
1668594177632,CSE 293,030,119420,Saul; Lawrence,9999,0,9999,0
1668594177632,CSE 293,031,119421,Savage; Stefan,9999,0,9999,0
1668594177632,CSE 293,032,119425,Schulze; Jurgen P.,9999,0,9999,0
1668594177632,CSE 293,033,119426,Snoeren; Alex C.,9999,0,9999,0
1668594177632,CSE 293,034,119428,Shang; Jingbo,9999,0,9999,0
1668594177632,CSE 293,035,119430,Stefan; Deian,9999,0,9999,0
1668594177632,CSE 293,036,119431,Su; Hao,9999,0,9999,0
1668594177632,CSE 293,037,119433,Swanson; Steven James,9999,0,9999,0
1668594177632,CSE 293,038,119435,Tullsen; Dean Michael,9999,0,9999,0
1668594177632,CSE 293,039,119483,Voelker; Geoffrey M.,9999,0,9999,0
1668594177632,CSE 293,040,119537,Zhao; Jishen,9999,0,9999,0
1668594177632,CSE 293,041,119538,Zhou; Yuan-Yuan,9999,0,9999,0
1668594177632,CSE 293,042,119539,Gao; Sicun,9999,0,9999,0
1668594177632,CSE 293,043,119540,Weibel; Nadir,9999,0,9999,0
1668594177632,CSE 293,044,119541,Gupta; Rajesh K.,9999,0,9999,0
1668594177632,CSE 293,045,126410,Vaccaro; Kristen Marie,9999,0,9999,0
1668594177632,CSE 293,046,126411,Klemke; Richard,9999,0,9999,0
1668594178056,CSE 294,A00,102459,Voelker; Geoffrey M.,0,2,0,0
1668594178056,CSE 294,B00,111322,Orailoglu; Alex,0,2,0,0
1668594178487,DSE 201,A00,096914,Deutsch; Alin Bernard,30,0,30,0
1668594178915,DSE 210,A00,096915,Dasgupta; Sanjoy,30,0,30,0
1668594179344,DSE 241,A00,144528,Smith; Neil Gordon,30,0,30,0
1668594179769,DSE 260A,A00,096916,Altintas De Callaf; Ilkay,30,0,30,0
1668594180226,ECE 200,001,103586,Antipa; Nicholas A,9999,0,9999,0
1668594180226,ECE 200,002,103587,Atanasov; Nikolay A.,9999,0,9999,0
1668594180226,ECE 200,003,103588,Bharadia; Dinesh,9999,0,9999,0
1668594180226,ECE 200,004,103589,Cheng; Chung Kuan,9999,0,9999,0
1668594180226,ECE 200,005,103590,Cosman; Pamela C.,9999,0,9999,0
1668594180226,ECE 200,006,103591,Dayeh; Shadi Ahmad,9999,0,9999,0
1668594180226,ECE 200,007,103592,Fainman; Yeshaiahu,9999,0,9999,0
1668594180226,ECE 200,008,103593,Ford; Joseph Earl,9999,0,9999,0
1668594180226,ECE 200,009,103594,Franceschetti; Massimo,9999,0,9999,0
1668594180226,ECE 200,010,103595,Fullerton; Eric E,9999,0,9999,0
1668594180226,ECE 200,011,103596,Galton; Ian A,9999,0,9999,0
1668594180226,ECE 200,012,103597,Gilja; Vikash,9999,0,9999,0
1668594180226,ECE 200,013,103598,Hall; Drew A.,9999,0,9999,0
1668594180226,ECE 200,014,103599,Hsueh; Tzu-Chien,9999,0,9999,0
1668594180226,ECE 200,015,103600,Javidi; Tara,9999,0,9999,0
1668594180226,ECE 200,016,103601,Kahng; Andrew Byun,9999,0,9999,0
1668594180226,ECE 200,017,103602,Kim; Young-Han,9999,0,9999,0
1668594180226,ECE 200,018,103603,Koushanfar; Farinaz,9999,0,9999,0
1668594180226,ECE 200,019,103604,Kuzum; Duygu,9999,0,9999,0
1668594180226,ECE 200,020,103605,Le; Hanh-Phuc,9999,0,9999,0
1668594180226,ECE 200,021,103606,Lin; Bill,9999,0,9999,0
1668594180226,ECE 200,022,103607,Liu; Zhaowei,9998,0,9999,1
1668594180226,ECE 200,023,103608,Lo; Yu-Hwa,9999,0,9999,0
1668594180226,ECE 200,024,103609,Lomakin; Vitaliy,9999,0,9999,0
1668594180226,ECE 200,025,103610,Mercier; Patrick Philip,9999,0,9999,0
1668594180226,ECE 200,026,103611,Meyer; Florian,9999,0,9999,0
1668594180226,ECE 200,027,103612,Milstein; Laurence B.,9999,0,9999,0
1668594180226,ECE 200,028,103613,Mir Arabbaygi; Siavash,9999,0,9999,0
1668594180226,ECE 200,029,103614,Mookherjea; Shayan,9999,0,9999,0
1668594180226,ECE 200,030,103615,Morris; Karcher William,9999,0,9999,0
1668594180226,ECE 200,031,103616,Ng; Tse Nga,9999,0,9999,0
1668594180226,ECE 200,032,103617,Nguyen; Truong Quang,9999,0,9999,0
1668594180226,ECE 200,033,103618,Nomura; Kenji,9999,0,9999,0
1668594180226,ECE 200,034,103619,Orlitsky; Alon,9999,0,9999,0
1668594180226,ECE 200,035,103620,Pal; Piya,9999,0,9999,0
1668594180226,ECE 200,036,103621,Papen; George C.,9999,0,9999,0
1668594180226,ECE 200,037,103622,Radic; Stojan,9999,0,9999,0
1668594180226,ECE 200,038,103623,Rao; Bhaskar D.,9999,0,9999,0
1668594180226,ECE 200,039,103624,Rao; Ramesh R,9999,0,9999,0
1668594180226,ECE 200,040,103625,Rebeiz; Gabriel,9999,0,9999,0
1668594180226,ECE 200,041,103626,Sanford; John R,9999,0,9999,0
1668594180226,ECE 200,042,103627,Siegel; Paul H.,9999,0,9999,0
1668594180226,ECE 200,043,103628,Sievenpiper; Daniel F.,9999,0,9999,0
1668594180226,ECE 200,044,103629,Sworder; David D.,9999,0,9999,0
1668594180226,ECE 200,045,103630,Taur; Yuan,9999,0,9999,0
1668594180226,ECE 200,046,103631,Touri; Behrouz,9999,0,9999,0
1668594180226,ECE 200,047,103632,Trivedi; Mohan M.,9999,0,9999,0
1668594180226,ECE 200,048,103633,Vasconcelos; Nuno,9999,0,9999,0
1668594180226,ECE 200,049,103634,Wang; Xiaolong,9999,0,9999,0
1668594180226,ECE 200,050,103635,Xie; Pengtao,9999,0,9999,0
1668594180226,ECE 200,051,103636,Yip; Michael,9999,0,9999,0
1668594180226,ECE 200,052,103637,Zeger; Kenneth A.,999,0,999,0
1668594180226,ECE 200,053,103638,Zhang; Xinyu,9999,0,9999,0
1668594180226,ECE 200,054,103639,Turakhia; Yatish Girish,9999,0,9999,0
1668594180226,ECE 200,055,103640,Kang; Mingu,9999,0,9999,0
1668594180226,ECE 200,056,103641,Shi; Yuanyuan,9999,0,9999,0
1668594180226,ECE 200,057,103642,Wang; Edward Jay,9999,0,9999,0
1668594180226,ECE 200,058,103643,Zheng; Yang,9999,0,9999,0
1668594180650,ECE 202,A00,103644,Kuzum; Duygu,0,47,0,0
1668594181076,ECE 212BN,A00,103646,Ng; Tse Nga,0,10,0,0
1668594181503,ECE 221,A00,111493,Staff,0,0,0,0
1668594181926,ECE 222B,A00,103647,Lomakin; Vitaliy,0,22,0,0
1668594182350,ECE 230B,A00,103648,Taur; Yuan,0,4,0,0
1668594182775,ECE 238B,A00,103649,Garay; Javier,0,0,0,0
1668594183198,ECE 240B,A00,112900,Fainman; Yeshaiahu,0,8,0,0
1668594183622,ECE 247A,A00,103650,Jokerst; Jesse Vincent,0,6,0,0
1668594184050,ECE 247B,A00,103651,Wang; Joseph,0,14,0,0
1668594184474,ECE 250,A00,103652,Siegel; Paul H.,0,85,0,0
1668594184904,ECE 251A,A00,103654,Rao; Bhaskar D.,0,65,0,0
1668594185334,ECE 257B,A00,103655,Bharadia; Dinesh,0,33,0,0
1668594185763,ECE 258A,A00,103656,Milstein; Laurence B.,0,29,0,0
1668594186189,ECE 260B,A00,103658,Kang; Mingu,0,121,0,0
1668594186618,ECE 264A,A00,103659,Galton; Ian A,0,42,0,34
1668594187046,ECE 265A,A00,103661,Gudem; Prasad S.S.,0,41,0,37
1668594187471,ECE 265D,A00,103662,Gudem; Prasad S.S.,0,27,0,0
1668594187900,ECE 268,A00,103663,Koushanfar; Farinaz,0,44,0,0
1668594188324,ECE 269,A01,103665,Pal; Piya,0,223,0,0
1668594188757,ECE 271B,A00,103666,Vasconcelos; Manuela,0,80,0,0
1668594189186,ECE 276A,A00,103667,Atanasov; Nikolay A.,0,127,0,0
1668594189616,ECE 277,A00,103668,An; Cheolhong,0,151,0,0
1668594190042,ECE 279,A00,117947,Hall; Drew A.,0,22,0,0
1668594190898,ECE 283,A00,103670,Hsueh; Tzu-Chien,0,57,0,0
1668594191323,ECE 284,A00,103671,Turakhia; Yatish Girish,0,40,0,0
1668594191748,ECE 285,A00,103672,Zheng; Yang,0,40,0,0
1668594191748,ECE 285,B00,103673,Sworder; David D.,0,61,0,0
1668594192175,ECE 287,A00,103676,Javidi; Tara,0,7,0,0
1668594192604,MATH 200B,A00,098023,Salehi Golsefidy; Alireza,7,0,15,8
1668594193031,MATH 202B,A00,098024,Rhoades; Brendon Patrick,7,0,15,8
1668594193460,MATH 203B,A00,098025,Oprea; Dragos N.,9,0,15,6
1668594193883,MATH 204B,A00,098026,Sorensen; Claus M,13,0,15,2
1668594194309,MATH 208,A00,098027,Izadi; Elham,7,0,10,3
1668594194735,MATH 209,A00,098028,Pollack; Aaron,10,0,10,0
1668594195174,MATH 211A,A00,112919,Rogalski; Daniel,8,0,10,2
1668594195600,MATH 211B,A00,112920,Seward; Brandon M.,9,0,10,1
1668594196031,MATH 218,A00,098029,Li; Bo,10,0,10,0
1668594196455,MATH 220B,A00,098030,Novak; Jonathan I,10,0,15,5
1668594196884,MATH 221A,A00,098031,Ebenfelt; Peter F,12,0,15,3
1668594197310,MATH 231B,A00,098032,Zlatos; Andrej,9,0,15,6
1668594197739,MATH 240B,A00,098033,Ni; Lei,7,0,15,8
1668594198163,MATH 243,A00,098034,Jekel; David Andrew,10,0,10,0
1668594198595,MATH 245A,A00,098035,Nie; Jiawang,0,8,15,18
1668594199025,MATH 248,A00,098036,Bejenaru; Ioan,10,0,10,0
1668594199470,MATH 250B,A00,098037,Spolaor; Luca,12,0,15,3
1668594199903,MATH 258,A00,098038,Ni; Lei,8,0,10,2
1668594200346,MATH 264B,A00,098041,Rhoades; Brendon Patrick,6,0,15,9
1668594200771,MATH 268,A00,098042,Buss; Samuel R,10,0,10,0
1668594201198,MATH 269,A00,098043,Rhoades; Brendon Patrick,10,0,10,0
1668594201627,MATH 270B,A00,098044,Li; Bo,6,0,15,9
1668594202059,MATH 272B,A00,098045,Holst; Michael J,13,0,15,2
1668594202484,MATH 273A,A00,098046,Tian; Xiaochuan,10,0,15,5
1668594202912,MATH 275,A01,098048,Tian; Xiaochuan,6,0,10,4
1668594203338,MATH 278A,A00,098049,Holst; Michael J,6,0,10,4
1668594203763,MATH 278B,A00,098050,Cloninger; Alexander,10,0,10,0
1668594204187,MATH 278C,A00,098051,Nie; Jiawang,5,0,10,5
1668594204612,MATH 280B,A00,098052,Zheng; Tianyi,6,0,15,9
1668594205038,MATH 281B,A00,098053,Bradic; Jelena,0,2,15,15
1668594205464,MATH 282B,A00,098054,Arias-Castro; Ery,0,1,15,15
1668594205893,MATH 285,A00,098055,Fitzsimmons; Patrick J,0,4,15,16
1668594206318,MATH 287B,A00,098056,Arias-Castro; Ery,1,0,15,14
1668594206751,MATH 288,A00,098057,Agarwal; Pooja,9,0,10,1
1668594206751,MATH 288,B00,098058,Zhang; Danna,8,0,10,2
1668594206751,MATH 288,C00,098059,Williams; Ruth J,9,0,10,1
1668594207191,MATH 290B,A00,098060,Roberts; Justin Deritter,12,0,15,3
1668594207620,MATH 292,A00,098061,Belmont; Eva Kinoshita,10,0,10,0
1668594208044,MATH 295,A00,098062,Suk; Andrew Hoon,47,0,50,3
1668594208469,MATH 296,A00,098063,Novak; Jonathan I,20,0,20,0
1668594208896,MATH 297,001,098064,Gamst; Anthony Collins,9997,0,9999,2
1668594714440,COGS 205,A00,101395,Chiba; Andrea,19,0,20,1
1668594714870,COGS 210B,001,101404,Greene; Deanna Jacquelyn,9998,0,9999,1
1668594714870,COGS 210B,002,101417,Xia; Haijun,9999,0,9999,0
1668594714870,COGS 210B,003,101422,Nitz; Douglas A.,9999,0,9999,0
1668594714870,COGS 210B,004,101423,Hollan; James D.,9998,0,9999,1
1668594714870,COGS 210B,005,101424,Deak; Gedeon O.,9998,0,9999,1
1668594714870,COGS 210B,006,101425,Rossano; Federico,9999,0,9999,0
1668594715294,COGS 211B,A00,101427,Coulson; Seana M,9996,0,9999,3
1668594715718,COGS 220,A00,101428,Hollan; James D.,0,17,25,25
1668594716144,COGS 229,A00,101429,Dow; Steven P,17,0,25,8
1668594716572,COGS 230,A00,101430,Klemmer; Scott R,6,0,17,11
1668594716997,COGS 234,A00,101431,Xia; Haijun,0,1,25,25
1668594717423,COGS 260,A00,101432,Kiyonaga; Anastasia,21,0,25,4
1668594717423,COGS 260,B00,101433,Kirsh; David Joel,15,0,25,10
1668594717861,CSE 202,A00,102371,Impagliazzo; Russell,0,70,0,0
1668594718291,CSE 203B,A01,102373,Cheng; Chung Kuan,0,70,0,0
1668594718721,CSE 208,A00,102374,Micciancio; Daniele,0,5,0,0
1668594719145,CSE 209A,A00,112895,Impagliazzo; Russell,0,14,15,15
1668594719570,CSE 209B,A00,108005,Bellare; Mihir,0,7,0,0
1668594719995,CSE 210,A00,113163,Coblenz; Michael J,0,96,0,0
1668594720422,CSE 219,A00,106111,Dow; Steven P,0,8,20,20
1668594720851,CSE 221,A00,102376,Voelker; Geoffrey M.,0,78,0,0
1668594721277,CSE 224,A01,102378,Porter; George M,0,181,0,0
1668594721705,CSE 229A,A00,102379,Savage; Stefan,0,14,0,0
1668594722133,CSE 229C,A00,102380,Munyaka; Imani N. S.,0,12,0,0
1668594722576,CSE 232B,A00,102382,Deutsch; Alin Bernard,0,40,0,0
1668594723007,CSE 234,A01,112904,Kumar; Arun Kumar,0,0,0,0
1668594723443,CSE 237A,A00,102383,Rosing; Tajana Simunic,0,57,0,0
1668594723876,CSE 239A,A00,102384,Deutsch; Alin Bernard,0,18,0,0
1668594724305,CSE 239B,A00,102385,Polikarpova; Nadezhda,0,11,0,0
1668594724731,CSE 240A,A00,102386,Pannuto; Patrick William,0,49,0,0
1668594725163,CSE 240B,A00,102387,Zhao; Jishen,0,51,0,0
1668594725594,CSE 241A,A00,106406,Kang; Mingu,0,9,0,0
1668594726023,CSE 249B,A00,102388,Kahng; Andrew Byun,0,7,8,8
1668594726448,CSE 251B,A01,102392,Cottrell; Garrison W,0,54,0,0
1668594726448,CSE 251B,A02,102393,Cottrell; Garrison W,0,36,0,0
1668594726879,CSE 252B,A00,102394,Ochoa; Benjamin Lawrence,0,64,0,0
1668594727303,CSE 257,A01,102396,Gao; Sicun,0,160,0,0
1668594727733,CSE 272,A00,102397,Li; Tzumao,0,22,0,0
1668594728159,CSE 274,A00,111323,Chern; Albert Ren-Haur,0,16,0,0
1668594728586,CSE 282,A00,102398,Pevzner; Pavel Arkadjevich,0,0,0,0
1668594729021,CSE 284,A00,114175,Gymrek; Melissa Ann,0,33,0,0
1668594729475,CSE 290,A00,102399,Chandraker; Manmohan Krishna,0,11,0,0
1668594729475,CSE 290,B00,102400,Vaccaro; Kristen Marie,0,10,25,25
1668594729475,CSE 290,C00,102414,Pannuto; Patrick William,0,1,25,25
1668594729475,CSE 290,D00,102427,Pevzner; Pavel Arkadjevich,0,0,0,0
1668594729475,CSE 290,E00,102429,Zhao; Jishen,0,6,0,0
1668594729475,CSE 290,F00,102436,Tullsen; Dean Michael,0,6,0,0
1668594729475,CSE 290,G00,102440,Christensen; Henrik I,0,8,20,20
1668594729904,CSE 291,A00,102443,Su; Hao,0,0,0,0
1668594729904,CSE 291,B00,102448,Polikarpova; Nadezhda,0,0,0,0
1668594729904,CSE 291,C00,102453,Vaccaro; Kristen Marie,0,0,0,0
1668594729904,CSE 291,D00,111343,Savage; Stefan,0,0,0,0
1668594729904,CSE 291,E00,116474,Claffy; Kimberly Claire,0,0,0,0
1668594729904,CSE 291,F00,116479,Pasquale; Joseph,0,0,0,0
1668594730359,CSE 293,001,119111,Bafna; Vineet,9999,0,9999,0
1668594730359,CSE 293,002,119118,Bellare; Mihir,9999,0,9999,0
1668594730359,CSE 293,003,119122,Berg-Kirkpatrick; Taylor D,9999,0,9999,0
1668594730359,CSE 293,004,119135,Christensen; Henrik I,9999,0,9999,0
1668594730359,CSE 293,005,119142,Cottrell; Garrison W,9999,0,9999,0
1668594730359,CSE 293,006,119146,Deutsch; Alin Bernard,9999,0,9999,0
1668594730359,CSE 293,007,119159,Esmaeilzadeh; Hadi,9999,0,9999,0
1668594730359,CSE 293,008,119166,Freund; Yoav,9999,0,9999,0
1668594730359,CSE 293,009,119170,Griswold; William G.,9999,0,9999,0
1668594730359,CSE 293,010,119183,Gymrek; Melissa Ann,9999,0,9999,0
1668594730359,CSE 293,011,119190,Heninger; Nadia A,9999,0,9999,0
1668594730359,CSE 293,012,119230,Impagliazzo; Russell,9999,0,9999,0
1668594730359,CSE 293,013,119232,Jhala; Ranjit,9999,0,9999,0
1668594730359,CSE 293,014,119233,Kahng; Andrew Byun,9999,0,9999,0
1668594730359,CSE 293,015,119298,Kane; Daniel Mertz,9999,0,9999,0
1668594730359,CSE 293,016,119299,Kriegman; David J,9999,0,9999,0
1668594730359,CSE 293,017,119300,Kumar; Arun Kumar,9999,0,9999,0
1668594730359,CSE 293,018,119301,Lerner; Sorin,9999,0,9999,0
1668594730359,CSE 293,019,119302,Lovett; Shachar,9999,0,9999,0
1668594730359,CSE 293,020,119303,McAuley; Julian John,9999,0,9999,0
1668594730359,CSE 293,021,119304,Micciancio; Daniele,9999,0,9999,0
1668594730359,CSE 293,022,119367,Orailoglu; Alex,9999,0,9999,0
1668594730359,CSE 293,023,119382,Paturi; Ramamohan,9999,0,9999,0
1668594730359,CSE 293,024,119404,Polikarpova; Nadezhda,9999,0,9999,0
1668594730359,CSE 293,025,119406,Politz; Joseph Gibbs,9999,0,9999,0
1668594730359,CSE 293,026,119411,Porter; George M,9999,0,9999,0
1668594730359,CSE 293,027,119414,Porter; Leonard Emerson,9999,0,9999,0
1668594730359,CSE 293,028,119416,Ramamoorthi; Ravi,9999,0,9999,0
1668594730359,CSE 293,029,119417,Sahoo; Debashis,9999,0,9999,0
1668594730359,CSE 293,030,119420,Saul; Lawrence,9999,0,9999,0
1668594730359,CSE 293,031,119421,Savage; Stefan,9999,0,9999,0
1668594730359,CSE 293,032,119425,Schulze; Jurgen P.,9999,0,9999,0
1668594730359,CSE 293,033,119426,Snoeren; Alex C.,9999,0,9999,0
1668594730359,CSE 293,034,119428,Shang; Jingbo,9999,0,9999,0
1668594730359,CSE 293,035,119430,Stefan; Deian,9999,0,9999,0
1668594730359,CSE 293,036,119431,Su; Hao,9999,0,9999,0
1668594730359,CSE 293,037,119433,Swanson; Steven James,9999,0,9999,0
1668594730359,CSE 293,038,119435,Tullsen; Dean Michael,9999,0,9999,0
1668594730359,CSE 293,039,119483,Voelker; Geoffrey M.,9999,0,9999,0
1668594730359,CSE 293,040,119537,Zhao; Jishen,9999,0,9999,0
1668594730359,CSE 293,041,119538,Zhou; Yuan-Yuan,9999,0,9999,0
1668594730359,CSE 293,042,119539,Gao; Sicun,9999,0,9999,0
1668594730359,CSE 293,043,119540,Weibel; Nadir,9999,0,9999,0
1668594730359,CSE 293,044,119541,Gupta; Rajesh K.,9999,0,9999,0
1668594730359,CSE 293,045,126410,Vaccaro; Kristen Marie,9999,0,9999,0
1668594730359,CSE 293,046,126411,Klemke; Richard,9999,0,9999,0
1668594730787,CSE 294,A00,102459,Voelker; Geoffrey M.,0,2,0,0
1668594730787,CSE 294,B00,111322,Orailoglu; Alex,0,2,0,0
1668594731216,DSE 201,A00,096914,Deutsch; Alin Bernard,30,0,30,0
1668594731640,DSE 210,A00,096915,Dasgupta; Sanjoy,30,0,30,0
1668594732066,DSE 241,A00,144528,Smith; Neil Gordon,30,0,30,0
1668594732490,DSE 260A,A00,096916,Altintas De Callaf; Ilkay,30,0,30,0
1668594732948,ECE 200,001,103586,Antipa; Nicholas A,9999,0,9999,0
1668594732948,ECE 200,002,103587,Atanasov; Nikolay A.,9999,0,9999,0
1668594732948,ECE 200,003,103588,Bharadia; Dinesh,9999,0,9999,0
1668594732948,ECE 200,004,103589,Cheng; Chung Kuan,9999,0,9999,0
1668594732948,ECE 200,005,103590,Cosman; Pamela C.,9999,0,9999,0
1668594732948,ECE 200,006,103591,Dayeh; Shadi Ahmad,9999,0,9999,0
1668594732948,ECE 200,007,103592,Fainman; Yeshaiahu,9999,0,9999,0
1668594732948,ECE 200,008,103593,Ford; Joseph Earl,9999,0,9999,0
1668594732948,ECE 200,009,103594,Franceschetti; Massimo,9999,0,9999,0
1668594732948,ECE 200,010,103595,Fullerton; Eric E,9999,0,9999,0
1668594732948,ECE 200,011,103596,Galton; Ian A,9999,0,9999,0
1668594732948,ECE 200,012,103597,Gilja; Vikash,9999,0,9999,0
1668594732948,ECE 200,013,103598,Hall; Drew A.,9999,0,9999,0
1668594732948,ECE 200,014,103599,Hsueh; Tzu-Chien,9999,0,9999,0
1668594732948,ECE 200,015,103600,Javidi; Tara,9999,0,9999,0
1668594732948,ECE 200,016,103601,Kahng; Andrew Byun,9999,0,9999,0
1668594732948,ECE 200,017,103602,Kim; Young-Han,9999,0,9999,0
1668594732948,ECE 200,018,103603,Koushanfar; Farinaz,9999,0,9999,0
1668594732948,ECE 200,019,103604,Kuzum; Duygu,9999,0,9999,0
1668594732948,ECE 200,020,103605,Le; Hanh-Phuc,9999,0,9999,0
1668594732948,ECE 200,021,103606,Lin; Bill,9999,0,9999,0
1668594732948,ECE 200,022,103607,Liu; Zhaowei,9998,0,9999,1
1668594732948,ECE 200,023,103608,Lo; Yu-Hwa,9999,0,9999,0
1668594732948,ECE 200,024,103609,Lomakin; Vitaliy,9999,0,9999,0
1668594732948,ECE 200,025,103610,Mercier; Patrick Philip,9999,0,9999,0
1668594732948,ECE 200,026,103611,Meyer; Florian,9999,0,9999,0
1668594732948,ECE 200,027,103612,Milstein; Laurence B.,9999,0,9999,0
1668594732948,ECE 200,028,103613,Mir Arabbaygi; Siavash,9999,0,9999,0
1668594732948,ECE 200,029,103614,Mookherjea; Shayan,9999,0,9999,0
1668594732948,ECE 200,030,103615,Morris; Karcher William,9999,0,9999,0
1668594732948,ECE 200,031,103616,Ng; Tse Nga,9999,0,9999,0
1668594732948,ECE 200,032,103617,Nguyen; Truong Quang,9999,0,9999,0
1668594732948,ECE 200,033,103618,Nomura; Kenji,9999,0,9999,0
1668594732948,ECE 200,034,103619,Orlitsky; Alon,9999,0,9999,0
1668594732948,ECE 200,035,103620,Pal; Piya,9999,0,9999,0
1668594732948,ECE 200,036,103621,Papen; George C.,9999,0,9999,0
1668594732948,ECE 200,037,103622,Radic; Stojan,9999,0,9999,0
1668594732948,ECE 200,038,103623,Rao; Bhaskar D.,9999,0,9999,0
1668594732948,ECE 200,039,103624,Rao; Ramesh R,9999,0,9999,0
1668594732948,ECE 200,040,103625,Rebeiz; Gabriel,9999,0,9999,0
1668594732948,ECE 200,041,103626,Sanford; John R,9999,0,9999,0
1668594732948,ECE 200,042,103627,Siegel; Paul H.,9999,0,9999,0
1668594732948,ECE 200,043,103628,Sievenpiper; Daniel F.,9999,0,9999,0
1668594732948,ECE 200,044,103629,Sworder; David D.,9999,0,9999,0
1668594732948,ECE 200,045,103630,Taur; Yuan,9999,0,9999,0
1668594732948,ECE 200,046,103631,Touri; Behrouz,9999,0,9999,0
1668594732948,ECE 200,047,103632,Trivedi; Mohan M.,9999,0,9999,0
1668594732948,ECE 200,048,103633,Vasconcelos; Nuno,9999,0,9999,0
1668594732948,ECE 200,049,103634,Wang; Xiaolong,9999,0,9999,0
1668594732948,ECE 200,050,103635,Xie; Pengtao,9999,0,9999,0
1668594732948,ECE 200,051,103636,Yip; Michael,9999,0,9999,0
1668594732948,ECE 200,052,103637,Zeger; Kenneth A.,999,0,999,0
1668594732948,ECE 200,053,103638,Zhang; Xinyu,9999,0,9999,0
1668594732948,ECE 200,054,103639,Turakhia; Yatish Girish,9999,0,9999,0
1668594732948,ECE 200,055,103640,Kang; Mingu,9999,0,9999,0
1668594732948,ECE 200,056,103641,Shi; Yuanyuan,9999,0,9999,0
1668594732948,ECE 200,057,103642,Wang; Edward Jay,9999,0,9999,0
1668594732948,ECE 200,058,103643,Zheng; Yang,9999,0,9999,0
1668594733372,ECE 202,A00,103644,Kuzum; Duygu,0,47,0,0
1668594733797,ECE 212BN,A00,103646,Ng; Tse Nga,0,10,0,0
1668594734222,ECE 221,A00,111493,Staff,0,0,0,0
1668594734645,ECE 222B,A00,103647,Lomakin; Vitaliy,0,22,0,0
1668594735071,ECE 230B,A00,103648,Taur; Yuan,0,4,0,0
1668594735502,ECE 238B,A00,103649,Garay; Javier,0,0,0,0
1668594735929,ECE 240B,A00,112900,Fainman; Yeshaiahu,0,8,0,0
1668594736354,ECE 247A,A00,103650,Jokerst; Jesse Vincent,0,6,0,0
1668594736781,ECE 247B,A00,103651,Wang; Joseph,0,14,0,0
1668594737209,ECE 250,A00,103652,Siegel; Paul H.,0,85,0,0
1668594737634,ECE 251A,A00,103654,Rao; Bhaskar D.,0,65,0,0
1668594738061,ECE 257B,A00,103655,Bharadia; Dinesh,0,33,0,0
1668594738490,ECE 258A,A00,103656,Milstein; Laurence B.,0,29,0,0
1668594738918,ECE 260B,A00,103658,Kang; Mingu,0,121,0,0
1668594739354,ECE 264A,A00,103659,Galton; Ian A,0,42,0,34
1668594739789,ECE 265A,A00,103661,Gudem; Prasad S.S.,0,41,0,37
1668594740214,ECE 265D,A00,103662,Gudem; Prasad S.S.,0,27,0,0
1668594740654,ECE 268,A00,103663,Koushanfar; Farinaz,0,44,0,0
1668594741086,ECE 269,A01,103665,Pal; Piya,0,223,0,0
1668594741513,ECE 271B,A00,103666,Vasconcelos; Manuela,0,80,0,0
1668594741943,ECE 276A,A00,103667,Atanasov; Nikolay A.,0,127,0,0
1668594742375,ECE 277,A00,103668,An; Cheolhong,0,151,0,0
1668594742905,ECE 279,A00,117947,Hall; Drew A.,0,22,0,0
1668594743753,ECE 283,A00,103670,Hsueh; Tzu-Chien,0,57,0,0
1668594744179,ECE 284,A00,103671,Turakhia; Yatish Girish,0,40,0,0
1668594744603,ECE 285,A00,103672,Zheng; Yang,0,40,0,0
1668594744603,ECE 285,B00,103673,Sworder; David D.,0,61,0,0
1668594745029,ECE 287,A00,103676,Javidi; Tara,0,7,0,0
1668594745460,MATH 200B,A00,098023,Salehi Golsefidy; Alireza,7,0,15,8
1668594745886,MATH 202B,A00,098024,Rhoades; Brendon Patrick,7,0,15,8
1668594746316,MATH 203B,A00,098025,Oprea; Dragos N.,9,0,15,6
1668594746739,MATH 204B,A00,098026,Sorensen; Claus M,13,0,15,2
1668594747163,MATH 208,A00,098027,Izadi; Elham,7,0,10,3
1668594747587,MATH 209,A00,098028,Pollack; Aaron,10,0,10,0
1668594748017,MATH 211A,A00,112919,Rogalski; Daniel,8,0,10,2
1668594748440,MATH 211B,A00,112920,Seward; Brandon M.,9,0,10,1
1668594748867,MATH 218,A00,098029,Li; Bo,10,0,10,0
1668594749292,MATH 220B,A00,098030,Novak; Jonathan I,10,0,15,5
1668594749717,MATH 221A,A00,098031,Ebenfelt; Peter F,12,0,15,3
1668594750141,MATH 231B,A00,098032,Zlatos; Andrej,9,0,15,6
1668594750570,MATH 240B,A00,098033,Ni; Lei,7,0,15,8
1668594750995,MATH 243,A00,098034,Jekel; David Andrew,10,0,10,0
1668594751428,MATH 245A,A00,098035,Nie; Jiawang,0,8,15,18
1668594751856,MATH 248,A00,098036,Bejenaru; Ioan,10,0,10,0
1668594752284,MATH 250B,A00,098037,Spolaor; Luca,12,0,15,3
1668594752731,MATH 258,A00,098038,Ni; Lei,8,0,10,2
1668594753157,MATH 264B,A00,098041,Rhoades; Brendon Patrick,6,0,15,9
1668594753588,MATH 268,A00,098042,Buss; Samuel R,10,0,10,0
1668594754014,MATH 269,A00,098043,Rhoades; Brendon Patrick,10,0,10,0
1668594754439,MATH 270B,A00,098044,Li; Bo,6,0,15,9
1668594754868,MATH 272B,A00,098045,Holst; Michael J,13,0,15,2
1668594755307,MATH 273A,A00,098046,Tian; Xiaochuan,10,0,15,5
1668594755732,MATH 275,A01,098048,Tian; Xiaochuan,6,0,10,4
1668594756156,MATH 278A,A00,098049,Holst; Michael J,6,0,10,4
1668594756584,MATH 278B,A00,098050,Cloninger; Alexander,10,0,10,0
1668594757016,MATH 278C,A00,098051,Nie; Jiawang,5,0,10,5
1668594757441,MATH 280B,A00,098052,Zheng; Tianyi,6,0,15,9
1668594757865,MATH 281B,A00,098053,Bradic; Jelena,0,2,15,15
1668594758295,MATH 282B,A00,098054,Arias-Castro; Ery,0,1,15,15
1668594758747,MATH 285,A00,098055,Fitzsimmons; Patrick J,0,4,15,16
1668594759171,MATH 287B,A00,098056,Arias-Castro; Ery,1,0,15,14
1668594759611,MATH 288,A00,098057,Agarwal; Pooja,9,0,10,1
1668594759611,MATH 288,B00,098058,Zhang; Danna,8,0,10,2
1668594759611,MATH 288,C00,098059,Williams; Ruth J,9,0,10,1
1668594760054,MATH 290B,A00,098060,Roberts; Justin Deritter,12,0,15,3
1668594760479,MATH 292,A00,098061,Belmont; Eva Kinoshita,10,0,10,0
1668594760908,MATH 295,A00,098062,Suk; Andrew Hoon,47,0,50,3
1668594761347,MATH 296,A00,098063,Novak; Jonathan I,20,0,20,0
1668594761773,MATH 297,001,098064,Gamst; Anthony Collins,9997,0,9999,2
1668595266122,COGS 205,A00,101395,Chiba; Andrea,19,0,20,1
1668595266549,COGS 210B,001,101404,Greene; Deanna Jacquelyn,9998,0,9999,1
1668595266549,COGS 210B,002,101417,Xia; Haijun,9999,0,9999,0
1668595266549,COGS 210B,003,101422,Nitz; Douglas A.,9999,0,9999,0
1668595266549,COGS 210B,004,101423,Hollan; James D.,9998,0,9999,1
1668595266549,COGS 210B,005,101424,Deak; Gedeon O.,9998,0,9999,1
1668595266549,COGS 210B,006,101425,Rossano; Federico,9999,0,9999,0
1668595266975,COGS 211B,A00,101427,Coulson; Seana M,9996,0,9999,3
1668595267419,COGS 220,A00,101428,Hollan; James D.,0,17,25,25
1668595267843,COGS 229,A00,101429,Dow; Steven P,17,0,25,8
1668595268268,COGS 230,A00,101430,Klemmer; Scott R,6,0,17,11
1668595268695,COGS 234,A00,101431,Xia; Haijun,0,1,25,25
1668595269126,COGS 260,A00,101432,Kiyonaga; Anastasia,21,0,25,4
1668595269126,COGS 260,B00,101433,Kirsh; David Joel,15,0,25,10
1668595269552,CSE 202,A00,102371,Impagliazzo; Russell,0,70,0,0
1668595269980,CSE 203B,A01,102373,Cheng; Chung Kuan,0,70,0,0
1668595270421,CSE 208,A00,102374,Micciancio; Daniele,0,5,0,0
1668595270847,CSE 209A,A00,112895,Impagliazzo; Russell,0,14,15,15
1668595271271,CSE 209B,A00,108005,Bellare; Mihir,0,7,0,0
1668595271697,CSE 210,A00,113163,Coblenz; Michael J,0,96,0,0
1668595272121,CSE 219,A00,106111,Dow; Steven P,0,8,20,20
1668595272546,CSE 221,A00,102376,Voelker; Geoffrey M.,0,78,0,0
1668595272973,CSE 224,A01,102378,Porter; George M,0,181,0,0
1668595273402,CSE 229A,A00,102379,Savage; Stefan,0,14,0,0
1668595273832,CSE 229C,A00,102380,Munyaka; Imani N. S.,0,12,0,0
1668595274257,CSE 232B,A00,102382,Deutsch; Alin Bernard,0,40,0,0
1668595274682,CSE 234,A01,112904,Kumar; Arun Kumar,0,0,0,0
1668595275108,CSE 237A,A00,102383,Rosing; Tajana Simunic,0,57,0,0
1668595275531,CSE 239A,A00,102384,Deutsch; Alin Bernard,0,18,0,0
1668595275954,CSE 239B,A00,102385,Polikarpova; Nadezhda,0,11,0,0
1668595276380,CSE 240A,A00,102386,Pannuto; Patrick William,0,49,0,0
1668595276811,CSE 240B,A00,102387,Zhao; Jishen,0,51,0,0
1668595277239,CSE 241A,A00,106406,Kang; Mingu,0,9,0,0
1668595277663,CSE 249B,A00,102388,Kahng; Andrew Byun,0,7,8,8
1668595278098,CSE 251B,A01,102392,Cottrell; Garrison W,0,54,0,0
1668595278098,CSE 251B,A02,102393,Cottrell; Garrison W,0,36,0,0
1668595278522,CSE 252B,A00,102394,Ochoa; Benjamin Lawrence,0,64,0,0
1668595278948,CSE 257,A01,102396,Gao; Sicun,0,160,0,0
1668595279376,CSE 272,A00,102397,Li; Tzumao,0,22,0,0
1668595279801,CSE 274,A00,111323,Chern; Albert Ren-Haur,0,16,0,0
1668595280232,CSE 282,A00,102398,Pevzner; Pavel Arkadjevich,0,0,0,0
1668595280657,CSE 284,A00,114175,Gymrek; Melissa Ann,0,33,0,0
1668595281088,CSE 290,A00,102399,Chandraker; Manmohan Krishna,0,11,0,0
1668595281088,CSE 290,B00,102400,Vaccaro; Kristen Marie,0,10,25,25
1668595281088,CSE 290,C00,102414,Pannuto; Patrick William,0,1,25,25
1668595281088,CSE 290,D00,102427,Pevzner; Pavel Arkadjevich,0,0,0,0
1668595281088,CSE 290,E00,102429,Zhao; Jishen,0,6,0,0
1668595281088,CSE 290,F00,102436,Tullsen; Dean Michael,0,6,0,0
1668595281088,CSE 290,G00,102440,Christensen; Henrik I,0,8,20,20
1668595281518,CSE 291,A00,102443,Su; Hao,0,0,0,0
1668595281518,CSE 291,B00,102448,Polikarpova; Nadezhda,0,0,0,0
1668595281518,CSE 291,C00,102453,Vaccaro; Kristen Marie,0,0,0,0
1668595281518,CSE 291,D00,111343,Savage; Stefan,0,0,0,0
1668595281518,CSE 291,E00,116474,Claffy; Kimberly Claire,0,0,0,0
1668595281518,CSE 291,F00,116479,Pasquale; Joseph,0,0,0,0
1668595281962,CSE 293,001,119111,Bafna; Vineet,9999,0,9999,0
1668595281962,CSE 293,002,119118,Bellare; Mihir,9999,0,9999,0
1668595281962,CSE 293,003,119122,Berg-Kirkpatrick; Taylor D,9999,0,9999,0
1668595281962,CSE 293,004,119135,Christensen; Henrik I,9999,0,9999,0
1668595281962,CSE 293,005,119142,Cottrell; Garrison W,9999,0,9999,0
1668595281962,CSE 293,006,119146,Deutsch; Alin Bernard,9999,0,9999,0
1668595281962,CSE 293,007,119159,Esmaeilzadeh; Hadi,9999,0,9999,0
1668595281962,CSE 293,008,119166,Freund; Yoav,9999,0,9999,0
1668595281962,CSE 293,009,119170,Griswold; William G.,9999,0,9999,0
1668595281962,CSE 293,010,119183,Gymrek; Melissa Ann,9999,0,9999,0
1668595281962,CSE 293,011,119190,Heninger; Nadia A,9999,0,9999,0
1668595281962,CSE 293,012,119230,Impagliazzo; Russell,9999,0,9999,0
1668595281962,CSE 293,013,119232,Jhala; Ranjit,9999,0,9999,0
1668595281962,CSE 293,014,119233,Kahng; Andrew Byun,9999,0,9999,0
1668595281962,CSE 293,015,119298,Kane; Daniel Mertz,9999,0,9999,0
1668595281962,CSE 293,016,119299,Kriegman; David J,9999,0,9999,0
1668595281962,CSE 293,017,119300,Kumar; Arun Kumar,9999,0,9999,0
1668595281962,CSE 293,018,119301,Lerner; Sorin,9999,0,9999,0
1668595281962,CSE 293,019,119302,Lovett; Shachar,9999,0,9999,0
1668595281962,CSE 293,020,119303,McAuley; Julian John,9999,0,9999,0
1668595281962,CSE 293,021,119304,Micciancio; Daniele,9999,0,9999,0
1668595281962,CSE 293,022,119367,Orailoglu; Alex,9999,0,9999,0
1668595281962,CSE 293,023,119382,Paturi; Ramamohan,9999,0,9999,0
1668595281962,CSE 293,024,119404,Polikarpova; Nadezhda,9999,0,9999,0
1668595281962,CSE 293,025,119406,Politz; Joseph Gibbs,9999,0,9999,0
1668595281962,CSE 293,026,119411,Porter; George M,9999,0,9999,0
1668595281962,CSE 293,027,119414,Porter; Leonard Emerson,9999,0,9999,0
1668595281962,CSE 293,028,119416,Ramamoorthi; Ravi,9999,0,9999,0
1668595281962,CSE 293,029,119417,Sahoo; Debashis,9999,0,9999,0
1668595281962,CSE 293,030,119420,Saul; Lawrence,9999,0,9999,0
1668595281962,CSE 293,031,119421,Savage; Stefan,9999,0,9999,0
1668595281962,CSE 293,032,119425,Schulze; Jurgen P.,9999,0,9999,0
1668595281962,CSE 293,033,119426,Snoeren; Alex C.,9999,0,9999,0
1668595281962,CSE 293,034,119428,Shang; Jingbo,9999,0,9999,0
1668595281962,CSE 293,035,119430,Stefan; Deian,9999,0,9999,0
1668595281962,CSE 293,036,119431,Su; Hao,9999,0,9999,0
1668595281962,CSE 293,037,119433,Swanson; Steven James,9999,0,9999,0
1668595281962,CSE 293,038,119435,Tullsen; Dean Michael,9999,0,9999,0
1668595281962,CSE 293,039,119483,Voelker; Geoffrey M.,9999,0,9999,0
1668595281962,CSE 293,040,119537,Zhao; Jishen,9999,0,9999,0
1668595281962,CSE 293,041,119538,Zhou; Yuan-Yuan,9999,0,9999,0
1668595281962,CSE 293,042,119539,Gao; Sicun,9999,0,9999,0
1668595281962,CSE 293,043,119540,Weibel; Nadir,9999,0,9999,0
1668595281962,CSE 293,044,119541,Gupta; Rajesh K.,9999,0,9999,0
1668595281962,CSE 293,045,126410,Vaccaro; Kristen Marie,9999,0,9999,0
1668595281962,CSE 293,046,126411,Klemke; Richard,9999,0,9999,0
1668595282391,CSE 294,A00,102459,Voelker; Geoffrey M.,0,2,0,0
1668595282391,CSE 294,B00,111322,Orailoglu; Alex,0,2,0,0
1668595282817,DSE 201,A00,096914,Deutsch; Alin Bernard,30,0,30,0
1668595283242,DSE 210,A00,096915,Dasgupta; Sanjoy,30,0,30,0
1668595283668,DSE 241,A00,144528,Smith; Neil Gordon,30,0,30,0
1668595284093,DSE 260A,A00,096916,Altintas De Callaf; Ilkay,30,0,30,0
1668595284550,ECE 200,001,103586,Antipa; Nicholas A,9999,0,9999,0
1668595284550,ECE 200,002,103587,Atanasov; Nikolay A.,9999,0,9999,0
1668595284550,ECE 200,003,103588,Bharadia; Dinesh,9999,0,9999,0
1668595284550,ECE 200,004,103589,Cheng; Chung Kuan,9999,0,9999,0
1668595284550,ECE 200,005,103590,Cosman; Pamela C.,9999,0,9999,0
1668595284550,ECE 200,006,103591,Dayeh; Shadi Ahmad,9999,0,9999,0
1668595284550,ECE 200,007,103592,Fainman; Yeshaiahu,9999,0,9999,0
1668595284550,ECE 200,008,103593,Ford; Joseph Earl,9999,0,9999,0
1668595284550,ECE 200,009,103594,Franceschetti; Massimo,9999,0,9999,0
1668595284550,ECE 200,010,103595,Fullerton; Eric E,9999,0,9999,0
1668595284550,ECE 200,011,103596,Galton; Ian A,9999,0,9999,0
1668595284550,ECE 200,012,103597,Gilja; Vikash,9999,0,9999,0
1668595284550,ECE 200,013,103598,Hall; Drew A.,9999,0,9999,0
1668595284550,ECE 200,014,103599,Hsueh; Tzu-Chien,9999,0,9999,0
1668595284550,ECE 200,015,103600,Javidi; Tara,9999,0,9999,0
1668595284550,ECE 200,016,103601,Kahng; Andrew Byun,9999,0,9999,0
1668595284550,ECE 200,017,103602,Kim; Young-Han,9999,0,9999,0
1668595284550,ECE 200,018,103603,Koushanfar; Farinaz,9999,0,9999,0
1668595284550,ECE 200,019,103604,Kuzum; Duygu,9999,0,9999,0
1668595284550,ECE 200,020,103605,Le; Hanh-Phuc,9999,0,9999,0
1668595284550,ECE 200,021,103606,Lin; Bill,9999,0,9999,0
1668595284550,ECE 200,022,103607,Liu; Zhaowei,9998,0,9999,1
1668595284550,ECE 200,023,103608,Lo; Yu-Hwa,9999,0,9999,0
1668595284550,ECE 200,024,103609,Lomakin; Vitaliy,9999,0,9999,0
1668595284550,ECE 200,025,103610,Mercier; Patrick Philip,9999,0,9999,0
1668595284550,ECE 200,026,103611,Meyer; Florian,9999,0,9999,0
1668595284550,ECE 200,027,103612,Milstein; Laurence B.,9999,0,9999,0
1668595284550,ECE 200,028,103613,Mir Arabbaygi; Siavash,9999,0,9999,0
1668595284550,ECE 200,029,103614,Mookherjea; Shayan,9999,0,9999,0
1668595284550,ECE 200,030,103615,Morris; Karcher William,9999,0,9999,0
1668595284550,ECE 200,031,103616,Ng; Tse Nga,9999,0,9999,0
1668595284550,ECE 200,032,103617,Nguyen; Truong Quang,9999,0,9999,0
1668595284550,ECE 200,033,103618,Nomura; Kenji,9999,0,9999,0
1668595284550,ECE 200,034,103619,Orlitsky; Alon,9999,0,9999,0
1668595284550,ECE 200,035,103620,Pal; Piya,9999,0,9999,0
1668595284550,ECE 200,036,103621,Papen; George C.,9999,0,9999,0
1668595284550,ECE 200,037,103622,Radic; Stojan,9999,0,9999,0
1668595284550,ECE 200,038,103623,Rao; Bhaskar D.,9999,0,9999,0
1668595284550,ECE 200,039,103624,Rao; Ramesh R,9999,0,9999,0
1668595284550,ECE 200,040,103625,Rebeiz; Gabriel,9999,0,9999,0
1668595284550,ECE 200,041,103626,Sanford; John R,9999,0,9999,0
1668595284550,ECE 200,042,103627,Siegel; Paul H.,9999,0,9999,0
1668595284550,ECE 200,043,103628,Sievenpiper; Daniel F.,9999,0,9999,0
1668595284550,ECE 200,044,103629,Sworder; David D.,9999,0,9999,0
1668595284550,ECE 200,045,103630,Taur; Yuan,9999,0,9999,0
1668595284550,ECE 200,046,103631,Touri; Behrouz,9999,0,9999,0
1668595284550,ECE 200,047,103632,Trivedi; Mohan M.,9999,0,9999,0
1668595284550,ECE 200,048,103633,Vasconcelos; Nuno,9999,0,9999,0
1668595284550,ECE 200,049,103634,Wang; Xiaolong,9999,0,9999,0
1668595284550,ECE 200,050,103635,Xie; Pengtao,9999,0,9999,0
1668595284550,ECE 200,051,103636,Yip; Michael,9999,0,9999,0
1668595284550,ECE 200,052,103637,Zeger; Kenneth A.,999,0,999,0
1668595284550,ECE 200,053,103638,Zhang; Xinyu,9999,0,9999,0
1668595284550,ECE 200,054,103639,Turakhia; Yatish Girish,9999,0,9999,0
1668595284550,ECE 200,055,103640,Kang; Mingu,9999,0,9999,0
1668595284550,ECE 200,056,103641,Shi; Yuanyuan,9999,0,9999,0
1668595284550,ECE 200,057,103642,Wang; Edward Jay,9999,0,9999,0
1668595284550,ECE 200,058,103643,Zheng; Yang,9999,0,9999,0
1668595284975,ECE 202,A00,103644,Kuzum; Duygu,0,47,0,0
1668595285402,ECE 212BN,A00,103646,Ng; Tse Nga,0,10,0,0
1668595285828,ECE 221,A00,111493,Staff,0,0,0,0
1668595286256,ECE 222B,A00,103647,Lomakin; Vitaliy,0,22,0,0
1668595286679,ECE 230B,A00,103648,Taur; Yuan,0,4,0,0
1668595287104,ECE 238B,A00,103649,Garay; Javier,0,0,0,0
1668595287527,ECE 240B,A00,112900,Fainman; Yeshaiahu,0,8,0,0
1668595287950,ECE 247A,A00,103650,Jokerst; Jesse Vincent,0,6,0,0
1668595288386,ECE 247B,A00,103651,Wang; Joseph,0,14,0,0
1668595288812,ECE 250,A00,103652,Siegel; Paul H.,0,85,0,0
1668595289235,ECE 251A,A00,103654,Rao; Bhaskar D.,0,65,0,0
1668595289660,ECE 257B,A00,103655,Bharadia; Dinesh,0,33,0,0
1668595290087,ECE 258A,A00,103656,Milstein; Laurence B.,0,29,0,0
1668595290517,ECE 260B,A00,103658,Kang; Mingu,0,121,0,0
1668595290941,ECE 264A,A00,103659,Galton; Ian A,0,42,0,34
1668595291372,ECE 265A,A00,103661,Gudem; Prasad S.S.,0,41,0,37
1668595291799,ECE 265D,A00,103662,Gudem; Prasad S.S.,0,27,0,0
1668595292225,ECE 268,A00,103663,Koushanfar; Farinaz,0,44,0,0
1668595292654,ECE 269,A01,103665,Pal; Piya,0,223,0,0
1668595293082,ECE 271B,A00,103666,Vasconcelos; Manuela,0,80,0,0
1668595293507,ECE 276A,A00,103667,Atanasov; Nikolay A.,0,127,0,0
1668595293935,ECE 277,A00,103668,An; Cheolhong,0,151,0,0
1668595294360,ECE 279,A00,117947,Hall; Drew A.,0,22,0,0
1668595295223,ECE 283,A00,103670,Hsueh; Tzu-Chien,0,57,0,0
1668595295651,ECE 284,A00,103671,Turakhia; Yatish Girish,0,40,0,0
1668595296075,ECE 285,A00,103672,Zheng; Yang,0,40,0,0
1668595296075,ECE 285,B00,103673,Sworder; David D.,0,61,0,0
1668595296500,ECE 287,A00,103676,Javidi; Tara,0,7,0,0
1668595296930,MATH 200B,A00,098023,Salehi Golsefidy; Alireza,7,0,15,8
1668595297355,MATH 202B,A00,098024,Rhoades; Brendon Patrick,7,0,15,8
1668595297781,MATH 203B,A00,098025,Oprea; Dragos N.,9,0,15,6
1668595298208,MATH 204B,A00,098026,Sorensen; Claus M,13,0,15,2
1668595298635,MATH 208,A00,098027,Izadi; Elham,7,0,10,3
1668595299060,MATH 209,A00,098028,Pollack; Aaron,10,0,10,0
1668595299499,MATH 211A,A00,112919,Rogalski; Daniel,8,0,10,2
1668595299929,MATH 211B,A00,112920,Seward; Brandon M.,9,0,10,1
1668595300354,MATH 218,A00,098029,Li; Bo,10,0,10,0
1668595300785,MATH 220B,A00,098030,Novak; Jonathan I,10,0,15,5
1668595301215,MATH 221A,A00,098031,Ebenfelt; Peter F,12,0,15,3
1668595301644,MATH 231B,A00,098032,Zlatos; Andrej,9,0,15,6
1668595302074,MATH 240B,A00,098033,Ni; Lei,7,0,15,8
1668595302503,MATH 243,A00,098034,Jekel; David Andrew,10,0,10,0
1668595302928,MATH 245A,A00,098035,Nie; Jiawang,0,8,15,18
1668595303353,MATH 248,A00,098036,Bejenaru; Ioan,10,0,10,0
1668595303778,MATH 250B,A00,098037,Spolaor; Luca,12,0,15,3
1668595304205,MATH 258,A00,098038,Ni; Lei,8,0,10,2
1668595304631,MATH 264B,A00,098041,Rhoades; Brendon Patrick,6,0,15,9
1668595305057,MATH 268,A00,098042,Buss; Samuel R,10,0,10,0
1668595305496,MATH 269,A00,098043,Rhoades; Brendon Patrick,10,0,10,0
1668595305920,MATH 270B,A00,098044,Li; Bo,6,0,15,9
1668595306346,MATH 272B,A00,098045,Holst; Michael J,13,0,15,2
1668595306770,MATH 273A,A00,098046,Tian; Xiaochuan,10,0,15,5
1668595307195,MATH 275,A01,098048,Tian; Xiaochuan,6,0,10,4
1668595307620,MATH 278A,A00,098049,Holst; Michael J,6,0,10,4
1668595308045,MATH 278B,A00,098050,Cloninger; Alexander,10,0,10,0
1668595308470,MATH 278C,A00,098051,Nie; Jiawang,5,0,10,5
1668595309028,MATH 280B,A00,098052,Zheng; Tianyi,6,0,15,9
1668595309462,MATH 281B,A00,098053,Bradic; Jelena,0,2,15,15
1668595309897,MATH 282B,A00,098054,Arias-Castro; Ery,0,1,15,15
1668595310323,MATH 285,A00,098055,Fitzsimmons; Patrick J,0,4,15,16
1668595310760,MATH 287B,A00,098056,Arias-Castro; Ery,1,0,15,14
1668595311191,MATH 288,A00,098057,Agarwal; Pooja,9,0,10,1
1668595311191,MATH 288,B00,098058,Zhang; Danna,8,0,10,2
1668595311191,MATH 288,C00,098059,Williams; Ruth J,9,0,10,1
1668595311621,MATH 290B,A00,098060,Roberts; Justin Deritter,12,0,15,3
1668595312054,MATH 292,A00,098061,Belmont; Eva Kinoshita,10,0,10,0
1668595312484,MATH 295,A00,098062,Suk; Andrew Hoon,47,0,50,3
1668595312911,MATH 296,A00,098063,Novak; Jonathan I,20,0,20,0
1668595313347,MATH 297,001,098064,Gamst; Anthony Collins,9997,0,9999,2
1668595827473,COGS 205,A00,101395,Chiba; Andrea,19,0,20,1
1668595827902,COGS 210B,001,101404,Greene; Deanna Jacquelyn,9998,0,9999,1
1668595827902,COGS 210B,002,101417,Xia; Haijun,9999,0,9999,0
1668595827902,COGS 210B,003,101422,Nitz; Douglas A.,9999,0,9999,0
1668595827902,COGS 210B,004,101423,Hollan; James D.,9998,0,9999,1
1668595827902,COGS 210B,005,101424,Deak; Gedeon O.,9998,0,9999,1
1668595827902,COGS 210B,006,101425,Rossano; Federico,9999,0,9999,0
1668595828344,COGS 211B,A00,101427,Coulson; Seana M,9996,0,9999,3
1668595828768,COGS 220,A00,101428,Hollan; James D.,0,17,25,25
1668595829195,COGS 229,A00,101429,Dow; Steven P,17,0,25,8
1668595829621,COGS 230,A00,101430,Klemmer; Scott R,6,0,17,11
1668595830044,COGS 234,A00,101431,Xia; Haijun,0,1,25,25
1668595830469,COGS 260,A00,101432,Kiyonaga; Anastasia,21,0,25,4
1668595830469,COGS 260,B00,101433,Kirsh; David Joel,15,0,25,10
1668595830900,CSE 202,A00,102371,Impagliazzo; Russell,0,70,0,0
1668595831326,CSE 203B,A01,102373,Cheng; Chung Kuan,0,70,0,0
1668595831752,CSE 208,A00,102374,Micciancio; Daniele,0,5,0,0
1668595832176,CSE 209A,A00,112895,Impagliazzo; Russell,0,14,15,15
1668595832601,CSE 209B,A00,108005,Bellare; Mihir,0,7,0,0
1668595833031,CSE 210,A00,113163,Coblenz; Michael J,0,96,0,0
1668595833454,CSE 219,A00,106111,Dow; Steven P,0,8,20,20
1668595833881,CSE 221,A00,102376,Voelker; Geoffrey M.,0,78,0,0
1668595834305,CSE 224,A01,102378,Porter; George M,0,181,0,0
1668595834732,CSE 229A,A00,102379,Savage; Stefan,0,14,0,0
1668595835160,CSE 229C,A00,102380,Munyaka; Imani N. S.,0,12,0,0
1668595835585,CSE 232B,A00,102382,Deutsch; Alin Bernard,0,40,0,0
1668595836010,CSE 234,A01,112904,Kumar; Arun Kumar,0,0,0,0
1668595836436,CSE 237A,A00,102383,Rosing; Tajana Simunic,0,57,0,0
1668595836860,CSE 239A,A00,102384,Deutsch; Alin Bernard,0,18,0,0
1668595837287,CSE 239B,A00,102385,Polikarpova; Nadezhda,0,11,0,0
1668595837725,CSE 240A,A00,102386,Pannuto; Patrick William,0,49,0,0
1668595838152,CSE 240B,A00,102387,Zhao; Jishen,0,51,0,0
1668595838583,CSE 241A,A00,106406,Kang; Mingu,0,9,0,0
1668595839011,CSE 249B,A00,102388,Kahng; Andrew Byun,0,7,8,8
1668595839435,CSE 251B,A01,102392,Cottrell; Garrison W,0,54,0,0
1668595839435,CSE 251B,A02,102393,Cottrell; Garrison W,0,36,0,0
1668595839858,CSE 252B,A00,102394,Ochoa; Benjamin Lawrence,0,64,0,0
1668595840282,CSE 257,A01,102396,Gao; Sicun,0,160,0,0
1668595840711,CSE 272,A00,102397,Li; Tzumao,0,22,0,0
1668595841152,CSE 274,A00,111323,Chern; Albert Ren-Haur,0,16,0,0
1668595841682,CSE 282,A00,102398,Pevzner; Pavel Arkadjevich,0,0,0,0
1668595842118,CSE 284,A00,114175,Gymrek; Melissa Ann,0,33,0,0
1668595842548,CSE 290,A00,102399,Chandraker; Manmohan Krishna,0,11,0,0
1668595842548,CSE 290,B00,102400,Vaccaro; Kristen Marie,0,10,25,25
1668595842548,CSE 290,C00,102414,Pannuto; Patrick William,0,1,25,25
1668595842548,CSE 290,D00,102427,Pevzner; Pavel Arkadjevich,0,0,0,0
1668595842548,CSE 290,E00,102429,Zhao; Jishen,0,6,0,0
1668595842548,CSE 290,F00,102436,Tullsen; Dean Michael,0,6,0,0
1668595842548,CSE 290,G00,102440,Christensen; Henrik I,0,8,20,20
1668595842974,CSE 291,A00,102443,Su; Hao,0,0,0,0
1668595842974,CSE 291,B00,102448,Polikarpova; Nadezhda,0,0,0,0
1668595842974,CSE 291,C00,102453,Vaccaro; Kristen Marie,0,0,0,0
1668595842974,CSE 291,D00,111343,Savage; Stefan,0,0,0,0
1668595842974,CSE 291,E00,116474,Claffy; Kimberly Claire,0,0,0,0
1668595842974,CSE 291,F00,116479,Pasquale; Joseph,0,0,0,0
1668595843424,CSE 293,001,119111,Bafna; Vineet,9999,0,9999,0
1668595843424,CSE 293,002,119118,Bellare; Mihir,9999,0,9999,0
1668595843424,CSE 293,003,119122,Berg-Kirkpatrick; Taylor D,9999,0,9999,0
1668595843424,CSE 293,004,119135,Christensen; Henrik I,9999,0,9999,0
1668595843424,CSE 293,005,119142,Cottrell; Garrison W,9999,0,9999,0
1668595843424,CSE 293,006,119146,Deutsch; Alin Bernard,9999,0,9999,0
1668595843424,CSE 293,007,119159,Esmaeilzadeh; Hadi,9999,0,9999,0
1668595843424,CSE 293,008,119166,Freund; Yoav,9999,0,9999,0
1668595843424,CSE 293,009,119170,Griswold; William G.,9999,0,9999,0
1668595843424,CSE 293,010,119183,Gymrek; Melissa Ann,9999,0,9999,0
1668595843424,CSE 293,011,119190,Heninger; Nadia A,9999,0,9999,0
1668595843424,CSE 293,012,119230,Impagliazzo; Russell,9999,0,9999,0
1668595843424,CSE 293,013,119232,Jhala; Ranjit,9999,0,9999,0
1668595843424,CSE 293,014,119233,Kahng; Andrew Byun,9999,0,9999,0
1668595843424,CSE 293,015,119298,Kane; Daniel Mertz,9999,0,9999,0
1668595843424,CSE 293,016,119299,Kriegman; David J,9999,0,9999,0
1668595843424,CSE 293,017,119300,Kumar; Arun Kumar,9999,0,9999,0
1668595843424,CSE 293,018,119301,Lerner; Sorin,9999,0,9999,0
1668595843424,CSE 293,019,119302,Lovett; Shachar,9999,0,9999,0
1668595843424,CSE 293,020,119303,McAuley; Julian John,9999,0,9999,0
1668595843424,CSE 293,021,119304,Micciancio; Daniele,9999,0,9999,0
1668595843424,CSE 293,022,119367,Orailoglu; Alex,9999,0,9999,0
1668595843424,CSE 293,023,119382,Paturi; Ramamohan,9999,0,9999,0
1668595843424,CSE 293,024,119404,Polikarpova; Nadezhda,9999,0,9999,0
1668595843424,CSE 293,025,119406,Politz; Joseph Gibbs,9999,0,9999,0
1668595843424,CSE 293,026,119411,Porter; George M,9999,0,9999,0
1668595843424,CSE 293,027,119414,Porter; Leonard Emerson,9999,0,9999,0
1668595843424,CSE 293,028,119416,Ramamoorthi; Ravi,9999,0,9999,0
1668595843424,CSE 293,029,119417,Sahoo; Debashis,9999,0,9999,0
1668595843424,CSE 293,030,119420,Saul; Lawrence,9999,0,9999,0
1668595843424,CSE 293,031,119421,Savage; Stefan,9999,0,9999,0
1668595843424,CSE 293,032,119425,Schulze; Jurgen P.,9999,0,9999,0
1668595843424,CSE 293,033,119426,Snoeren; Alex C.,9999,0,9999,0
1668595843424,CSE 293,034,119428,Shang; Jingbo,9999,0,9999,0
1668595843424,CSE 293,035,119430,Stefan; Deian,9999,0,9999,0
1668595843424,CSE 293,036,119431,Su; Hao,9999,0,9999,0
1668595843424,CSE 293,037,119433,Swanson; Steven James,9999,0,9999,0
1668595843424,CSE 293,038,119435,Tullsen; Dean Michael,9999,0,9999,0
1668595843424,CSE 293,039,119483,Voelker; Geoffrey M.,9999,0,9999,0
1668595843424,CSE 293,040,119537,Zhao; Jishen,9999,0,9999,0
1668595843424,CSE 293,041,119538,Zhou; Yuan-Yuan,9999,0,9999,0
1668595843424,CSE 293,042,119539,Gao; Sicun,9999,0,9999,0
1668595843424,CSE 293,043,119540,Weibel; Nadir,9999,0,9999,0
1668595843424,CSE 293,044,119541,Gupta; Rajesh K.,9999,0,9999,0
1668595843424,CSE 293,045,126410,Vaccaro; Kristen Marie,9999,0,9999,0
1668595843424,CSE 293,046,126411,Klemke; Richard,9999,0,9999,0
1668595843848,CSE 294,A00,102459,Voelker; Geoffrey M.,0,2,0,0
1668595843848,CSE 294,B00,111322,Orailoglu; Alex,0,2,0,0
1668595844272,DSE 201,A00,096914,Deutsch; Alin Bernard,30,0,30,0
1668595844702,DSE 210,A00,096915,Dasgupta; Sanjoy,30,0,30,0
1668595845128,DSE 241,A00,144528,Smith; Neil Gordon,30,0,30,0
1668595845554,DSE 260A,A00,096916,Altintas De Callaf; Ilkay,30,0,30,0
1668595846005,ECE 200,001,103586,Antipa; Nicholas A,9999,0,9999,0
1668595846005,ECE 200,002,103587,Atanasov; Nikolay A.,9999,0,9999,0
1668595846005,ECE 200,003,103588,Bharadia; Dinesh,9999,0,9999,0
1668595846005,ECE 200,004,103589,Cheng; Chung Kuan,9999,0,9999,0
1668595846005,ECE 200,005,103590,Cosman; Pamela C.,9999,0,9999,0
1668595846005,ECE 200,006,103591,Dayeh; Shadi Ahmad,9999,0,9999,0
1668595846005,ECE 200,007,103592,Fainman; Yeshaiahu,9999,0,9999,0
1668595846005,ECE 200,008,103593,Ford; Joseph Earl,9999,0,9999,0
1668595846005,ECE 200,009,103594,Franceschetti; Massimo,9999,0,9999,0
1668595846005,ECE 200,010,103595,Fullerton; Eric E,9999,0,9999,0
1668595846005,ECE 200,011,103596,Galton; Ian A,9999,0,9999,0
1668595846005,ECE 200,012,103597,Gilja; Vikash,9999,0,9999,0
1668595846005,ECE 200,013,103598,Hall; Drew A.,9999,0,9999,0
1668595846005,ECE 200,014,103599,Hsueh; Tzu-Chien,9999,0,9999,0
1668595846005,ECE 200,015,103600,Javidi; Tara,9999,0,9999,0
1668595846005,ECE 200,016,103601,Kahng; Andrew Byun,9999,0,9999,0
1668595846005,ECE 200,017,103602,Kim; Young-Han,9999,0,9999,0
1668595846005,ECE 200,018,103603,Koushanfar; Farinaz,9999,0,9999,0
1668595846005,ECE 200,019,103604,Kuzum; Duygu,9999,0,9999,0
1668595846005,ECE 200,020,103605,Le; Hanh-Phuc,9999,0,9999,0
1668595846005,ECE 200,021,103606,Lin; Bill,9999,0,9999,0
1668595846005,ECE 200,022,103607,Liu; Zhaowei,9998,0,9999,1
1668595846005,ECE 200,023,103608,Lo; Yu-Hwa,9999,0,9999,0
1668595846005,ECE 200,024,103609,Lomakin; Vitaliy,9999,0,9999,0
1668595846005,ECE 200,025,103610,Mercier; Patrick Philip,9999,0,9999,0
1668595846005,ECE 200,026,103611,Meyer; Florian,9999,0,9999,0
1668595846005,ECE 200,027,103612,Milstein; Laurence B.,9999,0,9999,0
1668595846005,ECE 200,028,103613,Mir Arabbaygi; Siavash,9999,0,9999,0
1668595846005,ECE 200,029,103614,Mookherjea; Shayan,9999,0,9999,0
1668595846005,ECE 200,030,103615,Morris; Karcher William,9999,0,9999,0
1668595846005,ECE 200,031,103616,Ng; Tse Nga,9999,0,9999,0
1668595846005,ECE 200,032,103617,Nguyen; Truong Quang,9999,0,9999,0
1668595846005,ECE 200,033,103618,Nomura; Kenji,9999,0,9999,0
1668595846005,ECE 200,034,103619,Orlitsky; Alon,9999,0,9999,0
1668595846005,ECE 200,035,103620,Pal; Piya,9999,0,9999,0
1668595846005,ECE 200,036,103621,Papen; George C.,9999,0,9999,0
1668595846005,ECE 200,037,103622,Radic; Stojan,9999,0,9999,0
1668595846005,ECE 200,038,103623,Rao; Bhaskar D.,9999,0,9999,0
1668595846005,ECE 200,039,103624,Rao; Ramesh R,9999,0,9999,0
1668595846005,ECE 200,040,103625,Rebeiz; Gabriel,9999,0,9999,0
1668595846005,ECE 200,041,103626,Sanford; John R,9999,0,9999,0
1668595846005,ECE 200,042,103627,Siegel; Paul H.,9999,0,9999,0
1668595846005,ECE 200,043,103628,Sievenpiper; Daniel F.,9999,0,9999,0
1668595846005,ECE 200,044,103629,Sworder; David D.,9999,0,9999,0
1668595846005,ECE 200,045,103630,Taur; Yuan,9999,0,9999,0
1668595846005,ECE 200,046,103631,Touri; Behrouz,9999,0,9999,0
1668595846005,ECE 200,047,103632,Trivedi; Mohan M.,9999,0,9999,0
1668595846005,ECE 200,048,103633,Vasconcelos; Nuno,9999,0,9999,0
1668595846005,ECE 200,049,103634,Wang; Xiaolong,9999,0,9999,0
1668595846005,ECE 200,050,103635,Xie; Pengtao,9999,0,9999,0
1668595846005,ECE 200,051,103636,Yip; Michael,9999,0,9999,0
1668595846005,ECE 200,052,103637,Zeger; Kenneth A.,999,0,999,0
1668595846005,ECE 200,053,103638,Zhang; Xinyu,9999,0,9999,0
1668595846005,ECE 200,054,103639,Turakhia; Yatish Girish,9999,0,9999,0
1668595846005,ECE 200,055,103640,Kang; Mingu,9999,0,9999,0
1668595846005,ECE 200,056,103641,Shi; Yuanyuan,9999,0,9999,0
1668595846005,ECE 200,057,103642,Wang; Edward Jay,9999,0,9999,0
1668595846005,ECE 200,058,103643,Zheng; Yang,9999,0,9999,0
1668595846428,ECE 202,A00,103644,Kuzum; Duygu,0,47,0,0
1668595846856,ECE 212BN,A00,103646,Ng; Tse Nga,0,10,0,0
1668595847283,ECE 221,A00,111493,Staff,0,0,0,0
1668595847709,ECE 222B,A00,103647,Lomakin; Vitaliy,0,22,0,0
1668595848133,ECE 230B,A00,103648,Taur; Yuan,0,4,0,0
1668595848559,ECE 238B,A00,103649,Garay; Javier,0,0,0,0
1668595848985,ECE 240B,A00,112900,Fainman; Yeshaiahu,0,8,0,0
1668595849409,ECE 247A,A00,103650,Jokerst; Jesse Vincent,0,6,0,0
1668595849838,ECE 247B,A00,103651,Wang; Joseph,0,14,0,0
1668595850271,ECE 250,A00,103652,Siegel; Paul H.,0,85,0,0
1668595850704,ECE 251A,A00,103654,Rao; Bhaskar D.,0,65,0,0
1668595851131,ECE 257B,A00,103655,Bharadia; Dinesh,0,33,0,0
1668595851566,ECE 258A,A00,103656,Milstein; Laurence B.,0,29,0,0
1668595851989,ECE 260B,A00,103658,Kang; Mingu,0,121,0,0
1668595852430,ECE 264A,A00,103659,Galton; Ian A,0,42,0,34
1668595852860,ECE 265A,A00,103661,Gudem; Prasad S.S.,0,41,0,37
1668595853287,ECE 265D,A00,103662,Gudem; Prasad S.S.,0,27,0,0
1668595853710,ECE 268,A00,103663,Koushanfar; Farinaz,0,44,0,0
1668595854134,ECE 269,A01,103665,Pal; Piya,0,223,0,0
1668595854578,ECE 271B,A00,103666,Vasconcelos; Manuela,0,80,0,0
1668595855016,ECE 276A,A00,103667,Atanasov; Nikolay A.,0,127,0,0
1668595855447,ECE 277,A00,103668,An; Cheolhong,0,151,0,0
1668595855878,ECE 279,A00,117947,Hall; Drew A.,0,22,0,0
1668595856732,ECE 283,A00,103670,Hsueh; Tzu-Chien,0,57,0,0
1668595857156,ECE 284,A00,103671,Turakhia; Yatish Girish,0,40,0,0
1668595857593,ECE 285,A00,103672,Zheng; Yang,0,40,0,0
1668595857593,ECE 285,B00,103673,Sworder; David D.,0,61,0,0
1668595858016,ECE 287,A00,103676,Javidi; Tara,0,7,0,0
1668595858442,MATH 200B,A00,098023,Salehi Golsefidy; Alireza,7,0,15,8
1668595858867,MATH 202B,A00,098024,Rhoades; Brendon Patrick,7,0,15,8
1668595859291,MATH 203B,A00,098025,Oprea; Dragos N.,9,0,15,6
1668595859717,MATH 204B,A00,098026,Sorensen; Claus M,13,0,15,2
1668595860141,MATH 208,A00,098027,Izadi; Elham,7,0,10,3
1668595860586,MATH 209,A00,098028,Pollack; Aaron,10,0,10,0
1668595861009,MATH 211A,A00,112919,Rogalski; Daniel,8,0,10,2
1668595861434,MATH 211B,A00,112920,Seward; Brandon M.,9,0,10,1
1668595861858,MATH 218,A00,098029,Li; Bo,10,0,10,0
1668595862283,MATH 220B,A00,098030,Novak; Jonathan I,10,0,15,5
1668595862712,MATH 221A,A00,098031,Ebenfelt; Peter F,12,0,15,3
1668595863139,MATH 231B,A00,098032,Zlatos; Andrej,9,0,15,6
1668595863564,MATH 240B,A00,098033,Ni; Lei,7,0,15,8
1668595863991,MATH 243,A00,098034,Jekel; David Andrew,10,0,10,0
1668595864417,MATH 245A,A00,098035,Nie; Jiawang,0,8,15,18
1668595864844,MATH 248,A00,098036,Bejenaru; Ioan,10,0,10,0
1668595865269,MATH 250B,A00,098037,Spolaor; Luca,12,0,15,3
1668595865709,MATH 258,A00,098038,Ni; Lei,8,0,10,2
1668595866134,MATH 264B,A00,098041,Rhoades; Brendon Patrick,6,0,15,9
1668595866571,MATH 268,A00,098042,Buss; Samuel R,10,0,10,0
1668595866996,MATH 269,A00,098043,Rhoades; Brendon Patrick,10,0,10,0
1668595867433,MATH 270B,A00,098044,Li; Bo,6,0,15,9
1668595867859,MATH 272B,A00,098045,Holst; Michael J,13,0,15,2
1668595868284,MATH 273A,A00,098046,Tian; Xiaochuan,10,0,15,5
1668595868710,MATH 275,A01,098048,Tian; Xiaochuan,6,0,10,4
1668595869132,MATH 278A,A00,098049,Holst; Michael J,6,0,10,4
1668595869560,MATH 278B,A00,098050,Cloninger; Alexander,10,0,10,0
1668595869985,MATH 278C,A00,098051,Nie; Jiawang,5,0,10,5
1668595870409,MATH 280B,A00,098052,Zheng; Tianyi,6,0,15,9
1668595870837,MATH 281B,A00,098053,Bradic; Jelena,0,2,15,15
1668595871261,MATH 282B,A00,098054,Arias-Castro; Ery,0,1,15,15
1668595871686,MATH 285,A00,098055,Fitzsimmons; Patrick J,0,4,15,16
1668595872113,MATH 287B,A00,098056,Arias-Castro; Ery,1,0,15,14
1668595872541,MATH 288,A00,098057,Agarwal; Pooja,9,0,10,1
1668595872541,MATH 288,B00,098058,Zhang; Danna,8,0,10,2
1668595872541,MATH 288,C00,098059,Williams; Ruth J,9,0,10,1
1668595872968,MATH 290B,A00,098060,Roberts; Justin Deritter,12,0,15,3
1668595873393,MATH 292,A00,098061,Belmont; Eva Kinoshita,10,0,10,0
1668595873818,MATH 295,A00,098062,Suk; Andrew Hoon,47,0,50,3
1668595874241,MATH 296,A00,098063,Novak; Jonathan I,20,0,20,0
1668595874665,MATH 297,001,098064,Gamst; Anthony Collins,9997,0,9999,2
1668596378317,COGS 205,A00,101395,Chiba; Andrea,19,0,20,1
1668596378752,COGS 210B,001,101404,Greene; Deanna Jacquelyn,9998,0,9999,1
1668596378752,COGS 210B,002,101417,Xia; Haijun,9999,0,9999,0
1668596378752,COGS 210B,003,101422,Nitz; Douglas A.,9999,0,9999,0
1668596378752,COGS 210B,004,101423,Hollan; James D.,9998,0,9999,1
1668596378752,COGS 210B,005,101424,Deak; Gedeon O.,9998,0,9999,1
1668596378752,COGS 210B,006,101425,Rossano; Federico,9999,0,9999,0
1668596379179,COGS 211B,A00,101427,Coulson; Seana M,9996,0,9999,3
1668596379604,COGS 220,A00,101428,Hollan; James D.,0,17,25,25
1668596380034,COGS 229,A00,101429,Dow; Steven P,17,0,25,8
1668596380458,COGS 230,A00,101430,Klemmer; Scott R,6,0,17,11
1668596380891,COGS 234,A00,101431,Xia; Haijun,0,1,25,25
1668596381318,COGS 260,A00,101432,Kiyonaga; Anastasia,21,0,25,4
1668596381318,COGS 260,B00,101433,Kirsh; David Joel,15,0,25,10
1668596381747,CSE 202,A00,102371,Impagliazzo; Russell,0,70,0,0
1668596382180,CSE 203B,A01,102373,Cheng; Chung Kuan,0,70,0,0
1668596382618,CSE 208,A00,102374,Micciancio; Daniele,0,5,0,0
1668596383055,CSE 209A,A00,112895,Impagliazzo; Russell,0,14,15,15
1668596383484,CSE 209B,A00,108005,Bellare; Mihir,0,7,0,0
1668596383909,CSE 210,A00,113163,Coblenz; Michael J,0,96,0,0
1668596384337,CSE 219,A00,106111,Dow; Steven P,0,8,20,20
1668596384769,CSE 221,A00,102376,Voelker; Geoffrey M.,0,78,0,0
1668596385211,CSE 224,A01,102378,Porter; George M,0,181,0,0
1668596385648,CSE 229A,A00,102379,Savage; Stefan,0,14,0,0
1668596386076,CSE 229C,A00,102380,Munyaka; Imani N. S.,0,12,0,0
1668596386502,CSE 232B,A00,102382,Deutsch; Alin Bernard,0,40,0,0
1668596386940,CSE 234,A01,112904,Kumar; Arun Kumar,0,0,0,0
1668596387366,CSE 237A,A00,102383,Rosing; Tajana Simunic,0,57,0,0
1668596387793,CSE 239A,A00,102384,Deutsch; Alin Bernard,0,18,0,0
1668596388225,CSE 239B,A00,102385,Polikarpova; Nadezhda,0,11,0,0
1668596388660,CSE 240A,A00,102386,Pannuto; Patrick William,0,49,0,0
1668596389099,CSE 240B,A00,102387,Zhao; Jishen,0,51,0,0
1668596389533,CSE 241A,A00,106406,Kang; Mingu,0,9,0,0
1668596389970,CSE 249B,A00,102388,Kahng; Andrew Byun,0,7,8,8
1668596390396,CSE 251B,A01,102392,Cottrell; Garrison W,0,54,0,0
1668596390396,CSE 251B,A02,102393,Cottrell; Garrison W,0,36,0,0
1668596390834,CSE 252B,A00,102394,Ochoa; Benjamin Lawrence,0,64,0,0
1668596391262,CSE 257,A01,102396,Gao; Sicun,0,160,0,0
1668596391693,CSE 272,A00,102397,Li; Tzumao,0,22,0,0
1668596392117,CSE 274,A00,111323,Chern; Albert Ren-Haur,0,16,0,0
1668596392558,CSE 282,A00,102398,Pevzner; Pavel Arkadjevich,0,0,0,0
1668596392982,CSE 284,A00,114175,Gymrek; Melissa Ann,0,33,0,0
1668596393414,CSE 290,A00,102399,Chandraker; Manmohan Krishna,0,11,0,0
1668596393414,CSE 290,B00,102400,Vaccaro; Kristen Marie,0,10,25,25
1668596393414,CSE 290,C00,102414,Pannuto; Patrick William,0,1,25,25
1668596393414,CSE 290,D00,102427,Pevzner; Pavel Arkadjevich,0,0,0,0
1668596393414,CSE 290,E00,102429,Zhao; Jishen,0,6,0,0
1668596393414,CSE 290,F00,102436,Tullsen; Dean Michael,0,6,0,0
1668596393414,CSE 290,G00,102440,Christensen; Henrik I,0,8,20,20
1668596393843,CSE 291,A00,102443,Su; Hao,0,0,0,0
1668596393843,CSE 291,B00,102448,Polikarpova; Nadezhda,0,0,0,0
1668596393843,CSE 291,C00,102453,Vaccaro; Kristen Marie,0,0,0,0
1668596393843,CSE 291,D00,111343,Savage; Stefan,0,0,0,0
1668596393843,CSE 291,E00,116474,Claffy; Kimberly Claire,0,0,0,0
1668596393843,CSE 291,F00,116479,Pasquale; Joseph,0,0,0,0
1668596394289,CSE 293,001,119111,Bafna; Vineet,9999,0,9999,0
1668596394289,CSE 293,002,119118,Bellare; Mihir,9999,0,9999,0
1668596394289,CSE 293,003,119122,Berg-Kirkpatrick; Taylor D,9999,0,9999,0
1668596394289,CSE 293,004,119135,Christensen; Henrik I,9999,0,9999,0
1668596394289,CSE 293,005,119142,Cottrell; Garrison W,9999,0,9999,0
1668596394289,CSE 293,006,119146,Deutsch; Alin Bernard,9999,0,9999,0
1668596394289,CSE 293,007,119159,Esmaeilzadeh; Hadi,9999,0,9999,0
1668596394289,CSE 293,008,119166,Freund; Yoav,9999,0,9999,0
1668596394289,CSE 293,009,119170,Griswold; William G.,9999,0,9999,0
1668596394289,CSE 293,010,119183,Gymrek; Melissa Ann,9999,0,9999,0
1668596394289,CSE 293,011,119190,Heninger; Nadia A,9999,0,9999,0
1668596394289,CSE 293,012,119230,Impagliazzo; Russell,9999,0,9999,0
1668596394289,CSE 293,013,119232,Jhala; Ranjit,9999,0,9999,0
1668596394289,CSE 293,014,119233,Kahng; Andrew Byun,9999,0,9999,0
1668596394289,CSE 293,015,119298,Kane; Daniel Mertz,9999,0,9999,0
1668596394289,CSE 293,016,119299,Kriegman; David J,9999,0,9999,0
1668596394289,CSE 293,017,119300,Kumar; Arun Kumar,9999,0,9999,0
1668596394289,CSE 293,018,119301,Lerner; Sorin,9999,0,9999,0
1668596394289,CSE 293,019,119302,Lovett; Shachar,9999,0,9999,0
1668596394289,CSE 293,020,119303,McAuley; Julian John,9999,0,9999,0
1668596394289,CSE 293,021,119304,Micciancio; Daniele,9999,0,9999,0
1668596394289,CSE 293,022,119367,Orailoglu; Alex,9999,0,9999,0
1668596394289,CSE 293,023,119382,Paturi; Ramamohan,9999,0,9999,0
1668596394289,CSE 293,024,119404,Polikarpova; Nadezhda,9999,0,9999,0
1668596394289,CSE 293,025,119406,Politz; Joseph Gibbs,9999,0,9999,0
1668596394289,CSE 293,026,119411,Porter; George M,9999,0,9999,0
1668596394289,CSE 293,027,119414,Porter; Leonard Emerson,9999,0,9999,0
1668596394289,CSE 293,028,119416,Ramamoorthi; Ravi,9999,0,9999,0
1668596394289,CSE 293,029,119417,Sahoo; Debashis,9999,0,9999,0
1668596394289,CSE 293,030,119420,Saul; Lawrence,9999,0,9999,0
1668596394289,CSE 293,031,119421,Savage; Stefan,9999,0,9999,0
1668596394289,CSE 293,032,119425,Schulze; Jurgen P.,9999,0,9999,0
1668596394289,CSE 293,033,119426,Snoeren; Alex C.,9999,0,9999,0
1668596394289,CSE 293,034,119428,Shang; Jingbo,9999,0,9999,0
1668596394289,CSE 293,035,119430,Stefan; Deian,9999,0,9999,0
1668596394289,CSE 293,036,119431,Su; Hao,9999,0,9999,0
1668596394289,CSE 293,037,119433,Swanson; Steven James,9999,0,9999,0
1668596394289,CSE 293,038,119435,Tullsen; Dean Michael,9999,0,9999,0
1668596394289,CSE 293,039,119483,Voelker; Geoffrey M.,9999,0,9999,0
1668596394289,CSE 293,040,119537,Zhao; Jishen,9999,0,9999,0
1668596394289,CSE 293,041,119538,Zhou; Yuan-Yuan,9999,0,9999,0
1668596394289,CSE 293,042,119539,Gao; Sicun,9999,0,9999,0
1668596394289,CSE 293,043,119540,Weibel; Nadir,9999,0,9999,0
1668596394289,CSE 293,044,119541,Gupta; Rajesh K.,9999,0,9999,0
1668596394289,CSE 293,045,126410,Vaccaro; Kristen Marie,9999,0,9999,0
1668596394289,CSE 293,046,126411,Klemke; Richard,9999,0,9999,0
1668596394714,CSE 294,A00,102459,Voelker; Geoffrey M.,0,2,0,0
1668596394714,CSE 294,B00,111322,Orailoglu; Alex,0,2,0,0
1668596395142,DSE 201,A00,096914,Deutsch; Alin Bernard,30,0,30,0
1668596395569,DSE 210,A00,096915,Dasgupta; Sanjoy,30,0,30,0
1668596395994,DSE 241,A00,144528,Smith; Neil Gordon,30,0,30,0
1668596396418,DSE 260A,A00,096916,Altintas De Callaf; Ilkay,30,0,30,0
1668596396861,ECE 200,001,103586,Antipa; Nicholas A,9999,0,9999,0
1668596396861,ECE 200,002,103587,Atanasov; Nikolay A.,9999,0,9999,0
1668596396861,ECE 200,003,103588,Bharadia; Dinesh,9999,0,9999,0
1668596396861,ECE 200,004,103589,Cheng; Chung Kuan,9999,0,9999,0
1668596396861,ECE 200,005,103590,Cosman; Pamela C.,9999,0,9999,0
1668596396861,ECE 200,006,103591,Dayeh; Shadi Ahmad,9999,0,9999,0
1668596396861,ECE 200,007,103592,Fainman; Yeshaiahu,9999,0,9999,0
1668596396861,ECE 200,008,103593,Ford; Joseph Earl,9999,0,9999,0
1668596396861,ECE 200,009,103594,Franceschetti; Massimo,9999,0,9999,0
1668596396861,ECE 200,010,103595,Fullerton; Eric E,9999,0,9999,0
1668596396861,ECE 200,011,103596,Galton; Ian A,9999,0,9999,0
1668596396861,ECE 200,012,103597,Gilja; Vikash,9999,0,9999,0
1668596396861,ECE 200,013,103598,Hall; Drew A.,9999,0,9999,0
1668596396861,ECE 200,014,103599,Hsueh; Tzu-Chien,9999,0,9999,0
1668596396861,ECE 200,015,103600,Javidi; Tara,9999,0,9999,0
1668596396861,ECE 200,016,103601,Kahng; Andrew Byun,9999,0,9999,0
1668596396861,ECE 200,017,103602,Kim; Young-Han,9999,0,9999,0
1668596396861,ECE 200,018,103603,Koushanfar; Farinaz,9999,0,9999,0
1668596396861,ECE 200,019,103604,Kuzum; Duygu,9999,0,9999,0
1668596396861,ECE 200,020,103605,Le; Hanh-Phuc,9999,0,9999,0
1668596396861,ECE 200,021,103606,Lin; Bill,9999,0,9999,0
1668596396861,ECE 200,022,103607,Liu; Zhaowei,9998,0,9999,1
1668596396861,ECE 200,023,103608,Lo; Yu-Hwa,9999,0,9999,0
1668596396861,ECE 200,024,103609,Lomakin; Vitaliy,9999,0,9999,0
1668596396861,ECE 200,025,103610,Mercier; Patrick Philip,9999,0,9999,0
1668596396861,ECE 200,026,103611,Meyer; Florian,9999,0,9999,0
1668596396861,ECE 200,027,103612,Milstein; Laurence B.,9999,0,9999,0
1668596396861,ECE 200,028,103613,Mir Arabbaygi; Siavash,9999,0,9999,0
1668596396861,ECE 200,029,103614,Mookherjea; Shayan,9999,0,9999,0
1668596396861,ECE 200,030,103615,Morris; Karcher William,9999,0,9999,0
1668596396861,ECE 200,031,103616,Ng; Tse Nga,9999,0,9999,0
1668596396861,ECE 200,032,103617,Nguyen; Truong Quang,9999,0,9999,0
1668596396861,ECE 200,033,103618,Nomura; Kenji,9999,0,9999,0
1668596396861,ECE 200,034,103619,Orlitsky; Alon,9999,0,9999,0
1668596396861,ECE 200,035,103620,Pal; Piya,9999,0,9999,0
1668596396861,ECE 200,036,103621,Papen; George C.,9999,0,9999,0
1668596396861,ECE 200,037,103622,Radic; Stojan,9999,0,9999,0
1668596396861,ECE 200,038,103623,Rao; Bhaskar D.,9999,0,9999,0
1668596396861,ECE 200,039,103624,Rao; Ramesh R,9999,0,9999,0
1668596396861,ECE 200,040,103625,Rebeiz; Gabriel,9999,0,9999,0
1668596396861,ECE 200,041,103626,Sanford; John R,9999,0,9999,0
1668596396861,ECE 200,042,103627,Siegel; Paul H.,9999,0,9999,0
1668596396861,ECE 200,043,103628,Sievenpiper; Daniel F.,9999,0,9999,0
1668596396861,ECE 200,044,103629,Sworder; David D.,9999,0,9999,0
1668596396861,ECE 200,045,103630,Taur; Yuan,9999,0,9999,0
1668596396861,ECE 200,046,103631,Touri; Behrouz,9999,0,9999,0
1668596396861,ECE 200,047,103632,Trivedi; Mohan M.,9999,0,9999,0
1668596396861,ECE 200,048,103633,Vasconcelos; Nuno,9999,0,9999,0
1668596396861,ECE 200,049,103634,Wang; Xiaolong,9999,0,9999,0
1668596396861,ECE 200,050,103635,Xie; Pengtao,9999,0,9999,0
1668596396861,ECE 200,051,103636,Yip; Michael,9999,0,9999,0
1668596396861,ECE 200,052,103637,Zeger; Kenneth A.,999,0,999,0
1668596396861,ECE 200,053,103638,Zhang; Xinyu,9999,0,9999,0
1668596396861,ECE 200,054,103639,Turakhia; Yatish Girish,9999,0,9999,0
1668596396861,ECE 200,055,103640,Kang; Mingu,9999,0,9999,0
1668596396861,ECE 200,056,103641,Shi; Yuanyuan,9999,0,9999,0
1668596396861,ECE 200,057,103642,Wang; Edward Jay,9999,0,9999,0
1668596396861,ECE 200,058,103643,Zheng; Yang,9999,0,9999,0
1668596397299,ECE 202,A00,103644,Kuzum; Duygu,0,47,0,0
1668596397731,ECE 212BN,A00,103646,Ng; Tse Nga,0,10,0,0
1668596398158,ECE 221,A00,111493,Staff,0,0,0,0
1668596398587,ECE 222B,A00,103647,Lomakin; Vitaliy,0,22,0,0
1668596399020,ECE 230B,A00,103648,Taur; Yuan,0,4,0,0
1668596399444,ECE 238B,A00,103649,Garay; Javier,0,0,0,0
1668596399876,ECE 240B,A00,112900,Fainman; Yeshaiahu,0,8,0,0
1668596400300,ECE 247A,A00,103650,Jokerst; Jesse Vincent,0,6,0,0
1668596400727,ECE 247B,A00,103651,Wang; Joseph,0,14,0,0
1668596401158,ECE 250,A00,103652,Siegel; Paul H.,0,85,0,0
1668596401582,ECE 251A,A00,103654,Rao; Bhaskar D.,0,65,0,0
1668596402022,ECE 257B,A00,103655,Bharadia; Dinesh,0,33,0,0
1668596402459,ECE 258A,A00,103656,Milstein; Laurence B.,0,29,0,0
1668596402904,ECE 260B,A00,103658,Kang; Mingu,0,121,0,0
1668596403329,ECE 264A,A00,103659,Galton; Ian A,0,42,0,34
1668596403752,ECE 265A,A00,103661,Gudem; Prasad S.S.,0,41,0,37
1668596404203,ECE 265D,A00,103662,Gudem; Prasad S.S.,0,27,0,0
1668596404632,ECE 268,A00,103663,Koushanfar; Farinaz,0,44,0,0
1668596405061,ECE 269,A01,103665,Pal; Piya,0,223,0,0
1668596405489,ECE 271B,A00,103666,Vasconcelos; Manuela,0,80,0,0
1668596405912,ECE 276A,A00,103667,Atanasov; Nikolay A.,0,127,0,0
1668596406342,ECE 277,A00,103668,An; Cheolhong,0,151,0,0
1668596406776,ECE 279,A00,117947,Hall; Drew A.,0,22,0,0
1668596407717,ECE 283,A00,103670,Hsueh; Tzu-Chien,0,57,0,0
1668596408140,ECE 284,A00,103671,Turakhia; Yatish Girish,0,40,0,0
1668596408564,ECE 285,A00,103672,Zheng; Yang,0,40,0,0
1668596408564,ECE 285,B00,103673,Sworder; David D.,0,61,0,0
1668596408988,ECE 287,A00,103676,Javidi; Tara,0,7,0,0
1668596409413,MATH 200B,A00,098023,Salehi Golsefidy; Alireza,7,0,15,8
1668596409840,MATH 202B,A00,098024,Rhoades; Brendon Patrick,7,0,15,8
1668596410268,MATH 203B,A00,098025,Oprea; Dragos N.,9,0,15,6
1668596410697,MATH 204B,A00,098026,Sorensen; Claus M,13,0,15,2
1668596411122,MATH 208,A00,098027,Izadi; Elham,7,0,10,3
1668596411550,MATH 209,A00,098028,Pollack; Aaron,10,0,10,0
1668596411977,MATH 211A,A00,112919,Rogalski; Daniel,8,0,10,2
1668596412402,MATH 211B,A00,112920,Seward; Brandon M.,9,0,10,1
1668596412826,MATH 218,A00,098029,Li; Bo,10,0,10,0
1668596413249,MATH 220B,A00,098030,Novak; Jonathan I,10,0,15,5
1668596413683,MATH 221A,A00,098031,Ebenfelt; Peter F,12,0,15,3
1668596414107,MATH 231B,A00,098032,Zlatos; Andrej,9,0,15,6
1668596414533,MATH 240B,A00,098033,Ni; Lei,7,0,15,8
1668596414958,MATH 243,A00,098034,Jekel; David Andrew,10,0,10,0
1668596415386,MATH 245A,A00,098035,Nie; Jiawang,0,8,15,18
1668596415813,MATH 248,A00,098036,Bejenaru; Ioan,10,0,10,0
1668596416245,MATH 250B,A00,098037,Spolaor; Luca,12,0,15,3
1668596416672,MATH 258,A00,098038,Ni; Lei,8,0,10,2
1668596417096,MATH 264B,A00,098041,Rhoades; Brendon Patrick,6,0,15,9
1668596417519,MATH 268,A00,098042,Buss; Samuel R,10,0,10,0
1668596417942,MATH 269,A00,098043,Rhoades; Brendon Patrick,10,0,10,0
1668596418364,MATH 270B,A00,098044,Li; Bo,6,0,15,9
1668596418788,MATH 272B,A00,098045,Holst; Michael J,13,0,15,2
1668596419216,MATH 273A,A00,098046,Tian; Xiaochuan,10,0,15,5
1668596419641,MATH 275,A01,098048,Tian; Xiaochuan,6,0,10,4
1668596420065,MATH 278A,A00,098049,Holst; Michael J,6,0,10,4
1668596420489,MATH 278B,A00,098050,Cloninger; Alexander,10,0,10,0
1668596420916,MATH 278C,A00,098051,Nie; Jiawang,5,0,10,5
1668596421341,MATH 280B,A00,098052,Zheng; Tianyi,6,0,15,9
1668596421765,MATH 281B,A00,098053,Bradic; Jelena,0,2,15,15
1668596422190,MATH 282B,A00,098054,Arias-Castro; Ery,0,1,15,15
1668596422627,MATH 285,A00,098055,Fitzsimmons; Patrick J,0,4,15,16
1668596423054,MATH 287B,A00,098056,Arias-Castro; Ery,1,0,15,14
1668596423490,MATH 288,A00,098057,Agarwal; Pooja,9,0,10,1
1668596423490,MATH 288,B00,098058,Zhang; Danna,8,0,10,2
1668596423490,MATH 288,C00,098059,Williams; Ruth J,9,0,10,1
1668596423913,MATH 290B,A00,098060,Roberts; Justin Deritter,12,0,15,3
1668596424336,MATH 292,A00,098061,Belmont; Eva Kinoshita,10,0,10,0
1668596424762,MATH 295,A00,098062,Suk; Andrew Hoon,47,0,50,3
1668596425186,MATH 296,A00,098063,Novak; Jonathan I,20,0,20,0
1668596425609,MATH 297,001,098064,Gamst; Anthony Collins,9997,0,9999,2
1668596930673,COGS 205,A00,101395,Chiba; Andrea,19,0,20,1
1668596931112,COGS 210B,001,101404,Greene; Deanna Jacquelyn,9998,0,9999,1
1668596931112,COGS 210B,002,101417,Xia; Haijun,9999,0,9999,0
1668596931112,COGS 210B,003,101422,Nitz; Douglas A.,9999,0,9999,0
1668596931112,COGS 210B,004,101423,Hollan; James D.,9998,0,9999,1
1668596931112,COGS 210B,005,101424,Deak; Gedeon O.,9998,0,9999,1
1668596931112,COGS 210B,006,101425,Rossano; Federico,9999,0,9999,0
1668596931539,COGS 211B,A00,101427,Coulson; Seana M,9996,0,9999,3
1668596931962,COGS 220,A00,101428,Hollan; James D.,0,17,25,25
1668596932385,COGS 229,A00,101429,Dow; Steven P,17,0,25,8
1668596932809,COGS 230,A00,101430,Klemmer; Scott R,6,0,17,11
1668596933236,COGS 234,A00,101431,Xia; Haijun,0,1,25,25
1668596933664,COGS 260,A00,101432,Kiyonaga; Anastasia,21,0,25,4
1668596933664,COGS 260,B00,101433,Kirsh; David Joel,15,0,25,10
1668596934089,CSE 202,A00,102371,Impagliazzo; Russell,0,70,0,0
1668596934521,CSE 203B,A01,102373,Cheng; Chung Kuan,0,70,0,0
1668596934945,CSE 208,A00,102374,Micciancio; Daniele,0,5,0,0
1668596935371,CSE 209A,A00,112895,Impagliazzo; Russell,0,14,15,15
1668596935809,CSE 209B,A00,108005,Bellare; Mihir,0,7,0,0
1668596936237,CSE 210,A00,113163,Coblenz; Michael J,0,96,0,0
1668596936667,CSE 219,A00,106111,Dow; Steven P,0,8,20,20
1668596937096,CSE 221,A00,102376,Voelker; Geoffrey M.,0,78,0,0
1668596937533,CSE 224,A01,102378,Porter; George M,0,181,0,0
1668596937977,CSE 229A,A00,102379,Savage; Stefan,0,14,0,0
1668596938418,CSE 229C,A00,102380,Munyaka; Imani N. S.,0,12,0,0
1668596938864,CSE 232B,A00,102382,Deutsch; Alin Bernard,0,40,0,0
1668596939287,CSE 234,A01,112904,Kumar; Arun Kumar,0,0,0,0
1668596939710,CSE 237A,A00,102383,Rosing; Tajana Simunic,0,57,0,0
1668596940138,CSE 239A,A00,102384,Deutsch; Alin Bernard,0,18,0,0
1668596940563,CSE 239B,A00,102385,Polikarpova; Nadezhda,0,11,0,0
1668596940988,CSE 240A,A00,102386,Pannuto; Patrick William,0,49,0,0
1668596941414,CSE 240B,A00,102387,Zhao; Jishen,0,51,0,0
1668596941841,CSE 241A,A00,106406,Kang; Mingu,0,9,0,0
1668596942273,CSE 249B,A00,102388,Kahng; Andrew Byun,0,7,8,8
1668596942700,CSE 251B,A01,102392,Cottrell; Garrison W,0,54,0,0
1668596942700,CSE 251B,A02,102393,Cottrell; Garrison W,0,36,0,0
1668596943131,CSE 252B,A00,102394,Ochoa; Benjamin Lawrence,0,64,0,0
1668596943562,CSE 257,A01,102396,Gao; Sicun,0,160,0,0
1668596943986,CSE 272,A00,102397,Li; Tzumao,0,22,0,0
1668596944411,CSE 274,A00,111323,Chern; Albert Ren-Haur,0,16,0,0
1668596944839,CSE 282,A00,102398,Pevzner; Pavel Arkadjevich,0,0,0,0
1668596945266,CSE 284,A00,114175,Gymrek; Melissa Ann,0,33,0,0
1668596945698,CSE 290,A00,102399,Chandraker; Manmohan Krishna,0,11,0,0
1668596945698,CSE 290,B00,102400,Vaccaro; Kristen Marie,0,10,25,25
1668596945698,CSE 290,C00,102414,Pannuto; Patrick William,0,1,25,25
1668596945698,CSE 290,D00,102427,Pevzner; Pavel Arkadjevich,0,0,0,0
1668596945698,CSE 290,E00,102429,Zhao; Jishen,0,6,0,0
1668596945698,CSE 290,F00,102436,Tullsen; Dean Michael,0,6,0,0
1668596945698,CSE 290,G00,102440,Christensen; Henrik I,0,8,20,20
1668596946129,CSE 291,A00,102443,Su; Hao,0,0,0,0
1668596946129,CSE 291,B00,102448,Polikarpova; Nadezhda,0,0,0,0
1668596946129,CSE 291,C00,102453,Vaccaro; Kristen Marie,0,0,0,0
1668596946129,CSE 291,D00,111343,Savage; Stefan,0,0,0,0
1668596946129,CSE 291,E00,116474,Claffy; Kimberly Claire,0,0,0,0
1668596946129,CSE 291,F00,116479,Pasquale; Joseph,0,0,0,0
1668596946585,CSE 293,001,119111,Bafna; Vineet,9999,0,9999,0
1668596946585,CSE 293,002,119118,Bellare; Mihir,9999,0,9999,0
1668596946585,CSE 293,003,119122,Berg-Kirkpatrick; Taylor D,9999,0,9999,0
1668596946585,CSE 293,004,119135,Christensen; Henrik I,9999,0,9999,0
1668596946585,CSE 293,005,119142,Cottrell; Garrison W,9999,0,9999,0
1668596946585,CSE 293,006,119146,Deutsch; Alin Bernard,9999,0,9999,0
1668596946585,CSE 293,007,119159,Esmaeilzadeh; Hadi,9999,0,9999,0
1668596946585,CSE 293,008,119166,Freund; Yoav,9999,0,9999,0
1668596946585,CSE 293,009,119170,Griswold; William G.,9999,0,9999,0
1668596946585,CSE 293,010,119183,Gymrek; Melissa Ann,9999,0,9999,0
1668596946585,CSE 293,011,119190,Heninger; Nadia A,9999,0,9999,0
1668596946585,CSE 293,012,119230,Impagliazzo; Russell,9999,0,9999,0
1668596946585,CSE 293,013,119232,Jhala; Ranjit,9999,0,9999,0
1668596946585,CSE 293,014,119233,Kahng; Andrew Byun,9999,0,9999,0
1668596946585,CSE 293,015,119298,Kane; Daniel Mertz,9999,0,9999,0
1668596946585,CSE 293,016,119299,Kriegman; David J,9999,0,9999,0
1668596946585,CSE 293,017,119300,Kumar; Arun Kumar,9999,0,9999,0
1668596946585,CSE 293,018,119301,Lerner; Sorin,9999,0,9999,0
1668596946585,CSE 293,019,119302,Lovett; Shachar,9999,0,9999,0
1668596946585,CSE 293,020,119303,McAuley; Julian John,9999,0,9999,0
1668596946585,CSE 293,021,119304,Micciancio; Daniele,9999,0,9999,0
1668596946585,CSE 293,022,119367,Orailoglu; Alex,9999,0,9999,0
1668596946585,CSE 293,023,119382,Paturi; Ramamohan,9999,0,9999,0
1668596946585,CSE 293,024,119404,Polikarpova; Nadezhda,9999,0,9999,0
1668596946585,CSE 293,025,119406,Politz; Joseph Gibbs,9999,0,9999,0
1668596946585,CSE 293,026,119411,Porter; George M,9999,0,9999,0
1668596946585,CSE 293,027,119414,Porter; Leonard Emerson,9999,0,9999,0
1668596946585,CSE 293,028,119416,Ramamoorthi; Ravi,9999,0,9999,0
1668596946585,CSE 293,029,119417,Sahoo; Debashis,9999,0,9999,0
1668596946585,CSE 293,030,119420,Saul; Lawrence,9999,0,9999,0
1668596946585,CSE 293,031,119421,Savage; Stefan,9999,0,9999,0
1668596946585,CSE 293,032,119425,Schulze; Jurgen P.,9999,0,9999,0
1668596946585,CSE 293,033,119426,Snoeren; Alex C.,9999,0,9999,0
1668596946585,CSE 293,034,119428,Shang; Jingbo,9999,0,9999,0
1668596946585,CSE 293,035,119430,Stefan; Deian,9999,0,9999,0
1668596946585,CSE 293,036,119431,Su; Hao,9999,0,9999,0
1668596946585,CSE 293,037,119433,Swanson; Steven James,9999,0,9999,0
1668596946585,CSE 293,038,119435,Tullsen; Dean Michael,9999,0,9999,0
1668596946585,CSE 293,039,119483,Voelker; Geoffrey M.,9999,0,9999,0
1668596946585,CSE 293,040,119537,Zhao; Jishen,9999,0,9999,0
1668596946585,CSE 293,041,119538,Zhou; Yuan-Yuan,9999,0,9999,0
1668596946585,CSE 293,042,119539,Gao; Sicun,9999,0,9999,0
1668596946585,CSE 293,043,119540,Weibel; Nadir,9999,0,9999,0
1668596946585,CSE 293,044,119541,Gupta; Rajesh K.,9999,0,9999,0
1668596946585,CSE 293,045,126410,Vaccaro; Kristen Marie,9999,0,9999,0
1668596946585,CSE 293,046,126411,Klemke; Richard,9999,0,9999,0
1668596947023,CSE 294,A00,102459,Voelker; Geoffrey M.,0,2,0,0
1668596947023,CSE 294,B00,111322,Orailoglu; Alex,0,2,0,0
1668596947463,DSE 201,A00,096914,Deutsch; Alin Bernard,30,0,30,0
1668596947895,DSE 210,A00,096915,Dasgupta; Sanjoy,30,0,30,0
1668596948331,DSE 241,A00,144528,Smith; Neil Gordon,30,0,30,0
1668596948758,DSE 260A,A00,096916,Altintas De Callaf; Ilkay,30,0,30,0
1668596949203,ECE 200,001,103586,Antipa; Nicholas A,9999,0,9999,0
1668596949203,ECE 200,002,103587,Atanasov; Nikolay A.,9999,0,9999,0
1668596949203,ECE 200,003,103588,Bharadia; Dinesh,9999,0,9999,0
1668596949203,ECE 200,004,103589,Cheng; Chung Kuan,9999,0,9999,0
1668596949203,ECE 200,005,103590,Cosman; Pamela C.,9999,0,9999,0
1668596949203,ECE 200,006,103591,Dayeh; Shadi Ahmad,9999,0,9999,0
1668596949203,ECE 200,007,103592,Fainman; Yeshaiahu,9999,0,9999,0
1668596949203,ECE 200,008,103593,Ford; Joseph Earl,9999,0,9999,0
1668596949203,ECE 200,009,103594,Franceschetti; Massimo,9999,0,9999,0
1668596949203,ECE 200,010,103595,Fullerton; Eric E,9999,0,9999,0
1668596949203,ECE 200,011,103596,Galton; Ian A,9999,0,9999,0
1668596949203,ECE 200,012,103597,Gilja; Vikash,9999,0,9999,0
1668596949203,ECE 200,013,103598,Hall; Drew A.,9999,0,9999,0
1668596949203,ECE 200,014,103599,Hsueh; Tzu-Chien,9999,0,9999,0
1668596949203,ECE 200,015,103600,Javidi; Tara,9999,0,9999,0
1668596949203,ECE 200,016,103601,Kahng; Andrew Byun,9999,0,9999,0
1668596949203,ECE 200,017,103602,Kim; Young-Han,9999,0,9999,0
1668596949203,ECE 200,018,103603,Koushanfar; Farinaz,9999,0,9999,0
1668596949203,ECE 200,019,103604,Kuzum; Duygu,9999,0,9999,0
1668596949203,ECE 200,020,103605,Le; Hanh-Phuc,9999,0,9999,0
1668596949203,ECE 200,021,103606,Lin; Bill,9999,0,9999,0
1668596949203,ECE 200,022,103607,Liu; Zhaowei,9998,0,9999,1
1668596949203,ECE 200,023,103608,Lo; Yu-Hwa,9999,0,9999,0
1668596949203,ECE 200,024,103609,Lomakin; Vitaliy,9999,0,9999,0
1668596949203,ECE 200,025,103610,Mercier; Patrick Philip,9999,0,9999,0
1668596949203,ECE 200,026,103611,Meyer; Florian,9999,0,9999,0
1668596949203,ECE 200,027,103612,Milstein; Laurence B.,9999,0,9999,0
1668596949203,ECE 200,028,103613,Mir Arabbaygi; Siavash,9999,0,9999,0
1668596949203,ECE 200,029,103614,Mookherjea; Shayan,9999,0,9999,0
1668596949203,ECE 200,030,103615,Morris; Karcher William,9999,0,9999,0
1668596949203,ECE 200,031,103616,Ng; Tse Nga,9999,0,9999,0
1668596949203,ECE 200,032,103617,Nguyen; Truong Quang,9999,0,9999,0
1668596949203,ECE 200,033,103618,Nomura; Kenji,9999,0,9999,0
1668596949203,ECE 200,034,103619,Orlitsky; Alon,9999,0,9999,0
1668596949203,ECE 200,035,103620,Pal; Piya,9999,0,9999,0
1668596949203,ECE 200,036,103621,Papen; George C.,9999,0,9999,0
1668596949203,ECE 200,037,103622,Radic; Stojan,9999,0,9999,0
1668596949203,ECE 200,038,103623,Rao; Bhaskar D.,9999,0,9999,0
1668596949203,ECE 200,039,103624,Rao; Ramesh R,9999,0,9999,0
1668596949203,ECE 200,040,103625,Rebeiz; Gabriel,9999,0,9999,0
1668596949203,ECE 200,041,103626,Sanford; John R,9999,0,9999,0
1668596949203,ECE 200,042,103627,Siegel; Paul H.,9999,0,9999,0
1668596949203,ECE 200,043,103628,Sievenpiper; Daniel F.,9999,0,9999,0
1668596949203,ECE 200,044,103629,Sworder; David D.,9999,0,9999,0
1668596949203,ECE 200,045,103630,Taur; Yuan,9999,0,9999,0
1668596949203,ECE 200,046,103631,Touri; Behrouz,9999,0,9999,0
1668596949203,ECE 200,047,103632,Trivedi; Mohan M.,9999,0,9999,0
1668596949203,ECE 200,048,103633,Vasconcelos; Nuno,9999,0,9999,0
1668596949203,ECE 200,049,103634,Wang; Xiaolong,9999,0,9999,0
1668596949203,ECE 200,050,103635,Xie; Pengtao,9999,0,9999,0
1668596949203,ECE 200,051,103636,Yip; Michael,9999,0,9999,0
1668596949203,ECE 200,052,103637,Zeger; Kenneth A.,999,0,999,0
1668596949203,ECE 200,053,103638,Zhang; Xinyu,9999,0,9999,0
1668596949203,ECE 200,054,103639,Turakhia; Yatish Girish,9999,0,9999,0
1668596949203,ECE 200,055,103640,Kang; Mingu,9999,0,9999,0
1668596949203,ECE 200,056,103641,Shi; Yuanyuan,9999,0,9999,0
1668596949203,ECE 200,057,103642,Wang; Edward Jay,9999,0,9999,0
1668596949203,ECE 200,058,103643,Zheng; Yang,9999,0,9999,0
1668596949628,ECE 202,A00,103644,Kuzum; Duygu,0,47,0,0
1668596950056,ECE 212BN,A00,103646,Ng; Tse Nga,0,10,0,0
1668596950480,ECE 221,A00,111493,Staff,0,0,0,0
1668596950904,ECE 222B,A00,103647,Lomakin; Vitaliy,0,22,0,0
1668596951329,ECE 230B,A00,103648,Taur; Yuan,0,4,0,0
1668596951760,ECE 238B,A00,103649,Garay; Javier,0,0,0,0
1668596952199,ECE 240B,A00,112900,Fainman; Yeshaiahu,0,8,0,0
1668596952627,ECE 247A,A00,103650,Jokerst; Jesse Vincent,0,6,0,0
1668596953055,ECE 247B,A00,103651,Wang; Joseph,0,14,0,0
1668596953479,ECE 250,A00,103652,Siegel; Paul H.,0,85,0,0
1668596953907,ECE 251A,A00,103654,Rao; Bhaskar D.,0,65,0,0
1668596954334,ECE 257B,A00,103655,Bharadia; Dinesh,0,33,0,0
1668596954759,ECE 258A,A00,103656,Milstein; Laurence B.,0,29,0,0
1668596955183,ECE 260B,A00,103658,Kang; Mingu,0,121,0,0
1668596955606,ECE 264A,A00,103659,Galton; Ian A,0,41,0,35
1668596956037,ECE 265A,A00,103661,Gudem; Prasad S.S.,0,40,0,38
1668596956467,ECE 265D,A00,103662,Gudem; Prasad S.S.,0,27,0,0
1668596956897,ECE 268,A00,103663,Koushanfar; Farinaz,0,44,0,0
1668596957327,ECE 269,A01,103665,Pal; Piya,0,223,0,0
1668596957760,ECE 271B,A00,103666,Vasconcelos; Manuela,0,80,0,0
1668596958186,ECE 276A,A00,103667,Atanasov; Nikolay A.,0,127,0,0
1668596958640,ECE 277,A00,103668,An; Cheolhong,0,151,0,0
1668596959066,ECE 279,A00,117947,Hall; Drew A.,0,22,0,0
1668596959924,ECE 283,A00,103670,Hsueh; Tzu-Chien,0,57,0,0
1668596960352,ECE 284,A00,103671,Turakhia; Yatish Girish,0,40,0,0
1668596960784,ECE 285,A00,103672,Zheng; Yang,0,40,0,0
1668596960784,ECE 285,B00,103673,Sworder; David D.,0,61,0,0
1668596961208,ECE 287,A00,103676,Javidi; Tara,0,7,0,0
1668596961637,MATH 200B,A00,098023,Salehi Golsefidy; Alireza,7,0,15,8
1668596962061,MATH 202B,A00,098024,Rhoades; Brendon Patrick,7,0,15,8
1668596962492,MATH 203B,A00,098025,Oprea; Dragos N.,9,0,15,6
1668596962919,MATH 204B,A00,098026,Sorensen; Claus M,13,0,15,2
1668596963342,MATH 208,A00,098027,Izadi; Elham,7,0,10,3
1668596963773,MATH 209,A00,098028,Pollack; Aaron,10,0,10,0
1668596964199,MATH 211A,A00,112919,Rogalski; Daniel,8,0,10,2
1668596964629,MATH 211B,A00,112920,Seward; Brandon M.,9,0,10,1
1668596965053,MATH 218,A00,098029,Li; Bo,10,0,10,0
1668596965481,MATH 220B,A00,098030,Novak; Jonathan I,10,0,15,5
1668596965909,MATH 221A,A00,098031,Ebenfelt; Peter F,12,0,15,3
1668596966334,MATH 231B,A00,098032,Zlatos; Andrej,9,0,15,6
1668596966760,MATH 240B,A00,098033,Ni; Lei,7,0,15,8
1668596967186,MATH 243,A00,098034,Jekel; David Andrew,10,0,10,0
1668596967612,MATH 245A,A00,098035,Nie; Jiawang,0,8,15,18
1668596968039,MATH 248,A00,098036,Bejenaru; Ioan,10,0,10,0
1668596968465,MATH 250B,A00,098037,Spolaor; Luca,12,0,15,3
1668596968890,MATH 258,A00,098038,Ni; Lei,8,0,10,2
1668596969318,MATH 264B,A00,098041,Rhoades; Brendon Patrick,6,0,15,9
1668596969744,MATH 268,A00,098042,Buss; Samuel R,10,0,10,0
1668596970179,MATH 269,A00,098043,Rhoades; Brendon Patrick,10,0,10,0
1668596970615,MATH 270B,A00,098044,Li; Bo,6,0,15,9
1668596971047,MATH 272B,A00,098045,Holst; Michael J,13,0,15,2
1668596971482,MATH 273A,A00,098046,Tian; Xiaochuan,10,0,15,5
1668596971920,MATH 275,A01,098048,Tian; Xiaochuan,6,0,10,4
1668596972356,MATH 278A,A00,098049,Holst; Michael J,6,0,10,4
1668596972780,MATH 278B,A00,098050,Cloninger; Alexander,10,0,10,0
1668596973204,MATH 278C,A00,098051,Nie; Jiawang,5,0,10,5
1668596973631,MATH 280B,A00,098052,Zheng; Tianyi,6,0,15,9
1668596974157,MATH 281B,A00,098053,Bradic; Jelena,0,2,15,15
1668596974581,MATH 282B,A00,098054,Arias-Castro; Ery,0,1,15,15
1668596975006,MATH 285,A00,098055,Fitzsimmons; Patrick J,0,4,15,16
1668596975434,MATH 287B,A00,098056,Arias-Castro; Ery,1,0,15,14
1668596975858,MATH 288,A00,098057,Agarwal; Pooja,9,0,10,1
1668596975858,MATH 288,B00,098058,Zhang; Danna,8,0,10,2
1668596975858,MATH 288,C00,098059,Williams; Ruth J,9,0,10,1
1668596976281,MATH 290B,A00,098060,Roberts; Justin Deritter,12,0,15,3
1668596976708,MATH 292,A00,098061,Belmont; Eva Kinoshita,10,0,10,0
1668596977138,MATH 295,A00,098062,Suk; Andrew Hoon,47,0,50,3
1668596977565,MATH 296,A00,098063,Novak; Jonathan I,20,0,20,0
1668596977992,MATH 297,001,098064,Gamst; Anthony Collins,9997,0,9999,2
1668597481816,COGS 205,A00,101395,Chiba; Andrea,19,0,20,1
1668597482249,COGS 210B,001,101404,Greene; Deanna Jacquelyn,9998,0,9999,1
1668597482249,COGS 210B,002,101417,Xia; Haijun,9999,0,9999,0
1668597482249,COGS 210B,003,101422,Nitz; Douglas A.,9999,0,9999,0
1668597482249,COGS 210B,004,101423,Hollan; James D.,9998,0,9999,1
1668597482249,COGS 210B,005,101424,Deak; Gedeon O.,9998,0,9999,1
1668597482249,COGS 210B,006,101425,Rossano; Federico,9999,0,9999,0
1668597482680,COGS 211B,A00,101427,Coulson; Seana M,9996,0,9999,3
1668597483110,COGS 220,A00,101428,Hollan; James D.,0,17,25,25
1668597483542,COGS 229,A00,101429,Dow; Steven P,17,0,25,8
1668597483984,COGS 230,A00,101430,Klemmer; Scott R,6,0,17,11
1668597484409,COGS 234,A00,101431,Xia; Haijun,0,1,25,25
1668597484840,COGS 260,A00,101432,Kiyonaga; Anastasia,21,0,25,4
1668597484840,COGS 260,B00,101433,Kirsh; David Joel,15,0,25,10
1668597485264,CSE 202,A00,102371,Impagliazzo; Russell,0,70,0,0
1668597485690,CSE 203B,A01,102373,Cheng; Chung Kuan,0,70,0,0
1668597486118,CSE 208,A00,102374,Micciancio; Daniele,0,5,0,0
1668597486550,CSE 209A,A00,112895,Impagliazzo; Russell,0,14,15,15
1668597486980,CSE 209B,A00,108005,Bellare; Mihir,0,7,0,0
1668597487408,CSE 210,A00,113163,Coblenz; Michael J,0,96,0,0
1668597487833,CSE 219,A00,106111,Dow; Steven P,0,8,20,20
1668597488268,CSE 221,A00,102376,Voelker; Geoffrey M.,0,78,0,0
1668597488716,CSE 224,A01,102378,Porter; George M,0,181,0,0
1668597489141,CSE 229A,A00,102379,Savage; Stefan,0,14,0,0
1668597489564,CSE 229C,A00,102380,Munyaka; Imani N. S.,0,12,0,0
1668597489988,CSE 232B,A00,102382,Deutsch; Alin Bernard,0,40,0,0
1668597490412,CSE 234,A01,112904,Kumar; Arun Kumar,0,0,0,0
1668597490840,CSE 237A,A00,102383,Rosing; Tajana Simunic,0,57,0,0
1668597491265,CSE 239A,A00,102384,Deutsch; Alin Bernard,0,18,0,0
1668597491690,CSE 239B,A00,102385,Polikarpova; Nadezhda,0,11,0,0
1668597492120,CSE 240A,A00,102386,Pannuto; Patrick William,0,49,0,0
1668597492547,CSE 240B,A00,102387,Zhao; Jishen,0,51,0,0
1668597492973,CSE 241A,A00,106406,Kang; Mingu,0,9,0,0
1668597493405,CSE 249B,A00,102388,Kahng; Andrew Byun,0,7,8,8
1668597493839,CSE 251B,A01,102392,Cottrell; Garrison W,0,54,0,0
1668597493839,CSE 251B,A02,102393,Cottrell; Garrison W,0,36,0,0
1668597494274,CSE 252B,A00,102394,Ochoa; Benjamin Lawrence,0,64,0,0
1668597494718,CSE 257,A01,102396,Gao; Sicun,0,160,0,0
1668597495147,CSE 272,A00,102397,Li; Tzumao,0,22,0,0
1668597495583,CSE 274,A00,111323,Chern; Albert Ren-Haur,0,16,0,0
1668597496009,CSE 282,A00,102398,Pevzner; Pavel Arkadjevich,0,0,0,0
1668597496526,CSE 284,A00,114175,Gymrek; Melissa Ann,0,33,0,0
1668597496956,CSE 290,A00,102399,Chandraker; Manmohan Krishna,0,11,0,0
1668597496956,CSE 290,B00,102400,Vaccaro; Kristen Marie,0,10,25,25
1668597496956,CSE 290,C00,102414,Pannuto; Patrick William,0,1,25,25
1668597496956,CSE 290,D00,102427,Pevzner; Pavel Arkadjevich,0,0,0,0
1668597496956,CSE 290,E00,102429,Zhao; Jishen,0,6,0,0
1668597496956,CSE 290,F00,102436,Tullsen; Dean Michael,0,6,0,0
1668597496956,CSE 290,G00,102440,Christensen; Henrik I,0,8,20,20
1668597497385,CSE 291,A00,102443,Su; Hao,0,0,0,0
1668597497385,CSE 291,B00,102448,Polikarpova; Nadezhda,0,0,0,0
1668597497385,CSE 291,C00,102453,Vaccaro; Kristen Marie,0,0,0,0
1668597497385,CSE 291,D00,111343,Savage; Stefan,0,0,0,0
1668597497385,CSE 291,E00,116474,Claffy; Kimberly Claire,0,0,0,0
1668597497385,CSE 291,F00,116479,Pasquale; Joseph,0,0,0,0
1668597497820,CSE 293,001,119111,Bafna; Vineet,9999,0,9999,0
1668597497820,CSE 293,002,119118,Bellare; Mihir,9999,0,9999,0
1668597497820,CSE 293,003,119122,Berg-Kirkpatrick; Taylor D,9999,0,9999,0
1668597497820,CSE 293,004,119135,Christensen; Henrik I,9999,0,9999,0
1668597497820,CSE 293,005,119142,Cottrell; Garrison W,9999,0,9999,0
1668597497820,CSE 293,006,119146,Deutsch; Alin Bernard,9999,0,9999,0
1668597497820,CSE 293,007,119159,Esmaeilzadeh; Hadi,9999,0,9999,0
1668597497820,CSE 293,008,119166,Freund; Yoav,9999,0,9999,0
1668597497820,CSE 293,009,119170,Griswold; William G.,9999,0,9999,0
1668597497820,CSE 293,010,119183,Gymrek; Melissa Ann,9999,0,9999,0
1668597497820,CSE 293,011,119190,Heninger; Nadia A,9999,0,9999,0
1668597497820,CSE 293,012,119230,Impagliazzo; Russell,9999,0,9999,0
1668597497820,CSE 293,013,119232,Jhala; Ranjit,9999,0,9999,0
1668597497820,CSE 293,014,119233,Kahng; Andrew Byun,9999,0,9999,0
1668597497820,CSE 293,015,119298,Kane; Daniel Mertz,9999,0,9999,0
1668597497820,CSE 293,016,119299,Kriegman; David J,9999,0,9999,0
1668597497820,CSE 293,017,119300,Kumar; Arun Kumar,9999,0,9999,0
1668597497820,CSE 293,018,119301,Lerner; Sorin,9999,0,9999,0
1668597497820,CSE 293,019,119302,Lovett; Shachar,9999,0,9999,0
1668597497820,CSE 293,020,119303,McAuley; Julian John,9999,0,9999,0
1668597497820,CSE 293,021,119304,Micciancio; Daniele,9999,0,9999,0
1668597497820,CSE 293,022,119367,Orailoglu; Alex,9999,0,9999,0
1668597497820,CSE 293,023,119382,Paturi; Ramamohan,9999,0,9999,0
1668597497820,CSE 293,024,119404,Polikarpova; Nadezhda,9999,0,9999,0
1668597497820,CSE 293,025,119406,Politz; Joseph Gibbs,9999,0,9999,0
1668597497820,CSE 293,026,119411,Porter; George M,9999,0,9999,0
1668597497820,CSE 293,027,119414,Porter; Leonard Emerson,9999,0,9999,0
1668597497820,CSE 293,028,119416,Ramamoorthi; Ravi,9999,0,9999,0
1668597497820,CSE 293,029,119417,Sahoo; Debashis,9999,0,9999,0
1668597497820,CSE 293,030,119420,Saul; Lawrence,9999,0,9999,0
1668597497820,CSE 293,031,119421,Savage; Stefan,9999,0,9999,0
1668597497820,CSE 293,032,119425,Schulze; Jurgen P.,9999,0,9999,0
1668597497820,CSE 293,033,119426,Snoeren; Alex C.,9999,0,9999,0
1668597497820,CSE 293,034,119428,Shang; Jingbo,9999,0,9999,0
1668597497820,CSE 293,035,119430,Stefan; Deian,9999,0,9999,0
1668597497820,CSE 293,036,119431,Su; Hao,9999,0,9999,0
1668597497820,CSE 293,037,119433,Swanson; Steven James,9999,0,9999,0
1668597497820,CSE 293,038,119435,Tullsen; Dean Michael,9999,0,9999,0
1668597497820,CSE 293,039,119483,Voelker; Geoffrey M.,9999,0,9999,0
1668597497820,CSE 293,040,119537,Zhao; Jishen,9999,0,9999,0
1668597497820,CSE 293,041,119538,Zhou; Yuan-Yuan,9999,0,9999,0
1668597497820,CSE 293,042,119539,Gao; Sicun,9999,0,9999,0
1668597497820,CSE 293,043,119540,Weibel; Nadir,9999,0,9999,0
1668597497820,CSE 293,044,119541,Gupta; Rajesh K.,9999,0,9999,0
1668597497820,CSE 293,045,126410,Vaccaro; Kristen Marie,9999,0,9999,0
1668597497820,CSE 293,046,126411,Klemke; Richard,9999,0,9999,0
1668597498247,CSE 294,A00,102459,Voelker; Geoffrey M.,0,2,0,0
1668597498247,CSE 294,B00,111322,Orailoglu; Alex,0,2,0,0
1668597498671,DSE 201,A00,096914,Deutsch; Alin Bernard,30,0,30,0
1668597499094,DSE 210,A00,096915,Dasgupta; Sanjoy,30,0,30,0
1668597499517,DSE 241,A00,144528,Smith; Neil Gordon,30,0,30,0
1668597499946,DSE 260A,A00,096916,Altintas De Callaf; Ilkay,30,0,30,0
1668597500381,ECE 200,001,103586,Antipa; Nicholas A,9999,0,9999,0
1668597500381,ECE 200,002,103587,Atanasov; Nikolay A.,9999,0,9999,0
1668597500381,ECE 200,003,103588,Bharadia; Dinesh,9999,0,9999,0
1668597500381,ECE 200,004,103589,Cheng; Chung Kuan,9999,0,9999,0
1668597500381,ECE 200,005,103590,Cosman; Pamela C.,9999,0,9999,0
1668597500381,ECE 200,006,103591,Dayeh; Shadi Ahmad,9999,0,9999,0
1668597500381,ECE 200,007,103592,Fainman; Yeshaiahu,9999,0,9999,0
1668597500381,ECE 200,008,103593,Ford; Joseph Earl,9999,0,9999,0
1668597500381,ECE 200,009,103594,Franceschetti; Massimo,9999,0,9999,0
1668597500381,ECE 200,010,103595,Fullerton; Eric E,9999,0,9999,0
1668597500381,ECE 200,011,103596,Galton; Ian A,9999,0,9999,0
1668597500381,ECE 200,012,103597,Gilja; Vikash,9999,0,9999,0
1668597500381,ECE 200,013,103598,Hall; Drew A.,9999,0,9999,0
1668597500381,ECE 200,014,103599,Hsueh; Tzu-Chien,9999,0,9999,0
1668597500381,ECE 200,015,103600,Javidi; Tara,9999,0,9999,0
1668597500381,ECE 200,016,103601,Kahng; Andrew Byun,9999,0,9999,0
1668597500381,ECE 200,017,103602,Kim; Young-Han,9999,0,9999,0
1668597500381,ECE 200,018,103603,Koushanfar; Farinaz,9999,0,9999,0
1668597500381,ECE 200,019,103604,Kuzum; Duygu,9999,0,9999,0
1668597500381,ECE 200,020,103605,Le; Hanh-Phuc,9999,0,9999,0
1668597500381,ECE 200,021,103606,Lin; Bill,9999,0,9999,0
1668597500381,ECE 200,022,103607,Liu; Zhaowei,9998,0,9999,1
1668597500381,ECE 200,023,103608,Lo; Yu-Hwa,9999,0,9999,0
1668597500381,ECE 200,024,103609,Lomakin; Vitaliy,9999,0,9999,0
1668597500381,ECE 200,025,103610,Mercier; Patrick Philip,9999,0,9999,0
1668597500381,ECE 200,026,103611,Meyer; Florian,9999,0,9999,0
1668597500381,ECE 200,027,103612,Milstein; Laurence B.,9999,0,9999,0
1668597500381,ECE 200,028,103613,Mir Arabbaygi; Siavash,9999,0,9999,0
1668597500381,ECE 200,029,103614,Mookherjea; Shayan,9999,0,9999,0
1668597500381,ECE 200,030,103615,Morris; Karcher William,9999,0,9999,0
1668597500381,ECE 200,031,103616,Ng; Tse Nga,9999,0,9999,0
1668597500381,ECE 200,032,103617,Nguyen; Truong Quang,9999,0,9999,0
1668597500381,ECE 200,033,103618,Nomura; Kenji,9999,0,9999,0
1668597500381,ECE 200,034,103619,Orlitsky; Alon,9999,0,9999,0
1668597500381,ECE 200,035,103620,Pal; Piya,9999,0,9999,0
1668597500381,ECE 200,036,103621,Papen; George C.,9999,0,9999,0
1668597500381,ECE 200,037,103622,Radic; Stojan,9999,0,9999,0
1668597500381,ECE 200,038,103623,Rao; Bhaskar D.,9999,0,9999,0
1668597500381,ECE 200,039,103624,Rao; Ramesh R,9999,0,9999,0
1668597500381,ECE 200,040,103625,Rebeiz; Gabriel,9999,0,9999,0
1668597500381,ECE 200,041,103626,Sanford; John R,9999,0,9999,0
1668597500381,ECE 200,042,103627,Siegel; Paul H.,9999,0,9999,0
1668597500381,ECE 200,043,103628,Sievenpiper; Daniel F.,9999,0,9999,0
1668597500381,ECE 200,044,103629,Sworder; David D.,9999,0,9999,0
1668597500381,ECE 200,045,103630,Taur; Yuan,9999,0,9999,0
1668597500381,ECE 200,046,103631,Touri; Behrouz,9999,0,9999,0
1668597500381,ECE 200,047,103632,Trivedi; Mohan M.,9999,0,9999,0
1668597500381,ECE 200,048,103633,Vasconcelos; Nuno,9999,0,9999,0
1668597500381,ECE 200,049,103634,Wang; Xiaolong,9999,0,9999,0
1668597500381,ECE 200,050,103635,Xie; Pengtao,9999,0,9999,0
1668597500381,ECE 200,051,103636,Yip; Michael,9999,0,9999,0
1668597500381,ECE 200,052,103637,Zeger; Kenneth A.,999,0,999,0
1668597500381,ECE 200,053,103638,Zhang; Xinyu,9999,0,9999,0
1668597500381,ECE 200,054,103639,Turakhia; Yatish Girish,9999,0,9999,0
1668597500381,ECE 200,055,103640,Kang; Mingu,9999,0,9999,0
1668597500381,ECE 200,056,103641,Shi; Yuanyuan,9999,0,9999,0
1668597500381,ECE 200,057,103642,Wang; Edward Jay,9999,0,9999,0
1668597500381,ECE 200,058,103643,Zheng; Yang,9999,0,9999,0
1668597500805,ECE 202,A00,103644,Kuzum; Duygu,0,47,0,0
1668597501233,ECE 212BN,A00,103646,Ng; Tse Nga,0,10,0,0
1668597501656,ECE 221,A00,111493,Staff,0,0,0,0
1668597502082,ECE 222B,A00,103647,Lomakin; Vitaliy,0,22,0,0
1668597502506,ECE 230B,A00,103648,Taur; Yuan,0,4,0,0
1668597502929,ECE 238B,A00,103649,Garay; Javier,0,0,0,0
1668597503352,ECE 240B,A00,112900,Fainman; Yeshaiahu,0,8,0,0
1668597503777,ECE 247A,A00,103650,Jokerst; Jesse Vincent,0,6,0,0
1668597504203,ECE 247B,A00,103651,Wang; Joseph,0,14,0,0
1668597504632,ECE 250,A00,103652,Siegel; Paul H.,0,85,0,0
1668597505060,ECE 251A,A00,103654,Rao; Bhaskar D.,0,65,0,0
1668597505486,ECE 257B,A00,103655,Bharadia; Dinesh,0,33,0,0
1668597505920,ECE 258A,A00,103656,Milstein; Laurence B.,0,29,0,0
1668597506344,ECE 260B,A00,103658,Kang; Mingu,0,121,0,0
1668597506773,ECE 264A,A00,103659,Galton; Ian A,0,41,0,35
1668597507197,ECE 265A,A00,103661,Gudem; Prasad S.S.,0,40,0,38
1668597507624,ECE 265D,A00,103662,Gudem; Prasad S.S.,0,27,0,0
1668597508051,ECE 268,A00,103663,Koushanfar; Farinaz,0,44,0,0
1668597508475,ECE 269,A01,103665,Pal; Piya,0,223,0,0
1668597508899,ECE 271B,A00,103666,Vasconcelos; Manuela,0,80,0,0
1668597509327,ECE 276A,A00,103667,Atanasov; Nikolay A.,0,127,0,0
1668597509750,ECE 277,A00,103668,An; Cheolhong,0,151,0,0
1668597510174,ECE 279,A00,117947,Hall; Drew A.,0,22,0,0
1668597511028,ECE 283,A00,103670,Hsueh; Tzu-Chien,0,57,0,0
1668597511454,ECE 284,A00,103671,Turakhia; Yatish Girish,0,40,0,0
1668597511877,ECE 285,A00,103672,Zheng; Yang,0,40,0,0
1668597511877,ECE 285,B00,103673,Sworder; David D.,0,61,0,0
1668597512308,ECE 287,A00,103676,Javidi; Tara,0,7,0,0
1668597512736,MATH 200B,A00,098023,Salehi Golsefidy; Alireza,7,0,15,8
1668597513162,MATH 202B,A00,098024,Rhoades; Brendon Patrick,7,0,15,8
1668597513586,MATH 203B,A00,098025,Oprea; Dragos N.,9,0,15,6
1668597514011,MATH 204B,A00,098026,Sorensen; Claus M,13,0,15,2
1668597514438,MATH 208,A00,098027,Izadi; Elham,7,0,10,3
1668597514863,MATH 209,A00,098028,Pollack; Aaron,10,0,10,0
1668597515286,MATH 211A,A00,112919,Rogalski; Daniel,8,0,10,2
1668597515712,MATH 211B,A00,112920,Seward; Brandon M.,9,0,10,1
1668597516136,MATH 218,A00,098029,Li; Bo,10,0,10,0
1668597516561,MATH 220B,A00,098030,Novak; Jonathan I,10,0,15,5
1668597516990,MATH 221A,A00,098031,Ebenfelt; Peter F,12,0,15,3
1668597517423,MATH 231B,A00,098032,Zlatos; Andrej,9,0,15,6
1668597517860,MATH 240B,A00,098033,Ni; Lei,7,0,15,8
1668597518283,MATH 243,A00,098034,Jekel; David Andrew,10,0,10,0
1668597518706,MATH 245A,A00,098035,Nie; Jiawang,0,8,15,18
1668597519130,MATH 248,A00,098036,Bejenaru; Ioan,10,0,10,0
1668597519557,MATH 250B,A00,098037,Spolaor; Luca,12,0,15,3
1668597519986,MATH 258,A00,098038,Ni; Lei,8,0,10,2
1668597520412,MATH 264B,A00,098041,Rhoades; Brendon Patrick,6,0,15,9
1668597520839,MATH 268,A00,098042,Buss; Samuel R,10,0,10,0
1668597521262,MATH 269,A00,098043,Rhoades; Brendon Patrick,10,0,10,0
1668597521688,MATH 270B,A00,098044,Li; Bo,6,0,15,9
1668597522111,MATH 272B,A00,098045,Holst; Michael J,13,0,15,2
1668597522539,MATH 273A,A00,098046,Tian; Xiaochuan,10,0,15,5
1668597522964,MATH 275,A01,098048,Tian; Xiaochuan,6,0,10,4
1668597523392,MATH 278A,A00,098049,Holst; Michael J,6,0,10,4
1668597523819,MATH 278B,A00,098050,Cloninger; Alexander,10,0,10,0
1668597524242,MATH 278C,A00,098051,Nie; Jiawang,5,0,10,5
1668597524674,MATH 280B,A00,098052,Zheng; Tianyi,6,0,15,9
1668597525098,MATH 281B,A00,098053,Bradic; Jelena,0,2,15,15
1668597525522,MATH 282B,A00,098054,Arias-Castro; Ery,0,1,15,15
1668597525950,MATH 285,A00,098055,Fitzsimmons; Patrick J,0,4,15,16
1668597526376,MATH 287B,A00,098056,Arias-Castro; Ery,1,0,15,14
1668597526800,MATH 288,A00,098057,Agarwal; Pooja,9,0,10,1
1668597526800,MATH 288,B00,098058,Zhang; Danna,8,0,10,2
1668597526800,MATH 288,C00,098059,Williams; Ruth J,9,0,10,1
1668597527227,MATH 290B,A00,098060,Roberts; Justin Deritter,12,0,15,3
1668597527652,MATH 292,A00,098061,Belmont; Eva Kinoshita,10,0,10,0
1668597528077,MATH 295,A00,098062,Suk; Andrew Hoon,47,0,50,3
1668597528509,MATH 296,A00,098063,Novak; Jonathan I,20,0,20,0
1668597528934,MATH 297,001,098064,Gamst; Anthony Collins,9997,0,9999,2
1668598033589,COGS 205,A00,101395,Chiba; Andrea,19,0,20,1
1668598034035,COGS 210B,001,101404,Greene; Deanna Jacquelyn,9998,0,9999,1
1668598034035,COGS 210B,002,101417,Xia; Haijun,9999,0,9999,0
1668598034035,COGS 210B,003,101422,Nitz; Douglas A.,9999,0,9999,0
1668598034035,COGS 210B,004,101423,Hollan; James D.,9998,0,9999,1
1668598034035,COGS 210B,005,101424,Deak; Gedeon O.,9998,0,9999,1
1668598034035,COGS 210B,006,101425,Rossano; Federico,9999,0,9999,0
1668598034460,COGS 211B,A00,101427,Coulson; Seana M,9996,0,9999,3
1668598034884,COGS 220,A00,101428,Hollan; James D.,0,17,25,25
1668598035311,COGS 229,A00,101429,Dow; Steven P,17,0,25,8
1668598035743,COGS 230,A00,101430,Klemmer; Scott R,6,0,17,11
1668598036169,COGS 234,A00,101431,Xia; Haijun,0,1,25,25
1668598036594,COGS 260,A00,101432,Kiyonaga; Anastasia,21,0,25,4
1668598036594,COGS 260,B00,101433,Kirsh; David Joel,15,0,25,10
1668598037025,CSE 202,A00,102371,Impagliazzo; Russell,0,70,0,0
1668598037452,CSE 203B,A01,102373,Cheng; Chung Kuan,0,70,0,0
1668598037876,CSE 208,A00,102374,Micciancio; Daniele,0,5,0,0
1668598038301,CSE 209A,A00,112895,Impagliazzo; Russell,0,14,15,15
1668598038728,CSE 209B,A00,108005,Bellare; Mihir,0,7,0,0
1668598039158,CSE 210,A00,113163,Coblenz; Michael J,0,96,0,0
1668598039583,CSE 219,A00,106111,Dow; Steven P,0,8,20,20
1668598040008,CSE 221,A00,102376,Voelker; Geoffrey M.,0,78,0,0
1668598040434,CSE 224,A01,102378,Porter; George M,0,181,0,0
1668598040857,CSE 229A,A00,102379,Savage; Stefan,0,14,0,0
1668598041283,CSE 229C,A00,102380,Munyaka; Imani N. S.,0,12,0,0
1668598041712,CSE 232B,A00,102382,Deutsch; Alin Bernard,0,40,0,0
1668598042138,CSE 234,A01,112904,Kumar; Arun Kumar,0,0,0,0
1668598042563,CSE 237A,A00,102383,Rosing; Tajana Simunic,0,57,0,0
1668598042992,CSE 239A,A00,102384,Deutsch; Alin Bernard,0,18,0,0
1668598043423,CSE 239B,A00,102385,Polikarpova; Nadezhda,0,11,0,0
1668598043849,CSE 240A,A00,102386,Pannuto; Patrick William,0,49,0,0
1668598044272,CSE 240B,A00,102387,Zhao; Jishen,0,51,0,0
1668598044703,CSE 241A,A00,106406,Kang; Mingu,0,9,0,0
1668598045142,CSE 249B,A00,102388,Kahng; Andrew Byun,0,7,8,8
1668598045575,CSE 251B,A01,102392,Cottrell; Garrison W,0,54,0,0
1668598045575,CSE 251B,A02,102393,Cottrell; Garrison W,0,36,0,0
1668598046011,CSE 252B,A00,102394,Ochoa; Benjamin Lawrence,0,64,0,0
1668598046449,CSE 257,A01,102396,Gao; Sicun,0,160,0,0
1668598046875,CSE 272,A00,102397,Li; Tzumao,0,22,0,0
1668598047302,CSE 274,A00,111323,Chern; Albert Ren-Haur,0,16,0,0
1668598047728,CSE 282,A00,102398,Pevzner; Pavel Arkadjevich,0,0,0,0
1668598048155,CSE 284,A00,114175,Gymrek; Melissa Ann,0,33,0,0
1668598048587,CSE 290,A00,102399,Chandraker; Manmohan Krishna,0,11,0,0
1668598048587,CSE 290,B00,102400,Vaccaro; Kristen Marie,0,10,25,25
1668598048587,CSE 290,C00,102414,Pannuto; Patrick William,0,1,25,25
1668598048587,CSE 290,D00,102427,Pevzner; Pavel Arkadjevich,0,0,0,0
1668598048587,CSE 290,E00,102429,Zhao; Jishen,0,6,0,0
1668598048587,CSE 290,F00,102436,Tullsen; Dean Michael,0,6,0,0
1668598048587,CSE 290,G00,102440,Christensen; Henrik I,0,8,20,20
1668598049014,CSE 291,A00,102443,Su; Hao,0,0,0,0
1668598049014,CSE 291,B00,102448,Polikarpova; Nadezhda,0,0,0,0
1668598049014,CSE 291,C00,102453,Vaccaro; Kristen Marie,0,0,0,0
1668598049014,CSE 291,D00,111343,Savage; Stefan,0,0,0,0
1668598049014,CSE 291,E00,116474,Claffy; Kimberly Claire,0,0,0,0
1668598049014,CSE 291,F00,116479,Pasquale; Joseph,0,0,0,0
1668598049453,CSE 293,001,119111,Bafna; Vineet,9999,0,9999,0
1668598049453,CSE 293,002,119118,Bellare; Mihir,9999,0,9999,0
1668598049453,CSE 293,003,119122,Berg-Kirkpatrick; Taylor D,9999,0,9999,0
1668598049453,CSE 293,004,119135,Christensen; Henrik I,9999,0,9999,0
1668598049453,CSE 293,005,119142,Cottrell; Garrison W,9999,0,9999,0
1668598049453,CSE 293,006,119146,Deutsch; Alin Bernard,9999,0,9999,0
1668598049453,CSE 293,007,119159,Esmaeilzadeh; Hadi,9999,0,9999,0
1668598049453,CSE 293,008,119166,Freund; Yoav,9999,0,9999,0
1668598049453,CSE 293,009,119170,Griswold; William G.,9999,0,9999,0
1668598049453,CSE 293,010,119183,Gymrek; Melissa Ann,9999,0,9999,0
1668598049453,CSE 293,011,119190,Heninger; Nadia A,9999,0,9999,0
1668598049453,CSE 293,012,119230,Impagliazzo; Russell,9999,0,9999,0
1668598049453,CSE 293,013,119232,Jhala; Ranjit,9999,0,9999,0
1668598049453,CSE 293,014,119233,Kahng; Andrew Byun,9999,0,9999,0
1668598049453,CSE 293,015,119298,Kane; Daniel Mertz,9999,0,9999,0
1668598049453,CSE 293,016,119299,Kriegman; David J,9999,0,9999,0
1668598049453,CSE 293,017,119300,Kumar; Arun Kumar,9999,0,9999,0
1668598049453,CSE 293,018,119301,Lerner; Sorin,9999,0,9999,0
1668598049453,CSE 293,019,119302,Lovett; Shachar,9999,0,9999,0
1668598049453,CSE 293,020,119303,McAuley; Julian John,9999,0,9999,0
1668598049453,CSE 293,021,119304,Micciancio; Daniele,9999,0,9999,0
1668598049453,CSE 293,022,119367,Orailoglu; Alex,9999,0,9999,0
1668598049453,CSE 293,023,119382,Paturi; Ramamohan,9999,0,9999,0
1668598049453,CSE 293,024,119404,Polikarpova; Nadezhda,9999,0,9999,0
1668598049453,CSE 293,025,119406,Politz; Joseph Gibbs,9999,0,9999,0
1668598049453,CSE 293,026,119411,Porter; George M,9999,0,9999,0
1668598049453,CSE 293,027,119414,Porter; Leonard Emerson,9999,0,9999,0
1668598049453,CSE 293,028,119416,Ramamoorthi; Ravi,9999,0,9999,0
1668598049453,CSE 293,029,119417,Sahoo; Debashis,9999,0,9999,0
1668598049453,CSE 293,030,119420,Saul; Lawrence,9999,0,9999,0
1668598049453,CSE 293,031,119421,Savage; Stefan,9999,0,9999,0
1668598049453,CSE 293,032,119425,Schulze; Jurgen P.,9999,0,9999,0
1668598049453,CSE 293,033,119426,Snoeren; Alex C.,9999,0,9999,0
1668598049453,CSE 293,034,119428,Shang; Jingbo,9999,0,9999,0
1668598049453,CSE 293,035,119430,Stefan; Deian,9999,0,9999,0
1668598049453,CSE 293,036,119431,Su; Hao,9999,0,9999,0
1668598049453,CSE 293,037,119433,Swanson; Steven James,9999,0,9999,0
1668598049453,CSE 293,038,119435,Tullsen; Dean Michael,9999,0,9999,0
1668598049453,CSE 293,039,119483,Voelker; Geoffrey M.,9999,0,9999,0
1668598049453,CSE 293,040,119537,Zhao; Jishen,9999,0,9999,0
1668598049453,CSE 293,041,119538,Zhou; Yuan-Yuan,9999,0,9999,0
1668598049453,CSE 293,042,119539,Gao; Sicun,9999,0,9999,0
1668598049453,CSE 293,043,119540,Weibel; Nadir,9999,0,9999,0
1668598049453,CSE 293,044,119541,Gupta; Rajesh K.,9999,0,9999,0
1668598049453,CSE 293,045,126410,Vaccaro; Kristen Marie,9999,0,9999,0
1668598049453,CSE 293,046,126411,Klemke; Richard,9999,0,9999,0
1668598049887,CSE 294,A00,102459,Voelker; Geoffrey M.,0,2,0,0
1668598049887,CSE 294,B00,111322,Orailoglu; Alex,0,2,0,0
1668598050316,DSE 201,A00,096914,Deutsch; Alin Bernard,30,0,30,0
1668598050741,DSE 210,A00,096915,Dasgupta; Sanjoy,30,0,30,0
1668598051166,DSE 241,A00,144528,Smith; Neil Gordon,30,0,30,0
1668598051595,DSE 260A,A00,096916,Altintas De Callaf; Ilkay,30,0,30,0
1668598052048,ECE 200,001,103586,Antipa; Nicholas A,9999,0,9999,0
1668598052048,ECE 200,002,103587,Atanasov; Nikolay A.,9999,0,9999,0
1668598052048,ECE 200,003,103588,Bharadia; Dinesh,9999,0,9999,0
1668598052048,ECE 200,004,103589,Cheng; Chung Kuan,9999,0,9999,0
1668598052048,ECE 200,005,103590,Cosman; Pamela C.,9999,0,9999,0
1668598052048,ECE 200,006,103591,Dayeh; Shadi Ahmad,9999,0,9999,0
1668598052048,ECE 200,007,103592,Fainman; Yeshaiahu,9999,0,9999,0
1668598052048,ECE 200,008,103593,Ford; Joseph Earl,9999,0,9999,0
1668598052048,ECE 200,009,103594,Franceschetti; Massimo,9999,0,9999,0
1668598052048,ECE 200,010,103595,Fullerton; Eric E,9999,0,9999,0
1668598052048,ECE 200,011,103596,Galton; Ian A,9999,0,9999,0
1668598052048,ECE 200,012,103597,Gilja; Vikash,9999,0,9999,0
1668598052048,ECE 200,013,103598,Hall; Drew A.,9999,0,9999,0
1668598052048,ECE 200,014,103599,Hsueh; Tzu-Chien,9999,0,9999,0
1668598052048,ECE 200,015,103600,Javidi; Tara,9999,0,9999,0
1668598052048,ECE 200,016,103601,Kahng; Andrew Byun,9999,0,9999,0
1668598052048,ECE 200,017,103602,Kim; Young-Han,9999,0,9999,0
1668598052048,ECE 200,018,103603,Koushanfar; Farinaz,9999,0,9999,0
1668598052048,ECE 200,019,103604,Kuzum; Duygu,9999,0,9999,0
1668598052048,ECE 200,020,103605,Le; Hanh-Phuc,9999,0,9999,0
1668598052048,ECE 200,021,103606,Lin; Bill,9999,0,9999,0
1668598052048,ECE 200,022,103607,Liu; Zhaowei,9998,0,9999,1
1668598052048,ECE 200,023,103608,Lo; Yu-Hwa,9999,0,9999,0
1668598052048,ECE 200,024,103609,Lomakin; Vitaliy,9999,0,9999,0
1668598052048,ECE 200,025,103610,Mercier; Patrick Philip,9999,0,9999,0
1668598052048,ECE 200,026,103611,Meyer; Florian,9999,0,9999,0
1668598052048,ECE 200,027,103612,Milstein; Laurence B.,9999,0,9999,0
1668598052048,ECE 200,028,103613,Mir Arabbaygi; Siavash,9999,0,9999,0
1668598052048,ECE 200,029,103614,Mookherjea; Shayan,9999,0,9999,0
1668598052048,ECE 200,030,103615,Morris; Karcher William,9999,0,9999,0
1668598052048,ECE 200,031,103616,Ng; Tse Nga,9999,0,9999,0
1668598052048,ECE 200,032,103617,Nguyen; Truong Quang,9999,0,9999,0
1668598052048,ECE 200,033,103618,Nomura; Kenji,9999,0,9999,0
1668598052048,ECE 200,034,103619,Orlitsky; Alon,9999,0,9999,0
1668598052048,ECE 200,035,103620,Pal; Piya,9999,0,9999,0
1668598052048,ECE 200,036,103621,Papen; George C.,9999,0,9999,0
1668598052048,ECE 200,037,103622,Radic; Stojan,9999,0,9999,0
1668598052048,ECE 200,038,103623,Rao; Bhaskar D.,9999,0,9999,0
1668598052048,ECE 200,039,103624,Rao; Ramesh R,9999,0,9999,0
1668598052048,ECE 200,040,103625,Rebeiz; Gabriel,9999,0,9999,0
1668598052048,ECE 200,041,103626,Sanford; John R,9999,0,9999,0
1668598052048,ECE 200,042,103627,Siegel; Paul H.,9999,0,9999,0
1668598052048,ECE 200,043,103628,Sievenpiper; Daniel F.,9999,0,9999,0
1668598052048,ECE 200,044,103629,Sworder; David D.,9999,0,9999,0
1668598052048,ECE 200,045,103630,Taur; Yuan,9999,0,9999,0
1668598052048,ECE 200,046,103631,Touri; Behrouz,9999,0,9999,0
1668598052048,ECE 200,047,103632,Trivedi; Mohan M.,9999,0,9999,0
1668598052048,ECE 200,048,103633,Vasconcelos; Nuno,9999,0,9999,0
1668598052048,ECE 200,049,103634,Wang; Xiaolong,9999,0,9999,0
1668598052048,ECE 200,050,103635,Xie; Pengtao,9999,0,9999,0
1668598052048,ECE 200,051,103636,Yip; Michael,9999,0,9999,0
1668598052048,ECE 200,052,103637,Zeger; Kenneth A.,999,0,999,0
1668598052048,ECE 200,053,103638,Zhang; Xinyu,9999,0,9999,0
1668598052048,ECE 200,054,103639,Turakhia; Yatish Girish,9999,0,9999,0
1668598052048,ECE 200,055,103640,Kang; Mingu,9999,0,9999,0
1668598052048,ECE 200,056,103641,Shi; Yuanyuan,9999,0,9999,0
1668598052048,ECE 200,057,103642,Wang; Edward Jay,9999,0,9999,0
1668598052048,ECE 200,058,103643,Zheng; Yang,9999,0,9999,0
1668598052473,ECE 202,A00,103644,Kuzum; Duygu,0,47,0,0
1668598052898,ECE 212BN,A00,103646,Ng; Tse Nga,0,10,0,0
1668598053323,ECE 221,A00,111493,Staff,0,0,0,0
1668598053747,ECE 222B,A00,103647,Lomakin; Vitaliy,0,22,0,0
1668598054174,ECE 230B,A00,103648,Taur; Yuan,0,4,0,0
1668598054600,ECE 238B,A00,103649,Garay; Javier,0,0,0,0
1668598055027,ECE 240B,A00,112900,Fainman; Yeshaiahu,0,8,0,0
1668598055462,ECE 247A,A00,103650,Jokerst; Jesse Vincent,0,6,0,0
1668598055887,ECE 247B,A00,103651,Wang; Joseph,0,14,0,0
1668598056313,ECE 250,A00,103652,Siegel; Paul H.,0,85,0,0
1668598056741,ECE 251A,A00,103654,Rao; Bhaskar D.,0,65,0,0
1668598057176,ECE 257B,A00,103655,Bharadia; Dinesh,0,33,0,0
1668598057606,ECE 258A,A00,103656,Milstein; Laurence B.,0,29,0,0
1668598058037,ECE 260B,A00,103658,Kang; Mingu,0,121,0,0
1668598058461,ECE 264A,A00,103659,Galton; Ian A,0,41,0,35
1668598058884,ECE 265A,A00,103661,Gudem; Prasad S.S.,0,40,0,38
1668598059309,ECE 265D,A00,103662,Gudem; Prasad S.S.,0,27,0,0
1668598059736,ECE 268,A00,103663,Koushanfar; Farinaz,0,44,0,0
1668598060173,ECE 269,A01,103665,Pal; Piya,0,223,0,0
1668598060600,ECE 271B,A00,103666,Vasconcelos; Manuela,0,80,0,0
1668598061025,ECE 276A,A00,103667,Atanasov; Nikolay A.,0,127,0,0
1668598061450,ECE 277,A00,103668,An; Cheolhong,0,151,0,0
1668598061875,ECE 279,A00,117947,Hall; Drew A.,0,22,0,0
1668598062807,ECE 283,A00,103670,Hsueh; Tzu-Chien,0,57,0,0
1668598063238,ECE 284,A00,103671,Turakhia; Yatish Girish,0,40,0,0
1668598063662,ECE 285,A00,103672,Zheng; Yang,0,40,0,0
1668598063662,ECE 285,B00,103673,Sworder; David D.,0,61,0,0
1668598064089,ECE 287,A00,103676,Javidi; Tara,0,7,0,0
1668598064516,MATH 200B,A00,098023,Salehi Golsefidy; Alireza,7,0,15,8
1668598064944,MATH 202B,A00,098024,Rhoades; Brendon Patrick,7,0,15,8
1668598065371,MATH 203B,A00,098025,Oprea; Dragos N.,9,0,15,6
1668598065796,MATH 204B,A00,098026,Sorensen; Claus M,13,0,15,2
1668598066223,MATH 208,A00,098027,Izadi; Elham,7,0,10,3
1668598066651,MATH 209,A00,098028,Pollack; Aaron,10,0,10,0
1668598067084,MATH 211A,A00,112919,Rogalski; Daniel,8,0,10,2
1668598067510,MATH 211B,A00,112920,Seward; Brandon M.,9,0,10,1
1668598067935,MATH 218,A00,098029,Li; Bo,10,0,10,0
1668598068360,MATH 220B,A00,098030,Novak; Jonathan I,10,0,15,5
1668598068785,MATH 221A,A00,098031,Ebenfelt; Peter F,12,0,15,3
1668598069230,MATH 231B,A00,098032,Zlatos; Andrej,9,0,15,6
1668598069661,MATH 240B,A00,098033,Ni; Lei,7,0,15,8
1668598070094,MATH 243,A00,098034,Jekel; David Andrew,10,0,10,0
1668598070519,MATH 245A,A00,098035,Nie; Jiawang,0,8,15,18
1668598070942,MATH 248,A00,098036,Bejenaru; Ioan,10,0,10,0
1668598071375,MATH 250B,A00,098037,Spolaor; Luca,12,0,15,3
1668598071800,MATH 258,A00,098038,Ni; Lei,8,0,10,2
1668598072232,MATH 264B,A00,098041,Rhoades; Brendon Patrick,6,0,15,9
1668598072671,MATH 268,A00,098042,Buss; Samuel R,10,0,10,0
1668598073104,MATH 269,A00,098043,Rhoades; Brendon Patrick,10,0,10,0
1668598073530,MATH 270B,A00,098044,Li; Bo,6,0,15,9
1668598073959,MATH 272B,A00,098045,Holst; Michael J,13,0,15,2
1668598074383,MATH 273A,A00,098046,Tian; Xiaochuan,10,0,15,5
1668598074819,MATH 275,A01,098048,Tian; Xiaochuan,6,0,10,4
1668598075247,MATH 278A,A00,098049,Holst; Michael J,6,0,10,4
1668598075675,MATH 278B,A00,098050,Cloninger; Alexander,10,0,10,0
1668598076113,MATH 278C,A00,098051,Nie; Jiawang,5,0,10,5
1668598076564,MATH 280B,A00,098052,Zheng; Tianyi,6,0,15,9
1668598076992,MATH 281B,A00,098053,Bradic; Jelena,0,2,15,15
1668598077420,MATH 282B,A00,098054,Arias-Castro; Ery,0,1,15,15
1668598077850,MATH 285,A00,098055,Fitzsimmons; Patrick J,0,4,15,16
1668598078282,MATH 287B,A00,098056,Arias-Castro; Ery,1,0,15,14
1668598078719,MATH 288,A00,098057,Agarwal; Pooja,9,0,10,1
1668598078719,MATH 288,B00,098058,Zhang; Danna,8,0,10,2
1668598078719,MATH 288,C00,098059,Williams; Ruth J,9,0,10,1
1668598079145,MATH 290B,A00,098060,Roberts; Justin Deritter,12,0,15,3
1668598079580,MATH 292,A00,098061,Belmont; Eva Kinoshita,10,0,10,0
1668598080006,MATH 295,A00,098062,Suk; Andrew Hoon,47,0,50,3
1668598080444,MATH 296,A00,098063,Novak; Jonathan I,20,0,20,0
1668598080880,MATH 297,001,098064,Gamst; Anthony Collins,9997,0,9999,2
1668598586335,COGS 205,A00,101395,Chiba; Andrea,19,0,20,1
1668598586859,COGS 210B,001,101404,Greene; Deanna Jacquelyn,9998,0,9999,1
1668598586859,COGS 210B,002,101417,Xia; Haijun,9999,0,9999,0
1668598586859,COGS 210B,003,101422,Nitz; Douglas A.,9999,0,9999,0
1668598586859,COGS 210B,004,101423,Hollan; James D.,9998,0,9999,1
1668598586859,COGS 210B,005,101424,Deak; Gedeon O.,9998,0,9999,1
1668598586859,COGS 210B,006,101425,Rossano; Federico,9999,0,9999,0
1668598587287,COGS 211B,A00,101427,Coulson; Seana M,9996,0,9999,3
1668598587711,COGS 220,A00,101428,Hollan; James D.,0,17,25,25
1668598588146,COGS 229,A00,101429,Dow; Steven P,17,0,25,8
1668598588572,COGS 230,A00,101430,Klemmer; Scott R,6,0,17,11
1668598589012,COGS 234,A00,101431,Xia; Haijun,0,1,25,25
1668598589459,COGS 260,A00,101432,Kiyonaga; Anastasia,21,0,25,4
1668598589459,COGS 260,B00,101433,Kirsh; David Joel,15,0,25,10
1668598589894,CSE 202,A00,102371,Impagliazzo; Russell,0,70,0,0
1668598590324,CSE 203B,A01,102373,Cheng; Chung Kuan,0,70,0,0
1668598590749,CSE 208,A00,102374,Micciancio; Daniele,0,5,0,0
1668598591177,CSE 209A,A00,112895,Impagliazzo; Russell,0,14,15,15
1668598591607,CSE 209B,A00,108005,Bellare; Mihir,0,7,0,0
1668598592051,CSE 210,A00,113163,Coblenz; Michael J,0,96,0,0
1668598592481,CSE 219,A00,106111,Dow; Steven P,0,8,20,20
1668598592906,CSE 221,A00,102376,Voelker; Geoffrey M.,0,78,0,0
1668598593330,CSE 224,A01,102378,Porter; George M,0,181,0,0
1668598593754,CSE 229A,A00,102379,Savage; Stefan,0,14,0,0
1668598594178,CSE 229C,A00,102380,Munyaka; Imani N. S.,0,12,0,0
1668598594604,CSE 232B,A00,102382,Deutsch; Alin Bernard,0,40,0,0
1668598595030,CSE 234,A01,112904,Kumar; Arun Kumar,0,0,0,0
1668598595467,CSE 237A,A00,102383,Rosing; Tajana Simunic,0,57,0,0
1668598595892,CSE 239A,A00,102384,Deutsch; Alin Bernard,0,18,0,0
1668598596320,CSE 239B,A00,102385,Polikarpova; Nadezhda,0,11,0,0
1668598596745,CSE 240A,A00,102386,Pannuto; Patrick William,0,49,0,0
1668598597174,CSE 240B,A00,102387,Zhao; Jishen,0,51,0,0
1668598597608,CSE 241A,A00,106406,Kang; Mingu,0,9,0,0
1668598598046,CSE 249B,A00,102388,Kahng; Andrew Byun,0,7,8,8
1668598598485,CSE 251B,A01,102392,Cottrell; Garrison W,0,54,0,0
1668598598485,CSE 251B,A02,102393,Cottrell; Garrison W,0,36,0,0
1668598598909,CSE 252B,A00,102394,Ochoa; Benjamin Lawrence,0,64,0,0
1668598599334,CSE 257,A01,102396,Gao; Sicun,0,160,0,0
1668598599776,CSE 272,A00,102397,Li; Tzumao,0,22,0,0
1668598600213,CSE 274,A00,111323,Chern; Albert Ren-Haur,0,16,0,0
1668598600652,CSE 282,A00,102398,Pevzner; Pavel Arkadjevich,0,0,0,0
1668598601088,CSE 284,A00,114175,Gymrek; Melissa Ann,0,33,0,0
1668598601530,CSE 290,A00,102399,Chandraker; Manmohan Krishna,0,11,0,0
1668598601530,CSE 290,B00,102400,Vaccaro; Kristen Marie,0,10,25,25
1668598601530,CSE 290,C00,102414,Pannuto; Patrick William,0,1,25,25
1668598601530,CSE 290,D00,102427,Pevzner; Pavel Arkadjevich,0,0,0,0
1668598601530,CSE 290,E00,102429,Zhao; Jishen,0,6,0,0
1668598601530,CSE 290,F00,102436,Tullsen; Dean Michael,0,6,0,0
1668598601530,CSE 290,G00,102440,Christensen; Henrik I,0,8,20,20
1668598601979,CSE 291,A00,102443,Su; Hao,0,0,0,0
1668598601979,CSE 291,B00,102448,Polikarpova; Nadezhda,0,0,0,0
1668598601979,CSE 291,C00,102453,Vaccaro; Kristen Marie,0,0,0,0
1668598601979,CSE 291,D00,111343,Savage; Stefan,0,0,0,0
1668598601979,CSE 291,E00,116474,Claffy; Kimberly Claire,0,0,0,0
1668598601979,CSE 291,F00,116479,Pasquale; Joseph,0,0,0,0
1668598602424,CSE 293,001,119111,Bafna; Vineet,9999,0,9999,0
1668598602424,CSE 293,002,119118,Bellare; Mihir,9999,0,9999,0
1668598602424,CSE 293,003,119122,Berg-Kirkpatrick; Taylor D,9999,0,9999,0
1668598602424,CSE 293,004,119135,Christensen; Henrik I,9999,0,9999,0
1668598602424,CSE 293,005,119142,Cottrell; Garrison W,9999,0,9999,0
1668598602424,CSE 293,006,119146,Deutsch; Alin Bernard,9999,0,9999,0
1668598602424,CSE 293,007,119159,Esmaeilzadeh; Hadi,9999,0,9999,0
1668598602424,CSE 293,008,119166,Freund; Yoav,9999,0,9999,0
1668598602424,CSE 293,009,119170,Griswold; William G.,9999,0,9999,0
1668598602424,CSE 293,010,119183,Gymrek; Melissa Ann,9999,0,9999,0
1668598602424,CSE 293,011,119190,Heninger; Nadia A,9999,0,9999,0
1668598602424,CSE 293,012,119230,Impagliazzo; Russell,9999,0,9999,0
1668598602424,CSE 293,013,119232,Jhala; Ranjit,9999,0,9999,0
1668598602424,CSE 293,014,119233,Kahng; Andrew Byun,9999,0,9999,0
1668598602424,CSE 293,015,119298,Kane; Daniel Mertz,9999,0,9999,0
1668598602424,CSE 293,016,119299,Kriegman; David J,9999,0,9999,0
1668598602424,CSE 293,017,119300,Kumar; Arun Kumar,9999,0,9999,0
1668598602424,CSE 293,018,119301,Lerner; Sorin,9999,0,9999,0
1668598602424,CSE 293,019,119302,Lovett; Shachar,9999,0,9999,0
1668598602424,CSE 293,020,119303,McAuley; Julian John,9999,0,9999,0
1668598602424,CSE 293,021,119304,Micciancio; Daniele,9999,0,9999,0
1668598602424,CSE 293,022,119367,Orailoglu; Alex,9999,0,9999,0
1668598602424,CSE 293,023,119382,Paturi; Ramamohan,9999,0,9999,0
1668598602424,CSE 293,024,119404,Polikarpova; Nadezhda,9999,0,9999,0
1668598602424,CSE 293,025,119406,Politz; Joseph Gibbs,9999,0,9999,0
1668598602424,CSE 293,026,119411,Porter; George M,9999,0,9999,0
1668598602424,CSE 293,027,119414,Porter; Leonard Emerson,9999,0,9999,0
1668598602424,CSE 293,028,119416,Ramamoorthi; Ravi,9999,0,9999,0
1668598602424,CSE 293,029,119417,Sahoo; Debashis,9999,0,9999,0
1668598602424,CSE 293,030,119420,Saul; Lawrence,9999,0,9999,0
1668598602424,CSE 293,031,119421,Savage; Stefan,9999,0,9999,0
1668598602424,CSE 293,032,119425,Schulze; Jurgen P.,9999,0,9999,0
1668598602424,CSE 293,033,119426,Snoeren; Alex C.,9999,0,9999,0
1668598602424,CSE 293,034,119428,Shang; Jingbo,9999,0,9999,0
1668598602424,CSE 293,035,119430,Stefan; Deian,9999,0,9999,0
1668598602424,CSE 293,036,119431,Su; Hao,9999,0,9999,0
1668598602424,CSE 293,037,119433,Swanson; Steven James,9999,0,9999,0
1668598602424,CSE 293,038,119435,Tullsen; Dean Michael,9999,0,9999,0
1668598602424,CSE 293,039,119483,Voelker; Geoffrey M.,9999,0,9999,0
1668598602424,CSE 293,040,119537,Zhao; Jishen,9999,0,9999,0
1668598602424,CSE 293,041,119538,Zhou; Yuan-Yuan,9999,0,9999,0
1668598602424,CSE 293,042,119539,Gao; Sicun,9999,0,9999,0
1668598602424,CSE 293,043,119540,Weibel; Nadir,9999,0,9999,0
1668598602424,CSE 293,044,119541,Gupta; Rajesh K.,9999,0,9999,0
1668598602424,CSE 293,045,126410,Vaccaro; Kristen Marie,9999,0,9999,0
1668598602424,CSE 293,046,126411,Klemke; Richard,9999,0,9999,0
1668598602853,CSE 294,A00,102459,Voelker; Geoffrey M.,0,2,0,0
1668598602853,CSE 294,B00,111322,Orailoglu; Alex,0,2,0,0
1668598603276,DSE 201,A00,096914,Deutsch; Alin Bernard,30,0,30,0
1668598603711,DSE 210,A00,096915,Dasgupta; Sanjoy,30,0,30,0
1668598604137,DSE 241,A00,144528,Smith; Neil Gordon,30,0,30,0
1668598604565,DSE 260A,A00,096916,Altintas De Callaf; Ilkay,30,0,30,0
1668598605020,ECE 200,001,103586,Antipa; Nicholas A,9999,0,9999,0
1668598605020,ECE 200,002,103587,Atanasov; Nikolay A.,9999,0,9999,0
1668598605020,ECE 200,003,103588,Bharadia; Dinesh,9999,0,9999,0
1668598605020,ECE 200,004,103589,Cheng; Chung Kuan,9999,0,9999,0
1668598605020,ECE 200,005,103590,Cosman; Pamela C.,9999,0,9999,0
1668598605020,ECE 200,006,103591,Dayeh; Shadi Ahmad,9999,0,9999,0
1668598605020,ECE 200,007,103592,Fainman; Yeshaiahu,9999,0,9999,0
1668598605020,ECE 200,008,103593,Ford; Joseph Earl,9999,0,9999,0
1668598605020,ECE 200,009,103594,Franceschetti; Massimo,9999,0,9999,0
1668598605020,ECE 200,010,103595,Fullerton; Eric E,9999,0,9999,0
1668598605020,ECE 200,011,103596,Galton; Ian A,9999,0,9999,0
1668598605020,ECE 200,012,103597,Gilja; Vikash,9999,0,9999,0
1668598605020,ECE 200,013,103598,Hall; Drew A.,9999,0,9999,0
1668598605020,ECE 200,014,103599,Hsueh; Tzu-Chien,9999,0,9999,0
1668598605020,ECE 200,015,103600,Javidi; Tara,9999,0,9999,0
1668598605020,ECE 200,016,103601,Kahng; Andrew Byun,9999,0,9999,0
1668598605020,ECE 200,017,103602,Kim; Young-Han,9999,0,9999,0
1668598605020,ECE 200,018,103603,Koushanfar; Farinaz,9999,0,9999,0
1668598605020,ECE 200,019,103604,Kuzum; Duygu,9999,0,9999,0
1668598605020,ECE 200,020,103605,Le; Hanh-Phuc,9999,0,9999,0
1668598605020,ECE 200,021,103606,Lin; Bill,9999,0,9999,0
1668598605020,ECE 200,022,103607,Liu; Zhaowei,9998,0,9999,1
1668598605020,ECE 200,023,103608,Lo; Yu-Hwa,9999,0,9999,0
1668598605020,ECE 200,024,103609,Lomakin; Vitaliy,9999,0,9999,0
1668598605020,ECE 200,025,103610,Mercier; Patrick Philip,9999,0,9999,0
1668598605020,ECE 200,026,103611,Meyer; Florian,9999,0,9999,0
1668598605020,ECE 200,027,103612,Milstein; Laurence B.,9999,0,9999,0
1668598605020,ECE 200,028,103613,Mir Arabbaygi; Siavash,9999,0,9999,0
1668598605020,ECE 200,029,103614,Mookherjea; Shayan,9999,0,9999,0
1668598605020,ECE 200,030,103615,Morris; Karcher William,9999,0,9999,0
1668598605020,ECE 200,031,103616,Ng; Tse Nga,9999,0,9999,0
1668598605020,ECE 200,032,103617,Nguyen; Truong Quang,9999,0,9999,0
1668598605020,ECE 200,033,103618,Nomura; Kenji,9999,0,9999,0
1668598605020,ECE 200,034,103619,Orlitsky; Alon,9999,0,9999,0
1668598605020,ECE 200,035,103620,Pal; Piya,9999,0,9999,0
1668598605020,ECE 200,036,103621,Papen; George C.,9999,0,9999,0
1668598605020,ECE 200,037,103622,Radic; Stojan,9999,0,9999,0
1668598605020,ECE 200,038,103623,Rao; Bhaskar D.,9999,0,9999,0
1668598605020,ECE 200,039,103624,Rao; Ramesh R,9999,0,9999,0
1668598605020,ECE 200,040,103625,Rebeiz; Gabriel,9999,0,9999,0
1668598605020,ECE 200,041,103626,Sanford; John R,9999,0,9999,0
1668598605020,ECE 200,042,103627,Siegel; Paul H.,9999,0,9999,0
1668598605020,ECE 200,043,103628,Sievenpiper; Daniel F.,9999,0,9999,0
1668598605020,ECE 200,044,103629,Sworder; David D.,9999,0,9999,0
1668598605020,ECE 200,045,103630,Taur; Yuan,9999,0,9999,0
1668598605020,ECE 200,046,103631,Touri; Behrouz,9999,0,9999,0
1668598605020,ECE 200,047,103632,Trivedi; Mohan M.,9999,0,9999,0
1668598605020,ECE 200,048,103633,Vasconcelos; Nuno,9999,0,9999,0
1668598605020,ECE 200,049,103634,Wang; Xiaolong,9999,0,9999,0
1668598605020,ECE 200,050,103635,Xie; Pengtao,9999,0,9999,0
1668598605020,ECE 200,051,103636,Yip; Michael,9999,0,9999,0
1668598605020,ECE 200,052,103637,Zeger; Kenneth A.,999,0,999,0
1668598605020,ECE 200,053,103638,Zhang; Xinyu,9999,0,9999,0
1668598605020,ECE 200,054,103639,Turakhia; Yatish Girish,9999,0,9999,0
1668598605020,ECE 200,055,103640,Kang; Mingu,9999,0,9999,0
1668598605020,ECE 200,056,103641,Shi; Yuanyuan,9999,0,9999,0
1668598605020,ECE 200,057,103642,Wang; Edward Jay,9999,0,9999,0
1668598605020,ECE 200,058,103643,Zheng; Yang,9999,0,9999,0
1668598605447,ECE 202,A00,103644,Kuzum; Duygu,0,47,0,0
1668598605871,ECE 212BN,A00,103646,Ng; Tse Nga,0,10,0,0
1668598606312,ECE 221,A00,111493,Staff,0,0,0,0
1668598606742,ECE 222B,A00,103647,Lomakin; Vitaliy,0,22,0,0
1668598607169,ECE 230B,A00,103648,Taur; Yuan,0,4,0,0
1668598607604,ECE 238B,A00,103649,Garay; Javier,0,0,0,0
1668598608039,ECE 240B,A00,112900,Fainman; Yeshaiahu,0,8,0,0
1668598608465,ECE 247A,A00,103650,Jokerst; Jesse Vincent,0,6,0,0
1668598608900,ECE 247B,A00,103651,Wang; Joseph,0,14,0,0
1668598609351,ECE 250,A00,103652,Siegel; Paul H.,0,85,0,0
1668598609786,ECE 251A,A00,103654,Rao; Bhaskar D.,0,65,0,0
1668598610209,ECE 257B,A00,103655,Bharadia; Dinesh,0,33,0,0
1668598610649,ECE 258A,A00,103656,Milstein; Laurence B.,0,29,0,0
1668598611072,ECE 260B,A00,103658,Kang; Mingu,0,121,0,0
1668598611497,ECE 264A,A00,103659,Galton; Ian A,0,41,0,35
1668598611923,ECE 265A,A00,103661,Gudem; Prasad S.S.,0,40,0,38
1668598612346,ECE 265D,A00,103662,Gudem; Prasad S.S.,0,27,0,0
1668598612773,ECE 268,A00,103663,Koushanfar; Farinaz,0,44,0,0
1668598613203,ECE 269,A01,103665,Pal; Piya,0,223,0,0
1668598613629,ECE 271B,A00,103666,Vasconcelos; Manuela,0,80,0,0
1668598614053,ECE 276A,A00,103667,Atanasov; Nikolay A.,0,127,0,0
1668598614490,ECE 277,A00,103668,An; Cheolhong,0,151,0,0
1668598614913,ECE 279,A00,117947,Hall; Drew A.,0,22,0,0
1668598615769,ECE 283,A00,103670,Hsueh; Tzu-Chien,0,57,0,0
1668598616197,ECE 284,A00,103671,Turakhia; Yatish Girish,0,40,0,0
1668598616626,ECE 285,A00,103672,Zheng; Yang,0,40,0,0
1668598616626,ECE 285,B00,103673,Sworder; David D.,0,61,0,0
1668598617057,ECE 287,A00,103676,Javidi; Tara,0,7,0,0
1668598617484,MATH 200B,A00,098023,Salehi Golsefidy; Alireza,7,0,15,8
1668598617916,MATH 202B,A00,098024,Rhoades; Brendon Patrick,7,0,15,8
1668598618352,MATH 203B,A00,098025,Oprea; Dragos N.,9,0,15,6
1668598618795,MATH 204B,A00,098026,Sorensen; Claus M,13,0,15,2
1668598619219,MATH 208,A00,098027,Izadi; Elham,7,0,10,3
1668598619651,MATH 209,A00,098028,Pollack; Aaron,10,0,10,0
1668598620075,MATH 211A,A00,112919,Rogalski; Daniel,8,0,10,2
1668598620502,MATH 211B,A00,112920,Seward; Brandon M.,9,0,10,1
1668598620928,MATH 218,A00,098029,Li; Bo,10,0,10,0
1668598621354,MATH 220B,A00,098030,Novak; Jonathan I,10,0,15,5
1668598621778,MATH 221A,A00,098031,Ebenfelt; Peter F,12,0,15,3
1668598622209,MATH 231B,A00,098032,Zlatos; Andrej,9,0,15,6
1668598622638,MATH 240B,A00,098033,Ni; Lei,7,0,15,8
1668598623062,MATH 243,A00,098034,Jekel; David Andrew,10,0,10,0
1668598623491,MATH 245A,A00,098035,Nie; Jiawang,0,8,15,18
1668598623919,MATH 248,A00,098036,Bejenaru; Ioan,10,0,10,0
1668598624351,MATH 250B,A00,098037,Spolaor; Luca,12,0,15,3
1668598624803,MATH 258,A00,098038,Ni; Lei,8,0,10,2
1668598625226,MATH 264B,A00,098041,Rhoades; Brendon Patrick,6,0,15,9
1668598625650,MATH 268,A00,098042,Buss; Samuel R,10,0,10,0
1668598626078,MATH 269,A00,098043,Rhoades; Brendon Patrick,10,0,10,0
1668598626503,MATH 270B,A00,098044,Li; Bo,6,0,15,9
1668598626928,MATH 272B,A00,098045,Holst; Michael J,13,0,15,2
1668598627363,MATH 273A,A00,098046,Tian; Xiaochuan,10,0,15,5
1668598627794,MATH 275,A01,098048,Tian; Xiaochuan,6,0,10,4
1668598628220,MATH 278A,A00,098049,Holst; Michael J,6,0,10,4
1668598628648,MATH 278B,A00,098050,Cloninger; Alexander,10,0,10,0
1668598629072,MATH 278C,A00,098051,Nie; Jiawang,5,0,10,5
1668598629504,MATH 280B,A00,098052,Zheng; Tianyi,6,0,15,9
1668598629933,MATH 281B,A00,098053,Bradic; Jelena,0,2,15,15
1668598630487,MATH 282B,A00,098054,Arias-Castro; Ery,0,1,15,15
1668598630916,MATH 285,A00,098055,Fitzsimmons; Patrick J,0,4,15,16
1668598631340,MATH 287B,A00,098056,Arias-Castro; Ery,1,0,15,14
1668598631768,MATH 288,A00,098057,Agarwal; Pooja,9,0,10,1
1668598631768,MATH 288,B00,098058,Zhang; Danna,8,0,10,2
1668598631768,MATH 288,C00,098059,Williams; Ruth J,9,0,10,1
1668598632194,MATH 290B,A00,098060,Roberts; Justin Deritter,12,0,15,3
1668598632619,MATH 292,A00,098061,Belmont; Eva Kinoshita,10,0,10,0
1668598633045,MATH 295,A00,098062,Suk; Andrew Hoon,47,0,50,3
1668598633466,MATH 296,A00,098063,Novak; Jonathan I,20,0,20,0
1668598633902,MATH 297,001,098064,Gamst; Anthony Collins,9997,0,9999,2
1668599139203,COGS 205,A00,101395,Chiba; Andrea,19,0,20,1
1668599139631,COGS 210B,001,101404,Greene; Deanna Jacquelyn,9998,0,9999,1
1668599139631,COGS 210B,002,101417,Xia; Haijun,9999,0,9999,0
1668599139631,COGS 210B,003,101422,Nitz; Douglas A.,9999,0,9999,0
1668599139631,COGS 210B,004,101423,Hollan; James D.,9998,0,9999,1
1668599139631,COGS 210B,005,101424,Deak; Gedeon O.,9998,0,9999,1
1668599139631,COGS 210B,006,101425,Rossano; Federico,9999,0,9999,0
1668599140066,COGS 211B,A00,101427,Coulson; Seana M,9996,0,9999,3
1668599140491,COGS 220,A00,101428,Hollan; James D.,0,17,25,25
1668599140917,COGS 229,A00,101429,Dow; Steven P,17,0,25,8
1668599141345,COGS 230,A00,101430,Klemmer; Scott R,6,0,17,11
1668599141769,COGS 234,A00,101431,Xia; Haijun,0,1,25,25
1668599142194,COGS 260,A00,101432,Kiyonaga; Anastasia,21,0,25,4
1668599142194,COGS 260,B00,101433,Kirsh; David Joel,15,0,25,10
1668599142624,CSE 202,A00,102371,Impagliazzo; Russell,0,70,0,0
1668599143051,CSE 203B,A01,102373,Cheng; Chung Kuan,0,70,0,0
1668599143475,CSE 208,A00,102374,Micciancio; Daniele,0,5,0,0
1668599143912,CSE 209A,A00,112895,Impagliazzo; Russell,0,14,15,15
1668599144349,CSE 209B,A00,108005,Bellare; Mihir,0,7,0,0
1668599144774,CSE 210,A00,113163,Coblenz; Michael J,0,96,0,0
1668599145198,CSE 219,A00,106111,Dow; Steven P,0,8,20,20
1668599145631,CSE 221,A00,102376,Voelker; Geoffrey M.,0,78,0,0
1668599146056,CSE 224,A01,102378,Porter; George M,0,181,0,0
1668599146485,CSE 229A,A00,102379,Savage; Stefan,0,14,0,0
1668599146917,CSE 229C,A00,102380,Munyaka; Imani N. S.,0,12,0,0
1668599147350,CSE 232B,A00,102382,Deutsch; Alin Bernard,0,40,0,0
1668599147786,CSE 234,A01,112904,Kumar; Arun Kumar,0,0,0,0
1668599148237,CSE 237A,A00,102383,Rosing; Tajana Simunic,0,57,0,0
1668599148662,CSE 239A,A00,102384,Deutsch; Alin Bernard,0,18,0,0
1668599149090,CSE 239B,A00,102385,Polikarpova; Nadezhda,0,11,0,0
1668599149527,CSE 240A,A00,102386,Pannuto; Patrick William,0,49,0,0
1668599149955,CSE 240B,A00,102387,Zhao; Jishen,0,51,0,0
1668599150384,CSE 241A,A00,106406,Kang; Mingu,0,9,0,0
1668599150810,CSE 249B,A00,102388,Kahng; Andrew Byun,0,7,8,8
1668599151245,CSE 251B,A01,102392,Cottrell; Garrison W,0,54,0,0
1668599151245,CSE 251B,A02,102393,Cottrell; Garrison W,0,36,0,0
1668599151700,CSE 252B,A00,102394,Ochoa; Benjamin Lawrence,0,64,0,0
1668599152142,CSE 257,A01,102396,Gao; Sicun,0,160,0,0
1668599152579,CSE 272,A00,102397,Li; Tzumao,0,22,0,0
1668599153009,CSE 274,A00,111323,Chern; Albert Ren-Haur,0,16,0,0
1668599153435,CSE 282,A00,102398,Pevzner; Pavel Arkadjevich,0,0,0,0
1668599153866,CSE 284,A00,114175,Gymrek; Melissa Ann,0,33,0,0
1668599154387,CSE 290,A00,102399,Chandraker; Manmohan Krishna,0,11,0,0
1668599154387,CSE 290,B00,102400,Vaccaro; Kristen Marie,0,10,25,25
1668599154387,CSE 290,C00,102414,Pannuto; Patrick William,0,1,25,25
1668599154387,CSE 290,D00,102427,Pevzner; Pavel Arkadjevich,0,0,0,0
1668599154387,CSE 290,E00,102429,Zhao; Jishen,0,6,0,0
1668599154387,CSE 290,F00,102436,Tullsen; Dean Michael,0,6,0,0
1668599154387,CSE 290,G00,102440,Christensen; Henrik I,0,8,20,20
1668599154824,CSE 291,A00,102443,Su; Hao,0,0,0,0
1668599154824,CSE 291,B00,102448,Polikarpova; Nadezhda,0,0,0,0
1668599154824,CSE 291,C00,102453,Vaccaro; Kristen Marie,0,0,0,0
1668599154824,CSE 291,D00,111343,Savage; Stefan,0,0,0,0
1668599154824,CSE 291,E00,116474,Claffy; Kimberly Claire,0,0,0,0
1668599154824,CSE 291,F00,116479,Pasquale; Joseph,0,0,0,0
1668599155301,CSE 293,001,119111,Bafna; Vineet,9999,0,9999,0
1668599155301,CSE 293,002,119118,Bellare; Mihir,9999,0,9999,0
1668599155301,CSE 293,003,119122,Berg-Kirkpatrick; Taylor D,9999,0,9999,0
1668599155301,CSE 293,004,119135,Christensen; Henrik I,9999,0,9999,0
1668599155301,CSE 293,005,119142,Cottrell; Garrison W,9999,0,9999,0
1668599155301,CSE 293,006,119146,Deutsch; Alin Bernard,9999,0,9999,0
1668599155301,CSE 293,007,119159,Esmaeilzadeh; Hadi,9999,0,9999,0
1668599155301,CSE 293,008,119166,Freund; Yoav,9999,0,9999,0
1668599155301,CSE 293,009,119170,Griswold; William G.,9999,0,9999,0
1668599155301,CSE 293,010,119183,Gymrek; Melissa Ann,9999,0,9999,0
1668599155301,CSE 293,011,119190,Heninger; Nadia A,9999,0,9999,0
1668599155301,CSE 293,012,119230,Impagliazzo; Russell,9999,0,9999,0
1668599155301,CSE 293,013,119232,Jhala; Ranjit,9999,0,9999,0
1668599155301,CSE 293,014,119233,Kahng; Andrew Byun,9999,0,9999,0
1668599155301,CSE 293,015,119298,Kane; Daniel Mertz,9999,0,9999,0
1668599155301,CSE 293,016,119299,Kriegman; David J,9999,0,9999,0
1668599155301,CSE 293,017,119300,Kumar; Arun Kumar,9999,0,9999,0
1668599155301,CSE 293,018,119301,Lerner; Sorin,9999,0,9999,0
1668599155301,CSE 293,019,119302,Lovett; Shachar,9999,0,9999,0
1668599155301,CSE 293,020,119303,McAuley; Julian John,9999,0,9999,0
1668599155301,CSE 293,021,119304,Micciancio; Daniele,9999,0,9999,0
1668599155301,CSE 293,022,119367,Orailoglu; Alex,9999,0,9999,0
1668599155301,CSE 293,023,119382,Paturi; Ramamohan,9999,0,9999,0
1668599155301,CSE 293,024,119404,Polikarpova; Nadezhda,9999,0,9999,0
1668599155301,CSE 293,025,119406,Politz; Joseph Gibbs,9999,0,9999,0
1668599155301,CSE 293,026,119411,Porter; George M,9999,0,9999,0
1668599155301,CSE 293,027,119414,Porter; Leonard Emerson,9999,0,9999,0
1668599155301,CSE 293,028,119416,Ramamoorthi; Ravi,9999,0,9999,0
1668599155301,CSE 293,029,119417,Sahoo; Debashis,9999,0,9999,0
1668599155301,CSE 293,030,119420,Saul; Lawrence,9999,0,9999,0
1668599155301,CSE 293,031,119421,Savage; Stefan,9999,0,9999,0
1668599155301,CSE 293,032,119425,Schulze; Jurgen P.,9999,0,9999,0
1668599155301,CSE 293,033,119426,Snoeren; Alex C.,9999,0,9999,0
1668599155301,CSE 293,034,119428,Shang; Jingbo,9999,0,9999,0
1668599155301,CSE 293,035,119430,Stefan; Deian,9999,0,9999,0
1668599155301,CSE 293,036,119431,Su; Hao,9999,0,9999,0
1668599155301,CSE 293,037,119433,Swanson; Steven James,9999,0,9999,0
1668599155301,CSE 293,038,119435,Tullsen; Dean Michael,9999,0,9999,0
1668599155301,CSE 293,039,119483,Voelker; Geoffrey M.,9999,0,9999,0
1668599155301,CSE 293,040,119537,Zhao; Jishen,9999,0,9999,0
1668599155301,CSE 293,041,119538,Zhou; Yuan-Yuan,9999,0,9999,0
1668599155301,CSE 293,042,119539,Gao; Sicun,9999,0,9999,0
1668599155301,CSE 293,043,119540,Weibel; Nadir,9999,0,9999,0
1668599155301,CSE 293,044,119541,Gupta; Rajesh K.,9999,0,9999,0
1668599155301,CSE 293,045,126410,Vaccaro; Kristen Marie,9999,0,9999,0
1668599155301,CSE 293,046,126411,Klemke; Richard,9999,0,9999,0
1668599155732,CSE 294,A00,102459,Voelker; Geoffrey M.,0,2,0,0
1668599155732,CSE 294,B00,111322,Orailoglu; Alex,0,2,0,0
1668599156156,DSE 201,A00,096914,Deutsch; Alin Bernard,30,0,30,0
1668599156586,DSE 210,A00,096915,Dasgupta; Sanjoy,30,0,30,0
1668599157014,DSE 241,A00,144528,Smith; Neil Gordon,30,0,30,0
1668599157440,DSE 260A,A00,096916,Altintas De Callaf; Ilkay,30,0,30,0
1668599157894,ECE 200,001,103586,Antipa; Nicholas A,9999,0,9999,0
1668599157894,ECE 200,002,103587,Atanasov; Nikolay A.,9999,0,9999,0
1668599157894,ECE 200,003,103588,Bharadia; Dinesh,9999,0,9999,0
1668599157894,ECE 200,004,103589,Cheng; Chung Kuan,9999,0,9999,0
1668599157894,ECE 200,005,103590,Cosman; Pamela C.,9999,0,9999,0
1668599157894,ECE 200,006,103591,Dayeh; Shadi Ahmad,9999,0,9999,0
1668599157894,ECE 200,007,103592,Fainman; Yeshaiahu,9999,0,9999,0
1668599157894,ECE 200,008,103593,Ford; Joseph Earl,9999,0,9999,0
1668599157894,ECE 200,009,103594,Franceschetti; Massimo,9999,0,9999,0
1668599157894,ECE 200,010,103595,Fullerton; Eric E,9999,0,9999,0
1668599157894,ECE 200,011,103596,Galton; Ian A,9999,0,9999,0
1668599157894,ECE 200,012,103597,Gilja; Vikash,9999,0,9999,0
1668599157894,ECE 200,013,103598,Hall; Drew A.,9999,0,9999,0
1668599157894,ECE 200,014,103599,Hsueh; Tzu-Chien,9999,0,9999,0
1668599157894,ECE 200,015,103600,Javidi; Tara,9999,0,9999,0
1668599157894,ECE 200,016,103601,Kahng; Andrew Byun,9999,0,9999,0
1668599157894,ECE 200,017,103602,Kim; Young-Han,9999,0,9999,0
1668599157894,ECE 200,018,103603,Koushanfar; Farinaz,9999,0,9999,0
1668599157894,ECE 200,019,103604,Kuzum; Duygu,9999,0,9999,0
1668599157894,ECE 200,020,103605,Le; Hanh-Phuc,9999,0,9999,0
1668599157894,ECE 200,021,103606,Lin; Bill,9999,0,9999,0
1668599157894,ECE 200,022,103607,Liu; Zhaowei,9998,0,9999,1
1668599157894,ECE 200,023,103608,Lo; Yu-Hwa,9999,0,9999,0
1668599157894,ECE 200,024,103609,Lomakin; Vitaliy,9999,0,9999,0
1668599157894,ECE 200,025,103610,Mercier; Patrick Philip,9999,0,9999,0
1668599157894,ECE 200,026,103611,Meyer; Florian,9999,0,9999,0
1668599157894,ECE 200,027,103612,Milstein; Laurence B.,9999,0,9999,0
1668599157894,ECE 200,028,103613,Mir Arabbaygi; Siavash,9999,0,9999,0
1668599157894,ECE 200,029,103614,Mookherjea; Shayan,9999,0,9999,0
1668599157894,ECE 200,030,103615,Morris; Karcher William,9999,0,9999,0
1668599157894,ECE 200,031,103616,Ng; Tse Nga,9999,0,9999,0
1668599157894,ECE 200,032,103617,Nguyen; Truong Quang,9999,0,9999,0
1668599157894,ECE 200,033,103618,Nomura; Kenji,9999,0,9999,0
1668599157894,ECE 200,034,103619,Orlitsky; Alon,9999,0,9999,0
1668599157894,ECE 200,035,103620,Pal; Piya,9999,0,9999,0
1668599157894,ECE 200,036,103621,Papen; George C.,9999,0,9999,0
1668599157894,ECE 200,037,103622,Radic; Stojan,9999,0,9999,0
1668599157894,ECE 200,038,103623,Rao; Bhaskar D.,9999,0,9999,0
1668599157894,ECE 200,039,103624,Rao; Ramesh R,9999,0,9999,0
1668599157894,ECE 200,040,103625,Rebeiz; Gabriel,9999,0,9999,0
1668599157894,ECE 200,041,103626,Sanford; John R,9999,0,9999,0
1668599157894,ECE 200,042,103627,Siegel; Paul H.,9999,0,9999,0
1668599157894,ECE 200,043,103628,Sievenpiper; Daniel F.,9999,0,9999,0
1668599157894,ECE 200,044,103629,Sworder; David D.,9999,0,9999,0
1668599157894,ECE 200,045,103630,Taur; Yuan,9999,0,9999,0
1668599157894,ECE 200,046,103631,Touri; Behrouz,9999,0,9999,0
1668599157894,ECE 200,047,103632,Trivedi; Mohan M.,9999,0,9999,0
1668599157894,ECE 200,048,103633,Vasconcelos; Nuno,9999,0,9999,0
1668599157894,ECE 200,049,103634,Wang; Xiaolong,9999,0,9999,0
1668599157894,ECE 200,050,103635,Xie; Pengtao,9999,0,9999,0
1668599157894,ECE 200,051,103636,Yip; Michael,9999,0,9999,0
1668599157894,ECE 200,052,103637,Zeger; Kenneth A.,999,0,999,0
1668599157894,ECE 200,053,103638,Zhang; Xinyu,9999,0,9999,0
1668599157894,ECE 200,054,103639,Turakhia; Yatish Girish,9999,0,9999,0
1668599157894,ECE 200,055,103640,Kang; Mingu,9999,0,9999,0
1668599157894,ECE 200,056,103641,Shi; Yuanyuan,9999,0,9999,0
1668599157894,ECE 200,057,103642,Wang; Edward Jay,9999,0,9999,0
1668599157894,ECE 200,058,103643,Zheng; Yang,9999,0,9999,0
1668599158320,ECE 202,A00,103644,Kuzum; Duygu,0,47,0,0
1668599158744,ECE 212BN,A00,103646,Ng; Tse Nga,0,10,0,0
1668599159170,ECE 221,A00,111493,Staff,0,0,0,0
1668599159597,ECE 222B,A00,103647,Lomakin; Vitaliy,0,22,0,0
1668599160032,ECE 230B,A00,103648,Taur; Yuan,0,4,0,0
1668599160458,ECE 238B,A00,103649,Garay; Javier,0,0,0,0
1668599160882,ECE 240B,A00,112900,Fainman; Yeshaiahu,0,8,0,0
1668599161307,ECE 247A,A00,103650,Jokerst; Jesse Vincent,0,6,0,0
1668599161730,ECE 247B,A00,103651,Wang; Joseph,0,14,0,0
1668599162170,ECE 250,A00,103652,Siegel; Paul H.,0,85,0,0
1668599162599,ECE 251A,A00,103654,Rao; Bhaskar D.,0,65,0,0
1668599163030,ECE 257B,A00,103655,Bharadia; Dinesh,0,33,0,0
1668599163458,ECE 258A,A00,103656,Milstein; Laurence B.,0,29,0,0
1668599163881,ECE 260B,A00,103658,Kang; Mingu,0,121,0,0
1668599164313,ECE 264A,A00,103659,Galton; Ian A,0,41,0,35
1668599164737,ECE 265A,A00,103661,Gudem; Prasad S.S.,0,40,0,38
1668599165166,ECE 265D,A00,103662,Gudem; Prasad S.S.,0,27,0,0
1668599165591,ECE 268,A00,103663,Koushanfar; Farinaz,0,44,0,0
1668599166024,ECE 269,A01,103665,Pal; Piya,0,223,0,0
1668599166473,ECE 271B,A00,103666,Vasconcelos; Manuela,0,80,0,0
1668599166901,ECE 276A,A00,103667,Atanasov; Nikolay A.,0,127,0,0
1668599167340,ECE 277,A00,103668,An; Cheolhong,0,151,0,0
1668599167767,ECE 279,A00,117947,Hall; Drew A.,0,22,0,0
1668599168649,ECE 283,A00,103670,Hsueh; Tzu-Chien,0,57,0,0
1668599169085,ECE 284,A00,103671,Turakhia; Yatish Girish,0,40,0,0
1668599169517,ECE 285,A00,103672,Zheng; Yang,0,40,0,0
1668599169517,ECE 285,B00,103673,Sworder; David D.,0,61,0,0
1668599169942,ECE 287,A00,103676,Javidi; Tara,0,7,0,0
1668599170369,MATH 200B,A00,098023,Salehi Golsefidy; Alireza,7,0,15,8
1668599170793,MATH 202B,A00,098024,Rhoades; Brendon Patrick,7,0,15,8
1668599171220,MATH 203B,A00,098025,Oprea; Dragos N.,9,0,15,6
1668599171646,MATH 204B,A00,098026,Sorensen; Claus M,13,0,15,2
1668599172071,MATH 208,A00,098027,Izadi; Elham,7,0,10,3
1668599172496,MATH 209,A00,098028,Pollack; Aaron,10,0,10,0
1668599172924,MATH 211A,A00,112919,Rogalski; Daniel,8,0,10,2
1668599173348,MATH 211B,A00,112920,Seward; Brandon M.,9,0,10,1
1668599173776,MATH 218,A00,098029,Li; Bo,10,0,10,0
1668599174204,MATH 220B,A00,098030,Novak; Jonathan I,10,0,15,5
1668599174628,MATH 221A,A00,098031,Ebenfelt; Peter F,12,0,15,3
1668599175056,MATH 231B,A00,098032,Zlatos; Andrej,9,0,15,6
1668599175484,MATH 240B,A00,098033,Ni; Lei,7,0,15,8
1668599175915,MATH 243,A00,098034,Jekel; David Andrew,10,0,10,0
1668599176346,MATH 245A,A00,098035,Nie; Jiawang,0,8,15,18
1668599176776,MATH 248,A00,098036,Bejenaru; Ioan,10,0,10,0
1668599177201,MATH 250B,A00,098037,Spolaor; Luca,12,0,15,3
1668599177625,MATH 258,A00,098038,Ni; Lei,8,0,10,2
1668599178055,MATH 264B,A00,098041,Rhoades; Brendon Patrick,6,0,15,9
1668599178480,MATH 268,A00,098042,Buss; Samuel R,10,0,10,0
1668599178905,MATH 269,A00,098043,Rhoades; Brendon Patrick,10,0,10,0
1668599179338,MATH 270B,A00,098044,Li; Bo,6,0,15,9
1668599179766,MATH 272B,A00,098045,Holst; Michael J,13,0,15,2
1668599180194,MATH 273A,A00,098046,Tian; Xiaochuan,10,0,15,5
1668599180637,MATH 275,A01,098048,Tian; Xiaochuan,6,0,10,4
1668599181060,MATH 278A,A00,098049,Holst; Michael J,6,0,10,4
1668599181486,MATH 278B,A00,098050,Cloninger; Alexander,10,0,10,0
1668599181909,MATH 278C,A00,098051,Nie; Jiawang,5,0,10,5
1668599182337,MATH 280B,A00,098052,Zheng; Tianyi,6,0,15,9
1668599182761,MATH 281B,A00,098053,Bradic; Jelena,0,2,15,15
1668599183189,MATH 282B,A00,098054,Arias-Castro; Ery,0,1,15,15
1668599183617,MATH 285,A00,098055,Fitzsimmons; Patrick J,0,4,15,16
1668599184039,MATH 287B,A00,098056,Arias-Castro; Ery,1,0,15,14
1668599184469,MATH 288,A00,098057,Agarwal; Pooja,9,0,10,1
1668599184469,MATH 288,B00,098058,Zhang; Danna,8,0,10,2
1668599184469,MATH 288,C00,098059,Williams; Ruth J,9,0,10,1
1668599184895,MATH 290B,A00,098060,Roberts; Justin Deritter,12,0,15,3
1668599185318,MATH 292,A00,098061,Belmont; Eva Kinoshita,10,0,10,0
1668599185750,MATH 295,A00,098062,Suk; Andrew Hoon,47,0,50,3
1668599186184,MATH 296,A00,098063,Novak; Jonathan I,20,0,20,0
1668599186617,MATH 297,001,098064,Gamst; Anthony Collins,9997,0,9999,2
1668599691907,COGS 205,A00,101395,Chiba; Andrea,19,0,20,1
1668599692360,COGS 210B,001,101404,Greene; Deanna Jacquelyn,9998,0,9999,1
1668599692360,COGS 210B,002,101417,Xia; Haijun,9999,0,9999,0
1668599692360,COGS 210B,003,101422,Nitz; Douglas A.,9999,0,9999,0
1668599692360,COGS 210B,004,101423,Hollan; James D.,9998,0,9999,1
1668599692360,COGS 210B,005,101424,Deak; Gedeon O.,9998,0,9999,1
1668599692360,COGS 210B,006,101425,Rossano; Federico,9999,0,9999,0
1668599692790,COGS 211B,A00,101427,Coulson; Seana M,9996,0,9999,3
1668599693217,COGS 220,A00,101428,Hollan; James D.,0,17,25,25
1668599693645,COGS 229,A00,101429,Dow; Steven P,17,0,25,8
1668599694073,COGS 230,A00,101430,Klemmer; Scott R,6,0,17,11
1668599694509,COGS 234,A00,101431,Xia; Haijun,0,1,25,25
1668599694943,COGS 260,A00,101432,Kiyonaga; Anastasia,21,0,25,4
1668599694943,COGS 260,B00,101433,Kirsh; David Joel,15,0,25,10
1668599695378,CSE 202,A00,102371,Impagliazzo; Russell,0,70,0,0
1668599695815,CSE 203B,A01,102373,Cheng; Chung Kuan,0,70,0,0
1668599696244,CSE 208,A00,102374,Micciancio; Daniele,0,5,0,0
1668599696670,CSE 209A,A00,112895,Impagliazzo; Russell,0,14,15,15
1668599697096,CSE 209B,A00,108005,Bellare; Mihir,0,7,0,0
1668599697540,CSE 210,A00,113163,Coblenz; Michael J,0,96,0,0
1668599697964,CSE 219,A00,106111,Dow; Steven P,0,8,20,20
1668599698391,CSE 221,A00,102376,Voelker; Geoffrey M.,0,78,0,0
1668599698816,CSE 224,A01,102378,Porter; George M,0,181,0,0
1668599699245,CSE 229A,A00,102379,Savage; Stefan,0,14,0,0
1668599699675,CSE 229C,A00,102380,Munyaka; Imani N. S.,0,12,0,0
1668599700101,CSE 232B,A00,102382,Deutsch; Alin Bernard,0,40,0,0
1668599700540,CSE 234,A01,112904,Kumar; Arun Kumar,0,0,0,0
1668599700976,CSE 237A,A00,102383,Rosing; Tajana Simunic,0,57,0,0
1668599701403,CSE 239A,A00,102384,Deutsch; Alin Bernard,0,18,0,0
1668599701828,CSE 239B,A00,102385,Polikarpova; Nadezhda,0,11,0,0
1668599702259,CSE 240A,A00,102386,Pannuto; Patrick William,0,49,0,0
1668599702683,CSE 240B,A00,102387,Zhao; Jishen,0,51,0,0
1668599703107,CSE 241A,A00,106406,Kang; Mingu,0,9,0,0
1668599703532,CSE 249B,A00,102388,Kahng; Andrew Byun,0,7,8,8
1668599703959,CSE 251B,A01,102392,Cottrell; Garrison W,0,54,0,0
1668599703959,CSE 251B,A02,102393,Cottrell; Garrison W,0,36,0,0
1668599704389,CSE 252B,A00,102394,Ochoa; Benjamin Lawrence,0,64,0,0
1668599704819,CSE 257,A01,102396,Gao; Sicun,0,160,0,0
1668599705244,CSE 272,A00,102397,Li; Tzumao,0,22,0,0
1668599705674,CSE 274,A00,111323,Chern; Albert Ren-Haur,0,16,0,0
1668599706099,CSE 282,A00,102398,Pevzner; Pavel Arkadjevich,0,0,0,0
1668599706527,CSE 284,A00,114175,Gymrek; Melissa Ann,0,33,0,0
1668599706958,CSE 290,A00,102399,Chandraker; Manmohan Krishna,0,11,0,0
1668599706958,CSE 290,B00,102400,Vaccaro; Kristen Marie,0,10,25,25
1668599706958,CSE 290,C00,102414,Pannuto; Patrick William,0,1,25,25
1668599706958,CSE 290,D00,102427,Pevzner; Pavel Arkadjevich,0,0,0,0
1668599706958,CSE 290,E00,102429,Zhao; Jishen,0,6,0,0
1668599706958,CSE 290,F00,102436,Tullsen; Dean Michael,0,6,0,0
1668599706958,CSE 290,G00,102440,Christensen; Henrik I,0,8,20,20
1668599707396,CSE 291,A00,102443,Su; Hao,0,0,0,0
1668599707396,CSE 291,B00,102448,Polikarpova; Nadezhda,0,0,0,0
1668599707396,CSE 291,C00,102453,Vaccaro; Kristen Marie,0,0,0,0
1668599707396,CSE 291,D00,111343,Savage; Stefan,0,0,0,0
1668599707396,CSE 291,E00,116474,Claffy; Kimberly Claire,0,0,0,0
1668599707396,CSE 291,F00,116479,Pasquale; Joseph,0,0,0,0
1668599707863,CSE 293,001,119111,Bafna; Vineet,9999,0,9999,0
1668599707863,CSE 293,002,119118,Bellare; Mihir,9999,0,9999,0
1668599707863,CSE 293,003,119122,Berg-Kirkpatrick; Taylor D,9999,0,9999,0
1668599707863,CSE 293,004,119135,Christensen; Henrik I,9999,0,9999,0
1668599707863,CSE 293,005,119142,Cottrell; Garrison W,9999,0,9999,0
1668599707863,CSE 293,006,119146,Deutsch; Alin Bernard,9999,0,9999,0
1668599707863,CSE 293,007,119159,Esmaeilzadeh; Hadi,9999,0,9999,0
1668599707863,CSE 293,008,119166,Freund; Yoav,9999,0,9999,0
1668599707863,CSE 293,009,119170,Griswold; William G.,9999,0,9999,0
1668599707863,CSE 293,010,119183,Gymrek; Melissa Ann,9999,0,9999,0
1668599707863,CSE 293,011,119190,Heninger; Nadia A,9999,0,9999,0
1668599707863,CSE 293,012,119230,Impagliazzo; Russell,9999,0,9999,0
1668599707863,CSE 293,013,119232,Jhala; Ranjit,9999,0,9999,0
1668599707863,CSE 293,014,119233,Kahng; Andrew Byun,9999,0,9999,0
1668599707863,CSE 293,015,119298,Kane; Daniel Mertz,9999,0,9999,0
1668599707863,CSE 293,016,119299,Kriegman; David J,9999,0,9999,0
1668599707863,CSE 293,017,119300,Kumar; Arun Kumar,9999,0,9999,0
1668599707863,CSE 293,018,119301,Lerner; Sorin,9999,0,9999,0
1668599707863,CSE 293,019,119302,Lovett; Shachar,9999,0,9999,0
1668599707863,CSE 293,020,119303,McAuley; Julian John,9999,0,9999,0
1668599707863,CSE 293,021,119304,Micciancio; Daniele,9999,0,9999,0
1668599707863,CSE 293,022,119367,Orailoglu; Alex,9999,0,9999,0
1668599707863,CSE 293,023,119382,Paturi; Ramamohan,9999,0,9999,0
1668599707863,CSE 293,024,119404,Polikarpova; Nadezhda,9999,0,9999,0
1668599707863,CSE 293,025,119406,Politz; Joseph Gibbs,9999,0,9999,0
1668599707863,CSE 293,026,119411,Porter; George M,9999,0,9999,0
1668599707863,CSE 293,027,119414,Porter; Leonard Emerson,9999,0,9999,0
1668599707863,CSE 293,028,119416,Ramamoorthi; Ravi,9999,0,9999,0
1668599707863,CSE 293,029,119417,Sahoo; Debashis,9999,0,9999,0
1668599707863,CSE 293,030,119420,Saul; Lawrence,9999,0,9999,0
1668599707863,CSE 293,031,119421,Savage; Stefan,9999,0,9999,0
1668599707863,CSE 293,032,119425,Schulze; Jurgen P.,9999,0,9999,0
1668599707863,CSE 293,033,119426,Snoeren; Alex C.,9999,0,9999,0
1668599707863,CSE 293,034,119428,Shang; Jingbo,9999,0,9999,0
1668599707863,CSE 293,035,119430,Stefan; Deian,9999,0,9999,0
1668599707863,CSE 293,036,119431,Su; Hao,9999,0,9999,0
1668599707863,CSE 293,037,119433,Swanson; Steven James,9999,0,9999,0
1668599707863,CSE 293,038,119435,Tullsen; Dean Michael,9999,0,9999,0
1668599707863,CSE 293,039,119483,Voelker; Geoffrey M.,9999,0,9999,0
1668599707863,CSE 293,040,119537,Zhao; Jishen,9999,0,9999,0
1668599707863,CSE 293,041,119538,Zhou; Yuan-Yuan,9999,0,9999,0
1668599707863,CSE 293,042,119539,Gao; Sicun,9999,0,9999,0
1668599707863,CSE 293,043,119540,Weibel; Nadir,9999,0,9999,0
1668599707863,CSE 293,044,119541,Gupta; Rajesh K.,9999,0,9999,0
1668599707863,CSE 293,045,126410,Vaccaro; Kristen Marie,9999,0,9999,0
1668599707863,CSE 293,046,126411,Klemke; Richard,9999,0,9999,0
1668599708288,CSE 294,A00,102459,Voelker; Geoffrey M.,0,2,0,0
1668599708288,CSE 294,B00,111322,Orailoglu; Alex,0,2,0,0
1668599708718,DSE 201,A00,096914,Deutsch; Alin Bernard,30,0,30,0
1668599709143,DSE 210,A00,096915,Dasgupta; Sanjoy,30,0,30,0
1668599709567,DSE 241,A00,144528,Smith; Neil Gordon,30,0,30,0
1668599709993,DSE 260A,A00,096916,Altintas De Callaf; Ilkay,30,0,30,0
1668599710498,ECE 200,001,103586,Antipa; Nicholas A,9999,0,9999,0
1668599710498,ECE 200,002,103587,Atanasov; Nikolay A.,9999,0,9999,0
1668599710498,ECE 200,003,103588,Bharadia; Dinesh,9999,0,9999,0
1668599710498,ECE 200,004,103589,Cheng; Chung Kuan,9999,0,9999,0
1668599710498,ECE 200,005,103590,Cosman; Pamela C.,9999,0,9999,0
1668599710498,ECE 200,006,103591,Dayeh; Shadi Ahmad,9999,0,9999,0
1668599710498,ECE 200,007,103592,Fainman; Yeshaiahu,9999,0,9999,0
1668599710498,ECE 200,008,103593,Ford; Joseph Earl,9999,0,9999,0
1668599710498,ECE 200,009,103594,Franceschetti; Massimo,9999,0,9999,0
1668599710498,ECE 200,010,103595,Fullerton; Eric E,9999,0,9999,0
1668599710498,ECE 200,011,103596,Galton; Ian A,9999,0,9999,0
1668599710498,ECE 200,012,103597,Gilja; Vikash,9999,0,9999,0
1668599710498,ECE 200,013,103598,Hall; Drew A.,9999,0,9999,0
1668599710498,ECE 200,014,103599,Hsueh; Tzu-Chien,9999,0,9999,0
1668599710498,ECE 200,015,103600,Javidi; Tara,9999,0,9999,0
1668599710498,ECE 200,016,103601,Kahng; Andrew Byun,9999,0,9999,0
1668599710498,ECE 200,017,103602,Kim; Young-Han,9999,0,9999,0
1668599710498,ECE 200,018,103603,Koushanfar; Farinaz,9999,0,9999,0
1668599710498,ECE 200,019,103604,Kuzum; Duygu,9999,0,9999,0
1668599710498,ECE 200,020,103605,Le; Hanh-Phuc,9999,0,9999,0
1668599710498,ECE 200,021,103606,Lin; Bill,9999,0,9999,0
1668599710498,ECE 200,022,103607,Liu; Zhaowei,9998,0,9999,1
1668599710498,ECE 200,023,103608,Lo; Yu-Hwa,9999,0,9999,0
1668599710498,ECE 200,024,103609,Lomakin; Vitaliy,9999,0,9999,0
1668599710498,ECE 200,025,103610,Mercier; Patrick Philip,9999,0,9999,0
1668599710498,ECE 200,026,103611,Meyer; Florian,9999,0,9999,0
1668599710498,ECE 200,027,103612,Milstein; Laurence B.,9999,0,9999,0
1668599710498,ECE 200,028,103613,Mir Arabbaygi; Siavash,9999,0,9999,0
1668599710498,ECE 200,029,103614,Mookherjea; Shayan,9999,0,9999,0
1668599710498,ECE 200,030,103615,Morris; Karcher William,9999,0,9999,0
1668599710498,ECE 200,031,103616,Ng; Tse Nga,9999,0,9999,0
1668599710498,ECE 200,032,103617,Nguyen; Truong Quang,9999,0,9999,0
1668599710498,ECE 200,033,103618,Nomura; Kenji,9999,0,9999,0
1668599710498,ECE 200,034,103619,Orlitsky; Alon,9999,0,9999,0
1668599710498,ECE 200,035,103620,Pal; Piya,9999,0,9999,0
1668599710498,ECE 200,036,103621,Papen; George C.,9999,0,9999,0
1668599710498,ECE 200,037,103622,Radic; Stojan,9999,0,9999,0
1668599710498,ECE 200,038,103623,Rao; Bhaskar D.,9999,0,9999,0
1668599710498,ECE 200,039,103624,Rao; Ramesh R,9999,0,9999,0
1668599710498,ECE 200,040,103625,Rebeiz; Gabriel,9999,0,9999,0
1668599710498,ECE 200,041,103626,Sanford; John R,9999,0,9999,0
1668599710498,ECE 200,042,103627,Siegel; Paul H.,9999,0,9999,0
1668599710498,ECE 200,043,103628,Sievenpiper; Daniel F.,9999,0,9999,0
1668599710498,ECE 200,044,103629,Sworder; David D.,9999,0,9999,0
1668599710498,ECE 200,045,103630,Taur; Yuan,9999,0,9999,0
1668599710498,ECE 200,046,103631,Touri; Behrouz,9999,0,9999,0
1668599710498,ECE 200,047,103632,Trivedi; Mohan M.,9999,0,9999,0
1668599710498,ECE 200,048,103633,Vasconcelos; Nuno,9999,0,9999,0
1668599710498,ECE 200,049,103634,Wang; Xiaolong,9999,0,9999,0
1668599710498,ECE 200,050,103635,Xie; Pengtao,9999,0,9999,0
1668599710498,ECE 200,051,103636,Yip; Michael,9999,0,9999,0
1668599710498,ECE 200,052,103637,Zeger; Kenneth A.,999,0,999,0
1668599710498,ECE 200,053,103638,Zhang; Xinyu,9999,0,9999,0
1668599710498,ECE 200,054,103639,Turakhia; Yatish Girish,9999,0,9999,0
1668599710498,ECE 200,055,103640,Kang; Mingu,9999,0,9999,0
1668599710498,ECE 200,056,103641,Shi; Yuanyuan,9999,0,9999,0
1668599710498,ECE 200,057,103642,Wang; Edward Jay,9999,0,9999,0
1668599710498,ECE 200,058,103643,Zheng; Yang,9999,0,9999,0
1668599710926,ECE 202,A00,103644,Kuzum; Duygu,0,47,0,0
1668599711352,ECE 212BN,A00,103646,Ng; Tse Nga,0,10,0,0
1668599711781,ECE 221,A00,111493,Staff,0,0,0,0
1668599712205,ECE 222B,A00,103647,Lomakin; Vitaliy,0,22,0,0
1668599712629,ECE 230B,A00,103648,Taur; Yuan,0,4,0,0
1668599713055,ECE 238B,A00,103649,Garay; Javier,0,0,0,0
1668599713486,ECE 240B,A00,112900,Fainman; Yeshaiahu,0,8,0,0
1668599713917,ECE 247A,A00,103650,Jokerst; Jesse Vincent,0,6,0,0
1668599714378,ECE 247B,A00,103651,Wang; Joseph,0,14,0,0
1668599714840,ECE 250,A00,103652,Siegel; Paul H.,0,85,0,0
1668599715271,ECE 251A,A00,103654,Rao; Bhaskar D.,0,65,0,0
1668599715709,ECE 257B,A00,103655,Bharadia; Dinesh,0,33,0,0
1668599716146,ECE 258A,A00,103656,Milstein; Laurence B.,0,29,0,0
1668599716577,ECE 260B,A00,103658,Kang; Mingu,0,121,0,0
1668599717007,ECE 264A,A00,103659,Galton; Ian A,0,41,0,35
1668599717445,ECE 265A,A00,103661,Gudem; Prasad S.S.,0,40,0,38
1668599717890,ECE 265D,A00,103662,Gudem; Prasad S.S.,0,27,0,0
1668599718324,ECE 268,A00,103663,Koushanfar; Farinaz,0,44,0,0
1668599718756,ECE 269,A01,103665,Pal; Piya,0,223,0,0
1668599719199,ECE 271B,A00,103666,Vasconcelos; Manuela,0,80,0,0
1668599719639,ECE 276A,A00,103667,Atanasov; Nikolay A.,0,127,0,0
1668599720065,ECE 277,A00,103668,An; Cheolhong,0,151,0,0
1668599720502,ECE 279,A00,117947,Hall; Drew A.,0,22,0,0
1668599721376,ECE 283,A00,103670,Hsueh; Tzu-Chien,0,57,0,0
1668599721913,ECE 284,A00,103671,Turakhia; Yatish Girish,0,40,0,0
1668599722343,ECE 285,A00,103672,Zheng; Yang,0,40,0,0
1668599722343,ECE 285,B00,103673,Sworder; David D.,0,61,0,0
1668599722773,ECE 287,A00,103676,Javidi; Tara,0,7,0,0
1668599723206,MATH 200B,A00,098023,Salehi Golsefidy; Alireza,7,0,15,8
1668599723635,MATH 202B,A00,098024,Rhoades; Brendon Patrick,7,0,15,8
1668599724059,MATH 203B,A00,098025,Oprea; Dragos N.,9,0,15,6
1668599724485,MATH 204B,A00,098026,Sorensen; Claus M,13,0,15,2
1668599724908,MATH 208,A00,098027,Izadi; Elham,7,0,10,3
1668599725334,MATH 209,A00,098028,Pollack; Aaron,10,0,10,0
1668599725767,MATH 211A,A00,112919,Rogalski; Daniel,8,0,10,2
1668599726190,MATH 211B,A00,112920,Seward; Brandon M.,9,0,10,1
1668599726615,MATH 218,A00,098029,Li; Bo,10,0,10,0
1668599727040,MATH 220B,A00,098030,Novak; Jonathan I,10,0,15,5
1668599727463,MATH 221A,A00,098031,Ebenfelt; Peter F,12,0,15,3
1668599727896,MATH 231B,A00,098032,Zlatos; Andrej,9,0,15,6
1668599728333,MATH 240B,A00,098033,Ni; Lei,7,0,15,8
1668599728770,MATH 243,A00,098034,Jekel; David Andrew,10,0,10,0
1668599729197,MATH 245A,A00,098035,Nie; Jiawang,0,8,15,18
1668599729628,MATH 248,A00,098036,Bejenaru; Ioan,10,0,10,0
1668599730067,MATH 250B,A00,098037,Spolaor; Luca,12,0,15,3
1668599730508,MATH 258,A00,098038,Ni; Lei,8,0,10,2
1668599730939,MATH 264B,A00,098041,Rhoades; Brendon Patrick,6,0,15,9
1668599731363,MATH 268,A00,098042,Buss; Samuel R,10,0,10,0
1668599731787,MATH 269,A00,098043,Rhoades; Brendon Patrick,10,0,10,0
1668599732214,MATH 270B,A00,098044,Li; Bo,6,0,15,9
1668599732637,MATH 272B,A00,098045,Holst; Michael J,13,0,15,2
1668599733066,MATH 273A,A00,098046,Tian; Xiaochuan,10,0,15,5
1668599733491,MATH 275,A01,098048,Tian; Xiaochuan,6,0,10,4
1668599733921,MATH 278A,A00,098049,Holst; Michael J,6,0,10,4
1668599734373,MATH 278B,A00,098050,Cloninger; Alexander,10,0,10,0
1668599734798,MATH 278C,A00,098051,Nie; Jiawang,5,0,10,5
1668599735221,MATH 280B,A00,098052,Zheng; Tianyi,6,0,15,9
1668599735649,MATH 281B,A00,098053,Bradic; Jelena,0,2,15,15
1668599736076,MATH 282B,A00,098054,Arias-Castro; Ery,0,1,15,15
1668599736502,MATH 285,A00,098055,Fitzsimmons; Patrick J,0,4,15,16
1668599736925,MATH 287B,A00,098056,Arias-Castro; Ery,1,0,15,14
1668599737351,MATH 288,A00,098057,Agarwal; Pooja,9,0,10,1
1668599737351,MATH 288,B00,098058,Zhang; Danna,8,0,10,2
1668599737351,MATH 288,C00,098059,Williams; Ruth J,9,0,10,1
1668599737776,MATH 290B,A00,098060,Roberts; Justin Deritter,12,0,15,3
1668599738200,MATH 292,A00,098061,Belmont; Eva Kinoshita,10,0,10,0
1668599738624,MATH 295,A00,098062,Suk; Andrew Hoon,47,0,50,3
1668599739047,MATH 296,A00,098063,Novak; Jonathan I,20,0,20,0
1668599739475,MATH 297,001,098064,Gamst; Anthony Collins,9997,0,9999,2
1668600244228,COGS 205,A00,101395,Chiba; Andrea,19,0,20,1
1668600244665,COGS 210B,001,101404,Greene; Deanna Jacquelyn,9998,0,9999,1
1668600244665,COGS 210B,002,101417,Xia; Haijun,9999,0,9999,0
1668600244665,COGS 210B,003,101422,Nitz; Douglas A.,9999,0,9999,0
1668600244665,COGS 210B,004,101423,Hollan; James D.,9998,0,9999,1
1668600244665,COGS 210B,005,101424,Deak; Gedeon O.,9998,0,9999,1
1668600244665,COGS 210B,006,101425,Rossano; Federico,9999,0,9999,0
1668600245194,COGS 211B,A00,101427,Coulson; Seana M,9996,0,9999,3
1668600245618,COGS 220,A00,101428,Hollan; James D.,0,17,25,25
1668600246042,COGS 229,A00,101429,Dow; Steven P,17,0,25,8
1668600246473,COGS 230,A00,101430,Klemmer; Scott R,6,0,17,11
1668600246901,COGS 234,A00,101431,Xia; Haijun,0,1,25,25
1668600247332,COGS 260,A00,101432,Kiyonaga; Anastasia,21,0,25,4
1668600247332,COGS 260,B00,101433,Kirsh; David Joel,15,0,25,10
1668600247774,CSE 202,A00,102371,Impagliazzo; Russell,0,70,0,0
1668600248220,CSE 203B,A01,102373,Cheng; Chung Kuan,0,70,0,0
1668600248656,CSE 208,A00,102374,Micciancio; Daniele,0,5,0,0
1668600249079,CSE 209A,A00,112895,Impagliazzo; Russell,0,14,15,15
1668600249509,CSE 209B,A00,108005,Bellare; Mihir,0,7,0,0
1668600249935,CSE 210,A00,113163,Coblenz; Michael J,0,96,0,0
1668600250363,CSE 219,A00,106111,Dow; Steven P,0,8,20,20
1668600250793,CSE 221,A00,102376,Voelker; Geoffrey M.,0,78,0,0
1668600251218,CSE 224,A01,102378,Porter; George M,0,181,0,0
1668600251647,CSE 229A,A00,102379,Savage; Stefan,0,14,0,0
1668600252075,CSE 229C,A00,102380,Munyaka; Imani N. S.,0,12,0,0
1668600252510,CSE 232B,A00,102382,Deutsch; Alin Bernard,0,40,0,0
1668600252940,CSE 234,A01,112904,Kumar; Arun Kumar,0,0,0,0
1668600253366,CSE 237A,A00,102383,Rosing; Tajana Simunic,0,57,0,0
1668600253790,CSE 239A,A00,102384,Deutsch; Alin Bernard,0,18,0,0
1668600254219,CSE 239B,A00,102385,Polikarpova; Nadezhda,0,11,0,0
1668600254648,CSE 240A,A00,102386,Pannuto; Patrick William,0,49,0,0
1668600255097,CSE 240B,A00,102387,Zhao; Jishen,0,51,0,0
1668600255525,CSE 241A,A00,106406,Kang; Mingu,0,9,0,0
1668600255949,CSE 249B,A00,102388,Kahng; Andrew Byun,0,7,8,8
1668600256376,CSE 251B,A01,102392,Cottrell; Garrison W,0,54,0,0
1668600256376,CSE 251B,A02,102393,Cottrell; Garrison W,0,36,0,0
1668600256809,CSE 252B,A00,102394,Ochoa; Benjamin Lawrence,0,64,0,0
1668600257240,CSE 257,A01,102396,Gao; Sicun,0,160,0,0
1668600257680,CSE 272,A00,102397,Li; Tzumao,0,22,0,0
1668600258107,CSE 274,A00,111323,Chern; Albert Ren-Haur,0,16,0,0
1668600258540,CSE 282,A00,102398,Pevzner; Pavel Arkadjevich,0,0,0,0
1668600258970,CSE 284,A00,114175,Gymrek; Melissa Ann,0,33,0,0
1668600259397,CSE 290,A00,102399,Chandraker; Manmohan Krishna,0,11,0,0
1668600259397,CSE 290,B00,102400,Vaccaro; Kristen Marie,0,10,25,25
1668600259397,CSE 290,C00,102414,Pannuto; Patrick William,0,1,25,25
1668600259397,CSE 290,D00,102427,Pevzner; Pavel Arkadjevich,0,0,0,0
1668600259397,CSE 290,E00,102429,Zhao; Jishen,0,6,0,0
1668600259397,CSE 290,F00,102436,Tullsen; Dean Michael,0,6,0,0
1668600259397,CSE 290,G00,102440,Christensen; Henrik I,0,8,20,20
1668600259827,CSE 291,A00,102443,Su; Hao,0,0,0,0
1668600259827,CSE 291,B00,102448,Polikarpova; Nadezhda,0,0,0,0
1668600259827,CSE 291,C00,102453,Vaccaro; Kristen Marie,0,0,0,0
1668600259827,CSE 291,D00,111343,Savage; Stefan,0,0,0,0
1668600259827,CSE 291,E00,116474,Claffy; Kimberly Claire,0,0,0,0
1668600259827,CSE 291,F00,116479,Pasquale; Joseph,0,0,0,0
1668600260325,CSE 293,001,119111,Bafna; Vineet,9999,0,9999,0
1668600260325,CSE 293,002,119118,Bellare; Mihir,9999,0,9999,0
1668600260325,CSE 293,003,119122,Berg-Kirkpatrick; Taylor D,9999,0,9999,0
1668600260325,CSE 293,004,119135,Christensen; Henrik I,9999,0,9999,0
1668600260325,CSE 293,005,119142,Cottrell; Garrison W,9999,0,9999,0
1668600260325,CSE 293,006,119146,Deutsch; Alin Bernard,9999,0,9999,0
1668600260325,CSE 293,007,119159,Esmaeilzadeh; Hadi,9999,0,9999,0
1668600260325,CSE 293,008,119166,Freund; Yoav,9999,0,9999,0
1668600260325,CSE 293,009,119170,Griswold; William G.,9999,0,9999,0
1668600260325,CSE 293,010,119183,Gymrek; Melissa Ann,9999,0,9999,0
1668600260325,CSE 293,011,119190,Heninger; Nadia A,9999,0,9999,0
1668600260325,CSE 293,012,119230,Impagliazzo; Russell,9999,0,9999,0
1668600260325,CSE 293,013,119232,Jhala; Ranjit,9999,0,9999,0
1668600260325,CSE 293,014,119233,Kahng; Andrew Byun,9999,0,9999,0
1668600260325,CSE 293,015,119298,Kane; Daniel Mertz,9999,0,9999,0
1668600260325,CSE 293,016,119299,Kriegman; David J,9999,0,9999,0
1668600260325,CSE 293,017,119300,Kumar; Arun Kumar,9999,0,9999,0
1668600260325,CSE 293,018,119301,Lerner; Sorin,9999,0,9999,0
1668600260325,CSE 293,019,119302,Lovett; Shachar,9999,0,9999,0
1668600260325,CSE 293,020,119303,McAuley; Julian John,9999,0,9999,0
1668600260325,CSE 293,021,119304,Micciancio; Daniele,9999,0,9999,0
1668600260325,CSE 293,022,119367,Orailoglu; Alex,9999,0,9999,0
1668600260325,CSE 293,023,119382,Paturi; Ramamohan,9999,0,9999,0
1668600260325,CSE 293,024,119404,Polikarpova; Nadezhda,9999,0,9999,0
1668600260325,CSE 293,025,119406,Politz; Joseph Gibbs,9999,0,9999,0
1668600260325,CSE 293,026,119411,Porter; George M,9999,0,9999,0
1668600260325,CSE 293,027,119414,Porter; Leonard Emerson,9999,0,9999,0
1668600260325,CSE 293,028,119416,Ramamoorthi; Ravi,9999,0,9999,0
1668600260325,CSE 293,029,119417,Sahoo; Debashis,9999,0,9999,0
1668600260325,CSE 293,030,119420,Saul; Lawrence,9999,0,9999,0
1668600260325,CSE 293,031,119421,Savage; Stefan,9999,0,9999,0
1668600260325,CSE 293,032,119425,Schulze; Jurgen P.,9999,0,9999,0
1668600260325,CSE 293,033,119426,Snoeren; Alex C.,9999,0,9999,0
1668600260325,CSE 293,034,119428,Shang; Jingbo,9999,0,9999,0
1668600260325,CSE 293,035,119430,Stefan; Deian,9999,0,9999,0
1668600260325,CSE 293,036,119431,Su; Hao,9999,0,9999,0
1668600260325,CSE 293,037,119433,Swanson; Steven James,9999,0,9999,0
1668600260325,CSE 293,038,119435,Tullsen; Dean Michael,9999,0,9999,0
1668600260325,CSE 293,039,119483,Voelker; Geoffrey M.,9999,0,9999,0
1668600260325,CSE 293,040,119537,Zhao; Jishen,9999,0,9999,0
1668600260325,CSE 293,041,119538,Zhou; Yuan-Yuan,9999,0,9999,0
1668600260325,CSE 293,042,119539,Gao; Sicun,9999,0,9999,0
1668600260325,CSE 293,043,119540,Weibel; Nadir,9999,0,9999,0
1668600260325,CSE 293,044,119541,Gupta; Rajesh K.,9999,0,9999,0
1668600260325,CSE 293,045,126410,Vaccaro; Kristen Marie,9999,0,9999,0
1668600260325,CSE 293,046,126411,Klemke; Richard,9999,0,9999,0
1668600260757,CSE 294,A00,102459,Voelker; Geoffrey M.,0,2,0,0
1668600260757,CSE 294,B00,111322,Orailoglu; Alex,0,2,0,0
1668600261190,DSE 201,A00,096914,Deutsch; Alin Bernard,30,0,30,0
1668600261614,DSE 210,A00,096915,Dasgupta; Sanjoy,30,0,30,0
1668600262040,DSE 241,A00,144528,Smith; Neil Gordon,30,0,30,0
1668600262464,DSE 260A,A00,096916,Altintas De Callaf; Ilkay,30,0,30,0
1668600262935,ECE 200,001,103586,Antipa; Nicholas A,9999,0,9999,0
1668600262935,ECE 200,002,103587,Atanasov; Nikolay A.,9999,0,9999,0
1668600262935,ECE 200,003,103588,Bharadia; Dinesh,9999,0,9999,0
1668600262935,ECE 200,004,103589,Cheng; Chung Kuan,9999,0,9999,0
1668600262935,ECE 200,005,103590,Cosman; Pamela C.,9999,0,9999,0
1668600262935,ECE 200,006,103591,Dayeh; Shadi Ahmad,9999,0,9999,0
1668600262935,ECE 200,007,103592,Fainman; Yeshaiahu,9999,0,9999,0
1668600262935,ECE 200,008,103593,Ford; Joseph Earl,9999,0,9999,0
1668600262935,ECE 200,009,103594,Franceschetti; Massimo,9999,0,9999,0
1668600262935,ECE 200,010,103595,Fullerton; Eric E,9999,0,9999,0
1668600262935,ECE 200,011,103596,Galton; Ian A,9999,0,9999,0
1668600262935,ECE 200,012,103597,Gilja; Vikash,9999,0,9999,0
1668600262935,ECE 200,013,103598,Hall; Drew A.,9999,0,9999,0
1668600262935,ECE 200,014,103599,Hsueh; Tzu-Chien,9999,0,9999,0
1668600262935,ECE 200,015,103600,Javidi; Tara,9999,0,9999,0
1668600262935,ECE 200,016,103601,Kahng; Andrew Byun,9999,0,9999,0
1668600262935,ECE 200,017,103602,Kim; Young-Han,9999,0,9999,0
1668600262935,ECE 200,018,103603,Koushanfar; Farinaz,9999,0,9999,0
1668600262935,ECE 200,019,103604,Kuzum; Duygu,9999,0,9999,0
1668600262935,ECE 200,020,103605,Le; Hanh-Phuc,9999,0,9999,0
1668600262935,ECE 200,021,103606,Lin; Bill,9999,0,9999,0
1668600262935,ECE 200,022,103607,Liu; Zhaowei,9998,0,9999,1
1668600262935,ECE 200,023,103608,Lo; Yu-Hwa,9999,0,9999,0
1668600262935,ECE 200,024,103609,Lomakin; Vitaliy,9999,0,9999,0
1668600262935,ECE 200,025,103610,Mercier; Patrick Philip,9999,0,9999,0
1668600262935,ECE 200,026,103611,Meyer; Florian,9999,0,9999,0
1668600262935,ECE 200,027,103612,Milstein; Laurence B.,9999,0,9999,0
1668600262935,ECE 200,028,103613,Mir Arabbaygi; Siavash,9999,0,9999,0
1668600262935,ECE 200,029,103614,Mookherjea; Shayan,9999,0,9999,0
1668600262935,ECE 200,030,103615,Morris; Karcher William,9999,0,9999,0
1668600262935,ECE 200,031,103616,Ng; Tse Nga,9999,0,9999,0
1668600262935,ECE 200,032,103617,Nguyen; Truong Quang,9999,0,9999,0
1668600262935,ECE 200,033,103618,Nomura; Kenji,9999,0,9999,0
1668600262935,ECE 200,034,103619,Orlitsky; Alon,9999,0,9999,0
1668600262935,ECE 200,035,103620,Pal; Piya,9999,0,9999,0
1668600262935,ECE 200,036,103621,Papen; George C.,9999,0,9999,0
1668600262935,ECE 200,037,103622,Radic; Stojan,9999,0,9999,0
1668600262935,ECE 200,038,103623,Rao; Bhaskar D.,9999,0,9999,0
1668600262935,ECE 200,039,103624,Rao; Ramesh R,9999,0,9999,0
1668600262935,ECE 200,040,103625,Rebeiz; Gabriel,9999,0,9999,0
1668600262935,ECE 200,041,103626,Sanford; John R,9999,0,9999,0
1668600262935,ECE 200,042,103627,Siegel; Paul H.,9999,0,9999,0
1668600262935,ECE 200,043,103628,Sievenpiper; Daniel F.,9999,0,9999,0
1668600262935,ECE 200,044,103629,Sworder; David D.,9999,0,9999,0
1668600262935,ECE 200,045,103630,Taur; Yuan,9999,0,9999,0
1668600262935,ECE 200,046,103631,Touri; Behrouz,9999,0,9999,0
1668600262935,ECE 200,047,103632,Trivedi; Mohan M.,9999,0,9999,0
1668600262935,ECE 200,048,103633,Vasconcelos; Nuno,9999,0,9999,0
1668600262935,ECE 200,049,103634,Wang; Xiaolong,9999,0,9999,0
1668600262935,ECE 200,050,103635,Xie; Pengtao,9999,0,9999,0
1668600262935,ECE 200,051,103636,Yip; Michael,9999,0,9999,0
1668600262935,ECE 200,052,103637,Zeger; Kenneth A.,999,0,999,0
1668600262935,ECE 200,053,103638,Zhang; Xinyu,9999,0,9999,0
1668600262935,ECE 200,054,103639,Turakhia; Yatish Girish,9999,0,9999,0
1668600262935,ECE 200,055,103640,Kang; Mingu,9999,0,9999,0
1668600262935,ECE 200,056,103641,Shi; Yuanyuan,9999,0,9999,0
1668600262935,ECE 200,057,103642,Wang; Edward Jay,9999,0,9999,0
1668600262935,ECE 200,058,103643,Zheng; Yang,9999,0,9999,0
1668600263365,ECE 202,A00,103644,Kuzum; Duygu,0,47,0,0
1668600263790,ECE 212BN,A00,103646,Ng; Tse Nga,0,10,0,0
1668600264217,ECE 221,A00,111493,Staff,0,0,0,0
1668600264641,ECE 222B,A00,103647,Lomakin; Vitaliy,0,22,0,0
1668600265073,ECE 230B,A00,103648,Taur; Yuan,0,4,0,0
1668600265499,ECE 238B,A00,103649,Garay; Javier,0,0,0,0
1668600265923,ECE 240B,A00,112900,Fainman; Yeshaiahu,0,8,0,0
1668600266351,ECE 247A,A00,103650,Jokerst; Jesse Vincent,0,6,0,0
1668600266774,ECE 247B,A00,103651,Wang; Joseph,0,14,0,0
1668600267205,ECE 250,A00,103652,Siegel; Paul H.,0,85,0,0
1668600267632,ECE 251A,A00,103654,Rao; Bhaskar D.,0,65,0,0
1668600268060,ECE 257B,A00,103655,Bharadia; Dinesh,0,33,0,0
1668600268487,ECE 258A,A00,103656,Milstein; Laurence B.,0,29,0,0
1668600268918,ECE 260B,A00,103658,Kang; Mingu,0,121,0,0
1668600269347,ECE 264A,A00,103659,Galton; Ian A,0,41,0,35
1668600269778,ECE 265A,A00,103661,Gudem; Prasad S.S.,0,40,0,38
1668600270204,ECE 265D,A00,103662,Gudem; Prasad S.S.,0,27,0,0
1668600270632,ECE 268,A00,103663,Koushanfar; Farinaz,0,44,0,0
1668600271082,ECE 269,A01,103665,Pal; Piya,0,223,0,0
1668600271514,ECE 271B,A00,103666,Vasconcelos; Manuela,0,80,0,0
1668600271958,ECE 276A,A00,103667,Atanasov; Nikolay A.,0,127,0,0
1668600272386,ECE 277,A00,103668,An; Cheolhong,0,151,0,0
1668600272818,ECE 279,A00,117947,Hall; Drew A.,0,22,0,0
1668600273672,ECE 283,A00,103670,Hsueh; Tzu-Chien,0,57,0,0
1668600274097,ECE 284,A00,103671,Turakhia; Yatish Girish,0,40,0,0
1668600274524,ECE 285,A00,103672,Zheng; Yang,0,40,0,0
1668600274524,ECE 285,B00,103673,Sworder; David D.,0,61,0,0
1668600274953,ECE 287,A00,103676,Javidi; Tara,0,7,0,0
1668600275388,MATH 200B,A00,098023,Salehi Golsefidy; Alireza,7,0,15,8
1668600275813,MATH 202B,A00,098024,Rhoades; Brendon Patrick,7,0,15,8
1668600276238,MATH 203B,A00,098025,Oprea; Dragos N.,9,0,15,6
1668600276666,MATH 204B,A00,098026,Sorensen; Claus M,13,0,15,2
1668600277095,MATH 208,A00,098027,Izadi; Elham,7,0,10,3
1668600277530,MATH 209,A00,098028,Pollack; Aaron,10,0,10,0
1668600277960,MATH 211A,A00,112919,Rogalski; Daniel,8,0,10,2
1668600278388,MATH 211B,A00,112920,Seward; Brandon M.,9,0,10,1
1668600278822,MATH 218,A00,098029,Li; Bo,10,0,10,0
1668600279251,MATH 220B,A00,098030,Novak; Jonathan I,10,0,15,5
1668600279682,MATH 221A,A00,098031,Ebenfelt; Peter F,12,0,15,3
1668600280124,MATH 231B,A00,098032,Zlatos; Andrej,9,0,15,6
1668600280551,MATH 240B,A00,098033,Ni; Lei,7,0,15,8
1668600280975,MATH 243,A00,098034,Jekel; David Andrew,10,0,10,0
1668600281406,MATH 245A,A00,098035,Nie; Jiawang,0,8,15,18
1668600281829,MATH 248,A00,098036,Bejenaru; Ioan,10,0,10,0
1668600282271,MATH 250B,A00,098037,Spolaor; Luca,12,0,15,3
1668600282702,MATH 258,A00,098038,Ni; Lei,8,0,10,2
1668600283135,MATH 264B,A00,098041,Rhoades; Brendon Patrick,6,0,15,9
1668600283570,MATH 268,A00,098042,Buss; Samuel R,10,0,10,0
1668600283994,MATH 269,A00,098043,Rhoades; Brendon Patrick,10,0,10,0
1668600284418,MATH 270B,A00,098044,Li; Bo,6,0,15,9
1668600284857,MATH 272B,A00,098045,Holst; Michael J,13,0,15,2
1668600285281,MATH 273A,A00,098046,Tian; Xiaochuan,10,0,15,5
1668600285709,MATH 275,A01,098048,Tian; Xiaochuan,6,0,10,4
1668600286140,MATH 278A,A00,098049,Holst; Michael J,6,0,10,4
1668600286578,MATH 278B,A00,098050,Cloninger; Alexander,10,0,10,0
1668600287022,MATH 278C,A00,098051,Nie; Jiawang,5,0,10,5
1668600287458,MATH 280B,A00,098052,Zheng; Tianyi,6,0,15,9
1668600287887,MATH 281B,A00,098053,Bradic; Jelena,0,2,15,15
1668600288319,MATH 282B,A00,098054,Arias-Castro; Ery,0,1,15,15
1668600288828,MATH 285,A00,098055,Fitzsimmons; Patrick J,0,4,15,16
1668600289254,MATH 287B,A00,098056,Arias-Castro; Ery,1,0,15,14
1668600289685,MATH 288,A00,098057,Agarwal; Pooja,9,0,10,1
1668600289685,MATH 288,B00,098058,Zhang; Danna,8,0,10,2
1668600289685,MATH 288,C00,098059,Williams; Ruth J,9,0,10,1
1668600290109,MATH 290B,A00,098060,Roberts; Justin Deritter,12,0,15,3
1668600290534,MATH 292,A00,098061,Belmont; Eva Kinoshita,10,0,10,0
1668600290957,MATH 295,A00,098062,Suk; Andrew Hoon,47,0,50,3
1668600291386,MATH 296,A00,098063,Novak; Jonathan I,20,0,20,0
1668600291823,MATH 297,001,098064,Gamst; Anthony Collins,9997,0,9999,2
