time,subj_course_id,sec_code,sec_id,prof,available,waitlist,total,enrolled_ct
1667931497118,COGS 205,A00,101395,Chiba; Andrea,19,0,20,1
1667931497546,COGS 210B,001,101404,Greene; Deanna Jacquelyn,9998,0,9999,1
1667931497546,COGS 210B,002,101417,Xia; Haijun,9999,0,9999,0
1667931497546,COGS 210B,003,101422,Nitz; Douglas A.,9999,0,9999,0
1667931497546,COGS 210B,004,101423,Hollan; James D.,9998,0,9999,1
1667931497546,COGS 210B,005,101424,Deak; Gedeon O.,9999,0,9999,0
1667931497546,COGS 210B,006,101425,Rossano; Federico,9999,0,9999,0
1667931497979,COGS 211B,A00,101427,Coulson; Seana M,9997,0,9999,2
1667931498405,COGS 220,A00,101428,Hollan; James D.,0,0,25,25
1667931498829,COGS 229,A00,101429,Dow; Steven P,19,0,25,6
1667931499270,COGS 230,A00,101430,Klemmer; Scott R,13,0,17,4
1667931499692,COGS 234,A00,101431,Xia; Haijun,10,0,25,15
1667931500135,COGS 260,A00,101432,Kiyonaga; Anastasia,19,0,25,6
1667931500135,COGS 260,B00,101433,Kirsh; David Joel,17,0,25,8
1667931500561,CSE 202,A00,102371,Impagliazzo; Russell,0,0,0,0
1667931500984,CSE 203B,A01,102373,Cheng; Chung Kuan,0,0,0,0
1667931501421,CSE 208,A00,102374,Micciancio; Daniele,0,0,0,0
1667931501842,CSE 209A,A00,112895,Impagliazzo; Russell,0,0,15,15
1667931502281,CSE 209B,A00,108005,Bellare; Mihir,0,0,0,0
1667931502707,CSE 210,A00,113163,Coblenz; Michael J,0,0,0,0
1667931503141,CSE 219,A00,106111,Dow; Steven P,0,0,20,20
1667931503568,CSE 221,A00,102376,Voelker; Geoffrey M.,0,0,0,0
1667931503996,CSE 224,A01,102378,Porter; George M,0,0,0,0
1667931504422,CSE 229A,A00,102379,Savage; Stefan,0,0,0,0
1667931504849,CSE 229C,A00,102380,Munyaka; Imani N. S.,0,0,0,0
1667931505271,CSE 232B,A00,102382,Deutsch; Alin Bernard,0,0,0,0
1667931505702,CSE 234,A01,112904,Kumar; Arun Kumar,0,0,0,0
1667931506125,CSE 237A,A00,102383,Rosing; Tajana Simunic,0,0,0,0
1667931506554,CSE 239A,A00,102384,Deutsch; Alin Bernard,0,0,0,0
1667931506976,CSE 239B,A00,102385,Polikarpova; Nadezhda,0,0,0,0
1667931507400,CSE 240A,A00,102386,Pannuto; Patrick William,0,0,0,0
1667931507832,CSE 240B,A00,102387,Zhao; Jishen,0,0,0,0
1667931508256,CSE 241A,A00,106406,Kang; Mingu,0,0,0,0
1667931508685,CSE 249B,A00,102388,Kahng; Andrew Byun,0,0,8,8
1667931509109,CSE 251B,A01,102392,Cottrell; Garrison W,0,0,0,0
1667931509109,CSE 251B,A02,102393,Cottrell; Garrison W,0,0,0,0
1667931509533,CSE 252B,A00,102394,Ochoa; Benjamin Lawrence,0,0,0,0
1667931509957,CSE 257,A01,102396,Gao; Sicun,0,0,0,0
1667931510394,CSE 272,A00,102397,Li; Tzumao,0,0,0,0
1667931510823,CSE 274,A00,111323,Chern; Albert Ren-Haur,0,0,0,0
1667931511249,CSE 282,A00,102398,Pevzner; Pavel Arkadjevich,0,0,0,0
1667931511673,CSE 284,A00,114175,Gymrek; Melissa Ann,0,0,0,0
1667931512099,CSE 290,A00,102399,Chandraker; Manmohan Krishna,0,0,0,0
1667931512099,CSE 290,B00,102400,Vaccaro; Kristen Marie,1,0,25,24
1667931512099,CSE 290,C00,102414,Pannuto; Patrick William,1,0,25,24
1667931512099,CSE 290,D00,102427,Pevzner; Pavel Arkadjevich,0,0,0,0
1667931512099,CSE 290,E00,102429,Zhao; Jishen,0,0,0,0
1667931512099,CSE 290,F00,102436,Tullsen; Dean Michael,0,0,0,0
1667931512099,CSE 290,G00,102440,Christensen; Henrik I,0,0,20,20
1667931512536,CSE 291,A00,102443,Su; Hao,0,0,0,0
1667931512536,CSE 291,B00,102448,Polikarpova; Nadezhda,0,0,0,0
1667931512536,CSE 291,C00,102453,Vaccaro; Kristen Marie,0,0,0,0
1667931512536,CSE 291,D00,111343,Savage; Stefan,0,0,0,0
1667931512536,CSE 291,E00,116474,Claffy; Kimberly Claire,0,0,0,0
1667931512536,CSE 291,F00,116479,Pasquale; Joseph,0,0,0,0
1667931512982,CSE 293,001,119111,Bafna; Vineet,9999,0,9999,0
1667931512982,CSE 293,002,119118,Bellare; Mihir,9999,0,9999,0
1667931512982,CSE 293,003,119122,Berg-Kirkpatrick; Taylor D,9999,0,9999,0
1667931512982,CSE 293,004,119135,Christensen; Henrik I,9999,0,9999,0
1667931512982,CSE 293,005,119142,Cottrell; Garrison W,9999,0,9999,0
1667931512982,CSE 293,006,119146,Deutsch; Alin Bernard,9999,0,9999,0
1667931512982,CSE 293,007,119159,Esmaeilzadeh; Hadi,9999,0,9999,0
1667931512982,CSE 293,008,119166,Freund; Yoav,9999,0,9999,0
1667931512982,CSE 293,009,119170,Griswold; William G.,9999,0,9999,0
1667931512982,CSE 293,010,119183,Gymrek; Melissa Ann,9999,0,9999,0
1667931512982,CSE 293,011,119190,Heninger; Nadia A,9999,0,9999,0
1667931512982,CSE 293,012,119230,Impagliazzo; Russell,9999,0,9999,0
1667931512982,CSE 293,013,119232,Jhala; Ranjit,9999,0,9999,0
1667931512982,CSE 293,014,119233,Kahng; Andrew Byun,9999,0,9999,0
1667931512982,CSE 293,015,119298,Kane; Daniel Mertz,9999,0,9999,0
1667931512982,CSE 293,016,119299,Kriegman; David J,9999,0,9999,0
1667931512982,CSE 293,017,119300,Kumar; Arun Kumar,9999,0,9999,0
1667931512982,CSE 293,018,119301,Lerner; Sorin,9999,0,9999,0
1667931512982,CSE 293,019,119302,Lovett; Shachar,9999,0,9999,0
1667931512982,CSE 293,020,119303,McAuley; Julian John,9999,0,9999,0
1667931512982,CSE 293,021,119304,Micciancio; Daniele,9999,0,9999,0
1667931512982,CSE 293,022,119367,Orailoglu; Alex,9999,0,9999,0
1667931512982,CSE 293,023,119382,Paturi; Ramamohan,9999,0,9999,0
1667931512982,CSE 293,024,119404,Polikarpova; Nadezhda,9999,0,9999,0
1667931512982,CSE 293,025,119406,Politz; Joseph Gibbs,9999,0,9999,0
1667931512982,CSE 293,026,119411,Porter; George M,9999,0,9999,0
1667931512982,CSE 293,027,119414,Porter; Leonard Emerson,9999,0,9999,0
1667931512982,CSE 293,028,119416,Ramamoorthi; Ravi,9999,0,9999,0
1667931512982,CSE 293,029,119417,Sahoo; Debashis,9999,0,9999,0
1667931512982,CSE 293,030,119420,Saul; Lawrence,9999,0,9999,0
1667931512982,CSE 293,031,119421,Savage; Stefan,9999,0,9999,0
1667931512982,CSE 293,032,119425,Schulze; Jurgen P.,9999,0,9999,0
1667931512982,CSE 293,033,119426,Snoeren; Alex C.,9999,0,9999,0
1667931512982,CSE 293,034,119428,Shang; Jingbo,9999,0,9999,0
1667931512982,CSE 293,035,119430,Stefan; Deian,9999,0,9999,0
1667931512982,CSE 293,036,119431,Su; Hao,9999,0,9999,0
1667931512982,CSE 293,037,119433,Swanson; Steven James,9999,0,9999,0
1667931512982,CSE 293,038,119435,Tullsen; Dean Michael,9999,0,9999,0
1667931512982,CSE 293,039,119483,Voelker; Geoffrey M.,9999,0,9999,0
1667931512982,CSE 293,040,119537,Zhao; Jishen,9999,0,9999,0
1667931512982,CSE 293,041,119538,Zhou; Yuan-Yuan,9999,0,9999,0
1667931512982,CSE 293,042,119539,Gao; Sicun,9999,0,9999,0
1667931512982,CSE 293,043,119540,Weibel; Nadir,9999,0,9999,0
1667931512982,CSE 293,044,119541,Gupta; Rajesh K.,9999,0,9999,0
1667931513414,CSE 294,A00,102459,Voelker; Geoffrey M.,0,0,0,0
1667931513414,CSE 294,B00,111322,Orailoglu; Alex,0,0,0,0
1667931513837,DSE 201,A00,096914,Deutsch; Alin Bernard,30,0,30,0
1667931514258,DSE 210,A00,096915,Dasgupta; Sanjoy,30,0,30,0
1667931514709,DSE 260A,A00,096916,Altintas De Callaf; Ilkay,30,0,30,0
1667931515152,ECE 200,001,103586,Antipa; Nicholas A,9999,0,9999,0
1667931515152,ECE 200,002,103587,Atanasov; Nikolay A.,9999,0,9999,0
1667931515152,ECE 200,003,103588,Bharadia; Dinesh,9999,0,9999,0
1667931515152,ECE 200,004,103589,Cheng; Chung Kuan,9999,0,9999,0
1667931515152,ECE 200,005,103590,Cosman; Pamela C.,9999,0,9999,0
1667931515152,ECE 200,006,103591,Dayeh; Shadi Ahmad,9999,0,9999,0
1667931515152,ECE 200,007,103592,Fainman; Yeshaiahu,9999,0,9999,0
1667931515152,ECE 200,008,103593,Ford; Joseph Earl,9999,0,9999,0
1667931515152,ECE 200,009,103594,Franceschetti; Massimo,9999,0,9999,0
1667931515152,ECE 200,010,103595,Fullerton; Eric E,9999,0,9999,0
1667931515152,ECE 200,011,103596,Galton; Ian A,9999,0,9999,0
1667931515152,ECE 200,012,103597,Gilja; Vikash,9999,0,9999,0
1667931515152,ECE 200,013,103598,Hall; Drew A.,9999,0,9999,0
1667931515152,ECE 200,014,103599,Hsueh; Tzu-Chien,9999,0,9999,0
1667931515152,ECE 200,015,103600,Javidi; Tara,9999,0,9999,0
1667931515152,ECE 200,016,103601,Kahng; Andrew Byun,9999,0,9999,0
1667931515152,ECE 200,017,103602,Kim; Young-Han,9999,0,9999,0
1667931515152,ECE 200,018,103603,Koushanfar; Farinaz,9999,0,9999,0
1667931515152,ECE 200,019,103604,Kuzum; Duygu,9999,0,9999,0
1667931515152,ECE 200,020,103605,Le; Hanh-Phuc,9999,0,9999,0
1667931515152,ECE 200,021,103606,Lin; Bill,9999,0,9999,0
1667931515152,ECE 200,022,103607,Liu; Zhaowei,9998,0,9999,1
1667931515152,ECE 200,023,103608,Lo; Yu-Hwa,9999,0,9999,0
1667931515152,ECE 200,024,103609,Lomakin; Vitaliy,9999,0,9999,0
1667931515152,ECE 200,025,103610,Mercier; Patrick Philip,9999,0,9999,0
1667931515152,ECE 200,026,103611,Meyer; Florian,9999,0,9999,0
1667931515152,ECE 200,027,103612,Milstein; Laurence B.,9999,0,9999,0
1667931515152,ECE 200,028,103613,Mir Arabbaygi; Siavash,9999,0,9999,0
1667931515152,ECE 200,029,103614,Mookherjea; Shayan,9999,0,9999,0
1667931515152,ECE 200,030,103615,Morris; Karcher William,9999,0,9999,0
1667931515152,ECE 200,031,103616,Ng; Tse Nga,9999,0,9999,0
1667931515152,ECE 200,032,103617,Nguyen; Truong Quang,9999,0,9999,0
1667931515152,ECE 200,033,103618,Nomura; Kenji,9999,0,9999,0
1667931515152,ECE 200,034,103619,Orlitsky; Alon,9999,0,9999,0
1667931515152,ECE 200,035,103620,Pal; Piya,9999,0,9999,0
1667931515152,ECE 200,036,103621,Papen; George C.,9999,0,9999,0
1667931515152,ECE 200,037,103622,Radic; Stojan,9999,0,9999,0
1667931515152,ECE 200,038,103623,Rao; Bhaskar D.,9999,0,9999,0
1667931515152,ECE 200,039,103624,Rao; Ramesh R,9999,0,9999,0
1667931515152,ECE 200,040,103625,Rebeiz; Gabriel,9999,0,9999,0
1667931515152,ECE 200,041,103626,Sanford; John R,9999,0,9999,0
1667931515152,ECE 200,042,103627,Siegel; Paul H.,9999,0,9999,0
1667931515152,ECE 200,043,103628,Sievenpiper; Daniel F.,9999,0,9999,0
1667931515152,ECE 200,044,103629,Sworder; David D.,9999,0,9999,0
1667931515152,ECE 200,045,103630,Taur; Yuan,9999,0,9999,0
1667931515152,ECE 200,046,103631,Touri; Behrouz,9999,0,9999,0
1667931515152,ECE 200,047,103632,Trivedi; Mohan M.,9999,0,9999,0
1667931515152,ECE 200,048,103633,Vasconcelos; Nuno,9999,0,9999,0
1667931515152,ECE 200,049,103634,Wang; Xiaolong,9999,0,9999,0
1667931515152,ECE 200,050,103635,Xie; Pengtao,9999,0,9999,0
1667931515152,ECE 200,051,103636,Yip; Michael,9999,0,9999,0
1667931515152,ECE 200,052,103637,Zeger; Kenneth A.,999,0,999,0
1667931515152,ECE 200,053,103638,Zhang; Xinyu,9999,0,9999,0
1667931515152,ECE 200,054,103639,Turakhia; Yatish Girish,9999,0,9999,0
1667931515152,ECE 200,055,103640,Kang; Mingu,9999,0,9999,0
1667931515152,ECE 200,056,103641,Shi; Yuanyuan,9999,0,9999,0
1667931515152,ECE 200,057,103642,Wang; Edward Jay,9999,0,9999,0
1667931515152,ECE 200,058,103643,Zheng; Yang,9999,0,9999,0
1667931515585,ECE 202,A00,103644,Kuzum; Duygu,0,0,0,0
1667931516008,ECE 212BN,A00,103646,Ng; Tse Nga,0,0,0,0
1667931516523,ECE 221,A00,111493,Staff,0,0,0,0
1667931516945,ECE 222B,A00,103647,Lomakin; Vitaliy,0,0,0,0
1667931517370,ECE 230B,A00,103648,Taur; Yuan,0,0,0,0
1667931517792,ECE 238B,A00,103649,Garay; Javier,0,0,0,0
1667931518220,ECE 240B,A00,112900,Fainman; Yeshaiahu,0,0,0,0
1667931518645,ECE 247A,A00,103650,Jokerst; Jesse Vincent,0,0,0,0
1667931519069,ECE 247B,A00,103651,Wang; Joseph,0,0,0,0
1667931519501,ECE 250,A00,103652,Siegel; Paul H.,0,0,0,0
1667931519929,ECE 251A,A00,103654,Rao; Bhaskar D.,0,0,0,0
1667931520369,ECE 257B,A00,103655,Bharadia; Dinesh,0,0,0,0
1667931520795,ECE 258A,A00,103656,Milstein; Laurence B.,0,0,0,0
1667931521220,ECE 260B,A00,103658,Kang; Mingu,0,0,0,0
1667931521665,ECE 264A,A00,103659,Galton; Ian A,0,0,0,0
1667931522097,ECE 265A,A00,103661,Gudem; Prasad S.S.,0,0,0,0
1667931522533,ECE 265D,A00,103662,Gudem; Prasad S.S.,0,0,0,0
1667931522958,ECE 268,A00,103663,Koushanfar; Farinaz,0,0,0,0
1667931523389,ECE 269,A01,103665,Pal; Piya,0,0,0,0
1667931523811,ECE 271B,A00,103666,Vasconcelos; Manuela,0,0,0,0
1667931524234,ECE 276A,A00,103667,Atanasov; Nikolay A.,0,0,0,0
1667931524659,ECE 277,A00,103668,An; Cheolhong,0,0,0,0
1667931525088,ECE 279,A00,117947,Hall; Drew A.,0,0,0,0
1667931525940,ECE 283,A00,103670,Hsueh; Tzu-Chien,0,0,0,0
1667931526367,ECE 284,A00,103671,Turakhia; Yatish Girish,0,0,0,0
1667931526806,ECE 285,A00,103672,Zheng; Yang,0,0,0,0
1667931526806,ECE 285,B00,103673,Sworder; David D.,0,0,0,0
1667931527229,ECE 287,A00,103676,Javidi; Tara,0,0,0,0
1667931527657,MATH 200B,A00,098023,Salehi Golsefidy; Alireza,15,0,15,0
1667931528088,MATH 202B,A00,098024,Rhoades; Brendon Patrick,14,0,15,1
1667931528530,MATH 203B,A00,098025,Oprea; Dragos N.,14,0,15,1
1667931528957,MATH 204B,A00,098026,Sorensen; Claus M,15,0,15,0
1667931529397,MATH 208,A00,098027,Izadi; Elham,7,0,10,3
1667931529829,MATH 209,A00,098028,Pollack; Aaron,10,0,10,0
1667931530251,MATH 211A,A00,112919,Rogalski; Daniel,10,0,10,0
1667931530675,MATH 211B,A00,112920,Seward; Brandon M.,10,0,10,0
1667931531104,MATH 218,A00,098029,Li; Bo,10,0,10,0
1667931531527,MATH 220B,A00,098030,Novak; Jonathan I,15,0,15,0
1667931531957,MATH 221A,A00,098031,Ebenfelt; Peter F,14,0,15,1
1667931532383,MATH 231B,A00,098032,Zlatos; Andrej,15,0,15,0
1667931532826,MATH 240B,A00,098033,Ni; Lei,13,0,15,2
1667931533258,MATH 243,A00,098034,Jekel; David Andrew,10,0,10,0
1667931533680,MATH 245A,A00,098035,Nie; Jiawang,6,0,15,9
1667931534112,MATH 248,A00,098036,Bejenaru; Ioan,10,0,10,0
1667931534545,MATH 250B,A00,098037,Spolaor; Luca,14,0,15,1
1667931534975,MATH 258,A00,098038,Ni; Lei,10,0,10,0
1667931535406,MATH 264B,A00,098041,Rhoades; Brendon Patrick,13,0,15,2
1667931535832,MATH 268,A00,098042,Buss; Samuel R,10,0,10,0
1667931536255,MATH 269,A00,098043,Rhoades; Brendon Patrick,10,0,10,0
1667931536683,MATH 270B,A00,098044,Li; Bo,13,0,15,2
1667931537119,MATH 272B,A00,098045,Holst; Michael J,13,0,15,2
1667931537543,MATH 273A,A00,098046,Tian; Xiaochuan,12,0,15,3
1667931537971,MATH 275,A01,098048,Tian; Xiaochuan,7,0,10,3
1667931538401,MATH 278A,A00,098049,Holst; Michael J,8,0,10,2
1667931538834,MATH 278B,A00,098050,Cloninger; Alexander,10,0,10,0
1667931539262,MATH 278C,A00,098051,Nie; Jiawang,9,0,10,1
1667931539686,MATH 280B,A00,098052,Zheng; Tianyi,12,0,15,3
1667931540112,MATH 281B,A00,098053,Bradic; Jelena,5,0,15,10
1667931540534,MATH 282B,A00,098054,Arias-Castro; Ery,2,0,15,13
1667931540962,MATH 285,A00,098055,Fitzsimmons; Patrick J,2,0,15,13
1667931541398,MATH 287B,A00,098056,Arias-Castro; Ery,9,0,15,6
1667931541823,MATH 288,A00,098057,Agarwal; Pooja,9,0,10,1
1667931541823,MATH 288,B00,098058,Zhang; Danna,9,0,10,1
1667931541823,MATH 288,C00,098059,Williams; Ruth J,10,0,10,0
1667931542253,MATH 290B,A00,098060,Roberts; Justin Deritter,14,0,15,1
1667931542677,MATH 292,A00,098061,Belmont; Eva Kinoshita,10,0,10,0
1667931543103,MATH 295,A00,098062,Suk; Andrew Hoon,48,0,50,2
1667931543532,MATH 296,A00,098063,Novak; Jonathan I,20,0,20,0
1667931543957,MATH 297,001,098064,Gamst; Anthony Collins,9997,0,9999,2
1667932057658,COGS 205,A00,101395,Chiba; Andrea,19,0,20,1
1667932058087,COGS 210B,001,101404,Greene; Deanna Jacquelyn,9998,0,9999,1
1667932058087,COGS 210B,002,101417,Xia; Haijun,9999,0,9999,0
1667932058087,COGS 210B,003,101422,Nitz; Douglas A.,9999,0,9999,0
1667932058087,COGS 210B,004,101423,Hollan; James D.,9998,0,9999,1
1667932058087,COGS 210B,005,101424,Deak; Gedeon O.,9999,0,9999,0
1667932058087,COGS 210B,006,101425,Rossano; Federico,9999,0,9999,0
1667932058511,COGS 211B,A00,101427,Coulson; Seana M,9997,0,9999,2
1667932058937,COGS 220,A00,101428,Hollan; James D.,0,0,25,25
1667932059377,COGS 229,A00,101429,Dow; Steven P,19,0,25,6
1667932059801,COGS 230,A00,101430,Klemmer; Scott R,13,0,17,4
1667932060226,COGS 234,A00,101431,Xia; Haijun,10,0,25,15
1667932060650,COGS 260,A00,101432,Kiyonaga; Anastasia,19,0,25,6
1667932060650,COGS 260,B00,101433,Kirsh; David Joel,17,0,25,8
1667932061078,CSE 202,A00,102371,Impagliazzo; Russell,0,0,0,0
1667932061503,CSE 203B,A01,102373,Cheng; Chung Kuan,0,0,0,0
1667932061926,CSE 208,A00,102374,Micciancio; Daniele,0,0,0,0
1667932062360,CSE 209A,A00,112895,Impagliazzo; Russell,0,0,15,15
1667932062787,CSE 209B,A00,108005,Bellare; Mihir,0,0,0,0
1667932063220,CSE 210,A00,113163,Coblenz; Michael J,0,0,0,0
1667932063648,CSE 219,A00,106111,Dow; Steven P,0,0,20,20
1667932064073,CSE 221,A00,102376,Voelker; Geoffrey M.,0,0,0,0
1667932064497,CSE 224,A01,102378,Porter; George M,0,0,0,0
1667932064919,CSE 229A,A00,102379,Savage; Stefan,0,0,0,0
1667932065512,CSE 229C,A00,102380,Munyaka; Imani N. S.,0,0,0,0
1667932065936,CSE 232B,A00,102382,Deutsch; Alin Bernard,0,0,0,0
1667932066361,CSE 234,A01,112904,Kumar; Arun Kumar,0,0,0,0
1667932066785,CSE 237A,A00,102383,Rosing; Tajana Simunic,0,0,0,0
1667932067210,CSE 239A,A00,102384,Deutsch; Alin Bernard,0,0,0,0
1667932067637,CSE 239B,A00,102385,Polikarpova; Nadezhda,0,0,0,0
1667932068071,CSE 240A,A00,102386,Pannuto; Patrick William,0,0,0,0
1667932068502,CSE 240B,A00,102387,Zhao; Jishen,0,0,0,0
1667932068925,CSE 241A,A00,106406,Kang; Mingu,0,0,0,0
1667932069349,CSE 249B,A00,102388,Kahng; Andrew Byun,0,0,8,8
1667932069770,CSE 251B,A01,102392,Cottrell; Garrison W,0,0,0,0
1667932069770,CSE 251B,A02,102393,Cottrell; Garrison W,0,0,0,0
1667932070198,CSE 252B,A00,102394,Ochoa; Benjamin Lawrence,0,0,0,0
1667932070626,CSE 257,A01,102396,Gao; Sicun,0,0,0,0
1667932071052,CSE 272,A00,102397,Li; Tzumao,0,0,0,0
1667932071479,CSE 274,A00,111323,Chern; Albert Ren-Haur,0,0,0,0
1667932071902,CSE 282,A00,102398,Pevzner; Pavel Arkadjevich,0,0,0,0
1667932072323,CSE 284,A00,114175,Gymrek; Melissa Ann,0,0,0,0
1667932072750,CSE 290,A00,102399,Chandraker; Manmohan Krishna,0,0,0,0
1667932072750,CSE 290,B00,102400,Vaccaro; Kristen Marie,1,0,25,24
1667932072750,CSE 290,C00,102414,Pannuto; Patrick William,1,0,25,24
1667932072750,CSE 290,D00,102427,Pevzner; Pavel Arkadjevich,0,0,0,0
1667932072750,CSE 290,E00,102429,Zhao; Jishen,0,0,0,0
1667932072750,CSE 290,F00,102436,Tullsen; Dean Michael,0,0,0,0
1667932072750,CSE 290,G00,102440,Christensen; Henrik I,0,0,20,20
1667932073188,CSE 291,A00,102443,Su; Hao,0,0,0,0
1667932073188,CSE 291,B00,102448,Polikarpova; Nadezhda,0,0,0,0
1667932073188,CSE 291,C00,102453,Vaccaro; Kristen Marie,0,0,0,0
1667932073188,CSE 291,D00,111343,Savage; Stefan,0,0,0,0
1667932073188,CSE 291,E00,116474,Claffy; Kimberly Claire,0,0,0,0
1667932073188,CSE 291,F00,116479,Pasquale; Joseph,0,0,0,0
1667932073624,CSE 293,001,119111,Bafna; Vineet,9999,0,9999,0
1667932073624,CSE 293,002,119118,Bellare; Mihir,9999,0,9999,0
1667932073624,CSE 293,003,119122,Berg-Kirkpatrick; Taylor D,9999,0,9999,0
1667932073624,CSE 293,004,119135,Christensen; Henrik I,9999,0,9999,0
1667932073624,CSE 293,005,119142,Cottrell; Garrison W,9999,0,9999,0
1667932073624,CSE 293,006,119146,Deutsch; Alin Bernard,9999,0,9999,0
1667932073624,CSE 293,007,119159,Esmaeilzadeh; Hadi,9999,0,9999,0
1667932073624,CSE 293,008,119166,Freund; Yoav,9999,0,9999,0
1667932073624,CSE 293,009,119170,Griswold; William G.,9999,0,9999,0
1667932073624,CSE 293,010,119183,Gymrek; Melissa Ann,9999,0,9999,0
1667932073624,CSE 293,011,119190,Heninger; Nadia A,9999,0,9999,0
1667932073624,CSE 293,012,119230,Impagliazzo; Russell,9999,0,9999,0
1667932073624,CSE 293,013,119232,Jhala; Ranjit,9999,0,9999,0
1667932073624,CSE 293,014,119233,Kahng; Andrew Byun,9999,0,9999,0
1667932073624,CSE 293,015,119298,Kane; Daniel Mertz,9999,0,9999,0
1667932073624,CSE 293,016,119299,Kriegman; David J,9999,0,9999,0
1667932073624,CSE 293,017,119300,Kumar; Arun Kumar,9999,0,9999,0
1667932073624,CSE 293,018,119301,Lerner; Sorin,9999,0,9999,0
1667932073624,CSE 293,019,119302,Lovett; Shachar,9999,0,9999,0
1667932073624,CSE 293,020,119303,McAuley; Julian John,9999,0,9999,0
1667932073624,CSE 293,021,119304,Micciancio; Daniele,9999,0,9999,0
1667932073624,CSE 293,022,119367,Orailoglu; Alex,9999,0,9999,0
1667932073624,CSE 293,023,119382,Paturi; Ramamohan,9999,0,9999,0
1667932073624,CSE 293,024,119404,Polikarpova; Nadezhda,9999,0,9999,0
1667932073624,CSE 293,025,119406,Politz; Joseph Gibbs,9999,0,9999,0
1667932073624,CSE 293,026,119411,Porter; George M,9999,0,9999,0
1667932073624,CSE 293,027,119414,Porter; Leonard Emerson,9999,0,9999,0
1667932073624,CSE 293,028,119416,Ramamoorthi; Ravi,9999,0,9999,0
1667932073624,CSE 293,029,119417,Sahoo; Debashis,9999,0,9999,0
1667932073624,CSE 293,030,119420,Saul; Lawrence,9999,0,9999,0
1667932073624,CSE 293,031,119421,Savage; Stefan,9999,0,9999,0
1667932073624,CSE 293,032,119425,Schulze; Jurgen P.,9999,0,9999,0
1667932073624,CSE 293,033,119426,Snoeren; Alex C.,9999,0,9999,0
1667932073624,CSE 293,034,119428,Shang; Jingbo,9999,0,9999,0
1667932073624,CSE 293,035,119430,Stefan; Deian,9999,0,9999,0
1667932073624,CSE 293,036,119431,Su; Hao,9999,0,9999,0
1667932073624,CSE 293,037,119433,Swanson; Steven James,9999,0,9999,0
1667932073624,CSE 293,038,119435,Tullsen; Dean Michael,9999,0,9999,0
1667932073624,CSE 293,039,119483,Voelker; Geoffrey M.,9999,0,9999,0
1667932073624,CSE 293,040,119537,Zhao; Jishen,9999,0,9999,0
1667932073624,CSE 293,041,119538,Zhou; Yuan-Yuan,9999,0,9999,0
1667932073624,CSE 293,042,119539,Gao; Sicun,9999,0,9999,0
1667932073624,CSE 293,043,119540,Weibel; Nadir,9999,0,9999,0
1667932073624,CSE 293,044,119541,Gupta; Rajesh K.,9999,0,9999,0
1667932074048,CSE 294,A00,102459,Voelker; Geoffrey M.,0,0,0,0
1667932074048,CSE 294,B00,111322,Orailoglu; Alex,0,0,0,0
1667932074472,DSE 201,A00,096914,Deutsch; Alin Bernard,30,0,30,0
1667932074904,DSE 210,A00,096915,Dasgupta; Sanjoy,30,0,30,0
1667932075328,DSE 260A,A00,096916,Altintas De Callaf; Ilkay,30,0,30,0
1667932075759,ECE 200,001,103586,Antipa; Nicholas A,9999,0,9999,0
1667932075759,ECE 200,002,103587,Atanasov; Nikolay A.,9999,0,9999,0
1667932075759,ECE 200,003,103588,Bharadia; Dinesh,9999,0,9999,0
1667932075759,ECE 200,004,103589,Cheng; Chung Kuan,9999,0,9999,0
1667932075759,ECE 200,005,103590,Cosman; Pamela C.,9999,0,9999,0
1667932075759,ECE 200,006,103591,Dayeh; Shadi Ahmad,9999,0,9999,0
1667932075759,ECE 200,007,103592,Fainman; Yeshaiahu,9999,0,9999,0
1667932075759,ECE 200,008,103593,Ford; Joseph Earl,9999,0,9999,0
1667932075759,ECE 200,009,103594,Franceschetti; Massimo,9999,0,9999,0
1667932075759,ECE 200,010,103595,Fullerton; Eric E,9999,0,9999,0
1667932075759,ECE 200,011,103596,Galton; Ian A,9999,0,9999,0
1667932075759,ECE 200,012,103597,Gilja; Vikash,9999,0,9999,0
1667932075759,ECE 200,013,103598,Hall; Drew A.,9999,0,9999,0
1667932075759,ECE 200,014,103599,Hsueh; Tzu-Chien,9999,0,9999,0
1667932075759,ECE 200,015,103600,Javidi; Tara,9999,0,9999,0
1667932075759,ECE 200,016,103601,Kahng; Andrew Byun,9999,0,9999,0
1667932075759,ECE 200,017,103602,Kim; Young-Han,9999,0,9999,0
1667932075759,ECE 200,018,103603,Koushanfar; Farinaz,9999,0,9999,0
1667932075759,ECE 200,019,103604,Kuzum; Duygu,9999,0,9999,0
1667932075759,ECE 200,020,103605,Le; Hanh-Phuc,9999,0,9999,0
1667932075759,ECE 200,021,103606,Lin; Bill,9999,0,9999,0
1667932075759,ECE 200,022,103607,Liu; Zhaowei,9998,0,9999,1
1667932075759,ECE 200,023,103608,Lo; Yu-Hwa,9999,0,9999,0
1667932075759,ECE 200,024,103609,Lomakin; Vitaliy,9999,0,9999,0
1667932075759,ECE 200,025,103610,Mercier; Patrick Philip,9999,0,9999,0
1667932075759,ECE 200,026,103611,Meyer; Florian,9999,0,9999,0
1667932075759,ECE 200,027,103612,Milstein; Laurence B.,9999,0,9999,0
1667932075759,ECE 200,028,103613,Mir Arabbaygi; Siavash,9999,0,9999,0
1667932075759,ECE 200,029,103614,Mookherjea; Shayan,9999,0,9999,0
1667932075759,ECE 200,030,103615,Morris; Karcher William,9999,0,9999,0
1667932075759,ECE 200,031,103616,Ng; Tse Nga,9999,0,9999,0
1667932075759,ECE 200,032,103617,Nguyen; Truong Quang,9999,0,9999,0
1667932075759,ECE 200,033,103618,Nomura; Kenji,9999,0,9999,0
1667932075759,ECE 200,034,103619,Orlitsky; Alon,9999,0,9999,0
1667932075759,ECE 200,035,103620,Pal; Piya,9999,0,9999,0
1667932075759,ECE 200,036,103621,Papen; George C.,9999,0,9999,0
1667932075759,ECE 200,037,103622,Radic; Stojan,9999,0,9999,0
1667932075759,ECE 200,038,103623,Rao; Bhaskar D.,9999,0,9999,0
1667932075759,ECE 200,039,103624,Rao; Ramesh R,9999,0,9999,0
1667932075759,ECE 200,040,103625,Rebeiz; Gabriel,9999,0,9999,0
1667932075759,ECE 200,041,103626,Sanford; John R,9999,0,9999,0
1667932075759,ECE 200,042,103627,Siegel; Paul H.,9999,0,9999,0
1667932075759,ECE 200,043,103628,Sievenpiper; Daniel F.,9999,0,9999,0
1667932075759,ECE 200,044,103629,Sworder; David D.,9999,0,9999,0
1667932075759,ECE 200,045,103630,Taur; Yuan,9999,0,9999,0
1667932075759,ECE 200,046,103631,Touri; Behrouz,9999,0,9999,0
1667932075759,ECE 200,047,103632,Trivedi; Mohan M.,9999,0,9999,0
1667932075759,ECE 200,048,103633,Vasconcelos; Nuno,9999,0,9999,0
1667932075759,ECE 200,049,103634,Wang; Xiaolong,9999,0,9999,0
1667932075759,ECE 200,050,103635,Xie; Pengtao,9999,0,9999,0
1667932075759,ECE 200,051,103636,Yip; Michael,9999,0,9999,0
1667932075759,ECE 200,052,103637,Zeger; Kenneth A.,999,0,999,0
1667932075759,ECE 200,053,103638,Zhang; Xinyu,9999,0,9999,0
1667932075759,ECE 200,054,103639,Turakhia; Yatish Girish,9999,0,9999,0
1667932075759,ECE 200,055,103640,Kang; Mingu,9999,0,9999,0
1667932075759,ECE 200,056,103641,Shi; Yuanyuan,9999,0,9999,0
1667932075759,ECE 200,057,103642,Wang; Edward Jay,9999,0,9999,0
1667932075759,ECE 200,058,103643,Zheng; Yang,9999,0,9999,0
1667932076191,ECE 202,A00,103644,Kuzum; Duygu,0,0,0,0
1667932076630,ECE 212BN,A00,103646,Ng; Tse Nga,0,0,0,0
1667932077056,ECE 221,A00,111493,Staff,0,0,0,0
1667932077480,ECE 222B,A00,103647,Lomakin; Vitaliy,0,0,0,0
1667932077908,ECE 230B,A00,103648,Taur; Yuan,0,0,0,0
1667932078348,ECE 238B,A00,103649,Garay; Javier,0,0,0,0
1667932078780,ECE 240B,A00,112900,Fainman; Yeshaiahu,0,0,0,0
1667932079208,ECE 247A,A00,103650,Jokerst; Jesse Vincent,0,0,0,0
1667932079632,ECE 247B,A00,103651,Wang; Joseph,0,0,0,0
1667932080053,ECE 250,A00,103652,Siegel; Paul H.,0,0,0,0
1667932080478,ECE 251A,A00,103654,Rao; Bhaskar D.,0,0,0,0
1667932080903,ECE 257B,A00,103655,Bharadia; Dinesh,0,0,0,0
1667932081341,ECE 258A,A00,103656,Milstein; Laurence B.,0,0,0,0
1667932081765,ECE 260B,A00,103658,Kang; Mingu,0,0,0,0
1667932082191,ECE 264A,A00,103659,Galton; Ian A,0,0,0,0
1667932082632,ECE 265A,A00,103661,Gudem; Prasad S.S.,0,0,0,0
1667932083056,ECE 265D,A00,103662,Gudem; Prasad S.S.,0,0,0,0
1667932083479,ECE 268,A00,103663,Koushanfar; Farinaz,0,0,0,0
1667932083901,ECE 269,A01,103665,Pal; Piya,0,0,0,0
1667932084326,ECE 271B,A00,103666,Vasconcelos; Manuela,0,0,0,0
1667932084750,ECE 276A,A00,103667,Atanasov; Nikolay A.,0,0,0,0
1667932085175,ECE 277,A00,103668,An; Cheolhong,0,0,0,0
1667932085614,ECE 279,A00,117947,Hall; Drew A.,0,0,0,0
1667932086471,ECE 283,A00,103670,Hsueh; Tzu-Chien,0,0,0,0
1667932086896,ECE 284,A00,103671,Turakhia; Yatish Girish,0,0,0,0
1667932087326,ECE 285,A00,103672,Zheng; Yang,0,0,0,0
1667932087326,ECE 285,B00,103673,Sworder; David D.,0,0,0,0
1667932087754,ECE 287,A00,103676,Javidi; Tara,0,0,0,0
1667932088186,MATH 200B,A00,098023,Salehi Golsefidy; Alireza,15,0,15,0
1667932088618,MATH 202B,A00,098024,Rhoades; Brendon Patrick,14,0,15,1
1667932089043,MATH 203B,A00,098025,Oprea; Dragos N.,14,0,15,1
1667932089471,MATH 204B,A00,098026,Sorensen; Claus M,15,0,15,0
1667932089901,MATH 208,A00,098027,Izadi; Elham,7,0,10,3
1667932090330,MATH 209,A00,098028,Pollack; Aaron,10,0,10,0
1667932090752,MATH 211A,A00,112919,Rogalski; Daniel,10,0,10,0
1667932091176,MATH 211B,A00,112920,Seward; Brandon M.,10,0,10,0
1667932091604,MATH 218,A00,098029,Li; Bo,10,0,10,0
1667932092029,MATH 220B,A00,098030,Novak; Jonathan I,15,0,15,0
1667932092457,MATH 221A,A00,098031,Ebenfelt; Peter F,14,0,15,1
1667932092882,MATH 231B,A00,098032,Zlatos; Andrej,15,0,15,0
1667932093305,MATH 240B,A00,098033,Ni; Lei,13,0,15,2
1667932093820,MATH 243,A00,098034,Jekel; David Andrew,10,0,10,0
1667932094243,MATH 245A,A00,098035,Nie; Jiawang,6,0,15,9
1667932094666,MATH 248,A00,098036,Bejenaru; Ioan,10,0,10,0
1667932095090,MATH 250B,A00,098037,Spolaor; Luca,14,0,15,1
1667932095519,MATH 258,A00,098038,Ni; Lei,10,0,10,0
1667932095947,MATH 264B,A00,098041,Rhoades; Brendon Patrick,13,0,15,2
1667932096370,MATH 268,A00,098042,Buss; Samuel R,10,0,10,0
1667932096803,MATH 269,A00,098043,Rhoades; Brendon Patrick,10,0,10,0
1667932097242,MATH 270B,A00,098044,Li; Bo,13,0,15,2
1667932097667,MATH 272B,A00,098045,Holst; Michael J,13,0,15,2
1667932098102,MATH 273A,A00,098046,Tian; Xiaochuan,12,0,15,3
1667932098525,MATH 275,A01,098048,Tian; Xiaochuan,7,0,10,3
1667932098950,MATH 278A,A00,098049,Holst; Michael J,8,0,10,2
1667932099382,MATH 278B,A00,098050,Cloninger; Alexander,10,0,10,0
1667932099804,MATH 278C,A00,098051,Nie; Jiawang,9,0,10,1
1667932100232,MATH 280B,A00,098052,Zheng; Tianyi,12,0,15,3
1667932100658,MATH 281B,A00,098053,Bradic; Jelena,5,0,15,10
1667932101085,MATH 282B,A00,098054,Arias-Castro; Ery,2,0,15,13
1667932101519,MATH 285,A00,098055,Fitzsimmons; Patrick J,2,0,15,13
1667932101943,MATH 287B,A00,098056,Arias-Castro; Ery,9,0,15,6
1667932102379,MATH 288,A00,098057,Agarwal; Pooja,9,0,10,1
1667932102379,MATH 288,B00,098058,Zhang; Danna,9,0,10,1
1667932102379,MATH 288,C00,098059,Williams; Ruth J,10,0,10,0
1667932102804,MATH 290B,A00,098060,Roberts; Justin Deritter,14,0,15,1
1667932103227,MATH 292,A00,098061,Belmont; Eva Kinoshita,10,0,10,0
1667932103658,MATH 295,A00,098062,Suk; Andrew Hoon,48,0,50,2
1667932104081,MATH 296,A00,098063,Novak; Jonathan I,20,0,20,0
1667932104503,MATH 297,001,098064,Gamst; Anthony Collins,9997,0,9999,2
1667932607446,COGS 205,A00,101395,Chiba; Andrea,19,0,20,1
1667932607874,COGS 210B,001,101404,Greene; Deanna Jacquelyn,9998,0,9999,1
1667932607874,COGS 210B,002,101417,Xia; Haijun,9999,0,9999,0
1667932607874,COGS 210B,003,101422,Nitz; Douglas A.,9999,0,9999,0
1667932607874,COGS 210B,004,101423,Hollan; James D.,9998,0,9999,1
1667932607874,COGS 210B,005,101424,Deak; Gedeon O.,9999,0,9999,0
1667932607874,COGS 210B,006,101425,Rossano; Federico,9999,0,9999,0
1667932608297,COGS 211B,A00,101427,Coulson; Seana M,9997,0,9999,2
1667932608723,COGS 220,A00,101428,Hollan; James D.,0,0,25,25
1667932609150,COGS 229,A00,101429,Dow; Steven P,19,0,25,6
1667932609573,COGS 230,A00,101430,Klemmer; Scott R,13,0,17,4
1667932610001,COGS 234,A00,101431,Xia; Haijun,10,0,25,15
1667932610426,COGS 260,A00,101432,Kiyonaga; Anastasia,19,0,25,6
1667932610426,COGS 260,B00,101433,Kirsh; David Joel,17,0,25,8
1667932610853,CSE 202,A00,102371,Impagliazzo; Russell,0,0,0,0
1667932611280,CSE 203B,A01,102373,Cheng; Chung Kuan,0,0,0,0
1667932611709,CSE 208,A00,102374,Micciancio; Daniele,0,0,0,0
1667932612132,CSE 209A,A00,112895,Impagliazzo; Russell,0,0,15,15
1667932612555,CSE 209B,A00,108005,Bellare; Mihir,0,0,0,0
1667932612980,CSE 210,A00,113163,Coblenz; Michael J,0,0,0,0
1667932613415,CSE 219,A00,106111,Dow; Steven P,0,0,20,20
1667932613840,CSE 221,A00,102376,Voelker; Geoffrey M.,0,0,0,0
1667932614267,CSE 224,A01,102378,Porter; George M,0,0,0,0
1667932614692,CSE 229A,A00,102379,Savage; Stefan,0,0,0,0
1667932615115,CSE 229C,A00,102380,Munyaka; Imani N. S.,0,0,0,0
1667932615539,CSE 232B,A00,102382,Deutsch; Alin Bernard,0,0,0,0
1667932615962,CSE 234,A01,112904,Kumar; Arun Kumar,0,0,0,0
1667932616386,CSE 237A,A00,102383,Rosing; Tajana Simunic,0,0,0,0
1667932616907,CSE 239A,A00,102384,Deutsch; Alin Bernard,0,0,0,0
1667932617338,CSE 239B,A00,102385,Polikarpova; Nadezhda,0,0,0,0
1667932617765,CSE 240A,A00,102386,Pannuto; Patrick William,0,0,0,0
1667932618191,CSE 240B,A00,102387,Zhao; Jishen,0,0,0,0
1667932618616,CSE 241A,A00,106406,Kang; Mingu,0,0,0,0
1667932619038,CSE 249B,A00,102388,Kahng; Andrew Byun,0,0,8,8
1667932619462,CSE 251B,A01,102392,Cottrell; Garrison W,0,0,0,0
1667932619462,CSE 251B,A02,102393,Cottrell; Garrison W,0,0,0,0
1667932619888,CSE 252B,A00,102394,Ochoa; Benjamin Lawrence,0,0,0,0
1667932620316,CSE 257,A01,102396,Gao; Sicun,0,0,0,0
1667932620745,CSE 272,A00,102397,Li; Tzumao,0,0,0,0
1667932621170,CSE 274,A00,111323,Chern; Albert Ren-Haur,0,0,0,0
1667932621598,CSE 282,A00,102398,Pevzner; Pavel Arkadjevich,0,0,0,0
1667932622028,CSE 284,A00,114175,Gymrek; Melissa Ann,0,0,0,0
1667932622451,CSE 290,A00,102399,Chandraker; Manmohan Krishna,0,0,0,0
1667932622451,CSE 290,B00,102400,Vaccaro; Kristen Marie,1,0,25,24
1667932622451,CSE 290,C00,102414,Pannuto; Patrick William,1,0,25,24
1667932622451,CSE 290,D00,102427,Pevzner; Pavel Arkadjevich,0,0,0,0
1667932622451,CSE 290,E00,102429,Zhao; Jishen,0,0,0,0
1667932622451,CSE 290,F00,102436,Tullsen; Dean Michael,0,0,0,0
1667932622451,CSE 290,G00,102440,Christensen; Henrik I,0,0,20,20
1667932622888,CSE 291,A00,102443,Su; Hao,0,0,0,0
1667932622888,CSE 291,B00,102448,Polikarpova; Nadezhda,0,0,0,0
1667932622888,CSE 291,C00,102453,Vaccaro; Kristen Marie,0,0,0,0
1667932622888,CSE 291,D00,111343,Savage; Stefan,0,0,0,0
1667932622888,CSE 291,E00,116474,Claffy; Kimberly Claire,0,0,0,0
1667932622888,CSE 291,F00,116479,Pasquale; Joseph,0,0,0,0
1667932623318,CSE 293,001,119111,Bafna; Vineet,9999,0,9999,0
1667932623318,CSE 293,002,119118,Bellare; Mihir,9999,0,9999,0
1667932623318,CSE 293,003,119122,Berg-Kirkpatrick; Taylor D,9999,0,9999,0
1667932623318,CSE 293,004,119135,Christensen; Henrik I,9999,0,9999,0
1667932623318,CSE 293,005,119142,Cottrell; Garrison W,9999,0,9999,0
1667932623318,CSE 293,006,119146,Deutsch; Alin Bernard,9999,0,9999,0
1667932623318,CSE 293,007,119159,Esmaeilzadeh; Hadi,9999,0,9999,0
1667932623318,CSE 293,008,119166,Freund; Yoav,9999,0,9999,0
1667932623318,CSE 293,009,119170,Griswold; William G.,9999,0,9999,0
1667932623318,CSE 293,010,119183,Gymrek; Melissa Ann,9999,0,9999,0
1667932623318,CSE 293,011,119190,Heninger; Nadia A,9999,0,9999,0
1667932623318,CSE 293,012,119230,Impagliazzo; Russell,9999,0,9999,0
1667932623318,CSE 293,013,119232,Jhala; Ranjit,9999,0,9999,0
1667932623318,CSE 293,014,119233,Kahng; Andrew Byun,9999,0,9999,0
1667932623318,CSE 293,015,119298,Kane; Daniel Mertz,9999,0,9999,0
1667932623318,CSE 293,016,119299,Kriegman; David J,9999,0,9999,0
1667932623318,CSE 293,017,119300,Kumar; Arun Kumar,9999,0,9999,0
1667932623318,CSE 293,018,119301,Lerner; Sorin,9999,0,9999,0
1667932623318,CSE 293,019,119302,Lovett; Shachar,9999,0,9999,0
1667932623318,CSE 293,020,119303,McAuley; Julian John,9999,0,9999,0
1667932623318,CSE 293,021,119304,Micciancio; Daniele,9999,0,9999,0
1667932623318,CSE 293,022,119367,Orailoglu; Alex,9999,0,9999,0
1667932623318,CSE 293,023,119382,Paturi; Ramamohan,9999,0,9999,0
1667932623318,CSE 293,024,119404,Polikarpova; Nadezhda,9999,0,9999,0
1667932623318,CSE 293,025,119406,Politz; Joseph Gibbs,9999,0,9999,0
1667932623318,CSE 293,026,119411,Porter; George M,9999,0,9999,0
1667932623318,CSE 293,027,119414,Porter; Leonard Emerson,9999,0,9999,0
1667932623318,CSE 293,028,119416,Ramamoorthi; Ravi,9999,0,9999,0
1667932623318,CSE 293,029,119417,Sahoo; Debashis,9999,0,9999,0
1667932623318,CSE 293,030,119420,Saul; Lawrence,9999,0,9999,0
1667932623318,CSE 293,031,119421,Savage; Stefan,9999,0,9999,0
1667932623318,CSE 293,032,119425,Schulze; Jurgen P.,9999,0,9999,0
1667932623318,CSE 293,033,119426,Snoeren; Alex C.,9999,0,9999,0
1667932623318,CSE 293,034,119428,Shang; Jingbo,9999,0,9999,0
1667932623318,CSE 293,035,119430,Stefan; Deian,9999,0,9999,0
1667932623318,CSE 293,036,119431,Su; Hao,9999,0,9999,0
1667932623318,CSE 293,037,119433,Swanson; Steven James,9999,0,9999,0
1667932623318,CSE 293,038,119435,Tullsen; Dean Michael,9999,0,9999,0
1667932623318,CSE 293,039,119483,Voelker; Geoffrey M.,9999,0,9999,0
1667932623318,CSE 293,040,119537,Zhao; Jishen,9999,0,9999,0
1667932623318,CSE 293,041,119538,Zhou; Yuan-Yuan,9999,0,9999,0
1667932623318,CSE 293,042,119539,Gao; Sicun,9999,0,9999,0
1667932623318,CSE 293,043,119540,Weibel; Nadir,9999,0,9999,0
1667932623318,CSE 293,044,119541,Gupta; Rajesh K.,9999,0,9999,0
1667932623743,CSE 294,A00,102459,Voelker; Geoffrey M.,0,0,0,0
1667932623743,CSE 294,B00,111322,Orailoglu; Alex,0,0,0,0
1667932624166,DSE 201,A00,096914,Deutsch; Alin Bernard,30,0,30,0
1667932624592,DSE 210,A00,096915,Dasgupta; Sanjoy,30,0,30,0
1667932625016,DSE 260A,A00,096916,Altintas De Callaf; Ilkay,30,0,30,0
1667932625457,ECE 200,001,103586,Antipa; Nicholas A,9999,0,9999,0
1667932625457,ECE 200,002,103587,Atanasov; Nikolay A.,9999,0,9999,0
1667932625457,ECE 200,003,103588,Bharadia; Dinesh,9999,0,9999,0
1667932625457,ECE 200,004,103589,Cheng; Chung Kuan,9999,0,9999,0
1667932625457,ECE 200,005,103590,Cosman; Pamela C.,9999,0,9999,0
1667932625457,ECE 200,006,103591,Dayeh; Shadi Ahmad,9999,0,9999,0
1667932625457,ECE 200,007,103592,Fainman; Yeshaiahu,9999,0,9999,0
1667932625457,ECE 200,008,103593,Ford; Joseph Earl,9999,0,9999,0
1667932625457,ECE 200,009,103594,Franceschetti; Massimo,9999,0,9999,0
1667932625457,ECE 200,010,103595,Fullerton; Eric E,9999,0,9999,0
1667932625457,ECE 200,011,103596,Galton; Ian A,9999,0,9999,0
1667932625457,ECE 200,012,103597,Gilja; Vikash,9999,0,9999,0
1667932625457,ECE 200,013,103598,Hall; Drew A.,9999,0,9999,0
1667932625457,ECE 200,014,103599,Hsueh; Tzu-Chien,9999,0,9999,0
1667932625457,ECE 200,015,103600,Javidi; Tara,9999,0,9999,0
1667932625457,ECE 200,016,103601,Kahng; Andrew Byun,9999,0,9999,0
1667932625457,ECE 200,017,103602,Kim; Young-Han,9999,0,9999,0
1667932625457,ECE 200,018,103603,Koushanfar; Farinaz,9999,0,9999,0
1667932625457,ECE 200,019,103604,Kuzum; Duygu,9999,0,9999,0
1667932625457,ECE 200,020,103605,Le; Hanh-Phuc,9999,0,9999,0
1667932625457,ECE 200,021,103606,Lin; Bill,9999,0,9999,0
1667932625457,ECE 200,022,103607,Liu; Zhaowei,9998,0,9999,1
1667932625457,ECE 200,023,103608,Lo; Yu-Hwa,9999,0,9999,0
1667932625457,ECE 200,024,103609,Lomakin; Vitaliy,9999,0,9999,0
1667932625457,ECE 200,025,103610,Mercier; Patrick Philip,9999,0,9999,0
1667932625457,ECE 200,026,103611,Meyer; Florian,9999,0,9999,0
1667932625457,ECE 200,027,103612,Milstein; Laurence B.,9999,0,9999,0
1667932625457,ECE 200,028,103613,Mir Arabbaygi; Siavash,9999,0,9999,0
1667932625457,ECE 200,029,103614,Mookherjea; Shayan,9999,0,9999,0
1667932625457,ECE 200,030,103615,Morris; Karcher William,9999,0,9999,0
1667932625457,ECE 200,031,103616,Ng; Tse Nga,9999,0,9999,0
1667932625457,ECE 200,032,103617,Nguyen; Truong Quang,9999,0,9999,0
1667932625457,ECE 200,033,103618,Nomura; Kenji,9999,0,9999,0
1667932625457,ECE 200,034,103619,Orlitsky; Alon,9999,0,9999,0
1667932625457,ECE 200,035,103620,Pal; Piya,9999,0,9999,0
1667932625457,ECE 200,036,103621,Papen; George C.,9999,0,9999,0
1667932625457,ECE 200,037,103622,Radic; Stojan,9999,0,9999,0
1667932625457,ECE 200,038,103623,Rao; Bhaskar D.,9999,0,9999,0
1667932625457,ECE 200,039,103624,Rao; Ramesh R,9999,0,9999,0
1667932625457,ECE 200,040,103625,Rebeiz; Gabriel,9999,0,9999,0
1667932625457,ECE 200,041,103626,Sanford; John R,9999,0,9999,0
1667932625457,ECE 200,042,103627,Siegel; Paul H.,9999,0,9999,0
1667932625457,ECE 200,043,103628,Sievenpiper; Daniel F.,9999,0,9999,0
1667932625457,ECE 200,044,103629,Sworder; David D.,9999,0,9999,0
1667932625457,ECE 200,045,103630,Taur; Yuan,9999,0,9999,0
1667932625457,ECE 200,046,103631,Touri; Behrouz,9999,0,9999,0
1667932625457,ECE 200,047,103632,Trivedi; Mohan M.,9999,0,9999,0
1667932625457,ECE 200,048,103633,Vasconcelos; Nuno,9999,0,9999,0
1667932625457,ECE 200,049,103634,Wang; Xiaolong,9999,0,9999,0
1667932625457,ECE 200,050,103635,Xie; Pengtao,9999,0,9999,0
1667932625457,ECE 200,051,103636,Yip; Michael,9999,0,9999,0
1667932625457,ECE 200,052,103637,Zeger; Kenneth A.,999,0,999,0
1667932625457,ECE 200,053,103638,Zhang; Xinyu,9999,0,9999,0
1667932625457,ECE 200,054,103639,Turakhia; Yatish Girish,9999,0,9999,0
1667932625457,ECE 200,055,103640,Kang; Mingu,9999,0,9999,0
1667932625457,ECE 200,056,103641,Shi; Yuanyuan,9999,0,9999,0
1667932625457,ECE 200,057,103642,Wang; Edward Jay,9999,0,9999,0
1667932625457,ECE 200,058,103643,Zheng; Yang,9999,0,9999,0
1667932625885,ECE 202,A00,103644,Kuzum; Duygu,0,0,0,0
1667932626307,ECE 212BN,A00,103646,Ng; Tse Nga,0,0,0,0
1667932626740,ECE 221,A00,111493,Staff,0,0,0,0
1667932627163,ECE 222B,A00,103647,Lomakin; Vitaliy,0,0,0,0
1667932627587,ECE 230B,A00,103648,Taur; Yuan,0,0,0,0
1667932628013,ECE 238B,A00,103649,Garay; Javier,0,0,0,0
1667932628437,ECE 240B,A00,112900,Fainman; Yeshaiahu,0,0,0,0
1667932628868,ECE 247A,A00,103650,Jokerst; Jesse Vincent,0,0,0,0
1667932629291,ECE 247B,A00,103651,Wang; Joseph,0,0,0,0
1667932629722,ECE 250,A00,103652,Siegel; Paul H.,0,0,0,0
1667932630143,ECE 251A,A00,103654,Rao; Bhaskar D.,0,0,0,0
1667932630588,ECE 257B,A00,103655,Bharadia; Dinesh,0,0,0,0
1667932631013,ECE 258A,A00,103656,Milstein; Laurence B.,0,0,0,0
1667932631442,ECE 260B,A00,103658,Kang; Mingu,0,0,0,0
1667932631867,ECE 264A,A00,103659,Galton; Ian A,0,0,0,0
1667932632299,ECE 265A,A00,103661,Gudem; Prasad S.S.,0,0,0,0
1667932632727,ECE 265D,A00,103662,Gudem; Prasad S.S.,0,0,0,0
1667932633161,ECE 268,A00,103663,Koushanfar; Farinaz,0,0,0,0
1667932633584,ECE 269,A01,103665,Pal; Piya,0,0,0,0
1667932634017,ECE 271B,A00,103666,Vasconcelos; Manuela,0,0,0,0
1667932634451,ECE 276A,A00,103667,Atanasov; Nikolay A.,0,0,0,0
1667932634875,ECE 277,A00,103668,An; Cheolhong,0,0,0,0
1667932635311,ECE 279,A00,117947,Hall; Drew A.,0,0,0,0
1667932636163,ECE 283,A00,103670,Hsueh; Tzu-Chien,0,0,0,0
1667932636589,ECE 284,A00,103671,Turakhia; Yatish Girish,0,0,0,0
1667932637013,ECE 285,A00,103672,Zheng; Yang,0,0,0,0
1667932637013,ECE 285,B00,103673,Sworder; David D.,0,0,0,0
1667932637435,ECE 287,A00,103676,Javidi; Tara,0,0,0,0
1667932637872,MATH 200B,A00,098023,Salehi Golsefidy; Alireza,15,0,15,0
1667932638294,MATH 202B,A00,098024,Rhoades; Brendon Patrick,14,0,15,1
1667932638715,MATH 203B,A00,098025,Oprea; Dragos N.,14,0,15,1
1667932639154,MATH 204B,A00,098026,Sorensen; Claus M,15,0,15,0
1667932639579,MATH 208,A00,098027,Izadi; Elham,7,0,10,3
1667932640003,MATH 209,A00,098028,Pollack; Aaron,10,0,10,0
1667932640427,MATH 211A,A00,112919,Rogalski; Daniel,10,0,10,0
1667932640854,MATH 211B,A00,112920,Seward; Brandon M.,10,0,10,0
1667932641281,MATH 218,A00,098029,Li; Bo,10,0,10,0
1667932641716,MATH 220B,A00,098030,Novak; Jonathan I,15,0,15,0
1667932642144,MATH 221A,A00,098031,Ebenfelt; Peter F,14,0,15,1
1667932642569,MATH 231B,A00,098032,Zlatos; Andrej,15,0,15,0
1667932642991,MATH 240B,A00,098033,Ni; Lei,12,0,15,3
1667932643421,MATH 243,A00,098034,Jekel; David Andrew,10,0,10,0
1667932643845,MATH 245A,A00,098035,Nie; Jiawang,6,0,15,9
1667932644273,MATH 248,A00,098036,Bejenaru; Ioan,10,0,10,0
1667932644697,MATH 250B,A00,098037,Spolaor; Luca,14,0,15,1
1667932645119,MATH 258,A00,098038,Ni; Lei,10,0,10,0
1667932645543,MATH 264B,A00,098041,Rhoades; Brendon Patrick,13,0,15,2
1667932645980,MATH 268,A00,098042,Buss; Samuel R,10,0,10,0
1667932646409,MATH 269,A00,098043,Rhoades; Brendon Patrick,10,0,10,0
1667932646839,MATH 270B,A00,098044,Li; Bo,12,0,15,3
1667932647264,MATH 272B,A00,098045,Holst; Michael J,13,0,15,2
1667932647689,MATH 273A,A00,098046,Tian; Xiaochuan,12,0,15,3
1667932648113,MATH 275,A01,098048,Tian; Xiaochuan,6,0,10,4
1667932648539,MATH 278A,A00,098049,Holst; Michael J,8,0,10,2
1667932648965,MATH 278B,A00,098050,Cloninger; Alexander,10,0,10,0
1667932649389,MATH 278C,A00,098051,Nie; Jiawang,9,0,10,1
1667932649824,MATH 280B,A00,098052,Zheng; Tianyi,12,0,15,3
1667932650251,MATH 281B,A00,098053,Bradic; Jelena,4,0,15,11
1667932650676,MATH 282B,A00,098054,Arias-Castro; Ery,2,0,15,13
1667932651098,MATH 285,A00,098055,Fitzsimmons; Patrick J,2,0,15,13
1667932651523,MATH 287B,A00,098056,Arias-Castro; Ery,9,0,15,6
1667932651945,MATH 288,A00,098057,Agarwal; Pooja,9,0,10,1
1667932651945,MATH 288,B00,098058,Zhang; Danna,9,0,10,1
1667932651945,MATH 288,C00,098059,Williams; Ruth J,10,0,10,0
1667932652366,MATH 290B,A00,098060,Roberts; Justin Deritter,14,0,15,1
1667932652799,MATH 292,A00,098061,Belmont; Eva Kinoshita,10,0,10,0
1667932653233,MATH 295,A00,098062,Suk; Andrew Hoon,48,0,50,2
1667932653661,MATH 296,A00,098063,Novak; Jonathan I,20,0,20,0
1667932654084,MATH 297,001,098064,Gamst; Anthony Collins,9997,0,9999,2
1667933156271,COGS 205,A00,101395,Chiba; Andrea,19,0,20,1
1667933156714,COGS 210B,001,101404,Greene; Deanna Jacquelyn,9998,0,9999,1
1667933156714,COGS 210B,002,101417,Xia; Haijun,9999,0,9999,0
1667933156714,COGS 210B,003,101422,Nitz; Douglas A.,9999,0,9999,0
1667933156714,COGS 210B,004,101423,Hollan; James D.,9998,0,9999,1
1667933156714,COGS 210B,005,101424,Deak; Gedeon O.,9999,0,9999,0
1667933156714,COGS 210B,006,101425,Rossano; Federico,9999,0,9999,0
1667933157137,COGS 211B,A00,101427,Coulson; Seana M,9997,0,9999,2
1667933157560,COGS 220,A00,101428,Hollan; James D.,0,0,25,25
1667933157982,COGS 229,A00,101429,Dow; Steven P,19,0,25,6
1667933158413,COGS 230,A00,101430,Klemmer; Scott R,13,0,17,4
1667933158843,COGS 234,A00,101431,Xia; Haijun,10,0,25,15
1667933159266,COGS 260,A00,101432,Kiyonaga; Anastasia,19,0,25,6
1667933159266,COGS 260,B00,101433,Kirsh; David Joel,17,0,25,8
1667933159688,CSE 202,A00,102371,Impagliazzo; Russell,0,0,0,0
1667933160114,CSE 203B,A01,102373,Cheng; Chung Kuan,0,0,0,0
1667933160564,CSE 208,A00,102374,Micciancio; Daniele,0,0,0,0
1667933160992,CSE 209A,A00,112895,Impagliazzo; Russell,0,0,15,15
1667933161424,CSE 209B,A00,108005,Bellare; Mihir,0,0,0,0
1667933161856,CSE 210,A00,113163,Coblenz; Michael J,0,0,0,0
1667933162283,CSE 219,A00,106111,Dow; Steven P,0,0,20,20
1667933162709,CSE 221,A00,102376,Voelker; Geoffrey M.,0,0,0,0
1667933163152,CSE 224,A01,102378,Porter; George M,0,0,0,0
1667933163576,CSE 229A,A00,102379,Savage; Stefan,0,0,0,0
1667933164018,CSE 229C,A00,102380,Munyaka; Imani N. S.,0,0,0,0
1667933164441,CSE 232B,A00,102382,Deutsch; Alin Bernard,0,0,0,0
1667933164891,CSE 234,A01,112904,Kumar; Arun Kumar,0,0,0,0
1667933165320,CSE 237A,A00,102383,Rosing; Tajana Simunic,0,0,0,0
1667933165748,CSE 239A,A00,102384,Deutsch; Alin Bernard,0,0,0,0
1667933166186,CSE 239B,A00,102385,Polikarpova; Nadezhda,0,0,0,0
1667933166626,CSE 240A,A00,102386,Pannuto; Patrick William,0,0,0,0
1667933167049,CSE 240B,A00,102387,Zhao; Jishen,0,0,0,0
1667933167475,CSE 241A,A00,106406,Kang; Mingu,0,0,0,0
1667933167903,CSE 249B,A00,102388,Kahng; Andrew Byun,0,0,8,8
1667933168335,CSE 251B,A01,102392,Cottrell; Garrison W,0,0,0,0
1667933168335,CSE 251B,A02,102393,Cottrell; Garrison W,0,0,0,0
1667933168764,CSE 252B,A00,102394,Ochoa; Benjamin Lawrence,0,0,0,0
1667933169401,CSE 257,A01,102396,Gao; Sicun,0,0,0,0
1667933169839,CSE 272,A00,102397,Li; Tzumao,0,0,0,0
1667933170265,CSE 274,A00,111323,Chern; Albert Ren-Haur,0,0,0,0
1667933170698,CSE 282,A00,102398,Pevzner; Pavel Arkadjevich,0,0,0,0
1667933171129,CSE 284,A00,114175,Gymrek; Melissa Ann,0,0,0,0
1667933171559,CSE 290,A00,102399,Chandraker; Manmohan Krishna,0,0,0,0
1667933171559,CSE 290,B00,102400,Vaccaro; Kristen Marie,0,0,25,25
1667933171559,CSE 290,C00,102414,Pannuto; Patrick William,1,0,25,24
1667933171559,CSE 290,D00,102427,Pevzner; Pavel Arkadjevich,0,0,0,0
1667933171559,CSE 290,E00,102429,Zhao; Jishen,0,0,0,0
1667933171559,CSE 290,F00,102436,Tullsen; Dean Michael,0,0,0,0
1667933171559,CSE 290,G00,102440,Christensen; Henrik I,0,0,20,20
1667933171995,CSE 291,A00,102443,Su; Hao,0,0,0,0
1667933171995,CSE 291,B00,102448,Polikarpova; Nadezhda,0,0,0,0
1667933171995,CSE 291,C00,102453,Vaccaro; Kristen Marie,0,0,0,0
1667933171995,CSE 291,D00,111343,Savage; Stefan,0,0,0,0
1667933171995,CSE 291,E00,116474,Claffy; Kimberly Claire,0,0,0,0
1667933171995,CSE 291,F00,116479,Pasquale; Joseph,0,0,0,0
1667933172451,CSE 293,001,119111,Bafna; Vineet,9999,0,9999,0
1667933172451,CSE 293,002,119118,Bellare; Mihir,9999,0,9999,0
1667933172451,CSE 293,003,119122,Berg-Kirkpatrick; Taylor D,9999,0,9999,0
1667933172451,CSE 293,004,119135,Christensen; Henrik I,9999,0,9999,0
1667933172451,CSE 293,005,119142,Cottrell; Garrison W,9999,0,9999,0
1667933172451,CSE 293,006,119146,Deutsch; Alin Bernard,9999,0,9999,0
1667933172451,CSE 293,007,119159,Esmaeilzadeh; Hadi,9999,0,9999,0
1667933172451,CSE 293,008,119166,Freund; Yoav,9999,0,9999,0
1667933172451,CSE 293,009,119170,Griswold; William G.,9999,0,9999,0
1667933172451,CSE 293,010,119183,Gymrek; Melissa Ann,9999,0,9999,0
1667933172451,CSE 293,011,119190,Heninger; Nadia A,9999,0,9999,0
1667933172451,CSE 293,012,119230,Impagliazzo; Russell,9999,0,9999,0
1667933172451,CSE 293,013,119232,Jhala; Ranjit,9999,0,9999,0
1667933172451,CSE 293,014,119233,Kahng; Andrew Byun,9999,0,9999,0
1667933172451,CSE 293,015,119298,Kane; Daniel Mertz,9999,0,9999,0
1667933172451,CSE 293,016,119299,Kriegman; David J,9999,0,9999,0
1667933172451,CSE 293,017,119300,Kumar; Arun Kumar,9999,0,9999,0
1667933172451,CSE 293,018,119301,Lerner; Sorin,9999,0,9999,0
1667933172451,CSE 293,019,119302,Lovett; Shachar,9999,0,9999,0
1667933172451,CSE 293,020,119303,McAuley; Julian John,9999,0,9999,0
1667933172451,CSE 293,021,119304,Micciancio; Daniele,9999,0,9999,0
1667933172451,CSE 293,022,119367,Orailoglu; Alex,9999,0,9999,0
1667933172451,CSE 293,023,119382,Paturi; Ramamohan,9999,0,9999,0
1667933172451,CSE 293,024,119404,Polikarpova; Nadezhda,9999,0,9999,0
1667933172451,CSE 293,025,119406,Politz; Joseph Gibbs,9999,0,9999,0
1667933172451,CSE 293,026,119411,Porter; George M,9999,0,9999,0
1667933172451,CSE 293,027,119414,Porter; Leonard Emerson,9999,0,9999,0
1667933172451,CSE 293,028,119416,Ramamoorthi; Ravi,9999,0,9999,0
1667933172451,CSE 293,029,119417,Sahoo; Debashis,9999,0,9999,0
1667933172451,CSE 293,030,119420,Saul; Lawrence,9999,0,9999,0
1667933172451,CSE 293,031,119421,Savage; Stefan,9999,0,9999,0
1667933172451,CSE 293,032,119425,Schulze; Jurgen P.,9999,0,9999,0
1667933172451,CSE 293,033,119426,Snoeren; Alex C.,9999,0,9999,0
1667933172451,CSE 293,034,119428,Shang; Jingbo,9999,0,9999,0
1667933172451,CSE 293,035,119430,Stefan; Deian,9999,0,9999,0
1667933172451,CSE 293,036,119431,Su; Hao,9999,0,9999,0
1667933172451,CSE 293,037,119433,Swanson; Steven James,9999,0,9999,0
1667933172451,CSE 293,038,119435,Tullsen; Dean Michael,9999,0,9999,0
1667933172451,CSE 293,039,119483,Voelker; Geoffrey M.,9999,0,9999,0
1667933172451,CSE 293,040,119537,Zhao; Jishen,9999,0,9999,0
1667933172451,CSE 293,041,119538,Zhou; Yuan-Yuan,9999,0,9999,0
1667933172451,CSE 293,042,119539,Gao; Sicun,9999,0,9999,0
1667933172451,CSE 293,043,119540,Weibel; Nadir,9999,0,9999,0
1667933172451,CSE 293,044,119541,Gupta; Rajesh K.,9999,0,9999,0
1667933172884,CSE 294,A00,102459,Voelker; Geoffrey M.,0,0,0,0
1667933172884,CSE 294,B00,111322,Orailoglu; Alex,0,0,0,0
1667933173319,DSE 201,A00,096914,Deutsch; Alin Bernard,30,0,30,0
1667933173748,DSE 210,A00,096915,Dasgupta; Sanjoy,30,0,30,0
1667933174174,DSE 260A,A00,096916,Altintas De Callaf; Ilkay,30,0,30,0
1667933174624,ECE 200,001,103586,Antipa; Nicholas A,9999,0,9999,0
1667933174624,ECE 200,002,103587,Atanasov; Nikolay A.,9999,0,9999,0
1667933174624,ECE 200,003,103588,Bharadia; Dinesh,9999,0,9999,0
1667933174624,ECE 200,004,103589,Cheng; Chung Kuan,9999,0,9999,0
1667933174624,ECE 200,005,103590,Cosman; Pamela C.,9999,0,9999,0
1667933174624,ECE 200,006,103591,Dayeh; Shadi Ahmad,9999,0,9999,0
1667933174624,ECE 200,007,103592,Fainman; Yeshaiahu,9999,0,9999,0
1667933174624,ECE 200,008,103593,Ford; Joseph Earl,9999,0,9999,0
1667933174624,ECE 200,009,103594,Franceschetti; Massimo,9999,0,9999,0
1667933174624,ECE 200,010,103595,Fullerton; Eric E,9999,0,9999,0
1667933174624,ECE 200,011,103596,Galton; Ian A,9999,0,9999,0
1667933174624,ECE 200,012,103597,Gilja; Vikash,9999,0,9999,0
1667933174624,ECE 200,013,103598,Hall; Drew A.,9999,0,9999,0
1667933174624,ECE 200,014,103599,Hsueh; Tzu-Chien,9999,0,9999,0
1667933174624,ECE 200,015,103600,Javidi; Tara,9999,0,9999,0
1667933174624,ECE 200,016,103601,Kahng; Andrew Byun,9999,0,9999,0
1667933174624,ECE 200,017,103602,Kim; Young-Han,9999,0,9999,0
1667933174624,ECE 200,018,103603,Koushanfar; Farinaz,9999,0,9999,0
1667933174624,ECE 200,019,103604,Kuzum; Duygu,9999,0,9999,0
1667933174624,ECE 200,020,103605,Le; Hanh-Phuc,9999,0,9999,0
1667933174624,ECE 200,021,103606,Lin; Bill,9999,0,9999,0
1667933174624,ECE 200,022,103607,Liu; Zhaowei,9998,0,9999,1
1667933174624,ECE 200,023,103608,Lo; Yu-Hwa,9999,0,9999,0
1667933174624,ECE 200,024,103609,Lomakin; Vitaliy,9999,0,9999,0
1667933174624,ECE 200,025,103610,Mercier; Patrick Philip,9999,0,9999,0
1667933174624,ECE 200,026,103611,Meyer; Florian,9999,0,9999,0
1667933174624,ECE 200,027,103612,Milstein; Laurence B.,9999,0,9999,0
1667933174624,ECE 200,028,103613,Mir Arabbaygi; Siavash,9999,0,9999,0
1667933174624,ECE 200,029,103614,Mookherjea; Shayan,9999,0,9999,0
1667933174624,ECE 200,030,103615,Morris; Karcher William,9999,0,9999,0
1667933174624,ECE 200,031,103616,Ng; Tse Nga,9999,0,9999,0
1667933174624,ECE 200,032,103617,Nguyen; Truong Quang,9999,0,9999,0
1667933174624,ECE 200,033,103618,Nomura; Kenji,9999,0,9999,0
1667933174624,ECE 200,034,103619,Orlitsky; Alon,9999,0,9999,0
1667933174624,ECE 200,035,103620,Pal; Piya,9999,0,9999,0
1667933174624,ECE 200,036,103621,Papen; George C.,9999,0,9999,0
1667933174624,ECE 200,037,103622,Radic; Stojan,9999,0,9999,0
1667933174624,ECE 200,038,103623,Rao; Bhaskar D.,9999,0,9999,0
1667933174624,ECE 200,039,103624,Rao; Ramesh R,9999,0,9999,0
1667933174624,ECE 200,040,103625,Rebeiz; Gabriel,9999,0,9999,0
1667933174624,ECE 200,041,103626,Sanford; John R,9999,0,9999,0
1667933174624,ECE 200,042,103627,Siegel; Paul H.,9999,0,9999,0
1667933174624,ECE 200,043,103628,Sievenpiper; Daniel F.,9999,0,9999,0
1667933174624,ECE 200,044,103629,Sworder; David D.,9999,0,9999,0
1667933174624,ECE 200,045,103630,Taur; Yuan,9999,0,9999,0
1667933174624,ECE 200,046,103631,Touri; Behrouz,9999,0,9999,0
1667933174624,ECE 200,047,103632,Trivedi; Mohan M.,9999,0,9999,0
1667933174624,ECE 200,048,103633,Vasconcelos; Nuno,9999,0,9999,0
1667933174624,ECE 200,049,103634,Wang; Xiaolong,9999,0,9999,0
1667933174624,ECE 200,050,103635,Xie; Pengtao,9999,0,9999,0
1667933174624,ECE 200,051,103636,Yip; Michael,9999,0,9999,0
1667933174624,ECE 200,052,103637,Zeger; Kenneth A.,999,0,999,0
1667933174624,ECE 200,053,103638,Zhang; Xinyu,9999,0,9999,0
1667933174624,ECE 200,054,103639,Turakhia; Yatish Girish,9999,0,9999,0
1667933174624,ECE 200,055,103640,Kang; Mingu,9999,0,9999,0
1667933174624,ECE 200,056,103641,Shi; Yuanyuan,9999,0,9999,0
1667933174624,ECE 200,057,103642,Wang; Edward Jay,9999,0,9999,0
1667933174624,ECE 200,058,103643,Zheng; Yang,9999,0,9999,0
1667933175049,ECE 202,A00,103644,Kuzum; Duygu,0,0,0,0
1667933175478,ECE 212BN,A00,103646,Ng; Tse Nga,0,0,0,0
1667933175907,ECE 221,A00,111493,Staff,0,0,0,0
1667933176329,ECE 222B,A00,103647,Lomakin; Vitaliy,0,0,0,0
1667933176764,ECE 230B,A00,103648,Taur; Yuan,0,0,0,0
1667933177202,ECE 238B,A00,103649,Garay; Javier,0,0,0,0
1667933177641,ECE 240B,A00,112900,Fainman; Yeshaiahu,0,0,0,0
1667933178064,ECE 247A,A00,103650,Jokerst; Jesse Vincent,0,0,0,0
1667933178492,ECE 247B,A00,103651,Wang; Joseph,0,0,0,0
1667933178930,ECE 250,A00,103652,Siegel; Paul H.,0,0,0,0
1667933179356,ECE 251A,A00,103654,Rao; Bhaskar D.,0,0,0,0
1667933179780,ECE 257B,A00,103655,Bharadia; Dinesh,0,0,0,0
1667933180207,ECE 258A,A00,103656,Milstein; Laurence B.,0,0,0,0
1667933180637,ECE 260B,A00,103658,Kang; Mingu,0,0,0,0
1667933181063,ECE 264A,A00,103659,Galton; Ian A,0,0,0,0
1667933181499,ECE 265A,A00,103661,Gudem; Prasad S.S.,0,0,0,0
1667933181920,ECE 265D,A00,103662,Gudem; Prasad S.S.,0,0,0,0
1667933182346,ECE 268,A00,103663,Koushanfar; Farinaz,0,0,0,0
1667933182872,ECE 269,A01,103665,Pal; Piya,0,0,0,0
1667933183303,ECE 271B,A00,103666,Vasconcelos; Manuela,0,0,0,0
1667933183745,ECE 276A,A00,103667,Atanasov; Nikolay A.,0,0,0,0
1667933184171,ECE 277,A00,103668,An; Cheolhong,0,0,0,0
1667933184595,ECE 279,A00,117947,Hall; Drew A.,0,0,0,0
1667933185461,ECE 283,A00,103670,Hsueh; Tzu-Chien,0,0,0,0
1667933185890,ECE 284,A00,103671,Turakhia; Yatish Girish,0,0,0,0
1667933186312,ECE 285,A00,103672,Zheng; Yang,0,0,0,0
1667933186312,ECE 285,B00,103673,Sworder; David D.,0,0,0,0
1667933186733,ECE 287,A00,103676,Javidi; Tara,0,0,0,0
1667933187156,MATH 200B,A00,098023,Salehi Golsefidy; Alireza,15,0,15,0
1667933187578,MATH 202B,A00,098024,Rhoades; Brendon Patrick,14,0,15,1
1667933188001,MATH 203B,A00,098025,Oprea; Dragos N.,14,0,15,1
1667933188426,MATH 204B,A00,098026,Sorensen; Claus M,15,0,15,0
1667933188855,MATH 208,A00,098027,Izadi; Elham,7,0,10,3
1667933189287,MATH 209,A00,098028,Pollack; Aaron,10,0,10,0
1667933189716,MATH 211A,A00,112919,Rogalski; Daniel,10,0,10,0
1667933190150,MATH 211B,A00,112920,Seward; Brandon M.,10,0,10,0
1667933190575,MATH 218,A00,098029,Li; Bo,10,0,10,0
1667933190999,MATH 220B,A00,098030,Novak; Jonathan I,15,0,15,0
1667933191424,MATH 221A,A00,098031,Ebenfelt; Peter F,14,0,15,1
1667933191849,MATH 231B,A00,098032,Zlatos; Andrej,15,0,15,0
1667933192278,MATH 240B,A00,098033,Ni; Lei,12,0,15,3
1667933192707,MATH 243,A00,098034,Jekel; David Andrew,10,0,10,0
1667933193133,MATH 245A,A00,098035,Nie; Jiawang,6,0,15,9
1667933193556,MATH 248,A00,098036,Bejenaru; Ioan,10,0,10,0
1667933193990,MATH 250B,A00,098037,Spolaor; Luca,14,0,15,1
1667933194416,MATH 258,A00,098038,Ni; Lei,10,0,10,0
1667933194841,MATH 264B,A00,098041,Rhoades; Brendon Patrick,13,0,15,2
1667933195277,MATH 268,A00,098042,Buss; Samuel R,10,0,10,0
1667933195700,MATH 269,A00,098043,Rhoades; Brendon Patrick,10,0,10,0
1667933196124,MATH 270B,A00,098044,Li; Bo,12,0,15,3
1667933196558,MATH 272B,A00,098045,Holst; Michael J,13,0,15,2
1667933196982,MATH 273A,A00,098046,Tian; Xiaochuan,12,0,15,3
1667933197416,MATH 275,A01,098048,Tian; Xiaochuan,6,0,10,4
1667933197860,MATH 278A,A00,098049,Holst; Michael J,8,0,10,2
1667933198283,MATH 278B,A00,098050,Cloninger; Alexander,10,0,10,0
1667933198710,MATH 278C,A00,098051,Nie; Jiawang,9,0,10,1
1667933199139,MATH 280B,A00,098052,Zheng; Tianyi,12,0,15,3
1667933199563,MATH 281B,A00,098053,Bradic; Jelena,4,0,15,11
1667933199985,MATH 282B,A00,098054,Arias-Castro; Ery,2,0,15,13
1667933200409,MATH 285,A00,098055,Fitzsimmons; Patrick J,2,0,15,13
1667933200835,MATH 287B,A00,098056,Arias-Castro; Ery,9,0,15,6
1667933201262,MATH 288,A00,098057,Agarwal; Pooja,9,0,10,1
1667933201262,MATH 288,B00,098058,Zhang; Danna,9,0,10,1
1667933201262,MATH 288,C00,098059,Williams; Ruth J,10,0,10,0
1667933201691,MATH 290B,A00,098060,Roberts; Justin Deritter,14,0,15,1
1667933202121,MATH 292,A00,098061,Belmont; Eva Kinoshita,10,0,10,0
1667933202543,MATH 295,A00,098062,Suk; Andrew Hoon,48,0,50,2
1667933202969,MATH 296,A00,098063,Novak; Jonathan I,20,0,20,0
1667933203404,MATH 297,001,098064,Gamst; Anthony Collins,9997,0,9999,2
1667933706780,COGS 205,A00,101395,Chiba; Andrea,19,0,20,1
1667933707204,COGS 210B,001,101404,Greene; Deanna Jacquelyn,9998,0,9999,1
1667933707204,COGS 210B,002,101417,Xia; Haijun,9999,0,9999,0
1667933707204,COGS 210B,003,101422,Nitz; Douglas A.,9999,0,9999,0
1667933707204,COGS 210B,004,101423,Hollan; James D.,9998,0,9999,1
1667933707204,COGS 210B,005,101424,Deak; Gedeon O.,9999,0,9999,0
1667933707204,COGS 210B,006,101425,Rossano; Federico,9999,0,9999,0
1667933707627,COGS 211B,A00,101427,Coulson; Seana M,9997,0,9999,2
1667933708055,COGS 220,A00,101428,Hollan; James D.,0,0,25,25
1667933708481,COGS 229,A00,101429,Dow; Steven P,19,0,25,6
1667933708910,COGS 230,A00,101430,Klemmer; Scott R,13,0,17,4
1667933709339,COGS 234,A00,101431,Xia; Haijun,10,0,25,15
1667933709761,COGS 260,A00,101432,Kiyonaga; Anastasia,19,0,25,6
1667933709761,COGS 260,B00,101433,Kirsh; David Joel,17,0,25,8
1667933710185,CSE 202,A00,102371,Impagliazzo; Russell,0,0,0,0
1667933710609,CSE 203B,A01,102373,Cheng; Chung Kuan,0,0,0,0
1667933711033,CSE 208,A00,102374,Micciancio; Daniele,0,0,0,0
1667933711462,CSE 209A,A00,112895,Impagliazzo; Russell,0,0,15,15
1667933711887,CSE 209B,A00,108005,Bellare; Mihir,0,0,0,0
1667933712311,CSE 210,A00,113163,Coblenz; Michael J,0,0,0,0
1667933712738,CSE 219,A00,106111,Dow; Steven P,0,0,20,20
1667933713160,CSE 221,A00,102376,Voelker; Geoffrey M.,0,0,0,0
1667933713584,CSE 224,A01,102378,Porter; George M,0,0,0,0
1667933714009,CSE 229A,A00,102379,Savage; Stefan,0,0,0,0
1667933714442,CSE 229C,A00,102380,Munyaka; Imani N. S.,0,0,0,0
1667933714871,CSE 232B,A00,102382,Deutsch; Alin Bernard,0,0,0,0
1667933715295,CSE 234,A01,112904,Kumar; Arun Kumar,0,0,0,0
1667933715722,CSE 237A,A00,102383,Rosing; Tajana Simunic,0,0,0,0
1667933716148,CSE 239A,A00,102384,Deutsch; Alin Bernard,0,0,0,0
1667933716570,CSE 239B,A00,102385,Polikarpova; Nadezhda,0,0,0,0
1667933716991,CSE 240A,A00,102386,Pannuto; Patrick William,0,0,0,0
1667933717418,CSE 240B,A00,102387,Zhao; Jishen,0,0,0,0
1667933717850,CSE 241A,A00,106406,Kang; Mingu,0,0,0,0
1667933718274,CSE 249B,A00,102388,Kahng; Andrew Byun,0,0,8,8
1667933718701,CSE 251B,A01,102392,Cottrell; Garrison W,0,0,0,0
1667933718701,CSE 251B,A02,102393,Cottrell; Garrison W,0,0,0,0
1667933719127,CSE 252B,A00,102394,Ochoa; Benjamin Lawrence,0,0,0,0
1667933719552,CSE 257,A01,102396,Gao; Sicun,0,0,0,0
1667933719982,CSE 272,A00,102397,Li; Tzumao,0,0,0,0
1667933720417,CSE 274,A00,111323,Chern; Albert Ren-Haur,0,0,0,0
1667933720857,CSE 282,A00,102398,Pevzner; Pavel Arkadjevich,0,0,0,0
1667933721291,CSE 284,A00,114175,Gymrek; Melissa Ann,0,0,0,0
1667933721734,CSE 290,A00,102399,Chandraker; Manmohan Krishna,0,0,0,0
1667933721734,CSE 290,B00,102400,Vaccaro; Kristen Marie,0,0,25,25
1667933721734,CSE 290,C00,102414,Pannuto; Patrick William,1,0,25,24
1667933721734,CSE 290,D00,102427,Pevzner; Pavel Arkadjevich,0,0,0,0
1667933721734,CSE 290,E00,102429,Zhao; Jishen,0,0,0,0
1667933721734,CSE 290,F00,102436,Tullsen; Dean Michael,0,0,0,0
1667933721734,CSE 290,G00,102440,Christensen; Henrik I,0,0,20,20
1667933722159,CSE 291,A00,102443,Su; Hao,0,0,0,0
1667933722159,CSE 291,B00,102448,Polikarpova; Nadezhda,0,0,0,0
1667933722159,CSE 291,C00,102453,Vaccaro; Kristen Marie,0,0,0,0
1667933722159,CSE 291,D00,111343,Savage; Stefan,0,0,0,0
1667933722159,CSE 291,E00,116474,Claffy; Kimberly Claire,0,0,0,0
1667933722159,CSE 291,F00,116479,Pasquale; Joseph,0,0,0,0
1667933722626,CSE 293,001,119111,Bafna; Vineet,9999,0,9999,0
1667933722626,CSE 293,002,119118,Bellare; Mihir,9999,0,9999,0
1667933722626,CSE 293,003,119122,Berg-Kirkpatrick; Taylor D,9999,0,9999,0
1667933722626,CSE 293,004,119135,Christensen; Henrik I,9999,0,9999,0
1667933722626,CSE 293,005,119142,Cottrell; Garrison W,9999,0,9999,0
1667933722626,CSE 293,006,119146,Deutsch; Alin Bernard,9999,0,9999,0
1667933722626,CSE 293,007,119159,Esmaeilzadeh; Hadi,9999,0,9999,0
1667933722626,CSE 293,008,119166,Freund; Yoav,9999,0,9999,0
1667933722626,CSE 293,009,119170,Griswold; William G.,9999,0,9999,0
1667933722626,CSE 293,010,119183,Gymrek; Melissa Ann,9999,0,9999,0
1667933722626,CSE 293,011,119190,Heninger; Nadia A,9999,0,9999,0
1667933722626,CSE 293,012,119230,Impagliazzo; Russell,9999,0,9999,0
1667933722626,CSE 293,013,119232,Jhala; Ranjit,9999,0,9999,0
1667933722626,CSE 293,014,119233,Kahng; Andrew Byun,9999,0,9999,0
1667933722626,CSE 293,015,119298,Kane; Daniel Mertz,9999,0,9999,0
1667933722626,CSE 293,016,119299,Kriegman; David J,9999,0,9999,0
1667933722626,CSE 293,017,119300,Kumar; Arun Kumar,9999,0,9999,0
1667933722626,CSE 293,018,119301,Lerner; Sorin,9999,0,9999,0
1667933722626,CSE 293,019,119302,Lovett; Shachar,9999,0,9999,0
1667933722626,CSE 293,020,119303,McAuley; Julian John,9999,0,9999,0
1667933722626,CSE 293,021,119304,Micciancio; Daniele,9999,0,9999,0
1667933722626,CSE 293,022,119367,Orailoglu; Alex,9999,0,9999,0
1667933722626,CSE 293,023,119382,Paturi; Ramamohan,9999,0,9999,0
1667933722626,CSE 293,024,119404,Polikarpova; Nadezhda,9999,0,9999,0
1667933722626,CSE 293,025,119406,Politz; Joseph Gibbs,9999,0,9999,0
1667933722626,CSE 293,026,119411,Porter; George M,9999,0,9999,0
1667933722626,CSE 293,027,119414,Porter; Leonard Emerson,9999,0,9999,0
1667933722626,CSE 293,028,119416,Ramamoorthi; Ravi,9999,0,9999,0
1667933722626,CSE 293,029,119417,Sahoo; Debashis,9999,0,9999,0
1667933722626,CSE 293,030,119420,Saul; Lawrence,9999,0,9999,0
1667933722626,CSE 293,031,119421,Savage; Stefan,9999,0,9999,0
1667933722626,CSE 293,032,119425,Schulze; Jurgen P.,9999,0,9999,0
1667933722626,CSE 293,033,119426,Snoeren; Alex C.,9999,0,9999,0
1667933722626,CSE 293,034,119428,Shang; Jingbo,9999,0,9999,0
1667933722626,CSE 293,035,119430,Stefan; Deian,9999,0,9999,0
1667933722626,CSE 293,036,119431,Su; Hao,9999,0,9999,0
1667933722626,CSE 293,037,119433,Swanson; Steven James,9999,0,9999,0
1667933722626,CSE 293,038,119435,Tullsen; Dean Michael,9999,0,9999,0
1667933722626,CSE 293,039,119483,Voelker; Geoffrey M.,9999,0,9999,0
1667933722626,CSE 293,040,119537,Zhao; Jishen,9999,0,9999,0
1667933722626,CSE 293,041,119538,Zhou; Yuan-Yuan,9999,0,9999,0
1667933722626,CSE 293,042,119539,Gao; Sicun,9999,0,9999,0
1667933722626,CSE 293,043,119540,Weibel; Nadir,9999,0,9999,0
1667933722626,CSE 293,044,119541,Gupta; Rajesh K.,9999,0,9999,0
1667933723051,CSE 294,A00,102459,Voelker; Geoffrey M.,0,0,0,0
1667933723051,CSE 294,B00,111322,Orailoglu; Alex,0,0,0,0
1667933723482,DSE 201,A00,096914,Deutsch; Alin Bernard,30,0,30,0
1667933723922,DSE 210,A00,096915,Dasgupta; Sanjoy,30,0,30,0
1667933724346,DSE 260A,A00,096916,Altintas De Callaf; Ilkay,30,0,30,0
1667933724777,ECE 200,001,103586,Antipa; Nicholas A,9999,0,9999,0
1667933724777,ECE 200,002,103587,Atanasov; Nikolay A.,9999,0,9999,0
1667933724777,ECE 200,003,103588,Bharadia; Dinesh,9999,0,9999,0
1667933724777,ECE 200,004,103589,Cheng; Chung Kuan,9999,0,9999,0
1667933724777,ECE 200,005,103590,Cosman; Pamela C.,9999,0,9999,0
1667933724777,ECE 200,006,103591,Dayeh; Shadi Ahmad,9999,0,9999,0
1667933724777,ECE 200,007,103592,Fainman; Yeshaiahu,9999,0,9999,0
1667933724777,ECE 200,008,103593,Ford; Joseph Earl,9999,0,9999,0
1667933724777,ECE 200,009,103594,Franceschetti; Massimo,9999,0,9999,0
1667933724777,ECE 200,010,103595,Fullerton; Eric E,9999,0,9999,0
1667933724777,ECE 200,011,103596,Galton; Ian A,9999,0,9999,0
1667933724777,ECE 200,012,103597,Gilja; Vikash,9999,0,9999,0
1667933724777,ECE 200,013,103598,Hall; Drew A.,9999,0,9999,0
1667933724777,ECE 200,014,103599,Hsueh; Tzu-Chien,9999,0,9999,0
1667933724777,ECE 200,015,103600,Javidi; Tara,9999,0,9999,0
1667933724777,ECE 200,016,103601,Kahng; Andrew Byun,9999,0,9999,0
1667933724777,ECE 200,017,103602,Kim; Young-Han,9999,0,9999,0
1667933724777,ECE 200,018,103603,Koushanfar; Farinaz,9999,0,9999,0
1667933724777,ECE 200,019,103604,Kuzum; Duygu,9999,0,9999,0
1667933724777,ECE 200,020,103605,Le; Hanh-Phuc,9999,0,9999,0
1667933724777,ECE 200,021,103606,Lin; Bill,9999,0,9999,0
1667933724777,ECE 200,022,103607,Liu; Zhaowei,9998,0,9999,1
1667933724777,ECE 200,023,103608,Lo; Yu-Hwa,9999,0,9999,0
1667933724777,ECE 200,024,103609,Lomakin; Vitaliy,9999,0,9999,0
1667933724777,ECE 200,025,103610,Mercier; Patrick Philip,9999,0,9999,0
1667933724777,ECE 200,026,103611,Meyer; Florian,9999,0,9999,0
1667933724777,ECE 200,027,103612,Milstein; Laurence B.,9999,0,9999,0
1667933724777,ECE 200,028,103613,Mir Arabbaygi; Siavash,9999,0,9999,0
1667933724777,ECE 200,029,103614,Mookherjea; Shayan,9999,0,9999,0
1667933724777,ECE 200,030,103615,Morris; Karcher William,9999,0,9999,0
1667933724777,ECE 200,031,103616,Ng; Tse Nga,9999,0,9999,0
1667933724777,ECE 200,032,103617,Nguyen; Truong Quang,9999,0,9999,0
1667933724777,ECE 200,033,103618,Nomura; Kenji,9999,0,9999,0
1667933724777,ECE 200,034,103619,Orlitsky; Alon,9999,0,9999,0
1667933724777,ECE 200,035,103620,Pal; Piya,9999,0,9999,0
1667933724777,ECE 200,036,103621,Papen; George C.,9999,0,9999,0
1667933724777,ECE 200,037,103622,Radic; Stojan,9999,0,9999,0
1667933724777,ECE 200,038,103623,Rao; Bhaskar D.,9999,0,9999,0
1667933724777,ECE 200,039,103624,Rao; Ramesh R,9999,0,9999,0
1667933724777,ECE 200,040,103625,Rebeiz; Gabriel,9999,0,9999,0
1667933724777,ECE 200,041,103626,Sanford; John R,9999,0,9999,0
1667933724777,ECE 200,042,103627,Siegel; Paul H.,9999,0,9999,0
1667933724777,ECE 200,043,103628,Sievenpiper; Daniel F.,9999,0,9999,0
1667933724777,ECE 200,044,103629,Sworder; David D.,9999,0,9999,0
1667933724777,ECE 200,045,103630,Taur; Yuan,9999,0,9999,0
1667933724777,ECE 200,046,103631,Touri; Behrouz,9999,0,9999,0
1667933724777,ECE 200,047,103632,Trivedi; Mohan M.,9999,0,9999,0
1667933724777,ECE 200,048,103633,Vasconcelos; Nuno,9999,0,9999,0
1667933724777,ECE 200,049,103634,Wang; Xiaolong,9999,0,9999,0
1667933724777,ECE 200,050,103635,Xie; Pengtao,9999,0,9999,0
1667933724777,ECE 200,051,103636,Yip; Michael,9999,0,9999,0
1667933724777,ECE 200,052,103637,Zeger; Kenneth A.,999,0,999,0
1667933724777,ECE 200,053,103638,Zhang; Xinyu,9999,0,9999,0
1667933724777,ECE 200,054,103639,Turakhia; Yatish Girish,9999,0,9999,0
1667933724777,ECE 200,055,103640,Kang; Mingu,9999,0,9999,0
1667933724777,ECE 200,056,103641,Shi; Yuanyuan,9999,0,9999,0
1667933724777,ECE 200,057,103642,Wang; Edward Jay,9999,0,9999,0
1667933724777,ECE 200,058,103643,Zheng; Yang,9999,0,9999,0
1667933725212,ECE 202,A00,103644,Kuzum; Duygu,0,0,0,0
1667933725638,ECE 212BN,A00,103646,Ng; Tse Nga,0,0,0,0
1667933726068,ECE 221,A00,111493,Staff,0,0,0,0
1667933726506,ECE 222B,A00,103647,Lomakin; Vitaliy,0,0,0,0
1667933726929,ECE 230B,A00,103648,Taur; Yuan,0,0,0,0
1667933727352,ECE 238B,A00,103649,Garay; Javier,0,0,0,0
1667933727775,ECE 240B,A00,112900,Fainman; Yeshaiahu,0,0,0,0
1667933728198,ECE 247A,A00,103650,Jokerst; Jesse Vincent,0,0,0,0
1667933728638,ECE 247B,A00,103651,Wang; Joseph,0,0,0,0
1667933729067,ECE 250,A00,103652,Siegel; Paul H.,0,0,0,0
1667933729492,ECE 251A,A00,103654,Rao; Bhaskar D.,0,0,0,0
1667933729916,ECE 257B,A00,103655,Bharadia; Dinesh,0,0,0,0
1667933730351,ECE 258A,A00,103656,Milstein; Laurence B.,0,0,0,0
1667933730788,ECE 260B,A00,103658,Kang; Mingu,0,0,0,0
1667933731225,ECE 264A,A00,103659,Galton; Ian A,0,0,0,0
1667933731652,ECE 265A,A00,103661,Gudem; Prasad S.S.,0,0,0,0
1667933732082,ECE 265D,A00,103662,Gudem; Prasad S.S.,0,0,0,0
1667933732511,ECE 268,A00,103663,Koushanfar; Farinaz,0,0,0,0
1667933732941,ECE 269,A01,103665,Pal; Piya,0,0,0,0
1667933733373,ECE 271B,A00,103666,Vasconcelos; Manuela,0,0,0,0
1667933733815,ECE 276A,A00,103667,Atanasov; Nikolay A.,0,0,0,0
1667933734241,ECE 277,A00,103668,An; Cheolhong,0,0,0,0
1667933734674,ECE 279,A00,117947,Hall; Drew A.,0,0,0,0
1667933735543,ECE 283,A00,103670,Hsueh; Tzu-Chien,0,0,0,0
1667933735965,ECE 284,A00,103671,Turakhia; Yatish Girish,0,0,0,0
1667933736392,ECE 285,A00,103672,Zheng; Yang,0,0,0,0
1667933736392,ECE 285,B00,103673,Sworder; David D.,0,0,0,0
1667933736824,ECE 287,A00,103676,Javidi; Tara,0,0,0,0
1667933737247,MATH 200B,A00,098023,Salehi Golsefidy; Alireza,15,0,15,0
1667933737682,MATH 202B,A00,098024,Rhoades; Brendon Patrick,14,0,15,1
1667933738116,MATH 203B,A00,098025,Oprea; Dragos N.,14,0,15,1
1667933738543,MATH 204B,A00,098026,Sorensen; Claus M,15,0,15,0
1667933738972,MATH 208,A00,098027,Izadi; Elham,7,0,10,3
1667933739397,MATH 209,A00,098028,Pollack; Aaron,10,0,10,0
1667933739822,MATH 211A,A00,112919,Rogalski; Daniel,10,0,10,0
1667933740247,MATH 211B,A00,112920,Seward; Brandon M.,10,0,10,0
1667933740673,MATH 218,A00,098029,Li; Bo,10,0,10,0
1667933741096,MATH 220B,A00,098030,Novak; Jonathan I,15,0,15,0
1667933741523,MATH 221A,A00,098031,Ebenfelt; Peter F,14,0,15,1
1667933741949,MATH 231B,A00,098032,Zlatos; Andrej,15,0,15,0
1667933742382,MATH 240B,A00,098033,Ni; Lei,12,0,15,3
1667933742817,MATH 243,A00,098034,Jekel; David Andrew,10,0,10,0
1667933743250,MATH 245A,A00,098035,Nie; Jiawang,6,0,15,9
1667933743678,MATH 248,A00,098036,Bejenaru; Ioan,10,0,10,0
1667933744102,MATH 250B,A00,098037,Spolaor; Luca,14,0,15,1
1667933744530,MATH 258,A00,098038,Ni; Lei,10,0,10,0
1667933744952,MATH 264B,A00,098041,Rhoades; Brendon Patrick,13,0,15,2
1667933745378,MATH 268,A00,098042,Buss; Samuel R,10,0,10,0
1667933745803,MATH 269,A00,098043,Rhoades; Brendon Patrick,10,0,10,0
1667933746234,MATH 270B,A00,098044,Li; Bo,12,0,15,3
1667933746664,MATH 272B,A00,098045,Holst; Michael J,13,0,15,2
1667933747098,MATH 273A,A00,098046,Tian; Xiaochuan,12,0,15,3
1667933747522,MATH 275,A01,098048,Tian; Xiaochuan,6,0,10,4
1667933747956,MATH 278A,A00,098049,Holst; Michael J,8,0,10,2
1667933748390,MATH 278B,A00,098050,Cloninger; Alexander,10,0,10,0
1667933748831,MATH 278C,A00,098051,Nie; Jiawang,9,0,10,1
1667933749419,MATH 280B,A00,098052,Zheng; Tianyi,12,0,15,3
1667933749960,MATH 281B,A00,098053,Bradic; Jelena,4,0,15,11
1667933750396,MATH 282B,A00,098054,Arias-Castro; Ery,2,0,15,13
1667933750819,MATH 285,A00,098055,Fitzsimmons; Patrick J,2,0,15,13
1667933751245,MATH 287B,A00,098056,Arias-Castro; Ery,9,0,15,6
1667933751680,MATH 288,A00,098057,Agarwal; Pooja,9,0,10,1
1667933751680,MATH 288,B00,098058,Zhang; Danna,9,0,10,1
1667933751680,MATH 288,C00,098059,Williams; Ruth J,10,0,10,0
1667933752109,MATH 290B,A00,098060,Roberts; Justin Deritter,14,0,15,1
1667933752540,MATH 292,A00,098061,Belmont; Eva Kinoshita,10,0,10,0
1667933752974,MATH 295,A00,098062,Suk; Andrew Hoon,48,0,50,2
1667933753403,MATH 296,A00,098063,Novak; Jonathan I,20,0,20,0
1667933753829,MATH 297,001,098064,Gamst; Anthony Collins,9997,0,9999,2
1667934267904,COGS 205,A00,101395,Chiba; Andrea,19,0,20,1
1667934268338,COGS 210B,001,101404,Greene; Deanna Jacquelyn,9998,0,9999,1
1667934268338,COGS 210B,002,101417,Xia; Haijun,9999,0,9999,0
1667934268338,COGS 210B,003,101422,Nitz; Douglas A.,9999,0,9999,0
1667934268338,COGS 210B,004,101423,Hollan; James D.,9998,0,9999,1
1667934268338,COGS 210B,005,101424,Deak; Gedeon O.,9999,0,9999,0
1667934268338,COGS 210B,006,101425,Rossano; Federico,9999,0,9999,0
1667934268764,COGS 211B,A00,101427,Coulson; Seana M,9997,0,9999,2
1667934269187,COGS 220,A00,101428,Hollan; James D.,0,0,25,25
1667934269609,COGS 229,A00,101429,Dow; Steven P,19,0,25,6
1667934270032,COGS 230,A00,101430,Klemmer; Scott R,13,0,17,4
1667934270457,COGS 234,A00,101431,Xia; Haijun,10,0,25,15
1667934270880,COGS 260,A00,101432,Kiyonaga; Anastasia,19,0,25,6
1667934270880,COGS 260,B00,101433,Kirsh; David Joel,17,0,25,8
1667934271305,CSE 202,A00,102371,Impagliazzo; Russell,0,0,0,0
1667934271732,CSE 203B,A01,102373,Cheng; Chung Kuan,0,0,0,0
1667934272175,CSE 208,A00,102374,Micciancio; Daniele,0,0,0,0
1667934272601,CSE 209A,A00,112895,Impagliazzo; Russell,0,0,15,15
1667934273032,CSE 209B,A00,108005,Bellare; Mihir,0,0,0,0
1667934273461,CSE 210,A00,113163,Coblenz; Michael J,0,0,0,0
1667934273892,CSE 219,A00,106111,Dow; Steven P,0,0,20,20
1667934274316,CSE 221,A00,102376,Voelker; Geoffrey M.,0,0,0,0
1667934274741,CSE 224,A01,102378,Porter; George M,0,0,0,0
1667934275165,CSE 229A,A00,102379,Savage; Stefan,0,0,0,0
1667934275589,CSE 229C,A00,102380,Munyaka; Imani N. S.,0,0,0,0
1667934276019,CSE 232B,A00,102382,Deutsch; Alin Bernard,0,0,0,0
1667934276443,CSE 234,A01,112904,Kumar; Arun Kumar,0,0,0,0
1667934276875,CSE 237A,A00,102383,Rosing; Tajana Simunic,0,0,0,0
1667934277305,CSE 239A,A00,102384,Deutsch; Alin Bernard,0,0,0,0
1667934277734,CSE 239B,A00,102385,Polikarpova; Nadezhda,0,0,0,0
1667934278164,CSE 240A,A00,102386,Pannuto; Patrick William,0,0,0,0
1667934278585,CSE 240B,A00,102387,Zhao; Jishen,0,0,0,0
1667934279011,CSE 241A,A00,106406,Kang; Mingu,0,0,0,0
1667934279434,CSE 249B,A00,102388,Kahng; Andrew Byun,0,0,8,8
1667934279860,CSE 251B,A01,102392,Cottrell; Garrison W,0,0,0,0
1667934279860,CSE 251B,A02,102393,Cottrell; Garrison W,0,0,0,0
1667934280287,CSE 252B,A00,102394,Ochoa; Benjamin Lawrence,0,0,0,0
1667934280710,CSE 257,A01,102396,Gao; Sicun,0,0,0,0
1667934281136,CSE 272,A00,102397,Li; Tzumao,0,0,0,0
1667934281559,CSE 274,A00,111323,Chern; Albert Ren-Haur,0,0,0,0
1667934281982,CSE 282,A00,102398,Pevzner; Pavel Arkadjevich,0,0,0,0
1667934282412,CSE 284,A00,114175,Gymrek; Melissa Ann,0,0,0,0
1667934282843,CSE 290,A00,102399,Chandraker; Manmohan Krishna,0,0,0,0
1667934282843,CSE 290,B00,102400,Vaccaro; Kristen Marie,0,0,25,25
1667934282843,CSE 290,C00,102414,Pannuto; Patrick William,1,0,25,24
1667934282843,CSE 290,D00,102427,Pevzner; Pavel Arkadjevich,0,0,0,0
1667934282843,CSE 290,E00,102429,Zhao; Jishen,0,0,0,0
1667934282843,CSE 290,F00,102436,Tullsen; Dean Michael,0,0,0,0
1667934282843,CSE 290,G00,102440,Christensen; Henrik I,0,0,20,20
1667934283284,CSE 291,A00,102443,Su; Hao,0,0,0,0
1667934283284,CSE 291,B00,102448,Polikarpova; Nadezhda,0,0,0,0
1667934283284,CSE 291,C00,102453,Vaccaro; Kristen Marie,0,0,0,0
1667934283284,CSE 291,D00,111343,Savage; Stefan,0,0,0,0
1667934283284,CSE 291,E00,116474,Claffy; Kimberly Claire,0,0,0,0
1667934283284,CSE 291,F00,116479,Pasquale; Joseph,0,0,0,0
1667934283715,CSE 293,001,119111,Bafna; Vineet,9999,0,9999,0
1667934283715,CSE 293,002,119118,Bellare; Mihir,9999,0,9999,0
1667934283715,CSE 293,003,119122,Berg-Kirkpatrick; Taylor D,9999,0,9999,0
1667934283715,CSE 293,004,119135,Christensen; Henrik I,9999,0,9999,0
1667934283715,CSE 293,005,119142,Cottrell; Garrison W,9999,0,9999,0
1667934283715,CSE 293,006,119146,Deutsch; Alin Bernard,9999,0,9999,0
1667934283715,CSE 293,007,119159,Esmaeilzadeh; Hadi,9999,0,9999,0
1667934283715,CSE 293,008,119166,Freund; Yoav,9999,0,9999,0
1667934283715,CSE 293,009,119170,Griswold; William G.,9999,0,9999,0
1667934283715,CSE 293,010,119183,Gymrek; Melissa Ann,9999,0,9999,0
1667934283715,CSE 293,011,119190,Heninger; Nadia A,9999,0,9999,0
1667934283715,CSE 293,012,119230,Impagliazzo; Russell,9999,0,9999,0
1667934283715,CSE 293,013,119232,Jhala; Ranjit,9999,0,9999,0
1667934283715,CSE 293,014,119233,Kahng; Andrew Byun,9999,0,9999,0
1667934283715,CSE 293,015,119298,Kane; Daniel Mertz,9999,0,9999,0
1667934283715,CSE 293,016,119299,Kriegman; David J,9999,0,9999,0
1667934283715,CSE 293,017,119300,Kumar; Arun Kumar,9999,0,9999,0
1667934283715,CSE 293,018,119301,Lerner; Sorin,9999,0,9999,0
1667934283715,CSE 293,019,119302,Lovett; Shachar,9999,0,9999,0
1667934283715,CSE 293,020,119303,McAuley; Julian John,9999,0,9999,0
1667934283715,CSE 293,021,119304,Micciancio; Daniele,9999,0,9999,0
1667934283715,CSE 293,022,119367,Orailoglu; Alex,9999,0,9999,0
1667934283715,CSE 293,023,119382,Paturi; Ramamohan,9999,0,9999,0
1667934283715,CSE 293,024,119404,Polikarpova; Nadezhda,9999,0,9999,0
1667934283715,CSE 293,025,119406,Politz; Joseph Gibbs,9999,0,9999,0
1667934283715,CSE 293,026,119411,Porter; George M,9999,0,9999,0
1667934283715,CSE 293,027,119414,Porter; Leonard Emerson,9999,0,9999,0
1667934283715,CSE 293,028,119416,Ramamoorthi; Ravi,9999,0,9999,0
1667934283715,CSE 293,029,119417,Sahoo; Debashis,9999,0,9999,0
1667934283715,CSE 293,030,119420,Saul; Lawrence,9999,0,9999,0
1667934283715,CSE 293,031,119421,Savage; Stefan,9999,0,9999,0
1667934283715,CSE 293,032,119425,Schulze; Jurgen P.,9999,0,9999,0
1667934283715,CSE 293,033,119426,Snoeren; Alex C.,9999,0,9999,0
1667934283715,CSE 293,034,119428,Shang; Jingbo,9999,0,9999,0
1667934283715,CSE 293,035,119430,Stefan; Deian,9999,0,9999,0
1667934283715,CSE 293,036,119431,Su; Hao,9999,0,9999,0
1667934283715,CSE 293,037,119433,Swanson; Steven James,9999,0,9999,0
1667934283715,CSE 293,038,119435,Tullsen; Dean Michael,9999,0,9999,0
1667934283715,CSE 293,039,119483,Voelker; Geoffrey M.,9999,0,9999,0
1667934283715,CSE 293,040,119537,Zhao; Jishen,9999,0,9999,0
1667934283715,CSE 293,041,119538,Zhou; Yuan-Yuan,9999,0,9999,0
1667934283715,CSE 293,042,119539,Gao; Sicun,9999,0,9999,0
1667934283715,CSE 293,043,119540,Weibel; Nadir,9999,0,9999,0
1667934283715,CSE 293,044,119541,Gupta; Rajesh K.,9999,0,9999,0
1667934284237,CSE 294,A00,102459,Voelker; Geoffrey M.,0,0,0,0
1667934284237,CSE 294,B00,111322,Orailoglu; Alex,0,0,0,0
1667934284662,DSE 201,A00,096914,Deutsch; Alin Bernard,30,0,30,0
1667934285085,DSE 210,A00,096915,Dasgupta; Sanjoy,30,0,30,0
1667934285511,DSE 260A,A00,096916,Altintas De Callaf; Ilkay,30,0,30,0
1667934285952,ECE 200,001,103586,Antipa; Nicholas A,9999,0,9999,0
1667934285952,ECE 200,002,103587,Atanasov; Nikolay A.,9999,0,9999,0
1667934285952,ECE 200,003,103588,Bharadia; Dinesh,9999,0,9999,0
1667934285952,ECE 200,004,103589,Cheng; Chung Kuan,9999,0,9999,0
1667934285952,ECE 200,005,103590,Cosman; Pamela C.,9999,0,9999,0
1667934285952,ECE 200,006,103591,Dayeh; Shadi Ahmad,9999,0,9999,0
1667934285952,ECE 200,007,103592,Fainman; Yeshaiahu,9999,0,9999,0
1667934285952,ECE 200,008,103593,Ford; Joseph Earl,9999,0,9999,0
1667934285952,ECE 200,009,103594,Franceschetti; Massimo,9999,0,9999,0
1667934285952,ECE 200,010,103595,Fullerton; Eric E,9999,0,9999,0
1667934285952,ECE 200,011,103596,Galton; Ian A,9999,0,9999,0
1667934285952,ECE 200,012,103597,Gilja; Vikash,9999,0,9999,0
1667934285952,ECE 200,013,103598,Hall; Drew A.,9999,0,9999,0
1667934285952,ECE 200,014,103599,Hsueh; Tzu-Chien,9999,0,9999,0
1667934285952,ECE 200,015,103600,Javidi; Tara,9999,0,9999,0
1667934285952,ECE 200,016,103601,Kahng; Andrew Byun,9999,0,9999,0
1667934285952,ECE 200,017,103602,Kim; Young-Han,9999,0,9999,0
1667934285952,ECE 200,018,103603,Koushanfar; Farinaz,9999,0,9999,0
1667934285952,ECE 200,019,103604,Kuzum; Duygu,9999,0,9999,0
1667934285952,ECE 200,020,103605,Le; Hanh-Phuc,9999,0,9999,0
1667934285952,ECE 200,021,103606,Lin; Bill,9999,0,9999,0
1667934285952,ECE 200,022,103607,Liu; Zhaowei,9998,0,9999,1
1667934285952,ECE 200,023,103608,Lo; Yu-Hwa,9999,0,9999,0
1667934285952,ECE 200,024,103609,Lomakin; Vitaliy,9999,0,9999,0
1667934285952,ECE 200,025,103610,Mercier; Patrick Philip,9999,0,9999,0
1667934285952,ECE 200,026,103611,Meyer; Florian,9999,0,9999,0
1667934285952,ECE 200,027,103612,Milstein; Laurence B.,9999,0,9999,0
1667934285952,ECE 200,028,103613,Mir Arabbaygi; Siavash,9999,0,9999,0
1667934285952,ECE 200,029,103614,Mookherjea; Shayan,9999,0,9999,0
1667934285952,ECE 200,030,103615,Morris; Karcher William,9999,0,9999,0
1667934285952,ECE 200,031,103616,Ng; Tse Nga,9999,0,9999,0
1667934285952,ECE 200,032,103617,Nguyen; Truong Quang,9999,0,9999,0
1667934285952,ECE 200,033,103618,Nomura; Kenji,9999,0,9999,0
1667934285952,ECE 200,034,103619,Orlitsky; Alon,9999,0,9999,0
1667934285952,ECE 200,035,103620,Pal; Piya,9999,0,9999,0
1667934285952,ECE 200,036,103621,Papen; George C.,9999,0,9999,0
1667934285952,ECE 200,037,103622,Radic; Stojan,9999,0,9999,0
1667934285952,ECE 200,038,103623,Rao; Bhaskar D.,9999,0,9999,0
1667934285952,ECE 200,039,103624,Rao; Ramesh R,9999,0,9999,0
1667934285952,ECE 200,040,103625,Rebeiz; Gabriel,9999,0,9999,0
1667934285952,ECE 200,041,103626,Sanford; John R,9999,0,9999,0
1667934285952,ECE 200,042,103627,Siegel; Paul H.,9999,0,9999,0
1667934285952,ECE 200,043,103628,Sievenpiper; Daniel F.,9999,0,9999,0
1667934285952,ECE 200,044,103629,Sworder; David D.,9999,0,9999,0
1667934285952,ECE 200,045,103630,Taur; Yuan,9999,0,9999,0
1667934285952,ECE 200,046,103631,Touri; Behrouz,9999,0,9999,0
1667934285952,ECE 200,047,103632,Trivedi; Mohan M.,9999,0,9999,0
1667934285952,ECE 200,048,103633,Vasconcelos; Nuno,9999,0,9999,0
1667934285952,ECE 200,049,103634,Wang; Xiaolong,9999,0,9999,0
1667934285952,ECE 200,050,103635,Xie; Pengtao,9999,0,9999,0
1667934285952,ECE 200,051,103636,Yip; Michael,9999,0,9999,0
1667934285952,ECE 200,052,103637,Zeger; Kenneth A.,999,0,999,0
1667934285952,ECE 200,053,103638,Zhang; Xinyu,9999,0,9999,0
1667934285952,ECE 200,054,103639,Turakhia; Yatish Girish,9999,0,9999,0
1667934285952,ECE 200,055,103640,Kang; Mingu,9999,0,9999,0
1667934285952,ECE 200,056,103641,Shi; Yuanyuan,9999,0,9999,0
1667934285952,ECE 200,057,103642,Wang; Edward Jay,9999,0,9999,0
1667934285952,ECE 200,058,103643,Zheng; Yang,9999,0,9999,0
1667934286377,ECE 202,A00,103644,Kuzum; Duygu,0,0,0,0
1667934286799,ECE 212BN,A00,103646,Ng; Tse Nga,0,0,0,0
1667934287223,ECE 221,A00,111493,Staff,0,0,0,0
1667934287647,ECE 222B,A00,103647,Lomakin; Vitaliy,0,0,0,0
1667934288082,ECE 230B,A00,103648,Taur; Yuan,0,0,0,0
1667934288556,ECE 238B,A00,103649,Garay; Javier,0,0,0,0
1667934289003,ECE 240B,A00,112900,Fainman; Yeshaiahu,0,0,0,0
1667934289430,ECE 247A,A00,103650,Jokerst; Jesse Vincent,0,0,0,0
1667934289859,ECE 247B,A00,103651,Wang; Joseph,0,0,0,0
1667934290286,ECE 250,A00,103652,Siegel; Paul H.,0,0,0,0
1667934290713,ECE 251A,A00,103654,Rao; Bhaskar D.,0,0,0,0
1667934291137,ECE 257B,A00,103655,Bharadia; Dinesh,0,0,0,0
1667934291564,ECE 258A,A00,103656,Milstein; Laurence B.,0,0,0,0
1667934291990,ECE 260B,A00,103658,Kang; Mingu,0,0,0,0
1667934292414,ECE 264A,A00,103659,Galton; Ian A,0,0,0,0
1667934292840,ECE 265A,A00,103661,Gudem; Prasad S.S.,0,0,0,0
1667934293264,ECE 265D,A00,103662,Gudem; Prasad S.S.,0,0,0,0
1667934293690,ECE 268,A00,103663,Koushanfar; Farinaz,0,0,0,0
1667934294171,ECE 269,A01,103665,Pal; Piya,0,0,0,0
1667934294601,ECE 271B,A00,103666,Vasconcelos; Manuela,0,0,0,0
1667934295030,ECE 276A,A00,103667,Atanasov; Nikolay A.,0,0,0,0
1667934295453,ECE 277,A00,103668,An; Cheolhong,0,0,0,0
1667934295885,ECE 279,A00,117947,Hall; Drew A.,0,0,0,0
1667934296743,ECE 283,A00,103670,Hsueh; Tzu-Chien,0,0,0,0
1667934297167,ECE 284,A00,103671,Turakhia; Yatish Girish,0,0,0,0
1667934297593,ECE 285,A00,103672,Zheng; Yang,0,0,0,0
1667934297593,ECE 285,B00,103673,Sworder; David D.,0,0,0,0
1667934298027,ECE 287,A00,103676,Javidi; Tara,0,0,0,0
1667934298449,MATH 200B,A00,098023,Salehi Golsefidy; Alireza,15,0,15,0
1667934298878,MATH 202B,A00,098024,Rhoades; Brendon Patrick,13,0,15,2
1667934299307,MATH 203B,A00,098025,Oprea; Dragos N.,14,0,15,1
1667934299729,MATH 204B,A00,098026,Sorensen; Claus M,15,0,15,0
1667934300160,MATH 208,A00,098027,Izadi; Elham,7,0,10,3
1667934300586,MATH 209,A00,098028,Pollack; Aaron,10,0,10,0
1667934301011,MATH 211A,A00,112919,Rogalski; Daniel,10,0,10,0
1667934301441,MATH 211B,A00,112920,Seward; Brandon M.,10,0,10,0
1667934301864,MATH 218,A00,098029,Li; Bo,10,0,10,0
1667934302297,MATH 220B,A00,098030,Novak; Jonathan I,15,0,15,0
1667934302725,MATH 221A,A00,098031,Ebenfelt; Peter F,14,0,15,1
1667934303154,MATH 231B,A00,098032,Zlatos; Andrej,15,0,15,0
1667934303589,MATH 240B,A00,098033,Ni; Lei,11,0,15,4
1667934304020,MATH 243,A00,098034,Jekel; David Andrew,10,0,10,0
1667934304454,MATH 245A,A00,098035,Nie; Jiawang,5,0,15,10
1667934304887,MATH 248,A00,098036,Bejenaru; Ioan,10,0,10,0
1667934305311,MATH 250B,A00,098037,Spolaor; Luca,14,0,15,1
1667934305737,MATH 258,A00,098038,Ni; Lei,10,0,10,0
1667934306163,MATH 264B,A00,098041,Rhoades; Brendon Patrick,13,0,15,2
1667934306590,MATH 268,A00,098042,Buss; Samuel R,10,0,10,0
1667934307022,MATH 269,A00,098043,Rhoades; Brendon Patrick,10,0,10,0
1667934307451,MATH 270B,A00,098044,Li; Bo,11,0,15,4
1667934307881,MATH 272B,A00,098045,Holst; Michael J,13,0,15,2
1667934308306,MATH 273A,A00,098046,Tian; Xiaochuan,12,0,15,3
1667934308729,MATH 275,A01,098048,Tian; Xiaochuan,6,0,10,4
1667934309152,MATH 278A,A00,098049,Holst; Michael J,8,0,10,2
1667934309582,MATH 278B,A00,098050,Cloninger; Alexander,10,0,10,0
1667934310013,MATH 278C,A00,098051,Nie; Jiawang,8,0,10,2
1667934310439,MATH 280B,A00,098052,Zheng; Tianyi,12,0,15,3
1667934310867,MATH 281B,A00,098053,Bradic; Jelena,4,0,15,11
1667934311302,MATH 282B,A00,098054,Arias-Castro; Ery,2,0,15,13
1667934311732,MATH 285,A00,098055,Fitzsimmons; Patrick J,2,0,15,13
1667934312164,MATH 287B,A00,098056,Arias-Castro; Ery,9,0,15,6
1667934312592,MATH 288,A00,098057,Agarwal; Pooja,9,0,10,1
1667934312592,MATH 288,B00,098058,Zhang; Danna,9,0,10,1
1667934312592,MATH 288,C00,098059,Williams; Ruth J,10,0,10,0
1667934313019,MATH 290B,A00,098060,Roberts; Justin Deritter,14,0,15,1
1667934313466,MATH 292,A00,098061,Belmont; Eva Kinoshita,10,0,10,0
1667934313898,MATH 295,A00,098062,Suk; Andrew Hoon,48,0,50,2
1667934314339,MATH 296,A00,098063,Novak; Jonathan I,20,0,20,0
1667934314763,MATH 297,001,098064,Gamst; Anthony Collins,9997,0,9999,2
1667934817964,COGS 205,A00,101395,Chiba; Andrea,19,0,20,1
1667934818394,COGS 210B,001,101404,Greene; Deanna Jacquelyn,9998,0,9999,1
1667934818394,COGS 210B,002,101417,Xia; Haijun,9999,0,9999,0
1667934818394,COGS 210B,003,101422,Nitz; Douglas A.,9999,0,9999,0
1667934818394,COGS 210B,004,101423,Hollan; James D.,9998,0,9999,1
1667934818394,COGS 210B,005,101424,Deak; Gedeon O.,9999,0,9999,0
1667934818394,COGS 210B,006,101425,Rossano; Federico,9999,0,9999,0
1667934818823,COGS 211B,A00,101427,Coulson; Seana M,9997,0,9999,2
1667934819250,COGS 220,A00,101428,Hollan; James D.,0,0,25,25
1667934819672,COGS 229,A00,101429,Dow; Steven P,19,0,25,6
1667934820101,COGS 230,A00,101430,Klemmer; Scott R,13,0,17,4
1667934820525,COGS 234,A00,101431,Xia; Haijun,10,0,25,15
1667934820948,COGS 260,A00,101432,Kiyonaga; Anastasia,19,0,25,6
1667934820948,COGS 260,B00,101433,Kirsh; David Joel,17,0,25,8
1667934821373,CSE 202,A00,102371,Impagliazzo; Russell,0,0,0,0
1667934821810,CSE 203B,A01,102373,Cheng; Chung Kuan,0,0,0,0
1667934822251,CSE 208,A00,102374,Micciancio; Daniele,0,0,0,0
1667934822682,CSE 209A,A00,112895,Impagliazzo; Russell,0,0,15,15
1667934823107,CSE 209B,A00,108005,Bellare; Mihir,0,0,0,0
1667934823529,CSE 210,A00,113163,Coblenz; Michael J,0,0,0,0
1667934823950,CSE 219,A00,106111,Dow; Steven P,0,0,20,20
1667934824375,CSE 221,A00,102376,Voelker; Geoffrey M.,0,0,0,0
1667934824816,CSE 224,A01,102378,Porter; George M,0,0,0,0
1667934825246,CSE 229A,A00,102379,Savage; Stefan,0,0,0,0
1667934825666,CSE 229C,A00,102380,Munyaka; Imani N. S.,0,0,0,0
1667934826093,CSE 232B,A00,102382,Deutsch; Alin Bernard,0,0,0,0
1667934826517,CSE 234,A01,112904,Kumar; Arun Kumar,0,0,0,0
1667934826944,CSE 237A,A00,102383,Rosing; Tajana Simunic,0,0,0,0
1667934827369,CSE 239A,A00,102384,Deutsch; Alin Bernard,0,0,0,0
1667934827793,CSE 239B,A00,102385,Polikarpova; Nadezhda,0,0,0,0
1667934828217,CSE 240A,A00,102386,Pannuto; Patrick William,0,0,0,0
1667934828657,CSE 240B,A00,102387,Zhao; Jishen,0,0,0,0
1667934829089,CSE 241A,A00,106406,Kang; Mingu,0,0,0,0
1667934829516,CSE 249B,A00,102388,Kahng; Andrew Byun,0,0,8,8
1667934829947,CSE 251B,A01,102392,Cottrell; Garrison W,0,0,0,0
1667934829947,CSE 251B,A02,102393,Cottrell; Garrison W,0,0,0,0
1667934830370,CSE 252B,A00,102394,Ochoa; Benjamin Lawrence,0,0,0,0
1667934830796,CSE 257,A01,102396,Gao; Sicun,0,0,0,0
1667934831218,CSE 272,A00,102397,Li; Tzumao,0,0,0,0
1667934831652,CSE 274,A00,111323,Chern; Albert Ren-Haur,0,0,0,0
1667934832083,CSE 282,A00,102398,Pevzner; Pavel Arkadjevich,0,0,0,0
1667934832517,CSE 284,A00,114175,Gymrek; Melissa Ann,0,0,0,0
1667934832939,CSE 290,A00,102399,Chandraker; Manmohan Krishna,0,0,0,0
1667934832939,CSE 290,B00,102400,Vaccaro; Kristen Marie,0,0,25,25
1667934832939,CSE 290,C00,102414,Pannuto; Patrick William,1,0,25,24
1667934832939,CSE 290,D00,102427,Pevzner; Pavel Arkadjevich,0,0,0,0
1667934832939,CSE 290,E00,102429,Zhao; Jishen,0,0,0,0
1667934832939,CSE 290,F00,102436,Tullsen; Dean Michael,0,0,0,0
1667934832939,CSE 290,G00,102440,Christensen; Henrik I,0,0,20,20
1667934833375,CSE 291,A00,102443,Su; Hao,0,0,0,0
1667934833375,CSE 291,B00,102448,Polikarpova; Nadezhda,0,0,0,0
1667934833375,CSE 291,C00,102453,Vaccaro; Kristen Marie,0,0,0,0
1667934833375,CSE 291,D00,111343,Savage; Stefan,0,0,0,0
1667934833375,CSE 291,E00,116474,Claffy; Kimberly Claire,0,0,0,0
1667934833375,CSE 291,F00,116479,Pasquale; Joseph,0,0,0,0
1667934833810,CSE 293,001,119111,Bafna; Vineet,9999,0,9999,0
1667934833810,CSE 293,002,119118,Bellare; Mihir,9999,0,9999,0
1667934833810,CSE 293,003,119122,Berg-Kirkpatrick; Taylor D,9999,0,9999,0
1667934833810,CSE 293,004,119135,Christensen; Henrik I,9999,0,9999,0
1667934833810,CSE 293,005,119142,Cottrell; Garrison W,9999,0,9999,0
1667934833810,CSE 293,006,119146,Deutsch; Alin Bernard,9999,0,9999,0
1667934833810,CSE 293,007,119159,Esmaeilzadeh; Hadi,9999,0,9999,0
1667934833810,CSE 293,008,119166,Freund; Yoav,9999,0,9999,0
1667934833810,CSE 293,009,119170,Griswold; William G.,9999,0,9999,0
1667934833810,CSE 293,010,119183,Gymrek; Melissa Ann,9999,0,9999,0
1667934833810,CSE 293,011,119190,Heninger; Nadia A,9999,0,9999,0
1667934833810,CSE 293,012,119230,Impagliazzo; Russell,9999,0,9999,0
1667934833810,CSE 293,013,119232,Jhala; Ranjit,9999,0,9999,0
1667934833810,CSE 293,014,119233,Kahng; Andrew Byun,9999,0,9999,0
1667934833810,CSE 293,015,119298,Kane; Daniel Mertz,9999,0,9999,0
1667934833810,CSE 293,016,119299,Kriegman; David J,9999,0,9999,0
1667934833810,CSE 293,017,119300,Kumar; Arun Kumar,9999,0,9999,0
1667934833810,CSE 293,018,119301,Lerner; Sorin,9999,0,9999,0
1667934833810,CSE 293,019,119302,Lovett; Shachar,9999,0,9999,0
1667934833810,CSE 293,020,119303,McAuley; Julian John,9999,0,9999,0
1667934833810,CSE 293,021,119304,Micciancio; Daniele,9999,0,9999,0
1667934833810,CSE 293,022,119367,Orailoglu; Alex,9999,0,9999,0
1667934833810,CSE 293,023,119382,Paturi; Ramamohan,9999,0,9999,0
1667934833810,CSE 293,024,119404,Polikarpova; Nadezhda,9999,0,9999,0
1667934833810,CSE 293,025,119406,Politz; Joseph Gibbs,9999,0,9999,0
1667934833810,CSE 293,026,119411,Porter; George M,9999,0,9999,0
1667934833810,CSE 293,027,119414,Porter; Leonard Emerson,9999,0,9999,0
1667934833810,CSE 293,028,119416,Ramamoorthi; Ravi,9999,0,9999,0
1667934833810,CSE 293,029,119417,Sahoo; Debashis,9999,0,9999,0
1667934833810,CSE 293,030,119420,Saul; Lawrence,9999,0,9999,0
1667934833810,CSE 293,031,119421,Savage; Stefan,9999,0,9999,0
1667934833810,CSE 293,032,119425,Schulze; Jurgen P.,9999,0,9999,0
1667934833810,CSE 293,033,119426,Snoeren; Alex C.,9999,0,9999,0
1667934833810,CSE 293,034,119428,Shang; Jingbo,9999,0,9999,0
1667934833810,CSE 293,035,119430,Stefan; Deian,9999,0,9999,0
1667934833810,CSE 293,036,119431,Su; Hao,9999,0,9999,0
1667934833810,CSE 293,037,119433,Swanson; Steven James,9999,0,9999,0
1667934833810,CSE 293,038,119435,Tullsen; Dean Michael,9999,0,9999,0
1667934833810,CSE 293,039,119483,Voelker; Geoffrey M.,9999,0,9999,0
1667934833810,CSE 293,040,119537,Zhao; Jishen,9999,0,9999,0
1667934833810,CSE 293,041,119538,Zhou; Yuan-Yuan,9999,0,9999,0
1667934833810,CSE 293,042,119539,Gao; Sicun,9999,0,9999,0
1667934833810,CSE 293,043,119540,Weibel; Nadir,9999,0,9999,0
1667934833810,CSE 293,044,119541,Gupta; Rajesh K.,9999,0,9999,0
1667934834234,CSE 294,A00,102459,Voelker; Geoffrey M.,0,0,0,0
1667934834234,CSE 294,B00,111322,Orailoglu; Alex,0,0,0,0
1667934834656,DSE 201,A00,096914,Deutsch; Alin Bernard,30,0,30,0
1667934835079,DSE 210,A00,096915,Dasgupta; Sanjoy,30,0,30,0
1667934835511,DSE 260A,A00,096916,Altintas De Callaf; Ilkay,30,0,30,0
1667934835940,ECE 200,001,103586,Antipa; Nicholas A,9999,0,9999,0
1667934835940,ECE 200,002,103587,Atanasov; Nikolay A.,9999,0,9999,0
1667934835940,ECE 200,003,103588,Bharadia; Dinesh,9999,0,9999,0
1667934835940,ECE 200,004,103589,Cheng; Chung Kuan,9999,0,9999,0
1667934835940,ECE 200,005,103590,Cosman; Pamela C.,9999,0,9999,0
1667934835940,ECE 200,006,103591,Dayeh; Shadi Ahmad,9999,0,9999,0
1667934835940,ECE 200,007,103592,Fainman; Yeshaiahu,9999,0,9999,0
1667934835940,ECE 200,008,103593,Ford; Joseph Earl,9999,0,9999,0
1667934835940,ECE 200,009,103594,Franceschetti; Massimo,9999,0,9999,0
1667934835940,ECE 200,010,103595,Fullerton; Eric E,9999,0,9999,0
1667934835940,ECE 200,011,103596,Galton; Ian A,9999,0,9999,0
1667934835940,ECE 200,012,103597,Gilja; Vikash,9999,0,9999,0
1667934835940,ECE 200,013,103598,Hall; Drew A.,9999,0,9999,0
1667934835940,ECE 200,014,103599,Hsueh; Tzu-Chien,9999,0,9999,0
1667934835940,ECE 200,015,103600,Javidi; Tara,9999,0,9999,0
1667934835940,ECE 200,016,103601,Kahng; Andrew Byun,9999,0,9999,0
1667934835940,ECE 200,017,103602,Kim; Young-Han,9999,0,9999,0
1667934835940,ECE 200,018,103603,Koushanfar; Farinaz,9999,0,9999,0
1667934835940,ECE 200,019,103604,Kuzum; Duygu,9999,0,9999,0
1667934835940,ECE 200,020,103605,Le; Hanh-Phuc,9999,0,9999,0
1667934835940,ECE 200,021,103606,Lin; Bill,9999,0,9999,0
1667934835940,ECE 200,022,103607,Liu; Zhaowei,9998,0,9999,1
1667934835940,ECE 200,023,103608,Lo; Yu-Hwa,9999,0,9999,0
1667934835940,ECE 200,024,103609,Lomakin; Vitaliy,9999,0,9999,0
1667934835940,ECE 200,025,103610,Mercier; Patrick Philip,9999,0,9999,0
1667934835940,ECE 200,026,103611,Meyer; Florian,9999,0,9999,0
1667934835940,ECE 200,027,103612,Milstein; Laurence B.,9999,0,9999,0
1667934835940,ECE 200,028,103613,Mir Arabbaygi; Siavash,9999,0,9999,0
1667934835940,ECE 200,029,103614,Mookherjea; Shayan,9999,0,9999,0
1667934835940,ECE 200,030,103615,Morris; Karcher William,9999,0,9999,0
1667934835940,ECE 200,031,103616,Ng; Tse Nga,9999,0,9999,0
1667934835940,ECE 200,032,103617,Nguyen; Truong Quang,9999,0,9999,0
1667934835940,ECE 200,033,103618,Nomura; Kenji,9999,0,9999,0
1667934835940,ECE 200,034,103619,Orlitsky; Alon,9999,0,9999,0
1667934835940,ECE 200,035,103620,Pal; Piya,9999,0,9999,0
1667934835940,ECE 200,036,103621,Papen; George C.,9999,0,9999,0
1667934835940,ECE 200,037,103622,Radic; Stojan,9999,0,9999,0
1667934835940,ECE 200,038,103623,Rao; Bhaskar D.,9999,0,9999,0
1667934835940,ECE 200,039,103624,Rao; Ramesh R,9999,0,9999,0
1667934835940,ECE 200,040,103625,Rebeiz; Gabriel,9999,0,9999,0
1667934835940,ECE 200,041,103626,Sanford; John R,9999,0,9999,0
1667934835940,ECE 200,042,103627,Siegel; Paul H.,9999,0,9999,0
1667934835940,ECE 200,043,103628,Sievenpiper; Daniel F.,9999,0,9999,0
1667934835940,ECE 200,044,103629,Sworder; David D.,9999,0,9999,0
1667934835940,ECE 200,045,103630,Taur; Yuan,9999,0,9999,0
1667934835940,ECE 200,046,103631,Touri; Behrouz,9999,0,9999,0
1667934835940,ECE 200,047,103632,Trivedi; Mohan M.,9999,0,9999,0
1667934835940,ECE 200,048,103633,Vasconcelos; Nuno,9999,0,9999,0
1667934835940,ECE 200,049,103634,Wang; Xiaolong,9999,0,9999,0
1667934835940,ECE 200,050,103635,Xie; Pengtao,9999,0,9999,0
1667934835940,ECE 200,051,103636,Yip; Michael,9999,0,9999,0
1667934835940,ECE 200,052,103637,Zeger; Kenneth A.,999,0,999,0
1667934835940,ECE 200,053,103638,Zhang; Xinyu,9999,0,9999,0
1667934835940,ECE 200,054,103639,Turakhia; Yatish Girish,9999,0,9999,0
1667934835940,ECE 200,055,103640,Kang; Mingu,9999,0,9999,0
1667934835940,ECE 200,056,103641,Shi; Yuanyuan,9999,0,9999,0
1667934835940,ECE 200,057,103642,Wang; Edward Jay,9999,0,9999,0
1667934835940,ECE 200,058,103643,Zheng; Yang,9999,0,9999,0
1667934836371,ECE 202,A00,103644,Kuzum; Duygu,0,0,0,0
1667934836794,ECE 212BN,A00,103646,Ng; Tse Nga,0,0,0,0
1667934837226,ECE 221,A00,111493,Staff,0,0,0,0
1667934837648,ECE 222B,A00,103647,Lomakin; Vitaliy,0,0,0,0
1667934838080,ECE 230B,A00,103648,Taur; Yuan,0,0,0,0
1667934838503,ECE 238B,A00,103649,Garay; Javier,0,0,0,0
1667934838939,ECE 240B,A00,112900,Fainman; Yeshaiahu,0,0,0,0
1667934839371,ECE 247A,A00,103650,Jokerst; Jesse Vincent,0,0,0,0
1667934839800,ECE 247B,A00,103651,Wang; Joseph,0,0,0,0
1667934840243,ECE 250,A00,103652,Siegel; Paul H.,0,0,0,0
1667934840667,ECE 251A,A00,103654,Rao; Bhaskar D.,0,0,0,0
1667934841094,ECE 257B,A00,103655,Bharadia; Dinesh,0,0,0,0
1667934841526,ECE 258A,A00,103656,Milstein; Laurence B.,0,0,0,0
1667934841951,ECE 260B,A00,103658,Kang; Mingu,0,0,0,0
1667934842385,ECE 264A,A00,103659,Galton; Ian A,0,0,0,0
1667934842833,ECE 265A,A00,103661,Gudem; Prasad S.S.,0,0,0,0
1667934843258,ECE 265D,A00,103662,Gudem; Prasad S.S.,0,0,0,0
1667934843685,ECE 268,A00,103663,Koushanfar; Farinaz,0,0,0,0
1667934844108,ECE 269,A01,103665,Pal; Piya,0,0,0,0
1667934844533,ECE 271B,A00,103666,Vasconcelos; Manuela,0,0,0,0
1667934844968,ECE 276A,A00,103667,Atanasov; Nikolay A.,0,0,0,0
1667934845398,ECE 277,A00,103668,An; Cheolhong,0,0,0,0
1667934845823,ECE 279,A00,117947,Hall; Drew A.,0,0,0,0
1667934846684,ECE 283,A00,103670,Hsueh; Tzu-Chien,0,0,0,0
1667934847108,ECE 284,A00,103671,Turakhia; Yatish Girish,0,0,0,0
1667934847540,ECE 285,A00,103672,Zheng; Yang,0,0,0,0
1667934847540,ECE 285,B00,103673,Sworder; David D.,0,0,0,0
1667934847965,ECE 287,A00,103676,Javidi; Tara,0,0,0,0
1667934848390,MATH 200B,A00,098023,Salehi Golsefidy; Alireza,14,0,15,1
1667934848821,MATH 202B,A00,098024,Rhoades; Brendon Patrick,13,0,15,2
1667934849248,MATH 203B,A00,098025,Oprea; Dragos N.,14,0,15,1
1667934849682,MATH 204B,A00,098026,Sorensen; Claus M,15,0,15,0
1667934850107,MATH 208,A00,098027,Izadi; Elham,7,0,10,3
1667934850534,MATH 209,A00,098028,Pollack; Aaron,10,0,10,0
1667934851044,MATH 211A,A00,112919,Rogalski; Daniel,10,0,10,0
1667934851468,MATH 211B,A00,112920,Seward; Brandon M.,10,0,10,0
1667934851895,MATH 218,A00,098029,Li; Bo,10,0,10,0
1667934852318,MATH 220B,A00,098030,Novak; Jonathan I,14,0,15,1
1667934852747,MATH 221A,A00,098031,Ebenfelt; Peter F,14,0,15,1
1667934853168,MATH 231B,A00,098032,Zlatos; Andrej,14,0,15,1
1667934853592,MATH 240B,A00,098033,Ni; Lei,11,0,15,4
1667934854017,MATH 243,A00,098034,Jekel; David Andrew,10,0,10,0
1667934854455,MATH 245A,A00,098035,Nie; Jiawang,4,0,15,11
1667934854889,MATH 248,A00,098036,Bejenaru; Ioan,10,0,10,0
1667934855310,MATH 250B,A00,098037,Spolaor; Luca,14,0,15,1
1667934855743,MATH 258,A00,098038,Ni; Lei,10,0,10,0
1667934856167,MATH 264B,A00,098041,Rhoades; Brendon Patrick,13,0,15,2
1667934856605,MATH 268,A00,098042,Buss; Samuel R,10,0,10,0
1667934857038,MATH 269,A00,098043,Rhoades; Brendon Patrick,10,0,10,0
1667934857464,MATH 270B,A00,098044,Li; Bo,11,0,15,4
1667934857904,MATH 272B,A00,098045,Holst; Michael J,13,0,15,2
1667934858333,MATH 273A,A00,098046,Tian; Xiaochuan,12,0,15,3
1667934858758,MATH 275,A01,098048,Tian; Xiaochuan,6,0,10,4
1667934859183,MATH 278A,A00,098049,Holst; Michael J,8,0,10,2
1667934859605,MATH 278B,A00,098050,Cloninger; Alexander,10,0,10,0
1667934860031,MATH 278C,A00,098051,Nie; Jiawang,8,0,10,2
1667934860453,MATH 280B,A00,098052,Zheng; Tianyi,12,0,15,3
1667934860903,MATH 281B,A00,098053,Bradic; Jelena,4,0,15,11
1667934861326,MATH 282B,A00,098054,Arias-Castro; Ery,2,0,15,13
1667934861750,MATH 285,A00,098055,Fitzsimmons; Patrick J,2,0,15,13
1667934862176,MATH 287B,A00,098056,Arias-Castro; Ery,9,0,15,6
1667934862599,MATH 288,A00,098057,Agarwal; Pooja,9,0,10,1
1667934862599,MATH 288,B00,098058,Zhang; Danna,9,0,10,1
1667934862599,MATH 288,C00,098059,Williams; Ruth J,10,0,10,0
1667934863025,MATH 290B,A00,098060,Roberts; Justin Deritter,14,0,15,1
1667934863448,MATH 292,A00,098061,Belmont; Eva Kinoshita,10,0,10,0
1667934863872,MATH 295,A00,098062,Suk; Andrew Hoon,48,0,50,2
1667934864315,MATH 296,A00,098063,Novak; Jonathan I,20,0,20,0
1667934864741,MATH 297,001,098064,Gamst; Anthony Collins,9997,0,9999,2
1667935369083,COGS 205,A00,101395,Chiba; Andrea,19,0,20,1
1667935369504,COGS 210B,001,101404,Greene; Deanna Jacquelyn,9998,0,9999,1
1667935369504,COGS 210B,002,101417,Xia; Haijun,9999,0,9999,0
1667935369504,COGS 210B,003,101422,Nitz; Douglas A.,9999,0,9999,0
1667935369504,COGS 210B,004,101423,Hollan; James D.,9998,0,9999,1
1667935369504,COGS 210B,005,101424,Deak; Gedeon O.,9999,0,9999,0
1667935369504,COGS 210B,006,101425,Rossano; Federico,9999,0,9999,0
1667935369936,COGS 211B,A00,101427,Coulson; Seana M,9997,0,9999,2
1667935370359,COGS 220,A00,101428,Hollan; James D.,0,0,25,25
1667935370798,COGS 229,A00,101429,Dow; Steven P,19,0,25,6
1667935371223,COGS 230,A00,101430,Klemmer; Scott R,13,0,17,4
1667935371644,COGS 234,A00,101431,Xia; Haijun,10,0,25,15
1667935372068,COGS 260,A00,101432,Kiyonaga; Anastasia,20,0,25,5
1667935372068,COGS 260,B00,101433,Kirsh; David Joel,17,0,25,8
1667935372503,CSE 202,A00,102371,Impagliazzo; Russell,0,0,0,0
1667935372926,CSE 203B,A01,102373,Cheng; Chung Kuan,0,0,0,0
1667935373348,CSE 208,A00,102374,Micciancio; Daniele,0,0,0,0
1667935373776,CSE 209A,A00,112895,Impagliazzo; Russell,0,0,15,15
1667935374213,CSE 209B,A00,108005,Bellare; Mihir,0,0,0,0
1667935374647,CSE 210,A00,113163,Coblenz; Michael J,0,0,0,0
1667935375071,CSE 219,A00,106111,Dow; Steven P,0,0,20,20
1667935375571,CSE 221,A00,102376,Voelker; Geoffrey M.,0,0,0,0
1667935375995,CSE 224,A01,102378,Porter; George M,0,0,0,0
1667935376423,CSE 229A,A00,102379,Savage; Stefan,0,0,0,0
1667935376856,CSE 229C,A00,102380,Munyaka; Imani N. S.,0,0,0,0
1667935377290,CSE 232B,A00,102382,Deutsch; Alin Bernard,0,0,0,0
1667935377724,CSE 234,A01,112904,Kumar; Arun Kumar,0,0,0,0
1667935378150,CSE 237A,A00,102383,Rosing; Tajana Simunic,0,0,0,0
1667935378573,CSE 239A,A00,102384,Deutsch; Alin Bernard,0,0,0,0
1667935378994,CSE 239B,A00,102385,Polikarpova; Nadezhda,0,0,0,0
1667935379419,CSE 240A,A00,102386,Pannuto; Patrick William,0,0,0,0
1667935379849,CSE 240B,A00,102387,Zhao; Jishen,0,0,0,0
1667935380279,CSE 241A,A00,106406,Kang; Mingu,0,0,0,0
1667935380713,CSE 249B,A00,102388,Kahng; Andrew Byun,0,0,8,8
1667935381145,CSE 251B,A01,102392,Cottrell; Garrison W,0,0,0,0
1667935381145,CSE 251B,A02,102393,Cottrell; Garrison W,0,0,0,0
1667935381579,CSE 252B,A00,102394,Ochoa; Benjamin Lawrence,0,0,0,0
1667935382001,CSE 257,A01,102396,Gao; Sicun,0,0,0,0
1667935382439,CSE 272,A00,102397,Li; Tzumao,0,0,0,0
1667935382867,CSE 274,A00,111323,Chern; Albert Ren-Haur,0,0,0,0
1667935383290,CSE 282,A00,102398,Pevzner; Pavel Arkadjevich,0,0,0,0
1667935383725,CSE 284,A00,114175,Gymrek; Melissa Ann,0,0,0,0
1667935384148,CSE 290,A00,102399,Chandraker; Manmohan Krishna,0,0,0,0
1667935384148,CSE 290,B00,102400,Vaccaro; Kristen Marie,0,0,25,25
1667935384148,CSE 290,C00,102414,Pannuto; Patrick William,1,0,25,24
1667935384148,CSE 290,D00,102427,Pevzner; Pavel Arkadjevich,0,0,0,0
1667935384148,CSE 290,E00,102429,Zhao; Jishen,0,0,0,0
1667935384148,CSE 290,F00,102436,Tullsen; Dean Michael,0,0,0,0
1667935384148,CSE 290,G00,102440,Christensen; Henrik I,0,0,20,20
1667935384573,CSE 291,A00,102443,Su; Hao,0,0,0,0
1667935384573,CSE 291,B00,102448,Polikarpova; Nadezhda,0,0,0,0
1667935384573,CSE 291,C00,102453,Vaccaro; Kristen Marie,0,0,0,0
1667935384573,CSE 291,D00,111343,Savage; Stefan,0,0,0,0
1667935384573,CSE 291,E00,116474,Claffy; Kimberly Claire,0,0,0,0
1667935384573,CSE 291,F00,116479,Pasquale; Joseph,0,0,0,0
1667935385045,CSE 293,001,119111,Bafna; Vineet,9999,0,9999,0
1667935385045,CSE 293,002,119118,Bellare; Mihir,9999,0,9999,0
1667935385045,CSE 293,003,119122,Berg-Kirkpatrick; Taylor D,9999,0,9999,0
1667935385045,CSE 293,004,119135,Christensen; Henrik I,9999,0,9999,0
1667935385045,CSE 293,005,119142,Cottrell; Garrison W,9999,0,9999,0
1667935385045,CSE 293,006,119146,Deutsch; Alin Bernard,9999,0,9999,0
1667935385045,CSE 293,007,119159,Esmaeilzadeh; Hadi,9999,0,9999,0
1667935385045,CSE 293,008,119166,Freund; Yoav,9999,0,9999,0
1667935385045,CSE 293,009,119170,Griswold; William G.,9999,0,9999,0
1667935385045,CSE 293,010,119183,Gymrek; Melissa Ann,9999,0,9999,0
1667935385045,CSE 293,011,119190,Heninger; Nadia A,9999,0,9999,0
1667935385045,CSE 293,012,119230,Impagliazzo; Russell,9999,0,9999,0
1667935385045,CSE 293,013,119232,Jhala; Ranjit,9999,0,9999,0
1667935385045,CSE 293,014,119233,Kahng; Andrew Byun,9999,0,9999,0
1667935385045,CSE 293,015,119298,Kane; Daniel Mertz,9999,0,9999,0
1667935385045,CSE 293,016,119299,Kriegman; David J,9999,0,9999,0
1667935385045,CSE 293,017,119300,Kumar; Arun Kumar,9999,0,9999,0
1667935385045,CSE 293,018,119301,Lerner; Sorin,9999,0,9999,0
1667935385045,CSE 293,019,119302,Lovett; Shachar,9999,0,9999,0
1667935385045,CSE 293,020,119303,McAuley; Julian John,9999,0,9999,0
1667935385045,CSE 293,021,119304,Micciancio; Daniele,9999,0,9999,0
1667935385045,CSE 293,022,119367,Orailoglu; Alex,9999,0,9999,0
1667935385045,CSE 293,023,119382,Paturi; Ramamohan,9999,0,9999,0
1667935385045,CSE 293,024,119404,Polikarpova; Nadezhda,9999,0,9999,0
1667935385045,CSE 293,025,119406,Politz; Joseph Gibbs,9999,0,9999,0
1667935385045,CSE 293,026,119411,Porter; George M,9999,0,9999,0
1667935385045,CSE 293,027,119414,Porter; Leonard Emerson,9999,0,9999,0
1667935385045,CSE 293,028,119416,Ramamoorthi; Ravi,9999,0,9999,0
1667935385045,CSE 293,029,119417,Sahoo; Debashis,9999,0,9999,0
1667935385045,CSE 293,030,119420,Saul; Lawrence,9999,0,9999,0
1667935385045,CSE 293,031,119421,Savage; Stefan,9999,0,9999,0
1667935385045,CSE 293,032,119425,Schulze; Jurgen P.,9999,0,9999,0
1667935385045,CSE 293,033,119426,Snoeren; Alex C.,9999,0,9999,0
1667935385045,CSE 293,034,119428,Shang; Jingbo,9999,0,9999,0
1667935385045,CSE 293,035,119430,Stefan; Deian,9999,0,9999,0
1667935385045,CSE 293,036,119431,Su; Hao,9999,0,9999,0
1667935385045,CSE 293,037,119433,Swanson; Steven James,9999,0,9999,0
1667935385045,CSE 293,038,119435,Tullsen; Dean Michael,9999,0,9999,0
1667935385045,CSE 293,039,119483,Voelker; Geoffrey M.,9999,0,9999,0
1667935385045,CSE 293,040,119537,Zhao; Jishen,9999,0,9999,0
1667935385045,CSE 293,041,119538,Zhou; Yuan-Yuan,9999,0,9999,0
1667935385045,CSE 293,042,119539,Gao; Sicun,9999,0,9999,0
1667935385045,CSE 293,043,119540,Weibel; Nadir,9999,0,9999,0
1667935385045,CSE 293,044,119541,Gupta; Rajesh K.,9999,0,9999,0
1667935385469,CSE 294,A00,102459,Voelker; Geoffrey M.,0,0,0,0
1667935385469,CSE 294,B00,111322,Orailoglu; Alex,0,0,0,0
1667935385904,DSE 201,A00,096914,Deutsch; Alin Bernard,30,0,30,0
1667935386329,DSE 210,A00,096915,Dasgupta; Sanjoy,30,0,30,0
1667935386758,DSE 260A,A00,096916,Altintas De Callaf; Ilkay,30,0,30,0
1667935387195,ECE 200,001,103586,Antipa; Nicholas A,9999,0,9999,0
1667935387195,ECE 200,002,103587,Atanasov; Nikolay A.,9999,0,9999,0
1667935387195,ECE 200,003,103588,Bharadia; Dinesh,9999,0,9999,0
1667935387195,ECE 200,004,103589,Cheng; Chung Kuan,9999,0,9999,0
1667935387195,ECE 200,005,103590,Cosman; Pamela C.,9999,0,9999,0
1667935387195,ECE 200,006,103591,Dayeh; Shadi Ahmad,9999,0,9999,0
1667935387195,ECE 200,007,103592,Fainman; Yeshaiahu,9999,0,9999,0
1667935387195,ECE 200,008,103593,Ford; Joseph Earl,9999,0,9999,0
1667935387195,ECE 200,009,103594,Franceschetti; Massimo,9999,0,9999,0
1667935387195,ECE 200,010,103595,Fullerton; Eric E,9999,0,9999,0
1667935387195,ECE 200,011,103596,Galton; Ian A,9999,0,9999,0
1667935387195,ECE 200,012,103597,Gilja; Vikash,9999,0,9999,0
1667935387195,ECE 200,013,103598,Hall; Drew A.,9999,0,9999,0
1667935387195,ECE 200,014,103599,Hsueh; Tzu-Chien,9999,0,9999,0
1667935387195,ECE 200,015,103600,Javidi; Tara,9999,0,9999,0
1667935387195,ECE 200,016,103601,Kahng; Andrew Byun,9999,0,9999,0
1667935387195,ECE 200,017,103602,Kim; Young-Han,9999,0,9999,0
1667935387195,ECE 200,018,103603,Koushanfar; Farinaz,9999,0,9999,0
1667935387195,ECE 200,019,103604,Kuzum; Duygu,9999,0,9999,0
1667935387195,ECE 200,020,103605,Le; Hanh-Phuc,9999,0,9999,0
1667935387195,ECE 200,021,103606,Lin; Bill,9999,0,9999,0
1667935387195,ECE 200,022,103607,Liu; Zhaowei,9998,0,9999,1
1667935387195,ECE 200,023,103608,Lo; Yu-Hwa,9999,0,9999,0
1667935387195,ECE 200,024,103609,Lomakin; Vitaliy,9999,0,9999,0
1667935387195,ECE 200,025,103610,Mercier; Patrick Philip,9999,0,9999,0
1667935387195,ECE 200,026,103611,Meyer; Florian,9999,0,9999,0
1667935387195,ECE 200,027,103612,Milstein; Laurence B.,9999,0,9999,0
1667935387195,ECE 200,028,103613,Mir Arabbaygi; Siavash,9999,0,9999,0
1667935387195,ECE 200,029,103614,Mookherjea; Shayan,9999,0,9999,0
1667935387195,ECE 200,030,103615,Morris; Karcher William,9999,0,9999,0
1667935387195,ECE 200,031,103616,Ng; Tse Nga,9999,0,9999,0
1667935387195,ECE 200,032,103617,Nguyen; Truong Quang,9999,0,9999,0
1667935387195,ECE 200,033,103618,Nomura; Kenji,9999,0,9999,0
1667935387195,ECE 200,034,103619,Orlitsky; Alon,9999,0,9999,0
1667935387195,ECE 200,035,103620,Pal; Piya,9999,0,9999,0
1667935387195,ECE 200,036,103621,Papen; George C.,9999,0,9999,0
1667935387195,ECE 200,037,103622,Radic; Stojan,9999,0,9999,0
1667935387195,ECE 200,038,103623,Rao; Bhaskar D.,9999,0,9999,0
1667935387195,ECE 200,039,103624,Rao; Ramesh R,9999,0,9999,0
1667935387195,ECE 200,040,103625,Rebeiz; Gabriel,9999,0,9999,0
1667935387195,ECE 200,041,103626,Sanford; John R,9999,0,9999,0
1667935387195,ECE 200,042,103627,Siegel; Paul H.,9999,0,9999,0
1667935387195,ECE 200,043,103628,Sievenpiper; Daniel F.,9999,0,9999,0
1667935387195,ECE 200,044,103629,Sworder; David D.,9999,0,9999,0
1667935387195,ECE 200,045,103630,Taur; Yuan,9999,0,9999,0
1667935387195,ECE 200,046,103631,Touri; Behrouz,9999,0,9999,0
1667935387195,ECE 200,047,103632,Trivedi; Mohan M.,9999,0,9999,0
1667935387195,ECE 200,048,103633,Vasconcelos; Nuno,9999,0,9999,0
1667935387195,ECE 200,049,103634,Wang; Xiaolong,9999,0,9999,0
1667935387195,ECE 200,050,103635,Xie; Pengtao,9999,0,9999,0
1667935387195,ECE 200,051,103636,Yip; Michael,9999,0,9999,0
1667935387195,ECE 200,052,103637,Zeger; Kenneth A.,999,0,999,0
1667935387195,ECE 200,053,103638,Zhang; Xinyu,9999,0,9999,0
1667935387195,ECE 200,054,103639,Turakhia; Yatish Girish,9999,0,9999,0
1667935387195,ECE 200,055,103640,Kang; Mingu,9999,0,9999,0
1667935387195,ECE 200,056,103641,Shi; Yuanyuan,9999,0,9999,0
1667935387195,ECE 200,057,103642,Wang; Edward Jay,9999,0,9999,0
1667935387195,ECE 200,058,103643,Zheng; Yang,9999,0,9999,0
1667935387619,ECE 202,A00,103644,Kuzum; Duygu,0,0,0,0
1667935388042,ECE 212BN,A00,103646,Ng; Tse Nga,0,0,0,0
1667935388467,ECE 221,A00,111493,Staff,0,0,0,0
1667935388902,ECE 222B,A00,103647,Lomakin; Vitaliy,0,0,0,0
1667935389329,ECE 230B,A00,103648,Taur; Yuan,0,0,0,0
1667935389757,ECE 238B,A00,103649,Garay; Javier,0,0,0,0
1667935390181,ECE 240B,A00,112900,Fainman; Yeshaiahu,0,0,0,0
1667935390604,ECE 247A,A00,103650,Jokerst; Jesse Vincent,0,0,0,0
1667935391040,ECE 247B,A00,103651,Wang; Joseph,0,0,0,0
1667935391468,ECE 250,A00,103652,Siegel; Paul H.,0,0,0,0
1667935391891,ECE 251A,A00,103654,Rao; Bhaskar D.,0,0,0,0
1667935392335,ECE 257B,A00,103655,Bharadia; Dinesh,0,0,0,0
1667935392757,ECE 258A,A00,103656,Milstein; Laurence B.,0,0,0,0
1667935393183,ECE 260B,A00,103658,Kang; Mingu,0,0,0,0
1667935393612,ECE 264A,A00,103659,Galton; Ian A,0,0,0,0
1667935394047,ECE 265A,A00,103661,Gudem; Prasad S.S.,0,0,0,0
1667935394470,ECE 265D,A00,103662,Gudem; Prasad S.S.,0,0,0,0
1667935394893,ECE 268,A00,103663,Koushanfar; Farinaz,0,0,0,0
1667935395319,ECE 269,A01,103665,Pal; Piya,0,0,0,0
1667935395751,ECE 271B,A00,103666,Vasconcelos; Manuela,0,0,0,0
1667935396175,ECE 276A,A00,103667,Atanasov; Nikolay A.,0,0,0,0
1667935396615,ECE 277,A00,103668,An; Cheolhong,0,0,0,0
1667935397042,ECE 279,A00,117947,Hall; Drew A.,0,0,0,0
1667935397905,ECE 283,A00,103670,Hsueh; Tzu-Chien,0,0,0,0
1667935398337,ECE 284,A00,103671,Turakhia; Yatish Girish,0,0,0,0
1667935398762,ECE 285,A00,103672,Zheng; Yang,0,0,0,0
1667935398762,ECE 285,B00,103673,Sworder; David D.,0,0,0,0
1667935399191,ECE 287,A00,103676,Javidi; Tara,0,0,0,0
1667935399622,MATH 200B,A00,098023,Salehi Golsefidy; Alireza,14,0,15,1
1667935400045,MATH 202B,A00,098024,Rhoades; Brendon Patrick,13,0,15,2
1667935400487,MATH 203B,A00,098025,Oprea; Dragos N.,14,0,15,1
1667935400921,MATH 204B,A00,098026,Sorensen; Claus M,15,0,15,0
1667935401345,MATH 208,A00,098027,Izadi; Elham,7,0,10,3
1667935401769,MATH 209,A00,098028,Pollack; Aaron,10,0,10,0
1667935402192,MATH 211A,A00,112919,Rogalski; Daniel,10,0,10,0
1667935402639,MATH 211B,A00,112920,Seward; Brandon M.,10,0,10,0
1667935403076,MATH 218,A00,098029,Li; Bo,10,0,10,0
1667935403500,MATH 220B,A00,098030,Novak; Jonathan I,14,0,15,1
1667935403927,MATH 221A,A00,098031,Ebenfelt; Peter F,14,0,15,1
1667935404364,MATH 231B,A00,098032,Zlatos; Andrej,14,0,15,1
1667935404798,MATH 240B,A00,098033,Ni; Lei,11,0,15,4
1667935405221,MATH 243,A00,098034,Jekel; David Andrew,10,0,10,0
1667935405647,MATH 245A,A00,098035,Nie; Jiawang,4,0,15,11
1667935406071,MATH 248,A00,098036,Bejenaru; Ioan,10,0,10,0
1667935406498,MATH 250B,A00,098037,Spolaor; Luca,14,0,15,1
1667935406920,MATH 258,A00,098038,Ni; Lei,10,0,10,0
1667935407342,MATH 264B,A00,098041,Rhoades; Brendon Patrick,13,0,15,2
1667935407768,MATH 268,A00,098042,Buss; Samuel R,10,0,10,0
1667935408196,MATH 269,A00,098043,Rhoades; Brendon Patrick,10,0,10,0
1667935408621,MATH 270B,A00,098044,Li; Bo,11,0,15,4
1667935409046,MATH 272B,A00,098045,Holst; Michael J,13,0,15,2
1667935409473,MATH 273A,A00,098046,Tian; Xiaochuan,12,0,15,3
1667935409899,MATH 275,A01,098048,Tian; Xiaochuan,6,0,10,4
1667935410326,MATH 278A,A00,098049,Holst; Michael J,8,0,10,2
1667935410747,MATH 278B,A00,098050,Cloninger; Alexander,10,0,10,0
1667935411175,MATH 278C,A00,098051,Nie; Jiawang,8,0,10,2
1667935411615,MATH 280B,A00,098052,Zheng; Tianyi,12,0,15,3
1667935412047,MATH 281B,A00,098053,Bradic; Jelena,4,0,15,11
1667935412474,MATH 282B,A00,098054,Arias-Castro; Ery,2,0,15,13
1667935412905,MATH 285,A00,098055,Fitzsimmons; Patrick J,2,0,15,13
1667935413338,MATH 287B,A00,098056,Arias-Castro; Ery,9,0,15,6
1667935413769,MATH 288,A00,098057,Agarwal; Pooja,9,0,10,1
1667935413769,MATH 288,B00,098058,Zhang; Danna,9,0,10,1
1667935413769,MATH 288,C00,098059,Williams; Ruth J,10,0,10,0
1667935414193,MATH 290B,A00,098060,Roberts; Justin Deritter,14,0,15,1
1667935414616,MATH 292,A00,098061,Belmont; Eva Kinoshita,10,0,10,0
1667935415040,MATH 295,A00,098062,Suk; Andrew Hoon,48,0,50,2
1667935415466,MATH 296,A00,098063,Novak; Jonathan I,20,0,20,0
1667935415907,MATH 297,001,098064,Gamst; Anthony Collins,9997,0,9999,2
1667935919238,COGS 205,A00,101395,Chiba; Andrea,19,0,20,1
1667935919669,COGS 210B,001,101404,Greene; Deanna Jacquelyn,9998,0,9999,1
1667935919669,COGS 210B,002,101417,Xia; Haijun,9999,0,9999,0
1667935919669,COGS 210B,003,101422,Nitz; Douglas A.,9999,0,9999,0
1667935919669,COGS 210B,004,101423,Hollan; James D.,9998,0,9999,1
1667935919669,COGS 210B,005,101424,Deak; Gedeon O.,9999,0,9999,0
1667935919669,COGS 210B,006,101425,Rossano; Federico,9999,0,9999,0
1667935920093,COGS 211B,A00,101427,Coulson; Seana M,9997,0,9999,2
1667935920520,COGS 220,A00,101428,Hollan; James D.,0,0,25,25
1667935920944,COGS 229,A00,101429,Dow; Steven P,19,0,25,6
1667935921378,COGS 230,A00,101430,Klemmer; Scott R,13,0,17,4
1667935921800,COGS 234,A00,101431,Xia; Haijun,10,0,25,15
1667935922257,COGS 260,A00,101432,Kiyonaga; Anastasia,20,0,25,5
1667935922257,COGS 260,B00,101433,Kirsh; David Joel,17,0,25,8
1667935922695,CSE 202,A00,102371,Impagliazzo; Russell,0,0,0,0
1667935923134,CSE 203B,A01,102373,Cheng; Chung Kuan,0,0,0,0
1667935923564,CSE 208,A00,102374,Micciancio; Daniele,0,0,0,0
1667935923990,CSE 209A,A00,112895,Impagliazzo; Russell,0,0,15,15
1667935924415,CSE 209B,A00,108005,Bellare; Mihir,0,0,0,0
1667935924850,CSE 210,A00,113163,Coblenz; Michael J,0,0,0,0
1667935925277,CSE 219,A00,106111,Dow; Steven P,0,0,20,20
1667935925703,CSE 221,A00,102376,Voelker; Geoffrey M.,0,0,0,0
1667935926129,CSE 224,A01,102378,Porter; George M,0,0,0,0
1667935926554,CSE 229A,A00,102379,Savage; Stefan,0,0,0,0
1667935926980,CSE 229C,A00,102380,Munyaka; Imani N. S.,0,0,0,0
1667935927405,CSE 232B,A00,102382,Deutsch; Alin Bernard,0,0,0,0
1667935927828,CSE 234,A01,112904,Kumar; Arun Kumar,0,0,0,0
1667935928265,CSE 237A,A00,102383,Rosing; Tajana Simunic,0,0,0,0
1667935928717,CSE 239A,A00,102384,Deutsch; Alin Bernard,0,0,0,0
1667935929142,CSE 239B,A00,102385,Polikarpova; Nadezhda,0,0,0,0
1667935929564,CSE 240A,A00,102386,Pannuto; Patrick William,0,0,0,0
1667935929995,CSE 240B,A00,102387,Zhao; Jishen,0,0,0,0
1667935930419,CSE 241A,A00,106406,Kang; Mingu,0,0,0,0
1667935930843,CSE 249B,A00,102388,Kahng; Andrew Byun,0,0,8,8
1667935931268,CSE 251B,A01,102392,Cottrell; Garrison W,0,0,0,0
1667935931268,CSE 251B,A02,102393,Cottrell; Garrison W,0,0,0,0
1667935931700,CSE 252B,A00,102394,Ochoa; Benjamin Lawrence,0,0,0,0
1667935932137,CSE 257,A01,102396,Gao; Sicun,0,0,0,0
1667935932560,CSE 272,A00,102397,Li; Tzumao,0,0,0,0
1667935932988,CSE 274,A00,111323,Chern; Albert Ren-Haur,0,0,0,0
1667935933414,CSE 282,A00,102398,Pevzner; Pavel Arkadjevich,0,0,0,0
1667935933842,CSE 284,A00,114175,Gymrek; Melissa Ann,0,0,0,0
1667935934265,CSE 290,A00,102399,Chandraker; Manmohan Krishna,0,0,0,0
1667935934265,CSE 290,B00,102400,Vaccaro; Kristen Marie,0,0,25,25
1667935934265,CSE 290,C00,102414,Pannuto; Patrick William,1,0,25,24
1667935934265,CSE 290,D00,102427,Pevzner; Pavel Arkadjevich,0,0,0,0
1667935934265,CSE 290,E00,102429,Zhao; Jishen,0,0,0,0
1667935934265,CSE 290,F00,102436,Tullsen; Dean Michael,0,0,0,0
1667935934265,CSE 290,G00,102440,Christensen; Henrik I,0,0,20,20
1667935934710,CSE 291,A00,102443,Su; Hao,0,0,0,0
1667935934710,CSE 291,B00,102448,Polikarpova; Nadezhda,0,0,0,0
1667935934710,CSE 291,C00,102453,Vaccaro; Kristen Marie,0,0,0,0
1667935934710,CSE 291,D00,111343,Savage; Stefan,0,0,0,0
1667935934710,CSE 291,E00,116474,Claffy; Kimberly Claire,0,0,0,0
1667935934710,CSE 291,F00,116479,Pasquale; Joseph,0,0,0,0
1667935935169,CSE 293,001,119111,Bafna; Vineet,9999,0,9999,0
1667935935169,CSE 293,002,119118,Bellare; Mihir,9999,0,9999,0
1667935935169,CSE 293,003,119122,Berg-Kirkpatrick; Taylor D,9999,0,9999,0
1667935935169,CSE 293,004,119135,Christensen; Henrik I,9999,0,9999,0
1667935935169,CSE 293,005,119142,Cottrell; Garrison W,9999,0,9999,0
1667935935169,CSE 293,006,119146,Deutsch; Alin Bernard,9999,0,9999,0
1667935935169,CSE 293,007,119159,Esmaeilzadeh; Hadi,9999,0,9999,0
1667935935169,CSE 293,008,119166,Freund; Yoav,9999,0,9999,0
1667935935169,CSE 293,009,119170,Griswold; William G.,9999,0,9999,0
1667935935169,CSE 293,010,119183,Gymrek; Melissa Ann,9999,0,9999,0
1667935935169,CSE 293,011,119190,Heninger; Nadia A,9999,0,9999,0
1667935935169,CSE 293,012,119230,Impagliazzo; Russell,9999,0,9999,0
1667935935169,CSE 293,013,119232,Jhala; Ranjit,9999,0,9999,0
1667935935169,CSE 293,014,119233,Kahng; Andrew Byun,9999,0,9999,0
1667935935169,CSE 293,015,119298,Kane; Daniel Mertz,9999,0,9999,0
1667935935169,CSE 293,016,119299,Kriegman; David J,9999,0,9999,0
1667935935169,CSE 293,017,119300,Kumar; Arun Kumar,9999,0,9999,0
1667935935169,CSE 293,018,119301,Lerner; Sorin,9999,0,9999,0
1667935935169,CSE 293,019,119302,Lovett; Shachar,9999,0,9999,0
1667935935169,CSE 293,020,119303,McAuley; Julian John,9999,0,9999,0
1667935935169,CSE 293,021,119304,Micciancio; Daniele,9999,0,9999,0
1667935935169,CSE 293,022,119367,Orailoglu; Alex,9999,0,9999,0
1667935935169,CSE 293,023,119382,Paturi; Ramamohan,9999,0,9999,0
1667935935169,CSE 293,024,119404,Polikarpova; Nadezhda,9999,0,9999,0
1667935935169,CSE 293,025,119406,Politz; Joseph Gibbs,9999,0,9999,0
1667935935169,CSE 293,026,119411,Porter; George M,9999,0,9999,0
1667935935169,CSE 293,027,119414,Porter; Leonard Emerson,9999,0,9999,0
1667935935169,CSE 293,028,119416,Ramamoorthi; Ravi,9999,0,9999,0
1667935935169,CSE 293,029,119417,Sahoo; Debashis,9999,0,9999,0
1667935935169,CSE 293,030,119420,Saul; Lawrence,9999,0,9999,0
1667935935169,CSE 293,031,119421,Savage; Stefan,9999,0,9999,0
1667935935169,CSE 293,032,119425,Schulze; Jurgen P.,9999,0,9999,0
1667935935169,CSE 293,033,119426,Snoeren; Alex C.,9999,0,9999,0
1667935935169,CSE 293,034,119428,Shang; Jingbo,9999,0,9999,0
1667935935169,CSE 293,035,119430,Stefan; Deian,9999,0,9999,0
1667935935169,CSE 293,036,119431,Su; Hao,9999,0,9999,0
1667935935169,CSE 293,037,119433,Swanson; Steven James,9999,0,9999,0
1667935935169,CSE 293,038,119435,Tullsen; Dean Michael,9999,0,9999,0
1667935935169,CSE 293,039,119483,Voelker; Geoffrey M.,9999,0,9999,0
1667935935169,CSE 293,040,119537,Zhao; Jishen,9999,0,9999,0
1667935935169,CSE 293,041,119538,Zhou; Yuan-Yuan,9999,0,9999,0
1667935935169,CSE 293,042,119539,Gao; Sicun,9999,0,9999,0
1667935935169,CSE 293,043,119540,Weibel; Nadir,9999,0,9999,0
1667935935169,CSE 293,044,119541,Gupta; Rajesh K.,9999,0,9999,0
1667935935597,CSE 294,A00,102459,Voelker; Geoffrey M.,0,0,0,0
1667935935597,CSE 294,B00,111322,Orailoglu; Alex,0,0,0,0
1667935936029,DSE 201,A00,096914,Deutsch; Alin Bernard,30,0,30,0
1667935936457,DSE 210,A00,096915,Dasgupta; Sanjoy,30,0,30,0
1667935936891,DSE 260A,A00,096916,Altintas De Callaf; Ilkay,30,0,30,0
1667935937328,ECE 200,001,103586,Antipa; Nicholas A,9999,0,9999,0
1667935937328,ECE 200,002,103587,Atanasov; Nikolay A.,9999,0,9999,0
1667935937328,ECE 200,003,103588,Bharadia; Dinesh,9999,0,9999,0
1667935937328,ECE 200,004,103589,Cheng; Chung Kuan,9999,0,9999,0
1667935937328,ECE 200,005,103590,Cosman; Pamela C.,9999,0,9999,0
1667935937328,ECE 200,006,103591,Dayeh; Shadi Ahmad,9999,0,9999,0
1667935937328,ECE 200,007,103592,Fainman; Yeshaiahu,9999,0,9999,0
1667935937328,ECE 200,008,103593,Ford; Joseph Earl,9999,0,9999,0
1667935937328,ECE 200,009,103594,Franceschetti; Massimo,9999,0,9999,0
1667935937328,ECE 200,010,103595,Fullerton; Eric E,9999,0,9999,0
1667935937328,ECE 200,011,103596,Galton; Ian A,9999,0,9999,0
1667935937328,ECE 200,012,103597,Gilja; Vikash,9999,0,9999,0
1667935937328,ECE 200,013,103598,Hall; Drew A.,9999,0,9999,0
1667935937328,ECE 200,014,103599,Hsueh; Tzu-Chien,9999,0,9999,0
1667935937328,ECE 200,015,103600,Javidi; Tara,9999,0,9999,0
1667935937328,ECE 200,016,103601,Kahng; Andrew Byun,9999,0,9999,0
1667935937328,ECE 200,017,103602,Kim; Young-Han,9999,0,9999,0
1667935937328,ECE 200,018,103603,Koushanfar; Farinaz,9999,0,9999,0
1667935937328,ECE 200,019,103604,Kuzum; Duygu,9999,0,9999,0
1667935937328,ECE 200,020,103605,Le; Hanh-Phuc,9999,0,9999,0
1667935937328,ECE 200,021,103606,Lin; Bill,9999,0,9999,0
1667935937328,ECE 200,022,103607,Liu; Zhaowei,9998,0,9999,1
1667935937328,ECE 200,023,103608,Lo; Yu-Hwa,9999,0,9999,0
1667935937328,ECE 200,024,103609,Lomakin; Vitaliy,9999,0,9999,0
1667935937328,ECE 200,025,103610,Mercier; Patrick Philip,9999,0,9999,0
1667935937328,ECE 200,026,103611,Meyer; Florian,9999,0,9999,0
1667935937328,ECE 200,027,103612,Milstein; Laurence B.,9999,0,9999,0
1667935937328,ECE 200,028,103613,Mir Arabbaygi; Siavash,9999,0,9999,0
1667935937328,ECE 200,029,103614,Mookherjea; Shayan,9999,0,9999,0
1667935937328,ECE 200,030,103615,Morris; Karcher William,9999,0,9999,0
1667935937328,ECE 200,031,103616,Ng; Tse Nga,9999,0,9999,0
1667935937328,ECE 200,032,103617,Nguyen; Truong Quang,9999,0,9999,0
1667935937328,ECE 200,033,103618,Nomura; Kenji,9999,0,9999,0
1667935937328,ECE 200,034,103619,Orlitsky; Alon,9999,0,9999,0
1667935937328,ECE 200,035,103620,Pal; Piya,9999,0,9999,0
1667935937328,ECE 200,036,103621,Papen; George C.,9999,0,9999,0
1667935937328,ECE 200,037,103622,Radic; Stojan,9999,0,9999,0
1667935937328,ECE 200,038,103623,Rao; Bhaskar D.,9999,0,9999,0
1667935937328,ECE 200,039,103624,Rao; Ramesh R,9999,0,9999,0
1667935937328,ECE 200,040,103625,Rebeiz; Gabriel,9999,0,9999,0
1667935937328,ECE 200,041,103626,Sanford; John R,9999,0,9999,0
1667935937328,ECE 200,042,103627,Siegel; Paul H.,9999,0,9999,0
1667935937328,ECE 200,043,103628,Sievenpiper; Daniel F.,9999,0,9999,0
1667935937328,ECE 200,044,103629,Sworder; David D.,9999,0,9999,0
1667935937328,ECE 200,045,103630,Taur; Yuan,9999,0,9999,0
1667935937328,ECE 200,046,103631,Touri; Behrouz,9999,0,9999,0
1667935937328,ECE 200,047,103632,Trivedi; Mohan M.,9999,0,9999,0
1667935937328,ECE 200,048,103633,Vasconcelos; Nuno,9999,0,9999,0
1667935937328,ECE 200,049,103634,Wang; Xiaolong,9999,0,9999,0
1667935937328,ECE 200,050,103635,Xie; Pengtao,9999,0,9999,0
1667935937328,ECE 200,051,103636,Yip; Michael,9999,0,9999,0
1667935937328,ECE 200,052,103637,Zeger; Kenneth A.,999,0,999,0
1667935937328,ECE 200,053,103638,Zhang; Xinyu,9999,0,9999,0
1667935937328,ECE 200,054,103639,Turakhia; Yatish Girish,9999,0,9999,0
1667935937328,ECE 200,055,103640,Kang; Mingu,9999,0,9999,0
1667935937328,ECE 200,056,103641,Shi; Yuanyuan,9999,0,9999,0
1667935937328,ECE 200,057,103642,Wang; Edward Jay,9999,0,9999,0
1667935937328,ECE 200,058,103643,Zheng; Yang,9999,0,9999,0
1667935937752,ECE 202,A00,103644,Kuzum; Duygu,0,0,0,0
1667935938175,ECE 212BN,A00,103646,Ng; Tse Nga,0,0,0,0
1667935938596,ECE 221,A00,111493,Staff,0,0,0,0
1667935939022,ECE 222B,A00,103647,Lomakin; Vitaliy,0,0,0,0
1667935939463,ECE 230B,A00,103648,Taur; Yuan,0,0,0,0
1667935939888,ECE 238B,A00,103649,Garay; Javier,0,0,0,0
1667935940317,ECE 240B,A00,112900,Fainman; Yeshaiahu,0,0,0,0
1667935940758,ECE 247A,A00,103650,Jokerst; Jesse Vincent,0,0,0,0
1667935941196,ECE 247B,A00,103651,Wang; Joseph,0,0,0,0
1667935941618,ECE 250,A00,103652,Siegel; Paul H.,0,0,0,0
1667935942048,ECE 251A,A00,103654,Rao; Bhaskar D.,0,0,0,0
1667935942561,ECE 257B,A00,103655,Bharadia; Dinesh,0,0,0,0
1667935942985,ECE 258A,A00,103656,Milstein; Laurence B.,0,0,0,0
1667935943413,ECE 260B,A00,103658,Kang; Mingu,0,0,0,0
1667935943840,ECE 264A,A00,103659,Galton; Ian A,0,0,0,0
1667935944266,ECE 265A,A00,103661,Gudem; Prasad S.S.,0,0,0,0
1667935944689,ECE 265D,A00,103662,Gudem; Prasad S.S.,0,0,0,0
1667935945119,ECE 268,A00,103663,Koushanfar; Farinaz,0,0,0,0
1667935945543,ECE 269,A01,103665,Pal; Piya,0,0,0,0
1667935945974,ECE 271B,A00,103666,Vasconcelos; Manuela,0,0,0,0
1667935946403,ECE 276A,A00,103667,Atanasov; Nikolay A.,0,0,0,0
1667935946828,ECE 277,A00,103668,An; Cheolhong,0,0,0,0
1667935947256,ECE 279,A00,117947,Hall; Drew A.,0,0,0,0
1667935948108,ECE 283,A00,103670,Hsueh; Tzu-Chien,0,0,0,0
1667935948537,ECE 284,A00,103671,Turakhia; Yatish Girish,0,0,0,0
1667935948964,ECE 285,A00,103672,Zheng; Yang,0,0,0,0
1667935948964,ECE 285,B00,103673,Sworder; David D.,0,0,0,0
1667935949394,ECE 287,A00,103676,Javidi; Tara,0,0,0,0
1667935949824,MATH 200B,A00,098023,Salehi Golsefidy; Alireza,14,0,15,1
1667935950255,MATH 202B,A00,098024,Rhoades; Brendon Patrick,13,0,15,2
1667935950683,MATH 203B,A00,098025,Oprea; Dragos N.,14,0,15,1
1667935951108,MATH 204B,A00,098026,Sorensen; Claus M,15,0,15,0
1667935951537,MATH 208,A00,098027,Izadi; Elham,7,0,10,3
1667935951962,MATH 209,A00,098028,Pollack; Aaron,10,0,10,0
1667935952391,MATH 211A,A00,112919,Rogalski; Daniel,10,0,10,0
1667935952818,MATH 211B,A00,112920,Seward; Brandon M.,10,0,10,0
1667935953241,MATH 218,A00,098029,Li; Bo,10,0,10,0
1667935953665,MATH 220B,A00,098030,Novak; Jonathan I,14,0,15,1
1667935954093,MATH 221A,A00,098031,Ebenfelt; Peter F,14,0,15,1
1667935954516,MATH 231B,A00,098032,Zlatos; Andrej,14,0,15,1
1667935954956,MATH 240B,A00,098033,Ni; Lei,11,0,15,4
1667935955392,MATH 243,A00,098034,Jekel; David Andrew,10,0,10,0
1667935955818,MATH 245A,A00,098035,Nie; Jiawang,4,0,15,11
1667935956243,MATH 248,A00,098036,Bejenaru; Ioan,10,0,10,0
1667935956670,MATH 250B,A00,098037,Spolaor; Luca,14,0,15,1
1667935957096,MATH 258,A00,098038,Ni; Lei,10,0,10,0
1667935957521,MATH 264B,A00,098041,Rhoades; Brendon Patrick,13,0,15,2
1667935957959,MATH 268,A00,098042,Buss; Samuel R,10,0,10,0
1667935958381,MATH 269,A00,098043,Rhoades; Brendon Patrick,10,0,10,0
1667935958810,MATH 270B,A00,098044,Li; Bo,11,0,15,4
1667935959238,MATH 272B,A00,098045,Holst; Michael J,13,0,15,2
1667935959674,MATH 273A,A00,098046,Tian; Xiaochuan,12,0,15,3
1667935960103,MATH 275,A01,098048,Tian; Xiaochuan,6,0,10,4
1667935960529,MATH 278A,A00,098049,Holst; Michael J,8,0,10,2
1667935960954,MATH 278B,A00,098050,Cloninger; Alexander,10,0,10,0
1667935961376,MATH 278C,A00,098051,Nie; Jiawang,8,0,10,2
1667935961804,MATH 280B,A00,098052,Zheng; Tianyi,12,0,15,3
1667935962232,MATH 281B,A00,098053,Bradic; Jelena,4,0,15,11
1667935962678,MATH 282B,A00,098054,Arias-Castro; Ery,2,0,15,13
1667935963103,MATH 285,A00,098055,Fitzsimmons; Patrick J,2,0,15,13
1667935963532,MATH 287B,A00,098056,Arias-Castro; Ery,9,0,15,6
1667935963970,MATH 288,A00,098057,Agarwal; Pooja,9,0,10,1
1667935963970,MATH 288,B00,098058,Zhang; Danna,9,0,10,1
1667935963970,MATH 288,C00,098059,Williams; Ruth J,10,0,10,0
1667935964393,MATH 290B,A00,098060,Roberts; Justin Deritter,14,0,15,1
1667935964827,MATH 292,A00,098061,Belmont; Eva Kinoshita,10,0,10,0
1667935965272,MATH 295,A00,098062,Suk; Andrew Hoon,48,0,50,2
1667935965699,MATH 296,A00,098063,Novak; Jonathan I,20,0,20,0
1667935966122,MATH 297,001,098064,Gamst; Anthony Collins,9997,0,9999,2
1667936481527,COGS 205,A00,101395,Chiba; Andrea,19,0,20,1
1667936481951,COGS 210B,001,101404,Greene; Deanna Jacquelyn,9998,0,9999,1
1667936481951,COGS 210B,002,101417,Xia; Haijun,9999,0,9999,0
1667936481951,COGS 210B,003,101422,Nitz; Douglas A.,9999,0,9999,0
1667936481951,COGS 210B,004,101423,Hollan; James D.,9998,0,9999,1
1667936481951,COGS 210B,005,101424,Deak; Gedeon O.,9999,0,9999,0
1667936481951,COGS 210B,006,101425,Rossano; Federico,9999,0,9999,0
1667936482375,COGS 211B,A00,101427,Coulson; Seana M,9997,0,9999,2
1667936482808,COGS 220,A00,101428,Hollan; James D.,0,0,25,25
1667936483233,COGS 229,A00,101429,Dow; Steven P,19,0,25,6
1667936483663,COGS 230,A00,101430,Klemmer; Scott R,13,0,17,4
1667936484091,COGS 234,A00,101431,Xia; Haijun,10,0,25,15
1667936484513,COGS 260,A00,101432,Kiyonaga; Anastasia,20,0,25,5
1667936484513,COGS 260,B00,101433,Kirsh; David Joel,17,0,25,8
1667936484951,CSE 202,A00,102371,Impagliazzo; Russell,0,0,0,0
1667936485378,CSE 203B,A01,102373,Cheng; Chung Kuan,0,0,0,0
1667936485801,CSE 208,A00,102374,Micciancio; Daniele,0,0,0,0
1667936486232,CSE 209A,A00,112895,Impagliazzo; Russell,0,0,15,15
1667936486659,CSE 209B,A00,108005,Bellare; Mihir,0,0,0,0
1667936487081,CSE 210,A00,113163,Coblenz; Michael J,0,0,0,0
1667936487511,CSE 219,A00,106111,Dow; Steven P,0,0,20,20
1667936487935,CSE 221,A00,102376,Voelker; Geoffrey M.,0,0,0,0
1667936488361,CSE 224,A01,102378,Porter; George M,0,0,0,0
1667936488791,CSE 229A,A00,102379,Savage; Stefan,0,0,0,0
1667936489225,CSE 229C,A00,102380,Munyaka; Imani N. S.,0,0,0,0
1667936489650,CSE 232B,A00,102382,Deutsch; Alin Bernard,0,0,0,0
1667936490076,CSE 234,A01,112904,Kumar; Arun Kumar,0,0,0,0
1667936490510,CSE 237A,A00,102383,Rosing; Tajana Simunic,0,0,0,0
1667936490942,CSE 239A,A00,102384,Deutsch; Alin Bernard,0,0,0,0
1667936491384,CSE 239B,A00,102385,Polikarpova; Nadezhda,0,0,0,0
1667936491815,CSE 240A,A00,102386,Pannuto; Patrick William,0,0,0,0
1667936492241,CSE 240B,A00,102387,Zhao; Jishen,0,0,0,0
1667936492671,CSE 241A,A00,106406,Kang; Mingu,0,0,0,0
1667936493093,CSE 249B,A00,102388,Kahng; Andrew Byun,0,0,8,8
1667936493517,CSE 251B,A01,102392,Cottrell; Garrison W,0,0,0,0
1667936493517,CSE 251B,A02,102393,Cottrell; Garrison W,0,0,0,0
1667936493940,CSE 252B,A00,102394,Ochoa; Benjamin Lawrence,0,0,0,0
1667936494362,CSE 257,A01,102396,Gao; Sicun,0,0,0,0
1667936494797,CSE 272,A00,102397,Li; Tzumao,0,0,0,0
1667936495219,CSE 274,A00,111323,Chern; Albert Ren-Haur,0,0,0,0
1667936495662,CSE 282,A00,102398,Pevzner; Pavel Arkadjevich,0,0,0,0
1667936496683,CSE 284,A00,114175,Gymrek; Melissa Ann,0,0,0,0
1667936497107,CSE 290,A00,102399,Chandraker; Manmohan Krishna,0,0,0,0
1667936497107,CSE 290,B00,102400,Vaccaro; Kristen Marie,0,0,25,25
1667936497107,CSE 290,C00,102414,Pannuto; Patrick William,1,0,25,24
1667936497107,CSE 290,D00,102427,Pevzner; Pavel Arkadjevich,0,0,0,0
1667936497107,CSE 290,E00,102429,Zhao; Jishen,0,0,0,0
1667936497107,CSE 290,F00,102436,Tullsen; Dean Michael,0,0,0,0
1667936497107,CSE 290,G00,102440,Christensen; Henrik I,0,0,20,20
1667936497532,CSE 291,A00,102443,Su; Hao,0,0,0,0
1667936497532,CSE 291,B00,102448,Polikarpova; Nadezhda,0,0,0,0
1667936497532,CSE 291,C00,102453,Vaccaro; Kristen Marie,0,0,0,0
1667936497532,CSE 291,D00,111343,Savage; Stefan,0,0,0,0
1667936497532,CSE 291,E00,116474,Claffy; Kimberly Claire,0,0,0,0
1667936497532,CSE 291,F00,116479,Pasquale; Joseph,0,0,0,0
1667936497987,CSE 293,001,119111,Bafna; Vineet,9999,0,9999,0
1667936497987,CSE 293,002,119118,Bellare; Mihir,9999,0,9999,0
1667936497987,CSE 293,003,119122,Berg-Kirkpatrick; Taylor D,9999,0,9999,0
1667936497987,CSE 293,004,119135,Christensen; Henrik I,9999,0,9999,0
1667936497987,CSE 293,005,119142,Cottrell; Garrison W,9999,0,9999,0
1667936497987,CSE 293,006,119146,Deutsch; Alin Bernard,9999,0,9999,0
1667936497987,CSE 293,007,119159,Esmaeilzadeh; Hadi,9999,0,9999,0
1667936497987,CSE 293,008,119166,Freund; Yoav,9999,0,9999,0
1667936497987,CSE 293,009,119170,Griswold; William G.,9999,0,9999,0
1667936497987,CSE 293,010,119183,Gymrek; Melissa Ann,9999,0,9999,0
1667936497987,CSE 293,011,119190,Heninger; Nadia A,9999,0,9999,0
1667936497987,CSE 293,012,119230,Impagliazzo; Russell,9999,0,9999,0
1667936497987,CSE 293,013,119232,Jhala; Ranjit,9999,0,9999,0
1667936497987,CSE 293,014,119233,Kahng; Andrew Byun,9999,0,9999,0
1667936497987,CSE 293,015,119298,Kane; Daniel Mertz,9999,0,9999,0
1667936497987,CSE 293,016,119299,Kriegman; David J,9999,0,9999,0
1667936497987,CSE 293,017,119300,Kumar; Arun Kumar,9999,0,9999,0
1667936497987,CSE 293,018,119301,Lerner; Sorin,9999,0,9999,0
1667936497987,CSE 293,019,119302,Lovett; Shachar,9999,0,9999,0
1667936497987,CSE 293,020,119303,McAuley; Julian John,9999,0,9999,0
1667936497987,CSE 293,021,119304,Micciancio; Daniele,9999,0,9999,0
1667936497987,CSE 293,022,119367,Orailoglu; Alex,9999,0,9999,0
1667936497987,CSE 293,023,119382,Paturi; Ramamohan,9999,0,9999,0
1667936497987,CSE 293,024,119404,Polikarpova; Nadezhda,9999,0,9999,0
1667936497987,CSE 293,025,119406,Politz; Joseph Gibbs,9999,0,9999,0
1667936497987,CSE 293,026,119411,Porter; George M,9999,0,9999,0
1667936497987,CSE 293,027,119414,Porter; Leonard Emerson,9999,0,9999,0
1667936497987,CSE 293,028,119416,Ramamoorthi; Ravi,9999,0,9999,0
1667936497987,CSE 293,029,119417,Sahoo; Debashis,9999,0,9999,0
1667936497987,CSE 293,030,119420,Saul; Lawrence,9999,0,9999,0
1667936497987,CSE 293,031,119421,Savage; Stefan,9999,0,9999,0
1667936497987,CSE 293,032,119425,Schulze; Jurgen P.,9999,0,9999,0
1667936497987,CSE 293,033,119426,Snoeren; Alex C.,9999,0,9999,0
1667936497987,CSE 293,034,119428,Shang; Jingbo,9999,0,9999,0
1667936497987,CSE 293,035,119430,Stefan; Deian,9999,0,9999,0
1667936497987,CSE 293,036,119431,Su; Hao,9999,0,9999,0
1667936497987,CSE 293,037,119433,Swanson; Steven James,9999,0,9999,0
1667936497987,CSE 293,038,119435,Tullsen; Dean Michael,9999,0,9999,0
1667936497987,CSE 293,039,119483,Voelker; Geoffrey M.,9999,0,9999,0
1667936497987,CSE 293,040,119537,Zhao; Jishen,9999,0,9999,0
1667936497987,CSE 293,041,119538,Zhou; Yuan-Yuan,9999,0,9999,0
1667936497987,CSE 293,042,119539,Gao; Sicun,9999,0,9999,0
1667936497987,CSE 293,043,119540,Weibel; Nadir,9999,0,9999,0
1667936497987,CSE 293,044,119541,Gupta; Rajesh K.,9999,0,9999,0
1667936498412,CSE 294,A00,102459,Voelker; Geoffrey M.,0,0,0,0
1667936498412,CSE 294,B00,111322,Orailoglu; Alex,0,0,0,0
1667936498834,DSE 201,A00,096914,Deutsch; Alin Bernard,30,0,30,0
1667936499264,DSE 210,A00,096915,Dasgupta; Sanjoy,30,0,30,0
1667936499689,DSE 260A,A00,096916,Altintas De Callaf; Ilkay,30,0,30,0
1667936500148,ECE 200,001,103586,Antipa; Nicholas A,9999,0,9999,0
1667936500148,ECE 200,002,103587,Atanasov; Nikolay A.,9999,0,9999,0
1667936500148,ECE 200,003,103588,Bharadia; Dinesh,9999,0,9999,0
1667936500148,ECE 200,004,103589,Cheng; Chung Kuan,9999,0,9999,0
1667936500148,ECE 200,005,103590,Cosman; Pamela C.,9999,0,9999,0
1667936500148,ECE 200,006,103591,Dayeh; Shadi Ahmad,9999,0,9999,0
1667936500148,ECE 200,007,103592,Fainman; Yeshaiahu,9999,0,9999,0
1667936500148,ECE 200,008,103593,Ford; Joseph Earl,9999,0,9999,0
1667936500148,ECE 200,009,103594,Franceschetti; Massimo,9999,0,9999,0
1667936500148,ECE 200,010,103595,Fullerton; Eric E,9999,0,9999,0
1667936500148,ECE 200,011,103596,Galton; Ian A,9999,0,9999,0
1667936500148,ECE 200,012,103597,Gilja; Vikash,9999,0,9999,0
1667936500148,ECE 200,013,103598,Hall; Drew A.,9999,0,9999,0
1667936500148,ECE 200,014,103599,Hsueh; Tzu-Chien,9999,0,9999,0
1667936500148,ECE 200,015,103600,Javidi; Tara,9999,0,9999,0
1667936500148,ECE 200,016,103601,Kahng; Andrew Byun,9999,0,9999,0
1667936500148,ECE 200,017,103602,Kim; Young-Han,9999,0,9999,0
1667936500148,ECE 200,018,103603,Koushanfar; Farinaz,9999,0,9999,0
1667936500148,ECE 200,019,103604,Kuzum; Duygu,9999,0,9999,0
1667936500148,ECE 200,020,103605,Le; Hanh-Phuc,9999,0,9999,0
1667936500148,ECE 200,021,103606,Lin; Bill,9999,0,9999,0
1667936500148,ECE 200,022,103607,Liu; Zhaowei,9998,0,9999,1
1667936500148,ECE 200,023,103608,Lo; Yu-Hwa,9999,0,9999,0
1667936500148,ECE 200,024,103609,Lomakin; Vitaliy,9999,0,9999,0
1667936500148,ECE 200,025,103610,Mercier; Patrick Philip,9999,0,9999,0
1667936500148,ECE 200,026,103611,Meyer; Florian,9999,0,9999,0
1667936500148,ECE 200,027,103612,Milstein; Laurence B.,9999,0,9999,0
1667936500148,ECE 200,028,103613,Mir Arabbaygi; Siavash,9999,0,9999,0
1667936500148,ECE 200,029,103614,Mookherjea; Shayan,9999,0,9999,0
1667936500148,ECE 200,030,103615,Morris; Karcher William,9999,0,9999,0
1667936500148,ECE 200,031,103616,Ng; Tse Nga,9999,0,9999,0
1667936500148,ECE 200,032,103617,Nguyen; Truong Quang,9999,0,9999,0
1667936500148,ECE 200,033,103618,Nomura; Kenji,9999,0,9999,0
1667936500148,ECE 200,034,103619,Orlitsky; Alon,9999,0,9999,0
1667936500148,ECE 200,035,103620,Pal; Piya,9999,0,9999,0
1667936500148,ECE 200,036,103621,Papen; George C.,9999,0,9999,0
1667936500148,ECE 200,037,103622,Radic; Stojan,9999,0,9999,0
1667936500148,ECE 200,038,103623,Rao; Bhaskar D.,9999,0,9999,0
1667936500148,ECE 200,039,103624,Rao; Ramesh R,9999,0,9999,0
1667936500148,ECE 200,040,103625,Rebeiz; Gabriel,9999,0,9999,0
1667936500148,ECE 200,041,103626,Sanford; John R,9999,0,9999,0
1667936500148,ECE 200,042,103627,Siegel; Paul H.,9999,0,9999,0
1667936500148,ECE 200,043,103628,Sievenpiper; Daniel F.,9999,0,9999,0
1667936500148,ECE 200,044,103629,Sworder; David D.,9999,0,9999,0
1667936500148,ECE 200,045,103630,Taur; Yuan,9999,0,9999,0
1667936500148,ECE 200,046,103631,Touri; Behrouz,9999,0,9999,0
1667936500148,ECE 200,047,103632,Trivedi; Mohan M.,9999,0,9999,0
1667936500148,ECE 200,048,103633,Vasconcelos; Nuno,9999,0,9999,0
1667936500148,ECE 200,049,103634,Wang; Xiaolong,9999,0,9999,0
1667936500148,ECE 200,050,103635,Xie; Pengtao,9999,0,9999,0
1667936500148,ECE 200,051,103636,Yip; Michael,9999,0,9999,0
1667936500148,ECE 200,052,103637,Zeger; Kenneth A.,999,0,999,0
1667936500148,ECE 200,053,103638,Zhang; Xinyu,9999,0,9999,0
1667936500148,ECE 200,054,103639,Turakhia; Yatish Girish,9999,0,9999,0
1667936500148,ECE 200,055,103640,Kang; Mingu,9999,0,9999,0
1667936500148,ECE 200,056,103641,Shi; Yuanyuan,9999,0,9999,0
1667936500148,ECE 200,057,103642,Wang; Edward Jay,9999,0,9999,0
1667936500148,ECE 200,058,103643,Zheng; Yang,9999,0,9999,0
1667936500571,ECE 202,A00,103644,Kuzum; Duygu,0,0,0,0
1667936500993,ECE 212BN,A00,103646,Ng; Tse Nga,0,0,0,0
1667936501417,ECE 221,A00,111493,Staff,0,0,0,0
1667936501840,ECE 222B,A00,103647,Lomakin; Vitaliy,0,0,0,0
1667936502264,ECE 230B,A00,103648,Taur; Yuan,0,0,0,0
1667936502696,ECE 238B,A00,103649,Garay; Javier,0,0,0,0
1667936503129,ECE 240B,A00,112900,Fainman; Yeshaiahu,0,0,0,0
1667936503563,ECE 247A,A00,103650,Jokerst; Jesse Vincent,0,0,0,0
1667936503987,ECE 247B,A00,103651,Wang; Joseph,0,0,0,0
1667936504410,ECE 250,A00,103652,Siegel; Paul H.,0,0,0,0
1667936504835,ECE 251A,A00,103654,Rao; Bhaskar D.,0,0,0,0
1667936505260,ECE 257B,A00,103655,Bharadia; Dinesh,0,0,0,0
1667936505688,ECE 258A,A00,103656,Milstein; Laurence B.,0,0,0,0
1667936506110,ECE 260B,A00,103658,Kang; Mingu,0,0,0,0
1667936506546,ECE 264A,A00,103659,Galton; Ian A,0,0,0,0
1667936506968,ECE 265A,A00,103661,Gudem; Prasad S.S.,0,0,0,0
1667936507402,ECE 265D,A00,103662,Gudem; Prasad S.S.,0,0,0,0
1667936507837,ECE 268,A00,103663,Koushanfar; Farinaz,0,0,0,0
1667936508265,ECE 269,A01,103665,Pal; Piya,0,0,0,0
1667936508687,ECE 271B,A00,103666,Vasconcelos; Manuela,0,0,0,0
1667936509119,ECE 276A,A00,103667,Atanasov; Nikolay A.,0,0,0,0
1667936509545,ECE 277,A00,103668,An; Cheolhong,0,0,0,0
1667936509976,ECE 279,A00,117947,Hall; Drew A.,0,0,0,0
1667936510831,ECE 283,A00,103670,Hsueh; Tzu-Chien,0,0,0,0
1667936511256,ECE 284,A00,103671,Turakhia; Yatish Girish,0,0,0,0
1667936511684,ECE 285,A00,103672,Zheng; Yang,0,0,0,0
1667936511684,ECE 285,B00,103673,Sworder; David D.,0,0,0,0
1667936512115,ECE 287,A00,103676,Javidi; Tara,0,0,0,0
1667936512543,MATH 200B,A00,098023,Salehi Golsefidy; Alireza,14,0,15,1
1667936512967,MATH 202B,A00,098024,Rhoades; Brendon Patrick,13,0,15,2
1667936513391,MATH 203B,A00,098025,Oprea; Dragos N.,14,0,15,1
1667936513827,MATH 204B,A00,098026,Sorensen; Claus M,15,0,15,0
1667936514253,MATH 208,A00,098027,Izadi; Elham,7,0,10,3
1667936514677,MATH 209,A00,098028,Pollack; Aaron,10,0,10,0
1667936515112,MATH 211A,A00,112919,Rogalski; Daniel,10,0,10,0
1667936515547,MATH 211B,A00,112920,Seward; Brandon M.,10,0,10,0
1667936515977,MATH 218,A00,098029,Li; Bo,10,0,10,0
1667936516401,MATH 220B,A00,098030,Novak; Jonathan I,14,0,15,1
1667936516825,MATH 221A,A00,098031,Ebenfelt; Peter F,14,0,15,1
1667936517247,MATH 231B,A00,098032,Zlatos; Andrej,14,0,15,1
1667936517681,MATH 240B,A00,098033,Ni; Lei,11,0,15,4
1667936518103,MATH 243,A00,098034,Jekel; David Andrew,10,0,10,0
1667936518526,MATH 245A,A00,098035,Nie; Jiawang,4,0,15,11
1667936518950,MATH 248,A00,098036,Bejenaru; Ioan,10,0,10,0
1667936519382,MATH 250B,A00,098037,Spolaor; Luca,14,0,15,1
1667936519804,MATH 258,A00,098038,Ni; Lei,10,0,10,0
1667936520237,MATH 264B,A00,098041,Rhoades; Brendon Patrick,13,0,15,2
1667936520660,MATH 268,A00,098042,Buss; Samuel R,10,0,10,0
1667936521095,MATH 269,A00,098043,Rhoades; Brendon Patrick,10,0,10,0
1667936521528,MATH 270B,A00,098044,Li; Bo,11,0,15,4
1667936522045,MATH 272B,A00,098045,Holst; Michael J,13,0,15,2
1667936522479,MATH 273A,A00,098046,Tian; Xiaochuan,12,0,15,3
1667936522923,MATH 275,A01,098048,Tian; Xiaochuan,6,0,10,4
1667936523346,MATH 278A,A00,098049,Holst; Michael J,8,0,10,2
1667936523777,MATH 278B,A00,098050,Cloninger; Alexander,10,0,10,0
1667936524200,MATH 278C,A00,098051,Nie; Jiawang,8,0,10,2
1667936524650,MATH 280B,A00,098052,Zheng; Tianyi,12,0,15,3
1667936525078,MATH 281B,A00,098053,Bradic; Jelena,4,0,15,11
1667936525503,MATH 282B,A00,098054,Arias-Castro; Ery,2,0,15,13
1667936525932,MATH 285,A00,098055,Fitzsimmons; Patrick J,2,0,15,13
1667936526357,MATH 287B,A00,098056,Arias-Castro; Ery,9,0,15,6
1667936526796,MATH 288,A00,098057,Agarwal; Pooja,9,0,10,1
1667936526796,MATH 288,B00,098058,Zhang; Danna,9,0,10,1
1667936526796,MATH 288,C00,098059,Williams; Ruth J,10,0,10,0
1667936527219,MATH 290B,A00,098060,Roberts; Justin Deritter,14,0,15,1
1667936527641,MATH 292,A00,098061,Belmont; Eva Kinoshita,10,0,10,0
1667936528063,MATH 295,A00,098062,Suk; Andrew Hoon,48,0,50,2
1667936528487,MATH 296,A00,098063,Novak; Jonathan I,20,0,20,0
1667936528915,MATH 297,001,098064,Gamst; Anthony Collins,9997,0,9999,2
1667937031493,COGS 205,A00,101395,Chiba; Andrea,19,0,20,1
1667937031925,COGS 210B,001,101404,Greene; Deanna Jacquelyn,9998,0,9999,1
1667937031925,COGS 210B,002,101417,Xia; Haijun,9999,0,9999,0
1667937031925,COGS 210B,003,101422,Nitz; Douglas A.,9999,0,9999,0
1667937031925,COGS 210B,004,101423,Hollan; James D.,9998,0,9999,1
1667937031925,COGS 210B,005,101424,Deak; Gedeon O.,9999,0,9999,0
1667937031925,COGS 210B,006,101425,Rossano; Federico,9999,0,9999,0
1667937032347,COGS 211B,A00,101427,Coulson; Seana M,9997,0,9999,2
1667937032773,COGS 220,A00,101428,Hollan; James D.,0,0,25,25
1667937033203,COGS 229,A00,101429,Dow; Steven P,19,0,25,6
1667937033628,COGS 230,A00,101430,Klemmer; Scott R,13,0,17,4
1667937034064,COGS 234,A00,101431,Xia; Haijun,10,0,25,15
1667937034491,COGS 260,A00,101432,Kiyonaga; Anastasia,20,0,25,5
1667937034491,COGS 260,B00,101433,Kirsh; David Joel,17,0,25,8
1667937034916,CSE 202,A00,102371,Impagliazzo; Russell,0,0,0,0
1667937035343,CSE 203B,A01,102373,Cheng; Chung Kuan,0,0,0,0
1667937035777,CSE 208,A00,102374,Micciancio; Daniele,0,0,0,0
1667937036200,CSE 209A,A00,112895,Impagliazzo; Russell,0,0,15,15
1667937036623,CSE 209B,A00,108005,Bellare; Mihir,0,0,0,0
1667937037050,CSE 210,A00,113163,Coblenz; Michael J,0,0,0,0
1667937037473,CSE 219,A00,106111,Dow; Steven P,0,0,20,20
1667937037897,CSE 221,A00,102376,Voelker; Geoffrey M.,0,0,0,0
1667937038321,CSE 224,A01,102378,Porter; George M,0,0,0,0
1667937038743,CSE 229A,A00,102379,Savage; Stefan,0,0,0,0
1667937039172,CSE 229C,A00,102380,Munyaka; Imani N. S.,0,0,0,0
1667937039599,CSE 232B,A00,102382,Deutsch; Alin Bernard,0,0,0,0
1667937040023,CSE 234,A01,112904,Kumar; Arun Kumar,0,0,0,0
1667937040452,CSE 237A,A00,102383,Rosing; Tajana Simunic,0,0,0,0
1667937040878,CSE 239A,A00,102384,Deutsch; Alin Bernard,0,0,0,0
1667937041299,CSE 239B,A00,102385,Polikarpova; Nadezhda,0,0,0,0
1667937041735,CSE 240A,A00,102386,Pannuto; Patrick William,0,0,0,0
1667937042168,CSE 240B,A00,102387,Zhao; Jishen,0,0,0,0
1667937042604,CSE 241A,A00,106406,Kang; Mingu,0,0,0,0
1667937043030,CSE 249B,A00,102388,Kahng; Andrew Byun,0,0,8,8
1667937043451,CSE 251B,A01,102392,Cottrell; Garrison W,0,0,0,0
1667937043451,CSE 251B,A02,102393,Cottrell; Garrison W,0,0,0,0
1667937043874,CSE 252B,A00,102394,Ochoa; Benjamin Lawrence,0,0,0,0
1667937044305,CSE 257,A01,102396,Gao; Sicun,0,0,0,0
1667937044824,CSE 272,A00,102397,Li; Tzumao,0,0,0,0
1667937045254,CSE 274,A00,111323,Chern; Albert Ren-Haur,0,0,0,0
1667937045694,CSE 282,A00,102398,Pevzner; Pavel Arkadjevich,0,0,0,0
1667937046120,CSE 284,A00,114175,Gymrek; Melissa Ann,0,0,0,0
1667937046547,CSE 290,A00,102399,Chandraker; Manmohan Krishna,0,0,0,0
1667937046547,CSE 290,B00,102400,Vaccaro; Kristen Marie,0,0,25,25
1667937046547,CSE 290,C00,102414,Pannuto; Patrick William,1,0,25,24
1667937046547,CSE 290,D00,102427,Pevzner; Pavel Arkadjevich,0,0,0,0
1667937046547,CSE 290,E00,102429,Zhao; Jishen,0,0,0,0
1667937046547,CSE 290,F00,102436,Tullsen; Dean Michael,0,0,0,0
1667937046547,CSE 290,G00,102440,Christensen; Henrik I,0,0,20,20
1667937046970,CSE 291,A00,102443,Su; Hao,0,0,0,0
1667937046970,CSE 291,B00,102448,Polikarpova; Nadezhda,0,0,0,0
1667937046970,CSE 291,C00,102453,Vaccaro; Kristen Marie,0,0,0,0
1667937046970,CSE 291,D00,111343,Savage; Stefan,0,0,0,0
1667937046970,CSE 291,E00,116474,Claffy; Kimberly Claire,0,0,0,0
1667937046970,CSE 291,F00,116479,Pasquale; Joseph,0,0,0,0
1667937047416,CSE 293,001,119111,Bafna; Vineet,9999,0,9999,0
1667937047416,CSE 293,002,119118,Bellare; Mihir,9999,0,9999,0
1667937047416,CSE 293,003,119122,Berg-Kirkpatrick; Taylor D,9999,0,9999,0
1667937047416,CSE 293,004,119135,Christensen; Henrik I,9999,0,9999,0
1667937047416,CSE 293,005,119142,Cottrell; Garrison W,9999,0,9999,0
1667937047416,CSE 293,006,119146,Deutsch; Alin Bernard,9999,0,9999,0
1667937047416,CSE 293,007,119159,Esmaeilzadeh; Hadi,9999,0,9999,0
1667937047416,CSE 293,008,119166,Freund; Yoav,9999,0,9999,0
1667937047416,CSE 293,009,119170,Griswold; William G.,9999,0,9999,0
1667937047416,CSE 293,010,119183,Gymrek; Melissa Ann,9999,0,9999,0
1667937047416,CSE 293,011,119190,Heninger; Nadia A,9999,0,9999,0
1667937047416,CSE 293,012,119230,Impagliazzo; Russell,9999,0,9999,0
1667937047416,CSE 293,013,119232,Jhala; Ranjit,9999,0,9999,0
1667937047416,CSE 293,014,119233,Kahng; Andrew Byun,9999,0,9999,0
1667937047416,CSE 293,015,119298,Kane; Daniel Mertz,9999,0,9999,0
1667937047416,CSE 293,016,119299,Kriegman; David J,9999,0,9999,0
1667937047416,CSE 293,017,119300,Kumar; Arun Kumar,9999,0,9999,0
1667937047416,CSE 293,018,119301,Lerner; Sorin,9999,0,9999,0
1667937047416,CSE 293,019,119302,Lovett; Shachar,9999,0,9999,0
1667937047416,CSE 293,020,119303,McAuley; Julian John,9999,0,9999,0
1667937047416,CSE 293,021,119304,Micciancio; Daniele,9999,0,9999,0
1667937047416,CSE 293,022,119367,Orailoglu; Alex,9999,0,9999,0
1667937047416,CSE 293,023,119382,Paturi; Ramamohan,9999,0,9999,0
1667937047416,CSE 293,024,119404,Polikarpova; Nadezhda,9999,0,9999,0
1667937047416,CSE 293,025,119406,Politz; Joseph Gibbs,9999,0,9999,0
1667937047416,CSE 293,026,119411,Porter; George M,9999,0,9999,0
1667937047416,CSE 293,027,119414,Porter; Leonard Emerson,9999,0,9999,0
1667937047416,CSE 293,028,119416,Ramamoorthi; Ravi,9999,0,9999,0
1667937047416,CSE 293,029,119417,Sahoo; Debashis,9999,0,9999,0
1667937047416,CSE 293,030,119420,Saul; Lawrence,9999,0,9999,0
1667937047416,CSE 293,031,119421,Savage; Stefan,9999,0,9999,0
1667937047416,CSE 293,032,119425,Schulze; Jurgen P.,9999,0,9999,0
1667937047416,CSE 293,033,119426,Snoeren; Alex C.,9999,0,9999,0
1667937047416,CSE 293,034,119428,Shang; Jingbo,9999,0,9999,0
1667937047416,CSE 293,035,119430,Stefan; Deian,9999,0,9999,0
1667937047416,CSE 293,036,119431,Su; Hao,9999,0,9999,0
1667937047416,CSE 293,037,119433,Swanson; Steven James,9999,0,9999,0
1667937047416,CSE 293,038,119435,Tullsen; Dean Michael,9999,0,9999,0
1667937047416,CSE 293,039,119483,Voelker; Geoffrey M.,9999,0,9999,0
1667937047416,CSE 293,040,119537,Zhao; Jishen,9999,0,9999,0
1667937047416,CSE 293,041,119538,Zhou; Yuan-Yuan,9999,0,9999,0
1667937047416,CSE 293,042,119539,Gao; Sicun,9999,0,9999,0
1667937047416,CSE 293,043,119540,Weibel; Nadir,9999,0,9999,0
1667937047416,CSE 293,044,119541,Gupta; Rajesh K.,9999,0,9999,0
1667937047843,CSE 294,A00,102459,Voelker; Geoffrey M.,0,0,0,0
1667937047843,CSE 294,B00,111322,Orailoglu; Alex,0,0,0,0
1667937048289,DSE 201,A00,096914,Deutsch; Alin Bernard,30,0,30,0
1667937048714,DSE 210,A00,096915,Dasgupta; Sanjoy,30,0,30,0
1667937049138,DSE 260A,A00,096916,Altintas De Callaf; Ilkay,30,0,30,0
1667937049569,ECE 200,001,103586,Antipa; Nicholas A,9999,0,9999,0
1667937049569,ECE 200,002,103587,Atanasov; Nikolay A.,9999,0,9999,0
1667937049569,ECE 200,003,103588,Bharadia; Dinesh,9999,0,9999,0
1667937049569,ECE 200,004,103589,Cheng; Chung Kuan,9999,0,9999,0
1667937049569,ECE 200,005,103590,Cosman; Pamela C.,9999,0,9999,0
1667937049569,ECE 200,006,103591,Dayeh; Shadi Ahmad,9999,0,9999,0
1667937049569,ECE 200,007,103592,Fainman; Yeshaiahu,9999,0,9999,0
1667937049569,ECE 200,008,103593,Ford; Joseph Earl,9999,0,9999,0
1667937049569,ECE 200,009,103594,Franceschetti; Massimo,9999,0,9999,0
1667937049569,ECE 200,010,103595,Fullerton; Eric E,9999,0,9999,0
1667937049569,ECE 200,011,103596,Galton; Ian A,9999,0,9999,0
1667937049569,ECE 200,012,103597,Gilja; Vikash,9999,0,9999,0
1667937049569,ECE 200,013,103598,Hall; Drew A.,9999,0,9999,0
1667937049569,ECE 200,014,103599,Hsueh; Tzu-Chien,9999,0,9999,0
1667937049569,ECE 200,015,103600,Javidi; Tara,9999,0,9999,0
1667937049569,ECE 200,016,103601,Kahng; Andrew Byun,9999,0,9999,0
1667937049569,ECE 200,017,103602,Kim; Young-Han,9999,0,9999,0
1667937049569,ECE 200,018,103603,Koushanfar; Farinaz,9999,0,9999,0
1667937049569,ECE 200,019,103604,Kuzum; Duygu,9999,0,9999,0
1667937049569,ECE 200,020,103605,Le; Hanh-Phuc,9999,0,9999,0
1667937049569,ECE 200,021,103606,Lin; Bill,9999,0,9999,0
1667937049569,ECE 200,022,103607,Liu; Zhaowei,9998,0,9999,1
1667937049569,ECE 200,023,103608,Lo; Yu-Hwa,9999,0,9999,0
1667937049569,ECE 200,024,103609,Lomakin; Vitaliy,9999,0,9999,0
1667937049569,ECE 200,025,103610,Mercier; Patrick Philip,9999,0,9999,0
1667937049569,ECE 200,026,103611,Meyer; Florian,9999,0,9999,0
1667937049569,ECE 200,027,103612,Milstein; Laurence B.,9999,0,9999,0
1667937049569,ECE 200,028,103613,Mir Arabbaygi; Siavash,9999,0,9999,0
1667937049569,ECE 200,029,103614,Mookherjea; Shayan,9999,0,9999,0
1667937049569,ECE 200,030,103615,Morris; Karcher William,9999,0,9999,0
1667937049569,ECE 200,031,103616,Ng; Tse Nga,9999,0,9999,0
1667937049569,ECE 200,032,103617,Nguyen; Truong Quang,9999,0,9999,0
1667937049569,ECE 200,033,103618,Nomura; Kenji,9999,0,9999,0
1667937049569,ECE 200,034,103619,Orlitsky; Alon,9999,0,9999,0
1667937049569,ECE 200,035,103620,Pal; Piya,9999,0,9999,0
1667937049569,ECE 200,036,103621,Papen; George C.,9999,0,9999,0
1667937049569,ECE 200,037,103622,Radic; Stojan,9999,0,9999,0
1667937049569,ECE 200,038,103623,Rao; Bhaskar D.,9999,0,9999,0
1667937049569,ECE 200,039,103624,Rao; Ramesh R,9999,0,9999,0
1667937049569,ECE 200,040,103625,Rebeiz; Gabriel,9999,0,9999,0
1667937049569,ECE 200,041,103626,Sanford; John R,9999,0,9999,0
1667937049569,ECE 200,042,103627,Siegel; Paul H.,9999,0,9999,0
1667937049569,ECE 200,043,103628,Sievenpiper; Daniel F.,9999,0,9999,0
1667937049569,ECE 200,044,103629,Sworder; David D.,9999,0,9999,0
1667937049569,ECE 200,045,103630,Taur; Yuan,9999,0,9999,0
1667937049569,ECE 200,046,103631,Touri; Behrouz,9999,0,9999,0
1667937049569,ECE 200,047,103632,Trivedi; Mohan M.,9999,0,9999,0
1667937049569,ECE 200,048,103633,Vasconcelos; Nuno,9999,0,9999,0
1667937049569,ECE 200,049,103634,Wang; Xiaolong,9999,0,9999,0
1667937049569,ECE 200,050,103635,Xie; Pengtao,9999,0,9999,0
1667937049569,ECE 200,051,103636,Yip; Michael,9999,0,9999,0
1667937049569,ECE 200,052,103637,Zeger; Kenneth A.,999,0,999,0
1667937049569,ECE 200,053,103638,Zhang; Xinyu,9999,0,9999,0
1667937049569,ECE 200,054,103639,Turakhia; Yatish Girish,9999,0,9999,0
1667937049569,ECE 200,055,103640,Kang; Mingu,9999,0,9999,0
1667937049569,ECE 200,056,103641,Shi; Yuanyuan,9999,0,9999,0
1667937049569,ECE 200,057,103642,Wang; Edward Jay,9999,0,9999,0
1667937049569,ECE 200,058,103643,Zheng; Yang,9999,0,9999,0
1667937050002,ECE 202,A00,103644,Kuzum; Duygu,0,0,0,0
1667937050428,ECE 212BN,A00,103646,Ng; Tse Nga,0,0,0,0
1667937050853,ECE 221,A00,111493,Staff,0,0,0,0
1667937051275,ECE 222B,A00,103647,Lomakin; Vitaliy,0,0,0,0
1667937051696,ECE 230B,A00,103648,Taur; Yuan,0,0,0,0
1667937052124,ECE 238B,A00,103649,Garay; Javier,0,0,0,0
1667937052547,ECE 240B,A00,112900,Fainman; Yeshaiahu,0,0,0,0
1667937052976,ECE 247A,A00,103650,Jokerst; Jesse Vincent,0,0,0,0
1667937053401,ECE 247B,A00,103651,Wang; Joseph,0,0,0,0
1667937053830,ECE 250,A00,103652,Siegel; Paul H.,0,0,0,0
1667937054258,ECE 251A,A00,103654,Rao; Bhaskar D.,0,0,0,0
1667937054687,ECE 257B,A00,103655,Bharadia; Dinesh,0,0,0,0
1667937055114,ECE 258A,A00,103656,Milstein; Laurence B.,0,0,0,0
1667937055543,ECE 260B,A00,103658,Kang; Mingu,0,0,0,0
1667937055976,ECE 264A,A00,103659,Galton; Ian A,0,0,0,0
1667937056403,ECE 265A,A00,103661,Gudem; Prasad S.S.,0,0,0,0
1667937056824,ECE 265D,A00,103662,Gudem; Prasad S.S.,0,0,0,0
1667937057247,ECE 268,A00,103663,Koushanfar; Farinaz,0,0,0,0
1667937057669,ECE 269,A01,103665,Pal; Piya,0,0,0,0
1667937058093,ECE 271B,A00,103666,Vasconcelos; Manuela,0,0,0,0
1667937058532,ECE 276A,A00,103667,Atanasov; Nikolay A.,0,0,0,0
1667937058956,ECE 277,A00,103668,An; Cheolhong,0,0,0,0
1667937059379,ECE 279,A00,117947,Hall; Drew A.,0,0,0,0
1667937060228,ECE 283,A00,103670,Hsueh; Tzu-Chien,0,0,0,0
1667937060651,ECE 284,A00,103671,Turakhia; Yatish Girish,0,0,0,0
1667937061080,ECE 285,A00,103672,Zheng; Yang,0,0,0,0
1667937061080,ECE 285,B00,103673,Sworder; David D.,0,0,0,0
1667937061504,ECE 287,A00,103676,Javidi; Tara,0,0,0,0
1667937061930,MATH 200B,A00,098023,Salehi Golsefidy; Alireza,14,0,15,1
1667937062365,MATH 202B,A00,098024,Rhoades; Brendon Patrick,13,0,15,2
1667937062794,MATH 203B,A00,098025,Oprea; Dragos N.,14,0,15,1
1667937063217,MATH 204B,A00,098026,Sorensen; Claus M,15,0,15,0
1667937063638,MATH 208,A00,098027,Izadi; Elham,7,0,10,3
1667937064064,MATH 209,A00,098028,Pollack; Aaron,10,0,10,0
1667937064492,MATH 211A,A00,112919,Rogalski; Daniel,10,0,10,0
1667937064921,MATH 211B,A00,112920,Seward; Brandon M.,10,0,10,0
1667937065343,MATH 218,A00,098029,Li; Bo,10,0,10,0
1667937065767,MATH 220B,A00,098030,Novak; Jonathan I,14,0,15,1
1667937066192,MATH 221A,A00,098031,Ebenfelt; Peter F,14,0,15,1
1667937066618,MATH 231B,A00,098032,Zlatos; Andrej,14,0,15,1
1667937067054,MATH 240B,A00,098033,Ni; Lei,11,0,15,4
1667937067481,MATH 243,A00,098034,Jekel; David Andrew,10,0,10,0
1667937067903,MATH 245A,A00,098035,Nie; Jiawang,4,0,15,11
1667937068333,MATH 248,A00,098036,Bejenaru; Ioan,10,0,10,0
1667937068762,MATH 250B,A00,098037,Spolaor; Luca,14,0,15,1
1667937069196,MATH 258,A00,098038,Ni; Lei,10,0,10,0
1667937069620,MATH 264B,A00,098041,Rhoades; Brendon Patrick,13,0,15,2
1667937070059,MATH 268,A00,098042,Buss; Samuel R,10,0,10,0
1667937070483,MATH 269,A00,098043,Rhoades; Brendon Patrick,10,0,10,0
1667937070919,MATH 270B,A00,098044,Li; Bo,11,0,15,4
1667937071346,MATH 272B,A00,098045,Holst; Michael J,13,0,15,2
1667937071774,MATH 273A,A00,098046,Tian; Xiaochuan,12,0,15,3
1667937072197,MATH 275,A01,098048,Tian; Xiaochuan,6,0,10,4
1667937072619,MATH 278A,A00,098049,Holst; Michael J,8,0,10,2
1667937073044,MATH 278B,A00,098050,Cloninger; Alexander,10,0,10,0
1667937073477,MATH 278C,A00,098051,Nie; Jiawang,8,0,10,2
1667937073916,MATH 280B,A00,098052,Zheng; Tianyi,12,0,15,3
1667937074343,MATH 281B,A00,098053,Bradic; Jelena,4,0,15,11
1667937074767,MATH 282B,A00,098054,Arias-Castro; Ery,2,0,15,13
1667937075193,MATH 285,A00,098055,Fitzsimmons; Patrick J,2,0,15,13
1667937075624,MATH 287B,A00,098056,Arias-Castro; Ery,9,0,15,6
1667937076047,MATH 288,A00,098057,Agarwal; Pooja,9,0,10,1
1667937076047,MATH 288,B00,098058,Zhang; Danna,9,0,10,1
1667937076047,MATH 288,C00,098059,Williams; Ruth J,10,0,10,0
1667937076477,MATH 290B,A00,098060,Roberts; Justin Deritter,14,0,15,1
1667937076907,MATH 292,A00,098061,Belmont; Eva Kinoshita,10,0,10,0
1667937077348,MATH 295,A00,098062,Suk; Andrew Hoon,48,0,50,2
1667937077770,MATH 296,A00,098063,Novak; Jonathan I,20,0,20,0
1667937078205,MATH 297,001,098064,Gamst; Anthony Collins,9997,0,9999,2
1667937581215,COGS 205,A00,101395,Chiba; Andrea,19,0,20,1
1667937581644,COGS 210B,001,101404,Greene; Deanna Jacquelyn,9998,0,9999,1
1667937581644,COGS 210B,002,101417,Xia; Haijun,9999,0,9999,0
1667937581644,COGS 210B,003,101422,Nitz; Douglas A.,9999,0,9999,0
1667937581644,COGS 210B,004,101423,Hollan; James D.,9998,0,9999,1
1667937581644,COGS 210B,005,101424,Deak; Gedeon O.,9999,0,9999,0
1667937581644,COGS 210B,006,101425,Rossano; Federico,9999,0,9999,0
1667937582065,COGS 211B,A00,101427,Coulson; Seana M,9997,0,9999,2
1667937582496,COGS 220,A00,101428,Hollan; James D.,0,0,25,25
1667937582923,COGS 229,A00,101429,Dow; Steven P,19,0,25,6
1667937583352,COGS 230,A00,101430,Klemmer; Scott R,13,0,17,4
1667937583786,COGS 234,A00,101431,Xia; Haijun,10,0,25,15
1667937584208,COGS 260,A00,101432,Kiyonaga; Anastasia,20,0,25,5
1667937584208,COGS 260,B00,101433,Kirsh; David Joel,17,0,25,8
1667937584634,CSE 202,A00,102371,Impagliazzo; Russell,0,0,0,0
1667937585060,CSE 203B,A01,102373,Cheng; Chung Kuan,0,0,0,0
1667937585484,CSE 208,A00,102374,Micciancio; Daniele,0,0,0,0
1667937585907,CSE 209A,A00,112895,Impagliazzo; Russell,0,0,15,15
1667937586353,CSE 209B,A00,108005,Bellare; Mihir,0,0,0,0
1667937586777,CSE 210,A00,113163,Coblenz; Michael J,0,0,0,0
1667937587198,CSE 219,A00,106111,Dow; Steven P,0,0,20,20
1667937587621,CSE 221,A00,102376,Voelker; Geoffrey M.,0,0,0,0
1667937588050,CSE 224,A01,102378,Porter; George M,0,0,0,0
1667937588474,CSE 229A,A00,102379,Savage; Stefan,0,0,0,0
1667937588898,CSE 229C,A00,102380,Munyaka; Imani N. S.,0,0,0,0
1667937589318,CSE 232B,A00,102382,Deutsch; Alin Bernard,0,0,0,0
1667937589742,CSE 234,A01,112904,Kumar; Arun Kumar,0,0,0,0
1667937590182,CSE 237A,A00,102383,Rosing; Tajana Simunic,0,0,0,0
1667937590612,CSE 239A,A00,102384,Deutsch; Alin Bernard,0,0,0,0
1667937591034,CSE 239B,A00,102385,Polikarpova; Nadezhda,0,0,0,0
1667937591463,CSE 240A,A00,102386,Pannuto; Patrick William,0,0,0,0
1667937591896,CSE 240B,A00,102387,Zhao; Jishen,0,0,0,0
1667937592321,CSE 241A,A00,106406,Kang; Mingu,0,0,0,0
1667937592744,CSE 249B,A00,102388,Kahng; Andrew Byun,0,0,8,8
1667937593170,CSE 251B,A01,102392,Cottrell; Garrison W,0,0,0,0
1667937593170,CSE 251B,A02,102393,Cottrell; Garrison W,0,0,0,0
1667937593620,CSE 252B,A00,102394,Ochoa; Benjamin Lawrence,0,0,0,0
1667937594046,CSE 257,A01,102396,Gao; Sicun,0,0,0,0
1667937594468,CSE 272,A00,102397,Li; Tzumao,0,0,0,0
1667937594890,CSE 274,A00,111323,Chern; Albert Ren-Haur,0,0,0,0
1667937595316,CSE 282,A00,102398,Pevzner; Pavel Arkadjevich,0,0,0,0
1667937595740,CSE 284,A00,114175,Gymrek; Melissa Ann,0,0,0,0
1667937596171,CSE 290,A00,102399,Chandraker; Manmohan Krishna,0,0,0,0
1667937596171,CSE 290,B00,102400,Vaccaro; Kristen Marie,0,0,25,25
1667937596171,CSE 290,C00,102414,Pannuto; Patrick William,1,0,25,24
1667937596171,CSE 290,D00,102427,Pevzner; Pavel Arkadjevich,0,0,0,0
1667937596171,CSE 290,E00,102429,Zhao; Jishen,0,0,0,0
1667937596171,CSE 290,F00,102436,Tullsen; Dean Michael,0,0,0,0
1667937596171,CSE 290,G00,102440,Christensen; Henrik I,0,0,20,20
1667937596599,CSE 291,A00,102443,Su; Hao,0,0,0,0
1667937596599,CSE 291,B00,102448,Polikarpova; Nadezhda,0,0,0,0
1667937596599,CSE 291,C00,102453,Vaccaro; Kristen Marie,0,0,0,0
1667937596599,CSE 291,D00,111343,Savage; Stefan,0,0,0,0
1667937596599,CSE 291,E00,116474,Claffy; Kimberly Claire,0,0,0,0
1667937596599,CSE 291,F00,116479,Pasquale; Joseph,0,0,0,0
1667937597028,CSE 293,001,119111,Bafna; Vineet,9999,0,9999,0
1667937597028,CSE 293,002,119118,Bellare; Mihir,9999,0,9999,0
1667937597028,CSE 293,003,119122,Berg-Kirkpatrick; Taylor D,9999,0,9999,0
1667937597028,CSE 293,004,119135,Christensen; Henrik I,9999,0,9999,0
1667937597028,CSE 293,005,119142,Cottrell; Garrison W,9999,0,9999,0
1667937597028,CSE 293,006,119146,Deutsch; Alin Bernard,9999,0,9999,0
1667937597028,CSE 293,007,119159,Esmaeilzadeh; Hadi,9999,0,9999,0
1667937597028,CSE 293,008,119166,Freund; Yoav,9999,0,9999,0
1667937597028,CSE 293,009,119170,Griswold; William G.,9999,0,9999,0
1667937597028,CSE 293,010,119183,Gymrek; Melissa Ann,9999,0,9999,0
1667937597028,CSE 293,011,119190,Heninger; Nadia A,9999,0,9999,0
1667937597028,CSE 293,012,119230,Impagliazzo; Russell,9999,0,9999,0
1667937597028,CSE 293,013,119232,Jhala; Ranjit,9999,0,9999,0
1667937597028,CSE 293,014,119233,Kahng; Andrew Byun,9999,0,9999,0
1667937597028,CSE 293,015,119298,Kane; Daniel Mertz,9999,0,9999,0
1667937597028,CSE 293,016,119299,Kriegman; David J,9999,0,9999,0
1667937597028,CSE 293,017,119300,Kumar; Arun Kumar,9999,0,9999,0
1667937597028,CSE 293,018,119301,Lerner; Sorin,9999,0,9999,0
1667937597028,CSE 293,019,119302,Lovett; Shachar,9999,0,9999,0
1667937597028,CSE 293,020,119303,McAuley; Julian John,9999,0,9999,0
1667937597028,CSE 293,021,119304,Micciancio; Daniele,9999,0,9999,0
1667937597028,CSE 293,022,119367,Orailoglu; Alex,9999,0,9999,0
1667937597028,CSE 293,023,119382,Paturi; Ramamohan,9999,0,9999,0
1667937597028,CSE 293,024,119404,Polikarpova; Nadezhda,9999,0,9999,0
1667937597028,CSE 293,025,119406,Politz; Joseph Gibbs,9999,0,9999,0
1667937597028,CSE 293,026,119411,Porter; George M,9999,0,9999,0
1667937597028,CSE 293,027,119414,Porter; Leonard Emerson,9999,0,9999,0
1667937597028,CSE 293,028,119416,Ramamoorthi; Ravi,9999,0,9999,0
1667937597028,CSE 293,029,119417,Sahoo; Debashis,9999,0,9999,0
1667937597028,CSE 293,030,119420,Saul; Lawrence,9999,0,9999,0
1667937597028,CSE 293,031,119421,Savage; Stefan,9999,0,9999,0
1667937597028,CSE 293,032,119425,Schulze; Jurgen P.,9999,0,9999,0
1667937597028,CSE 293,033,119426,Snoeren; Alex C.,9999,0,9999,0
1667937597028,CSE 293,034,119428,Shang; Jingbo,9999,0,9999,0
1667937597028,CSE 293,035,119430,Stefan; Deian,9999,0,9999,0
1667937597028,CSE 293,036,119431,Su; Hao,9999,0,9999,0
1667937597028,CSE 293,037,119433,Swanson; Steven James,9999,0,9999,0
1667937597028,CSE 293,038,119435,Tullsen; Dean Michael,9999,0,9999,0
1667937597028,CSE 293,039,119483,Voelker; Geoffrey M.,9999,0,9999,0
1667937597028,CSE 293,040,119537,Zhao; Jishen,9999,0,9999,0
1667937597028,CSE 293,041,119538,Zhou; Yuan-Yuan,9999,0,9999,0
1667937597028,CSE 293,042,119539,Gao; Sicun,9999,0,9999,0
1667937597028,CSE 293,043,119540,Weibel; Nadir,9999,0,9999,0
1667937597028,CSE 293,044,119541,Gupta; Rajesh K.,9999,0,9999,0
1667937597462,CSE 294,A00,102459,Voelker; Geoffrey M.,0,0,0,0
1667937597462,CSE 294,B00,111322,Orailoglu; Alex,0,0,0,0
1667937597898,DSE 201,A00,096914,Deutsch; Alin Bernard,30,0,30,0
1667937598322,DSE 210,A00,096915,Dasgupta; Sanjoy,30,0,30,0
1667937598747,DSE 260A,A00,096916,Altintas De Callaf; Ilkay,30,0,30,0
1667937599177,ECE 200,001,103586,Antipa; Nicholas A,9999,0,9999,0
1667937599177,ECE 200,002,103587,Atanasov; Nikolay A.,9999,0,9999,0
1667937599177,ECE 200,003,103588,Bharadia; Dinesh,9999,0,9999,0
1667937599177,ECE 200,004,103589,Cheng; Chung Kuan,9999,0,9999,0
1667937599177,ECE 200,005,103590,Cosman; Pamela C.,9999,0,9999,0
1667937599177,ECE 200,006,103591,Dayeh; Shadi Ahmad,9999,0,9999,0
1667937599177,ECE 200,007,103592,Fainman; Yeshaiahu,9999,0,9999,0
1667937599177,ECE 200,008,103593,Ford; Joseph Earl,9999,0,9999,0
1667937599177,ECE 200,009,103594,Franceschetti; Massimo,9999,0,9999,0
1667937599177,ECE 200,010,103595,Fullerton; Eric E,9999,0,9999,0
1667937599177,ECE 200,011,103596,Galton; Ian A,9999,0,9999,0
1667937599177,ECE 200,012,103597,Gilja; Vikash,9999,0,9999,0
1667937599177,ECE 200,013,103598,Hall; Drew A.,9999,0,9999,0
1667937599177,ECE 200,014,103599,Hsueh; Tzu-Chien,9999,0,9999,0
1667937599177,ECE 200,015,103600,Javidi; Tara,9999,0,9999,0
1667937599177,ECE 200,016,103601,Kahng; Andrew Byun,9999,0,9999,0
1667937599177,ECE 200,017,103602,Kim; Young-Han,9999,0,9999,0
1667937599177,ECE 200,018,103603,Koushanfar; Farinaz,9999,0,9999,0
1667937599177,ECE 200,019,103604,Kuzum; Duygu,9999,0,9999,0
1667937599177,ECE 200,020,103605,Le; Hanh-Phuc,9999,0,9999,0
1667937599177,ECE 200,021,103606,Lin; Bill,9999,0,9999,0
1667937599177,ECE 200,022,103607,Liu; Zhaowei,9998,0,9999,1
1667937599177,ECE 200,023,103608,Lo; Yu-Hwa,9999,0,9999,0
1667937599177,ECE 200,024,103609,Lomakin; Vitaliy,9999,0,9999,0
1667937599177,ECE 200,025,103610,Mercier; Patrick Philip,9999,0,9999,0
1667937599177,ECE 200,026,103611,Meyer; Florian,9999,0,9999,0
1667937599177,ECE 200,027,103612,Milstein; Laurence B.,9999,0,9999,0
1667937599177,ECE 200,028,103613,Mir Arabbaygi; Siavash,9999,0,9999,0
1667937599177,ECE 200,029,103614,Mookherjea; Shayan,9999,0,9999,0
1667937599177,ECE 200,030,103615,Morris; Karcher William,9999,0,9999,0
1667937599177,ECE 200,031,103616,Ng; Tse Nga,9999,0,9999,0
1667937599177,ECE 200,032,103617,Nguyen; Truong Quang,9999,0,9999,0
1667937599177,ECE 200,033,103618,Nomura; Kenji,9999,0,9999,0
1667937599177,ECE 200,034,103619,Orlitsky; Alon,9999,0,9999,0
1667937599177,ECE 200,035,103620,Pal; Piya,9999,0,9999,0
1667937599177,ECE 200,036,103621,Papen; George C.,9999,0,9999,0
1667937599177,ECE 200,037,103622,Radic; Stojan,9999,0,9999,0
1667937599177,ECE 200,038,103623,Rao; Bhaskar D.,9999,0,9999,0
1667937599177,ECE 200,039,103624,Rao; Ramesh R,9999,0,9999,0
1667937599177,ECE 200,040,103625,Rebeiz; Gabriel,9999,0,9999,0
1667937599177,ECE 200,041,103626,Sanford; John R,9999,0,9999,0
1667937599177,ECE 200,042,103627,Siegel; Paul H.,9999,0,9999,0
1667937599177,ECE 200,043,103628,Sievenpiper; Daniel F.,9999,0,9999,0
1667937599177,ECE 200,044,103629,Sworder; David D.,9999,0,9999,0
1667937599177,ECE 200,045,103630,Taur; Yuan,9999,0,9999,0
1667937599177,ECE 200,046,103631,Touri; Behrouz,9999,0,9999,0
1667937599177,ECE 200,047,103632,Trivedi; Mohan M.,9999,0,9999,0
1667937599177,ECE 200,048,103633,Vasconcelos; Nuno,9999,0,9999,0
1667937599177,ECE 200,049,103634,Wang; Xiaolong,9999,0,9999,0
1667937599177,ECE 200,050,103635,Xie; Pengtao,9999,0,9999,0
1667937599177,ECE 200,051,103636,Yip; Michael,9999,0,9999,0
1667937599177,ECE 200,052,103637,Zeger; Kenneth A.,999,0,999,0
1667937599177,ECE 200,053,103638,Zhang; Xinyu,9999,0,9999,0
1667937599177,ECE 200,054,103639,Turakhia; Yatish Girish,9999,0,9999,0
1667937599177,ECE 200,055,103640,Kang; Mingu,9999,0,9999,0
1667937599177,ECE 200,056,103641,Shi; Yuanyuan,9999,0,9999,0
1667937599177,ECE 200,057,103642,Wang; Edward Jay,9999,0,9999,0
1667937599177,ECE 200,058,103643,Zheng; Yang,9999,0,9999,0
1667937599603,ECE 202,A00,103644,Kuzum; Duygu,0,0,0,0
1667937600038,ECE 212BN,A00,103646,Ng; Tse Nga,0,0,0,0
1667937600463,ECE 221,A00,111493,Staff,0,0,0,0
1667937600899,ECE 222B,A00,103647,Lomakin; Vitaliy,0,0,0,0
1667937601328,ECE 230B,A00,103648,Taur; Yuan,0,0,0,0
1667937601753,ECE 238B,A00,103649,Garay; Javier,0,0,0,0
1667937602176,ECE 240B,A00,112900,Fainman; Yeshaiahu,0,0,0,0
1667937602626,ECE 247A,A00,103650,Jokerst; Jesse Vincent,0,0,0,0
1667937603058,ECE 247B,A00,103651,Wang; Joseph,0,0,0,0
1667937603485,ECE 250,A00,103652,Siegel; Paul H.,0,0,0,0
1667937603908,ECE 251A,A00,103654,Rao; Bhaskar D.,0,0,0,0
1667937604336,ECE 257B,A00,103655,Bharadia; Dinesh,0,0,0,0
1667937604910,ECE 258A,A00,103656,Milstein; Laurence B.,0,0,0,0
1667937605334,ECE 260B,A00,103658,Kang; Mingu,0,0,0,0
1667937605769,ECE 264A,A00,103659,Galton; Ian A,0,0,0,0
1667937606195,ECE 265A,A00,103661,Gudem; Prasad S.S.,0,0,0,0
1667937606622,ECE 265D,A00,103662,Gudem; Prasad S.S.,0,0,0,0
1667937607052,ECE 268,A00,103663,Koushanfar; Farinaz,0,0,0,0
1667937607481,ECE 269,A01,103665,Pal; Piya,0,0,0,0
1667937607909,ECE 271B,A00,103666,Vasconcelos; Manuela,0,0,0,0
1667937608333,ECE 276A,A00,103667,Atanasov; Nikolay A.,0,0,0,0
1667937608767,ECE 277,A00,103668,An; Cheolhong,0,0,0,0
1667937609199,ECE 279,A00,117947,Hall; Drew A.,0,0,0,0
1667937610102,ECE 283,A00,103670,Hsueh; Tzu-Chien,0,0,0,0
1667937610530,ECE 284,A00,103671,Turakhia; Yatish Girish,0,0,0,0
1667937610957,ECE 285,A00,103672,Zheng; Yang,0,0,0,0
1667937610957,ECE 285,B00,103673,Sworder; David D.,0,0,0,0
1667937611493,ECE 287,A00,103676,Javidi; Tara,0,0,0,0
1667937611917,MATH 200B,A00,098023,Salehi Golsefidy; Alireza,14,0,15,1
1667937612343,MATH 202B,A00,098024,Rhoades; Brendon Patrick,13,0,15,2
1667937612775,MATH 203B,A00,098025,Oprea; Dragos N.,14,0,15,1
1667937613199,MATH 204B,A00,098026,Sorensen; Claus M,15,0,15,0
1667937613632,MATH 208,A00,098027,Izadi; Elham,7,0,10,3
1667937614055,MATH 209,A00,098028,Pollack; Aaron,10,0,10,0
1667937614495,MATH 211A,A00,112919,Rogalski; Daniel,10,0,10,0
1667937614999,MATH 211B,A00,112920,Seward; Brandon M.,10,0,10,0
1667937615424,MATH 218,A00,098029,Li; Bo,10,0,10,0
1667937615876,MATH 220B,A00,098030,Novak; Jonathan I,14,0,15,1
1667937616310,MATH 221A,A00,098031,Ebenfelt; Peter F,14,0,15,1
1667937616741,MATH 231B,A00,098032,Zlatos; Andrej,14,0,15,1
1667937617170,MATH 240B,A00,098033,Ni; Lei,11,0,15,4
1667937617595,MATH 243,A00,098034,Jekel; David Andrew,10,0,10,0
1667937618041,MATH 245A,A00,098035,Nie; Jiawang,4,0,15,11
1667937618463,MATH 248,A00,098036,Bejenaru; Ioan,10,0,10,0
1667937618964,MATH 250B,A00,098037,Spolaor; Luca,14,0,15,1
1667937619386,MATH 258,A00,098038,Ni; Lei,10,0,10,0
1667937619828,MATH 264B,A00,098041,Rhoades; Brendon Patrick,13,0,15,2
1667937620292,MATH 268,A00,098042,Buss; Samuel R,10,0,10,0
1667937620721,MATH 269,A00,098043,Rhoades; Brendon Patrick,10,0,10,0
1667937621156,MATH 270B,A00,098044,Li; Bo,11,0,15,4
1667937621609,MATH 272B,A00,098045,Holst; Michael J,13,0,15,2
1667937622032,MATH 273A,A00,098046,Tian; Xiaochuan,12,0,15,3
1667937622454,MATH 275,A01,098048,Tian; Xiaochuan,6,0,10,4
1667937622882,MATH 278A,A00,098049,Holst; Michael J,8,0,10,2
1667937623308,MATH 278B,A00,098050,Cloninger; Alexander,10,0,10,0
1667937623747,MATH 278C,A00,098051,Nie; Jiawang,8,0,10,2
1667937624170,MATH 280B,A00,098052,Zheng; Tianyi,12,0,15,3
1667937624593,MATH 281B,A00,098053,Bradic; Jelena,4,0,15,11
1667937625016,MATH 282B,A00,098054,Arias-Castro; Ery,2,0,15,13
1667937625452,MATH 285,A00,098055,Fitzsimmons; Patrick J,1,0,15,14
1667937625876,MATH 287B,A00,098056,Arias-Castro; Ery,8,0,15,7
1667937626308,MATH 288,A00,098057,Agarwal; Pooja,9,0,10,1
1667937626308,MATH 288,B00,098058,Zhang; Danna,9,0,10,1
1667937626308,MATH 288,C00,098059,Williams; Ruth J,10,0,10,0
1667937626737,MATH 290B,A00,098060,Roberts; Justin Deritter,14,0,15,1
1667937627173,MATH 292,A00,098061,Belmont; Eva Kinoshita,10,0,10,0
1667937627602,MATH 295,A00,098062,Suk; Andrew Hoon,48,0,50,2
1667937628024,MATH 296,A00,098063,Novak; Jonathan I,20,0,20,0
1667937628464,MATH 297,001,098064,Gamst; Anthony Collins,9997,0,9999,2
1667938130795,COGS 205,A00,101395,Chiba; Andrea,19,0,20,1
1667938131223,COGS 210B,001,101404,Greene; Deanna Jacquelyn,9998,0,9999,1
1667938131223,COGS 210B,002,101417,Xia; Haijun,9999,0,9999,0
1667938131223,COGS 210B,003,101422,Nitz; Douglas A.,9999,0,9999,0
1667938131223,COGS 210B,004,101423,Hollan; James D.,9998,0,9999,1
1667938131223,COGS 210B,005,101424,Deak; Gedeon O.,9999,0,9999,0
1667938131223,COGS 210B,006,101425,Rossano; Federico,9999,0,9999,0
1667938131644,COGS 211B,A00,101427,Coulson; Seana M,9997,0,9999,2
1667938132070,COGS 220,A00,101428,Hollan; James D.,0,0,25,25
1667938132506,COGS 229,A00,101429,Dow; Steven P,19,0,25,6
1667938132931,COGS 230,A00,101430,Klemmer; Scott R,13,0,17,4
1667938133354,COGS 234,A00,101431,Xia; Haijun,10,0,25,15
1667938133781,COGS 260,A00,101432,Kiyonaga; Anastasia,20,0,25,5
1667938133781,COGS 260,B00,101433,Kirsh; David Joel,17,0,25,8
1667938134299,CSE 202,A00,102371,Impagliazzo; Russell,0,0,0,0
1667938134722,CSE 203B,A01,102373,Cheng; Chung Kuan,0,0,0,0
1667938135150,CSE 208,A00,102374,Micciancio; Daniele,0,0,0,0
1667938135573,CSE 209A,A00,112895,Impagliazzo; Russell,0,0,15,15
1667938135996,CSE 209B,A00,108005,Bellare; Mihir,0,0,0,0
1667938136436,CSE 210,A00,113163,Coblenz; Michael J,0,0,0,0
1667938136869,CSE 219,A00,106111,Dow; Steven P,0,0,20,20
1667938137293,CSE 221,A00,102376,Voelker; Geoffrey M.,0,0,0,0
1667938137717,CSE 224,A01,102378,Porter; George M,0,0,0,0
1667938138141,CSE 229A,A00,102379,Savage; Stefan,0,0,0,0
1667938138567,CSE 229C,A00,102380,Munyaka; Imani N. S.,0,0,0,0
1667938138998,CSE 232B,A00,102382,Deutsch; Alin Bernard,0,0,0,0
1667938139423,CSE 234,A01,112904,Kumar; Arun Kumar,0,0,0,0
1667938139849,CSE 237A,A00,102383,Rosing; Tajana Simunic,0,0,0,0
1667938140276,CSE 239A,A00,102384,Deutsch; Alin Bernard,0,0,0,0
1667938140700,CSE 239B,A00,102385,Polikarpova; Nadezhda,0,0,0,0
1667938141124,CSE 240A,A00,102386,Pannuto; Patrick William,0,0,0,0
1667938141564,CSE 240B,A00,102387,Zhao; Jishen,0,0,0,0
1667938141989,CSE 241A,A00,106406,Kang; Mingu,0,0,0,0
1667938142420,CSE 249B,A00,102388,Kahng; Andrew Byun,0,0,8,8
1667938142847,CSE 251B,A01,102392,Cottrell; Garrison W,0,0,0,0
1667938142847,CSE 251B,A02,102393,Cottrell; Garrison W,0,0,0,0
1667938143276,CSE 252B,A00,102394,Ochoa; Benjamin Lawrence,0,0,0,0
1667938143699,CSE 257,A01,102396,Gao; Sicun,0,0,0,0
1667938144134,CSE 272,A00,102397,Li; Tzumao,0,0,0,0
1667938144558,CSE 274,A00,111323,Chern; Albert Ren-Haur,0,0,0,0
1667938144981,CSE 282,A00,102398,Pevzner; Pavel Arkadjevich,0,0,0,0
1667938145404,CSE 284,A00,114175,Gymrek; Melissa Ann,0,0,0,0
1667938145834,CSE 290,A00,102399,Chandraker; Manmohan Krishna,0,0,0,0
1667938145834,CSE 290,B00,102400,Vaccaro; Kristen Marie,0,0,25,25
1667938145834,CSE 290,C00,102414,Pannuto; Patrick William,1,0,25,24
1667938145834,CSE 290,D00,102427,Pevzner; Pavel Arkadjevich,0,0,0,0
1667938145834,CSE 290,E00,102429,Zhao; Jishen,0,0,0,0
1667938145834,CSE 290,F00,102436,Tullsen; Dean Michael,0,0,0,0
1667938145834,CSE 290,G00,102440,Christensen; Henrik I,0,0,20,20
1667938146264,CSE 291,A00,102443,Su; Hao,0,0,0,0
1667938146264,CSE 291,B00,102448,Polikarpova; Nadezhda,0,0,0,0
1667938146264,CSE 291,C00,102453,Vaccaro; Kristen Marie,0,0,0,0
1667938146264,CSE 291,D00,111343,Savage; Stefan,0,0,0,0
1667938146264,CSE 291,E00,116474,Claffy; Kimberly Claire,0,0,0,0
1667938146264,CSE 291,F00,116479,Pasquale; Joseph,0,0,0,0
1667938146699,CSE 293,001,119111,Bafna; Vineet,9999,0,9999,0
1667938146699,CSE 293,002,119118,Bellare; Mihir,9999,0,9999,0
1667938146699,CSE 293,003,119122,Berg-Kirkpatrick; Taylor D,9999,0,9999,0
1667938146699,CSE 293,004,119135,Christensen; Henrik I,9999,0,9999,0
1667938146699,CSE 293,005,119142,Cottrell; Garrison W,9999,0,9999,0
1667938146699,CSE 293,006,119146,Deutsch; Alin Bernard,9999,0,9999,0
1667938146699,CSE 293,007,119159,Esmaeilzadeh; Hadi,9999,0,9999,0
1667938146699,CSE 293,008,119166,Freund; Yoav,9999,0,9999,0
1667938146699,CSE 293,009,119170,Griswold; William G.,9999,0,9999,0
1667938146699,CSE 293,010,119183,Gymrek; Melissa Ann,9999,0,9999,0
1667938146699,CSE 293,011,119190,Heninger; Nadia A,9999,0,9999,0
1667938146699,CSE 293,012,119230,Impagliazzo; Russell,9999,0,9999,0
1667938146699,CSE 293,013,119232,Jhala; Ranjit,9999,0,9999,0
1667938146699,CSE 293,014,119233,Kahng; Andrew Byun,9999,0,9999,0
1667938146699,CSE 293,015,119298,Kane; Daniel Mertz,9999,0,9999,0
1667938146699,CSE 293,016,119299,Kriegman; David J,9999,0,9999,0
1667938146699,CSE 293,017,119300,Kumar; Arun Kumar,9999,0,9999,0
1667938146699,CSE 293,018,119301,Lerner; Sorin,9999,0,9999,0
1667938146699,CSE 293,019,119302,Lovett; Shachar,9999,0,9999,0
1667938146699,CSE 293,020,119303,McAuley; Julian John,9999,0,9999,0
1667938146699,CSE 293,021,119304,Micciancio; Daniele,9999,0,9999,0
1667938146699,CSE 293,022,119367,Orailoglu; Alex,9999,0,9999,0
1667938146699,CSE 293,023,119382,Paturi; Ramamohan,9999,0,9999,0
1667938146699,CSE 293,024,119404,Polikarpova; Nadezhda,9999,0,9999,0
1667938146699,CSE 293,025,119406,Politz; Joseph Gibbs,9999,0,9999,0
1667938146699,CSE 293,026,119411,Porter; George M,9999,0,9999,0
1667938146699,CSE 293,027,119414,Porter; Leonard Emerson,9999,0,9999,0
1667938146699,CSE 293,028,119416,Ramamoorthi; Ravi,9999,0,9999,0
1667938146699,CSE 293,029,119417,Sahoo; Debashis,9999,0,9999,0
1667938146699,CSE 293,030,119420,Saul; Lawrence,9999,0,9999,0
1667938146699,CSE 293,031,119421,Savage; Stefan,9999,0,9999,0
1667938146699,CSE 293,032,119425,Schulze; Jurgen P.,9999,0,9999,0
1667938146699,CSE 293,033,119426,Snoeren; Alex C.,9999,0,9999,0
1667938146699,CSE 293,034,119428,Shang; Jingbo,9999,0,9999,0
1667938146699,CSE 293,035,119430,Stefan; Deian,9999,0,9999,0
1667938146699,CSE 293,036,119431,Su; Hao,9999,0,9999,0
1667938146699,CSE 293,037,119433,Swanson; Steven James,9999,0,9999,0
1667938146699,CSE 293,038,119435,Tullsen; Dean Michael,9999,0,9999,0
1667938146699,CSE 293,039,119483,Voelker; Geoffrey M.,9999,0,9999,0
1667938146699,CSE 293,040,119537,Zhao; Jishen,9999,0,9999,0
1667938146699,CSE 293,041,119538,Zhou; Yuan-Yuan,9999,0,9999,0
1667938146699,CSE 293,042,119539,Gao; Sicun,9999,0,9999,0
1667938146699,CSE 293,043,119540,Weibel; Nadir,9999,0,9999,0
1667938146699,CSE 293,044,119541,Gupta; Rajesh K.,9999,0,9999,0
1667938147128,CSE 294,A00,102459,Voelker; Geoffrey M.,0,0,0,0
1667938147128,CSE 294,B00,111322,Orailoglu; Alex,0,0,0,0
1667938147566,DSE 201,A00,096914,Deutsch; Alin Bernard,30,0,30,0
1667938147989,DSE 210,A00,096915,Dasgupta; Sanjoy,30,0,30,0
1667938148410,DSE 260A,A00,096916,Altintas De Callaf; Ilkay,30,0,30,0
1667938148853,ECE 200,001,103586,Antipa; Nicholas A,9999,0,9999,0
1667938148853,ECE 200,002,103587,Atanasov; Nikolay A.,9999,0,9999,0
1667938148853,ECE 200,003,103588,Bharadia; Dinesh,9999,0,9999,0
1667938148853,ECE 200,004,103589,Cheng; Chung Kuan,9999,0,9999,0
1667938148853,ECE 200,005,103590,Cosman; Pamela C.,9999,0,9999,0
1667938148853,ECE 200,006,103591,Dayeh; Shadi Ahmad,9999,0,9999,0
1667938148853,ECE 200,007,103592,Fainman; Yeshaiahu,9999,0,9999,0
1667938148853,ECE 200,008,103593,Ford; Joseph Earl,9999,0,9999,0
1667938148853,ECE 200,009,103594,Franceschetti; Massimo,9999,0,9999,0
1667938148853,ECE 200,010,103595,Fullerton; Eric E,9999,0,9999,0
1667938148853,ECE 200,011,103596,Galton; Ian A,9999,0,9999,0
1667938148853,ECE 200,012,103597,Gilja; Vikash,9999,0,9999,0
1667938148853,ECE 200,013,103598,Hall; Drew A.,9999,0,9999,0
1667938148853,ECE 200,014,103599,Hsueh; Tzu-Chien,9999,0,9999,0
1667938148853,ECE 200,015,103600,Javidi; Tara,9999,0,9999,0
1667938148853,ECE 200,016,103601,Kahng; Andrew Byun,9999,0,9999,0
1667938148853,ECE 200,017,103602,Kim; Young-Han,9999,0,9999,0
1667938148853,ECE 200,018,103603,Koushanfar; Farinaz,9999,0,9999,0
1667938148853,ECE 200,019,103604,Kuzum; Duygu,9999,0,9999,0
1667938148853,ECE 200,020,103605,Le; Hanh-Phuc,9999,0,9999,0
1667938148853,ECE 200,021,103606,Lin; Bill,9999,0,9999,0
1667938148853,ECE 200,022,103607,Liu; Zhaowei,9998,0,9999,1
1667938148853,ECE 200,023,103608,Lo; Yu-Hwa,9999,0,9999,0
1667938148853,ECE 200,024,103609,Lomakin; Vitaliy,9999,0,9999,0
1667938148853,ECE 200,025,103610,Mercier; Patrick Philip,9999,0,9999,0
1667938148853,ECE 200,026,103611,Meyer; Florian,9999,0,9999,0
1667938148853,ECE 200,027,103612,Milstein; Laurence B.,9999,0,9999,0
1667938148853,ECE 200,028,103613,Mir Arabbaygi; Siavash,9999,0,9999,0
1667938148853,ECE 200,029,103614,Mookherjea; Shayan,9999,0,9999,0
1667938148853,ECE 200,030,103615,Morris; Karcher William,9999,0,9999,0
1667938148853,ECE 200,031,103616,Ng; Tse Nga,9999,0,9999,0
1667938148853,ECE 200,032,103617,Nguyen; Truong Quang,9999,0,9999,0
1667938148853,ECE 200,033,103618,Nomura; Kenji,9999,0,9999,0
1667938148853,ECE 200,034,103619,Orlitsky; Alon,9999,0,9999,0
1667938148853,ECE 200,035,103620,Pal; Piya,9999,0,9999,0
1667938148853,ECE 200,036,103621,Papen; George C.,9999,0,9999,0
1667938148853,ECE 200,037,103622,Radic; Stojan,9999,0,9999,0
1667938148853,ECE 200,038,103623,Rao; Bhaskar D.,9999,0,9999,0
1667938148853,ECE 200,039,103624,Rao; Ramesh R,9999,0,9999,0
1667938148853,ECE 200,040,103625,Rebeiz; Gabriel,9999,0,9999,0
1667938148853,ECE 200,041,103626,Sanford; John R,9999,0,9999,0
1667938148853,ECE 200,042,103627,Siegel; Paul H.,9999,0,9999,0
1667938148853,ECE 200,043,103628,Sievenpiper; Daniel F.,9999,0,9999,0
1667938148853,ECE 200,044,103629,Sworder; David D.,9999,0,9999,0
1667938148853,ECE 200,045,103630,Taur; Yuan,9999,0,9999,0
1667938148853,ECE 200,046,103631,Touri; Behrouz,9999,0,9999,0
1667938148853,ECE 200,047,103632,Trivedi; Mohan M.,9999,0,9999,0
1667938148853,ECE 200,048,103633,Vasconcelos; Nuno,9999,0,9999,0
1667938148853,ECE 200,049,103634,Wang; Xiaolong,9999,0,9999,0
1667938148853,ECE 200,050,103635,Xie; Pengtao,9999,0,9999,0
1667938148853,ECE 200,051,103636,Yip; Michael,9999,0,9999,0
1667938148853,ECE 200,052,103637,Zeger; Kenneth A.,999,0,999,0
1667938148853,ECE 200,053,103638,Zhang; Xinyu,9999,0,9999,0
1667938148853,ECE 200,054,103639,Turakhia; Yatish Girish,9999,0,9999,0
1667938148853,ECE 200,055,103640,Kang; Mingu,9999,0,9999,0
1667938148853,ECE 200,056,103641,Shi; Yuanyuan,9999,0,9999,0
1667938148853,ECE 200,057,103642,Wang; Edward Jay,9999,0,9999,0
1667938148853,ECE 200,058,103643,Zheng; Yang,9999,0,9999,0
1667938149288,ECE 202,A00,103644,Kuzum; Duygu,0,0,0,0
1667938149711,ECE 212BN,A00,103646,Ng; Tse Nga,0,0,0,0
1667938150135,ECE 221,A00,111493,Staff,0,0,0,0
1667938150565,ECE 222B,A00,103647,Lomakin; Vitaliy,0,0,0,0
1667938150995,ECE 230B,A00,103648,Taur; Yuan,0,0,0,0
1667938151420,ECE 238B,A00,103649,Garay; Javier,0,0,0,0
1667938151848,ECE 240B,A00,112900,Fainman; Yeshaiahu,0,0,0,0
1667938152273,ECE 247A,A00,103650,Jokerst; Jesse Vincent,0,0,0,0
1667938152698,ECE 247B,A00,103651,Wang; Joseph,0,0,0,0
1667938153140,ECE 250,A00,103652,Siegel; Paul H.,0,0,0,0
1667938153563,ECE 251A,A00,103654,Rao; Bhaskar D.,0,0,0,0
1667938153989,ECE 257B,A00,103655,Bharadia; Dinesh,0,0,0,0
1667938154429,ECE 258A,A00,103656,Milstein; Laurence B.,0,0,0,0
1667938154850,ECE 260B,A00,103658,Kang; Mingu,0,0,0,0
1667938155282,ECE 264A,A00,103659,Galton; Ian A,0,0,0,0
1667938155710,ECE 265A,A00,103661,Gudem; Prasad S.S.,0,0,0,0
1667938156137,ECE 265D,A00,103662,Gudem; Prasad S.S.,0,0,0,0
1667938156569,ECE 268,A00,103663,Koushanfar; Farinaz,0,0,0,0
1667938156993,ECE 269,A01,103665,Pal; Piya,0,0,0,0
1667938157416,ECE 271B,A00,103666,Vasconcelos; Manuela,0,0,0,0
1667938157839,ECE 276A,A00,103667,Atanasov; Nikolay A.,0,0,0,0
1667938158266,ECE 277,A00,103668,An; Cheolhong,0,0,0,0
1667938158697,ECE 279,A00,117947,Hall; Drew A.,0,0,0,0
1667938159561,ECE 283,A00,103670,Hsueh; Tzu-Chien,0,0,0,0
1667938159985,ECE 284,A00,103671,Turakhia; Yatish Girish,0,0,0,0
1667938160408,ECE 285,A00,103672,Zheng; Yang,0,0,0,0
1667938160408,ECE 285,B00,103673,Sworder; David D.,0,0,0,0
1667938160832,ECE 287,A00,103676,Javidi; Tara,0,0,0,0
1667938161257,MATH 200B,A00,098023,Salehi Golsefidy; Alireza,14,0,15,1
1667938161686,MATH 202B,A00,098024,Rhoades; Brendon Patrick,13,0,15,2
1667938162120,MATH 203B,A00,098025,Oprea; Dragos N.,14,0,15,1
1667938162550,MATH 204B,A00,098026,Sorensen; Claus M,15,0,15,0
1667938162983,MATH 208,A00,098027,Izadi; Elham,7,0,10,3
1667938163427,MATH 209,A00,098028,Pollack; Aaron,10,0,10,0
1667938163862,MATH 211A,A00,112919,Rogalski; Daniel,10,0,10,0
1667938164288,MATH 211B,A00,112920,Seward; Brandon M.,10,0,10,0
1667938164720,MATH 218,A00,098029,Li; Bo,10,0,10,0
1667938165155,MATH 220B,A00,098030,Novak; Jonathan I,14,0,15,1
1667938165588,MATH 221A,A00,098031,Ebenfelt; Peter F,14,0,15,1
1667938166010,MATH 231B,A00,098032,Zlatos; Andrej,14,0,15,1
1667938166440,MATH 240B,A00,098033,Ni; Lei,11,0,15,4
1667938166866,MATH 243,A00,098034,Jekel; David Andrew,10,0,10,0
1667938167291,MATH 245A,A00,098035,Nie; Jiawang,4,0,15,11
1667938167714,MATH 248,A00,098036,Bejenaru; Ioan,10,0,10,0
1667938168135,MATH 250B,A00,098037,Spolaor; Luca,14,0,15,1
1667938168568,MATH 258,A00,098038,Ni; Lei,10,0,10,0
1667938169004,MATH 264B,A00,098041,Rhoades; Brendon Patrick,13,0,15,2
1667938169443,MATH 268,A00,098042,Buss; Samuel R,10,0,10,0
1667938169875,MATH 269,A00,098043,Rhoades; Brendon Patrick,10,0,10,0
1667938170306,MATH 270B,A00,098044,Li; Bo,11,0,15,4
1667938170733,MATH 272B,A00,098045,Holst; Michael J,13,0,15,2
1667938171155,MATH 273A,A00,098046,Tian; Xiaochuan,12,0,15,3
1667938171581,MATH 275,A01,098048,Tian; Xiaochuan,6,0,10,4
1667938172005,MATH 278A,A00,098049,Holst; Michael J,8,0,10,2
1667938172430,MATH 278B,A00,098050,Cloninger; Alexander,10,0,10,0
1667938172865,MATH 278C,A00,098051,Nie; Jiawang,8,0,10,2
1667938173294,MATH 280B,A00,098052,Zheng; Tianyi,12,0,15,3
1667938173724,MATH 281B,A00,098053,Bradic; Jelena,4,0,15,11
1667938174149,MATH 282B,A00,098054,Arias-Castro; Ery,2,0,15,13
1667938174580,MATH 285,A00,098055,Fitzsimmons; Patrick J,1,0,15,14
1667938175004,MATH 287B,A00,098056,Arias-Castro; Ery,8,0,15,7
1667938175431,MATH 288,A00,098057,Agarwal; Pooja,9,0,10,1
1667938175431,MATH 288,B00,098058,Zhang; Danna,9,0,10,1
1667938175431,MATH 288,C00,098059,Williams; Ruth J,10,0,10,0
1667938175863,MATH 290B,A00,098060,Roberts; Justin Deritter,14,0,15,1
1667938176288,MATH 292,A00,098061,Belmont; Eva Kinoshita,10,0,10,0
1667938176716,MATH 295,A00,098062,Suk; Andrew Hoon,48,0,50,2
1667938177145,MATH 296,A00,098063,Novak; Jonathan I,20,0,20,0
1667938177652,MATH 297,001,098064,Gamst; Anthony Collins,9997,0,9999,2
1667938679501,COGS 205,A00,101395,Chiba; Andrea,19,0,20,1
1667938679933,COGS 210B,001,101404,Greene; Deanna Jacquelyn,9998,0,9999,1
1667938679933,COGS 210B,002,101417,Xia; Haijun,9999,0,9999,0
1667938679933,COGS 210B,003,101422,Nitz; Douglas A.,9999,0,9999,0
1667938679933,COGS 210B,004,101423,Hollan; James D.,9998,0,9999,1
1667938679933,COGS 210B,005,101424,Deak; Gedeon O.,9999,0,9999,0
1667938679933,COGS 210B,006,101425,Rossano; Federico,9999,0,9999,0
1667938680357,COGS 211B,A00,101427,Coulson; Seana M,9997,0,9999,2
1667938680785,COGS 220,A00,101428,Hollan; James D.,0,0,25,25
1667938681214,COGS 229,A00,101429,Dow; Steven P,19,0,25,6
1667938681638,COGS 230,A00,101430,Klemmer; Scott R,13,0,17,4
1667938682061,COGS 234,A00,101431,Xia; Haijun,10,0,25,15
1667938682493,COGS 260,A00,101432,Kiyonaga; Anastasia,20,0,25,5
1667938682493,COGS 260,B00,101433,Kirsh; David Joel,17,0,25,8
1667938682916,CSE 202,A00,102371,Impagliazzo; Russell,0,0,0,0
1667938683340,CSE 203B,A01,102373,Cheng; Chung Kuan,0,0,0,0
1667938683765,CSE 208,A00,102374,Micciancio; Daniele,0,0,0,0
1667938684188,CSE 209A,A00,112895,Impagliazzo; Russell,0,0,15,15
1667938684613,CSE 209B,A00,108005,Bellare; Mihir,0,0,0,0
1667938685038,CSE 210,A00,113163,Coblenz; Michael J,0,0,0,0
1667938685460,CSE 219,A00,106111,Dow; Steven P,0,0,20,20
1667938685894,CSE 221,A00,102376,Voelker; Geoffrey M.,0,0,0,0
1667938686321,CSE 224,A01,102378,Porter; George M,0,0,0,0
1667938686743,CSE 229A,A00,102379,Savage; Stefan,0,0,0,0
1667938687166,CSE 229C,A00,102380,Munyaka; Imani N. S.,0,0,0,0
1667938687590,CSE 232B,A00,102382,Deutsch; Alin Bernard,0,0,0,0
1667938688017,CSE 234,A01,112904,Kumar; Arun Kumar,0,0,0,0
1667938688448,CSE 237A,A00,102383,Rosing; Tajana Simunic,0,0,0,0
1667938688912,CSE 239A,A00,102384,Deutsch; Alin Bernard,0,0,0,0
1667938689343,CSE 239B,A00,102385,Polikarpova; Nadezhda,0,0,0,0
1667938689766,CSE 240A,A00,102386,Pannuto; Patrick William,0,0,0,0
1667938690192,CSE 240B,A00,102387,Zhao; Jishen,0,0,0,0
1667938690614,CSE 241A,A00,106406,Kang; Mingu,0,0,0,0
1667938691046,CSE 249B,A00,102388,Kahng; Andrew Byun,0,0,8,8
1667938691480,CSE 251B,A01,102392,Cottrell; Garrison W,0,0,0,0
1667938691480,CSE 251B,A02,102393,Cottrell; Garrison W,0,0,0,0
1667938691922,CSE 252B,A00,102394,Ochoa; Benjamin Lawrence,0,0,0,0
1667938692353,CSE 257,A01,102396,Gao; Sicun,0,0,0,0
1667938692778,CSE 272,A00,102397,Li; Tzumao,0,0,0,0
1667938693211,CSE 274,A00,111323,Chern; Albert Ren-Haur,0,0,0,0
1667938693637,CSE 282,A00,102398,Pevzner; Pavel Arkadjevich,0,0,0,0
1667938694077,CSE 284,A00,114175,Gymrek; Melissa Ann,0,0,0,0
1667938694500,CSE 290,A00,102399,Chandraker; Manmohan Krishna,0,0,0,0
1667938694500,CSE 290,B00,102400,Vaccaro; Kristen Marie,0,0,25,25
1667938694500,CSE 290,C00,102414,Pannuto; Patrick William,1,0,25,24
1667938694500,CSE 290,D00,102427,Pevzner; Pavel Arkadjevich,0,0,0,0
1667938694500,CSE 290,E00,102429,Zhao; Jishen,0,0,0,0
1667938694500,CSE 290,F00,102436,Tullsen; Dean Michael,0,0,0,0
1667938694500,CSE 290,G00,102440,Christensen; Henrik I,0,0,20,20
1667938694924,CSE 291,A00,102443,Su; Hao,0,0,0,0
1667938694924,CSE 291,B00,102448,Polikarpova; Nadezhda,0,0,0,0
1667938694924,CSE 291,C00,102453,Vaccaro; Kristen Marie,0,0,0,0
1667938694924,CSE 291,D00,111343,Savage; Stefan,0,0,0,0
1667938694924,CSE 291,E00,116474,Claffy; Kimberly Claire,0,0,0,0
1667938694924,CSE 291,F00,116479,Pasquale; Joseph,0,0,0,0
1667938695374,CSE 293,001,119111,Bafna; Vineet,9999,0,9999,0
1667938695374,CSE 293,002,119118,Bellare; Mihir,9999,0,9999,0
1667938695374,CSE 293,003,119122,Berg-Kirkpatrick; Taylor D,9999,0,9999,0
1667938695374,CSE 293,004,119135,Christensen; Henrik I,9999,0,9999,0
1667938695374,CSE 293,005,119142,Cottrell; Garrison W,9999,0,9999,0
1667938695374,CSE 293,006,119146,Deutsch; Alin Bernard,9999,0,9999,0
1667938695374,CSE 293,007,119159,Esmaeilzadeh; Hadi,9999,0,9999,0
1667938695374,CSE 293,008,119166,Freund; Yoav,9999,0,9999,0
1667938695374,CSE 293,009,119170,Griswold; William G.,9999,0,9999,0
1667938695374,CSE 293,010,119183,Gymrek; Melissa Ann,9999,0,9999,0
1667938695374,CSE 293,011,119190,Heninger; Nadia A,9999,0,9999,0
1667938695374,CSE 293,012,119230,Impagliazzo; Russell,9999,0,9999,0
1667938695374,CSE 293,013,119232,Jhala; Ranjit,9999,0,9999,0
1667938695374,CSE 293,014,119233,Kahng; Andrew Byun,9999,0,9999,0
1667938695374,CSE 293,015,119298,Kane; Daniel Mertz,9999,0,9999,0
1667938695374,CSE 293,016,119299,Kriegman; David J,9999,0,9999,0
1667938695374,CSE 293,017,119300,Kumar; Arun Kumar,9999,0,9999,0
1667938695374,CSE 293,018,119301,Lerner; Sorin,9999,0,9999,0
1667938695374,CSE 293,019,119302,Lovett; Shachar,9999,0,9999,0
1667938695374,CSE 293,020,119303,McAuley; Julian John,9999,0,9999,0
1667938695374,CSE 293,021,119304,Micciancio; Daniele,9999,0,9999,0
1667938695374,CSE 293,022,119367,Orailoglu; Alex,9999,0,9999,0
1667938695374,CSE 293,023,119382,Paturi; Ramamohan,9999,0,9999,0
1667938695374,CSE 293,024,119404,Polikarpova; Nadezhda,9999,0,9999,0
1667938695374,CSE 293,025,119406,Politz; Joseph Gibbs,9999,0,9999,0
1667938695374,CSE 293,026,119411,Porter; George M,9999,0,9999,0
1667938695374,CSE 293,027,119414,Porter; Leonard Emerson,9999,0,9999,0
1667938695374,CSE 293,028,119416,Ramamoorthi; Ravi,9999,0,9999,0
1667938695374,CSE 293,029,119417,Sahoo; Debashis,9999,0,9999,0
1667938695374,CSE 293,030,119420,Saul; Lawrence,9999,0,9999,0
1667938695374,CSE 293,031,119421,Savage; Stefan,9999,0,9999,0
1667938695374,CSE 293,032,119425,Schulze; Jurgen P.,9999,0,9999,0
1667938695374,CSE 293,033,119426,Snoeren; Alex C.,9999,0,9999,0
1667938695374,CSE 293,034,119428,Shang; Jingbo,9999,0,9999,0
1667938695374,CSE 293,035,119430,Stefan; Deian,9999,0,9999,0
1667938695374,CSE 293,036,119431,Su; Hao,9999,0,9999,0
1667938695374,CSE 293,037,119433,Swanson; Steven James,9999,0,9999,0
1667938695374,CSE 293,038,119435,Tullsen; Dean Michael,9999,0,9999,0
1667938695374,CSE 293,039,119483,Voelker; Geoffrey M.,9999,0,9999,0
1667938695374,CSE 293,040,119537,Zhao; Jishen,9999,0,9999,0
1667938695374,CSE 293,041,119538,Zhou; Yuan-Yuan,9999,0,9999,0
1667938695374,CSE 293,042,119539,Gao; Sicun,9999,0,9999,0
1667938695374,CSE 293,043,119540,Weibel; Nadir,9999,0,9999,0
1667938695374,CSE 293,044,119541,Gupta; Rajesh K.,9999,0,9999,0
1667938695804,CSE 294,A00,102459,Voelker; Geoffrey M.,0,0,0,0
1667938695804,CSE 294,B00,111322,Orailoglu; Alex,0,0,0,0
1667938696227,DSE 201,A00,096914,Deutsch; Alin Bernard,30,0,30,0
1667938696656,DSE 210,A00,096915,Dasgupta; Sanjoy,30,0,30,0
1667938697080,DSE 260A,A00,096916,Altintas De Callaf; Ilkay,30,0,30,0
1667938697546,ECE 200,001,103586,Antipa; Nicholas A,9999,0,9999,0
1667938697546,ECE 200,002,103587,Atanasov; Nikolay A.,9999,0,9999,0
1667938697546,ECE 200,003,103588,Bharadia; Dinesh,9999,0,9999,0
1667938697546,ECE 200,004,103589,Cheng; Chung Kuan,9999,0,9999,0
1667938697546,ECE 200,005,103590,Cosman; Pamela C.,9999,0,9999,0
1667938697546,ECE 200,006,103591,Dayeh; Shadi Ahmad,9999,0,9999,0
1667938697546,ECE 200,007,103592,Fainman; Yeshaiahu,9999,0,9999,0
1667938697546,ECE 200,008,103593,Ford; Joseph Earl,9999,0,9999,0
1667938697546,ECE 200,009,103594,Franceschetti; Massimo,9999,0,9999,0
1667938697546,ECE 200,010,103595,Fullerton; Eric E,9999,0,9999,0
1667938697546,ECE 200,011,103596,Galton; Ian A,9999,0,9999,0
1667938697546,ECE 200,012,103597,Gilja; Vikash,9999,0,9999,0
1667938697546,ECE 200,013,103598,Hall; Drew A.,9999,0,9999,0
1667938697546,ECE 200,014,103599,Hsueh; Tzu-Chien,9999,0,9999,0
1667938697546,ECE 200,015,103600,Javidi; Tara,9999,0,9999,0
1667938697546,ECE 200,016,103601,Kahng; Andrew Byun,9999,0,9999,0
1667938697546,ECE 200,017,103602,Kim; Young-Han,9999,0,9999,0
1667938697546,ECE 200,018,103603,Koushanfar; Farinaz,9999,0,9999,0
1667938697546,ECE 200,019,103604,Kuzum; Duygu,9999,0,9999,0
1667938697546,ECE 200,020,103605,Le; Hanh-Phuc,9999,0,9999,0
1667938697546,ECE 200,021,103606,Lin; Bill,9999,0,9999,0
1667938697546,ECE 200,022,103607,Liu; Zhaowei,9998,0,9999,1
1667938697546,ECE 200,023,103608,Lo; Yu-Hwa,9999,0,9999,0
1667938697546,ECE 200,024,103609,Lomakin; Vitaliy,9999,0,9999,0
1667938697546,ECE 200,025,103610,Mercier; Patrick Philip,9999,0,9999,0
1667938697546,ECE 200,026,103611,Meyer; Florian,9999,0,9999,0
1667938697546,ECE 200,027,103612,Milstein; Laurence B.,9999,0,9999,0
1667938697546,ECE 200,028,103613,Mir Arabbaygi; Siavash,9999,0,9999,0
1667938697546,ECE 200,029,103614,Mookherjea; Shayan,9999,0,9999,0
1667938697546,ECE 200,030,103615,Morris; Karcher William,9999,0,9999,0
1667938697546,ECE 200,031,103616,Ng; Tse Nga,9999,0,9999,0
1667938697546,ECE 200,032,103617,Nguyen; Truong Quang,9999,0,9999,0
1667938697546,ECE 200,033,103618,Nomura; Kenji,9999,0,9999,0
1667938697546,ECE 200,034,103619,Orlitsky; Alon,9999,0,9999,0
1667938697546,ECE 200,035,103620,Pal; Piya,9999,0,9999,0
1667938697546,ECE 200,036,103621,Papen; George C.,9999,0,9999,0
1667938697546,ECE 200,037,103622,Radic; Stojan,9999,0,9999,0
1667938697546,ECE 200,038,103623,Rao; Bhaskar D.,9999,0,9999,0
1667938697546,ECE 200,039,103624,Rao; Ramesh R,9999,0,9999,0
1667938697546,ECE 200,040,103625,Rebeiz; Gabriel,9999,0,9999,0
1667938697546,ECE 200,041,103626,Sanford; John R,9999,0,9999,0
1667938697546,ECE 200,042,103627,Siegel; Paul H.,9999,0,9999,0
1667938697546,ECE 200,043,103628,Sievenpiper; Daniel F.,9999,0,9999,0
1667938697546,ECE 200,044,103629,Sworder; David D.,9999,0,9999,0
1667938697546,ECE 200,045,103630,Taur; Yuan,9999,0,9999,0
1667938697546,ECE 200,046,103631,Touri; Behrouz,9999,0,9999,0
1667938697546,ECE 200,047,103632,Trivedi; Mohan M.,9999,0,9999,0
1667938697546,ECE 200,048,103633,Vasconcelos; Nuno,9999,0,9999,0
1667938697546,ECE 200,049,103634,Wang; Xiaolong,9999,0,9999,0
1667938697546,ECE 200,050,103635,Xie; Pengtao,9999,0,9999,0
1667938697546,ECE 200,051,103636,Yip; Michael,9999,0,9999,0
1667938697546,ECE 200,052,103637,Zeger; Kenneth A.,999,0,999,0
1667938697546,ECE 200,053,103638,Zhang; Xinyu,9999,0,9999,0
1667938697546,ECE 200,054,103639,Turakhia; Yatish Girish,9999,0,9999,0
1667938697546,ECE 200,055,103640,Kang; Mingu,9999,0,9999,0
1667938697546,ECE 200,056,103641,Shi; Yuanyuan,9999,0,9999,0
1667938697546,ECE 200,057,103642,Wang; Edward Jay,9999,0,9999,0
1667938697546,ECE 200,058,103643,Zheng; Yang,9999,0,9999,0
1667938697980,ECE 202,A00,103644,Kuzum; Duygu,0,0,0,0
1667938698414,ECE 212BN,A00,103646,Ng; Tse Nga,0,0,0,0
1667938698840,ECE 221,A00,111493,Staff,0,0,0,0
1667938699265,ECE 222B,A00,103647,Lomakin; Vitaliy,0,0,0,0
1667938699783,ECE 230B,A00,103648,Taur; Yuan,0,0,0,0
1667938700208,ECE 238B,A00,103649,Garay; Javier,0,0,0,0
1667938700635,ECE 240B,A00,112900,Fainman; Yeshaiahu,0,0,0,0
1667938701061,ECE 247A,A00,103650,Jokerst; Jesse Vincent,0,0,0,0
1667938701485,ECE 247B,A00,103651,Wang; Joseph,0,0,0,0
1667938701913,ECE 250,A00,103652,Siegel; Paul H.,0,0,0,0
1667938702343,ECE 251A,A00,103654,Rao; Bhaskar D.,0,0,0,0
1667938702774,ECE 257B,A00,103655,Bharadia; Dinesh,0,0,0,0
1667938703198,ECE 258A,A00,103656,Milstein; Laurence B.,0,0,0,0
1667938703625,ECE 260B,A00,103658,Kang; Mingu,0,0,0,0
1667938704062,ECE 264A,A00,103659,Galton; Ian A,0,0,0,0
1667938704485,ECE 265A,A00,103661,Gudem; Prasad S.S.,0,0,0,0
1667938704910,ECE 265D,A00,103662,Gudem; Prasad S.S.,0,0,0,0
1667938705336,ECE 268,A00,103663,Koushanfar; Farinaz,0,0,0,0
1667938705768,ECE 269,A01,103665,Pal; Piya,0,0,0,0
1667938706189,ECE 271B,A00,103666,Vasconcelos; Manuela,0,0,0,0
1667938706617,ECE 276A,A00,103667,Atanasov; Nikolay A.,0,0,0,0
1667938707039,ECE 277,A00,103668,An; Cheolhong,0,0,0,0
1667938707472,ECE 279,A00,117947,Hall; Drew A.,0,0,0,0
1667938708322,ECE 283,A00,103670,Hsueh; Tzu-Chien,0,0,0,0
1667938708747,ECE 284,A00,103671,Turakhia; Yatish Girish,0,0,0,0
1667938709168,ECE 285,A00,103672,Zheng; Yang,0,0,0,0
1667938709168,ECE 285,B00,103673,Sworder; David D.,0,0,0,0
1667938709596,ECE 287,A00,103676,Javidi; Tara,0,0,0,0
1667938710018,MATH 200B,A00,098023,Salehi Golsefidy; Alireza,14,0,15,1
1667938710445,MATH 202B,A00,098024,Rhoades; Brendon Patrick,13,0,15,2
1667938710869,MATH 203B,A00,098025,Oprea; Dragos N.,14,0,15,1
1667938711291,MATH 204B,A00,098026,Sorensen; Claus M,15,0,15,0
1667938711853,MATH 208,A00,098027,Izadi; Elham,7,0,10,3
1667938712280,MATH 209,A00,098028,Pollack; Aaron,10,0,10,0
1667938712707,MATH 211A,A00,112919,Rogalski; Daniel,10,0,10,0
1667938713132,MATH 211B,A00,112920,Seward; Brandon M.,10,0,10,0
1667938713570,MATH 218,A00,098029,Li; Bo,10,0,10,0
1667938713996,MATH 220B,A00,098030,Novak; Jonathan I,14,0,15,1
1667938714418,MATH 221A,A00,098031,Ebenfelt; Peter F,14,0,15,1
1667938714844,MATH 231B,A00,098032,Zlatos; Andrej,13,0,15,2
1667938715275,MATH 240B,A00,098033,Ni; Lei,11,0,15,4
1667938715707,MATH 243,A00,098034,Jekel; David Andrew,10,0,10,0
1667938716131,MATH 245A,A00,098035,Nie; Jiawang,4,0,15,11
1667938716564,MATH 248,A00,098036,Bejenaru; Ioan,10,0,10,0
1667938716991,MATH 250B,A00,098037,Spolaor; Luca,14,0,15,1
1667938717416,MATH 258,A00,098038,Ni; Lei,10,0,10,0
1667938717841,MATH 264B,A00,098041,Rhoades; Brendon Patrick,13,0,15,2
1667938718267,MATH 268,A00,098042,Buss; Samuel R,10,0,10,0
1667938718693,MATH 269,A00,098043,Rhoades; Brendon Patrick,10,0,10,0
1667938719123,MATH 270B,A00,098044,Li; Bo,11,0,15,4
1667938719553,MATH 272B,A00,098045,Holst; Michael J,13,0,15,2
1667938719978,MATH 273A,A00,098046,Tian; Xiaochuan,12,0,15,3
1667938720413,MATH 275,A01,098048,Tian; Xiaochuan,6,0,10,4
1667938720837,MATH 278A,A00,098049,Holst; Michael J,8,0,10,2
1667938721261,MATH 278B,A00,098050,Cloninger; Alexander,10,0,10,0
1667938721684,MATH 278C,A00,098051,Nie; Jiawang,8,0,10,2
1667938722111,MATH 280B,A00,098052,Zheng; Tianyi,12,0,15,3
1667938722540,MATH 281B,A00,098053,Bradic; Jelena,4,0,15,11
1667938722978,MATH 282B,A00,098054,Arias-Castro; Ery,2,0,15,13
1667938723406,MATH 285,A00,098055,Fitzsimmons; Patrick J,0,0,15,15
1667938723828,MATH 287B,A00,098056,Arias-Castro; Ery,8,0,15,7
1667938724251,MATH 288,A00,098057,Agarwal; Pooja,9,0,10,1
1667938724251,MATH 288,B00,098058,Zhang; Danna,9,0,10,1
1667938724251,MATH 288,C00,098059,Williams; Ruth J,10,0,10,0
1667938724675,MATH 290B,A00,098060,Roberts; Justin Deritter,14,0,15,1
1667938725108,MATH 292,A00,098061,Belmont; Eva Kinoshita,10,0,10,0
1667938725541,MATH 295,A00,098062,Suk; Andrew Hoon,48,0,50,2
1667938725965,MATH 296,A00,098063,Novak; Jonathan I,20,0,20,0
1667938726389,MATH 297,001,098064,Gamst; Anthony Collins,9997,0,9999,2
1667939239431,COGS 205,A00,101395,Chiba; Andrea,19,0,20,1
1667939239859,COGS 210B,001,101404,Greene; Deanna Jacquelyn,9998,0,9999,1
1667939239859,COGS 210B,002,101417,Xia; Haijun,9999,0,9999,0
1667939239859,COGS 210B,003,101422,Nitz; Douglas A.,9999,0,9999,0
1667939239859,COGS 210B,004,101423,Hollan; James D.,9998,0,9999,1
1667939239859,COGS 210B,005,101424,Deak; Gedeon O.,9999,0,9999,0
1667939239859,COGS 210B,006,101425,Rossano; Federico,9999,0,9999,0
1667939240291,COGS 211B,A00,101427,Coulson; Seana M,9997,0,9999,2
1667939240714,COGS 220,A00,101428,Hollan; James D.,0,0,25,25
1667939241138,COGS 229,A00,101429,Dow; Steven P,19,0,25,6
1667939241564,COGS 230,A00,101430,Klemmer; Scott R,13,0,17,4
1667939241992,COGS 234,A00,101431,Xia; Haijun,10,0,25,15
1667939242421,COGS 260,A00,101432,Kiyonaga; Anastasia,20,0,25,5
1667939242421,COGS 260,B00,101433,Kirsh; David Joel,17,0,25,8
1667939242849,CSE 202,A00,102371,Impagliazzo; Russell,0,0,0,0
1667939243288,CSE 203B,A01,102373,Cheng; Chung Kuan,0,0,0,0
1667939243710,CSE 208,A00,102374,Micciancio; Daniele,0,0,0,0
1667939244132,CSE 209A,A00,112895,Impagliazzo; Russell,0,0,15,15
1667939244565,CSE 209B,A00,108005,Bellare; Mihir,0,0,0,0
1667939244989,CSE 210,A00,113163,Coblenz; Michael J,0,0,0,0
1667939245414,CSE 219,A00,106111,Dow; Steven P,0,0,20,20
1667939245837,CSE 221,A00,102376,Voelker; Geoffrey M.,0,0,0,0
1667939246268,CSE 224,A01,102378,Porter; George M,0,0,0,0
1667939246694,CSE 229A,A00,102379,Savage; Stefan,0,0,0,0
1667939247129,CSE 229C,A00,102380,Munyaka; Imani N. S.,0,0,0,0
1667939247554,CSE 232B,A00,102382,Deutsch; Alin Bernard,0,0,0,0
1667939247976,CSE 234,A01,112904,Kumar; Arun Kumar,0,0,0,0
1667939248562,CSE 237A,A00,102383,Rosing; Tajana Simunic,0,0,0,0
1667939248985,CSE 239A,A00,102384,Deutsch; Alin Bernard,0,0,0,0
1667939249408,CSE 239B,A00,102385,Polikarpova; Nadezhda,0,0,0,0
1667939249839,CSE 240A,A00,102386,Pannuto; Patrick William,0,0,0,0
1667939250263,CSE 240B,A00,102387,Zhao; Jishen,0,0,0,0
1667939250701,CSE 241A,A00,106406,Kang; Mingu,0,0,0,0
1667939251123,CSE 249B,A00,102388,Kahng; Andrew Byun,0,0,8,8
1667939251546,CSE 251B,A01,102392,Cottrell; Garrison W,0,0,0,0
1667939251546,CSE 251B,A02,102393,Cottrell; Garrison W,0,0,0,0
1667939251982,CSE 252B,A00,102394,Ochoa; Benjamin Lawrence,0,0,0,0
1667939252406,CSE 257,A01,102396,Gao; Sicun,0,0,0,0
1667939252830,CSE 272,A00,102397,Li; Tzumao,0,0,0,0
1667939253260,CSE 274,A00,111323,Chern; Albert Ren-Haur,0,0,0,0
1667939253683,CSE 282,A00,102398,Pevzner; Pavel Arkadjevich,0,0,0,0
1667939254108,CSE 284,A00,114175,Gymrek; Melissa Ann,0,0,0,0
1667939254533,CSE 290,A00,102399,Chandraker; Manmohan Krishna,0,0,0,0
1667939254533,CSE 290,B00,102400,Vaccaro; Kristen Marie,0,0,25,25
1667939254533,CSE 290,C00,102414,Pannuto; Patrick William,1,0,25,24
1667939254533,CSE 290,D00,102427,Pevzner; Pavel Arkadjevich,0,0,0,0
1667939254533,CSE 290,E00,102429,Zhao; Jishen,0,0,0,0
1667939254533,CSE 290,F00,102436,Tullsen; Dean Michael,0,0,0,0
1667939254533,CSE 290,G00,102440,Christensen; Henrik I,0,0,20,20
1667939254982,CSE 291,A00,102443,Su; Hao,0,0,0,0
1667939254982,CSE 291,B00,102448,Polikarpova; Nadezhda,0,0,0,0
1667939254982,CSE 291,C00,102453,Vaccaro; Kristen Marie,0,0,0,0
1667939254982,CSE 291,D00,111343,Savage; Stefan,0,0,0,0
1667939254982,CSE 291,E00,116474,Claffy; Kimberly Claire,0,0,0,0
1667939254982,CSE 291,F00,116479,Pasquale; Joseph,0,0,0,0
1667939255434,CSE 293,001,119111,Bafna; Vineet,9999,0,9999,0
1667939255434,CSE 293,002,119118,Bellare; Mihir,9999,0,9999,0
1667939255434,CSE 293,003,119122,Berg-Kirkpatrick; Taylor D,9999,0,9999,0
1667939255434,CSE 293,004,119135,Christensen; Henrik I,9999,0,9999,0
1667939255434,CSE 293,005,119142,Cottrell; Garrison W,9999,0,9999,0
1667939255434,CSE 293,006,119146,Deutsch; Alin Bernard,9999,0,9999,0
1667939255434,CSE 293,007,119159,Esmaeilzadeh; Hadi,9999,0,9999,0
1667939255434,CSE 293,008,119166,Freund; Yoav,9999,0,9999,0
1667939255434,CSE 293,009,119170,Griswold; William G.,9999,0,9999,0
1667939255434,CSE 293,010,119183,Gymrek; Melissa Ann,9999,0,9999,0
1667939255434,CSE 293,011,119190,Heninger; Nadia A,9999,0,9999,0
1667939255434,CSE 293,012,119230,Impagliazzo; Russell,9999,0,9999,0
1667939255434,CSE 293,013,119232,Jhala; Ranjit,9999,0,9999,0
1667939255434,CSE 293,014,119233,Kahng; Andrew Byun,9999,0,9999,0
1667939255434,CSE 293,015,119298,Kane; Daniel Mertz,9999,0,9999,0
1667939255434,CSE 293,016,119299,Kriegman; David J,9999,0,9999,0
1667939255434,CSE 293,017,119300,Kumar; Arun Kumar,9999,0,9999,0
1667939255434,CSE 293,018,119301,Lerner; Sorin,9999,0,9999,0
1667939255434,CSE 293,019,119302,Lovett; Shachar,9999,0,9999,0
1667939255434,CSE 293,020,119303,McAuley; Julian John,9999,0,9999,0
1667939255434,CSE 293,021,119304,Micciancio; Daniele,9999,0,9999,0
1667939255434,CSE 293,022,119367,Orailoglu; Alex,9999,0,9999,0
1667939255434,CSE 293,023,119382,Paturi; Ramamohan,9999,0,9999,0
1667939255434,CSE 293,024,119404,Polikarpova; Nadezhda,9999,0,9999,0
1667939255434,CSE 293,025,119406,Politz; Joseph Gibbs,9999,0,9999,0
1667939255434,CSE 293,026,119411,Porter; George M,9999,0,9999,0
1667939255434,CSE 293,027,119414,Porter; Leonard Emerson,9999,0,9999,0
1667939255434,CSE 293,028,119416,Ramamoorthi; Ravi,9999,0,9999,0
1667939255434,CSE 293,029,119417,Sahoo; Debashis,9999,0,9999,0
1667939255434,CSE 293,030,119420,Saul; Lawrence,9999,0,9999,0
1667939255434,CSE 293,031,119421,Savage; Stefan,9999,0,9999,0
1667939255434,CSE 293,032,119425,Schulze; Jurgen P.,9999,0,9999,0
1667939255434,CSE 293,033,119426,Snoeren; Alex C.,9999,0,9999,0
1667939255434,CSE 293,034,119428,Shang; Jingbo,9999,0,9999,0
1667939255434,CSE 293,035,119430,Stefan; Deian,9999,0,9999,0
1667939255434,CSE 293,036,119431,Su; Hao,9999,0,9999,0
1667939255434,CSE 293,037,119433,Swanson; Steven James,9999,0,9999,0
1667939255434,CSE 293,038,119435,Tullsen; Dean Michael,9999,0,9999,0
1667939255434,CSE 293,039,119483,Voelker; Geoffrey M.,9999,0,9999,0
1667939255434,CSE 293,040,119537,Zhao; Jishen,9999,0,9999,0
1667939255434,CSE 293,041,119538,Zhou; Yuan-Yuan,9999,0,9999,0
1667939255434,CSE 293,042,119539,Gao; Sicun,9999,0,9999,0
1667939255434,CSE 293,043,119540,Weibel; Nadir,9999,0,9999,0
1667939255434,CSE 293,044,119541,Gupta; Rajesh K.,9999,0,9999,0
1667939255858,CSE 294,A00,102459,Voelker; Geoffrey M.,0,0,0,0
1667939255858,CSE 294,B00,111322,Orailoglu; Alex,0,0,0,0
1667939256289,DSE 201,A00,096914,Deutsch; Alin Bernard,30,0,30,0
1667939256713,DSE 210,A00,096915,Dasgupta; Sanjoy,30,0,30,0
1667939257141,DSE 260A,A00,096916,Altintas De Callaf; Ilkay,30,0,30,0
1667939257586,ECE 200,001,103586,Antipa; Nicholas A,9999,0,9999,0
1667939257586,ECE 200,002,103587,Atanasov; Nikolay A.,9999,0,9999,0
1667939257586,ECE 200,003,103588,Bharadia; Dinesh,9999,0,9999,0
1667939257586,ECE 200,004,103589,Cheng; Chung Kuan,9999,0,9999,0
1667939257586,ECE 200,005,103590,Cosman; Pamela C.,9999,0,9999,0
1667939257586,ECE 200,006,103591,Dayeh; Shadi Ahmad,9999,0,9999,0
1667939257586,ECE 200,007,103592,Fainman; Yeshaiahu,9999,0,9999,0
1667939257586,ECE 200,008,103593,Ford; Joseph Earl,9999,0,9999,0
1667939257586,ECE 200,009,103594,Franceschetti; Massimo,9999,0,9999,0
1667939257586,ECE 200,010,103595,Fullerton; Eric E,9999,0,9999,0
1667939257586,ECE 200,011,103596,Galton; Ian A,9999,0,9999,0
1667939257586,ECE 200,012,103597,Gilja; Vikash,9999,0,9999,0
1667939257586,ECE 200,013,103598,Hall; Drew A.,9999,0,9999,0
1667939257586,ECE 200,014,103599,Hsueh; Tzu-Chien,9999,0,9999,0
1667939257586,ECE 200,015,103600,Javidi; Tara,9999,0,9999,0
1667939257586,ECE 200,016,103601,Kahng; Andrew Byun,9999,0,9999,0
1667939257586,ECE 200,017,103602,Kim; Young-Han,9999,0,9999,0
1667939257586,ECE 200,018,103603,Koushanfar; Farinaz,9999,0,9999,0
1667939257586,ECE 200,019,103604,Kuzum; Duygu,9999,0,9999,0
1667939257586,ECE 200,020,103605,Le; Hanh-Phuc,9999,0,9999,0
1667939257586,ECE 200,021,103606,Lin; Bill,9999,0,9999,0
1667939257586,ECE 200,022,103607,Liu; Zhaowei,9998,0,9999,1
1667939257586,ECE 200,023,103608,Lo; Yu-Hwa,9999,0,9999,0
1667939257586,ECE 200,024,103609,Lomakin; Vitaliy,9999,0,9999,0
1667939257586,ECE 200,025,103610,Mercier; Patrick Philip,9999,0,9999,0
1667939257586,ECE 200,026,103611,Meyer; Florian,9999,0,9999,0
1667939257586,ECE 200,027,103612,Milstein; Laurence B.,9999,0,9999,0
1667939257586,ECE 200,028,103613,Mir Arabbaygi; Siavash,9999,0,9999,0
1667939257586,ECE 200,029,103614,Mookherjea; Shayan,9999,0,9999,0
1667939257586,ECE 200,030,103615,Morris; Karcher William,9999,0,9999,0
1667939257586,ECE 200,031,103616,Ng; Tse Nga,9999,0,9999,0
1667939257586,ECE 200,032,103617,Nguyen; Truong Quang,9999,0,9999,0
1667939257586,ECE 200,033,103618,Nomura; Kenji,9999,0,9999,0
1667939257586,ECE 200,034,103619,Orlitsky; Alon,9999,0,9999,0
1667939257586,ECE 200,035,103620,Pal; Piya,9999,0,9999,0
1667939257586,ECE 200,036,103621,Papen; George C.,9999,0,9999,0
1667939257586,ECE 200,037,103622,Radic; Stojan,9999,0,9999,0
1667939257586,ECE 200,038,103623,Rao; Bhaskar D.,9999,0,9999,0
1667939257586,ECE 200,039,103624,Rao; Ramesh R,9999,0,9999,0
1667939257586,ECE 200,040,103625,Rebeiz; Gabriel,9999,0,9999,0
1667939257586,ECE 200,041,103626,Sanford; John R,9999,0,9999,0
1667939257586,ECE 200,042,103627,Siegel; Paul H.,9999,0,9999,0
1667939257586,ECE 200,043,103628,Sievenpiper; Daniel F.,9999,0,9999,0
1667939257586,ECE 200,044,103629,Sworder; David D.,9999,0,9999,0
1667939257586,ECE 200,045,103630,Taur; Yuan,9999,0,9999,0
1667939257586,ECE 200,046,103631,Touri; Behrouz,9999,0,9999,0
1667939257586,ECE 200,047,103632,Trivedi; Mohan M.,9999,0,9999,0
1667939257586,ECE 200,048,103633,Vasconcelos; Nuno,9999,0,9999,0
1667939257586,ECE 200,049,103634,Wang; Xiaolong,9999,0,9999,0
1667939257586,ECE 200,050,103635,Xie; Pengtao,9999,0,9999,0
1667939257586,ECE 200,051,103636,Yip; Michael,9999,0,9999,0
1667939257586,ECE 200,052,103637,Zeger; Kenneth A.,999,0,999,0
1667939257586,ECE 200,053,103638,Zhang; Xinyu,9999,0,9999,0
1667939257586,ECE 200,054,103639,Turakhia; Yatish Girish,9999,0,9999,0
1667939257586,ECE 200,055,103640,Kang; Mingu,9999,0,9999,0
1667939257586,ECE 200,056,103641,Shi; Yuanyuan,9999,0,9999,0
1667939257586,ECE 200,057,103642,Wang; Edward Jay,9999,0,9999,0
1667939257586,ECE 200,058,103643,Zheng; Yang,9999,0,9999,0
1667939258013,ECE 202,A00,103644,Kuzum; Duygu,0,0,0,0
1667939258436,ECE 212BN,A00,103646,Ng; Tse Nga,0,0,0,0
1667939258860,ECE 221,A00,111493,Staff,0,0,0,0
1667939259284,ECE 222B,A00,103647,Lomakin; Vitaliy,0,0,0,0
1667939259708,ECE 230B,A00,103648,Taur; Yuan,0,0,0,0
1667939260137,ECE 238B,A00,103649,Garay; Javier,0,0,0,0
1667939260560,ECE 240B,A00,112900,Fainman; Yeshaiahu,0,0,0,0
1667939260983,ECE 247A,A00,103650,Jokerst; Jesse Vincent,0,0,0,0
1667939261417,ECE 247B,A00,103651,Wang; Joseph,0,0,0,0
1667939261840,ECE 250,A00,103652,Siegel; Paul H.,0,0,0,0
1667939262265,ECE 251A,A00,103654,Rao; Bhaskar D.,0,0,0,0
1667939262688,ECE 257B,A00,103655,Bharadia; Dinesh,0,0,0,0
1667939263115,ECE 258A,A00,103656,Milstein; Laurence B.,0,0,0,0
1667939263545,ECE 260B,A00,103658,Kang; Mingu,0,0,0,0
1667939263980,ECE 264A,A00,103659,Galton; Ian A,0,0,0,0
1667939264411,ECE 265A,A00,103661,Gudem; Prasad S.S.,0,0,0,0
1667939264839,ECE 265D,A00,103662,Gudem; Prasad S.S.,0,0,0,0
1667939265270,ECE 268,A00,103663,Koushanfar; Farinaz,0,0,0,0
1667939265694,ECE 269,A01,103665,Pal; Piya,0,0,0,0
1667939266120,ECE 271B,A00,103666,Vasconcelos; Manuela,0,0,0,0
1667939266544,ECE 276A,A00,103667,Atanasov; Nikolay A.,0,0,0,0
1667939266967,ECE 277,A00,103668,An; Cheolhong,0,0,0,0
1667939267390,ECE 279,A00,117947,Hall; Drew A.,0,0,0,0
1667939268255,ECE 283,A00,103670,Hsueh; Tzu-Chien,0,0,0,0
1667939268679,ECE 284,A00,103671,Turakhia; Yatish Girish,0,0,0,0
1667939269117,ECE 285,A00,103672,Zheng; Yang,0,0,0,0
1667939269117,ECE 285,B00,103673,Sworder; David D.,0,0,0,0
1667939269543,ECE 287,A00,103676,Javidi; Tara,0,0,0,0
1667939269967,MATH 200B,A00,098023,Salehi Golsefidy; Alireza,14,0,15,1
1667939270394,MATH 202B,A00,098024,Rhoades; Brendon Patrick,13,0,15,2
1667939270833,MATH 203B,A00,098025,Oprea; Dragos N.,14,0,15,1
1667939271263,MATH 204B,A00,098026,Sorensen; Claus M,15,0,15,0
1667939271689,MATH 208,A00,098027,Izadi; Elham,7,0,10,3
1667939272133,MATH 209,A00,098028,Pollack; Aaron,10,0,10,0
1667939272565,MATH 211A,A00,112919,Rogalski; Daniel,10,0,10,0
1667939272997,MATH 211B,A00,112920,Seward; Brandon M.,10,0,10,0
1667939273427,MATH 218,A00,098029,Li; Bo,10,0,10,0
1667939273854,MATH 220B,A00,098030,Novak; Jonathan I,14,0,15,1
1667939274285,MATH 221A,A00,098031,Ebenfelt; Peter F,14,0,15,1
1667939274710,MATH 231B,A00,098032,Zlatos; Andrej,13,0,15,2
1667939275137,MATH 240B,A00,098033,Ni; Lei,11,0,15,4
1667939275568,MATH 243,A00,098034,Jekel; David Andrew,10,0,10,0
1667939275998,MATH 245A,A00,098035,Nie; Jiawang,4,0,15,11
1667939276521,MATH 248,A00,098036,Bejenaru; Ioan,10,0,10,0
1667939276953,MATH 250B,A00,098037,Spolaor; Luca,14,0,15,1
1667939277380,MATH 258,A00,098038,Ni; Lei,10,0,10,0
1667939277803,MATH 264B,A00,098041,Rhoades; Brendon Patrick,13,0,15,2
1667939278227,MATH 268,A00,098042,Buss; Samuel R,10,0,10,0
1667939278650,MATH 269,A00,098043,Rhoades; Brendon Patrick,10,0,10,0
1667939279075,MATH 270B,A00,098044,Li; Bo,11,0,15,4
1667939279500,MATH 272B,A00,098045,Holst; Michael J,13,0,15,2
1667939279926,MATH 273A,A00,098046,Tian; Xiaochuan,12,0,15,3
1667939280355,MATH 275,A01,098048,Tian; Xiaochuan,6,0,10,4
1667939280787,MATH 278A,A00,098049,Holst; Michael J,8,0,10,2
1667939281218,MATH 278B,A00,098050,Cloninger; Alexander,10,0,10,0
1667939281642,MATH 278C,A00,098051,Nie; Jiawang,8,0,10,2
1667939282067,MATH 280B,A00,098052,Zheng; Tianyi,12,0,15,3
1667939282493,MATH 281B,A00,098053,Bradic; Jelena,4,0,15,11
1667939282920,MATH 282B,A00,098054,Arias-Castro; Ery,2,0,15,13
1667939283348,MATH 285,A00,098055,Fitzsimmons; Patrick J,0,0,15,15
1667939283779,MATH 287B,A00,098056,Arias-Castro; Ery,8,0,15,7
1667939284209,MATH 288,A00,098057,Agarwal; Pooja,9,0,10,1
1667939284209,MATH 288,B00,098058,Zhang; Danna,9,0,10,1
1667939284209,MATH 288,C00,098059,Williams; Ruth J,10,0,10,0
1667939284633,MATH 290B,A00,098060,Roberts; Justin Deritter,14,0,15,1
1667939285055,MATH 292,A00,098061,Belmont; Eva Kinoshita,10,0,10,0
1667939285488,MATH 295,A00,098062,Suk; Andrew Hoon,48,0,50,2
1667939285914,MATH 296,A00,098063,Novak; Jonathan I,20,0,20,0
1667939286355,MATH 297,001,098064,Gamst; Anthony Collins,9997,0,9999,2
1667939791354,COGS 205,A00,101395,Chiba; Andrea,19,0,20,1
1667939791780,COGS 210B,001,101404,Greene; Deanna Jacquelyn,9998,0,9999,1
1667939791780,COGS 210B,002,101417,Xia; Haijun,9999,0,9999,0
1667939791780,COGS 210B,003,101422,Nitz; Douglas A.,9999,0,9999,0
1667939791780,COGS 210B,004,101423,Hollan; James D.,9998,0,9999,1
1667939791780,COGS 210B,005,101424,Deak; Gedeon O.,9999,0,9999,0
1667939791780,COGS 210B,006,101425,Rossano; Federico,9999,0,9999,0
1667939792210,COGS 211B,A00,101427,Coulson; Seana M,9997,0,9999,2
1667939792641,COGS 220,A00,101428,Hollan; James D.,0,0,25,25
1667939793063,COGS 229,A00,101429,Dow; Steven P,18,0,25,7
1667939793493,COGS 230,A00,101430,Klemmer; Scott R,13,0,17,4
1667939793916,COGS 234,A00,101431,Xia; Haijun,10,0,25,15
1667939794341,COGS 260,A00,101432,Kiyonaga; Anastasia,20,0,25,5
1667939794341,COGS 260,B00,101433,Kirsh; David Joel,17,0,25,8
1667939794768,CSE 202,A00,102371,Impagliazzo; Russell,0,0,0,0
1667939795195,CSE 203B,A01,102373,Cheng; Chung Kuan,0,0,0,0
1667939795618,CSE 208,A00,102374,Micciancio; Daniele,0,0,0,0
1667939796040,CSE 209A,A00,112895,Impagliazzo; Russell,0,0,15,15
1667939796469,CSE 209B,A00,108005,Bellare; Mihir,0,0,0,0
1667939796893,CSE 210,A00,113163,Coblenz; Michael J,0,0,0,0
1667939797318,CSE 219,A00,106111,Dow; Steven P,0,0,20,20
1667939797748,CSE 221,A00,102376,Voelker; Geoffrey M.,0,0,0,0
1667939798175,CSE 224,A01,102378,Porter; George M,0,0,0,0
1667939798600,CSE 229A,A00,102379,Savage; Stefan,0,0,0,0
1667939799029,CSE 229C,A00,102380,Munyaka; Imani N. S.,0,0,0,0
1667939799460,CSE 232B,A00,102382,Deutsch; Alin Bernard,0,0,0,0
1667939799884,CSE 234,A01,112904,Kumar; Arun Kumar,0,0,0,0
1667939800308,CSE 237A,A00,102383,Rosing; Tajana Simunic,0,0,0,0
1667939800733,CSE 239A,A00,102384,Deutsch; Alin Bernard,0,0,0,0
1667939801161,CSE 239B,A00,102385,Polikarpova; Nadezhda,0,0,0,0
1667939801683,CSE 240A,A00,102386,Pannuto; Patrick William,0,0,0,0
1667939802106,CSE 240B,A00,102387,Zhao; Jishen,0,0,0,0
1667939802530,CSE 241A,A00,106406,Kang; Mingu,0,0,0,0
1667939802956,CSE 249B,A00,102388,Kahng; Andrew Byun,0,0,8,8
1667939803385,CSE 251B,A01,102392,Cottrell; Garrison W,0,0,0,0
1667939803385,CSE 251B,A02,102393,Cottrell; Garrison W,0,0,0,0
1667939803824,CSE 252B,A00,102394,Ochoa; Benjamin Lawrence,0,0,0,0
1667939804247,CSE 257,A01,102396,Gao; Sicun,0,0,0,0
1667939804674,CSE 272,A00,102397,Li; Tzumao,0,0,0,0
1667939805100,CSE 274,A00,111323,Chern; Albert Ren-Haur,0,0,0,0
1667939805523,CSE 282,A00,102398,Pevzner; Pavel Arkadjevich,0,0,0,0
1667939805955,CSE 284,A00,114175,Gymrek; Melissa Ann,0,0,0,0
1667939806387,CSE 290,A00,102399,Chandraker; Manmohan Krishna,0,0,0,0
1667939806387,CSE 290,B00,102400,Vaccaro; Kristen Marie,0,0,25,25
1667939806387,CSE 290,C00,102414,Pannuto; Patrick William,1,0,25,24
1667939806387,CSE 290,D00,102427,Pevzner; Pavel Arkadjevich,0,0,0,0
1667939806387,CSE 290,E00,102429,Zhao; Jishen,0,0,0,0
1667939806387,CSE 290,F00,102436,Tullsen; Dean Michael,0,0,0,0
1667939806387,CSE 290,G00,102440,Christensen; Henrik I,0,0,20,20
1667939806821,CSE 291,A00,102443,Su; Hao,0,0,0,0
1667939806821,CSE 291,B00,102448,Polikarpova; Nadezhda,0,0,0,0
1667939806821,CSE 291,C00,102453,Vaccaro; Kristen Marie,0,0,0,0
1667939806821,CSE 291,D00,111343,Savage; Stefan,0,0,0,0
1667939806821,CSE 291,E00,116474,Claffy; Kimberly Claire,0,0,0,0
1667939806821,CSE 291,F00,116479,Pasquale; Joseph,0,0,0,0
1667939807259,CSE 293,001,119111,Bafna; Vineet,9999,0,9999,0
1667939807259,CSE 293,002,119118,Bellare; Mihir,9999,0,9999,0
1667939807259,CSE 293,003,119122,Berg-Kirkpatrick; Taylor D,9999,0,9999,0
1667939807259,CSE 293,004,119135,Christensen; Henrik I,9999,0,9999,0
1667939807259,CSE 293,005,119142,Cottrell; Garrison W,9999,0,9999,0
1667939807259,CSE 293,006,119146,Deutsch; Alin Bernard,9999,0,9999,0
1667939807259,CSE 293,007,119159,Esmaeilzadeh; Hadi,9999,0,9999,0
1667939807259,CSE 293,008,119166,Freund; Yoav,9999,0,9999,0
1667939807259,CSE 293,009,119170,Griswold; William G.,9999,0,9999,0
1667939807259,CSE 293,010,119183,Gymrek; Melissa Ann,9999,0,9999,0
1667939807259,CSE 293,011,119190,Heninger; Nadia A,9999,0,9999,0
1667939807259,CSE 293,012,119230,Impagliazzo; Russell,9999,0,9999,0
1667939807259,CSE 293,013,119232,Jhala; Ranjit,9999,0,9999,0
1667939807259,CSE 293,014,119233,Kahng; Andrew Byun,9999,0,9999,0
1667939807259,CSE 293,015,119298,Kane; Daniel Mertz,9999,0,9999,0
1667939807259,CSE 293,016,119299,Kriegman; David J,9999,0,9999,0
1667939807259,CSE 293,017,119300,Kumar; Arun Kumar,9999,0,9999,0
1667939807259,CSE 293,018,119301,Lerner; Sorin,9999,0,9999,0
1667939807259,CSE 293,019,119302,Lovett; Shachar,9999,0,9999,0
1667939807259,CSE 293,020,119303,McAuley; Julian John,9999,0,9999,0
1667939807259,CSE 293,021,119304,Micciancio; Daniele,9999,0,9999,0
1667939807259,CSE 293,022,119367,Orailoglu; Alex,9999,0,9999,0
1667939807259,CSE 293,023,119382,Paturi; Ramamohan,9999,0,9999,0
1667939807259,CSE 293,024,119404,Polikarpova; Nadezhda,9999,0,9999,0
1667939807259,CSE 293,025,119406,Politz; Joseph Gibbs,9999,0,9999,0
1667939807259,CSE 293,026,119411,Porter; George M,9999,0,9999,0
1667939807259,CSE 293,027,119414,Porter; Leonard Emerson,9999,0,9999,0
1667939807259,CSE 293,028,119416,Ramamoorthi; Ravi,9999,0,9999,0
1667939807259,CSE 293,029,119417,Sahoo; Debashis,9999,0,9999,0
1667939807259,CSE 293,030,119420,Saul; Lawrence,9999,0,9999,0
1667939807259,CSE 293,031,119421,Savage; Stefan,9999,0,9999,0
1667939807259,CSE 293,032,119425,Schulze; Jurgen P.,9999,0,9999,0
1667939807259,CSE 293,033,119426,Snoeren; Alex C.,9999,0,9999,0
1667939807259,CSE 293,034,119428,Shang; Jingbo,9999,0,9999,0
1667939807259,CSE 293,035,119430,Stefan; Deian,9999,0,9999,0
1667939807259,CSE 293,036,119431,Su; Hao,9999,0,9999,0
1667939807259,CSE 293,037,119433,Swanson; Steven James,9999,0,9999,0
1667939807259,CSE 293,038,119435,Tullsen; Dean Michael,9999,0,9999,0
1667939807259,CSE 293,039,119483,Voelker; Geoffrey M.,9999,0,9999,0
1667939807259,CSE 293,040,119537,Zhao; Jishen,9999,0,9999,0
1667939807259,CSE 293,041,119538,Zhou; Yuan-Yuan,9999,0,9999,0
1667939807259,CSE 293,042,119539,Gao; Sicun,9999,0,9999,0
1667939807259,CSE 293,043,119540,Weibel; Nadir,9999,0,9999,0
1667939807259,CSE 293,044,119541,Gupta; Rajesh K.,9999,0,9999,0
1667939807681,CSE 294,A00,102459,Voelker; Geoffrey M.,0,0,0,0
1667939807681,CSE 294,B00,111322,Orailoglu; Alex,0,0,0,0
1667939808106,DSE 201,A00,096914,Deutsch; Alin Bernard,30,0,30,0
1667939808546,DSE 210,A00,096915,Dasgupta; Sanjoy,30,0,30,0
1667939808977,DSE 260A,A00,096916,Altintas De Callaf; Ilkay,30,0,30,0
1667939809466,ECE 200,001,103586,Antipa; Nicholas A,9999,0,9999,0
1667939809466,ECE 200,002,103587,Atanasov; Nikolay A.,9999,0,9999,0
1667939809466,ECE 200,003,103588,Bharadia; Dinesh,9999,0,9999,0
1667939809466,ECE 200,004,103589,Cheng; Chung Kuan,9999,0,9999,0
1667939809466,ECE 200,005,103590,Cosman; Pamela C.,9999,0,9999,0
1667939809466,ECE 200,006,103591,Dayeh; Shadi Ahmad,9999,0,9999,0
1667939809466,ECE 200,007,103592,Fainman; Yeshaiahu,9999,0,9999,0
1667939809466,ECE 200,008,103593,Ford; Joseph Earl,9999,0,9999,0
1667939809466,ECE 200,009,103594,Franceschetti; Massimo,9999,0,9999,0
1667939809466,ECE 200,010,103595,Fullerton; Eric E,9999,0,9999,0
1667939809466,ECE 200,011,103596,Galton; Ian A,9999,0,9999,0
1667939809466,ECE 200,012,103597,Gilja; Vikash,9999,0,9999,0
1667939809466,ECE 200,013,103598,Hall; Drew A.,9999,0,9999,0
1667939809466,ECE 200,014,103599,Hsueh; Tzu-Chien,9999,0,9999,0
1667939809466,ECE 200,015,103600,Javidi; Tara,9999,0,9999,0
1667939809466,ECE 200,016,103601,Kahng; Andrew Byun,9999,0,9999,0
1667939809466,ECE 200,017,103602,Kim; Young-Han,9999,0,9999,0
1667939809466,ECE 200,018,103603,Koushanfar; Farinaz,9999,0,9999,0
1667939809466,ECE 200,019,103604,Kuzum; Duygu,9999,0,9999,0
1667939809466,ECE 200,020,103605,Le; Hanh-Phuc,9999,0,9999,0
1667939809466,ECE 200,021,103606,Lin; Bill,9999,0,9999,0
1667939809466,ECE 200,022,103607,Liu; Zhaowei,9998,0,9999,1
1667939809466,ECE 200,023,103608,Lo; Yu-Hwa,9999,0,9999,0
1667939809466,ECE 200,024,103609,Lomakin; Vitaliy,9999,0,9999,0
1667939809466,ECE 200,025,103610,Mercier; Patrick Philip,9999,0,9999,0
1667939809466,ECE 200,026,103611,Meyer; Florian,9999,0,9999,0
1667939809466,ECE 200,027,103612,Milstein; Laurence B.,9999,0,9999,0
1667939809466,ECE 200,028,103613,Mir Arabbaygi; Siavash,9999,0,9999,0
1667939809466,ECE 200,029,103614,Mookherjea; Shayan,9999,0,9999,0
1667939809466,ECE 200,030,103615,Morris; Karcher William,9999,0,9999,0
1667939809466,ECE 200,031,103616,Ng; Tse Nga,9999,0,9999,0
1667939809466,ECE 200,032,103617,Nguyen; Truong Quang,9999,0,9999,0
1667939809466,ECE 200,033,103618,Nomura; Kenji,9999,0,9999,0
1667939809466,ECE 200,034,103619,Orlitsky; Alon,9999,0,9999,0
1667939809466,ECE 200,035,103620,Pal; Piya,9999,0,9999,0
1667939809466,ECE 200,036,103621,Papen; George C.,9999,0,9999,0
1667939809466,ECE 200,037,103622,Radic; Stojan,9999,0,9999,0
1667939809466,ECE 200,038,103623,Rao; Bhaskar D.,9999,0,9999,0
1667939809466,ECE 200,039,103624,Rao; Ramesh R,9999,0,9999,0
1667939809466,ECE 200,040,103625,Rebeiz; Gabriel,9999,0,9999,0
1667939809466,ECE 200,041,103626,Sanford; John R,9999,0,9999,0
1667939809466,ECE 200,042,103627,Siegel; Paul H.,9999,0,9999,0
1667939809466,ECE 200,043,103628,Sievenpiper; Daniel F.,9999,0,9999,0
1667939809466,ECE 200,044,103629,Sworder; David D.,9999,0,9999,0
1667939809466,ECE 200,045,103630,Taur; Yuan,9999,0,9999,0
1667939809466,ECE 200,046,103631,Touri; Behrouz,9999,0,9999,0
1667939809466,ECE 200,047,103632,Trivedi; Mohan M.,9999,0,9999,0
1667939809466,ECE 200,048,103633,Vasconcelos; Nuno,9999,0,9999,0
1667939809466,ECE 200,049,103634,Wang; Xiaolong,9999,0,9999,0
1667939809466,ECE 200,050,103635,Xie; Pengtao,9999,0,9999,0
1667939809466,ECE 200,051,103636,Yip; Michael,9999,0,9999,0
1667939809466,ECE 200,052,103637,Zeger; Kenneth A.,999,0,999,0
1667939809466,ECE 200,053,103638,Zhang; Xinyu,9999,0,9999,0
1667939809466,ECE 200,054,103639,Turakhia; Yatish Girish,9999,0,9999,0
1667939809466,ECE 200,055,103640,Kang; Mingu,9999,0,9999,0
1667939809466,ECE 200,056,103641,Shi; Yuanyuan,9999,0,9999,0
1667939809466,ECE 200,057,103642,Wang; Edward Jay,9999,0,9999,0
1667939809466,ECE 200,058,103643,Zheng; Yang,9999,0,9999,0
1667939809889,ECE 202,A00,103644,Kuzum; Duygu,0,0,0,0
1667939810312,ECE 212BN,A00,103646,Ng; Tse Nga,0,0,0,0
1667939810740,ECE 221,A00,111493,Staff,0,0,0,0
1667939811164,ECE 222B,A00,103647,Lomakin; Vitaliy,0,0,0,0
1667939811596,ECE 230B,A00,103648,Taur; Yuan,0,0,0,0
1667939812022,ECE 238B,A00,103649,Garay; Javier,0,0,0,0
1667939812450,ECE 240B,A00,112900,Fainman; Yeshaiahu,0,0,0,0
1667939812873,ECE 247A,A00,103650,Jokerst; Jesse Vincent,0,0,0,0
1667939813297,ECE 247B,A00,103651,Wang; Joseph,0,0,0,0
1667939813725,ECE 250,A00,103652,Siegel; Paul H.,0,0,0,0
1667939814148,ECE 251A,A00,103654,Rao; Bhaskar D.,0,0,0,0
1667939814572,ECE 257B,A00,103655,Bharadia; Dinesh,0,0,0,0
1667939814998,ECE 258A,A00,103656,Milstein; Laurence B.,0,0,0,0
1667939815429,ECE 260B,A00,103658,Kang; Mingu,0,0,0,0
1667939815855,ECE 264A,A00,103659,Galton; Ian A,0,0,0,0
1667939816290,ECE 265A,A00,103661,Gudem; Prasad S.S.,0,0,0,0
1667939816713,ECE 265D,A00,103662,Gudem; Prasad S.S.,0,0,0,0
1667939817138,ECE 268,A00,103663,Koushanfar; Farinaz,0,0,0,0
1667939817571,ECE 269,A01,103665,Pal; Piya,0,0,0,0
1667939817999,ECE 271B,A00,103666,Vasconcelos; Manuela,0,0,0,0
1667939818431,ECE 276A,A00,103667,Atanasov; Nikolay A.,0,0,0,0
1667939818858,ECE 277,A00,103668,An; Cheolhong,0,0,0,0
1667939819284,ECE 279,A00,117947,Hall; Drew A.,0,0,0,0
1667939820140,ECE 283,A00,103670,Hsueh; Tzu-Chien,0,0,0,0
1667939820570,ECE 284,A00,103671,Turakhia; Yatish Girish,0,0,0,0
1667939820995,ECE 285,A00,103672,Zheng; Yang,0,0,0,0
1667939820995,ECE 285,B00,103673,Sworder; David D.,0,0,0,0
1667939821421,ECE 287,A00,103676,Javidi; Tara,0,0,0,0
1667939821857,MATH 200B,A00,098023,Salehi Golsefidy; Alireza,14,0,15,1
1667939822280,MATH 202B,A00,098024,Rhoades; Brendon Patrick,13,0,15,2
1667939822706,MATH 203B,A00,098025,Oprea; Dragos N.,14,0,15,1
1667939823132,MATH 204B,A00,098026,Sorensen; Claus M,15,0,15,0
1667939823556,MATH 208,A00,098027,Izadi; Elham,7,0,10,3
1667939823981,MATH 209,A00,098028,Pollack; Aaron,10,0,10,0
1667939824413,MATH 211A,A00,112919,Rogalski; Daniel,10,0,10,0
1667939824842,MATH 211B,A00,112920,Seward; Brandon M.,10,0,10,0
1667939825268,MATH 218,A00,098029,Li; Bo,10,0,10,0
1667939825694,MATH 220B,A00,098030,Novak; Jonathan I,14,0,15,1
1667939826120,MATH 221A,A00,098031,Ebenfelt; Peter F,14,0,15,1
1667939826549,MATH 231B,A00,098032,Zlatos; Andrej,13,0,15,2
1667939826975,MATH 240B,A00,098033,Ni; Lei,11,0,15,4
1667939827399,MATH 243,A00,098034,Jekel; David Andrew,10,0,10,0
1667939827825,MATH 245A,A00,098035,Nie; Jiawang,4,0,15,11
1667939828248,MATH 248,A00,098036,Bejenaru; Ioan,10,0,10,0
1667939828672,MATH 250B,A00,098037,Spolaor; Luca,14,0,15,1
1667939829100,MATH 258,A00,098038,Ni; Lei,10,0,10,0
1667939829523,MATH 264B,A00,098041,Rhoades; Brendon Patrick,13,0,15,2
1667939829948,MATH 268,A00,098042,Buss; Samuel R,10,0,10,0
1667939830373,MATH 269,A00,098043,Rhoades; Brendon Patrick,10,0,10,0
1667939830808,MATH 270B,A00,098044,Li; Bo,11,0,15,4
1667939831241,MATH 272B,A00,098045,Holst; Michael J,13,0,15,2
1667939831685,MATH 273A,A00,098046,Tian; Xiaochuan,12,0,15,3
1667939832114,MATH 275,A01,098048,Tian; Xiaochuan,6,0,10,4
1667939832538,MATH 278A,A00,098049,Holst; Michael J,8,0,10,2
1667939832969,MATH 278B,A00,098050,Cloninger; Alexander,10,0,10,0
1667939833401,MATH 278C,A00,098051,Nie; Jiawang,7,0,10,3
1667939833828,MATH 280B,A00,098052,Zheng; Tianyi,12,0,15,3
1667939834252,MATH 281B,A00,098053,Bradic; Jelena,4,0,15,11
1667939834678,MATH 282B,A00,098054,Arias-Castro; Ery,2,0,15,13
1667939835107,MATH 285,A00,098055,Fitzsimmons; Patrick J,0,0,15,15
1667939835536,MATH 287B,A00,098056,Arias-Castro; Ery,8,0,15,7
1667939835975,MATH 288,A00,098057,Agarwal; Pooja,9,0,10,1
1667939835975,MATH 288,B00,098058,Zhang; Danna,9,0,10,1
1667939835975,MATH 288,C00,098059,Williams; Ruth J,10,0,10,0
1667939836397,MATH 290B,A00,098060,Roberts; Justin Deritter,14,0,15,1
1667939836822,MATH 292,A00,098061,Belmont; Eva Kinoshita,10,0,10,0
1667939837259,MATH 295,A00,098062,Suk; Andrew Hoon,48,0,50,2
1667939837684,MATH 296,A00,098063,Novak; Jonathan I,20,0,20,0
1667939838111,MATH 297,001,098064,Gamst; Anthony Collins,9997,0,9999,2
1667940341383,COGS 205,A00,101395,Chiba; Andrea,19,0,20,1
1667940341814,COGS 210B,001,101404,Greene; Deanna Jacquelyn,9998,0,9999,1
1667940341814,COGS 210B,002,101417,Xia; Haijun,9999,0,9999,0
1667940341814,COGS 210B,003,101422,Nitz; Douglas A.,9999,0,9999,0
1667940341814,COGS 210B,004,101423,Hollan; James D.,9998,0,9999,1
1667940341814,COGS 210B,005,101424,Deak; Gedeon O.,9999,0,9999,0
1667940341814,COGS 210B,006,101425,Rossano; Federico,9999,0,9999,0
1667940342238,COGS 211B,A00,101427,Coulson; Seana M,9997,0,9999,2
1667940342662,COGS 220,A00,101428,Hollan; James D.,0,0,25,25
1667940343100,COGS 229,A00,101429,Dow; Steven P,18,0,25,7
1667940343529,COGS 230,A00,101430,Klemmer; Scott R,13,0,17,4
1667940343953,COGS 234,A00,101431,Xia; Haijun,10,0,25,15
1667940344382,COGS 260,A00,101432,Kiyonaga; Anastasia,20,0,25,5
1667940344382,COGS 260,B00,101433,Kirsh; David Joel,17,0,25,8
1667940344805,CSE 202,A00,102371,Impagliazzo; Russell,0,0,0,0
1667940345234,CSE 203B,A01,102373,Cheng; Chung Kuan,0,0,0,0
1667940345673,CSE 208,A00,102374,Micciancio; Daniele,0,0,0,0
1667940346098,CSE 209A,A00,112895,Impagliazzo; Russell,0,0,15,15
1667940346521,CSE 209B,A00,108005,Bellare; Mihir,0,0,0,0
1667940346948,CSE 210,A00,113163,Coblenz; Michael J,0,0,0,0
1667940347371,CSE 219,A00,106111,Dow; Steven P,0,0,20,20
1667940347799,CSE 221,A00,102376,Voelker; Geoffrey M.,0,0,0,0
1667940348228,CSE 224,A01,102378,Porter; George M,0,0,0,0
1667940348654,CSE 229A,A00,102379,Savage; Stefan,0,0,0,0
1667940349086,CSE 229C,A00,102380,Munyaka; Imani N. S.,0,0,0,0
1667940349513,CSE 232B,A00,102382,Deutsch; Alin Bernard,0,0,0,0
1667940349939,CSE 234,A01,112904,Kumar; Arun Kumar,0,0,0,0
1667940350374,CSE 237A,A00,102383,Rosing; Tajana Simunic,0,0,0,0
1667940350806,CSE 239A,A00,102384,Deutsch; Alin Bernard,0,0,0,0
1667940351233,CSE 239B,A00,102385,Polikarpova; Nadezhda,0,0,0,0
1667940351657,CSE 240A,A00,102386,Pannuto; Patrick William,0,0,0,0
1667940352085,CSE 240B,A00,102387,Zhao; Jishen,0,0,0,0
1667940352507,CSE 241A,A00,106406,Kang; Mingu,0,0,0,0
1667940352931,CSE 249B,A00,102388,Kahng; Andrew Byun,0,0,8,8
1667940353358,CSE 251B,A01,102392,Cottrell; Garrison W,0,0,0,0
1667940353358,CSE 251B,A02,102393,Cottrell; Garrison W,0,0,0,0
1667940353784,CSE 252B,A00,102394,Ochoa; Benjamin Lawrence,0,0,0,0
1667940354211,CSE 257,A01,102396,Gao; Sicun,0,0,0,0
1667940354645,CSE 272,A00,102397,Li; Tzumao,0,0,0,0
1667940355067,CSE 274,A00,111323,Chern; Albert Ren-Haur,0,0,0,0
1667940355491,CSE 282,A00,102398,Pevzner; Pavel Arkadjevich,0,0,0,0
1667940355919,CSE 284,A00,114175,Gymrek; Melissa Ann,0,0,0,0
1667940356346,CSE 290,A00,102399,Chandraker; Manmohan Krishna,0,0,0,0
1667940356346,CSE 290,B00,102400,Vaccaro; Kristen Marie,0,0,25,25
1667940356346,CSE 290,C00,102414,Pannuto; Patrick William,1,0,25,24
1667940356346,CSE 290,D00,102427,Pevzner; Pavel Arkadjevich,0,0,0,0
1667940356346,CSE 290,E00,102429,Zhao; Jishen,0,0,0,0
1667940356346,CSE 290,F00,102436,Tullsen; Dean Michael,0,0,0,0
1667940356346,CSE 290,G00,102440,Christensen; Henrik I,0,0,20,20
1667940356770,CSE 291,A00,102443,Su; Hao,0,0,0,0
1667940356770,CSE 291,B00,102448,Polikarpova; Nadezhda,0,0,0,0
1667940356770,CSE 291,C00,102453,Vaccaro; Kristen Marie,0,0,0,0
1667940356770,CSE 291,D00,111343,Savage; Stefan,0,0,0,0
1667940356770,CSE 291,E00,116474,Claffy; Kimberly Claire,0,0,0,0
1667940356770,CSE 291,F00,116479,Pasquale; Joseph,0,0,0,0
1667940357200,CSE 293,001,119111,Bafna; Vineet,9999,0,9999,0
1667940357200,CSE 293,002,119118,Bellare; Mihir,9999,0,9999,0
1667940357200,CSE 293,003,119122,Berg-Kirkpatrick; Taylor D,9999,0,9999,0
1667940357200,CSE 293,004,119135,Christensen; Henrik I,9999,0,9999,0
1667940357200,CSE 293,005,119142,Cottrell; Garrison W,9999,0,9999,0
1667940357200,CSE 293,006,119146,Deutsch; Alin Bernard,9999,0,9999,0
1667940357200,CSE 293,007,119159,Esmaeilzadeh; Hadi,9999,0,9999,0
1667940357200,CSE 293,008,119166,Freund; Yoav,9999,0,9999,0
1667940357200,CSE 293,009,119170,Griswold; William G.,9999,0,9999,0
1667940357200,CSE 293,010,119183,Gymrek; Melissa Ann,9999,0,9999,0
1667940357200,CSE 293,011,119190,Heninger; Nadia A,9999,0,9999,0
1667940357200,CSE 293,012,119230,Impagliazzo; Russell,9999,0,9999,0
1667940357200,CSE 293,013,119232,Jhala; Ranjit,9999,0,9999,0
1667940357200,CSE 293,014,119233,Kahng; Andrew Byun,9999,0,9999,0
1667940357200,CSE 293,015,119298,Kane; Daniel Mertz,9999,0,9999,0
1667940357200,CSE 293,016,119299,Kriegman; David J,9999,0,9999,0
1667940357200,CSE 293,017,119300,Kumar; Arun Kumar,9999,0,9999,0
1667940357200,CSE 293,018,119301,Lerner; Sorin,9999,0,9999,0
1667940357200,CSE 293,019,119302,Lovett; Shachar,9999,0,9999,0
1667940357200,CSE 293,020,119303,McAuley; Julian John,9999,0,9999,0
1667940357200,CSE 293,021,119304,Micciancio; Daniele,9999,0,9999,0
1667940357200,CSE 293,022,119367,Orailoglu; Alex,9999,0,9999,0
1667940357200,CSE 293,023,119382,Paturi; Ramamohan,9999,0,9999,0
1667940357200,CSE 293,024,119404,Polikarpova; Nadezhda,9999,0,9999,0
1667940357200,CSE 293,025,119406,Politz; Joseph Gibbs,9999,0,9999,0
1667940357200,CSE 293,026,119411,Porter; George M,9999,0,9999,0
1667940357200,CSE 293,027,119414,Porter; Leonard Emerson,9999,0,9999,0
1667940357200,CSE 293,028,119416,Ramamoorthi; Ravi,9999,0,9999,0
1667940357200,CSE 293,029,119417,Sahoo; Debashis,9999,0,9999,0
1667940357200,CSE 293,030,119420,Saul; Lawrence,9999,0,9999,0
1667940357200,CSE 293,031,119421,Savage; Stefan,9999,0,9999,0
1667940357200,CSE 293,032,119425,Schulze; Jurgen P.,9999,0,9999,0
1667940357200,CSE 293,033,119426,Snoeren; Alex C.,9999,0,9999,0
1667940357200,CSE 293,034,119428,Shang; Jingbo,9999,0,9999,0
1667940357200,CSE 293,035,119430,Stefan; Deian,9999,0,9999,0
1667940357200,CSE 293,036,119431,Su; Hao,9999,0,9999,0
1667940357200,CSE 293,037,119433,Swanson; Steven James,9999,0,9999,0
1667940357200,CSE 293,038,119435,Tullsen; Dean Michael,9999,0,9999,0
1667940357200,CSE 293,039,119483,Voelker; Geoffrey M.,9999,0,9999,0
1667940357200,CSE 293,040,119537,Zhao; Jishen,9999,0,9999,0
1667940357200,CSE 293,041,119538,Zhou; Yuan-Yuan,9999,0,9999,0
1667940357200,CSE 293,042,119539,Gao; Sicun,9999,0,9999,0
1667940357200,CSE 293,043,119540,Weibel; Nadir,9999,0,9999,0
1667940357200,CSE 293,044,119541,Gupta; Rajesh K.,9999,0,9999,0
1667940357641,CSE 294,A00,102459,Voelker; Geoffrey M.,0,0,0,0
1667940357641,CSE 294,B00,111322,Orailoglu; Alex,0,0,0,0
1667940358065,DSE 201,A00,096914,Deutsch; Alin Bernard,30,0,30,0
1667940358492,DSE 210,A00,096915,Dasgupta; Sanjoy,30,0,30,0
1667940358914,DSE 260A,A00,096916,Altintas De Callaf; Ilkay,30,0,30,0
1667940359392,ECE 200,001,103586,Antipa; Nicholas A,9999,0,9999,0
1667940359392,ECE 200,002,103587,Atanasov; Nikolay A.,9999,0,9999,0
1667940359392,ECE 200,003,103588,Bharadia; Dinesh,9999,0,9999,0
1667940359392,ECE 200,004,103589,Cheng; Chung Kuan,9999,0,9999,0
1667940359392,ECE 200,005,103590,Cosman; Pamela C.,9999,0,9999,0
1667940359392,ECE 200,006,103591,Dayeh; Shadi Ahmad,9999,0,9999,0
1667940359392,ECE 200,007,103592,Fainman; Yeshaiahu,9999,0,9999,0
1667940359392,ECE 200,008,103593,Ford; Joseph Earl,9999,0,9999,0
1667940359392,ECE 200,009,103594,Franceschetti; Massimo,9999,0,9999,0
1667940359392,ECE 200,010,103595,Fullerton; Eric E,9999,0,9999,0
1667940359392,ECE 200,011,103596,Galton; Ian A,9999,0,9999,0
1667940359392,ECE 200,012,103597,Gilja; Vikash,9999,0,9999,0
1667940359392,ECE 200,013,103598,Hall; Drew A.,9999,0,9999,0
1667940359392,ECE 200,014,103599,Hsueh; Tzu-Chien,9999,0,9999,0
1667940359392,ECE 200,015,103600,Javidi; Tara,9999,0,9999,0
1667940359392,ECE 200,016,103601,Kahng; Andrew Byun,9999,0,9999,0
1667940359392,ECE 200,017,103602,Kim; Young-Han,9999,0,9999,0
1667940359392,ECE 200,018,103603,Koushanfar; Farinaz,9999,0,9999,0
1667940359392,ECE 200,019,103604,Kuzum; Duygu,9999,0,9999,0
1667940359392,ECE 200,020,103605,Le; Hanh-Phuc,9999,0,9999,0
1667940359392,ECE 200,021,103606,Lin; Bill,9999,0,9999,0
1667940359392,ECE 200,022,103607,Liu; Zhaowei,9998,0,9999,1
1667940359392,ECE 200,023,103608,Lo; Yu-Hwa,9999,0,9999,0
1667940359392,ECE 200,024,103609,Lomakin; Vitaliy,9999,0,9999,0
1667940359392,ECE 200,025,103610,Mercier; Patrick Philip,9999,0,9999,0
1667940359392,ECE 200,026,103611,Meyer; Florian,9999,0,9999,0
1667940359392,ECE 200,027,103612,Milstein; Laurence B.,9999,0,9999,0
1667940359392,ECE 200,028,103613,Mir Arabbaygi; Siavash,9999,0,9999,0
1667940359392,ECE 200,029,103614,Mookherjea; Shayan,9999,0,9999,0
1667940359392,ECE 200,030,103615,Morris; Karcher William,9999,0,9999,0
1667940359392,ECE 200,031,103616,Ng; Tse Nga,9999,0,9999,0
1667940359392,ECE 200,032,103617,Nguyen; Truong Quang,9999,0,9999,0
1667940359392,ECE 200,033,103618,Nomura; Kenji,9999,0,9999,0
1667940359392,ECE 200,034,103619,Orlitsky; Alon,9999,0,9999,0
1667940359392,ECE 200,035,103620,Pal; Piya,9999,0,9999,0
1667940359392,ECE 200,036,103621,Papen; George C.,9999,0,9999,0
1667940359392,ECE 200,037,103622,Radic; Stojan,9999,0,9999,0
1667940359392,ECE 200,038,103623,Rao; Bhaskar D.,9999,0,9999,0
1667940359392,ECE 200,039,103624,Rao; Ramesh R,9999,0,9999,0
1667940359392,ECE 200,040,103625,Rebeiz; Gabriel,9999,0,9999,0
1667940359392,ECE 200,041,103626,Sanford; John R,9999,0,9999,0
1667940359392,ECE 200,042,103627,Siegel; Paul H.,9999,0,9999,0
1667940359392,ECE 200,043,103628,Sievenpiper; Daniel F.,9999,0,9999,0
1667940359392,ECE 200,044,103629,Sworder; David D.,9999,0,9999,0
1667940359392,ECE 200,045,103630,Taur; Yuan,9999,0,9999,0
1667940359392,ECE 200,046,103631,Touri; Behrouz,9999,0,9999,0
1667940359392,ECE 200,047,103632,Trivedi; Mohan M.,9999,0,9999,0
1667940359392,ECE 200,048,103633,Vasconcelos; Nuno,9999,0,9999,0
1667940359392,ECE 200,049,103634,Wang; Xiaolong,9999,0,9999,0
1667940359392,ECE 200,050,103635,Xie; Pengtao,9999,0,9999,0
1667940359392,ECE 200,051,103636,Yip; Michael,9999,0,9999,0
1667940359392,ECE 200,052,103637,Zeger; Kenneth A.,999,0,999,0
1667940359392,ECE 200,053,103638,Zhang; Xinyu,9999,0,9999,0
1667940359392,ECE 200,054,103639,Turakhia; Yatish Girish,9999,0,9999,0
1667940359392,ECE 200,055,103640,Kang; Mingu,9999,0,9999,0
1667940359392,ECE 200,056,103641,Shi; Yuanyuan,9999,0,9999,0
1667940359392,ECE 200,057,103642,Wang; Edward Jay,9999,0,9999,0
1667940359392,ECE 200,058,103643,Zheng; Yang,9999,0,9999,0
1667940359815,ECE 202,A00,103644,Kuzum; Duygu,0,0,0,0
1667940360253,ECE 212BN,A00,103646,Ng; Tse Nga,0,0,0,0
1667940360685,ECE 221,A00,111493,Staff,0,0,0,0
1667940361111,ECE 222B,A00,103647,Lomakin; Vitaliy,0,0,0,0
1667940361536,ECE 230B,A00,103648,Taur; Yuan,0,0,0,0
1667940361963,ECE 238B,A00,103649,Garay; Javier,0,0,0,0
1667940362391,ECE 240B,A00,112900,Fainman; Yeshaiahu,0,0,0,0
1667940362817,ECE 247A,A00,103650,Jokerst; Jesse Vincent,0,0,0,0
1667940363239,ECE 247B,A00,103651,Wang; Joseph,0,0,0,0
1667940363674,ECE 250,A00,103652,Siegel; Paul H.,0,0,0,0
1667940364126,ECE 251A,A00,103654,Rao; Bhaskar D.,0,0,0,0
1667940364555,ECE 257B,A00,103655,Bharadia; Dinesh,0,0,0,0
1667940364987,ECE 258A,A00,103656,Milstein; Laurence B.,0,0,0,0
1667940365414,ECE 260B,A00,103658,Kang; Mingu,0,0,0,0
1667940365843,ECE 264A,A00,103659,Galton; Ian A,0,0,0,0
1667940366273,ECE 265A,A00,103661,Gudem; Prasad S.S.,0,0,0,0
1667940366697,ECE 265D,A00,103662,Gudem; Prasad S.S.,0,0,0,0
1667940367129,ECE 268,A00,103663,Koushanfar; Farinaz,0,0,0,0
1667940367552,ECE 269,A01,103665,Pal; Piya,0,0,0,0
1667940367979,ECE 271B,A00,103666,Vasconcelos; Manuela,0,0,0,0
1667940368486,ECE 276A,A00,103667,Atanasov; Nikolay A.,0,0,0,0
1667940368913,ECE 277,A00,103668,An; Cheolhong,0,0,0,0
1667940369347,ECE 279,A00,117947,Hall; Drew A.,0,0,0,0
1667940370203,ECE 283,A00,103670,Hsueh; Tzu-Chien,0,0,0,0
1667940370630,ECE 284,A00,103671,Turakhia; Yatish Girish,0,0,0,0
1667940371064,ECE 285,A00,103672,Zheng; Yang,0,0,0,0
1667940371064,ECE 285,B00,103673,Sworder; David D.,0,0,0,0
1667940371496,ECE 287,A00,103676,Javidi; Tara,0,0,0,0
1667940371927,MATH 200B,A00,098023,Salehi Golsefidy; Alireza,14,0,15,1
1667940372365,MATH 202B,A00,098024,Rhoades; Brendon Patrick,13,0,15,2
1667940372789,MATH 203B,A00,098025,Oprea; Dragos N.,14,0,15,1
1667940373219,MATH 204B,A00,098026,Sorensen; Claus M,15,0,15,0
1667940373644,MATH 208,A00,098027,Izadi; Elham,7,0,10,3
1667940374070,MATH 209,A00,098028,Pollack; Aaron,10,0,10,0
1667940374502,MATH 211A,A00,112919,Rogalski; Daniel,10,0,10,0
1667940374951,MATH 211B,A00,112920,Seward; Brandon M.,10,0,10,0
1667940375378,MATH 218,A00,098029,Li; Bo,10,0,10,0
1667940375801,MATH 220B,A00,098030,Novak; Jonathan I,14,0,15,1
1667940376233,MATH 221A,A00,098031,Ebenfelt; Peter F,14,0,15,1
1667940376659,MATH 231B,A00,098032,Zlatos; Andrej,13,0,15,2
1667940377091,MATH 240B,A00,098033,Ni; Lei,11,0,15,4
1667940377531,MATH 243,A00,098034,Jekel; David Andrew,10,0,10,0
1667940377954,MATH 245A,A00,098035,Nie; Jiawang,4,0,15,11
1667940378379,MATH 248,A00,098036,Bejenaru; Ioan,10,0,10,0
1667940378807,MATH 250B,A00,098037,Spolaor; Luca,14,0,15,1
1667940379230,MATH 258,A00,098038,Ni; Lei,10,0,10,0
1667940379660,MATH 264B,A00,098041,Rhoades; Brendon Patrick,13,0,15,2
1667940380089,MATH 268,A00,098042,Buss; Samuel R,10,0,10,0
1667940380517,MATH 269,A00,098043,Rhoades; Brendon Patrick,10,0,10,0
1667940380942,MATH 270B,A00,098044,Li; Bo,11,0,15,4
1667940381365,MATH 272B,A00,098045,Holst; Michael J,13,0,15,2
1667940381794,MATH 273A,A00,098046,Tian; Xiaochuan,12,0,15,3
1667940382223,MATH 275,A01,098048,Tian; Xiaochuan,6,0,10,4
1667940382659,MATH 278A,A00,098049,Holst; Michael J,8,0,10,2
1667940383091,MATH 278B,A00,098050,Cloninger; Alexander,10,0,10,0
1667940383519,MATH 278C,A00,098051,Nie; Jiawang,7,0,10,3
1667940383942,MATH 280B,A00,098052,Zheng; Tianyi,12,0,15,3
1667940384365,MATH 281B,A00,098053,Bradic; Jelena,4,0,15,11
1667940384788,MATH 282B,A00,098054,Arias-Castro; Ery,2,0,15,13
1667940385212,MATH 285,A00,098055,Fitzsimmons; Patrick J,0,0,15,15
1667940385639,MATH 287B,A00,098056,Arias-Castro; Ery,8,0,15,7
1667940386072,MATH 288,A00,098057,Agarwal; Pooja,9,0,10,1
1667940386072,MATH 288,B00,098058,Zhang; Danna,9,0,10,1
1667940386072,MATH 288,C00,098059,Williams; Ruth J,10,0,10,0
1667940386500,MATH 290B,A00,098060,Roberts; Justin Deritter,14,0,15,1
1667940386923,MATH 292,A00,098061,Belmont; Eva Kinoshita,10,0,10,0
1667940387348,MATH 295,A00,098062,Suk; Andrew Hoon,48,0,50,2
1667940387781,MATH 296,A00,098063,Novak; Jonathan I,20,0,20,0
1667940388203,MATH 297,001,098064,Gamst; Anthony Collins,9997,0,9999,2
1667940890629,COGS 205,A00,101395,Chiba; Andrea,19,0,20,1
1667940891131,COGS 210B,001,101404,Greene; Deanna Jacquelyn,9998,0,9999,1
1667940891131,COGS 210B,002,101417,Xia; Haijun,9999,0,9999,0
1667940891131,COGS 210B,003,101422,Nitz; Douglas A.,9999,0,9999,0
1667940891131,COGS 210B,004,101423,Hollan; James D.,9998,0,9999,1
1667940891131,COGS 210B,005,101424,Deak; Gedeon O.,9999,0,9999,0
1667940891131,COGS 210B,006,101425,Rossano; Federico,9999,0,9999,0
1667940891555,COGS 211B,A00,101427,Coulson; Seana M,9997,0,9999,2
1667940891986,COGS 220,A00,101428,Hollan; James D.,0,0,25,25
1667940892414,COGS 229,A00,101429,Dow; Steven P,18,0,25,7
1667940892847,COGS 230,A00,101430,Klemmer; Scott R,13,0,17,4
1667940893277,COGS 234,A00,101431,Xia; Haijun,10,0,25,15
1667940893702,COGS 260,A00,101432,Kiyonaga; Anastasia,20,0,25,5
1667940893702,COGS 260,B00,101433,Kirsh; David Joel,17,0,25,8
1667940894138,CSE 202,A00,102371,Impagliazzo; Russell,0,0,0,0
1667940894571,CSE 203B,A01,102373,Cheng; Chung Kuan,0,0,0,0
1667940894998,CSE 208,A00,102374,Micciancio; Daniele,0,0,0,0
1667940895427,CSE 209A,A00,112895,Impagliazzo; Russell,0,0,15,15
1667940895851,CSE 209B,A00,108005,Bellare; Mihir,0,0,0,0
1667940896279,CSE 210,A00,113163,Coblenz; Michael J,0,0,0,0
1667940896707,CSE 219,A00,106111,Dow; Steven P,0,0,20,20
1667940897143,CSE 221,A00,102376,Voelker; Geoffrey M.,0,0,0,0
1667940897577,CSE 224,A01,102378,Porter; George M,0,0,0,0
1667940898006,CSE 229A,A00,102379,Savage; Stefan,0,0,0,0
1667940898434,CSE 229C,A00,102380,Munyaka; Imani N. S.,0,0,0,0
1667940898858,CSE 232B,A00,102382,Deutsch; Alin Bernard,0,0,0,0
1667940899283,CSE 234,A01,112904,Kumar; Arun Kumar,0,0,0,0
1667940899707,CSE 237A,A00,102383,Rosing; Tajana Simunic,0,0,0,0
1667940900132,CSE 239A,A00,102384,Deutsch; Alin Bernard,0,0,0,0
1667940900553,CSE 239B,A00,102385,Polikarpova; Nadezhda,0,0,0,0
1667940900977,CSE 240A,A00,102386,Pannuto; Patrick William,0,0,0,0
1667940901409,CSE 240B,A00,102387,Zhao; Jishen,0,0,0,0
1667940901836,CSE 241A,A00,106406,Kang; Mingu,0,0,0,0
1667940902259,CSE 249B,A00,102388,Kahng; Andrew Byun,0,0,8,8
1667940902687,CSE 251B,A01,102392,Cottrell; Garrison W,0,0,0,0
1667940902687,CSE 251B,A02,102393,Cottrell; Garrison W,0,0,0,0
1667940903115,CSE 252B,A00,102394,Ochoa; Benjamin Lawrence,0,0,0,0
1667940903539,CSE 257,A01,102396,Gao; Sicun,0,0,0,0
1667940903965,CSE 272,A00,102397,Li; Tzumao,0,0,0,0
1667940904398,CSE 274,A00,111323,Chern; Albert Ren-Haur,0,0,0,0
1667940904829,CSE 282,A00,102398,Pevzner; Pavel Arkadjevich,0,0,0,0
1667940905254,CSE 284,A00,114175,Gymrek; Melissa Ann,0,0,0,0
1667940905681,CSE 290,A00,102399,Chandraker; Manmohan Krishna,0,0,0,0
1667940905681,CSE 290,B00,102400,Vaccaro; Kristen Marie,0,0,25,25
1667940905681,CSE 290,C00,102414,Pannuto; Patrick William,1,0,25,24
1667940905681,CSE 290,D00,102427,Pevzner; Pavel Arkadjevich,0,0,0,0
1667940905681,CSE 290,E00,102429,Zhao; Jishen,0,0,0,0
1667940905681,CSE 290,F00,102436,Tullsen; Dean Michael,0,0,0,0
1667940905681,CSE 290,G00,102440,Christensen; Henrik I,0,0,20,20
1667940906114,CSE 291,A00,102443,Su; Hao,0,0,0,0
1667940906114,CSE 291,B00,102448,Polikarpova; Nadezhda,0,0,0,0
1667940906114,CSE 291,C00,102453,Vaccaro; Kristen Marie,0,0,0,0
1667940906114,CSE 291,D00,111343,Savage; Stefan,0,0,0,0
1667940906114,CSE 291,E00,116474,Claffy; Kimberly Claire,0,0,0,0
1667940906114,CSE 291,F00,116479,Pasquale; Joseph,0,0,0,0
1667940906581,CSE 293,001,119111,Bafna; Vineet,9999,0,9999,0
1667940906581,CSE 293,002,119118,Bellare; Mihir,9999,0,9999,0
1667940906581,CSE 293,003,119122,Berg-Kirkpatrick; Taylor D,9999,0,9999,0
1667940906581,CSE 293,004,119135,Christensen; Henrik I,9999,0,9999,0
1667940906581,CSE 293,005,119142,Cottrell; Garrison W,9999,0,9999,0
1667940906581,CSE 293,006,119146,Deutsch; Alin Bernard,9999,0,9999,0
1667940906581,CSE 293,007,119159,Esmaeilzadeh; Hadi,9999,0,9999,0
1667940906581,CSE 293,008,119166,Freund; Yoav,9999,0,9999,0
1667940906581,CSE 293,009,119170,Griswold; William G.,9999,0,9999,0
1667940906581,CSE 293,010,119183,Gymrek; Melissa Ann,9999,0,9999,0
1667940906581,CSE 293,011,119190,Heninger; Nadia A,9999,0,9999,0
1667940906581,CSE 293,012,119230,Impagliazzo; Russell,9999,0,9999,0
1667940906581,CSE 293,013,119232,Jhala; Ranjit,9999,0,9999,0
1667940906581,CSE 293,014,119233,Kahng; Andrew Byun,9999,0,9999,0
1667940906581,CSE 293,015,119298,Kane; Daniel Mertz,9999,0,9999,0
1667940906581,CSE 293,016,119299,Kriegman; David J,9999,0,9999,0
1667940906581,CSE 293,017,119300,Kumar; Arun Kumar,9999,0,9999,0
1667940906581,CSE 293,018,119301,Lerner; Sorin,9999,0,9999,0
1667940906581,CSE 293,019,119302,Lovett; Shachar,9999,0,9999,0
1667940906581,CSE 293,020,119303,McAuley; Julian John,9999,0,9999,0
1667940906581,CSE 293,021,119304,Micciancio; Daniele,9999,0,9999,0
1667940906581,CSE 293,022,119367,Orailoglu; Alex,9999,0,9999,0
1667940906581,CSE 293,023,119382,Paturi; Ramamohan,9999,0,9999,0
1667940906581,CSE 293,024,119404,Polikarpova; Nadezhda,9999,0,9999,0
1667940906581,CSE 293,025,119406,Politz; Joseph Gibbs,9999,0,9999,0
1667940906581,CSE 293,026,119411,Porter; George M,9999,0,9999,0
1667940906581,CSE 293,027,119414,Porter; Leonard Emerson,9999,0,9999,0
1667940906581,CSE 293,028,119416,Ramamoorthi; Ravi,9999,0,9999,0
1667940906581,CSE 293,029,119417,Sahoo; Debashis,9999,0,9999,0
1667940906581,CSE 293,030,119420,Saul; Lawrence,9999,0,9999,0
1667940906581,CSE 293,031,119421,Savage; Stefan,9999,0,9999,0
1667940906581,CSE 293,032,119425,Schulze; Jurgen P.,9999,0,9999,0
1667940906581,CSE 293,033,119426,Snoeren; Alex C.,9999,0,9999,0
1667940906581,CSE 293,034,119428,Shang; Jingbo,9999,0,9999,0
1667940906581,CSE 293,035,119430,Stefan; Deian,9999,0,9999,0
1667940906581,CSE 293,036,119431,Su; Hao,9999,0,9999,0
1667940906581,CSE 293,037,119433,Swanson; Steven James,9999,0,9999,0
1667940906581,CSE 293,038,119435,Tullsen; Dean Michael,9999,0,9999,0
1667940906581,CSE 293,039,119483,Voelker; Geoffrey M.,9999,0,9999,0
1667940906581,CSE 293,040,119537,Zhao; Jishen,9999,0,9999,0
1667940906581,CSE 293,041,119538,Zhou; Yuan-Yuan,9999,0,9999,0
1667940906581,CSE 293,042,119539,Gao; Sicun,9999,0,9999,0
1667940906581,CSE 293,043,119540,Weibel; Nadir,9999,0,9999,0
1667940906581,CSE 293,044,119541,Gupta; Rajesh K.,9999,0,9999,0
1667940907003,CSE 294,A00,102459,Voelker; Geoffrey M.,0,0,0,0
1667940907003,CSE 294,B00,111322,Orailoglu; Alex,0,0,0,0
1667940907433,DSE 201,A00,096914,Deutsch; Alin Bernard,30,0,30,0
1667940907857,DSE 210,A00,096915,Dasgupta; Sanjoy,30,0,30,0
1667940908283,DSE 260A,A00,096916,Altintas De Callaf; Ilkay,30,0,30,0
1667940908782,ECE 200,001,103586,Antipa; Nicholas A,9999,0,9999,0
1667940908782,ECE 200,002,103587,Atanasov; Nikolay A.,9999,0,9999,0
1667940908782,ECE 200,003,103588,Bharadia; Dinesh,9999,0,9999,0
1667940908782,ECE 200,004,103589,Cheng; Chung Kuan,9999,0,9999,0
1667940908782,ECE 200,005,103590,Cosman; Pamela C.,9999,0,9999,0
1667940908782,ECE 200,006,103591,Dayeh; Shadi Ahmad,9999,0,9999,0
1667940908782,ECE 200,007,103592,Fainman; Yeshaiahu,9999,0,9999,0
1667940908782,ECE 200,008,103593,Ford; Joseph Earl,9999,0,9999,0
1667940908782,ECE 200,009,103594,Franceschetti; Massimo,9999,0,9999,0
1667940908782,ECE 200,010,103595,Fullerton; Eric E,9999,0,9999,0
1667940908782,ECE 200,011,103596,Galton; Ian A,9999,0,9999,0
1667940908782,ECE 200,012,103597,Gilja; Vikash,9999,0,9999,0
1667940908782,ECE 200,013,103598,Hall; Drew A.,9999,0,9999,0
1667940908782,ECE 200,014,103599,Hsueh; Tzu-Chien,9999,0,9999,0
1667940908782,ECE 200,015,103600,Javidi; Tara,9999,0,9999,0
1667940908782,ECE 200,016,103601,Kahng; Andrew Byun,9999,0,9999,0
1667940908782,ECE 200,017,103602,Kim; Young-Han,9999,0,9999,0
1667940908782,ECE 200,018,103603,Koushanfar; Farinaz,9999,0,9999,0
1667940908782,ECE 200,019,103604,Kuzum; Duygu,9999,0,9999,0
1667940908782,ECE 200,020,103605,Le; Hanh-Phuc,9999,0,9999,0
1667940908782,ECE 200,021,103606,Lin; Bill,9999,0,9999,0
1667940908782,ECE 200,022,103607,Liu; Zhaowei,9998,0,9999,1
1667940908782,ECE 200,023,103608,Lo; Yu-Hwa,9999,0,9999,0
1667940908782,ECE 200,024,103609,Lomakin; Vitaliy,9999,0,9999,0
1667940908782,ECE 200,025,103610,Mercier; Patrick Philip,9999,0,9999,0
1667940908782,ECE 200,026,103611,Meyer; Florian,9999,0,9999,0
1667940908782,ECE 200,027,103612,Milstein; Laurence B.,9999,0,9999,0
1667940908782,ECE 200,028,103613,Mir Arabbaygi; Siavash,9999,0,9999,0
1667940908782,ECE 200,029,103614,Mookherjea; Shayan,9999,0,9999,0
1667940908782,ECE 200,030,103615,Morris; Karcher William,9999,0,9999,0
1667940908782,ECE 200,031,103616,Ng; Tse Nga,9999,0,9999,0
1667940908782,ECE 200,032,103617,Nguyen; Truong Quang,9999,0,9999,0
1667940908782,ECE 200,033,103618,Nomura; Kenji,9999,0,9999,0
1667940908782,ECE 200,034,103619,Orlitsky; Alon,9999,0,9999,0
1667940908782,ECE 200,035,103620,Pal; Piya,9999,0,9999,0
1667940908782,ECE 200,036,103621,Papen; George C.,9999,0,9999,0
1667940908782,ECE 200,037,103622,Radic; Stojan,9999,0,9999,0
1667940908782,ECE 200,038,103623,Rao; Bhaskar D.,9999,0,9999,0
1667940908782,ECE 200,039,103624,Rao; Ramesh R,9999,0,9999,0
1667940908782,ECE 200,040,103625,Rebeiz; Gabriel,9999,0,9999,0
1667940908782,ECE 200,041,103626,Sanford; John R,9999,0,9999,0
1667940908782,ECE 200,042,103627,Siegel; Paul H.,9999,0,9999,0
1667940908782,ECE 200,043,103628,Sievenpiper; Daniel F.,9999,0,9999,0
1667940908782,ECE 200,044,103629,Sworder; David D.,9999,0,9999,0
1667940908782,ECE 200,045,103630,Taur; Yuan,9999,0,9999,0
1667940908782,ECE 200,046,103631,Touri; Behrouz,9999,0,9999,0
1667940908782,ECE 200,047,103632,Trivedi; Mohan M.,9999,0,9999,0
1667940908782,ECE 200,048,103633,Vasconcelos; Nuno,9999,0,9999,0
1667940908782,ECE 200,049,103634,Wang; Xiaolong,9999,0,9999,0
1667940908782,ECE 200,050,103635,Xie; Pengtao,9999,0,9999,0
1667940908782,ECE 200,051,103636,Yip; Michael,9999,0,9999,0
1667940908782,ECE 200,052,103637,Zeger; Kenneth A.,999,0,999,0
1667940908782,ECE 200,053,103638,Zhang; Xinyu,9999,0,9999,0
1667940908782,ECE 200,054,103639,Turakhia; Yatish Girish,9999,0,9999,0
1667940908782,ECE 200,055,103640,Kang; Mingu,9999,0,9999,0
1667940908782,ECE 200,056,103641,Shi; Yuanyuan,9999,0,9999,0
1667940908782,ECE 200,057,103642,Wang; Edward Jay,9999,0,9999,0
1667940908782,ECE 200,058,103643,Zheng; Yang,9999,0,9999,0
1667940909205,ECE 202,A00,103644,Kuzum; Duygu,0,0,0,0
1667940909631,ECE 212BN,A00,103646,Ng; Tse Nga,0,0,0,0
1667940910053,ECE 221,A00,111493,Staff,0,0,0,0
1667940910478,ECE 222B,A00,103647,Lomakin; Vitaliy,0,0,0,0
1667940910905,ECE 230B,A00,103648,Taur; Yuan,0,0,0,0
1667940911329,ECE 238B,A00,103649,Garay; Javier,0,0,0,0
1667940911759,ECE 240B,A00,112900,Fainman; Yeshaiahu,0,0,0,0
1667940912192,ECE 247A,A00,103650,Jokerst; Jesse Vincent,0,0,0,0
1667940912626,ECE 247B,A00,103651,Wang; Joseph,0,0,0,0
1667940913053,ECE 250,A00,103652,Siegel; Paul H.,0,0,0,0
1667940913478,ECE 251A,A00,103654,Rao; Bhaskar D.,0,0,0,0
1667940913902,ECE 257B,A00,103655,Bharadia; Dinesh,0,0,0,0
1667940914325,ECE 258A,A00,103656,Milstein; Laurence B.,0,0,0,0
1667940914757,ECE 260B,A00,103658,Kang; Mingu,0,0,0,0
1667940915181,ECE 264A,A00,103659,Galton; Ian A,0,0,0,0
1667940915612,ECE 265A,A00,103661,Gudem; Prasad S.S.,0,0,0,0
1667940916042,ECE 265D,A00,103662,Gudem; Prasad S.S.,0,0,0,0
1667940916466,ECE 268,A00,103663,Koushanfar; Farinaz,0,0,0,0
1667940916894,ECE 269,A01,103665,Pal; Piya,0,0,0,0
1667940917322,ECE 271B,A00,103666,Vasconcelos; Manuela,0,0,0,0
1667940917750,ECE 276A,A00,103667,Atanasov; Nikolay A.,0,0,0,0
1667940918173,ECE 277,A00,103668,An; Cheolhong,0,0,0,0
1667940918598,ECE 279,A00,117947,Hall; Drew A.,0,0,0,0
1667940919452,ECE 283,A00,103670,Hsueh; Tzu-Chien,0,0,0,0
1667940919882,ECE 284,A00,103671,Turakhia; Yatish Girish,0,0,0,0
1667940920308,ECE 285,A00,103672,Zheng; Yang,0,0,0,0
1667940920308,ECE 285,B00,103673,Sworder; David D.,0,0,0,0
1667940920732,ECE 287,A00,103676,Javidi; Tara,0,0,0,0
1667940921155,MATH 200B,A00,098023,Salehi Golsefidy; Alireza,14,0,15,1
1667940921580,MATH 202B,A00,098024,Rhoades; Brendon Patrick,13,0,15,2
1667940922011,MATH 203B,A00,098025,Oprea; Dragos N.,14,0,15,1
1667940922434,MATH 204B,A00,098026,Sorensen; Claus M,15,0,15,0
1667940922859,MATH 208,A00,098027,Izadi; Elham,7,0,10,3
1667940923302,MATH 209,A00,098028,Pollack; Aaron,10,0,10,0
1667940923727,MATH 211A,A00,112919,Rogalski; Daniel,10,0,10,0
1667940924151,MATH 211B,A00,112920,Seward; Brandon M.,10,0,10,0
1667940924583,MATH 218,A00,098029,Li; Bo,10,0,10,0
1667940925010,MATH 220B,A00,098030,Novak; Jonathan I,14,0,15,1
1667940925439,MATH 221A,A00,098031,Ebenfelt; Peter F,14,0,15,1
1667940925874,MATH 231B,A00,098032,Zlatos; Andrej,13,0,15,2
1667940926301,MATH 240B,A00,098033,Ni; Lei,11,0,15,4
1667940926725,MATH 243,A00,098034,Jekel; David Andrew,10,0,10,0
1667940927152,MATH 245A,A00,098035,Nie; Jiawang,4,0,15,11
1667940927576,MATH 248,A00,098036,Bejenaru; Ioan,10,0,10,0
1667940928009,MATH 250B,A00,098037,Spolaor; Luca,14,0,15,1
1667940928446,MATH 258,A00,098038,Ni; Lei,10,0,10,0
1667940928876,MATH 264B,A00,098041,Rhoades; Brendon Patrick,13,0,15,2
1667940929298,MATH 268,A00,098042,Buss; Samuel R,10,0,10,0
1667940929722,MATH 269,A00,098043,Rhoades; Brendon Patrick,10,0,10,0
1667940930156,MATH 270B,A00,098044,Li; Bo,11,0,15,4
1667940930590,MATH 272B,A00,098045,Holst; Michael J,13,0,15,2
1667940931020,MATH 273A,A00,098046,Tian; Xiaochuan,12,0,15,3
1667940931448,MATH 275,A01,098048,Tian; Xiaochuan,6,0,10,4
1667940931876,MATH 278A,A00,098049,Holst; Michael J,8,0,10,2
1667940932308,MATH 278B,A00,098050,Cloninger; Alexander,10,0,10,0
1667940932735,MATH 278C,A00,098051,Nie; Jiawang,7,0,10,3
1667940933165,MATH 280B,A00,098052,Zheng; Tianyi,12,0,15,3
1667940933587,MATH 281B,A00,098053,Bradic; Jelena,4,0,15,11
1667940934017,MATH 282B,A00,098054,Arias-Castro; Ery,2,0,15,13
1667940934570,MATH 285,A00,098055,Fitzsimmons; Patrick J,0,0,15,15
1667940934994,MATH 287B,A00,098056,Arias-Castro; Ery,8,0,15,7
1667940935429,MATH 288,A00,098057,Agarwal; Pooja,9,0,10,1
1667940935429,MATH 288,B00,098058,Zhang; Danna,9,0,10,1
1667940935429,MATH 288,C00,098059,Williams; Ruth J,10,0,10,0
1667940935862,MATH 290B,A00,098060,Roberts; Justin Deritter,14,0,15,1
1667940936288,MATH 292,A00,098061,Belmont; Eva Kinoshita,10,0,10,0
1667940936712,MATH 295,A00,098062,Suk; Andrew Hoon,48,0,50,2
1667940937135,MATH 296,A00,098063,Novak; Jonathan I,20,0,20,0
1667940937559,MATH 297,001,098064,Gamst; Anthony Collins,9997,0,9999,2
1667941452781,COGS 205,A00,101395,Chiba; Andrea,19,0,20,1
1667941453222,COGS 210B,001,101404,Greene; Deanna Jacquelyn,9998,0,9999,1
1667941453222,COGS 210B,002,101417,Xia; Haijun,9999,0,9999,0
1667941453222,COGS 210B,003,101422,Nitz; Douglas A.,9999,0,9999,0
1667941453222,COGS 210B,004,101423,Hollan; James D.,9998,0,9999,1
1667941453222,COGS 210B,005,101424,Deak; Gedeon O.,9999,0,9999,0
1667941453222,COGS 210B,006,101425,Rossano; Federico,9999,0,9999,0
1667941453664,COGS 211B,A00,101427,Coulson; Seana M,9997,0,9999,2
1667941454092,COGS 220,A00,101428,Hollan; James D.,0,0,25,25
1667941454518,COGS 229,A00,101429,Dow; Steven P,18,0,25,7
1667941454946,COGS 230,A00,101430,Klemmer; Scott R,13,0,17,4
1667941455378,COGS 234,A00,101431,Xia; Haijun,10,0,25,15
1667941455801,COGS 260,A00,101432,Kiyonaga; Anastasia,20,0,25,5
1667941455801,COGS 260,B00,101433,Kirsh; David Joel,17,0,25,8
1667941456235,CSE 202,A00,102371,Impagliazzo; Russell,0,0,0,0
1667941456673,CSE 203B,A01,102373,Cheng; Chung Kuan,0,0,0,0
1667941457115,CSE 208,A00,102374,Micciancio; Daniele,0,0,0,0
1667941457553,CSE 209A,A00,112895,Impagliazzo; Russell,0,0,15,15
1667941457993,CSE 209B,A00,108005,Bellare; Mihir,0,0,0,0
1667941458417,CSE 210,A00,113163,Coblenz; Michael J,0,0,0,0
1667941458846,CSE 219,A00,106111,Dow; Steven P,0,0,20,20
1667941459284,CSE 221,A00,102376,Voelker; Geoffrey M.,0,0,0,0
1667941459710,CSE 224,A01,102378,Porter; George M,0,0,0,0
1667941460141,CSE 229A,A00,102379,Savage; Stefan,0,0,0,0
1667941460577,CSE 229C,A00,102380,Munyaka; Imani N. S.,0,0,0,0
1667941461004,CSE 232B,A00,102382,Deutsch; Alin Bernard,0,0,0,0
1667941461439,CSE 234,A01,112904,Kumar; Arun Kumar,0,0,0,0
1667941461864,CSE 237A,A00,102383,Rosing; Tajana Simunic,0,0,0,0
1667941462289,CSE 239A,A00,102384,Deutsch; Alin Bernard,0,0,0,0
1667941462712,CSE 239B,A00,102385,Polikarpova; Nadezhda,0,0,0,0
1667941463142,CSE 240A,A00,102386,Pannuto; Patrick William,0,0,0,0
1667941463571,CSE 240B,A00,102387,Zhao; Jishen,0,0,0,0
1667941464001,CSE 241A,A00,106406,Kang; Mingu,0,0,0,0
1667941464430,CSE 249B,A00,102388,Kahng; Andrew Byun,0,0,8,8
1667941464874,CSE 251B,A01,102392,Cottrell; Garrison W,0,0,0,0
1667941464874,CSE 251B,A02,102393,Cottrell; Garrison W,0,0,0,0
1667941465302,CSE 252B,A00,102394,Ochoa; Benjamin Lawrence,0,0,0,0
1667941465737,CSE 257,A01,102396,Gao; Sicun,0,0,0,0
1667941466186,CSE 272,A00,102397,Li; Tzumao,0,0,0,0
1667941466611,CSE 274,A00,111323,Chern; Albert Ren-Haur,0,0,0,0
1667941467041,CSE 282,A00,102398,Pevzner; Pavel Arkadjevich,0,0,0,0
1667941467463,CSE 284,A00,114175,Gymrek; Melissa Ann,0,0,0,0
1667941467900,CSE 290,A00,102399,Chandraker; Manmohan Krishna,0,0,0,0
1667941467900,CSE 290,B00,102400,Vaccaro; Kristen Marie,0,0,25,25
1667941467900,CSE 290,C00,102414,Pannuto; Patrick William,1,0,25,24
1667941467900,CSE 290,D00,102427,Pevzner; Pavel Arkadjevich,0,0,0,0
1667941467900,CSE 290,E00,102429,Zhao; Jishen,0,0,0,0
1667941467900,CSE 290,F00,102436,Tullsen; Dean Michael,0,0,0,0
1667941467900,CSE 290,G00,102440,Christensen; Henrik I,0,0,20,20
1667941468330,CSE 291,A00,102443,Su; Hao,0,0,0,0
1667941468330,CSE 291,B00,102448,Polikarpova; Nadezhda,0,0,0,0
1667941468330,CSE 291,C00,102453,Vaccaro; Kristen Marie,0,0,0,0
1667941468330,CSE 291,D00,111343,Savage; Stefan,0,0,0,0
1667941468330,CSE 291,E00,116474,Claffy; Kimberly Claire,0,0,0,0
1667941468330,CSE 291,F00,116479,Pasquale; Joseph,0,0,0,0
1667941468768,CSE 293,001,119111,Bafna; Vineet,9999,0,9999,0
1667941468768,CSE 293,002,119118,Bellare; Mihir,9999,0,9999,0
1667941468768,CSE 293,003,119122,Berg-Kirkpatrick; Taylor D,9999,0,9999,0
1667941468768,CSE 293,004,119135,Christensen; Henrik I,9999,0,9999,0
1667941468768,CSE 293,005,119142,Cottrell; Garrison W,9999,0,9999,0
1667941468768,CSE 293,006,119146,Deutsch; Alin Bernard,9999,0,9999,0
1667941468768,CSE 293,007,119159,Esmaeilzadeh; Hadi,9999,0,9999,0
1667941468768,CSE 293,008,119166,Freund; Yoav,9999,0,9999,0
1667941468768,CSE 293,009,119170,Griswold; William G.,9999,0,9999,0
1667941468768,CSE 293,010,119183,Gymrek; Melissa Ann,9999,0,9999,0
1667941468768,CSE 293,011,119190,Heninger; Nadia A,9999,0,9999,0
1667941468768,CSE 293,012,119230,Impagliazzo; Russell,9999,0,9999,0
1667941468768,CSE 293,013,119232,Jhala; Ranjit,9999,0,9999,0
1667941468768,CSE 293,014,119233,Kahng; Andrew Byun,9999,0,9999,0
1667941468768,CSE 293,015,119298,Kane; Daniel Mertz,9999,0,9999,0
1667941468768,CSE 293,016,119299,Kriegman; David J,9999,0,9999,0
1667941468768,CSE 293,017,119300,Kumar; Arun Kumar,9999,0,9999,0
1667941468768,CSE 293,018,119301,Lerner; Sorin,9999,0,9999,0
1667941468768,CSE 293,019,119302,Lovett; Shachar,9999,0,9999,0
1667941468768,CSE 293,020,119303,McAuley; Julian John,9999,0,9999,0
1667941468768,CSE 293,021,119304,Micciancio; Daniele,9999,0,9999,0
1667941468768,CSE 293,022,119367,Orailoglu; Alex,9999,0,9999,0
1667941468768,CSE 293,023,119382,Paturi; Ramamohan,9999,0,9999,0
1667941468768,CSE 293,024,119404,Polikarpova; Nadezhda,9999,0,9999,0
1667941468768,CSE 293,025,119406,Politz; Joseph Gibbs,9999,0,9999,0
1667941468768,CSE 293,026,119411,Porter; George M,9999,0,9999,0
1667941468768,CSE 293,027,119414,Porter; Leonard Emerson,9999,0,9999,0
1667941468768,CSE 293,028,119416,Ramamoorthi; Ravi,9999,0,9999,0
1667941468768,CSE 293,029,119417,Sahoo; Debashis,9999,0,9999,0
1667941468768,CSE 293,030,119420,Saul; Lawrence,9999,0,9999,0
1667941468768,CSE 293,031,119421,Savage; Stefan,9999,0,9999,0
1667941468768,CSE 293,032,119425,Schulze; Jurgen P.,9999,0,9999,0
1667941468768,CSE 293,033,119426,Snoeren; Alex C.,9999,0,9999,0
1667941468768,CSE 293,034,119428,Shang; Jingbo,9999,0,9999,0
1667941468768,CSE 293,035,119430,Stefan; Deian,9999,0,9999,0
1667941468768,CSE 293,036,119431,Su; Hao,9999,0,9999,0
1667941468768,CSE 293,037,119433,Swanson; Steven James,9999,0,9999,0
1667941468768,CSE 293,038,119435,Tullsen; Dean Michael,9999,0,9999,0
1667941468768,CSE 293,039,119483,Voelker; Geoffrey M.,9999,0,9999,0
1667941468768,CSE 293,040,119537,Zhao; Jishen,9999,0,9999,0
1667941468768,CSE 293,041,119538,Zhou; Yuan-Yuan,9999,0,9999,0
1667941468768,CSE 293,042,119539,Gao; Sicun,9999,0,9999,0
1667941468768,CSE 293,043,119540,Weibel; Nadir,9999,0,9999,0
1667941468768,CSE 293,044,119541,Gupta; Rajesh K.,9999,0,9999,0
1667941469205,CSE 294,A00,102459,Voelker; Geoffrey M.,0,0,0,0
1667941469205,CSE 294,B00,111322,Orailoglu; Alex,0,0,0,0
1667941469628,DSE 201,A00,096914,Deutsch; Alin Bernard,30,0,30,0
1667941470183,DSE 210,A00,096915,Dasgupta; Sanjoy,30,0,30,0
1667941470613,DSE 260A,A00,096916,Altintas De Callaf; Ilkay,30,0,30,0
1667941471071,ECE 200,001,103586,Antipa; Nicholas A,9999,0,9999,0
1667941471071,ECE 200,002,103587,Atanasov; Nikolay A.,9999,0,9999,0
1667941471071,ECE 200,003,103588,Bharadia; Dinesh,9999,0,9999,0
1667941471071,ECE 200,004,103589,Cheng; Chung Kuan,9999,0,9999,0
1667941471071,ECE 200,005,103590,Cosman; Pamela C.,9999,0,9999,0
1667941471071,ECE 200,006,103591,Dayeh; Shadi Ahmad,9999,0,9999,0
1667941471071,ECE 200,007,103592,Fainman; Yeshaiahu,9999,0,9999,0
1667941471071,ECE 200,008,103593,Ford; Joseph Earl,9999,0,9999,0
1667941471071,ECE 200,009,103594,Franceschetti; Massimo,9999,0,9999,0
1667941471071,ECE 200,010,103595,Fullerton; Eric E,9999,0,9999,0
1667941471071,ECE 200,011,103596,Galton; Ian A,9999,0,9999,0
1667941471071,ECE 200,012,103597,Gilja; Vikash,9999,0,9999,0
1667941471071,ECE 200,013,103598,Hall; Drew A.,9999,0,9999,0
1667941471071,ECE 200,014,103599,Hsueh; Tzu-Chien,9999,0,9999,0
1667941471071,ECE 200,015,103600,Javidi; Tara,9999,0,9999,0
1667941471071,ECE 200,016,103601,Kahng; Andrew Byun,9999,0,9999,0
1667941471071,ECE 200,017,103602,Kim; Young-Han,9999,0,9999,0
1667941471071,ECE 200,018,103603,Koushanfar; Farinaz,9999,0,9999,0
1667941471071,ECE 200,019,103604,Kuzum; Duygu,9999,0,9999,0
1667941471071,ECE 200,020,103605,Le; Hanh-Phuc,9999,0,9999,0
1667941471071,ECE 200,021,103606,Lin; Bill,9999,0,9999,0
1667941471071,ECE 200,022,103607,Liu; Zhaowei,9998,0,9999,1
1667941471071,ECE 200,023,103608,Lo; Yu-Hwa,9999,0,9999,0
1667941471071,ECE 200,024,103609,Lomakin; Vitaliy,9999,0,9999,0
1667941471071,ECE 200,025,103610,Mercier; Patrick Philip,9999,0,9999,0
1667941471071,ECE 200,026,103611,Meyer; Florian,9999,0,9999,0
1667941471071,ECE 200,027,103612,Milstein; Laurence B.,9999,0,9999,0
1667941471071,ECE 200,028,103613,Mir Arabbaygi; Siavash,9999,0,9999,0
1667941471071,ECE 200,029,103614,Mookherjea; Shayan,9999,0,9999,0
1667941471071,ECE 200,030,103615,Morris; Karcher William,9999,0,9999,0
1667941471071,ECE 200,031,103616,Ng; Tse Nga,9999,0,9999,0
1667941471071,ECE 200,032,103617,Nguyen; Truong Quang,9999,0,9999,0
1667941471071,ECE 200,033,103618,Nomura; Kenji,9999,0,9999,0
1667941471071,ECE 200,034,103619,Orlitsky; Alon,9999,0,9999,0
1667941471071,ECE 200,035,103620,Pal; Piya,9999,0,9999,0
1667941471071,ECE 200,036,103621,Papen; George C.,9999,0,9999,0
1667941471071,ECE 200,037,103622,Radic; Stojan,9999,0,9999,0
1667941471071,ECE 200,038,103623,Rao; Bhaskar D.,9999,0,9999,0
1667941471071,ECE 200,039,103624,Rao; Ramesh R,9999,0,9999,0
1667941471071,ECE 200,040,103625,Rebeiz; Gabriel,9999,0,9999,0
1667941471071,ECE 200,041,103626,Sanford; John R,9999,0,9999,0
1667941471071,ECE 200,042,103627,Siegel; Paul H.,9999,0,9999,0
1667941471071,ECE 200,043,103628,Sievenpiper; Daniel F.,9999,0,9999,0
1667941471071,ECE 200,044,103629,Sworder; David D.,9999,0,9999,0
1667941471071,ECE 200,045,103630,Taur; Yuan,9999,0,9999,0
1667941471071,ECE 200,046,103631,Touri; Behrouz,9999,0,9999,0
1667941471071,ECE 200,047,103632,Trivedi; Mohan M.,9999,0,9999,0
1667941471071,ECE 200,048,103633,Vasconcelos; Nuno,9999,0,9999,0
1667941471071,ECE 200,049,103634,Wang; Xiaolong,9999,0,9999,0
1667941471071,ECE 200,050,103635,Xie; Pengtao,9999,0,9999,0
1667941471071,ECE 200,051,103636,Yip; Michael,9999,0,9999,0
1667941471071,ECE 200,052,103637,Zeger; Kenneth A.,999,0,999,0
1667941471071,ECE 200,053,103638,Zhang; Xinyu,9999,0,9999,0
1667941471071,ECE 200,054,103639,Turakhia; Yatish Girish,9999,0,9999,0
1667941471071,ECE 200,055,103640,Kang; Mingu,9999,0,9999,0
1667941471071,ECE 200,056,103641,Shi; Yuanyuan,9999,0,9999,0
1667941471071,ECE 200,057,103642,Wang; Edward Jay,9999,0,9999,0
1667941471071,ECE 200,058,103643,Zheng; Yang,9999,0,9999,0
1667941471498,ECE 202,A00,103644,Kuzum; Duygu,0,0,0,0
1667941471934,ECE 212BN,A00,103646,Ng; Tse Nga,0,0,0,0
1667941472361,ECE 221,A00,111493,Staff,0,0,0,0
1667941472787,ECE 222B,A00,103647,Lomakin; Vitaliy,0,0,0,0
1667941473214,ECE 230B,A00,103648,Taur; Yuan,0,0,0,0
1667941473652,ECE 238B,A00,103649,Garay; Javier,0,0,0,0
1667941474082,ECE 240B,A00,112900,Fainman; Yeshaiahu,0,0,0,0
1667941474509,ECE 247A,A00,103650,Jokerst; Jesse Vincent,0,0,0,0
1667941474938,ECE 247B,A00,103651,Wang; Joseph,0,0,0,0
1667941475361,ECE 250,A00,103652,Siegel; Paul H.,0,0,0,0
1667941475788,ECE 251A,A00,103654,Rao; Bhaskar D.,0,0,0,0
1667941476222,ECE 257B,A00,103655,Bharadia; Dinesh,0,0,0,0
1667941476647,ECE 258A,A00,103656,Milstein; Laurence B.,0,0,0,0
1667941477072,ECE 260B,A00,103658,Kang; Mingu,0,0,0,0
1667941477499,ECE 264A,A00,103659,Galton; Ian A,0,0,0,0
1667941477939,ECE 265A,A00,103661,Gudem; Prasad S.S.,0,0,0,0
1667941478363,ECE 265D,A00,103662,Gudem; Prasad S.S.,0,0,0,0
1667941478795,ECE 268,A00,103663,Koushanfar; Farinaz,0,0,0,0
1667941479236,ECE 269,A01,103665,Pal; Piya,0,0,0,0
1667941479666,ECE 271B,A00,103666,Vasconcelos; Manuela,0,0,0,0
1667941480088,ECE 276A,A00,103667,Atanasov; Nikolay A.,0,0,0,0
1667941480513,ECE 277,A00,103668,An; Cheolhong,0,0,0,0
1667941480946,ECE 279,A00,117947,Hall; Drew A.,0,0,0,0
1667941481797,ECE 283,A00,103670,Hsueh; Tzu-Chien,0,0,0,0
1667941482222,ECE 284,A00,103671,Turakhia; Yatish Girish,0,0,0,0
1667941482676,ECE 285,A00,103672,Zheng; Yang,0,0,0,0
1667941482676,ECE 285,B00,103673,Sworder; David D.,0,0,0,0
1667941483110,ECE 287,A00,103676,Javidi; Tara,0,0,0,0
1667941483552,MATH 200B,A00,098023,Salehi Golsefidy; Alireza,14,0,15,1
1667941483977,MATH 202B,A00,098024,Rhoades; Brendon Patrick,13,0,15,2
1667941484414,MATH 203B,A00,098025,Oprea; Dragos N.,14,0,15,1
1667941484847,MATH 204B,A00,098026,Sorensen; Claus M,15,0,15,0
1667941485272,MATH 208,A00,098027,Izadi; Elham,7,0,10,3
1667941485697,MATH 209,A00,098028,Pollack; Aaron,10,0,10,0
1667941486121,MATH 211A,A00,112919,Rogalski; Daniel,10,0,10,0
1667941486549,MATH 211B,A00,112920,Seward; Brandon M.,10,0,10,0
1667941486975,MATH 218,A00,098029,Li; Bo,10,0,10,0
1667941487411,MATH 220B,A00,098030,Novak; Jonathan I,14,0,15,1
1667941487844,MATH 221A,A00,098031,Ebenfelt; Peter F,14,0,15,1
1667941488277,MATH 231B,A00,098032,Zlatos; Andrej,13,0,15,2
1667941488702,MATH 240B,A00,098033,Ni; Lei,11,0,15,4
1667941489129,MATH 243,A00,098034,Jekel; David Andrew,10,0,10,0
1667941489555,MATH 245A,A00,098035,Nie; Jiawang,4,0,15,11
1667941489985,MATH 248,A00,098036,Bejenaru; Ioan,10,0,10,0
1667941490411,MATH 250B,A00,098037,Spolaor; Luca,14,0,15,1
1667941490835,MATH 258,A00,098038,Ni; Lei,10,0,10,0
1667941491261,MATH 264B,A00,098041,Rhoades; Brendon Patrick,13,0,15,2
1667941491688,MATH 268,A00,098042,Buss; Samuel R,10,0,10,0
1667941492125,MATH 269,A00,098043,Rhoades; Brendon Patrick,10,0,10,0
1667941492549,MATH 270B,A00,098044,Li; Bo,11,0,15,4
1667941492980,MATH 272B,A00,098045,Holst; Michael J,13,0,15,2
1667941493407,MATH 273A,A00,098046,Tian; Xiaochuan,12,0,15,3
1667941493832,MATH 275,A01,098048,Tian; Xiaochuan,6,0,10,4
1667941494260,MATH 278A,A00,098049,Holst; Michael J,8,0,10,2
1667941494698,MATH 278B,A00,098050,Cloninger; Alexander,10,0,10,0
1667941495131,MATH 278C,A00,098051,Nie; Jiawang,7,0,10,3
1667941495561,MATH 280B,A00,098052,Zheng; Tianyi,12,0,15,3
1667941495999,MATH 281B,A00,098053,Bradic; Jelena,4,0,15,11
1667941496454,MATH 282B,A00,098054,Arias-Castro; Ery,2,0,15,13
1667941496881,MATH 285,A00,098055,Fitzsimmons; Patrick J,0,0,15,15
1667941497313,MATH 287B,A00,098056,Arias-Castro; Ery,8,0,15,7
1667941497751,MATH 288,A00,098057,Agarwal; Pooja,9,0,10,1
1667941497751,MATH 288,B00,098058,Zhang; Danna,9,0,10,1
1667941497751,MATH 288,C00,098059,Williams; Ruth J,10,0,10,0
1667941498184,MATH 290B,A00,098060,Roberts; Justin Deritter,14,0,15,1
1667941498607,MATH 292,A00,098061,Belmont; Eva Kinoshita,10,0,10,0
1667941499035,MATH 295,A00,098062,Suk; Andrew Hoon,48,0,50,2
1667941499464,MATH 296,A00,098063,Novak; Jonathan I,20,0,20,0
1667941499892,MATH 297,001,098064,Gamst; Anthony Collins,9997,0,9999,2
1667942005679,COGS 205,A00,101395,Chiba; Andrea,19,0,20,1
1667942006107,COGS 210B,001,101404,Greene; Deanna Jacquelyn,9998,0,9999,1
1667942006107,COGS 210B,002,101417,Xia; Haijun,9999,0,9999,0
1667942006107,COGS 210B,003,101422,Nitz; Douglas A.,9999,0,9999,0
1667942006107,COGS 210B,004,101423,Hollan; James D.,9998,0,9999,1
1667942006107,COGS 210B,005,101424,Deak; Gedeon O.,9999,0,9999,0
1667942006107,COGS 210B,006,101425,Rossano; Federico,9999,0,9999,0
1667942006539,COGS 211B,A00,101427,Coulson; Seana M,9997,0,9999,2
1667942006962,COGS 220,A00,101428,Hollan; James D.,0,0,25,25
1667942007387,COGS 229,A00,101429,Dow; Steven P,18,0,25,7
1667942007816,COGS 230,A00,101430,Klemmer; Scott R,13,0,17,4
1667942008240,COGS 234,A00,101431,Xia; Haijun,10,0,25,15
1667942008668,COGS 260,A00,101432,Kiyonaga; Anastasia,20,0,25,5
1667942008668,COGS 260,B00,101433,Kirsh; David Joel,17,0,25,8
1667942009095,CSE 202,A00,102371,Impagliazzo; Russell,0,0,0,0
1667942009534,CSE 203B,A01,102373,Cheng; Chung Kuan,0,0,0,0
1667942009969,CSE 208,A00,102374,Micciancio; Daniele,0,0,0,0
1667942010395,CSE 209A,A00,112895,Impagliazzo; Russell,0,0,15,15
1667942010821,CSE 209B,A00,108005,Bellare; Mihir,0,0,0,0
1667942011244,CSE 210,A00,113163,Coblenz; Michael J,0,0,0,0
1667942011670,CSE 219,A00,106111,Dow; Steven P,0,0,20,20
1667942012100,CSE 221,A00,102376,Voelker; Geoffrey M.,0,0,0,0
1667942012552,CSE 224,A01,102378,Porter; George M,0,0,0,0
1667942012978,CSE 229A,A00,102379,Savage; Stefan,0,0,0,0
1667942013401,CSE 229C,A00,102380,Munyaka; Imani N. S.,0,0,0,0
1667942013824,CSE 232B,A00,102382,Deutsch; Alin Bernard,0,0,0,0
1667942014251,CSE 234,A01,112904,Kumar; Arun Kumar,0,0,0,0
1667942014674,CSE 237A,A00,102383,Rosing; Tajana Simunic,0,0,0,0
1667942015101,CSE 239A,A00,102384,Deutsch; Alin Bernard,0,0,0,0
1667942015530,CSE 239B,A00,102385,Polikarpova; Nadezhda,0,0,0,0
1667942015954,CSE 240A,A00,102386,Pannuto; Patrick William,0,0,0,0
1667942016378,CSE 240B,A00,102387,Zhao; Jishen,0,0,0,0
1667942016805,CSE 241A,A00,106406,Kang; Mingu,0,0,0,0
1667942017229,CSE 249B,A00,102388,Kahng; Andrew Byun,0,0,8,8
1667942017668,CSE 251B,A01,102392,Cottrell; Garrison W,0,0,0,0
1667942017668,CSE 251B,A02,102393,Cottrell; Garrison W,0,0,0,0
1667942018095,CSE 252B,A00,102394,Ochoa; Benjamin Lawrence,0,0,0,0
1667942018527,CSE 257,A01,102396,Gao; Sicun,0,0,0,0
1667942018966,CSE 272,A00,102397,Li; Tzumao,0,0,0,0
1667942019392,CSE 274,A00,111323,Chern; Albert Ren-Haur,0,0,0,0
1667942019825,CSE 282,A00,102398,Pevzner; Pavel Arkadjevich,0,0,0,0
1667942020253,CSE 284,A00,114175,Gymrek; Melissa Ann,0,0,0,0
1667942020679,CSE 290,A00,102399,Chandraker; Manmohan Krishna,0,0,0,0
1667942020679,CSE 290,B00,102400,Vaccaro; Kristen Marie,0,0,25,25
1667942020679,CSE 290,C00,102414,Pannuto; Patrick William,1,0,25,24
1667942020679,CSE 290,D00,102427,Pevzner; Pavel Arkadjevich,0,0,0,0
1667942020679,CSE 290,E00,102429,Zhao; Jishen,0,0,0,0
1667942020679,CSE 290,F00,102436,Tullsen; Dean Michael,0,0,0,0
1667942020679,CSE 290,G00,102440,Christensen; Henrik I,0,0,20,20
1667942021109,CSE 291,A00,102443,Su; Hao,0,0,0,0
1667942021109,CSE 291,B00,102448,Polikarpova; Nadezhda,0,0,0,0
1667942021109,CSE 291,C00,102453,Vaccaro; Kristen Marie,0,0,0,0
1667942021109,CSE 291,D00,111343,Savage; Stefan,0,0,0,0
1667942021109,CSE 291,E00,116474,Claffy; Kimberly Claire,0,0,0,0
1667942021109,CSE 291,F00,116479,Pasquale; Joseph,0,0,0,0
1667942021573,CSE 293,001,119111,Bafna; Vineet,9999,0,9999,0
1667942021573,CSE 293,002,119118,Bellare; Mihir,9999,0,9999,0
1667942021573,CSE 293,003,119122,Berg-Kirkpatrick; Taylor D,9999,0,9999,0
1667942021573,CSE 293,004,119135,Christensen; Henrik I,9999,0,9999,0
1667942021573,CSE 293,005,119142,Cottrell; Garrison W,9999,0,9999,0
1667942021573,CSE 293,006,119146,Deutsch; Alin Bernard,9999,0,9999,0
1667942021573,CSE 293,007,119159,Esmaeilzadeh; Hadi,9999,0,9999,0
1667942021573,CSE 293,008,119166,Freund; Yoav,9999,0,9999,0
1667942021573,CSE 293,009,119170,Griswold; William G.,9999,0,9999,0
1667942021573,CSE 293,010,119183,Gymrek; Melissa Ann,9999,0,9999,0
1667942021573,CSE 293,011,119190,Heninger; Nadia A,9999,0,9999,0
1667942021573,CSE 293,012,119230,Impagliazzo; Russell,9999,0,9999,0
1667942021573,CSE 293,013,119232,Jhala; Ranjit,9999,0,9999,0
1667942021573,CSE 293,014,119233,Kahng; Andrew Byun,9999,0,9999,0
1667942021573,CSE 293,015,119298,Kane; Daniel Mertz,9999,0,9999,0
1667942021573,CSE 293,016,119299,Kriegman; David J,9999,0,9999,0
1667942021573,CSE 293,017,119300,Kumar; Arun Kumar,9999,0,9999,0
1667942021573,CSE 293,018,119301,Lerner; Sorin,9999,0,9999,0
1667942021573,CSE 293,019,119302,Lovett; Shachar,9999,0,9999,0
1667942021573,CSE 293,020,119303,McAuley; Julian John,9999,0,9999,0
1667942021573,CSE 293,021,119304,Micciancio; Daniele,9999,0,9999,0
1667942021573,CSE 293,022,119367,Orailoglu; Alex,9999,0,9999,0
1667942021573,CSE 293,023,119382,Paturi; Ramamohan,9999,0,9999,0
1667942021573,CSE 293,024,119404,Polikarpova; Nadezhda,9999,0,9999,0
1667942021573,CSE 293,025,119406,Politz; Joseph Gibbs,9999,0,9999,0
1667942021573,CSE 293,026,119411,Porter; George M,9999,0,9999,0
1667942021573,CSE 293,027,119414,Porter; Leonard Emerson,9999,0,9999,0
1667942021573,CSE 293,028,119416,Ramamoorthi; Ravi,9999,0,9999,0
1667942021573,CSE 293,029,119417,Sahoo; Debashis,9999,0,9999,0
1667942021573,CSE 293,030,119420,Saul; Lawrence,9999,0,9999,0
1667942021573,CSE 293,031,119421,Savage; Stefan,9999,0,9999,0
1667942021573,CSE 293,032,119425,Schulze; Jurgen P.,9999,0,9999,0
1667942021573,CSE 293,033,119426,Snoeren; Alex C.,9999,0,9999,0
1667942021573,CSE 293,034,119428,Shang; Jingbo,9999,0,9999,0
1667942021573,CSE 293,035,119430,Stefan; Deian,9999,0,9999,0
1667942021573,CSE 293,036,119431,Su; Hao,9999,0,9999,0
1667942021573,CSE 293,037,119433,Swanson; Steven James,9999,0,9999,0
1667942021573,CSE 293,038,119435,Tullsen; Dean Michael,9999,0,9999,0
1667942021573,CSE 293,039,119483,Voelker; Geoffrey M.,9999,0,9999,0
1667942021573,CSE 293,040,119537,Zhao; Jishen,9999,0,9999,0
1667942021573,CSE 293,041,119538,Zhou; Yuan-Yuan,9999,0,9999,0
1667942021573,CSE 293,042,119539,Gao; Sicun,9999,0,9999,0
1667942021573,CSE 293,043,119540,Weibel; Nadir,9999,0,9999,0
1667942021573,CSE 293,044,119541,Gupta; Rajesh K.,9999,0,9999,0
1667942022003,CSE 294,A00,102459,Voelker; Geoffrey M.,0,0,0,0
1667942022003,CSE 294,B00,111322,Orailoglu; Alex,0,0,0,0
1667942022428,DSE 201,A00,096914,Deutsch; Alin Bernard,30,0,30,0
1667942022861,DSE 210,A00,096915,Dasgupta; Sanjoy,30,0,30,0
1667942023285,DSE 260A,A00,096916,Altintas De Callaf; Ilkay,30,0,30,0
1667942023769,ECE 200,001,103586,Antipa; Nicholas A,9999,0,9999,0
1667942023769,ECE 200,002,103587,Atanasov; Nikolay A.,9999,0,9999,0
1667942023769,ECE 200,003,103588,Bharadia; Dinesh,9999,0,9999,0
1667942023769,ECE 200,004,103589,Cheng; Chung Kuan,9999,0,9999,0
1667942023769,ECE 200,005,103590,Cosman; Pamela C.,9999,0,9999,0
1667942023769,ECE 200,006,103591,Dayeh; Shadi Ahmad,9999,0,9999,0
1667942023769,ECE 200,007,103592,Fainman; Yeshaiahu,9999,0,9999,0
1667942023769,ECE 200,008,103593,Ford; Joseph Earl,9999,0,9999,0
1667942023769,ECE 200,009,103594,Franceschetti; Massimo,9999,0,9999,0
1667942023769,ECE 200,010,103595,Fullerton; Eric E,9999,0,9999,0
1667942023769,ECE 200,011,103596,Galton; Ian A,9999,0,9999,0
1667942023769,ECE 200,012,103597,Gilja; Vikash,9999,0,9999,0
1667942023769,ECE 200,013,103598,Hall; Drew A.,9999,0,9999,0
1667942023769,ECE 200,014,103599,Hsueh; Tzu-Chien,9999,0,9999,0
1667942023769,ECE 200,015,103600,Javidi; Tara,9999,0,9999,0
1667942023769,ECE 200,016,103601,Kahng; Andrew Byun,9999,0,9999,0
1667942023769,ECE 200,017,103602,Kim; Young-Han,9999,0,9999,0
1667942023769,ECE 200,018,103603,Koushanfar; Farinaz,9999,0,9999,0
1667942023769,ECE 200,019,103604,Kuzum; Duygu,9999,0,9999,0
1667942023769,ECE 200,020,103605,Le; Hanh-Phuc,9999,0,9999,0
1667942023769,ECE 200,021,103606,Lin; Bill,9999,0,9999,0
1667942023769,ECE 200,022,103607,Liu; Zhaowei,9998,0,9999,1
1667942023769,ECE 200,023,103608,Lo; Yu-Hwa,9999,0,9999,0
1667942023769,ECE 200,024,103609,Lomakin; Vitaliy,9999,0,9999,0
1667942023769,ECE 200,025,103610,Mercier; Patrick Philip,9999,0,9999,0
1667942023769,ECE 200,026,103611,Meyer; Florian,9999,0,9999,0
1667942023769,ECE 200,027,103612,Milstein; Laurence B.,9999,0,9999,0
1667942023769,ECE 200,028,103613,Mir Arabbaygi; Siavash,9999,0,9999,0
1667942023769,ECE 200,029,103614,Mookherjea; Shayan,9999,0,9999,0
1667942023769,ECE 200,030,103615,Morris; Karcher William,9999,0,9999,0
1667942023769,ECE 200,031,103616,Ng; Tse Nga,9999,0,9999,0
1667942023769,ECE 200,032,103617,Nguyen; Truong Quang,9999,0,9999,0
1667942023769,ECE 200,033,103618,Nomura; Kenji,9999,0,9999,0
1667942023769,ECE 200,034,103619,Orlitsky; Alon,9999,0,9999,0
1667942023769,ECE 200,035,103620,Pal; Piya,9999,0,9999,0
1667942023769,ECE 200,036,103621,Papen; George C.,9999,0,9999,0
1667942023769,ECE 200,037,103622,Radic; Stojan,9999,0,9999,0
1667942023769,ECE 200,038,103623,Rao; Bhaskar D.,9999,0,9999,0
1667942023769,ECE 200,039,103624,Rao; Ramesh R,9999,0,9999,0
1667942023769,ECE 200,040,103625,Rebeiz; Gabriel,9999,0,9999,0
1667942023769,ECE 200,041,103626,Sanford; John R,9999,0,9999,0
1667942023769,ECE 200,042,103627,Siegel; Paul H.,9999,0,9999,0
1667942023769,ECE 200,043,103628,Sievenpiper; Daniel F.,9999,0,9999,0
1667942023769,ECE 200,044,103629,Sworder; David D.,9999,0,9999,0
1667942023769,ECE 200,045,103630,Taur; Yuan,9999,0,9999,0
1667942023769,ECE 200,046,103631,Touri; Behrouz,9999,0,9999,0
1667942023769,ECE 200,047,103632,Trivedi; Mohan M.,9999,0,9999,0
1667942023769,ECE 200,048,103633,Vasconcelos; Nuno,9999,0,9999,0
1667942023769,ECE 200,049,103634,Wang; Xiaolong,9999,0,9999,0
1667942023769,ECE 200,050,103635,Xie; Pengtao,9999,0,9999,0
1667942023769,ECE 200,051,103636,Yip; Michael,9999,0,9999,0
1667942023769,ECE 200,052,103637,Zeger; Kenneth A.,999,0,999,0
1667942023769,ECE 200,053,103638,Zhang; Xinyu,9999,0,9999,0
1667942023769,ECE 200,054,103639,Turakhia; Yatish Girish,9999,0,9999,0
1667942023769,ECE 200,055,103640,Kang; Mingu,9999,0,9999,0
1667942023769,ECE 200,056,103641,Shi; Yuanyuan,9999,0,9999,0
1667942023769,ECE 200,057,103642,Wang; Edward Jay,9999,0,9999,0
1667942023769,ECE 200,058,103643,Zheng; Yang,9999,0,9999,0
1667942024199,ECE 202,A00,103644,Kuzum; Duygu,0,0,0,0
1667942024626,ECE 212BN,A00,103646,Ng; Tse Nga,0,0,0,0
1667942025054,ECE 221,A00,111493,Staff,0,0,0,0
1667942025481,ECE 222B,A00,103647,Lomakin; Vitaliy,0,0,0,0
1667942025905,ECE 230B,A00,103648,Taur; Yuan,0,0,0,0
1667942026327,ECE 238B,A00,103649,Garay; Javier,0,0,0,0
1667942026751,ECE 240B,A00,112900,Fainman; Yeshaiahu,0,0,0,0
1667942027179,ECE 247A,A00,103650,Jokerst; Jesse Vincent,0,0,0,0
1667942027608,ECE 247B,A00,103651,Wang; Joseph,0,0,0,0
1667942028034,ECE 250,A00,103652,Siegel; Paul H.,0,0,0,0
1667942028460,ECE 251A,A00,103654,Rao; Bhaskar D.,0,0,0,0
1667942028909,ECE 257B,A00,103655,Bharadia; Dinesh,0,0,0,0
1667942029343,ECE 258A,A00,103656,Milstein; Laurence B.,0,0,0,0
1667942029773,ECE 260B,A00,103658,Kang; Mingu,0,0,0,0
1667942030197,ECE 264A,A00,103659,Galton; Ian A,0,0,0,0
1667942030626,ECE 265A,A00,103661,Gudem; Prasad S.S.,0,0,0,0
1667942031062,ECE 265D,A00,103662,Gudem; Prasad S.S.,0,0,0,0
1667942031504,ECE 268,A00,103663,Koushanfar; Farinaz,0,0,0,0
1667942031932,ECE 269,A01,103665,Pal; Piya,0,0,0,0
1667942032359,ECE 271B,A00,103666,Vasconcelos; Manuela,0,0,0,0
1667942032795,ECE 276A,A00,103667,Atanasov; Nikolay A.,0,0,0,0
1667942033230,ECE 277,A00,103668,An; Cheolhong,0,0,0,0
1667942033657,ECE 279,A00,117947,Hall; Drew A.,0,0,0,0
1667942034515,ECE 283,A00,103670,Hsueh; Tzu-Chien,0,0,0,0
1667942034950,ECE 284,A00,103671,Turakhia; Yatish Girish,0,0,0,0
1667942035375,ECE 285,A00,103672,Zheng; Yang,0,0,0,0
1667942035375,ECE 285,B00,103673,Sworder; David D.,0,0,0,0
1667942035805,ECE 287,A00,103676,Javidi; Tara,0,0,0,0
1667942036241,MATH 200B,A00,098023,Salehi Golsefidy; Alireza,14,0,15,1
1667942036669,MATH 202B,A00,098024,Rhoades; Brendon Patrick,13,0,15,2
1667942037092,MATH 203B,A00,098025,Oprea; Dragos N.,14,0,15,1
1667942037518,MATH 204B,A00,098026,Sorensen; Claus M,15,0,15,0
1667942037941,MATH 208,A00,098027,Izadi; Elham,7,0,10,3
1667942038379,MATH 209,A00,098028,Pollack; Aaron,10,0,10,0
1667942038802,MATH 211A,A00,112919,Rogalski; Daniel,10,0,10,0
1667942039231,MATH 211B,A00,112920,Seward; Brandon M.,10,0,10,0
1667942039742,MATH 218,A00,098029,Li; Bo,10,0,10,0
1667942040172,MATH 220B,A00,098030,Novak; Jonathan I,14,0,15,1
1667942040597,MATH 221A,A00,098031,Ebenfelt; Peter F,14,0,15,1
1667942041019,MATH 231B,A00,098032,Zlatos; Andrej,13,0,15,2
1667942041443,MATH 240B,A00,098033,Ni; Lei,11,0,15,4
1667942041876,MATH 243,A00,098034,Jekel; David Andrew,10,0,10,0
1667942042312,MATH 245A,A00,098035,Nie; Jiawang,4,0,15,11
1667942042741,MATH 248,A00,098036,Bejenaru; Ioan,10,0,10,0
1667942043171,MATH 250B,A00,098037,Spolaor; Luca,14,0,15,1
1667942043606,MATH 258,A00,098038,Ni; Lei,10,0,10,0
1667942044035,MATH 264B,A00,098041,Rhoades; Brendon Patrick,13,0,15,2
1667942044458,MATH 268,A00,098042,Buss; Samuel R,10,0,10,0
1667942044894,MATH 269,A00,098043,Rhoades; Brendon Patrick,10,0,10,0
1667942045321,MATH 270B,A00,098044,Li; Bo,11,0,15,4
1667942045747,MATH 272B,A00,098045,Holst; Michael J,13,0,15,2
1667942046171,MATH 273A,A00,098046,Tian; Xiaochuan,12,0,15,3
1667942046593,MATH 275,A01,098048,Tian; Xiaochuan,6,0,10,4
1667942047041,MATH 278A,A00,098049,Holst; Michael J,8,0,10,2
1667942047463,MATH 278B,A00,098050,Cloninger; Alexander,10,0,10,0
1667942047896,MATH 278C,A00,098051,Nie; Jiawang,7,0,10,3
1667942048322,MATH 280B,A00,098052,Zheng; Tianyi,12,0,15,3
1667942048751,MATH 281B,A00,098053,Bradic; Jelena,4,0,15,11
1667942049183,MATH 282B,A00,098054,Arias-Castro; Ery,2,0,15,13
1667942049607,MATH 285,A00,098055,Fitzsimmons; Patrick J,0,0,15,15
1667942050038,MATH 287B,A00,098056,Arias-Castro; Ery,8,0,15,7
1667942050464,MATH 288,A00,098057,Agarwal; Pooja,9,0,10,1
1667942050464,MATH 288,B00,098058,Zhang; Danna,9,0,10,1
1667942050464,MATH 288,C00,098059,Williams; Ruth J,10,0,10,0
1667942050901,MATH 290B,A00,098060,Roberts; Justin Deritter,14,0,15,1
1667942051341,MATH 292,A00,098061,Belmont; Eva Kinoshita,10,0,10,0
1667942051767,MATH 295,A00,098062,Suk; Andrew Hoon,48,0,50,2
1667942052193,MATH 296,A00,098063,Novak; Jonathan I,20,0,20,0
1667942052617,MATH 297,001,098064,Gamst; Anthony Collins,9997,0,9999,2
1667942557543,COGS 205,A00,101395,Chiba; Andrea,19,0,20,1
1667942557987,COGS 210B,001,101404,Greene; Deanna Jacquelyn,9998,0,9999,1
1667942557987,COGS 210B,002,101417,Xia; Haijun,9999,0,9999,0
1667942557987,COGS 210B,003,101422,Nitz; Douglas A.,9999,0,9999,0
1667942557987,COGS 210B,004,101423,Hollan; James D.,9998,0,9999,1
1667942557987,COGS 210B,005,101424,Deak; Gedeon O.,9999,0,9999,0
1667942557987,COGS 210B,006,101425,Rossano; Federico,9999,0,9999,0
1667942558412,COGS 211B,A00,101427,Coulson; Seana M,9997,0,9999,2
1667942558835,COGS 220,A00,101428,Hollan; James D.,0,0,25,25
1667942559258,COGS 229,A00,101429,Dow; Steven P,18,0,25,7
1667942559681,COGS 230,A00,101430,Klemmer; Scott R,13,0,17,4
1667942560118,COGS 234,A00,101431,Xia; Haijun,10,0,25,15
1667942560545,COGS 260,A00,101432,Kiyonaga; Anastasia,20,0,25,5
1667942560545,COGS 260,B00,101433,Kirsh; David Joel,17,0,25,8
1667942560967,CSE 202,A00,102371,Impagliazzo; Russell,0,0,0,0
1667942561391,CSE 203B,A01,102373,Cheng; Chung Kuan,0,0,0,0
1667942561816,CSE 208,A00,102374,Micciancio; Daniele,0,0,0,0
1667942562237,CSE 209A,A00,112895,Impagliazzo; Russell,0,0,15,15
1667942562668,CSE 209B,A00,108005,Bellare; Mihir,0,0,0,0
1667942563091,CSE 210,A00,113163,Coblenz; Michael J,0,0,0,0
1667942563538,CSE 219,A00,106111,Dow; Steven P,0,0,20,20
1667942563962,CSE 221,A00,102376,Voelker; Geoffrey M.,0,0,0,0
1667942564385,CSE 224,A01,102378,Porter; George M,0,0,0,0
1667942564890,CSE 229A,A00,102379,Savage; Stefan,0,0,0,0
1667942565319,CSE 229C,A00,102380,Munyaka; Imani N. S.,0,0,0,0
1667942565766,CSE 232B,A00,102382,Deutsch; Alin Bernard,0,0,0,0
1667942566189,CSE 234,A01,112904,Kumar; Arun Kumar,0,0,0,0
1667942566611,CSE 237A,A00,102383,Rosing; Tajana Simunic,0,0,0,0
1667942567041,CSE 239A,A00,102384,Deutsch; Alin Bernard,0,0,0,0
1667942567478,CSE 239B,A00,102385,Polikarpova; Nadezhda,0,0,0,0
1667942567909,CSE 240A,A00,102386,Pannuto; Patrick William,0,0,0,0
1667942568349,CSE 240B,A00,102387,Zhao; Jishen,0,0,0,0
1667942568784,CSE 241A,A00,106406,Kang; Mingu,0,0,0,0
1667942569224,CSE 249B,A00,102388,Kahng; Andrew Byun,0,0,8,8
1667942569656,CSE 251B,A01,102392,Cottrell; Garrison W,0,0,0,0
1667942569656,CSE 251B,A02,102393,Cottrell; Garrison W,0,0,0,0
1667942570079,CSE 252B,A00,102394,Ochoa; Benjamin Lawrence,0,0,0,0
1667942570517,CSE 257,A01,102396,Gao; Sicun,0,0,0,0
1667942570942,CSE 272,A00,102397,Li; Tzumao,0,0,0,0
1667942571386,CSE 274,A00,111323,Chern; Albert Ren-Haur,0,0,0,0
1667942571816,CSE 282,A00,102398,Pevzner; Pavel Arkadjevich,0,0,0,0
1667942572243,CSE 284,A00,114175,Gymrek; Melissa Ann,0,0,0,0
1667942572674,CSE 290,A00,102399,Chandraker; Manmohan Krishna,0,0,0,0
1667942572674,CSE 290,B00,102400,Vaccaro; Kristen Marie,0,0,25,25
1667942572674,CSE 290,C00,102414,Pannuto; Patrick William,1,0,25,24
1667942572674,CSE 290,D00,102427,Pevzner; Pavel Arkadjevich,0,0,0,0
1667942572674,CSE 290,E00,102429,Zhao; Jishen,0,0,0,0
1667942572674,CSE 290,F00,102436,Tullsen; Dean Michael,0,0,0,0
1667942572674,CSE 290,G00,102440,Christensen; Henrik I,0,0,20,20
1667942573104,CSE 291,A00,102443,Su; Hao,0,0,0,0
1667942573104,CSE 291,B00,102448,Polikarpova; Nadezhda,0,0,0,0
1667942573104,CSE 291,C00,102453,Vaccaro; Kristen Marie,0,0,0,0
1667942573104,CSE 291,D00,111343,Savage; Stefan,0,0,0,0
1667942573104,CSE 291,E00,116474,Claffy; Kimberly Claire,0,0,0,0
1667942573104,CSE 291,F00,116479,Pasquale; Joseph,0,0,0,0
1667942573543,CSE 293,001,119111,Bafna; Vineet,9999,0,9999,0
1667942573543,CSE 293,002,119118,Bellare; Mihir,9999,0,9999,0
1667942573543,CSE 293,003,119122,Berg-Kirkpatrick; Taylor D,9999,0,9999,0
1667942573543,CSE 293,004,119135,Christensen; Henrik I,9999,0,9999,0
1667942573543,CSE 293,005,119142,Cottrell; Garrison W,9999,0,9999,0
1667942573543,CSE 293,006,119146,Deutsch; Alin Bernard,9999,0,9999,0
1667942573543,CSE 293,007,119159,Esmaeilzadeh; Hadi,9999,0,9999,0
1667942573543,CSE 293,008,119166,Freund; Yoav,9999,0,9999,0
1667942573543,CSE 293,009,119170,Griswold; William G.,9999,0,9999,0
1667942573543,CSE 293,010,119183,Gymrek; Melissa Ann,9999,0,9999,0
1667942573543,CSE 293,011,119190,Heninger; Nadia A,9999,0,9999,0
1667942573543,CSE 293,012,119230,Impagliazzo; Russell,9999,0,9999,0
1667942573543,CSE 293,013,119232,Jhala; Ranjit,9999,0,9999,0
1667942573543,CSE 293,014,119233,Kahng; Andrew Byun,9999,0,9999,0
1667942573543,CSE 293,015,119298,Kane; Daniel Mertz,9999,0,9999,0
1667942573543,CSE 293,016,119299,Kriegman; David J,9999,0,9999,0
1667942573543,CSE 293,017,119300,Kumar; Arun Kumar,9999,0,9999,0
1667942573543,CSE 293,018,119301,Lerner; Sorin,9999,0,9999,0
1667942573543,CSE 293,019,119302,Lovett; Shachar,9999,0,9999,0
1667942573543,CSE 293,020,119303,McAuley; Julian John,9999,0,9999,0
1667942573543,CSE 293,021,119304,Micciancio; Daniele,9999,0,9999,0
1667942573543,CSE 293,022,119367,Orailoglu; Alex,9999,0,9999,0
1667942573543,CSE 293,023,119382,Paturi; Ramamohan,9999,0,9999,0
1667942573543,CSE 293,024,119404,Polikarpova; Nadezhda,9999,0,9999,0
1667942573543,CSE 293,025,119406,Politz; Joseph Gibbs,9999,0,9999,0
1667942573543,CSE 293,026,119411,Porter; George M,9999,0,9999,0
1667942573543,CSE 293,027,119414,Porter; Leonard Emerson,9999,0,9999,0
1667942573543,CSE 293,028,119416,Ramamoorthi; Ravi,9999,0,9999,0
1667942573543,CSE 293,029,119417,Sahoo; Debashis,9999,0,9999,0
1667942573543,CSE 293,030,119420,Saul; Lawrence,9999,0,9999,0
1667942573543,CSE 293,031,119421,Savage; Stefan,9999,0,9999,0
1667942573543,CSE 293,032,119425,Schulze; Jurgen P.,9999,0,9999,0
1667942573543,CSE 293,033,119426,Snoeren; Alex C.,9999,0,9999,0
1667942573543,CSE 293,034,119428,Shang; Jingbo,9999,0,9999,0
1667942573543,CSE 293,035,119430,Stefan; Deian,9999,0,9999,0
1667942573543,CSE 293,036,119431,Su; Hao,9999,0,9999,0
1667942573543,CSE 293,037,119433,Swanson; Steven James,9999,0,9999,0
1667942573543,CSE 293,038,119435,Tullsen; Dean Michael,9999,0,9999,0
1667942573543,CSE 293,039,119483,Voelker; Geoffrey M.,9999,0,9999,0
1667942573543,CSE 293,040,119537,Zhao; Jishen,9999,0,9999,0
1667942573543,CSE 293,041,119538,Zhou; Yuan-Yuan,9999,0,9999,0
1667942573543,CSE 293,042,119539,Gao; Sicun,9999,0,9999,0
1667942573543,CSE 293,043,119540,Weibel; Nadir,9999,0,9999,0
1667942573543,CSE 293,044,119541,Gupta; Rajesh K.,9999,0,9999,0
1667942573968,CSE 294,A00,102459,Voelker; Geoffrey M.,0,0,0,0
1667942573968,CSE 294,B00,111322,Orailoglu; Alex,0,0,0,0
1667942574393,DSE 201,A00,096914,Deutsch; Alin Bernard,30,0,30,0
1667942574816,DSE 210,A00,096915,Dasgupta; Sanjoy,30,0,30,0
1667942575241,DSE 260A,A00,096916,Altintas De Callaf; Ilkay,30,0,30,0
1667942575680,ECE 200,001,103586,Antipa; Nicholas A,9999,0,9999,0
1667942575680,ECE 200,002,103587,Atanasov; Nikolay A.,9999,0,9999,0
1667942575680,ECE 200,003,103588,Bharadia; Dinesh,9999,0,9999,0
1667942575680,ECE 200,004,103589,Cheng; Chung Kuan,9999,0,9999,0
1667942575680,ECE 200,005,103590,Cosman; Pamela C.,9999,0,9999,0
1667942575680,ECE 200,006,103591,Dayeh; Shadi Ahmad,9999,0,9999,0
1667942575680,ECE 200,007,103592,Fainman; Yeshaiahu,9999,0,9999,0
1667942575680,ECE 200,008,103593,Ford; Joseph Earl,9999,0,9999,0
1667942575680,ECE 200,009,103594,Franceschetti; Massimo,9999,0,9999,0
1667942575680,ECE 200,010,103595,Fullerton; Eric E,9999,0,9999,0
1667942575680,ECE 200,011,103596,Galton; Ian A,9999,0,9999,0
1667942575680,ECE 200,012,103597,Gilja; Vikash,9999,0,9999,0
1667942575680,ECE 200,013,103598,Hall; Drew A.,9999,0,9999,0
1667942575680,ECE 200,014,103599,Hsueh; Tzu-Chien,9999,0,9999,0
1667942575680,ECE 200,015,103600,Javidi; Tara,9999,0,9999,0
1667942575680,ECE 200,016,103601,Kahng; Andrew Byun,9999,0,9999,0
1667942575680,ECE 200,017,103602,Kim; Young-Han,9999,0,9999,0
1667942575680,ECE 200,018,103603,Koushanfar; Farinaz,9999,0,9999,0
1667942575680,ECE 200,019,103604,Kuzum; Duygu,9999,0,9999,0
1667942575680,ECE 200,020,103605,Le; Hanh-Phuc,9999,0,9999,0
1667942575680,ECE 200,021,103606,Lin; Bill,9999,0,9999,0
1667942575680,ECE 200,022,103607,Liu; Zhaowei,9998,0,9999,1
1667942575680,ECE 200,023,103608,Lo; Yu-Hwa,9999,0,9999,0
1667942575680,ECE 200,024,103609,Lomakin; Vitaliy,9999,0,9999,0
1667942575680,ECE 200,025,103610,Mercier; Patrick Philip,9999,0,9999,0
1667942575680,ECE 200,026,103611,Meyer; Florian,9999,0,9999,0
1667942575680,ECE 200,027,103612,Milstein; Laurence B.,9999,0,9999,0
1667942575680,ECE 200,028,103613,Mir Arabbaygi; Siavash,9999,0,9999,0
1667942575680,ECE 200,029,103614,Mookherjea; Shayan,9999,0,9999,0
1667942575680,ECE 200,030,103615,Morris; Karcher William,9999,0,9999,0
1667942575680,ECE 200,031,103616,Ng; Tse Nga,9999,0,9999,0
1667942575680,ECE 200,032,103617,Nguyen; Truong Quang,9999,0,9999,0
1667942575680,ECE 200,033,103618,Nomura; Kenji,9999,0,9999,0
1667942575680,ECE 200,034,103619,Orlitsky; Alon,9999,0,9999,0
1667942575680,ECE 200,035,103620,Pal; Piya,9999,0,9999,0
1667942575680,ECE 200,036,103621,Papen; George C.,9999,0,9999,0
1667942575680,ECE 200,037,103622,Radic; Stojan,9999,0,9999,0
1667942575680,ECE 200,038,103623,Rao; Bhaskar D.,9999,0,9999,0
1667942575680,ECE 200,039,103624,Rao; Ramesh R,9999,0,9999,0
1667942575680,ECE 200,040,103625,Rebeiz; Gabriel,9999,0,9999,0
1667942575680,ECE 200,041,103626,Sanford; John R,9999,0,9999,0
1667942575680,ECE 200,042,103627,Siegel; Paul H.,9999,0,9999,0
1667942575680,ECE 200,043,103628,Sievenpiper; Daniel F.,9999,0,9999,0
1667942575680,ECE 200,044,103629,Sworder; David D.,9999,0,9999,0
1667942575680,ECE 200,045,103630,Taur; Yuan,9999,0,9999,0
1667942575680,ECE 200,046,103631,Touri; Behrouz,9999,0,9999,0
1667942575680,ECE 200,047,103632,Trivedi; Mohan M.,9999,0,9999,0
1667942575680,ECE 200,048,103633,Vasconcelos; Nuno,9999,0,9999,0
1667942575680,ECE 200,049,103634,Wang; Xiaolong,9999,0,9999,0
1667942575680,ECE 200,050,103635,Xie; Pengtao,9999,0,9999,0
1667942575680,ECE 200,051,103636,Yip; Michael,9999,0,9999,0
1667942575680,ECE 200,052,103637,Zeger; Kenneth A.,999,0,999,0
1667942575680,ECE 200,053,103638,Zhang; Xinyu,9999,0,9999,0
1667942575680,ECE 200,054,103639,Turakhia; Yatish Girish,9999,0,9999,0
1667942575680,ECE 200,055,103640,Kang; Mingu,9999,0,9999,0
1667942575680,ECE 200,056,103641,Shi; Yuanyuan,9999,0,9999,0
1667942575680,ECE 200,057,103642,Wang; Edward Jay,9999,0,9999,0
1667942575680,ECE 200,058,103643,Zheng; Yang,9999,0,9999,0
1667942576106,ECE 202,A00,103644,Kuzum; Duygu,0,0,0,0
1667942576528,ECE 212BN,A00,103646,Ng; Tse Nga,0,0,0,0
1667942576951,ECE 221,A00,111493,Staff,0,0,0,0
1667942577390,ECE 222B,A00,103647,Lomakin; Vitaliy,0,0,0,0
1667942577813,ECE 230B,A00,103648,Taur; Yuan,0,0,0,0
1667942578244,ECE 238B,A00,103649,Garay; Javier,0,0,0,0
1667942578678,ECE 240B,A00,112900,Fainman; Yeshaiahu,0,0,0,0
1667942579101,ECE 247A,A00,103650,Jokerst; Jesse Vincent,0,0,0,0
1667942579534,ECE 247B,A00,103651,Wang; Joseph,0,0,0,0
1667942579956,ECE 250,A00,103652,Siegel; Paul H.,0,0,0,0
1667942580381,ECE 251A,A00,103654,Rao; Bhaskar D.,0,0,0,0
1667942580822,ECE 257B,A00,103655,Bharadia; Dinesh,0,0,0,0
1667942581253,ECE 258A,A00,103656,Milstein; Laurence B.,0,0,0,0
1667942581680,ECE 260B,A00,103658,Kang; Mingu,0,0,0,0
1667942582102,ECE 264A,A00,103659,Galton; Ian A,0,0,0,0
1667942582527,ECE 265A,A00,103661,Gudem; Prasad S.S.,0,0,0,0
1667942582955,ECE 265D,A00,103662,Gudem; Prasad S.S.,0,0,0,0
1667942583389,ECE 268,A00,103663,Koushanfar; Farinaz,0,0,0,0
1667942583822,ECE 269,A01,103665,Pal; Piya,0,0,0,0
1667942584250,ECE 271B,A00,103666,Vasconcelos; Manuela,0,0,0,0
1667942584680,ECE 276A,A00,103667,Atanasov; Nikolay A.,0,0,0,0
1667942585114,ECE 277,A00,103668,An; Cheolhong,0,0,0,0
1667942585552,ECE 279,A00,117947,Hall; Drew A.,0,0,0,0
1667942586404,ECE 283,A00,103670,Hsueh; Tzu-Chien,0,0,0,0
1667942586829,ECE 284,A00,103671,Turakhia; Yatish Girish,0,0,0,0
1667942587261,ECE 285,A00,103672,Zheng; Yang,0,0,0,0
1667942587261,ECE 285,B00,103673,Sworder; David D.,0,0,0,0
1667942587691,ECE 287,A00,103676,Javidi; Tara,0,0,0,0
1667942588125,MATH 200B,A00,098023,Salehi Golsefidy; Alireza,14,0,15,1
1667942588585,MATH 202B,A00,098024,Rhoades; Brendon Patrick,13,0,15,2
1667942589009,MATH 203B,A00,098025,Oprea; Dragos N.,14,0,15,1
1667942589450,MATH 204B,A00,098026,Sorensen; Claus M,15,0,15,0
1667942589900,MATH 208,A00,098027,Izadi; Elham,7,0,10,3
1667942590331,MATH 209,A00,098028,Pollack; Aaron,10,0,10,0
1667942590754,MATH 211A,A00,112919,Rogalski; Daniel,10,0,10,0
1667942591177,MATH 211B,A00,112920,Seward; Brandon M.,10,0,10,0
1667942591601,MATH 218,A00,098029,Li; Bo,10,0,10,0
1667942592029,MATH 220B,A00,098030,Novak; Jonathan I,14,0,15,1
1667942592452,MATH 221A,A00,098031,Ebenfelt; Peter F,14,0,15,1
1667942592875,MATH 231B,A00,098032,Zlatos; Andrej,13,0,15,2
1667942593302,MATH 240B,A00,098033,Ni; Lei,11,0,15,4
1667942593742,MATH 243,A00,098034,Jekel; David Andrew,10,0,10,0
1667942594165,MATH 245A,A00,098035,Nie; Jiawang,4,0,15,11
1667942594590,MATH 248,A00,098036,Bejenaru; Ioan,10,0,10,0
1667942595024,MATH 250B,A00,098037,Spolaor; Luca,14,0,15,1
1667942595447,MATH 258,A00,098038,Ni; Lei,10,0,10,0
1667942595873,MATH 264B,A00,098041,Rhoades; Brendon Patrick,13,0,15,2
1667942596302,MATH 268,A00,098042,Buss; Samuel R,10,0,10,0
1667942596728,MATH 269,A00,098043,Rhoades; Brendon Patrick,10,0,10,0
1667942597161,MATH 270B,A00,098044,Li; Bo,11,0,15,4
1667942597586,MATH 272B,A00,098045,Holst; Michael J,13,0,15,2
1667942598010,MATH 273A,A00,098046,Tian; Xiaochuan,12,0,15,3
1667942598435,MATH 275,A01,098048,Tian; Xiaochuan,6,0,10,4
1667942598861,MATH 278A,A00,098049,Holst; Michael J,8,0,10,2
1667942599285,MATH 278B,A00,098050,Cloninger; Alexander,10,0,10,0
1667942599713,MATH 278C,A00,098051,Nie; Jiawang,7,0,10,3
1667942600138,MATH 280B,A00,098052,Zheng; Tianyi,12,0,15,3
1667942600572,MATH 281B,A00,098053,Bradic; Jelena,4,0,15,11
1667942600999,MATH 282B,A00,098054,Arias-Castro; Ery,2,0,15,13
1667942601428,MATH 285,A00,098055,Fitzsimmons; Patrick J,0,0,15,15
1667942601850,MATH 287B,A00,098056,Arias-Castro; Ery,8,0,15,7
1667942602287,MATH 288,A00,098057,Agarwal; Pooja,9,0,10,1
1667942602287,MATH 288,B00,098058,Zhang; Danna,9,0,10,1
1667942602287,MATH 288,C00,098059,Williams; Ruth J,10,0,10,0
1667942602714,MATH 290B,A00,098060,Roberts; Justin Deritter,14,0,15,1
1667942603138,MATH 292,A00,098061,Belmont; Eva Kinoshita,10,0,10,0
1667942603568,MATH 295,A00,098062,Suk; Andrew Hoon,48,0,50,2
1667942603995,MATH 296,A00,098063,Novak; Jonathan I,20,0,20,0
1667942604443,MATH 297,001,098064,Gamst; Anthony Collins,9997,0,9999,2
1667943108926,COGS 205,A00,101395,Chiba; Andrea,19,0,20,1
1667943109350,COGS 210B,001,101404,Greene; Deanna Jacquelyn,9998,0,9999,1
1667943109350,COGS 210B,002,101417,Xia; Haijun,9999,0,9999,0
1667943109350,COGS 210B,003,101422,Nitz; Douglas A.,9999,0,9999,0
1667943109350,COGS 210B,004,101423,Hollan; James D.,9998,0,9999,1
1667943109350,COGS 210B,005,101424,Deak; Gedeon O.,9999,0,9999,0
1667943109350,COGS 210B,006,101425,Rossano; Federico,9999,0,9999,0
1667943109775,COGS 211B,A00,101427,Coulson; Seana M,9997,0,9999,2
1667943110202,COGS 220,A00,101428,Hollan; James D.,0,0,25,25
1667943110627,COGS 229,A00,101429,Dow; Steven P,18,0,25,7
1667943111052,COGS 230,A00,101430,Klemmer; Scott R,13,0,17,4
1667943111484,COGS 234,A00,101431,Xia; Haijun,10,0,25,15
1667943111932,COGS 260,A00,101432,Kiyonaga; Anastasia,20,0,25,5
1667943111932,COGS 260,B00,101433,Kirsh; David Joel,17,0,25,8
1667943112355,CSE 202,A00,102371,Impagliazzo; Russell,0,0,0,0
1667943112785,CSE 203B,A01,102373,Cheng; Chung Kuan,0,0,0,0
1667943113211,CSE 208,A00,102374,Micciancio; Daniele,0,0,0,0
1667943113636,CSE 209A,A00,112895,Impagliazzo; Russell,0,0,15,15
1667943114084,CSE 209B,A00,108005,Bellare; Mihir,0,0,0,0
1667943114513,CSE 210,A00,113163,Coblenz; Michael J,0,0,0,0
1667943114938,CSE 219,A00,106111,Dow; Steven P,0,0,20,20
1667943115363,CSE 221,A00,102376,Voelker; Geoffrey M.,0,0,0,0
1667943115786,CSE 224,A01,102378,Porter; George M,0,0,0,0
1667943116220,CSE 229A,A00,102379,Savage; Stefan,0,0,0,0
1667943116655,CSE 229C,A00,102380,Munyaka; Imani N. S.,0,0,0,0
1667943117089,CSE 232B,A00,102382,Deutsch; Alin Bernard,0,0,0,0
1667943117510,CSE 234,A01,112904,Kumar; Arun Kumar,0,0,0,0
1667943117936,CSE 237A,A00,102383,Rosing; Tajana Simunic,0,0,0,0
1667943118370,CSE 239A,A00,102384,Deutsch; Alin Bernard,0,0,0,0
1667943118795,CSE 239B,A00,102385,Polikarpova; Nadezhda,0,0,0,0
1667943119223,CSE 240A,A00,102386,Pannuto; Patrick William,0,0,0,0
1667943119646,CSE 240B,A00,102387,Zhao; Jishen,0,0,0,0
1667943120071,CSE 241A,A00,106406,Kang; Mingu,0,0,0,0
1667943120497,CSE 249B,A00,102388,Kahng; Andrew Byun,0,0,8,8
1667943120922,CSE 251B,A01,102392,Cottrell; Garrison W,0,0,0,0
1667943120922,CSE 251B,A02,102393,Cottrell; Garrison W,0,0,0,0
1667943121346,CSE 252B,A00,102394,Ochoa; Benjamin Lawrence,0,0,0,0
1667943121785,CSE 257,A01,102396,Gao; Sicun,0,0,0,0
1667943122211,CSE 272,A00,102397,Li; Tzumao,0,0,0,0
1667943122634,CSE 274,A00,111323,Chern; Albert Ren-Haur,0,0,0,0
1667943123057,CSE 282,A00,102398,Pevzner; Pavel Arkadjevich,0,0,0,0
1667943123489,CSE 284,A00,114175,Gymrek; Melissa Ann,0,0,0,0
1667943123922,CSE 290,A00,102399,Chandraker; Manmohan Krishna,0,0,0,0
1667943123922,CSE 290,B00,102400,Vaccaro; Kristen Marie,0,0,25,25
1667943123922,CSE 290,C00,102414,Pannuto; Patrick William,1,0,25,24
1667943123922,CSE 290,D00,102427,Pevzner; Pavel Arkadjevich,0,0,0,0
1667943123922,CSE 290,E00,102429,Zhao; Jishen,0,0,0,0
1667943123922,CSE 290,F00,102436,Tullsen; Dean Michael,0,0,0,0
1667943123922,CSE 290,G00,102440,Christensen; Henrik I,0,0,20,20
1667943124366,CSE 291,A00,102443,Su; Hao,0,0,0,0
1667943124366,CSE 291,B00,102448,Polikarpova; Nadezhda,0,0,0,0
1667943124366,CSE 291,C00,102453,Vaccaro; Kristen Marie,0,0,0,0
1667943124366,CSE 291,D00,111343,Savage; Stefan,0,0,0,0
1667943124366,CSE 291,E00,116474,Claffy; Kimberly Claire,0,0,0,0
1667943124366,CSE 291,F00,116479,Pasquale; Joseph,0,0,0,0
1667943124803,CSE 293,001,119111,Bafna; Vineet,9999,0,9999,0
1667943124803,CSE 293,002,119118,Bellare; Mihir,9999,0,9999,0
1667943124803,CSE 293,003,119122,Berg-Kirkpatrick; Taylor D,9999,0,9999,0
1667943124803,CSE 293,004,119135,Christensen; Henrik I,9999,0,9999,0
1667943124803,CSE 293,005,119142,Cottrell; Garrison W,9999,0,9999,0
1667943124803,CSE 293,006,119146,Deutsch; Alin Bernard,9999,0,9999,0
1667943124803,CSE 293,007,119159,Esmaeilzadeh; Hadi,9999,0,9999,0
1667943124803,CSE 293,008,119166,Freund; Yoav,9999,0,9999,0
1667943124803,CSE 293,009,119170,Griswold; William G.,9999,0,9999,0
1667943124803,CSE 293,010,119183,Gymrek; Melissa Ann,9999,0,9999,0
1667943124803,CSE 293,011,119190,Heninger; Nadia A,9999,0,9999,0
1667943124803,CSE 293,012,119230,Impagliazzo; Russell,9999,0,9999,0
1667943124803,CSE 293,013,119232,Jhala; Ranjit,9999,0,9999,0
1667943124803,CSE 293,014,119233,Kahng; Andrew Byun,9999,0,9999,0
1667943124803,CSE 293,015,119298,Kane; Daniel Mertz,9999,0,9999,0
1667943124803,CSE 293,016,119299,Kriegman; David J,9999,0,9999,0
1667943124803,CSE 293,017,119300,Kumar; Arun Kumar,9999,0,9999,0
1667943124803,CSE 293,018,119301,Lerner; Sorin,9999,0,9999,0
1667943124803,CSE 293,019,119302,Lovett; Shachar,9999,0,9999,0
1667943124803,CSE 293,020,119303,McAuley; Julian John,9999,0,9999,0
1667943124803,CSE 293,021,119304,Micciancio; Daniele,9999,0,9999,0
1667943124803,CSE 293,022,119367,Orailoglu; Alex,9999,0,9999,0
1667943124803,CSE 293,023,119382,Paturi; Ramamohan,9999,0,9999,0
1667943124803,CSE 293,024,119404,Polikarpova; Nadezhda,9999,0,9999,0
1667943124803,CSE 293,025,119406,Politz; Joseph Gibbs,9999,0,9999,0
1667943124803,CSE 293,026,119411,Porter; George M,9999,0,9999,0
1667943124803,CSE 293,027,119414,Porter; Leonard Emerson,9999,0,9999,0
1667943124803,CSE 293,028,119416,Ramamoorthi; Ravi,9999,0,9999,0
1667943124803,CSE 293,029,119417,Sahoo; Debashis,9999,0,9999,0
1667943124803,CSE 293,030,119420,Saul; Lawrence,9999,0,9999,0
1667943124803,CSE 293,031,119421,Savage; Stefan,9999,0,9999,0
1667943124803,CSE 293,032,119425,Schulze; Jurgen P.,9999,0,9999,0
1667943124803,CSE 293,033,119426,Snoeren; Alex C.,9999,0,9999,0
1667943124803,CSE 293,034,119428,Shang; Jingbo,9999,0,9999,0
1667943124803,CSE 293,035,119430,Stefan; Deian,9999,0,9999,0
1667943124803,CSE 293,036,119431,Su; Hao,9999,0,9999,0
1667943124803,CSE 293,037,119433,Swanson; Steven James,9999,0,9999,0
1667943124803,CSE 293,038,119435,Tullsen; Dean Michael,9999,0,9999,0
1667943124803,CSE 293,039,119483,Voelker; Geoffrey M.,9999,0,9999,0
1667943124803,CSE 293,040,119537,Zhao; Jishen,9999,0,9999,0
1667943124803,CSE 293,041,119538,Zhou; Yuan-Yuan,9999,0,9999,0
1667943124803,CSE 293,042,119539,Gao; Sicun,9999,0,9999,0
1667943124803,CSE 293,043,119540,Weibel; Nadir,9999,0,9999,0
1667943124803,CSE 293,044,119541,Gupta; Rajesh K.,9999,0,9999,0
1667943125247,CSE 294,A00,102459,Voelker; Geoffrey M.,0,0,0,0
1667943125247,CSE 294,B00,111322,Orailoglu; Alex,0,0,0,0
1667943125669,DSE 201,A00,096914,Deutsch; Alin Bernard,30,0,30,0
1667943126115,DSE 210,A00,096915,Dasgupta; Sanjoy,30,0,30,0
1667943126546,DSE 260A,A00,096916,Altintas De Callaf; Ilkay,30,0,30,0
1667943127007,ECE 200,001,103586,Antipa; Nicholas A,9999,0,9999,0
1667943127007,ECE 200,002,103587,Atanasov; Nikolay A.,9999,0,9999,0
1667943127007,ECE 200,003,103588,Bharadia; Dinesh,9999,0,9999,0
1667943127007,ECE 200,004,103589,Cheng; Chung Kuan,9999,0,9999,0
1667943127007,ECE 200,005,103590,Cosman; Pamela C.,9999,0,9999,0
1667943127007,ECE 200,006,103591,Dayeh; Shadi Ahmad,9999,0,9999,0
1667943127007,ECE 200,007,103592,Fainman; Yeshaiahu,9999,0,9999,0
1667943127007,ECE 200,008,103593,Ford; Joseph Earl,9999,0,9999,0
1667943127007,ECE 200,009,103594,Franceschetti; Massimo,9999,0,9999,0
1667943127007,ECE 200,010,103595,Fullerton; Eric E,9999,0,9999,0
1667943127007,ECE 200,011,103596,Galton; Ian A,9999,0,9999,0
1667943127007,ECE 200,012,103597,Gilja; Vikash,9999,0,9999,0
1667943127007,ECE 200,013,103598,Hall; Drew A.,9999,0,9999,0
1667943127007,ECE 200,014,103599,Hsueh; Tzu-Chien,9999,0,9999,0
1667943127007,ECE 200,015,103600,Javidi; Tara,9999,0,9999,0
1667943127007,ECE 200,016,103601,Kahng; Andrew Byun,9999,0,9999,0
1667943127007,ECE 200,017,103602,Kim; Young-Han,9999,0,9999,0
1667943127007,ECE 200,018,103603,Koushanfar; Farinaz,9999,0,9999,0
1667943127007,ECE 200,019,103604,Kuzum; Duygu,9999,0,9999,0
1667943127007,ECE 200,020,103605,Le; Hanh-Phuc,9999,0,9999,0
1667943127007,ECE 200,021,103606,Lin; Bill,9999,0,9999,0
1667943127007,ECE 200,022,103607,Liu; Zhaowei,9998,0,9999,1
1667943127007,ECE 200,023,103608,Lo; Yu-Hwa,9999,0,9999,0
1667943127007,ECE 200,024,103609,Lomakin; Vitaliy,9999,0,9999,0
1667943127007,ECE 200,025,103610,Mercier; Patrick Philip,9999,0,9999,0
1667943127007,ECE 200,026,103611,Meyer; Florian,9999,0,9999,0
1667943127007,ECE 200,027,103612,Milstein; Laurence B.,9999,0,9999,0
1667943127007,ECE 200,028,103613,Mir Arabbaygi; Siavash,9999,0,9999,0
1667943127007,ECE 200,029,103614,Mookherjea; Shayan,9999,0,9999,0
1667943127007,ECE 200,030,103615,Morris; Karcher William,9999,0,9999,0
1667943127007,ECE 200,031,103616,Ng; Tse Nga,9999,0,9999,0
1667943127007,ECE 200,032,103617,Nguyen; Truong Quang,9999,0,9999,0
1667943127007,ECE 200,033,103618,Nomura; Kenji,9999,0,9999,0
1667943127007,ECE 200,034,103619,Orlitsky; Alon,9999,0,9999,0
1667943127007,ECE 200,035,103620,Pal; Piya,9999,0,9999,0
1667943127007,ECE 200,036,103621,Papen; George C.,9999,0,9999,0
1667943127007,ECE 200,037,103622,Radic; Stojan,9999,0,9999,0
1667943127007,ECE 200,038,103623,Rao; Bhaskar D.,9999,0,9999,0
1667943127007,ECE 200,039,103624,Rao; Ramesh R,9999,0,9999,0
1667943127007,ECE 200,040,103625,Rebeiz; Gabriel,9999,0,9999,0
1667943127007,ECE 200,041,103626,Sanford; John R,9999,0,9999,0
1667943127007,ECE 200,042,103627,Siegel; Paul H.,9999,0,9999,0
1667943127007,ECE 200,043,103628,Sievenpiper; Daniel F.,9999,0,9999,0
1667943127007,ECE 200,044,103629,Sworder; David D.,9999,0,9999,0
1667943127007,ECE 200,045,103630,Taur; Yuan,9999,0,9999,0
1667943127007,ECE 200,046,103631,Touri; Behrouz,9999,0,9999,0
1667943127007,ECE 200,047,103632,Trivedi; Mohan M.,9999,0,9999,0
1667943127007,ECE 200,048,103633,Vasconcelos; Nuno,9999,0,9999,0
1667943127007,ECE 200,049,103634,Wang; Xiaolong,9999,0,9999,0
1667943127007,ECE 200,050,103635,Xie; Pengtao,9999,0,9999,0
1667943127007,ECE 200,051,103636,Yip; Michael,9999,0,9999,0
1667943127007,ECE 200,052,103637,Zeger; Kenneth A.,999,0,999,0
1667943127007,ECE 200,053,103638,Zhang; Xinyu,9999,0,9999,0
1667943127007,ECE 200,054,103639,Turakhia; Yatish Girish,9999,0,9999,0
1667943127007,ECE 200,055,103640,Kang; Mingu,9999,0,9999,0
1667943127007,ECE 200,056,103641,Shi; Yuanyuan,9999,0,9999,0
1667943127007,ECE 200,057,103642,Wang; Edward Jay,9999,0,9999,0
1667943127007,ECE 200,058,103643,Zheng; Yang,9999,0,9999,0
1667943127433,ECE 202,A00,103644,Kuzum; Duygu,0,0,0,0
1667943127882,ECE 212BN,A00,103646,Ng; Tse Nga,0,0,0,0
1667943128306,ECE 221,A00,111493,Staff,0,0,0,0
1667943128743,ECE 222B,A00,103647,Lomakin; Vitaliy,0,0,0,0
1667943129168,ECE 230B,A00,103648,Taur; Yuan,0,0,0,0
1667943129594,ECE 238B,A00,103649,Garay; Javier,0,0,0,0
1667943130017,ECE 240B,A00,112900,Fainman; Yeshaiahu,0,0,0,0
1667943130445,ECE 247A,A00,103650,Jokerst; Jesse Vincent,0,0,0,0
1667943130870,ECE 247B,A00,103651,Wang; Joseph,0,0,0,0
1667943131311,ECE 250,A00,103652,Siegel; Paul H.,0,0,0,0
1667943131736,ECE 251A,A00,103654,Rao; Bhaskar D.,0,0,0,0
1667943132164,ECE 257B,A00,103655,Bharadia; Dinesh,0,0,0,0
1667943132588,ECE 258A,A00,103656,Milstein; Laurence B.,0,0,0,0
1667943133102,ECE 260B,A00,103658,Kang; Mingu,0,0,0,0
1667943133538,ECE 264A,A00,103659,Galton; Ian A,0,0,0,0
1667943133977,ECE 265A,A00,103661,Gudem; Prasad S.S.,0,0,0,0
1667943134402,ECE 265D,A00,103662,Gudem; Prasad S.S.,0,0,0,0
1667943134825,ECE 268,A00,103663,Koushanfar; Farinaz,0,0,0,0
1667943135251,ECE 269,A01,103665,Pal; Piya,0,0,0,0
1667943135674,ECE 271B,A00,103666,Vasconcelos; Manuela,0,0,0,0
1667943136105,ECE 276A,A00,103667,Atanasov; Nikolay A.,0,0,0,0
1667943136534,ECE 277,A00,103668,An; Cheolhong,0,0,0,0
1667943136958,ECE 279,A00,117947,Hall; Drew A.,0,0,0,0
1667943137810,ECE 283,A00,103670,Hsueh; Tzu-Chien,0,0,0,0
1667943138245,ECE 284,A00,103671,Turakhia; Yatish Girish,0,0,0,0
1667943138669,ECE 285,A00,103672,Zheng; Yang,0,0,0,0
1667943138669,ECE 285,B00,103673,Sworder; David D.,0,0,0,0
1667943139108,ECE 287,A00,103676,Javidi; Tara,0,0,0,0
1667943139539,MATH 200B,A00,098023,Salehi Golsefidy; Alireza,14,0,15,1
1667943139964,MATH 202B,A00,098024,Rhoades; Brendon Patrick,13,0,15,2
1667943140393,MATH 203B,A00,098025,Oprea; Dragos N.,14,0,15,1
1667943140824,MATH 204B,A00,098026,Sorensen; Claus M,15,0,15,0
1667943141255,MATH 208,A00,098027,Izadi; Elham,7,0,10,3
1667943141688,MATH 209,A00,098028,Pollack; Aaron,10,0,10,0
1667943142117,MATH 211A,A00,112919,Rogalski; Daniel,10,0,10,0
1667943142540,MATH 211B,A00,112920,Seward; Brandon M.,10,0,10,0
1667943142967,MATH 218,A00,098029,Li; Bo,10,0,10,0
1667943143402,MATH 220B,A00,098030,Novak; Jonathan I,14,0,15,1
1667943143832,MATH 221A,A00,098031,Ebenfelt; Peter F,14,0,15,1
1667943144277,MATH 231B,A00,098032,Zlatos; Andrej,13,0,15,2
1667943144701,MATH 240B,A00,098033,Ni; Lei,11,0,15,4
1667943145131,MATH 243,A00,098034,Jekel; David Andrew,10,0,10,0
1667943145565,MATH 245A,A00,098035,Nie; Jiawang,4,0,15,11
1667943145990,MATH 248,A00,098036,Bejenaru; Ioan,10,0,10,0
1667943146422,MATH 250B,A00,098037,Spolaor; Luca,14,0,15,1
1667943146849,MATH 258,A00,098038,Ni; Lei,10,0,10,0
1667943147274,MATH 264B,A00,098041,Rhoades; Brendon Patrick,13,0,15,2
1667943147697,MATH 268,A00,098042,Buss; Samuel R,10,0,10,0
1667943148124,MATH 269,A00,098043,Rhoades; Brendon Patrick,10,0,10,0
1667943148551,MATH 270B,A00,098044,Li; Bo,11,0,15,4
1667943148973,MATH 272B,A00,098045,Holst; Michael J,13,0,15,2
1667943149402,MATH 273A,A00,098046,Tian; Xiaochuan,12,0,15,3
1667943149828,MATH 275,A01,098048,Tian; Xiaochuan,6,0,10,4
1667943150255,MATH 278A,A00,098049,Holst; Michael J,8,0,10,2
1667943150687,MATH 278B,A00,098050,Cloninger; Alexander,10,0,10,0
1667943151110,MATH 278C,A00,098051,Nie; Jiawang,7,0,10,3
1667943151541,MATH 280B,A00,098052,Zheng; Tianyi,12,0,15,3
1667943151969,MATH 281B,A00,098053,Bradic; Jelena,4,0,15,11
1667943152392,MATH 282B,A00,098054,Arias-Castro; Ery,2,0,15,13
1667943152820,MATH 285,A00,098055,Fitzsimmons; Patrick J,0,0,15,15
1667943153242,MATH 287B,A00,098056,Arias-Castro; Ery,8,0,15,7
1667943153670,MATH 288,A00,098057,Agarwal; Pooja,9,0,10,1
1667943153670,MATH 288,B00,098058,Zhang; Danna,9,0,10,1
1667943153670,MATH 288,C00,098059,Williams; Ruth J,10,0,10,0
1667943154100,MATH 290B,A00,098060,Roberts; Justin Deritter,14,0,15,1
1667943154533,MATH 292,A00,098061,Belmont; Eva Kinoshita,10,0,10,0
1667943154965,MATH 295,A00,098062,Suk; Andrew Hoon,48,0,50,2
1667943155394,MATH 296,A00,098063,Novak; Jonathan I,20,0,20,0
1667943155824,MATH 297,001,098064,Gamst; Anthony Collins,9997,0,9999,2
1667943671167,COGS 205,A00,101395,Chiba; Andrea,19,0,20,1
1667943671591,COGS 210B,001,101404,Greene; Deanna Jacquelyn,9998,0,9999,1
1667943671591,COGS 210B,002,101417,Xia; Haijun,9999,0,9999,0
1667943671591,COGS 210B,003,101422,Nitz; Douglas A.,9999,0,9999,0
1667943671591,COGS 210B,004,101423,Hollan; James D.,9998,0,9999,1
1667943671591,COGS 210B,005,101424,Deak; Gedeon O.,9999,0,9999,0
1667943671591,COGS 210B,006,101425,Rossano; Federico,9999,0,9999,0
1667943672030,COGS 211B,A00,101427,Coulson; Seana M,9997,0,9999,2
1667943672455,COGS 220,A00,101428,Hollan; James D.,0,0,25,25
1667943672886,COGS 229,A00,101429,Dow; Steven P,18,0,25,7
1667943673312,COGS 230,A00,101430,Klemmer; Scott R,13,0,17,4
1667943673738,COGS 234,A00,101431,Xia; Haijun,10,0,25,15
1667943674165,COGS 260,A00,101432,Kiyonaga; Anastasia,20,0,25,5
1667943674165,COGS 260,B00,101433,Kirsh; David Joel,17,0,25,8
1667943674600,CSE 202,A00,102371,Impagliazzo; Russell,0,0,0,0
1667943675025,CSE 203B,A01,102373,Cheng; Chung Kuan,0,0,0,0
1667943675469,CSE 208,A00,102374,Micciancio; Daniele,0,0,0,0
1667943675908,CSE 209A,A00,112895,Impagliazzo; Russell,0,0,15,15
1667943676333,CSE 209B,A00,108005,Bellare; Mihir,0,0,0,0
1667943676759,CSE 210,A00,113163,Coblenz; Michael J,0,0,0,0
1667943677186,CSE 219,A00,106111,Dow; Steven P,0,0,20,20
1667943677615,CSE 221,A00,102376,Voelker; Geoffrey M.,0,0,0,0
1667943678057,CSE 224,A01,102378,Porter; George M,0,0,0,0
1667943678481,CSE 229A,A00,102379,Savage; Stefan,0,0,0,0
1667943678907,CSE 229C,A00,102380,Munyaka; Imani N. S.,0,0,0,0
1667943679331,CSE 232B,A00,102382,Deutsch; Alin Bernard,0,0,0,0
1667943679755,CSE 234,A01,112904,Kumar; Arun Kumar,0,0,0,0
1667943680190,CSE 237A,A00,102383,Rosing; Tajana Simunic,0,0,0,0
1667943680615,CSE 239A,A00,102384,Deutsch; Alin Bernard,0,0,0,0
1667943681043,CSE 239B,A00,102385,Polikarpova; Nadezhda,0,0,0,0
1667943681465,CSE 240A,A00,102386,Pannuto; Patrick William,0,0,0,0
1667943681890,CSE 240B,A00,102387,Zhao; Jishen,0,0,0,0
1667943682316,CSE 241A,A00,106406,Kang; Mingu,0,0,0,0
1667943682741,CSE 249B,A00,102388,Kahng; Andrew Byun,0,0,8,8
1667943683173,CSE 251B,A01,102392,Cottrell; Garrison W,0,0,0,0
1667943683173,CSE 251B,A02,102393,Cottrell; Garrison W,0,0,0,0
1667943683600,CSE 252B,A00,102394,Ochoa; Benjamin Lawrence,0,0,0,0
1667943684038,CSE 257,A01,102396,Gao; Sicun,0,0,0,0
1667943684483,CSE 272,A00,102397,Li; Tzumao,0,0,0,0
1667943684905,CSE 274,A00,111323,Chern; Albert Ren-Haur,0,0,0,0
1667943685327,CSE 282,A00,102398,Pevzner; Pavel Arkadjevich,0,0,0,0
1667943685754,CSE 284,A00,114175,Gymrek; Melissa Ann,0,0,0,0
1667943686178,CSE 290,A00,102399,Chandraker; Manmohan Krishna,0,0,0,0
1667943686178,CSE 290,B00,102400,Vaccaro; Kristen Marie,0,0,25,25
1667943686178,CSE 290,C00,102414,Pannuto; Patrick William,1,0,25,24
1667943686178,CSE 290,D00,102427,Pevzner; Pavel Arkadjevich,0,0,0,0
1667943686178,CSE 290,E00,102429,Zhao; Jishen,0,0,0,0
1667943686178,CSE 290,F00,102436,Tullsen; Dean Michael,0,0,0,0
1667943686178,CSE 290,G00,102440,Christensen; Henrik I,0,0,20,20
1667943686609,CSE 291,A00,102443,Su; Hao,0,0,0,0
1667943686609,CSE 291,B00,102448,Polikarpova; Nadezhda,0,0,0,0
1667943686609,CSE 291,C00,102453,Vaccaro; Kristen Marie,0,0,0,0
1667943686609,CSE 291,D00,111343,Savage; Stefan,0,0,0,0
1667943686609,CSE 291,E00,116474,Claffy; Kimberly Claire,0,0,0,0
1667943686609,CSE 291,F00,116479,Pasquale; Joseph,0,0,0,0
1667943687077,CSE 293,001,119111,Bafna; Vineet,9999,0,9999,0
1667943687077,CSE 293,002,119118,Bellare; Mihir,9999,0,9999,0
1667943687077,CSE 293,003,119122,Berg-Kirkpatrick; Taylor D,9999,0,9999,0
1667943687077,CSE 293,004,119135,Christensen; Henrik I,9999,0,9999,0
1667943687077,CSE 293,005,119142,Cottrell; Garrison W,9999,0,9999,0
1667943687077,CSE 293,006,119146,Deutsch; Alin Bernard,9999,0,9999,0
1667943687077,CSE 293,007,119159,Esmaeilzadeh; Hadi,9999,0,9999,0
1667943687077,CSE 293,008,119166,Freund; Yoav,9999,0,9999,0
1667943687077,CSE 293,009,119170,Griswold; William G.,9999,0,9999,0
1667943687077,CSE 293,010,119183,Gymrek; Melissa Ann,9999,0,9999,0
1667943687077,CSE 293,011,119190,Heninger; Nadia A,9999,0,9999,0
1667943687077,CSE 293,012,119230,Impagliazzo; Russell,9999,0,9999,0
1667943687077,CSE 293,013,119232,Jhala; Ranjit,9999,0,9999,0
1667943687077,CSE 293,014,119233,Kahng; Andrew Byun,9999,0,9999,0
1667943687077,CSE 293,015,119298,Kane; Daniel Mertz,9999,0,9999,0
1667943687077,CSE 293,016,119299,Kriegman; David J,9999,0,9999,0
1667943687077,CSE 293,017,119300,Kumar; Arun Kumar,9999,0,9999,0
1667943687077,CSE 293,018,119301,Lerner; Sorin,9999,0,9999,0
1667943687077,CSE 293,019,119302,Lovett; Shachar,9999,0,9999,0
1667943687077,CSE 293,020,119303,McAuley; Julian John,9999,0,9999,0
1667943687077,CSE 293,021,119304,Micciancio; Daniele,9999,0,9999,0
1667943687077,CSE 293,022,119367,Orailoglu; Alex,9999,0,9999,0
1667943687077,CSE 293,023,119382,Paturi; Ramamohan,9999,0,9999,0
1667943687077,CSE 293,024,119404,Polikarpova; Nadezhda,9999,0,9999,0
1667943687077,CSE 293,025,119406,Politz; Joseph Gibbs,9999,0,9999,0
1667943687077,CSE 293,026,119411,Porter; George M,9999,0,9999,0
1667943687077,CSE 293,027,119414,Porter; Leonard Emerson,9999,0,9999,0
1667943687077,CSE 293,028,119416,Ramamoorthi; Ravi,9999,0,9999,0
1667943687077,CSE 293,029,119417,Sahoo; Debashis,9999,0,9999,0
1667943687077,CSE 293,030,119420,Saul; Lawrence,9999,0,9999,0
1667943687077,CSE 293,031,119421,Savage; Stefan,9999,0,9999,0
1667943687077,CSE 293,032,119425,Schulze; Jurgen P.,9999,0,9999,0
1667943687077,CSE 293,033,119426,Snoeren; Alex C.,9999,0,9999,0
1667943687077,CSE 293,034,119428,Shang; Jingbo,9999,0,9999,0
1667943687077,CSE 293,035,119430,Stefan; Deian,9999,0,9999,0
1667943687077,CSE 293,036,119431,Su; Hao,9999,0,9999,0
1667943687077,CSE 293,037,119433,Swanson; Steven James,9999,0,9999,0
1667943687077,CSE 293,038,119435,Tullsen; Dean Michael,9999,0,9999,0
1667943687077,CSE 293,039,119483,Voelker; Geoffrey M.,9999,0,9999,0
1667943687077,CSE 293,040,119537,Zhao; Jishen,9999,0,9999,0
1667943687077,CSE 293,041,119538,Zhou; Yuan-Yuan,9999,0,9999,0
1667943687077,CSE 293,042,119539,Gao; Sicun,9999,0,9999,0
1667943687077,CSE 293,043,119540,Weibel; Nadir,9999,0,9999,0
1667943687077,CSE 293,044,119541,Gupta; Rajesh K.,9999,0,9999,0
1667943687501,CSE 294,A00,102459,Voelker; Geoffrey M.,0,0,0,0
1667943687501,CSE 294,B00,111322,Orailoglu; Alex,0,0,0,0
1667943687928,DSE 201,A00,096914,Deutsch; Alin Bernard,30,0,30,0
1667943688353,DSE 210,A00,096915,Dasgupta; Sanjoy,30,0,30,0
1667943688779,DSE 260A,A00,096916,Altintas De Callaf; Ilkay,30,0,30,0
1667943689249,ECE 200,001,103586,Antipa; Nicholas A,9999,0,9999,0
1667943689249,ECE 200,002,103587,Atanasov; Nikolay A.,9999,0,9999,0
1667943689249,ECE 200,003,103588,Bharadia; Dinesh,9999,0,9999,0
1667943689249,ECE 200,004,103589,Cheng; Chung Kuan,9999,0,9999,0
1667943689249,ECE 200,005,103590,Cosman; Pamela C.,9999,0,9999,0
1667943689249,ECE 200,006,103591,Dayeh; Shadi Ahmad,9999,0,9999,0
1667943689249,ECE 200,007,103592,Fainman; Yeshaiahu,9999,0,9999,0
1667943689249,ECE 200,008,103593,Ford; Joseph Earl,9999,0,9999,0
1667943689249,ECE 200,009,103594,Franceschetti; Massimo,9999,0,9999,0
1667943689249,ECE 200,010,103595,Fullerton; Eric E,9999,0,9999,0
1667943689249,ECE 200,011,103596,Galton; Ian A,9999,0,9999,0
1667943689249,ECE 200,012,103597,Gilja; Vikash,9999,0,9999,0
1667943689249,ECE 200,013,103598,Hall; Drew A.,9999,0,9999,0
1667943689249,ECE 200,014,103599,Hsueh; Tzu-Chien,9999,0,9999,0
1667943689249,ECE 200,015,103600,Javidi; Tara,9999,0,9999,0
1667943689249,ECE 200,016,103601,Kahng; Andrew Byun,9999,0,9999,0
1667943689249,ECE 200,017,103602,Kim; Young-Han,9999,0,9999,0
1667943689249,ECE 200,018,103603,Koushanfar; Farinaz,9999,0,9999,0
1667943689249,ECE 200,019,103604,Kuzum; Duygu,9999,0,9999,0
1667943689249,ECE 200,020,103605,Le; Hanh-Phuc,9999,0,9999,0
1667943689249,ECE 200,021,103606,Lin; Bill,9999,0,9999,0
1667943689249,ECE 200,022,103607,Liu; Zhaowei,9998,0,9999,1
1667943689249,ECE 200,023,103608,Lo; Yu-Hwa,9999,0,9999,0
1667943689249,ECE 200,024,103609,Lomakin; Vitaliy,9999,0,9999,0
1667943689249,ECE 200,025,103610,Mercier; Patrick Philip,9999,0,9999,0
1667943689249,ECE 200,026,103611,Meyer; Florian,9999,0,9999,0
1667943689249,ECE 200,027,103612,Milstein; Laurence B.,9999,0,9999,0
1667943689249,ECE 200,028,103613,Mir Arabbaygi; Siavash,9999,0,9999,0
1667943689249,ECE 200,029,103614,Mookherjea; Shayan,9999,0,9999,0
1667943689249,ECE 200,030,103615,Morris; Karcher William,9999,0,9999,0
1667943689249,ECE 200,031,103616,Ng; Tse Nga,9999,0,9999,0
1667943689249,ECE 200,032,103617,Nguyen; Truong Quang,9999,0,9999,0
1667943689249,ECE 200,033,103618,Nomura; Kenji,9999,0,9999,0
1667943689249,ECE 200,034,103619,Orlitsky; Alon,9999,0,9999,0
1667943689249,ECE 200,035,103620,Pal; Piya,9999,0,9999,0
1667943689249,ECE 200,036,103621,Papen; George C.,9999,0,9999,0
1667943689249,ECE 200,037,103622,Radic; Stojan,9999,0,9999,0
1667943689249,ECE 200,038,103623,Rao; Bhaskar D.,9999,0,9999,0
1667943689249,ECE 200,039,103624,Rao; Ramesh R,9999,0,9999,0
1667943689249,ECE 200,040,103625,Rebeiz; Gabriel,9999,0,9999,0
1667943689249,ECE 200,041,103626,Sanford; John R,9999,0,9999,0
1667943689249,ECE 200,042,103627,Siegel; Paul H.,9999,0,9999,0
1667943689249,ECE 200,043,103628,Sievenpiper; Daniel F.,9999,0,9999,0
1667943689249,ECE 200,044,103629,Sworder; David D.,9999,0,9999,0
1667943689249,ECE 200,045,103630,Taur; Yuan,9999,0,9999,0
1667943689249,ECE 200,046,103631,Touri; Behrouz,9999,0,9999,0
1667943689249,ECE 200,047,103632,Trivedi; Mohan M.,9999,0,9999,0
1667943689249,ECE 200,048,103633,Vasconcelos; Nuno,9999,0,9999,0
1667943689249,ECE 200,049,103634,Wang; Xiaolong,9999,0,9999,0
1667943689249,ECE 200,050,103635,Xie; Pengtao,9999,0,9999,0
1667943689249,ECE 200,051,103636,Yip; Michael,9999,0,9999,0
1667943689249,ECE 200,052,103637,Zeger; Kenneth A.,999,0,999,0
1667943689249,ECE 200,053,103638,Zhang; Xinyu,9999,0,9999,0
1667943689249,ECE 200,054,103639,Turakhia; Yatish Girish,9999,0,9999,0
1667943689249,ECE 200,055,103640,Kang; Mingu,9999,0,9999,0
1667943689249,ECE 200,056,103641,Shi; Yuanyuan,9999,0,9999,0
1667943689249,ECE 200,057,103642,Wang; Edward Jay,9999,0,9999,0
1667943689249,ECE 200,058,103643,Zheng; Yang,9999,0,9999,0
1667943689675,ECE 202,A00,103644,Kuzum; Duygu,0,0,0,0
1667943690098,ECE 212BN,A00,103646,Ng; Tse Nga,0,0,0,0
1667943690521,ECE 221,A00,111493,Staff,0,0,0,0
1667943690959,ECE 222B,A00,103647,Lomakin; Vitaliy,0,0,0,0
1667943691391,ECE 230B,A00,103648,Taur; Yuan,0,0,0,0
1667943691816,ECE 238B,A00,103649,Garay; Javier,0,0,0,0
1667943692251,ECE 240B,A00,112900,Fainman; Yeshaiahu,0,0,0,0
1667943692686,ECE 247A,A00,103650,Jokerst; Jesse Vincent,0,0,0,0
1667943693116,ECE 247B,A00,103651,Wang; Joseph,0,0,0,0
1667943693545,ECE 250,A00,103652,Siegel; Paul H.,0,0,0,0
1667943693968,ECE 251A,A00,103654,Rao; Bhaskar D.,0,0,0,0
1667943694395,ECE 257B,A00,103655,Bharadia; Dinesh,0,0,0,0
1667943694837,ECE 258A,A00,103656,Milstein; Laurence B.,0,0,0,0
1667943695264,ECE 260B,A00,103658,Kang; Mingu,0,0,0,0
1667943695699,ECE 264A,A00,103659,Galton; Ian A,0,0,0,0
1667943696137,ECE 265A,A00,103661,Gudem; Prasad S.S.,0,0,0,0
1667943696568,ECE 265D,A00,103662,Gudem; Prasad S.S.,0,0,0,0
1667943696994,ECE 268,A00,103663,Koushanfar; Farinaz,0,0,0,0
1667943697418,ECE 269,A01,103665,Pal; Piya,0,0,0,0
1667943697861,ECE 271B,A00,103666,Vasconcelos; Manuela,0,0,0,0
1667943698294,ECE 276A,A00,103667,Atanasov; Nikolay A.,0,0,0,0
1667943698720,ECE 277,A00,103668,An; Cheolhong,0,0,0,0
1667943699144,ECE 279,A00,117947,Hall; Drew A.,0,0,0,0
1667943699996,ECE 283,A00,103670,Hsueh; Tzu-Chien,0,0,0,0
1667943700424,ECE 284,A00,103671,Turakhia; Yatish Girish,0,0,0,0
1667943700852,ECE 285,A00,103672,Zheng; Yang,0,0,0,0
1667943700852,ECE 285,B00,103673,Sworder; David D.,0,0,0,0
1667943701279,ECE 287,A00,103676,Javidi; Tara,0,0,0,0
1667943701702,MATH 200B,A00,098023,Salehi Golsefidy; Alireza,14,0,15,1
1667943702209,MATH 202B,A00,098024,Rhoades; Brendon Patrick,13,0,15,2
1667943702637,MATH 203B,A00,098025,Oprea; Dragos N.,14,0,15,1
1667943703086,MATH 204B,A00,098026,Sorensen; Claus M,15,0,15,0
1667943703517,MATH 208,A00,098027,Izadi; Elham,7,0,10,3
1667943703945,MATH 209,A00,098028,Pollack; Aaron,10,0,10,0
1667943704382,MATH 211A,A00,112919,Rogalski; Daniel,10,0,10,0
1667943704805,MATH 211B,A00,112920,Seward; Brandon M.,10,0,10,0
1667943705233,MATH 218,A00,098029,Li; Bo,10,0,10,0
1667943705660,MATH 220B,A00,098030,Novak; Jonathan I,14,0,15,1
1667943706100,MATH 221A,A00,098031,Ebenfelt; Peter F,14,0,15,1
1667943706535,MATH 231B,A00,098032,Zlatos; Andrej,13,0,15,2
1667943706964,MATH 240B,A00,098033,Ni; Lei,11,0,15,4
1667943707394,MATH 243,A00,098034,Jekel; David Andrew,10,0,10,0
1667943707827,MATH 245A,A00,098035,Nie; Jiawang,4,0,15,11
1667943708258,MATH 248,A00,098036,Bejenaru; Ioan,10,0,10,0
1667943708681,MATH 250B,A00,098037,Spolaor; Luca,14,0,15,1
1667943709105,MATH 258,A00,098038,Ni; Lei,10,0,10,0
1667943709538,MATH 264B,A00,098041,Rhoades; Brendon Patrick,13,0,15,2
1667943709962,MATH 268,A00,098042,Buss; Samuel R,10,0,10,0
1667943710391,MATH 269,A00,098043,Rhoades; Brendon Patrick,10,0,10,0
1667943710821,MATH 270B,A00,098044,Li; Bo,11,0,15,4
1667943711243,MATH 272B,A00,098045,Holst; Michael J,13,0,15,2
1667943711667,MATH 273A,A00,098046,Tian; Xiaochuan,12,0,15,3
1667943712176,MATH 275,A01,098048,Tian; Xiaochuan,6,0,10,4
1667943712602,MATH 278A,A00,098049,Holst; Michael J,8,0,10,2
1667943713026,MATH 278B,A00,098050,Cloninger; Alexander,10,0,10,0
1667943713457,MATH 278C,A00,098051,Nie; Jiawang,7,0,10,3
1667943713882,MATH 280B,A00,098052,Zheng; Tianyi,12,0,15,3
1667943714317,MATH 281B,A00,098053,Bradic; Jelena,4,0,15,11
1667943714745,MATH 282B,A00,098054,Arias-Castro; Ery,2,0,15,13
1667943715181,MATH 285,A00,098055,Fitzsimmons; Patrick J,0,0,15,15
1667943715604,MATH 287B,A00,098056,Arias-Castro; Ery,8,0,15,7
1667943716032,MATH 288,A00,098057,Agarwal; Pooja,9,0,10,1
1667943716032,MATH 288,B00,098058,Zhang; Danna,9,0,10,1
1667943716032,MATH 288,C00,098059,Williams; Ruth J,10,0,10,0
1667943716461,MATH 290B,A00,098060,Roberts; Justin Deritter,14,0,15,1
1667943716902,MATH 292,A00,098061,Belmont; Eva Kinoshita,10,0,10,0
1667943717325,MATH 295,A00,098062,Suk; Andrew Hoon,48,0,50,2
1667943717752,MATH 296,A00,098063,Novak; Jonathan I,20,0,20,0
1667943718181,MATH 297,001,098064,Gamst; Anthony Collins,9997,0,9999,2
1667944223826,COGS 205,A00,101395,Chiba; Andrea,19,0,20,1
1667944224263,COGS 210B,001,101404,Greene; Deanna Jacquelyn,9998,0,9999,1
1667944224263,COGS 210B,002,101417,Xia; Haijun,9999,0,9999,0
1667944224263,COGS 210B,003,101422,Nitz; Douglas A.,9999,0,9999,0
1667944224263,COGS 210B,004,101423,Hollan; James D.,9998,0,9999,1
1667944224263,COGS 210B,005,101424,Deak; Gedeon O.,9999,0,9999,0
1667944224263,COGS 210B,006,101425,Rossano; Federico,9999,0,9999,0
1667944224687,COGS 211B,A00,101427,Coulson; Seana M,9997,0,9999,2
1667944225114,COGS 220,A00,101428,Hollan; James D.,0,0,25,25
1667944225539,COGS 229,A00,101429,Dow; Steven P,18,0,25,7
1667944225967,COGS 230,A00,101430,Klemmer; Scott R,13,0,17,4
1667944226391,COGS 234,A00,101431,Xia; Haijun,10,0,25,15
1667944226820,COGS 260,A00,101432,Kiyonaga; Anastasia,20,0,25,5
1667944226820,COGS 260,B00,101433,Kirsh; David Joel,17,0,25,8
1667944227256,CSE 202,A00,102371,Impagliazzo; Russell,0,0,0,0
1667944227683,CSE 203B,A01,102373,Cheng; Chung Kuan,0,0,0,0
1667944228124,CSE 208,A00,102374,Micciancio; Daniele,0,0,0,0
1667944228549,CSE 209A,A00,112895,Impagliazzo; Russell,0,0,15,15
1667944228980,CSE 209B,A00,108005,Bellare; Mihir,0,0,0,0
1667944229417,CSE 210,A00,113163,Coblenz; Michael J,0,0,0,0
1667944229854,CSE 219,A00,106111,Dow; Steven P,0,0,20,20
1667944230280,CSE 221,A00,102376,Voelker; Geoffrey M.,0,0,0,0
1667944230701,CSE 224,A01,102378,Porter; George M,0,0,0,0
1667944231135,CSE 229A,A00,102379,Savage; Stefan,0,0,0,0
1667944231563,CSE 229C,A00,102380,Munyaka; Imani N. S.,0,0,0,0
1667944231997,CSE 232B,A00,102382,Deutsch; Alin Bernard,0,0,0,0
1667944232428,CSE 234,A01,112904,Kumar; Arun Kumar,0,0,0,0
1667944232851,CSE 237A,A00,102383,Rosing; Tajana Simunic,0,0,0,0
1667944233275,CSE 239A,A00,102384,Deutsch; Alin Bernard,0,0,0,0
1667944233704,CSE 239B,A00,102385,Polikarpova; Nadezhda,0,0,0,0
1667944234133,CSE 240A,A00,102386,Pannuto; Patrick William,0,0,0,0
1667944234561,CSE 240B,A00,102387,Zhao; Jishen,0,0,0,0
1667944234992,CSE 241A,A00,106406,Kang; Mingu,0,0,0,0
1667944235427,CSE 249B,A00,102388,Kahng; Andrew Byun,0,0,8,8
1667944235864,CSE 251B,A01,102392,Cottrell; Garrison W,0,0,0,0
1667944235864,CSE 251B,A02,102393,Cottrell; Garrison W,0,0,0,0
1667944236301,CSE 252B,A00,102394,Ochoa; Benjamin Lawrence,0,0,0,0
1667944236725,CSE 257,A01,102396,Gao; Sicun,0,0,0,0
1667944237150,CSE 272,A00,102397,Li; Tzumao,0,0,0,0
1667944237573,CSE 274,A00,111323,Chern; Albert Ren-Haur,0,0,0,0
1667944238078,CSE 282,A00,102398,Pevzner; Pavel Arkadjevich,0,0,0,0
1667944238501,CSE 284,A00,114175,Gymrek; Melissa Ann,0,0,0,0
1667944238931,CSE 290,A00,102399,Chandraker; Manmohan Krishna,0,0,0,0
1667944238931,CSE 290,B00,102400,Vaccaro; Kristen Marie,0,0,25,25
1667944238931,CSE 290,C00,102414,Pannuto; Patrick William,1,0,25,24
1667944238931,CSE 290,D00,102427,Pevzner; Pavel Arkadjevich,0,0,0,0
1667944238931,CSE 290,E00,102429,Zhao; Jishen,0,0,0,0
1667944238931,CSE 290,F00,102436,Tullsen; Dean Michael,0,0,0,0
1667944238931,CSE 290,G00,102440,Christensen; Henrik I,0,0,20,20
1667944239370,CSE 291,A00,102443,Su; Hao,0,0,0,0
1667944239370,CSE 291,B00,102448,Polikarpova; Nadezhda,0,0,0,0
1667944239370,CSE 291,C00,102453,Vaccaro; Kristen Marie,0,0,0,0
1667944239370,CSE 291,D00,111343,Savage; Stefan,0,0,0,0
1667944239370,CSE 291,E00,116474,Claffy; Kimberly Claire,0,0,0,0
1667944239370,CSE 291,F00,116479,Pasquale; Joseph,0,0,0,0
1667944239817,CSE 293,001,119111,Bafna; Vineet,9999,0,9999,0
1667944239817,CSE 293,002,119118,Bellare; Mihir,9999,0,9999,0
1667944239817,CSE 293,003,119122,Berg-Kirkpatrick; Taylor D,9999,0,9999,0
1667944239817,CSE 293,004,119135,Christensen; Henrik I,9999,0,9999,0
1667944239817,CSE 293,005,119142,Cottrell; Garrison W,9999,0,9999,0
1667944239817,CSE 293,006,119146,Deutsch; Alin Bernard,9999,0,9999,0
1667944239817,CSE 293,007,119159,Esmaeilzadeh; Hadi,9999,0,9999,0
1667944239817,CSE 293,008,119166,Freund; Yoav,9999,0,9999,0
1667944239817,CSE 293,009,119170,Griswold; William G.,9999,0,9999,0
1667944239817,CSE 293,010,119183,Gymrek; Melissa Ann,9999,0,9999,0
1667944239817,CSE 293,011,119190,Heninger; Nadia A,9999,0,9999,0
1667944239817,CSE 293,012,119230,Impagliazzo; Russell,9999,0,9999,0
1667944239817,CSE 293,013,119232,Jhala; Ranjit,9999,0,9999,0
1667944239817,CSE 293,014,119233,Kahng; Andrew Byun,9999,0,9999,0
1667944239817,CSE 293,015,119298,Kane; Daniel Mertz,9999,0,9999,0
1667944239817,CSE 293,016,119299,Kriegman; David J,9999,0,9999,0
1667944239817,CSE 293,017,119300,Kumar; Arun Kumar,9999,0,9999,0
1667944239817,CSE 293,018,119301,Lerner; Sorin,9999,0,9999,0
1667944239817,CSE 293,019,119302,Lovett; Shachar,9999,0,9999,0
1667944239817,CSE 293,020,119303,McAuley; Julian John,9999,0,9999,0
1667944239817,CSE 293,021,119304,Micciancio; Daniele,9999,0,9999,0
1667944239817,CSE 293,022,119367,Orailoglu; Alex,9999,0,9999,0
1667944239817,CSE 293,023,119382,Paturi; Ramamohan,9999,0,9999,0
1667944239817,CSE 293,024,119404,Polikarpova; Nadezhda,9999,0,9999,0
1667944239817,CSE 293,025,119406,Politz; Joseph Gibbs,9999,0,9999,0
1667944239817,CSE 293,026,119411,Porter; George M,9999,0,9999,0
1667944239817,CSE 293,027,119414,Porter; Leonard Emerson,9999,0,9999,0
1667944239817,CSE 293,028,119416,Ramamoorthi; Ravi,9999,0,9999,0
1667944239817,CSE 293,029,119417,Sahoo; Debashis,9999,0,9999,0
1667944239817,CSE 293,030,119420,Saul; Lawrence,9999,0,9999,0
1667944239817,CSE 293,031,119421,Savage; Stefan,9999,0,9999,0
1667944239817,CSE 293,032,119425,Schulze; Jurgen P.,9999,0,9999,0
1667944239817,CSE 293,033,119426,Snoeren; Alex C.,9999,0,9999,0
1667944239817,CSE 293,034,119428,Shang; Jingbo,9999,0,9999,0
1667944239817,CSE 293,035,119430,Stefan; Deian,9999,0,9999,0
1667944239817,CSE 293,036,119431,Su; Hao,9999,0,9999,0
1667944239817,CSE 293,037,119433,Swanson; Steven James,9999,0,9999,0
1667944239817,CSE 293,038,119435,Tullsen; Dean Michael,9999,0,9999,0
1667944239817,CSE 293,039,119483,Voelker; Geoffrey M.,9999,0,9999,0
1667944239817,CSE 293,040,119537,Zhao; Jishen,9999,0,9999,0
1667944239817,CSE 293,041,119538,Zhou; Yuan-Yuan,9999,0,9999,0
1667944239817,CSE 293,042,119539,Gao; Sicun,9999,0,9999,0
1667944239817,CSE 293,043,119540,Weibel; Nadir,9999,0,9999,0
1667944239817,CSE 293,044,119541,Gupta; Rajesh K.,9999,0,9999,0
1667944240238,CSE 294,A00,102459,Voelker; Geoffrey M.,0,0,0,0
1667944240238,CSE 294,B00,111322,Orailoglu; Alex,0,0,0,0
1667944240668,DSE 201,A00,096914,Deutsch; Alin Bernard,30,0,30,0
1667944241093,DSE 210,A00,096915,Dasgupta; Sanjoy,30,0,30,0
1667944241519,DSE 260A,A00,096916,Altintas De Callaf; Ilkay,30,0,30,0
1667944242111,ECE 200,001,103586,Antipa; Nicholas A,9999,0,9999,0
1667944242111,ECE 200,002,103587,Atanasov; Nikolay A.,9999,0,9999,0
1667944242111,ECE 200,003,103588,Bharadia; Dinesh,9999,0,9999,0
1667944242111,ECE 200,004,103589,Cheng; Chung Kuan,9999,0,9999,0
1667944242111,ECE 200,005,103590,Cosman; Pamela C.,9999,0,9999,0
1667944242111,ECE 200,006,103591,Dayeh; Shadi Ahmad,9999,0,9999,0
1667944242111,ECE 200,007,103592,Fainman; Yeshaiahu,9999,0,9999,0
1667944242111,ECE 200,008,103593,Ford; Joseph Earl,9999,0,9999,0
1667944242111,ECE 200,009,103594,Franceschetti; Massimo,9999,0,9999,0
1667944242111,ECE 200,010,103595,Fullerton; Eric E,9999,0,9999,0
1667944242111,ECE 200,011,103596,Galton; Ian A,9999,0,9999,0
1667944242111,ECE 200,012,103597,Gilja; Vikash,9999,0,9999,0
1667944242111,ECE 200,013,103598,Hall; Drew A.,9999,0,9999,0
1667944242111,ECE 200,014,103599,Hsueh; Tzu-Chien,9999,0,9999,0
1667944242111,ECE 200,015,103600,Javidi; Tara,9999,0,9999,0
1667944242111,ECE 200,016,103601,Kahng; Andrew Byun,9999,0,9999,0
1667944242111,ECE 200,017,103602,Kim; Young-Han,9999,0,9999,0
1667944242111,ECE 200,018,103603,Koushanfar; Farinaz,9999,0,9999,0
1667944242111,ECE 200,019,103604,Kuzum; Duygu,9999,0,9999,0
1667944242111,ECE 200,020,103605,Le; Hanh-Phuc,9999,0,9999,0
1667944242111,ECE 200,021,103606,Lin; Bill,9999,0,9999,0
1667944242111,ECE 200,022,103607,Liu; Zhaowei,9998,0,9999,1
1667944242111,ECE 200,023,103608,Lo; Yu-Hwa,9999,0,9999,0
1667944242111,ECE 200,024,103609,Lomakin; Vitaliy,9999,0,9999,0
1667944242111,ECE 200,025,103610,Mercier; Patrick Philip,9999,0,9999,0
1667944242111,ECE 200,026,103611,Meyer; Florian,9999,0,9999,0
1667944242111,ECE 200,027,103612,Milstein; Laurence B.,9999,0,9999,0
1667944242111,ECE 200,028,103613,Mir Arabbaygi; Siavash,9999,0,9999,0
1667944242111,ECE 200,029,103614,Mookherjea; Shayan,9999,0,9999,0
1667944242111,ECE 200,030,103615,Morris; Karcher William,9999,0,9999,0
1667944242111,ECE 200,031,103616,Ng; Tse Nga,9999,0,9999,0
1667944242111,ECE 200,032,103617,Nguyen; Truong Quang,9999,0,9999,0
1667944242111,ECE 200,033,103618,Nomura; Kenji,9999,0,9999,0
1667944242111,ECE 200,034,103619,Orlitsky; Alon,9999,0,9999,0
1667944242111,ECE 200,035,103620,Pal; Piya,9999,0,9999,0
1667944242111,ECE 200,036,103621,Papen; George C.,9999,0,9999,0
1667944242111,ECE 200,037,103622,Radic; Stojan,9999,0,9999,0
1667944242111,ECE 200,038,103623,Rao; Bhaskar D.,9999,0,9999,0
1667944242111,ECE 200,039,103624,Rao; Ramesh R,9999,0,9999,0
1667944242111,ECE 200,040,103625,Rebeiz; Gabriel,9999,0,9999,0
1667944242111,ECE 200,041,103626,Sanford; John R,9999,0,9999,0
1667944242111,ECE 200,042,103627,Siegel; Paul H.,9999,0,9999,0
1667944242111,ECE 200,043,103628,Sievenpiper; Daniel F.,9999,0,9999,0
1667944242111,ECE 200,044,103629,Sworder; David D.,9999,0,9999,0
1667944242111,ECE 200,045,103630,Taur; Yuan,9999,0,9999,0
1667944242111,ECE 200,046,103631,Touri; Behrouz,9999,0,9999,0
1667944242111,ECE 200,047,103632,Trivedi; Mohan M.,9999,0,9999,0
1667944242111,ECE 200,048,103633,Vasconcelos; Nuno,9999,0,9999,0
1667944242111,ECE 200,049,103634,Wang; Xiaolong,9999,0,9999,0
1667944242111,ECE 200,050,103635,Xie; Pengtao,9999,0,9999,0
1667944242111,ECE 200,051,103636,Yip; Michael,9999,0,9999,0
1667944242111,ECE 200,052,103637,Zeger; Kenneth A.,999,0,999,0
1667944242111,ECE 200,053,103638,Zhang; Xinyu,9999,0,9999,0
1667944242111,ECE 200,054,103639,Turakhia; Yatish Girish,9999,0,9999,0
1667944242111,ECE 200,055,103640,Kang; Mingu,9999,0,9999,0
1667944242111,ECE 200,056,103641,Shi; Yuanyuan,9999,0,9999,0
1667944242111,ECE 200,057,103642,Wang; Edward Jay,9999,0,9999,0
1667944242111,ECE 200,058,103643,Zheng; Yang,9999,0,9999,0
1667944242536,ECE 202,A00,103644,Kuzum; Duygu,0,0,0,0
1667944242975,ECE 212BN,A00,103646,Ng; Tse Nga,0,0,0,0
1667944243397,ECE 221,A00,111493,Staff,0,0,0,0
1667944243823,ECE 222B,A00,103647,Lomakin; Vitaliy,0,0,0,0
1667944244260,ECE 230B,A00,103648,Taur; Yuan,0,0,0,0
1667944244698,ECE 238B,A00,103649,Garay; Javier,0,0,0,0
1667944245123,ECE 240B,A00,112900,Fainman; Yeshaiahu,0,0,0,0
1667944245546,ECE 247A,A00,103650,Jokerst; Jesse Vincent,0,0,0,0
1667944245978,ECE 247B,A00,103651,Wang; Joseph,0,0,0,0
1667944246410,ECE 250,A00,103652,Siegel; Paul H.,0,0,0,0
1667944246845,ECE 251A,A00,103654,Rao; Bhaskar D.,0,0,0,0
1667944247274,ECE 257B,A00,103655,Bharadia; Dinesh,0,0,0,0
1667944247706,ECE 258A,A00,103656,Milstein; Laurence B.,0,0,0,0
1667944248134,ECE 260B,A00,103658,Kang; Mingu,0,0,0,0
1667944248561,ECE 264A,A00,103659,Galton; Ian A,0,0,0,0
1667944248995,ECE 265A,A00,103661,Gudem; Prasad S.S.,0,0,0,0
1667944249420,ECE 265D,A00,103662,Gudem; Prasad S.S.,0,0,0,0
1667944249857,ECE 268,A00,103663,Koushanfar; Farinaz,0,0,0,0
1667944250292,ECE 269,A01,103665,Pal; Piya,0,0,0,0
1667944250717,ECE 271B,A00,103666,Vasconcelos; Manuela,0,0,0,0
1667944251141,ECE 276A,A00,103667,Atanasov; Nikolay A.,0,0,0,0
1667944251565,ECE 277,A00,103668,An; Cheolhong,0,0,0,0
1667944251990,ECE 279,A00,117947,Hall; Drew A.,0,0,0,0
1667944252855,ECE 283,A00,103670,Hsueh; Tzu-Chien,0,0,0,0
1667944253281,ECE 284,A00,103671,Turakhia; Yatish Girish,0,0,0,0
1667944253709,ECE 285,A00,103672,Zheng; Yang,0,0,0,0
1667944253709,ECE 285,B00,103673,Sworder; David D.,0,0,0,0
1667944254141,ECE 287,A00,103676,Javidi; Tara,0,0,0,0
1667944254571,MATH 200B,A00,098023,Salehi Golsefidy; Alireza,14,0,15,1
1667944255002,MATH 202B,A00,098024,Rhoades; Brendon Patrick,13,0,15,2
1667944255423,MATH 203B,A00,098025,Oprea; Dragos N.,14,0,15,1
1667944255846,MATH 204B,A00,098026,Sorensen; Claus M,15,0,15,0
1667944256273,MATH 208,A00,098027,Izadi; Elham,7,0,10,3
1667944256703,MATH 209,A00,098028,Pollack; Aaron,10,0,10,0
1667944257133,MATH 211A,A00,112919,Rogalski; Daniel,10,0,10,0
1667944257563,MATH 211B,A00,112920,Seward; Brandon M.,10,0,10,0
1667944257997,MATH 218,A00,098029,Li; Bo,10,0,10,0
1667944258437,MATH 220B,A00,098030,Novak; Jonathan I,14,0,15,1
1667944258875,MATH 221A,A00,098031,Ebenfelt; Peter F,14,0,15,1
1667944259310,MATH 231B,A00,098032,Zlatos; Andrej,13,0,15,2
1667944259736,MATH 240B,A00,098033,Ni; Lei,11,0,15,4
1667944260162,MATH 243,A00,098034,Jekel; David Andrew,10,0,10,0
1667944260594,MATH 245A,A00,098035,Nie; Jiawang,4,0,15,11
1667944261178,MATH 248,A00,098036,Bejenaru; Ioan,10,0,10,0
1667944261611,MATH 250B,A00,098037,Spolaor; Luca,14,0,15,1
1667944262048,MATH 258,A00,098038,Ni; Lei,10,0,10,0
1667944262470,MATH 264B,A00,098041,Rhoades; Brendon Patrick,13,0,15,2
1667944262893,MATH 268,A00,098042,Buss; Samuel R,10,0,10,0
1667944263319,MATH 269,A00,098043,Rhoades; Brendon Patrick,10,0,10,0
1667944263742,MATH 270B,A00,098044,Li; Bo,11,0,15,4
1667944264173,MATH 272B,A00,098045,Holst; Michael J,13,0,15,2
1667944264602,MATH 273A,A00,098046,Tian; Xiaochuan,12,0,15,3
1667944265053,MATH 275,A01,098048,Tian; Xiaochuan,6,0,10,4
1667944265475,MATH 278A,A00,098049,Holst; Michael J,8,0,10,2
1667944265899,MATH 278B,A00,098050,Cloninger; Alexander,10,0,10,0
1667944266324,MATH 278C,A00,098051,Nie; Jiawang,7,0,10,3
1667944266761,MATH 280B,A00,098052,Zheng; Tianyi,12,0,15,3
1667944267198,MATH 281B,A00,098053,Bradic; Jelena,4,0,15,11
1667944267628,MATH 282B,A00,098054,Arias-Castro; Ery,2,0,15,13
1667944268064,MATH 285,A00,098055,Fitzsimmons; Patrick J,0,0,15,15
1667944268495,MATH 287B,A00,098056,Arias-Castro; Ery,8,0,15,7
1667944268932,MATH 288,A00,098057,Agarwal; Pooja,9,0,10,1
1667944268932,MATH 288,B00,098058,Zhang; Danna,9,0,10,1
1667944268932,MATH 288,C00,098059,Williams; Ruth J,10,0,10,0
1667944269355,MATH 290B,A00,098060,Roberts; Justin Deritter,14,0,15,1
1667944269783,MATH 292,A00,098061,Belmont; Eva Kinoshita,10,0,10,0
1667944270208,MATH 295,A00,098062,Suk; Andrew Hoon,48,0,50,2
1667944270636,MATH 296,A00,098063,Novak; Jonathan I,20,0,20,0
1667944271059,MATH 297,001,098064,Gamst; Anthony Collins,9997,0,9999,2
1667944775988,COGS 205,A00,101395,Chiba; Andrea,19,0,20,1
1667944776429,COGS 210B,001,101404,Greene; Deanna Jacquelyn,9998,0,9999,1
1667944776429,COGS 210B,002,101417,Xia; Haijun,9999,0,9999,0
1667944776429,COGS 210B,003,101422,Nitz; Douglas A.,9999,0,9999,0
1667944776429,COGS 210B,004,101423,Hollan; James D.,9998,0,9999,1
1667944776429,COGS 210B,005,101424,Deak; Gedeon O.,9999,0,9999,0
1667944776429,COGS 210B,006,101425,Rossano; Federico,9999,0,9999,0
1667944776854,COGS 211B,A00,101427,Coulson; Seana M,9997,0,9999,2
1667944777278,COGS 220,A00,101428,Hollan; James D.,0,0,25,25
1667944777700,COGS 229,A00,101429,Dow; Steven P,18,0,25,7
1667944778138,COGS 230,A00,101430,Klemmer; Scott R,13,0,17,4
1667944778561,COGS 234,A00,101431,Xia; Haijun,10,0,25,15
1667944778993,COGS 260,A00,101432,Kiyonaga; Anastasia,20,0,25,5
1667944778993,COGS 260,B00,101433,Kirsh; David Joel,17,0,25,8
1667944779417,CSE 202,A00,102371,Impagliazzo; Russell,0,0,0,0
1667944779846,CSE 203B,A01,102373,Cheng; Chung Kuan,0,0,0,0
1667944780270,CSE 208,A00,102374,Micciancio; Daniele,0,0,0,0
1667944780695,CSE 209A,A00,112895,Impagliazzo; Russell,0,0,15,15
1667944781127,CSE 209B,A00,108005,Bellare; Mihir,0,0,0,0
1667944781553,CSE 210,A00,113163,Coblenz; Michael J,0,0,0,0
1667944781985,CSE 219,A00,106111,Dow; Steven P,0,0,20,20
1667944782410,CSE 221,A00,102376,Voelker; Geoffrey M.,0,0,0,0
1667944782834,CSE 224,A01,102378,Porter; George M,0,0,0,0
1667944783279,CSE 229A,A00,102379,Savage; Stefan,0,0,0,0
1667944783712,CSE 229C,A00,102380,Munyaka; Imani N. S.,0,0,0,0
1667944784134,CSE 232B,A00,102382,Deutsch; Alin Bernard,0,0,0,0
1667944784569,CSE 234,A01,112904,Kumar; Arun Kumar,0,0,0,0
1667944784994,CSE 237A,A00,102383,Rosing; Tajana Simunic,0,0,0,0
1667944785433,CSE 239A,A00,102384,Deutsch; Alin Bernard,0,0,0,0
1667944785873,CSE 239B,A00,102385,Polikarpova; Nadezhda,0,0,0,0
1667944786309,CSE 240A,A00,102386,Pannuto; Patrick William,0,0,0,0
1667944786746,CSE 240B,A00,102387,Zhao; Jishen,0,0,0,0
1667944787173,CSE 241A,A00,106406,Kang; Mingu,0,0,0,0
1667944787604,CSE 249B,A00,102388,Kahng; Andrew Byun,0,0,8,8
1667944788050,CSE 251B,A01,102392,Cottrell; Garrison W,0,0,0,0
1667944788050,CSE 251B,A02,102393,Cottrell; Garrison W,0,0,0,0
1667944788477,CSE 252B,A00,102394,Ochoa; Benjamin Lawrence,0,0,0,0
1667944788903,CSE 257,A01,102396,Gao; Sicun,0,0,0,0
1667944789330,CSE 272,A00,102397,Li; Tzumao,0,0,0,0
1667944789754,CSE 274,A00,111323,Chern; Albert Ren-Haur,0,0,0,0
1667944790190,CSE 282,A00,102398,Pevzner; Pavel Arkadjevich,0,0,0,0
1667944790618,CSE 284,A00,114175,Gymrek; Melissa Ann,0,0,0,0
1667944791044,CSE 290,A00,102399,Chandraker; Manmohan Krishna,0,0,0,0
1667944791044,CSE 290,B00,102400,Vaccaro; Kristen Marie,0,0,25,25
1667944791044,CSE 290,C00,102414,Pannuto; Patrick William,1,0,25,24
1667944791044,CSE 290,D00,102427,Pevzner; Pavel Arkadjevich,0,0,0,0
1667944791044,CSE 290,E00,102429,Zhao; Jishen,0,0,0,0
1667944791044,CSE 290,F00,102436,Tullsen; Dean Michael,0,0,0,0
1667944791044,CSE 290,G00,102440,Christensen; Henrik I,0,0,20,20
1667944791470,CSE 291,A00,102443,Su; Hao,0,0,0,0
1667944791470,CSE 291,B00,102448,Polikarpova; Nadezhda,0,0,0,0
1667944791470,CSE 291,C00,102453,Vaccaro; Kristen Marie,0,0,0,0
1667944791470,CSE 291,D00,111343,Savage; Stefan,0,0,0,0
1667944791470,CSE 291,E00,116474,Claffy; Kimberly Claire,0,0,0,0
1667944791470,CSE 291,F00,116479,Pasquale; Joseph,0,0,0,0
1667944791910,CSE 293,001,119111,Bafna; Vineet,9999,0,9999,0
1667944791910,CSE 293,002,119118,Bellare; Mihir,9999,0,9999,0
1667944791910,CSE 293,003,119122,Berg-Kirkpatrick; Taylor D,9999,0,9999,0
1667944791910,CSE 293,004,119135,Christensen; Henrik I,9999,0,9999,0
1667944791910,CSE 293,005,119142,Cottrell; Garrison W,9999,0,9999,0
1667944791910,CSE 293,006,119146,Deutsch; Alin Bernard,9999,0,9999,0
1667944791910,CSE 293,007,119159,Esmaeilzadeh; Hadi,9999,0,9999,0
1667944791910,CSE 293,008,119166,Freund; Yoav,9999,0,9999,0
1667944791910,CSE 293,009,119170,Griswold; William G.,9999,0,9999,0
1667944791910,CSE 293,010,119183,Gymrek; Melissa Ann,9999,0,9999,0
1667944791910,CSE 293,011,119190,Heninger; Nadia A,9999,0,9999,0
1667944791910,CSE 293,012,119230,Impagliazzo; Russell,9999,0,9999,0
1667944791910,CSE 293,013,119232,Jhala; Ranjit,9999,0,9999,0
1667944791910,CSE 293,014,119233,Kahng; Andrew Byun,9999,0,9999,0
1667944791910,CSE 293,015,119298,Kane; Daniel Mertz,9999,0,9999,0
1667944791910,CSE 293,016,119299,Kriegman; David J,9999,0,9999,0
1667944791910,CSE 293,017,119300,Kumar; Arun Kumar,9999,0,9999,0
1667944791910,CSE 293,018,119301,Lerner; Sorin,9999,0,9999,0
1667944791910,CSE 293,019,119302,Lovett; Shachar,9999,0,9999,0
1667944791910,CSE 293,020,119303,McAuley; Julian John,9999,0,9999,0
1667944791910,CSE 293,021,119304,Micciancio; Daniele,9999,0,9999,0
1667944791910,CSE 293,022,119367,Orailoglu; Alex,9999,0,9999,0
1667944791910,CSE 293,023,119382,Paturi; Ramamohan,9999,0,9999,0
1667944791910,CSE 293,024,119404,Polikarpova; Nadezhda,9999,0,9999,0
1667944791910,CSE 293,025,119406,Politz; Joseph Gibbs,9999,0,9999,0
1667944791910,CSE 293,026,119411,Porter; George M,9999,0,9999,0
1667944791910,CSE 293,027,119414,Porter; Leonard Emerson,9999,0,9999,0
1667944791910,CSE 293,028,119416,Ramamoorthi; Ravi,9999,0,9999,0
1667944791910,CSE 293,029,119417,Sahoo; Debashis,9999,0,9999,0
1667944791910,CSE 293,030,119420,Saul; Lawrence,9999,0,9999,0
1667944791910,CSE 293,031,119421,Savage; Stefan,9999,0,9999,0
1667944791910,CSE 293,032,119425,Schulze; Jurgen P.,9999,0,9999,0
1667944791910,CSE 293,033,119426,Snoeren; Alex C.,9999,0,9999,0
1667944791910,CSE 293,034,119428,Shang; Jingbo,9999,0,9999,0
1667944791910,CSE 293,035,119430,Stefan; Deian,9999,0,9999,0
1667944791910,CSE 293,036,119431,Su; Hao,9999,0,9999,0
1667944791910,CSE 293,037,119433,Swanson; Steven James,9999,0,9999,0
1667944791910,CSE 293,038,119435,Tullsen; Dean Michael,9999,0,9999,0
1667944791910,CSE 293,039,119483,Voelker; Geoffrey M.,9999,0,9999,0
1667944791910,CSE 293,040,119537,Zhao; Jishen,9999,0,9999,0
1667944791910,CSE 293,041,119538,Zhou; Yuan-Yuan,9999,0,9999,0
1667944791910,CSE 293,042,119539,Gao; Sicun,9999,0,9999,0
1667944791910,CSE 293,043,119540,Weibel; Nadir,9999,0,9999,0
1667944791910,CSE 293,044,119541,Gupta; Rajesh K.,9999,0,9999,0
1667944792333,CSE 294,A00,102459,Voelker; Geoffrey M.,0,0,0,0
1667944792333,CSE 294,B00,111322,Orailoglu; Alex,0,0,0,0
1667944792756,DSE 201,A00,096914,Deutsch; Alin Bernard,30,0,30,0
1667944793192,DSE 210,A00,096915,Dasgupta; Sanjoy,30,0,30,0
1667944793624,DSE 260A,A00,096916,Altintas De Callaf; Ilkay,30,0,30,0
1667944794072,ECE 200,001,103586,Antipa; Nicholas A,9999,0,9999,0
1667944794072,ECE 200,002,103587,Atanasov; Nikolay A.,9999,0,9999,0
1667944794072,ECE 200,003,103588,Bharadia; Dinesh,9999,0,9999,0
1667944794072,ECE 200,004,103589,Cheng; Chung Kuan,9999,0,9999,0
1667944794072,ECE 200,005,103590,Cosman; Pamela C.,9999,0,9999,0
1667944794072,ECE 200,006,103591,Dayeh; Shadi Ahmad,9999,0,9999,0
1667944794072,ECE 200,007,103592,Fainman; Yeshaiahu,9999,0,9999,0
1667944794072,ECE 200,008,103593,Ford; Joseph Earl,9999,0,9999,0
1667944794072,ECE 200,009,103594,Franceschetti; Massimo,9999,0,9999,0
1667944794072,ECE 200,010,103595,Fullerton; Eric E,9999,0,9999,0
1667944794072,ECE 200,011,103596,Galton; Ian A,9999,0,9999,0
1667944794072,ECE 200,012,103597,Gilja; Vikash,9999,0,9999,0
1667944794072,ECE 200,013,103598,Hall; Drew A.,9999,0,9999,0
1667944794072,ECE 200,014,103599,Hsueh; Tzu-Chien,9999,0,9999,0
1667944794072,ECE 200,015,103600,Javidi; Tara,9999,0,9999,0
1667944794072,ECE 200,016,103601,Kahng; Andrew Byun,9999,0,9999,0
1667944794072,ECE 200,017,103602,Kim; Young-Han,9999,0,9999,0
1667944794072,ECE 200,018,103603,Koushanfar; Farinaz,9999,0,9999,0
1667944794072,ECE 200,019,103604,Kuzum; Duygu,9999,0,9999,0
1667944794072,ECE 200,020,103605,Le; Hanh-Phuc,9999,0,9999,0
1667944794072,ECE 200,021,103606,Lin; Bill,9999,0,9999,0
1667944794072,ECE 200,022,103607,Liu; Zhaowei,9998,0,9999,1
1667944794072,ECE 200,023,103608,Lo; Yu-Hwa,9999,0,9999,0
1667944794072,ECE 200,024,103609,Lomakin; Vitaliy,9999,0,9999,0
1667944794072,ECE 200,025,103610,Mercier; Patrick Philip,9999,0,9999,0
1667944794072,ECE 200,026,103611,Meyer; Florian,9999,0,9999,0
1667944794072,ECE 200,027,103612,Milstein; Laurence B.,9999,0,9999,0
1667944794072,ECE 200,028,103613,Mir Arabbaygi; Siavash,9999,0,9999,0
1667944794072,ECE 200,029,103614,Mookherjea; Shayan,9999,0,9999,0
1667944794072,ECE 200,030,103615,Morris; Karcher William,9999,0,9999,0
1667944794072,ECE 200,031,103616,Ng; Tse Nga,9999,0,9999,0
1667944794072,ECE 200,032,103617,Nguyen; Truong Quang,9999,0,9999,0
1667944794072,ECE 200,033,103618,Nomura; Kenji,9999,0,9999,0
1667944794072,ECE 200,034,103619,Orlitsky; Alon,9999,0,9999,0
1667944794072,ECE 200,035,103620,Pal; Piya,9999,0,9999,0
1667944794072,ECE 200,036,103621,Papen; George C.,9999,0,9999,0
1667944794072,ECE 200,037,103622,Radic; Stojan,9999,0,9999,0
1667944794072,ECE 200,038,103623,Rao; Bhaskar D.,9999,0,9999,0
1667944794072,ECE 200,039,103624,Rao; Ramesh R,9999,0,9999,0
1667944794072,ECE 200,040,103625,Rebeiz; Gabriel,9999,0,9999,0
1667944794072,ECE 200,041,103626,Sanford; John R,9999,0,9999,0
1667944794072,ECE 200,042,103627,Siegel; Paul H.,9999,0,9999,0
1667944794072,ECE 200,043,103628,Sievenpiper; Daniel F.,9999,0,9999,0
1667944794072,ECE 200,044,103629,Sworder; David D.,9999,0,9999,0
1667944794072,ECE 200,045,103630,Taur; Yuan,9999,0,9999,0
1667944794072,ECE 200,046,103631,Touri; Behrouz,9999,0,9999,0
1667944794072,ECE 200,047,103632,Trivedi; Mohan M.,9999,0,9999,0
1667944794072,ECE 200,048,103633,Vasconcelos; Nuno,9999,0,9999,0
1667944794072,ECE 200,049,103634,Wang; Xiaolong,9999,0,9999,0
1667944794072,ECE 200,050,103635,Xie; Pengtao,9999,0,9999,0
1667944794072,ECE 200,051,103636,Yip; Michael,9999,0,9999,0
1667944794072,ECE 200,052,103637,Zeger; Kenneth A.,999,0,999,0
1667944794072,ECE 200,053,103638,Zhang; Xinyu,9999,0,9999,0
1667944794072,ECE 200,054,103639,Turakhia; Yatish Girish,9999,0,9999,0
1667944794072,ECE 200,055,103640,Kang; Mingu,9999,0,9999,0
1667944794072,ECE 200,056,103641,Shi; Yuanyuan,9999,0,9999,0
1667944794072,ECE 200,057,103642,Wang; Edward Jay,9999,0,9999,0
1667944794072,ECE 200,058,103643,Zheng; Yang,9999,0,9999,0
1667944794507,ECE 202,A00,103644,Kuzum; Duygu,0,0,0,0
1667944794936,ECE 212BN,A00,103646,Ng; Tse Nga,0,0,0,0
1667944795367,ECE 221,A00,111493,Staff,0,0,0,0
1667944795801,ECE 222B,A00,103647,Lomakin; Vitaliy,0,0,0,0
1667944796230,ECE 230B,A00,103648,Taur; Yuan,0,0,0,0
1667944796676,ECE 238B,A00,103649,Garay; Javier,0,0,0,0
1667944797107,ECE 240B,A00,112900,Fainman; Yeshaiahu,0,0,0,0
1667944797533,ECE 247A,A00,103650,Jokerst; Jesse Vincent,0,0,0,0
1667944797964,ECE 247B,A00,103651,Wang; Joseph,0,0,0,0
1667944798391,ECE 250,A00,103652,Siegel; Paul H.,0,0,0,0
1667944798844,ECE 251A,A00,103654,Rao; Bhaskar D.,0,0,0,0
1667944799266,ECE 257B,A00,103655,Bharadia; Dinesh,0,0,0,0
1667944799693,ECE 258A,A00,103656,Milstein; Laurence B.,0,0,0,0
1667944800127,ECE 260B,A00,103658,Kang; Mingu,0,0,0,0
1667944800685,ECE 264A,A00,103659,Galton; Ian A,0,0,0,0
1667944801113,ECE 265A,A00,103661,Gudem; Prasad S.S.,0,0,0,0
1667944801551,ECE 265D,A00,103662,Gudem; Prasad S.S.,0,0,0,0
1667944802010,ECE 268,A00,103663,Koushanfar; Farinaz,0,0,0,0
1667944802436,ECE 269,A01,103665,Pal; Piya,0,0,0,0
1667944802869,ECE 271B,A00,103666,Vasconcelos; Manuela,0,0,0,0
1667944803331,ECE 276A,A00,103667,Atanasov; Nikolay A.,0,0,0,0
1667944803767,ECE 277,A00,103668,An; Cheolhong,0,0,0,0
1667944804205,ECE 279,A00,117947,Hall; Drew A.,0,0,0,0
1667944805053,ECE 283,A00,103670,Hsueh; Tzu-Chien,0,0,0,0
1667944805506,ECE 284,A00,103671,Turakhia; Yatish Girish,0,0,0,0
1667944805948,ECE 285,A00,103672,Zheng; Yang,0,0,0,0
1667944805948,ECE 285,B00,103673,Sworder; David D.,0,0,0,0
1667944806371,ECE 287,A00,103676,Javidi; Tara,0,0,0,0
1667944806803,MATH 200B,A00,098023,Salehi Golsefidy; Alireza,14,0,15,1
1667944807345,MATH 202B,A00,098024,Rhoades; Brendon Patrick,13,0,15,2
1667944807776,MATH 203B,A00,098025,Oprea; Dragos N.,14,0,15,1
1667944808211,MATH 204B,A00,098026,Sorensen; Claus M,15,0,15,0
1667944808656,MATH 208,A00,098027,Izadi; Elham,7,0,10,3
1667944809082,MATH 209,A00,098028,Pollack; Aaron,10,0,10,0
1667944809506,MATH 211A,A00,112919,Rogalski; Daniel,10,0,10,0
1667944809942,MATH 211B,A00,112920,Seward; Brandon M.,10,0,10,0
1667944810371,MATH 218,A00,098029,Li; Bo,10,0,10,0
1667944810807,MATH 220B,A00,098030,Novak; Jonathan I,14,0,15,1
1667944811232,MATH 221A,A00,098031,Ebenfelt; Peter F,14,0,15,1
1667944811668,MATH 231B,A00,098032,Zlatos; Andrej,13,0,15,2
1667944812102,MATH 240B,A00,098033,Ni; Lei,11,0,15,4
1667944812526,MATH 243,A00,098034,Jekel; David Andrew,10,0,10,0
1667944812952,MATH 245A,A00,098035,Nie; Jiawang,4,0,15,11
1667944813380,MATH 248,A00,098036,Bejenaru; Ioan,10,0,10,0
1667944813806,MATH 250B,A00,098037,Spolaor; Luca,14,0,15,1
1667944814233,MATH 258,A00,098038,Ni; Lei,10,0,10,0
1667944814669,MATH 264B,A00,098041,Rhoades; Brendon Patrick,13,0,15,2
1667944815115,MATH 268,A00,098042,Buss; Samuel R,10,0,10,0
1667944815611,MATH 269,A00,098043,Rhoades; Brendon Patrick,10,0,10,0
1667944816042,MATH 270B,A00,098044,Li; Bo,11,0,15,4
1667944816472,MATH 272B,A00,098045,Holst; Michael J,13,0,15,2
1667944816897,MATH 273A,A00,098046,Tian; Xiaochuan,12,0,15,3
1667944817349,MATH 275,A01,098048,Tian; Xiaochuan,6,0,10,4
1667944817776,MATH 278A,A00,098049,Holst; Michael J,8,0,10,2
1667944818211,MATH 278B,A00,098050,Cloninger; Alexander,10,0,10,0
1667944818643,MATH 278C,A00,098051,Nie; Jiawang,7,0,10,3
1667944819082,MATH 280B,A00,098052,Zheng; Tianyi,12,0,15,3
1667944819506,MATH 281B,A00,098053,Bradic; Jelena,4,0,15,11
1667944819944,MATH 282B,A00,098054,Arias-Castro; Ery,2,0,15,13
1667944820391,MATH 285,A00,098055,Fitzsimmons; Patrick J,0,0,15,15
1667944820814,MATH 287B,A00,098056,Arias-Castro; Ery,8,0,15,7
1667944821241,MATH 288,A00,098057,Agarwal; Pooja,9,0,10,1
1667944821241,MATH 288,B00,098058,Zhang; Danna,9,0,10,1
1667944821241,MATH 288,C00,098059,Williams; Ruth J,10,0,10,0
1667944821682,MATH 290B,A00,098060,Roberts; Justin Deritter,14,0,15,1
1667944822105,MATH 292,A00,098061,Belmont; Eva Kinoshita,10,0,10,0
1667944822534,MATH 295,A00,098062,Suk; Andrew Hoon,48,0,50,2
1667944822964,MATH 296,A00,098063,Novak; Jonathan I,20,0,20,0
1667944823398,MATH 297,001,098064,Gamst; Anthony Collins,9997,0,9999,2
1667945330819,COGS 205,A00,101395,Chiba; Andrea,19,0,20,1
1667945331248,COGS 210B,001,101404,Greene; Deanna Jacquelyn,9998,0,9999,1
1667945331248,COGS 210B,002,101417,Xia; Haijun,9999,0,9999,0
1667945331248,COGS 210B,003,101422,Nitz; Douglas A.,9999,0,9999,0
1667945331248,COGS 210B,004,101423,Hollan; James D.,9998,0,9999,1
1667945331248,COGS 210B,005,101424,Deak; Gedeon O.,9999,0,9999,0
1667945331248,COGS 210B,006,101425,Rossano; Federico,9999,0,9999,0
1667945331682,COGS 211B,A00,101427,Coulson; Seana M,9997,0,9999,2
1667945332112,COGS 220,A00,101428,Hollan; James D.,0,0,25,25
1667945332551,COGS 229,A00,101429,Dow; Steven P,18,0,25,7
1667945332998,COGS 230,A00,101430,Klemmer; Scott R,13,0,17,4
1667945333426,COGS 234,A00,101431,Xia; Haijun,10,0,25,15
1667945333860,COGS 260,A00,101432,Kiyonaga; Anastasia,20,0,25,5
1667945333860,COGS 260,B00,101433,Kirsh; David Joel,17,0,25,8
1667945334435,CSE 202,A00,102371,Impagliazzo; Russell,0,0,0,0
1667945334857,CSE 203B,A01,102373,Cheng; Chung Kuan,0,0,0,0
1667945335395,CSE 208,A00,102374,Micciancio; Daniele,0,0,0,0
1667945335827,CSE 209A,A00,112895,Impagliazzo; Russell,0,0,15,15
1667945336265,CSE 209B,A00,108005,Bellare; Mihir,0,0,0,0
1667945336693,CSE 210,A00,113163,Coblenz; Michael J,0,0,0,0
1667945337128,CSE 219,A00,106111,Dow; Steven P,0,0,20,20
1667945337561,CSE 221,A00,102376,Voelker; Geoffrey M.,0,0,0,0
1667945337988,CSE 224,A01,102378,Porter; George M,0,0,0,0
1667945338413,CSE 229A,A00,102379,Savage; Stefan,0,0,0,0
1667945338834,CSE 229C,A00,102380,Munyaka; Imani N. S.,0,0,0,0
1667945339258,CSE 232B,A00,102382,Deutsch; Alin Bernard,0,0,0,0
1667945339685,CSE 234,A01,112904,Kumar; Arun Kumar,0,0,0,0
1667945340118,CSE 237A,A00,102383,Rosing; Tajana Simunic,0,0,0,0
1667945340551,CSE 239A,A00,102384,Deutsch; Alin Bernard,0,0,0,0
1667945340983,CSE 239B,A00,102385,Polikarpova; Nadezhda,0,0,0,0
1667945341411,CSE 240A,A00,102386,Pannuto; Patrick William,0,0,0,0
1667945341848,CSE 240B,A00,102387,Zhao; Jishen,0,0,0,0
1667945342278,CSE 241A,A00,106406,Kang; Mingu,0,0,0,0
1667945342702,CSE 249B,A00,102388,Kahng; Andrew Byun,0,0,8,8
1667945343149,CSE 251B,A01,102392,Cottrell; Garrison W,0,0,0,0
1667945343149,CSE 251B,A02,102393,Cottrell; Garrison W,0,0,0,0
1667945343581,CSE 252B,A00,102394,Ochoa; Benjamin Lawrence,0,0,0,0
1667945344005,CSE 257,A01,102396,Gao; Sicun,0,0,0,0
1667945344439,CSE 272,A00,102397,Li; Tzumao,0,0,0,0
1667945344869,CSE 274,A00,111323,Chern; Albert Ren-Haur,0,0,0,0
1667945345294,CSE 282,A00,102398,Pevzner; Pavel Arkadjevich,0,0,0,0
1667945345721,CSE 284,A00,114175,Gymrek; Melissa Ann,0,0,0,0
1667945346145,CSE 290,A00,102399,Chandraker; Manmohan Krishna,0,0,0,0
1667945346145,CSE 290,B00,102400,Vaccaro; Kristen Marie,0,0,25,25
1667945346145,CSE 290,C00,102414,Pannuto; Patrick William,0,0,25,25
1667945346145,CSE 290,D00,102427,Pevzner; Pavel Arkadjevich,0,0,0,0
1667945346145,CSE 290,E00,102429,Zhao; Jishen,0,0,0,0
1667945346145,CSE 290,F00,102436,Tullsen; Dean Michael,0,0,0,0
1667945346145,CSE 290,G00,102440,Christensen; Henrik I,0,0,20,20
1667945346574,CSE 291,A00,102443,Su; Hao,0,0,0,0
1667945346574,CSE 291,B00,102448,Polikarpova; Nadezhda,0,0,0,0
1667945346574,CSE 291,C00,102453,Vaccaro; Kristen Marie,0,0,0,0
1667945346574,CSE 291,D00,111343,Savage; Stefan,0,0,0,0
1667945346574,CSE 291,E00,116474,Claffy; Kimberly Claire,0,0,0,0
1667945346574,CSE 291,F00,116479,Pasquale; Joseph,0,0,0,0
1667945347001,CSE 293,001,119111,Bafna; Vineet,9999,0,9999,0
1667945347001,CSE 293,002,119118,Bellare; Mihir,9999,0,9999,0
1667945347001,CSE 293,003,119122,Berg-Kirkpatrick; Taylor D,9999,0,9999,0
1667945347001,CSE 293,004,119135,Christensen; Henrik I,9999,0,9999,0
1667945347001,CSE 293,005,119142,Cottrell; Garrison W,9999,0,9999,0
1667945347001,CSE 293,006,119146,Deutsch; Alin Bernard,9999,0,9999,0
1667945347001,CSE 293,007,119159,Esmaeilzadeh; Hadi,9999,0,9999,0
1667945347001,CSE 293,008,119166,Freund; Yoav,9999,0,9999,0
1667945347001,CSE 293,009,119170,Griswold; William G.,9999,0,9999,0
1667945347001,CSE 293,010,119183,Gymrek; Melissa Ann,9999,0,9999,0
1667945347001,CSE 293,011,119190,Heninger; Nadia A,9999,0,9999,0
1667945347001,CSE 293,012,119230,Impagliazzo; Russell,9999,0,9999,0
1667945347001,CSE 293,013,119232,Jhala; Ranjit,9999,0,9999,0
1667945347001,CSE 293,014,119233,Kahng; Andrew Byun,9999,0,9999,0
1667945347001,CSE 293,015,119298,Kane; Daniel Mertz,9999,0,9999,0
1667945347001,CSE 293,016,119299,Kriegman; David J,9999,0,9999,0
1667945347001,CSE 293,017,119300,Kumar; Arun Kumar,9999,0,9999,0
1667945347001,CSE 293,018,119301,Lerner; Sorin,9999,0,9999,0
1667945347001,CSE 293,019,119302,Lovett; Shachar,9999,0,9999,0
1667945347001,CSE 293,020,119303,McAuley; Julian John,9999,0,9999,0
1667945347001,CSE 293,021,119304,Micciancio; Daniele,9999,0,9999,0
1667945347001,CSE 293,022,119367,Orailoglu; Alex,9999,0,9999,0
1667945347001,CSE 293,023,119382,Paturi; Ramamohan,9999,0,9999,0
1667945347001,CSE 293,024,119404,Polikarpova; Nadezhda,9999,0,9999,0
1667945347001,CSE 293,025,119406,Politz; Joseph Gibbs,9999,0,9999,0
1667945347001,CSE 293,026,119411,Porter; George M,9999,0,9999,0
1667945347001,CSE 293,027,119414,Porter; Leonard Emerson,9999,0,9999,0
1667945347001,CSE 293,028,119416,Ramamoorthi; Ravi,9999,0,9999,0
1667945347001,CSE 293,029,119417,Sahoo; Debashis,9999,0,9999,0
1667945347001,CSE 293,030,119420,Saul; Lawrence,9999,0,9999,0
1667945347001,CSE 293,031,119421,Savage; Stefan,9999,0,9999,0
1667945347001,CSE 293,032,119425,Schulze; Jurgen P.,9999,0,9999,0
1667945347001,CSE 293,033,119426,Snoeren; Alex C.,9999,0,9999,0
1667945347001,CSE 293,034,119428,Shang; Jingbo,9999,0,9999,0
1667945347001,CSE 293,035,119430,Stefan; Deian,9999,0,9999,0
1667945347001,CSE 293,036,119431,Su; Hao,9999,0,9999,0
1667945347001,CSE 293,037,119433,Swanson; Steven James,9999,0,9999,0
1667945347001,CSE 293,038,119435,Tullsen; Dean Michael,9999,0,9999,0
1667945347001,CSE 293,039,119483,Voelker; Geoffrey M.,9999,0,9999,0
1667945347001,CSE 293,040,119537,Zhao; Jishen,9999,0,9999,0
1667945347001,CSE 293,041,119538,Zhou; Yuan-Yuan,9999,0,9999,0
1667945347001,CSE 293,042,119539,Gao; Sicun,9999,0,9999,0
1667945347001,CSE 293,043,119540,Weibel; Nadir,9999,0,9999,0
1667945347001,CSE 293,044,119541,Gupta; Rajesh K.,9999,0,9999,0
1667945347427,CSE 294,A00,102459,Voelker; Geoffrey M.,0,0,0,0
1667945347427,CSE 294,B00,111322,Orailoglu; Alex,0,0,0,0
1667945347867,DSE 201,A00,096914,Deutsch; Alin Bernard,30,0,30,0
1667945348294,DSE 210,A00,096915,Dasgupta; Sanjoy,30,0,30,0
1667945348719,DSE 260A,A00,096916,Altintas De Callaf; Ilkay,30,0,30,0
1667945349149,ECE 200,001,103586,Antipa; Nicholas A,9999,0,9999,0
1667945349149,ECE 200,002,103587,Atanasov; Nikolay A.,9999,0,9999,0
1667945349149,ECE 200,003,103588,Bharadia; Dinesh,9999,0,9999,0
1667945349149,ECE 200,004,103589,Cheng; Chung Kuan,9999,0,9999,0
1667945349149,ECE 200,005,103590,Cosman; Pamela C.,9999,0,9999,0
1667945349149,ECE 200,006,103591,Dayeh; Shadi Ahmad,9999,0,9999,0
1667945349149,ECE 200,007,103592,Fainman; Yeshaiahu,9999,0,9999,0
1667945349149,ECE 200,008,103593,Ford; Joseph Earl,9999,0,9999,0
1667945349149,ECE 200,009,103594,Franceschetti; Massimo,9999,0,9999,0
1667945349149,ECE 200,010,103595,Fullerton; Eric E,9999,0,9999,0
1667945349149,ECE 200,011,103596,Galton; Ian A,9999,0,9999,0
1667945349149,ECE 200,012,103597,Gilja; Vikash,9999,0,9999,0
1667945349149,ECE 200,013,103598,Hall; Drew A.,9999,0,9999,0
1667945349149,ECE 200,014,103599,Hsueh; Tzu-Chien,9999,0,9999,0
1667945349149,ECE 200,015,103600,Javidi; Tara,9999,0,9999,0
1667945349149,ECE 200,016,103601,Kahng; Andrew Byun,9999,0,9999,0
1667945349149,ECE 200,017,103602,Kim; Young-Han,9999,0,9999,0
1667945349149,ECE 200,018,103603,Koushanfar; Farinaz,9999,0,9999,0
1667945349149,ECE 200,019,103604,Kuzum; Duygu,9999,0,9999,0
1667945349149,ECE 200,020,103605,Le; Hanh-Phuc,9999,0,9999,0
1667945349149,ECE 200,021,103606,Lin; Bill,9999,0,9999,0
1667945349149,ECE 200,022,103607,Liu; Zhaowei,9998,0,9999,1
1667945349149,ECE 200,023,103608,Lo; Yu-Hwa,9999,0,9999,0
1667945349149,ECE 200,024,103609,Lomakin; Vitaliy,9999,0,9999,0
1667945349149,ECE 200,025,103610,Mercier; Patrick Philip,9999,0,9999,0
1667945349149,ECE 200,026,103611,Meyer; Florian,9999,0,9999,0
1667945349149,ECE 200,027,103612,Milstein; Laurence B.,9999,0,9999,0
1667945349149,ECE 200,028,103613,Mir Arabbaygi; Siavash,9999,0,9999,0
1667945349149,ECE 200,029,103614,Mookherjea; Shayan,9999,0,9999,0
1667945349149,ECE 200,030,103615,Morris; Karcher William,9999,0,9999,0
1667945349149,ECE 200,031,103616,Ng; Tse Nga,9999,0,9999,0
1667945349149,ECE 200,032,103617,Nguyen; Truong Quang,9999,0,9999,0
1667945349149,ECE 200,033,103618,Nomura; Kenji,9999,0,9999,0
1667945349149,ECE 200,034,103619,Orlitsky; Alon,9999,0,9999,0
1667945349149,ECE 200,035,103620,Pal; Piya,9999,0,9999,0
1667945349149,ECE 200,036,103621,Papen; George C.,9999,0,9999,0
1667945349149,ECE 200,037,103622,Radic; Stojan,9999,0,9999,0
1667945349149,ECE 200,038,103623,Rao; Bhaskar D.,9999,0,9999,0
1667945349149,ECE 200,039,103624,Rao; Ramesh R,9999,0,9999,0
1667945349149,ECE 200,040,103625,Rebeiz; Gabriel,9999,0,9999,0
1667945349149,ECE 200,041,103626,Sanford; John R,9999,0,9999,0
1667945349149,ECE 200,042,103627,Siegel; Paul H.,9999,0,9999,0
1667945349149,ECE 200,043,103628,Sievenpiper; Daniel F.,9999,0,9999,0
1667945349149,ECE 200,044,103629,Sworder; David D.,9999,0,9999,0
1667945349149,ECE 200,045,103630,Taur; Yuan,9999,0,9999,0
1667945349149,ECE 200,046,103631,Touri; Behrouz,9999,0,9999,0
1667945349149,ECE 200,047,103632,Trivedi; Mohan M.,9999,0,9999,0
1667945349149,ECE 200,048,103633,Vasconcelos; Nuno,9999,0,9999,0
1667945349149,ECE 200,049,103634,Wang; Xiaolong,9999,0,9999,0
1667945349149,ECE 200,050,103635,Xie; Pengtao,9999,0,9999,0
1667945349149,ECE 200,051,103636,Yip; Michael,9999,0,9999,0
1667945349149,ECE 200,052,103637,Zeger; Kenneth A.,999,0,999,0
1667945349149,ECE 200,053,103638,Zhang; Xinyu,9999,0,9999,0
1667945349149,ECE 200,054,103639,Turakhia; Yatish Girish,9999,0,9999,0
1667945349149,ECE 200,055,103640,Kang; Mingu,9999,0,9999,0
1667945349149,ECE 200,056,103641,Shi; Yuanyuan,9999,0,9999,0
1667945349149,ECE 200,057,103642,Wang; Edward Jay,9999,0,9999,0
1667945349149,ECE 200,058,103643,Zheng; Yang,9999,0,9999,0
1667945349580,ECE 202,A00,103644,Kuzum; Duygu,0,0,0,0
1667945350005,ECE 212BN,A00,103646,Ng; Tse Nga,0,0,0,0
1667945350432,ECE 221,A00,111493,Staff,0,0,0,0
1667945350860,ECE 222B,A00,103647,Lomakin; Vitaliy,0,0,0,0
1667945351293,ECE 230B,A00,103648,Taur; Yuan,0,0,0,0
1667945351779,ECE 238B,A00,103649,Garay; Javier,0,0,0,0
1667945352209,ECE 240B,A00,112900,Fainman; Yeshaiahu,0,0,0,0
1667945352636,ECE 247A,A00,103650,Jokerst; Jesse Vincent,0,0,0,0
1667945353073,ECE 247B,A00,103651,Wang; Joseph,0,0,0,0
1667945353499,ECE 250,A00,103652,Siegel; Paul H.,0,0,0,0
1667945353931,ECE 251A,A00,103654,Rao; Bhaskar D.,0,0,0,0
1667945354365,ECE 257B,A00,103655,Bharadia; Dinesh,0,0,0,0
1667945354793,ECE 258A,A00,103656,Milstein; Laurence B.,0,0,0,0
1667945355217,ECE 260B,A00,103658,Kang; Mingu,0,0,0,0
1667945355641,ECE 264A,A00,103659,Galton; Ian A,0,0,0,0
1667945356089,ECE 265A,A00,103661,Gudem; Prasad S.S.,0,0,0,0
1667945356529,ECE 265D,A00,103662,Gudem; Prasad S.S.,0,0,0,0
1667945356957,ECE 268,A00,103663,Koushanfar; Farinaz,0,0,0,0
1667945357381,ECE 269,A01,103665,Pal; Piya,0,0,0,0
1667945357806,ECE 271B,A00,103666,Vasconcelos; Manuela,0,0,0,0
1667945358227,ECE 276A,A00,103667,Atanasov; Nikolay A.,0,0,0,0
1667945358654,ECE 277,A00,103668,An; Cheolhong,0,0,0,0
1667945359078,ECE 279,A00,117947,Hall; Drew A.,0,0,0,0
1667945359929,ECE 283,A00,103670,Hsueh; Tzu-Chien,0,0,0,0
1667945360359,ECE 284,A00,103671,Turakhia; Yatish Girish,0,0,0,0
1667945360787,ECE 285,A00,103672,Zheng; Yang,0,0,0,0
1667945360787,ECE 285,B00,103673,Sworder; David D.,0,0,0,0
1667945361224,ECE 287,A00,103676,Javidi; Tara,0,0,0,0
1667945361661,MATH 200B,A00,098023,Salehi Golsefidy; Alireza,14,0,15,1
1667945362088,MATH 202B,A00,098024,Rhoades; Brendon Patrick,13,0,15,2
1667945362512,MATH 203B,A00,098025,Oprea; Dragos N.,14,0,15,1
1667945362935,MATH 204B,A00,098026,Sorensen; Claus M,15,0,15,0
1667945363358,MATH 208,A00,098027,Izadi; Elham,7,0,10,3
1667945363818,MATH 209,A00,098028,Pollack; Aaron,10,0,10,0
1667945364253,MATH 211A,A00,112919,Rogalski; Daniel,10,0,10,0
1667945364682,MATH 211B,A00,112920,Seward; Brandon M.,10,0,10,0
1667945365104,MATH 218,A00,098029,Li; Bo,10,0,10,0
1667945365535,MATH 220B,A00,098030,Novak; Jonathan I,14,0,15,1
1667945365963,MATH 221A,A00,098031,Ebenfelt; Peter F,14,0,15,1
1667945366392,MATH 231B,A00,098032,Zlatos; Andrej,13,0,15,2
1667945366814,MATH 240B,A00,098033,Ni; Lei,11,0,15,4
1667945367236,MATH 243,A00,098034,Jekel; David Andrew,10,0,10,0
1667945367665,MATH 245A,A00,098035,Nie; Jiawang,4,0,15,11
1667945368104,MATH 248,A00,098036,Bejenaru; Ioan,10,0,10,0
1667945368535,MATH 250B,A00,098037,Spolaor; Luca,14,0,15,1
1667945368960,MATH 258,A00,098038,Ni; Lei,10,0,10,0
1667945369403,MATH 264B,A00,098041,Rhoades; Brendon Patrick,13,0,15,2
1667945369838,MATH 268,A00,098042,Buss; Samuel R,10,0,10,0
1667945370269,MATH 269,A00,098043,Rhoades; Brendon Patrick,10,0,10,0
1667945370695,MATH 270B,A00,098044,Li; Bo,11,0,15,4
1667945371130,MATH 272B,A00,098045,Holst; Michael J,13,0,15,2
1667945371553,MATH 273A,A00,098046,Tian; Xiaochuan,12,0,15,3
1667945371988,MATH 275,A01,098048,Tian; Xiaochuan,6,0,10,4
1667945372414,MATH 278A,A00,098049,Holst; Michael J,8,0,10,2
1667945372851,MATH 278B,A00,098050,Cloninger; Alexander,10,0,10,0
1667945373282,MATH 278C,A00,098051,Nie; Jiawang,7,0,10,3
1667945373705,MATH 280B,A00,098052,Zheng; Tianyi,12,0,15,3
1667945374131,MATH 281B,A00,098053,Bradic; Jelena,4,0,15,11
1667945374574,MATH 282B,A00,098054,Arias-Castro; Ery,2,0,15,13
1667945375003,MATH 285,A00,098055,Fitzsimmons; Patrick J,0,0,15,15
1667945375425,MATH 287B,A00,098056,Arias-Castro; Ery,8,0,15,7
1667945375861,MATH 288,A00,098057,Agarwal; Pooja,9,0,10,1
1667945375861,MATH 288,B00,098058,Zhang; Danna,9,0,10,1
1667945375861,MATH 288,C00,098059,Williams; Ruth J,10,0,10,0
1667945376287,MATH 290B,A00,098060,Roberts; Justin Deritter,14,0,15,1
1667945376715,MATH 292,A00,098061,Belmont; Eva Kinoshita,10,0,10,0
1667945377139,MATH 295,A00,098062,Suk; Andrew Hoon,48,0,50,2
1667945377565,MATH 296,A00,098063,Novak; Jonathan I,20,0,20,0
1667945377997,MATH 297,001,098064,Gamst; Anthony Collins,9997,0,9999,2
1667945895093,COGS 205,A00,101395,Chiba; Andrea,19,0,20,1
1667945895530,COGS 210B,001,101404,Greene; Deanna Jacquelyn,9998,0,9999,1
1667945895530,COGS 210B,002,101417,Xia; Haijun,9999,0,9999,0
1667945895530,COGS 210B,003,101422,Nitz; Douglas A.,9999,0,9999,0
1667945895530,COGS 210B,004,101423,Hollan; James D.,9998,0,9999,1
1667945895530,COGS 210B,005,101424,Deak; Gedeon O.,9999,0,9999,0
1667945895530,COGS 210B,006,101425,Rossano; Federico,9999,0,9999,0
1667945895957,COGS 211B,A00,101427,Coulson; Seana M,9997,0,9999,2
1667945896383,COGS 220,A00,101428,Hollan; James D.,0,0,25,25
1667945896820,COGS 229,A00,101429,Dow; Steven P,18,0,25,7
1667945897257,COGS 230,A00,101430,Klemmer; Scott R,13,0,17,4
1667945897688,COGS 234,A00,101431,Xia; Haijun,9,0,25,16
1667945898118,COGS 260,A00,101432,Kiyonaga; Anastasia,20,0,25,5
1667945898118,COGS 260,B00,101433,Kirsh; David Joel,17,0,25,8
1667945898556,CSE 202,A00,102371,Impagliazzo; Russell,0,0,0,0
1667945898987,CSE 203B,A01,102373,Cheng; Chung Kuan,0,0,0,0
1667945899423,CSE 208,A00,102374,Micciancio; Daniele,0,0,0,0
1667945899861,CSE 209A,A00,112895,Impagliazzo; Russell,0,0,15,15
1667945900290,CSE 209B,A00,108005,Bellare; Mihir,0,0,0,0
1667945900723,CSE 210,A00,113163,Coblenz; Michael J,0,0,0,0
1667945901152,CSE 219,A00,106111,Dow; Steven P,0,0,20,20
1667945901586,CSE 221,A00,102376,Voelker; Geoffrey M.,0,0,0,0
1667945902012,CSE 224,A01,102378,Porter; George M,0,0,0,0
1667945902441,CSE 229A,A00,102379,Savage; Stefan,0,0,0,0
1667945902867,CSE 229C,A00,102380,Munyaka; Imani N. S.,0,0,0,0
1667945903302,CSE 232B,A00,102382,Deutsch; Alin Bernard,0,0,0,0
1667945903726,CSE 234,A01,112904,Kumar; Arun Kumar,0,0,0,0
1667945904158,CSE 237A,A00,102383,Rosing; Tajana Simunic,0,0,0,0
1667945904591,CSE 239A,A00,102384,Deutsch; Alin Bernard,0,0,0,0
1667945905013,CSE 239B,A00,102385,Polikarpova; Nadezhda,0,0,0,0
1667945905445,CSE 240A,A00,102386,Pannuto; Patrick William,0,0,0,0
1667945905875,CSE 240B,A00,102387,Zhao; Jishen,0,0,0,0
1667945906315,CSE 241A,A00,106406,Kang; Mingu,0,0,0,0
1667945906740,CSE 249B,A00,102388,Kahng; Andrew Byun,0,0,8,8
1667945907172,CSE 251B,A01,102392,Cottrell; Garrison W,0,0,0,0
1667945907172,CSE 251B,A02,102393,Cottrell; Garrison W,0,0,0,0
1667945907594,CSE 252B,A00,102394,Ochoa; Benjamin Lawrence,0,0,0,0
1667945908021,CSE 257,A01,102396,Gao; Sicun,0,0,0,0
1667945908456,CSE 272,A00,102397,Li; Tzumao,0,0,0,0
1667945908889,CSE 274,A00,111323,Chern; Albert Ren-Haur,0,0,0,0
1667945909319,CSE 282,A00,102398,Pevzner; Pavel Arkadjevich,0,0,0,0
1667945909745,CSE 284,A00,114175,Gymrek; Melissa Ann,0,0,0,0
1667945910170,CSE 290,A00,102399,Chandraker; Manmohan Krishna,0,0,0,0
1667945910170,CSE 290,B00,102400,Vaccaro; Kristen Marie,0,0,25,25
1667945910170,CSE 290,C00,102414,Pannuto; Patrick William,0,0,25,25
1667945910170,CSE 290,D00,102427,Pevzner; Pavel Arkadjevich,0,0,0,0
1667945910170,CSE 290,E00,102429,Zhao; Jishen,0,0,0,0
1667945910170,CSE 290,F00,102436,Tullsen; Dean Michael,0,0,0,0
1667945910170,CSE 290,G00,102440,Christensen; Henrik I,0,0,20,20
1667945910598,CSE 291,A00,102443,Su; Hao,0,0,0,0
1667945910598,CSE 291,B00,102448,Polikarpova; Nadezhda,0,0,0,0
1667945910598,CSE 291,C00,102453,Vaccaro; Kristen Marie,0,0,0,0
1667945910598,CSE 291,D00,111343,Savage; Stefan,0,0,0,0
1667945910598,CSE 291,E00,116474,Claffy; Kimberly Claire,0,0,0,0
1667945910598,CSE 291,F00,116479,Pasquale; Joseph,0,0,0,0
1667945911036,CSE 293,001,119111,Bafna; Vineet,9999,0,9999,0
1667945911036,CSE 293,002,119118,Bellare; Mihir,9999,0,9999,0
1667945911036,CSE 293,003,119122,Berg-Kirkpatrick; Taylor D,9999,0,9999,0
1667945911036,CSE 293,004,119135,Christensen; Henrik I,9999,0,9999,0
1667945911036,CSE 293,005,119142,Cottrell; Garrison W,9999,0,9999,0
1667945911036,CSE 293,006,119146,Deutsch; Alin Bernard,9999,0,9999,0
1667945911036,CSE 293,007,119159,Esmaeilzadeh; Hadi,9999,0,9999,0
1667945911036,CSE 293,008,119166,Freund; Yoav,9999,0,9999,0
1667945911036,CSE 293,009,119170,Griswold; William G.,9999,0,9999,0
1667945911036,CSE 293,010,119183,Gymrek; Melissa Ann,9999,0,9999,0
1667945911036,CSE 293,011,119190,Heninger; Nadia A,9999,0,9999,0
1667945911036,CSE 293,012,119230,Impagliazzo; Russell,9999,0,9999,0
1667945911036,CSE 293,013,119232,Jhala; Ranjit,9999,0,9999,0
1667945911036,CSE 293,014,119233,Kahng; Andrew Byun,9999,0,9999,0
1667945911036,CSE 293,015,119298,Kane; Daniel Mertz,9999,0,9999,0
1667945911036,CSE 293,016,119299,Kriegman; David J,9999,0,9999,0
1667945911036,CSE 293,017,119300,Kumar; Arun Kumar,9999,0,9999,0
1667945911036,CSE 293,018,119301,Lerner; Sorin,9999,0,9999,0
1667945911036,CSE 293,019,119302,Lovett; Shachar,9999,0,9999,0
1667945911036,CSE 293,020,119303,McAuley; Julian John,9999,0,9999,0
1667945911036,CSE 293,021,119304,Micciancio; Daniele,9999,0,9999,0
1667945911036,CSE 293,022,119367,Orailoglu; Alex,9999,0,9999,0
1667945911036,CSE 293,023,119382,Paturi; Ramamohan,9999,0,9999,0
1667945911036,CSE 293,024,119404,Polikarpova; Nadezhda,9999,0,9999,0
1667945911036,CSE 293,025,119406,Politz; Joseph Gibbs,9999,0,9999,0
1667945911036,CSE 293,026,119411,Porter; George M,9999,0,9999,0
1667945911036,CSE 293,027,119414,Porter; Leonard Emerson,9999,0,9999,0
1667945911036,CSE 293,028,119416,Ramamoorthi; Ravi,9999,0,9999,0
1667945911036,CSE 293,029,119417,Sahoo; Debashis,9999,0,9999,0
1667945911036,CSE 293,030,119420,Saul; Lawrence,9999,0,9999,0
1667945911036,CSE 293,031,119421,Savage; Stefan,9999,0,9999,0
1667945911036,CSE 293,032,119425,Schulze; Jurgen P.,9999,0,9999,0
1667945911036,CSE 293,033,119426,Snoeren; Alex C.,9999,0,9999,0
1667945911036,CSE 293,034,119428,Shang; Jingbo,9999,0,9999,0
1667945911036,CSE 293,035,119430,Stefan; Deian,9999,0,9999,0
1667945911036,CSE 293,036,119431,Su; Hao,9999,0,9999,0
1667945911036,CSE 293,037,119433,Swanson; Steven James,9999,0,9999,0
1667945911036,CSE 293,038,119435,Tullsen; Dean Michael,9999,0,9999,0
1667945911036,CSE 293,039,119483,Voelker; Geoffrey M.,9999,0,9999,0
1667945911036,CSE 293,040,119537,Zhao; Jishen,9999,0,9999,0
1667945911036,CSE 293,041,119538,Zhou; Yuan-Yuan,9999,0,9999,0
1667945911036,CSE 293,042,119539,Gao; Sicun,9999,0,9999,0
1667945911036,CSE 293,043,119540,Weibel; Nadir,9999,0,9999,0
1667945911036,CSE 293,044,119541,Gupta; Rajesh K.,9999,0,9999,0
1667945911468,CSE 294,A00,102459,Voelker; Geoffrey M.,0,0,0,0
1667945911468,CSE 294,B00,111322,Orailoglu; Alex,0,0,0,0
1667945911890,DSE 201,A00,096914,Deutsch; Alin Bernard,30,0,30,0
1667945912316,DSE 210,A00,096915,Dasgupta; Sanjoy,30,0,30,0
1667945912741,DSE 260A,A00,096916,Altintas De Callaf; Ilkay,30,0,30,0
1667945913229,ECE 200,001,103586,Antipa; Nicholas A,9999,0,9999,0
1667945913229,ECE 200,002,103587,Atanasov; Nikolay A.,9999,0,9999,0
1667945913229,ECE 200,003,103588,Bharadia; Dinesh,9999,0,9999,0
1667945913229,ECE 200,004,103589,Cheng; Chung Kuan,9999,0,9999,0
1667945913229,ECE 200,005,103590,Cosman; Pamela C.,9999,0,9999,0
1667945913229,ECE 200,006,103591,Dayeh; Shadi Ahmad,9999,0,9999,0
1667945913229,ECE 200,007,103592,Fainman; Yeshaiahu,9999,0,9999,0
1667945913229,ECE 200,008,103593,Ford; Joseph Earl,9999,0,9999,0
1667945913229,ECE 200,009,103594,Franceschetti; Massimo,9999,0,9999,0
1667945913229,ECE 200,010,103595,Fullerton; Eric E,9999,0,9999,0
1667945913229,ECE 200,011,103596,Galton; Ian A,9999,0,9999,0
1667945913229,ECE 200,012,103597,Gilja; Vikash,9999,0,9999,0
1667945913229,ECE 200,013,103598,Hall; Drew A.,9999,0,9999,0
1667945913229,ECE 200,014,103599,Hsueh; Tzu-Chien,9999,0,9999,0
1667945913229,ECE 200,015,103600,Javidi; Tara,9999,0,9999,0
1667945913229,ECE 200,016,103601,Kahng; Andrew Byun,9999,0,9999,0
1667945913229,ECE 200,017,103602,Kim; Young-Han,9999,0,9999,0
1667945913229,ECE 200,018,103603,Koushanfar; Farinaz,9999,0,9999,0
1667945913229,ECE 200,019,103604,Kuzum; Duygu,9999,0,9999,0
1667945913229,ECE 200,020,103605,Le; Hanh-Phuc,9999,0,9999,0
1667945913229,ECE 200,021,103606,Lin; Bill,9999,0,9999,0
1667945913229,ECE 200,022,103607,Liu; Zhaowei,9998,0,9999,1
1667945913229,ECE 200,023,103608,Lo; Yu-Hwa,9999,0,9999,0
1667945913229,ECE 200,024,103609,Lomakin; Vitaliy,9999,0,9999,0
1667945913229,ECE 200,025,103610,Mercier; Patrick Philip,9999,0,9999,0
1667945913229,ECE 200,026,103611,Meyer; Florian,9999,0,9999,0
1667945913229,ECE 200,027,103612,Milstein; Laurence B.,9999,0,9999,0
1667945913229,ECE 200,028,103613,Mir Arabbaygi; Siavash,9999,0,9999,0
1667945913229,ECE 200,029,103614,Mookherjea; Shayan,9999,0,9999,0
1667945913229,ECE 200,030,103615,Morris; Karcher William,9999,0,9999,0
1667945913229,ECE 200,031,103616,Ng; Tse Nga,9999,0,9999,0
1667945913229,ECE 200,032,103617,Nguyen; Truong Quang,9999,0,9999,0
1667945913229,ECE 200,033,103618,Nomura; Kenji,9999,0,9999,0
1667945913229,ECE 200,034,103619,Orlitsky; Alon,9999,0,9999,0
1667945913229,ECE 200,035,103620,Pal; Piya,9999,0,9999,0
1667945913229,ECE 200,036,103621,Papen; George C.,9999,0,9999,0
1667945913229,ECE 200,037,103622,Radic; Stojan,9999,0,9999,0
1667945913229,ECE 200,038,103623,Rao; Bhaskar D.,9999,0,9999,0
1667945913229,ECE 200,039,103624,Rao; Ramesh R,9999,0,9999,0
1667945913229,ECE 200,040,103625,Rebeiz; Gabriel,9999,0,9999,0
1667945913229,ECE 200,041,103626,Sanford; John R,9999,0,9999,0
1667945913229,ECE 200,042,103627,Siegel; Paul H.,9999,0,9999,0
1667945913229,ECE 200,043,103628,Sievenpiper; Daniel F.,9999,0,9999,0
1667945913229,ECE 200,044,103629,Sworder; David D.,9999,0,9999,0
1667945913229,ECE 200,045,103630,Taur; Yuan,9999,0,9999,0
1667945913229,ECE 200,046,103631,Touri; Behrouz,9999,0,9999,0
1667945913229,ECE 200,047,103632,Trivedi; Mohan M.,9999,0,9999,0
1667945913229,ECE 200,048,103633,Vasconcelos; Nuno,9999,0,9999,0
1667945913229,ECE 200,049,103634,Wang; Xiaolong,9999,0,9999,0
1667945913229,ECE 200,050,103635,Xie; Pengtao,9999,0,9999,0
1667945913229,ECE 200,051,103636,Yip; Michael,9999,0,9999,0
1667945913229,ECE 200,052,103637,Zeger; Kenneth A.,999,0,999,0
1667945913229,ECE 200,053,103638,Zhang; Xinyu,9999,0,9999,0
1667945913229,ECE 200,054,103639,Turakhia; Yatish Girish,9999,0,9999,0
1667945913229,ECE 200,055,103640,Kang; Mingu,9999,0,9999,0
1667945913229,ECE 200,056,103641,Shi; Yuanyuan,9999,0,9999,0
1667945913229,ECE 200,057,103642,Wang; Edward Jay,9999,0,9999,0
1667945913229,ECE 200,058,103643,Zheng; Yang,9999,0,9999,0
1667945913651,ECE 202,A00,103644,Kuzum; Duygu,0,0,0,0
1667945914074,ECE 212BN,A00,103646,Ng; Tse Nga,0,0,0,0
1667945914499,ECE 221,A00,111493,Staff,0,0,0,0
1667945914924,ECE 222B,A00,103647,Lomakin; Vitaliy,0,0,0,0
1667945915351,ECE 230B,A00,103648,Taur; Yuan,0,0,0,0
1667945915789,ECE 238B,A00,103649,Garay; Javier,0,0,0,0
1667945916296,ECE 240B,A00,112900,Fainman; Yeshaiahu,0,0,0,0
1667945916725,ECE 247A,A00,103650,Jokerst; Jesse Vincent,0,0,0,0
1667945917159,ECE 247B,A00,103651,Wang; Joseph,0,0,0,0
1667945917588,ECE 250,A00,103652,Siegel; Paul H.,0,0,0,0
1667945918013,ECE 251A,A00,103654,Rao; Bhaskar D.,0,0,0,0
1667945918443,ECE 257B,A00,103655,Bharadia; Dinesh,0,0,0,0
1667945918879,ECE 258A,A00,103656,Milstein; Laurence B.,0,0,0,0
1667945919306,ECE 260B,A00,103658,Kang; Mingu,0,0,0,0
1667945919734,ECE 264A,A00,103659,Galton; Ian A,0,0,0,0
1667945920161,ECE 265A,A00,103661,Gudem; Prasad S.S.,0,0,0,0
1667945920587,ECE 265D,A00,103662,Gudem; Prasad S.S.,0,0,0,0
1667945921010,ECE 268,A00,103663,Koushanfar; Farinaz,0,0,0,0
1667945921447,ECE 269,A01,103665,Pal; Piya,0,0,0,0
1667945921873,ECE 271B,A00,103666,Vasconcelos; Manuela,0,0,0,0
1667945922307,ECE 276A,A00,103667,Atanasov; Nikolay A.,0,0,0,0
1667945922744,ECE 277,A00,103668,An; Cheolhong,0,0,0,0
1667945923172,ECE 279,A00,117947,Hall; Drew A.,0,0,0,0
1667945924026,ECE 283,A00,103670,Hsueh; Tzu-Chien,0,0,0,0
1667945924460,ECE 284,A00,103671,Turakhia; Yatish Girish,0,0,0,0
1667945924887,ECE 285,A00,103672,Zheng; Yang,0,0,0,0
1667945924887,ECE 285,B00,103673,Sworder; David D.,0,0,0,0
1667945925309,ECE 287,A00,103676,Javidi; Tara,0,0,0,0
1667945925733,MATH 200B,A00,098023,Salehi Golsefidy; Alireza,14,0,15,1
1667945926160,MATH 202B,A00,098024,Rhoades; Brendon Patrick,13,0,15,2
1667945926589,MATH 203B,A00,098025,Oprea; Dragos N.,14,0,15,1
1667945927013,MATH 204B,A00,098026,Sorensen; Claus M,15,0,15,0
1667945927443,MATH 208,A00,098027,Izadi; Elham,7,0,10,3
1667945927870,MATH 209,A00,098028,Pollack; Aaron,10,0,10,0
1667945928301,MATH 211A,A00,112919,Rogalski; Daniel,10,0,10,0
1667945928726,MATH 211B,A00,112920,Seward; Brandon M.,10,0,10,0
1667945929158,MATH 218,A00,098029,Li; Bo,10,0,10,0
1667945929588,MATH 220B,A00,098030,Novak; Jonathan I,14,0,15,1
1667945930018,MATH 221A,A00,098031,Ebenfelt; Peter F,14,0,15,1
1667945930444,MATH 231B,A00,098032,Zlatos; Andrej,13,0,15,2
1667945930873,MATH 240B,A00,098033,Ni; Lei,11,0,15,4
1667945931301,MATH 243,A00,098034,Jekel; David Andrew,10,0,10,0
1667945931731,MATH 245A,A00,098035,Nie; Jiawang,4,0,15,11
1667945932157,MATH 248,A00,098036,Bejenaru; Ioan,10,0,10,0
1667945932581,MATH 250B,A00,098037,Spolaor; Luca,14,0,15,1
1667945933013,MATH 258,A00,098038,Ni; Lei,10,0,10,0
1667945933442,MATH 264B,A00,098041,Rhoades; Brendon Patrick,13,0,15,2
1667945933869,MATH 268,A00,098042,Buss; Samuel R,10,0,10,0
1667945934307,MATH 269,A00,098043,Rhoades; Brendon Patrick,10,0,10,0
1667945934735,MATH 270B,A00,098044,Li; Bo,11,0,15,4
1667945935158,MATH 272B,A00,098045,Holst; Michael J,13,0,15,2
1667945935586,MATH 273A,A00,098046,Tian; Xiaochuan,12,0,15,3
1667945936014,MATH 275,A01,098048,Tian; Xiaochuan,6,0,10,4
1667945936438,MATH 278A,A00,098049,Holst; Michael J,8,0,10,2
1667945936865,MATH 278B,A00,098050,Cloninger; Alexander,10,0,10,0
1667945937291,MATH 278C,A00,098051,Nie; Jiawang,7,0,10,3
1667945937722,MATH 280B,A00,098052,Zheng; Tianyi,12,0,15,3
1667945938155,MATH 281B,A00,098053,Bradic; Jelena,4,0,15,11
1667945938579,MATH 282B,A00,098054,Arias-Castro; Ery,2,0,15,13
1667945939011,MATH 285,A00,098055,Fitzsimmons; Patrick J,0,0,15,15
1667945939436,MATH 287B,A00,098056,Arias-Castro; Ery,7,0,15,8
1667945939882,MATH 288,A00,098057,Agarwal; Pooja,9,0,10,1
1667945939882,MATH 288,B00,098058,Zhang; Danna,9,0,10,1
1667945939882,MATH 288,C00,098059,Williams; Ruth J,10,0,10,0
1667945940306,MATH 290B,A00,098060,Roberts; Justin Deritter,14,0,15,1
1667945940749,MATH 292,A00,098061,Belmont; Eva Kinoshita,10,0,10,0
1667945941186,MATH 295,A00,098062,Suk; Andrew Hoon,48,0,50,2
1667945941613,MATH 296,A00,098063,Novak; Jonathan I,20,0,20,0
1667945942039,MATH 297,001,098064,Gamst; Anthony Collins,9997,0,9999,2
1667946447518,COGS 205,A00,101395,Chiba; Andrea,19,0,20,1
1667946447953,COGS 210B,001,101404,Greene; Deanna Jacquelyn,9998,0,9999,1
1667946447953,COGS 210B,002,101417,Xia; Haijun,9999,0,9999,0
1667946447953,COGS 210B,003,101422,Nitz; Douglas A.,9999,0,9999,0
1667946447953,COGS 210B,004,101423,Hollan; James D.,9998,0,9999,1
1667946447953,COGS 210B,005,101424,Deak; Gedeon O.,9999,0,9999,0
1667946447953,COGS 210B,006,101425,Rossano; Federico,9999,0,9999,0
1667946448387,COGS 211B,A00,101427,Coulson; Seana M,9997,0,9999,2
1667946448811,COGS 220,A00,101428,Hollan; James D.,0,0,25,25
1667946449235,COGS 229,A00,101429,Dow; Steven P,18,0,25,7
1667946449657,COGS 230,A00,101430,Klemmer; Scott R,13,0,17,4
1667946450087,COGS 234,A00,101431,Xia; Haijun,9,0,25,16
1667946450514,COGS 260,A00,101432,Kiyonaga; Anastasia,20,0,25,5
1667946450514,COGS 260,B00,101433,Kirsh; David Joel,17,0,25,8
1667946450946,CSE 202,A00,102371,Impagliazzo; Russell,0,0,0,0
1667946451370,CSE 203B,A01,102373,Cheng; Chung Kuan,0,0,0,0
1667946451803,CSE 208,A00,102374,Micciancio; Daniele,0,0,0,0
1667946452227,CSE 209A,A00,112895,Impagliazzo; Russell,0,0,15,15
1667946452653,CSE 209B,A00,108005,Bellare; Mihir,0,0,0,0
1667946453078,CSE 210,A00,113163,Coblenz; Michael J,0,0,0,0
1667946453502,CSE 219,A00,106111,Dow; Steven P,0,0,20,20
1667946453926,CSE 221,A00,102376,Voelker; Geoffrey M.,0,0,0,0
1667946454349,CSE 224,A01,102378,Porter; George M,0,0,0,0
1667946454777,CSE 229A,A00,102379,Savage; Stefan,0,0,0,0
1667946455203,CSE 229C,A00,102380,Munyaka; Imani N. S.,0,0,0,0
1667946455640,CSE 232B,A00,102382,Deutsch; Alin Bernard,0,0,0,0
1667946456063,CSE 234,A01,112904,Kumar; Arun Kumar,0,0,0,0
1667946456491,CSE 237A,A00,102383,Rosing; Tajana Simunic,0,0,0,0
1667946456914,CSE 239A,A00,102384,Deutsch; Alin Bernard,0,0,0,0
1667946457339,CSE 239B,A00,102385,Polikarpova; Nadezhda,0,0,0,0
1667946457771,CSE 240A,A00,102386,Pannuto; Patrick William,0,0,0,0
1667946458198,CSE 240B,A00,102387,Zhao; Jishen,0,0,0,0
1667946458621,CSE 241A,A00,106406,Kang; Mingu,0,0,0,0
1667946459054,CSE 249B,A00,102388,Kahng; Andrew Byun,0,0,8,8
1667946459477,CSE 251B,A01,102392,Cottrell; Garrison W,0,0,0,0
1667946459477,CSE 251B,A02,102393,Cottrell; Garrison W,0,0,0,0
1667946459903,CSE 252B,A00,102394,Ochoa; Benjamin Lawrence,0,0,0,0
1667946460342,CSE 257,A01,102396,Gao; Sicun,0,0,0,0
1667946460774,CSE 272,A00,102397,Li; Tzumao,0,0,0,0
1667946461211,CSE 274,A00,111323,Chern; Albert Ren-Haur,0,0,0,0
1667946461635,CSE 282,A00,102398,Pevzner; Pavel Arkadjevich,0,0,0,0
1667946462062,CSE 284,A00,114175,Gymrek; Melissa Ann,0,0,0,0
1667946462495,CSE 290,A00,102399,Chandraker; Manmohan Krishna,0,0,0,0
1667946462495,CSE 290,B00,102400,Vaccaro; Kristen Marie,0,0,25,25
1667946462495,CSE 290,C00,102414,Pannuto; Patrick William,0,0,25,25
1667946462495,CSE 290,D00,102427,Pevzner; Pavel Arkadjevich,0,0,0,0
1667946462495,CSE 290,E00,102429,Zhao; Jishen,0,0,0,0
1667946462495,CSE 290,F00,102436,Tullsen; Dean Michael,0,0,0,0
1667946462495,CSE 290,G00,102440,Christensen; Henrik I,0,0,20,20
1667946462925,CSE 291,A00,102443,Su; Hao,0,0,0,0
1667946462925,CSE 291,B00,102448,Polikarpova; Nadezhda,0,0,0,0
1667946462925,CSE 291,C00,102453,Vaccaro; Kristen Marie,0,0,0,0
1667946462925,CSE 291,D00,111343,Savage; Stefan,0,0,0,0
1667946462925,CSE 291,E00,116474,Claffy; Kimberly Claire,0,0,0,0
1667946462925,CSE 291,F00,116479,Pasquale; Joseph,0,0,0,0
1667946463382,CSE 293,001,119111,Bafna; Vineet,9999,0,9999,0
1667946463382,CSE 293,002,119118,Bellare; Mihir,9999,0,9999,0
1667946463382,CSE 293,003,119122,Berg-Kirkpatrick; Taylor D,9999,0,9999,0
1667946463382,CSE 293,004,119135,Christensen; Henrik I,9999,0,9999,0
1667946463382,CSE 293,005,119142,Cottrell; Garrison W,9999,0,9999,0
1667946463382,CSE 293,006,119146,Deutsch; Alin Bernard,9999,0,9999,0
1667946463382,CSE 293,007,119159,Esmaeilzadeh; Hadi,9999,0,9999,0
1667946463382,CSE 293,008,119166,Freund; Yoav,9999,0,9999,0
1667946463382,CSE 293,009,119170,Griswold; William G.,9999,0,9999,0
1667946463382,CSE 293,010,119183,Gymrek; Melissa Ann,9999,0,9999,0
1667946463382,CSE 293,011,119190,Heninger; Nadia A,9999,0,9999,0
1667946463382,CSE 293,012,119230,Impagliazzo; Russell,9999,0,9999,0
1667946463382,CSE 293,013,119232,Jhala; Ranjit,9999,0,9999,0
1667946463382,CSE 293,014,119233,Kahng; Andrew Byun,9999,0,9999,0
1667946463382,CSE 293,015,119298,Kane; Daniel Mertz,9999,0,9999,0
1667946463382,CSE 293,016,119299,Kriegman; David J,9999,0,9999,0
1667946463382,CSE 293,017,119300,Kumar; Arun Kumar,9999,0,9999,0
1667946463382,CSE 293,018,119301,Lerner; Sorin,9999,0,9999,0
1667946463382,CSE 293,019,119302,Lovett; Shachar,9999,0,9999,0
1667946463382,CSE 293,020,119303,McAuley; Julian John,9999,0,9999,0
1667946463382,CSE 293,021,119304,Micciancio; Daniele,9999,0,9999,0
1667946463382,CSE 293,022,119367,Orailoglu; Alex,9999,0,9999,0
1667946463382,CSE 293,023,119382,Paturi; Ramamohan,9999,0,9999,0
1667946463382,CSE 293,024,119404,Polikarpova; Nadezhda,9999,0,9999,0
1667946463382,CSE 293,025,119406,Politz; Joseph Gibbs,9999,0,9999,0
1667946463382,CSE 293,026,119411,Porter; George M,9999,0,9999,0
1667946463382,CSE 293,027,119414,Porter; Leonard Emerson,9999,0,9999,0
1667946463382,CSE 293,028,119416,Ramamoorthi; Ravi,9999,0,9999,0
1667946463382,CSE 293,029,119417,Sahoo; Debashis,9999,0,9999,0
1667946463382,CSE 293,030,119420,Saul; Lawrence,9999,0,9999,0
1667946463382,CSE 293,031,119421,Savage; Stefan,9999,0,9999,0
1667946463382,CSE 293,032,119425,Schulze; Jurgen P.,9999,0,9999,0
1667946463382,CSE 293,033,119426,Snoeren; Alex C.,9999,0,9999,0
1667946463382,CSE 293,034,119428,Shang; Jingbo,9999,0,9999,0
1667946463382,CSE 293,035,119430,Stefan; Deian,9999,0,9999,0
1667946463382,CSE 293,036,119431,Su; Hao,9999,0,9999,0
1667946463382,CSE 293,037,119433,Swanson; Steven James,9999,0,9999,0
1667946463382,CSE 293,038,119435,Tullsen; Dean Michael,9999,0,9999,0
1667946463382,CSE 293,039,119483,Voelker; Geoffrey M.,9999,0,9999,0
1667946463382,CSE 293,040,119537,Zhao; Jishen,9999,0,9999,0
1667946463382,CSE 293,041,119538,Zhou; Yuan-Yuan,9999,0,9999,0
1667946463382,CSE 293,042,119539,Gao; Sicun,9999,0,9999,0
1667946463382,CSE 293,043,119540,Weibel; Nadir,9999,0,9999,0
1667946463382,CSE 293,044,119541,Gupta; Rajesh K.,9999,0,9999,0
1667946463810,CSE 294,A00,102459,Voelker; Geoffrey M.,0,0,0,0
1667946463810,CSE 294,B00,111322,Orailoglu; Alex,0,0,0,0
1667946464240,DSE 201,A00,096914,Deutsch; Alin Bernard,30,0,30,0
1667946464679,DSE 210,A00,096915,Dasgupta; Sanjoy,30,0,30,0
1667946465117,DSE 260A,A00,096916,Altintas De Callaf; Ilkay,30,0,30,0
1667946465599,ECE 200,001,103586,Antipa; Nicholas A,9999,0,9999,0
1667946465599,ECE 200,002,103587,Atanasov; Nikolay A.,9999,0,9999,0
1667946465599,ECE 200,003,103588,Bharadia; Dinesh,9999,0,9999,0
1667946465599,ECE 200,004,103589,Cheng; Chung Kuan,9999,0,9999,0
1667946465599,ECE 200,005,103590,Cosman; Pamela C.,9999,0,9999,0
1667946465599,ECE 200,006,103591,Dayeh; Shadi Ahmad,9999,0,9999,0
1667946465599,ECE 200,007,103592,Fainman; Yeshaiahu,9999,0,9999,0
1667946465599,ECE 200,008,103593,Ford; Joseph Earl,9999,0,9999,0
1667946465599,ECE 200,009,103594,Franceschetti; Massimo,9999,0,9999,0
1667946465599,ECE 200,010,103595,Fullerton; Eric E,9999,0,9999,0
1667946465599,ECE 200,011,103596,Galton; Ian A,9999,0,9999,0
1667946465599,ECE 200,012,103597,Gilja; Vikash,9999,0,9999,0
1667946465599,ECE 200,013,103598,Hall; Drew A.,9999,0,9999,0
1667946465599,ECE 200,014,103599,Hsueh; Tzu-Chien,9999,0,9999,0
1667946465599,ECE 200,015,103600,Javidi; Tara,9999,0,9999,0
1667946465599,ECE 200,016,103601,Kahng; Andrew Byun,9999,0,9999,0
1667946465599,ECE 200,017,103602,Kim; Young-Han,9999,0,9999,0
1667946465599,ECE 200,018,103603,Koushanfar; Farinaz,9999,0,9999,0
1667946465599,ECE 200,019,103604,Kuzum; Duygu,9999,0,9999,0
1667946465599,ECE 200,020,103605,Le; Hanh-Phuc,9999,0,9999,0
1667946465599,ECE 200,021,103606,Lin; Bill,9999,0,9999,0
1667946465599,ECE 200,022,103607,Liu; Zhaowei,9998,0,9999,1
1667946465599,ECE 200,023,103608,Lo; Yu-Hwa,9999,0,9999,0
1667946465599,ECE 200,024,103609,Lomakin; Vitaliy,9999,0,9999,0
1667946465599,ECE 200,025,103610,Mercier; Patrick Philip,9999,0,9999,0
1667946465599,ECE 200,026,103611,Meyer; Florian,9999,0,9999,0
1667946465599,ECE 200,027,103612,Milstein; Laurence B.,9999,0,9999,0
1667946465599,ECE 200,028,103613,Mir Arabbaygi; Siavash,9999,0,9999,0
1667946465599,ECE 200,029,103614,Mookherjea; Shayan,9999,0,9999,0
1667946465599,ECE 200,030,103615,Morris; Karcher William,9999,0,9999,0
1667946465599,ECE 200,031,103616,Ng; Tse Nga,9999,0,9999,0
1667946465599,ECE 200,032,103617,Nguyen; Truong Quang,9999,0,9999,0
1667946465599,ECE 200,033,103618,Nomura; Kenji,9999,0,9999,0
1667946465599,ECE 200,034,103619,Orlitsky; Alon,9999,0,9999,0
1667946465599,ECE 200,035,103620,Pal; Piya,9999,0,9999,0
1667946465599,ECE 200,036,103621,Papen; George C.,9999,0,9999,0
1667946465599,ECE 200,037,103622,Radic; Stojan,9999,0,9999,0
1667946465599,ECE 200,038,103623,Rao; Bhaskar D.,9999,0,9999,0
1667946465599,ECE 200,039,103624,Rao; Ramesh R,9999,0,9999,0
1667946465599,ECE 200,040,103625,Rebeiz; Gabriel,9999,0,9999,0
1667946465599,ECE 200,041,103626,Sanford; John R,9999,0,9999,0
1667946465599,ECE 200,042,103627,Siegel; Paul H.,9999,0,9999,0
1667946465599,ECE 200,043,103628,Sievenpiper; Daniel F.,9999,0,9999,0
1667946465599,ECE 200,044,103629,Sworder; David D.,9999,0,9999,0
1667946465599,ECE 200,045,103630,Taur; Yuan,9999,0,9999,0
1667946465599,ECE 200,046,103631,Touri; Behrouz,9999,0,9999,0
1667946465599,ECE 200,047,103632,Trivedi; Mohan M.,9999,0,9999,0
1667946465599,ECE 200,048,103633,Vasconcelos; Nuno,9999,0,9999,0
1667946465599,ECE 200,049,103634,Wang; Xiaolong,9999,0,9999,0
1667946465599,ECE 200,050,103635,Xie; Pengtao,9999,0,9999,0
1667946465599,ECE 200,051,103636,Yip; Michael,9999,0,9999,0
1667946465599,ECE 200,052,103637,Zeger; Kenneth A.,999,0,999,0
1667946465599,ECE 200,053,103638,Zhang; Xinyu,9999,0,9999,0
1667946465599,ECE 200,054,103639,Turakhia; Yatish Girish,9999,0,9999,0
1667946465599,ECE 200,055,103640,Kang; Mingu,9999,0,9999,0
1667946465599,ECE 200,056,103641,Shi; Yuanyuan,9999,0,9999,0
1667946465599,ECE 200,057,103642,Wang; Edward Jay,9999,0,9999,0
1667946465599,ECE 200,058,103643,Zheng; Yang,9999,0,9999,0
1667946466024,ECE 202,A00,103644,Kuzum; Duygu,0,0,0,0
1667946466450,ECE 212BN,A00,103646,Ng; Tse Nga,0,0,0,0
1667946466873,ECE 221,A00,111493,Staff,0,0,0,0
1667946467304,ECE 222B,A00,103647,Lomakin; Vitaliy,0,0,0,0
1667946467729,ECE 230B,A00,103648,Taur; Yuan,0,0,0,0
1667946468150,ECE 238B,A00,103649,Garay; Javier,0,0,0,0
1667946468582,ECE 240B,A00,112900,Fainman; Yeshaiahu,0,0,0,0
1667946469011,ECE 247A,A00,103650,Jokerst; Jesse Vincent,0,0,0,0
1667946469435,ECE 247B,A00,103651,Wang; Joseph,0,0,0,0
1667946469862,ECE 250,A00,103652,Siegel; Paul H.,0,0,0,0
1667946470289,ECE 251A,A00,103654,Rao; Bhaskar D.,0,0,0,0
1667946470720,ECE 257B,A00,103655,Bharadia; Dinesh,0,0,0,0
1667946471144,ECE 258A,A00,103656,Milstein; Laurence B.,0,0,0,0
1667946471571,ECE 260B,A00,103658,Kang; Mingu,0,0,0,0
1667946471994,ECE 264A,A00,103659,Galton; Ian A,0,0,0,0
1667946472419,ECE 265A,A00,103661,Gudem; Prasad S.S.,0,0,0,0
1667946472864,ECE 265D,A00,103662,Gudem; Prasad S.S.,0,0,0,0
1667946473291,ECE 268,A00,103663,Koushanfar; Farinaz,0,0,0,0
1667946473716,ECE 269,A01,103665,Pal; Piya,0,0,0,0
1667946474138,ECE 271B,A00,103666,Vasconcelos; Manuela,0,0,0,0
1667946474572,ECE 276A,A00,103667,Atanasov; Nikolay A.,0,0,0,0
1667946475011,ECE 277,A00,103668,An; Cheolhong,0,0,0,0
1667946475446,ECE 279,A00,117947,Hall; Drew A.,0,0,0,0
1667946476302,ECE 283,A00,103670,Hsueh; Tzu-Chien,0,0,0,0
1667946476729,ECE 284,A00,103671,Turakhia; Yatish Girish,0,0,0,0
1667946477152,ECE 285,A00,103672,Zheng; Yang,0,0,0,0
1667946477152,ECE 285,B00,103673,Sworder; David D.,0,0,0,0
1667946477576,ECE 287,A00,103676,Javidi; Tara,0,0,0,0
1667946478005,MATH 200B,A00,098023,Salehi Golsefidy; Alireza,14,0,15,1
1667946478441,MATH 202B,A00,098024,Rhoades; Brendon Patrick,13,0,15,2
1667946478870,MATH 203B,A00,098025,Oprea; Dragos N.,14,0,15,1
1667946479295,MATH 204B,A00,098026,Sorensen; Claus M,15,0,15,0
1667946479727,MATH 208,A00,098027,Izadi; Elham,7,0,10,3
1667946480149,MATH 209,A00,098028,Pollack; Aaron,10,0,10,0
1667946480574,MATH 211A,A00,112919,Rogalski; Daniel,10,0,10,0
1667946480996,MATH 211B,A00,112920,Seward; Brandon M.,10,0,10,0
1667946481419,MATH 218,A00,098029,Li; Bo,10,0,10,0
1667946481841,MATH 220B,A00,098030,Novak; Jonathan I,14,0,15,1
1667946482276,MATH 221A,A00,098031,Ebenfelt; Peter F,14,0,15,1
1667946482703,MATH 231B,A00,098032,Zlatos; Andrej,13,0,15,2
1667946483133,MATH 240B,A00,098033,Ni; Lei,11,0,15,4
1667946483577,MATH 243,A00,098034,Jekel; David Andrew,10,0,10,0
1667946484005,MATH 245A,A00,098035,Nie; Jiawang,4,0,15,11
1667946484435,MATH 248,A00,098036,Bejenaru; Ioan,10,0,10,0
1667946484859,MATH 250B,A00,098037,Spolaor; Luca,14,0,15,1
1667946485401,MATH 258,A00,098038,Ni; Lei,10,0,10,0
1667946485825,MATH 264B,A00,098041,Rhoades; Brendon Patrick,13,0,15,2
1667946486263,MATH 268,A00,098042,Buss; Samuel R,10,0,10,0
1667946486687,MATH 269,A00,098043,Rhoades; Brendon Patrick,10,0,10,0
1667946487122,MATH 270B,A00,098044,Li; Bo,11,0,15,4
1667946487547,MATH 272B,A00,098045,Holst; Michael J,13,0,15,2
1667946487977,MATH 273A,A00,098046,Tian; Xiaochuan,12,0,15,3
1667946488404,MATH 275,A01,098048,Tian; Xiaochuan,6,0,10,4
1667946488834,MATH 278A,A00,098049,Holst; Michael J,8,0,10,2
1667946489257,MATH 278B,A00,098050,Cloninger; Alexander,10,0,10,0
1667946489690,MATH 278C,A00,098051,Nie; Jiawang,7,0,10,3
1667946490125,MATH 280B,A00,098052,Zheng; Tianyi,12,0,15,3
1667946490550,MATH 281B,A00,098053,Bradic; Jelena,4,0,15,11
1667946490979,MATH 282B,A00,098054,Arias-Castro; Ery,2,0,15,13
1667946491406,MATH 285,A00,098055,Fitzsimmons; Patrick J,0,0,15,15
1667946491831,MATH 287B,A00,098056,Arias-Castro; Ery,7,0,15,8
1667946492257,MATH 288,A00,098057,Agarwal; Pooja,9,0,10,1
1667946492257,MATH 288,B00,098058,Zhang; Danna,9,0,10,1
1667946492257,MATH 288,C00,098059,Williams; Ruth J,10,0,10,0
1667946492689,MATH 290B,A00,098060,Roberts; Justin Deritter,14,0,15,1
1667946493115,MATH 292,A00,098061,Belmont; Eva Kinoshita,10,0,10,0
1667946493540,MATH 295,A00,098062,Suk; Andrew Hoon,48,0,50,2
1667946493967,MATH 296,A00,098063,Novak; Jonathan I,20,0,20,0
1667946494392,MATH 297,001,098064,Gamst; Anthony Collins,9997,0,9999,2
1667946997688,COGS 205,A00,101395,Chiba; Andrea,19,0,20,1
1667946998113,COGS 210B,001,101404,Greene; Deanna Jacquelyn,9998,0,9999,1
1667946998113,COGS 210B,002,101417,Xia; Haijun,9999,0,9999,0
1667946998113,COGS 210B,003,101422,Nitz; Douglas A.,9999,0,9999,0
1667946998113,COGS 210B,004,101423,Hollan; James D.,9998,0,9999,1
1667946998113,COGS 210B,005,101424,Deak; Gedeon O.,9999,0,9999,0
1667946998113,COGS 210B,006,101425,Rossano; Federico,9999,0,9999,0
1667946998559,COGS 211B,A00,101427,Coulson; Seana M,9997,0,9999,2
1667946998984,COGS 220,A00,101428,Hollan; James D.,0,0,25,25
1667946999406,COGS 229,A00,101429,Dow; Steven P,18,0,25,7
1667946999834,COGS 230,A00,101430,Klemmer; Scott R,13,0,17,4
1667947000260,COGS 234,A00,101431,Xia; Haijun,9,0,25,16
1667947000685,COGS 260,A00,101432,Kiyonaga; Anastasia,20,0,25,5
1667947000685,COGS 260,B00,101433,Kirsh; David Joel,17,0,25,8
1667947001109,CSE 202,A00,102371,Impagliazzo; Russell,0,0,0,0
1667947001535,CSE 203B,A01,102373,Cheng; Chung Kuan,0,0,0,0
1667947001968,CSE 208,A00,102374,Micciancio; Daniele,0,0,0,0
1667947002406,CSE 209A,A00,112895,Impagliazzo; Russell,0,0,15,15
1667947002838,CSE 209B,A00,108005,Bellare; Mihir,0,0,0,0
1667947003270,CSE 210,A00,113163,Coblenz; Michael J,0,0,0,0
1667947003702,CSE 219,A00,106111,Dow; Steven P,0,0,20,20
1667947004125,CSE 221,A00,102376,Voelker; Geoffrey M.,0,0,0,0
1667947004548,CSE 224,A01,102378,Porter; George M,0,0,0,0
1667947004976,CSE 229A,A00,102379,Savage; Stefan,0,0,0,0
1667947005400,CSE 229C,A00,102380,Munyaka; Imani N. S.,0,0,0,0
1667947005823,CSE 232B,A00,102382,Deutsch; Alin Bernard,0,0,0,0
1667947006244,CSE 234,A01,112904,Kumar; Arun Kumar,0,0,0,0
1667947006667,CSE 237A,A00,102383,Rosing; Tajana Simunic,0,0,0,0
1667947007090,CSE 239A,A00,102384,Deutsch; Alin Bernard,0,0,0,0
1667947007514,CSE 239B,A00,102385,Polikarpova; Nadezhda,0,0,0,0
1667947007945,CSE 240A,A00,102386,Pannuto; Patrick William,0,0,0,0
1667947008367,CSE 240B,A00,102387,Zhao; Jishen,0,0,0,0
1667947008882,CSE 241A,A00,106406,Kang; Mingu,0,0,0,0
1667947009309,CSE 249B,A00,102388,Kahng; Andrew Byun,0,0,8,8
1667947009736,CSE 251B,A01,102392,Cottrell; Garrison W,0,0,0,0
1667947009736,CSE 251B,A02,102393,Cottrell; Garrison W,0,0,0,0
1667947010161,CSE 252B,A00,102394,Ochoa; Benjamin Lawrence,0,0,0,0
1667947010586,CSE 257,A01,102396,Gao; Sicun,0,0,0,0
1667947011016,CSE 272,A00,102397,Li; Tzumao,0,0,0,0
1667947011438,CSE 274,A00,111323,Chern; Albert Ren-Haur,0,0,0,0
1667947011861,CSE 282,A00,102398,Pevzner; Pavel Arkadjevich,0,0,0,0
1667947012287,CSE 284,A00,114175,Gymrek; Melissa Ann,0,0,0,0
1667947012711,CSE 290,A00,102399,Chandraker; Manmohan Krishna,0,0,0,0
1667947012711,CSE 290,B00,102400,Vaccaro; Kristen Marie,0,0,25,25
1667947012711,CSE 290,C00,102414,Pannuto; Patrick William,0,0,25,25
1667947012711,CSE 290,D00,102427,Pevzner; Pavel Arkadjevich,0,0,0,0
1667947012711,CSE 290,E00,102429,Zhao; Jishen,0,0,0,0
1667947012711,CSE 290,F00,102436,Tullsen; Dean Michael,0,0,0,0
1667947012711,CSE 290,G00,102440,Christensen; Henrik I,0,0,20,20
1667947013143,CSE 291,A00,102443,Su; Hao,0,0,0,0
1667947013143,CSE 291,B00,102448,Polikarpova; Nadezhda,0,0,0,0
1667947013143,CSE 291,C00,102453,Vaccaro; Kristen Marie,0,0,0,0
1667947013143,CSE 291,D00,111343,Savage; Stefan,0,0,0,0
1667947013143,CSE 291,E00,116474,Claffy; Kimberly Claire,0,0,0,0
1667947013143,CSE 291,F00,116479,Pasquale; Joseph,0,0,0,0
1667947013613,CSE 293,001,119111,Bafna; Vineet,9999,0,9999,0
1667947013613,CSE 293,002,119118,Bellare; Mihir,9999,0,9999,0
1667947013613,CSE 293,003,119122,Berg-Kirkpatrick; Taylor D,9999,0,9999,0
1667947013613,CSE 293,004,119135,Christensen; Henrik I,9999,0,9999,0
1667947013613,CSE 293,005,119142,Cottrell; Garrison W,9999,0,9999,0
1667947013613,CSE 293,006,119146,Deutsch; Alin Bernard,9999,0,9999,0
1667947013613,CSE 293,007,119159,Esmaeilzadeh; Hadi,9999,0,9999,0
1667947013613,CSE 293,008,119166,Freund; Yoav,9999,0,9999,0
1667947013613,CSE 293,009,119170,Griswold; William G.,9999,0,9999,0
1667947013613,CSE 293,010,119183,Gymrek; Melissa Ann,9999,0,9999,0
1667947013613,CSE 293,011,119190,Heninger; Nadia A,9999,0,9999,0
1667947013613,CSE 293,012,119230,Impagliazzo; Russell,9999,0,9999,0
1667947013613,CSE 293,013,119232,Jhala; Ranjit,9999,0,9999,0
1667947013613,CSE 293,014,119233,Kahng; Andrew Byun,9999,0,9999,0
1667947013613,CSE 293,015,119298,Kane; Daniel Mertz,9999,0,9999,0
1667947013613,CSE 293,016,119299,Kriegman; David J,9999,0,9999,0
1667947013613,CSE 293,017,119300,Kumar; Arun Kumar,9999,0,9999,0
1667947013613,CSE 293,018,119301,Lerner; Sorin,9999,0,9999,0
1667947013613,CSE 293,019,119302,Lovett; Shachar,9999,0,9999,0
1667947013613,CSE 293,020,119303,McAuley; Julian John,9999,0,9999,0
1667947013613,CSE 293,021,119304,Micciancio; Daniele,9999,0,9999,0
1667947013613,CSE 293,022,119367,Orailoglu; Alex,9999,0,9999,0
1667947013613,CSE 293,023,119382,Paturi; Ramamohan,9999,0,9999,0
1667947013613,CSE 293,024,119404,Polikarpova; Nadezhda,9999,0,9999,0
1667947013613,CSE 293,025,119406,Politz; Joseph Gibbs,9999,0,9999,0
1667947013613,CSE 293,026,119411,Porter; George M,9999,0,9999,0
1667947013613,CSE 293,027,119414,Porter; Leonard Emerson,9999,0,9999,0
1667947013613,CSE 293,028,119416,Ramamoorthi; Ravi,9999,0,9999,0
1667947013613,CSE 293,029,119417,Sahoo; Debashis,9999,0,9999,0
1667947013613,CSE 293,030,119420,Saul; Lawrence,9999,0,9999,0
1667947013613,CSE 293,031,119421,Savage; Stefan,9999,0,9999,0
1667947013613,CSE 293,032,119425,Schulze; Jurgen P.,9999,0,9999,0
1667947013613,CSE 293,033,119426,Snoeren; Alex C.,9999,0,9999,0
1667947013613,CSE 293,034,119428,Shang; Jingbo,9999,0,9999,0
1667947013613,CSE 293,035,119430,Stefan; Deian,9999,0,9999,0
1667947013613,CSE 293,036,119431,Su; Hao,9999,0,9999,0
1667947013613,CSE 293,037,119433,Swanson; Steven James,9999,0,9999,0
1667947013613,CSE 293,038,119435,Tullsen; Dean Michael,9999,0,9999,0
1667947013613,CSE 293,039,119483,Voelker; Geoffrey M.,9999,0,9999,0
1667947013613,CSE 293,040,119537,Zhao; Jishen,9999,0,9999,0
1667947013613,CSE 293,041,119538,Zhou; Yuan-Yuan,9999,0,9999,0
1667947013613,CSE 293,042,119539,Gao; Sicun,9999,0,9999,0
1667947013613,CSE 293,043,119540,Weibel; Nadir,9999,0,9999,0
1667947013613,CSE 293,044,119541,Gupta; Rajesh K.,9999,0,9999,0
1667947014042,CSE 294,A00,102459,Voelker; Geoffrey M.,0,0,0,0
1667947014042,CSE 294,B00,111322,Orailoglu; Alex,0,0,0,0
1667947014465,DSE 201,A00,096914,Deutsch; Alin Bernard,30,0,30,0
1667947014897,DSE 210,A00,096915,Dasgupta; Sanjoy,30,0,30,0
1667947015321,DSE 260A,A00,096916,Altintas De Callaf; Ilkay,30,0,30,0
1667947015756,ECE 200,001,103586,Antipa; Nicholas A,9999,0,9999,0
1667947015756,ECE 200,002,103587,Atanasov; Nikolay A.,9999,0,9999,0
1667947015756,ECE 200,003,103588,Bharadia; Dinesh,9999,0,9999,0
1667947015756,ECE 200,004,103589,Cheng; Chung Kuan,9999,0,9999,0
1667947015756,ECE 200,005,103590,Cosman; Pamela C.,9999,0,9999,0
1667947015756,ECE 200,006,103591,Dayeh; Shadi Ahmad,9999,0,9999,0
1667947015756,ECE 200,007,103592,Fainman; Yeshaiahu,9999,0,9999,0
1667947015756,ECE 200,008,103593,Ford; Joseph Earl,9999,0,9999,0
1667947015756,ECE 200,009,103594,Franceschetti; Massimo,9999,0,9999,0
1667947015756,ECE 200,010,103595,Fullerton; Eric E,9999,0,9999,0
1667947015756,ECE 200,011,103596,Galton; Ian A,9999,0,9999,0
1667947015756,ECE 200,012,103597,Gilja; Vikash,9999,0,9999,0
1667947015756,ECE 200,013,103598,Hall; Drew A.,9999,0,9999,0
1667947015756,ECE 200,014,103599,Hsueh; Tzu-Chien,9999,0,9999,0
1667947015756,ECE 200,015,103600,Javidi; Tara,9999,0,9999,0
1667947015756,ECE 200,016,103601,Kahng; Andrew Byun,9999,0,9999,0
1667947015756,ECE 200,017,103602,Kim; Young-Han,9999,0,9999,0
1667947015756,ECE 200,018,103603,Koushanfar; Farinaz,9999,0,9999,0
1667947015756,ECE 200,019,103604,Kuzum; Duygu,9999,0,9999,0
1667947015756,ECE 200,020,103605,Le; Hanh-Phuc,9999,0,9999,0
1667947015756,ECE 200,021,103606,Lin; Bill,9999,0,9999,0
1667947015756,ECE 200,022,103607,Liu; Zhaowei,9998,0,9999,1
1667947015756,ECE 200,023,103608,Lo; Yu-Hwa,9999,0,9999,0
1667947015756,ECE 200,024,103609,Lomakin; Vitaliy,9999,0,9999,0
1667947015756,ECE 200,025,103610,Mercier; Patrick Philip,9999,0,9999,0
1667947015756,ECE 200,026,103611,Meyer; Florian,9999,0,9999,0
1667947015756,ECE 200,027,103612,Milstein; Laurence B.,9999,0,9999,0
1667947015756,ECE 200,028,103613,Mir Arabbaygi; Siavash,9999,0,9999,0
1667947015756,ECE 200,029,103614,Mookherjea; Shayan,9999,0,9999,0
1667947015756,ECE 200,030,103615,Morris; Karcher William,9999,0,9999,0
1667947015756,ECE 200,031,103616,Ng; Tse Nga,9999,0,9999,0
1667947015756,ECE 200,032,103617,Nguyen; Truong Quang,9999,0,9999,0
1667947015756,ECE 200,033,103618,Nomura; Kenji,9999,0,9999,0
1667947015756,ECE 200,034,103619,Orlitsky; Alon,9999,0,9999,0
1667947015756,ECE 200,035,103620,Pal; Piya,9999,0,9999,0
1667947015756,ECE 200,036,103621,Papen; George C.,9999,0,9999,0
1667947015756,ECE 200,037,103622,Radic; Stojan,9999,0,9999,0
1667947015756,ECE 200,038,103623,Rao; Bhaskar D.,9999,0,9999,0
1667947015756,ECE 200,039,103624,Rao; Ramesh R,9999,0,9999,0
1667947015756,ECE 200,040,103625,Rebeiz; Gabriel,9999,0,9999,0
1667947015756,ECE 200,041,103626,Sanford; John R,9999,0,9999,0
1667947015756,ECE 200,042,103627,Siegel; Paul H.,9999,0,9999,0
1667947015756,ECE 200,043,103628,Sievenpiper; Daniel F.,9999,0,9999,0
1667947015756,ECE 200,044,103629,Sworder; David D.,9999,0,9999,0
1667947015756,ECE 200,045,103630,Taur; Yuan,9999,0,9999,0
1667947015756,ECE 200,046,103631,Touri; Behrouz,9999,0,9999,0
1667947015756,ECE 200,047,103632,Trivedi; Mohan M.,9999,0,9999,0
1667947015756,ECE 200,048,103633,Vasconcelos; Nuno,9999,0,9999,0
1667947015756,ECE 200,049,103634,Wang; Xiaolong,9999,0,9999,0
1667947015756,ECE 200,050,103635,Xie; Pengtao,9999,0,9999,0
1667947015756,ECE 200,051,103636,Yip; Michael,9999,0,9999,0
1667947015756,ECE 200,052,103637,Zeger; Kenneth A.,999,0,999,0
1667947015756,ECE 200,053,103638,Zhang; Xinyu,9999,0,9999,0
1667947015756,ECE 200,054,103639,Turakhia; Yatish Girish,9999,0,9999,0
1667947015756,ECE 200,055,103640,Kang; Mingu,9999,0,9999,0
1667947015756,ECE 200,056,103641,Shi; Yuanyuan,9999,0,9999,0
1667947015756,ECE 200,057,103642,Wang; Edward Jay,9999,0,9999,0
1667947015756,ECE 200,058,103643,Zheng; Yang,9999,0,9999,0
1667947016186,ECE 202,A00,103644,Kuzum; Duygu,0,0,0,0
1667947016612,ECE 212BN,A00,103646,Ng; Tse Nga,0,0,0,0
1667947017035,ECE 221,A00,111493,Staff,0,0,0,0
1667947017464,ECE 222B,A00,103647,Lomakin; Vitaliy,0,0,0,0
1667947017894,ECE 230B,A00,103648,Taur; Yuan,0,0,0,0
1667947018331,ECE 238B,A00,103649,Garay; Javier,0,0,0,0
1667947018759,ECE 240B,A00,112900,Fainman; Yeshaiahu,0,0,0,0
1667947019186,ECE 247A,A00,103650,Jokerst; Jesse Vincent,0,0,0,0
1667947019620,ECE 247B,A00,103651,Wang; Joseph,0,0,0,0
1667947020057,ECE 250,A00,103652,Siegel; Paul H.,0,0,0,0
1667947020480,ECE 251A,A00,103654,Rao; Bhaskar D.,0,0,0,0
1667947020913,ECE 257B,A00,103655,Bharadia; Dinesh,0,0,0,0
1667947021336,ECE 258A,A00,103656,Milstein; Laurence B.,0,0,0,0
1667947021761,ECE 260B,A00,103658,Kang; Mingu,0,0,0,0
1667947022190,ECE 264A,A00,103659,Galton; Ian A,0,0,0,0
1667947022615,ECE 265A,A00,103661,Gudem; Prasad S.S.,0,0,0,0
1667947023041,ECE 265D,A00,103662,Gudem; Prasad S.S.,0,0,0,0
1667947023473,ECE 268,A00,103663,Koushanfar; Farinaz,0,0,0,0
1667947023897,ECE 269,A01,103665,Pal; Piya,0,0,0,0
1667947024322,ECE 271B,A00,103666,Vasconcelos; Manuela,0,0,0,0
1667947024745,ECE 276A,A00,103667,Atanasov; Nikolay A.,0,0,0,0
1667947025174,ECE 277,A00,103668,An; Cheolhong,0,0,0,0
1667947025601,ECE 279,A00,117947,Hall; Drew A.,0,0,0,0
1667947026467,ECE 283,A00,103670,Hsueh; Tzu-Chien,0,0,0,0
1667947026895,ECE 284,A00,103671,Turakhia; Yatish Girish,0,0,0,0
1667947027318,ECE 285,A00,103672,Zheng; Yang,0,0,0,0
1667947027318,ECE 285,B00,103673,Sworder; David D.,0,0,0,0
1667947027742,ECE 287,A00,103676,Javidi; Tara,0,0,0,0
1667947028164,MATH 200B,A00,098023,Salehi Golsefidy; Alireza,14,0,15,1
1667947028586,MATH 202B,A00,098024,Rhoades; Brendon Patrick,13,0,15,2
1667947029018,MATH 203B,A00,098025,Oprea; Dragos N.,14,0,15,1
1667947029443,MATH 204B,A00,098026,Sorensen; Claus M,15,0,15,0
1667947029871,MATH 208,A00,098027,Izadi; Elham,7,0,10,3
1667947030299,MATH 209,A00,098028,Pollack; Aaron,10,0,10,0
1667947030731,MATH 211A,A00,112919,Rogalski; Daniel,10,0,10,0
1667947031166,MATH 211B,A00,112920,Seward; Brandon M.,10,0,10,0
1667947031593,MATH 218,A00,098029,Li; Bo,10,0,10,0
1667947032029,MATH 220B,A00,098030,Novak; Jonathan I,14,0,15,1
1667947032452,MATH 221A,A00,098031,Ebenfelt; Peter F,14,0,15,1
1667947032878,MATH 231B,A00,098032,Zlatos; Andrej,13,0,15,2
1667947033300,MATH 240B,A00,098033,Ni; Lei,11,0,15,4
1667947033728,MATH 243,A00,098034,Jekel; David Andrew,10,0,10,0
1667947034162,MATH 245A,A00,098035,Nie; Jiawang,4,0,15,11
1667947034594,MATH 248,A00,098036,Bejenaru; Ioan,10,0,10,0
1667947035025,MATH 250B,A00,098037,Spolaor; Luca,14,0,15,1
1667947035451,MATH 258,A00,098038,Ni; Lei,10,0,10,0
1667947035874,MATH 264B,A00,098041,Rhoades; Brendon Patrick,13,0,15,2
1667947036299,MATH 268,A00,098042,Buss; Samuel R,10,0,10,0
1667947036725,MATH 269,A00,098043,Rhoades; Brendon Patrick,10,0,10,0
1667947037150,MATH 270B,A00,098044,Li; Bo,11,0,15,4
1667947037573,MATH 272B,A00,098045,Holst; Michael J,13,0,15,2
1667947038007,MATH 273A,A00,098046,Tian; Xiaochuan,12,0,15,3
1667947038433,MATH 275,A01,098048,Tian; Xiaochuan,6,0,10,4
1667947038855,MATH 278A,A00,098049,Holst; Michael J,8,0,10,2
1667947039277,MATH 278B,A00,098050,Cloninger; Alexander,10,0,10,0
1667947039701,MATH 278C,A00,098051,Nie; Jiawang,7,0,10,3
1667947040134,MATH 280B,A00,098052,Zheng; Tianyi,12,0,15,3
1667947040566,MATH 281B,A00,098053,Bradic; Jelena,4,0,15,11
1667947040994,MATH 282B,A00,098054,Arias-Castro; Ery,2,0,15,13
1667947041426,MATH 285,A00,098055,Fitzsimmons; Patrick J,0,0,15,15
1667947041850,MATH 287B,A00,098056,Arias-Castro; Ery,7,0,15,8
1667947042273,MATH 288,A00,098057,Agarwal; Pooja,9,0,10,1
1667947042273,MATH 288,B00,098058,Zhang; Danna,9,0,10,1
1667947042273,MATH 288,C00,098059,Williams; Ruth J,10,0,10,0
1667947042696,MATH 290B,A00,098060,Roberts; Justin Deritter,14,0,15,1
1667947043121,MATH 292,A00,098061,Belmont; Eva Kinoshita,10,0,10,0
1667947043548,MATH 295,A00,098062,Suk; Andrew Hoon,48,0,50,2
1667947043971,MATH 296,A00,098063,Novak; Jonathan I,20,0,20,0
1667947044401,MATH 297,001,098064,Gamst; Anthony Collins,9997,0,9999,2
1667947547308,COGS 205,A00,101395,Chiba; Andrea,19,0,20,1
1667947547741,COGS 210B,001,101404,Greene; Deanna Jacquelyn,9998,0,9999,1
1667947547741,COGS 210B,002,101417,Xia; Haijun,9999,0,9999,0
1667947547741,COGS 210B,003,101422,Nitz; Douglas A.,9999,0,9999,0
1667947547741,COGS 210B,004,101423,Hollan; James D.,9998,0,9999,1
1667947547741,COGS 210B,005,101424,Deak; Gedeon O.,9999,0,9999,0
1667947547741,COGS 210B,006,101425,Rossano; Federico,9999,0,9999,0
1667947548166,COGS 211B,A00,101427,Coulson; Seana M,9997,0,9999,2
1667947548589,COGS 220,A00,101428,Hollan; James D.,0,0,25,25
1667947549020,COGS 229,A00,101429,Dow; Steven P,18,0,25,7
1667947549443,COGS 230,A00,101430,Klemmer; Scott R,13,0,17,4
1667947549879,COGS 234,A00,101431,Xia; Haijun,8,0,25,17
1667947550329,COGS 260,A00,101432,Kiyonaga; Anastasia,20,0,25,5
1667947550329,COGS 260,B00,101433,Kirsh; David Joel,17,0,25,8
1667947550753,CSE 202,A00,102371,Impagliazzo; Russell,0,0,0,0
1667947551207,CSE 203B,A01,102373,Cheng; Chung Kuan,0,0,0,0
1667947551633,CSE 208,A00,102374,Micciancio; Daniele,0,0,0,0
1667947552057,CSE 209A,A00,112895,Impagliazzo; Russell,0,0,15,15
1667947552479,CSE 209B,A00,108005,Bellare; Mihir,0,0,0,0
1667947552909,CSE 210,A00,113163,Coblenz; Michael J,0,0,0,0
1667947553332,CSE 219,A00,106111,Dow; Steven P,0,0,20,20
1667947553757,CSE 221,A00,102376,Voelker; Geoffrey M.,0,0,0,0
1667947554190,CSE 224,A01,102378,Porter; George M,0,0,0,0
1667947554611,CSE 229A,A00,102379,Savage; Stefan,0,0,0,0
1667947555047,CSE 229C,A00,102380,Munyaka; Imani N. S.,0,0,0,0
1667947555472,CSE 232B,A00,102382,Deutsch; Alin Bernard,0,0,0,0
1667947555909,CSE 234,A01,112904,Kumar; Arun Kumar,0,0,0,0
1667947556345,CSE 237A,A00,102383,Rosing; Tajana Simunic,0,0,0,0
1667947556772,CSE 239A,A00,102384,Deutsch; Alin Bernard,0,0,0,0
1667947557194,CSE 239B,A00,102385,Polikarpova; Nadezhda,0,0,0,0
1667947557615,CSE 240A,A00,102386,Pannuto; Patrick William,0,0,0,0
1667947558064,CSE 240B,A00,102387,Zhao; Jishen,0,0,0,0
1667947558491,CSE 241A,A00,106406,Kang; Mingu,0,0,0,0
1667947558919,CSE 249B,A00,102388,Kahng; Andrew Byun,0,0,8,8
1667947559342,CSE 251B,A01,102392,Cottrell; Garrison W,0,0,0,0
1667947559342,CSE 251B,A02,102393,Cottrell; Garrison W,0,0,0,0
1667947559771,CSE 252B,A00,102394,Ochoa; Benjamin Lawrence,0,0,0,0
1667947560206,CSE 257,A01,102396,Gao; Sicun,0,0,0,0
1667947560641,CSE 272,A00,102397,Li; Tzumao,0,0,0,0
1667947561077,CSE 274,A00,111323,Chern; Albert Ren-Haur,0,0,0,0
1667947561501,CSE 282,A00,102398,Pevzner; Pavel Arkadjevich,0,0,0,0
1667947561922,CSE 284,A00,114175,Gymrek; Melissa Ann,0,0,0,0
1667947562352,CSE 290,A00,102399,Chandraker; Manmohan Krishna,0,0,0,0
1667947562352,CSE 290,B00,102400,Vaccaro; Kristen Marie,0,0,25,25
1667947562352,CSE 290,C00,102414,Pannuto; Patrick William,0,0,25,25
1667947562352,CSE 290,D00,102427,Pevzner; Pavel Arkadjevich,0,0,0,0
1667947562352,CSE 290,E00,102429,Zhao; Jishen,0,0,0,0
1667947562352,CSE 290,F00,102436,Tullsen; Dean Michael,0,0,0,0
1667947562352,CSE 290,G00,102440,Christensen; Henrik I,0,0,20,20
1667947562797,CSE 291,A00,102443,Su; Hao,0,0,0,0
1667947562797,CSE 291,B00,102448,Polikarpova; Nadezhda,0,0,0,0
1667947562797,CSE 291,C00,102453,Vaccaro; Kristen Marie,0,0,0,0
1667947562797,CSE 291,D00,111343,Savage; Stefan,0,0,0,0
1667947562797,CSE 291,E00,116474,Claffy; Kimberly Claire,0,0,0,0
1667947562797,CSE 291,F00,116479,Pasquale; Joseph,0,0,0,0
1667947563246,CSE 293,001,119111,Bafna; Vineet,9999,0,9999,0
1667947563246,CSE 293,002,119118,Bellare; Mihir,9999,0,9999,0
1667947563246,CSE 293,003,119122,Berg-Kirkpatrick; Taylor D,9999,0,9999,0
1667947563246,CSE 293,004,119135,Christensen; Henrik I,9999,0,9999,0
1667947563246,CSE 293,005,119142,Cottrell; Garrison W,9999,0,9999,0
1667947563246,CSE 293,006,119146,Deutsch; Alin Bernard,9999,0,9999,0
1667947563246,CSE 293,007,119159,Esmaeilzadeh; Hadi,9999,0,9999,0
1667947563246,CSE 293,008,119166,Freund; Yoav,9999,0,9999,0
1667947563246,CSE 293,009,119170,Griswold; William G.,9999,0,9999,0
1667947563246,CSE 293,010,119183,Gymrek; Melissa Ann,9998,0,9999,1
1667947563246,CSE 293,011,119190,Heninger; Nadia A,9999,0,9999,0
1667947563246,CSE 293,012,119230,Impagliazzo; Russell,9999,0,9999,0
1667947563246,CSE 293,013,119232,Jhala; Ranjit,9999,0,9999,0
1667947563246,CSE 293,014,119233,Kahng; Andrew Byun,9999,0,9999,0
1667947563246,CSE 293,015,119298,Kane; Daniel Mertz,9999,0,9999,0
1667947563246,CSE 293,016,119299,Kriegman; David J,9999,0,9999,0
1667947563246,CSE 293,017,119300,Kumar; Arun Kumar,9999,0,9999,0
1667947563246,CSE 293,018,119301,Lerner; Sorin,9999,0,9999,0
1667947563246,CSE 293,019,119302,Lovett; Shachar,9999,0,9999,0
1667947563246,CSE 293,020,119303,McAuley; Julian John,9999,0,9999,0
1667947563246,CSE 293,021,119304,Micciancio; Daniele,9999,0,9999,0
1667947563246,CSE 293,022,119367,Orailoglu; Alex,9999,0,9999,0
1667947563246,CSE 293,023,119382,Paturi; Ramamohan,9999,0,9999,0
1667947563246,CSE 293,024,119404,Polikarpova; Nadezhda,9999,0,9999,0
1667947563246,CSE 293,025,119406,Politz; Joseph Gibbs,9999,0,9999,0
1667947563246,CSE 293,026,119411,Porter; George M,9999,0,9999,0
1667947563246,CSE 293,027,119414,Porter; Leonard Emerson,9999,0,9999,0
1667947563246,CSE 293,028,119416,Ramamoorthi; Ravi,9999,0,9999,0
1667947563246,CSE 293,029,119417,Sahoo; Debashis,9999,0,9999,0
1667947563246,CSE 293,030,119420,Saul; Lawrence,9999,0,9999,0
1667947563246,CSE 293,031,119421,Savage; Stefan,9999,0,9999,0
1667947563246,CSE 293,032,119425,Schulze; Jurgen P.,9999,0,9999,0
1667947563246,CSE 293,033,119426,Snoeren; Alex C.,9999,0,9999,0
1667947563246,CSE 293,034,119428,Shang; Jingbo,9999,0,9999,0
1667947563246,CSE 293,035,119430,Stefan; Deian,9999,0,9999,0
1667947563246,CSE 293,036,119431,Su; Hao,9999,0,9999,0
1667947563246,CSE 293,037,119433,Swanson; Steven James,9999,0,9999,0
1667947563246,CSE 293,038,119435,Tullsen; Dean Michael,9999,0,9999,0
1667947563246,CSE 293,039,119483,Voelker; Geoffrey M.,9999,0,9999,0
1667947563246,CSE 293,040,119537,Zhao; Jishen,9999,0,9999,0
1667947563246,CSE 293,041,119538,Zhou; Yuan-Yuan,9999,0,9999,0
1667947563246,CSE 293,042,119539,Gao; Sicun,9999,0,9999,0
1667947563246,CSE 293,043,119540,Weibel; Nadir,9999,0,9999,0
1667947563246,CSE 293,044,119541,Gupta; Rajesh K.,9999,0,9999,0
1667947563681,CSE 294,A00,102459,Voelker; Geoffrey M.,0,0,0,0
1667947563681,CSE 294,B00,111322,Orailoglu; Alex,0,0,0,0
1667947564110,DSE 201,A00,096914,Deutsch; Alin Bernard,30,0,30,0
1667947564533,DSE 210,A00,096915,Dasgupta; Sanjoy,30,0,30,0
1667947564959,DSE 260A,A00,096916,Altintas De Callaf; Ilkay,30,0,30,0
1667947565393,ECE 200,001,103586,Antipa; Nicholas A,9999,0,9999,0
1667947565393,ECE 200,002,103587,Atanasov; Nikolay A.,9999,0,9999,0
1667947565393,ECE 200,003,103588,Bharadia; Dinesh,9999,0,9999,0
1667947565393,ECE 200,004,103589,Cheng; Chung Kuan,9999,0,9999,0
1667947565393,ECE 200,005,103590,Cosman; Pamela C.,9999,0,9999,0
1667947565393,ECE 200,006,103591,Dayeh; Shadi Ahmad,9999,0,9999,0
1667947565393,ECE 200,007,103592,Fainman; Yeshaiahu,9999,0,9999,0
1667947565393,ECE 200,008,103593,Ford; Joseph Earl,9999,0,9999,0
1667947565393,ECE 200,009,103594,Franceschetti; Massimo,9999,0,9999,0
1667947565393,ECE 200,010,103595,Fullerton; Eric E,9999,0,9999,0
1667947565393,ECE 200,011,103596,Galton; Ian A,9999,0,9999,0
1667947565393,ECE 200,012,103597,Gilja; Vikash,9999,0,9999,0
1667947565393,ECE 200,013,103598,Hall; Drew A.,9999,0,9999,0
1667947565393,ECE 200,014,103599,Hsueh; Tzu-Chien,9999,0,9999,0
1667947565393,ECE 200,015,103600,Javidi; Tara,9999,0,9999,0
1667947565393,ECE 200,016,103601,Kahng; Andrew Byun,9999,0,9999,0
1667947565393,ECE 200,017,103602,Kim; Young-Han,9999,0,9999,0
1667947565393,ECE 200,018,103603,Koushanfar; Farinaz,9999,0,9999,0
1667947565393,ECE 200,019,103604,Kuzum; Duygu,9999,0,9999,0
1667947565393,ECE 200,020,103605,Le; Hanh-Phuc,9999,0,9999,0
1667947565393,ECE 200,021,103606,Lin; Bill,9999,0,9999,0
1667947565393,ECE 200,022,103607,Liu; Zhaowei,9998,0,9999,1
1667947565393,ECE 200,023,103608,Lo; Yu-Hwa,9999,0,9999,0
1667947565393,ECE 200,024,103609,Lomakin; Vitaliy,9999,0,9999,0
1667947565393,ECE 200,025,103610,Mercier; Patrick Philip,9999,0,9999,0
1667947565393,ECE 200,026,103611,Meyer; Florian,9999,0,9999,0
1667947565393,ECE 200,027,103612,Milstein; Laurence B.,9999,0,9999,0
1667947565393,ECE 200,028,103613,Mir Arabbaygi; Siavash,9999,0,9999,0
1667947565393,ECE 200,029,103614,Mookherjea; Shayan,9999,0,9999,0
1667947565393,ECE 200,030,103615,Morris; Karcher William,9999,0,9999,0
1667947565393,ECE 200,031,103616,Ng; Tse Nga,9999,0,9999,0
1667947565393,ECE 200,032,103617,Nguyen; Truong Quang,9999,0,9999,0
1667947565393,ECE 200,033,103618,Nomura; Kenji,9999,0,9999,0
1667947565393,ECE 200,034,103619,Orlitsky; Alon,9999,0,9999,0
1667947565393,ECE 200,035,103620,Pal; Piya,9999,0,9999,0
1667947565393,ECE 200,036,103621,Papen; George C.,9999,0,9999,0
1667947565393,ECE 200,037,103622,Radic; Stojan,9999,0,9999,0
1667947565393,ECE 200,038,103623,Rao; Bhaskar D.,9999,0,9999,0
1667947565393,ECE 200,039,103624,Rao; Ramesh R,9999,0,9999,0
1667947565393,ECE 200,040,103625,Rebeiz; Gabriel,9999,0,9999,0
1667947565393,ECE 200,041,103626,Sanford; John R,9999,0,9999,0
1667947565393,ECE 200,042,103627,Siegel; Paul H.,9999,0,9999,0
1667947565393,ECE 200,043,103628,Sievenpiper; Daniel F.,9999,0,9999,0
1667947565393,ECE 200,044,103629,Sworder; David D.,9999,0,9999,0
1667947565393,ECE 200,045,103630,Taur; Yuan,9999,0,9999,0
1667947565393,ECE 200,046,103631,Touri; Behrouz,9999,0,9999,0
1667947565393,ECE 200,047,103632,Trivedi; Mohan M.,9999,0,9999,0
1667947565393,ECE 200,048,103633,Vasconcelos; Nuno,9999,0,9999,0
1667947565393,ECE 200,049,103634,Wang; Xiaolong,9999,0,9999,0
1667947565393,ECE 200,050,103635,Xie; Pengtao,9999,0,9999,0
1667947565393,ECE 200,051,103636,Yip; Michael,9999,0,9999,0
1667947565393,ECE 200,052,103637,Zeger; Kenneth A.,999,0,999,0
1667947565393,ECE 200,053,103638,Zhang; Xinyu,9999,0,9999,0
1667947565393,ECE 200,054,103639,Turakhia; Yatish Girish,9999,0,9999,0
1667947565393,ECE 200,055,103640,Kang; Mingu,9999,0,9999,0
1667947565393,ECE 200,056,103641,Shi; Yuanyuan,9999,0,9999,0
1667947565393,ECE 200,057,103642,Wang; Edward Jay,9999,0,9999,0
1667947565393,ECE 200,058,103643,Zheng; Yang,9999,0,9999,0
1667947565826,ECE 202,A00,103644,Kuzum; Duygu,0,0,0,0
1667947566253,ECE 212BN,A00,103646,Ng; Tse Nga,0,0,0,0
1667947566690,ECE 221,A00,111493,Staff,0,0,0,0
1667947567118,ECE 222B,A00,103647,Lomakin; Vitaliy,0,0,0,0
1667947567545,ECE 230B,A00,103648,Taur; Yuan,0,0,0,0
1667947567967,ECE 238B,A00,103649,Garay; Javier,0,0,0,0
1667947568395,ECE 240B,A00,112900,Fainman; Yeshaiahu,0,0,0,0
1667947568820,ECE 247A,A00,103650,Jokerst; Jesse Vincent,0,0,0,0
1667947569251,ECE 247B,A00,103651,Wang; Joseph,0,0,0,0
1667947569681,ECE 250,A00,103652,Siegel; Paul H.,0,0,0,0
1667947570106,ECE 251A,A00,103654,Rao; Bhaskar D.,0,0,0,0
1667947570542,ECE 257B,A00,103655,Bharadia; Dinesh,0,0,0,0
1667947570977,ECE 258A,A00,103656,Milstein; Laurence B.,0,0,0,0
1667947571409,ECE 260B,A00,103658,Kang; Mingu,0,0,0,0
1667947571834,ECE 264A,A00,103659,Galton; Ian A,0,0,0,0
1667947572266,ECE 265A,A00,103661,Gudem; Prasad S.S.,0,0,0,0
1667947572692,ECE 265D,A00,103662,Gudem; Prasad S.S.,0,0,0,0
1667947573124,ECE 268,A00,103663,Koushanfar; Farinaz,0,0,0,0
1667947573554,ECE 269,A01,103665,Pal; Piya,0,0,0,0
1667947573985,ECE 271B,A00,103666,Vasconcelos; Manuela,0,0,0,0
1667947574409,ECE 276A,A00,103667,Atanasov; Nikolay A.,0,0,0,0
1667947574845,ECE 277,A00,103668,An; Cheolhong,0,0,0,0
1667947575354,ECE 279,A00,117947,Hall; Drew A.,0,0,0,0
1667947576217,ECE 283,A00,103670,Hsueh; Tzu-Chien,0,0,0,0
1667947576665,ECE 284,A00,103671,Turakhia; Yatish Girish,0,0,0,0
1667947577088,ECE 285,A00,103672,Zheng; Yang,0,0,0,0
1667947577088,ECE 285,B00,103673,Sworder; David D.,0,0,0,0
1667947577530,ECE 287,A00,103676,Javidi; Tara,0,0,0,0
1667947577954,MATH 200B,A00,098023,Salehi Golsefidy; Alireza,14,0,15,1
1667947578391,MATH 202B,A00,098024,Rhoades; Brendon Patrick,13,0,15,2
1667947578818,MATH 203B,A00,098025,Oprea; Dragos N.,14,0,15,1
1667947579240,MATH 204B,A00,098026,Sorensen; Claus M,15,0,15,0
1667947579665,MATH 208,A00,098027,Izadi; Elham,7,0,10,3
1667947580096,MATH 209,A00,098028,Pollack; Aaron,10,0,10,0
1667947580537,MATH 211A,A00,112919,Rogalski; Daniel,10,0,10,0
1667947580961,MATH 211B,A00,112920,Seward; Brandon M.,10,0,10,0
1667947581394,MATH 218,A00,098029,Li; Bo,10,0,10,0
1667947581839,MATH 220B,A00,098030,Novak; Jonathan I,14,0,15,1
1667947582261,MATH 221A,A00,098031,Ebenfelt; Peter F,14,0,15,1
1667947582690,MATH 231B,A00,098032,Zlatos; Andrej,13,0,15,2
1667947583120,MATH 240B,A00,098033,Ni; Lei,11,0,15,4
1667947583559,MATH 243,A00,098034,Jekel; David Andrew,10,0,10,0
1667947583983,MATH 245A,A00,098035,Nie; Jiawang,4,0,15,11
1667947584420,MATH 248,A00,098036,Bejenaru; Ioan,10,0,10,0
1667947584847,MATH 250B,A00,098037,Spolaor; Luca,14,0,15,1
1667947585267,MATH 258,A00,098038,Ni; Lei,10,0,10,0
1667947585700,MATH 264B,A00,098041,Rhoades; Brendon Patrick,13,0,15,2
1667947586123,MATH 268,A00,098042,Buss; Samuel R,10,0,10,0
1667947586556,MATH 269,A00,098043,Rhoades; Brendon Patrick,10,0,10,0
1667947586992,MATH 270B,A00,098044,Li; Bo,11,0,15,4
1667947587416,MATH 272B,A00,098045,Holst; Michael J,13,0,15,2
1667947587852,MATH 273A,A00,098046,Tian; Xiaochuan,12,0,15,3
1667947588278,MATH 275,A01,098048,Tian; Xiaochuan,6,0,10,4
1667947588718,MATH 278A,A00,098049,Holst; Michael J,8,0,10,2
1667947589151,MATH 278B,A00,098050,Cloninger; Alexander,10,0,10,0
1667947589577,MATH 278C,A00,098051,Nie; Jiawang,7,0,10,3
1667947590012,MATH 280B,A00,098052,Zheng; Tianyi,12,0,15,3
1667947590443,MATH 281B,A00,098053,Bradic; Jelena,4,0,15,11
1667947590873,MATH 282B,A00,098054,Arias-Castro; Ery,2,0,15,13
1667947591305,MATH 285,A00,098055,Fitzsimmons; Patrick J,0,0,15,15
1667947591739,MATH 287B,A00,098056,Arias-Castro; Ery,7,0,15,8
1667947592163,MATH 288,A00,098057,Agarwal; Pooja,9,0,10,1
1667947592163,MATH 288,B00,098058,Zhang; Danna,9,0,10,1
1667947592163,MATH 288,C00,098059,Williams; Ruth J,10,0,10,0
1667947592598,MATH 290B,A00,098060,Roberts; Justin Deritter,14,0,15,1
1667947593019,MATH 292,A00,098061,Belmont; Eva Kinoshita,10,0,10,0
1667947593460,MATH 295,A00,098062,Suk; Andrew Hoon,48,0,50,2
1667947593884,MATH 296,A00,098063,Novak; Jonathan I,20,0,20,0
1667947594306,MATH 297,001,098064,Gamst; Anthony Collins,9997,0,9999,2
1667948109942,COGS 205,A00,101395,Chiba; Andrea,19,0,20,1
1667948110366,COGS 210B,001,101404,Greene; Deanna Jacquelyn,9998,0,9999,1
1667948110366,COGS 210B,002,101417,Xia; Haijun,9999,0,9999,0
1667948110366,COGS 210B,003,101422,Nitz; Douglas A.,9999,0,9999,0
1667948110366,COGS 210B,004,101423,Hollan; James D.,9998,0,9999,1
1667948110366,COGS 210B,005,101424,Deak; Gedeon O.,9999,0,9999,0
1667948110366,COGS 210B,006,101425,Rossano; Federico,9999,0,9999,0
1667948110793,COGS 211B,A00,101427,Coulson; Seana M,9997,0,9999,2
1667948111298,COGS 220,A00,101428,Hollan; James D.,0,0,25,25
1667948111731,COGS 229,A00,101429,Dow; Steven P,18,0,25,7
1667948112157,COGS 230,A00,101430,Klemmer; Scott R,13,0,17,4
1667948112580,COGS 234,A00,101431,Xia; Haijun,8,0,25,17
1667948113011,COGS 260,A00,101432,Kiyonaga; Anastasia,20,0,25,5
1667948113011,COGS 260,B00,101433,Kirsh; David Joel,16,0,25,9
1667948113442,CSE 202,A00,102371,Impagliazzo; Russell,0,0,0,0
1667948113881,CSE 203B,A01,102373,Cheng; Chung Kuan,0,0,0,0
1667948114309,CSE 208,A00,102374,Micciancio; Daniele,0,0,0,0
1667948114739,CSE 209A,A00,112895,Impagliazzo; Russell,0,0,15,15
1667948115169,CSE 209B,A00,108005,Bellare; Mihir,0,0,0,0
1667948115596,CSE 210,A00,113163,Coblenz; Michael J,0,0,0,0
1667948116019,CSE 219,A00,106111,Dow; Steven P,0,0,20,20
1667948116472,CSE 221,A00,102376,Voelker; Geoffrey M.,0,0,0,0
1667948116902,CSE 224,A01,102378,Porter; George M,0,0,0,0
1667948117325,CSE 229A,A00,102379,Savage; Stefan,0,0,0,0
1667948117747,CSE 229C,A00,102380,Munyaka; Imani N. S.,0,0,0,0
1667948118172,CSE 232B,A00,102382,Deutsch; Alin Bernard,0,0,0,0
1667948118597,CSE 234,A01,112904,Kumar; Arun Kumar,0,0,0,0
1667948119024,CSE 237A,A00,102383,Rosing; Tajana Simunic,0,0,0,0
1667948119446,CSE 239A,A00,102384,Deutsch; Alin Bernard,0,0,0,0
1667948119881,CSE 239B,A00,102385,Polikarpova; Nadezhda,0,0,0,0
1667948120305,CSE 240A,A00,102386,Pannuto; Patrick William,0,0,0,0
1667948120728,CSE 240B,A00,102387,Zhao; Jishen,0,0,0,0
1667948121153,CSE 241A,A00,106406,Kang; Mingu,0,0,0,0
1667948121576,CSE 249B,A00,102388,Kahng; Andrew Byun,0,0,8,8
1667948122001,CSE 251B,A01,102392,Cottrell; Garrison W,0,0,0,0
1667948122001,CSE 251B,A02,102393,Cottrell; Garrison W,0,0,0,0
1667948122433,CSE 252B,A00,102394,Ochoa; Benjamin Lawrence,0,0,0,0
1667948122862,CSE 257,A01,102396,Gao; Sicun,0,0,0,0
1667948123287,CSE 272,A00,102397,Li; Tzumao,0,0,0,0
1667948123709,CSE 274,A00,111323,Chern; Albert Ren-Haur,0,0,0,0
1667948124136,CSE 282,A00,102398,Pevzner; Pavel Arkadjevich,0,0,0,0
1667948124574,CSE 284,A00,114175,Gymrek; Melissa Ann,0,0,0,0
1667948125012,CSE 290,A00,102399,Chandraker; Manmohan Krishna,0,0,0,0
1667948125012,CSE 290,B00,102400,Vaccaro; Kristen Marie,0,0,25,25
1667948125012,CSE 290,C00,102414,Pannuto; Patrick William,0,0,25,25
1667948125012,CSE 290,D00,102427,Pevzner; Pavel Arkadjevich,0,0,0,0
1667948125012,CSE 290,E00,102429,Zhao; Jishen,0,0,0,0
1667948125012,CSE 290,F00,102436,Tullsen; Dean Michael,0,0,0,0
1667948125012,CSE 290,G00,102440,Christensen; Henrik I,0,0,20,20
1667948125462,CSE 291,A00,102443,Su; Hao,0,0,0,0
1667948125462,CSE 291,B00,102448,Polikarpova; Nadezhda,0,0,0,0
1667948125462,CSE 291,C00,102453,Vaccaro; Kristen Marie,0,0,0,0
1667948125462,CSE 291,D00,111343,Savage; Stefan,0,0,0,0
1667948125462,CSE 291,E00,116474,Claffy; Kimberly Claire,0,0,0,0
1667948125462,CSE 291,F00,116479,Pasquale; Joseph,0,0,0,0
1667948125913,CSE 293,001,119111,Bafna; Vineet,9999,0,9999,0
1667948125913,CSE 293,002,119118,Bellare; Mihir,9999,0,9999,0
1667948125913,CSE 293,003,119122,Berg-Kirkpatrick; Taylor D,9999,0,9999,0
1667948125913,CSE 293,004,119135,Christensen; Henrik I,9999,0,9999,0
1667948125913,CSE 293,005,119142,Cottrell; Garrison W,9999,0,9999,0
1667948125913,CSE 293,006,119146,Deutsch; Alin Bernard,9999,0,9999,0
1667948125913,CSE 293,007,119159,Esmaeilzadeh; Hadi,9999,0,9999,0
1667948125913,CSE 293,008,119166,Freund; Yoav,9999,0,9999,0
1667948125913,CSE 293,009,119170,Griswold; William G.,9999,0,9999,0
1667948125913,CSE 293,010,119183,Gymrek; Melissa Ann,9998,0,9999,1
1667948125913,CSE 293,011,119190,Heninger; Nadia A,9999,0,9999,0
1667948125913,CSE 293,012,119230,Impagliazzo; Russell,9999,0,9999,0
1667948125913,CSE 293,013,119232,Jhala; Ranjit,9999,0,9999,0
1667948125913,CSE 293,014,119233,Kahng; Andrew Byun,9999,0,9999,0
1667948125913,CSE 293,015,119298,Kane; Daniel Mertz,9999,0,9999,0
1667948125913,CSE 293,016,119299,Kriegman; David J,9999,0,9999,0
1667948125913,CSE 293,017,119300,Kumar; Arun Kumar,9999,0,9999,0
1667948125913,CSE 293,018,119301,Lerner; Sorin,9999,0,9999,0
1667948125913,CSE 293,019,119302,Lovett; Shachar,9999,0,9999,0
1667948125913,CSE 293,020,119303,McAuley; Julian John,9999,0,9999,0
1667948125913,CSE 293,021,119304,Micciancio; Daniele,9999,0,9999,0
1667948125913,CSE 293,022,119367,Orailoglu; Alex,9999,0,9999,0
1667948125913,CSE 293,023,119382,Paturi; Ramamohan,9999,0,9999,0
1667948125913,CSE 293,024,119404,Polikarpova; Nadezhda,9999,0,9999,0
1667948125913,CSE 293,025,119406,Politz; Joseph Gibbs,9999,0,9999,0
1667948125913,CSE 293,026,119411,Porter; George M,9999,0,9999,0
1667948125913,CSE 293,027,119414,Porter; Leonard Emerson,9999,0,9999,0
1667948125913,CSE 293,028,119416,Ramamoorthi; Ravi,9999,0,9999,0
1667948125913,CSE 293,029,119417,Sahoo; Debashis,9999,0,9999,0
1667948125913,CSE 293,030,119420,Saul; Lawrence,9999,0,9999,0
1667948125913,CSE 293,031,119421,Savage; Stefan,9999,0,9999,0
1667948125913,CSE 293,032,119425,Schulze; Jurgen P.,9999,0,9999,0
1667948125913,CSE 293,033,119426,Snoeren; Alex C.,9999,0,9999,0
1667948125913,CSE 293,034,119428,Shang; Jingbo,9999,0,9999,0
1667948125913,CSE 293,035,119430,Stefan; Deian,9999,0,9999,0
1667948125913,CSE 293,036,119431,Su; Hao,9999,0,9999,0
1667948125913,CSE 293,037,119433,Swanson; Steven James,9999,0,9999,0
1667948125913,CSE 293,038,119435,Tullsen; Dean Michael,9999,0,9999,0
1667948125913,CSE 293,039,119483,Voelker; Geoffrey M.,9999,0,9999,0
1667948125913,CSE 293,040,119537,Zhao; Jishen,9999,0,9999,0
1667948125913,CSE 293,041,119538,Zhou; Yuan-Yuan,9999,0,9999,0
1667948125913,CSE 293,042,119539,Gao; Sicun,9999,0,9999,0
1667948125913,CSE 293,043,119540,Weibel; Nadir,9999,0,9999,0
1667948125913,CSE 293,044,119541,Gupta; Rajesh K.,9999,0,9999,0
1667948126337,CSE 294,A00,102459,Voelker; Geoffrey M.,0,0,0,0
1667948126337,CSE 294,B00,111322,Orailoglu; Alex,0,0,0,0
1667948126762,DSE 201,A00,096914,Deutsch; Alin Bernard,30,0,30,0
1667948127201,DSE 210,A00,096915,Dasgupta; Sanjoy,30,0,30,0
1667948127622,DSE 260A,A00,096916,Altintas De Callaf; Ilkay,30,0,30,0
1667948128057,ECE 200,001,103586,Antipa; Nicholas A,9999,0,9999,0
1667948128057,ECE 200,002,103587,Atanasov; Nikolay A.,9999,0,9999,0
1667948128057,ECE 200,003,103588,Bharadia; Dinesh,9999,0,9999,0
1667948128057,ECE 200,004,103589,Cheng; Chung Kuan,9999,0,9999,0
1667948128057,ECE 200,005,103590,Cosman; Pamela C.,9999,0,9999,0
1667948128057,ECE 200,006,103591,Dayeh; Shadi Ahmad,9999,0,9999,0
1667948128057,ECE 200,007,103592,Fainman; Yeshaiahu,9999,0,9999,0
1667948128057,ECE 200,008,103593,Ford; Joseph Earl,9999,0,9999,0
1667948128057,ECE 200,009,103594,Franceschetti; Massimo,9999,0,9999,0
1667948128057,ECE 200,010,103595,Fullerton; Eric E,9999,0,9999,0
1667948128057,ECE 200,011,103596,Galton; Ian A,9999,0,9999,0
1667948128057,ECE 200,012,103597,Gilja; Vikash,9999,0,9999,0
1667948128057,ECE 200,013,103598,Hall; Drew A.,9999,0,9999,0
1667948128057,ECE 200,014,103599,Hsueh; Tzu-Chien,9999,0,9999,0
1667948128057,ECE 200,015,103600,Javidi; Tara,9999,0,9999,0
1667948128057,ECE 200,016,103601,Kahng; Andrew Byun,9999,0,9999,0
1667948128057,ECE 200,017,103602,Kim; Young-Han,9999,0,9999,0
1667948128057,ECE 200,018,103603,Koushanfar; Farinaz,9999,0,9999,0
1667948128057,ECE 200,019,103604,Kuzum; Duygu,9999,0,9999,0
1667948128057,ECE 200,020,103605,Le; Hanh-Phuc,9999,0,9999,0
1667948128057,ECE 200,021,103606,Lin; Bill,9999,0,9999,0
1667948128057,ECE 200,022,103607,Liu; Zhaowei,9998,0,9999,1
1667948128057,ECE 200,023,103608,Lo; Yu-Hwa,9999,0,9999,0
1667948128057,ECE 200,024,103609,Lomakin; Vitaliy,9999,0,9999,0
1667948128057,ECE 200,025,103610,Mercier; Patrick Philip,9999,0,9999,0
1667948128057,ECE 200,026,103611,Meyer; Florian,9999,0,9999,0
1667948128057,ECE 200,027,103612,Milstein; Laurence B.,9999,0,9999,0
1667948128057,ECE 200,028,103613,Mir Arabbaygi; Siavash,9999,0,9999,0
1667948128057,ECE 200,029,103614,Mookherjea; Shayan,9999,0,9999,0
1667948128057,ECE 200,030,103615,Morris; Karcher William,9999,0,9999,0
1667948128057,ECE 200,031,103616,Ng; Tse Nga,9999,0,9999,0
1667948128057,ECE 200,032,103617,Nguyen; Truong Quang,9999,0,9999,0
1667948128057,ECE 200,033,103618,Nomura; Kenji,9999,0,9999,0
1667948128057,ECE 200,034,103619,Orlitsky; Alon,9999,0,9999,0
1667948128057,ECE 200,035,103620,Pal; Piya,9999,0,9999,0
1667948128057,ECE 200,036,103621,Papen; George C.,9999,0,9999,0
1667948128057,ECE 200,037,103622,Radic; Stojan,9999,0,9999,0
1667948128057,ECE 200,038,103623,Rao; Bhaskar D.,9999,0,9999,0
1667948128057,ECE 200,039,103624,Rao; Ramesh R,9999,0,9999,0
1667948128057,ECE 200,040,103625,Rebeiz; Gabriel,9999,0,9999,0
1667948128057,ECE 200,041,103626,Sanford; John R,9999,0,9999,0
1667948128057,ECE 200,042,103627,Siegel; Paul H.,9999,0,9999,0
1667948128057,ECE 200,043,103628,Sievenpiper; Daniel F.,9999,0,9999,0
1667948128057,ECE 200,044,103629,Sworder; David D.,9999,0,9999,0
1667948128057,ECE 200,045,103630,Taur; Yuan,9999,0,9999,0
1667948128057,ECE 200,046,103631,Touri; Behrouz,9999,0,9999,0
1667948128057,ECE 200,047,103632,Trivedi; Mohan M.,9999,0,9999,0
1667948128057,ECE 200,048,103633,Vasconcelos; Nuno,9999,0,9999,0
1667948128057,ECE 200,049,103634,Wang; Xiaolong,9999,0,9999,0
1667948128057,ECE 200,050,103635,Xie; Pengtao,9999,0,9999,0
1667948128057,ECE 200,051,103636,Yip; Michael,9999,0,9999,0
1667948128057,ECE 200,052,103637,Zeger; Kenneth A.,999,0,999,0
1667948128057,ECE 200,053,103638,Zhang; Xinyu,9999,0,9999,0
1667948128057,ECE 200,054,103639,Turakhia; Yatish Girish,9999,0,9999,0
1667948128057,ECE 200,055,103640,Kang; Mingu,9999,0,9999,0
1667948128057,ECE 200,056,103641,Shi; Yuanyuan,9999,0,9999,0
1667948128057,ECE 200,057,103642,Wang; Edward Jay,9999,0,9999,0
1667948128057,ECE 200,058,103643,Zheng; Yang,9999,0,9999,0
1667948128493,ECE 202,A00,103644,Kuzum; Duygu,0,0,0,0
1667948128919,ECE 212BN,A00,103646,Ng; Tse Nga,0,0,0,0
1667948129342,ECE 221,A00,111493,Staff,0,0,0,0
1667948129765,ECE 222B,A00,103647,Lomakin; Vitaliy,0,0,0,0
1667948130198,ECE 230B,A00,103648,Taur; Yuan,0,0,0,0
1667948130622,ECE 238B,A00,103649,Garay; Javier,0,0,0,0
1667948131045,ECE 240B,A00,112900,Fainman; Yeshaiahu,0,0,0,0
1667948131468,ECE 247A,A00,103650,Jokerst; Jesse Vincent,0,0,0,0
1667948131889,ECE 247B,A00,103651,Wang; Joseph,0,0,0,0
1667948132314,ECE 250,A00,103652,Siegel; Paul H.,0,0,0,0
1667948132738,ECE 251A,A00,103654,Rao; Bhaskar D.,0,0,0,0
1667948133164,ECE 257B,A00,103655,Bharadia; Dinesh,0,0,0,0
1667948133594,ECE 258A,A00,103656,Milstein; Laurence B.,0,0,0,0
1667948134018,ECE 260B,A00,103658,Kang; Mingu,0,0,0,0
1667948134441,ECE 264A,A00,103659,Galton; Ian A,0,0,0,0
1667948134872,ECE 265A,A00,103661,Gudem; Prasad S.S.,0,0,0,0
1667948135298,ECE 265D,A00,103662,Gudem; Prasad S.S.,0,0,0,0
1667948135719,ECE 268,A00,103663,Koushanfar; Farinaz,0,0,0,0
1667948136142,ECE 269,A01,103665,Pal; Piya,0,0,0,0
1667948136563,ECE 271B,A00,103666,Vasconcelos; Manuela,0,0,0,0
1667948136986,ECE 276A,A00,103667,Atanasov; Nikolay A.,0,0,0,0
1667948137419,ECE 277,A00,103668,An; Cheolhong,0,0,0,0
1667948137849,ECE 279,A00,117947,Hall; Drew A.,0,0,0,0
1667948138699,ECE 283,A00,103670,Hsueh; Tzu-Chien,0,0,0,0
1667948139123,ECE 284,A00,103671,Turakhia; Yatish Girish,0,0,0,0
1667948139553,ECE 285,A00,103672,Zheng; Yang,0,0,0,0
1667948139553,ECE 285,B00,103673,Sworder; David D.,0,0,0,0
1667948139978,ECE 287,A00,103676,Javidi; Tara,0,0,0,0
1667948140414,MATH 200B,A00,098023,Salehi Golsefidy; Alireza,14,0,15,1
1667948140841,MATH 202B,A00,098024,Rhoades; Brendon Patrick,13,0,15,2
1667948141266,MATH 203B,A00,098025,Oprea; Dragos N.,14,0,15,1
1667948141691,MATH 204B,A00,098026,Sorensen; Claus M,15,0,15,0
1667948142114,MATH 208,A00,098027,Izadi; Elham,7,0,10,3
1667948142546,MATH 209,A00,098028,Pollack; Aaron,10,0,10,0
1667948142974,MATH 211A,A00,112919,Rogalski; Daniel,10,0,10,0
1667948143414,MATH 211B,A00,112920,Seward; Brandon M.,10,0,10,0
1667948143840,MATH 218,A00,098029,Li; Bo,10,0,10,0
1667948144266,MATH 220B,A00,098030,Novak; Jonathan I,14,0,15,1
1667948144695,MATH 221A,A00,098031,Ebenfelt; Peter F,14,0,15,1
1667948145122,MATH 231B,A00,098032,Zlatos; Andrej,13,0,15,2
1667948145543,MATH 240B,A00,098033,Ni; Lei,11,0,15,4
1667948145974,MATH 243,A00,098034,Jekel; David Andrew,10,0,10,0
1667948146409,MATH 245A,A00,098035,Nie; Jiawang,4,0,15,11
1667948146833,MATH 248,A00,098036,Bejenaru; Ioan,10,0,10,0
1667948147268,MATH 250B,A00,098037,Spolaor; Luca,14,0,15,1
1667948147694,MATH 258,A00,098038,Ni; Lei,10,0,10,0
1667948148124,MATH 264B,A00,098041,Rhoades; Brendon Patrick,13,0,15,2
1667948148549,MATH 268,A00,098042,Buss; Samuel R,10,0,10,0
1667948148981,MATH 269,A00,098043,Rhoades; Brendon Patrick,10,0,10,0
1667948149413,MATH 270B,A00,098044,Li; Bo,11,0,15,4
1667948149842,MATH 272B,A00,098045,Holst; Michael J,13,0,15,2
1667948150267,MATH 273A,A00,098046,Tian; Xiaochuan,12,0,15,3
1667948150693,MATH 275,A01,098048,Tian; Xiaochuan,6,0,10,4
1667948151119,MATH 278A,A00,098049,Holst; Michael J,8,0,10,2
1667948151544,MATH 278B,A00,098050,Cloninger; Alexander,10,0,10,0
1667948151966,MATH 278C,A00,098051,Nie; Jiawang,7,0,10,3
1667948152414,MATH 280B,A00,098052,Zheng; Tianyi,12,0,15,3
1667948152837,MATH 281B,A00,098053,Bradic; Jelena,4,0,15,11
1667948153266,MATH 282B,A00,098054,Arias-Castro; Ery,2,0,15,13
1667948153692,MATH 285,A00,098055,Fitzsimmons; Patrick J,0,0,15,15
1667948154118,MATH 287B,A00,098056,Arias-Castro; Ery,7,0,15,8
1667948154648,MATH 288,A00,098057,Agarwal; Pooja,9,0,10,1
1667948154648,MATH 288,B00,098058,Zhang; Danna,9,0,10,1
1667948154648,MATH 288,C00,098059,Williams; Ruth J,10,0,10,0
1667948155073,MATH 290B,A00,098060,Roberts; Justin Deritter,14,0,15,1
1667948155496,MATH 292,A00,098061,Belmont; Eva Kinoshita,10,0,10,0
1667948155923,MATH 295,A00,098062,Suk; Andrew Hoon,48,0,50,2
1667948156361,MATH 296,A00,098063,Novak; Jonathan I,20,0,20,0
1667948156782,MATH 297,001,098064,Gamst; Anthony Collins,9997,0,9999,2
1667948660997,COGS 205,A00,101395,Chiba; Andrea,19,0,20,1
1667948661421,COGS 210B,001,101404,Greene; Deanna Jacquelyn,9998,0,9999,1
1667948661421,COGS 210B,002,101417,Xia; Haijun,9999,0,9999,0
1667948661421,COGS 210B,003,101422,Nitz; Douglas A.,9999,0,9999,0
1667948661421,COGS 210B,004,101423,Hollan; James D.,9998,0,9999,1
1667948661421,COGS 210B,005,101424,Deak; Gedeon O.,9999,0,9999,0
1667948661421,COGS 210B,006,101425,Rossano; Federico,9999,0,9999,0
1667948661854,COGS 211B,A00,101427,Coulson; Seana M,9997,0,9999,2
1667948662279,COGS 220,A00,101428,Hollan; James D.,0,0,25,25
1667948662713,COGS 229,A00,101429,Dow; Steven P,18,0,25,7
1667948663144,COGS 230,A00,101430,Klemmer; Scott R,13,0,17,4
1667948663570,COGS 234,A00,101431,Xia; Haijun,8,0,25,17
1667948663994,COGS 260,A00,101432,Kiyonaga; Anastasia,20,0,25,5
1667948663994,COGS 260,B00,101433,Kirsh; David Joel,16,0,25,9
1667948664422,CSE 202,A00,102371,Impagliazzo; Russell,0,0,0,0
1667948664855,CSE 203B,A01,102373,Cheng; Chung Kuan,0,0,0,0
1667948665287,CSE 208,A00,102374,Micciancio; Daniele,0,0,0,0
1667948665713,CSE 209A,A00,112895,Impagliazzo; Russell,0,0,15,15
1667948666137,CSE 209B,A00,108005,Bellare; Mihir,0,0,0,0
1667948666569,CSE 210,A00,113163,Coblenz; Michael J,0,0,0,0
1667948666999,CSE 219,A00,106111,Dow; Steven P,0,0,20,20
1667948667423,CSE 221,A00,102376,Voelker; Geoffrey M.,0,0,0,0
1667948667846,CSE 224,A01,102378,Porter; George M,0,0,0,0
1667948668273,CSE 229A,A00,102379,Savage; Stefan,0,0,0,0
1667948668701,CSE 229C,A00,102380,Munyaka; Imani N. S.,0,0,0,0
1667948669134,CSE 232B,A00,102382,Deutsch; Alin Bernard,0,0,0,0
1667948669558,CSE 234,A01,112904,Kumar; Arun Kumar,0,0,0,0
1667948670002,CSE 237A,A00,102383,Rosing; Tajana Simunic,0,0,0,0
1667948670424,CSE 239A,A00,102384,Deutsch; Alin Bernard,0,0,0,0
1667948670846,CSE 239B,A00,102385,Polikarpova; Nadezhda,0,0,0,0
1667948671270,CSE 240A,A00,102386,Pannuto; Patrick William,0,0,0,0
1667948671697,CSE 240B,A00,102387,Zhao; Jishen,0,0,0,0
1667948672123,CSE 241A,A00,106406,Kang; Mingu,0,0,0,0
1667948672548,CSE 249B,A00,102388,Kahng; Andrew Byun,0,0,8,8
1667948672980,CSE 251B,A01,102392,Cottrell; Garrison W,0,0,0,0
1667948672980,CSE 251B,A02,102393,Cottrell; Garrison W,0,0,0,0
1667948673403,CSE 252B,A00,102394,Ochoa; Benjamin Lawrence,0,0,0,0
1667948673826,CSE 257,A01,102396,Gao; Sicun,0,0,0,0
1667948674257,CSE 272,A00,102397,Li; Tzumao,0,0,0,0
1667948674702,CSE 274,A00,111323,Chern; Albert Ren-Haur,0,0,0,0
1667948675133,CSE 282,A00,102398,Pevzner; Pavel Arkadjevich,0,0,0,0
1667948675556,CSE 284,A00,114175,Gymrek; Melissa Ann,0,0,0,0
1667948675987,CSE 290,A00,102399,Chandraker; Manmohan Krishna,0,0,0,0
1667948675987,CSE 290,B00,102400,Vaccaro; Kristen Marie,0,0,25,25
1667948675987,CSE 290,C00,102414,Pannuto; Patrick William,0,0,25,25
1667948675987,CSE 290,D00,102427,Pevzner; Pavel Arkadjevich,0,0,0,0
1667948675987,CSE 290,E00,102429,Zhao; Jishen,0,0,0,0
1667948675987,CSE 290,F00,102436,Tullsen; Dean Michael,0,0,0,0
1667948675987,CSE 290,G00,102440,Christensen; Henrik I,0,0,20,20
1667948676415,CSE 291,A00,102443,Su; Hao,0,0,0,0
1667948676415,CSE 291,B00,102448,Polikarpova; Nadezhda,0,0,0,0
1667948676415,CSE 291,C00,102453,Vaccaro; Kristen Marie,0,0,0,0
1667948676415,CSE 291,D00,111343,Savage; Stefan,0,0,0,0
1667948676415,CSE 291,E00,116474,Claffy; Kimberly Claire,0,0,0,0
1667948676415,CSE 291,F00,116479,Pasquale; Joseph,0,0,0,0
1667948676846,CSE 293,001,119111,Bafna; Vineet,9999,0,9999,0
1667948676846,CSE 293,002,119118,Bellare; Mihir,9999,0,9999,0
1667948676846,CSE 293,003,119122,Berg-Kirkpatrick; Taylor D,9999,0,9999,0
1667948676846,CSE 293,004,119135,Christensen; Henrik I,9999,0,9999,0
1667948676846,CSE 293,005,119142,Cottrell; Garrison W,9999,0,9999,0
1667948676846,CSE 293,006,119146,Deutsch; Alin Bernard,9999,0,9999,0
1667948676846,CSE 293,007,119159,Esmaeilzadeh; Hadi,9999,0,9999,0
1667948676846,CSE 293,008,119166,Freund; Yoav,9999,0,9999,0
1667948676846,CSE 293,009,119170,Griswold; William G.,9999,0,9999,0
1667948676846,CSE 293,010,119183,Gymrek; Melissa Ann,9998,0,9999,1
1667948676846,CSE 293,011,119190,Heninger; Nadia A,9999,0,9999,0
1667948676846,CSE 293,012,119230,Impagliazzo; Russell,9999,0,9999,0
1667948676846,CSE 293,013,119232,Jhala; Ranjit,9999,0,9999,0
1667948676846,CSE 293,014,119233,Kahng; Andrew Byun,9999,0,9999,0
1667948676846,CSE 293,015,119298,Kane; Daniel Mertz,9999,0,9999,0
1667948676846,CSE 293,016,119299,Kriegman; David J,9999,0,9999,0
1667948676846,CSE 293,017,119300,Kumar; Arun Kumar,9999,0,9999,0
1667948676846,CSE 293,018,119301,Lerner; Sorin,9999,0,9999,0
1667948676846,CSE 293,019,119302,Lovett; Shachar,9999,0,9999,0
1667948676846,CSE 293,020,119303,McAuley; Julian John,9999,0,9999,0
1667948676846,CSE 293,021,119304,Micciancio; Daniele,9999,0,9999,0
1667948676846,CSE 293,022,119367,Orailoglu; Alex,9999,0,9999,0
1667948676846,CSE 293,023,119382,Paturi; Ramamohan,9999,0,9999,0
1667948676846,CSE 293,024,119404,Polikarpova; Nadezhda,9999,0,9999,0
1667948676846,CSE 293,025,119406,Politz; Joseph Gibbs,9999,0,9999,0
1667948676846,CSE 293,026,119411,Porter; George M,9999,0,9999,0
1667948676846,CSE 293,027,119414,Porter; Leonard Emerson,9999,0,9999,0
1667948676846,CSE 293,028,119416,Ramamoorthi; Ravi,9999,0,9999,0
1667948676846,CSE 293,029,119417,Sahoo; Debashis,9999,0,9999,0
1667948676846,CSE 293,030,119420,Saul; Lawrence,9999,0,9999,0
1667948676846,CSE 293,031,119421,Savage; Stefan,9999,0,9999,0
1667948676846,CSE 293,032,119425,Schulze; Jurgen P.,9999,0,9999,0
1667948676846,CSE 293,033,119426,Snoeren; Alex C.,9999,0,9999,0
1667948676846,CSE 293,034,119428,Shang; Jingbo,9999,0,9999,0
1667948676846,CSE 293,035,119430,Stefan; Deian,9999,0,9999,0
1667948676846,CSE 293,036,119431,Su; Hao,9999,0,9999,0
1667948676846,CSE 293,037,119433,Swanson; Steven James,9999,0,9999,0
1667948676846,CSE 293,038,119435,Tullsen; Dean Michael,9999,0,9999,0
1667948676846,CSE 293,039,119483,Voelker; Geoffrey M.,9999,0,9999,0
1667948676846,CSE 293,040,119537,Zhao; Jishen,9999,0,9999,0
1667948676846,CSE 293,041,119538,Zhou; Yuan-Yuan,9999,0,9999,0
1667948676846,CSE 293,042,119539,Gao; Sicun,9999,0,9999,0
1667948676846,CSE 293,043,119540,Weibel; Nadir,9999,0,9999,0
1667948676846,CSE 293,044,119541,Gupta; Rajesh K.,9999,0,9999,0
1667948677273,CSE 294,A00,102459,Voelker; Geoffrey M.,0,0,0,0
1667948677273,CSE 294,B00,111322,Orailoglu; Alex,0,0,0,0
1667948677706,DSE 201,A00,096914,Deutsch; Alin Bernard,30,0,30,0
1667948678130,DSE 210,A00,096915,Dasgupta; Sanjoy,30,0,30,0
1667948678554,DSE 260A,A00,096916,Altintas De Callaf; Ilkay,30,0,30,0
1667948679096,ECE 200,001,103586,Antipa; Nicholas A,9999,0,9999,0
1667948679096,ECE 200,002,103587,Atanasov; Nikolay A.,9999,0,9999,0
1667948679096,ECE 200,003,103588,Bharadia; Dinesh,9999,0,9999,0
1667948679096,ECE 200,004,103589,Cheng; Chung Kuan,9999,0,9999,0
1667948679096,ECE 200,005,103590,Cosman; Pamela C.,9999,0,9999,0
1667948679096,ECE 200,006,103591,Dayeh; Shadi Ahmad,9999,0,9999,0
1667948679096,ECE 200,007,103592,Fainman; Yeshaiahu,9999,0,9999,0
1667948679096,ECE 200,008,103593,Ford; Joseph Earl,9999,0,9999,0
1667948679096,ECE 200,009,103594,Franceschetti; Massimo,9999,0,9999,0
1667948679096,ECE 200,010,103595,Fullerton; Eric E,9999,0,9999,0
1667948679096,ECE 200,011,103596,Galton; Ian A,9999,0,9999,0
1667948679096,ECE 200,012,103597,Gilja; Vikash,9999,0,9999,0
1667948679096,ECE 200,013,103598,Hall; Drew A.,9999,0,9999,0
1667948679096,ECE 200,014,103599,Hsueh; Tzu-Chien,9999,0,9999,0
1667948679096,ECE 200,015,103600,Javidi; Tara,9999,0,9999,0
1667948679096,ECE 200,016,103601,Kahng; Andrew Byun,9999,0,9999,0
1667948679096,ECE 200,017,103602,Kim; Young-Han,9999,0,9999,0
1667948679096,ECE 200,018,103603,Koushanfar; Farinaz,9999,0,9999,0
1667948679096,ECE 200,019,103604,Kuzum; Duygu,9999,0,9999,0
1667948679096,ECE 200,020,103605,Le; Hanh-Phuc,9999,0,9999,0
1667948679096,ECE 200,021,103606,Lin; Bill,9999,0,9999,0
1667948679096,ECE 200,022,103607,Liu; Zhaowei,9998,0,9999,1
1667948679096,ECE 200,023,103608,Lo; Yu-Hwa,9999,0,9999,0
1667948679096,ECE 200,024,103609,Lomakin; Vitaliy,9999,0,9999,0
1667948679096,ECE 200,025,103610,Mercier; Patrick Philip,9999,0,9999,0
1667948679096,ECE 200,026,103611,Meyer; Florian,9999,0,9999,0
1667948679096,ECE 200,027,103612,Milstein; Laurence B.,9999,0,9999,0
1667948679096,ECE 200,028,103613,Mir Arabbaygi; Siavash,9999,0,9999,0
1667948679096,ECE 200,029,103614,Mookherjea; Shayan,9999,0,9999,0
1667948679096,ECE 200,030,103615,Morris; Karcher William,9999,0,9999,0
1667948679096,ECE 200,031,103616,Ng; Tse Nga,9999,0,9999,0
1667948679096,ECE 200,032,103617,Nguyen; Truong Quang,9999,0,9999,0
1667948679096,ECE 200,033,103618,Nomura; Kenji,9999,0,9999,0
1667948679096,ECE 200,034,103619,Orlitsky; Alon,9999,0,9999,0
1667948679096,ECE 200,035,103620,Pal; Piya,9999,0,9999,0
1667948679096,ECE 200,036,103621,Papen; George C.,9999,0,9999,0
1667948679096,ECE 200,037,103622,Radic; Stojan,9999,0,9999,0
1667948679096,ECE 200,038,103623,Rao; Bhaskar D.,9999,0,9999,0
1667948679096,ECE 200,039,103624,Rao; Ramesh R,9999,0,9999,0
1667948679096,ECE 200,040,103625,Rebeiz; Gabriel,9999,0,9999,0
1667948679096,ECE 200,041,103626,Sanford; John R,9999,0,9999,0
1667948679096,ECE 200,042,103627,Siegel; Paul H.,9999,0,9999,0
1667948679096,ECE 200,043,103628,Sievenpiper; Daniel F.,9999,0,9999,0
1667948679096,ECE 200,044,103629,Sworder; David D.,9999,0,9999,0
1667948679096,ECE 200,045,103630,Taur; Yuan,9999,0,9999,0
1667948679096,ECE 200,046,103631,Touri; Behrouz,9999,0,9999,0
1667948679096,ECE 200,047,103632,Trivedi; Mohan M.,9999,0,9999,0
1667948679096,ECE 200,048,103633,Vasconcelos; Nuno,9999,0,9999,0
1667948679096,ECE 200,049,103634,Wang; Xiaolong,9999,0,9999,0
1667948679096,ECE 200,050,103635,Xie; Pengtao,9999,0,9999,0
1667948679096,ECE 200,051,103636,Yip; Michael,9999,0,9999,0
1667948679096,ECE 200,052,103637,Zeger; Kenneth A.,999,0,999,0
1667948679096,ECE 200,053,103638,Zhang; Xinyu,9999,0,9999,0
1667948679096,ECE 200,054,103639,Turakhia; Yatish Girish,9999,0,9999,0
1667948679096,ECE 200,055,103640,Kang; Mingu,9999,0,9999,0
1667948679096,ECE 200,056,103641,Shi; Yuanyuan,9999,0,9999,0
1667948679096,ECE 200,057,103642,Wang; Edward Jay,9999,0,9999,0
1667948679096,ECE 200,058,103643,Zheng; Yang,9999,0,9999,0
1667948679518,ECE 202,A00,103644,Kuzum; Duygu,0,0,0,0
1667948679943,ECE 212BN,A00,103646,Ng; Tse Nga,0,0,0,0
1667948680373,ECE 221,A00,111493,Staff,0,0,0,0
1667948680805,ECE 222B,A00,103647,Lomakin; Vitaliy,0,0,0,0
1667948681233,ECE 230B,A00,103648,Taur; Yuan,0,0,0,0
1667948681658,ECE 238B,A00,103649,Garay; Javier,0,0,0,0
1667948682085,ECE 240B,A00,112900,Fainman; Yeshaiahu,0,0,0,0
1667948682511,ECE 247A,A00,103650,Jokerst; Jesse Vincent,0,0,0,0
1667948682937,ECE 247B,A00,103651,Wang; Joseph,0,0,0,0
1667948683369,ECE 250,A00,103652,Siegel; Paul H.,0,0,0,0
1667948683797,ECE 251A,A00,103654,Rao; Bhaskar D.,0,0,0,0
1667948684221,ECE 257B,A00,103655,Bharadia; Dinesh,0,0,0,0
1667948684646,ECE 258A,A00,103656,Milstein; Laurence B.,0,0,0,0
1667948685081,ECE 260B,A00,103658,Kang; Mingu,0,0,0,0
1667948685506,ECE 264A,A00,103659,Galton; Ian A,0,0,0,0
1667948685928,ECE 265A,A00,103661,Gudem; Prasad S.S.,0,0,0,0
1667948686375,ECE 265D,A00,103662,Gudem; Prasad S.S.,0,0,0,0
1667948686801,ECE 268,A00,103663,Koushanfar; Farinaz,0,0,0,0
1667948687235,ECE 269,A01,103665,Pal; Piya,0,0,0,0
1667948687667,ECE 271B,A00,103666,Vasconcelos; Manuela,0,0,0,0
1667948688100,ECE 276A,A00,103667,Atanasov; Nikolay A.,0,0,0,0
1667948688524,ECE 277,A00,103668,An; Cheolhong,0,0,0,0
1667948688952,ECE 279,A00,117947,Hall; Drew A.,0,0,0,0
1667948689810,ECE 283,A00,103670,Hsueh; Tzu-Chien,0,0,0,0
1667948690236,ECE 284,A00,103671,Turakhia; Yatish Girish,0,0,0,0
1667948690669,ECE 285,A00,103672,Zheng; Yang,0,0,0,0
1667948690669,ECE 285,B00,103673,Sworder; David D.,0,0,0,0
1667948691100,ECE 287,A00,103676,Javidi; Tara,0,0,0,0
1667948691705,MATH 200B,A00,098023,Salehi Golsefidy; Alireza,14,0,15,1
1667948692133,MATH 202B,A00,098024,Rhoades; Brendon Patrick,13,0,15,2
1667948692570,MATH 203B,A00,098025,Oprea; Dragos N.,14,0,15,1
1667948692994,MATH 204B,A00,098026,Sorensen; Claus M,15,0,15,0
1667948693426,MATH 208,A00,098027,Izadi; Elham,7,0,10,3
1667948693848,MATH 209,A00,098028,Pollack; Aaron,10,0,10,0
1667948694273,MATH 211A,A00,112919,Rogalski; Daniel,10,0,10,0
1667948694700,MATH 211B,A00,112920,Seward; Brandon M.,10,0,10,0
1667948695122,MATH 218,A00,098029,Li; Bo,10,0,10,0
1667948695558,MATH 220B,A00,098030,Novak; Jonathan I,14,0,15,1
1667948695983,MATH 221A,A00,098031,Ebenfelt; Peter F,14,0,15,1
1667948696405,MATH 231B,A00,098032,Zlatos; Andrej,13,0,15,2
1667948696841,MATH 240B,A00,098033,Ni; Lei,11,0,15,4
1667948697265,MATH 243,A00,098034,Jekel; David Andrew,10,0,10,0
1667948697690,MATH 245A,A00,098035,Nie; Jiawang,3,0,15,12
1667948698114,MATH 248,A00,098036,Bejenaru; Ioan,10,0,10,0
1667948698552,MATH 250B,A00,098037,Spolaor; Luca,14,0,15,1
1667948698976,MATH 258,A00,098038,Ni; Lei,10,0,10,0
1667948699407,MATH 264B,A00,098041,Rhoades; Brendon Patrick,13,0,15,2
1667948699833,MATH 268,A00,098042,Buss; Samuel R,10,0,10,0
1667948700258,MATH 269,A00,098043,Rhoades; Brendon Patrick,10,0,10,0
1667948700681,MATH 270B,A00,098044,Li; Bo,11,0,15,4
1667948701111,MATH 272B,A00,098045,Holst; Michael J,13,0,15,2
1667948701539,MATH 273A,A00,098046,Tian; Xiaochuan,12,0,15,3
1667948701965,MATH 275,A01,098048,Tian; Xiaochuan,6,0,10,4
1667948702401,MATH 278A,A00,098049,Holst; Michael J,8,0,10,2
1667948702831,MATH 278B,A00,098050,Cloninger; Alexander,10,0,10,0
1667948703272,MATH 278C,A00,098051,Nie; Jiawang,7,0,10,3
1667948703693,MATH 280B,A00,098052,Zheng; Tianyi,12,0,15,3
1667948704119,MATH 281B,A00,098053,Bradic; Jelena,4,0,15,11
1667948704550,MATH 282B,A00,098054,Arias-Castro; Ery,2,0,15,13
1667948704974,MATH 285,A00,098055,Fitzsimmons; Patrick J,0,0,15,15
1667948705398,MATH 287B,A00,098056,Arias-Castro; Ery,7,0,15,8
1667948705830,MATH 288,A00,098057,Agarwal; Pooja,9,0,10,1
1667948705830,MATH 288,B00,098058,Zhang; Danna,9,0,10,1
1667948705830,MATH 288,C00,098059,Williams; Ruth J,10,0,10,0
1667948706263,MATH 290B,A00,098060,Roberts; Justin Deritter,14,0,15,1
1667948706698,MATH 292,A00,098061,Belmont; Eva Kinoshita,10,0,10,0
1667948707126,MATH 295,A00,098062,Suk; Andrew Hoon,48,0,50,2
1667948707555,MATH 296,A00,098063,Novak; Jonathan I,20,0,20,0
1667948707978,MATH 297,001,098064,Gamst; Anthony Collins,9997,0,9999,2
1667949211378,COGS 205,A00,101395,Chiba; Andrea,19,0,20,1
1667949211802,COGS 210B,001,101404,Greene; Deanna Jacquelyn,9998,0,9999,1
1667949211802,COGS 210B,002,101417,Xia; Haijun,9999,0,9999,0
1667949211802,COGS 210B,003,101422,Nitz; Douglas A.,9999,0,9999,0
1667949211802,COGS 210B,004,101423,Hollan; James D.,9998,0,9999,1
1667949211802,COGS 210B,005,101424,Deak; Gedeon O.,9999,0,9999,0
1667949211802,COGS 210B,006,101425,Rossano; Federico,9999,0,9999,0
1667949212241,COGS 211B,A00,101427,Coulson; Seana M,9997,0,9999,2
1667949212671,COGS 220,A00,101428,Hollan; James D.,0,0,25,25
1667949213108,COGS 229,A00,101429,Dow; Steven P,18,0,25,7
1667949213531,COGS 230,A00,101430,Klemmer; Scott R,13,0,17,4
1667949213973,COGS 234,A00,101431,Xia; Haijun,8,0,25,17
1667949214401,COGS 260,A00,101432,Kiyonaga; Anastasia,20,0,25,5
1667949214401,COGS 260,B00,101433,Kirsh; David Joel,16,0,25,9
1667949214842,CSE 202,A00,102371,Impagliazzo; Russell,0,0,0,0
1667949215265,CSE 203B,A01,102373,Cheng; Chung Kuan,0,0,0,0
1667949215691,CSE 208,A00,102374,Micciancio; Daniele,0,0,0,0
1667949216130,CSE 209A,A00,112895,Impagliazzo; Russell,0,0,15,15
1667949216564,CSE 209B,A00,108005,Bellare; Mihir,0,0,0,0
1667949216995,CSE 210,A00,113163,Coblenz; Michael J,0,0,0,0
1667949217433,CSE 219,A00,106111,Dow; Steven P,0,0,20,20
1667949217856,CSE 221,A00,102376,Voelker; Geoffrey M.,0,0,0,0
1667949218283,CSE 224,A01,102378,Porter; George M,0,0,0,0
1667949218707,CSE 229A,A00,102379,Savage; Stefan,0,0,0,0
1667949219132,CSE 229C,A00,102380,Munyaka; Imani N. S.,0,0,0,0
1667949219561,CSE 232B,A00,102382,Deutsch; Alin Bernard,0,0,0,0
1667949219996,CSE 234,A01,112904,Kumar; Arun Kumar,0,0,0,0
1667949220420,CSE 237A,A00,102383,Rosing; Tajana Simunic,0,0,0,0
1667949220850,CSE 239A,A00,102384,Deutsch; Alin Bernard,0,0,0,0
1667949221275,CSE 239B,A00,102385,Polikarpova; Nadezhda,0,0,0,0
1667949221698,CSE 240A,A00,102386,Pannuto; Patrick William,0,0,0,0
1667949222122,CSE 240B,A00,102387,Zhao; Jishen,0,0,0,0
1667949222561,CSE 241A,A00,106406,Kang; Mingu,0,0,0,0
1667949222987,CSE 249B,A00,102388,Kahng; Andrew Byun,0,0,8,8
1667949223412,CSE 251B,A01,102392,Cottrell; Garrison W,0,0,0,0
1667949223412,CSE 251B,A02,102393,Cottrell; Garrison W,0,0,0,0
1667949223835,CSE 252B,A00,102394,Ochoa; Benjamin Lawrence,0,0,0,0
1667949224258,CSE 257,A01,102396,Gao; Sicun,0,0,0,0
1667949224684,CSE 272,A00,102397,Li; Tzumao,0,0,0,0
1667949225111,CSE 274,A00,111323,Chern; Albert Ren-Haur,0,0,0,0
1667949225542,CSE 282,A00,102398,Pevzner; Pavel Arkadjevich,0,0,0,0
1667949225973,CSE 284,A00,114175,Gymrek; Melissa Ann,0,0,0,0
1667949226396,CSE 290,A00,102399,Chandraker; Manmohan Krishna,0,0,0,0
1667949226396,CSE 290,B00,102400,Vaccaro; Kristen Marie,0,0,25,25
1667949226396,CSE 290,C00,102414,Pannuto; Patrick William,0,0,25,25
1667949226396,CSE 290,D00,102427,Pevzner; Pavel Arkadjevich,0,0,0,0
1667949226396,CSE 290,E00,102429,Zhao; Jishen,0,0,0,0
1667949226396,CSE 290,F00,102436,Tullsen; Dean Michael,0,0,0,0
1667949226396,CSE 290,G00,102440,Christensen; Henrik I,0,0,20,20
1667949226834,CSE 291,A00,102443,Su; Hao,0,0,0,0
1667949226834,CSE 291,B00,102448,Polikarpova; Nadezhda,0,0,0,0
1667949226834,CSE 291,C00,102453,Vaccaro; Kristen Marie,0,0,0,0
1667949226834,CSE 291,D00,111343,Savage; Stefan,0,0,0,0
1667949226834,CSE 291,E00,116474,Claffy; Kimberly Claire,0,0,0,0
1667949226834,CSE 291,F00,116479,Pasquale; Joseph,0,0,0,0
1667949227297,CSE 293,001,119111,Bafna; Vineet,9999,0,9999,0
1667949227297,CSE 293,002,119118,Bellare; Mihir,9999,0,9999,0
1667949227297,CSE 293,003,119122,Berg-Kirkpatrick; Taylor D,9999,0,9999,0
1667949227297,CSE 293,004,119135,Christensen; Henrik I,9999,0,9999,0
1667949227297,CSE 293,005,119142,Cottrell; Garrison W,9999,0,9999,0
1667949227297,CSE 293,006,119146,Deutsch; Alin Bernard,9999,0,9999,0
1667949227297,CSE 293,007,119159,Esmaeilzadeh; Hadi,9999,0,9999,0
1667949227297,CSE 293,008,119166,Freund; Yoav,9999,0,9999,0
1667949227297,CSE 293,009,119170,Griswold; William G.,9999,0,9999,0
1667949227297,CSE 293,010,119183,Gymrek; Melissa Ann,9998,0,9999,1
1667949227297,CSE 293,011,119190,Heninger; Nadia A,9999,0,9999,0
1667949227297,CSE 293,012,119230,Impagliazzo; Russell,9999,0,9999,0
1667949227297,CSE 293,013,119232,Jhala; Ranjit,9999,0,9999,0
1667949227297,CSE 293,014,119233,Kahng; Andrew Byun,9999,0,9999,0
1667949227297,CSE 293,015,119298,Kane; Daniel Mertz,9999,0,9999,0
1667949227297,CSE 293,016,119299,Kriegman; David J,9999,0,9999,0
1667949227297,CSE 293,017,119300,Kumar; Arun Kumar,9999,0,9999,0
1667949227297,CSE 293,018,119301,Lerner; Sorin,9999,0,9999,0
1667949227297,CSE 293,019,119302,Lovett; Shachar,9999,0,9999,0
1667949227297,CSE 293,020,119303,McAuley; Julian John,9999,0,9999,0
1667949227297,CSE 293,021,119304,Micciancio; Daniele,9999,0,9999,0
1667949227297,CSE 293,022,119367,Orailoglu; Alex,9999,0,9999,0
1667949227297,CSE 293,023,119382,Paturi; Ramamohan,9999,0,9999,0
1667949227297,CSE 293,024,119404,Polikarpova; Nadezhda,9999,0,9999,0
1667949227297,CSE 293,025,119406,Politz; Joseph Gibbs,9999,0,9999,0
1667949227297,CSE 293,026,119411,Porter; George M,9999,0,9999,0
1667949227297,CSE 293,027,119414,Porter; Leonard Emerson,9999,0,9999,0
1667949227297,CSE 293,028,119416,Ramamoorthi; Ravi,9999,0,9999,0
1667949227297,CSE 293,029,119417,Sahoo; Debashis,9999,0,9999,0
1667949227297,CSE 293,030,119420,Saul; Lawrence,9999,0,9999,0
1667949227297,CSE 293,031,119421,Savage; Stefan,9999,0,9999,0
1667949227297,CSE 293,032,119425,Schulze; Jurgen P.,9999,0,9999,0
1667949227297,CSE 293,033,119426,Snoeren; Alex C.,9999,0,9999,0
1667949227297,CSE 293,034,119428,Shang; Jingbo,9999,0,9999,0
1667949227297,CSE 293,035,119430,Stefan; Deian,9999,0,9999,0
1667949227297,CSE 293,036,119431,Su; Hao,9999,0,9999,0
1667949227297,CSE 293,037,119433,Swanson; Steven James,9999,0,9999,0
1667949227297,CSE 293,038,119435,Tullsen; Dean Michael,9999,0,9999,0
1667949227297,CSE 293,039,119483,Voelker; Geoffrey M.,9999,0,9999,0
1667949227297,CSE 293,040,119537,Zhao; Jishen,9999,0,9999,0
1667949227297,CSE 293,041,119538,Zhou; Yuan-Yuan,9999,0,9999,0
1667949227297,CSE 293,042,119539,Gao; Sicun,9999,0,9999,0
1667949227297,CSE 293,043,119540,Weibel; Nadir,9999,0,9999,0
1667949227297,CSE 293,044,119541,Gupta; Rajesh K.,9999,0,9999,0
1667949227723,CSE 294,A00,102459,Voelker; Geoffrey M.,0,0,0,0
1667949227723,CSE 294,B00,111322,Orailoglu; Alex,0,0,0,0
1667949228150,DSE 201,A00,096914,Deutsch; Alin Bernard,30,0,30,0
1667949228575,DSE 210,A00,096915,Dasgupta; Sanjoy,30,0,30,0
1667949229001,DSE 260A,A00,096916,Altintas De Callaf; Ilkay,30,0,30,0
1667949229429,ECE 200,001,103586,Antipa; Nicholas A,9999,0,9999,0
1667949229429,ECE 200,002,103587,Atanasov; Nikolay A.,9999,0,9999,0
1667949229429,ECE 200,003,103588,Bharadia; Dinesh,9999,0,9999,0
1667949229429,ECE 200,004,103589,Cheng; Chung Kuan,9999,0,9999,0
1667949229429,ECE 200,005,103590,Cosman; Pamela C.,9999,0,9999,0
1667949229429,ECE 200,006,103591,Dayeh; Shadi Ahmad,9999,0,9999,0
1667949229429,ECE 200,007,103592,Fainman; Yeshaiahu,9999,0,9999,0
1667949229429,ECE 200,008,103593,Ford; Joseph Earl,9999,0,9999,0
1667949229429,ECE 200,009,103594,Franceschetti; Massimo,9999,0,9999,0
1667949229429,ECE 200,010,103595,Fullerton; Eric E,9999,0,9999,0
1667949229429,ECE 200,011,103596,Galton; Ian A,9999,0,9999,0
1667949229429,ECE 200,012,103597,Gilja; Vikash,9999,0,9999,0
1667949229429,ECE 200,013,103598,Hall; Drew A.,9999,0,9999,0
1667949229429,ECE 200,014,103599,Hsueh; Tzu-Chien,9999,0,9999,0
1667949229429,ECE 200,015,103600,Javidi; Tara,9999,0,9999,0
1667949229429,ECE 200,016,103601,Kahng; Andrew Byun,9999,0,9999,0
1667949229429,ECE 200,017,103602,Kim; Young-Han,9999,0,9999,0
1667949229429,ECE 200,018,103603,Koushanfar; Farinaz,9999,0,9999,0
1667949229429,ECE 200,019,103604,Kuzum; Duygu,9999,0,9999,0
1667949229429,ECE 200,020,103605,Le; Hanh-Phuc,9999,0,9999,0
1667949229429,ECE 200,021,103606,Lin; Bill,9999,0,9999,0
1667949229429,ECE 200,022,103607,Liu; Zhaowei,9998,0,9999,1
1667949229429,ECE 200,023,103608,Lo; Yu-Hwa,9999,0,9999,0
1667949229429,ECE 200,024,103609,Lomakin; Vitaliy,9999,0,9999,0
1667949229429,ECE 200,025,103610,Mercier; Patrick Philip,9999,0,9999,0
1667949229429,ECE 200,026,103611,Meyer; Florian,9999,0,9999,0
1667949229429,ECE 200,027,103612,Milstein; Laurence B.,9999,0,9999,0
1667949229429,ECE 200,028,103613,Mir Arabbaygi; Siavash,9999,0,9999,0
1667949229429,ECE 200,029,103614,Mookherjea; Shayan,9999,0,9999,0
1667949229429,ECE 200,030,103615,Morris; Karcher William,9999,0,9999,0
1667949229429,ECE 200,031,103616,Ng; Tse Nga,9999,0,9999,0
1667949229429,ECE 200,032,103617,Nguyen; Truong Quang,9999,0,9999,0
1667949229429,ECE 200,033,103618,Nomura; Kenji,9999,0,9999,0
1667949229429,ECE 200,034,103619,Orlitsky; Alon,9999,0,9999,0
1667949229429,ECE 200,035,103620,Pal; Piya,9999,0,9999,0
1667949229429,ECE 200,036,103621,Papen; George C.,9999,0,9999,0
1667949229429,ECE 200,037,103622,Radic; Stojan,9999,0,9999,0
1667949229429,ECE 200,038,103623,Rao; Bhaskar D.,9999,0,9999,0
1667949229429,ECE 200,039,103624,Rao; Ramesh R,9999,0,9999,0
1667949229429,ECE 200,040,103625,Rebeiz; Gabriel,9999,0,9999,0
1667949229429,ECE 200,041,103626,Sanford; John R,9999,0,9999,0
1667949229429,ECE 200,042,103627,Siegel; Paul H.,9999,0,9999,0
1667949229429,ECE 200,043,103628,Sievenpiper; Daniel F.,9999,0,9999,0
1667949229429,ECE 200,044,103629,Sworder; David D.,9999,0,9999,0
1667949229429,ECE 200,045,103630,Taur; Yuan,9999,0,9999,0
1667949229429,ECE 200,046,103631,Touri; Behrouz,9999,0,9999,0
1667949229429,ECE 200,047,103632,Trivedi; Mohan M.,9999,0,9999,0
1667949229429,ECE 200,048,103633,Vasconcelos; Nuno,9999,0,9999,0
1667949229429,ECE 200,049,103634,Wang; Xiaolong,9999,0,9999,0
1667949229429,ECE 200,050,103635,Xie; Pengtao,9999,0,9999,0
1667949229429,ECE 200,051,103636,Yip; Michael,9999,0,9999,0
1667949229429,ECE 200,052,103637,Zeger; Kenneth A.,999,0,999,0
1667949229429,ECE 200,053,103638,Zhang; Xinyu,9999,0,9999,0
1667949229429,ECE 200,054,103639,Turakhia; Yatish Girish,9999,0,9999,0
1667949229429,ECE 200,055,103640,Kang; Mingu,9999,0,9999,0
1667949229429,ECE 200,056,103641,Shi; Yuanyuan,9999,0,9999,0
1667949229429,ECE 200,057,103642,Wang; Edward Jay,9999,0,9999,0
1667949229429,ECE 200,058,103643,Zheng; Yang,9999,0,9999,0
1667949229855,ECE 202,A00,103644,Kuzum; Duygu,0,0,0,0
1667949230278,ECE 212BN,A00,103646,Ng; Tse Nga,0,0,0,0
1667949230704,ECE 221,A00,111493,Staff,0,0,0,0
1667949231131,ECE 222B,A00,103647,Lomakin; Vitaliy,0,0,0,0
1667949231554,ECE 230B,A00,103648,Taur; Yuan,0,0,0,0
1667949231981,ECE 238B,A00,103649,Garay; Javier,0,0,0,0
1667949232403,ECE 240B,A00,112900,Fainman; Yeshaiahu,0,0,0,0
1667949232828,ECE 247A,A00,103650,Jokerst; Jesse Vincent,0,0,0,0
1667949233258,ECE 247B,A00,103651,Wang; Joseph,0,0,0,0
1667949233694,ECE 250,A00,103652,Siegel; Paul H.,0,0,0,0
1667949234129,ECE 251A,A00,103654,Rao; Bhaskar D.,0,0,0,0
1667949234554,ECE 257B,A00,103655,Bharadia; Dinesh,0,0,0,0
1667949234979,ECE 258A,A00,103656,Milstein; Laurence B.,0,0,0,0
1667949235408,ECE 260B,A00,103658,Kang; Mingu,0,0,0,0
1667949235832,ECE 264A,A00,103659,Galton; Ian A,0,0,0,0
1667949236272,ECE 265A,A00,103661,Gudem; Prasad S.S.,0,0,0,0
1667949236696,ECE 265D,A00,103662,Gudem; Prasad S.S.,0,0,0,0
1667949237135,ECE 268,A00,103663,Koushanfar; Farinaz,0,0,0,0
1667949237563,ECE 269,A01,103665,Pal; Piya,0,0,0,0
1667949237989,ECE 271B,A00,103666,Vasconcelos; Manuela,0,0,0,0
1667949238412,ECE 276A,A00,103667,Atanasov; Nikolay A.,0,0,0,0
1667949238837,ECE 277,A00,103668,An; Cheolhong,0,0,0,0
1667949239269,ECE 279,A00,117947,Hall; Drew A.,0,0,0,0
1667949240123,ECE 283,A00,103670,Hsueh; Tzu-Chien,0,0,0,0
1667949240557,ECE 284,A00,103671,Turakhia; Yatish Girish,0,0,0,0
1667949240980,ECE 285,A00,103672,Zheng; Yang,0,0,0,0
1667949240980,ECE 285,B00,103673,Sworder; David D.,0,0,0,0
1667949241415,ECE 287,A00,103676,Javidi; Tara,0,0,0,0
1667949241848,MATH 200B,A00,098023,Salehi Golsefidy; Alireza,14,0,15,1
1667949242274,MATH 202B,A00,098024,Rhoades; Brendon Patrick,13,0,15,2
1667949242703,MATH 203B,A00,098025,Oprea; Dragos N.,14,0,15,1
1667949243132,MATH 204B,A00,098026,Sorensen; Claus M,15,0,15,0
1667949243555,MATH 208,A00,098027,Izadi; Elham,7,0,10,3
1667949243997,MATH 209,A00,098028,Pollack; Aaron,10,0,10,0
1667949244437,MATH 211A,A00,112919,Rogalski; Daniel,10,0,10,0
1667949244860,MATH 211B,A00,112920,Seward; Brandon M.,10,0,10,0
1667949245291,MATH 218,A00,098029,Li; Bo,10,0,10,0
1667949245718,MATH 220B,A00,098030,Novak; Jonathan I,14,0,15,1
1667949246225,MATH 221A,A00,098031,Ebenfelt; Peter F,14,0,15,1
1667949246647,MATH 231B,A00,098032,Zlatos; Andrej,13,0,15,2
1667949247074,MATH 240B,A00,098033,Ni; Lei,11,0,15,4
1667949247498,MATH 243,A00,098034,Jekel; David Andrew,10,0,10,0
1667949247923,MATH 245A,A00,098035,Nie; Jiawang,2,0,15,13
1667949248349,MATH 248,A00,098036,Bejenaru; Ioan,10,0,10,0
1667949248782,MATH 250B,A00,098037,Spolaor; Luca,14,0,15,1
1667949249213,MATH 258,A00,098038,Ni; Lei,10,0,10,0
1667949249635,MATH 264B,A00,098041,Rhoades; Brendon Patrick,13,0,15,2
1667949250072,MATH 268,A00,098042,Buss; Samuel R,10,0,10,0
1667949250501,MATH 269,A00,098043,Rhoades; Brendon Patrick,10,0,10,0
1667949250933,MATH 270B,A00,098044,Li; Bo,11,0,15,4
1667949251355,MATH 272B,A00,098045,Holst; Michael J,13,0,15,2
1667949251781,MATH 273A,A00,098046,Tian; Xiaochuan,12,0,15,3
1667949252207,MATH 275,A01,098048,Tian; Xiaochuan,6,0,10,4
1667949252630,MATH 278A,A00,098049,Holst; Michael J,8,0,10,2
1667949253050,MATH 278B,A00,098050,Cloninger; Alexander,10,0,10,0
1667949253473,MATH 278C,A00,098051,Nie; Jiawang,7,0,10,3
1667949253902,MATH 280B,A00,098052,Zheng; Tianyi,12,0,15,3
1667949254330,MATH 281B,A00,098053,Bradic; Jelena,4,0,15,11
1667949254753,MATH 282B,A00,098054,Arias-Castro; Ery,2,0,15,13
1667949255179,MATH 285,A00,098055,Fitzsimmons; Patrick J,0,0,15,15
1667949255607,MATH 287B,A00,098056,Arias-Castro; Ery,7,0,15,8
1667949256031,MATH 288,A00,098057,Agarwal; Pooja,9,0,10,1
1667949256031,MATH 288,B00,098058,Zhang; Danna,9,0,10,1
1667949256031,MATH 288,C00,098059,Williams; Ruth J,10,0,10,0
1667949256458,MATH 290B,A00,098060,Roberts; Justin Deritter,14,0,15,1
1667949256880,MATH 292,A00,098061,Belmont; Eva Kinoshita,10,0,10,0
1667949257309,MATH 295,A00,098062,Suk; Andrew Hoon,48,0,50,2
1667949257735,MATH 296,A00,098063,Novak; Jonathan I,20,0,20,0
1667949258173,MATH 297,001,098064,Gamst; Anthony Collins,9997,0,9999,2
1667949762343,COGS 205,A00,101395,Chiba; Andrea,19,0,20,1
1667949762772,COGS 210B,001,101404,Greene; Deanna Jacquelyn,9998,0,9999,1
1667949762772,COGS 210B,002,101417,Xia; Haijun,9999,0,9999,0
1667949762772,COGS 210B,003,101422,Nitz; Douglas A.,9999,0,9999,0
1667949762772,COGS 210B,004,101423,Hollan; James D.,9998,0,9999,1
1667949762772,COGS 210B,005,101424,Deak; Gedeon O.,9999,0,9999,0
1667949762772,COGS 210B,006,101425,Rossano; Federico,9999,0,9999,0
1667949763205,COGS 211B,A00,101427,Coulson; Seana M,9997,0,9999,2
1667949763638,COGS 220,A00,101428,Hollan; James D.,0,0,25,25
1667949764068,COGS 229,A00,101429,Dow; Steven P,18,0,25,7
1667949764499,COGS 230,A00,101430,Klemmer; Scott R,13,0,17,4
1667949764924,COGS 234,A00,101431,Xia; Haijun,8,0,25,17
1667949765357,COGS 260,A00,101432,Kiyonaga; Anastasia,20,0,25,5
1667949765357,COGS 260,B00,101433,Kirsh; David Joel,16,0,25,9
1667949765784,CSE 202,A00,102371,Impagliazzo; Russell,0,0,0,0
1667949766211,CSE 203B,A01,102373,Cheng; Chung Kuan,0,0,0,0
1667949766641,CSE 208,A00,102374,Micciancio; Daniele,0,0,0,0
1667949767062,CSE 209A,A00,112895,Impagliazzo; Russell,0,0,15,15
1667949767492,CSE 209B,A00,108005,Bellare; Mihir,0,0,0,0
1667949767923,CSE 210,A00,113163,Coblenz; Michael J,0,0,0,0
1667949768352,CSE 219,A00,106111,Dow; Steven P,0,0,20,20
1667949768777,CSE 221,A00,102376,Voelker; Geoffrey M.,0,0,0,0
1667949769213,CSE 224,A01,102378,Porter; George M,0,0,0,0
1667949769634,CSE 229A,A00,102379,Savage; Stefan,0,0,0,0
1667949770074,CSE 229C,A00,102380,Munyaka; Imani N. S.,0,0,0,0
1667949770595,CSE 232B,A00,102382,Deutsch; Alin Bernard,0,0,0,0
1667949771017,CSE 234,A01,112904,Kumar; Arun Kumar,0,0,0,0
1667949771449,CSE 237A,A00,102383,Rosing; Tajana Simunic,0,0,0,0
1667949771875,CSE 239A,A00,102384,Deutsch; Alin Bernard,0,0,0,0
1667949772300,CSE 239B,A00,102385,Polikarpova; Nadezhda,0,0,0,0
1667949772727,CSE 240A,A00,102386,Pannuto; Patrick William,0,0,0,0
1667949773152,CSE 240B,A00,102387,Zhao; Jishen,0,0,0,0
1667949773578,CSE 241A,A00,106406,Kang; Mingu,0,0,0,0
1667949774001,CSE 249B,A00,102388,Kahng; Andrew Byun,0,0,8,8
1667949774433,CSE 251B,A01,102392,Cottrell; Garrison W,0,0,0,0
1667949774433,CSE 251B,A02,102393,Cottrell; Garrison W,0,0,0,0
1667949774862,CSE 252B,A00,102394,Ochoa; Benjamin Lawrence,0,0,0,0
1667949775284,CSE 257,A01,102396,Gao; Sicun,0,0,0,0
1667949775706,CSE 272,A00,102397,Li; Tzumao,0,0,0,0
1667949776139,CSE 274,A00,111323,Chern; Albert Ren-Haur,0,0,0,0
1667949776573,CSE 282,A00,102398,Pevzner; Pavel Arkadjevich,0,0,0,0
1667949776995,CSE 284,A00,114175,Gymrek; Melissa Ann,0,0,0,0
1667949777428,CSE 290,A00,102399,Chandraker; Manmohan Krishna,0,0,0,0
1667949777428,CSE 290,B00,102400,Vaccaro; Kristen Marie,0,0,25,25
1667949777428,CSE 290,C00,102414,Pannuto; Patrick William,0,0,25,25
1667949777428,CSE 290,D00,102427,Pevzner; Pavel Arkadjevich,0,0,0,0
1667949777428,CSE 290,E00,102429,Zhao; Jishen,0,0,0,0
1667949777428,CSE 290,F00,102436,Tullsen; Dean Michael,0,0,0,0
1667949777428,CSE 290,G00,102440,Christensen; Henrik I,0,0,20,20
1667949777855,CSE 291,A00,102443,Su; Hao,0,0,0,0
1667949777855,CSE 291,B00,102448,Polikarpova; Nadezhda,0,0,0,0
1667949777855,CSE 291,C00,102453,Vaccaro; Kristen Marie,0,0,0,0
1667949777855,CSE 291,D00,111343,Savage; Stefan,0,0,0,0
1667949777855,CSE 291,E00,116474,Claffy; Kimberly Claire,0,0,0,0
1667949777855,CSE 291,F00,116479,Pasquale; Joseph,0,0,0,0
1667949778314,CSE 293,001,119111,Bafna; Vineet,9999,0,9999,0
1667949778314,CSE 293,002,119118,Bellare; Mihir,9999,0,9999,0
1667949778314,CSE 293,003,119122,Berg-Kirkpatrick; Taylor D,9999,0,9999,0
1667949778314,CSE 293,004,119135,Christensen; Henrik I,9999,0,9999,0
1667949778314,CSE 293,005,119142,Cottrell; Garrison W,9999,0,9999,0
1667949778314,CSE 293,006,119146,Deutsch; Alin Bernard,9999,0,9999,0
1667949778314,CSE 293,007,119159,Esmaeilzadeh; Hadi,9999,0,9999,0
1667949778314,CSE 293,008,119166,Freund; Yoav,9999,0,9999,0
1667949778314,CSE 293,009,119170,Griswold; William G.,9999,0,9999,0
1667949778314,CSE 293,010,119183,Gymrek; Melissa Ann,9998,0,9999,1
1667949778314,CSE 293,011,119190,Heninger; Nadia A,9999,0,9999,0
1667949778314,CSE 293,012,119230,Impagliazzo; Russell,9999,0,9999,0
1667949778314,CSE 293,013,119232,Jhala; Ranjit,9999,0,9999,0
1667949778314,CSE 293,014,119233,Kahng; Andrew Byun,9999,0,9999,0
1667949778314,CSE 293,015,119298,Kane; Daniel Mertz,9999,0,9999,0
1667949778314,CSE 293,016,119299,Kriegman; David J,9999,0,9999,0
1667949778314,CSE 293,017,119300,Kumar; Arun Kumar,9999,0,9999,0
1667949778314,CSE 293,018,119301,Lerner; Sorin,9999,0,9999,0
1667949778314,CSE 293,019,119302,Lovett; Shachar,9999,0,9999,0
1667949778314,CSE 293,020,119303,McAuley; Julian John,9999,0,9999,0
1667949778314,CSE 293,021,119304,Micciancio; Daniele,9999,0,9999,0
1667949778314,CSE 293,022,119367,Orailoglu; Alex,9999,0,9999,0
1667949778314,CSE 293,023,119382,Paturi; Ramamohan,9999,0,9999,0
1667949778314,CSE 293,024,119404,Polikarpova; Nadezhda,9999,0,9999,0
1667949778314,CSE 293,025,119406,Politz; Joseph Gibbs,9999,0,9999,0
1667949778314,CSE 293,026,119411,Porter; George M,9999,0,9999,0
1667949778314,CSE 293,027,119414,Porter; Leonard Emerson,9999,0,9999,0
1667949778314,CSE 293,028,119416,Ramamoorthi; Ravi,9999,0,9999,0
1667949778314,CSE 293,029,119417,Sahoo; Debashis,9999,0,9999,0
1667949778314,CSE 293,030,119420,Saul; Lawrence,9999,0,9999,0
1667949778314,CSE 293,031,119421,Savage; Stefan,9999,0,9999,0
1667949778314,CSE 293,032,119425,Schulze; Jurgen P.,9999,0,9999,0
1667949778314,CSE 293,033,119426,Snoeren; Alex C.,9999,0,9999,0
1667949778314,CSE 293,034,119428,Shang; Jingbo,9999,0,9999,0
1667949778314,CSE 293,035,119430,Stefan; Deian,9999,0,9999,0
1667949778314,CSE 293,036,119431,Su; Hao,9999,0,9999,0
1667949778314,CSE 293,037,119433,Swanson; Steven James,9999,0,9999,0
1667949778314,CSE 293,038,119435,Tullsen; Dean Michael,9999,0,9999,0
1667949778314,CSE 293,039,119483,Voelker; Geoffrey M.,9999,0,9999,0
1667949778314,CSE 293,040,119537,Zhao; Jishen,9999,0,9999,0
1667949778314,CSE 293,041,119538,Zhou; Yuan-Yuan,9999,0,9999,0
1667949778314,CSE 293,042,119539,Gao; Sicun,9999,0,9999,0
1667949778314,CSE 293,043,119540,Weibel; Nadir,9999,0,9999,0
1667949778314,CSE 293,044,119541,Gupta; Rajesh K.,9999,0,9999,0
1667949778739,CSE 294,A00,102459,Voelker; Geoffrey M.,0,0,0,0
1667949778739,CSE 294,B00,111322,Orailoglu; Alex,0,0,0,0
1667949779191,DSE 201,A00,096914,Deutsch; Alin Bernard,30,0,30,0
1667949779632,DSE 210,A00,096915,Dasgupta; Sanjoy,30,0,30,0
1667949780074,DSE 260A,A00,096916,Altintas De Callaf; Ilkay,30,0,30,0
1667949780512,ECE 200,001,103586,Antipa; Nicholas A,9999,0,9999,0
1667949780512,ECE 200,002,103587,Atanasov; Nikolay A.,9999,0,9999,0
1667949780512,ECE 200,003,103588,Bharadia; Dinesh,9999,0,9999,0
1667949780512,ECE 200,004,103589,Cheng; Chung Kuan,9999,0,9999,0
1667949780512,ECE 200,005,103590,Cosman; Pamela C.,9999,0,9999,0
1667949780512,ECE 200,006,103591,Dayeh; Shadi Ahmad,9999,0,9999,0
1667949780512,ECE 200,007,103592,Fainman; Yeshaiahu,9999,0,9999,0
1667949780512,ECE 200,008,103593,Ford; Joseph Earl,9999,0,9999,0
1667949780512,ECE 200,009,103594,Franceschetti; Massimo,9999,0,9999,0
1667949780512,ECE 200,010,103595,Fullerton; Eric E,9999,0,9999,0
1667949780512,ECE 200,011,103596,Galton; Ian A,9999,0,9999,0
1667949780512,ECE 200,012,103597,Gilja; Vikash,9999,0,9999,0
1667949780512,ECE 200,013,103598,Hall; Drew A.,9999,0,9999,0
1667949780512,ECE 200,014,103599,Hsueh; Tzu-Chien,9999,0,9999,0
1667949780512,ECE 200,015,103600,Javidi; Tara,9999,0,9999,0
1667949780512,ECE 200,016,103601,Kahng; Andrew Byun,9999,0,9999,0
1667949780512,ECE 200,017,103602,Kim; Young-Han,9999,0,9999,0
1667949780512,ECE 200,018,103603,Koushanfar; Farinaz,9999,0,9999,0
1667949780512,ECE 200,019,103604,Kuzum; Duygu,9999,0,9999,0
1667949780512,ECE 200,020,103605,Le; Hanh-Phuc,9999,0,9999,0
1667949780512,ECE 200,021,103606,Lin; Bill,9999,0,9999,0
1667949780512,ECE 200,022,103607,Liu; Zhaowei,9998,0,9999,1
1667949780512,ECE 200,023,103608,Lo; Yu-Hwa,9999,0,9999,0
1667949780512,ECE 200,024,103609,Lomakin; Vitaliy,9999,0,9999,0
1667949780512,ECE 200,025,103610,Mercier; Patrick Philip,9999,0,9999,0
1667949780512,ECE 200,026,103611,Meyer; Florian,9999,0,9999,0
1667949780512,ECE 200,027,103612,Milstein; Laurence B.,9999,0,9999,0
1667949780512,ECE 200,028,103613,Mir Arabbaygi; Siavash,9999,0,9999,0
1667949780512,ECE 200,029,103614,Mookherjea; Shayan,9999,0,9999,0
1667949780512,ECE 200,030,103615,Morris; Karcher William,9999,0,9999,0
1667949780512,ECE 200,031,103616,Ng; Tse Nga,9999,0,9999,0
1667949780512,ECE 200,032,103617,Nguyen; Truong Quang,9999,0,9999,0
1667949780512,ECE 200,033,103618,Nomura; Kenji,9999,0,9999,0
1667949780512,ECE 200,034,103619,Orlitsky; Alon,9999,0,9999,0
1667949780512,ECE 200,035,103620,Pal; Piya,9999,0,9999,0
1667949780512,ECE 200,036,103621,Papen; George C.,9999,0,9999,0
1667949780512,ECE 200,037,103622,Radic; Stojan,9999,0,9999,0
1667949780512,ECE 200,038,103623,Rao; Bhaskar D.,9999,0,9999,0
1667949780512,ECE 200,039,103624,Rao; Ramesh R,9999,0,9999,0
1667949780512,ECE 200,040,103625,Rebeiz; Gabriel,9999,0,9999,0
1667949780512,ECE 200,041,103626,Sanford; John R,9999,0,9999,0
1667949780512,ECE 200,042,103627,Siegel; Paul H.,9999,0,9999,0
1667949780512,ECE 200,043,103628,Sievenpiper; Daniel F.,9999,0,9999,0
1667949780512,ECE 200,044,103629,Sworder; David D.,9999,0,9999,0
1667949780512,ECE 200,045,103630,Taur; Yuan,9999,0,9999,0
1667949780512,ECE 200,046,103631,Touri; Behrouz,9999,0,9999,0
1667949780512,ECE 200,047,103632,Trivedi; Mohan M.,9999,0,9999,0
1667949780512,ECE 200,048,103633,Vasconcelos; Nuno,9999,0,9999,0
1667949780512,ECE 200,049,103634,Wang; Xiaolong,9999,0,9999,0
1667949780512,ECE 200,050,103635,Xie; Pengtao,9999,0,9999,0
1667949780512,ECE 200,051,103636,Yip; Michael,9999,0,9999,0
1667949780512,ECE 200,052,103637,Zeger; Kenneth A.,999,0,999,0
1667949780512,ECE 200,053,103638,Zhang; Xinyu,9999,0,9999,0
1667949780512,ECE 200,054,103639,Turakhia; Yatish Girish,9999,0,9999,0
1667949780512,ECE 200,055,103640,Kang; Mingu,9999,0,9999,0
1667949780512,ECE 200,056,103641,Shi; Yuanyuan,9999,0,9999,0
1667949780512,ECE 200,057,103642,Wang; Edward Jay,9999,0,9999,0
1667949780512,ECE 200,058,103643,Zheng; Yang,9999,0,9999,0
1667949780948,ECE 202,A00,103644,Kuzum; Duygu,0,0,0,0
1667949781369,ECE 212BN,A00,103646,Ng; Tse Nga,0,0,0,0
1667949781805,ECE 221,A00,111493,Staff,0,0,0,0
1667949782230,ECE 222B,A00,103647,Lomakin; Vitaliy,0,0,0,0
1667949782668,ECE 230B,A00,103648,Taur; Yuan,0,0,0,0
1667949783105,ECE 238B,A00,103649,Garay; Javier,0,0,0,0
1667949783541,ECE 240B,A00,112900,Fainman; Yeshaiahu,0,0,0,0
1667949783964,ECE 247A,A00,103650,Jokerst; Jesse Vincent,0,0,0,0
1667949784393,ECE 247B,A00,103651,Wang; Joseph,0,0,0,0
1667949784816,ECE 250,A00,103652,Siegel; Paul H.,0,0,0,0
1667949785242,ECE 251A,A00,103654,Rao; Bhaskar D.,0,0,0,0
1667949785686,ECE 257B,A00,103655,Bharadia; Dinesh,0,0,0,0
1667949786114,ECE 258A,A00,103656,Milstein; Laurence B.,0,0,0,0
1667949786552,ECE 260B,A00,103658,Kang; Mingu,0,0,0,0
1667949786978,ECE 264A,A00,103659,Galton; Ian A,0,0,0,0
1667949787400,ECE 265A,A00,103661,Gudem; Prasad S.S.,0,0,0,0
1667949787846,ECE 265D,A00,103662,Gudem; Prasad S.S.,0,0,0,0
1667949788278,ECE 268,A00,103663,Koushanfar; Farinaz,0,0,0,0
1667949788716,ECE 269,A01,103665,Pal; Piya,0,0,0,0
1667949789140,ECE 271B,A00,103666,Vasconcelos; Manuela,0,0,0,0
1667949789567,ECE 276A,A00,103667,Atanasov; Nikolay A.,0,0,0,0
1667949790000,ECE 277,A00,103668,An; Cheolhong,0,0,0,0
1667949790426,ECE 279,A00,117947,Hall; Drew A.,0,0,0,0
1667949791280,ECE 283,A00,103670,Hsueh; Tzu-Chien,0,0,0,0
1667949791712,ECE 284,A00,103671,Turakhia; Yatish Girish,0,0,0,0
1667949792141,ECE 285,A00,103672,Zheng; Yang,0,0,0,0
1667949792141,ECE 285,B00,103673,Sworder; David D.,0,0,0,0
1667949792567,ECE 287,A00,103676,Javidi; Tara,0,0,0,0
1667949792997,MATH 200B,A00,098023,Salehi Golsefidy; Alireza,14,0,15,1
1667949793432,MATH 202B,A00,098024,Rhoades; Brendon Patrick,12,0,15,3
1667949793857,MATH 203B,A00,098025,Oprea; Dragos N.,14,0,15,1
1667949794287,MATH 204B,A00,098026,Sorensen; Claus M,15,0,15,0
1667949794711,MATH 208,A00,098027,Izadi; Elham,7,0,10,3
1667949795149,MATH 209,A00,098028,Pollack; Aaron,10,0,10,0
1667949795581,MATH 211A,A00,112919,Rogalski; Daniel,10,0,10,0
1667949796021,MATH 211B,A00,112920,Seward; Brandon M.,10,0,10,0
1667949796449,MATH 218,A00,098029,Li; Bo,10,0,10,0
1667949796873,MATH 220B,A00,098030,Novak; Jonathan I,13,0,15,2
1667949797309,MATH 221A,A00,098031,Ebenfelt; Peter F,14,0,15,1
1667949797746,MATH 231B,A00,098032,Zlatos; Andrej,13,0,15,2
1667949798233,MATH 240B,A00,098033,Ni; Lei,10,0,15,5
1667949798660,MATH 243,A00,098034,Jekel; David Andrew,10,0,10,0
1667949799092,MATH 245A,A00,098035,Nie; Jiawang,2,0,15,13
1667949799526,MATH 248,A00,098036,Bejenaru; Ioan,10,0,10,0
1667949799961,MATH 250B,A00,098037,Spolaor; Luca,14,0,15,1
1667949800394,MATH 258,A00,098038,Ni; Lei,10,0,10,0
1667949800817,MATH 264B,A00,098041,Rhoades; Brendon Patrick,13,0,15,2
1667949801244,MATH 268,A00,098042,Buss; Samuel R,10,0,10,0
1667949801680,MATH 269,A00,098043,Rhoades; Brendon Patrick,10,0,10,0
1667949802111,MATH 270B,A00,098044,Li; Bo,11,0,15,4
1667949802540,MATH 272B,A00,098045,Holst; Michael J,13,0,15,2
1667949802966,MATH 273A,A00,098046,Tian; Xiaochuan,12,0,15,3
1667949803401,MATH 275,A01,098048,Tian; Xiaochuan,6,0,10,4
1667949803832,MATH 278A,A00,098049,Holst; Michael J,8,0,10,2
1667949804264,MATH 278B,A00,098050,Cloninger; Alexander,10,0,10,0
1667949804695,MATH 278C,A00,098051,Nie; Jiawang,8,0,10,2
1667949805117,MATH 280B,A00,098052,Zheng; Tianyi,12,0,15,3
1667949805555,MATH 281B,A00,098053,Bradic; Jelena,4,0,15,11
1667949805984,MATH 282B,A00,098054,Arias-Castro; Ery,2,0,15,13
1667949806431,MATH 285,A00,098055,Fitzsimmons; Patrick J,0,0,15,15
1667949806859,MATH 287B,A00,098056,Arias-Castro; Ery,7,0,15,8
1667949807285,MATH 288,A00,098057,Agarwal; Pooja,9,0,10,1
1667949807285,MATH 288,B00,098058,Zhang; Danna,9,0,10,1
1667949807285,MATH 288,C00,098059,Williams; Ruth J,10,0,10,0
1667949807709,MATH 290B,A00,098060,Roberts; Justin Deritter,14,0,15,1
1667949808143,MATH 292,A00,098061,Belmont; Eva Kinoshita,10,0,10,0
1667949808575,MATH 295,A00,098062,Suk; Andrew Hoon,48,0,50,2
1667949808997,MATH 296,A00,098063,Novak; Jonathan I,20,0,20,0
1667949809421,MATH 297,001,098064,Gamst; Anthony Collins,9997,0,9999,2
1667950624434,COGS 205,A00,101395,Chiba; Andrea,19,0,20,1
1667950624869,COGS 210B,001,101404,Greene; Deanna Jacquelyn,9998,0,9999,1
1667950624869,COGS 210B,002,101417,Xia; Haijun,9999,0,9999,0
1667950624869,COGS 210B,003,101422,Nitz; Douglas A.,9999,0,9999,0
1667950624869,COGS 210B,004,101423,Hollan; James D.,9998,0,9999,1
1667950624869,COGS 210B,005,101424,Deak; Gedeon O.,9999,0,9999,0
1667950624869,COGS 210B,006,101425,Rossano; Federico,9999,0,9999,0
1667950625298,COGS 211B,A00,101427,Coulson; Seana M,9997,0,9999,2
1667950625725,COGS 220,A00,101428,Hollan; James D.,0,0,25,25
1667950626162,COGS 229,A00,101429,Dow; Steven P,18,0,25,7
1667950626601,COGS 230,A00,101430,Klemmer; Scott R,13,0,17,4
1667950627031,COGS 234,A00,101431,Xia; Haijun,8,0,25,17
1667950627464,COGS 260,A00,101432,Kiyonaga; Anastasia,20,0,25,5
1667950627464,COGS 260,B00,101433,Kirsh; David Joel,16,0,25,9
1667950627904,CSE 202,A00,102371,Impagliazzo; Russell,0,0,0,0
1667950628331,CSE 203B,A01,102373,Cheng; Chung Kuan,0,0,0,0
1667950628762,CSE 208,A00,102374,Micciancio; Daniele,0,0,0,0
1667950629191,CSE 209A,A00,112895,Impagliazzo; Russell,0,0,15,15
1667950629615,CSE 209B,A00,108005,Bellare; Mihir,0,0,0,0
1667950630038,CSE 210,A00,113163,Coblenz; Michael J,0,0,0,0
1667950630465,CSE 219,A00,106111,Dow; Steven P,0,0,20,20
1667950630900,CSE 221,A00,102376,Voelker; Geoffrey M.,0,0,0,0
1667950631323,CSE 224,A01,102378,Porter; George M,0,0,0,0
1667950631745,CSE 229A,A00,102379,Savage; Stefan,0,0,0,0
1667950632174,CSE 229C,A00,102380,Munyaka; Imani N. S.,0,0,0,0
1667950632596,CSE 232B,A00,102382,Deutsch; Alin Bernard,0,0,0,0
1667950633062,CSE 234,A01,112904,Kumar; Arun Kumar,0,0,0,0
1667950633494,CSE 237A,A00,102383,Rosing; Tajana Simunic,0,0,0,0
1667950633921,CSE 239A,A00,102384,Deutsch; Alin Bernard,0,0,0,0
1667950634346,CSE 239B,A00,102385,Polikarpova; Nadezhda,0,0,0,0
1667950634771,CSE 240A,A00,102386,Pannuto; Patrick William,0,0,0,0
1667950635194,CSE 240B,A00,102387,Zhao; Jishen,0,0,0,0
1667950635635,CSE 241A,A00,106406,Kang; Mingu,0,0,0,0
1667950636057,CSE 249B,A00,102388,Kahng; Andrew Byun,0,0,8,8
1667950636482,CSE 251B,A01,102392,Cottrell; Garrison W,0,0,0,0
1667950636482,CSE 251B,A02,102393,Cottrell; Garrison W,0,0,0,0
1667950636930,CSE 252B,A00,102394,Ochoa; Benjamin Lawrence,0,0,0,0
1667950637360,CSE 257,A01,102396,Gao; Sicun,0,0,0,0
1667950637802,CSE 272,A00,102397,Li; Tzumao,0,0,0,0
1667950638228,CSE 274,A00,111323,Chern; Albert Ren-Haur,0,0,0,0
1667950638652,CSE 282,A00,102398,Pevzner; Pavel Arkadjevich,0,0,0,0
1667950639081,CSE 284,A00,114175,Gymrek; Melissa Ann,0,0,0,0
1667950639510,CSE 290,A00,102399,Chandraker; Manmohan Krishna,0,0,0,0
1667950639510,CSE 290,B00,102400,Vaccaro; Kristen Marie,0,0,25,25
1667950639510,CSE 290,C00,102414,Pannuto; Patrick William,0,0,25,25
1667950639510,CSE 290,D00,102427,Pevzner; Pavel Arkadjevich,0,0,0,0
1667950639510,CSE 290,E00,102429,Zhao; Jishen,0,0,0,0
1667950639510,CSE 290,F00,102436,Tullsen; Dean Michael,0,0,0,0
1667950639510,CSE 290,G00,102440,Christensen; Henrik I,0,0,20,20
1667950639963,CSE 291,A00,102443,Su; Hao,0,0,0,0
1667950639963,CSE 291,B00,102448,Polikarpova; Nadezhda,0,0,0,0
1667950639963,CSE 291,C00,102453,Vaccaro; Kristen Marie,0,0,0,0
1667950639963,CSE 291,D00,111343,Savage; Stefan,0,0,0,0
1667950639963,CSE 291,E00,116474,Claffy; Kimberly Claire,0,0,0,0
1667950639963,CSE 291,F00,116479,Pasquale; Joseph,0,0,0,0
1667950640405,CSE 293,001,119111,Bafna; Vineet,9999,0,9999,0
1667950640405,CSE 293,002,119118,Bellare; Mihir,9999,0,9999,0
1667950640405,CSE 293,003,119122,Berg-Kirkpatrick; Taylor D,9999,0,9999,0
1667950640405,CSE 293,004,119135,Christensen; Henrik I,9999,0,9999,0
1667950640405,CSE 293,005,119142,Cottrell; Garrison W,9999,0,9999,0
1667950640405,CSE 293,006,119146,Deutsch; Alin Bernard,9999,0,9999,0
1667950640405,CSE 293,007,119159,Esmaeilzadeh; Hadi,9999,0,9999,0
1667950640405,CSE 293,008,119166,Freund; Yoav,9999,0,9999,0
1667950640405,CSE 293,009,119170,Griswold; William G.,9999,0,9999,0
1667950640405,CSE 293,010,119183,Gymrek; Melissa Ann,9999,0,9999,0
1667950640405,CSE 293,011,119190,Heninger; Nadia A,9999,0,9999,0
1667950640405,CSE 293,012,119230,Impagliazzo; Russell,9999,0,9999,0
1667950640405,CSE 293,013,119232,Jhala; Ranjit,9999,0,9999,0
1667950640405,CSE 293,014,119233,Kahng; Andrew Byun,9999,0,9999,0
1667950640405,CSE 293,015,119298,Kane; Daniel Mertz,9999,0,9999,0
1667950640405,CSE 293,016,119299,Kriegman; David J,9999,0,9999,0
1667950640405,CSE 293,017,119300,Kumar; Arun Kumar,9999,0,9999,0
1667950640405,CSE 293,018,119301,Lerner; Sorin,9999,0,9999,0
1667950640405,CSE 293,019,119302,Lovett; Shachar,9999,0,9999,0
1667950640405,CSE 293,020,119303,McAuley; Julian John,9999,0,9999,0
1667950640405,CSE 293,021,119304,Micciancio; Daniele,9999,0,9999,0
1667950640405,CSE 293,022,119367,Orailoglu; Alex,9999,0,9999,0
1667950640405,CSE 293,023,119382,Paturi; Ramamohan,9999,0,9999,0
1667950640405,CSE 293,024,119404,Polikarpova; Nadezhda,9999,0,9999,0
1667950640405,CSE 293,025,119406,Politz; Joseph Gibbs,9999,0,9999,0
1667950640405,CSE 293,026,119411,Porter; George M,9999,0,9999,0
1667950640405,CSE 293,027,119414,Porter; Leonard Emerson,9999,0,9999,0
1667950640405,CSE 293,028,119416,Ramamoorthi; Ravi,9999,0,9999,0
1667950640405,CSE 293,029,119417,Sahoo; Debashis,9999,0,9999,0
1667950640405,CSE 293,030,119420,Saul; Lawrence,9999,0,9999,0
1667950640405,CSE 293,031,119421,Savage; Stefan,9999,0,9999,0
1667950640405,CSE 293,032,119425,Schulze; Jurgen P.,9999,0,9999,0
1667950640405,CSE 293,033,119426,Snoeren; Alex C.,9999,0,9999,0
1667950640405,CSE 293,034,119428,Shang; Jingbo,9999,0,9999,0
1667950640405,CSE 293,035,119430,Stefan; Deian,9999,0,9999,0
1667950640405,CSE 293,036,119431,Su; Hao,9999,0,9999,0
1667950640405,CSE 293,037,119433,Swanson; Steven James,9999,0,9999,0
1667950640405,CSE 293,038,119435,Tullsen; Dean Michael,9999,0,9999,0
1667950640405,CSE 293,039,119483,Voelker; Geoffrey M.,9999,0,9999,0
1667950640405,CSE 293,040,119537,Zhao; Jishen,9999,0,9999,0
1667950640405,CSE 293,041,119538,Zhou; Yuan-Yuan,9999,0,9999,0
1667950640405,CSE 293,042,119539,Gao; Sicun,9999,0,9999,0
1667950640405,CSE 293,043,119540,Weibel; Nadir,9999,0,9999,0
1667950640405,CSE 293,044,119541,Gupta; Rajesh K.,9999,0,9999,0
1667950640842,CSE 294,A00,102459,Voelker; Geoffrey M.,0,0,0,0
1667950640842,CSE 294,B00,111322,Orailoglu; Alex,0,0,0,0
1667950641268,DSE 201,A00,096914,Deutsch; Alin Bernard,30,0,30,0
1667950641697,DSE 210,A00,096915,Dasgupta; Sanjoy,30,0,30,0
1667950642124,DSE 260A,A00,096916,Altintas De Callaf; Ilkay,30,0,30,0
1667950642558,ECE 200,001,103586,Antipa; Nicholas A,9999,0,9999,0
1667950642558,ECE 200,002,103587,Atanasov; Nikolay A.,9999,0,9999,0
1667950642558,ECE 200,003,103588,Bharadia; Dinesh,9999,0,9999,0
1667950642558,ECE 200,004,103589,Cheng; Chung Kuan,9999,0,9999,0
1667950642558,ECE 200,005,103590,Cosman; Pamela C.,9999,0,9999,0
1667950642558,ECE 200,006,103591,Dayeh; Shadi Ahmad,9999,0,9999,0
1667950642558,ECE 200,007,103592,Fainman; Yeshaiahu,9999,0,9999,0
1667950642558,ECE 200,008,103593,Ford; Joseph Earl,9999,0,9999,0
1667950642558,ECE 200,009,103594,Franceschetti; Massimo,9999,0,9999,0
1667950642558,ECE 200,010,103595,Fullerton; Eric E,9999,0,9999,0
1667950642558,ECE 200,011,103596,Galton; Ian A,9999,0,9999,0
1667950642558,ECE 200,012,103597,Gilja; Vikash,9999,0,9999,0
1667950642558,ECE 200,013,103598,Hall; Drew A.,9999,0,9999,0
1667950642558,ECE 200,014,103599,Hsueh; Tzu-Chien,9999,0,9999,0
1667950642558,ECE 200,015,103600,Javidi; Tara,9999,0,9999,0
1667950642558,ECE 200,016,103601,Kahng; Andrew Byun,9999,0,9999,0
1667950642558,ECE 200,017,103602,Kim; Young-Han,9999,0,9999,0
1667950642558,ECE 200,018,103603,Koushanfar; Farinaz,9999,0,9999,0
1667950642558,ECE 200,019,103604,Kuzum; Duygu,9999,0,9999,0
1667950642558,ECE 200,020,103605,Le; Hanh-Phuc,9999,0,9999,0
1667950642558,ECE 200,021,103606,Lin; Bill,9999,0,9999,0
1667950642558,ECE 200,022,103607,Liu; Zhaowei,9998,0,9999,1
1667950642558,ECE 200,023,103608,Lo; Yu-Hwa,9999,0,9999,0
1667950642558,ECE 200,024,103609,Lomakin; Vitaliy,9999,0,9999,0
1667950642558,ECE 200,025,103610,Mercier; Patrick Philip,9999,0,9999,0
1667950642558,ECE 200,026,103611,Meyer; Florian,9999,0,9999,0
1667950642558,ECE 200,027,103612,Milstein; Laurence B.,9999,0,9999,0
1667950642558,ECE 200,028,103613,Mir Arabbaygi; Siavash,9999,0,9999,0
1667950642558,ECE 200,029,103614,Mookherjea; Shayan,9999,0,9999,0
1667950642558,ECE 200,030,103615,Morris; Karcher William,9999,0,9999,0
1667950642558,ECE 200,031,103616,Ng; Tse Nga,9999,0,9999,0
1667950642558,ECE 200,032,103617,Nguyen; Truong Quang,9999,0,9999,0
1667950642558,ECE 200,033,103618,Nomura; Kenji,9999,0,9999,0
1667950642558,ECE 200,034,103619,Orlitsky; Alon,9999,0,9999,0
1667950642558,ECE 200,035,103620,Pal; Piya,9999,0,9999,0
1667950642558,ECE 200,036,103621,Papen; George C.,9999,0,9999,0
1667950642558,ECE 200,037,103622,Radic; Stojan,9999,0,9999,0
1667950642558,ECE 200,038,103623,Rao; Bhaskar D.,9999,0,9999,0
1667950642558,ECE 200,039,103624,Rao; Ramesh R,9999,0,9999,0
1667950642558,ECE 200,040,103625,Rebeiz; Gabriel,9999,0,9999,0
1667950642558,ECE 200,041,103626,Sanford; John R,9999,0,9999,0
1667950642558,ECE 200,042,103627,Siegel; Paul H.,9999,0,9999,0
1667950642558,ECE 200,043,103628,Sievenpiper; Daniel F.,9999,0,9999,0
1667950642558,ECE 200,044,103629,Sworder; David D.,9999,0,9999,0
1667950642558,ECE 200,045,103630,Taur; Yuan,9999,0,9999,0
1667950642558,ECE 200,046,103631,Touri; Behrouz,9999,0,9999,0
1667950642558,ECE 200,047,103632,Trivedi; Mohan M.,9999,0,9999,0
1667950642558,ECE 200,048,103633,Vasconcelos; Nuno,9999,0,9999,0
1667950642558,ECE 200,049,103634,Wang; Xiaolong,9999,0,9999,0
1667950642558,ECE 200,050,103635,Xie; Pengtao,9999,0,9999,0
1667950642558,ECE 200,051,103636,Yip; Michael,9999,0,9999,0
1667950642558,ECE 200,052,103637,Zeger; Kenneth A.,999,0,999,0
1667950642558,ECE 200,053,103638,Zhang; Xinyu,9999,0,9999,0
1667950642558,ECE 200,054,103639,Turakhia; Yatish Girish,9999,0,9999,0
1667950642558,ECE 200,055,103640,Kang; Mingu,9999,0,9999,0
1667950642558,ECE 200,056,103641,Shi; Yuanyuan,9999,0,9999,0
1667950642558,ECE 200,057,103642,Wang; Edward Jay,9999,0,9999,0
1667950642558,ECE 200,058,103643,Zheng; Yang,9999,0,9999,0
1667950642980,ECE 202,A00,103644,Kuzum; Duygu,0,0,0,0
1667950643418,ECE 212BN,A00,103646,Ng; Tse Nga,0,0,0,0
1667950643842,ECE 221,A00,111493,Staff,0,0,0,0
1667950644265,ECE 222B,A00,103647,Lomakin; Vitaliy,0,0,0,0
1667950644705,ECE 230B,A00,103648,Taur; Yuan,0,0,0,0
1667950645137,ECE 238B,A00,103649,Garay; Javier,0,0,0,0
1667950645562,ECE 240B,A00,112900,Fainman; Yeshaiahu,0,0,0,0
1667950645997,ECE 247A,A00,103650,Jokerst; Jesse Vincent,0,0,0,0
1667950646444,ECE 247B,A00,103651,Wang; Joseph,0,0,0,0
1667950646876,ECE 250,A00,103652,Siegel; Paul H.,0,0,0,0
1667950647315,ECE 251A,A00,103654,Rao; Bhaskar D.,0,0,0,0
1667950647736,ECE 257B,A00,103655,Bharadia; Dinesh,0,0,0,0
1667950648169,ECE 258A,A00,103656,Milstein; Laurence B.,0,0,0,0
1667950648612,ECE 260B,A00,103658,Kang; Mingu,0,0,0,0
1667950649035,ECE 264A,A00,103659,Galton; Ian A,0,0,0,0
1667950649460,ECE 265A,A00,103661,Gudem; Prasad S.S.,0,0,0,0
1667950649884,ECE 265D,A00,103662,Gudem; Prasad S.S.,0,0,0,0
1667950650334,ECE 268,A00,103663,Koushanfar; Farinaz,0,0,0,0
1667950650764,ECE 269,A01,103665,Pal; Piya,0,0,0,0
1667950651188,ECE 271B,A00,103666,Vasconcelos; Manuela,0,0,0,0
1667950651610,ECE 276A,A00,103667,Atanasov; Nikolay A.,0,0,0,0
1667950652037,ECE 277,A00,103668,An; Cheolhong,0,0,0,0
1667950652469,ECE 279,A00,117947,Hall; Drew A.,0,0,0,0
1667950653328,ECE 283,A00,103670,Hsueh; Tzu-Chien,0,0,0,0
1667950653766,ECE 284,A00,103671,Turakhia; Yatish Girish,0,0,0,0
1667950654194,ECE 285,A00,103672,Zheng; Yang,0,0,0,0
1667950654194,ECE 285,B00,103673,Sworder; David D.,0,0,0,0
1667950654623,ECE 287,A00,103676,Javidi; Tara,0,0,0,0
1667950655061,MATH 200B,A00,098023,Salehi Golsefidy; Alireza,14,0,15,1
1667950655492,MATH 202B,A00,098024,Rhoades; Brendon Patrick,12,0,15,3
1667950655916,MATH 203B,A00,098025,Oprea; Dragos N.,14,0,15,1
1667950656352,MATH 204B,A00,098026,Sorensen; Claus M,15,0,15,0
1667950656774,MATH 208,A00,098027,Izadi; Elham,7,0,10,3
1667950657211,MATH 209,A00,098028,Pollack; Aaron,10,0,10,0
1667950657639,MATH 211A,A00,112919,Rogalski; Daniel,10,0,10,0
1667950658081,MATH 211B,A00,112920,Seward; Brandon M.,10,0,10,0
1667950658506,MATH 218,A00,098029,Li; Bo,10,0,10,0
1667950658931,MATH 220B,A00,098030,Novak; Jonathan I,13,0,15,2
1667950659357,MATH 221A,A00,098031,Ebenfelt; Peter F,14,0,15,1
1667950659786,MATH 231B,A00,098032,Zlatos; Andrej,13,0,15,2
1667950660208,MATH 240B,A00,098033,Ni; Lei,10,0,15,5
1667950660635,MATH 243,A00,098034,Jekel; David Andrew,10,0,10,0
1667950661060,MATH 245A,A00,098035,Nie; Jiawang,2,0,15,13
1667950661483,MATH 248,A00,098036,Bejenaru; Ioan,10,0,10,0
1667950661910,MATH 250B,A00,098037,Spolaor; Luca,14,0,15,1
1667950662342,MATH 258,A00,098038,Ni; Lei,10,0,10,0
1667950662851,MATH 264B,A00,098041,Rhoades; Brendon Patrick,13,0,15,2
1667950663274,MATH 268,A00,098042,Buss; Samuel R,10,0,10,0
1667950663698,MATH 269,A00,098043,Rhoades; Brendon Patrick,10,0,10,0
1667950664122,MATH 270B,A00,098044,Li; Bo,11,0,15,4
1667950664554,MATH 272B,A00,098045,Holst; Michael J,13,0,15,2
1667950664983,MATH 273A,A00,098046,Tian; Xiaochuan,12,0,15,3
1667950665407,MATH 275,A01,098048,Tian; Xiaochuan,6,0,10,4
1667950665830,MATH 278A,A00,098049,Holst; Michael J,8,0,10,2
1667950666255,MATH 278B,A00,098050,Cloninger; Alexander,10,0,10,0
1667950666681,MATH 278C,A00,098051,Nie; Jiawang,8,0,10,2
1667950667108,MATH 280B,A00,098052,Zheng; Tianyi,12,0,15,3
1667950667542,MATH 281B,A00,098053,Bradic; Jelena,4,0,15,11
1667950667966,MATH 282B,A00,098054,Arias-Castro; Ery,2,0,15,13
1667950668390,MATH 285,A00,098055,Fitzsimmons; Patrick J,0,0,15,15
1667950668815,MATH 287B,A00,098056,Arias-Castro; Ery,7,0,15,8
1667950669248,MATH 288,A00,098057,Agarwal; Pooja,9,0,10,1
1667950669248,MATH 288,B00,098058,Zhang; Danna,9,0,10,1
1667950669248,MATH 288,C00,098059,Williams; Ruth J,10,0,10,0
1667950669676,MATH 290B,A00,098060,Roberts; Justin Deritter,14,0,15,1
1667950670099,MATH 292,A00,098061,Belmont; Eva Kinoshita,10,0,10,0
1667950670523,MATH 295,A00,098062,Suk; Andrew Hoon,48,0,50,2
1667950670948,MATH 296,A00,098063,Novak; Jonathan I,20,0,20,0
1667950671375,MATH 297,001,098064,Gamst; Anthony Collins,9997,0,9999,2
1667951176492,COGS 205,A00,101395,Chiba; Andrea,19,0,20,1
1667951176925,COGS 210B,001,101404,Greene; Deanna Jacquelyn,9998,0,9999,1
1667951176925,COGS 210B,002,101417,Xia; Haijun,9999,0,9999,0
1667951176925,COGS 210B,003,101422,Nitz; Douglas A.,9999,0,9999,0
1667951176925,COGS 210B,004,101423,Hollan; James D.,9998,0,9999,1
1667951176925,COGS 210B,005,101424,Deak; Gedeon O.,9999,0,9999,0
1667951176925,COGS 210B,006,101425,Rossano; Federico,9999,0,9999,0
1667951177349,COGS 211B,A00,101427,Coulson; Seana M,9997,0,9999,2
1667951177773,COGS 220,A00,101428,Hollan; James D.,0,0,25,25
1667951178195,COGS 229,A00,101429,Dow; Steven P,18,0,25,7
1667951178625,COGS 230,A00,101430,Klemmer; Scott R,13,0,17,4
1667951179066,COGS 234,A00,101431,Xia; Haijun,8,0,25,17
1667951179504,COGS 260,A00,101432,Kiyonaga; Anastasia,20,0,25,5
1667951179504,COGS 260,B00,101433,Kirsh; David Joel,16,0,25,9
1667951180060,CSE 202,A00,102371,Impagliazzo; Russell,0,0,0,0
1667951180488,CSE 203B,A01,102373,Cheng; Chung Kuan,0,0,0,0
1667951180911,CSE 208,A00,102374,Micciancio; Daniele,0,0,0,0
1667951181362,CSE 209A,A00,112895,Impagliazzo; Russell,0,0,15,15
1667951181784,CSE 209B,A00,108005,Bellare; Mihir,0,0,0,0
1667951182212,CSE 210,A00,113163,Coblenz; Michael J,0,0,0,0
1667951182637,CSE 219,A00,106111,Dow; Steven P,0,0,20,20
1667951183063,CSE 221,A00,102376,Voelker; Geoffrey M.,0,0,0,0
1667951183500,CSE 224,A01,102378,Porter; George M,0,0,0,0
1667951183931,CSE 229A,A00,102379,Savage; Stefan,0,0,0,0
1667951184358,CSE 229C,A00,102380,Munyaka; Imani N. S.,0,0,0,0
1667951184801,CSE 232B,A00,102382,Deutsch; Alin Bernard,0,0,0,0
1667951185237,CSE 234,A01,112904,Kumar; Arun Kumar,0,0,0,0
1667951185677,CSE 237A,A00,102383,Rosing; Tajana Simunic,0,0,0,0
1667951186108,CSE 239A,A00,102384,Deutsch; Alin Bernard,0,0,0,0
1667951186536,CSE 239B,A00,102385,Polikarpova; Nadezhda,0,0,0,0
1667951186960,CSE 240A,A00,102386,Pannuto; Patrick William,0,0,0,0
1667951187388,CSE 240B,A00,102387,Zhao; Jishen,0,0,0,0
1667951187821,CSE 241A,A00,106406,Kang; Mingu,0,0,0,0
1667951188354,CSE 249B,A00,102388,Kahng; Andrew Byun,0,0,8,8
1667951188788,CSE 251B,A01,102392,Cottrell; Garrison W,0,0,0,0
1667951188788,CSE 251B,A02,102393,Cottrell; Garrison W,0,0,0,0
1667951189225,CSE 252B,A00,102394,Ochoa; Benjamin Lawrence,0,0,0,0
1667951189651,CSE 257,A01,102396,Gao; Sicun,0,0,0,0
1667951190083,CSE 272,A00,102397,Li; Tzumao,0,0,0,0
1667951190524,CSE 274,A00,111323,Chern; Albert Ren-Haur,0,0,0,0
1667951190965,CSE 282,A00,102398,Pevzner; Pavel Arkadjevich,0,0,0,0
1667951191394,CSE 284,A00,114175,Gymrek; Melissa Ann,0,0,0,0
1667951191817,CSE 290,A00,102399,Chandraker; Manmohan Krishna,0,0,0,0
1667951191817,CSE 290,B00,102400,Vaccaro; Kristen Marie,0,0,25,25
1667951191817,CSE 290,C00,102414,Pannuto; Patrick William,0,0,25,25
1667951191817,CSE 290,D00,102427,Pevzner; Pavel Arkadjevich,0,0,0,0
1667951191817,CSE 290,E00,102429,Zhao; Jishen,0,0,0,0
1667951191817,CSE 290,F00,102436,Tullsen; Dean Michael,0,0,0,0
1667951191817,CSE 290,G00,102440,Christensen; Henrik I,0,0,20,20
1667951192241,CSE 291,A00,102443,Su; Hao,0,0,0,0
1667951192241,CSE 291,B00,102448,Polikarpova; Nadezhda,0,0,0,0
1667951192241,CSE 291,C00,102453,Vaccaro; Kristen Marie,0,0,0,0
1667951192241,CSE 291,D00,111343,Savage; Stefan,0,0,0,0
1667951192241,CSE 291,E00,116474,Claffy; Kimberly Claire,0,0,0,0
1667951192241,CSE 291,F00,116479,Pasquale; Joseph,0,0,0,0
1667951192673,CSE 293,001,119111,Bafna; Vineet,9999,0,9999,0
1667951192673,CSE 293,002,119118,Bellare; Mihir,9999,0,9999,0
1667951192673,CSE 293,003,119122,Berg-Kirkpatrick; Taylor D,9999,0,9999,0
1667951192673,CSE 293,004,119135,Christensen; Henrik I,9999,0,9999,0
1667951192673,CSE 293,005,119142,Cottrell; Garrison W,9999,0,9999,0
1667951192673,CSE 293,006,119146,Deutsch; Alin Bernard,9999,0,9999,0
1667951192673,CSE 293,007,119159,Esmaeilzadeh; Hadi,9999,0,9999,0
1667951192673,CSE 293,008,119166,Freund; Yoav,9999,0,9999,0
1667951192673,CSE 293,009,119170,Griswold; William G.,9999,0,9999,0
1667951192673,CSE 293,010,119183,Gymrek; Melissa Ann,9999,0,9999,0
1667951192673,CSE 293,011,119190,Heninger; Nadia A,9999,0,9999,0
1667951192673,CSE 293,012,119230,Impagliazzo; Russell,9999,0,9999,0
1667951192673,CSE 293,013,119232,Jhala; Ranjit,9999,0,9999,0
1667951192673,CSE 293,014,119233,Kahng; Andrew Byun,9999,0,9999,0
1667951192673,CSE 293,015,119298,Kane; Daniel Mertz,9999,0,9999,0
1667951192673,CSE 293,016,119299,Kriegman; David J,9999,0,9999,0
1667951192673,CSE 293,017,119300,Kumar; Arun Kumar,9999,0,9999,0
1667951192673,CSE 293,018,119301,Lerner; Sorin,9999,0,9999,0
1667951192673,CSE 293,019,119302,Lovett; Shachar,9999,0,9999,0
1667951192673,CSE 293,020,119303,McAuley; Julian John,9999,0,9999,0
1667951192673,CSE 293,021,119304,Micciancio; Daniele,9999,0,9999,0
1667951192673,CSE 293,022,119367,Orailoglu; Alex,9999,0,9999,0
1667951192673,CSE 293,023,119382,Paturi; Ramamohan,9999,0,9999,0
1667951192673,CSE 293,024,119404,Polikarpova; Nadezhda,9999,0,9999,0
1667951192673,CSE 293,025,119406,Politz; Joseph Gibbs,9999,0,9999,0
1667951192673,CSE 293,026,119411,Porter; George M,9999,0,9999,0
1667951192673,CSE 293,027,119414,Porter; Leonard Emerson,9999,0,9999,0
1667951192673,CSE 293,028,119416,Ramamoorthi; Ravi,9999,0,9999,0
1667951192673,CSE 293,029,119417,Sahoo; Debashis,9999,0,9999,0
1667951192673,CSE 293,030,119420,Saul; Lawrence,9999,0,9999,0
1667951192673,CSE 293,031,119421,Savage; Stefan,9999,0,9999,0
1667951192673,CSE 293,032,119425,Schulze; Jurgen P.,9999,0,9999,0
1667951192673,CSE 293,033,119426,Snoeren; Alex C.,9999,0,9999,0
1667951192673,CSE 293,034,119428,Shang; Jingbo,9999,0,9999,0
1667951192673,CSE 293,035,119430,Stefan; Deian,9999,0,9999,0
1667951192673,CSE 293,036,119431,Su; Hao,9999,0,9999,0
1667951192673,CSE 293,037,119433,Swanson; Steven James,9999,0,9999,0
1667951192673,CSE 293,038,119435,Tullsen; Dean Michael,9999,0,9999,0
1667951192673,CSE 293,039,119483,Voelker; Geoffrey M.,9999,0,9999,0
1667951192673,CSE 293,040,119537,Zhao; Jishen,9999,0,9999,0
1667951192673,CSE 293,041,119538,Zhou; Yuan-Yuan,9999,0,9999,0
1667951192673,CSE 293,042,119539,Gao; Sicun,9999,0,9999,0
1667951192673,CSE 293,043,119540,Weibel; Nadir,9999,0,9999,0
1667951192673,CSE 293,044,119541,Gupta; Rajesh K.,9999,0,9999,0
1667951193096,CSE 294,A00,102459,Voelker; Geoffrey M.,0,0,0,0
1667951193096,CSE 294,B00,111322,Orailoglu; Alex,0,0,0,0
1667951193521,DSE 201,A00,096914,Deutsch; Alin Bernard,30,0,30,0
1667951193947,DSE 210,A00,096915,Dasgupta; Sanjoy,30,0,30,0
1667951194374,DSE 260A,A00,096916,Altintas De Callaf; Ilkay,30,0,30,0
1667951194839,ECE 200,001,103586,Antipa; Nicholas A,9999,0,9999,0
1667951194839,ECE 200,002,103587,Atanasov; Nikolay A.,9999,0,9999,0
1667951194839,ECE 200,003,103588,Bharadia; Dinesh,9999,0,9999,0
1667951194839,ECE 200,004,103589,Cheng; Chung Kuan,9999,0,9999,0
1667951194839,ECE 200,005,103590,Cosman; Pamela C.,9999,0,9999,0
1667951194839,ECE 200,006,103591,Dayeh; Shadi Ahmad,9999,0,9999,0
1667951194839,ECE 200,007,103592,Fainman; Yeshaiahu,9999,0,9999,0
1667951194839,ECE 200,008,103593,Ford; Joseph Earl,9999,0,9999,0
1667951194839,ECE 200,009,103594,Franceschetti; Massimo,9999,0,9999,0
1667951194839,ECE 200,010,103595,Fullerton; Eric E,9999,0,9999,0
1667951194839,ECE 200,011,103596,Galton; Ian A,9999,0,9999,0
1667951194839,ECE 200,012,103597,Gilja; Vikash,9999,0,9999,0
1667951194839,ECE 200,013,103598,Hall; Drew A.,9999,0,9999,0
1667951194839,ECE 200,014,103599,Hsueh; Tzu-Chien,9999,0,9999,0
1667951194839,ECE 200,015,103600,Javidi; Tara,9999,0,9999,0
1667951194839,ECE 200,016,103601,Kahng; Andrew Byun,9999,0,9999,0
1667951194839,ECE 200,017,103602,Kim; Young-Han,9999,0,9999,0
1667951194839,ECE 200,018,103603,Koushanfar; Farinaz,9999,0,9999,0
1667951194839,ECE 200,019,103604,Kuzum; Duygu,9999,0,9999,0
1667951194839,ECE 200,020,103605,Le; Hanh-Phuc,9999,0,9999,0
1667951194839,ECE 200,021,103606,Lin; Bill,9999,0,9999,0
1667951194839,ECE 200,022,103607,Liu; Zhaowei,9998,0,9999,1
1667951194839,ECE 200,023,103608,Lo; Yu-Hwa,9999,0,9999,0
1667951194839,ECE 200,024,103609,Lomakin; Vitaliy,9999,0,9999,0
1667951194839,ECE 200,025,103610,Mercier; Patrick Philip,9999,0,9999,0
1667951194839,ECE 200,026,103611,Meyer; Florian,9999,0,9999,0
1667951194839,ECE 200,027,103612,Milstein; Laurence B.,9999,0,9999,0
1667951194839,ECE 200,028,103613,Mir Arabbaygi; Siavash,9999,0,9999,0
1667951194839,ECE 200,029,103614,Mookherjea; Shayan,9999,0,9999,0
1667951194839,ECE 200,030,103615,Morris; Karcher William,9999,0,9999,0
1667951194839,ECE 200,031,103616,Ng; Tse Nga,9999,0,9999,0
1667951194839,ECE 200,032,103617,Nguyen; Truong Quang,9999,0,9999,0
1667951194839,ECE 200,033,103618,Nomura; Kenji,9999,0,9999,0
1667951194839,ECE 200,034,103619,Orlitsky; Alon,9999,0,9999,0
1667951194839,ECE 200,035,103620,Pal; Piya,9999,0,9999,0
1667951194839,ECE 200,036,103621,Papen; George C.,9999,0,9999,0
1667951194839,ECE 200,037,103622,Radic; Stojan,9999,0,9999,0
1667951194839,ECE 200,038,103623,Rao; Bhaskar D.,9999,0,9999,0
1667951194839,ECE 200,039,103624,Rao; Ramesh R,9999,0,9999,0
1667951194839,ECE 200,040,103625,Rebeiz; Gabriel,9999,0,9999,0
1667951194839,ECE 200,041,103626,Sanford; John R,9999,0,9999,0
1667951194839,ECE 200,042,103627,Siegel; Paul H.,9999,0,9999,0
1667951194839,ECE 200,043,103628,Sievenpiper; Daniel F.,9999,0,9999,0
1667951194839,ECE 200,044,103629,Sworder; David D.,9999,0,9999,0
1667951194839,ECE 200,045,103630,Taur; Yuan,9999,0,9999,0
1667951194839,ECE 200,046,103631,Touri; Behrouz,9999,0,9999,0
1667951194839,ECE 200,047,103632,Trivedi; Mohan M.,9999,0,9999,0
1667951194839,ECE 200,048,103633,Vasconcelos; Nuno,9999,0,9999,0
1667951194839,ECE 200,049,103634,Wang; Xiaolong,9999,0,9999,0
1667951194839,ECE 200,050,103635,Xie; Pengtao,9999,0,9999,0
1667951194839,ECE 200,051,103636,Yip; Michael,9999,0,9999,0
1667951194839,ECE 200,052,103637,Zeger; Kenneth A.,999,0,999,0
1667951194839,ECE 200,053,103638,Zhang; Xinyu,9999,0,9999,0
1667951194839,ECE 200,054,103639,Turakhia; Yatish Girish,9999,0,9999,0
1667951194839,ECE 200,055,103640,Kang; Mingu,9999,0,9999,0
1667951194839,ECE 200,056,103641,Shi; Yuanyuan,9999,0,9999,0
1667951194839,ECE 200,057,103642,Wang; Edward Jay,9999,0,9999,0
1667951194839,ECE 200,058,103643,Zheng; Yang,9999,0,9999,0
1667951195272,ECE 202,A00,103644,Kuzum; Duygu,0,0,0,0
1667951195708,ECE 212BN,A00,103646,Ng; Tse Nga,0,0,0,0
1667951196132,ECE 221,A00,111493,Staff,0,0,0,0
1667951196556,ECE 222B,A00,103647,Lomakin; Vitaliy,0,0,0,0
1667951196983,ECE 230B,A00,103648,Taur; Yuan,0,0,0,0
1667951197409,ECE 238B,A00,103649,Garay; Javier,0,0,0,0
1667951197834,ECE 240B,A00,112900,Fainman; Yeshaiahu,0,0,0,0
1667951198264,ECE 247A,A00,103650,Jokerst; Jesse Vincent,0,0,0,0
1667951198687,ECE 247B,A00,103651,Wang; Joseph,0,0,0,0
1667951199135,ECE 250,A00,103652,Siegel; Paul H.,0,0,0,0
1667951199562,ECE 251A,A00,103654,Rao; Bhaskar D.,0,0,0,0
1667951199993,ECE 257B,A00,103655,Bharadia; Dinesh,0,0,0,0
1667951200416,ECE 258A,A00,103656,Milstein; Laurence B.,0,0,0,0
1667951200845,ECE 260B,A00,103658,Kang; Mingu,0,0,0,0
1667951201270,ECE 264A,A00,103659,Galton; Ian A,0,0,0,0
1667951201707,ECE 265A,A00,103661,Gudem; Prasad S.S.,0,0,0,0
1667951202136,ECE 265D,A00,103662,Gudem; Prasad S.S.,0,0,0,0
1667951202559,ECE 268,A00,103663,Koushanfar; Farinaz,0,0,0,0
1667951202983,ECE 269,A01,103665,Pal; Piya,0,0,0,0
1667951203423,ECE 271B,A00,103666,Vasconcelos; Manuela,0,0,0,0
1667951203852,ECE 276A,A00,103667,Atanasov; Nikolay A.,0,0,0,0
1667951204285,ECE 277,A00,103668,An; Cheolhong,0,0,0,0
1667951204721,ECE 279,A00,117947,Hall; Drew A.,0,0,0,0
1667951205594,ECE 283,A00,103670,Hsueh; Tzu-Chien,0,0,0,0
1667951206019,ECE 284,A00,103671,Turakhia; Yatish Girish,0,0,0,0
1667951206449,ECE 285,A00,103672,Zheng; Yang,0,0,0,0
1667951206449,ECE 285,B00,103673,Sworder; David D.,0,0,0,0
1667951206875,ECE 287,A00,103676,Javidi; Tara,0,0,0,0
1667951207307,MATH 200B,A00,098023,Salehi Golsefidy; Alireza,14,0,15,1
1667951207730,MATH 202B,A00,098024,Rhoades; Brendon Patrick,12,0,15,3
1667951208154,MATH 203B,A00,098025,Oprea; Dragos N.,14,0,15,1
1667951208596,MATH 204B,A00,098026,Sorensen; Claus M,15,0,15,0
1667951209019,MATH 208,A00,098027,Izadi; Elham,7,0,10,3
1667951209461,MATH 209,A00,098028,Pollack; Aaron,10,0,10,0
1667951209888,MATH 211A,A00,112919,Rogalski; Daniel,10,0,10,0
1667951210315,MATH 211B,A00,112920,Seward; Brandon M.,10,0,10,0
1667951210751,MATH 218,A00,098029,Li; Bo,10,0,10,0
1667951211178,MATH 220B,A00,098030,Novak; Jonathan I,13,0,15,2
1667951211604,MATH 221A,A00,098031,Ebenfelt; Peter F,14,0,15,1
1667951212029,MATH 231B,A00,098032,Zlatos; Andrej,13,0,15,2
1667951212451,MATH 240B,A00,098033,Ni; Lei,10,0,15,5
1667951212875,MATH 243,A00,098034,Jekel; David Andrew,10,0,10,0
1667951213307,MATH 245A,A00,098035,Nie; Jiawang,2,0,15,13
1667951213731,MATH 248,A00,098036,Bejenaru; Ioan,10,0,10,0
1667951214169,MATH 250B,A00,098037,Spolaor; Luca,14,0,15,1
1667951214606,MATH 258,A00,098038,Ni; Lei,10,0,10,0
1667951215031,MATH 264B,A00,098041,Rhoades; Brendon Patrick,13,0,15,2
1667951215456,MATH 268,A00,098042,Buss; Samuel R,10,0,10,0
1667951215885,MATH 269,A00,098043,Rhoades; Brendon Patrick,10,0,10,0
1667951216307,MATH 270B,A00,098044,Li; Bo,11,0,15,4
1667951216737,MATH 272B,A00,098045,Holst; Michael J,13,0,15,2
1667951217166,MATH 273A,A00,098046,Tian; Xiaochuan,12,0,15,3
1667951217617,MATH 275,A01,098048,Tian; Xiaochuan,6,0,10,4
1667951218043,MATH 278A,A00,098049,Holst; Michael J,8,0,10,2
1667951218482,MATH 278B,A00,098050,Cloninger; Alexander,10,0,10,0
1667951218913,MATH 278C,A00,098051,Nie; Jiawang,8,0,10,2
1667951219339,MATH 280B,A00,098052,Zheng; Tianyi,12,0,15,3
1667951219776,MATH 281B,A00,098053,Bradic; Jelena,4,0,15,11
1667951220199,MATH 282B,A00,098054,Arias-Castro; Ery,2,0,15,13
1667951220623,MATH 285,A00,098055,Fitzsimmons; Patrick J,0,0,15,15
1667951221048,MATH 287B,A00,098056,Arias-Castro; Ery,7,0,15,8
1667951221473,MATH 288,A00,098057,Agarwal; Pooja,9,0,10,1
1667951221473,MATH 288,B00,098058,Zhang; Danna,9,0,10,1
1667951221473,MATH 288,C00,098059,Williams; Ruth J,10,0,10,0
1667951221907,MATH 290B,A00,098060,Roberts; Justin Deritter,14,0,15,1
1667951222342,MATH 292,A00,098061,Belmont; Eva Kinoshita,10,0,10,0
1667951222765,MATH 295,A00,098062,Suk; Andrew Hoon,48,0,50,2
1667951223190,MATH 296,A00,098063,Novak; Jonathan I,20,0,20,0
1667951223623,MATH 297,001,098064,Gamst; Anthony Collins,9997,0,9999,2
1667951728712,COGS 205,A00,101395,Chiba; Andrea,19,0,20,1
1667951729148,COGS 210B,001,101404,Greene; Deanna Jacquelyn,9998,0,9999,1
1667951729148,COGS 210B,002,101417,Xia; Haijun,9999,0,9999,0
1667951729148,COGS 210B,003,101422,Nitz; Douglas A.,9999,0,9999,0
1667951729148,COGS 210B,004,101423,Hollan; James D.,9998,0,9999,1
1667951729148,COGS 210B,005,101424,Deak; Gedeon O.,9999,0,9999,0
1667951729148,COGS 210B,006,101425,Rossano; Federico,9999,0,9999,0
1667951729588,COGS 211B,A00,101427,Coulson; Seana M,9997,0,9999,2
1667951730023,COGS 220,A00,101428,Hollan; James D.,0,0,25,25
1667951730460,COGS 229,A00,101429,Dow; Steven P,18,0,25,7
1667951730886,COGS 230,A00,101430,Klemmer; Scott R,13,0,17,4
1667951731308,COGS 234,A00,101431,Xia; Haijun,7,0,25,18
1667951731759,COGS 260,A00,101432,Kiyonaga; Anastasia,20,0,25,5
1667951731759,COGS 260,B00,101433,Kirsh; David Joel,16,0,25,9
1667951732181,CSE 202,A00,102371,Impagliazzo; Russell,0,0,0,0
1667951732602,CSE 203B,A01,102373,Cheng; Chung Kuan,0,0,0,0
1667951733026,CSE 208,A00,102374,Micciancio; Daniele,0,0,0,0
1667951733448,CSE 209A,A00,112895,Impagliazzo; Russell,0,0,15,15
1667951733875,CSE 209B,A00,108005,Bellare; Mihir,0,0,0,0
1667951734322,CSE 210,A00,113163,Coblenz; Michael J,0,0,0,0
1667951734746,CSE 219,A00,106111,Dow; Steven P,0,0,20,20
1667951735168,CSE 221,A00,102376,Voelker; Geoffrey M.,0,0,0,0
1667951735596,CSE 224,A01,102378,Porter; George M,0,0,0,0
1667951736020,CSE 229A,A00,102379,Savage; Stefan,0,0,0,0
1667951736446,CSE 229C,A00,102380,Munyaka; Imani N. S.,0,0,0,0
1667951736870,CSE 232B,A00,102382,Deutsch; Alin Bernard,0,0,0,0
1667951737295,CSE 234,A01,112904,Kumar; Arun Kumar,0,0,0,0
1667951737724,CSE 237A,A00,102383,Rosing; Tajana Simunic,0,0,0,0
1667951738152,CSE 239A,A00,102384,Deutsch; Alin Bernard,0,0,0,0
1667951738587,CSE 239B,A00,102385,Polikarpova; Nadezhda,0,0,0,0
1667951739009,CSE 240A,A00,102386,Pannuto; Patrick William,0,0,0,0
1667951739454,CSE 240B,A00,102387,Zhao; Jishen,0,0,0,0
1667951739895,CSE 241A,A00,106406,Kang; Mingu,0,0,0,0
1667951740318,CSE 249B,A00,102388,Kahng; Andrew Byun,0,0,8,8
1667951740766,CSE 251B,A01,102392,Cottrell; Garrison W,0,0,0,0
1667951740766,CSE 251B,A02,102393,Cottrell; Garrison W,0,0,0,0
1667951741190,CSE 252B,A00,102394,Ochoa; Benjamin Lawrence,0,0,0,0
1667951741634,CSE 257,A01,102396,Gao; Sicun,0,0,0,0
1667951742071,CSE 272,A00,102397,Li; Tzumao,0,0,0,0
1667951742504,CSE 274,A00,111323,Chern; Albert Ren-Haur,0,0,0,0
1667951742934,CSE 282,A00,102398,Pevzner; Pavel Arkadjevich,0,0,0,0
1667951743359,CSE 284,A00,114175,Gymrek; Melissa Ann,0,0,0,0
1667951743781,CSE 290,A00,102399,Chandraker; Manmohan Krishna,0,0,0,0
1667951743781,CSE 290,B00,102400,Vaccaro; Kristen Marie,0,0,25,25
1667951743781,CSE 290,C00,102414,Pannuto; Patrick William,0,0,25,25
1667951743781,CSE 290,D00,102427,Pevzner; Pavel Arkadjevich,0,0,0,0
1667951743781,CSE 290,E00,102429,Zhao; Jishen,0,0,0,0
1667951743781,CSE 290,F00,102436,Tullsen; Dean Michael,0,0,0,0
1667951743781,CSE 290,G00,102440,Christensen; Henrik I,0,0,20,20
1667951744215,CSE 291,A00,102443,Su; Hao,0,0,0,0
1667951744215,CSE 291,B00,102448,Polikarpova; Nadezhda,0,0,0,0
1667951744215,CSE 291,C00,102453,Vaccaro; Kristen Marie,0,0,0,0
1667951744215,CSE 291,D00,111343,Savage; Stefan,0,0,0,0
1667951744215,CSE 291,E00,116474,Claffy; Kimberly Claire,0,0,0,0
1667951744215,CSE 291,F00,116479,Pasquale; Joseph,0,0,0,0
1667951744656,CSE 293,001,119111,Bafna; Vineet,9999,0,9999,0
1667951744656,CSE 293,002,119118,Bellare; Mihir,9999,0,9999,0
1667951744656,CSE 293,003,119122,Berg-Kirkpatrick; Taylor D,9999,0,9999,0
1667951744656,CSE 293,004,119135,Christensen; Henrik I,9999,0,9999,0
1667951744656,CSE 293,005,119142,Cottrell; Garrison W,9999,0,9999,0
1667951744656,CSE 293,006,119146,Deutsch; Alin Bernard,9999,0,9999,0
1667951744656,CSE 293,007,119159,Esmaeilzadeh; Hadi,9999,0,9999,0
1667951744656,CSE 293,008,119166,Freund; Yoav,9999,0,9999,0
1667951744656,CSE 293,009,119170,Griswold; William G.,9999,0,9999,0
1667951744656,CSE 293,010,119183,Gymrek; Melissa Ann,9999,0,9999,0
1667951744656,CSE 293,011,119190,Heninger; Nadia A,9999,0,9999,0
1667951744656,CSE 293,012,119230,Impagliazzo; Russell,9999,0,9999,0
1667951744656,CSE 293,013,119232,Jhala; Ranjit,9999,0,9999,0
1667951744656,CSE 293,014,119233,Kahng; Andrew Byun,9999,0,9999,0
1667951744656,CSE 293,015,119298,Kane; Daniel Mertz,9999,0,9999,0
1667951744656,CSE 293,016,119299,Kriegman; David J,9999,0,9999,0
1667951744656,CSE 293,017,119300,Kumar; Arun Kumar,9999,0,9999,0
1667951744656,CSE 293,018,119301,Lerner; Sorin,9999,0,9999,0
1667951744656,CSE 293,019,119302,Lovett; Shachar,9999,0,9999,0
1667951744656,CSE 293,020,119303,McAuley; Julian John,9999,0,9999,0
1667951744656,CSE 293,021,119304,Micciancio; Daniele,9999,0,9999,0
1667951744656,CSE 293,022,119367,Orailoglu; Alex,9999,0,9999,0
1667951744656,CSE 293,023,119382,Paturi; Ramamohan,9999,0,9999,0
1667951744656,CSE 293,024,119404,Polikarpova; Nadezhda,9999,0,9999,0
1667951744656,CSE 293,025,119406,Politz; Joseph Gibbs,9999,0,9999,0
1667951744656,CSE 293,026,119411,Porter; George M,9999,0,9999,0
1667951744656,CSE 293,027,119414,Porter; Leonard Emerson,9999,0,9999,0
1667951744656,CSE 293,028,119416,Ramamoorthi; Ravi,9999,0,9999,0
1667951744656,CSE 293,029,119417,Sahoo; Debashis,9999,0,9999,0
1667951744656,CSE 293,030,119420,Saul; Lawrence,9999,0,9999,0
1667951744656,CSE 293,031,119421,Savage; Stefan,9999,0,9999,0
1667951744656,CSE 293,032,119425,Schulze; Jurgen P.,9999,0,9999,0
1667951744656,CSE 293,033,119426,Snoeren; Alex C.,9999,0,9999,0
1667951744656,CSE 293,034,119428,Shang; Jingbo,9999,0,9999,0
1667951744656,CSE 293,035,119430,Stefan; Deian,9999,0,9999,0
1667951744656,CSE 293,036,119431,Su; Hao,9999,0,9999,0
1667951744656,CSE 293,037,119433,Swanson; Steven James,9999,0,9999,0
1667951744656,CSE 293,038,119435,Tullsen; Dean Michael,9999,0,9999,0
1667951744656,CSE 293,039,119483,Voelker; Geoffrey M.,9999,0,9999,0
1667951744656,CSE 293,040,119537,Zhao; Jishen,9999,0,9999,0
1667951744656,CSE 293,041,119538,Zhou; Yuan-Yuan,9999,0,9999,0
1667951744656,CSE 293,042,119539,Gao; Sicun,9999,0,9999,0
1667951744656,CSE 293,043,119540,Weibel; Nadir,9999,0,9999,0
1667951744656,CSE 293,044,119541,Gupta; Rajesh K.,9999,0,9999,0
1667951745092,CSE 294,A00,102459,Voelker; Geoffrey M.,0,0,0,0
1667951745092,CSE 294,B00,111322,Orailoglu; Alex,0,0,0,0
1667951745515,DSE 201,A00,096914,Deutsch; Alin Bernard,30,0,30,0
1667951745942,DSE 210,A00,096915,Dasgupta; Sanjoy,30,0,30,0
1667951746373,DSE 260A,A00,096916,Altintas De Callaf; Ilkay,30,0,30,0
1667951746842,ECE 200,001,103586,Antipa; Nicholas A,9999,0,9999,0
1667951746842,ECE 200,002,103587,Atanasov; Nikolay A.,9999,0,9999,0
1667951746842,ECE 200,003,103588,Bharadia; Dinesh,9999,0,9999,0
1667951746842,ECE 200,004,103589,Cheng; Chung Kuan,9999,0,9999,0
1667951746842,ECE 200,005,103590,Cosman; Pamela C.,9999,0,9999,0
1667951746842,ECE 200,006,103591,Dayeh; Shadi Ahmad,9999,0,9999,0
1667951746842,ECE 200,007,103592,Fainman; Yeshaiahu,9999,0,9999,0
1667951746842,ECE 200,008,103593,Ford; Joseph Earl,9999,0,9999,0
1667951746842,ECE 200,009,103594,Franceschetti; Massimo,9999,0,9999,0
1667951746842,ECE 200,010,103595,Fullerton; Eric E,9999,0,9999,0
1667951746842,ECE 200,011,103596,Galton; Ian A,9999,0,9999,0
1667951746842,ECE 200,012,103597,Gilja; Vikash,9999,0,9999,0
1667951746842,ECE 200,013,103598,Hall; Drew A.,9999,0,9999,0
1667951746842,ECE 200,014,103599,Hsueh; Tzu-Chien,9999,0,9999,0
1667951746842,ECE 200,015,103600,Javidi; Tara,9999,0,9999,0
1667951746842,ECE 200,016,103601,Kahng; Andrew Byun,9999,0,9999,0
1667951746842,ECE 200,017,103602,Kim; Young-Han,9999,0,9999,0
1667951746842,ECE 200,018,103603,Koushanfar; Farinaz,9999,0,9999,0
1667951746842,ECE 200,019,103604,Kuzum; Duygu,9999,0,9999,0
1667951746842,ECE 200,020,103605,Le; Hanh-Phuc,9999,0,9999,0
1667951746842,ECE 200,021,103606,Lin; Bill,9999,0,9999,0
1667951746842,ECE 200,022,103607,Liu; Zhaowei,9998,0,9999,1
1667951746842,ECE 200,023,103608,Lo; Yu-Hwa,9999,0,9999,0
1667951746842,ECE 200,024,103609,Lomakin; Vitaliy,9999,0,9999,0
1667951746842,ECE 200,025,103610,Mercier; Patrick Philip,9999,0,9999,0
1667951746842,ECE 200,026,103611,Meyer; Florian,9999,0,9999,0
1667951746842,ECE 200,027,103612,Milstein; Laurence B.,9999,0,9999,0
1667951746842,ECE 200,028,103613,Mir Arabbaygi; Siavash,9999,0,9999,0
1667951746842,ECE 200,029,103614,Mookherjea; Shayan,9999,0,9999,0
1667951746842,ECE 200,030,103615,Morris; Karcher William,9999,0,9999,0
1667951746842,ECE 200,031,103616,Ng; Tse Nga,9999,0,9999,0
1667951746842,ECE 200,032,103617,Nguyen; Truong Quang,9999,0,9999,0
1667951746842,ECE 200,033,103618,Nomura; Kenji,9999,0,9999,0
1667951746842,ECE 200,034,103619,Orlitsky; Alon,9999,0,9999,0
1667951746842,ECE 200,035,103620,Pal; Piya,9999,0,9999,0
1667951746842,ECE 200,036,103621,Papen; George C.,9999,0,9999,0
1667951746842,ECE 200,037,103622,Radic; Stojan,9999,0,9999,0
1667951746842,ECE 200,038,103623,Rao; Bhaskar D.,9999,0,9999,0
1667951746842,ECE 200,039,103624,Rao; Ramesh R,9999,0,9999,0
1667951746842,ECE 200,040,103625,Rebeiz; Gabriel,9999,0,9999,0
1667951746842,ECE 200,041,103626,Sanford; John R,9999,0,9999,0
1667951746842,ECE 200,042,103627,Siegel; Paul H.,9999,0,9999,0
1667951746842,ECE 200,043,103628,Sievenpiper; Daniel F.,9999,0,9999,0
1667951746842,ECE 200,044,103629,Sworder; David D.,9999,0,9999,0
1667951746842,ECE 200,045,103630,Taur; Yuan,9999,0,9999,0
1667951746842,ECE 200,046,103631,Touri; Behrouz,9999,0,9999,0
1667951746842,ECE 200,047,103632,Trivedi; Mohan M.,9999,0,9999,0
1667951746842,ECE 200,048,103633,Vasconcelos; Nuno,9999,0,9999,0
1667951746842,ECE 200,049,103634,Wang; Xiaolong,9999,0,9999,0
1667951746842,ECE 200,050,103635,Xie; Pengtao,9999,0,9999,0
1667951746842,ECE 200,051,103636,Yip; Michael,9999,0,9999,0
1667951746842,ECE 200,052,103637,Zeger; Kenneth A.,999,0,999,0
1667951746842,ECE 200,053,103638,Zhang; Xinyu,9999,0,9999,0
1667951746842,ECE 200,054,103639,Turakhia; Yatish Girish,9999,0,9999,0
1667951746842,ECE 200,055,103640,Kang; Mingu,9999,0,9999,0
1667951746842,ECE 200,056,103641,Shi; Yuanyuan,9999,0,9999,0
1667951746842,ECE 200,057,103642,Wang; Edward Jay,9999,0,9999,0
1667951746842,ECE 200,058,103643,Zheng; Yang,9999,0,9999,0
1667951747264,ECE 202,A00,103644,Kuzum; Duygu,0,0,0,0
1667951747688,ECE 212BN,A00,103646,Ng; Tse Nga,0,0,0,0
1667951748112,ECE 221,A00,111493,Staff,0,0,0,0
1667951748544,ECE 222B,A00,103647,Lomakin; Vitaliy,0,0,0,0
1667951748972,ECE 230B,A00,103648,Taur; Yuan,0,0,0,0
1667951749407,ECE 238B,A00,103649,Garay; Javier,0,0,0,0
1667951749836,ECE 240B,A00,112900,Fainman; Yeshaiahu,0,0,0,0
1667951750258,ECE 247A,A00,103650,Jokerst; Jesse Vincent,0,0,0,0
1667951750697,ECE 247B,A00,103651,Wang; Joseph,0,0,0,0
1667951751131,ECE 250,A00,103652,Siegel; Paul H.,0,0,0,0
1667951751569,ECE 251A,A00,103654,Rao; Bhaskar D.,0,0,0,0
1667951752007,ECE 257B,A00,103655,Bharadia; Dinesh,0,0,0,0
1667951752431,ECE 258A,A00,103656,Milstein; Laurence B.,0,0,0,0
1667951752855,ECE 260B,A00,103658,Kang; Mingu,0,0,0,0
1667951753281,ECE 264A,A00,103659,Galton; Ian A,0,0,0,0
1667951753711,ECE 265A,A00,103661,Gudem; Prasad S.S.,0,0,0,0
1667951754136,ECE 265D,A00,103662,Gudem; Prasad S.S.,0,0,0,0
1667951754560,ECE 268,A00,103663,Koushanfar; Farinaz,0,0,0,0
1667951754984,ECE 269,A01,103665,Pal; Piya,0,0,0,0
1667951755492,ECE 271B,A00,103666,Vasconcelos; Manuela,0,0,0,0
1667951755927,ECE 276A,A00,103667,Atanasov; Nikolay A.,0,0,0,0
1667951756355,ECE 277,A00,103668,An; Cheolhong,0,0,0,0
1667951756786,ECE 279,A00,117947,Hall; Drew A.,0,0,0,0
1667951757753,ECE 283,A00,103670,Hsueh; Tzu-Chien,0,0,0,0
1667951758179,ECE 284,A00,103671,Turakhia; Yatish Girish,0,0,0,0
1667951758603,ECE 285,A00,103672,Zheng; Yang,0,0,0,0
1667951758603,ECE 285,B00,103673,Sworder; David D.,0,0,0,0
1667951759038,ECE 287,A00,103676,Javidi; Tara,0,0,0,0
1667951759480,MATH 200B,A00,098023,Salehi Golsefidy; Alireza,14,0,15,1
1667951759925,MATH 202B,A00,098024,Rhoades; Brendon Patrick,12,0,15,3
1667951760348,MATH 203B,A00,098025,Oprea; Dragos N.,14,0,15,1
1667951760775,MATH 204B,A00,098026,Sorensen; Claus M,15,0,15,0
1667951761206,MATH 208,A00,098027,Izadi; Elham,7,0,10,3
1667951761660,MATH 209,A00,098028,Pollack; Aaron,10,0,10,0
1667951762091,MATH 211A,A00,112919,Rogalski; Daniel,10,0,10,0
1667951762513,MATH 211B,A00,112920,Seward; Brandon M.,10,0,10,0
1667951762938,MATH 218,A00,098029,Li; Bo,10,0,10,0
1667951763369,MATH 220B,A00,098030,Novak; Jonathan I,13,0,15,2
1667951763828,MATH 221A,A00,098031,Ebenfelt; Peter F,14,0,15,1
1667951764251,MATH 231B,A00,098032,Zlatos; Andrej,13,0,15,2
1667951764676,MATH 240B,A00,098033,Ni; Lei,10,0,15,5
1667951765099,MATH 243,A00,098034,Jekel; David Andrew,10,0,10,0
1667951765525,MATH 245A,A00,098035,Nie; Jiawang,1,0,15,14
1667951765950,MATH 248,A00,098036,Bejenaru; Ioan,10,0,10,0
1667951766379,MATH 250B,A00,098037,Spolaor; Luca,14,0,15,1
1667951766808,MATH 258,A00,098038,Ni; Lei,10,0,10,0
1667951767252,MATH 264B,A00,098041,Rhoades; Brendon Patrick,13,0,15,2
1667951767683,MATH 268,A00,098042,Buss; Samuel R,10,0,10,0
1667951768110,MATH 269,A00,098043,Rhoades; Brendon Patrick,10,0,10,0
1667951768549,MATH 270B,A00,098044,Li; Bo,11,0,15,4
1667951768973,MATH 272B,A00,098045,Holst; Michael J,13,0,15,2
1667951769404,MATH 273A,A00,098046,Tian; Xiaochuan,12,0,15,3
1667951769836,MATH 275,A01,098048,Tian; Xiaochuan,6,0,10,4
1667951770259,MATH 278A,A00,098049,Holst; Michael J,8,0,10,2
1667951770683,MATH 278B,A00,098050,Cloninger; Alexander,10,0,10,0
1667951771106,MATH 278C,A00,098051,Nie; Jiawang,8,0,10,2
1667951771533,MATH 280B,A00,098052,Zheng; Tianyi,12,0,15,3
1667951771974,MATH 281B,A00,098053,Bradic; Jelena,4,0,15,11
1667951772411,MATH 282B,A00,098054,Arias-Castro; Ery,2,0,15,13
1667951772836,MATH 285,A00,098055,Fitzsimmons; Patrick J,0,0,15,16
1667951773264,MATH 287B,A00,098056,Arias-Castro; Ery,6,0,15,9
1667951773695,MATH 288,A00,098057,Agarwal; Pooja,9,0,10,1
1667951773695,MATH 288,B00,098058,Zhang; Danna,9,0,10,1
1667951773695,MATH 288,C00,098059,Williams; Ruth J,10,0,10,0
1667951774141,MATH 290B,A00,098060,Roberts; Justin Deritter,14,0,15,1
1667951774567,MATH 292,A00,098061,Belmont; Eva Kinoshita,10,0,10,0
1667951774993,MATH 295,A00,098062,Suk; Andrew Hoon,48,0,50,2
1667951775423,MATH 296,A00,098063,Novak; Jonathan I,20,0,20,0
1667951775846,MATH 297,001,098064,Gamst; Anthony Collins,9997,0,9999,2
1667952285161,COGS 205,A00,101395,Chiba; Andrea,19,0,20,1
1667952285608,COGS 210B,001,101404,Greene; Deanna Jacquelyn,9998,0,9999,1
1667952285608,COGS 210B,002,101417,Xia; Haijun,9999,0,9999,0
1667952285608,COGS 210B,003,101422,Nitz; Douglas A.,9999,0,9999,0
1667952285608,COGS 210B,004,101423,Hollan; James D.,9998,0,9999,1
1667952285608,COGS 210B,005,101424,Deak; Gedeon O.,9999,0,9999,0
1667952285608,COGS 210B,006,101425,Rossano; Federico,9999,0,9999,0
1667952286033,COGS 211B,A00,101427,Coulson; Seana M,9997,0,9999,2
1667952286457,COGS 220,A00,101428,Hollan; James D.,0,0,25,25
1667952287001,COGS 229,A00,101429,Dow; Steven P,18,0,25,7
1667952287437,COGS 230,A00,101430,Klemmer; Scott R,13,0,17,4
1667952287861,COGS 234,A00,101431,Xia; Haijun,7,0,25,18
1667952288285,COGS 260,A00,101432,Kiyonaga; Anastasia,20,0,25,5
1667952288285,COGS 260,B00,101433,Kirsh; David Joel,16,0,25,9
1667952288735,CSE 202,A00,102371,Impagliazzo; Russell,0,0,0,0
1667952289161,CSE 203B,A01,102373,Cheng; Chung Kuan,0,0,0,0
1667952289614,CSE 208,A00,102374,Micciancio; Daniele,0,0,0,0
1667952290069,CSE 209A,A00,112895,Impagliazzo; Russell,0,0,15,15
1667952290504,CSE 209B,A00,108005,Bellare; Mihir,0,0,0,0
1667952290950,CSE 210,A00,113163,Coblenz; Michael J,0,0,0,0
1667952291384,CSE 219,A00,106111,Dow; Steven P,0,0,20,20
1667952291808,CSE 221,A00,102376,Voelker; Geoffrey M.,0,0,0,0
1667952292255,CSE 224,A01,102378,Porter; George M,0,0,0,0
1667952292688,CSE 229A,A00,102379,Savage; Stefan,0,0,0,0
1667952293131,CSE 229C,A00,102380,Munyaka; Imani N. S.,0,0,0,0
1667952293557,CSE 232B,A00,102382,Deutsch; Alin Bernard,0,0,0,0
1667952293991,CSE 234,A01,112904,Kumar; Arun Kumar,0,0,0,0
1667952294420,CSE 237A,A00,102383,Rosing; Tajana Simunic,0,0,0,0
1667952294846,CSE 239A,A00,102384,Deutsch; Alin Bernard,0,0,0,0
1667952295286,CSE 239B,A00,102385,Polikarpova; Nadezhda,0,0,0,0
1667952295727,CSE 240A,A00,102386,Pannuto; Patrick William,0,0,0,0
1667952296152,CSE 240B,A00,102387,Zhao; Jishen,0,0,0,0
1667952296586,CSE 241A,A00,106406,Kang; Mingu,0,0,0,0
1667952297011,CSE 249B,A00,102388,Kahng; Andrew Byun,0,0,8,8
1667952297443,CSE 251B,A01,102392,Cottrell; Garrison W,0,0,0,0
1667952297443,CSE 251B,A02,102393,Cottrell; Garrison W,0,0,0,0
1667952297881,CSE 252B,A00,102394,Ochoa; Benjamin Lawrence,0,0,0,0
1667952298321,CSE 257,A01,102396,Gao; Sicun,0,0,0,0
1667952298744,CSE 272,A00,102397,Li; Tzumao,0,0,0,0
1667952299171,CSE 274,A00,111323,Chern; Albert Ren-Haur,0,0,0,0
1667952299607,CSE 282,A00,102398,Pevzner; Pavel Arkadjevich,0,0,0,0
1667952300039,CSE 284,A00,114175,Gymrek; Melissa Ann,0,0,0,0
1667952300468,CSE 290,A00,102399,Chandraker; Manmohan Krishna,0,0,0,0
1667952300468,CSE 290,B00,102400,Vaccaro; Kristen Marie,0,0,25,25
1667952300468,CSE 290,C00,102414,Pannuto; Patrick William,0,0,25,25
1667952300468,CSE 290,D00,102427,Pevzner; Pavel Arkadjevich,0,0,0,0
1667952300468,CSE 290,E00,102429,Zhao; Jishen,0,0,0,0
1667952300468,CSE 290,F00,102436,Tullsen; Dean Michael,0,0,0,0
1667952300468,CSE 290,G00,102440,Christensen; Henrik I,0,0,20,20
1667952300922,CSE 291,A00,102443,Su; Hao,0,0,0,0
1667952300922,CSE 291,B00,102448,Polikarpova; Nadezhda,0,0,0,0
1667952300922,CSE 291,C00,102453,Vaccaro; Kristen Marie,0,0,0,0
1667952300922,CSE 291,D00,111343,Savage; Stefan,0,0,0,0
1667952300922,CSE 291,E00,116474,Claffy; Kimberly Claire,0,0,0,0
1667952300922,CSE 291,F00,116479,Pasquale; Joseph,0,0,0,0
1667952301393,CSE 293,001,119111,Bafna; Vineet,9999,0,9999,0
1667952301393,CSE 293,002,119118,Bellare; Mihir,9999,0,9999,0
1667952301393,CSE 293,003,119122,Berg-Kirkpatrick; Taylor D,9999,0,9999,0
1667952301393,CSE 293,004,119135,Christensen; Henrik I,9999,0,9999,0
1667952301393,CSE 293,005,119142,Cottrell; Garrison W,9999,0,9999,0
1667952301393,CSE 293,006,119146,Deutsch; Alin Bernard,9999,0,9999,0
1667952301393,CSE 293,007,119159,Esmaeilzadeh; Hadi,9999,0,9999,0
1667952301393,CSE 293,008,119166,Freund; Yoav,9999,0,9999,0
1667952301393,CSE 293,009,119170,Griswold; William G.,9999,0,9999,0
1667952301393,CSE 293,010,119183,Gymrek; Melissa Ann,9999,0,9999,0
1667952301393,CSE 293,011,119190,Heninger; Nadia A,9999,0,9999,0
1667952301393,CSE 293,012,119230,Impagliazzo; Russell,9999,0,9999,0
1667952301393,CSE 293,013,119232,Jhala; Ranjit,9999,0,9999,0
1667952301393,CSE 293,014,119233,Kahng; Andrew Byun,9999,0,9999,0
1667952301393,CSE 293,015,119298,Kane; Daniel Mertz,9999,0,9999,0
1667952301393,CSE 293,016,119299,Kriegman; David J,9999,0,9999,0
1667952301393,CSE 293,017,119300,Kumar; Arun Kumar,9999,0,9999,0
1667952301393,CSE 293,018,119301,Lerner; Sorin,9999,0,9999,0
1667952301393,CSE 293,019,119302,Lovett; Shachar,9999,0,9999,0
1667952301393,CSE 293,020,119303,McAuley; Julian John,9999,0,9999,0
1667952301393,CSE 293,021,119304,Micciancio; Daniele,9999,0,9999,0
1667952301393,CSE 293,022,119367,Orailoglu; Alex,9999,0,9999,0
1667952301393,CSE 293,023,119382,Paturi; Ramamohan,9999,0,9999,0
1667952301393,CSE 293,024,119404,Polikarpova; Nadezhda,9999,0,9999,0
1667952301393,CSE 293,025,119406,Politz; Joseph Gibbs,9999,0,9999,0
1667952301393,CSE 293,026,119411,Porter; George M,9999,0,9999,0
1667952301393,CSE 293,027,119414,Porter; Leonard Emerson,9999,0,9999,0
1667952301393,CSE 293,028,119416,Ramamoorthi; Ravi,9999,0,9999,0
1667952301393,CSE 293,029,119417,Sahoo; Debashis,9999,0,9999,0
1667952301393,CSE 293,030,119420,Saul; Lawrence,9999,0,9999,0
1667952301393,CSE 293,031,119421,Savage; Stefan,9999,0,9999,0
1667952301393,CSE 293,032,119425,Schulze; Jurgen P.,9999,0,9999,0
1667952301393,CSE 293,033,119426,Snoeren; Alex C.,9999,0,9999,0
1667952301393,CSE 293,034,119428,Shang; Jingbo,9999,0,9999,0
1667952301393,CSE 293,035,119430,Stefan; Deian,9999,0,9999,0
1667952301393,CSE 293,036,119431,Su; Hao,9999,0,9999,0
1667952301393,CSE 293,037,119433,Swanson; Steven James,9999,0,9999,0
1667952301393,CSE 293,038,119435,Tullsen; Dean Michael,9999,0,9999,0
1667952301393,CSE 293,039,119483,Voelker; Geoffrey M.,9999,0,9999,0
1667952301393,CSE 293,040,119537,Zhao; Jishen,9999,0,9999,0
1667952301393,CSE 293,041,119538,Zhou; Yuan-Yuan,9999,0,9999,0
1667952301393,CSE 293,042,119539,Gao; Sicun,9999,0,9999,0
1667952301393,CSE 293,043,119540,Weibel; Nadir,9999,0,9999,0
1667952301393,CSE 293,044,119541,Gupta; Rajesh K.,9999,0,9999,0
1667952301836,CSE 294,A00,102459,Voelker; Geoffrey M.,0,0,0,0
1667952301836,CSE 294,B00,111322,Orailoglu; Alex,0,0,0,0
1667952302271,DSE 201,A00,096914,Deutsch; Alin Bernard,30,0,30,0
1667952302693,DSE 210,A00,096915,Dasgupta; Sanjoy,30,0,30,0
1667952303117,DSE 260A,A00,096916,Altintas De Callaf; Ilkay,30,0,30,0
1667952303578,ECE 200,001,103586,Antipa; Nicholas A,9999,0,9999,0
1667952303578,ECE 200,002,103587,Atanasov; Nikolay A.,9999,0,9999,0
1667952303578,ECE 200,003,103588,Bharadia; Dinesh,9999,0,9999,0
1667952303578,ECE 200,004,103589,Cheng; Chung Kuan,9999,0,9999,0
1667952303578,ECE 200,005,103590,Cosman; Pamela C.,9999,0,9999,0
1667952303578,ECE 200,006,103591,Dayeh; Shadi Ahmad,9999,0,9999,0
1667952303578,ECE 200,007,103592,Fainman; Yeshaiahu,9999,0,9999,0
1667952303578,ECE 200,008,103593,Ford; Joseph Earl,9999,0,9999,0
1667952303578,ECE 200,009,103594,Franceschetti; Massimo,9999,0,9999,0
1667952303578,ECE 200,010,103595,Fullerton; Eric E,9999,0,9999,0
1667952303578,ECE 200,011,103596,Galton; Ian A,9999,0,9999,0
1667952303578,ECE 200,012,103597,Gilja; Vikash,9999,0,9999,0
1667952303578,ECE 200,013,103598,Hall; Drew A.,9999,0,9999,0
1667952303578,ECE 200,014,103599,Hsueh; Tzu-Chien,9999,0,9999,0
1667952303578,ECE 200,015,103600,Javidi; Tara,9999,0,9999,0
1667952303578,ECE 200,016,103601,Kahng; Andrew Byun,9999,0,9999,0
1667952303578,ECE 200,017,103602,Kim; Young-Han,9999,0,9999,0
1667952303578,ECE 200,018,103603,Koushanfar; Farinaz,9999,0,9999,0
1667952303578,ECE 200,019,103604,Kuzum; Duygu,9999,0,9999,0
1667952303578,ECE 200,020,103605,Le; Hanh-Phuc,9999,0,9999,0
1667952303578,ECE 200,021,103606,Lin; Bill,9999,0,9999,0
1667952303578,ECE 200,022,103607,Liu; Zhaowei,9998,0,9999,1
1667952303578,ECE 200,023,103608,Lo; Yu-Hwa,9999,0,9999,0
1667952303578,ECE 200,024,103609,Lomakin; Vitaliy,9999,0,9999,0
1667952303578,ECE 200,025,103610,Mercier; Patrick Philip,9999,0,9999,0
1667952303578,ECE 200,026,103611,Meyer; Florian,9999,0,9999,0
1667952303578,ECE 200,027,103612,Milstein; Laurence B.,9999,0,9999,0
1667952303578,ECE 200,028,103613,Mir Arabbaygi; Siavash,9999,0,9999,0
1667952303578,ECE 200,029,103614,Mookherjea; Shayan,9999,0,9999,0
1667952303578,ECE 200,030,103615,Morris; Karcher William,9999,0,9999,0
1667952303578,ECE 200,031,103616,Ng; Tse Nga,9999,0,9999,0
1667952303578,ECE 200,032,103617,Nguyen; Truong Quang,9999,0,9999,0
1667952303578,ECE 200,033,103618,Nomura; Kenji,9999,0,9999,0
1667952303578,ECE 200,034,103619,Orlitsky; Alon,9999,0,9999,0
1667952303578,ECE 200,035,103620,Pal; Piya,9999,0,9999,0
1667952303578,ECE 200,036,103621,Papen; George C.,9999,0,9999,0
1667952303578,ECE 200,037,103622,Radic; Stojan,9999,0,9999,0
1667952303578,ECE 200,038,103623,Rao; Bhaskar D.,9999,0,9999,0
1667952303578,ECE 200,039,103624,Rao; Ramesh R,9999,0,9999,0
1667952303578,ECE 200,040,103625,Rebeiz; Gabriel,9999,0,9999,0
1667952303578,ECE 200,041,103626,Sanford; John R,9999,0,9999,0
1667952303578,ECE 200,042,103627,Siegel; Paul H.,9999,0,9999,0
1667952303578,ECE 200,043,103628,Sievenpiper; Daniel F.,9999,0,9999,0
1667952303578,ECE 200,044,103629,Sworder; David D.,9999,0,9999,0
1667952303578,ECE 200,045,103630,Taur; Yuan,9999,0,9999,0
1667952303578,ECE 200,046,103631,Touri; Behrouz,9999,0,9999,0
1667952303578,ECE 200,047,103632,Trivedi; Mohan M.,9999,0,9999,0
1667952303578,ECE 200,048,103633,Vasconcelos; Nuno,9999,0,9999,0
1667952303578,ECE 200,049,103634,Wang; Xiaolong,9999,0,9999,0
1667952303578,ECE 200,050,103635,Xie; Pengtao,9999,0,9999,0
1667952303578,ECE 200,051,103636,Yip; Michael,9999,0,9999,0
1667952303578,ECE 200,052,103637,Zeger; Kenneth A.,999,0,999,0
1667952303578,ECE 200,053,103638,Zhang; Xinyu,9999,0,9999,0
1667952303578,ECE 200,054,103639,Turakhia; Yatish Girish,9999,0,9999,0
1667952303578,ECE 200,055,103640,Kang; Mingu,9999,0,9999,0
1667952303578,ECE 200,056,103641,Shi; Yuanyuan,9999,0,9999,0
1667952303578,ECE 200,057,103642,Wang; Edward Jay,9999,0,9999,0
1667952303578,ECE 200,058,103643,Zheng; Yang,9999,0,9999,0
1667952304006,ECE 202,A00,103644,Kuzum; Duygu,0,0,0,0
1667952304458,ECE 212BN,A00,103646,Ng; Tse Nga,0,0,0,0
1667952304881,ECE 221,A00,111493,Staff,0,0,0,0
1667952305312,ECE 222B,A00,103647,Lomakin; Vitaliy,0,0,0,0
1667952305746,ECE 230B,A00,103648,Taur; Yuan,0,0,0,0
1667952306174,ECE 238B,A00,103649,Garay; Javier,0,0,0,0
1667952306618,ECE 240B,A00,112900,Fainman; Yeshaiahu,0,0,0,0
1667952307040,ECE 247A,A00,103650,Jokerst; Jesse Vincent,0,0,0,0
1667952307469,ECE 247B,A00,103651,Wang; Joseph,0,0,0,0
1667952307893,ECE 250,A00,103652,Siegel; Paul H.,0,0,0,0
1667952308329,ECE 251A,A00,103654,Rao; Bhaskar D.,0,0,0,0
1667952308752,ECE 257B,A00,103655,Bharadia; Dinesh,0,0,0,0
1667952309190,ECE 258A,A00,103656,Milstein; Laurence B.,0,0,0,0
1667952309629,ECE 260B,A00,103658,Kang; Mingu,0,0,0,0
1667952310061,ECE 264A,A00,103659,Galton; Ian A,0,0,0,0
1667952310484,ECE 265A,A00,103661,Gudem; Prasad S.S.,0,0,0,0
1667952310941,ECE 265D,A00,103662,Gudem; Prasad S.S.,0,0,0,0
1667952311364,ECE 268,A00,103663,Koushanfar; Farinaz,0,0,0,0
1667952311792,ECE 269,A01,103665,Pal; Piya,0,0,0,0
1667952312235,ECE 271B,A00,103666,Vasconcelos; Manuela,0,0,0,0
1667952312669,ECE 276A,A00,103667,Atanasov; Nikolay A.,0,0,0,0
1667952313114,ECE 277,A00,103668,An; Cheolhong,0,0,0,0
1667952313554,ECE 279,A00,117947,Hall; Drew A.,0,0,0,0
1667952314401,ECE 283,A00,103670,Hsueh; Tzu-Chien,0,0,0,0
1667952314831,ECE 284,A00,103671,Turakhia; Yatish Girish,0,0,0,0
1667952315266,ECE 285,A00,103672,Zheng; Yang,0,0,0,0
1667952315266,ECE 285,B00,103673,Sworder; David D.,0,0,0,0
1667952315690,ECE 287,A00,103676,Javidi; Tara,0,0,0,0
1667952316123,MATH 200B,A00,098023,Salehi Golsefidy; Alireza,14,0,15,1
1667952316564,MATH 202B,A00,098024,Rhoades; Brendon Patrick,12,0,15,3
1667952317014,MATH 203B,A00,098025,Oprea; Dragos N.,14,0,15,1
1667952317442,MATH 204B,A00,098026,Sorensen; Claus M,15,0,15,0
1667952317891,MATH 208,A00,098027,Izadi; Elham,7,0,10,3
1667952318327,MATH 209,A00,098028,Pollack; Aaron,10,0,10,0
1667952318767,MATH 211A,A00,112919,Rogalski; Daniel,10,0,10,0
1667952319192,MATH 211B,A00,112920,Seward; Brandon M.,10,0,10,0
1667952319625,MATH 218,A00,098029,Li; Bo,10,0,10,0
1667952320056,MATH 220B,A00,098030,Novak; Jonathan I,13,0,15,2
1667952320506,MATH 221A,A00,098031,Ebenfelt; Peter F,14,0,15,1
1667952320942,MATH 231B,A00,098032,Zlatos; Andrej,13,0,15,2
1667952321368,MATH 240B,A00,098033,Ni; Lei,10,0,15,5
1667952321795,MATH 243,A00,098034,Jekel; David Andrew,10,0,10,0
1667952322233,MATH 245A,A00,098035,Nie; Jiawang,1,0,15,14
1667952322697,MATH 248,A00,098036,Bejenaru; Ioan,10,0,10,0
1667952323122,MATH 250B,A00,098037,Spolaor; Luca,14,0,15,1
1667952323552,MATH 258,A00,098038,Ni; Lei,10,0,10,0
1667952323985,MATH 264B,A00,098041,Rhoades; Brendon Patrick,13,0,15,2
1667952324418,MATH 268,A00,098042,Buss; Samuel R,10,0,10,0
1667952324855,MATH 269,A00,098043,Rhoades; Brendon Patrick,10,0,10,0
1667952325280,MATH 270B,A00,098044,Li; Bo,11,0,15,4
1667952325723,MATH 272B,A00,098045,Holst; Michael J,13,0,15,2
1667952326144,MATH 273A,A00,098046,Tian; Xiaochuan,12,0,15,3
1667952326580,MATH 275,A01,098048,Tian; Xiaochuan,6,0,10,4
1667952327004,MATH 278A,A00,098049,Holst; Michael J,8,0,10,2
1667952327427,MATH 278B,A00,098050,Cloninger; Alexander,10,0,10,0
1667952327852,MATH 278C,A00,098051,Nie; Jiawang,8,0,10,2
1667952328279,MATH 280B,A00,098052,Zheng; Tianyi,12,0,15,3
1667952328717,MATH 281B,A00,098053,Bradic; Jelena,4,0,15,11
1667952329152,MATH 282B,A00,098054,Arias-Castro; Ery,2,0,15,13
1667952329580,MATH 285,A00,098055,Fitzsimmons; Patrick J,0,0,15,16
1667952330020,MATH 287B,A00,098056,Arias-Castro; Ery,6,0,15,9
1667952330449,MATH 288,A00,098057,Agarwal; Pooja,9,0,10,1
1667952330449,MATH 288,B00,098058,Zhang; Danna,9,0,10,1
1667952330449,MATH 288,C00,098059,Williams; Ruth J,10,0,10,0
1667952330957,MATH 290B,A00,098060,Roberts; Justin Deritter,14,0,15,1
1667952331389,MATH 292,A00,098061,Belmont; Eva Kinoshita,10,0,10,0
1667952331811,MATH 295,A00,098062,Suk; Andrew Hoon,48,0,50,2
1667952332235,MATH 296,A00,098063,Novak; Jonathan I,20,0,20,0
1667952332663,MATH 297,001,098064,Gamst; Anthony Collins,9997,0,9999,2
1667952852545,COGS 205,A00,101395,Chiba; Andrea,19,0,20,1
1667952852972,COGS 210B,001,101404,Greene; Deanna Jacquelyn,9998,0,9999,1
1667952852972,COGS 210B,002,101417,Xia; Haijun,9999,0,9999,0
1667952852972,COGS 210B,003,101422,Nitz; Douglas A.,9999,0,9999,0
1667952852972,COGS 210B,004,101423,Hollan; James D.,9998,0,9999,1
1667952852972,COGS 210B,005,101424,Deak; Gedeon O.,9999,0,9999,0
1667952852972,COGS 210B,006,101425,Rossano; Federico,9999,0,9999,0
1667952853395,COGS 211B,A00,101427,Coulson; Seana M,9997,0,9999,2
1667952853819,COGS 220,A00,101428,Hollan; James D.,0,0,25,25
1667952854243,COGS 229,A00,101429,Dow; Steven P,18,0,25,7
1667952854670,COGS 230,A00,101430,Klemmer; Scott R,13,0,17,4
1667952855093,COGS 234,A00,101431,Xia; Haijun,7,0,25,18
1667952855517,COGS 260,A00,101432,Kiyonaga; Anastasia,20,0,25,5
1667952855517,COGS 260,B00,101433,Kirsh; David Joel,16,0,25,9
1667952855942,CSE 202,A00,102371,Impagliazzo; Russell,0,0,0,0
1667952856375,CSE 203B,A01,102373,Cheng; Chung Kuan,0,0,0,0
1667952856806,CSE 208,A00,102374,Micciancio; Daniele,0,0,0,0
1667952857235,CSE 209A,A00,112895,Impagliazzo; Russell,0,0,15,15
1667952857663,CSE 209B,A00,108005,Bellare; Mihir,0,0,0,0
1667952858085,CSE 210,A00,113163,Coblenz; Michael J,0,0,0,0
1667952858507,CSE 219,A00,106111,Dow; Steven P,0,0,20,20
1667952858934,CSE 221,A00,102376,Voelker; Geoffrey M.,0,0,0,0
1667952859364,CSE 224,A01,102378,Porter; George M,0,0,0,0
1667952859787,CSE 229A,A00,102379,Savage; Stefan,0,0,0,0
1667952860218,CSE 229C,A00,102380,Munyaka; Imani N. S.,0,0,0,0
1667952860646,CSE 232B,A00,102382,Deutsch; Alin Bernard,0,0,0,0
1667952861083,CSE 234,A01,112904,Kumar; Arun Kumar,0,0,0,0
1667952861513,CSE 237A,A00,102383,Rosing; Tajana Simunic,0,0,0,0
1667952861934,CSE 239A,A00,102384,Deutsch; Alin Bernard,0,0,0,0
1667952862360,CSE 239B,A00,102385,Polikarpova; Nadezhda,0,0,0,0
1667952862800,CSE 240A,A00,102386,Pannuto; Patrick William,0,0,0,0
1667952863223,CSE 240B,A00,102387,Zhao; Jishen,0,0,0,0
1667952863655,CSE 241A,A00,106406,Kang; Mingu,0,0,0,0
1667952864086,CSE 249B,A00,102388,Kahng; Andrew Byun,0,0,8,8
1667952864514,CSE 251B,A01,102392,Cottrell; Garrison W,0,0,0,0
1667952864514,CSE 251B,A02,102393,Cottrell; Garrison W,0,0,0,0
1667952864939,CSE 252B,A00,102394,Ochoa; Benjamin Lawrence,0,0,0,0
1667952865361,CSE 257,A01,102396,Gao; Sicun,0,0,0,0
1667952865788,CSE 272,A00,102397,Li; Tzumao,0,0,0,0
1667952866218,CSE 274,A00,111323,Chern; Albert Ren-Haur,0,0,0,0
1667952866645,CSE 282,A00,102398,Pevzner; Pavel Arkadjevich,0,0,0,0
1667952867087,CSE 284,A00,114175,Gymrek; Melissa Ann,0,0,0,0
1667952867516,CSE 290,A00,102399,Chandraker; Manmohan Krishna,0,0,0,0
1667952867516,CSE 290,B00,102400,Vaccaro; Kristen Marie,0,0,25,25
1667952867516,CSE 290,C00,102414,Pannuto; Patrick William,0,0,25,25
1667952867516,CSE 290,D00,102427,Pevzner; Pavel Arkadjevich,0,0,0,0
1667952867516,CSE 290,E00,102429,Zhao; Jishen,0,0,0,0
1667952867516,CSE 290,F00,102436,Tullsen; Dean Michael,0,0,0,0
1667952867516,CSE 290,G00,102440,Christensen; Henrik I,0,0,20,20
1667952867948,CSE 291,A00,102443,Su; Hao,0,0,0,0
1667952867948,CSE 291,B00,102448,Polikarpova; Nadezhda,0,0,0,0
1667952867948,CSE 291,C00,102453,Vaccaro; Kristen Marie,0,0,0,0
1667952867948,CSE 291,D00,111343,Savage; Stefan,0,0,0,0
1667952867948,CSE 291,E00,116474,Claffy; Kimberly Claire,0,0,0,0
1667952867948,CSE 291,F00,116479,Pasquale; Joseph,0,0,0,0
1667952868376,CSE 293,001,119111,Bafna; Vineet,9999,0,9999,0
1667952868376,CSE 293,002,119118,Bellare; Mihir,9999,0,9999,0
1667952868376,CSE 293,003,119122,Berg-Kirkpatrick; Taylor D,9999,0,9999,0
1667952868376,CSE 293,004,119135,Christensen; Henrik I,9999,0,9999,0
1667952868376,CSE 293,005,119142,Cottrell; Garrison W,9999,0,9999,0
1667952868376,CSE 293,006,119146,Deutsch; Alin Bernard,9999,0,9999,0
1667952868376,CSE 293,007,119159,Esmaeilzadeh; Hadi,9999,0,9999,0
1667952868376,CSE 293,008,119166,Freund; Yoav,9999,0,9999,0
1667952868376,CSE 293,009,119170,Griswold; William G.,9999,0,9999,0
1667952868376,CSE 293,010,119183,Gymrek; Melissa Ann,9999,0,9999,0
1667952868376,CSE 293,011,119190,Heninger; Nadia A,9999,0,9999,0
1667952868376,CSE 293,012,119230,Impagliazzo; Russell,9999,0,9999,0
1667952868376,CSE 293,013,119232,Jhala; Ranjit,9999,0,9999,0
1667952868376,CSE 293,014,119233,Kahng; Andrew Byun,9999,0,9999,0
1667952868376,CSE 293,015,119298,Kane; Daniel Mertz,9999,0,9999,0
1667952868376,CSE 293,016,119299,Kriegman; David J,9999,0,9999,0
1667952868376,CSE 293,017,119300,Kumar; Arun Kumar,9999,0,9999,0
1667952868376,CSE 293,018,119301,Lerner; Sorin,9999,0,9999,0
1667952868376,CSE 293,019,119302,Lovett; Shachar,9999,0,9999,0
1667952868376,CSE 293,020,119303,McAuley; Julian John,9999,0,9999,0
1667952868376,CSE 293,021,119304,Micciancio; Daniele,9999,0,9999,0
1667952868376,CSE 293,022,119367,Orailoglu; Alex,9999,0,9999,0
1667952868376,CSE 293,023,119382,Paturi; Ramamohan,9999,0,9999,0
1667952868376,CSE 293,024,119404,Polikarpova; Nadezhda,9999,0,9999,0
1667952868376,CSE 293,025,119406,Politz; Joseph Gibbs,9999,0,9999,0
1667952868376,CSE 293,026,119411,Porter; George M,9999,0,9999,0
1667952868376,CSE 293,027,119414,Porter; Leonard Emerson,9999,0,9999,0
1667952868376,CSE 293,028,119416,Ramamoorthi; Ravi,9999,0,9999,0
1667952868376,CSE 293,029,119417,Sahoo; Debashis,9999,0,9999,0
1667952868376,CSE 293,030,119420,Saul; Lawrence,9999,0,9999,0
1667952868376,CSE 293,031,119421,Savage; Stefan,9999,0,9999,0
1667952868376,CSE 293,032,119425,Schulze; Jurgen P.,9999,0,9999,0
1667952868376,CSE 293,033,119426,Snoeren; Alex C.,9999,0,9999,0
1667952868376,CSE 293,034,119428,Shang; Jingbo,9999,0,9999,0
1667952868376,CSE 293,035,119430,Stefan; Deian,9999,0,9999,0
1667952868376,CSE 293,036,119431,Su; Hao,9999,0,9999,0
1667952868376,CSE 293,037,119433,Swanson; Steven James,9999,0,9999,0
1667952868376,CSE 293,038,119435,Tullsen; Dean Michael,9999,0,9999,0
1667952868376,CSE 293,039,119483,Voelker; Geoffrey M.,9999,0,9999,0
1667952868376,CSE 293,040,119537,Zhao; Jishen,9999,0,9999,0
1667952868376,CSE 293,041,119538,Zhou; Yuan-Yuan,9999,0,9999,0
1667952868376,CSE 293,042,119539,Gao; Sicun,9999,0,9999,0
1667952868376,CSE 293,043,119540,Weibel; Nadir,9999,0,9999,0
1667952868376,CSE 293,044,119541,Gupta; Rajesh K.,9999,0,9999,0
1667952868802,CSE 294,A00,102459,Voelker; Geoffrey M.,0,0,0,0
1667952868802,CSE 294,B00,111322,Orailoglu; Alex,0,0,0,0
1667952869231,DSE 201,A00,096914,Deutsch; Alin Bernard,30,0,30,0
1667952869669,DSE 210,A00,096915,Dasgupta; Sanjoy,30,0,30,0
1667952870095,DSE 260A,A00,096916,Altintas De Callaf; Ilkay,30,0,30,0
1667952870562,ECE 200,001,103586,Antipa; Nicholas A,9999,0,9999,0
1667952870562,ECE 200,002,103587,Atanasov; Nikolay A.,9999,0,9999,0
1667952870562,ECE 200,003,103588,Bharadia; Dinesh,9999,0,9999,0
1667952870562,ECE 200,004,103589,Cheng; Chung Kuan,9999,0,9999,0
1667952870562,ECE 200,005,103590,Cosman; Pamela C.,9999,0,9999,0
1667952870562,ECE 200,006,103591,Dayeh; Shadi Ahmad,9999,0,9999,0
1667952870562,ECE 200,007,103592,Fainman; Yeshaiahu,9999,0,9999,0
1667952870562,ECE 200,008,103593,Ford; Joseph Earl,9999,0,9999,0
1667952870562,ECE 200,009,103594,Franceschetti; Massimo,9999,0,9999,0
1667952870562,ECE 200,010,103595,Fullerton; Eric E,9999,0,9999,0
1667952870562,ECE 200,011,103596,Galton; Ian A,9999,0,9999,0
1667952870562,ECE 200,012,103597,Gilja; Vikash,9999,0,9999,0
1667952870562,ECE 200,013,103598,Hall; Drew A.,9999,0,9999,0
1667952870562,ECE 200,014,103599,Hsueh; Tzu-Chien,9999,0,9999,0
1667952870562,ECE 200,015,103600,Javidi; Tara,9999,0,9999,0
1667952870562,ECE 200,016,103601,Kahng; Andrew Byun,9999,0,9999,0
1667952870562,ECE 200,017,103602,Kim; Young-Han,9999,0,9999,0
1667952870562,ECE 200,018,103603,Koushanfar; Farinaz,9999,0,9999,0
1667952870562,ECE 200,019,103604,Kuzum; Duygu,9999,0,9999,0
1667952870562,ECE 200,020,103605,Le; Hanh-Phuc,9999,0,9999,0
1667952870562,ECE 200,021,103606,Lin; Bill,9999,0,9999,0
1667952870562,ECE 200,022,103607,Liu; Zhaowei,9998,0,9999,1
1667952870562,ECE 200,023,103608,Lo; Yu-Hwa,9999,0,9999,0
1667952870562,ECE 200,024,103609,Lomakin; Vitaliy,9999,0,9999,0
1667952870562,ECE 200,025,103610,Mercier; Patrick Philip,9999,0,9999,0
1667952870562,ECE 200,026,103611,Meyer; Florian,9999,0,9999,0
1667952870562,ECE 200,027,103612,Milstein; Laurence B.,9999,0,9999,0
1667952870562,ECE 200,028,103613,Mir Arabbaygi; Siavash,9999,0,9999,0
1667952870562,ECE 200,029,103614,Mookherjea; Shayan,9999,0,9999,0
1667952870562,ECE 200,030,103615,Morris; Karcher William,9999,0,9999,0
1667952870562,ECE 200,031,103616,Ng; Tse Nga,9999,0,9999,0
1667952870562,ECE 200,032,103617,Nguyen; Truong Quang,9999,0,9999,0
1667952870562,ECE 200,033,103618,Nomura; Kenji,9999,0,9999,0
1667952870562,ECE 200,034,103619,Orlitsky; Alon,9999,0,9999,0
1667952870562,ECE 200,035,103620,Pal; Piya,9999,0,9999,0
1667952870562,ECE 200,036,103621,Papen; George C.,9999,0,9999,0
1667952870562,ECE 200,037,103622,Radic; Stojan,9999,0,9999,0
1667952870562,ECE 200,038,103623,Rao; Bhaskar D.,9999,0,9999,0
1667952870562,ECE 200,039,103624,Rao; Ramesh R,9999,0,9999,0
1667952870562,ECE 200,040,103625,Rebeiz; Gabriel,9999,0,9999,0
1667952870562,ECE 200,041,103626,Sanford; John R,9999,0,9999,0
1667952870562,ECE 200,042,103627,Siegel; Paul H.,9999,0,9999,0
1667952870562,ECE 200,043,103628,Sievenpiper; Daniel F.,9999,0,9999,0
1667952870562,ECE 200,044,103629,Sworder; David D.,9999,0,9999,0
1667952870562,ECE 200,045,103630,Taur; Yuan,9999,0,9999,0
1667952870562,ECE 200,046,103631,Touri; Behrouz,9999,0,9999,0
1667952870562,ECE 200,047,103632,Trivedi; Mohan M.,9999,0,9999,0
1667952870562,ECE 200,048,103633,Vasconcelos; Nuno,9999,0,9999,0
1667952870562,ECE 200,049,103634,Wang; Xiaolong,9999,0,9999,0
1667952870562,ECE 200,050,103635,Xie; Pengtao,9999,0,9999,0
1667952870562,ECE 200,051,103636,Yip; Michael,9999,0,9999,0
1667952870562,ECE 200,052,103637,Zeger; Kenneth A.,999,0,999,0
1667952870562,ECE 200,053,103638,Zhang; Xinyu,9999,0,9999,0
1667952870562,ECE 200,054,103639,Turakhia; Yatish Girish,9999,0,9999,0
1667952870562,ECE 200,055,103640,Kang; Mingu,9999,0,9999,0
1667952870562,ECE 200,056,103641,Shi; Yuanyuan,9999,0,9999,0
1667952870562,ECE 200,057,103642,Wang; Edward Jay,9999,0,9999,0
1667952870562,ECE 200,058,103643,Zheng; Yang,9999,0,9999,0
1667952871062,ECE 202,A00,103644,Kuzum; Duygu,0,0,0,0
1667952871486,ECE 212BN,A00,103646,Ng; Tse Nga,0,0,0,0
1667952871916,ECE 221,A00,111493,Staff,0,0,0,0
1667952872344,ECE 222B,A00,103647,Lomakin; Vitaliy,0,0,0,0
1667952872780,ECE 230B,A00,103648,Taur; Yuan,0,0,0,0
1667952873215,ECE 238B,A00,103649,Garay; Javier,0,0,0,0
1667952873638,ECE 240B,A00,112900,Fainman; Yeshaiahu,0,0,0,0
1667952874073,ECE 247A,A00,103650,Jokerst; Jesse Vincent,0,0,0,0
1667952874509,ECE 247B,A00,103651,Wang; Joseph,0,0,0,0
1667952874934,ECE 250,A00,103652,Siegel; Paul H.,0,0,0,0
1667952875358,ECE 251A,A00,103654,Rao; Bhaskar D.,0,0,0,0
1667952875781,ECE 257B,A00,103655,Bharadia; Dinesh,0,0,0,0
1667952876203,ECE 258A,A00,103656,Milstein; Laurence B.,0,0,0,0
1667952876626,ECE 260B,A00,103658,Kang; Mingu,0,0,0,0
1667952877053,ECE 264A,A00,103659,Galton; Ian A,0,0,0,0
1667952877477,ECE 265A,A00,103661,Gudem; Prasad S.S.,0,0,0,0
1667952877908,ECE 265D,A00,103662,Gudem; Prasad S.S.,0,0,0,0
1667952878339,ECE 268,A00,103663,Koushanfar; Farinaz,0,0,0,0
1667952878762,ECE 269,A01,103665,Pal; Piya,0,0,0,0
1667952879186,ECE 271B,A00,103666,Vasconcelos; Manuela,0,0,0,0
1667952879615,ECE 276A,A00,103667,Atanasov; Nikolay A.,0,0,0,0
1667952880040,ECE 277,A00,103668,An; Cheolhong,0,0,0,0
1667952880466,ECE 279,A00,117947,Hall; Drew A.,0,0,0,0
1667952881311,ECE 283,A00,103670,Hsueh; Tzu-Chien,0,0,0,0
1667952881734,ECE 284,A00,103671,Turakhia; Yatish Girish,0,0,0,0
1667952882160,ECE 285,A00,103672,Zheng; Yang,0,0,0,0
1667952882160,ECE 285,B00,103673,Sworder; David D.,0,0,0,0
1667952882603,ECE 287,A00,103676,Javidi; Tara,0,0,0,0
1667952883027,MATH 200B,A00,098023,Salehi Golsefidy; Alireza,14,0,15,1
1667952883453,MATH 202B,A00,098024,Rhoades; Brendon Patrick,12,0,15,3
1667952883882,MATH 203B,A00,098025,Oprea; Dragos N.,13,0,15,2
1667952884305,MATH 204B,A00,098026,Sorensen; Claus M,15,0,15,0
1667952884729,MATH 208,A00,098027,Izadi; Elham,7,0,10,3
1667952885152,MATH 209,A00,098028,Pollack; Aaron,10,0,10,0
1667952885576,MATH 211A,A00,112919,Rogalski; Daniel,9,0,10,1
1667952886002,MATH 211B,A00,112920,Seward; Brandon M.,9,0,10,1
1667952886424,MATH 218,A00,098029,Li; Bo,10,0,10,0
1667952886852,MATH 220B,A00,098030,Novak; Jonathan I,13,0,15,2
1667952887278,MATH 221A,A00,098031,Ebenfelt; Peter F,13,0,15,2
1667952887703,MATH 231B,A00,098032,Zlatos; Andrej,13,0,15,2
1667952888127,MATH 240B,A00,098033,Ni; Lei,10,0,15,5
1667952888560,MATH 243,A00,098034,Jekel; David Andrew,10,0,10,0
1667952889005,MATH 245A,A00,098035,Nie; Jiawang,0,0,15,15
1667952889436,MATH 248,A00,098036,Bejenaru; Ioan,10,0,10,0
1667952889867,MATH 250B,A00,098037,Spolaor; Luca,14,0,15,1
1667952890291,MATH 258,A00,098038,Ni; Lei,10,0,10,0
1667952890724,MATH 264B,A00,098041,Rhoades; Brendon Patrick,12,0,15,3
1667952891154,MATH 268,A00,098042,Buss; Samuel R,10,0,10,0
1667952891577,MATH 269,A00,098043,Rhoades; Brendon Patrick,10,0,10,0
1667952892006,MATH 270B,A00,098044,Li; Bo,11,0,15,4
1667952892432,MATH 272B,A00,098045,Holst; Michael J,13,0,15,2
1667952892857,MATH 273A,A00,098046,Tian; Xiaochuan,12,0,15,3
1667952893283,MATH 275,A01,098048,Tian; Xiaochuan,6,0,10,4
1667952893718,MATH 278A,A00,098049,Holst; Michael J,8,0,10,2
1667952894139,MATH 278B,A00,098050,Cloninger; Alexander,10,0,10,0
1667952894562,MATH 278C,A00,098051,Nie; Jiawang,8,0,10,2
1667952894989,MATH 280B,A00,098052,Zheng; Tianyi,12,0,15,3
1667952895415,MATH 281B,A00,098053,Bradic; Jelena,4,0,15,11
1667952895839,MATH 282B,A00,098054,Arias-Castro; Ery,2,0,15,13
1667952896271,MATH 285,A00,098055,Fitzsimmons; Patrick J,0,0,15,17
1667952896703,MATH 287B,A00,098056,Arias-Castro; Ery,5,0,15,10
1667952897127,MATH 288,A00,098057,Agarwal; Pooja,9,0,10,1
1667952897127,MATH 288,B00,098058,Zhang; Danna,9,0,10,1
1667952897127,MATH 288,C00,098059,Williams; Ruth J,10,0,10,0
1667952897557,MATH 290B,A00,098060,Roberts; Justin Deritter,14,0,15,1
1667952897983,MATH 292,A00,098061,Belmont; Eva Kinoshita,10,0,10,0
1667952898410,MATH 295,A00,098062,Suk; Andrew Hoon,48,0,50,2
1667952898833,MATH 296,A00,098063,Novak; Jonathan I,20,0,20,0
1667952899257,MATH 297,001,098064,Gamst; Anthony Collins,9997,0,9999,2
1667953401969,COGS 205,A00,101395,Chiba; Andrea,19,0,20,1
1667953402391,COGS 210B,001,101404,Greene; Deanna Jacquelyn,9998,0,9999,1
1667953402391,COGS 210B,002,101417,Xia; Haijun,9999,0,9999,0
1667953402391,COGS 210B,003,101422,Nitz; Douglas A.,9999,0,9999,0
1667953402391,COGS 210B,004,101423,Hollan; James D.,9998,0,9999,1
1667953402391,COGS 210B,005,101424,Deak; Gedeon O.,9999,0,9999,0
1667953402391,COGS 210B,006,101425,Rossano; Federico,9999,0,9999,0
1667953402819,COGS 211B,A00,101427,Coulson; Seana M,9997,0,9999,2
1667953403243,COGS 220,A00,101428,Hollan; James D.,0,0,25,25
1667953403674,COGS 229,A00,101429,Dow; Steven P,18,0,25,7
1667953404099,COGS 230,A00,101430,Klemmer; Scott R,13,0,17,4
1667953404521,COGS 234,A00,101431,Xia; Haijun,7,0,25,18
1667953404944,COGS 260,A00,101432,Kiyonaga; Anastasia,20,0,25,5
1667953404944,COGS 260,B00,101433,Kirsh; David Joel,16,0,25,9
1667953405378,CSE 202,A00,102371,Impagliazzo; Russell,0,0,0,0
1667953405801,CSE 203B,A01,102373,Cheng; Chung Kuan,0,0,0,0
1667953406225,CSE 208,A00,102374,Micciancio; Daniele,0,0,0,0
1667953406646,CSE 209A,A00,112895,Impagliazzo; Russell,0,0,15,15
1667953407072,CSE 209B,A00,108005,Bellare; Mihir,0,0,0,0
1667953407495,CSE 210,A00,113163,Coblenz; Michael J,0,0,0,0
1667953407917,CSE 219,A00,106111,Dow; Steven P,0,0,20,20
1667953408344,CSE 221,A00,102376,Voelker; Geoffrey M.,0,0,0,0
1667953408767,CSE 224,A01,102378,Porter; George M,0,0,0,0
1667953409195,CSE 229A,A00,102379,Savage; Stefan,0,0,0,0
1667953409622,CSE 229C,A00,102380,Munyaka; Imani N. S.,0,0,0,0
1667953410058,CSE 232B,A00,102382,Deutsch; Alin Bernard,0,0,0,0
1667953410480,CSE 234,A01,112904,Kumar; Arun Kumar,0,0,0,0
1667953410908,CSE 237A,A00,102383,Rosing; Tajana Simunic,0,0,0,0
1667953411332,CSE 239A,A00,102384,Deutsch; Alin Bernard,0,0,0,0
1667953411755,CSE 239B,A00,102385,Polikarpova; Nadezhda,0,0,0,0
1667953412197,CSE 240A,A00,102386,Pannuto; Patrick William,0,0,0,0
1667953412629,CSE 240B,A00,102387,Zhao; Jishen,0,0,0,0
1667953413054,CSE 241A,A00,106406,Kang; Mingu,0,0,0,0
1667953413480,CSE 249B,A00,102388,Kahng; Andrew Byun,0,0,8,8
1667953413903,CSE 251B,A01,102392,Cottrell; Garrison W,0,0,0,0
1667953413903,CSE 251B,A02,102393,Cottrell; Garrison W,0,0,0,0
1667953414442,CSE 252B,A00,102394,Ochoa; Benjamin Lawrence,0,0,0,0
1667953414868,CSE 257,A01,102396,Gao; Sicun,0,0,0,0
1667953415294,CSE 272,A00,102397,Li; Tzumao,0,0,0,0
1667953415717,CSE 274,A00,111323,Chern; Albert Ren-Haur,0,0,0,0
1667953416142,CSE 282,A00,102398,Pevzner; Pavel Arkadjevich,0,0,0,0
1667953416567,CSE 284,A00,114175,Gymrek; Melissa Ann,0,0,0,0
1667953416997,CSE 290,A00,102399,Chandraker; Manmohan Krishna,0,0,0,0
1667953416997,CSE 290,B00,102400,Vaccaro; Kristen Marie,0,0,25,25
1667953416997,CSE 290,C00,102414,Pannuto; Patrick William,0,0,25,25
1667953416997,CSE 290,D00,102427,Pevzner; Pavel Arkadjevich,0,0,0,0
1667953416997,CSE 290,E00,102429,Zhao; Jishen,0,0,0,0
1667953416997,CSE 290,F00,102436,Tullsen; Dean Michael,0,0,0,0
1667953416997,CSE 290,G00,102440,Christensen; Henrik I,0,0,20,20
1667953417421,CSE 291,A00,102443,Su; Hao,0,0,0,0
1667953417421,CSE 291,B00,102448,Polikarpova; Nadezhda,0,0,0,0
1667953417421,CSE 291,C00,102453,Vaccaro; Kristen Marie,0,0,0,0
1667953417421,CSE 291,D00,111343,Savage; Stefan,0,0,0,0
1667953417421,CSE 291,E00,116474,Claffy; Kimberly Claire,0,0,0,0
1667953417421,CSE 291,F00,116479,Pasquale; Joseph,0,0,0,0
1667953417848,CSE 293,001,119111,Bafna; Vineet,9999,0,9999,0
1667953417848,CSE 293,002,119118,Bellare; Mihir,9999,0,9999,0
1667953417848,CSE 293,003,119122,Berg-Kirkpatrick; Taylor D,9999,0,9999,0
1667953417848,CSE 293,004,119135,Christensen; Henrik I,9999,0,9999,0
1667953417848,CSE 293,005,119142,Cottrell; Garrison W,9999,0,9999,0
1667953417848,CSE 293,006,119146,Deutsch; Alin Bernard,9999,0,9999,0
1667953417848,CSE 293,007,119159,Esmaeilzadeh; Hadi,9999,0,9999,0
1667953417848,CSE 293,008,119166,Freund; Yoav,9999,0,9999,0
1667953417848,CSE 293,009,119170,Griswold; William G.,9999,0,9999,0
1667953417848,CSE 293,010,119183,Gymrek; Melissa Ann,9999,0,9999,0
1667953417848,CSE 293,011,119190,Heninger; Nadia A,9999,0,9999,0
1667953417848,CSE 293,012,119230,Impagliazzo; Russell,9999,0,9999,0
1667953417848,CSE 293,013,119232,Jhala; Ranjit,9999,0,9999,0
1667953417848,CSE 293,014,119233,Kahng; Andrew Byun,9999,0,9999,0
1667953417848,CSE 293,015,119298,Kane; Daniel Mertz,9999,0,9999,0
1667953417848,CSE 293,016,119299,Kriegman; David J,9999,0,9999,0
1667953417848,CSE 293,017,119300,Kumar; Arun Kumar,9999,0,9999,0
1667953417848,CSE 293,018,119301,Lerner; Sorin,9999,0,9999,0
1667953417848,CSE 293,019,119302,Lovett; Shachar,9999,0,9999,0
1667953417848,CSE 293,020,119303,McAuley; Julian John,9999,0,9999,0
1667953417848,CSE 293,021,119304,Micciancio; Daniele,9999,0,9999,0
1667953417848,CSE 293,022,119367,Orailoglu; Alex,9999,0,9999,0
1667953417848,CSE 293,023,119382,Paturi; Ramamohan,9999,0,9999,0
1667953417848,CSE 293,024,119404,Polikarpova; Nadezhda,9999,0,9999,0
1667953417848,CSE 293,025,119406,Politz; Joseph Gibbs,9999,0,9999,0
1667953417848,CSE 293,026,119411,Porter; George M,9999,0,9999,0
1667953417848,CSE 293,027,119414,Porter; Leonard Emerson,9999,0,9999,0
1667953417848,CSE 293,028,119416,Ramamoorthi; Ravi,9999,0,9999,0
1667953417848,CSE 293,029,119417,Sahoo; Debashis,9999,0,9999,0
1667953417848,CSE 293,030,119420,Saul; Lawrence,9999,0,9999,0
1667953417848,CSE 293,031,119421,Savage; Stefan,9999,0,9999,0
1667953417848,CSE 293,032,119425,Schulze; Jurgen P.,9999,0,9999,0
1667953417848,CSE 293,033,119426,Snoeren; Alex C.,9999,0,9999,0
1667953417848,CSE 293,034,119428,Shang; Jingbo,9999,0,9999,0
1667953417848,CSE 293,035,119430,Stefan; Deian,9999,0,9999,0
1667953417848,CSE 293,036,119431,Su; Hao,9999,0,9999,0
1667953417848,CSE 293,037,119433,Swanson; Steven James,9999,0,9999,0
1667953417848,CSE 293,038,119435,Tullsen; Dean Michael,9999,0,9999,0
1667953417848,CSE 293,039,119483,Voelker; Geoffrey M.,9999,0,9999,0
1667953417848,CSE 293,040,119537,Zhao; Jishen,9999,0,9999,0
1667953417848,CSE 293,041,119538,Zhou; Yuan-Yuan,9999,0,9999,0
1667953417848,CSE 293,042,119539,Gao; Sicun,9999,0,9999,0
1667953417848,CSE 293,043,119540,Weibel; Nadir,9999,0,9999,0
1667953417848,CSE 293,044,119541,Gupta; Rajesh K.,9999,0,9999,0
1667953418271,CSE 294,A00,102459,Voelker; Geoffrey M.,0,0,0,0
1667953418271,CSE 294,B00,111322,Orailoglu; Alex,0,0,0,0
1667953418705,DSE 201,A00,096914,Deutsch; Alin Bernard,30,0,30,0
1667953419130,DSE 210,A00,096915,Dasgupta; Sanjoy,30,0,30,0
1667953419551,DSE 260A,A00,096916,Altintas De Callaf; Ilkay,30,0,30,0
1667953419980,ECE 200,001,103586,Antipa; Nicholas A,9999,0,9999,0
1667953419980,ECE 200,002,103587,Atanasov; Nikolay A.,9999,0,9999,0
1667953419980,ECE 200,003,103588,Bharadia; Dinesh,9999,0,9999,0
1667953419980,ECE 200,004,103589,Cheng; Chung Kuan,9999,0,9999,0
1667953419980,ECE 200,005,103590,Cosman; Pamela C.,9999,0,9999,0
1667953419980,ECE 200,006,103591,Dayeh; Shadi Ahmad,9999,0,9999,0
1667953419980,ECE 200,007,103592,Fainman; Yeshaiahu,9999,0,9999,0
1667953419980,ECE 200,008,103593,Ford; Joseph Earl,9999,0,9999,0
1667953419980,ECE 200,009,103594,Franceschetti; Massimo,9999,0,9999,0
1667953419980,ECE 200,010,103595,Fullerton; Eric E,9999,0,9999,0
1667953419980,ECE 200,011,103596,Galton; Ian A,9999,0,9999,0
1667953419980,ECE 200,012,103597,Gilja; Vikash,9999,0,9999,0
1667953419980,ECE 200,013,103598,Hall; Drew A.,9999,0,9999,0
1667953419980,ECE 200,014,103599,Hsueh; Tzu-Chien,9999,0,9999,0
1667953419980,ECE 200,015,103600,Javidi; Tara,9999,0,9999,0
1667953419980,ECE 200,016,103601,Kahng; Andrew Byun,9999,0,9999,0
1667953419980,ECE 200,017,103602,Kim; Young-Han,9999,0,9999,0
1667953419980,ECE 200,018,103603,Koushanfar; Farinaz,9999,0,9999,0
1667953419980,ECE 200,019,103604,Kuzum; Duygu,9999,0,9999,0
1667953419980,ECE 200,020,103605,Le; Hanh-Phuc,9999,0,9999,0
1667953419980,ECE 200,021,103606,Lin; Bill,9999,0,9999,0
1667953419980,ECE 200,022,103607,Liu; Zhaowei,9998,0,9999,1
1667953419980,ECE 200,023,103608,Lo; Yu-Hwa,9999,0,9999,0
1667953419980,ECE 200,024,103609,Lomakin; Vitaliy,9999,0,9999,0
1667953419980,ECE 200,025,103610,Mercier; Patrick Philip,9999,0,9999,0
1667953419980,ECE 200,026,103611,Meyer; Florian,9999,0,9999,0
1667953419980,ECE 200,027,103612,Milstein; Laurence B.,9999,0,9999,0
1667953419980,ECE 200,028,103613,Mir Arabbaygi; Siavash,9999,0,9999,0
1667953419980,ECE 200,029,103614,Mookherjea; Shayan,9999,0,9999,0
1667953419980,ECE 200,030,103615,Morris; Karcher William,9999,0,9999,0
1667953419980,ECE 200,031,103616,Ng; Tse Nga,9999,0,9999,0
1667953419980,ECE 200,032,103617,Nguyen; Truong Quang,9999,0,9999,0
1667953419980,ECE 200,033,103618,Nomura; Kenji,9999,0,9999,0
1667953419980,ECE 200,034,103619,Orlitsky; Alon,9999,0,9999,0
1667953419980,ECE 200,035,103620,Pal; Piya,9999,0,9999,0
1667953419980,ECE 200,036,103621,Papen; George C.,9999,0,9999,0
1667953419980,ECE 200,037,103622,Radic; Stojan,9999,0,9999,0
1667953419980,ECE 200,038,103623,Rao; Bhaskar D.,9999,0,9999,0
1667953419980,ECE 200,039,103624,Rao; Ramesh R,9999,0,9999,0
1667953419980,ECE 200,040,103625,Rebeiz; Gabriel,9999,0,9999,0
1667953419980,ECE 200,041,103626,Sanford; John R,9999,0,9999,0
1667953419980,ECE 200,042,103627,Siegel; Paul H.,9999,0,9999,0
1667953419980,ECE 200,043,103628,Sievenpiper; Daniel F.,9999,0,9999,0
1667953419980,ECE 200,044,103629,Sworder; David D.,9999,0,9999,0
1667953419980,ECE 200,045,103630,Taur; Yuan,9999,0,9999,0
1667953419980,ECE 200,046,103631,Touri; Behrouz,9999,0,9999,0
1667953419980,ECE 200,047,103632,Trivedi; Mohan M.,9999,0,9999,0
1667953419980,ECE 200,048,103633,Vasconcelos; Nuno,9999,0,9999,0
1667953419980,ECE 200,049,103634,Wang; Xiaolong,9999,0,9999,0
1667953419980,ECE 200,050,103635,Xie; Pengtao,9999,0,9999,0
1667953419980,ECE 200,051,103636,Yip; Michael,9999,0,9999,0
1667953419980,ECE 200,052,103637,Zeger; Kenneth A.,999,0,999,0
1667953419980,ECE 200,053,103638,Zhang; Xinyu,9999,0,9999,0
1667953419980,ECE 200,054,103639,Turakhia; Yatish Girish,9999,0,9999,0
1667953419980,ECE 200,055,103640,Kang; Mingu,9999,0,9999,0
1667953419980,ECE 200,056,103641,Shi; Yuanyuan,9999,0,9999,0
1667953419980,ECE 200,057,103642,Wang; Edward Jay,9999,0,9999,0
1667953419980,ECE 200,058,103643,Zheng; Yang,9999,0,9999,0
1667953420406,ECE 202,A00,103644,Kuzum; Duygu,0,0,0,0
1667953420859,ECE 212BN,A00,103646,Ng; Tse Nga,0,0,0,0
1667953421293,ECE 221,A00,111493,Staff,0,0,0,0
1667953421717,ECE 222B,A00,103647,Lomakin; Vitaliy,0,0,0,0
1667953422140,ECE 230B,A00,103648,Taur; Yuan,0,0,0,0
1667953422573,ECE 238B,A00,103649,Garay; Javier,0,0,0,0
1667953422997,ECE 240B,A00,112900,Fainman; Yeshaiahu,0,0,0,0
1667953423421,ECE 247A,A00,103650,Jokerst; Jesse Vincent,0,0,0,0
1667953423842,ECE 247B,A00,103651,Wang; Joseph,0,0,0,0
1667953424266,ECE 250,A00,103652,Siegel; Paul H.,0,0,0,0
1667953424689,ECE 251A,A00,103654,Rao; Bhaskar D.,0,0,0,0
1667953425127,ECE 257B,A00,103655,Bharadia; Dinesh,0,0,0,0
1667953425563,ECE 258A,A00,103656,Milstein; Laurence B.,0,0,0,0
1667953425989,ECE 260B,A00,103658,Kang; Mingu,0,0,0,0
1667953426423,ECE 264A,A00,103659,Galton; Ian A,0,0,0,0
1667953426853,ECE 265A,A00,103661,Gudem; Prasad S.S.,0,0,0,0
1667953427285,ECE 265D,A00,103662,Gudem; Prasad S.S.,0,0,0,0
1667953427711,ECE 268,A00,103663,Koushanfar; Farinaz,0,0,0,0
1667953428135,ECE 269,A01,103665,Pal; Piya,0,0,0,0
1667953428557,ECE 271B,A00,103666,Vasconcelos; Manuela,0,0,0,0
1667953428981,ECE 276A,A00,103667,Atanasov; Nikolay A.,0,0,0,0
1667953429412,ECE 277,A00,103668,An; Cheolhong,0,0,0,0
1667953429850,ECE 279,A00,117947,Hall; Drew A.,0,0,0,0
1667953430707,ECE 283,A00,103670,Hsueh; Tzu-Chien,0,0,0,0
1667953431131,ECE 284,A00,103671,Turakhia; Yatish Girish,0,0,0,0
1667953431560,ECE 285,A00,103672,Zheng; Yang,0,0,0,0
1667953431560,ECE 285,B00,103673,Sworder; David D.,0,0,0,0
1667953431993,ECE 287,A00,103676,Javidi; Tara,0,0,0,0
1667953432422,MATH 200B,A00,098023,Salehi Golsefidy; Alireza,14,0,15,1
1667953432849,MATH 202B,A00,098024,Rhoades; Brendon Patrick,12,0,15,3
1667953433275,MATH 203B,A00,098025,Oprea; Dragos N.,13,0,15,2
1667953433699,MATH 204B,A00,098026,Sorensen; Claus M,15,0,15,0
1667953434133,MATH 208,A00,098027,Izadi; Elham,7,0,10,3
1667953434558,MATH 209,A00,098028,Pollack; Aaron,10,0,10,0
1667953434988,MATH 211A,A00,112919,Rogalski; Daniel,9,0,10,1
1667953435410,MATH 211B,A00,112920,Seward; Brandon M.,9,0,10,1
1667953435832,MATH 218,A00,098029,Li; Bo,10,0,10,0
1667953436266,MATH 220B,A00,098030,Novak; Jonathan I,13,0,15,2
1667953436853,MATH 221A,A00,098031,Ebenfelt; Peter F,13,0,15,2
1667953437367,MATH 231B,A00,098032,Zlatos; Andrej,12,0,15,3
1667953437805,MATH 240B,A00,098033,Ni; Lei,10,0,15,5
1667953438234,MATH 243,A00,098034,Jekel; David Andrew,10,0,10,0
1667953438658,MATH 245A,A00,098035,Nie; Jiawang,0,0,15,16
1667953439082,MATH 248,A00,098036,Bejenaru; Ioan,10,0,10,0
1667953439510,MATH 250B,A00,098037,Spolaor; Luca,14,0,15,1
1667953439934,MATH 258,A00,098038,Ni; Lei,10,0,10,0
1667953440362,MATH 264B,A00,098041,Rhoades; Brendon Patrick,12,0,15,3
1667953440799,MATH 268,A00,098042,Buss; Samuel R,10,0,10,0
1667953441229,MATH 269,A00,098043,Rhoades; Brendon Patrick,10,0,10,0
1667953441653,MATH 270B,A00,098044,Li; Bo,11,0,15,4
1667953442085,MATH 272B,A00,098045,Holst; Michael J,13,0,15,2
1667953442507,MATH 273A,A00,098046,Tian; Xiaochuan,12,0,15,3
1667953442930,MATH 275,A01,098048,Tian; Xiaochuan,6,0,10,4
1667953443365,MATH 278A,A00,098049,Holst; Michael J,8,0,10,2
1667953443790,MATH 278B,A00,098050,Cloninger; Alexander,10,0,10,0
1667953444216,MATH 278C,A00,098051,Nie; Jiawang,8,0,10,2
1667953444640,MATH 280B,A00,098052,Zheng; Tianyi,12,0,15,3
1667953445074,MATH 281B,A00,098053,Bradic; Jelena,4,0,15,11
1667953445498,MATH 282B,A00,098054,Arias-Castro; Ery,2,0,15,13
1667953445922,MATH 285,A00,098055,Fitzsimmons; Patrick J,0,0,15,17
1667953446352,MATH 287B,A00,098056,Arias-Castro; Ery,5,0,15,10
1667953446781,MATH 288,A00,098057,Agarwal; Pooja,9,0,10,1
1667953446781,MATH 288,B00,098058,Zhang; Danna,9,0,10,1
1667953446781,MATH 288,C00,098059,Williams; Ruth J,10,0,10,0
1667953447210,MATH 290B,A00,098060,Roberts; Justin Deritter,14,0,15,1
1667953447632,MATH 292,A00,098061,Belmont; Eva Kinoshita,10,0,10,0
1667953448073,MATH 295,A00,098062,Suk; Andrew Hoon,48,0,50,2
1667953448502,MATH 296,A00,098063,Novak; Jonathan I,20,0,20,0
1667953448939,MATH 297,001,098064,Gamst; Anthony Collins,9997,0,9999,2
1667953951139,COGS 205,A00,101395,Chiba; Andrea,19,0,20,1
1667953951568,COGS 210B,001,101404,Greene; Deanna Jacquelyn,9998,0,9999,1
1667953951568,COGS 210B,002,101417,Xia; Haijun,9999,0,9999,0
1667953951568,COGS 210B,003,101422,Nitz; Douglas A.,9999,0,9999,0
1667953951568,COGS 210B,004,101423,Hollan; James D.,9998,0,9999,1
1667953951568,COGS 210B,005,101424,Deak; Gedeon O.,9999,0,9999,0
1667953951568,COGS 210B,006,101425,Rossano; Federico,9999,0,9999,0
1667953951992,COGS 211B,A00,101427,Coulson; Seana M,9997,0,9999,2
1667953952415,COGS 220,A00,101428,Hollan; James D.,0,0,25,25
1667953952838,COGS 229,A00,101429,Dow; Steven P,18,0,25,7
1667953953261,COGS 230,A00,101430,Klemmer; Scott R,13,0,17,4
1667953953687,COGS 234,A00,101431,Xia; Haijun,7,0,25,18
1667953954110,COGS 260,A00,101432,Kiyonaga; Anastasia,20,0,25,5
1667953954110,COGS 260,B00,101433,Kirsh; David Joel,16,0,25,9
1667953954539,CSE 202,A00,102371,Impagliazzo; Russell,0,0,0,0
1667953954962,CSE 203B,A01,102373,Cheng; Chung Kuan,0,0,0,0
1667953955389,CSE 208,A00,102374,Micciancio; Daniele,0,0,0,0
1667953955817,CSE 209A,A00,112895,Impagliazzo; Russell,0,0,15,15
1667953956257,CSE 209B,A00,108005,Bellare; Mihir,0,0,0,0
1667953956680,CSE 210,A00,113163,Coblenz; Michael J,0,0,0,0
1667953957105,CSE 219,A00,106111,Dow; Steven P,0,0,20,20
1667953957546,CSE 221,A00,102376,Voelker; Geoffrey M.,0,0,0,0
1667953957973,CSE 224,A01,102378,Porter; George M,0,0,0,0
1667953958401,CSE 229A,A00,102379,Savage; Stefan,0,0,0,0
1667953958833,CSE 229C,A00,102380,Munyaka; Imani N. S.,0,0,0,0
1667953959262,CSE 232B,A00,102382,Deutsch; Alin Bernard,0,0,0,0
1667953959782,CSE 234,A01,112904,Kumar; Arun Kumar,0,0,0,0
1667953960205,CSE 237A,A00,102383,Rosing; Tajana Simunic,0,0,0,0
1667953960634,CSE 239A,A00,102384,Deutsch; Alin Bernard,0,0,0,0
1667953961069,CSE 239B,A00,102385,Polikarpova; Nadezhda,0,0,0,0
1667953961492,CSE 240A,A00,102386,Pannuto; Patrick William,0,0,0,0
1667953961913,CSE 240B,A00,102387,Zhao; Jishen,0,0,0,0
1667953962341,CSE 241A,A00,106406,Kang; Mingu,0,0,0,0
1667953962770,CSE 249B,A00,102388,Kahng; Andrew Byun,0,0,8,8
1667953963200,CSE 251B,A01,102392,Cottrell; Garrison W,0,0,0,0
1667953963200,CSE 251B,A02,102393,Cottrell; Garrison W,0,0,0,0
1667953963627,CSE 252B,A00,102394,Ochoa; Benjamin Lawrence,0,0,0,0
1667953964054,CSE 257,A01,102396,Gao; Sicun,0,0,0,0
1667953964479,CSE 272,A00,102397,Li; Tzumao,0,0,0,0
1667953964912,CSE 274,A00,111323,Chern; Albert Ren-Haur,0,0,0,0
1667953965342,CSE 282,A00,102398,Pevzner; Pavel Arkadjevich,0,0,0,0
1667953965765,CSE 284,A00,114175,Gymrek; Melissa Ann,0,0,0,0
1667953966191,CSE 290,A00,102399,Chandraker; Manmohan Krishna,0,0,0,0
1667953966191,CSE 290,B00,102400,Vaccaro; Kristen Marie,0,0,25,25
1667953966191,CSE 290,C00,102414,Pannuto; Patrick William,0,0,25,25
1667953966191,CSE 290,D00,102427,Pevzner; Pavel Arkadjevich,0,0,0,0
1667953966191,CSE 290,E00,102429,Zhao; Jishen,0,0,0,0
1667953966191,CSE 290,F00,102436,Tullsen; Dean Michael,0,0,0,0
1667953966191,CSE 290,G00,102440,Christensen; Henrik I,0,0,20,20
1667953966622,CSE 291,A00,102443,Su; Hao,0,0,0,0
1667953966622,CSE 291,B00,102448,Polikarpova; Nadezhda,0,0,0,0
1667953966622,CSE 291,C00,102453,Vaccaro; Kristen Marie,0,0,0,0
1667953966622,CSE 291,D00,111343,Savage; Stefan,0,0,0,0
1667953966622,CSE 291,E00,116474,Claffy; Kimberly Claire,0,0,0,0
1667953966622,CSE 291,F00,116479,Pasquale; Joseph,0,0,0,0
1667953967050,CSE 293,001,119111,Bafna; Vineet,9999,0,9999,0
1667953967050,CSE 293,002,119118,Bellare; Mihir,9999,0,9999,0
1667953967050,CSE 293,003,119122,Berg-Kirkpatrick; Taylor D,9999,0,9999,0
1667953967050,CSE 293,004,119135,Christensen; Henrik I,9999,0,9999,0
1667953967050,CSE 293,005,119142,Cottrell; Garrison W,9999,0,9999,0
1667953967050,CSE 293,006,119146,Deutsch; Alin Bernard,9999,0,9999,0
1667953967050,CSE 293,007,119159,Esmaeilzadeh; Hadi,9999,0,9999,0
1667953967050,CSE 293,008,119166,Freund; Yoav,9999,0,9999,0
1667953967050,CSE 293,009,119170,Griswold; William G.,9999,0,9999,0
1667953967050,CSE 293,010,119183,Gymrek; Melissa Ann,9999,0,9999,0
1667953967050,CSE 293,011,119190,Heninger; Nadia A,9999,0,9999,0
1667953967050,CSE 293,012,119230,Impagliazzo; Russell,9999,0,9999,0
1667953967050,CSE 293,013,119232,Jhala; Ranjit,9999,0,9999,0
1667953967050,CSE 293,014,119233,Kahng; Andrew Byun,9999,0,9999,0
1667953967050,CSE 293,015,119298,Kane; Daniel Mertz,9999,0,9999,0
1667953967050,CSE 293,016,119299,Kriegman; David J,9999,0,9999,0
1667953967050,CSE 293,017,119300,Kumar; Arun Kumar,9999,0,9999,0
1667953967050,CSE 293,018,119301,Lerner; Sorin,9999,0,9999,0
1667953967050,CSE 293,019,119302,Lovett; Shachar,9999,0,9999,0
1667953967050,CSE 293,020,119303,McAuley; Julian John,9999,0,9999,0
1667953967050,CSE 293,021,119304,Micciancio; Daniele,9999,0,9999,0
1667953967050,CSE 293,022,119367,Orailoglu; Alex,9999,0,9999,0
1667953967050,CSE 293,023,119382,Paturi; Ramamohan,9999,0,9999,0
1667953967050,CSE 293,024,119404,Polikarpova; Nadezhda,9999,0,9999,0
1667953967050,CSE 293,025,119406,Politz; Joseph Gibbs,9999,0,9999,0
1667953967050,CSE 293,026,119411,Porter; George M,9999,0,9999,0
1667953967050,CSE 293,027,119414,Porter; Leonard Emerson,9999,0,9999,0
1667953967050,CSE 293,028,119416,Ramamoorthi; Ravi,9999,0,9999,0
1667953967050,CSE 293,029,119417,Sahoo; Debashis,9999,0,9999,0
1667953967050,CSE 293,030,119420,Saul; Lawrence,9999,0,9999,0
1667953967050,CSE 293,031,119421,Savage; Stefan,9999,0,9999,0
1667953967050,CSE 293,032,119425,Schulze; Jurgen P.,9999,0,9999,0
1667953967050,CSE 293,033,119426,Snoeren; Alex C.,9999,0,9999,0
1667953967050,CSE 293,034,119428,Shang; Jingbo,9999,0,9999,0
1667953967050,CSE 293,035,119430,Stefan; Deian,9999,0,9999,0
1667953967050,CSE 293,036,119431,Su; Hao,9999,0,9999,0
1667953967050,CSE 293,037,119433,Swanson; Steven James,9999,0,9999,0
1667953967050,CSE 293,038,119435,Tullsen; Dean Michael,9999,0,9999,0
1667953967050,CSE 293,039,119483,Voelker; Geoffrey M.,9999,0,9999,0
1667953967050,CSE 293,040,119537,Zhao; Jishen,9999,0,9999,0
1667953967050,CSE 293,041,119538,Zhou; Yuan-Yuan,9999,0,9999,0
1667953967050,CSE 293,042,119539,Gao; Sicun,9999,0,9999,0
1667953967050,CSE 293,043,119540,Weibel; Nadir,9999,0,9999,0
1667953967050,CSE 293,044,119541,Gupta; Rajesh K.,9999,0,9999,0
1667953967471,CSE 294,A00,102459,Voelker; Geoffrey M.,0,0,0,0
1667953967471,CSE 294,B00,111322,Orailoglu; Alex,0,0,0,0
1667953967898,DSE 201,A00,096914,Deutsch; Alin Bernard,30,0,30,0
1667953968320,DSE 210,A00,096915,Dasgupta; Sanjoy,30,0,30,0
1667953968748,DSE 260A,A00,096916,Altintas De Callaf; Ilkay,30,0,30,0
1667953969180,ECE 200,001,103586,Antipa; Nicholas A,9999,0,9999,0
1667953969180,ECE 200,002,103587,Atanasov; Nikolay A.,9999,0,9999,0
1667953969180,ECE 200,003,103588,Bharadia; Dinesh,9999,0,9999,0
1667953969180,ECE 200,004,103589,Cheng; Chung Kuan,9999,0,9999,0
1667953969180,ECE 200,005,103590,Cosman; Pamela C.,9999,0,9999,0
1667953969180,ECE 200,006,103591,Dayeh; Shadi Ahmad,9999,0,9999,0
1667953969180,ECE 200,007,103592,Fainman; Yeshaiahu,9999,0,9999,0
1667953969180,ECE 200,008,103593,Ford; Joseph Earl,9999,0,9999,0
1667953969180,ECE 200,009,103594,Franceschetti; Massimo,9999,0,9999,0
1667953969180,ECE 200,010,103595,Fullerton; Eric E,9999,0,9999,0
1667953969180,ECE 200,011,103596,Galton; Ian A,9999,0,9999,0
1667953969180,ECE 200,012,103597,Gilja; Vikash,9999,0,9999,0
1667953969180,ECE 200,013,103598,Hall; Drew A.,9999,0,9999,0
1667953969180,ECE 200,014,103599,Hsueh; Tzu-Chien,9999,0,9999,0
1667953969180,ECE 200,015,103600,Javidi; Tara,9999,0,9999,0
1667953969180,ECE 200,016,103601,Kahng; Andrew Byun,9999,0,9999,0
1667953969180,ECE 200,017,103602,Kim; Young-Han,9999,0,9999,0
1667953969180,ECE 200,018,103603,Koushanfar; Farinaz,9999,0,9999,0
1667953969180,ECE 200,019,103604,Kuzum; Duygu,9999,0,9999,0
1667953969180,ECE 200,020,103605,Le; Hanh-Phuc,9999,0,9999,0
1667953969180,ECE 200,021,103606,Lin; Bill,9999,0,9999,0
1667953969180,ECE 200,022,103607,Liu; Zhaowei,9998,0,9999,1
1667953969180,ECE 200,023,103608,Lo; Yu-Hwa,9999,0,9999,0
1667953969180,ECE 200,024,103609,Lomakin; Vitaliy,9999,0,9999,0
1667953969180,ECE 200,025,103610,Mercier; Patrick Philip,9999,0,9999,0
1667953969180,ECE 200,026,103611,Meyer; Florian,9999,0,9999,0
1667953969180,ECE 200,027,103612,Milstein; Laurence B.,9999,0,9999,0
1667953969180,ECE 200,028,103613,Mir Arabbaygi; Siavash,9999,0,9999,0
1667953969180,ECE 200,029,103614,Mookherjea; Shayan,9999,0,9999,0
1667953969180,ECE 200,030,103615,Morris; Karcher William,9999,0,9999,0
1667953969180,ECE 200,031,103616,Ng; Tse Nga,9999,0,9999,0
1667953969180,ECE 200,032,103617,Nguyen; Truong Quang,9999,0,9999,0
1667953969180,ECE 200,033,103618,Nomura; Kenji,9999,0,9999,0
1667953969180,ECE 200,034,103619,Orlitsky; Alon,9999,0,9999,0
1667953969180,ECE 200,035,103620,Pal; Piya,9999,0,9999,0
1667953969180,ECE 200,036,103621,Papen; George C.,9999,0,9999,0
1667953969180,ECE 200,037,103622,Radic; Stojan,9999,0,9999,0
1667953969180,ECE 200,038,103623,Rao; Bhaskar D.,9999,0,9999,0
1667953969180,ECE 200,039,103624,Rao; Ramesh R,9999,0,9999,0
1667953969180,ECE 200,040,103625,Rebeiz; Gabriel,9999,0,9999,0
1667953969180,ECE 200,041,103626,Sanford; John R,9999,0,9999,0
1667953969180,ECE 200,042,103627,Siegel; Paul H.,9999,0,9999,0
1667953969180,ECE 200,043,103628,Sievenpiper; Daniel F.,9999,0,9999,0
1667953969180,ECE 200,044,103629,Sworder; David D.,9999,0,9999,0
1667953969180,ECE 200,045,103630,Taur; Yuan,9999,0,9999,0
1667953969180,ECE 200,046,103631,Touri; Behrouz,9999,0,9999,0
1667953969180,ECE 200,047,103632,Trivedi; Mohan M.,9999,0,9999,0
1667953969180,ECE 200,048,103633,Vasconcelos; Nuno,9999,0,9999,0
1667953969180,ECE 200,049,103634,Wang; Xiaolong,9999,0,9999,0
1667953969180,ECE 200,050,103635,Xie; Pengtao,9999,0,9999,0
1667953969180,ECE 200,051,103636,Yip; Michael,9999,0,9999,0
1667953969180,ECE 200,052,103637,Zeger; Kenneth A.,999,0,999,0
1667953969180,ECE 200,053,103638,Zhang; Xinyu,9999,0,9999,0
1667953969180,ECE 200,054,103639,Turakhia; Yatish Girish,9999,0,9999,0
1667953969180,ECE 200,055,103640,Kang; Mingu,9999,0,9999,0
1667953969180,ECE 200,056,103641,Shi; Yuanyuan,9999,0,9999,0
1667953969180,ECE 200,057,103642,Wang; Edward Jay,9999,0,9999,0
1667953969180,ECE 200,058,103643,Zheng; Yang,9999,0,9999,0
1667953969607,ECE 202,A00,103644,Kuzum; Duygu,0,0,0,0
1667953970031,ECE 212BN,A00,103646,Ng; Tse Nga,0,0,0,0
1667953970454,ECE 221,A00,111493,Staff,0,0,0,0
1667953970884,ECE 222B,A00,103647,Lomakin; Vitaliy,0,0,0,0
1667953971317,ECE 230B,A00,103648,Taur; Yuan,0,0,0,0
1667953971742,ECE 238B,A00,103649,Garay; Javier,0,0,0,0
1667953972165,ECE 240B,A00,112900,Fainman; Yeshaiahu,0,0,0,0
1667953972597,ECE 247A,A00,103650,Jokerst; Jesse Vincent,0,0,0,0
1667953973021,ECE 247B,A00,103651,Wang; Joseph,0,0,0,0
1667953973446,ECE 250,A00,103652,Siegel; Paul H.,0,0,0,0
1667953973868,ECE 251A,A00,103654,Rao; Bhaskar D.,0,0,0,0
1667953974310,ECE 257B,A00,103655,Bharadia; Dinesh,0,0,0,0
1667953974732,ECE 258A,A00,103656,Milstein; Laurence B.,0,0,0,0
1667953975164,ECE 260B,A00,103658,Kang; Mingu,0,0,0,0
1667953975594,ECE 264A,A00,103659,Galton; Ian A,0,0,0,0
1667953976019,ECE 265A,A00,103661,Gudem; Prasad S.S.,0,0,0,0
1667953976452,ECE 265D,A00,103662,Gudem; Prasad S.S.,0,0,0,0
1667953976885,ECE 268,A00,103663,Koushanfar; Farinaz,0,0,0,0
1667953977328,ECE 269,A01,103665,Pal; Piya,0,0,0,0
1667953977760,ECE 271B,A00,103666,Vasconcelos; Manuela,0,0,0,0
1667953978184,ECE 276A,A00,103667,Atanasov; Nikolay A.,0,0,0,0
1667953978613,ECE 277,A00,103668,An; Cheolhong,0,0,0,0
1667953979054,ECE 279,A00,117947,Hall; Drew A.,0,0,0,0
1667953979916,ECE 283,A00,103670,Hsueh; Tzu-Chien,0,0,0,0
1667953980355,ECE 284,A00,103671,Turakhia; Yatish Girish,0,0,0,0
1667953980797,ECE 285,A00,103672,Zheng; Yang,0,0,0,0
1667953980797,ECE 285,B00,103673,Sworder; David D.,0,0,0,0
1667953981222,ECE 287,A00,103676,Javidi; Tara,0,0,0,0
1667953981645,MATH 200B,A00,098023,Salehi Golsefidy; Alireza,14,0,15,1
1667953982069,MATH 202B,A00,098024,Rhoades; Brendon Patrick,12,0,15,3
1667953982499,MATH 203B,A00,098025,Oprea; Dragos N.,13,0,15,2
1667953982926,MATH 204B,A00,098026,Sorensen; Claus M,15,0,15,0
1667953983349,MATH 208,A00,098027,Izadi; Elham,7,0,10,3
1667953983778,MATH 209,A00,098028,Pollack; Aaron,10,0,10,0
1667953984210,MATH 211A,A00,112919,Rogalski; Daniel,9,0,10,1
1667953984667,MATH 211B,A00,112920,Seward; Brandon M.,9,0,10,1
1667953985097,MATH 218,A00,098029,Li; Bo,10,0,10,0
1667953985533,MATH 220B,A00,098030,Novak; Jonathan I,13,0,15,2
1667953985962,MATH 221A,A00,098031,Ebenfelt; Peter F,13,0,15,2
1667953986388,MATH 231B,A00,098032,Zlatos; Andrej,12,0,15,3
1667953986820,MATH 240B,A00,098033,Ni; Lei,10,0,15,5
1667953987244,MATH 243,A00,098034,Jekel; David Andrew,10,0,10,0
1667953987668,MATH 245A,A00,098035,Nie; Jiawang,0,0,15,16
1667953988101,MATH 248,A00,098036,Bejenaru; Ioan,10,0,10,0
1667953988538,MATH 250B,A00,098037,Spolaor; Luca,14,0,15,1
1667953988961,MATH 258,A00,098038,Ni; Lei,10,0,10,0
1667953989392,MATH 264B,A00,098041,Rhoades; Brendon Patrick,12,0,15,3
1667953989814,MATH 268,A00,098042,Buss; Samuel R,10,0,10,0
1667953990238,MATH 269,A00,098043,Rhoades; Brendon Patrick,10,0,10,0
1667953990674,MATH 270B,A00,098044,Li; Bo,11,0,15,4
1667953991096,MATH 272B,A00,098045,Holst; Michael J,13,0,15,2
1667953991523,MATH 273A,A00,098046,Tian; Xiaochuan,12,0,15,3
1667953991958,MATH 275,A01,098048,Tian; Xiaochuan,6,0,10,4
1667953992388,MATH 278A,A00,098049,Holst; Michael J,8,0,10,2
1667953992810,MATH 278B,A00,098050,Cloninger; Alexander,10,0,10,0
1667953993232,MATH 278C,A00,098051,Nie; Jiawang,8,0,10,2
1667953993657,MATH 280B,A00,098052,Zheng; Tianyi,12,0,15,3
1667953994081,MATH 281B,A00,098053,Bradic; Jelena,4,0,15,11
1667953994507,MATH 282B,A00,098054,Arias-Castro; Ery,2,0,15,13
1667953994934,MATH 285,A00,098055,Fitzsimmons; Patrick J,0,0,15,17
1667953995361,MATH 287B,A00,098056,Arias-Castro; Ery,5,0,15,10
1667953995783,MATH 288,A00,098057,Agarwal; Pooja,9,0,10,1
1667953995783,MATH 288,B00,098058,Zhang; Danna,9,0,10,1
1667953995783,MATH 288,C00,098059,Williams; Ruth J,10,0,10,0
1667953996209,MATH 290B,A00,098060,Roberts; Justin Deritter,14,0,15,1
1667953996641,MATH 292,A00,098061,Belmont; Eva Kinoshita,10,0,10,0
1667953997067,MATH 295,A00,098062,Suk; Andrew Hoon,48,0,50,2
1667953997488,MATH 296,A00,098063,Novak; Jonathan I,20,0,20,0
1667953997912,MATH 297,001,098064,Gamst; Anthony Collins,9997,0,9999,2
1667954499781,COGS 205,A00,101395,Chiba; Andrea,19,0,20,1
1667954500218,COGS 210B,001,101404,Greene; Deanna Jacquelyn,9998,0,9999,1
1667954500218,COGS 210B,002,101417,Xia; Haijun,9999,0,9999,0
1667954500218,COGS 210B,003,101422,Nitz; Douglas A.,9999,0,9999,0
1667954500218,COGS 210B,004,101423,Hollan; James D.,9998,0,9999,1
1667954500218,COGS 210B,005,101424,Deak; Gedeon O.,9999,0,9999,0
1667954500218,COGS 210B,006,101425,Rossano; Federico,9999,0,9999,0
1667954500641,COGS 211B,A00,101427,Coulson; Seana M,9997,0,9999,2
1667954501077,COGS 220,A00,101428,Hollan; James D.,0,0,25,25
1667954501499,COGS 229,A00,101429,Dow; Steven P,18,0,25,7
1667954501927,COGS 230,A00,101430,Klemmer; Scott R,13,0,17,4
1667954502361,COGS 234,A00,101431,Xia; Haijun,7,0,25,18
1667954502792,COGS 260,A00,101432,Kiyonaga; Anastasia,20,0,25,5
1667954502792,COGS 260,B00,101433,Kirsh; David Joel,16,0,25,9
1667954503213,CSE 202,A00,102371,Impagliazzo; Russell,0,0,0,0
1667954503641,CSE 203B,A01,102373,Cheng; Chung Kuan,0,0,0,0
1667954504075,CSE 208,A00,102374,Micciancio; Daniele,0,0,0,0
1667954504510,CSE 209A,A00,112895,Impagliazzo; Russell,0,0,15,15
1667954504937,CSE 209B,A00,108005,Bellare; Mihir,0,0,0,0
1667954505370,CSE 210,A00,113163,Coblenz; Michael J,0,0,0,0
1667954505808,CSE 219,A00,106111,Dow; Steven P,0,0,20,20
1667954506234,CSE 221,A00,102376,Voelker; Geoffrey M.,0,0,0,0
1667954506656,CSE 224,A01,102378,Porter; George M,0,0,0,0
1667954507082,CSE 229A,A00,102379,Savage; Stefan,0,0,0,0
1667954507506,CSE 229C,A00,102380,Munyaka; Imani N. S.,0,0,0,0
1667954507930,CSE 232B,A00,102382,Deutsch; Alin Bernard,0,0,0,0
1667954508362,CSE 234,A01,112904,Kumar; Arun Kumar,0,0,0,0
1667954508787,CSE 237A,A00,102383,Rosing; Tajana Simunic,0,0,0,0
1667954509209,CSE 239A,A00,102384,Deutsch; Alin Bernard,0,0,0,0
1667954509632,CSE 239B,A00,102385,Polikarpova; Nadezhda,0,0,0,0
1667954510059,CSE 240A,A00,102386,Pannuto; Patrick William,0,0,0,0
1667954510481,CSE 240B,A00,102387,Zhao; Jishen,0,0,0,0
1667954510904,CSE 241A,A00,106406,Kang; Mingu,0,0,0,0
1667954511338,CSE 249B,A00,102388,Kahng; Andrew Byun,0,0,8,8
1667954511770,CSE 251B,A01,102392,Cottrell; Garrison W,0,0,0,0
1667954511770,CSE 251B,A02,102393,Cottrell; Garrison W,0,0,0,0
1667954512194,CSE 252B,A00,102394,Ochoa; Benjamin Lawrence,0,0,0,0
1667954512624,CSE 257,A01,102396,Gao; Sicun,0,0,0,0
1667954513047,CSE 272,A00,102397,Li; Tzumao,0,0,0,0
1667954513469,CSE 274,A00,111323,Chern; Albert Ren-Haur,0,0,0,0
1667954513908,CSE 282,A00,102398,Pevzner; Pavel Arkadjevich,0,0,0,0
1667954514334,CSE 284,A00,114175,Gymrek; Melissa Ann,0,0,0,0
1667954514769,CSE 290,A00,102399,Chandraker; Manmohan Krishna,0,0,0,0
1667954514769,CSE 290,B00,102400,Vaccaro; Kristen Marie,0,0,25,25
1667954514769,CSE 290,C00,102414,Pannuto; Patrick William,0,0,25,25
1667954514769,CSE 290,D00,102427,Pevzner; Pavel Arkadjevich,0,0,0,0
1667954514769,CSE 290,E00,102429,Zhao; Jishen,0,0,0,0
1667954514769,CSE 290,F00,102436,Tullsen; Dean Michael,0,0,0,0
1667954514769,CSE 290,G00,102440,Christensen; Henrik I,0,0,20,20
1667954515201,CSE 291,A00,102443,Su; Hao,0,0,0,0
1667954515201,CSE 291,B00,102448,Polikarpova; Nadezhda,0,0,0,0
1667954515201,CSE 291,C00,102453,Vaccaro; Kristen Marie,0,0,0,0
1667954515201,CSE 291,D00,111343,Savage; Stefan,0,0,0,0
1667954515201,CSE 291,E00,116474,Claffy; Kimberly Claire,0,0,0,0
1667954515201,CSE 291,F00,116479,Pasquale; Joseph,0,0,0,0
1667954515644,CSE 293,001,119111,Bafna; Vineet,9999,0,9999,0
1667954515644,CSE 293,002,119118,Bellare; Mihir,9999,0,9999,0
1667954515644,CSE 293,003,119122,Berg-Kirkpatrick; Taylor D,9999,0,9999,0
1667954515644,CSE 293,004,119135,Christensen; Henrik I,9999,0,9999,0
1667954515644,CSE 293,005,119142,Cottrell; Garrison W,9999,0,9999,0
1667954515644,CSE 293,006,119146,Deutsch; Alin Bernard,9999,0,9999,0
1667954515644,CSE 293,007,119159,Esmaeilzadeh; Hadi,9999,0,9999,0
1667954515644,CSE 293,008,119166,Freund; Yoav,9999,0,9999,0
1667954515644,CSE 293,009,119170,Griswold; William G.,9999,0,9999,0
1667954515644,CSE 293,010,119183,Gymrek; Melissa Ann,9999,0,9999,0
1667954515644,CSE 293,011,119190,Heninger; Nadia A,9999,0,9999,0
1667954515644,CSE 293,012,119230,Impagliazzo; Russell,9999,0,9999,0
1667954515644,CSE 293,013,119232,Jhala; Ranjit,9999,0,9999,0
1667954515644,CSE 293,014,119233,Kahng; Andrew Byun,9999,0,9999,0
1667954515644,CSE 293,015,119298,Kane; Daniel Mertz,9999,0,9999,0
1667954515644,CSE 293,016,119299,Kriegman; David J,9999,0,9999,0
1667954515644,CSE 293,017,119300,Kumar; Arun Kumar,9999,0,9999,0
1667954515644,CSE 293,018,119301,Lerner; Sorin,9999,0,9999,0
1667954515644,CSE 293,019,119302,Lovett; Shachar,9999,0,9999,0
1667954515644,CSE 293,020,119303,McAuley; Julian John,9999,0,9999,0
1667954515644,CSE 293,021,119304,Micciancio; Daniele,9999,0,9999,0
1667954515644,CSE 293,022,119367,Orailoglu; Alex,9999,0,9999,0
1667954515644,CSE 293,023,119382,Paturi; Ramamohan,9999,0,9999,0
1667954515644,CSE 293,024,119404,Polikarpova; Nadezhda,9999,0,9999,0
1667954515644,CSE 293,025,119406,Politz; Joseph Gibbs,9999,0,9999,0
1667954515644,CSE 293,026,119411,Porter; George M,9999,0,9999,0
1667954515644,CSE 293,027,119414,Porter; Leonard Emerson,9999,0,9999,0
1667954515644,CSE 293,028,119416,Ramamoorthi; Ravi,9999,0,9999,0
1667954515644,CSE 293,029,119417,Sahoo; Debashis,9999,0,9999,0
1667954515644,CSE 293,030,119420,Saul; Lawrence,9999,0,9999,0
1667954515644,CSE 293,031,119421,Savage; Stefan,9999,0,9999,0
1667954515644,CSE 293,032,119425,Schulze; Jurgen P.,9999,0,9999,0
1667954515644,CSE 293,033,119426,Snoeren; Alex C.,9999,0,9999,0
1667954515644,CSE 293,034,119428,Shang; Jingbo,9999,0,9999,0
1667954515644,CSE 293,035,119430,Stefan; Deian,9999,0,9999,0
1667954515644,CSE 293,036,119431,Su; Hao,9999,0,9999,0
1667954515644,CSE 293,037,119433,Swanson; Steven James,9999,0,9999,0
1667954515644,CSE 293,038,119435,Tullsen; Dean Michael,9999,0,9999,0
1667954515644,CSE 293,039,119483,Voelker; Geoffrey M.,9999,0,9999,0
1667954515644,CSE 293,040,119537,Zhao; Jishen,9999,0,9999,0
1667954515644,CSE 293,041,119538,Zhou; Yuan-Yuan,9999,0,9999,0
1667954515644,CSE 293,042,119539,Gao; Sicun,9999,0,9999,0
1667954515644,CSE 293,043,119540,Weibel; Nadir,9999,0,9999,0
1667954515644,CSE 293,044,119541,Gupta; Rajesh K.,9999,0,9999,0
1667954516070,CSE 294,A00,102459,Voelker; Geoffrey M.,0,0,0,0
1667954516070,CSE 294,B00,111322,Orailoglu; Alex,0,0,0,0
1667954516504,DSE 201,A00,096914,Deutsch; Alin Bernard,30,0,30,0
1667954516934,DSE 210,A00,096915,Dasgupta; Sanjoy,30,0,30,0
1667954517375,DSE 260A,A00,096916,Altintas De Callaf; Ilkay,30,0,30,0
1667954517807,ECE 200,001,103586,Antipa; Nicholas A,9999,0,9999,0
1667954517807,ECE 200,002,103587,Atanasov; Nikolay A.,9999,0,9999,0
1667954517807,ECE 200,003,103588,Bharadia; Dinesh,9999,0,9999,0
1667954517807,ECE 200,004,103589,Cheng; Chung Kuan,9999,0,9999,0
1667954517807,ECE 200,005,103590,Cosman; Pamela C.,9999,0,9999,0
1667954517807,ECE 200,006,103591,Dayeh; Shadi Ahmad,9999,0,9999,0
1667954517807,ECE 200,007,103592,Fainman; Yeshaiahu,9999,0,9999,0
1667954517807,ECE 200,008,103593,Ford; Joseph Earl,9999,0,9999,0
1667954517807,ECE 200,009,103594,Franceschetti; Massimo,9999,0,9999,0
1667954517807,ECE 200,010,103595,Fullerton; Eric E,9999,0,9999,0
1667954517807,ECE 200,011,103596,Galton; Ian A,9999,0,9999,0
1667954517807,ECE 200,012,103597,Gilja; Vikash,9999,0,9999,0
1667954517807,ECE 200,013,103598,Hall; Drew A.,9999,0,9999,0
1667954517807,ECE 200,014,103599,Hsueh; Tzu-Chien,9999,0,9999,0
1667954517807,ECE 200,015,103600,Javidi; Tara,9999,0,9999,0
1667954517807,ECE 200,016,103601,Kahng; Andrew Byun,9999,0,9999,0
1667954517807,ECE 200,017,103602,Kim; Young-Han,9999,0,9999,0
1667954517807,ECE 200,018,103603,Koushanfar; Farinaz,9999,0,9999,0
1667954517807,ECE 200,019,103604,Kuzum; Duygu,9999,0,9999,0
1667954517807,ECE 200,020,103605,Le; Hanh-Phuc,9999,0,9999,0
1667954517807,ECE 200,021,103606,Lin; Bill,9999,0,9999,0
1667954517807,ECE 200,022,103607,Liu; Zhaowei,9998,0,9999,1
1667954517807,ECE 200,023,103608,Lo; Yu-Hwa,9999,0,9999,0
1667954517807,ECE 200,024,103609,Lomakin; Vitaliy,9999,0,9999,0
1667954517807,ECE 200,025,103610,Mercier; Patrick Philip,9999,0,9999,0
1667954517807,ECE 200,026,103611,Meyer; Florian,9999,0,9999,0
1667954517807,ECE 200,027,103612,Milstein; Laurence B.,9999,0,9999,0
1667954517807,ECE 200,028,103613,Mir Arabbaygi; Siavash,9999,0,9999,0
1667954517807,ECE 200,029,103614,Mookherjea; Shayan,9999,0,9999,0
1667954517807,ECE 200,030,103615,Morris; Karcher William,9999,0,9999,0
1667954517807,ECE 200,031,103616,Ng; Tse Nga,9999,0,9999,0
1667954517807,ECE 200,032,103617,Nguyen; Truong Quang,9999,0,9999,0
1667954517807,ECE 200,033,103618,Nomura; Kenji,9999,0,9999,0
1667954517807,ECE 200,034,103619,Orlitsky; Alon,9999,0,9999,0
1667954517807,ECE 200,035,103620,Pal; Piya,9999,0,9999,0
1667954517807,ECE 200,036,103621,Papen; George C.,9999,0,9999,0
1667954517807,ECE 200,037,103622,Radic; Stojan,9999,0,9999,0
1667954517807,ECE 200,038,103623,Rao; Bhaskar D.,9999,0,9999,0
1667954517807,ECE 200,039,103624,Rao; Ramesh R,9999,0,9999,0
1667954517807,ECE 200,040,103625,Rebeiz; Gabriel,9999,0,9999,0
1667954517807,ECE 200,041,103626,Sanford; John R,9999,0,9999,0
1667954517807,ECE 200,042,103627,Siegel; Paul H.,9999,0,9999,0
1667954517807,ECE 200,043,103628,Sievenpiper; Daniel F.,9999,0,9999,0
1667954517807,ECE 200,044,103629,Sworder; David D.,9999,0,9999,0
1667954517807,ECE 200,045,103630,Taur; Yuan,9999,0,9999,0
1667954517807,ECE 200,046,103631,Touri; Behrouz,9999,0,9999,0
1667954517807,ECE 200,047,103632,Trivedi; Mohan M.,9999,0,9999,0
1667954517807,ECE 200,048,103633,Vasconcelos; Nuno,9999,0,9999,0
1667954517807,ECE 200,049,103634,Wang; Xiaolong,9999,0,9999,0
1667954517807,ECE 200,050,103635,Xie; Pengtao,9999,0,9999,0
1667954517807,ECE 200,051,103636,Yip; Michael,9999,0,9999,0
1667954517807,ECE 200,052,103637,Zeger; Kenneth A.,999,0,999,0
1667954517807,ECE 200,053,103638,Zhang; Xinyu,9999,0,9999,0
1667954517807,ECE 200,054,103639,Turakhia; Yatish Girish,9999,0,9999,0
1667954517807,ECE 200,055,103640,Kang; Mingu,9999,0,9999,0
1667954517807,ECE 200,056,103641,Shi; Yuanyuan,9999,0,9999,0
1667954517807,ECE 200,057,103642,Wang; Edward Jay,9999,0,9999,0
1667954517807,ECE 200,058,103643,Zheng; Yang,9999,0,9999,0
1667954518229,ECE 202,A00,103644,Kuzum; Duygu,0,0,0,0
1667954518653,ECE 212BN,A00,103646,Ng; Tse Nga,0,0,0,0
1667954519081,ECE 221,A00,111493,Staff,0,0,0,0
1667954519515,ECE 222B,A00,103647,Lomakin; Vitaliy,0,0,0,0
1667954519941,ECE 230B,A00,103648,Taur; Yuan,0,0,0,0
1667954520378,ECE 238B,A00,103649,Garay; Javier,0,0,0,0
1667954520804,ECE 240B,A00,112900,Fainman; Yeshaiahu,0,0,0,0
1667954521232,ECE 247A,A00,103650,Jokerst; Jesse Vincent,0,0,0,0
1667954521659,ECE 247B,A00,103651,Wang; Joseph,0,0,0,0
1667954522086,ECE 250,A00,103652,Siegel; Paul H.,0,0,0,0
1667954522511,ECE 251A,A00,103654,Rao; Bhaskar D.,0,0,0,0
1667954522937,ECE 257B,A00,103655,Bharadia; Dinesh,0,0,0,0
1667954523369,ECE 258A,A00,103656,Milstein; Laurence B.,0,0,0,0
1667954523796,ECE 260B,A00,103658,Kang; Mingu,0,0,0,0
1667954524235,ECE 264A,A00,103659,Galton; Ian A,0,0,0,0
1667954524660,ECE 265A,A00,103661,Gudem; Prasad S.S.,0,0,0,0
1667954525169,ECE 265D,A00,103662,Gudem; Prasad S.S.,0,0,0,0
1667954525594,ECE 268,A00,103663,Koushanfar; Farinaz,0,0,0,0
1667954526027,ECE 269,A01,103665,Pal; Piya,0,0,0,0
1667954526454,ECE 271B,A00,103666,Vasconcelos; Manuela,0,0,0,0
1667954526883,ECE 276A,A00,103667,Atanasov; Nikolay A.,0,0,0,0
1667954527309,ECE 277,A00,103668,An; Cheolhong,0,0,0,0
1667954527730,ECE 279,A00,117947,Hall; Drew A.,0,0,0,0
1667954528581,ECE 283,A00,103670,Hsueh; Tzu-Chien,0,0,0,0
1667954529022,ECE 284,A00,103671,Turakhia; Yatish Girish,0,0,0,0
1667954529451,ECE 285,A00,103672,Zheng; Yang,0,0,0,0
1667954529451,ECE 285,B00,103673,Sworder; David D.,0,0,0,0
1667954529877,ECE 287,A00,103676,Javidi; Tara,0,0,0,0
1667954530309,MATH 200B,A00,098023,Salehi Golsefidy; Alireza,14,0,15,1
1667954530738,MATH 202B,A00,098024,Rhoades; Brendon Patrick,12,0,15,3
1667954531169,MATH 203B,A00,098025,Oprea; Dragos N.,13,0,15,2
1667954531591,MATH 204B,A00,098026,Sorensen; Claus M,15,0,15,0
1667954532016,MATH 208,A00,098027,Izadi; Elham,7,0,10,3
1667954532438,MATH 209,A00,098028,Pollack; Aaron,10,0,10,0
1667954532865,MATH 211A,A00,112919,Rogalski; Daniel,9,0,10,1
1667954533289,MATH 211B,A00,112920,Seward; Brandon M.,9,0,10,1
1667954533715,MATH 218,A00,098029,Li; Bo,10,0,10,0
1667954534143,MATH 220B,A00,098030,Novak; Jonathan I,13,0,15,2
1667954534566,MATH 221A,A00,098031,Ebenfelt; Peter F,13,0,15,2
1667954534988,MATH 231B,A00,098032,Zlatos; Andrej,12,0,15,3
1667954535419,MATH 240B,A00,098033,Ni; Lei,10,0,15,5
1667954535842,MATH 243,A00,098034,Jekel; David Andrew,10,0,10,0
1667954536267,MATH 245A,A00,098035,Nie; Jiawang,0,0,15,16
1667954536692,MATH 248,A00,098036,Bejenaru; Ioan,10,0,10,0
1667954537118,MATH 250B,A00,098037,Spolaor; Luca,14,0,15,1
1667954537557,MATH 258,A00,098038,Ni; Lei,10,0,10,0
1667954537984,MATH 264B,A00,098041,Rhoades; Brendon Patrick,12,0,15,3
1667954538409,MATH 268,A00,098042,Buss; Samuel R,10,0,10,0
1667954538836,MATH 269,A00,098043,Rhoades; Brendon Patrick,10,0,10,0
1667954539263,MATH 270B,A00,098044,Li; Bo,11,0,15,4
1667954539690,MATH 272B,A00,098045,Holst; Michael J,13,0,15,2
1667954540116,MATH 273A,A00,098046,Tian; Xiaochuan,12,0,15,3
1667954540545,MATH 275,A01,098048,Tian; Xiaochuan,6,0,10,4
1667954540977,MATH 278A,A00,098049,Holst; Michael J,8,0,10,2
1667954541400,MATH 278B,A00,098050,Cloninger; Alexander,10,0,10,0
1667954541822,MATH 278C,A00,098051,Nie; Jiawang,8,0,10,2
1667954542246,MATH 280B,A00,098052,Zheng; Tianyi,12,0,15,3
1667954542670,MATH 281B,A00,098053,Bradic; Jelena,4,0,15,11
1667954543100,MATH 282B,A00,098054,Arias-Castro; Ery,2,0,15,13
1667954543531,MATH 285,A00,098055,Fitzsimmons; Patrick J,0,0,15,17
1667954543955,MATH 287B,A00,098056,Arias-Castro; Ery,5,0,15,10
1667954544379,MATH 288,A00,098057,Agarwal; Pooja,9,0,10,1
1667954544379,MATH 288,B00,098058,Zhang; Danna,9,0,10,1
1667954544379,MATH 288,C00,098059,Williams; Ruth J,10,0,10,0
1667954544801,MATH 290B,A00,098060,Roberts; Justin Deritter,14,0,15,1
1667954545225,MATH 292,A00,098061,Belmont; Eva Kinoshita,10,0,10,0
1667954545650,MATH 295,A00,098062,Suk; Andrew Hoon,48,0,50,2
1667954546074,MATH 296,A00,098063,Novak; Jonathan I,20,0,20,0
1667954546496,MATH 297,001,098064,Gamst; Anthony Collins,9997,0,9999,2
1667955048232,COGS 205,A00,101395,Chiba; Andrea,19,0,20,1
1667955048656,COGS 210B,001,101404,Greene; Deanna Jacquelyn,9998,0,9999,1
1667955048656,COGS 210B,002,101417,Xia; Haijun,9999,0,9999,0
1667955048656,COGS 210B,003,101422,Nitz; Douglas A.,9999,0,9999,0
1667955048656,COGS 210B,004,101423,Hollan; James D.,9998,0,9999,1
1667955048656,COGS 210B,005,101424,Deak; Gedeon O.,9999,0,9999,0
1667955048656,COGS 210B,006,101425,Rossano; Federico,9999,0,9999,0
1667955049083,COGS 211B,A00,101427,Coulson; Seana M,9997,0,9999,2
1667955049506,COGS 220,A00,101428,Hollan; James D.,0,0,25,25
1667955049930,COGS 229,A00,101429,Dow; Steven P,18,0,25,7
1667955050356,COGS 230,A00,101430,Klemmer; Scott R,13,0,17,4
1667955050780,COGS 234,A00,101431,Xia; Haijun,7,0,25,18
1667955051211,COGS 260,A00,101432,Kiyonaga; Anastasia,20,0,25,5
1667955051211,COGS 260,B00,101433,Kirsh; David Joel,16,0,25,9
1667955051678,CSE 202,A00,102371,Impagliazzo; Russell,0,0,0,0
1667955052102,CSE 203B,A01,102373,Cheng; Chung Kuan,0,0,0,0
1667955052536,CSE 208,A00,102374,Micciancio; Daniele,0,0,0,0
1667955052958,CSE 209A,A00,112895,Impagliazzo; Russell,0,0,15,15
1667955053385,CSE 209B,A00,108005,Bellare; Mihir,0,0,0,0
1667955053810,CSE 210,A00,113163,Coblenz; Michael J,0,0,0,0
1667955054234,CSE 219,A00,106111,Dow; Steven P,0,0,20,20
1667955054659,CSE 221,A00,102376,Voelker; Geoffrey M.,0,0,0,0
1667955055082,CSE 224,A01,102378,Porter; George M,0,0,0,0
1667955055514,CSE 229A,A00,102379,Savage; Stefan,0,0,0,0
1667955055946,CSE 229C,A00,102380,Munyaka; Imani N. S.,0,0,0,0
1667955056385,CSE 232B,A00,102382,Deutsch; Alin Bernard,0,0,0,0
1667955056825,CSE 234,A01,112904,Kumar; Arun Kumar,0,0,0,0
1667955057253,CSE 237A,A00,102383,Rosing; Tajana Simunic,0,0,0,0
1667955057677,CSE 239A,A00,102384,Deutsch; Alin Bernard,0,0,0,0
1667955058103,CSE 239B,A00,102385,Polikarpova; Nadezhda,0,0,0,0
1667955058527,CSE 240A,A00,102386,Pannuto; Patrick William,0,0,0,0
1667955058950,CSE 240B,A00,102387,Zhao; Jishen,0,0,0,0
1667955059374,CSE 241A,A00,106406,Kang; Mingu,0,0,0,0
1667955059804,CSE 249B,A00,102388,Kahng; Andrew Byun,0,0,8,8
1667955060230,CSE 251B,A01,102392,Cottrell; Garrison W,0,0,0,0
1667955060230,CSE 251B,A02,102393,Cottrell; Garrison W,0,0,0,0
1667955060656,CSE 252B,A00,102394,Ochoa; Benjamin Lawrence,0,0,0,0
1667955061081,CSE 257,A01,102396,Gao; Sicun,0,0,0,0
1667955061503,CSE 272,A00,102397,Li; Tzumao,0,0,0,0
1667955061927,CSE 274,A00,111323,Chern; Albert Ren-Haur,0,0,0,0
1667955062358,CSE 282,A00,102398,Pevzner; Pavel Arkadjevich,0,0,0,0
1667955062784,CSE 284,A00,114175,Gymrek; Melissa Ann,0,0,0,0
1667955063233,CSE 290,A00,102399,Chandraker; Manmohan Krishna,0,0,0,0
1667955063233,CSE 290,B00,102400,Vaccaro; Kristen Marie,0,0,25,25
1667955063233,CSE 290,C00,102414,Pannuto; Patrick William,0,0,25,25
1667955063233,CSE 290,D00,102427,Pevzner; Pavel Arkadjevich,0,0,0,0
1667955063233,CSE 290,E00,102429,Zhao; Jishen,0,0,0,0
1667955063233,CSE 290,F00,102436,Tullsen; Dean Michael,0,0,0,0
1667955063233,CSE 290,G00,102440,Christensen; Henrik I,0,0,20,20
1667955063660,CSE 291,A00,102443,Su; Hao,0,0,0,0
1667955063660,CSE 291,B00,102448,Polikarpova; Nadezhda,0,0,0,0
1667955063660,CSE 291,C00,102453,Vaccaro; Kristen Marie,0,0,0,0
1667955063660,CSE 291,D00,111343,Savage; Stefan,0,0,0,0
1667955063660,CSE 291,E00,116474,Claffy; Kimberly Claire,0,0,0,0
1667955063660,CSE 291,F00,116479,Pasquale; Joseph,0,0,0,0
1667955064089,CSE 293,001,119111,Bafna; Vineet,9999,0,9999,0
1667955064089,CSE 293,002,119118,Bellare; Mihir,9999,0,9999,0
1667955064089,CSE 293,003,119122,Berg-Kirkpatrick; Taylor D,9999,0,9999,0
1667955064089,CSE 293,004,119135,Christensen; Henrik I,9999,0,9999,0
1667955064089,CSE 293,005,119142,Cottrell; Garrison W,9999,0,9999,0
1667955064089,CSE 293,006,119146,Deutsch; Alin Bernard,9999,0,9999,0
1667955064089,CSE 293,007,119159,Esmaeilzadeh; Hadi,9999,0,9999,0
1667955064089,CSE 293,008,119166,Freund; Yoav,9999,0,9999,0
1667955064089,CSE 293,009,119170,Griswold; William G.,9999,0,9999,0
1667955064089,CSE 293,010,119183,Gymrek; Melissa Ann,9999,0,9999,0
1667955064089,CSE 293,011,119190,Heninger; Nadia A,9999,0,9999,0
1667955064089,CSE 293,012,119230,Impagliazzo; Russell,9999,0,9999,0
1667955064089,CSE 293,013,119232,Jhala; Ranjit,9999,0,9999,0
1667955064089,CSE 293,014,119233,Kahng; Andrew Byun,9999,0,9999,0
1667955064089,CSE 293,015,119298,Kane; Daniel Mertz,9999,0,9999,0
1667955064089,CSE 293,016,119299,Kriegman; David J,9999,0,9999,0
1667955064089,CSE 293,017,119300,Kumar; Arun Kumar,9999,0,9999,0
1667955064089,CSE 293,018,119301,Lerner; Sorin,9999,0,9999,0
1667955064089,CSE 293,019,119302,Lovett; Shachar,9999,0,9999,0
1667955064089,CSE 293,020,119303,McAuley; Julian John,9999,0,9999,0
1667955064089,CSE 293,021,119304,Micciancio; Daniele,9999,0,9999,0
1667955064089,CSE 293,022,119367,Orailoglu; Alex,9999,0,9999,0
1667955064089,CSE 293,023,119382,Paturi; Ramamohan,9999,0,9999,0
1667955064089,CSE 293,024,119404,Polikarpova; Nadezhda,9999,0,9999,0
1667955064089,CSE 293,025,119406,Politz; Joseph Gibbs,9999,0,9999,0
1667955064089,CSE 293,026,119411,Porter; George M,9999,0,9999,0
1667955064089,CSE 293,027,119414,Porter; Leonard Emerson,9999,0,9999,0
1667955064089,CSE 293,028,119416,Ramamoorthi; Ravi,9999,0,9999,0
1667955064089,CSE 293,029,119417,Sahoo; Debashis,9999,0,9999,0
1667955064089,CSE 293,030,119420,Saul; Lawrence,9999,0,9999,0
1667955064089,CSE 293,031,119421,Savage; Stefan,9999,0,9999,0
1667955064089,CSE 293,032,119425,Schulze; Jurgen P.,9999,0,9999,0
1667955064089,CSE 293,033,119426,Snoeren; Alex C.,9999,0,9999,0
1667955064089,CSE 293,034,119428,Shang; Jingbo,9999,0,9999,0
1667955064089,CSE 293,035,119430,Stefan; Deian,9999,0,9999,0
1667955064089,CSE 293,036,119431,Su; Hao,9999,0,9999,0
1667955064089,CSE 293,037,119433,Swanson; Steven James,9999,0,9999,0
1667955064089,CSE 293,038,119435,Tullsen; Dean Michael,9999,0,9999,0
1667955064089,CSE 293,039,119483,Voelker; Geoffrey M.,9999,0,9999,0
1667955064089,CSE 293,040,119537,Zhao; Jishen,9999,0,9999,0
1667955064089,CSE 293,041,119538,Zhou; Yuan-Yuan,9999,0,9999,0
1667955064089,CSE 293,042,119539,Gao; Sicun,9999,0,9999,0
1667955064089,CSE 293,043,119540,Weibel; Nadir,9999,0,9999,0
1667955064089,CSE 293,044,119541,Gupta; Rajesh K.,9999,0,9999,0
1667955064513,CSE 294,A00,102459,Voelker; Geoffrey M.,0,0,0,0
1667955064513,CSE 294,B00,111322,Orailoglu; Alex,0,0,0,0
1667955064934,DSE 201,A00,096914,Deutsch; Alin Bernard,30,0,30,0
1667955065358,DSE 210,A00,096915,Dasgupta; Sanjoy,30,0,30,0
1667955065783,DSE 260A,A00,096916,Altintas De Callaf; Ilkay,30,0,30,0
1667955066240,ECE 200,001,103586,Antipa; Nicholas A,9999,0,9999,0
1667955066240,ECE 200,002,103587,Atanasov; Nikolay A.,9999,0,9999,0
1667955066240,ECE 200,003,103588,Bharadia; Dinesh,9999,0,9999,0
1667955066240,ECE 200,004,103589,Cheng; Chung Kuan,9999,0,9999,0
1667955066240,ECE 200,005,103590,Cosman; Pamela C.,9999,0,9999,0
1667955066240,ECE 200,006,103591,Dayeh; Shadi Ahmad,9999,0,9999,0
1667955066240,ECE 200,007,103592,Fainman; Yeshaiahu,9999,0,9999,0
1667955066240,ECE 200,008,103593,Ford; Joseph Earl,9999,0,9999,0
1667955066240,ECE 200,009,103594,Franceschetti; Massimo,9999,0,9999,0
1667955066240,ECE 200,010,103595,Fullerton; Eric E,9999,0,9999,0
1667955066240,ECE 200,011,103596,Galton; Ian A,9999,0,9999,0
1667955066240,ECE 200,012,103597,Gilja; Vikash,9999,0,9999,0
1667955066240,ECE 200,013,103598,Hall; Drew A.,9999,0,9999,0
1667955066240,ECE 200,014,103599,Hsueh; Tzu-Chien,9999,0,9999,0
1667955066240,ECE 200,015,103600,Javidi; Tara,9999,0,9999,0
1667955066240,ECE 200,016,103601,Kahng; Andrew Byun,9999,0,9999,0
1667955066240,ECE 200,017,103602,Kim; Young-Han,9999,0,9999,0
1667955066240,ECE 200,018,103603,Koushanfar; Farinaz,9999,0,9999,0
1667955066240,ECE 200,019,103604,Kuzum; Duygu,9999,0,9999,0
1667955066240,ECE 200,020,103605,Le; Hanh-Phuc,9999,0,9999,0
1667955066240,ECE 200,021,103606,Lin; Bill,9999,0,9999,0
1667955066240,ECE 200,022,103607,Liu; Zhaowei,9998,0,9999,1
1667955066240,ECE 200,023,103608,Lo; Yu-Hwa,9999,0,9999,0
1667955066240,ECE 200,024,103609,Lomakin; Vitaliy,9999,0,9999,0
1667955066240,ECE 200,025,103610,Mercier; Patrick Philip,9999,0,9999,0
1667955066240,ECE 200,026,103611,Meyer; Florian,9999,0,9999,0
1667955066240,ECE 200,027,103612,Milstein; Laurence B.,9999,0,9999,0
1667955066240,ECE 200,028,103613,Mir Arabbaygi; Siavash,9999,0,9999,0
1667955066240,ECE 200,029,103614,Mookherjea; Shayan,9999,0,9999,0
1667955066240,ECE 200,030,103615,Morris; Karcher William,9999,0,9999,0
1667955066240,ECE 200,031,103616,Ng; Tse Nga,9999,0,9999,0
1667955066240,ECE 200,032,103617,Nguyen; Truong Quang,9999,0,9999,0
1667955066240,ECE 200,033,103618,Nomura; Kenji,9999,0,9999,0
1667955066240,ECE 200,034,103619,Orlitsky; Alon,9999,0,9999,0
1667955066240,ECE 200,035,103620,Pal; Piya,9999,0,9999,0
1667955066240,ECE 200,036,103621,Papen; George C.,9999,0,9999,0
1667955066240,ECE 200,037,103622,Radic; Stojan,9999,0,9999,0
1667955066240,ECE 200,038,103623,Rao; Bhaskar D.,9999,0,9999,0
1667955066240,ECE 200,039,103624,Rao; Ramesh R,9999,0,9999,0
1667955066240,ECE 200,040,103625,Rebeiz; Gabriel,9999,0,9999,0
1667955066240,ECE 200,041,103626,Sanford; John R,9999,0,9999,0
1667955066240,ECE 200,042,103627,Siegel; Paul H.,9999,0,9999,0
1667955066240,ECE 200,043,103628,Sievenpiper; Daniel F.,9999,0,9999,0
1667955066240,ECE 200,044,103629,Sworder; David D.,9999,0,9999,0
1667955066240,ECE 200,045,103630,Taur; Yuan,9999,0,9999,0
1667955066240,ECE 200,046,103631,Touri; Behrouz,9999,0,9999,0
1667955066240,ECE 200,047,103632,Trivedi; Mohan M.,9999,0,9999,0
1667955066240,ECE 200,048,103633,Vasconcelos; Nuno,9999,0,9999,0
1667955066240,ECE 200,049,103634,Wang; Xiaolong,9999,0,9999,0
1667955066240,ECE 200,050,103635,Xie; Pengtao,9999,0,9999,0
1667955066240,ECE 200,051,103636,Yip; Michael,9999,0,9999,0
1667955066240,ECE 200,052,103637,Zeger; Kenneth A.,999,0,999,0
1667955066240,ECE 200,053,103638,Zhang; Xinyu,9999,0,9999,0
1667955066240,ECE 200,054,103639,Turakhia; Yatish Girish,9999,0,9999,0
1667955066240,ECE 200,055,103640,Kang; Mingu,9999,0,9999,0
1667955066240,ECE 200,056,103641,Shi; Yuanyuan,9999,0,9999,0
1667955066240,ECE 200,057,103642,Wang; Edward Jay,9999,0,9999,0
1667955066240,ECE 200,058,103643,Zheng; Yang,9999,0,9999,0
1667955066666,ECE 202,A00,103644,Kuzum; Duygu,0,0,0,0
1667955067089,ECE 212BN,A00,103646,Ng; Tse Nga,0,0,0,0
1667955067512,ECE 221,A00,111493,Staff,0,0,0,0
1667955067936,ECE 222B,A00,103647,Lomakin; Vitaliy,0,0,0,0
1667955068360,ECE 230B,A00,103648,Taur; Yuan,0,0,0,0
1667955068880,ECE 238B,A00,103649,Garay; Javier,0,0,0,0
1667955069311,ECE 240B,A00,112900,Fainman; Yeshaiahu,0,0,0,0
1667955069738,ECE 247A,A00,103650,Jokerst; Jesse Vincent,0,0,0,0
1667955070169,ECE 247B,A00,103651,Wang; Joseph,0,0,0,0
1667955070595,ECE 250,A00,103652,Siegel; Paul H.,0,0,0,0
1667955071032,ECE 251A,A00,103654,Rao; Bhaskar D.,0,0,0,0
1667955071460,ECE 257B,A00,103655,Bharadia; Dinesh,0,0,0,0
1667955071887,ECE 258A,A00,103656,Milstein; Laurence B.,0,0,0,0
1667955072310,ECE 260B,A00,103658,Kang; Mingu,0,0,0,0
1667955072737,ECE 264A,A00,103659,Galton; Ian A,0,0,0,0
1667955073163,ECE 265A,A00,103661,Gudem; Prasad S.S.,0,0,0,0
1667955073593,ECE 265D,A00,103662,Gudem; Prasad S.S.,0,0,0,0
1667955074017,ECE 268,A00,103663,Koushanfar; Farinaz,0,0,0,0
1667955074445,ECE 269,A01,103665,Pal; Piya,0,0,0,0
1667955074869,ECE 271B,A00,103666,Vasconcelos; Manuela,0,0,0,0
1667955075291,ECE 276A,A00,103667,Atanasov; Nikolay A.,0,0,0,0
1667955075727,ECE 277,A00,103668,An; Cheolhong,0,0,0,0
1667955076150,ECE 279,A00,117947,Hall; Drew A.,0,0,0,0
1667955077016,ECE 283,A00,103670,Hsueh; Tzu-Chien,0,0,0,0
1667955077438,ECE 284,A00,103671,Turakhia; Yatish Girish,0,0,0,0
1667955077865,ECE 285,A00,103672,Zheng; Yang,0,0,0,0
1667955077865,ECE 285,B00,103673,Sworder; David D.,0,0,0,0
1667955078291,ECE 287,A00,103676,Javidi; Tara,0,0,0,0
1667955078716,MATH 200B,A00,098023,Salehi Golsefidy; Alireza,14,0,15,1
1667955079137,MATH 202B,A00,098024,Rhoades; Brendon Patrick,12,0,15,3
1667955079562,MATH 203B,A00,098025,Oprea; Dragos N.,13,0,15,2
1667955079986,MATH 204B,A00,098026,Sorensen; Claus M,15,0,15,0
1667955080411,MATH 208,A00,098027,Izadi; Elham,7,0,10,3
1667955080837,MATH 209,A00,098028,Pollack; Aaron,10,0,10,0
1667955081264,MATH 211A,A00,112919,Rogalski; Daniel,9,0,10,1
1667955081686,MATH 211B,A00,112920,Seward; Brandon M.,9,0,10,1
1667955082117,MATH 218,A00,098029,Li; Bo,10,0,10,0
1667955082546,MATH 220B,A00,098030,Novak; Jonathan I,13,0,15,2
1667955082970,MATH 221A,A00,098031,Ebenfelt; Peter F,13,0,15,2
1667955083407,MATH 231B,A00,098032,Zlatos; Andrej,12,0,15,3
1667955083834,MATH 240B,A00,098033,Ni; Lei,10,0,15,5
1667955084264,MATH 243,A00,098034,Jekel; David Andrew,10,0,10,0
1667955084687,MATH 245A,A00,098035,Nie; Jiawang,0,0,15,16
1667955085109,MATH 248,A00,098036,Bejenaru; Ioan,10,0,10,0
1667955085534,MATH 250B,A00,098037,Spolaor; Luca,14,0,15,1
1667955085956,MATH 258,A00,098038,Ni; Lei,10,0,10,0
1667955086387,MATH 264B,A00,098041,Rhoades; Brendon Patrick,12,0,15,3
1667955086811,MATH 268,A00,098042,Buss; Samuel R,10,0,10,0
1667955087234,MATH 269,A00,098043,Rhoades; Brendon Patrick,10,0,10,0
1667955087660,MATH 270B,A00,098044,Li; Bo,11,0,15,4
1667955088083,MATH 272B,A00,098045,Holst; Michael J,13,0,15,2
1667955088508,MATH 273A,A00,098046,Tian; Xiaochuan,12,0,15,3
1667955088932,MATH 275,A01,098048,Tian; Xiaochuan,6,0,10,4
1667955089358,MATH 278A,A00,098049,Holst; Michael J,8,0,10,2
1667955089788,MATH 278B,A00,098050,Cloninger; Alexander,10,0,10,0
1667955101467,MATH 278C,A00,098051,Nie; Jiawang,8,0,10,2
1667955101889,MATH 280B,A00,098052,Zheng; Tianyi,12,0,15,3
1667955102315,MATH 281B,A00,098053,Bradic; Jelena,4,0,15,11
1667955102739,MATH 282B,A00,098054,Arias-Castro; Ery,2,0,15,13
1667955103165,MATH 285,A00,098055,Fitzsimmons; Patrick J,0,0,15,17
1667955103599,MATH 287B,A00,098056,Arias-Castro; Ery,5,0,15,10
1667955104023,MATH 288,A00,098057,Agarwal; Pooja,9,0,10,1
1667955104023,MATH 288,B00,098058,Zhang; Danna,9,0,10,1
1667955104023,MATH 288,C00,098059,Williams; Ruth J,10,0,10,0
1667955104446,MATH 290B,A00,098060,Roberts; Justin Deritter,14,0,15,1
1667955104870,MATH 292,A00,098061,Belmont; Eva Kinoshita,10,0,10,0
1667955105293,MATH 295,A00,098062,Suk; Andrew Hoon,48,0,50,2
1667955105718,MATH 296,A00,098063,Novak; Jonathan I,20,0,20,0
1667955106142,MATH 297,001,098064,Gamst; Anthony Collins,9997,0,9999,2
1667955607788,COGS 205,A00,101395,Chiba; Andrea,19,0,20,1
1667955608215,COGS 210B,001,101404,Greene; Deanna Jacquelyn,9998,0,9999,1
1667955608215,COGS 210B,002,101417,Xia; Haijun,9999,0,9999,0
1667955608215,COGS 210B,003,101422,Nitz; Douglas A.,9999,0,9999,0
1667955608215,COGS 210B,004,101423,Hollan; James D.,9998,0,9999,1
1667955608215,COGS 210B,005,101424,Deak; Gedeon O.,9999,0,9999,0
1667955608215,COGS 210B,006,101425,Rossano; Federico,9999,0,9999,0
1667955608642,COGS 211B,A00,101427,Coulson; Seana M,9997,0,9999,2
1667955609085,COGS 220,A00,101428,Hollan; James D.,0,0,25,25
1667955609509,COGS 229,A00,101429,Dow; Steven P,18,0,25,7
1667955609947,COGS 230,A00,101430,Klemmer; Scott R,13,0,17,4
1667955610372,COGS 234,A00,101431,Xia; Haijun,7,0,25,18
1667955610800,COGS 260,A00,101432,Kiyonaga; Anastasia,20,0,25,5
1667955610800,COGS 260,B00,101433,Kirsh; David Joel,16,0,25,9
1667955611229,CSE 202,A00,102371,Impagliazzo; Russell,0,0,0,0
1667955611660,CSE 203B,A01,102373,Cheng; Chung Kuan,0,0,0,0
1667955612095,CSE 208,A00,102374,Micciancio; Daniele,0,0,0,0
1667955612520,CSE 209A,A00,112895,Impagliazzo; Russell,0,0,15,15
1667955612944,CSE 209B,A00,108005,Bellare; Mihir,0,0,0,0
1667955613379,CSE 210,A00,113163,Coblenz; Michael J,0,0,0,0
1667955613804,CSE 219,A00,106111,Dow; Steven P,0,0,20,20
1667955614234,CSE 221,A00,102376,Voelker; Geoffrey M.,0,0,0,0
1667955614664,CSE 224,A01,102378,Porter; George M,0,0,0,0
1667955615087,CSE 229A,A00,102379,Savage; Stefan,0,0,0,0
1667955615511,CSE 229C,A00,102380,Munyaka; Imani N. S.,0,0,0,0
1667955615943,CSE 232B,A00,102382,Deutsch; Alin Bernard,0,0,0,0
1667955616366,CSE 234,A01,112904,Kumar; Arun Kumar,0,0,0,0
1667955616793,CSE 237A,A00,102383,Rosing; Tajana Simunic,0,0,0,0
1667955617227,CSE 239A,A00,102384,Deutsch; Alin Bernard,0,0,0,0
1667955617651,CSE 239B,A00,102385,Polikarpova; Nadezhda,0,0,0,0
1667955618080,CSE 240A,A00,102386,Pannuto; Patrick William,0,0,0,0
1667955618504,CSE 240B,A00,102387,Zhao; Jishen,0,0,0,0
1667955618933,CSE 241A,A00,106406,Kang; Mingu,0,0,0,0
1667955619366,CSE 249B,A00,102388,Kahng; Andrew Byun,0,0,8,8
1667955619804,CSE 251B,A01,102392,Cottrell; Garrison W,0,0,0,0
1667955619804,CSE 251B,A02,102393,Cottrell; Garrison W,0,0,0,0
1667955620235,CSE 252B,A00,102394,Ochoa; Benjamin Lawrence,0,0,0,0
1667955620660,CSE 257,A01,102396,Gao; Sicun,0,0,0,0
1667955621085,CSE 272,A00,102397,Li; Tzumao,0,0,0,0
1667955621508,CSE 274,A00,111323,Chern; Albert Ren-Haur,0,0,0,0
1667955621930,CSE 282,A00,102398,Pevzner; Pavel Arkadjevich,0,0,0,0
1667955622353,CSE 284,A00,114175,Gymrek; Melissa Ann,0,0,0,0
1667955622776,CSE 290,A00,102399,Chandraker; Manmohan Krishna,0,0,0,0
1667955622776,CSE 290,B00,102400,Vaccaro; Kristen Marie,0,0,25,25
1667955622776,CSE 290,C00,102414,Pannuto; Patrick William,0,0,25,25
1667955622776,CSE 290,D00,102427,Pevzner; Pavel Arkadjevich,0,0,0,0
1667955622776,CSE 290,E00,102429,Zhao; Jishen,0,0,0,0
1667955622776,CSE 290,F00,102436,Tullsen; Dean Michael,0,0,0,0
1667955622776,CSE 290,G00,102440,Christensen; Henrik I,0,0,20,20
1667955623289,CSE 291,A00,102443,Su; Hao,0,0,0,0
1667955623289,CSE 291,B00,102448,Polikarpova; Nadezhda,0,0,0,0
1667955623289,CSE 291,C00,102453,Vaccaro; Kristen Marie,0,0,0,0
1667955623289,CSE 291,D00,111343,Savage; Stefan,0,0,0,0
1667955623289,CSE 291,E00,116474,Claffy; Kimberly Claire,0,0,0,0
1667955623289,CSE 291,F00,116479,Pasquale; Joseph,0,0,0,0
1667955623749,CSE 293,001,119111,Bafna; Vineet,9999,0,9999,0
1667955623749,CSE 293,002,119118,Bellare; Mihir,9999,0,9999,0
1667955623749,CSE 293,003,119122,Berg-Kirkpatrick; Taylor D,9999,0,9999,0
1667955623749,CSE 293,004,119135,Christensen; Henrik I,9999,0,9999,0
1667955623749,CSE 293,005,119142,Cottrell; Garrison W,9999,0,9999,0
1667955623749,CSE 293,006,119146,Deutsch; Alin Bernard,9999,0,9999,0
1667955623749,CSE 293,007,119159,Esmaeilzadeh; Hadi,9999,0,9999,0
1667955623749,CSE 293,008,119166,Freund; Yoav,9999,0,9999,0
1667955623749,CSE 293,009,119170,Griswold; William G.,9999,0,9999,0
1667955623749,CSE 293,010,119183,Gymrek; Melissa Ann,9999,0,9999,0
1667955623749,CSE 293,011,119190,Heninger; Nadia A,9999,0,9999,0
1667955623749,CSE 293,012,119230,Impagliazzo; Russell,9999,0,9999,0
1667955623749,CSE 293,013,119232,Jhala; Ranjit,9999,0,9999,0
1667955623749,CSE 293,014,119233,Kahng; Andrew Byun,9999,0,9999,0
1667955623749,CSE 293,015,119298,Kane; Daniel Mertz,9999,0,9999,0
1667955623749,CSE 293,016,119299,Kriegman; David J,9999,0,9999,0
1667955623749,CSE 293,017,119300,Kumar; Arun Kumar,9999,0,9999,0
1667955623749,CSE 293,018,119301,Lerner; Sorin,9999,0,9999,0
1667955623749,CSE 293,019,119302,Lovett; Shachar,9999,0,9999,0
1667955623749,CSE 293,020,119303,McAuley; Julian John,9999,0,9999,0
1667955623749,CSE 293,021,119304,Micciancio; Daniele,9999,0,9999,0
1667955623749,CSE 293,022,119367,Orailoglu; Alex,9999,0,9999,0
1667955623749,CSE 293,023,119382,Paturi; Ramamohan,9999,0,9999,0
1667955623749,CSE 293,024,119404,Polikarpova; Nadezhda,9999,0,9999,0
1667955623749,CSE 293,025,119406,Politz; Joseph Gibbs,9999,0,9999,0
1667955623749,CSE 293,026,119411,Porter; George M,9999,0,9999,0
1667955623749,CSE 293,027,119414,Porter; Leonard Emerson,9999,0,9999,0
1667955623749,CSE 293,028,119416,Ramamoorthi; Ravi,9999,0,9999,0
1667955623749,CSE 293,029,119417,Sahoo; Debashis,9999,0,9999,0
1667955623749,CSE 293,030,119420,Saul; Lawrence,9999,0,9999,0
1667955623749,CSE 293,031,119421,Savage; Stefan,9999,0,9999,0
1667955623749,CSE 293,032,119425,Schulze; Jurgen P.,9999,0,9999,0
1667955623749,CSE 293,033,119426,Snoeren; Alex C.,9999,0,9999,0
1667955623749,CSE 293,034,119428,Shang; Jingbo,9999,0,9999,0
1667955623749,CSE 293,035,119430,Stefan; Deian,9999,0,9999,0
1667955623749,CSE 293,036,119431,Su; Hao,9999,0,9999,0
1667955623749,CSE 293,037,119433,Swanson; Steven James,9999,0,9999,0
1667955623749,CSE 293,038,119435,Tullsen; Dean Michael,9999,0,9999,0
1667955623749,CSE 293,039,119483,Voelker; Geoffrey M.,9999,0,9999,0
1667955623749,CSE 293,040,119537,Zhao; Jishen,9999,0,9999,0
1667955623749,CSE 293,041,119538,Zhou; Yuan-Yuan,9999,0,9999,0
1667955623749,CSE 293,042,119539,Gao; Sicun,9999,0,9999,0
1667955623749,CSE 293,043,119540,Weibel; Nadir,9999,0,9999,0
1667955623749,CSE 293,044,119541,Gupta; Rajesh K.,9999,0,9999,0
1667955624178,CSE 294,A00,102459,Voelker; Geoffrey M.,0,0,0,0
1667955624178,CSE 294,B00,111322,Orailoglu; Alex,0,0,0,0
1667955624609,DSE 201,A00,096914,Deutsch; Alin Bernard,30,0,30,0
1667955625032,DSE 210,A00,096915,Dasgupta; Sanjoy,30,0,30,0
1667955625464,DSE 260A,A00,096916,Altintas De Callaf; Ilkay,30,0,30,0
1667955625892,ECE 200,001,103586,Antipa; Nicholas A,9999,0,9999,0
1667955625892,ECE 200,002,103587,Atanasov; Nikolay A.,9999,0,9999,0
1667955625892,ECE 200,003,103588,Bharadia; Dinesh,9999,0,9999,0
1667955625892,ECE 200,004,103589,Cheng; Chung Kuan,9999,0,9999,0
1667955625892,ECE 200,005,103590,Cosman; Pamela C.,9999,0,9999,0
1667955625892,ECE 200,006,103591,Dayeh; Shadi Ahmad,9999,0,9999,0
1667955625892,ECE 200,007,103592,Fainman; Yeshaiahu,9999,0,9999,0
1667955625892,ECE 200,008,103593,Ford; Joseph Earl,9999,0,9999,0
1667955625892,ECE 200,009,103594,Franceschetti; Massimo,9999,0,9999,0
1667955625892,ECE 200,010,103595,Fullerton; Eric E,9999,0,9999,0
1667955625892,ECE 200,011,103596,Galton; Ian A,9999,0,9999,0
1667955625892,ECE 200,012,103597,Gilja; Vikash,9999,0,9999,0
1667955625892,ECE 200,013,103598,Hall; Drew A.,9999,0,9999,0
1667955625892,ECE 200,014,103599,Hsueh; Tzu-Chien,9999,0,9999,0
1667955625892,ECE 200,015,103600,Javidi; Tara,9999,0,9999,0
1667955625892,ECE 200,016,103601,Kahng; Andrew Byun,9999,0,9999,0
1667955625892,ECE 200,017,103602,Kim; Young-Han,9999,0,9999,0
1667955625892,ECE 200,018,103603,Koushanfar; Farinaz,9999,0,9999,0
1667955625892,ECE 200,019,103604,Kuzum; Duygu,9999,0,9999,0
1667955625892,ECE 200,020,103605,Le; Hanh-Phuc,9999,0,9999,0
1667955625892,ECE 200,021,103606,Lin; Bill,9999,0,9999,0
1667955625892,ECE 200,022,103607,Liu; Zhaowei,9998,0,9999,1
1667955625892,ECE 200,023,103608,Lo; Yu-Hwa,9999,0,9999,0
1667955625892,ECE 200,024,103609,Lomakin; Vitaliy,9999,0,9999,0
1667955625892,ECE 200,025,103610,Mercier; Patrick Philip,9999,0,9999,0
1667955625892,ECE 200,026,103611,Meyer; Florian,9999,0,9999,0
1667955625892,ECE 200,027,103612,Milstein; Laurence B.,9999,0,9999,0
1667955625892,ECE 200,028,103613,Mir Arabbaygi; Siavash,9999,0,9999,0
1667955625892,ECE 200,029,103614,Mookherjea; Shayan,9999,0,9999,0
1667955625892,ECE 200,030,103615,Morris; Karcher William,9999,0,9999,0
1667955625892,ECE 200,031,103616,Ng; Tse Nga,9999,0,9999,0
1667955625892,ECE 200,032,103617,Nguyen; Truong Quang,9999,0,9999,0
1667955625892,ECE 200,033,103618,Nomura; Kenji,9999,0,9999,0
1667955625892,ECE 200,034,103619,Orlitsky; Alon,9999,0,9999,0
1667955625892,ECE 200,035,103620,Pal; Piya,9999,0,9999,0
1667955625892,ECE 200,036,103621,Papen; George C.,9999,0,9999,0
1667955625892,ECE 200,037,103622,Radic; Stojan,9999,0,9999,0
1667955625892,ECE 200,038,103623,Rao; Bhaskar D.,9999,0,9999,0
1667955625892,ECE 200,039,103624,Rao; Ramesh R,9999,0,9999,0
1667955625892,ECE 200,040,103625,Rebeiz; Gabriel,9999,0,9999,0
1667955625892,ECE 200,041,103626,Sanford; John R,9999,0,9999,0
1667955625892,ECE 200,042,103627,Siegel; Paul H.,9999,0,9999,0
1667955625892,ECE 200,043,103628,Sievenpiper; Daniel F.,9999,0,9999,0
1667955625892,ECE 200,044,103629,Sworder; David D.,9999,0,9999,0
1667955625892,ECE 200,045,103630,Taur; Yuan,9999,0,9999,0
1667955625892,ECE 200,046,103631,Touri; Behrouz,9999,0,9999,0
1667955625892,ECE 200,047,103632,Trivedi; Mohan M.,9999,0,9999,0
1667955625892,ECE 200,048,103633,Vasconcelos; Nuno,9999,0,9999,0
1667955625892,ECE 200,049,103634,Wang; Xiaolong,9999,0,9999,0
1667955625892,ECE 200,050,103635,Xie; Pengtao,9999,0,9999,0
1667955625892,ECE 200,051,103636,Yip; Michael,9999,0,9999,0
1667955625892,ECE 200,052,103637,Zeger; Kenneth A.,999,0,999,0
1667955625892,ECE 200,053,103638,Zhang; Xinyu,9999,0,9999,0
1667955625892,ECE 200,054,103639,Turakhia; Yatish Girish,9999,0,9999,0
1667955625892,ECE 200,055,103640,Kang; Mingu,9999,0,9999,0
1667955625892,ECE 200,056,103641,Shi; Yuanyuan,9999,0,9999,0
1667955625892,ECE 200,057,103642,Wang; Edward Jay,9999,0,9999,0
1667955625892,ECE 200,058,103643,Zheng; Yang,9999,0,9999,0
1667955626321,ECE 202,A00,103644,Kuzum; Duygu,0,0,0,0
1667955626745,ECE 212BN,A00,103646,Ng; Tse Nga,0,0,0,0
1667955627169,ECE 221,A00,111493,Staff,0,0,0,0
1667955627594,ECE 222B,A00,103647,Lomakin; Vitaliy,0,0,0,0
1667955628018,ECE 230B,A00,103648,Taur; Yuan,0,0,0,0
1667955628451,ECE 238B,A00,103649,Garay; Javier,0,0,0,0
1667955628883,ECE 240B,A00,112900,Fainman; Yeshaiahu,0,0,0,0
1667955629308,ECE 247A,A00,103650,Jokerst; Jesse Vincent,0,0,0,0
1667955629751,ECE 247B,A00,103651,Wang; Joseph,0,0,0,0
1667955630175,ECE 250,A00,103652,Siegel; Paul H.,0,0,0,0
1667955630603,ECE 251A,A00,103654,Rao; Bhaskar D.,0,0,0,0
1667955631041,ECE 257B,A00,103655,Bharadia; Dinesh,0,0,0,0
1667955631463,ECE 258A,A00,103656,Milstein; Laurence B.,0,0,0,0
1667955631886,ECE 260B,A00,103658,Kang; Mingu,0,0,0,0
1667955632317,ECE 264A,A00,103659,Galton; Ian A,0,0,0,0
1667955632742,ECE 265A,A00,103661,Gudem; Prasad S.S.,0,0,0,0
1667955633165,ECE 265D,A00,103662,Gudem; Prasad S.S.,0,0,0,0
1667955633591,ECE 268,A00,103663,Koushanfar; Farinaz,0,0,0,0
1667955634020,ECE 269,A01,103665,Pal; Piya,0,0,0,0
1667955634451,ECE 271B,A00,103666,Vasconcelos; Manuela,0,0,0,0
1667955634876,ECE 276A,A00,103667,Atanasov; Nikolay A.,0,0,0,0
1667955635325,ECE 277,A00,103668,An; Cheolhong,0,0,0,0
1667955635761,ECE 279,A00,117947,Hall; Drew A.,0,0,0,0
1667955636621,ECE 283,A00,103670,Hsueh; Tzu-Chien,0,0,0,0
1667955637048,ECE 284,A00,103671,Turakhia; Yatish Girish,0,0,0,0
1667955637473,ECE 285,A00,103672,Zheng; Yang,0,0,0,0
1667955637473,ECE 285,B00,103673,Sworder; David D.,0,0,0,0
1667955637902,ECE 287,A00,103676,Javidi; Tara,0,0,0,0
1667955638325,MATH 200B,A00,098023,Salehi Golsefidy; Alireza,14,0,15,1
1667955638757,MATH 202B,A00,098024,Rhoades; Brendon Patrick,12,0,15,3
1667955639180,MATH 203B,A00,098025,Oprea; Dragos N.,13,0,15,2
1667955639611,MATH 204B,A00,098026,Sorensen; Claus M,15,0,15,0
1667955640049,MATH 208,A00,098027,Izadi; Elham,7,0,10,3
1667955640473,MATH 209,A00,098028,Pollack; Aaron,10,0,10,0
1667955640899,MATH 211A,A00,112919,Rogalski; Daniel,9,0,10,1
1667955641321,MATH 211B,A00,112920,Seward; Brandon M.,9,0,10,1
1667955641756,MATH 218,A00,098029,Li; Bo,10,0,10,0
1667955642180,MATH 220B,A00,098030,Novak; Jonathan I,13,0,15,2
1667955642602,MATH 221A,A00,098031,Ebenfelt; Peter F,13,0,15,2
1667955643025,MATH 231B,A00,098032,Zlatos; Andrej,12,0,15,3
1667955643456,MATH 240B,A00,098033,Ni; Lei,10,0,15,5
1667955643888,MATH 243,A00,098034,Jekel; David Andrew,10,0,10,0
1667955644314,MATH 245A,A00,098035,Nie; Jiawang,0,0,15,16
1667955644741,MATH 248,A00,098036,Bejenaru; Ioan,10,0,10,0
1667955645163,MATH 250B,A00,098037,Spolaor; Luca,14,0,15,1
1667955645591,MATH 258,A00,098038,Ni; Lei,10,0,10,0
1667955646015,MATH 264B,A00,098041,Rhoades; Brendon Patrick,12,0,15,3
1667955646438,MATH 268,A00,098042,Buss; Samuel R,10,0,10,0
1667955646882,MATH 269,A00,098043,Rhoades; Brendon Patrick,10,0,10,0
1667955647307,MATH 270B,A00,098044,Li; Bo,11,0,15,4
1667955647731,MATH 272B,A00,098045,Holst; Michael J,13,0,15,2
1667955648156,MATH 273A,A00,098046,Tian; Xiaochuan,12,0,15,3
1667955648580,MATH 275,A01,098048,Tian; Xiaochuan,6,0,10,4
1667955649018,MATH 278A,A00,098049,Holst; Michael J,8,0,10,2
1667955649441,MATH 278B,A00,098050,Cloninger; Alexander,10,0,10,0
1667955649871,MATH 278C,A00,098051,Nie; Jiawang,8,0,10,2
1667955650297,MATH 280B,A00,098052,Zheng; Tianyi,12,0,15,3
1667955650727,MATH 281B,A00,098053,Bradic; Jelena,4,0,15,11
1667955651175,MATH 282B,A00,098054,Arias-Castro; Ery,2,0,15,13
1667955651597,MATH 285,A00,098055,Fitzsimmons; Patrick J,0,0,15,17
1667955652025,MATH 287B,A00,098056,Arias-Castro; Ery,5,0,15,10
1667955652460,MATH 288,A00,098057,Agarwal; Pooja,9,0,10,1
1667955652460,MATH 288,B00,098058,Zhang; Danna,9,0,10,1
1667955652460,MATH 288,C00,098059,Williams; Ruth J,10,0,10,0
1667955652897,MATH 290B,A00,098060,Roberts; Justin Deritter,14,0,15,1
1667955653320,MATH 292,A00,098061,Belmont; Eva Kinoshita,10,0,10,0
1667955653756,MATH 295,A00,098062,Suk; Andrew Hoon,48,0,50,2
1667955654184,MATH 296,A00,098063,Novak; Jonathan I,20,0,20,0
1667955654615,MATH 297,001,098064,Gamst; Anthony Collins,9997,0,9999,2
1667956157038,COGS 205,A00,101395,Chiba; Andrea,19,0,20,1
1667956157462,COGS 210B,001,101404,Greene; Deanna Jacquelyn,9998,0,9999,1
1667956157462,COGS 210B,002,101417,Xia; Haijun,9999,0,9999,0
1667956157462,COGS 210B,003,101422,Nitz; Douglas A.,9999,0,9999,0
1667956157462,COGS 210B,004,101423,Hollan; James D.,9998,0,9999,1
1667956157462,COGS 210B,005,101424,Deak; Gedeon O.,9999,0,9999,0
1667956157462,COGS 210B,006,101425,Rossano; Federico,9999,0,9999,0
1667956157886,COGS 211B,A00,101427,Coulson; Seana M,9997,0,9999,2
1667956158312,COGS 220,A00,101428,Hollan; James D.,0,0,25,25
1667956158757,COGS 229,A00,101429,Dow; Steven P,18,0,25,7
1667956159188,COGS 230,A00,101430,Klemmer; Scott R,13,0,17,4
1667956159622,COGS 234,A00,101431,Xia; Haijun,7,0,25,18
1667956160045,COGS 260,A00,101432,Kiyonaga; Anastasia,20,0,25,5
1667956160045,COGS 260,B00,101433,Kirsh; David Joel,16,0,25,9
1667956160477,CSE 202,A00,102371,Impagliazzo; Russell,0,0,0,0
1667956160902,CSE 203B,A01,102373,Cheng; Chung Kuan,0,0,0,0
1667956161330,CSE 208,A00,102374,Micciancio; Daniele,0,0,0,0
1667956161754,CSE 209A,A00,112895,Impagliazzo; Russell,0,0,15,15
1667956162186,CSE 209B,A00,108005,Bellare; Mihir,0,0,0,0
1667956162612,CSE 210,A00,113163,Coblenz; Michael J,0,0,0,0
1667956163037,CSE 219,A00,106111,Dow; Steven P,0,0,20,20
1667956163462,CSE 221,A00,102376,Voelker; Geoffrey M.,0,0,0,0
1667956163887,CSE 224,A01,102378,Porter; George M,0,0,0,0
1667956164307,CSE 229A,A00,102379,Savage; Stefan,0,0,0,0
1667956164732,CSE 229C,A00,102380,Munyaka; Imani N. S.,0,0,0,0
1667956165153,CSE 232B,A00,102382,Deutsch; Alin Bernard,0,0,0,0
1667956165584,CSE 234,A01,112904,Kumar; Arun Kumar,0,0,0,0
1667956166011,CSE 237A,A00,102383,Rosing; Tajana Simunic,0,0,0,0
1667956166438,CSE 239A,A00,102384,Deutsch; Alin Bernard,0,0,0,0
1667956166863,CSE 239B,A00,102385,Polikarpova; Nadezhda,0,0,0,0
1667956167288,CSE 240A,A00,102386,Pannuto; Patrick William,0,0,0,0
1667956167713,CSE 240B,A00,102387,Zhao; Jishen,0,0,0,0
1667956168146,CSE 241A,A00,106406,Kang; Mingu,0,0,0,0
1667956168569,CSE 249B,A00,102388,Kahng; Andrew Byun,0,0,8,8
1667956168992,CSE 251B,A01,102392,Cottrell; Garrison W,0,0,0,0
1667956168992,CSE 251B,A02,102393,Cottrell; Garrison W,0,0,0,0
1667956169416,CSE 252B,A00,102394,Ochoa; Benjamin Lawrence,0,0,0,0
1667956169843,CSE 257,A01,102396,Gao; Sicun,0,0,0,0
1667956170278,CSE 272,A00,102397,Li; Tzumao,0,0,0,0
1667956170700,CSE 274,A00,111323,Chern; Albert Ren-Haur,0,0,0,0
1667956171123,CSE 282,A00,102398,Pevzner; Pavel Arkadjevich,0,0,0,0
1667956171550,CSE 284,A00,114175,Gymrek; Melissa Ann,0,0,0,0
1667956171979,CSE 290,A00,102399,Chandraker; Manmohan Krishna,0,0,0,0
1667956171979,CSE 290,B00,102400,Vaccaro; Kristen Marie,0,0,25,25
1667956171979,CSE 290,C00,102414,Pannuto; Patrick William,0,0,25,25
1667956171979,CSE 290,D00,102427,Pevzner; Pavel Arkadjevich,0,0,0,0
1667956171979,CSE 290,E00,102429,Zhao; Jishen,0,0,0,0
1667956171979,CSE 290,F00,102436,Tullsen; Dean Michael,0,0,0,0
1667956171979,CSE 290,G00,102440,Christensen; Henrik I,0,0,20,20
1667956172408,CSE 291,A00,102443,Su; Hao,0,0,0,0
1667956172408,CSE 291,B00,102448,Polikarpova; Nadezhda,0,0,0,0
1667956172408,CSE 291,C00,102453,Vaccaro; Kristen Marie,0,0,0,0
1667956172408,CSE 291,D00,111343,Savage; Stefan,0,0,0,0
1667956172408,CSE 291,E00,116474,Claffy; Kimberly Claire,0,0,0,0
1667956172408,CSE 291,F00,116479,Pasquale; Joseph,0,0,0,0
1667956172842,CSE 293,001,119111,Bafna; Vineet,9999,0,9999,0
1667956172842,CSE 293,002,119118,Bellare; Mihir,9999,0,9999,0
1667956172842,CSE 293,003,119122,Berg-Kirkpatrick; Taylor D,9999,0,9999,0
1667956172842,CSE 293,004,119135,Christensen; Henrik I,9999,0,9999,0
1667956172842,CSE 293,005,119142,Cottrell; Garrison W,9999,0,9999,0
1667956172842,CSE 293,006,119146,Deutsch; Alin Bernard,9999,0,9999,0
1667956172842,CSE 293,007,119159,Esmaeilzadeh; Hadi,9999,0,9999,0
1667956172842,CSE 293,008,119166,Freund; Yoav,9999,0,9999,0
1667956172842,CSE 293,009,119170,Griswold; William G.,9999,0,9999,0
1667956172842,CSE 293,010,119183,Gymrek; Melissa Ann,9999,0,9999,0
1667956172842,CSE 293,011,119190,Heninger; Nadia A,9999,0,9999,0
1667956172842,CSE 293,012,119230,Impagliazzo; Russell,9999,0,9999,0
1667956172842,CSE 293,013,119232,Jhala; Ranjit,9999,0,9999,0
1667956172842,CSE 293,014,119233,Kahng; Andrew Byun,9999,0,9999,0
1667956172842,CSE 293,015,119298,Kane; Daniel Mertz,9999,0,9999,0
1667956172842,CSE 293,016,119299,Kriegman; David J,9999,0,9999,0
1667956172842,CSE 293,017,119300,Kumar; Arun Kumar,9999,0,9999,0
1667956172842,CSE 293,018,119301,Lerner; Sorin,9999,0,9999,0
1667956172842,CSE 293,019,119302,Lovett; Shachar,9999,0,9999,0
1667956172842,CSE 293,020,119303,McAuley; Julian John,9999,0,9999,0
1667956172842,CSE 293,021,119304,Micciancio; Daniele,9999,0,9999,0
1667956172842,CSE 293,022,119367,Orailoglu; Alex,9999,0,9999,0
1667956172842,CSE 293,023,119382,Paturi; Ramamohan,9999,0,9999,0
1667956172842,CSE 293,024,119404,Polikarpova; Nadezhda,9999,0,9999,0
1667956172842,CSE 293,025,119406,Politz; Joseph Gibbs,9999,0,9999,0
1667956172842,CSE 293,026,119411,Porter; George M,9999,0,9999,0
1667956172842,CSE 293,027,119414,Porter; Leonard Emerson,9999,0,9999,0
1667956172842,CSE 293,028,119416,Ramamoorthi; Ravi,9999,0,9999,0
1667956172842,CSE 293,029,119417,Sahoo; Debashis,9999,0,9999,0
1667956172842,CSE 293,030,119420,Saul; Lawrence,9999,0,9999,0
1667956172842,CSE 293,031,119421,Savage; Stefan,9999,0,9999,0
1667956172842,CSE 293,032,119425,Schulze; Jurgen P.,9999,0,9999,0
1667956172842,CSE 293,033,119426,Snoeren; Alex C.,9999,0,9999,0
1667956172842,CSE 293,034,119428,Shang; Jingbo,9999,0,9999,0
1667956172842,CSE 293,035,119430,Stefan; Deian,9999,0,9999,0
1667956172842,CSE 293,036,119431,Su; Hao,9999,0,9999,0
1667956172842,CSE 293,037,119433,Swanson; Steven James,9999,0,9999,0
1667956172842,CSE 293,038,119435,Tullsen; Dean Michael,9999,0,9999,0
1667956172842,CSE 293,039,119483,Voelker; Geoffrey M.,9999,0,9999,0
1667956172842,CSE 293,040,119537,Zhao; Jishen,9999,0,9999,0
1667956172842,CSE 293,041,119538,Zhou; Yuan-Yuan,9999,0,9999,0
1667956172842,CSE 293,042,119539,Gao; Sicun,9999,0,9999,0
1667956172842,CSE 293,043,119540,Weibel; Nadir,9999,0,9999,0
1667956172842,CSE 293,044,119541,Gupta; Rajesh K.,9999,0,9999,0
1667956173276,CSE 294,A00,102459,Voelker; Geoffrey M.,0,0,0,0
1667956173276,CSE 294,B00,111322,Orailoglu; Alex,0,0,0,0
1667956173700,DSE 201,A00,096914,Deutsch; Alin Bernard,30,0,30,0
1667956174126,DSE 210,A00,096915,Dasgupta; Sanjoy,30,0,30,0
1667956174556,DSE 260A,A00,096916,Altintas De Callaf; Ilkay,30,0,30,0
1667956175010,ECE 200,001,103586,Antipa; Nicholas A,9999,0,9999,0
1667956175010,ECE 200,002,103587,Atanasov; Nikolay A.,9999,0,9999,0
1667956175010,ECE 200,003,103588,Bharadia; Dinesh,9999,0,9999,0
1667956175010,ECE 200,004,103589,Cheng; Chung Kuan,9999,0,9999,0
1667956175010,ECE 200,005,103590,Cosman; Pamela C.,9999,0,9999,0
1667956175010,ECE 200,006,103591,Dayeh; Shadi Ahmad,9999,0,9999,0
1667956175010,ECE 200,007,103592,Fainman; Yeshaiahu,9999,0,9999,0
1667956175010,ECE 200,008,103593,Ford; Joseph Earl,9999,0,9999,0
1667956175010,ECE 200,009,103594,Franceschetti; Massimo,9999,0,9999,0
1667956175010,ECE 200,010,103595,Fullerton; Eric E,9999,0,9999,0
1667956175010,ECE 200,011,103596,Galton; Ian A,9999,0,9999,0
1667956175010,ECE 200,012,103597,Gilja; Vikash,9999,0,9999,0
1667956175010,ECE 200,013,103598,Hall; Drew A.,9999,0,9999,0
1667956175010,ECE 200,014,103599,Hsueh; Tzu-Chien,9999,0,9999,0
1667956175010,ECE 200,015,103600,Javidi; Tara,9999,0,9999,0
1667956175010,ECE 200,016,103601,Kahng; Andrew Byun,9999,0,9999,0
1667956175010,ECE 200,017,103602,Kim; Young-Han,9999,0,9999,0
1667956175010,ECE 200,018,103603,Koushanfar; Farinaz,9999,0,9999,0
1667956175010,ECE 200,019,103604,Kuzum; Duygu,9999,0,9999,0
1667956175010,ECE 200,020,103605,Le; Hanh-Phuc,9999,0,9999,0
1667956175010,ECE 200,021,103606,Lin; Bill,9999,0,9999,0
1667956175010,ECE 200,022,103607,Liu; Zhaowei,9998,0,9999,1
1667956175010,ECE 200,023,103608,Lo; Yu-Hwa,9999,0,9999,0
1667956175010,ECE 200,024,103609,Lomakin; Vitaliy,9999,0,9999,0
1667956175010,ECE 200,025,103610,Mercier; Patrick Philip,9999,0,9999,0
1667956175010,ECE 200,026,103611,Meyer; Florian,9999,0,9999,0
1667956175010,ECE 200,027,103612,Milstein; Laurence B.,9999,0,9999,0
1667956175010,ECE 200,028,103613,Mir Arabbaygi; Siavash,9999,0,9999,0
1667956175010,ECE 200,029,103614,Mookherjea; Shayan,9999,0,9999,0
1667956175010,ECE 200,030,103615,Morris; Karcher William,9999,0,9999,0
1667956175010,ECE 200,031,103616,Ng; Tse Nga,9999,0,9999,0
1667956175010,ECE 200,032,103617,Nguyen; Truong Quang,9999,0,9999,0
1667956175010,ECE 200,033,103618,Nomura; Kenji,9999,0,9999,0
1667956175010,ECE 200,034,103619,Orlitsky; Alon,9999,0,9999,0
1667956175010,ECE 200,035,103620,Pal; Piya,9999,0,9999,0
1667956175010,ECE 200,036,103621,Papen; George C.,9999,0,9999,0
1667956175010,ECE 200,037,103622,Radic; Stojan,9999,0,9999,0
1667956175010,ECE 200,038,103623,Rao; Bhaskar D.,9999,0,9999,0
1667956175010,ECE 200,039,103624,Rao; Ramesh R,9999,0,9999,0
1667956175010,ECE 200,040,103625,Rebeiz; Gabriel,9999,0,9999,0
1667956175010,ECE 200,041,103626,Sanford; John R,9999,0,9999,0
1667956175010,ECE 200,042,103627,Siegel; Paul H.,9999,0,9999,0
1667956175010,ECE 200,043,103628,Sievenpiper; Daniel F.,9999,0,9999,0
1667956175010,ECE 200,044,103629,Sworder; David D.,9999,0,9999,0
1667956175010,ECE 200,045,103630,Taur; Yuan,9999,0,9999,0
1667956175010,ECE 200,046,103631,Touri; Behrouz,9999,0,9999,0
1667956175010,ECE 200,047,103632,Trivedi; Mohan M.,9999,0,9999,0
1667956175010,ECE 200,048,103633,Vasconcelos; Nuno,9999,0,9999,0
1667956175010,ECE 200,049,103634,Wang; Xiaolong,9999,0,9999,0
1667956175010,ECE 200,050,103635,Xie; Pengtao,9999,0,9999,0
1667956175010,ECE 200,051,103636,Yip; Michael,9999,0,9999,0
1667956175010,ECE 200,052,103637,Zeger; Kenneth A.,999,0,999,0
1667956175010,ECE 200,053,103638,Zhang; Xinyu,9999,0,9999,0
1667956175010,ECE 200,054,103639,Turakhia; Yatish Girish,9999,0,9999,0
1667956175010,ECE 200,055,103640,Kang; Mingu,9999,0,9999,0
1667956175010,ECE 200,056,103641,Shi; Yuanyuan,9999,0,9999,0
1667956175010,ECE 200,057,103642,Wang; Edward Jay,9999,0,9999,0
1667956175010,ECE 200,058,103643,Zheng; Yang,9999,0,9999,0
1667956175435,ECE 202,A00,103644,Kuzum; Duygu,0,0,0,0
1667956175860,ECE 212BN,A00,103646,Ng; Tse Nga,0,0,0,0
1667956176290,ECE 221,A00,111493,Staff,0,0,0,0
1667956176718,ECE 222B,A00,103647,Lomakin; Vitaliy,0,0,0,0
1667956177142,ECE 230B,A00,103648,Taur; Yuan,0,0,0,0
1667956177567,ECE 238B,A00,103649,Garay; Javier,0,0,0,0
1667956177993,ECE 240B,A00,112900,Fainman; Yeshaiahu,0,0,0,0
1667956178423,ECE 247A,A00,103650,Jokerst; Jesse Vincent,0,0,0,0
1667956178846,ECE 247B,A00,103651,Wang; Joseph,0,0,0,0
1667956179275,ECE 250,A00,103652,Siegel; Paul H.,0,0,0,0
1667956179703,ECE 251A,A00,103654,Rao; Bhaskar D.,0,0,0,0
1667956180136,ECE 257B,A00,103655,Bharadia; Dinesh,0,0,0,0
1667956180569,ECE 258A,A00,103656,Milstein; Laurence B.,0,0,0,0
1667956180997,ECE 260B,A00,103658,Kang; Mingu,0,0,0,0
1667956181429,ECE 264A,A00,103659,Galton; Ian A,0,0,0,0
1667956181856,ECE 265A,A00,103661,Gudem; Prasad S.S.,0,0,0,0
1667956182284,ECE 265D,A00,103662,Gudem; Prasad S.S.,0,0,0,0
1667956182714,ECE 268,A00,103663,Koushanfar; Farinaz,0,0,0,0
1667956183136,ECE 269,A01,103665,Pal; Piya,0,0,0,0
1667956183563,ECE 271B,A00,103666,Vasconcelos; Manuela,0,0,0,0
1667956183987,ECE 276A,A00,103667,Atanasov; Nikolay A.,0,0,0,0
1667956184416,ECE 277,A00,103668,An; Cheolhong,0,0,0,0
1667956184849,ECE 279,A00,117947,Hall; Drew A.,0,0,0,0
1667956185693,ECE 283,A00,103670,Hsueh; Tzu-Chien,0,0,0,0
1667956186119,ECE 284,A00,103671,Turakhia; Yatish Girish,0,0,0,0
1667956186546,ECE 285,A00,103672,Zheng; Yang,0,0,0,0
1667956186546,ECE 285,B00,103673,Sworder; David D.,0,0,0,0
1667956186971,ECE 287,A00,103676,Javidi; Tara,0,0,0,0
1667956187407,MATH 200B,A00,098023,Salehi Golsefidy; Alireza,14,0,15,1
1667956187838,MATH 202B,A00,098024,Rhoades; Brendon Patrick,12,0,15,3
1667956188264,MATH 203B,A00,098025,Oprea; Dragos N.,13,0,15,2
1667956188689,MATH 204B,A00,098026,Sorensen; Claus M,15,0,15,0
1667956189196,MATH 208,A00,098027,Izadi; Elham,7,0,10,3
1667956189636,MATH 209,A00,098028,Pollack; Aaron,10,0,10,0
1667956190063,MATH 211A,A00,112919,Rogalski; Daniel,9,0,10,1
1667956190486,MATH 211B,A00,112920,Seward; Brandon M.,9,0,10,1
1667956190911,MATH 218,A00,098029,Li; Bo,10,0,10,0
1667956191342,MATH 220B,A00,098030,Novak; Jonathan I,13,0,15,2
1667956191766,MATH 221A,A00,098031,Ebenfelt; Peter F,13,0,15,2
1667956192194,MATH 231B,A00,098032,Zlatos; Andrej,12,0,15,3
1667956192617,MATH 240B,A00,098033,Ni; Lei,10,0,15,5
1667956193042,MATH 243,A00,098034,Jekel; David Andrew,10,0,10,0
1667956193466,MATH 245A,A00,098035,Nie; Jiawang,0,0,15,16
1667956193891,MATH 248,A00,098036,Bejenaru; Ioan,10,0,10,0
1667956194314,MATH 250B,A00,098037,Spolaor; Luca,14,0,15,1
1667956194738,MATH 258,A00,098038,Ni; Lei,10,0,10,0
1667956195162,MATH 264B,A00,098041,Rhoades; Brendon Patrick,12,0,15,3
1667956195586,MATH 268,A00,098042,Buss; Samuel R,10,0,10,0
1667956196008,MATH 269,A00,098043,Rhoades; Brendon Patrick,10,0,10,0
1667956196431,MATH 270B,A00,098044,Li; Bo,11,0,15,4
1667956196858,MATH 272B,A00,098045,Holst; Michael J,13,0,15,2
1667956197282,MATH 273A,A00,098046,Tian; Xiaochuan,12,0,15,3
1667956197710,MATH 275,A01,098048,Tian; Xiaochuan,6,0,10,4
1667956198140,MATH 278A,A00,098049,Holst; Michael J,8,0,10,2
1667956198562,MATH 278B,A00,098050,Cloninger; Alexander,10,0,10,0
1667956198986,MATH 278C,A00,098051,Nie; Jiawang,8,0,10,2
1667956199412,MATH 280B,A00,098052,Zheng; Tianyi,12,0,15,3
1667956199836,MATH 281B,A00,098053,Bradic; Jelena,4,0,15,11
1667956200261,MATH 282B,A00,098054,Arias-Castro; Ery,2,0,15,13
1667956200685,MATH 285,A00,098055,Fitzsimmons; Patrick J,0,0,15,17
1667956201113,MATH 287B,A00,098056,Arias-Castro; Ery,5,0,15,10
1667956201545,MATH 288,A00,098057,Agarwal; Pooja,9,0,10,1
1667956201545,MATH 288,B00,098058,Zhang; Danna,9,0,10,1
1667956201545,MATH 288,C00,098059,Williams; Ruth J,10,0,10,0
1667956201970,MATH 290B,A00,098060,Roberts; Justin Deritter,14,0,15,1
1667956202423,MATH 292,A00,098061,Belmont; Eva Kinoshita,10,0,10,0
1667956202850,MATH 295,A00,098062,Suk; Andrew Hoon,48,0,50,2
1667956203277,MATH 296,A00,098063,Novak; Jonathan I,20,0,20,0
1667956203708,MATH 297,001,098064,Gamst; Anthony Collins,9997,0,9999,2
1667956706082,COGS 205,A00,101395,Chiba; Andrea,19,0,20,1
1667956706512,COGS 210B,001,101404,Greene; Deanna Jacquelyn,9998,0,9999,1
1667956706512,COGS 210B,002,101417,Xia; Haijun,9999,0,9999,0
1667956706512,COGS 210B,003,101422,Nitz; Douglas A.,9999,0,9999,0
1667956706512,COGS 210B,004,101423,Hollan; James D.,9998,0,9999,1
1667956706512,COGS 210B,005,101424,Deak; Gedeon O.,9999,0,9999,0
1667956706512,COGS 210B,006,101425,Rossano; Federico,9999,0,9999,0
1667956706937,COGS 211B,A00,101427,Coulson; Seana M,9997,0,9999,2
1667956707361,COGS 220,A00,101428,Hollan; James D.,0,0,25,25
1667956707785,COGS 229,A00,101429,Dow; Steven P,18,0,25,7
1667956708207,COGS 230,A00,101430,Klemmer; Scott R,13,0,17,4
1667956708666,COGS 234,A00,101431,Xia; Haijun,7,0,25,18
1667956709090,COGS 260,A00,101432,Kiyonaga; Anastasia,20,0,25,5
1667956709090,COGS 260,B00,101433,Kirsh; David Joel,16,0,25,9
1667956709519,CSE 202,A00,102371,Impagliazzo; Russell,0,0,0,0
1667956709943,CSE 203B,A01,102373,Cheng; Chung Kuan,0,0,0,0
1667956710367,CSE 208,A00,102374,Micciancio; Daniele,0,0,0,0
1667956710790,CSE 209A,A00,112895,Impagliazzo; Russell,0,0,15,15
1667956711227,CSE 209B,A00,108005,Bellare; Mihir,0,0,0,0
1667956711729,CSE 210,A00,113163,Coblenz; Michael J,0,0,0,0
1667956712152,CSE 219,A00,106111,Dow; Steven P,0,0,20,20
1667956712582,CSE 221,A00,102376,Voelker; Geoffrey M.,0,0,0,0
1667956713004,CSE 224,A01,102378,Porter; George M,0,0,0,0
1667956713427,CSE 229A,A00,102379,Savage; Stefan,0,0,0,0
1667956713851,CSE 229C,A00,102380,Munyaka; Imani N. S.,0,0,0,0
1667956714275,CSE 232B,A00,102382,Deutsch; Alin Bernard,0,0,0,0
1667956714704,CSE 234,A01,112904,Kumar; Arun Kumar,0,0,0,0
1667956715126,CSE 237A,A00,102383,Rosing; Tajana Simunic,0,0,0,0
1667956715556,CSE 239A,A00,102384,Deutsch; Alin Bernard,0,0,0,0
1667956715981,CSE 239B,A00,102385,Polikarpova; Nadezhda,0,0,0,0
1667956716410,CSE 240A,A00,102386,Pannuto; Patrick William,0,0,0,0
1667956716837,CSE 240B,A00,102387,Zhao; Jishen,0,0,0,0
1667956717275,CSE 241A,A00,106406,Kang; Mingu,0,0,0,0
1667956717706,CSE 249B,A00,102388,Kahng; Andrew Byun,0,0,8,8
1667956718132,CSE 251B,A01,102392,Cottrell; Garrison W,0,0,0,0
1667956718132,CSE 251B,A02,102393,Cottrell; Garrison W,0,0,0,0
1667956718565,CSE 252B,A00,102394,Ochoa; Benjamin Lawrence,0,0,0,0
1667956718994,CSE 257,A01,102396,Gao; Sicun,0,0,0,0
1667956719420,CSE 272,A00,102397,Li; Tzumao,0,0,0,0
1667956719848,CSE 274,A00,111323,Chern; Albert Ren-Haur,0,0,0,0
1667956720273,CSE 282,A00,102398,Pevzner; Pavel Arkadjevich,0,0,0,0
1667956720696,CSE 284,A00,114175,Gymrek; Melissa Ann,0,0,0,0
1667956721120,CSE 290,A00,102399,Chandraker; Manmohan Krishna,0,0,0,0
1667956721120,CSE 290,B00,102400,Vaccaro; Kristen Marie,0,0,25,25
1667956721120,CSE 290,C00,102414,Pannuto; Patrick William,0,0,25,25
1667956721120,CSE 290,D00,102427,Pevzner; Pavel Arkadjevich,0,0,0,0
1667956721120,CSE 290,E00,102429,Zhao; Jishen,0,0,0,0
1667956721120,CSE 290,F00,102436,Tullsen; Dean Michael,0,0,0,0
1667956721120,CSE 290,G00,102440,Christensen; Henrik I,0,0,20,20
1667956721548,CSE 291,A00,102443,Su; Hao,0,0,0,0
1667956721548,CSE 291,B00,102448,Polikarpova; Nadezhda,0,0,0,0
1667956721548,CSE 291,C00,102453,Vaccaro; Kristen Marie,0,0,0,0
1667956721548,CSE 291,D00,111343,Savage; Stefan,0,0,0,0
1667956721548,CSE 291,E00,116474,Claffy; Kimberly Claire,0,0,0,0
1667956721548,CSE 291,F00,116479,Pasquale; Joseph,0,0,0,0
1667956721986,CSE 293,001,119111,Bafna; Vineet,9999,0,9999,0
1667956721986,CSE 293,002,119118,Bellare; Mihir,9999,0,9999,0
1667956721986,CSE 293,003,119122,Berg-Kirkpatrick; Taylor D,9999,0,9999,0
1667956721986,CSE 293,004,119135,Christensen; Henrik I,9999,0,9999,0
1667956721986,CSE 293,005,119142,Cottrell; Garrison W,9999,0,9999,0
1667956721986,CSE 293,006,119146,Deutsch; Alin Bernard,9999,0,9999,0
1667956721986,CSE 293,007,119159,Esmaeilzadeh; Hadi,9999,0,9999,0
1667956721986,CSE 293,008,119166,Freund; Yoav,9999,0,9999,0
1667956721986,CSE 293,009,119170,Griswold; William G.,9999,0,9999,0
1667956721986,CSE 293,010,119183,Gymrek; Melissa Ann,9999,0,9999,0
1667956721986,CSE 293,011,119190,Heninger; Nadia A,9999,0,9999,0
1667956721986,CSE 293,012,119230,Impagliazzo; Russell,9999,0,9999,0
1667956721986,CSE 293,013,119232,Jhala; Ranjit,9999,0,9999,0
1667956721986,CSE 293,014,119233,Kahng; Andrew Byun,9999,0,9999,0
1667956721986,CSE 293,015,119298,Kane; Daniel Mertz,9999,0,9999,0
1667956721986,CSE 293,016,119299,Kriegman; David J,9999,0,9999,0
1667956721986,CSE 293,017,119300,Kumar; Arun Kumar,9999,0,9999,0
1667956721986,CSE 293,018,119301,Lerner; Sorin,9999,0,9999,0
1667956721986,CSE 293,019,119302,Lovett; Shachar,9999,0,9999,0
1667956721986,CSE 293,020,119303,McAuley; Julian John,9999,0,9999,0
1667956721986,CSE 293,021,119304,Micciancio; Daniele,9999,0,9999,0
1667956721986,CSE 293,022,119367,Orailoglu; Alex,9999,0,9999,0
1667956721986,CSE 293,023,119382,Paturi; Ramamohan,9999,0,9999,0
1667956721986,CSE 293,024,119404,Polikarpova; Nadezhda,9999,0,9999,0
1667956721986,CSE 293,025,119406,Politz; Joseph Gibbs,9999,0,9999,0
1667956721986,CSE 293,026,119411,Porter; George M,9999,0,9999,0
1667956721986,CSE 293,027,119414,Porter; Leonard Emerson,9999,0,9999,0
1667956721986,CSE 293,028,119416,Ramamoorthi; Ravi,9999,0,9999,0
1667956721986,CSE 293,029,119417,Sahoo; Debashis,9999,0,9999,0
1667956721986,CSE 293,030,119420,Saul; Lawrence,9999,0,9999,0
1667956721986,CSE 293,031,119421,Savage; Stefan,9999,0,9999,0
1667956721986,CSE 293,032,119425,Schulze; Jurgen P.,9999,0,9999,0
1667956721986,CSE 293,033,119426,Snoeren; Alex C.,9999,0,9999,0
1667956721986,CSE 293,034,119428,Shang; Jingbo,9999,0,9999,0
1667956721986,CSE 293,035,119430,Stefan; Deian,9999,0,9999,0
1667956721986,CSE 293,036,119431,Su; Hao,9999,0,9999,0
1667956721986,CSE 293,037,119433,Swanson; Steven James,9999,0,9999,0
1667956721986,CSE 293,038,119435,Tullsen; Dean Michael,9999,0,9999,0
1667956721986,CSE 293,039,119483,Voelker; Geoffrey M.,9999,0,9999,0
1667956721986,CSE 293,040,119537,Zhao; Jishen,9999,0,9999,0
1667956721986,CSE 293,041,119538,Zhou; Yuan-Yuan,9999,0,9999,0
1667956721986,CSE 293,042,119539,Gao; Sicun,9999,0,9999,0
1667956721986,CSE 293,043,119540,Weibel; Nadir,9999,0,9999,0
1667956721986,CSE 293,044,119541,Gupta; Rajesh K.,9999,0,9999,0
1667956722412,CSE 294,A00,102459,Voelker; Geoffrey M.,0,0,0,0
1667956722412,CSE 294,B00,111322,Orailoglu; Alex,0,0,0,0
1667956722836,DSE 201,A00,096914,Deutsch; Alin Bernard,30,0,30,0
1667956723262,DSE 210,A00,096915,Dasgupta; Sanjoy,30,0,30,0
1667956723693,DSE 260A,A00,096916,Altintas De Callaf; Ilkay,30,0,30,0
1667956724169,ECE 200,001,103586,Antipa; Nicholas A,9999,0,9999,0
1667956724169,ECE 200,002,103587,Atanasov; Nikolay A.,9999,0,9999,0
1667956724169,ECE 200,003,103588,Bharadia; Dinesh,9999,0,9999,0
1667956724169,ECE 200,004,103589,Cheng; Chung Kuan,9999,0,9999,0
1667956724169,ECE 200,005,103590,Cosman; Pamela C.,9999,0,9999,0
1667956724169,ECE 200,006,103591,Dayeh; Shadi Ahmad,9999,0,9999,0
1667956724169,ECE 200,007,103592,Fainman; Yeshaiahu,9999,0,9999,0
1667956724169,ECE 200,008,103593,Ford; Joseph Earl,9999,0,9999,0
1667956724169,ECE 200,009,103594,Franceschetti; Massimo,9999,0,9999,0
1667956724169,ECE 200,010,103595,Fullerton; Eric E,9999,0,9999,0
1667956724169,ECE 200,011,103596,Galton; Ian A,9999,0,9999,0
1667956724169,ECE 200,012,103597,Gilja; Vikash,9999,0,9999,0
1667956724169,ECE 200,013,103598,Hall; Drew A.,9999,0,9999,0
1667956724169,ECE 200,014,103599,Hsueh; Tzu-Chien,9999,0,9999,0
1667956724169,ECE 200,015,103600,Javidi; Tara,9999,0,9999,0
1667956724169,ECE 200,016,103601,Kahng; Andrew Byun,9999,0,9999,0
1667956724169,ECE 200,017,103602,Kim; Young-Han,9999,0,9999,0
1667956724169,ECE 200,018,103603,Koushanfar; Farinaz,9999,0,9999,0
1667956724169,ECE 200,019,103604,Kuzum; Duygu,9999,0,9999,0
1667956724169,ECE 200,020,103605,Le; Hanh-Phuc,9999,0,9999,0
1667956724169,ECE 200,021,103606,Lin; Bill,9999,0,9999,0
1667956724169,ECE 200,022,103607,Liu; Zhaowei,9998,0,9999,1
1667956724169,ECE 200,023,103608,Lo; Yu-Hwa,9999,0,9999,0
1667956724169,ECE 200,024,103609,Lomakin; Vitaliy,9999,0,9999,0
1667956724169,ECE 200,025,103610,Mercier; Patrick Philip,9999,0,9999,0
1667956724169,ECE 200,026,103611,Meyer; Florian,9999,0,9999,0
1667956724169,ECE 200,027,103612,Milstein; Laurence B.,9999,0,9999,0
1667956724169,ECE 200,028,103613,Mir Arabbaygi; Siavash,9999,0,9999,0
1667956724169,ECE 200,029,103614,Mookherjea; Shayan,9999,0,9999,0
1667956724169,ECE 200,030,103615,Morris; Karcher William,9999,0,9999,0
1667956724169,ECE 200,031,103616,Ng; Tse Nga,9999,0,9999,0
1667956724169,ECE 200,032,103617,Nguyen; Truong Quang,9999,0,9999,0
1667956724169,ECE 200,033,103618,Nomura; Kenji,9999,0,9999,0
1667956724169,ECE 200,034,103619,Orlitsky; Alon,9999,0,9999,0
1667956724169,ECE 200,035,103620,Pal; Piya,9999,0,9999,0
1667956724169,ECE 200,036,103621,Papen; George C.,9999,0,9999,0
1667956724169,ECE 200,037,103622,Radic; Stojan,9999,0,9999,0
1667956724169,ECE 200,038,103623,Rao; Bhaskar D.,9999,0,9999,0
1667956724169,ECE 200,039,103624,Rao; Ramesh R,9999,0,9999,0
1667956724169,ECE 200,040,103625,Rebeiz; Gabriel,9999,0,9999,0
1667956724169,ECE 200,041,103626,Sanford; John R,9999,0,9999,0
1667956724169,ECE 200,042,103627,Siegel; Paul H.,9999,0,9999,0
1667956724169,ECE 200,043,103628,Sievenpiper; Daniel F.,9999,0,9999,0
1667956724169,ECE 200,044,103629,Sworder; David D.,9999,0,9999,0
1667956724169,ECE 200,045,103630,Taur; Yuan,9999,0,9999,0
1667956724169,ECE 200,046,103631,Touri; Behrouz,9999,0,9999,0
1667956724169,ECE 200,047,103632,Trivedi; Mohan M.,9999,0,9999,0
1667956724169,ECE 200,048,103633,Vasconcelos; Nuno,9999,0,9999,0
1667956724169,ECE 200,049,103634,Wang; Xiaolong,9999,0,9999,0
1667956724169,ECE 200,050,103635,Xie; Pengtao,9999,0,9999,0
1667956724169,ECE 200,051,103636,Yip; Michael,9999,0,9999,0
1667956724169,ECE 200,052,103637,Zeger; Kenneth A.,999,0,999,0
1667956724169,ECE 200,053,103638,Zhang; Xinyu,9999,0,9999,0
1667956724169,ECE 200,054,103639,Turakhia; Yatish Girish,9999,0,9999,0
1667956724169,ECE 200,055,103640,Kang; Mingu,9999,0,9999,0
1667956724169,ECE 200,056,103641,Shi; Yuanyuan,9999,0,9999,0
1667956724169,ECE 200,057,103642,Wang; Edward Jay,9999,0,9999,0
1667956724169,ECE 200,058,103643,Zheng; Yang,9999,0,9999,0
1667956724594,ECE 202,A00,103644,Kuzum; Duygu,0,0,0,0
1667956725019,ECE 212BN,A00,103646,Ng; Tse Nga,0,0,0,0
1667956725462,ECE 221,A00,111493,Staff,0,0,0,0
1667956725888,ECE 222B,A00,103647,Lomakin; Vitaliy,0,0,0,0
1667956726311,ECE 230B,A00,103648,Taur; Yuan,0,0,0,0
1667956726735,ECE 238B,A00,103649,Garay; Javier,0,0,0,0
1667956727164,ECE 240B,A00,112900,Fainman; Yeshaiahu,0,0,0,0
1667956727588,ECE 247A,A00,103650,Jokerst; Jesse Vincent,0,0,0,0
1667956728010,ECE 247B,A00,103651,Wang; Joseph,0,0,0,0
1667956728443,ECE 250,A00,103652,Siegel; Paul H.,0,0,0,0
1667956728870,ECE 251A,A00,103654,Rao; Bhaskar D.,0,0,0,0
1667956729299,ECE 257B,A00,103655,Bharadia; Dinesh,0,0,0,0
1667956729723,ECE 258A,A00,103656,Milstein; Laurence B.,0,0,0,0
1667956730150,ECE 260B,A00,103658,Kang; Mingu,0,0,0,0
1667956730574,ECE 264A,A00,103659,Galton; Ian A,0,0,0,0
1667956731000,ECE 265A,A00,103661,Gudem; Prasad S.S.,0,0,0,0
1667956731424,ECE 265D,A00,103662,Gudem; Prasad S.S.,0,0,0,0
1667956731848,ECE 268,A00,103663,Koushanfar; Farinaz,0,0,0,0
1667956732274,ECE 269,A01,103665,Pal; Piya,0,0,0,0
1667956732700,ECE 271B,A00,103666,Vasconcelos; Manuela,0,0,0,0
1667956733134,ECE 276A,A00,103667,Atanasov; Nikolay A.,0,0,0,0
1667956733558,ECE 277,A00,103668,An; Cheolhong,0,0,0,0
1667956733985,ECE 279,A00,117947,Hall; Drew A.,0,0,0,0
1667956734841,ECE 283,A00,103670,Hsueh; Tzu-Chien,0,0,0,0
1667956735276,ECE 284,A00,103671,Turakhia; Yatish Girish,0,0,0,0
1667956735699,ECE 285,A00,103672,Zheng; Yang,0,0,0,0
1667956735699,ECE 285,B00,103673,Sworder; David D.,0,0,0,0
1667956736124,ECE 287,A00,103676,Javidi; Tara,0,0,0,0
1667956736556,MATH 200B,A00,098023,Salehi Golsefidy; Alireza,14,0,15,1
1667956736980,MATH 202B,A00,098024,Rhoades; Brendon Patrick,12,0,15,3
1667956737408,MATH 203B,A00,098025,Oprea; Dragos N.,13,0,15,2
1667956737828,MATH 204B,A00,098026,Sorensen; Claus M,15,0,15,0
1667956738255,MATH 208,A00,098027,Izadi; Elham,7,0,10,3
1667956738678,MATH 209,A00,098028,Pollack; Aaron,10,0,10,0
1667956739105,MATH 211A,A00,112919,Rogalski; Daniel,9,0,10,1
1667956739528,MATH 211B,A00,112920,Seward; Brandon M.,9,0,10,1
1667956739951,MATH 218,A00,098029,Li; Bo,10,0,10,0
1667956740377,MATH 220B,A00,098030,Novak; Jonathan I,13,0,15,2
1667956740800,MATH 221A,A00,098031,Ebenfelt; Peter F,13,0,15,2
1667956741237,MATH 231B,A00,098032,Zlatos; Andrej,12,0,15,3
1667956741693,MATH 240B,A00,098033,Ni; Lei,10,0,15,5
1667956742119,MATH 243,A00,098034,Jekel; David Andrew,10,0,10,0
1667956742546,MATH 245A,A00,098035,Nie; Jiawang,0,0,15,16
1667956742974,MATH 248,A00,098036,Bejenaru; Ioan,10,0,10,0
1667956743403,MATH 250B,A00,098037,Spolaor; Luca,14,0,15,1
1667956743825,MATH 258,A00,098038,Ni; Lei,10,0,10,0
1667956744252,MATH 264B,A00,098041,Rhoades; Brendon Patrick,12,0,15,3
1667956744680,MATH 268,A00,098042,Buss; Samuel R,10,0,10,0
1667956745108,MATH 269,A00,098043,Rhoades; Brendon Patrick,10,0,10,0
1667956745533,MATH 270B,A00,098044,Li; Bo,11,0,15,4
1667956745961,MATH 272B,A00,098045,Holst; Michael J,13,0,15,2
1667956746389,MATH 273A,A00,098046,Tian; Xiaochuan,12,0,15,3
1667956746818,MATH 275,A01,098048,Tian; Xiaochuan,6,0,10,4
1667956747245,MATH 278A,A00,098049,Holst; Michael J,8,0,10,2
1667956747678,MATH 278B,A00,098050,Cloninger; Alexander,10,0,10,0
1667956748101,MATH 278C,A00,098051,Nie; Jiawang,8,0,10,2
1667956748537,MATH 280B,A00,098052,Zheng; Tianyi,12,0,15,3
1667956748960,MATH 281B,A00,098053,Bradic; Jelena,4,0,15,11
1667956749386,MATH 282B,A00,098054,Arias-Castro; Ery,2,0,15,13
1667956749812,MATH 285,A00,098055,Fitzsimmons; Patrick J,0,0,15,17
1667956750246,MATH 287B,A00,098056,Arias-Castro; Ery,5,0,15,10
1667956750672,MATH 288,A00,098057,Agarwal; Pooja,9,0,10,1
1667956750672,MATH 288,B00,098058,Zhang; Danna,9,0,10,1
1667956750672,MATH 288,C00,098059,Williams; Ruth J,10,0,10,0
1667956751104,MATH 290B,A00,098060,Roberts; Justin Deritter,14,0,15,1
1667956751527,MATH 292,A00,098061,Belmont; Eva Kinoshita,10,0,10,0
1667956751958,MATH 295,A00,098062,Suk; Andrew Hoon,48,0,50,2
1667956752382,MATH 296,A00,098063,Novak; Jonathan I,20,0,20,0
1667956752808,MATH 297,001,098064,Gamst; Anthony Collins,9997,0,9999,2
1667957255299,COGS 205,A00,101395,Chiba; Andrea,19,0,20,1
1667957255733,COGS 210B,001,101404,Greene; Deanna Jacquelyn,9998,0,9999,1
1667957255733,COGS 210B,002,101417,Xia; Haijun,9999,0,9999,0
1667957255733,COGS 210B,003,101422,Nitz; Douglas A.,9999,0,9999,0
1667957255733,COGS 210B,004,101423,Hollan; James D.,9998,0,9999,1
1667957255733,COGS 210B,005,101424,Deak; Gedeon O.,9999,0,9999,0
1667957255733,COGS 210B,006,101425,Rossano; Federico,9999,0,9999,0
1667957256163,COGS 211B,A00,101427,Coulson; Seana M,9997,0,9999,2
1667957256588,COGS 220,A00,101428,Hollan; James D.,0,0,25,25
1667957257014,COGS 229,A00,101429,Dow; Steven P,18,0,25,7
1667957257438,COGS 230,A00,101430,Klemmer; Scott R,13,0,17,4
1667957257860,COGS 234,A00,101431,Xia; Haijun,7,0,25,18
1667957258302,COGS 260,A00,101432,Kiyonaga; Anastasia,20,0,25,5
1667957258302,COGS 260,B00,101433,Kirsh; David Joel,16,0,25,9
1667957258743,CSE 202,A00,102371,Impagliazzo; Russell,0,0,0,0
1667957259173,CSE 203B,A01,102373,Cheng; Chung Kuan,0,0,0,0
1667957259597,CSE 208,A00,102374,Micciancio; Daniele,0,0,0,0
1667957260025,CSE 209A,A00,112895,Impagliazzo; Russell,0,0,15,15
1667957260455,CSE 209B,A00,108005,Bellare; Mihir,0,0,0,0
1667957260884,CSE 210,A00,113163,Coblenz; Michael J,0,0,0,0
1667957261339,CSE 219,A00,106111,Dow; Steven P,0,0,20,20
1667957261766,CSE 221,A00,102376,Voelker; Geoffrey M.,0,0,0,0
1667957262193,CSE 224,A01,102378,Porter; George M,0,0,0,0
1667957262619,CSE 229A,A00,102379,Savage; Stefan,0,0,0,0
1667957263040,CSE 229C,A00,102380,Munyaka; Imani N. S.,0,0,0,0
1667957263471,CSE 232B,A00,102382,Deutsch; Alin Bernard,0,0,0,0
1667957263894,CSE 234,A01,112904,Kumar; Arun Kumar,0,0,0,0
1667957264319,CSE 237A,A00,102383,Rosing; Tajana Simunic,0,0,0,0
1667957264745,CSE 239A,A00,102384,Deutsch; Alin Bernard,0,0,0,0
1667957265170,CSE 239B,A00,102385,Polikarpova; Nadezhda,0,0,0,0
1667957265596,CSE 240A,A00,102386,Pannuto; Patrick William,0,0,0,0
1667957266018,CSE 240B,A00,102387,Zhao; Jishen,0,0,0,0
1667957266441,CSE 241A,A00,106406,Kang; Mingu,0,0,0,0
1667957266877,CSE 249B,A00,102388,Kahng; Andrew Byun,0,0,8,8
1667957267305,CSE 251B,A01,102392,Cottrell; Garrison W,0,0,0,0
1667957267305,CSE 251B,A02,102393,Cottrell; Garrison W,0,0,0,0
1667957267728,CSE 252B,A00,102394,Ochoa; Benjamin Lawrence,0,0,0,0
1667957268153,CSE 257,A01,102396,Gao; Sicun,0,0,0,0
1667957268578,CSE 272,A00,102397,Li; Tzumao,0,0,0,0
1667957269004,CSE 274,A00,111323,Chern; Albert Ren-Haur,0,0,0,0
1667957269427,CSE 282,A00,102398,Pevzner; Pavel Arkadjevich,0,0,0,0
1667957269855,CSE 284,A00,114175,Gymrek; Melissa Ann,0,0,0,0
1667957270292,CSE 290,A00,102399,Chandraker; Manmohan Krishna,0,0,0,0
1667957270292,CSE 290,B00,102400,Vaccaro; Kristen Marie,0,0,25,25
1667957270292,CSE 290,C00,102414,Pannuto; Patrick William,0,0,25,25
1667957270292,CSE 290,D00,102427,Pevzner; Pavel Arkadjevich,0,0,0,0
1667957270292,CSE 290,E00,102429,Zhao; Jishen,0,0,0,0
1667957270292,CSE 290,F00,102436,Tullsen; Dean Michael,0,0,0,0
1667957270292,CSE 290,G00,102440,Christensen; Henrik I,0,0,20,20
1667957270722,CSE 291,A00,102443,Su; Hao,0,0,0,0
1667957270722,CSE 291,B00,102448,Polikarpova; Nadezhda,0,0,0,0
1667957270722,CSE 291,C00,102453,Vaccaro; Kristen Marie,0,0,0,0
1667957270722,CSE 291,D00,111343,Savage; Stefan,0,0,0,0
1667957270722,CSE 291,E00,116474,Claffy; Kimberly Claire,0,0,0,0
1667957270722,CSE 291,F00,116479,Pasquale; Joseph,0,0,0,0
1667957271158,CSE 293,001,119111,Bafna; Vineet,9999,0,9999,0
1667957271158,CSE 293,002,119118,Bellare; Mihir,9999,0,9999,0
1667957271158,CSE 293,003,119122,Berg-Kirkpatrick; Taylor D,9999,0,9999,0
1667957271158,CSE 293,004,119135,Christensen; Henrik I,9999,0,9999,0
1667957271158,CSE 293,005,119142,Cottrell; Garrison W,9999,0,9999,0
1667957271158,CSE 293,006,119146,Deutsch; Alin Bernard,9999,0,9999,0
1667957271158,CSE 293,007,119159,Esmaeilzadeh; Hadi,9999,0,9999,0
1667957271158,CSE 293,008,119166,Freund; Yoav,9999,0,9999,0
1667957271158,CSE 293,009,119170,Griswold; William G.,9999,0,9999,0
1667957271158,CSE 293,010,119183,Gymrek; Melissa Ann,9999,0,9999,0
1667957271158,CSE 293,011,119190,Heninger; Nadia A,9999,0,9999,0
1667957271158,CSE 293,012,119230,Impagliazzo; Russell,9999,0,9999,0
1667957271158,CSE 293,013,119232,Jhala; Ranjit,9999,0,9999,0
1667957271158,CSE 293,014,119233,Kahng; Andrew Byun,9999,0,9999,0
1667957271158,CSE 293,015,119298,Kane; Daniel Mertz,9999,0,9999,0
1667957271158,CSE 293,016,119299,Kriegman; David J,9999,0,9999,0
1667957271158,CSE 293,017,119300,Kumar; Arun Kumar,9999,0,9999,0
1667957271158,CSE 293,018,119301,Lerner; Sorin,9999,0,9999,0
1667957271158,CSE 293,019,119302,Lovett; Shachar,9999,0,9999,0
1667957271158,CSE 293,020,119303,McAuley; Julian John,9999,0,9999,0
1667957271158,CSE 293,021,119304,Micciancio; Daniele,9999,0,9999,0
1667957271158,CSE 293,022,119367,Orailoglu; Alex,9999,0,9999,0
1667957271158,CSE 293,023,119382,Paturi; Ramamohan,9999,0,9999,0
1667957271158,CSE 293,024,119404,Polikarpova; Nadezhda,9999,0,9999,0
1667957271158,CSE 293,025,119406,Politz; Joseph Gibbs,9999,0,9999,0
1667957271158,CSE 293,026,119411,Porter; George M,9999,0,9999,0
1667957271158,CSE 293,027,119414,Porter; Leonard Emerson,9999,0,9999,0
1667957271158,CSE 293,028,119416,Ramamoorthi; Ravi,9999,0,9999,0
1667957271158,CSE 293,029,119417,Sahoo; Debashis,9999,0,9999,0
1667957271158,CSE 293,030,119420,Saul; Lawrence,9999,0,9999,0
1667957271158,CSE 293,031,119421,Savage; Stefan,9999,0,9999,0
1667957271158,CSE 293,032,119425,Schulze; Jurgen P.,9999,0,9999,0
1667957271158,CSE 293,033,119426,Snoeren; Alex C.,9999,0,9999,0
1667957271158,CSE 293,034,119428,Shang; Jingbo,9999,0,9999,0
1667957271158,CSE 293,035,119430,Stefan; Deian,9999,0,9999,0
1667957271158,CSE 293,036,119431,Su; Hao,9999,0,9999,0
1667957271158,CSE 293,037,119433,Swanson; Steven James,9999,0,9999,0
1667957271158,CSE 293,038,119435,Tullsen; Dean Michael,9999,0,9999,0
1667957271158,CSE 293,039,119483,Voelker; Geoffrey M.,9999,0,9999,0
1667957271158,CSE 293,040,119537,Zhao; Jishen,9999,0,9999,0
1667957271158,CSE 293,041,119538,Zhou; Yuan-Yuan,9999,0,9999,0
1667957271158,CSE 293,042,119539,Gao; Sicun,9999,0,9999,0
1667957271158,CSE 293,043,119540,Weibel; Nadir,9999,0,9999,0
1667957271158,CSE 293,044,119541,Gupta; Rajesh K.,9999,0,9999,0
1667957271582,CSE 294,A00,102459,Voelker; Geoffrey M.,0,0,0,0
1667957271582,CSE 294,B00,111322,Orailoglu; Alex,0,0,0,0
1667957272005,DSE 201,A00,096914,Deutsch; Alin Bernard,30,0,30,0
1667957272432,DSE 210,A00,096915,Dasgupta; Sanjoy,30,0,30,0
1667957272857,DSE 260A,A00,096916,Altintas De Callaf; Ilkay,30,0,30,0
1667957273302,ECE 200,001,103586,Antipa; Nicholas A,9999,0,9999,0
1667957273302,ECE 200,002,103587,Atanasov; Nikolay A.,9999,0,9999,0
1667957273302,ECE 200,003,103588,Bharadia; Dinesh,9999,0,9999,0
1667957273302,ECE 200,004,103589,Cheng; Chung Kuan,9999,0,9999,0
1667957273302,ECE 200,005,103590,Cosman; Pamela C.,9999,0,9999,0
1667957273302,ECE 200,006,103591,Dayeh; Shadi Ahmad,9999,0,9999,0
1667957273302,ECE 200,007,103592,Fainman; Yeshaiahu,9999,0,9999,0
1667957273302,ECE 200,008,103593,Ford; Joseph Earl,9999,0,9999,0
1667957273302,ECE 200,009,103594,Franceschetti; Massimo,9999,0,9999,0
1667957273302,ECE 200,010,103595,Fullerton; Eric E,9999,0,9999,0
1667957273302,ECE 200,011,103596,Galton; Ian A,9999,0,9999,0
1667957273302,ECE 200,012,103597,Gilja; Vikash,9999,0,9999,0
1667957273302,ECE 200,013,103598,Hall; Drew A.,9999,0,9999,0
1667957273302,ECE 200,014,103599,Hsueh; Tzu-Chien,9999,0,9999,0
1667957273302,ECE 200,015,103600,Javidi; Tara,9999,0,9999,0
1667957273302,ECE 200,016,103601,Kahng; Andrew Byun,9999,0,9999,0
1667957273302,ECE 200,017,103602,Kim; Young-Han,9999,0,9999,0
1667957273302,ECE 200,018,103603,Koushanfar; Farinaz,9999,0,9999,0
1667957273302,ECE 200,019,103604,Kuzum; Duygu,9999,0,9999,0
1667957273302,ECE 200,020,103605,Le; Hanh-Phuc,9999,0,9999,0
1667957273302,ECE 200,021,103606,Lin; Bill,9999,0,9999,0
1667957273302,ECE 200,022,103607,Liu; Zhaowei,9998,0,9999,1
1667957273302,ECE 200,023,103608,Lo; Yu-Hwa,9999,0,9999,0
1667957273302,ECE 200,024,103609,Lomakin; Vitaliy,9999,0,9999,0
1667957273302,ECE 200,025,103610,Mercier; Patrick Philip,9999,0,9999,0
1667957273302,ECE 200,026,103611,Meyer; Florian,9999,0,9999,0
1667957273302,ECE 200,027,103612,Milstein; Laurence B.,9999,0,9999,0
1667957273302,ECE 200,028,103613,Mir Arabbaygi; Siavash,9999,0,9999,0
1667957273302,ECE 200,029,103614,Mookherjea; Shayan,9999,0,9999,0
1667957273302,ECE 200,030,103615,Morris; Karcher William,9999,0,9999,0
1667957273302,ECE 200,031,103616,Ng; Tse Nga,9999,0,9999,0
1667957273302,ECE 200,032,103617,Nguyen; Truong Quang,9999,0,9999,0
1667957273302,ECE 200,033,103618,Nomura; Kenji,9999,0,9999,0
1667957273302,ECE 200,034,103619,Orlitsky; Alon,9999,0,9999,0
1667957273302,ECE 200,035,103620,Pal; Piya,9999,0,9999,0
1667957273302,ECE 200,036,103621,Papen; George C.,9999,0,9999,0
1667957273302,ECE 200,037,103622,Radic; Stojan,9999,0,9999,0
1667957273302,ECE 200,038,103623,Rao; Bhaskar D.,9999,0,9999,0
1667957273302,ECE 200,039,103624,Rao; Ramesh R,9999,0,9999,0
1667957273302,ECE 200,040,103625,Rebeiz; Gabriel,9999,0,9999,0
1667957273302,ECE 200,041,103626,Sanford; John R,9999,0,9999,0
1667957273302,ECE 200,042,103627,Siegel; Paul H.,9999,0,9999,0
1667957273302,ECE 200,043,103628,Sievenpiper; Daniel F.,9999,0,9999,0
1667957273302,ECE 200,044,103629,Sworder; David D.,9999,0,9999,0
1667957273302,ECE 200,045,103630,Taur; Yuan,9999,0,9999,0
1667957273302,ECE 200,046,103631,Touri; Behrouz,9999,0,9999,0
1667957273302,ECE 200,047,103632,Trivedi; Mohan M.,9999,0,9999,0
1667957273302,ECE 200,048,103633,Vasconcelos; Nuno,9999,0,9999,0
1667957273302,ECE 200,049,103634,Wang; Xiaolong,9999,0,9999,0
1667957273302,ECE 200,050,103635,Xie; Pengtao,9999,0,9999,0
1667957273302,ECE 200,051,103636,Yip; Michael,9999,0,9999,0
1667957273302,ECE 200,052,103637,Zeger; Kenneth A.,999,0,999,0
1667957273302,ECE 200,053,103638,Zhang; Xinyu,9999,0,9999,0
1667957273302,ECE 200,054,103639,Turakhia; Yatish Girish,9999,0,9999,0
1667957273302,ECE 200,055,103640,Kang; Mingu,9999,0,9999,0
1667957273302,ECE 200,056,103641,Shi; Yuanyuan,9999,0,9999,0
1667957273302,ECE 200,057,103642,Wang; Edward Jay,9999,0,9999,0
1667957273302,ECE 200,058,103643,Zheng; Yang,9999,0,9999,0
1667957273728,ECE 202,A00,103644,Kuzum; Duygu,0,0,0,0
1667957274154,ECE 212BN,A00,103646,Ng; Tse Nga,0,0,0,0
1667957274578,ECE 221,A00,111493,Staff,0,0,0,0
1667957275002,ECE 222B,A00,103647,Lomakin; Vitaliy,0,0,0,0
1667957275425,ECE 230B,A00,103648,Taur; Yuan,0,0,0,0
1667957275849,ECE 238B,A00,103649,Garay; Javier,0,0,0,0
1667957276275,ECE 240B,A00,112900,Fainman; Yeshaiahu,0,0,0,0
1667957276709,ECE 247A,A00,103650,Jokerst; Jesse Vincent,0,0,0,0
1667957277133,ECE 247B,A00,103651,Wang; Joseph,0,0,0,0
1667957277647,ECE 250,A00,103652,Siegel; Paul H.,0,0,0,0
1667957278083,ECE 251A,A00,103654,Rao; Bhaskar D.,0,0,0,0
1667957278507,ECE 257B,A00,103655,Bharadia; Dinesh,0,0,0,0
1667957278934,ECE 258A,A00,103656,Milstein; Laurence B.,0,0,0,0
1667957279358,ECE 260B,A00,103658,Kang; Mingu,0,0,0,0
1667957279783,ECE 264A,A00,103659,Galton; Ian A,0,0,0,0
1667957280211,ECE 265A,A00,103661,Gudem; Prasad S.S.,0,0,0,0
1667957280633,ECE 265D,A00,103662,Gudem; Prasad S.S.,0,0,0,0
1667957281057,ECE 268,A00,103663,Koushanfar; Farinaz,0,0,0,0
1667957281486,ECE 269,A01,103665,Pal; Piya,0,0,0,0
1667957281910,ECE 271B,A00,103666,Vasconcelos; Manuela,0,0,0,0
1667957282338,ECE 276A,A00,103667,Atanasov; Nikolay A.,0,0,0,0
1667957282762,ECE 277,A00,103668,An; Cheolhong,0,0,0,0
1667957283185,ECE 279,A00,117947,Hall; Drew A.,0,0,0,0
1667957284051,ECE 283,A00,103670,Hsueh; Tzu-Chien,0,0,0,0
1667957284479,ECE 284,A00,103671,Turakhia; Yatish Girish,0,0,0,0
1667957284903,ECE 285,A00,103672,Zheng; Yang,0,0,0,0
1667957284903,ECE 285,B00,103673,Sworder; David D.,0,0,0,0
1667957285327,ECE 287,A00,103676,Javidi; Tara,0,0,0,0
1667957285751,MATH 200B,A00,098023,Salehi Golsefidy; Alireza,14,0,15,1
1667957286179,MATH 202B,A00,098024,Rhoades; Brendon Patrick,12,0,15,3
1667957286608,MATH 203B,A00,098025,Oprea; Dragos N.,13,0,15,2
1667957287033,MATH 204B,A00,098026,Sorensen; Claus M,15,0,15,0
1667957287457,MATH 208,A00,098027,Izadi; Elham,7,0,10,3
1667957287882,MATH 209,A00,098028,Pollack; Aaron,10,0,10,0
1667957288313,MATH 211A,A00,112919,Rogalski; Daniel,9,0,10,1
1667957288739,MATH 211B,A00,112920,Seward; Brandon M.,9,0,10,1
1667957289162,MATH 218,A00,098029,Li; Bo,10,0,10,0
1667957289592,MATH 220B,A00,098030,Novak; Jonathan I,13,0,15,2
1667957290033,MATH 221A,A00,098031,Ebenfelt; Peter F,13,0,15,2
1667957290464,MATH 231B,A00,098032,Zlatos; Andrej,12,0,15,3
1667957290887,MATH 240B,A00,098033,Ni; Lei,10,0,15,5
1667957291312,MATH 243,A00,098034,Jekel; David Andrew,10,0,10,0
1667957291736,MATH 245A,A00,098035,Nie; Jiawang,0,0,15,16
1667957292161,MATH 248,A00,098036,Bejenaru; Ioan,10,0,10,0
1667957292588,MATH 250B,A00,098037,Spolaor; Luca,14,0,15,1
1667957293028,MATH 258,A00,098038,Ni; Lei,10,0,10,0
1667957293454,MATH 264B,A00,098041,Rhoades; Brendon Patrick,12,0,15,3
1667957293881,MATH 268,A00,098042,Buss; Samuel R,10,0,10,0
1667957294312,MATH 269,A00,098043,Rhoades; Brendon Patrick,10,0,10,0
1667957294738,MATH 270B,A00,098044,Li; Bo,11,0,15,4
1667957295168,MATH 272B,A00,098045,Holst; Michael J,13,0,15,2
1667957295594,MATH 273A,A00,098046,Tian; Xiaochuan,12,0,15,3
1667957296020,MATH 275,A01,098048,Tian; Xiaochuan,6,0,10,4
1667957296443,MATH 278A,A00,098049,Holst; Michael J,8,0,10,2
1667957296870,MATH 278B,A00,098050,Cloninger; Alexander,10,0,10,0
1667957297292,MATH 278C,A00,098051,Nie; Jiawang,8,0,10,2
1667957297720,MATH 280B,A00,098052,Zheng; Tianyi,12,0,15,3
1667957298146,MATH 281B,A00,098053,Bradic; Jelena,4,0,15,11
1667957298570,MATH 282B,A00,098054,Arias-Castro; Ery,2,0,15,13
1667957298996,MATH 285,A00,098055,Fitzsimmons; Patrick J,0,0,15,17
1667957299423,MATH 287B,A00,098056,Arias-Castro; Ery,5,0,15,10
1667957299847,MATH 288,A00,098057,Agarwal; Pooja,9,0,10,1
1667957299847,MATH 288,B00,098058,Zhang; Danna,9,0,10,1
1667957299847,MATH 288,C00,098059,Williams; Ruth J,10,0,10,0
1667957300271,MATH 290B,A00,098060,Roberts; Justin Deritter,14,0,15,1
1667957300701,MATH 292,A00,098061,Belmont; Eva Kinoshita,10,0,10,0
1667957301130,MATH 295,A00,098062,Suk; Andrew Hoon,48,0,50,2
1667957301557,MATH 296,A00,098063,Novak; Jonathan I,20,0,20,0
1667957301982,MATH 297,001,098064,Gamst; Anthony Collins,9997,0,9999,2
1667957815125,COGS 205,A00,101395,Chiba; Andrea,19,0,20,1
1667957815556,COGS 210B,001,101404,Greene; Deanna Jacquelyn,9998,0,9999,1
1667957815556,COGS 210B,002,101417,Xia; Haijun,9999,0,9999,0
1667957815556,COGS 210B,003,101422,Nitz; Douglas A.,9999,0,9999,0
1667957815556,COGS 210B,004,101423,Hollan; James D.,9998,0,9999,1
1667957815556,COGS 210B,005,101424,Deak; Gedeon O.,9999,0,9999,0
1667957815556,COGS 210B,006,101425,Rossano; Federico,9999,0,9999,0
1667957815985,COGS 211B,A00,101427,Coulson; Seana M,9997,0,9999,2
1667957816409,COGS 220,A00,101428,Hollan; James D.,0,0,25,25
1667957816831,COGS 229,A00,101429,Dow; Steven P,18,0,25,7
1667957817257,COGS 230,A00,101430,Klemmer; Scott R,13,0,17,4
1667957817681,COGS 234,A00,101431,Xia; Haijun,7,0,25,18
1667957818106,COGS 260,A00,101432,Kiyonaga; Anastasia,20,0,25,5
1667957818106,COGS 260,B00,101433,Kirsh; David Joel,16,0,25,9
1667957818533,CSE 202,A00,102371,Impagliazzo; Russell,0,0,0,0
1667957818958,CSE 203B,A01,102373,Cheng; Chung Kuan,0,0,0,0
1667957819393,CSE 208,A00,102374,Micciancio; Daniele,0,0,0,0
1667957819818,CSE 209A,A00,112895,Impagliazzo; Russell,0,0,15,15
1667957820241,CSE 209B,A00,108005,Bellare; Mihir,0,0,0,0
1667957820665,CSE 210,A00,113163,Coblenz; Michael J,0,0,0,0
1667957821089,CSE 219,A00,106111,Dow; Steven P,0,0,20,20
1667957821514,CSE 221,A00,102376,Voelker; Geoffrey M.,0,0,0,0
1667957821944,CSE 224,A01,102378,Porter; George M,0,0,0,0
1667957822378,CSE 229A,A00,102379,Savage; Stefan,0,0,0,0
1667957822802,CSE 229C,A00,102380,Munyaka; Imani N. S.,0,0,0,0
1667957823226,CSE 232B,A00,102382,Deutsch; Alin Bernard,0,0,0,0
1667957823651,CSE 234,A01,112904,Kumar; Arun Kumar,0,0,0,0
1667957824080,CSE 237A,A00,102383,Rosing; Tajana Simunic,0,0,0,0
1667957824506,CSE 239A,A00,102384,Deutsch; Alin Bernard,0,0,0,0
1667957824939,CSE 239B,A00,102385,Polikarpova; Nadezhda,0,0,0,0
1667957825365,CSE 240A,A00,102386,Pannuto; Patrick William,0,0,0,0
1667957825790,CSE 240B,A00,102387,Zhao; Jishen,0,0,0,0
1667957826211,CSE 241A,A00,106406,Kang; Mingu,0,0,0,0
1667957826634,CSE 249B,A00,102388,Kahng; Andrew Byun,0,0,8,8
1667957827070,CSE 251B,A01,102392,Cottrell; Garrison W,0,0,0,0
1667957827070,CSE 251B,A02,102393,Cottrell; Garrison W,0,0,0,0
1667957827499,CSE 252B,A00,102394,Ochoa; Benjamin Lawrence,0,0,0,0
1667957827922,CSE 257,A01,102396,Gao; Sicun,0,0,0,0
1667957828347,CSE 272,A00,102397,Li; Tzumao,0,0,0,0
1667957828770,CSE 274,A00,111323,Chern; Albert Ren-Haur,0,0,0,0
1667957829192,CSE 282,A00,102398,Pevzner; Pavel Arkadjevich,0,0,0,0
1667957829617,CSE 284,A00,114175,Gymrek; Melissa Ann,0,0,0,0
1667957830045,CSE 290,A00,102399,Chandraker; Manmohan Krishna,0,0,0,0
1667957830045,CSE 290,B00,102400,Vaccaro; Kristen Marie,0,0,25,25
1667957830045,CSE 290,C00,102414,Pannuto; Patrick William,0,0,25,25
1667957830045,CSE 290,D00,102427,Pevzner; Pavel Arkadjevich,0,0,0,0
1667957830045,CSE 290,E00,102429,Zhao; Jishen,0,0,0,0
1667957830045,CSE 290,F00,102436,Tullsen; Dean Michael,0,0,0,0
1667957830045,CSE 290,G00,102440,Christensen; Henrik I,0,0,20,20
1667957830477,CSE 291,A00,102443,Su; Hao,0,0,0,0
1667957830477,CSE 291,B00,102448,Polikarpova; Nadezhda,0,0,0,0
1667957830477,CSE 291,C00,102453,Vaccaro; Kristen Marie,0,0,0,0
1667957830477,CSE 291,D00,111343,Savage; Stefan,0,0,0,0
1667957830477,CSE 291,E00,116474,Claffy; Kimberly Claire,0,0,0,0
1667957830477,CSE 291,F00,116479,Pasquale; Joseph,0,0,0,0
1667957830906,CSE 293,001,119111,Bafna; Vineet,9999,0,9999,0
1667957830906,CSE 293,002,119118,Bellare; Mihir,9999,0,9999,0
1667957830906,CSE 293,003,119122,Berg-Kirkpatrick; Taylor D,9999,0,9999,0
1667957830906,CSE 293,004,119135,Christensen; Henrik I,9999,0,9999,0
1667957830906,CSE 293,005,119142,Cottrell; Garrison W,9999,0,9999,0
1667957830906,CSE 293,006,119146,Deutsch; Alin Bernard,9999,0,9999,0
1667957830906,CSE 293,007,119159,Esmaeilzadeh; Hadi,9999,0,9999,0
1667957830906,CSE 293,008,119166,Freund; Yoav,9999,0,9999,0
1667957830906,CSE 293,009,119170,Griswold; William G.,9999,0,9999,0
1667957830906,CSE 293,010,119183,Gymrek; Melissa Ann,9999,0,9999,0
1667957830906,CSE 293,011,119190,Heninger; Nadia A,9999,0,9999,0
1667957830906,CSE 293,012,119230,Impagliazzo; Russell,9999,0,9999,0
1667957830906,CSE 293,013,119232,Jhala; Ranjit,9999,0,9999,0
1667957830906,CSE 293,014,119233,Kahng; Andrew Byun,9999,0,9999,0
1667957830906,CSE 293,015,119298,Kane; Daniel Mertz,9999,0,9999,0
1667957830906,CSE 293,016,119299,Kriegman; David J,9999,0,9999,0
1667957830906,CSE 293,017,119300,Kumar; Arun Kumar,9999,0,9999,0
1667957830906,CSE 293,018,119301,Lerner; Sorin,9999,0,9999,0
1667957830906,CSE 293,019,119302,Lovett; Shachar,9999,0,9999,0
1667957830906,CSE 293,020,119303,McAuley; Julian John,9999,0,9999,0
1667957830906,CSE 293,021,119304,Micciancio; Daniele,9999,0,9999,0
1667957830906,CSE 293,022,119367,Orailoglu; Alex,9999,0,9999,0
1667957830906,CSE 293,023,119382,Paturi; Ramamohan,9999,0,9999,0
1667957830906,CSE 293,024,119404,Polikarpova; Nadezhda,9999,0,9999,0
1667957830906,CSE 293,025,119406,Politz; Joseph Gibbs,9999,0,9999,0
1667957830906,CSE 293,026,119411,Porter; George M,9999,0,9999,0
1667957830906,CSE 293,027,119414,Porter; Leonard Emerson,9999,0,9999,0
1667957830906,CSE 293,028,119416,Ramamoorthi; Ravi,9999,0,9999,0
1667957830906,CSE 293,029,119417,Sahoo; Debashis,9999,0,9999,0
1667957830906,CSE 293,030,119420,Saul; Lawrence,9999,0,9999,0
1667957830906,CSE 293,031,119421,Savage; Stefan,9999,0,9999,0
1667957830906,CSE 293,032,119425,Schulze; Jurgen P.,9999,0,9999,0
1667957830906,CSE 293,033,119426,Snoeren; Alex C.,9999,0,9999,0
1667957830906,CSE 293,034,119428,Shang; Jingbo,9999,0,9999,0
1667957830906,CSE 293,035,119430,Stefan; Deian,9999,0,9999,0
1667957830906,CSE 293,036,119431,Su; Hao,9999,0,9999,0
1667957830906,CSE 293,037,119433,Swanson; Steven James,9999,0,9999,0
1667957830906,CSE 293,038,119435,Tullsen; Dean Michael,9999,0,9999,0
1667957830906,CSE 293,039,119483,Voelker; Geoffrey M.,9999,0,9999,0
1667957830906,CSE 293,040,119537,Zhao; Jishen,9999,0,9999,0
1667957830906,CSE 293,041,119538,Zhou; Yuan-Yuan,9999,0,9999,0
1667957830906,CSE 293,042,119539,Gao; Sicun,9999,0,9999,0
1667957830906,CSE 293,043,119540,Weibel; Nadir,9999,0,9999,0
1667957830906,CSE 293,044,119541,Gupta; Rajesh K.,9999,0,9999,0
1667957831333,CSE 294,A00,102459,Voelker; Geoffrey M.,0,0,0,0
1667957831333,CSE 294,B00,111322,Orailoglu; Alex,0,0,0,0
1667957831766,DSE 201,A00,096914,Deutsch; Alin Bernard,30,0,30,0
1667957832194,DSE 210,A00,096915,Dasgupta; Sanjoy,30,0,30,0
1667957832620,DSE 260A,A00,096916,Altintas De Callaf; Ilkay,30,0,30,0
1667957833240,ECE 200,001,103586,Antipa; Nicholas A,9999,0,9999,0
1667957833240,ECE 200,002,103587,Atanasov; Nikolay A.,9999,0,9999,0
1667957833240,ECE 200,003,103588,Bharadia; Dinesh,9999,0,9999,0
1667957833240,ECE 200,004,103589,Cheng; Chung Kuan,9999,0,9999,0
1667957833240,ECE 200,005,103590,Cosman; Pamela C.,9999,0,9999,0
1667957833240,ECE 200,006,103591,Dayeh; Shadi Ahmad,9999,0,9999,0
1667957833240,ECE 200,007,103592,Fainman; Yeshaiahu,9999,0,9999,0
1667957833240,ECE 200,008,103593,Ford; Joseph Earl,9999,0,9999,0
1667957833240,ECE 200,009,103594,Franceschetti; Massimo,9999,0,9999,0
1667957833240,ECE 200,010,103595,Fullerton; Eric E,9999,0,9999,0
1667957833240,ECE 200,011,103596,Galton; Ian A,9999,0,9999,0
1667957833240,ECE 200,012,103597,Gilja; Vikash,9999,0,9999,0
1667957833240,ECE 200,013,103598,Hall; Drew A.,9999,0,9999,0
1667957833240,ECE 200,014,103599,Hsueh; Tzu-Chien,9999,0,9999,0
1667957833240,ECE 200,015,103600,Javidi; Tara,9999,0,9999,0
1667957833240,ECE 200,016,103601,Kahng; Andrew Byun,9999,0,9999,0
1667957833240,ECE 200,017,103602,Kim; Young-Han,9999,0,9999,0
1667957833240,ECE 200,018,103603,Koushanfar; Farinaz,9999,0,9999,0
1667957833240,ECE 200,019,103604,Kuzum; Duygu,9999,0,9999,0
1667957833240,ECE 200,020,103605,Le; Hanh-Phuc,9999,0,9999,0
1667957833240,ECE 200,021,103606,Lin; Bill,9999,0,9999,0
1667957833240,ECE 200,022,103607,Liu; Zhaowei,9998,0,9999,1
1667957833240,ECE 200,023,103608,Lo; Yu-Hwa,9999,0,9999,0
1667957833240,ECE 200,024,103609,Lomakin; Vitaliy,9999,0,9999,0
1667957833240,ECE 200,025,103610,Mercier; Patrick Philip,9999,0,9999,0
1667957833240,ECE 200,026,103611,Meyer; Florian,9999,0,9999,0
1667957833240,ECE 200,027,103612,Milstein; Laurence B.,9999,0,9999,0
1667957833240,ECE 200,028,103613,Mir Arabbaygi; Siavash,9999,0,9999,0
1667957833240,ECE 200,029,103614,Mookherjea; Shayan,9999,0,9999,0
1667957833240,ECE 200,030,103615,Morris; Karcher William,9999,0,9999,0
1667957833240,ECE 200,031,103616,Ng; Tse Nga,9999,0,9999,0
1667957833240,ECE 200,032,103617,Nguyen; Truong Quang,9999,0,9999,0
1667957833240,ECE 200,033,103618,Nomura; Kenji,9999,0,9999,0
1667957833240,ECE 200,034,103619,Orlitsky; Alon,9999,0,9999,0
1667957833240,ECE 200,035,103620,Pal; Piya,9999,0,9999,0
1667957833240,ECE 200,036,103621,Papen; George C.,9999,0,9999,0
1667957833240,ECE 200,037,103622,Radic; Stojan,9999,0,9999,0
1667957833240,ECE 200,038,103623,Rao; Bhaskar D.,9999,0,9999,0
1667957833240,ECE 200,039,103624,Rao; Ramesh R,9999,0,9999,0
1667957833240,ECE 200,040,103625,Rebeiz; Gabriel,9999,0,9999,0
1667957833240,ECE 200,041,103626,Sanford; John R,9999,0,9999,0
1667957833240,ECE 200,042,103627,Siegel; Paul H.,9999,0,9999,0
1667957833240,ECE 200,043,103628,Sievenpiper; Daniel F.,9999,0,9999,0
1667957833240,ECE 200,044,103629,Sworder; David D.,9999,0,9999,0
1667957833240,ECE 200,045,103630,Taur; Yuan,9999,0,9999,0
1667957833240,ECE 200,046,103631,Touri; Behrouz,9999,0,9999,0
1667957833240,ECE 200,047,103632,Trivedi; Mohan M.,9999,0,9999,0
1667957833240,ECE 200,048,103633,Vasconcelos; Nuno,9999,0,9999,0
1667957833240,ECE 200,049,103634,Wang; Xiaolong,9999,0,9999,0
1667957833240,ECE 200,050,103635,Xie; Pengtao,9999,0,9999,0
1667957833240,ECE 200,051,103636,Yip; Michael,9999,0,9999,0
1667957833240,ECE 200,052,103637,Zeger; Kenneth A.,999,0,999,0
1667957833240,ECE 200,053,103638,Zhang; Xinyu,9999,0,9999,0
1667957833240,ECE 200,054,103639,Turakhia; Yatish Girish,9999,0,9999,0
1667957833240,ECE 200,055,103640,Kang; Mingu,9999,0,9999,0
1667957833240,ECE 200,056,103641,Shi; Yuanyuan,9999,0,9999,0
1667957833240,ECE 200,057,103642,Wang; Edward Jay,9999,0,9999,0
1667957833240,ECE 200,058,103643,Zheng; Yang,9999,0,9999,0
1667957833662,ECE 202,A00,103644,Kuzum; Duygu,0,0,0,0
1667957834096,ECE 212BN,A00,103646,Ng; Tse Nga,0,0,0,0
1667957834523,ECE 221,A00,111493,Staff,0,0,0,0
1667957834950,ECE 222B,A00,103647,Lomakin; Vitaliy,0,0,0,0
1667957835372,ECE 230B,A00,103648,Taur; Yuan,0,0,0,0
1667957835799,ECE 238B,A00,103649,Garay; Javier,0,0,0,0
1667957836226,ECE 240B,A00,112900,Fainman; Yeshaiahu,0,0,0,0
1667957836655,ECE 247A,A00,103650,Jokerst; Jesse Vincent,0,0,0,0
1667957837080,ECE 247B,A00,103651,Wang; Joseph,0,0,0,0
1667957837510,ECE 250,A00,103652,Siegel; Paul H.,0,0,0,0
1667957837939,ECE 251A,A00,103654,Rao; Bhaskar D.,0,0,0,0
1667957838362,ECE 257B,A00,103655,Bharadia; Dinesh,0,0,0,0
1667957838797,ECE 258A,A00,103656,Milstein; Laurence B.,0,0,0,0
1667957839228,ECE 260B,A00,103658,Kang; Mingu,0,0,0,0
1667957839655,ECE 264A,A00,103659,Galton; Ian A,0,0,0,0
1667957840084,ECE 265A,A00,103661,Gudem; Prasad S.S.,0,0,0,0
1667957840514,ECE 265D,A00,103662,Gudem; Prasad S.S.,0,0,0,0
1667957840942,ECE 268,A00,103663,Koushanfar; Farinaz,0,0,0,0
1667957841374,ECE 269,A01,103665,Pal; Piya,0,0,0,0
1667957841811,ECE 271B,A00,103666,Vasconcelos; Manuela,0,0,0,0
1667957842234,ECE 276A,A00,103667,Atanasov; Nikolay A.,0,0,0,0
1667957842663,ECE 277,A00,103668,An; Cheolhong,0,0,0,0
1667957843086,ECE 279,A00,117947,Hall; Drew A.,0,0,0,0
1667957843936,ECE 283,A00,103670,Hsueh; Tzu-Chien,0,0,0,0
1667957844365,ECE 284,A00,103671,Turakhia; Yatish Girish,0,0,0,0
1667957844787,ECE 285,A00,103672,Zheng; Yang,0,0,0,0
1667957844787,ECE 285,B00,103673,Sworder; David D.,0,0,0,0
1667957845214,ECE 287,A00,103676,Javidi; Tara,0,0,0,0
1667957845646,MATH 200B,A00,098023,Salehi Golsefidy; Alireza,14,0,15,1
1667957846074,MATH 202B,A00,098024,Rhoades; Brendon Patrick,12,0,15,3
1667957846499,MATH 203B,A00,098025,Oprea; Dragos N.,13,0,15,2
1667957846927,MATH 204B,A00,098026,Sorensen; Claus M,15,0,15,0
1667957847353,MATH 208,A00,098027,Izadi; Elham,7,0,10,3
1667957847777,MATH 209,A00,098028,Pollack; Aaron,10,0,10,0
1667957848204,MATH 211A,A00,112919,Rogalski; Daniel,9,0,10,1
1667957848627,MATH 211B,A00,112920,Seward; Brandon M.,9,0,10,1
1667957849060,MATH 218,A00,098029,Li; Bo,10,0,10,0
1667957849507,MATH 220B,A00,098030,Novak; Jonathan I,13,0,15,2
1667957849942,MATH 221A,A00,098031,Ebenfelt; Peter F,13,0,15,2
1667957850367,MATH 231B,A00,098032,Zlatos; Andrej,12,0,15,3
1667957850794,MATH 240B,A00,098033,Ni; Lei,10,0,15,5
1667957851220,MATH 243,A00,098034,Jekel; David Andrew,10,0,10,0
1667957851645,MATH 245A,A00,098035,Nie; Jiawang,0,0,15,16
1667957852070,MATH 248,A00,098036,Bejenaru; Ioan,10,0,10,0
1667957852506,MATH 250B,A00,098037,Spolaor; Luca,14,0,15,1
1667957852941,MATH 258,A00,098038,Ni; Lei,10,0,10,0
1667957853366,MATH 264B,A00,098041,Rhoades; Brendon Patrick,12,0,15,3
1667957853800,MATH 268,A00,098042,Buss; Samuel R,10,0,10,0
1667957854316,MATH 269,A00,098043,Rhoades; Brendon Patrick,10,0,10,0
1667957854758,MATH 270B,A00,098044,Li; Bo,11,0,15,4
1667957855184,MATH 272B,A00,098045,Holst; Michael J,13,0,15,2
1667957855608,MATH 273A,A00,098046,Tian; Xiaochuan,12,0,15,3
1667957856031,MATH 275,A01,098048,Tian; Xiaochuan,6,0,10,4
1667957856457,MATH 278A,A00,098049,Holst; Michael J,8,0,10,2
1667957856880,MATH 278B,A00,098050,Cloninger; Alexander,10,0,10,0
1667957857310,MATH 278C,A00,098051,Nie; Jiawang,8,0,10,2
1667957857735,MATH 280B,A00,098052,Zheng; Tianyi,12,0,15,3
1667957858168,MATH 281B,A00,098053,Bradic; Jelena,4,0,15,11
1667957858601,MATH 282B,A00,098054,Arias-Castro; Ery,2,0,15,13
1667957859025,MATH 285,A00,098055,Fitzsimmons; Patrick J,0,0,15,17
1667957859449,MATH 287B,A00,098056,Arias-Castro; Ery,5,0,15,10
1667957859877,MATH 288,A00,098057,Agarwal; Pooja,9,0,10,1
1667957859877,MATH 288,B00,098058,Zhang; Danna,9,0,10,1
1667957859877,MATH 288,C00,098059,Williams; Ruth J,10,0,10,0
1667957860302,MATH 290B,A00,098060,Roberts; Justin Deritter,14,0,15,1
1667957860728,MATH 292,A00,098061,Belmont; Eva Kinoshita,10,0,10,0
1667957861163,MATH 295,A00,098062,Suk; Andrew Hoon,48,0,50,2
1667957861595,MATH 296,A00,098063,Novak; Jonathan I,20,0,20,0
1667957862038,MATH 297,001,098064,Gamst; Anthony Collins,9997,0,9999,2
1667958363512,COGS 205,A00,101395,Chiba; Andrea,19,0,20,1
1667958363944,COGS 210B,001,101404,Greene; Deanna Jacquelyn,9998,0,9999,1
1667958363944,COGS 210B,002,101417,Xia; Haijun,9999,0,9999,0
1667958363944,COGS 210B,003,101422,Nitz; Douglas A.,9999,0,9999,0
1667958363944,COGS 210B,004,101423,Hollan; James D.,9998,0,9999,1
1667958363944,COGS 210B,005,101424,Deak; Gedeon O.,9999,0,9999,0
1667958363944,COGS 210B,006,101425,Rossano; Federico,9999,0,9999,0
1667958364372,COGS 211B,A00,101427,Coulson; Seana M,9997,0,9999,2
1667958364798,COGS 220,A00,101428,Hollan; James D.,0,0,25,25
1667958365225,COGS 229,A00,101429,Dow; Steven P,18,0,25,7
1667958365649,COGS 230,A00,101430,Klemmer; Scott R,13,0,17,4
1667958366079,COGS 234,A00,101431,Xia; Haijun,7,0,25,18
1667958366505,COGS 260,A00,101432,Kiyonaga; Anastasia,20,0,25,5
1667958366505,COGS 260,B00,101433,Kirsh; David Joel,16,0,25,9
1667958366936,CSE 202,A00,102371,Impagliazzo; Russell,0,0,0,0
1667958367360,CSE 203B,A01,102373,Cheng; Chung Kuan,0,0,0,0
1667958367801,CSE 208,A00,102374,Micciancio; Daniele,0,0,0,0
1667958368241,CSE 209A,A00,112895,Impagliazzo; Russell,0,0,15,15
1667958368663,CSE 209B,A00,108005,Bellare; Mihir,0,0,0,0
1667958369087,CSE 210,A00,113163,Coblenz; Michael J,0,0,0,0
1667958369514,CSE 219,A00,106111,Dow; Steven P,0,0,20,20
1667958369939,CSE 221,A00,102376,Voelker; Geoffrey M.,0,0,0,0
1667958370365,CSE 224,A01,102378,Porter; George M,0,0,0,0
1667958370795,CSE 229A,A00,102379,Savage; Stefan,0,0,0,0
1667958371222,CSE 229C,A00,102380,Munyaka; Imani N. S.,0,0,0,0
1667958371644,CSE 232B,A00,102382,Deutsch; Alin Bernard,0,0,0,0
1667958372072,CSE 234,A01,112904,Kumar; Arun Kumar,0,0,0,0
1667958372504,CSE 237A,A00,102383,Rosing; Tajana Simunic,0,0,0,0
1667958372948,CSE 239A,A00,102384,Deutsch; Alin Bernard,0,0,0,0
1667958373371,CSE 239B,A00,102385,Polikarpova; Nadezhda,0,0,0,0
1667958373797,CSE 240A,A00,102386,Pannuto; Patrick William,0,0,0,0
1667958374222,CSE 240B,A00,102387,Zhao; Jishen,0,0,0,0
1667958374648,CSE 241A,A00,106406,Kang; Mingu,0,0,0,0
1667958375077,CSE 249B,A00,102388,Kahng; Andrew Byun,0,0,8,8
1667958375514,CSE 251B,A01,102392,Cottrell; Garrison W,0,0,0,0
1667958375514,CSE 251B,A02,102393,Cottrell; Garrison W,0,0,0,0
1667958376040,CSE 252B,A00,102394,Ochoa; Benjamin Lawrence,0,0,0,0
1667958376462,CSE 257,A01,102396,Gao; Sicun,0,0,0,0
1667958376901,CSE 272,A00,102397,Li; Tzumao,0,0,0,0
1667958377324,CSE 274,A00,111323,Chern; Albert Ren-Haur,0,0,0,0
1667958377756,CSE 282,A00,102398,Pevzner; Pavel Arkadjevich,0,0,0,0
1667958378181,CSE 284,A00,114175,Gymrek; Melissa Ann,0,0,0,0
1667958378611,CSE 290,A00,102399,Chandraker; Manmohan Krishna,0,0,0,0
1667958378611,CSE 290,B00,102400,Vaccaro; Kristen Marie,0,0,25,25
1667958378611,CSE 290,C00,102414,Pannuto; Patrick William,0,0,25,25
1667958378611,CSE 290,D00,102427,Pevzner; Pavel Arkadjevich,0,0,0,0
1667958378611,CSE 290,E00,102429,Zhao; Jishen,0,0,0,0
1667958378611,CSE 290,F00,102436,Tullsen; Dean Michael,0,0,0,0
1667958378611,CSE 290,G00,102440,Christensen; Henrik I,0,0,20,20
1667958379036,CSE 291,A00,102443,Su; Hao,0,0,0,0
1667958379036,CSE 291,B00,102448,Polikarpova; Nadezhda,0,0,0,0
1667958379036,CSE 291,C00,102453,Vaccaro; Kristen Marie,0,0,0,0
1667958379036,CSE 291,D00,111343,Savage; Stefan,0,0,0,0
1667958379036,CSE 291,E00,116474,Claffy; Kimberly Claire,0,0,0,0
1667958379036,CSE 291,F00,116479,Pasquale; Joseph,0,0,0,0
1667958379476,CSE 293,001,119111,Bafna; Vineet,9999,0,9999,0
1667958379476,CSE 293,002,119118,Bellare; Mihir,9999,0,9999,0
1667958379476,CSE 293,003,119122,Berg-Kirkpatrick; Taylor D,9999,0,9999,0
1667958379476,CSE 293,004,119135,Christensen; Henrik I,9999,0,9999,0
1667958379476,CSE 293,005,119142,Cottrell; Garrison W,9999,0,9999,0
1667958379476,CSE 293,006,119146,Deutsch; Alin Bernard,9999,0,9999,0
1667958379476,CSE 293,007,119159,Esmaeilzadeh; Hadi,9999,0,9999,0
1667958379476,CSE 293,008,119166,Freund; Yoav,9999,0,9999,0
1667958379476,CSE 293,009,119170,Griswold; William G.,9999,0,9999,0
1667958379476,CSE 293,010,119183,Gymrek; Melissa Ann,9999,0,9999,0
1667958379476,CSE 293,011,119190,Heninger; Nadia A,9999,0,9999,0
1667958379476,CSE 293,012,119230,Impagliazzo; Russell,9999,0,9999,0
1667958379476,CSE 293,013,119232,Jhala; Ranjit,9999,0,9999,0
1667958379476,CSE 293,014,119233,Kahng; Andrew Byun,9999,0,9999,0
1667958379476,CSE 293,015,119298,Kane; Daniel Mertz,9999,0,9999,0
1667958379476,CSE 293,016,119299,Kriegman; David J,9999,0,9999,0
1667958379476,CSE 293,017,119300,Kumar; Arun Kumar,9999,0,9999,0
1667958379476,CSE 293,018,119301,Lerner; Sorin,9999,0,9999,0
1667958379476,CSE 293,019,119302,Lovett; Shachar,9999,0,9999,0
1667958379476,CSE 293,020,119303,McAuley; Julian John,9999,0,9999,0
1667958379476,CSE 293,021,119304,Micciancio; Daniele,9999,0,9999,0
1667958379476,CSE 293,022,119367,Orailoglu; Alex,9999,0,9999,0
1667958379476,CSE 293,023,119382,Paturi; Ramamohan,9999,0,9999,0
1667958379476,CSE 293,024,119404,Polikarpova; Nadezhda,9999,0,9999,0
1667958379476,CSE 293,025,119406,Politz; Joseph Gibbs,9999,0,9999,0
1667958379476,CSE 293,026,119411,Porter; George M,9999,0,9999,0
1667958379476,CSE 293,027,119414,Porter; Leonard Emerson,9999,0,9999,0
1667958379476,CSE 293,028,119416,Ramamoorthi; Ravi,9999,0,9999,0
1667958379476,CSE 293,029,119417,Sahoo; Debashis,9999,0,9999,0
1667958379476,CSE 293,030,119420,Saul; Lawrence,9999,0,9999,0
1667958379476,CSE 293,031,119421,Savage; Stefan,9999,0,9999,0
1667958379476,CSE 293,032,119425,Schulze; Jurgen P.,9999,0,9999,0
1667958379476,CSE 293,033,119426,Snoeren; Alex C.,9999,0,9999,0
1667958379476,CSE 293,034,119428,Shang; Jingbo,9999,0,9999,0
1667958379476,CSE 293,035,119430,Stefan; Deian,9999,0,9999,0
1667958379476,CSE 293,036,119431,Su; Hao,9999,0,9999,0
1667958379476,CSE 293,037,119433,Swanson; Steven James,9999,0,9999,0
1667958379476,CSE 293,038,119435,Tullsen; Dean Michael,9999,0,9999,0
1667958379476,CSE 293,039,119483,Voelker; Geoffrey M.,9999,0,9999,0
1667958379476,CSE 293,040,119537,Zhao; Jishen,9999,0,9999,0
1667958379476,CSE 293,041,119538,Zhou; Yuan-Yuan,9999,0,9999,0
1667958379476,CSE 293,042,119539,Gao; Sicun,9999,0,9999,0
1667958379476,CSE 293,043,119540,Weibel; Nadir,9999,0,9999,0
1667958379476,CSE 293,044,119541,Gupta; Rajesh K.,9999,0,9999,0
1667958379904,CSE 294,A00,102459,Voelker; Geoffrey M.,0,0,0,0
1667958379904,CSE 294,B00,111322,Orailoglu; Alex,0,0,0,0
1667958380334,DSE 201,A00,096914,Deutsch; Alin Bernard,30,0,30,0
1667958380764,DSE 210,A00,096915,Dasgupta; Sanjoy,30,0,30,0
1667958381189,DSE 260A,A00,096916,Altintas De Callaf; Ilkay,30,0,30,0
1667958381687,ECE 200,001,103586,Antipa; Nicholas A,9999,0,9999,0
1667958381687,ECE 200,002,103587,Atanasov; Nikolay A.,9999,0,9999,0
1667958381687,ECE 200,003,103588,Bharadia; Dinesh,9999,0,9999,0
1667958381687,ECE 200,004,103589,Cheng; Chung Kuan,9999,0,9999,0
1667958381687,ECE 200,005,103590,Cosman; Pamela C.,9999,0,9999,0
1667958381687,ECE 200,006,103591,Dayeh; Shadi Ahmad,9999,0,9999,0
1667958381687,ECE 200,007,103592,Fainman; Yeshaiahu,9999,0,9999,0
1667958381687,ECE 200,008,103593,Ford; Joseph Earl,9999,0,9999,0
1667958381687,ECE 200,009,103594,Franceschetti; Massimo,9999,0,9999,0
1667958381687,ECE 200,010,103595,Fullerton; Eric E,9999,0,9999,0
1667958381687,ECE 200,011,103596,Galton; Ian A,9999,0,9999,0
1667958381687,ECE 200,012,103597,Gilja; Vikash,9999,0,9999,0
1667958381687,ECE 200,013,103598,Hall; Drew A.,9999,0,9999,0
1667958381687,ECE 200,014,103599,Hsueh; Tzu-Chien,9999,0,9999,0
1667958381687,ECE 200,015,103600,Javidi; Tara,9999,0,9999,0
1667958381687,ECE 200,016,103601,Kahng; Andrew Byun,9999,0,9999,0
1667958381687,ECE 200,017,103602,Kim; Young-Han,9999,0,9999,0
1667958381687,ECE 200,018,103603,Koushanfar; Farinaz,9999,0,9999,0
1667958381687,ECE 200,019,103604,Kuzum; Duygu,9999,0,9999,0
1667958381687,ECE 200,020,103605,Le; Hanh-Phuc,9999,0,9999,0
1667958381687,ECE 200,021,103606,Lin; Bill,9999,0,9999,0
1667958381687,ECE 200,022,103607,Liu; Zhaowei,9998,0,9999,1
1667958381687,ECE 200,023,103608,Lo; Yu-Hwa,9999,0,9999,0
1667958381687,ECE 200,024,103609,Lomakin; Vitaliy,9999,0,9999,0
1667958381687,ECE 200,025,103610,Mercier; Patrick Philip,9999,0,9999,0
1667958381687,ECE 200,026,103611,Meyer; Florian,9999,0,9999,0
1667958381687,ECE 200,027,103612,Milstein; Laurence B.,9999,0,9999,0
1667958381687,ECE 200,028,103613,Mir Arabbaygi; Siavash,9999,0,9999,0
1667958381687,ECE 200,029,103614,Mookherjea; Shayan,9999,0,9999,0
1667958381687,ECE 200,030,103615,Morris; Karcher William,9999,0,9999,0
1667958381687,ECE 200,031,103616,Ng; Tse Nga,9999,0,9999,0
1667958381687,ECE 200,032,103617,Nguyen; Truong Quang,9999,0,9999,0
1667958381687,ECE 200,033,103618,Nomura; Kenji,9999,0,9999,0
1667958381687,ECE 200,034,103619,Orlitsky; Alon,9999,0,9999,0
1667958381687,ECE 200,035,103620,Pal; Piya,9999,0,9999,0
1667958381687,ECE 200,036,103621,Papen; George C.,9999,0,9999,0
1667958381687,ECE 200,037,103622,Radic; Stojan,9999,0,9999,0
1667958381687,ECE 200,038,103623,Rao; Bhaskar D.,9999,0,9999,0
1667958381687,ECE 200,039,103624,Rao; Ramesh R,9999,0,9999,0
1667958381687,ECE 200,040,103625,Rebeiz; Gabriel,9999,0,9999,0
1667958381687,ECE 200,041,103626,Sanford; John R,9999,0,9999,0
1667958381687,ECE 200,042,103627,Siegel; Paul H.,9999,0,9999,0
1667958381687,ECE 200,043,103628,Sievenpiper; Daniel F.,9999,0,9999,0
1667958381687,ECE 200,044,103629,Sworder; David D.,9999,0,9999,0
1667958381687,ECE 200,045,103630,Taur; Yuan,9999,0,9999,0
1667958381687,ECE 200,046,103631,Touri; Behrouz,9999,0,9999,0
1667958381687,ECE 200,047,103632,Trivedi; Mohan M.,9999,0,9999,0
1667958381687,ECE 200,048,103633,Vasconcelos; Nuno,9999,0,9999,0
1667958381687,ECE 200,049,103634,Wang; Xiaolong,9999,0,9999,0
1667958381687,ECE 200,050,103635,Xie; Pengtao,9999,0,9999,0
1667958381687,ECE 200,051,103636,Yip; Michael,9999,0,9999,0
1667958381687,ECE 200,052,103637,Zeger; Kenneth A.,999,0,999,0
1667958381687,ECE 200,053,103638,Zhang; Xinyu,9999,0,9999,0
1667958381687,ECE 200,054,103639,Turakhia; Yatish Girish,9999,0,9999,0
1667958381687,ECE 200,055,103640,Kang; Mingu,9999,0,9999,0
1667958381687,ECE 200,056,103641,Shi; Yuanyuan,9999,0,9999,0
1667958381687,ECE 200,057,103642,Wang; Edward Jay,9999,0,9999,0
1667958381687,ECE 200,058,103643,Zheng; Yang,9999,0,9999,0
1667958382126,ECE 202,A00,103644,Kuzum; Duygu,0,0,0,0
1667958382553,ECE 212BN,A00,103646,Ng; Tse Nga,0,0,0,0
1667958382977,ECE 221,A00,111493,Staff,0,0,0,0
1667958383405,ECE 222B,A00,103647,Lomakin; Vitaliy,0,0,0,0
1667958383829,ECE 230B,A00,103648,Taur; Yuan,0,0,0,0
1667958384257,ECE 238B,A00,103649,Garay; Javier,0,0,0,0
1667958384680,ECE 240B,A00,112900,Fainman; Yeshaiahu,0,0,0,0
1667958385106,ECE 247A,A00,103650,Jokerst; Jesse Vincent,0,0,0,0
1667958385534,ECE 247B,A00,103651,Wang; Joseph,0,0,0,0
1667958385975,ECE 250,A00,103652,Siegel; Paul H.,0,0,0,0
1667958386399,ECE 251A,A00,103654,Rao; Bhaskar D.,0,0,0,0
1667958386823,ECE 257B,A00,103655,Bharadia; Dinesh,0,0,0,0
1667958387253,ECE 258A,A00,103656,Milstein; Laurence B.,0,0,0,0
1667958387675,ECE 260B,A00,103658,Kang; Mingu,0,0,0,0
1667958388104,ECE 264A,A00,103659,Galton; Ian A,0,0,0,0
1667958388527,ECE 265A,A00,103661,Gudem; Prasad S.S.,0,0,0,0
1667958388951,ECE 265D,A00,103662,Gudem; Prasad S.S.,0,0,0,0
1667958389373,ECE 268,A00,103663,Koushanfar; Farinaz,0,0,0,0
1667958389801,ECE 269,A01,103665,Pal; Piya,0,0,0,0
1667958390226,ECE 271B,A00,103666,Vasconcelos; Manuela,0,0,0,0
1667958390652,ECE 276A,A00,103667,Atanasov; Nikolay A.,0,0,0,0
1667958391076,ECE 277,A00,103668,An; Cheolhong,0,0,0,0
1667958391503,ECE 279,A00,117947,Hall; Drew A.,0,0,0,0
1667958392366,ECE 283,A00,103670,Hsueh; Tzu-Chien,0,0,0,0
1667958392790,ECE 284,A00,103671,Turakhia; Yatish Girish,0,0,0,0
1667958393218,ECE 285,A00,103672,Zheng; Yang,0,0,0,0
1667958393218,ECE 285,B00,103673,Sworder; David D.,0,0,0,0
1667958393649,ECE 287,A00,103676,Javidi; Tara,0,0,0,0
1667958394101,MATH 200B,A00,098023,Salehi Golsefidy; Alireza,14,0,15,1
1667958394528,MATH 202B,A00,098024,Rhoades; Brendon Patrick,12,0,15,3
1667958394954,MATH 203B,A00,098025,Oprea; Dragos N.,13,0,15,2
1667958395376,MATH 204B,A00,098026,Sorensen; Claus M,15,0,15,0
1667958395806,MATH 208,A00,098027,Izadi; Elham,7,0,10,3
1667958396231,MATH 209,A00,098028,Pollack; Aaron,10,0,10,0
1667958396664,MATH 211A,A00,112919,Rogalski; Daniel,9,0,10,1
1667958397096,MATH 211B,A00,112920,Seward; Brandon M.,9,0,10,1
1667958397520,MATH 218,A00,098029,Li; Bo,10,0,10,0
1667958397949,MATH 220B,A00,098030,Novak; Jonathan I,13,0,15,2
1667958398380,MATH 221A,A00,098031,Ebenfelt; Peter F,13,0,15,2
1667958398819,MATH 231B,A00,098032,Zlatos; Andrej,12,0,15,3
1667958399244,MATH 240B,A00,098033,Ni; Lei,10,0,15,5
1667958399666,MATH 243,A00,098034,Jekel; David Andrew,10,0,10,0
1667958400089,MATH 245A,A00,098035,Nie; Jiawang,0,0,15,16
1667958400519,MATH 248,A00,098036,Bejenaru; Ioan,10,0,10,0
1667958400948,MATH 250B,A00,098037,Spolaor; Luca,14,0,15,1
1667958401383,MATH 258,A00,098038,Ni; Lei,10,0,10,0
1667958401810,MATH 264B,A00,098041,Rhoades; Brendon Patrick,12,0,15,3
1667958402232,MATH 268,A00,098042,Buss; Samuel R,10,0,10,0
1667958402658,MATH 269,A00,098043,Rhoades; Brendon Patrick,10,0,10,0
1667958403088,MATH 270B,A00,098044,Li; Bo,11,0,15,4
1667958403516,MATH 272B,A00,098045,Holst; Michael J,13,0,15,2
1667958403955,MATH 273A,A00,098046,Tian; Xiaochuan,12,0,15,3
1667958404388,MATH 275,A01,098048,Tian; Xiaochuan,6,0,10,4
1667958404817,MATH 278A,A00,098049,Holst; Michael J,8,0,10,2
1667958405243,MATH 278B,A00,098050,Cloninger; Alexander,10,0,10,0
1667958405666,MATH 278C,A00,098051,Nie; Jiawang,8,0,10,2
1667958406089,MATH 280B,A00,098052,Zheng; Tianyi,12,0,15,3
1667958406511,MATH 281B,A00,098053,Bradic; Jelena,4,0,15,11
1667958406938,MATH 282B,A00,098054,Arias-Castro; Ery,2,0,15,13
1667958407365,MATH 285,A00,098055,Fitzsimmons; Patrick J,0,0,15,17
1667958407789,MATH 287B,A00,098056,Arias-Castro; Ery,5,0,15,10
1667958408230,MATH 288,A00,098057,Agarwal; Pooja,9,0,10,1
1667958408230,MATH 288,B00,098058,Zhang; Danna,9,0,10,1
1667958408230,MATH 288,C00,098059,Williams; Ruth J,10,0,10,0
1667958408653,MATH 290B,A00,098060,Roberts; Justin Deritter,14,0,15,1
1667958409077,MATH 292,A00,098061,Belmont; Eva Kinoshita,10,0,10,0
1667958409504,MATH 295,A00,098062,Suk; Andrew Hoon,48,0,50,2
1667958409926,MATH 296,A00,098063,Novak; Jonathan I,20,0,20,0
1667958410356,MATH 297,001,098064,Gamst; Anthony Collins,9997,0,9999,2
1667958912745,COGS 205,A00,101395,Chiba; Andrea,19,0,20,1
1667958913178,COGS 210B,001,101404,Greene; Deanna Jacquelyn,9998,0,9999,1
1667958913178,COGS 210B,002,101417,Xia; Haijun,9999,0,9999,0
1667958913178,COGS 210B,003,101422,Nitz; Douglas A.,9999,0,9999,0
1667958913178,COGS 210B,004,101423,Hollan; James D.,9998,0,9999,1
1667958913178,COGS 210B,005,101424,Deak; Gedeon O.,9999,0,9999,0
1667958913178,COGS 210B,006,101425,Rossano; Federico,9999,0,9999,0
1667958913610,COGS 211B,A00,101427,Coulson; Seana M,9997,0,9999,2
1667958914036,COGS 220,A00,101428,Hollan; James D.,0,0,25,25
1667958914463,COGS 229,A00,101429,Dow; Steven P,18,0,25,7
1667958914897,COGS 230,A00,101430,Klemmer; Scott R,13,0,17,4
1667958915318,COGS 234,A00,101431,Xia; Haijun,7,0,25,18
1667958915751,COGS 260,A00,101432,Kiyonaga; Anastasia,20,0,25,5
1667958915751,COGS 260,B00,101433,Kirsh; David Joel,16,0,25,9
1667958916175,CSE 202,A00,102371,Impagliazzo; Russell,0,0,0,0
1667958916604,CSE 203B,A01,102373,Cheng; Chung Kuan,0,0,0,0
1667958917027,CSE 208,A00,102374,Micciancio; Daniele,0,0,0,0
1667958917449,CSE 209A,A00,112895,Impagliazzo; Russell,0,0,15,15
1667958917874,CSE 209B,A00,108005,Bellare; Mihir,0,0,0,0
1667958918317,CSE 210,A00,113163,Coblenz; Michael J,0,0,0,0
1667958918750,CSE 219,A00,106111,Dow; Steven P,0,0,20,20
1667958919173,CSE 221,A00,102376,Voelker; Geoffrey M.,0,0,0,0
1667958919595,CSE 224,A01,102378,Porter; George M,0,0,0,0
1667958920017,CSE 229A,A00,102379,Savage; Stefan,0,0,0,0
1667958920443,CSE 229C,A00,102380,Munyaka; Imani N. S.,0,0,0,0
1667958920866,CSE 232B,A00,102382,Deutsch; Alin Bernard,0,0,0,0
1667958921293,CSE 234,A01,112904,Kumar; Arun Kumar,0,0,0,0
1667958921716,CSE 237A,A00,102383,Rosing; Tajana Simunic,0,0,0,0
1667958922149,CSE 239A,A00,102384,Deutsch; Alin Bernard,0,0,0,0
1667958922576,CSE 239B,A00,102385,Polikarpova; Nadezhda,0,0,0,0
1667958923010,CSE 240A,A00,102386,Pannuto; Patrick William,0,0,0,0
1667958923435,CSE 240B,A00,102387,Zhao; Jishen,0,0,0,0
1667958923858,CSE 241A,A00,106406,Kang; Mingu,0,0,0,0
1667958924283,CSE 249B,A00,102388,Kahng; Andrew Byun,0,0,8,8
1667958924707,CSE 251B,A01,102392,Cottrell; Garrison W,0,0,0,0
1667958924707,CSE 251B,A02,102393,Cottrell; Garrison W,0,0,0,0
1667958925136,CSE 252B,A00,102394,Ochoa; Benjamin Lawrence,0,0,0,0
1667958925595,CSE 257,A01,102396,Gao; Sicun,0,0,0,0
1667958926018,CSE 272,A00,102397,Li; Tzumao,0,0,0,0
1667958926443,CSE 274,A00,111323,Chern; Albert Ren-Haur,0,0,0,0
1667958926869,CSE 282,A00,102398,Pevzner; Pavel Arkadjevich,0,0,0,0
1667958927292,CSE 284,A00,114175,Gymrek; Melissa Ann,0,0,0,0
1667958927731,CSE 290,A00,102399,Chandraker; Manmohan Krishna,0,0,0,0
1667958927731,CSE 290,B00,102400,Vaccaro; Kristen Marie,0,0,25,25
1667958927731,CSE 290,C00,102414,Pannuto; Patrick William,0,0,25,25
1667958927731,CSE 290,D00,102427,Pevzner; Pavel Arkadjevich,0,0,0,0
1667958927731,CSE 290,E00,102429,Zhao; Jishen,0,0,0,0
1667958927731,CSE 290,F00,102436,Tullsen; Dean Michael,0,0,0,0
1667958927731,CSE 290,G00,102440,Christensen; Henrik I,0,0,20,20
1667958928155,CSE 291,A00,102443,Su; Hao,0,0,0,0
1667958928155,CSE 291,B00,102448,Polikarpova; Nadezhda,0,0,0,0
1667958928155,CSE 291,C00,102453,Vaccaro; Kristen Marie,0,0,0,0
1667958928155,CSE 291,D00,111343,Savage; Stefan,0,0,0,0
1667958928155,CSE 291,E00,116474,Claffy; Kimberly Claire,0,0,0,0
1667958928155,CSE 291,F00,116479,Pasquale; Joseph,0,0,0,0
1667958928593,CSE 293,001,119111,Bafna; Vineet,9999,0,9999,0
1667958928593,CSE 293,002,119118,Bellare; Mihir,9999,0,9999,0
1667958928593,CSE 293,003,119122,Berg-Kirkpatrick; Taylor D,9999,0,9999,0
1667958928593,CSE 293,004,119135,Christensen; Henrik I,9999,0,9999,0
1667958928593,CSE 293,005,119142,Cottrell; Garrison W,9999,0,9999,0
1667958928593,CSE 293,006,119146,Deutsch; Alin Bernard,9999,0,9999,0
1667958928593,CSE 293,007,119159,Esmaeilzadeh; Hadi,9999,0,9999,0
1667958928593,CSE 293,008,119166,Freund; Yoav,9999,0,9999,0
1667958928593,CSE 293,009,119170,Griswold; William G.,9999,0,9999,0
1667958928593,CSE 293,010,119183,Gymrek; Melissa Ann,9999,0,9999,0
1667958928593,CSE 293,011,119190,Heninger; Nadia A,9999,0,9999,0
1667958928593,CSE 293,012,119230,Impagliazzo; Russell,9999,0,9999,0
1667958928593,CSE 293,013,119232,Jhala; Ranjit,9999,0,9999,0
1667958928593,CSE 293,014,119233,Kahng; Andrew Byun,9999,0,9999,0
1667958928593,CSE 293,015,119298,Kane; Daniel Mertz,9999,0,9999,0
1667958928593,CSE 293,016,119299,Kriegman; David J,9999,0,9999,0
1667958928593,CSE 293,017,119300,Kumar; Arun Kumar,9999,0,9999,0
1667958928593,CSE 293,018,119301,Lerner; Sorin,9999,0,9999,0
1667958928593,CSE 293,019,119302,Lovett; Shachar,9999,0,9999,0
1667958928593,CSE 293,020,119303,McAuley; Julian John,9999,0,9999,0
1667958928593,CSE 293,021,119304,Micciancio; Daniele,9999,0,9999,0
1667958928593,CSE 293,022,119367,Orailoglu; Alex,9999,0,9999,0
1667958928593,CSE 293,023,119382,Paturi; Ramamohan,9999,0,9999,0
1667958928593,CSE 293,024,119404,Polikarpova; Nadezhda,9999,0,9999,0
1667958928593,CSE 293,025,119406,Politz; Joseph Gibbs,9999,0,9999,0
1667958928593,CSE 293,026,119411,Porter; George M,9999,0,9999,0
1667958928593,CSE 293,027,119414,Porter; Leonard Emerson,9999,0,9999,0
1667958928593,CSE 293,028,119416,Ramamoorthi; Ravi,9999,0,9999,0
1667958928593,CSE 293,029,119417,Sahoo; Debashis,9999,0,9999,0
1667958928593,CSE 293,030,119420,Saul; Lawrence,9999,0,9999,0
1667958928593,CSE 293,031,119421,Savage; Stefan,9999,0,9999,0
1667958928593,CSE 293,032,119425,Schulze; Jurgen P.,9999,0,9999,0
1667958928593,CSE 293,033,119426,Snoeren; Alex C.,9999,0,9999,0
1667958928593,CSE 293,034,119428,Shang; Jingbo,9999,0,9999,0
1667958928593,CSE 293,035,119430,Stefan; Deian,9999,0,9999,0
1667958928593,CSE 293,036,119431,Su; Hao,9999,0,9999,0
1667958928593,CSE 293,037,119433,Swanson; Steven James,9999,0,9999,0
1667958928593,CSE 293,038,119435,Tullsen; Dean Michael,9999,0,9999,0
1667958928593,CSE 293,039,119483,Voelker; Geoffrey M.,9999,0,9999,0
1667958928593,CSE 293,040,119537,Zhao; Jishen,9999,0,9999,0
1667958928593,CSE 293,041,119538,Zhou; Yuan-Yuan,9999,0,9999,0
1667958928593,CSE 293,042,119539,Gao; Sicun,9999,0,9999,0
1667958928593,CSE 293,043,119540,Weibel; Nadir,9999,0,9999,0
1667958928593,CSE 293,044,119541,Gupta; Rajesh K.,9999,0,9999,0
1667958929017,CSE 294,A00,102459,Voelker; Geoffrey M.,0,0,0,0
1667958929017,CSE 294,B00,111322,Orailoglu; Alex,0,0,0,0
1667958929440,DSE 201,A00,096914,Deutsch; Alin Bernard,30,0,30,0
1667958929871,DSE 210,A00,096915,Dasgupta; Sanjoy,30,0,30,0
1667958930301,DSE 260A,A00,096916,Altintas De Callaf; Ilkay,30,0,30,0
1667958930770,ECE 200,001,103586,Antipa; Nicholas A,9999,0,9999,0
1667958930770,ECE 200,002,103587,Atanasov; Nikolay A.,9999,0,9999,0
1667958930770,ECE 200,003,103588,Bharadia; Dinesh,9999,0,9999,0
1667958930770,ECE 200,004,103589,Cheng; Chung Kuan,9999,0,9999,0
1667958930770,ECE 200,005,103590,Cosman; Pamela C.,9999,0,9999,0
1667958930770,ECE 200,006,103591,Dayeh; Shadi Ahmad,9999,0,9999,0
1667958930770,ECE 200,007,103592,Fainman; Yeshaiahu,9999,0,9999,0
1667958930770,ECE 200,008,103593,Ford; Joseph Earl,9999,0,9999,0
1667958930770,ECE 200,009,103594,Franceschetti; Massimo,9999,0,9999,0
1667958930770,ECE 200,010,103595,Fullerton; Eric E,9999,0,9999,0
1667958930770,ECE 200,011,103596,Galton; Ian A,9999,0,9999,0
1667958930770,ECE 200,012,103597,Gilja; Vikash,9999,0,9999,0
1667958930770,ECE 200,013,103598,Hall; Drew A.,9999,0,9999,0
1667958930770,ECE 200,014,103599,Hsueh; Tzu-Chien,9999,0,9999,0
1667958930770,ECE 200,015,103600,Javidi; Tara,9999,0,9999,0
1667958930770,ECE 200,016,103601,Kahng; Andrew Byun,9999,0,9999,0
1667958930770,ECE 200,017,103602,Kim; Young-Han,9999,0,9999,0
1667958930770,ECE 200,018,103603,Koushanfar; Farinaz,9999,0,9999,0
1667958930770,ECE 200,019,103604,Kuzum; Duygu,9999,0,9999,0
1667958930770,ECE 200,020,103605,Le; Hanh-Phuc,9999,0,9999,0
1667958930770,ECE 200,021,103606,Lin; Bill,9999,0,9999,0
1667958930770,ECE 200,022,103607,Liu; Zhaowei,9998,0,9999,1
1667958930770,ECE 200,023,103608,Lo; Yu-Hwa,9999,0,9999,0
1667958930770,ECE 200,024,103609,Lomakin; Vitaliy,9999,0,9999,0
1667958930770,ECE 200,025,103610,Mercier; Patrick Philip,9999,0,9999,0
1667958930770,ECE 200,026,103611,Meyer; Florian,9999,0,9999,0
1667958930770,ECE 200,027,103612,Milstein; Laurence B.,9999,0,9999,0
1667958930770,ECE 200,028,103613,Mir Arabbaygi; Siavash,9999,0,9999,0
1667958930770,ECE 200,029,103614,Mookherjea; Shayan,9999,0,9999,0
1667958930770,ECE 200,030,103615,Morris; Karcher William,9999,0,9999,0
1667958930770,ECE 200,031,103616,Ng; Tse Nga,9999,0,9999,0
1667958930770,ECE 200,032,103617,Nguyen; Truong Quang,9999,0,9999,0
1667958930770,ECE 200,033,103618,Nomura; Kenji,9999,0,9999,0
1667958930770,ECE 200,034,103619,Orlitsky; Alon,9999,0,9999,0
1667958930770,ECE 200,035,103620,Pal; Piya,9999,0,9999,0
1667958930770,ECE 200,036,103621,Papen; George C.,9999,0,9999,0
1667958930770,ECE 200,037,103622,Radic; Stojan,9999,0,9999,0
1667958930770,ECE 200,038,103623,Rao; Bhaskar D.,9999,0,9999,0
1667958930770,ECE 200,039,103624,Rao; Ramesh R,9999,0,9999,0
1667958930770,ECE 200,040,103625,Rebeiz; Gabriel,9999,0,9999,0
1667958930770,ECE 200,041,103626,Sanford; John R,9999,0,9999,0
1667958930770,ECE 200,042,103627,Siegel; Paul H.,9999,0,9999,0
1667958930770,ECE 200,043,103628,Sievenpiper; Daniel F.,9999,0,9999,0
1667958930770,ECE 200,044,103629,Sworder; David D.,9999,0,9999,0
1667958930770,ECE 200,045,103630,Taur; Yuan,9999,0,9999,0
1667958930770,ECE 200,046,103631,Touri; Behrouz,9999,0,9999,0
1667958930770,ECE 200,047,103632,Trivedi; Mohan M.,9999,0,9999,0
1667958930770,ECE 200,048,103633,Vasconcelos; Nuno,9999,0,9999,0
1667958930770,ECE 200,049,103634,Wang; Xiaolong,9999,0,9999,0
1667958930770,ECE 200,050,103635,Xie; Pengtao,9999,0,9999,0
1667958930770,ECE 200,051,103636,Yip; Michael,9999,0,9999,0
1667958930770,ECE 200,052,103637,Zeger; Kenneth A.,999,0,999,0
1667958930770,ECE 200,053,103638,Zhang; Xinyu,9999,0,9999,0
1667958930770,ECE 200,054,103639,Turakhia; Yatish Girish,9999,0,9999,0
1667958930770,ECE 200,055,103640,Kang; Mingu,9999,0,9999,0
1667958930770,ECE 200,056,103641,Shi; Yuanyuan,9999,0,9999,0
1667958930770,ECE 200,057,103642,Wang; Edward Jay,9999,0,9999,0
1667958930770,ECE 200,058,103643,Zheng; Yang,9999,0,9999,0
1667958931202,ECE 202,A00,103644,Kuzum; Duygu,0,0,0,0
1667958931625,ECE 212BN,A00,103646,Ng; Tse Nga,0,0,0,0
1667958932050,ECE 221,A00,111493,Staff,0,0,0,0
1667958932473,ECE 222B,A00,103647,Lomakin; Vitaliy,0,0,0,0
1667958932895,ECE 230B,A00,103648,Taur; Yuan,0,0,0,0
1667958933319,ECE 238B,A00,103649,Garay; Javier,0,0,0,0
1667958933741,ECE 240B,A00,112900,Fainman; Yeshaiahu,0,0,0,0
1667958934168,ECE 247A,A00,103650,Jokerst; Jesse Vincent,0,0,0,0
1667958934616,ECE 247B,A00,103651,Wang; Joseph,0,0,0,0
1667958935043,ECE 250,A00,103652,Siegel; Paul H.,0,0,0,0
1667958935467,ECE 251A,A00,103654,Rao; Bhaskar D.,0,0,0,0
1667958935897,ECE 257B,A00,103655,Bharadia; Dinesh,0,0,0,0
1667958936319,ECE 258A,A00,103656,Milstein; Laurence B.,0,0,0,0
1667958936745,ECE 260B,A00,103658,Kang; Mingu,0,0,0,0
1667958937172,ECE 264A,A00,103659,Galton; Ian A,0,0,0,0
1667958937596,ECE 265A,A00,103661,Gudem; Prasad S.S.,0,0,0,0
1667958938029,ECE 265D,A00,103662,Gudem; Prasad S.S.,0,0,0,0
1667958938452,ECE 268,A00,103663,Koushanfar; Farinaz,0,0,0,0
1667958938927,ECE 269,A01,103665,Pal; Piya,0,0,0,0
1667958939364,ECE 271B,A00,103666,Vasconcelos; Manuela,0,0,0,0
1667958939787,ECE 276A,A00,103667,Atanasov; Nikolay A.,0,0,0,0
1667958940217,ECE 277,A00,103668,An; Cheolhong,0,0,0,0
1667958940639,ECE 279,A00,117947,Hall; Drew A.,0,0,0,0
1667958941494,ECE 283,A00,103670,Hsueh; Tzu-Chien,0,0,0,0
1667958941997,ECE 284,A00,103671,Turakhia; Yatish Girish,0,0,0,0
1667958942420,ECE 285,A00,103672,Zheng; Yang,0,0,0,0
1667958942420,ECE 285,B00,103673,Sworder; David D.,0,0,0,0
1667958942842,ECE 287,A00,103676,Javidi; Tara,0,0,0,0
1667958943275,MATH 200B,A00,098023,Salehi Golsefidy; Alireza,14,0,15,1
1667958943706,MATH 202B,A00,098024,Rhoades; Brendon Patrick,12,0,15,3
1667958944135,MATH 203B,A00,098025,Oprea; Dragos N.,13,0,15,2
1667958944559,MATH 204B,A00,098026,Sorensen; Claus M,15,0,15,0
1667958944986,MATH 208,A00,098027,Izadi; Elham,7,0,10,3
1667958945408,MATH 209,A00,098028,Pollack; Aaron,10,0,10,0
1667958945832,MATH 211A,A00,112919,Rogalski; Daniel,9,0,10,1
1667958946258,MATH 211B,A00,112920,Seward; Brandon M.,9,0,10,1
1667958946689,MATH 218,A00,098029,Li; Bo,10,0,10,0
1667958947115,MATH 220B,A00,098030,Novak; Jonathan I,13,0,15,2
1667958947548,MATH 221A,A00,098031,Ebenfelt; Peter F,13,0,15,2
1667958947983,MATH 231B,A00,098032,Zlatos; Andrej,12,0,15,3
1667958948410,MATH 240B,A00,098033,Ni; Lei,10,0,15,5
1667958948834,MATH 243,A00,098034,Jekel; David Andrew,10,0,10,0
1667958949259,MATH 245A,A00,098035,Nie; Jiawang,0,0,15,16
1667958949686,MATH 248,A00,098036,Bejenaru; Ioan,10,0,10,0
1667958950112,MATH 250B,A00,098037,Spolaor; Luca,14,0,15,1
1667958950534,MATH 258,A00,098038,Ni; Lei,10,0,10,0
1667958950968,MATH 264B,A00,098041,Rhoades; Brendon Patrick,12,0,15,3
1667958951406,MATH 268,A00,098042,Buss; Samuel R,10,0,10,0
1667958951831,MATH 269,A00,098043,Rhoades; Brendon Patrick,10,0,10,0
1667958952259,MATH 270B,A00,098044,Li; Bo,11,0,15,4
1667958952688,MATH 272B,A00,098045,Holst; Michael J,13,0,15,2
1667958953117,MATH 273A,A00,098046,Tian; Xiaochuan,12,0,15,3
1667958953541,MATH 275,A01,098048,Tian; Xiaochuan,6,0,10,4
1667958953967,MATH 278A,A00,098049,Holst; Michael J,8,0,10,2
1667958954392,MATH 278B,A00,098050,Cloninger; Alexander,10,0,10,0
1667958954817,MATH 278C,A00,098051,Nie; Jiawang,8,0,10,2
1667958955242,MATH 280B,A00,098052,Zheng; Tianyi,12,0,15,3
1667958955679,MATH 281B,A00,098053,Bradic; Jelena,4,0,15,11
1667958956106,MATH 282B,A00,098054,Arias-Castro; Ery,2,0,15,13
1667958956530,MATH 285,A00,098055,Fitzsimmons; Patrick J,0,0,15,17
1667958956955,MATH 287B,A00,098056,Arias-Castro; Ery,5,0,15,10
1667958957383,MATH 288,A00,098057,Agarwal; Pooja,9,0,10,1
1667958957383,MATH 288,B00,098058,Zhang; Danna,9,0,10,1
1667958957383,MATH 288,C00,098059,Williams; Ruth J,10,0,10,0
1667958957819,MATH 290B,A00,098060,Roberts; Justin Deritter,14,0,15,1
1667958958254,MATH 292,A00,098061,Belmont; Eva Kinoshita,10,0,10,0
1667958958680,MATH 295,A00,098062,Suk; Andrew Hoon,48,0,50,2
1667958959112,MATH 296,A00,098063,Novak; Jonathan I,20,0,20,0
1667958959537,MATH 297,001,098064,Gamst; Anthony Collins,9997,0,9999,2
1667959464023,COGS 205,A00,101395,Chiba; Andrea,19,0,20,1
1667959464447,COGS 210B,001,101404,Greene; Deanna Jacquelyn,9998,0,9999,1
1667959464447,COGS 210B,002,101417,Xia; Haijun,9999,0,9999,0
1667959464447,COGS 210B,003,101422,Nitz; Douglas A.,9999,0,9999,0
1667959464447,COGS 210B,004,101423,Hollan; James D.,9998,0,9999,1
1667959464447,COGS 210B,005,101424,Deak; Gedeon O.,9999,0,9999,0
1667959464447,COGS 210B,006,101425,Rossano; Federico,9999,0,9999,0
1667959464870,COGS 211B,A00,101427,Coulson; Seana M,9997,0,9999,2
1667959465300,COGS 220,A00,101428,Hollan; James D.,0,0,25,25
1667959465726,COGS 229,A00,101429,Dow; Steven P,18,0,25,7
1667959466151,COGS 230,A00,101430,Klemmer; Scott R,13,0,17,4
1667959466650,COGS 234,A00,101431,Xia; Haijun,7,0,25,18
1667959467074,COGS 260,A00,101432,Kiyonaga; Anastasia,20,0,25,5
1667959467074,COGS 260,B00,101433,Kirsh; David Joel,16,0,25,9
1667959467503,CSE 202,A00,102371,Impagliazzo; Russell,0,0,0,0
1667959467928,CSE 203B,A01,102373,Cheng; Chung Kuan,0,0,0,0
1667959468356,CSE 208,A00,102374,Micciancio; Daniele,0,0,0,0
1667959468779,CSE 209A,A00,112895,Impagliazzo; Russell,0,0,15,15
1667959469210,CSE 209B,A00,108005,Bellare; Mihir,0,0,0,0
1667959469634,CSE 210,A00,113163,Coblenz; Michael J,0,0,0,0
1667959470058,CSE 219,A00,106111,Dow; Steven P,0,0,20,20
1667959470484,CSE 221,A00,102376,Voelker; Geoffrey M.,0,0,0,0
1667959470913,CSE 224,A01,102378,Porter; George M,0,0,0,0
1667959471336,CSE 229A,A00,102379,Savage; Stefan,0,0,0,0
1667959471760,CSE 229C,A00,102380,Munyaka; Imani N. S.,0,0,0,0
1667959472184,CSE 232B,A00,102382,Deutsch; Alin Bernard,0,0,0,0
1667959472606,CSE 234,A01,112904,Kumar; Arun Kumar,0,0,0,0
1667959473034,CSE 237A,A00,102383,Rosing; Tajana Simunic,0,0,0,0
1667959473465,CSE 239A,A00,102384,Deutsch; Alin Bernard,0,0,0,0
1667959473889,CSE 239B,A00,102385,Polikarpova; Nadezhda,0,0,0,0
1667959474330,CSE 240A,A00,102386,Pannuto; Patrick William,0,0,0,0
1667959474758,CSE 240B,A00,102387,Zhao; Jishen,0,0,0,0
1667959475185,CSE 241A,A00,106406,Kang; Mingu,0,0,0,0
1667959475612,CSE 249B,A00,102388,Kahng; Andrew Byun,0,0,8,8
1667959476036,CSE 251B,A01,102392,Cottrell; Garrison W,0,0,0,0
1667959476036,CSE 251B,A02,102393,Cottrell; Garrison W,0,0,0,0
1667959476463,CSE 252B,A00,102394,Ochoa; Benjamin Lawrence,0,0,0,0
1667959476888,CSE 257,A01,102396,Gao; Sicun,0,0,0,0
1667959477315,CSE 272,A00,102397,Li; Tzumao,0,0,0,0
1667959477739,CSE 274,A00,111323,Chern; Albert Ren-Haur,0,0,0,0
1667959478165,CSE 282,A00,102398,Pevzner; Pavel Arkadjevich,0,0,0,0
1667959478591,CSE 284,A00,114175,Gymrek; Melissa Ann,0,0,0,0
1667959479021,CSE 290,A00,102399,Chandraker; Manmohan Krishna,0,0,0,0
1667959479021,CSE 290,B00,102400,Vaccaro; Kristen Marie,0,0,25,25
1667959479021,CSE 290,C00,102414,Pannuto; Patrick William,0,0,25,25
1667959479021,CSE 290,D00,102427,Pevzner; Pavel Arkadjevich,0,0,0,0
1667959479021,CSE 290,E00,102429,Zhao; Jishen,0,0,0,0
1667959479021,CSE 290,F00,102436,Tullsen; Dean Michael,0,0,0,0
1667959479021,CSE 290,G00,102440,Christensen; Henrik I,0,0,20,20
1667959479454,CSE 291,A00,102443,Su; Hao,0,0,0,0
1667959479454,CSE 291,B00,102448,Polikarpova; Nadezhda,0,0,0,0
1667959479454,CSE 291,C00,102453,Vaccaro; Kristen Marie,0,0,0,0
1667959479454,CSE 291,D00,111343,Savage; Stefan,0,0,0,0
1667959479454,CSE 291,E00,116474,Claffy; Kimberly Claire,0,0,0,0
1667959479454,CSE 291,F00,116479,Pasquale; Joseph,0,0,0,0
1667959479894,CSE 293,001,119111,Bafna; Vineet,9999,0,9999,0
1667959479894,CSE 293,002,119118,Bellare; Mihir,9999,0,9999,0
1667959479894,CSE 293,003,119122,Berg-Kirkpatrick; Taylor D,9999,0,9999,0
1667959479894,CSE 293,004,119135,Christensen; Henrik I,9999,0,9999,0
1667959479894,CSE 293,005,119142,Cottrell; Garrison W,9999,0,9999,0
1667959479894,CSE 293,006,119146,Deutsch; Alin Bernard,9999,0,9999,0
1667959479894,CSE 293,007,119159,Esmaeilzadeh; Hadi,9999,0,9999,0
1667959479894,CSE 293,008,119166,Freund; Yoav,9999,0,9999,0
1667959479894,CSE 293,009,119170,Griswold; William G.,9999,0,9999,0
1667959479894,CSE 293,010,119183,Gymrek; Melissa Ann,9999,0,9999,0
1667959479894,CSE 293,011,119190,Heninger; Nadia A,9999,0,9999,0
1667959479894,CSE 293,012,119230,Impagliazzo; Russell,9999,0,9999,0
1667959479894,CSE 293,013,119232,Jhala; Ranjit,9999,0,9999,0
1667959479894,CSE 293,014,119233,Kahng; Andrew Byun,9999,0,9999,0
1667959479894,CSE 293,015,119298,Kane; Daniel Mertz,9999,0,9999,0
1667959479894,CSE 293,016,119299,Kriegman; David J,9999,0,9999,0
1667959479894,CSE 293,017,119300,Kumar; Arun Kumar,9999,0,9999,0
1667959479894,CSE 293,018,119301,Lerner; Sorin,9999,0,9999,0
1667959479894,CSE 293,019,119302,Lovett; Shachar,9999,0,9999,0
1667959479894,CSE 293,020,119303,McAuley; Julian John,9999,0,9999,0
1667959479894,CSE 293,021,119304,Micciancio; Daniele,9999,0,9999,0
1667959479894,CSE 293,022,119367,Orailoglu; Alex,9999,0,9999,0
1667959479894,CSE 293,023,119382,Paturi; Ramamohan,9999,0,9999,0
1667959479894,CSE 293,024,119404,Polikarpova; Nadezhda,9999,0,9999,0
1667959479894,CSE 293,025,119406,Politz; Joseph Gibbs,9999,0,9999,0
1667959479894,CSE 293,026,119411,Porter; George M,9999,0,9999,0
1667959479894,CSE 293,027,119414,Porter; Leonard Emerson,9999,0,9999,0
1667959479894,CSE 293,028,119416,Ramamoorthi; Ravi,9999,0,9999,0
1667959479894,CSE 293,029,119417,Sahoo; Debashis,9999,0,9999,0
1667959479894,CSE 293,030,119420,Saul; Lawrence,9999,0,9999,0
1667959479894,CSE 293,031,119421,Savage; Stefan,9999,0,9999,0
1667959479894,CSE 293,032,119425,Schulze; Jurgen P.,9999,0,9999,0
1667959479894,CSE 293,033,119426,Snoeren; Alex C.,9999,0,9999,0
1667959479894,CSE 293,034,119428,Shang; Jingbo,9999,0,9999,0
1667959479894,CSE 293,035,119430,Stefan; Deian,9999,0,9999,0
1667959479894,CSE 293,036,119431,Su; Hao,9999,0,9999,0
1667959479894,CSE 293,037,119433,Swanson; Steven James,9999,0,9999,0
1667959479894,CSE 293,038,119435,Tullsen; Dean Michael,9999,0,9999,0
1667959479894,CSE 293,039,119483,Voelker; Geoffrey M.,9999,0,9999,0
1667959479894,CSE 293,040,119537,Zhao; Jishen,9999,0,9999,0
1667959479894,CSE 293,041,119538,Zhou; Yuan-Yuan,9999,0,9999,0
1667959479894,CSE 293,042,119539,Gao; Sicun,9999,0,9999,0
1667959479894,CSE 293,043,119540,Weibel; Nadir,9999,0,9999,0
1667959479894,CSE 293,044,119541,Gupta; Rajesh K.,9999,0,9999,0
1667959480322,CSE 294,A00,102459,Voelker; Geoffrey M.,0,0,0,0
1667959480322,CSE 294,B00,111322,Orailoglu; Alex,0,0,0,0
1667959480757,DSE 201,A00,096914,Deutsch; Alin Bernard,30,0,30,0
1667959481180,DSE 210,A00,096915,Dasgupta; Sanjoy,30,0,30,0
1667959481613,DSE 260A,A00,096916,Altintas De Callaf; Ilkay,30,0,30,0
1667959482077,ECE 200,001,103586,Antipa; Nicholas A,9999,0,9999,0
1667959482077,ECE 200,002,103587,Atanasov; Nikolay A.,9999,0,9999,0
1667959482077,ECE 200,003,103588,Bharadia; Dinesh,9999,0,9999,0
1667959482077,ECE 200,004,103589,Cheng; Chung Kuan,9999,0,9999,0
1667959482077,ECE 200,005,103590,Cosman; Pamela C.,9999,0,9999,0
1667959482077,ECE 200,006,103591,Dayeh; Shadi Ahmad,9999,0,9999,0
1667959482077,ECE 200,007,103592,Fainman; Yeshaiahu,9999,0,9999,0
1667959482077,ECE 200,008,103593,Ford; Joseph Earl,9999,0,9999,0
1667959482077,ECE 200,009,103594,Franceschetti; Massimo,9999,0,9999,0
1667959482077,ECE 200,010,103595,Fullerton; Eric E,9999,0,9999,0
1667959482077,ECE 200,011,103596,Galton; Ian A,9999,0,9999,0
1667959482077,ECE 200,012,103597,Gilja; Vikash,9999,0,9999,0
1667959482077,ECE 200,013,103598,Hall; Drew A.,9999,0,9999,0
1667959482077,ECE 200,014,103599,Hsueh; Tzu-Chien,9999,0,9999,0
1667959482077,ECE 200,015,103600,Javidi; Tara,9999,0,9999,0
1667959482077,ECE 200,016,103601,Kahng; Andrew Byun,9999,0,9999,0
1667959482077,ECE 200,017,103602,Kim; Young-Han,9999,0,9999,0
1667959482077,ECE 200,018,103603,Koushanfar; Farinaz,9999,0,9999,0
1667959482077,ECE 200,019,103604,Kuzum; Duygu,9999,0,9999,0
1667959482077,ECE 200,020,103605,Le; Hanh-Phuc,9999,0,9999,0
1667959482077,ECE 200,021,103606,Lin; Bill,9999,0,9999,0
1667959482077,ECE 200,022,103607,Liu; Zhaowei,9998,0,9999,1
1667959482077,ECE 200,023,103608,Lo; Yu-Hwa,9999,0,9999,0
1667959482077,ECE 200,024,103609,Lomakin; Vitaliy,9999,0,9999,0
1667959482077,ECE 200,025,103610,Mercier; Patrick Philip,9999,0,9999,0
1667959482077,ECE 200,026,103611,Meyer; Florian,9999,0,9999,0
1667959482077,ECE 200,027,103612,Milstein; Laurence B.,9999,0,9999,0
1667959482077,ECE 200,028,103613,Mir Arabbaygi; Siavash,9999,0,9999,0
1667959482077,ECE 200,029,103614,Mookherjea; Shayan,9999,0,9999,0
1667959482077,ECE 200,030,103615,Morris; Karcher William,9999,0,9999,0
1667959482077,ECE 200,031,103616,Ng; Tse Nga,9999,0,9999,0
1667959482077,ECE 200,032,103617,Nguyen; Truong Quang,9999,0,9999,0
1667959482077,ECE 200,033,103618,Nomura; Kenji,9999,0,9999,0
1667959482077,ECE 200,034,103619,Orlitsky; Alon,9999,0,9999,0
1667959482077,ECE 200,035,103620,Pal; Piya,9999,0,9999,0
1667959482077,ECE 200,036,103621,Papen; George C.,9999,0,9999,0
1667959482077,ECE 200,037,103622,Radic; Stojan,9999,0,9999,0
1667959482077,ECE 200,038,103623,Rao; Bhaskar D.,9999,0,9999,0
1667959482077,ECE 200,039,103624,Rao; Ramesh R,9999,0,9999,0
1667959482077,ECE 200,040,103625,Rebeiz; Gabriel,9999,0,9999,0
1667959482077,ECE 200,041,103626,Sanford; John R,9999,0,9999,0
1667959482077,ECE 200,042,103627,Siegel; Paul H.,9999,0,9999,0
1667959482077,ECE 200,043,103628,Sievenpiper; Daniel F.,9999,0,9999,0
1667959482077,ECE 200,044,103629,Sworder; David D.,9999,0,9999,0
1667959482077,ECE 200,045,103630,Taur; Yuan,9999,0,9999,0
1667959482077,ECE 200,046,103631,Touri; Behrouz,9999,0,9999,0
1667959482077,ECE 200,047,103632,Trivedi; Mohan M.,9999,0,9999,0
1667959482077,ECE 200,048,103633,Vasconcelos; Nuno,9999,0,9999,0
1667959482077,ECE 200,049,103634,Wang; Xiaolong,9999,0,9999,0
1667959482077,ECE 200,050,103635,Xie; Pengtao,9999,0,9999,0
1667959482077,ECE 200,051,103636,Yip; Michael,9999,0,9999,0
1667959482077,ECE 200,052,103637,Zeger; Kenneth A.,999,0,999,0
1667959482077,ECE 200,053,103638,Zhang; Xinyu,9999,0,9999,0
1667959482077,ECE 200,054,103639,Turakhia; Yatish Girish,9999,0,9999,0
1667959482077,ECE 200,055,103640,Kang; Mingu,9999,0,9999,0
1667959482077,ECE 200,056,103641,Shi; Yuanyuan,9999,0,9999,0
1667959482077,ECE 200,057,103642,Wang; Edward Jay,9999,0,9999,0
1667959482077,ECE 200,058,103643,Zheng; Yang,9999,0,9999,0
1667959482510,ECE 202,A00,103644,Kuzum; Duygu,0,0,0,0
1667959482933,ECE 212BN,A00,103646,Ng; Tse Nga,0,0,0,0
1667959483366,ECE 221,A00,111493,Staff,0,0,0,0
1667959483792,ECE 222B,A00,103647,Lomakin; Vitaliy,0,0,0,0
1667959484216,ECE 230B,A00,103648,Taur; Yuan,0,0,0,0
1667959484649,ECE 238B,A00,103649,Garay; Javier,0,0,0,0
1667959485074,ECE 240B,A00,112900,Fainman; Yeshaiahu,0,0,0,0
1667959485498,ECE 247A,A00,103650,Jokerst; Jesse Vincent,0,0,0,0
1667959485926,ECE 247B,A00,103651,Wang; Joseph,0,0,0,0
1667959486352,ECE 250,A00,103652,Siegel; Paul H.,0,0,0,0
1667959486776,ECE 251A,A00,103654,Rao; Bhaskar D.,0,0,0,0
1667959487200,ECE 257B,A00,103655,Bharadia; Dinesh,0,0,0,0
1667959487626,ECE 258A,A00,103656,Milstein; Laurence B.,0,0,0,0
1667959488050,ECE 260B,A00,103658,Kang; Mingu,0,0,0,0
1667959488475,ECE 264A,A00,103659,Galton; Ian A,0,0,0,0
1667959488899,ECE 265A,A00,103661,Gudem; Prasad S.S.,0,0,0,0
1667959489326,ECE 265D,A00,103662,Gudem; Prasad S.S.,0,0,0,0
1667959489753,ECE 268,A00,103663,Koushanfar; Farinaz,0,0,0,0
1667959490183,ECE 269,A01,103665,Pal; Piya,0,0,0,0
1667959490616,ECE 271B,A00,103666,Vasconcelos; Manuela,0,0,0,0
1667959491038,ECE 276A,A00,103667,Atanasov; Nikolay A.,0,0,0,0
1667959491466,ECE 277,A00,103668,An; Cheolhong,0,0,0,0
1667959491901,ECE 279,A00,117947,Hall; Drew A.,0,0,0,0
1667959492753,ECE 283,A00,103670,Hsueh; Tzu-Chien,0,0,0,0
1667959493178,ECE 284,A00,103671,Turakhia; Yatish Girish,0,0,0,0
1667959493601,ECE 285,A00,103672,Zheng; Yang,0,0,0,0
1667959493601,ECE 285,B00,103673,Sworder; David D.,0,0,0,0
1667959494034,ECE 287,A00,103676,Javidi; Tara,0,0,0,0
1667959494461,MATH 200B,A00,098023,Salehi Golsefidy; Alireza,14,0,15,1
1667959494906,MATH 202B,A00,098024,Rhoades; Brendon Patrick,12,0,15,3
1667959495353,MATH 203B,A00,098025,Oprea; Dragos N.,13,0,15,2
1667959495775,MATH 204B,A00,098026,Sorensen; Claus M,15,0,15,0
1667959496208,MATH 208,A00,098027,Izadi; Elham,7,0,10,3
1667959496632,MATH 209,A00,098028,Pollack; Aaron,10,0,10,0
1667959497055,MATH 211A,A00,112919,Rogalski; Daniel,9,0,10,1
1667959497483,MATH 211B,A00,112920,Seward; Brandon M.,9,0,10,1
1667959497907,MATH 218,A00,098029,Li; Bo,10,0,10,0
1667959498335,MATH 220B,A00,098030,Novak; Jonathan I,13,0,15,2
1667959498758,MATH 221A,A00,098031,Ebenfelt; Peter F,13,0,15,2
1667959499184,MATH 231B,A00,098032,Zlatos; Andrej,12,0,15,3
1667959499628,MATH 240B,A00,098033,Ni; Lei,10,0,15,5
1667959500052,MATH 243,A00,098034,Jekel; David Andrew,10,0,10,0
1667959500480,MATH 245A,A00,098035,Nie; Jiawang,0,0,15,16
1667959500906,MATH 248,A00,098036,Bejenaru; Ioan,10,0,10,0
1667959501333,MATH 250B,A00,098037,Spolaor; Luca,14,0,15,1
1667959501771,MATH 258,A00,098038,Ni; Lei,10,0,10,0
1667959502193,MATH 264B,A00,098041,Rhoades; Brendon Patrick,12,0,15,3
1667959502624,MATH 268,A00,098042,Buss; Samuel R,10,0,10,0
1667959503053,MATH 269,A00,098043,Rhoades; Brendon Patrick,10,0,10,0
1667959503503,MATH 270B,A00,098044,Li; Bo,11,0,15,4
1667959503931,MATH 272B,A00,098045,Holst; Michael J,13,0,15,2
1667959504353,MATH 273A,A00,098046,Tian; Xiaochuan,12,0,15,3
1667959504786,MATH 275,A01,098048,Tian; Xiaochuan,6,0,10,4
1667959505209,MATH 278A,A00,098049,Holst; Michael J,8,0,10,2
1667959505631,MATH 278B,A00,098050,Cloninger; Alexander,10,0,10,0
1667959506055,MATH 278C,A00,098051,Nie; Jiawang,8,0,10,2
1667959506487,MATH 280B,A00,098052,Zheng; Tianyi,12,0,15,3
1667959506915,MATH 281B,A00,098053,Bradic; Jelena,4,0,15,11
1667959507348,MATH 282B,A00,098054,Arias-Castro; Ery,2,0,15,13
1667959507778,MATH 285,A00,098055,Fitzsimmons; Patrick J,0,0,15,17
1667959508210,MATH 287B,A00,098056,Arias-Castro; Ery,5,0,15,10
1667959508639,MATH 288,A00,098057,Agarwal; Pooja,9,0,10,1
1667959508639,MATH 288,B00,098058,Zhang; Danna,9,0,10,1
1667959508639,MATH 288,C00,098059,Williams; Ruth J,10,0,10,0
1667959509067,MATH 290B,A00,098060,Roberts; Justin Deritter,14,0,15,1
1667959509488,MATH 292,A00,098061,Belmont; Eva Kinoshita,10,0,10,0
1667959510019,MATH 295,A00,098062,Suk; Andrew Hoon,48,0,50,2
1667959510445,MATH 296,A00,098063,Novak; Jonathan I,20,0,20,0
1667959510877,MATH 297,001,098064,Gamst; Anthony Collins,9997,0,9999,2
1667960025936,COGS 205,A00,101395,Chiba; Andrea,19,0,20,1
1667960026368,COGS 210B,001,101404,Greene; Deanna Jacquelyn,9998,0,9999,1
1667960026368,COGS 210B,002,101417,Xia; Haijun,9999,0,9999,0
1667960026368,COGS 210B,003,101422,Nitz; Douglas A.,9999,0,9999,0
1667960026368,COGS 210B,004,101423,Hollan; James D.,9998,0,9999,1
1667960026368,COGS 210B,005,101424,Deak; Gedeon O.,9999,0,9999,0
1667960026368,COGS 210B,006,101425,Rossano; Federico,9999,0,9999,0
1667960026794,COGS 211B,A00,101427,Coulson; Seana M,9997,0,9999,2
1667960027222,COGS 220,A00,101428,Hollan; James D.,0,0,25,25
1667960027649,COGS 229,A00,101429,Dow; Steven P,18,0,25,7
1667960028074,COGS 230,A00,101430,Klemmer; Scott R,13,0,17,4
1667960028502,COGS 234,A00,101431,Xia; Haijun,7,0,25,18
1667960028926,COGS 260,A00,101432,Kiyonaga; Anastasia,20,0,25,5
1667960028926,COGS 260,B00,101433,Kirsh; David Joel,16,0,25,9
1667960029363,CSE 202,A00,102371,Impagliazzo; Russell,0,0,0,0
1667960029790,CSE 203B,A01,102373,Cheng; Chung Kuan,0,0,0,0
1667960030213,CSE 208,A00,102374,Micciancio; Daniele,0,0,0,0
1667960030634,CSE 209A,A00,112895,Impagliazzo; Russell,0,0,15,15
1667960031062,CSE 209B,A00,108005,Bellare; Mihir,0,0,0,0
1667960031485,CSE 210,A00,113163,Coblenz; Michael J,0,0,0,0
1667960031910,CSE 219,A00,106111,Dow; Steven P,0,0,20,20
1667960032338,CSE 221,A00,102376,Voelker; Geoffrey M.,0,0,0,0
1667960032765,CSE 224,A01,102378,Porter; George M,0,0,0,0
1667960033208,CSE 229A,A00,102379,Savage; Stefan,0,0,0,0
1667960033639,CSE 229C,A00,102380,Munyaka; Imani N. S.,0,0,0,0
1667960034067,CSE 232B,A00,102382,Deutsch; Alin Bernard,0,0,0,0
1667960034491,CSE 234,A01,112904,Kumar; Arun Kumar,0,0,0,0
1667960034919,CSE 237A,A00,102383,Rosing; Tajana Simunic,0,0,0,0
1667960035343,CSE 239A,A00,102384,Deutsch; Alin Bernard,0,0,0,0
1667960035776,CSE 239B,A00,102385,Polikarpova; Nadezhda,0,0,0,0
1667960036202,CSE 240A,A00,102386,Pannuto; Patrick William,0,0,0,0
1667960036634,CSE 240B,A00,102387,Zhao; Jishen,0,0,0,0
1667960037059,CSE 241A,A00,106406,Kang; Mingu,0,0,0,0
1667960037485,CSE 249B,A00,102388,Kahng; Andrew Byun,0,0,8,8
1667960037932,CSE 251B,A01,102392,Cottrell; Garrison W,0,0,0,0
1667960037932,CSE 251B,A02,102393,Cottrell; Garrison W,0,0,0,0
1667960038369,CSE 252B,A00,102394,Ochoa; Benjamin Lawrence,0,0,0,0
1667960038803,CSE 257,A01,102396,Gao; Sicun,0,0,0,0
1667960039227,CSE 272,A00,102397,Li; Tzumao,0,0,0,0
1667960039655,CSE 274,A00,111323,Chern; Albert Ren-Haur,0,0,0,0
1667960040086,CSE 282,A00,102398,Pevzner; Pavel Arkadjevich,0,0,0,0
1667960040522,CSE 284,A00,114175,Gymrek; Melissa Ann,0,0,0,0
1667960040951,CSE 290,A00,102399,Chandraker; Manmohan Krishna,0,0,0,0
1667960040951,CSE 290,B00,102400,Vaccaro; Kristen Marie,0,0,25,25
1667960040951,CSE 290,C00,102414,Pannuto; Patrick William,0,0,25,25
1667960040951,CSE 290,D00,102427,Pevzner; Pavel Arkadjevich,0,0,0,0
1667960040951,CSE 290,E00,102429,Zhao; Jishen,0,0,0,0
1667960040951,CSE 290,F00,102436,Tullsen; Dean Michael,0,0,0,0
1667960040951,CSE 290,G00,102440,Christensen; Henrik I,0,0,20,20
1667960041382,CSE 291,A00,102443,Su; Hao,0,0,0,0
1667960041382,CSE 291,B00,102448,Polikarpova; Nadezhda,0,0,0,0
1667960041382,CSE 291,C00,102453,Vaccaro; Kristen Marie,0,0,0,0
1667960041382,CSE 291,D00,111343,Savage; Stefan,0,0,0,0
1667960041382,CSE 291,E00,116474,Claffy; Kimberly Claire,0,0,0,0
1667960041382,CSE 291,F00,116479,Pasquale; Joseph,0,0,0,0
1667960041818,CSE 293,001,119111,Bafna; Vineet,9999,0,9999,0
1667960041818,CSE 293,002,119118,Bellare; Mihir,9999,0,9999,0
1667960041818,CSE 293,003,119122,Berg-Kirkpatrick; Taylor D,9999,0,9999,0
1667960041818,CSE 293,004,119135,Christensen; Henrik I,9999,0,9999,0
1667960041818,CSE 293,005,119142,Cottrell; Garrison W,9999,0,9999,0
1667960041818,CSE 293,006,119146,Deutsch; Alin Bernard,9999,0,9999,0
1667960041818,CSE 293,007,119159,Esmaeilzadeh; Hadi,9999,0,9999,0
1667960041818,CSE 293,008,119166,Freund; Yoav,9999,0,9999,0
1667960041818,CSE 293,009,119170,Griswold; William G.,9999,0,9999,0
1667960041818,CSE 293,010,119183,Gymrek; Melissa Ann,9999,0,9999,0
1667960041818,CSE 293,011,119190,Heninger; Nadia A,9999,0,9999,0
1667960041818,CSE 293,012,119230,Impagliazzo; Russell,9999,0,9999,0
1667960041818,CSE 293,013,119232,Jhala; Ranjit,9999,0,9999,0
1667960041818,CSE 293,014,119233,Kahng; Andrew Byun,9999,0,9999,0
1667960041818,CSE 293,015,119298,Kane; Daniel Mertz,9999,0,9999,0
1667960041818,CSE 293,016,119299,Kriegman; David J,9999,0,9999,0
1667960041818,CSE 293,017,119300,Kumar; Arun Kumar,9999,0,9999,0
1667960041818,CSE 293,018,119301,Lerner; Sorin,9999,0,9999,0
1667960041818,CSE 293,019,119302,Lovett; Shachar,9999,0,9999,0
1667960041818,CSE 293,020,119303,McAuley; Julian John,9999,0,9999,0
1667960041818,CSE 293,021,119304,Micciancio; Daniele,9999,0,9999,0
1667960041818,CSE 293,022,119367,Orailoglu; Alex,9999,0,9999,0
1667960041818,CSE 293,023,119382,Paturi; Ramamohan,9999,0,9999,0
1667960041818,CSE 293,024,119404,Polikarpova; Nadezhda,9999,0,9999,0
1667960041818,CSE 293,025,119406,Politz; Joseph Gibbs,9999,0,9999,0
1667960041818,CSE 293,026,119411,Porter; George M,9999,0,9999,0
1667960041818,CSE 293,027,119414,Porter; Leonard Emerson,9999,0,9999,0
1667960041818,CSE 293,028,119416,Ramamoorthi; Ravi,9999,0,9999,0
1667960041818,CSE 293,029,119417,Sahoo; Debashis,9999,0,9999,0
1667960041818,CSE 293,030,119420,Saul; Lawrence,9999,0,9999,0
1667960041818,CSE 293,031,119421,Savage; Stefan,9999,0,9999,0
1667960041818,CSE 293,032,119425,Schulze; Jurgen P.,9999,0,9999,0
1667960041818,CSE 293,033,119426,Snoeren; Alex C.,9999,0,9999,0
1667960041818,CSE 293,034,119428,Shang; Jingbo,9999,0,9999,0
1667960041818,CSE 293,035,119430,Stefan; Deian,9999,0,9999,0
1667960041818,CSE 293,036,119431,Su; Hao,9999,0,9999,0
1667960041818,CSE 293,037,119433,Swanson; Steven James,9999,0,9999,0
1667960041818,CSE 293,038,119435,Tullsen; Dean Michael,9999,0,9999,0
1667960041818,CSE 293,039,119483,Voelker; Geoffrey M.,9999,0,9999,0
1667960041818,CSE 293,040,119537,Zhao; Jishen,9999,0,9999,0
1667960041818,CSE 293,041,119538,Zhou; Yuan-Yuan,9999,0,9999,0
1667960041818,CSE 293,042,119539,Gao; Sicun,9999,0,9999,0
1667960041818,CSE 293,043,119540,Weibel; Nadir,9999,0,9999,0
1667960041818,CSE 293,044,119541,Gupta; Rajesh K.,9999,0,9999,0
1667960042256,CSE 294,A00,102459,Voelker; Geoffrey M.,0,0,0,0
1667960042256,CSE 294,B00,111322,Orailoglu; Alex,0,0,0,0
1667960042681,DSE 201,A00,096914,Deutsch; Alin Bernard,30,0,30,0
1667960043107,DSE 210,A00,096915,Dasgupta; Sanjoy,30,0,30,0
1667960043537,DSE 260A,A00,096916,Altintas De Callaf; Ilkay,30,0,30,0
1667960043982,ECE 200,001,103586,Antipa; Nicholas A,9999,0,9999,0
1667960043982,ECE 200,002,103587,Atanasov; Nikolay A.,9999,0,9999,0
1667960043982,ECE 200,003,103588,Bharadia; Dinesh,9999,0,9999,0
1667960043982,ECE 200,004,103589,Cheng; Chung Kuan,9999,0,9999,0
1667960043982,ECE 200,005,103590,Cosman; Pamela C.,9999,0,9999,0
1667960043982,ECE 200,006,103591,Dayeh; Shadi Ahmad,9999,0,9999,0
1667960043982,ECE 200,007,103592,Fainman; Yeshaiahu,9999,0,9999,0
1667960043982,ECE 200,008,103593,Ford; Joseph Earl,9999,0,9999,0
1667960043982,ECE 200,009,103594,Franceschetti; Massimo,9999,0,9999,0
1667960043982,ECE 200,010,103595,Fullerton; Eric E,9999,0,9999,0
1667960043982,ECE 200,011,103596,Galton; Ian A,9999,0,9999,0
1667960043982,ECE 200,012,103597,Gilja; Vikash,9999,0,9999,0
1667960043982,ECE 200,013,103598,Hall; Drew A.,9999,0,9999,0
1667960043982,ECE 200,014,103599,Hsueh; Tzu-Chien,9999,0,9999,0
1667960043982,ECE 200,015,103600,Javidi; Tara,9999,0,9999,0
1667960043982,ECE 200,016,103601,Kahng; Andrew Byun,9999,0,9999,0
1667960043982,ECE 200,017,103602,Kim; Young-Han,9999,0,9999,0
1667960043982,ECE 200,018,103603,Koushanfar; Farinaz,9999,0,9999,0
1667960043982,ECE 200,019,103604,Kuzum; Duygu,9999,0,9999,0
1667960043982,ECE 200,020,103605,Le; Hanh-Phuc,9999,0,9999,0
1667960043982,ECE 200,021,103606,Lin; Bill,9999,0,9999,0
1667960043982,ECE 200,022,103607,Liu; Zhaowei,9998,0,9999,1
1667960043982,ECE 200,023,103608,Lo; Yu-Hwa,9999,0,9999,0
1667960043982,ECE 200,024,103609,Lomakin; Vitaliy,9999,0,9999,0
1667960043982,ECE 200,025,103610,Mercier; Patrick Philip,9999,0,9999,0
1667960043982,ECE 200,026,103611,Meyer; Florian,9999,0,9999,0
1667960043982,ECE 200,027,103612,Milstein; Laurence B.,9999,0,9999,0
1667960043982,ECE 200,028,103613,Mir Arabbaygi; Siavash,9999,0,9999,0
1667960043982,ECE 200,029,103614,Mookherjea; Shayan,9999,0,9999,0
1667960043982,ECE 200,030,103615,Morris; Karcher William,9999,0,9999,0
1667960043982,ECE 200,031,103616,Ng; Tse Nga,9999,0,9999,0
1667960043982,ECE 200,032,103617,Nguyen; Truong Quang,9999,0,9999,0
1667960043982,ECE 200,033,103618,Nomura; Kenji,9999,0,9999,0
1667960043982,ECE 200,034,103619,Orlitsky; Alon,9999,0,9999,0
1667960043982,ECE 200,035,103620,Pal; Piya,9999,0,9999,0
1667960043982,ECE 200,036,103621,Papen; George C.,9999,0,9999,0
1667960043982,ECE 200,037,103622,Radic; Stojan,9999,0,9999,0
1667960043982,ECE 200,038,103623,Rao; Bhaskar D.,9999,0,9999,0
1667960043982,ECE 200,039,103624,Rao; Ramesh R,9999,0,9999,0
1667960043982,ECE 200,040,103625,Rebeiz; Gabriel,9999,0,9999,0
1667960043982,ECE 200,041,103626,Sanford; John R,9999,0,9999,0
1667960043982,ECE 200,042,103627,Siegel; Paul H.,9999,0,9999,0
1667960043982,ECE 200,043,103628,Sievenpiper; Daniel F.,9999,0,9999,0
1667960043982,ECE 200,044,103629,Sworder; David D.,9999,0,9999,0
1667960043982,ECE 200,045,103630,Taur; Yuan,9999,0,9999,0
1667960043982,ECE 200,046,103631,Touri; Behrouz,9999,0,9999,0
1667960043982,ECE 200,047,103632,Trivedi; Mohan M.,9999,0,9999,0
1667960043982,ECE 200,048,103633,Vasconcelos; Nuno,9999,0,9999,0
1667960043982,ECE 200,049,103634,Wang; Xiaolong,9999,0,9999,0
1667960043982,ECE 200,050,103635,Xie; Pengtao,9999,0,9999,0
1667960043982,ECE 200,051,103636,Yip; Michael,9999,0,9999,0
1667960043982,ECE 200,052,103637,Zeger; Kenneth A.,999,0,999,0
1667960043982,ECE 200,053,103638,Zhang; Xinyu,9999,0,9999,0
1667960043982,ECE 200,054,103639,Turakhia; Yatish Girish,9999,0,9999,0
1667960043982,ECE 200,055,103640,Kang; Mingu,9999,0,9999,0
1667960043982,ECE 200,056,103641,Shi; Yuanyuan,9999,0,9999,0
1667960043982,ECE 200,057,103642,Wang; Edward Jay,9999,0,9999,0
1667960043982,ECE 200,058,103643,Zheng; Yang,9999,0,9999,0
1667960044404,ECE 202,A00,103644,Kuzum; Duygu,0,0,0,0
1667960044834,ECE 212BN,A00,103646,Ng; Tse Nga,0,0,0,0
1667960045360,ECE 221,A00,111493,Staff,0,0,0,0
1667960045784,ECE 222B,A00,103647,Lomakin; Vitaliy,0,0,0,0
1667960046209,ECE 230B,A00,103648,Taur; Yuan,0,0,0,0
1667960046640,ECE 238B,A00,103649,Garay; Javier,0,0,0,0
1667960047068,ECE 240B,A00,112900,Fainman; Yeshaiahu,0,0,0,0
1667960047497,ECE 247A,A00,103650,Jokerst; Jesse Vincent,0,0,0,0
1667960047933,ECE 247B,A00,103651,Wang; Joseph,0,0,0,0
1667960048362,ECE 250,A00,103652,Siegel; Paul H.,0,0,0,0
1667960048795,ECE 251A,A00,103654,Rao; Bhaskar D.,0,0,0,0
1667960049222,ECE 257B,A00,103655,Bharadia; Dinesh,0,0,0,0
1667960049648,ECE 258A,A00,103656,Milstein; Laurence B.,0,0,0,0
1667960050202,ECE 260B,A00,103658,Kang; Mingu,0,0,0,0
1667960050631,ECE 264A,A00,103659,Galton; Ian A,0,0,0,0
1667960051054,ECE 265A,A00,103661,Gudem; Prasad S.S.,0,0,0,0
1667960051482,ECE 265D,A00,103662,Gudem; Prasad S.S.,0,0,0,0
1667960051910,ECE 268,A00,103663,Koushanfar; Farinaz,0,0,0,0
1667960052335,ECE 269,A01,103665,Pal; Piya,0,0,0,0
1667960052758,ECE 271B,A00,103666,Vasconcelos; Manuela,0,0,0,0
1667960053183,ECE 276A,A00,103667,Atanasov; Nikolay A.,0,0,0,0
1667960053611,ECE 277,A00,103668,An; Cheolhong,0,0,0,0
1667960054039,ECE 279,A00,117947,Hall; Drew A.,0,0,0,0
1667960054889,ECE 283,A00,103670,Hsueh; Tzu-Chien,0,0,0,0
1667960055319,ECE 284,A00,103671,Turakhia; Yatish Girish,0,0,0,0
1667960055758,ECE 285,A00,103672,Zheng; Yang,0,0,0,0
1667960055758,ECE 285,B00,103673,Sworder; David D.,0,0,0,0
1667960056187,ECE 287,A00,103676,Javidi; Tara,0,0,0,0
1667960056622,MATH 200B,A00,098023,Salehi Golsefidy; Alireza,14,0,15,1
1667960057049,MATH 202B,A00,098024,Rhoades; Brendon Patrick,12,0,15,3
1667960057486,MATH 203B,A00,098025,Oprea; Dragos N.,13,0,15,2
1667960057909,MATH 204B,A00,098026,Sorensen; Claus M,15,0,15,0
1667960058335,MATH 208,A00,098027,Izadi; Elham,7,0,10,3
1667960058760,MATH 209,A00,098028,Pollack; Aaron,10,0,10,0
1667960059198,MATH 211A,A00,112919,Rogalski; Daniel,9,0,10,1
1667960059627,MATH 211B,A00,112920,Seward; Brandon M.,9,0,10,1
1667960060064,MATH 218,A00,098029,Li; Bo,10,0,10,0
1667960060490,MATH 220B,A00,098030,Novak; Jonathan I,13,0,15,2
1667960060918,MATH 221A,A00,098031,Ebenfelt; Peter F,13,0,15,2
1667960061341,MATH 231B,A00,098032,Zlatos; Andrej,12,0,15,3
1667960061772,MATH 240B,A00,098033,Ni; Lei,10,0,15,5
1667960062198,MATH 243,A00,098034,Jekel; David Andrew,10,0,10,0
1667960062622,MATH 245A,A00,098035,Nie; Jiawang,0,0,15,16
1667960063047,MATH 248,A00,098036,Bejenaru; Ioan,10,0,10,0
1667960063471,MATH 250B,A00,098037,Spolaor; Luca,14,0,15,1
1667960063896,MATH 258,A00,098038,Ni; Lei,10,0,10,0
1667960064319,MATH 264B,A00,098041,Rhoades; Brendon Patrick,12,0,15,3
1667960064747,MATH 268,A00,098042,Buss; Samuel R,10,0,10,0
1667960065172,MATH 269,A00,098043,Rhoades; Brendon Patrick,10,0,10,0
1667960065598,MATH 270B,A00,098044,Li; Bo,11,0,15,4
1667960066024,MATH 272B,A00,098045,Holst; Michael J,13,0,15,2
1667960066450,MATH 273A,A00,098046,Tian; Xiaochuan,12,0,15,3
1667960066886,MATH 275,A01,098048,Tian; Xiaochuan,6,0,10,4
1667960067315,MATH 278A,A00,098049,Holst; Michael J,8,0,10,2
1667960067753,MATH 278B,A00,098050,Cloninger; Alexander,10,0,10,0
1667960068200,MATH 278C,A00,098051,Nie; Jiawang,8,0,10,2
1667960068629,MATH 280B,A00,098052,Zheng; Tianyi,12,0,15,3
1667960069055,MATH 281B,A00,098053,Bradic; Jelena,4,0,15,11
1667960069478,MATH 282B,A00,098054,Arias-Castro; Ery,2,0,15,13
1667960069910,MATH 285,A00,098055,Fitzsimmons; Patrick J,0,0,15,17
1667960070334,MATH 287B,A00,098056,Arias-Castro; Ery,5,0,15,10
1667960070762,MATH 288,A00,098057,Agarwal; Pooja,9,0,10,1
1667960070762,MATH 288,B00,098058,Zhang; Danna,9,0,10,1
1667960070762,MATH 288,C00,098059,Williams; Ruth J,10,0,10,0
1667960071186,MATH 290B,A00,098060,Roberts; Justin Deritter,14,0,15,1
1667960071612,MATH 292,A00,098061,Belmont; Eva Kinoshita,10,0,10,0
1667960072044,MATH 295,A00,098062,Suk; Andrew Hoon,48,0,50,2
1667960072474,MATH 296,A00,098063,Novak; Jonathan I,20,0,20,0
1667960072898,MATH 297,001,098064,Gamst; Anthony Collins,9997,0,9999,2
1667960575219,COGS 205,A00,101395,Chiba; Andrea,19,0,20,1
1667960575649,COGS 210B,001,101404,Greene; Deanna Jacquelyn,9998,0,9999,1
1667960575649,COGS 210B,002,101417,Xia; Haijun,9999,0,9999,0
1667960575649,COGS 210B,003,101422,Nitz; Douglas A.,9999,0,9999,0
1667960575649,COGS 210B,004,101423,Hollan; James D.,9998,0,9999,1
1667960575649,COGS 210B,005,101424,Deak; Gedeon O.,9999,0,9999,0
1667960575649,COGS 210B,006,101425,Rossano; Federico,9999,0,9999,0
1667960576074,COGS 211B,A00,101427,Coulson; Seana M,9997,0,9999,2
1667960576499,COGS 220,A00,101428,Hollan; James D.,0,0,25,25
1667960576937,COGS 229,A00,101429,Dow; Steven P,18,0,25,7
1667960577372,COGS 230,A00,101430,Klemmer; Scott R,13,0,17,4
1667960577798,COGS 234,A00,101431,Xia; Haijun,7,0,25,18
1667960578232,COGS 260,A00,101432,Kiyonaga; Anastasia,20,0,25,5
1667960578232,COGS 260,B00,101433,Kirsh; David Joel,16,0,25,9
1667960578657,CSE 202,A00,102371,Impagliazzo; Russell,0,0,0,0
1667960579086,CSE 203B,A01,102373,Cheng; Chung Kuan,0,0,0,0
1667960579510,CSE 208,A00,102374,Micciancio; Daniele,0,0,0,0
1667960579943,CSE 209A,A00,112895,Impagliazzo; Russell,0,0,15,15
1667960580371,CSE 209B,A00,108005,Bellare; Mihir,0,0,0,0
1667960580792,CSE 210,A00,113163,Coblenz; Michael J,0,0,0,0
1667960581225,CSE 219,A00,106111,Dow; Steven P,0,0,20,20
1667960581649,CSE 221,A00,102376,Voelker; Geoffrey M.,0,0,0,0
1667960582077,CSE 224,A01,102378,Porter; George M,0,0,0,0
1667960582501,CSE 229A,A00,102379,Savage; Stefan,0,0,0,0
1667960582928,CSE 229C,A00,102380,Munyaka; Imani N. S.,0,0,0,0
1667960583358,CSE 232B,A00,102382,Deutsch; Alin Bernard,0,0,0,0
1667960583781,CSE 234,A01,112904,Kumar; Arun Kumar,0,0,0,0
1667960584206,CSE 237A,A00,102383,Rosing; Tajana Simunic,0,0,0,0
1667960584627,CSE 239A,A00,102384,Deutsch; Alin Bernard,0,0,0,0
1667960585066,CSE 239B,A00,102385,Polikarpova; Nadezhda,0,0,0,0
1667960585492,CSE 240A,A00,102386,Pannuto; Patrick William,0,0,0,0
1667960585927,CSE 240B,A00,102387,Zhao; Jishen,0,0,0,0
1667960586356,CSE 241A,A00,106406,Kang; Mingu,0,0,0,0
1667960586780,CSE 249B,A00,102388,Kahng; Andrew Byun,0,0,8,8
1667960587211,CSE 251B,A01,102392,Cottrell; Garrison W,0,0,0,0
1667960587211,CSE 251B,A02,102393,Cottrell; Garrison W,0,0,0,0
1667960587644,CSE 252B,A00,102394,Ochoa; Benjamin Lawrence,0,0,0,0
1667960588072,CSE 257,A01,102396,Gao; Sicun,0,0,0,0
1667960588507,CSE 272,A00,102397,Li; Tzumao,0,0,0,0
1667960588930,CSE 274,A00,111323,Chern; Albert Ren-Haur,0,0,0,0
1667960589357,CSE 282,A00,102398,Pevzner; Pavel Arkadjevich,0,0,0,0
1667960589782,CSE 284,A00,114175,Gymrek; Melissa Ann,0,0,0,0
1667960590222,CSE 290,A00,102399,Chandraker; Manmohan Krishna,0,0,0,0
1667960590222,CSE 290,B00,102400,Vaccaro; Kristen Marie,0,0,25,25
1667960590222,CSE 290,C00,102414,Pannuto; Patrick William,0,0,25,25
1667960590222,CSE 290,D00,102427,Pevzner; Pavel Arkadjevich,0,0,0,0
1667960590222,CSE 290,E00,102429,Zhao; Jishen,0,0,0,0
1667960590222,CSE 290,F00,102436,Tullsen; Dean Michael,0,0,0,0
1667960590222,CSE 290,G00,102440,Christensen; Henrik I,0,0,20,20
1667960590652,CSE 291,A00,102443,Su; Hao,0,0,0,0
1667960590652,CSE 291,B00,102448,Polikarpova; Nadezhda,0,0,0,0
1667960590652,CSE 291,C00,102453,Vaccaro; Kristen Marie,0,0,0,0
1667960590652,CSE 291,D00,111343,Savage; Stefan,0,0,0,0
1667960590652,CSE 291,E00,116474,Claffy; Kimberly Claire,0,0,0,0
1667960590652,CSE 291,F00,116479,Pasquale; Joseph,0,0,0,0
1667960591087,CSE 293,001,119111,Bafna; Vineet,9999,0,9999,0
1667960591087,CSE 293,002,119118,Bellare; Mihir,9999,0,9999,0
1667960591087,CSE 293,003,119122,Berg-Kirkpatrick; Taylor D,9999,0,9999,0
1667960591087,CSE 293,004,119135,Christensen; Henrik I,9999,0,9999,0
1667960591087,CSE 293,005,119142,Cottrell; Garrison W,9999,0,9999,0
1667960591087,CSE 293,006,119146,Deutsch; Alin Bernard,9999,0,9999,0
1667960591087,CSE 293,007,119159,Esmaeilzadeh; Hadi,9999,0,9999,0
1667960591087,CSE 293,008,119166,Freund; Yoav,9999,0,9999,0
1667960591087,CSE 293,009,119170,Griswold; William G.,9999,0,9999,0
1667960591087,CSE 293,010,119183,Gymrek; Melissa Ann,9999,0,9999,0
1667960591087,CSE 293,011,119190,Heninger; Nadia A,9999,0,9999,0
1667960591087,CSE 293,012,119230,Impagliazzo; Russell,9999,0,9999,0
1667960591087,CSE 293,013,119232,Jhala; Ranjit,9999,0,9999,0
1667960591087,CSE 293,014,119233,Kahng; Andrew Byun,9999,0,9999,0
1667960591087,CSE 293,015,119298,Kane; Daniel Mertz,9999,0,9999,0
1667960591087,CSE 293,016,119299,Kriegman; David J,9999,0,9999,0
1667960591087,CSE 293,017,119300,Kumar; Arun Kumar,9999,0,9999,0
1667960591087,CSE 293,018,119301,Lerner; Sorin,9999,0,9999,0
1667960591087,CSE 293,019,119302,Lovett; Shachar,9999,0,9999,0
1667960591087,CSE 293,020,119303,McAuley; Julian John,9999,0,9999,0
1667960591087,CSE 293,021,119304,Micciancio; Daniele,9999,0,9999,0
1667960591087,CSE 293,022,119367,Orailoglu; Alex,9999,0,9999,0
1667960591087,CSE 293,023,119382,Paturi; Ramamohan,9999,0,9999,0
1667960591087,CSE 293,024,119404,Polikarpova; Nadezhda,9999,0,9999,0
1667960591087,CSE 293,025,119406,Politz; Joseph Gibbs,9999,0,9999,0
1667960591087,CSE 293,026,119411,Porter; George M,9999,0,9999,0
1667960591087,CSE 293,027,119414,Porter; Leonard Emerson,9999,0,9999,0
1667960591087,CSE 293,028,119416,Ramamoorthi; Ravi,9999,0,9999,0
1667960591087,CSE 293,029,119417,Sahoo; Debashis,9999,0,9999,0
1667960591087,CSE 293,030,119420,Saul; Lawrence,9999,0,9999,0
1667960591087,CSE 293,031,119421,Savage; Stefan,9999,0,9999,0
1667960591087,CSE 293,032,119425,Schulze; Jurgen P.,9999,0,9999,0
1667960591087,CSE 293,033,119426,Snoeren; Alex C.,9999,0,9999,0
1667960591087,CSE 293,034,119428,Shang; Jingbo,9999,0,9999,0
1667960591087,CSE 293,035,119430,Stefan; Deian,9999,0,9999,0
1667960591087,CSE 293,036,119431,Su; Hao,9999,0,9999,0
1667960591087,CSE 293,037,119433,Swanson; Steven James,9999,0,9999,0
1667960591087,CSE 293,038,119435,Tullsen; Dean Michael,9999,0,9999,0
1667960591087,CSE 293,039,119483,Voelker; Geoffrey M.,9999,0,9999,0
1667960591087,CSE 293,040,119537,Zhao; Jishen,9999,0,9999,0
1667960591087,CSE 293,041,119538,Zhou; Yuan-Yuan,9999,0,9999,0
1667960591087,CSE 293,042,119539,Gao; Sicun,9999,0,9999,0
1667960591087,CSE 293,043,119540,Weibel; Nadir,9999,0,9999,0
1667960591087,CSE 293,044,119541,Gupta; Rajesh K.,9999,0,9999,0
1667960591516,CSE 294,A00,102459,Voelker; Geoffrey M.,0,0,0,0
1667960591516,CSE 294,B00,111322,Orailoglu; Alex,0,0,0,0
1667960591944,DSE 201,A00,096914,Deutsch; Alin Bernard,30,0,30,0
1667960592378,DSE 210,A00,096915,Dasgupta; Sanjoy,30,0,30,0
1667960592807,DSE 260A,A00,096916,Altintas De Callaf; Ilkay,30,0,30,0
1667960593278,ECE 200,001,103586,Antipa; Nicholas A,9999,0,9999,0
1667960593278,ECE 200,002,103587,Atanasov; Nikolay A.,9999,0,9999,0
1667960593278,ECE 200,003,103588,Bharadia; Dinesh,9999,0,9999,0
1667960593278,ECE 200,004,103589,Cheng; Chung Kuan,9999,0,9999,0
1667960593278,ECE 200,005,103590,Cosman; Pamela C.,9999,0,9999,0
1667960593278,ECE 200,006,103591,Dayeh; Shadi Ahmad,9999,0,9999,0
1667960593278,ECE 200,007,103592,Fainman; Yeshaiahu,9999,0,9999,0
1667960593278,ECE 200,008,103593,Ford; Joseph Earl,9999,0,9999,0
1667960593278,ECE 200,009,103594,Franceschetti; Massimo,9999,0,9999,0
1667960593278,ECE 200,010,103595,Fullerton; Eric E,9999,0,9999,0
1667960593278,ECE 200,011,103596,Galton; Ian A,9999,0,9999,0
1667960593278,ECE 200,012,103597,Gilja; Vikash,9999,0,9999,0
1667960593278,ECE 200,013,103598,Hall; Drew A.,9999,0,9999,0
1667960593278,ECE 200,014,103599,Hsueh; Tzu-Chien,9999,0,9999,0
1667960593278,ECE 200,015,103600,Javidi; Tara,9999,0,9999,0
1667960593278,ECE 200,016,103601,Kahng; Andrew Byun,9999,0,9999,0
1667960593278,ECE 200,017,103602,Kim; Young-Han,9999,0,9999,0
1667960593278,ECE 200,018,103603,Koushanfar; Farinaz,9999,0,9999,0
1667960593278,ECE 200,019,103604,Kuzum; Duygu,9999,0,9999,0
1667960593278,ECE 200,020,103605,Le; Hanh-Phuc,9999,0,9999,0
1667960593278,ECE 200,021,103606,Lin; Bill,9999,0,9999,0
1667960593278,ECE 200,022,103607,Liu; Zhaowei,9998,0,9999,1
1667960593278,ECE 200,023,103608,Lo; Yu-Hwa,9999,0,9999,0
1667960593278,ECE 200,024,103609,Lomakin; Vitaliy,9999,0,9999,0
1667960593278,ECE 200,025,103610,Mercier; Patrick Philip,9999,0,9999,0
1667960593278,ECE 200,026,103611,Meyer; Florian,9999,0,9999,0
1667960593278,ECE 200,027,103612,Milstein; Laurence B.,9999,0,9999,0
1667960593278,ECE 200,028,103613,Mir Arabbaygi; Siavash,9999,0,9999,0
1667960593278,ECE 200,029,103614,Mookherjea; Shayan,9999,0,9999,0
1667960593278,ECE 200,030,103615,Morris; Karcher William,9999,0,9999,0
1667960593278,ECE 200,031,103616,Ng; Tse Nga,9999,0,9999,0
1667960593278,ECE 200,032,103617,Nguyen; Truong Quang,9999,0,9999,0
1667960593278,ECE 200,033,103618,Nomura; Kenji,9999,0,9999,0
1667960593278,ECE 200,034,103619,Orlitsky; Alon,9999,0,9999,0
1667960593278,ECE 200,035,103620,Pal; Piya,9999,0,9999,0
1667960593278,ECE 200,036,103621,Papen; George C.,9999,0,9999,0
1667960593278,ECE 200,037,103622,Radic; Stojan,9999,0,9999,0
1667960593278,ECE 200,038,103623,Rao; Bhaskar D.,9999,0,9999,0
1667960593278,ECE 200,039,103624,Rao; Ramesh R,9999,0,9999,0
1667960593278,ECE 200,040,103625,Rebeiz; Gabriel,9999,0,9999,0
1667960593278,ECE 200,041,103626,Sanford; John R,9999,0,9999,0
1667960593278,ECE 200,042,103627,Siegel; Paul H.,9999,0,9999,0
1667960593278,ECE 200,043,103628,Sievenpiper; Daniel F.,9999,0,9999,0
1667960593278,ECE 200,044,103629,Sworder; David D.,9999,0,9999,0
1667960593278,ECE 200,045,103630,Taur; Yuan,9999,0,9999,0
1667960593278,ECE 200,046,103631,Touri; Behrouz,9999,0,9999,0
1667960593278,ECE 200,047,103632,Trivedi; Mohan M.,9999,0,9999,0
1667960593278,ECE 200,048,103633,Vasconcelos; Nuno,9999,0,9999,0
1667960593278,ECE 200,049,103634,Wang; Xiaolong,9999,0,9999,0
1667960593278,ECE 200,050,103635,Xie; Pengtao,9999,0,9999,0
1667960593278,ECE 200,051,103636,Yip; Michael,9999,0,9999,0
1667960593278,ECE 200,052,103637,Zeger; Kenneth A.,999,0,999,0
1667960593278,ECE 200,053,103638,Zhang; Xinyu,9999,0,9999,0
1667960593278,ECE 200,054,103639,Turakhia; Yatish Girish,9999,0,9999,0
1667960593278,ECE 200,055,103640,Kang; Mingu,9999,0,9999,0
1667960593278,ECE 200,056,103641,Shi; Yuanyuan,9999,0,9999,0
1667960593278,ECE 200,057,103642,Wang; Edward Jay,9999,0,9999,0
1667960593278,ECE 200,058,103643,Zheng; Yang,9999,0,9999,0
1667960593705,ECE 202,A00,103644,Kuzum; Duygu,0,0,0,0
1667960594134,ECE 212BN,A00,103646,Ng; Tse Nga,0,0,0,0
1667960594562,ECE 221,A00,111493,Staff,0,0,0,0
1667960594993,ECE 222B,A00,103647,Lomakin; Vitaliy,0,0,0,0
1667960595420,ECE 230B,A00,103648,Taur; Yuan,0,0,0,0
1667960595845,ECE 238B,A00,103649,Garay; Javier,0,0,0,0
1667960596268,ECE 240B,A00,112900,Fainman; Yeshaiahu,0,0,0,0
1667960596702,ECE 247A,A00,103650,Jokerst; Jesse Vincent,0,0,0,0
1667960597134,ECE 247B,A00,103651,Wang; Joseph,0,0,0,0
1667960597558,ECE 250,A00,103652,Siegel; Paul H.,0,0,0,0
1667960597989,ECE 251A,A00,103654,Rao; Bhaskar D.,0,0,0,0
1667960598417,ECE 257B,A00,103655,Bharadia; Dinesh,0,0,0,0
1667960598843,ECE 258A,A00,103656,Milstein; Laurence B.,0,0,0,0
1667960599280,ECE 260B,A00,103658,Kang; Mingu,0,0,0,0
1667960599704,ECE 264A,A00,103659,Galton; Ian A,0,0,0,0
1667960600136,ECE 265A,A00,103661,Gudem; Prasad S.S.,0,0,0,0
1667960600560,ECE 265D,A00,103662,Gudem; Prasad S.S.,0,0,0,0
1667960600987,ECE 268,A00,103663,Koushanfar; Farinaz,0,0,0,0
1667960601418,ECE 269,A01,103665,Pal; Piya,0,0,0,0
1667960601851,ECE 271B,A00,103666,Vasconcelos; Manuela,0,0,0,0
1667960602278,ECE 276A,A00,103667,Atanasov; Nikolay A.,0,0,0,0
1667960602704,ECE 277,A00,103668,An; Cheolhong,0,0,0,0
1667960603127,ECE 279,A00,117947,Hall; Drew A.,0,0,0,0
1667960603988,ECE 283,A00,103670,Hsueh; Tzu-Chien,0,0,0,0
1667960604426,ECE 284,A00,103671,Turakhia; Yatish Girish,0,0,0,0
1667960604863,ECE 285,A00,103672,Zheng; Yang,0,0,0,0
1667960604863,ECE 285,B00,103673,Sworder; David D.,0,0,0,0
1667960605306,ECE 287,A00,103676,Javidi; Tara,0,0,0,0
1667960605739,MATH 200B,A00,098023,Salehi Golsefidy; Alireza,14,0,15,1
1667960606178,MATH 202B,A00,098024,Rhoades; Brendon Patrick,12,0,15,3
1667960606613,MATH 203B,A00,098025,Oprea; Dragos N.,13,0,15,2
1667960607041,MATH 204B,A00,098026,Sorensen; Claus M,15,0,15,0
1667960607467,MATH 208,A00,098027,Izadi; Elham,7,0,10,3
1667960607905,MATH 209,A00,098028,Pollack; Aaron,10,0,10,0
1667960608329,MATH 211A,A00,112919,Rogalski; Daniel,9,0,10,1
1667960608774,MATH 211B,A00,112920,Seward; Brandon M.,9,0,10,1
1667960609226,MATH 218,A00,098029,Li; Bo,10,0,10,0
1667960609677,MATH 220B,A00,098030,Novak; Jonathan I,13,0,15,2
1667960610102,MATH 221A,A00,098031,Ebenfelt; Peter F,13,0,15,2
1667960610538,MATH 231B,A00,098032,Zlatos; Andrej,12,0,15,3
1667960610965,MATH 240B,A00,098033,Ni; Lei,10,0,15,5
1667960611492,MATH 243,A00,098034,Jekel; David Andrew,10,0,10,0
1667960611924,MATH 245A,A00,098035,Nie; Jiawang,0,0,15,16
1667960612351,MATH 248,A00,098036,Bejenaru; Ioan,10,0,10,0
1667960612780,MATH 250B,A00,098037,Spolaor; Luca,14,0,15,1
1667960613212,MATH 258,A00,098038,Ni; Lei,10,0,10,0
1667960613653,MATH 264B,A00,098041,Rhoades; Brendon Patrick,12,0,15,3
1667960614080,MATH 268,A00,098042,Buss; Samuel R,10,0,10,0
1667960614506,MATH 269,A00,098043,Rhoades; Brendon Patrick,10,0,10,0
1667960614966,MATH 270B,A00,098044,Li; Bo,11,0,15,4
1667960615402,MATH 272B,A00,098045,Holst; Michael J,13,0,15,2
1667960615833,MATH 273A,A00,098046,Tian; Xiaochuan,12,0,15,3
1667960616261,MATH 275,A01,098048,Tian; Xiaochuan,6,0,10,4
1667960616688,MATH 278A,A00,098049,Holst; Michael J,8,0,10,2
1667960617116,MATH 278B,A00,098050,Cloninger; Alexander,10,0,10,0
1667960617541,MATH 278C,A00,098051,Nie; Jiawang,8,0,10,2
1667960617974,MATH 280B,A00,098052,Zheng; Tianyi,12,0,15,3
1667960618418,MATH 281B,A00,098053,Bradic; Jelena,4,0,15,11
1667960618861,MATH 282B,A00,098054,Arias-Castro; Ery,2,0,15,13
1667960619287,MATH 285,A00,098055,Fitzsimmons; Patrick J,0,0,15,17
1667960619712,MATH 287B,A00,098056,Arias-Castro; Ery,5,0,15,10
1667960620137,MATH 288,A00,098057,Agarwal; Pooja,9,0,10,1
1667960620137,MATH 288,B00,098058,Zhang; Danna,9,0,10,1
1667960620137,MATH 288,C00,098059,Williams; Ruth J,10,0,10,0
1667960620567,MATH 290B,A00,098060,Roberts; Justin Deritter,14,0,15,1
1667960620993,MATH 292,A00,098061,Belmont; Eva Kinoshita,10,0,10,0
1667960621429,MATH 295,A00,098062,Suk; Andrew Hoon,48,0,50,2
1667960621876,MATH 296,A00,098063,Novak; Jonathan I,20,0,20,0
1667960622301,MATH 297,001,098064,Gamst; Anthony Collins,9997,0,9999,2
1667961124896,COGS 205,A00,101395,Chiba; Andrea,19,0,20,1
1667961125323,COGS 210B,001,101404,Greene; Deanna Jacquelyn,9998,0,9999,1
1667961125323,COGS 210B,002,101417,Xia; Haijun,9999,0,9999,0
1667961125323,COGS 210B,003,101422,Nitz; Douglas A.,9999,0,9999,0
1667961125323,COGS 210B,004,101423,Hollan; James D.,9998,0,9999,1
1667961125323,COGS 210B,005,101424,Deak; Gedeon O.,9999,0,9999,0
1667961125323,COGS 210B,006,101425,Rossano; Federico,9999,0,9999,0
1667961125753,COGS 211B,A00,101427,Coulson; Seana M,9997,0,9999,2
1667961126177,COGS 220,A00,101428,Hollan; James D.,0,0,25,25
1667961126601,COGS 229,A00,101429,Dow; Steven P,18,0,25,7
1667961127025,COGS 230,A00,101430,Klemmer; Scott R,13,0,17,4
1667961127457,COGS 234,A00,101431,Xia; Haijun,7,0,25,18
1667961127892,COGS 260,A00,101432,Kiyonaga; Anastasia,20,0,25,5
1667961127892,COGS 260,B00,101433,Kirsh; David Joel,16,0,25,9
1667961128324,CSE 202,A00,102371,Impagliazzo; Russell,0,0,0,0
1667961128749,CSE 203B,A01,102373,Cheng; Chung Kuan,0,0,0,0
1667961129177,CSE 208,A00,102374,Micciancio; Daniele,0,0,0,0
1667961129609,CSE 209A,A00,112895,Impagliazzo; Russell,0,0,15,15
1667961130034,CSE 209B,A00,108005,Bellare; Mihir,0,0,0,0
1667961130465,CSE 210,A00,113163,Coblenz; Michael J,0,0,0,0
1667961130896,CSE 219,A00,106111,Dow; Steven P,0,0,20,20
1667961131324,CSE 221,A00,102376,Voelker; Geoffrey M.,0,0,0,0
1667961131754,CSE 224,A01,102378,Porter; George M,0,0,0,0
1667961132176,CSE 229A,A00,102379,Savage; Stefan,0,0,0,0
1667961132600,CSE 229C,A00,102380,Munyaka; Imani N. S.,0,0,0,0
1667961133024,CSE 232B,A00,102382,Deutsch; Alin Bernard,0,0,0,0
1667961133459,CSE 234,A01,112904,Kumar; Arun Kumar,0,0,0,0
1667961133882,CSE 237A,A00,102383,Rosing; Tajana Simunic,0,0,0,0
1667961134390,CSE 239A,A00,102384,Deutsch; Alin Bernard,0,0,0,0
1667961134821,CSE 239B,A00,102385,Polikarpova; Nadezhda,0,0,0,0
1667961135248,CSE 240A,A00,102386,Pannuto; Patrick William,0,0,0,0
1667961135673,CSE 240B,A00,102387,Zhao; Jishen,0,0,0,0
1667961136098,CSE 241A,A00,106406,Kang; Mingu,0,0,0,0
1667961136526,CSE 249B,A00,102388,Kahng; Andrew Byun,0,0,8,8
1667961136951,CSE 251B,A01,102392,Cottrell; Garrison W,0,0,0,0
1667961136951,CSE 251B,A02,102393,Cottrell; Garrison W,0,0,0,0
1667961137378,CSE 252B,A00,102394,Ochoa; Benjamin Lawrence,0,0,0,0
1667961137801,CSE 257,A01,102396,Gao; Sicun,0,0,0,0
1667961138238,CSE 272,A00,102397,Li; Tzumao,0,0,0,0
1667961138667,CSE 274,A00,111323,Chern; Albert Ren-Haur,0,0,0,0
1667961139097,CSE 282,A00,102398,Pevzner; Pavel Arkadjevich,0,0,0,0
1667961139522,CSE 284,A00,114175,Gymrek; Melissa Ann,0,0,0,0
1667961139947,CSE 290,A00,102399,Chandraker; Manmohan Krishna,0,0,0,0
1667961139947,CSE 290,B00,102400,Vaccaro; Kristen Marie,0,0,25,25
1667961139947,CSE 290,C00,102414,Pannuto; Patrick William,0,0,25,25
1667961139947,CSE 290,D00,102427,Pevzner; Pavel Arkadjevich,0,0,0,0
1667961139947,CSE 290,E00,102429,Zhao; Jishen,0,0,0,0
1667961139947,CSE 290,F00,102436,Tullsen; Dean Michael,0,0,0,0
1667961139947,CSE 290,G00,102440,Christensen; Henrik I,0,0,20,20
1667961140379,CSE 291,A00,102443,Su; Hao,0,0,0,0
1667961140379,CSE 291,B00,102448,Polikarpova; Nadezhda,0,0,0,0
1667961140379,CSE 291,C00,102453,Vaccaro; Kristen Marie,0,0,0,0
1667961140379,CSE 291,D00,111343,Savage; Stefan,0,0,0,0
1667961140379,CSE 291,E00,116474,Claffy; Kimberly Claire,0,0,0,0
1667961140379,CSE 291,F00,116479,Pasquale; Joseph,0,0,0,0
1667961140821,CSE 293,001,119111,Bafna; Vineet,9999,0,9999,0
1667961140821,CSE 293,002,119118,Bellare; Mihir,9999,0,9999,0
1667961140821,CSE 293,003,119122,Berg-Kirkpatrick; Taylor D,9999,0,9999,0
1667961140821,CSE 293,004,119135,Christensen; Henrik I,9999,0,9999,0
1667961140821,CSE 293,005,119142,Cottrell; Garrison W,9999,0,9999,0
1667961140821,CSE 293,006,119146,Deutsch; Alin Bernard,9999,0,9999,0
1667961140821,CSE 293,007,119159,Esmaeilzadeh; Hadi,9999,0,9999,0
1667961140821,CSE 293,008,119166,Freund; Yoav,9999,0,9999,0
1667961140821,CSE 293,009,119170,Griswold; William G.,9999,0,9999,0
1667961140821,CSE 293,010,119183,Gymrek; Melissa Ann,9999,0,9999,0
1667961140821,CSE 293,011,119190,Heninger; Nadia A,9999,0,9999,0
1667961140821,CSE 293,012,119230,Impagliazzo; Russell,9999,0,9999,0
1667961140821,CSE 293,013,119232,Jhala; Ranjit,9999,0,9999,0
1667961140821,CSE 293,014,119233,Kahng; Andrew Byun,9999,0,9999,0
1667961140821,CSE 293,015,119298,Kane; Daniel Mertz,9999,0,9999,0
1667961140821,CSE 293,016,119299,Kriegman; David J,9999,0,9999,0
1667961140821,CSE 293,017,119300,Kumar; Arun Kumar,9999,0,9999,0
1667961140821,CSE 293,018,119301,Lerner; Sorin,9999,0,9999,0
1667961140821,CSE 293,019,119302,Lovett; Shachar,9999,0,9999,0
1667961140821,CSE 293,020,119303,McAuley; Julian John,9999,0,9999,0
1667961140821,CSE 293,021,119304,Micciancio; Daniele,9999,0,9999,0
1667961140821,CSE 293,022,119367,Orailoglu; Alex,9999,0,9999,0
1667961140821,CSE 293,023,119382,Paturi; Ramamohan,9999,0,9999,0
1667961140821,CSE 293,024,119404,Polikarpova; Nadezhda,9999,0,9999,0
1667961140821,CSE 293,025,119406,Politz; Joseph Gibbs,9999,0,9999,0
1667961140821,CSE 293,026,119411,Porter; George M,9999,0,9999,0
1667961140821,CSE 293,027,119414,Porter; Leonard Emerson,9999,0,9999,0
1667961140821,CSE 293,028,119416,Ramamoorthi; Ravi,9999,0,9999,0
1667961140821,CSE 293,029,119417,Sahoo; Debashis,9999,0,9999,0
1667961140821,CSE 293,030,119420,Saul; Lawrence,9999,0,9999,0
1667961140821,CSE 293,031,119421,Savage; Stefan,9999,0,9999,0
1667961140821,CSE 293,032,119425,Schulze; Jurgen P.,9999,0,9999,0
1667961140821,CSE 293,033,119426,Snoeren; Alex C.,9999,0,9999,0
1667961140821,CSE 293,034,119428,Shang; Jingbo,9999,0,9999,0
1667961140821,CSE 293,035,119430,Stefan; Deian,9999,0,9999,0
1667961140821,CSE 293,036,119431,Su; Hao,9999,0,9999,0
1667961140821,CSE 293,037,119433,Swanson; Steven James,9999,0,9999,0
1667961140821,CSE 293,038,119435,Tullsen; Dean Michael,9999,0,9999,0
1667961140821,CSE 293,039,119483,Voelker; Geoffrey M.,9999,0,9999,0
1667961140821,CSE 293,040,119537,Zhao; Jishen,9999,0,9999,0
1667961140821,CSE 293,041,119538,Zhou; Yuan-Yuan,9999,0,9999,0
1667961140821,CSE 293,042,119539,Gao; Sicun,9999,0,9999,0
1667961140821,CSE 293,043,119540,Weibel; Nadir,9999,0,9999,0
1667961140821,CSE 293,044,119541,Gupta; Rajesh K.,9999,0,9999,0
1667961141318,CSE 294,A00,102459,Voelker; Geoffrey M.,0,0,0,0
1667961141318,CSE 294,B00,111322,Orailoglu; Alex,0,0,0,0
1667961141740,DSE 201,A00,096914,Deutsch; Alin Bernard,30,0,30,0
1667961142164,DSE 210,A00,096915,Dasgupta; Sanjoy,30,0,30,0
1667961142591,DSE 260A,A00,096916,Altintas De Callaf; Ilkay,30,0,30,0
1667961143021,ECE 200,001,103586,Antipa; Nicholas A,9999,0,9999,0
1667961143021,ECE 200,002,103587,Atanasov; Nikolay A.,9999,0,9999,0
1667961143021,ECE 200,003,103588,Bharadia; Dinesh,9999,0,9999,0
1667961143021,ECE 200,004,103589,Cheng; Chung Kuan,9999,0,9999,0
1667961143021,ECE 200,005,103590,Cosman; Pamela C.,9999,0,9999,0
1667961143021,ECE 200,006,103591,Dayeh; Shadi Ahmad,9999,0,9999,0
1667961143021,ECE 200,007,103592,Fainman; Yeshaiahu,9999,0,9999,0
1667961143021,ECE 200,008,103593,Ford; Joseph Earl,9999,0,9999,0
1667961143021,ECE 200,009,103594,Franceschetti; Massimo,9999,0,9999,0
1667961143021,ECE 200,010,103595,Fullerton; Eric E,9999,0,9999,0
1667961143021,ECE 200,011,103596,Galton; Ian A,9999,0,9999,0
1667961143021,ECE 200,012,103597,Gilja; Vikash,9999,0,9999,0
1667961143021,ECE 200,013,103598,Hall; Drew A.,9999,0,9999,0
1667961143021,ECE 200,014,103599,Hsueh; Tzu-Chien,9999,0,9999,0
1667961143021,ECE 200,015,103600,Javidi; Tara,9999,0,9999,0
1667961143021,ECE 200,016,103601,Kahng; Andrew Byun,9999,0,9999,0
1667961143021,ECE 200,017,103602,Kim; Young-Han,9999,0,9999,0
1667961143021,ECE 200,018,103603,Koushanfar; Farinaz,9999,0,9999,0
1667961143021,ECE 200,019,103604,Kuzum; Duygu,9999,0,9999,0
1667961143021,ECE 200,020,103605,Le; Hanh-Phuc,9999,0,9999,0
1667961143021,ECE 200,021,103606,Lin; Bill,9999,0,9999,0
1667961143021,ECE 200,022,103607,Liu; Zhaowei,9998,0,9999,1
1667961143021,ECE 200,023,103608,Lo; Yu-Hwa,9999,0,9999,0
1667961143021,ECE 200,024,103609,Lomakin; Vitaliy,9999,0,9999,0
1667961143021,ECE 200,025,103610,Mercier; Patrick Philip,9999,0,9999,0
1667961143021,ECE 200,026,103611,Meyer; Florian,9999,0,9999,0
1667961143021,ECE 200,027,103612,Milstein; Laurence B.,9999,0,9999,0
1667961143021,ECE 200,028,103613,Mir Arabbaygi; Siavash,9999,0,9999,0
1667961143021,ECE 200,029,103614,Mookherjea; Shayan,9999,0,9999,0
1667961143021,ECE 200,030,103615,Morris; Karcher William,9999,0,9999,0
1667961143021,ECE 200,031,103616,Ng; Tse Nga,9999,0,9999,0
1667961143021,ECE 200,032,103617,Nguyen; Truong Quang,9999,0,9999,0
1667961143021,ECE 200,033,103618,Nomura; Kenji,9999,0,9999,0
1667961143021,ECE 200,034,103619,Orlitsky; Alon,9999,0,9999,0
1667961143021,ECE 200,035,103620,Pal; Piya,9999,0,9999,0
1667961143021,ECE 200,036,103621,Papen; George C.,9999,0,9999,0
1667961143021,ECE 200,037,103622,Radic; Stojan,9999,0,9999,0
1667961143021,ECE 200,038,103623,Rao; Bhaskar D.,9999,0,9999,0
1667961143021,ECE 200,039,103624,Rao; Ramesh R,9999,0,9999,0
1667961143021,ECE 200,040,103625,Rebeiz; Gabriel,9999,0,9999,0
1667961143021,ECE 200,041,103626,Sanford; John R,9999,0,9999,0
1667961143021,ECE 200,042,103627,Siegel; Paul H.,9999,0,9999,0
1667961143021,ECE 200,043,103628,Sievenpiper; Daniel F.,9999,0,9999,0
1667961143021,ECE 200,044,103629,Sworder; David D.,9999,0,9999,0
1667961143021,ECE 200,045,103630,Taur; Yuan,9999,0,9999,0
1667961143021,ECE 200,046,103631,Touri; Behrouz,9999,0,9999,0
1667961143021,ECE 200,047,103632,Trivedi; Mohan M.,9999,0,9999,0
1667961143021,ECE 200,048,103633,Vasconcelos; Nuno,9999,0,9999,0
1667961143021,ECE 200,049,103634,Wang; Xiaolong,9999,0,9999,0
1667961143021,ECE 200,050,103635,Xie; Pengtao,9999,0,9999,0
1667961143021,ECE 200,051,103636,Yip; Michael,9999,0,9999,0
1667961143021,ECE 200,052,103637,Zeger; Kenneth A.,999,0,999,0
1667961143021,ECE 200,053,103638,Zhang; Xinyu,9999,0,9999,0
1667961143021,ECE 200,054,103639,Turakhia; Yatish Girish,9999,0,9999,0
1667961143021,ECE 200,055,103640,Kang; Mingu,9999,0,9999,0
1667961143021,ECE 200,056,103641,Shi; Yuanyuan,9999,0,9999,0
1667961143021,ECE 200,057,103642,Wang; Edward Jay,9999,0,9999,0
1667961143021,ECE 200,058,103643,Zheng; Yang,9999,0,9999,0
1667961143451,ECE 202,A00,103644,Kuzum; Duygu,0,0,0,0
1667961143876,ECE 212BN,A00,103646,Ng; Tse Nga,0,0,0,0
1667961144302,ECE 221,A00,111493,Staff,0,0,0,0
1667961144729,ECE 222B,A00,103647,Lomakin; Vitaliy,0,0,0,0
1667961145152,ECE 230B,A00,103648,Taur; Yuan,0,0,0,0
1667961145577,ECE 238B,A00,103649,Garay; Javier,0,0,0,0
1667961146008,ECE 240B,A00,112900,Fainman; Yeshaiahu,0,0,0,0
1667961146436,ECE 247A,A00,103650,Jokerst; Jesse Vincent,0,0,0,0
1667961146863,ECE 247B,A00,103651,Wang; Joseph,0,0,0,0
1667961147288,ECE 250,A00,103652,Siegel; Paul H.,0,0,0,0
1667961147729,ECE 251A,A00,103654,Rao; Bhaskar D.,0,0,0,0
1667961148155,ECE 257B,A00,103655,Bharadia; Dinesh,0,0,0,0
1667961148592,ECE 258A,A00,103656,Milstein; Laurence B.,0,0,0,0
1667961149017,ECE 260B,A00,103658,Kang; Mingu,0,0,0,0
1667961149446,ECE 264A,A00,103659,Galton; Ian A,0,0,0,0
1667961149868,ECE 265A,A00,103661,Gudem; Prasad S.S.,0,0,0,0
1667961150293,ECE 265D,A00,103662,Gudem; Prasad S.S.,0,0,0,0
1667961150722,ECE 268,A00,103663,Koushanfar; Farinaz,0,0,0,0
1667961151159,ECE 269,A01,103665,Pal; Piya,0,0,0,0
1667961151583,ECE 271B,A00,103666,Vasconcelos; Manuela,0,0,0,0
1667961152021,ECE 276A,A00,103667,Atanasov; Nikolay A.,0,0,0,0
1667961152446,ECE 277,A00,103668,An; Cheolhong,0,0,0,0
1667961152885,ECE 279,A00,117947,Hall; Drew A.,0,0,0,0
1667961153735,ECE 283,A00,103670,Hsueh; Tzu-Chien,0,0,0,0
1667961154164,ECE 284,A00,103671,Turakhia; Yatish Girish,0,0,0,0
1667961154591,ECE 285,A00,103672,Zheng; Yang,0,0,0,0
1667961154591,ECE 285,B00,103673,Sworder; David D.,0,0,0,0
1667961155016,ECE 287,A00,103676,Javidi; Tara,0,0,0,0
1667961155447,MATH 200B,A00,098023,Salehi Golsefidy; Alireza,14,0,15,1
1667961155874,MATH 202B,A00,098024,Rhoades; Brendon Patrick,12,0,15,3
1667961156307,MATH 203B,A00,098025,Oprea; Dragos N.,12,0,15,3
1667961156735,MATH 204B,A00,098026,Sorensen; Claus M,14,0,15,1
1667961157164,MATH 208,A00,098027,Izadi; Elham,7,0,10,3
1667961157594,MATH 209,A00,098028,Pollack; Aaron,10,0,10,0
1667961158023,MATH 211A,A00,112919,Rogalski; Daniel,9,0,10,1
1667961158447,MATH 211B,A00,112920,Seward; Brandon M.,9,0,10,1
1667961158873,MATH 218,A00,098029,Li; Bo,10,0,10,0
1667961159303,MATH 220B,A00,098030,Novak; Jonathan I,13,0,15,2
1667961159735,MATH 221A,A00,098031,Ebenfelt; Peter F,13,0,15,2
1667961160162,MATH 231B,A00,098032,Zlatos; Andrej,12,0,15,3
1667961160594,MATH 240B,A00,098033,Ni; Lei,10,0,15,5
1667961161030,MATH 243,A00,098034,Jekel; David Andrew,10,0,10,0
1667961161458,MATH 245A,A00,098035,Nie; Jiawang,0,0,15,16
1667961161885,MATH 248,A00,098036,Bejenaru; Ioan,10,0,10,0
1667961162325,MATH 250B,A00,098037,Spolaor; Luca,14,0,15,1
1667961162754,MATH 258,A00,098038,Ni; Lei,10,0,10,0
1667961163181,MATH 264B,A00,098041,Rhoades; Brendon Patrick,12,0,15,3
1667961163605,MATH 268,A00,098042,Buss; Samuel R,10,0,10,0
1667961164029,MATH 269,A00,098043,Rhoades; Brendon Patrick,10,0,10,0
1667961164454,MATH 270B,A00,098044,Li; Bo,11,0,15,4
1667961164880,MATH 272B,A00,098045,Holst; Michael J,13,0,15,2
1667961165306,MATH 273A,A00,098046,Tian; Xiaochuan,12,0,15,3
1667961165730,MATH 275,A01,098048,Tian; Xiaochuan,6,0,10,4
1667961166155,MATH 278A,A00,098049,Holst; Michael J,8,0,10,2
1667961166594,MATH 278B,A00,098050,Cloninger; Alexander,10,0,10,0
1667961167017,MATH 278C,A00,098051,Nie; Jiawang,8,0,10,2
1667961167447,MATH 280B,A00,098052,Zheng; Tianyi,12,0,15,3
1667961167875,MATH 281B,A00,098053,Bradic; Jelena,4,0,15,11
1667961168300,MATH 282B,A00,098054,Arias-Castro; Ery,2,0,15,13
1667961168729,MATH 285,A00,098055,Fitzsimmons; Patrick J,0,0,15,17
1667961169153,MATH 287B,A00,098056,Arias-Castro; Ery,5,0,15,10
1667961169583,MATH 288,A00,098057,Agarwal; Pooja,9,0,10,1
1667961169583,MATH 288,B00,098058,Zhang; Danna,9,0,10,1
1667961169583,MATH 288,C00,098059,Williams; Ruth J,10,0,10,0
1667961170006,MATH 290B,A00,098060,Roberts; Justin Deritter,14,0,15,1
1667961170433,MATH 292,A00,098061,Belmont; Eva Kinoshita,10,0,10,0
1667961170864,MATH 295,A00,098062,Suk; Andrew Hoon,48,0,50,2
1667961171288,MATH 296,A00,098063,Novak; Jonathan I,20,0,20,0
1667961171714,MATH 297,001,098064,Gamst; Anthony Collins,9997,0,9999,2
1667961673788,COGS 205,A00,101395,Chiba; Andrea,19,0,20,1
1667961674223,COGS 210B,001,101404,Greene; Deanna Jacquelyn,9998,0,9999,1
1667961674223,COGS 210B,002,101417,Xia; Haijun,9999,0,9999,0
1667961674223,COGS 210B,003,101422,Nitz; Douglas A.,9999,0,9999,0
1667961674223,COGS 210B,004,101423,Hollan; James D.,9998,0,9999,1
1667961674223,COGS 210B,005,101424,Deak; Gedeon O.,9999,0,9999,0
1667961674223,COGS 210B,006,101425,Rossano; Federico,9999,0,9999,0
1667961674647,COGS 211B,A00,101427,Coulson; Seana M,9997,0,9999,2
1667961675091,COGS 220,A00,101428,Hollan; James D.,0,0,25,25
1667961675517,COGS 229,A00,101429,Dow; Steven P,18,0,25,7
1667961675945,COGS 230,A00,101430,Klemmer; Scott R,13,0,17,4
1667961676373,COGS 234,A00,101431,Xia; Haijun,7,0,25,18
1667961676805,COGS 260,A00,101432,Kiyonaga; Anastasia,20,0,25,5
1667961676805,COGS 260,B00,101433,Kirsh; David Joel,16,0,25,9
1667961677238,CSE 202,A00,102371,Impagliazzo; Russell,0,0,0,0
1667961677663,CSE 203B,A01,102373,Cheng; Chung Kuan,0,0,0,0
1667961678090,CSE 208,A00,102374,Micciancio; Daniele,0,0,0,0
1667961678516,CSE 209A,A00,112895,Impagliazzo; Russell,0,0,15,15
1667961678945,CSE 209B,A00,108005,Bellare; Mihir,0,0,0,0
1667961679375,CSE 210,A00,113163,Coblenz; Michael J,0,0,0,0
1667961679803,CSE 219,A00,106111,Dow; Steven P,0,0,20,20
1667961680232,CSE 221,A00,102376,Voelker; Geoffrey M.,0,0,0,0
1667961680663,CSE 224,A01,102378,Porter; George M,0,0,0,0
1667961681087,CSE 229A,A00,102379,Savage; Stefan,0,0,0,0
1667961681514,CSE 229C,A00,102380,Munyaka; Imani N. S.,0,0,0,0
1667961681941,CSE 232B,A00,102382,Deutsch; Alin Bernard,0,0,0,0
1667961682371,CSE 234,A01,112904,Kumar; Arun Kumar,0,0,0,0
1667961682799,CSE 237A,A00,102383,Rosing; Tajana Simunic,0,0,0,0
1667961683228,CSE 239A,A00,102384,Deutsch; Alin Bernard,0,0,0,0
1667961683653,CSE 239B,A00,102385,Polikarpova; Nadezhda,0,0,0,0
1667961684075,CSE 240A,A00,102386,Pannuto; Patrick William,0,0,0,0
1667961684500,CSE 240B,A00,102387,Zhao; Jishen,0,0,0,0
1667961684926,CSE 241A,A00,106406,Kang; Mingu,0,0,0,0
1667961685353,CSE 249B,A00,102388,Kahng; Andrew Byun,0,0,8,8
1667961685779,CSE 251B,A01,102392,Cottrell; Garrison W,0,0,0,0
1667961685779,CSE 251B,A02,102393,Cottrell; Garrison W,0,0,0,0
1667961686207,CSE 252B,A00,102394,Ochoa; Benjamin Lawrence,0,0,0,0
1667961686639,CSE 257,A01,102396,Gao; Sicun,0,0,0,0
1667961687074,CSE 272,A00,102397,Li; Tzumao,0,0,0,0
1667961687501,CSE 274,A00,111323,Chern; Albert Ren-Haur,0,0,0,0
1667961687938,CSE 282,A00,102398,Pevzner; Pavel Arkadjevich,0,0,0,0
1667961688379,CSE 284,A00,114175,Gymrek; Melissa Ann,0,0,0,0
1667961688804,CSE 290,A00,102399,Chandraker; Manmohan Krishna,0,0,0,0
1667961688804,CSE 290,B00,102400,Vaccaro; Kristen Marie,0,0,25,25
1667961688804,CSE 290,C00,102414,Pannuto; Patrick William,0,0,25,25
1667961688804,CSE 290,D00,102427,Pevzner; Pavel Arkadjevich,0,0,0,0
1667961688804,CSE 290,E00,102429,Zhao; Jishen,0,0,0,0
1667961688804,CSE 290,F00,102436,Tullsen; Dean Michael,0,0,0,0
1667961688804,CSE 290,G00,102440,Christensen; Henrik I,0,0,20,20
1667961689229,CSE 291,A00,102443,Su; Hao,0,0,0,0
1667961689229,CSE 291,B00,102448,Polikarpova; Nadezhda,0,0,0,0
1667961689229,CSE 291,C00,102453,Vaccaro; Kristen Marie,0,0,0,0
1667961689229,CSE 291,D00,111343,Savage; Stefan,0,0,0,0
1667961689229,CSE 291,E00,116474,Claffy; Kimberly Claire,0,0,0,0
1667961689229,CSE 291,F00,116479,Pasquale; Joseph,0,0,0,0
1667961689664,CSE 293,001,119111,Bafna; Vineet,9999,0,9999,0
1667961689664,CSE 293,002,119118,Bellare; Mihir,9999,0,9999,0
1667961689664,CSE 293,003,119122,Berg-Kirkpatrick; Taylor D,9999,0,9999,0
1667961689664,CSE 293,004,119135,Christensen; Henrik I,9999,0,9999,0
1667961689664,CSE 293,005,119142,Cottrell; Garrison W,9999,0,9999,0
1667961689664,CSE 293,006,119146,Deutsch; Alin Bernard,9999,0,9999,0
1667961689664,CSE 293,007,119159,Esmaeilzadeh; Hadi,9999,0,9999,0
1667961689664,CSE 293,008,119166,Freund; Yoav,9999,0,9999,0
1667961689664,CSE 293,009,119170,Griswold; William G.,9999,0,9999,0
1667961689664,CSE 293,010,119183,Gymrek; Melissa Ann,9999,0,9999,0
1667961689664,CSE 293,011,119190,Heninger; Nadia A,9999,0,9999,0
1667961689664,CSE 293,012,119230,Impagliazzo; Russell,9999,0,9999,0
1667961689664,CSE 293,013,119232,Jhala; Ranjit,9999,0,9999,0
1667961689664,CSE 293,014,119233,Kahng; Andrew Byun,9999,0,9999,0
1667961689664,CSE 293,015,119298,Kane; Daniel Mertz,9999,0,9999,0
1667961689664,CSE 293,016,119299,Kriegman; David J,9999,0,9999,0
1667961689664,CSE 293,017,119300,Kumar; Arun Kumar,9999,0,9999,0
1667961689664,CSE 293,018,119301,Lerner; Sorin,9999,0,9999,0
1667961689664,CSE 293,019,119302,Lovett; Shachar,9999,0,9999,0
1667961689664,CSE 293,020,119303,McAuley; Julian John,9999,0,9999,0
1667961689664,CSE 293,021,119304,Micciancio; Daniele,9999,0,9999,0
1667961689664,CSE 293,022,119367,Orailoglu; Alex,9999,0,9999,0
1667961689664,CSE 293,023,119382,Paturi; Ramamohan,9999,0,9999,0
1667961689664,CSE 293,024,119404,Polikarpova; Nadezhda,9999,0,9999,0
1667961689664,CSE 293,025,119406,Politz; Joseph Gibbs,9999,0,9999,0
1667961689664,CSE 293,026,119411,Porter; George M,9999,0,9999,0
1667961689664,CSE 293,027,119414,Porter; Leonard Emerson,9999,0,9999,0
1667961689664,CSE 293,028,119416,Ramamoorthi; Ravi,9999,0,9999,0
1667961689664,CSE 293,029,119417,Sahoo; Debashis,9999,0,9999,0
1667961689664,CSE 293,030,119420,Saul; Lawrence,9999,0,9999,0
1667961689664,CSE 293,031,119421,Savage; Stefan,9999,0,9999,0
1667961689664,CSE 293,032,119425,Schulze; Jurgen P.,9999,0,9999,0
1667961689664,CSE 293,033,119426,Snoeren; Alex C.,9999,0,9999,0
1667961689664,CSE 293,034,119428,Shang; Jingbo,9999,0,9999,0
1667961689664,CSE 293,035,119430,Stefan; Deian,9999,0,9999,0
1667961689664,CSE 293,036,119431,Su; Hao,9999,0,9999,0
1667961689664,CSE 293,037,119433,Swanson; Steven James,9999,0,9999,0
1667961689664,CSE 293,038,119435,Tullsen; Dean Michael,9999,0,9999,0
1667961689664,CSE 293,039,119483,Voelker; Geoffrey M.,9999,0,9999,0
1667961689664,CSE 293,040,119537,Zhao; Jishen,9999,0,9999,0
1667961689664,CSE 293,041,119538,Zhou; Yuan-Yuan,9999,0,9999,0
1667961689664,CSE 293,042,119539,Gao; Sicun,9999,0,9999,0
1667961689664,CSE 293,043,119540,Weibel; Nadir,9999,0,9999,0
1667961689664,CSE 293,044,119541,Gupta; Rajesh K.,9999,0,9999,0
1667961690094,CSE 294,A00,102459,Voelker; Geoffrey M.,0,0,0,0
1667961690094,CSE 294,B00,111322,Orailoglu; Alex,0,0,0,0
1667961690522,DSE 201,A00,096914,Deutsch; Alin Bernard,30,0,30,0
1667961690945,DSE 210,A00,096915,Dasgupta; Sanjoy,30,0,30,0
1667961691376,DSE 260A,A00,096916,Altintas De Callaf; Ilkay,30,0,30,0
1667961691838,ECE 200,001,103586,Antipa; Nicholas A,9999,0,9999,0
1667961691838,ECE 200,002,103587,Atanasov; Nikolay A.,9999,0,9999,0
1667961691838,ECE 200,003,103588,Bharadia; Dinesh,9999,0,9999,0
1667961691838,ECE 200,004,103589,Cheng; Chung Kuan,9999,0,9999,0
1667961691838,ECE 200,005,103590,Cosman; Pamela C.,9999,0,9999,0
1667961691838,ECE 200,006,103591,Dayeh; Shadi Ahmad,9999,0,9999,0
1667961691838,ECE 200,007,103592,Fainman; Yeshaiahu,9999,0,9999,0
1667961691838,ECE 200,008,103593,Ford; Joseph Earl,9999,0,9999,0
1667961691838,ECE 200,009,103594,Franceschetti; Massimo,9999,0,9999,0
1667961691838,ECE 200,010,103595,Fullerton; Eric E,9999,0,9999,0
1667961691838,ECE 200,011,103596,Galton; Ian A,9999,0,9999,0
1667961691838,ECE 200,012,103597,Gilja; Vikash,9999,0,9999,0
1667961691838,ECE 200,013,103598,Hall; Drew A.,9999,0,9999,0
1667961691838,ECE 200,014,103599,Hsueh; Tzu-Chien,9999,0,9999,0
1667961691838,ECE 200,015,103600,Javidi; Tara,9999,0,9999,0
1667961691838,ECE 200,016,103601,Kahng; Andrew Byun,9999,0,9999,0
1667961691838,ECE 200,017,103602,Kim; Young-Han,9999,0,9999,0
1667961691838,ECE 200,018,103603,Koushanfar; Farinaz,9999,0,9999,0
1667961691838,ECE 200,019,103604,Kuzum; Duygu,9999,0,9999,0
1667961691838,ECE 200,020,103605,Le; Hanh-Phuc,9999,0,9999,0
1667961691838,ECE 200,021,103606,Lin; Bill,9999,0,9999,0
1667961691838,ECE 200,022,103607,Liu; Zhaowei,9998,0,9999,1
1667961691838,ECE 200,023,103608,Lo; Yu-Hwa,9999,0,9999,0
1667961691838,ECE 200,024,103609,Lomakin; Vitaliy,9999,0,9999,0
1667961691838,ECE 200,025,103610,Mercier; Patrick Philip,9999,0,9999,0
1667961691838,ECE 200,026,103611,Meyer; Florian,9999,0,9999,0
1667961691838,ECE 200,027,103612,Milstein; Laurence B.,9999,0,9999,0
1667961691838,ECE 200,028,103613,Mir Arabbaygi; Siavash,9999,0,9999,0
1667961691838,ECE 200,029,103614,Mookherjea; Shayan,9999,0,9999,0
1667961691838,ECE 200,030,103615,Morris; Karcher William,9999,0,9999,0
1667961691838,ECE 200,031,103616,Ng; Tse Nga,9999,0,9999,0
1667961691838,ECE 200,032,103617,Nguyen; Truong Quang,9999,0,9999,0
1667961691838,ECE 200,033,103618,Nomura; Kenji,9999,0,9999,0
1667961691838,ECE 200,034,103619,Orlitsky; Alon,9999,0,9999,0
1667961691838,ECE 200,035,103620,Pal; Piya,9999,0,9999,0
1667961691838,ECE 200,036,103621,Papen; George C.,9999,0,9999,0
1667961691838,ECE 200,037,103622,Radic; Stojan,9999,0,9999,0
1667961691838,ECE 200,038,103623,Rao; Bhaskar D.,9999,0,9999,0
1667961691838,ECE 200,039,103624,Rao; Ramesh R,9999,0,9999,0
1667961691838,ECE 200,040,103625,Rebeiz; Gabriel,9999,0,9999,0
1667961691838,ECE 200,041,103626,Sanford; John R,9999,0,9999,0
1667961691838,ECE 200,042,103627,Siegel; Paul H.,9999,0,9999,0
1667961691838,ECE 200,043,103628,Sievenpiper; Daniel F.,9999,0,9999,0
1667961691838,ECE 200,044,103629,Sworder; David D.,9999,0,9999,0
1667961691838,ECE 200,045,103630,Taur; Yuan,9999,0,9999,0
1667961691838,ECE 200,046,103631,Touri; Behrouz,9999,0,9999,0
1667961691838,ECE 200,047,103632,Trivedi; Mohan M.,9999,0,9999,0
1667961691838,ECE 200,048,103633,Vasconcelos; Nuno,9999,0,9999,0
1667961691838,ECE 200,049,103634,Wang; Xiaolong,9999,0,9999,0
1667961691838,ECE 200,050,103635,Xie; Pengtao,9999,0,9999,0
1667961691838,ECE 200,051,103636,Yip; Michael,9999,0,9999,0
1667961691838,ECE 200,052,103637,Zeger; Kenneth A.,999,0,999,0
1667961691838,ECE 200,053,103638,Zhang; Xinyu,9999,0,9999,0
1667961691838,ECE 200,054,103639,Turakhia; Yatish Girish,9999,0,9999,0
1667961691838,ECE 200,055,103640,Kang; Mingu,9999,0,9999,0
1667961691838,ECE 200,056,103641,Shi; Yuanyuan,9999,0,9999,0
1667961691838,ECE 200,057,103642,Wang; Edward Jay,9999,0,9999,0
1667961691838,ECE 200,058,103643,Zheng; Yang,9999,0,9999,0
1667961692263,ECE 202,A00,103644,Kuzum; Duygu,0,0,0,0
1667961692688,ECE 212BN,A00,103646,Ng; Tse Nga,0,0,0,0
1667961693118,ECE 221,A00,111493,Staff,0,0,0,0
1667961693544,ECE 222B,A00,103647,Lomakin; Vitaliy,0,0,0,0
1667961693970,ECE 230B,A00,103648,Taur; Yuan,0,0,0,0
1667961694397,ECE 238B,A00,103649,Garay; Javier,0,0,0,0
1667961694825,ECE 240B,A00,112900,Fainman; Yeshaiahu,0,0,0,0
1667961695253,ECE 247A,A00,103650,Jokerst; Jesse Vincent,0,0,0,0
1667961695675,ECE 247B,A00,103651,Wang; Joseph,0,0,0,0
1667961696106,ECE 250,A00,103652,Siegel; Paul H.,0,0,0,0
1667961696533,ECE 251A,A00,103654,Rao; Bhaskar D.,0,0,0,0
1667961696963,ECE 257B,A00,103655,Bharadia; Dinesh,0,0,0,0
1667961697386,ECE 258A,A00,103656,Milstein; Laurence B.,0,0,0,0
1667961697809,ECE 260B,A00,103658,Kang; Mingu,0,0,0,0
1667961698242,ECE 264A,A00,103659,Galton; Ian A,0,0,0,0
1667961698673,ECE 265A,A00,103661,Gudem; Prasad S.S.,0,0,0,0
1667961699099,ECE 265D,A00,103662,Gudem; Prasad S.S.,0,0,0,0
1667961699524,ECE 268,A00,103663,Koushanfar; Farinaz,0,0,0,0
1667961700051,ECE 269,A01,103665,Pal; Piya,0,0,0,0
1667961700479,ECE 271B,A00,103666,Vasconcelos; Manuela,0,0,0,0
1667961700923,ECE 276A,A00,103667,Atanasov; Nikolay A.,0,0,0,0
1667961701354,ECE 277,A00,103668,An; Cheolhong,0,0,0,0
1667961701777,ECE 279,A00,117947,Hall; Drew A.,0,0,0,0
1667961702626,ECE 283,A00,103670,Hsueh; Tzu-Chien,0,0,0,0
1667961703052,ECE 284,A00,103671,Turakhia; Yatish Girish,0,0,0,0
1667961703480,ECE 285,A00,103672,Zheng; Yang,0,0,0,0
1667961703480,ECE 285,B00,103673,Sworder; David D.,0,0,0,0
1667961703905,ECE 287,A00,103676,Javidi; Tara,0,0,0,0
1667961704334,MATH 200B,A00,098023,Salehi Golsefidy; Alireza,14,0,15,1
1667961704765,MATH 202B,A00,098024,Rhoades; Brendon Patrick,12,0,15,3
1667961705187,MATH 203B,A00,098025,Oprea; Dragos N.,12,0,15,3
1667961705617,MATH 204B,A00,098026,Sorensen; Claus M,14,0,15,1
1667961706043,MATH 208,A00,098027,Izadi; Elham,7,0,10,3
1667961706465,MATH 209,A00,098028,Pollack; Aaron,10,0,10,0
1667961706895,MATH 211A,A00,112919,Rogalski; Daniel,9,0,10,1
1667961707322,MATH 211B,A00,112920,Seward; Brandon M.,9,0,10,1
1667961707758,MATH 218,A00,098029,Li; Bo,10,0,10,0
1667961708185,MATH 220B,A00,098030,Novak; Jonathan I,13,0,15,2
1667961708610,MATH 221A,A00,098031,Ebenfelt; Peter F,13,0,15,2
1667961709034,MATH 231B,A00,098032,Zlatos; Andrej,12,0,15,3
1667961709457,MATH 240B,A00,098033,Ni; Lei,10,0,15,5
1667961709887,MATH 243,A00,098034,Jekel; David Andrew,10,0,10,0
1667961710314,MATH 245A,A00,098035,Nie; Jiawang,0,0,15,16
1667961710743,MATH 248,A00,098036,Bejenaru; Ioan,10,0,10,0
1667961711168,MATH 250B,A00,098037,Spolaor; Luca,14,0,15,1
1667961711593,MATH 258,A00,098038,Ni; Lei,10,0,10,0
1667961712018,MATH 264B,A00,098041,Rhoades; Brendon Patrick,12,0,15,3
1667961712442,MATH 268,A00,098042,Buss; Samuel R,10,0,10,0
1667961712866,MATH 269,A00,098043,Rhoades; Brendon Patrick,10,0,10,0
1667961713293,MATH 270B,A00,098044,Li; Bo,11,0,15,4
1667961713716,MATH 272B,A00,098045,Holst; Michael J,13,0,15,2
1667961714139,MATH 273A,A00,098046,Tian; Xiaochuan,12,0,15,3
1667961714571,MATH 275,A01,098048,Tian; Xiaochuan,6,0,10,4
1667961714995,MATH 278A,A00,098049,Holst; Michael J,8,0,10,2
1667961715418,MATH 278B,A00,098050,Cloninger; Alexander,10,0,10,0
1667961715852,MATH 278C,A00,098051,Nie; Jiawang,8,0,10,2
1667961716276,MATH 280B,A00,098052,Zheng; Tianyi,12,0,15,3
1667961716699,MATH 281B,A00,098053,Bradic; Jelena,4,0,15,11
1667961717124,MATH 282B,A00,098054,Arias-Castro; Ery,2,0,15,13
1667961717551,MATH 285,A00,098055,Fitzsimmons; Patrick J,0,0,15,17
1667961717976,MATH 287B,A00,098056,Arias-Castro; Ery,5,0,15,10
1667961718403,MATH 288,A00,098057,Agarwal; Pooja,9,0,10,1
1667961718403,MATH 288,B00,098058,Zhang; Danna,9,0,10,1
1667961718403,MATH 288,C00,098059,Williams; Ruth J,10,0,10,0
1667961718833,MATH 290B,A00,098060,Roberts; Justin Deritter,14,0,15,1
1667961719256,MATH 292,A00,098061,Belmont; Eva Kinoshita,10,0,10,0
1667961719683,MATH 295,A00,098062,Suk; Andrew Hoon,48,0,50,2
1667961720106,MATH 296,A00,098063,Novak; Jonathan I,20,0,20,0
1667961720544,MATH 297,001,098064,Gamst; Anthony Collins,9997,0,9999,2
1667962222662,COGS 205,A00,101395,Chiba; Andrea,19,0,20,1
1667962223089,COGS 210B,001,101404,Greene; Deanna Jacquelyn,9998,0,9999,1
1667962223089,COGS 210B,002,101417,Xia; Haijun,9999,0,9999,0
1667962223089,COGS 210B,003,101422,Nitz; Douglas A.,9999,0,9999,0
1667962223089,COGS 210B,004,101423,Hollan; James D.,9998,0,9999,1
1667962223089,COGS 210B,005,101424,Deak; Gedeon O.,9999,0,9999,0
1667962223089,COGS 210B,006,101425,Rossano; Federico,9999,0,9999,0
1667962223513,COGS 211B,A00,101427,Coulson; Seana M,9997,0,9999,2
1667962223937,COGS 220,A00,101428,Hollan; James D.,0,0,25,25
1667962224362,COGS 229,A00,101429,Dow; Steven P,18,0,25,7
1667962224790,COGS 230,A00,101430,Klemmer; Scott R,13,0,17,4
1667962225213,COGS 234,A00,101431,Xia; Haijun,7,0,25,18
1667962225640,COGS 260,A00,101432,Kiyonaga; Anastasia,20,0,25,5
1667962225640,COGS 260,B00,101433,Kirsh; David Joel,16,0,25,9
1667962226064,CSE 202,A00,102371,Impagliazzo; Russell,0,0,0,0
1667962226496,CSE 203B,A01,102373,Cheng; Chung Kuan,0,0,0,0
1667962226922,CSE 208,A00,102374,Micciancio; Daniele,0,0,0,0
1667962227346,CSE 209A,A00,112895,Impagliazzo; Russell,0,0,15,15
1667962227770,CSE 209B,A00,108005,Bellare; Mihir,0,0,0,0
1667962228193,CSE 210,A00,113163,Coblenz; Michael J,0,0,0,0
1667962228617,CSE 219,A00,106111,Dow; Steven P,0,0,20,20
1667962229053,CSE 221,A00,102376,Voelker; Geoffrey M.,0,0,0,0
1667962229480,CSE 224,A01,102378,Porter; George M,0,0,0,0
1667962229904,CSE 229A,A00,102379,Savage; Stefan,0,0,0,0
1667962230330,CSE 229C,A00,102380,Munyaka; Imani N. S.,0,0,0,0
1667962230763,CSE 232B,A00,102382,Deutsch; Alin Bernard,0,0,0,0
1667962231191,CSE 234,A01,112904,Kumar; Arun Kumar,0,0,0,0
1667962231619,CSE 237A,A00,102383,Rosing; Tajana Simunic,0,0,0,0
1667962232043,CSE 239A,A00,102384,Deutsch; Alin Bernard,0,0,0,0
1667962232466,CSE 239B,A00,102385,Polikarpova; Nadezhda,0,0,0,0
1667962232895,CSE 240A,A00,102386,Pannuto; Patrick William,0,0,0,0
1667962233322,CSE 240B,A00,102387,Zhao; Jishen,0,0,0,0
1667962233745,CSE 241A,A00,106406,Kang; Mingu,0,0,0,0
1667962234173,CSE 249B,A00,102388,Kahng; Andrew Byun,0,0,8,8
1667962234606,CSE 251B,A01,102392,Cottrell; Garrison W,0,0,0,0
1667962234606,CSE 251B,A02,102393,Cottrell; Garrison W,0,0,0,0
1667962235032,CSE 252B,A00,102394,Ochoa; Benjamin Lawrence,0,0,0,0
1667962235457,CSE 257,A01,102396,Gao; Sicun,0,0,0,0
1667962235888,CSE 272,A00,102397,Li; Tzumao,0,0,0,0
1667962236321,CSE 274,A00,111323,Chern; Albert Ren-Haur,0,0,0,0
1667962236743,CSE 282,A00,102398,Pevzner; Pavel Arkadjevich,0,0,0,0
1667962237168,CSE 284,A00,114175,Gymrek; Melissa Ann,0,0,0,0
1667962237592,CSE 290,A00,102399,Chandraker; Manmohan Krishna,0,0,0,0
1667962237592,CSE 290,B00,102400,Vaccaro; Kristen Marie,0,0,25,25
1667962237592,CSE 290,C00,102414,Pannuto; Patrick William,0,0,25,25
1667962237592,CSE 290,D00,102427,Pevzner; Pavel Arkadjevich,0,0,0,0
1667962237592,CSE 290,E00,102429,Zhao; Jishen,0,0,0,0
1667962237592,CSE 290,F00,102436,Tullsen; Dean Michael,0,0,0,0
1667962237592,CSE 290,G00,102440,Christensen; Henrik I,0,0,20,20
1667962238015,CSE 291,A00,102443,Su; Hao,0,0,0,0
1667962238015,CSE 291,B00,102448,Polikarpova; Nadezhda,0,0,0,0
1667962238015,CSE 291,C00,102453,Vaccaro; Kristen Marie,0,0,0,0
1667962238015,CSE 291,D00,111343,Savage; Stefan,0,0,0,0
1667962238015,CSE 291,E00,116474,Claffy; Kimberly Claire,0,0,0,0
1667962238015,CSE 291,F00,116479,Pasquale; Joseph,0,0,0,0
1667962238460,CSE 293,001,119111,Bafna; Vineet,9999,0,9999,0
1667962238460,CSE 293,002,119118,Bellare; Mihir,9999,0,9999,0
1667962238460,CSE 293,003,119122,Berg-Kirkpatrick; Taylor D,9999,0,9999,0
1667962238460,CSE 293,004,119135,Christensen; Henrik I,9999,0,9999,0
1667962238460,CSE 293,005,119142,Cottrell; Garrison W,9999,0,9999,0
1667962238460,CSE 293,006,119146,Deutsch; Alin Bernard,9999,0,9999,0
1667962238460,CSE 293,007,119159,Esmaeilzadeh; Hadi,9999,0,9999,0
1667962238460,CSE 293,008,119166,Freund; Yoav,9999,0,9999,0
1667962238460,CSE 293,009,119170,Griswold; William G.,9999,0,9999,0
1667962238460,CSE 293,010,119183,Gymrek; Melissa Ann,9999,0,9999,0
1667962238460,CSE 293,011,119190,Heninger; Nadia A,9999,0,9999,0
1667962238460,CSE 293,012,119230,Impagliazzo; Russell,9999,0,9999,0
1667962238460,CSE 293,013,119232,Jhala; Ranjit,9999,0,9999,0
1667962238460,CSE 293,014,119233,Kahng; Andrew Byun,9999,0,9999,0
1667962238460,CSE 293,015,119298,Kane; Daniel Mertz,9999,0,9999,0
1667962238460,CSE 293,016,119299,Kriegman; David J,9999,0,9999,0
1667962238460,CSE 293,017,119300,Kumar; Arun Kumar,9999,0,9999,0
1667962238460,CSE 293,018,119301,Lerner; Sorin,9999,0,9999,0
1667962238460,CSE 293,019,119302,Lovett; Shachar,9999,0,9999,0
1667962238460,CSE 293,020,119303,McAuley; Julian John,9999,0,9999,0
1667962238460,CSE 293,021,119304,Micciancio; Daniele,9999,0,9999,0
1667962238460,CSE 293,022,119367,Orailoglu; Alex,9999,0,9999,0
1667962238460,CSE 293,023,119382,Paturi; Ramamohan,9999,0,9999,0
1667962238460,CSE 293,024,119404,Polikarpova; Nadezhda,9999,0,9999,0
1667962238460,CSE 293,025,119406,Politz; Joseph Gibbs,9999,0,9999,0
1667962238460,CSE 293,026,119411,Porter; George M,9999,0,9999,0
1667962238460,CSE 293,027,119414,Porter; Leonard Emerson,9999,0,9999,0
1667962238460,CSE 293,028,119416,Ramamoorthi; Ravi,9999,0,9999,0
1667962238460,CSE 293,029,119417,Sahoo; Debashis,9999,0,9999,0
1667962238460,CSE 293,030,119420,Saul; Lawrence,9999,0,9999,0
1667962238460,CSE 293,031,119421,Savage; Stefan,9999,0,9999,0
1667962238460,CSE 293,032,119425,Schulze; Jurgen P.,9999,0,9999,0
1667962238460,CSE 293,033,119426,Snoeren; Alex C.,9999,0,9999,0
1667962238460,CSE 293,034,119428,Shang; Jingbo,9999,0,9999,0
1667962238460,CSE 293,035,119430,Stefan; Deian,9999,0,9999,0
1667962238460,CSE 293,036,119431,Su; Hao,9999,0,9999,0
1667962238460,CSE 293,037,119433,Swanson; Steven James,9999,0,9999,0
1667962238460,CSE 293,038,119435,Tullsen; Dean Michael,9999,0,9999,0
1667962238460,CSE 293,039,119483,Voelker; Geoffrey M.,9999,0,9999,0
1667962238460,CSE 293,040,119537,Zhao; Jishen,9999,0,9999,0
1667962238460,CSE 293,041,119538,Zhou; Yuan-Yuan,9999,0,9999,0
1667962238460,CSE 293,042,119539,Gao; Sicun,9999,0,9999,0
1667962238460,CSE 293,043,119540,Weibel; Nadir,9999,0,9999,0
1667962238460,CSE 293,044,119541,Gupta; Rajesh K.,9999,0,9999,0
1667962238886,CSE 294,A00,102459,Voelker; Geoffrey M.,0,0,0,0
1667962238886,CSE 294,B00,111322,Orailoglu; Alex,0,0,0,0
1667962239312,DSE 201,A00,096914,Deutsch; Alin Bernard,30,0,30,0
1667962239734,DSE 210,A00,096915,Dasgupta; Sanjoy,30,0,30,0
1667962240158,DSE 260A,A00,096916,Altintas De Callaf; Ilkay,30,0,30,0
1667962240598,ECE 200,001,103586,Antipa; Nicholas A,9999,0,9999,0
1667962240598,ECE 200,002,103587,Atanasov; Nikolay A.,9999,0,9999,0
1667962240598,ECE 200,003,103588,Bharadia; Dinesh,9999,0,9999,0
1667962240598,ECE 200,004,103589,Cheng; Chung Kuan,9999,0,9999,0
1667962240598,ECE 200,005,103590,Cosman; Pamela C.,9999,0,9999,0
1667962240598,ECE 200,006,103591,Dayeh; Shadi Ahmad,9999,0,9999,0
1667962240598,ECE 200,007,103592,Fainman; Yeshaiahu,9999,0,9999,0
1667962240598,ECE 200,008,103593,Ford; Joseph Earl,9999,0,9999,0
1667962240598,ECE 200,009,103594,Franceschetti; Massimo,9999,0,9999,0
1667962240598,ECE 200,010,103595,Fullerton; Eric E,9999,0,9999,0
1667962240598,ECE 200,011,103596,Galton; Ian A,9999,0,9999,0
1667962240598,ECE 200,012,103597,Gilja; Vikash,9999,0,9999,0
1667962240598,ECE 200,013,103598,Hall; Drew A.,9999,0,9999,0
1667962240598,ECE 200,014,103599,Hsueh; Tzu-Chien,9999,0,9999,0
1667962240598,ECE 200,015,103600,Javidi; Tara,9999,0,9999,0
1667962240598,ECE 200,016,103601,Kahng; Andrew Byun,9999,0,9999,0
1667962240598,ECE 200,017,103602,Kim; Young-Han,9999,0,9999,0
1667962240598,ECE 200,018,103603,Koushanfar; Farinaz,9999,0,9999,0
1667962240598,ECE 200,019,103604,Kuzum; Duygu,9999,0,9999,0
1667962240598,ECE 200,020,103605,Le; Hanh-Phuc,9999,0,9999,0
1667962240598,ECE 200,021,103606,Lin; Bill,9999,0,9999,0
1667962240598,ECE 200,022,103607,Liu; Zhaowei,9998,0,9999,1
1667962240598,ECE 200,023,103608,Lo; Yu-Hwa,9999,0,9999,0
1667962240598,ECE 200,024,103609,Lomakin; Vitaliy,9999,0,9999,0
1667962240598,ECE 200,025,103610,Mercier; Patrick Philip,9999,0,9999,0
1667962240598,ECE 200,026,103611,Meyer; Florian,9999,0,9999,0
1667962240598,ECE 200,027,103612,Milstein; Laurence B.,9999,0,9999,0
1667962240598,ECE 200,028,103613,Mir Arabbaygi; Siavash,9999,0,9999,0
1667962240598,ECE 200,029,103614,Mookherjea; Shayan,9999,0,9999,0
1667962240598,ECE 200,030,103615,Morris; Karcher William,9999,0,9999,0
1667962240598,ECE 200,031,103616,Ng; Tse Nga,9999,0,9999,0
1667962240598,ECE 200,032,103617,Nguyen; Truong Quang,9999,0,9999,0
1667962240598,ECE 200,033,103618,Nomura; Kenji,9999,0,9999,0
1667962240598,ECE 200,034,103619,Orlitsky; Alon,9999,0,9999,0
1667962240598,ECE 200,035,103620,Pal; Piya,9999,0,9999,0
1667962240598,ECE 200,036,103621,Papen; George C.,9999,0,9999,0
1667962240598,ECE 200,037,103622,Radic; Stojan,9999,0,9999,0
1667962240598,ECE 200,038,103623,Rao; Bhaskar D.,9999,0,9999,0
1667962240598,ECE 200,039,103624,Rao; Ramesh R,9999,0,9999,0
1667962240598,ECE 200,040,103625,Rebeiz; Gabriel,9999,0,9999,0
1667962240598,ECE 200,041,103626,Sanford; John R,9999,0,9999,0
1667962240598,ECE 200,042,103627,Siegel; Paul H.,9999,0,9999,0
1667962240598,ECE 200,043,103628,Sievenpiper; Daniel F.,9999,0,9999,0
1667962240598,ECE 200,044,103629,Sworder; David D.,9999,0,9999,0
1667962240598,ECE 200,045,103630,Taur; Yuan,9999,0,9999,0
1667962240598,ECE 200,046,103631,Touri; Behrouz,9999,0,9999,0
1667962240598,ECE 200,047,103632,Trivedi; Mohan M.,9999,0,9999,0
1667962240598,ECE 200,048,103633,Vasconcelos; Nuno,9999,0,9999,0
1667962240598,ECE 200,049,103634,Wang; Xiaolong,9999,0,9999,0
1667962240598,ECE 200,050,103635,Xie; Pengtao,9999,0,9999,0
1667962240598,ECE 200,051,103636,Yip; Michael,9999,0,9999,0
1667962240598,ECE 200,052,103637,Zeger; Kenneth A.,999,0,999,0
1667962240598,ECE 200,053,103638,Zhang; Xinyu,9999,0,9999,0
1667962240598,ECE 200,054,103639,Turakhia; Yatish Girish,9999,0,9999,0
1667962240598,ECE 200,055,103640,Kang; Mingu,9999,0,9999,0
1667962240598,ECE 200,056,103641,Shi; Yuanyuan,9999,0,9999,0
1667962240598,ECE 200,057,103642,Wang; Edward Jay,9999,0,9999,0
1667962240598,ECE 200,058,103643,Zheng; Yang,9999,0,9999,0
1667962241023,ECE 202,A00,103644,Kuzum; Duygu,0,0,0,0
1667962241449,ECE 212BN,A00,103646,Ng; Tse Nga,0,0,0,0
1667962241874,ECE 221,A00,111493,Staff,0,0,0,0
1667962242306,ECE 222B,A00,103647,Lomakin; Vitaliy,0,0,0,0
1667962242737,ECE 230B,A00,103648,Taur; Yuan,0,0,0,0
1667962243159,ECE 238B,A00,103649,Garay; Javier,0,0,0,0
1667962243582,ECE 240B,A00,112900,Fainman; Yeshaiahu,0,0,0,0
1667962244012,ECE 247A,A00,103650,Jokerst; Jesse Vincent,0,0,0,0
1667962244435,ECE 247B,A00,103651,Wang; Joseph,0,0,0,0
1667962244867,ECE 250,A00,103652,Siegel; Paul H.,0,0,0,0
1667962245300,ECE 251A,A00,103654,Rao; Bhaskar D.,0,0,0,0
1667962245732,ECE 257B,A00,103655,Bharadia; Dinesh,0,0,0,0
1667962246161,ECE 258A,A00,103656,Milstein; Laurence B.,0,0,0,0
1667962246585,ECE 260B,A00,103658,Kang; Mingu,0,0,0,0
1667962247008,ECE 264A,A00,103659,Galton; Ian A,0,0,0,0
1667962247430,ECE 265A,A00,103661,Gudem; Prasad S.S.,0,0,0,0
1667962247860,ECE 265D,A00,103662,Gudem; Prasad S.S.,0,0,0,0
1667962248288,ECE 268,A00,103663,Koushanfar; Farinaz,0,0,0,0
1667962248712,ECE 269,A01,103665,Pal; Piya,0,0,0,0
1667962249138,ECE 271B,A00,103666,Vasconcelos; Manuela,0,0,0,0
1667962249562,ECE 276A,A00,103667,Atanasov; Nikolay A.,0,0,0,0
1667962250002,ECE 277,A00,103668,An; Cheolhong,0,0,0,0
1667962250426,ECE 279,A00,117947,Hall; Drew A.,0,0,0,0
1667962251280,ECE 283,A00,103670,Hsueh; Tzu-Chien,0,0,0,0
1667962251702,ECE 284,A00,103671,Turakhia; Yatish Girish,0,0,0,0
1667962252141,ECE 285,A00,103672,Zheng; Yang,0,0,0,0
1667962252141,ECE 285,B00,103673,Sworder; David D.,0,0,0,0
1667962252573,ECE 287,A00,103676,Javidi; Tara,0,0,0,0
1667962253005,MATH 200B,A00,098023,Salehi Golsefidy; Alireza,14,0,15,1
1667962253432,MATH 202B,A00,098024,Rhoades; Brendon Patrick,12,0,15,3
1667962253857,MATH 203B,A00,098025,Oprea; Dragos N.,12,0,15,3
1667962254286,MATH 204B,A00,098026,Sorensen; Claus M,14,0,15,1
1667962254709,MATH 208,A00,098027,Izadi; Elham,7,0,10,3
1667962255139,MATH 209,A00,098028,Pollack; Aaron,10,0,10,0
1667962255564,MATH 211A,A00,112919,Rogalski; Daniel,9,0,10,1
1667962255987,MATH 211B,A00,112920,Seward; Brandon M.,9,0,10,1
1667962256411,MATH 218,A00,098029,Li; Bo,10,0,10,0
1667962256834,MATH 220B,A00,098030,Novak; Jonathan I,13,0,15,2
1667962257257,MATH 221A,A00,098031,Ebenfelt; Peter F,13,0,15,2
1667962257687,MATH 231B,A00,098032,Zlatos; Andrej,12,0,15,3
1667962258111,MATH 240B,A00,098033,Ni; Lei,10,0,15,5
1667962258542,MATH 243,A00,098034,Jekel; David Andrew,10,0,10,0
1667962258970,MATH 245A,A00,098035,Nie; Jiawang,0,0,15,16
1667962259394,MATH 248,A00,098036,Bejenaru; Ioan,10,0,10,0
1667962259818,MATH 250B,A00,098037,Spolaor; Luca,14,0,15,1
1667962260247,MATH 258,A00,098038,Ni; Lei,10,0,10,0
1667962260678,MATH 264B,A00,098041,Rhoades; Brendon Patrick,12,0,15,3
1667962261101,MATH 268,A00,098042,Buss; Samuel R,10,0,10,0
1667962261533,MATH 269,A00,098043,Rhoades; Brendon Patrick,10,0,10,0
1667962261961,MATH 270B,A00,098044,Li; Bo,11,0,15,4
1667962262388,MATH 272B,A00,098045,Holst; Michael J,13,0,15,2
1667962262814,MATH 273A,A00,098046,Tian; Xiaochuan,12,0,15,3
1667962263250,MATH 275,A01,098048,Tian; Xiaochuan,6,0,10,4
1667962263673,MATH 278A,A00,098049,Holst; Michael J,8,0,10,2
1667962264096,MATH 278B,A00,098050,Cloninger; Alexander,10,0,10,0
1667962264521,MATH 278C,A00,098051,Nie; Jiawang,8,0,10,2
1667962264954,MATH 280B,A00,098052,Zheng; Tianyi,12,0,15,3
1667962265473,MATH 281B,A00,098053,Bradic; Jelena,4,0,15,11
1667962265903,MATH 282B,A00,098054,Arias-Castro; Ery,2,0,15,13
1667962266329,MATH 285,A00,098055,Fitzsimmons; Patrick J,0,0,15,17
1667962266756,MATH 287B,A00,098056,Arias-Castro; Ery,5,0,15,10
1667962267198,MATH 288,A00,098057,Agarwal; Pooja,9,0,10,1
1667962267198,MATH 288,B00,098058,Zhang; Danna,9,0,10,1
1667962267198,MATH 288,C00,098059,Williams; Ruth J,10,0,10,0
1667962267622,MATH 290B,A00,098060,Roberts; Justin Deritter,14,0,15,1
1667962268054,MATH 292,A00,098061,Belmont; Eva Kinoshita,10,0,10,0
1667962268479,MATH 295,A00,098062,Suk; Andrew Hoon,48,0,50,2
1667962268903,MATH 296,A00,098063,Novak; Jonathan I,20,0,20,0
1667962269328,MATH 297,001,098064,Gamst; Anthony Collins,9997,0,9999,2
1667962781031,COGS 205,A00,101395,Chiba; Andrea,19,0,20,1
1667962781456,COGS 210B,001,101404,Greene; Deanna Jacquelyn,9998,0,9999,1
1667962781456,COGS 210B,002,101417,Xia; Haijun,9999,0,9999,0
1667962781456,COGS 210B,003,101422,Nitz; Douglas A.,9999,0,9999,0
1667962781456,COGS 210B,004,101423,Hollan; James D.,9998,0,9999,1
1667962781456,COGS 210B,005,101424,Deak; Gedeon O.,9999,0,9999,0
1667962781456,COGS 210B,006,101425,Rossano; Federico,9999,0,9999,0
1667962781879,COGS 211B,A00,101427,Coulson; Seana M,9997,0,9999,2
1667962782301,COGS 220,A00,101428,Hollan; James D.,0,0,25,25
1667962782731,COGS 229,A00,101429,Dow; Steven P,18,0,25,7
1667962783155,COGS 230,A00,101430,Klemmer; Scott R,13,0,17,4
1667962783586,COGS 234,A00,101431,Xia; Haijun,7,0,25,18
1667962784009,COGS 260,A00,101432,Kiyonaga; Anastasia,20,0,25,5
1667962784009,COGS 260,B00,101433,Kirsh; David Joel,16,0,25,9
1667962784433,CSE 202,A00,102371,Impagliazzo; Russell,0,0,0,0
1667962784862,CSE 203B,A01,102373,Cheng; Chung Kuan,0,0,0,0
1667962785284,CSE 208,A00,102374,Micciancio; Daniele,0,0,0,0
1667962785706,CSE 209A,A00,112895,Impagliazzo; Russell,0,0,15,15
1667962786133,CSE 209B,A00,108005,Bellare; Mihir,0,0,0,0
1667962786558,CSE 210,A00,113163,Coblenz; Michael J,0,0,0,0
1667962786985,CSE 219,A00,106111,Dow; Steven P,0,0,20,20
1667962787410,CSE 221,A00,102376,Voelker; Geoffrey M.,0,0,0,0
1667962787838,CSE 224,A01,102378,Porter; George M,0,0,0,0
1667962788263,CSE 229A,A00,102379,Savage; Stefan,0,0,0,0
1667962788688,CSE 229C,A00,102380,Munyaka; Imani N. S.,0,0,0,0
1667962789113,CSE 232B,A00,102382,Deutsch; Alin Bernard,0,0,0,0
1667962789536,CSE 234,A01,112904,Kumar; Arun Kumar,0,0,0,0
1667962789959,CSE 237A,A00,102383,Rosing; Tajana Simunic,0,0,0,0
1667962790390,CSE 239A,A00,102384,Deutsch; Alin Bernard,0,0,0,0
1667962790811,CSE 239B,A00,102385,Polikarpova; Nadezhda,0,0,0,0
1667962791235,CSE 240A,A00,102386,Pannuto; Patrick William,0,0,0,0
1667962791659,CSE 240B,A00,102387,Zhao; Jishen,0,0,0,0
1667962792082,CSE 241A,A00,106406,Kang; Mingu,0,0,0,0
1667962792508,CSE 249B,A00,102388,Kahng; Andrew Byun,0,0,8,8
1667962792938,CSE 251B,A01,102392,Cottrell; Garrison W,0,0,0,0
1667962792938,CSE 251B,A02,102393,Cottrell; Garrison W,0,0,0,0
1667962793375,CSE 252B,A00,102394,Ochoa; Benjamin Lawrence,0,0,0,0
1667962793798,CSE 257,A01,102396,Gao; Sicun,0,0,0,0
1667962794223,CSE 272,A00,102397,Li; Tzumao,0,0,0,0
1667962794646,CSE 274,A00,111323,Chern; Albert Ren-Haur,0,0,0,0
1667962795070,CSE 282,A00,102398,Pevzner; Pavel Arkadjevich,0,0,0,0
1667962795495,CSE 284,A00,114175,Gymrek; Melissa Ann,0,0,0,0
1667962795919,CSE 290,A00,102399,Chandraker; Manmohan Krishna,0,0,0,0
1667962795919,CSE 290,B00,102400,Vaccaro; Kristen Marie,0,0,25,25
1667962795919,CSE 290,C00,102414,Pannuto; Patrick William,0,0,25,25
1667962795919,CSE 290,D00,102427,Pevzner; Pavel Arkadjevich,0,0,0,0
1667962795919,CSE 290,E00,102429,Zhao; Jishen,0,0,0,0
1667962795919,CSE 290,F00,102436,Tullsen; Dean Michael,0,0,0,0
1667962795919,CSE 290,G00,102440,Christensen; Henrik I,0,0,20,20
1667962796349,CSE 291,A00,102443,Su; Hao,0,0,0,0
1667962796349,CSE 291,B00,102448,Polikarpova; Nadezhda,0,0,0,0
1667962796349,CSE 291,C00,102453,Vaccaro; Kristen Marie,0,0,0,0
1667962796349,CSE 291,D00,111343,Savage; Stefan,0,0,0,0
1667962796349,CSE 291,E00,116474,Claffy; Kimberly Claire,0,0,0,0
1667962796349,CSE 291,F00,116479,Pasquale; Joseph,0,0,0,0
1667962796783,CSE 293,001,119111,Bafna; Vineet,9999,0,9999,0
1667962796783,CSE 293,002,119118,Bellare; Mihir,9999,0,9999,0
1667962796783,CSE 293,003,119122,Berg-Kirkpatrick; Taylor D,9999,0,9999,0
1667962796783,CSE 293,004,119135,Christensen; Henrik I,9999,0,9999,0
1667962796783,CSE 293,005,119142,Cottrell; Garrison W,9999,0,9999,0
1667962796783,CSE 293,006,119146,Deutsch; Alin Bernard,9999,0,9999,0
1667962796783,CSE 293,007,119159,Esmaeilzadeh; Hadi,9999,0,9999,0
1667962796783,CSE 293,008,119166,Freund; Yoav,9999,0,9999,0
1667962796783,CSE 293,009,119170,Griswold; William G.,9999,0,9999,0
1667962796783,CSE 293,010,119183,Gymrek; Melissa Ann,9999,0,9999,0
1667962796783,CSE 293,011,119190,Heninger; Nadia A,9999,0,9999,0
1667962796783,CSE 293,012,119230,Impagliazzo; Russell,9999,0,9999,0
1667962796783,CSE 293,013,119232,Jhala; Ranjit,9999,0,9999,0
1667962796783,CSE 293,014,119233,Kahng; Andrew Byun,9999,0,9999,0
1667962796783,CSE 293,015,119298,Kane; Daniel Mertz,9999,0,9999,0
1667962796783,CSE 293,016,119299,Kriegman; David J,9999,0,9999,0
1667962796783,CSE 293,017,119300,Kumar; Arun Kumar,9999,0,9999,0
1667962796783,CSE 293,018,119301,Lerner; Sorin,9999,0,9999,0
1667962796783,CSE 293,019,119302,Lovett; Shachar,9999,0,9999,0
1667962796783,CSE 293,020,119303,McAuley; Julian John,9999,0,9999,0
1667962796783,CSE 293,021,119304,Micciancio; Daniele,9999,0,9999,0
1667962796783,CSE 293,022,119367,Orailoglu; Alex,9999,0,9999,0
1667962796783,CSE 293,023,119382,Paturi; Ramamohan,9999,0,9999,0
1667962796783,CSE 293,024,119404,Polikarpova; Nadezhda,9999,0,9999,0
1667962796783,CSE 293,025,119406,Politz; Joseph Gibbs,9999,0,9999,0
1667962796783,CSE 293,026,119411,Porter; George M,9999,0,9999,0
1667962796783,CSE 293,027,119414,Porter; Leonard Emerson,9999,0,9999,0
1667962796783,CSE 293,028,119416,Ramamoorthi; Ravi,9999,0,9999,0
1667962796783,CSE 293,029,119417,Sahoo; Debashis,9999,0,9999,0
1667962796783,CSE 293,030,119420,Saul; Lawrence,9999,0,9999,0
1667962796783,CSE 293,031,119421,Savage; Stefan,9999,0,9999,0
1667962796783,CSE 293,032,119425,Schulze; Jurgen P.,9999,0,9999,0
1667962796783,CSE 293,033,119426,Snoeren; Alex C.,9999,0,9999,0
1667962796783,CSE 293,034,119428,Shang; Jingbo,9999,0,9999,0
1667962796783,CSE 293,035,119430,Stefan; Deian,9999,0,9999,0
1667962796783,CSE 293,036,119431,Su; Hao,9999,0,9999,0
1667962796783,CSE 293,037,119433,Swanson; Steven James,9999,0,9999,0
1667962796783,CSE 293,038,119435,Tullsen; Dean Michael,9999,0,9999,0
1667962796783,CSE 293,039,119483,Voelker; Geoffrey M.,9999,0,9999,0
1667962796783,CSE 293,040,119537,Zhao; Jishen,9999,0,9999,0
1667962796783,CSE 293,041,119538,Zhou; Yuan-Yuan,9999,0,9999,0
1667962796783,CSE 293,042,119539,Gao; Sicun,9999,0,9999,0
1667962796783,CSE 293,043,119540,Weibel; Nadir,9999,0,9999,0
1667962796783,CSE 293,044,119541,Gupta; Rajesh K.,9999,0,9999,0
1667962797300,CSE 294,A00,102459,Voelker; Geoffrey M.,0,0,0,0
1667962797300,CSE 294,B00,111322,Orailoglu; Alex,0,0,0,0
1667962797724,DSE 201,A00,096914,Deutsch; Alin Bernard,30,0,30,0
1667962798147,DSE 210,A00,096915,Dasgupta; Sanjoy,30,0,30,0
1667962798573,DSE 260A,A00,096916,Altintas De Callaf; Ilkay,30,0,30,0
1667962799015,ECE 200,001,103586,Antipa; Nicholas A,9999,0,9999,0
1667962799015,ECE 200,002,103587,Atanasov; Nikolay A.,9999,0,9999,0
1667962799015,ECE 200,003,103588,Bharadia; Dinesh,9999,0,9999,0
1667962799015,ECE 200,004,103589,Cheng; Chung Kuan,9999,0,9999,0
1667962799015,ECE 200,005,103590,Cosman; Pamela C.,9999,0,9999,0
1667962799015,ECE 200,006,103591,Dayeh; Shadi Ahmad,9999,0,9999,0
1667962799015,ECE 200,007,103592,Fainman; Yeshaiahu,9999,0,9999,0
1667962799015,ECE 200,008,103593,Ford; Joseph Earl,9999,0,9999,0
1667962799015,ECE 200,009,103594,Franceschetti; Massimo,9999,0,9999,0
1667962799015,ECE 200,010,103595,Fullerton; Eric E,9999,0,9999,0
1667962799015,ECE 200,011,103596,Galton; Ian A,9999,0,9999,0
1667962799015,ECE 200,012,103597,Gilja; Vikash,9999,0,9999,0
1667962799015,ECE 200,013,103598,Hall; Drew A.,9999,0,9999,0
1667962799015,ECE 200,014,103599,Hsueh; Tzu-Chien,9999,0,9999,0
1667962799015,ECE 200,015,103600,Javidi; Tara,9999,0,9999,0
1667962799015,ECE 200,016,103601,Kahng; Andrew Byun,9999,0,9999,0
1667962799015,ECE 200,017,103602,Kim; Young-Han,9999,0,9999,0
1667962799015,ECE 200,018,103603,Koushanfar; Farinaz,9999,0,9999,0
1667962799015,ECE 200,019,103604,Kuzum; Duygu,9999,0,9999,0
1667962799015,ECE 200,020,103605,Le; Hanh-Phuc,9999,0,9999,0
1667962799015,ECE 200,021,103606,Lin; Bill,9999,0,9999,0
1667962799015,ECE 200,022,103607,Liu; Zhaowei,9998,0,9999,1
1667962799015,ECE 200,023,103608,Lo; Yu-Hwa,9999,0,9999,0
1667962799015,ECE 200,024,103609,Lomakin; Vitaliy,9999,0,9999,0
1667962799015,ECE 200,025,103610,Mercier; Patrick Philip,9999,0,9999,0
1667962799015,ECE 200,026,103611,Meyer; Florian,9999,0,9999,0
1667962799015,ECE 200,027,103612,Milstein; Laurence B.,9999,0,9999,0
1667962799015,ECE 200,028,103613,Mir Arabbaygi; Siavash,9999,0,9999,0
1667962799015,ECE 200,029,103614,Mookherjea; Shayan,9999,0,9999,0
1667962799015,ECE 200,030,103615,Morris; Karcher William,9999,0,9999,0
1667962799015,ECE 200,031,103616,Ng; Tse Nga,9999,0,9999,0
1667962799015,ECE 200,032,103617,Nguyen; Truong Quang,9999,0,9999,0
1667962799015,ECE 200,033,103618,Nomura; Kenji,9999,0,9999,0
1667962799015,ECE 200,034,103619,Orlitsky; Alon,9999,0,9999,0
1667962799015,ECE 200,035,103620,Pal; Piya,9999,0,9999,0
1667962799015,ECE 200,036,103621,Papen; George C.,9999,0,9999,0
1667962799015,ECE 200,037,103622,Radic; Stojan,9999,0,9999,0
1667962799015,ECE 200,038,103623,Rao; Bhaskar D.,9999,0,9999,0
1667962799015,ECE 200,039,103624,Rao; Ramesh R,9999,0,9999,0
1667962799015,ECE 200,040,103625,Rebeiz; Gabriel,9999,0,9999,0
1667962799015,ECE 200,041,103626,Sanford; John R,9999,0,9999,0
1667962799015,ECE 200,042,103627,Siegel; Paul H.,9999,0,9999,0
1667962799015,ECE 200,043,103628,Sievenpiper; Daniel F.,9999,0,9999,0
1667962799015,ECE 200,044,103629,Sworder; David D.,9999,0,9999,0
1667962799015,ECE 200,045,103630,Taur; Yuan,9999,0,9999,0
1667962799015,ECE 200,046,103631,Touri; Behrouz,9999,0,9999,0
1667962799015,ECE 200,047,103632,Trivedi; Mohan M.,9999,0,9999,0
1667962799015,ECE 200,048,103633,Vasconcelos; Nuno,9999,0,9999,0
1667962799015,ECE 200,049,103634,Wang; Xiaolong,9999,0,9999,0
1667962799015,ECE 200,050,103635,Xie; Pengtao,9999,0,9999,0
1667962799015,ECE 200,051,103636,Yip; Michael,9999,0,9999,0
1667962799015,ECE 200,052,103637,Zeger; Kenneth A.,999,0,999,0
1667962799015,ECE 200,053,103638,Zhang; Xinyu,9999,0,9999,0
1667962799015,ECE 200,054,103639,Turakhia; Yatish Girish,9999,0,9999,0
1667962799015,ECE 200,055,103640,Kang; Mingu,9999,0,9999,0
1667962799015,ECE 200,056,103641,Shi; Yuanyuan,9999,0,9999,0
1667962799015,ECE 200,057,103642,Wang; Edward Jay,9999,0,9999,0
1667962799015,ECE 200,058,103643,Zheng; Yang,9999,0,9999,0
1667962799439,ECE 202,A00,103644,Kuzum; Duygu,0,0,0,0
1667962799868,ECE 212BN,A00,103646,Ng; Tse Nga,0,0,0,0
1667962800290,ECE 221,A00,111493,Staff,0,0,0,0
1667962800717,ECE 222B,A00,103647,Lomakin; Vitaliy,0,0,0,0
1667962801140,ECE 230B,A00,103648,Taur; Yuan,0,0,0,0
1667962801562,ECE 238B,A00,103649,Garay; Javier,0,0,0,0
1667962801986,ECE 240B,A00,112900,Fainman; Yeshaiahu,0,0,0,0
1667962802420,ECE 247A,A00,103650,Jokerst; Jesse Vincent,0,0,0,0
1667962802844,ECE 247B,A00,103651,Wang; Joseph,0,0,0,0
1667962803276,ECE 250,A00,103652,Siegel; Paul H.,0,0,0,0
1667962803700,ECE 251A,A00,103654,Rao; Bhaskar D.,0,0,0,0
1667962804127,ECE 257B,A00,103655,Bharadia; Dinesh,0,0,0,0
1667962804556,ECE 258A,A00,103656,Milstein; Laurence B.,0,0,0,0
1667962804980,ECE 260B,A00,103658,Kang; Mingu,0,0,0,0
1667962805418,ECE 264A,A00,103659,Galton; Ian A,0,0,0,0
1667962805842,ECE 265A,A00,103661,Gudem; Prasad S.S.,0,0,0,0
1667962806278,ECE 265D,A00,103662,Gudem; Prasad S.S.,0,0,0,0
1667962806704,ECE 268,A00,103663,Koushanfar; Farinaz,0,0,0,0
1667962807136,ECE 269,A01,103665,Pal; Piya,0,0,0,0
1667962807565,ECE 271B,A00,103666,Vasconcelos; Manuela,0,0,0,0
1667962807990,ECE 276A,A00,103667,Atanasov; Nikolay A.,0,0,0,0
1667962808414,ECE 277,A00,103668,An; Cheolhong,0,0,0,0
1667962808839,ECE 279,A00,117947,Hall; Drew A.,0,0,0,0
1667962809696,ECE 283,A00,103670,Hsueh; Tzu-Chien,0,0,0,0
1667962810119,ECE 284,A00,103671,Turakhia; Yatish Girish,0,0,0,0
1667962810546,ECE 285,A00,103672,Zheng; Yang,0,0,0,0
1667962810546,ECE 285,B00,103673,Sworder; David D.,0,0,0,0
1667962810980,ECE 287,A00,103676,Javidi; Tara,0,0,0,0
1667962811413,MATH 200B,A00,098023,Salehi Golsefidy; Alireza,14,0,15,1
1667962811836,MATH 202B,A00,098024,Rhoades; Brendon Patrick,12,0,15,3
1667962812259,MATH 203B,A00,098025,Oprea; Dragos N.,12,0,15,3
1667962812687,MATH 204B,A00,098026,Sorensen; Claus M,14,0,15,1
1667962813109,MATH 208,A00,098027,Izadi; Elham,7,0,10,3
1667962813542,MATH 209,A00,098028,Pollack; Aaron,10,0,10,0
1667962813970,MATH 211A,A00,112919,Rogalski; Daniel,9,0,10,1
1667962814408,MATH 211B,A00,112920,Seward; Brandon M.,9,0,10,1
1667962814835,MATH 218,A00,098029,Li; Bo,10,0,10,0
1667962815260,MATH 220B,A00,098030,Novak; Jonathan I,13,0,15,2
1667962815682,MATH 221A,A00,098031,Ebenfelt; Peter F,13,0,15,2
1667962816119,MATH 231B,A00,098032,Zlatos; Andrej,12,0,15,3
1667962816542,MATH 240B,A00,098033,Ni; Lei,10,0,15,5
1667962816970,MATH 243,A00,098034,Jekel; David Andrew,10,0,10,0
1667962817399,MATH 245A,A00,098035,Nie; Jiawang,0,0,15,16
1667962817836,MATH 248,A00,098036,Bejenaru; Ioan,10,0,10,0
1667962818264,MATH 250B,A00,098037,Spolaor; Luca,14,0,15,1
1667962818690,MATH 258,A00,098038,Ni; Lei,10,0,10,0
1667962819113,MATH 264B,A00,098041,Rhoades; Brendon Patrick,12,0,15,3
1667962819545,MATH 268,A00,098042,Buss; Samuel R,10,0,10,0
1667962819970,MATH 269,A00,098043,Rhoades; Brendon Patrick,10,0,10,0
1667962820401,MATH 270B,A00,098044,Li; Bo,11,0,15,4
1667962820830,MATH 272B,A00,098045,Holst; Michael J,13,0,15,2
1667962821257,MATH 273A,A00,098046,Tian; Xiaochuan,12,0,15,3
1667962821683,MATH 275,A01,098048,Tian; Xiaochuan,6,0,10,4
1667962822111,MATH 278A,A00,098049,Holst; Michael J,8,0,10,2
1667962822625,MATH 278B,A00,098050,Cloninger; Alexander,10,0,10,0
1667962823054,MATH 278C,A00,098051,Nie; Jiawang,8,0,10,2
1667962823477,MATH 280B,A00,098052,Zheng; Tianyi,12,0,15,3
1667962823916,MATH 281B,A00,098053,Bradic; Jelena,4,0,15,11
1667962824338,MATH 282B,A00,098054,Arias-Castro; Ery,2,0,15,13
1667962824761,MATH 285,A00,098055,Fitzsimmons; Patrick J,0,0,15,17
1667962825190,MATH 287B,A00,098056,Arias-Castro; Ery,5,0,15,10
1667962825615,MATH 288,A00,098057,Agarwal; Pooja,9,0,10,1
1667962825615,MATH 288,B00,098058,Zhang; Danna,9,0,10,1
1667962825615,MATH 288,C00,098059,Williams; Ruth J,10,0,10,0
1667962826041,MATH 290B,A00,098060,Roberts; Justin Deritter,14,0,15,1
1667962826466,MATH 292,A00,098061,Belmont; Eva Kinoshita,10,0,10,0
1667962826891,MATH 295,A00,098062,Suk; Andrew Hoon,48,0,50,2
1667962827319,MATH 296,A00,098063,Novak; Jonathan I,20,0,20,0
1667962827748,MATH 297,001,098064,Gamst; Anthony Collins,9997,0,9999,2
1667963328933,COGS 205,A00,101395,Chiba; Andrea,19,0,20,1
1667963329357,COGS 210B,001,101404,Greene; Deanna Jacquelyn,9998,0,9999,1
1667963329357,COGS 210B,002,101417,Xia; Haijun,9999,0,9999,0
1667963329357,COGS 210B,003,101422,Nitz; Douglas A.,9999,0,9999,0
1667963329357,COGS 210B,004,101423,Hollan; James D.,9998,0,9999,1
1667963329357,COGS 210B,005,101424,Deak; Gedeon O.,9999,0,9999,0
1667963329357,COGS 210B,006,101425,Rossano; Federico,9999,0,9999,0
1667963329780,COGS 211B,A00,101427,Coulson; Seana M,9997,0,9999,2
1667963330206,COGS 220,A00,101428,Hollan; James D.,0,0,25,25
1667963330637,COGS 229,A00,101429,Dow; Steven P,18,0,25,7
1667963331079,COGS 230,A00,101430,Klemmer; Scott R,13,0,17,4
1667963331503,COGS 234,A00,101431,Xia; Haijun,7,0,25,18
1667963331931,COGS 260,A00,101432,Kiyonaga; Anastasia,20,0,25,5
1667963331931,COGS 260,B00,101433,Kirsh; David Joel,16,0,25,9
1667963332356,CSE 202,A00,102371,Impagliazzo; Russell,0,0,0,0
1667963332781,CSE 203B,A01,102373,Cheng; Chung Kuan,0,0,0,0
1667963333221,CSE 208,A00,102374,Micciancio; Daniele,0,0,0,0
1667963333647,CSE 209A,A00,112895,Impagliazzo; Russell,0,0,15,15
1667963334071,CSE 209B,A00,108005,Bellare; Mihir,0,0,0,0
1667963334502,CSE 210,A00,113163,Coblenz; Michael J,0,0,0,0
1667963334931,CSE 219,A00,106111,Dow; Steven P,0,0,20,20
1667963335365,CSE 221,A00,102376,Voelker; Geoffrey M.,0,0,0,0
1667963335791,CSE 224,A01,102378,Porter; George M,0,0,0,0
1667963336217,CSE 229A,A00,102379,Savage; Stefan,0,0,0,0
1667963336652,CSE 229C,A00,102380,Munyaka; Imani N. S.,0,0,0,0
1667963337085,CSE 232B,A00,102382,Deutsch; Alin Bernard,0,0,0,0
1667963337506,CSE 234,A01,112904,Kumar; Arun Kumar,0,0,0,0
1667963337932,CSE 237A,A00,102383,Rosing; Tajana Simunic,0,0,0,0
1667963338356,CSE 239A,A00,102384,Deutsch; Alin Bernard,0,0,0,0
1667963338780,CSE 239B,A00,102385,Polikarpova; Nadezhda,0,0,0,0
1667963339205,CSE 240A,A00,102386,Pannuto; Patrick William,0,0,0,0
1667963339630,CSE 240B,A00,102387,Zhao; Jishen,0,0,0,0
1667963340054,CSE 241A,A00,106406,Kang; Mingu,0,0,0,0
1667963340475,CSE 249B,A00,102388,Kahng; Andrew Byun,0,0,8,8
1667963340899,CSE 251B,A01,102392,Cottrell; Garrison W,0,0,0,0
1667963340899,CSE 251B,A02,102393,Cottrell; Garrison W,0,0,0,0
1667963341322,CSE 252B,A00,102394,Ochoa; Benjamin Lawrence,0,0,0,0
1667963341747,CSE 257,A01,102396,Gao; Sicun,0,0,0,0
1667963342171,CSE 272,A00,102397,Li; Tzumao,0,0,0,0
1667963342600,CSE 274,A00,111323,Chern; Albert Ren-Haur,0,0,0,0
1667963343039,CSE 282,A00,102398,Pevzner; Pavel Arkadjevich,0,0,0,0
1667963343480,CSE 284,A00,114175,Gymrek; Melissa Ann,0,0,0,0
1667963343906,CSE 290,A00,102399,Chandraker; Manmohan Krishna,0,0,0,0
1667963343906,CSE 290,B00,102400,Vaccaro; Kristen Marie,0,0,25,25
1667963343906,CSE 290,C00,102414,Pannuto; Patrick William,0,0,25,25
1667963343906,CSE 290,D00,102427,Pevzner; Pavel Arkadjevich,0,0,0,0
1667963343906,CSE 290,E00,102429,Zhao; Jishen,0,0,0,0
1667963343906,CSE 290,F00,102436,Tullsen; Dean Michael,0,0,0,0
1667963343906,CSE 290,G00,102440,Christensen; Henrik I,0,0,20,20
1667963344329,CSE 291,A00,102443,Su; Hao,0,0,0,0
1667963344329,CSE 291,B00,102448,Polikarpova; Nadezhda,0,0,0,0
1667963344329,CSE 291,C00,102453,Vaccaro; Kristen Marie,0,0,0,0
1667963344329,CSE 291,D00,111343,Savage; Stefan,0,0,0,0
1667963344329,CSE 291,E00,116474,Claffy; Kimberly Claire,0,0,0,0
1667963344329,CSE 291,F00,116479,Pasquale; Joseph,0,0,0,0
1667963344762,CSE 293,001,119111,Bafna; Vineet,9999,0,9999,0
1667963344762,CSE 293,002,119118,Bellare; Mihir,9999,0,9999,0
1667963344762,CSE 293,003,119122,Berg-Kirkpatrick; Taylor D,9999,0,9999,0
1667963344762,CSE 293,004,119135,Christensen; Henrik I,9999,0,9999,0
1667963344762,CSE 293,005,119142,Cottrell; Garrison W,9999,0,9999,0
1667963344762,CSE 293,006,119146,Deutsch; Alin Bernard,9999,0,9999,0
1667963344762,CSE 293,007,119159,Esmaeilzadeh; Hadi,9999,0,9999,0
1667963344762,CSE 293,008,119166,Freund; Yoav,9999,0,9999,0
1667963344762,CSE 293,009,119170,Griswold; William G.,9999,0,9999,0
1667963344762,CSE 293,010,119183,Gymrek; Melissa Ann,9999,0,9999,0
1667963344762,CSE 293,011,119190,Heninger; Nadia A,9999,0,9999,0
1667963344762,CSE 293,012,119230,Impagliazzo; Russell,9999,0,9999,0
1667963344762,CSE 293,013,119232,Jhala; Ranjit,9999,0,9999,0
1667963344762,CSE 293,014,119233,Kahng; Andrew Byun,9999,0,9999,0
1667963344762,CSE 293,015,119298,Kane; Daniel Mertz,9999,0,9999,0
1667963344762,CSE 293,016,119299,Kriegman; David J,9999,0,9999,0
1667963344762,CSE 293,017,119300,Kumar; Arun Kumar,9999,0,9999,0
1667963344762,CSE 293,018,119301,Lerner; Sorin,9999,0,9999,0
1667963344762,CSE 293,019,119302,Lovett; Shachar,9999,0,9999,0
1667963344762,CSE 293,020,119303,McAuley; Julian John,9999,0,9999,0
1667963344762,CSE 293,021,119304,Micciancio; Daniele,9999,0,9999,0
1667963344762,CSE 293,022,119367,Orailoglu; Alex,9999,0,9999,0
1667963344762,CSE 293,023,119382,Paturi; Ramamohan,9999,0,9999,0
1667963344762,CSE 293,024,119404,Polikarpova; Nadezhda,9999,0,9999,0
1667963344762,CSE 293,025,119406,Politz; Joseph Gibbs,9999,0,9999,0
1667963344762,CSE 293,026,119411,Porter; George M,9999,0,9999,0
1667963344762,CSE 293,027,119414,Porter; Leonard Emerson,9999,0,9999,0
1667963344762,CSE 293,028,119416,Ramamoorthi; Ravi,9999,0,9999,0
1667963344762,CSE 293,029,119417,Sahoo; Debashis,9999,0,9999,0
1667963344762,CSE 293,030,119420,Saul; Lawrence,9999,0,9999,0
1667963344762,CSE 293,031,119421,Savage; Stefan,9999,0,9999,0
1667963344762,CSE 293,032,119425,Schulze; Jurgen P.,9999,0,9999,0
1667963344762,CSE 293,033,119426,Snoeren; Alex C.,9999,0,9999,0
1667963344762,CSE 293,034,119428,Shang; Jingbo,9999,0,9999,0
1667963344762,CSE 293,035,119430,Stefan; Deian,9999,0,9999,0
1667963344762,CSE 293,036,119431,Su; Hao,9999,0,9999,0
1667963344762,CSE 293,037,119433,Swanson; Steven James,9999,0,9999,0
1667963344762,CSE 293,038,119435,Tullsen; Dean Michael,9999,0,9999,0
1667963344762,CSE 293,039,119483,Voelker; Geoffrey M.,9999,0,9999,0
1667963344762,CSE 293,040,119537,Zhao; Jishen,9999,0,9999,0
1667963344762,CSE 293,041,119538,Zhou; Yuan-Yuan,9999,0,9999,0
1667963344762,CSE 293,042,119539,Gao; Sicun,9999,0,9999,0
1667963344762,CSE 293,043,119540,Weibel; Nadir,9999,0,9999,0
1667963344762,CSE 293,044,119541,Gupta; Rajesh K.,9999,0,9999,0
1667963345185,CSE 294,A00,102459,Voelker; Geoffrey M.,0,0,0,0
1667963345185,CSE 294,B00,111322,Orailoglu; Alex,0,0,0,0
1667963345623,DSE 201,A00,096914,Deutsch; Alin Bernard,30,0,30,0
1667963346049,DSE 210,A00,096915,Dasgupta; Sanjoy,30,0,30,0
1667963346472,DSE 260A,A00,096916,Altintas De Callaf; Ilkay,30,0,30,0
1667963346915,ECE 200,001,103586,Antipa; Nicholas A,9999,0,9999,0
1667963346915,ECE 200,002,103587,Atanasov; Nikolay A.,9999,0,9999,0
1667963346915,ECE 200,003,103588,Bharadia; Dinesh,9999,0,9999,0
1667963346915,ECE 200,004,103589,Cheng; Chung Kuan,9999,0,9999,0
1667963346915,ECE 200,005,103590,Cosman; Pamela C.,9999,0,9999,0
1667963346915,ECE 200,006,103591,Dayeh; Shadi Ahmad,9999,0,9999,0
1667963346915,ECE 200,007,103592,Fainman; Yeshaiahu,9999,0,9999,0
1667963346915,ECE 200,008,103593,Ford; Joseph Earl,9999,0,9999,0
1667963346915,ECE 200,009,103594,Franceschetti; Massimo,9999,0,9999,0
1667963346915,ECE 200,010,103595,Fullerton; Eric E,9999,0,9999,0
1667963346915,ECE 200,011,103596,Galton; Ian A,9999,0,9999,0
1667963346915,ECE 200,012,103597,Gilja; Vikash,9999,0,9999,0
1667963346915,ECE 200,013,103598,Hall; Drew A.,9999,0,9999,0
1667963346915,ECE 200,014,103599,Hsueh; Tzu-Chien,9999,0,9999,0
1667963346915,ECE 200,015,103600,Javidi; Tara,9999,0,9999,0
1667963346915,ECE 200,016,103601,Kahng; Andrew Byun,9999,0,9999,0
1667963346915,ECE 200,017,103602,Kim; Young-Han,9999,0,9999,0
1667963346915,ECE 200,018,103603,Koushanfar; Farinaz,9999,0,9999,0
1667963346915,ECE 200,019,103604,Kuzum; Duygu,9999,0,9999,0
1667963346915,ECE 200,020,103605,Le; Hanh-Phuc,9999,0,9999,0
1667963346915,ECE 200,021,103606,Lin; Bill,9999,0,9999,0
1667963346915,ECE 200,022,103607,Liu; Zhaowei,9998,0,9999,1
1667963346915,ECE 200,023,103608,Lo; Yu-Hwa,9999,0,9999,0
1667963346915,ECE 200,024,103609,Lomakin; Vitaliy,9999,0,9999,0
1667963346915,ECE 200,025,103610,Mercier; Patrick Philip,9999,0,9999,0
1667963346915,ECE 200,026,103611,Meyer; Florian,9999,0,9999,0
1667963346915,ECE 200,027,103612,Milstein; Laurence B.,9999,0,9999,0
1667963346915,ECE 200,028,103613,Mir Arabbaygi; Siavash,9999,0,9999,0
1667963346915,ECE 200,029,103614,Mookherjea; Shayan,9999,0,9999,0
1667963346915,ECE 200,030,103615,Morris; Karcher William,9999,0,9999,0
1667963346915,ECE 200,031,103616,Ng; Tse Nga,9999,0,9999,0
1667963346915,ECE 200,032,103617,Nguyen; Truong Quang,9999,0,9999,0
1667963346915,ECE 200,033,103618,Nomura; Kenji,9999,0,9999,0
1667963346915,ECE 200,034,103619,Orlitsky; Alon,9999,0,9999,0
1667963346915,ECE 200,035,103620,Pal; Piya,9999,0,9999,0
1667963346915,ECE 200,036,103621,Papen; George C.,9999,0,9999,0
1667963346915,ECE 200,037,103622,Radic; Stojan,9999,0,9999,0
1667963346915,ECE 200,038,103623,Rao; Bhaskar D.,9999,0,9999,0
1667963346915,ECE 200,039,103624,Rao; Ramesh R,9999,0,9999,0
1667963346915,ECE 200,040,103625,Rebeiz; Gabriel,9999,0,9999,0
1667963346915,ECE 200,041,103626,Sanford; John R,9999,0,9999,0
1667963346915,ECE 200,042,103627,Siegel; Paul H.,9999,0,9999,0
1667963346915,ECE 200,043,103628,Sievenpiper; Daniel F.,9999,0,9999,0
1667963346915,ECE 200,044,103629,Sworder; David D.,9999,0,9999,0
1667963346915,ECE 200,045,103630,Taur; Yuan,9999,0,9999,0
1667963346915,ECE 200,046,103631,Touri; Behrouz,9999,0,9999,0
1667963346915,ECE 200,047,103632,Trivedi; Mohan M.,9999,0,9999,0
1667963346915,ECE 200,048,103633,Vasconcelos; Nuno,9999,0,9999,0
1667963346915,ECE 200,049,103634,Wang; Xiaolong,9999,0,9999,0
1667963346915,ECE 200,050,103635,Xie; Pengtao,9999,0,9999,0
1667963346915,ECE 200,051,103636,Yip; Michael,9999,0,9999,0
1667963346915,ECE 200,052,103637,Zeger; Kenneth A.,999,0,999,0
1667963346915,ECE 200,053,103638,Zhang; Xinyu,9999,0,9999,0
1667963346915,ECE 200,054,103639,Turakhia; Yatish Girish,9999,0,9999,0
1667963346915,ECE 200,055,103640,Kang; Mingu,9999,0,9999,0
1667963346915,ECE 200,056,103641,Shi; Yuanyuan,9999,0,9999,0
1667963346915,ECE 200,057,103642,Wang; Edward Jay,9999,0,9999,0
1667963346915,ECE 200,058,103643,Zheng; Yang,9999,0,9999,0
1667963347341,ECE 202,A00,103644,Kuzum; Duygu,0,0,0,0
1667963347771,ECE 212BN,A00,103646,Ng; Tse Nga,0,0,0,0
1667963348196,ECE 221,A00,111493,Staff,0,0,0,0
1667963348622,ECE 222B,A00,103647,Lomakin; Vitaliy,0,0,0,0
1667963349046,ECE 230B,A00,103648,Taur; Yuan,0,0,0,0
1667963349477,ECE 238B,A00,103649,Garay; Javier,0,0,0,0
1667963349899,ECE 240B,A00,112900,Fainman; Yeshaiahu,0,0,0,0
1667963350322,ECE 247A,A00,103650,Jokerst; Jesse Vincent,0,0,0,0
1667963350805,ECE 247B,A00,103651,Wang; Joseph,0,0,0,0
1667963351233,ECE 250,A00,103652,Siegel; Paul H.,0,0,0,0
1667963351658,ECE 251A,A00,103654,Rao; Bhaskar D.,0,0,0,0
1667963352081,ECE 257B,A00,103655,Bharadia; Dinesh,0,0,0,0
1667963352504,ECE 258A,A00,103656,Milstein; Laurence B.,0,0,0,0
1667963352933,ECE 260B,A00,103658,Kang; Mingu,0,0,0,0
1667963353357,ECE 264A,A00,103659,Galton; Ian A,0,0,0,0
1667963353781,ECE 265A,A00,103661,Gudem; Prasad S.S.,0,0,0,0
1667963354202,ECE 265D,A00,103662,Gudem; Prasad S.S.,0,0,0,0
1667963354637,ECE 268,A00,103663,Koushanfar; Farinaz,0,0,0,0
1667963355066,ECE 269,A01,103665,Pal; Piya,0,0,0,0
1667963355492,ECE 271B,A00,103666,Vasconcelos; Manuela,0,0,0,0
1667963355919,ECE 276A,A00,103667,Atanasov; Nikolay A.,0,0,0,0
1667963356348,ECE 277,A00,103668,An; Cheolhong,0,0,0,0
1667963356771,ECE 279,A00,117947,Hall; Drew A.,0,0,0,0
1667963357631,ECE 283,A00,103670,Hsueh; Tzu-Chien,0,0,0,0
1667963358056,ECE 284,A00,103671,Turakhia; Yatish Girish,0,0,0,0
1667963358482,ECE 285,A00,103672,Zheng; Yang,0,0,0,0
1667963358482,ECE 285,B00,103673,Sworder; David D.,0,0,0,0
1667963358905,ECE 287,A00,103676,Javidi; Tara,0,0,0,0
1667963359338,MATH 200B,A00,098023,Salehi Golsefidy; Alireza,14,0,15,1
1667963359776,MATH 202B,A00,098024,Rhoades; Brendon Patrick,12,0,15,3
1667963360200,MATH 203B,A00,098025,Oprea; Dragos N.,12,0,15,3
1667963360624,MATH 204B,A00,098026,Sorensen; Claus M,14,0,15,1
1667963361046,MATH 208,A00,098027,Izadi; Elham,7,0,10,3
1667963361468,MATH 209,A00,098028,Pollack; Aaron,10,0,10,0
1667963361981,MATH 211A,A00,112919,Rogalski; Daniel,9,0,10,1
1667963362406,MATH 211B,A00,112920,Seward; Brandon M.,9,0,10,1
1667963362852,MATH 218,A00,098029,Li; Bo,10,0,10,0
1667963363277,MATH 220B,A00,098030,Novak; Jonathan I,13,0,15,2
1667963363700,MATH 221A,A00,098031,Ebenfelt; Peter F,13,0,15,2
1667963364123,MATH 231B,A00,098032,Zlatos; Andrej,12,0,15,3
1667963364545,MATH 240B,A00,098033,Ni; Lei,10,0,15,5
1667963364970,MATH 243,A00,098034,Jekel; David Andrew,10,0,10,0
1667963365391,MATH 245A,A00,098035,Nie; Jiawang,0,0,15,16
1667963365814,MATH 248,A00,098036,Bejenaru; Ioan,10,0,10,0
1667963366239,MATH 250B,A00,098037,Spolaor; Luca,14,0,15,1
1667963366669,MATH 258,A00,098038,Ni; Lei,10,0,10,0
1667963367098,MATH 264B,A00,098041,Rhoades; Brendon Patrick,12,0,15,3
1667963367519,MATH 268,A00,098042,Buss; Samuel R,10,0,10,0
1667963367940,MATH 269,A00,098043,Rhoades; Brendon Patrick,10,0,10,0
1667963368363,MATH 270B,A00,098044,Li; Bo,11,0,15,4
1667963368787,MATH 272B,A00,098045,Holst; Michael J,13,0,15,2
1667963369216,MATH 273A,A00,098046,Tian; Xiaochuan,12,0,15,3
1667963369646,MATH 275,A01,098048,Tian; Xiaochuan,6,0,10,4
1667963370068,MATH 278A,A00,098049,Holst; Michael J,8,0,10,2
1667963370491,MATH 278B,A00,098050,Cloninger; Alexander,10,0,10,0
1667963370914,MATH 278C,A00,098051,Nie; Jiawang,8,0,10,2
1667963371353,MATH 280B,A00,098052,Zheng; Tianyi,12,0,15,3
1667963371778,MATH 281B,A00,098053,Bradic; Jelena,4,0,15,11
1667963372202,MATH 282B,A00,098054,Arias-Castro; Ery,2,0,15,13
1667963372629,MATH 285,A00,098055,Fitzsimmons; Patrick J,0,0,15,17
1667963373075,MATH 287B,A00,098056,Arias-Castro; Ery,5,0,15,10
1667963373498,MATH 288,A00,098057,Agarwal; Pooja,9,0,10,1
1667963373498,MATH 288,B00,098058,Zhang; Danna,9,0,10,1
1667963373498,MATH 288,C00,098059,Williams; Ruth J,10,0,10,0
1667963373937,MATH 290B,A00,098060,Roberts; Justin Deritter,14,0,15,1
1667963374358,MATH 292,A00,098061,Belmont; Eva Kinoshita,10,0,10,0
1667963374784,MATH 295,A00,098062,Suk; Andrew Hoon,48,0,50,2
1667963375213,MATH 296,A00,098063,Novak; Jonathan I,20,0,20,0
1667963375637,MATH 297,001,098064,Gamst; Anthony Collins,9997,0,9999,2
1667963876037,COGS 205,A00,101395,Chiba; Andrea,19,0,20,1
1667963876462,COGS 210B,001,101404,Greene; Deanna Jacquelyn,9998,0,9999,1
1667963876462,COGS 210B,002,101417,Xia; Haijun,9999,0,9999,0
1667963876462,COGS 210B,003,101422,Nitz; Douglas A.,9999,0,9999,0
1667963876462,COGS 210B,004,101423,Hollan; James D.,9998,0,9999,1
1667963876462,COGS 210B,005,101424,Deak; Gedeon O.,9999,0,9999,0
1667963876462,COGS 210B,006,101425,Rossano; Federico,9999,0,9999,0
1667963876888,COGS 211B,A00,101427,Coulson; Seana M,9997,0,9999,2
1667963877310,COGS 220,A00,101428,Hollan; James D.,0,0,25,25
1667963877734,COGS 229,A00,101429,Dow; Steven P,18,0,25,7
1667963878161,COGS 230,A00,101430,Klemmer; Scott R,13,0,17,4
1667963878583,COGS 234,A00,101431,Xia; Haijun,7,0,25,18
1667963879159,COGS 260,A00,101432,Kiyonaga; Anastasia,20,0,25,5
1667963879159,COGS 260,B00,101433,Kirsh; David Joel,16,0,25,9
1667963879584,CSE 202,A00,102371,Impagliazzo; Russell,0,0,0,0
1667963880011,CSE 203B,A01,102373,Cheng; Chung Kuan,0,0,0,0
1667963880434,CSE 208,A00,102374,Micciancio; Daniele,0,0,0,0
1667963880864,CSE 209A,A00,112895,Impagliazzo; Russell,0,0,15,15
1667963881294,CSE 209B,A00,108005,Bellare; Mihir,0,0,0,0
1667963881716,CSE 210,A00,113163,Coblenz; Michael J,0,0,0,0
1667963882147,CSE 219,A00,106111,Dow; Steven P,0,0,20,20
1667963882664,CSE 221,A00,102376,Voelker; Geoffrey M.,0,0,0,0
1667963883093,CSE 224,A01,102378,Porter; George M,0,0,0,0
1667963883523,CSE 229A,A00,102379,Savage; Stefan,0,0,0,0
1667963883945,CSE 229C,A00,102380,Munyaka; Imani N. S.,0,0,0,0
1667963884372,CSE 232B,A00,102382,Deutsch; Alin Bernard,0,0,0,0
1667963884794,CSE 234,A01,112904,Kumar; Arun Kumar,0,0,0,0
1667963885217,CSE 237A,A00,102383,Rosing; Tajana Simunic,0,0,0,0
1667963885650,CSE 239A,A00,102384,Deutsch; Alin Bernard,0,0,0,0
1667963886076,CSE 239B,A00,102385,Polikarpova; Nadezhda,0,0,0,0
1667963886503,CSE 240A,A00,102386,Pannuto; Patrick William,0,0,0,0
1667963886927,CSE 240B,A00,102387,Zhao; Jishen,0,0,0,0
1667963887356,CSE 241A,A00,106406,Kang; Mingu,0,0,0,0
1667963887780,CSE 249B,A00,102388,Kahng; Andrew Byun,0,0,8,8
1667963888208,CSE 251B,A01,102392,Cottrell; Garrison W,0,0,0,0
1667963888208,CSE 251B,A02,102393,Cottrell; Garrison W,0,0,0,0
1667963888632,CSE 252B,A00,102394,Ochoa; Benjamin Lawrence,0,0,0,0
1667963889057,CSE 257,A01,102396,Gao; Sicun,0,0,0,0
1667963889482,CSE 272,A00,102397,Li; Tzumao,0,0,0,0
1667963889905,CSE 274,A00,111323,Chern; Albert Ren-Haur,0,0,0,0
1667963890332,CSE 282,A00,102398,Pevzner; Pavel Arkadjevich,0,0,0,0
1667963890771,CSE 284,A00,114175,Gymrek; Melissa Ann,0,0,0,0
1667963891194,CSE 290,A00,102399,Chandraker; Manmohan Krishna,0,0,0,0
1667963891194,CSE 290,B00,102400,Vaccaro; Kristen Marie,0,0,25,25
1667963891194,CSE 290,C00,102414,Pannuto; Patrick William,0,0,25,25
1667963891194,CSE 290,D00,102427,Pevzner; Pavel Arkadjevich,0,0,0,0
1667963891194,CSE 290,E00,102429,Zhao; Jishen,0,0,0,0
1667963891194,CSE 290,F00,102436,Tullsen; Dean Michael,0,0,0,0
1667963891194,CSE 290,G00,102440,Christensen; Henrik I,0,0,20,20
1667963891625,CSE 291,A00,102443,Su; Hao,0,0,0,0
1667963891625,CSE 291,B00,102448,Polikarpova; Nadezhda,0,0,0,0
1667963891625,CSE 291,C00,102453,Vaccaro; Kristen Marie,0,0,0,0
1667963891625,CSE 291,D00,111343,Savage; Stefan,0,0,0,0
1667963891625,CSE 291,E00,116474,Claffy; Kimberly Claire,0,0,0,0
1667963891625,CSE 291,F00,116479,Pasquale; Joseph,0,0,0,0
1667963892085,CSE 293,001,119111,Bafna; Vineet,9999,0,9999,0
1667963892085,CSE 293,002,119118,Bellare; Mihir,9999,0,9999,0
1667963892085,CSE 293,003,119122,Berg-Kirkpatrick; Taylor D,9999,0,9999,0
1667963892085,CSE 293,004,119135,Christensen; Henrik I,9999,0,9999,0
1667963892085,CSE 293,005,119142,Cottrell; Garrison W,9999,0,9999,0
1667963892085,CSE 293,006,119146,Deutsch; Alin Bernard,9999,0,9999,0
1667963892085,CSE 293,007,119159,Esmaeilzadeh; Hadi,9999,0,9999,0
1667963892085,CSE 293,008,119166,Freund; Yoav,9999,0,9999,0
1667963892085,CSE 293,009,119170,Griswold; William G.,9999,0,9999,0
1667963892085,CSE 293,010,119183,Gymrek; Melissa Ann,9999,0,9999,0
1667963892085,CSE 293,011,119190,Heninger; Nadia A,9999,0,9999,0
1667963892085,CSE 293,012,119230,Impagliazzo; Russell,9999,0,9999,0
1667963892085,CSE 293,013,119232,Jhala; Ranjit,9999,0,9999,0
1667963892085,CSE 293,014,119233,Kahng; Andrew Byun,9999,0,9999,0
1667963892085,CSE 293,015,119298,Kane; Daniel Mertz,9999,0,9999,0
1667963892085,CSE 293,016,119299,Kriegman; David J,9999,0,9999,0
1667963892085,CSE 293,017,119300,Kumar; Arun Kumar,9999,0,9999,0
1667963892085,CSE 293,018,119301,Lerner; Sorin,9999,0,9999,0
1667963892085,CSE 293,019,119302,Lovett; Shachar,9999,0,9999,0
1667963892085,CSE 293,020,119303,McAuley; Julian John,9999,0,9999,0
1667963892085,CSE 293,021,119304,Micciancio; Daniele,9999,0,9999,0
1667963892085,CSE 293,022,119367,Orailoglu; Alex,9999,0,9999,0
1667963892085,CSE 293,023,119382,Paturi; Ramamohan,9999,0,9999,0
1667963892085,CSE 293,024,119404,Polikarpova; Nadezhda,9999,0,9999,0
1667963892085,CSE 293,025,119406,Politz; Joseph Gibbs,9999,0,9999,0
1667963892085,CSE 293,026,119411,Porter; George M,9999,0,9999,0
1667963892085,CSE 293,027,119414,Porter; Leonard Emerson,9999,0,9999,0
1667963892085,CSE 293,028,119416,Ramamoorthi; Ravi,9999,0,9999,0
1667963892085,CSE 293,029,119417,Sahoo; Debashis,9999,0,9999,0
1667963892085,CSE 293,030,119420,Saul; Lawrence,9999,0,9999,0
1667963892085,CSE 293,031,119421,Savage; Stefan,9999,0,9999,0
1667963892085,CSE 293,032,119425,Schulze; Jurgen P.,9999,0,9999,0
1667963892085,CSE 293,033,119426,Snoeren; Alex C.,9999,0,9999,0
1667963892085,CSE 293,034,119428,Shang; Jingbo,9999,0,9999,0
1667963892085,CSE 293,035,119430,Stefan; Deian,9999,0,9999,0
1667963892085,CSE 293,036,119431,Su; Hao,9999,0,9999,0
1667963892085,CSE 293,037,119433,Swanson; Steven James,9999,0,9999,0
1667963892085,CSE 293,038,119435,Tullsen; Dean Michael,9999,0,9999,0
1667963892085,CSE 293,039,119483,Voelker; Geoffrey M.,9999,0,9999,0
1667963892085,CSE 293,040,119537,Zhao; Jishen,9999,0,9999,0
1667963892085,CSE 293,041,119538,Zhou; Yuan-Yuan,9999,0,9999,0
1667963892085,CSE 293,042,119539,Gao; Sicun,9999,0,9999,0
1667963892085,CSE 293,043,119540,Weibel; Nadir,9999,0,9999,0
1667963892085,CSE 293,044,119541,Gupta; Rajesh K.,9999,0,9999,0
1667963892506,CSE 294,A00,102459,Voelker; Geoffrey M.,0,0,0,0
1667963892506,CSE 294,B00,111322,Orailoglu; Alex,0,0,0,0
1667963892933,DSE 201,A00,096914,Deutsch; Alin Bernard,30,0,30,0
1667963893358,DSE 210,A00,096915,Dasgupta; Sanjoy,30,0,30,0
1667963893789,DSE 260A,A00,096916,Altintas De Callaf; Ilkay,30,0,30,0
1667963894224,ECE 200,001,103586,Antipa; Nicholas A,9999,0,9999,0
1667963894224,ECE 200,002,103587,Atanasov; Nikolay A.,9999,0,9999,0
1667963894224,ECE 200,003,103588,Bharadia; Dinesh,9999,0,9999,0
1667963894224,ECE 200,004,103589,Cheng; Chung Kuan,9999,0,9999,0
1667963894224,ECE 200,005,103590,Cosman; Pamela C.,9999,0,9999,0
1667963894224,ECE 200,006,103591,Dayeh; Shadi Ahmad,9999,0,9999,0
1667963894224,ECE 200,007,103592,Fainman; Yeshaiahu,9999,0,9999,0
1667963894224,ECE 200,008,103593,Ford; Joseph Earl,9999,0,9999,0
1667963894224,ECE 200,009,103594,Franceschetti; Massimo,9999,0,9999,0
1667963894224,ECE 200,010,103595,Fullerton; Eric E,9999,0,9999,0
1667963894224,ECE 200,011,103596,Galton; Ian A,9999,0,9999,0
1667963894224,ECE 200,012,103597,Gilja; Vikash,9999,0,9999,0
1667963894224,ECE 200,013,103598,Hall; Drew A.,9999,0,9999,0
1667963894224,ECE 200,014,103599,Hsueh; Tzu-Chien,9999,0,9999,0
1667963894224,ECE 200,015,103600,Javidi; Tara,9999,0,9999,0
1667963894224,ECE 200,016,103601,Kahng; Andrew Byun,9999,0,9999,0
1667963894224,ECE 200,017,103602,Kim; Young-Han,9999,0,9999,0
1667963894224,ECE 200,018,103603,Koushanfar; Farinaz,9999,0,9999,0
1667963894224,ECE 200,019,103604,Kuzum; Duygu,9999,0,9999,0
1667963894224,ECE 200,020,103605,Le; Hanh-Phuc,9999,0,9999,0
1667963894224,ECE 200,021,103606,Lin; Bill,9999,0,9999,0
1667963894224,ECE 200,022,103607,Liu; Zhaowei,9998,0,9999,1
1667963894224,ECE 200,023,103608,Lo; Yu-Hwa,9999,0,9999,0
1667963894224,ECE 200,024,103609,Lomakin; Vitaliy,9999,0,9999,0
1667963894224,ECE 200,025,103610,Mercier; Patrick Philip,9999,0,9999,0
1667963894224,ECE 200,026,103611,Meyer; Florian,9999,0,9999,0
1667963894224,ECE 200,027,103612,Milstein; Laurence B.,9999,0,9999,0
1667963894224,ECE 200,028,103613,Mir Arabbaygi; Siavash,9999,0,9999,0
1667963894224,ECE 200,029,103614,Mookherjea; Shayan,9999,0,9999,0
1667963894224,ECE 200,030,103615,Morris; Karcher William,9999,0,9999,0
1667963894224,ECE 200,031,103616,Ng; Tse Nga,9999,0,9999,0
1667963894224,ECE 200,032,103617,Nguyen; Truong Quang,9999,0,9999,0
1667963894224,ECE 200,033,103618,Nomura; Kenji,9999,0,9999,0
1667963894224,ECE 200,034,103619,Orlitsky; Alon,9999,0,9999,0
1667963894224,ECE 200,035,103620,Pal; Piya,9999,0,9999,0
1667963894224,ECE 200,036,103621,Papen; George C.,9999,0,9999,0
1667963894224,ECE 200,037,103622,Radic; Stojan,9999,0,9999,0
1667963894224,ECE 200,038,103623,Rao; Bhaskar D.,9999,0,9999,0
1667963894224,ECE 200,039,103624,Rao; Ramesh R,9999,0,9999,0
1667963894224,ECE 200,040,103625,Rebeiz; Gabriel,9999,0,9999,0
1667963894224,ECE 200,041,103626,Sanford; John R,9999,0,9999,0
1667963894224,ECE 200,042,103627,Siegel; Paul H.,9999,0,9999,0
1667963894224,ECE 200,043,103628,Sievenpiper; Daniel F.,9999,0,9999,0
1667963894224,ECE 200,044,103629,Sworder; David D.,9999,0,9999,0
1667963894224,ECE 200,045,103630,Taur; Yuan,9999,0,9999,0
1667963894224,ECE 200,046,103631,Touri; Behrouz,9999,0,9999,0
1667963894224,ECE 200,047,103632,Trivedi; Mohan M.,9999,0,9999,0
1667963894224,ECE 200,048,103633,Vasconcelos; Nuno,9999,0,9999,0
1667963894224,ECE 200,049,103634,Wang; Xiaolong,9999,0,9999,0
1667963894224,ECE 200,050,103635,Xie; Pengtao,9999,0,9999,0
1667963894224,ECE 200,051,103636,Yip; Michael,9999,0,9999,0
1667963894224,ECE 200,052,103637,Zeger; Kenneth A.,999,0,999,0
1667963894224,ECE 200,053,103638,Zhang; Xinyu,9999,0,9999,0
1667963894224,ECE 200,054,103639,Turakhia; Yatish Girish,9999,0,9999,0
1667963894224,ECE 200,055,103640,Kang; Mingu,9999,0,9999,0
1667963894224,ECE 200,056,103641,Shi; Yuanyuan,9999,0,9999,0
1667963894224,ECE 200,057,103642,Wang; Edward Jay,9999,0,9999,0
1667963894224,ECE 200,058,103643,Zheng; Yang,9999,0,9999,0
1667963894649,ECE 202,A00,103644,Kuzum; Duygu,0,0,0,0
1667963895084,ECE 212BN,A00,103646,Ng; Tse Nga,0,0,0,0
1667963895508,ECE 221,A00,111493,Staff,0,0,0,0
1667963895939,ECE 222B,A00,103647,Lomakin; Vitaliy,0,0,0,0
1667963896372,ECE 230B,A00,103648,Taur; Yuan,0,0,0,0
1667963896808,ECE 238B,A00,103649,Garay; Javier,0,0,0,0
1667963897236,ECE 240B,A00,112900,Fainman; Yeshaiahu,0,0,0,0
1667963897667,ECE 247A,A00,103650,Jokerst; Jesse Vincent,0,0,0,0
1667963898090,ECE 247B,A00,103651,Wang; Joseph,0,0,0,0
1667963898513,ECE 250,A00,103652,Siegel; Paul H.,0,0,0,0
1667963898936,ECE 251A,A00,103654,Rao; Bhaskar D.,0,0,0,0
1667963899361,ECE 257B,A00,103655,Bharadia; Dinesh,0,0,0,0
1667963899787,ECE 258A,A00,103656,Milstein; Laurence B.,0,0,0,0
1667963900211,ECE 260B,A00,103658,Kang; Mingu,0,0,0,0
1667963900634,ECE 264A,A00,103659,Galton; Ian A,0,0,0,0
1667963901069,ECE 265A,A00,103661,Gudem; Prasad S.S.,0,0,0,0
1667963901500,ECE 265D,A00,103662,Gudem; Prasad S.S.,0,0,0,0
1667963901922,ECE 268,A00,103663,Koushanfar; Farinaz,0,0,0,0
1667963902347,ECE 269,A01,103665,Pal; Piya,0,0,0,0
1667963902770,ECE 271B,A00,103666,Vasconcelos; Manuela,0,0,0,0
1667963903198,ECE 276A,A00,103667,Atanasov; Nikolay A.,0,0,0,0
1667963903620,ECE 277,A00,103668,An; Cheolhong,0,0,0,0
1667963904048,ECE 279,A00,117947,Hall; Drew A.,0,0,0,0
1667963904894,ECE 283,A00,103670,Hsueh; Tzu-Chien,0,0,0,0
1667963905316,ECE 284,A00,103671,Turakhia; Yatish Girish,0,0,0,0
1667963905745,ECE 285,A00,103672,Zheng; Yang,0,0,0,0
1667963905745,ECE 285,B00,103673,Sworder; David D.,0,0,0,0
1667963906169,ECE 287,A00,103676,Javidi; Tara,0,0,0,0
1667963906603,MATH 200B,A00,098023,Salehi Golsefidy; Alireza,14,0,15,1
1667963907042,MATH 202B,A00,098024,Rhoades; Brendon Patrick,12,0,15,3
1667963907466,MATH 203B,A00,098025,Oprea; Dragos N.,12,0,15,3
1667963907890,MATH 204B,A00,098026,Sorensen; Claus M,14,0,15,1
1667963908312,MATH 208,A00,098027,Izadi; Elham,7,0,10,3
1667963908739,MATH 209,A00,098028,Pollack; Aaron,10,0,10,0
1667963909163,MATH 211A,A00,112919,Rogalski; Daniel,9,0,10,1
1667963909587,MATH 211B,A00,112920,Seward; Brandon M.,9,0,10,1
1667963910011,MATH 218,A00,098029,Li; Bo,10,0,10,0
1667963910434,MATH 220B,A00,098030,Novak; Jonathan I,13,0,15,2
1667963910859,MATH 221A,A00,098031,Ebenfelt; Peter F,13,0,15,2
1667963911282,MATH 231B,A00,098032,Zlatos; Andrej,12,0,15,3
1667963911711,MATH 240B,A00,098033,Ni; Lei,10,0,15,5
1667963912148,MATH 243,A00,098034,Jekel; David Andrew,10,0,10,0
1667963912578,MATH 245A,A00,098035,Nie; Jiawang,0,0,15,16
1667963913000,MATH 248,A00,098036,Bejenaru; Ioan,10,0,10,0
1667963913424,MATH 250B,A00,098037,Spolaor; Luca,14,0,15,1
1667963913851,MATH 258,A00,098038,Ni; Lei,10,0,10,0
1667963914281,MATH 264B,A00,098041,Rhoades; Brendon Patrick,12,0,15,3
1667963914708,MATH 268,A00,098042,Buss; Samuel R,10,0,10,0
1667963915130,MATH 269,A00,098043,Rhoades; Brendon Patrick,10,0,10,0
1667963915557,MATH 270B,A00,098044,Li; Bo,11,0,15,4
1667963915987,MATH 272B,A00,098045,Holst; Michael J,13,0,15,2
1667963916416,MATH 273A,A00,098046,Tian; Xiaochuan,12,0,15,3
1667963916841,MATH 275,A01,098048,Tian; Xiaochuan,6,0,10,4
1667963917266,MATH 278A,A00,098049,Holst; Michael J,8,0,10,2
1667963917689,MATH 278B,A00,098050,Cloninger; Alexander,10,0,10,0
1667963918115,MATH 278C,A00,098051,Nie; Jiawang,8,0,10,2
1667963918544,MATH 280B,A00,098052,Zheng; Tianyi,12,0,15,3
1667963918970,MATH 281B,A00,098053,Bradic; Jelena,4,0,15,11
1667963919392,MATH 282B,A00,098054,Arias-Castro; Ery,2,0,15,13
1667963919816,MATH 285,A00,098055,Fitzsimmons; Patrick J,0,0,15,17
1667963920247,MATH 287B,A00,098056,Arias-Castro; Ery,5,0,15,10
1667963920671,MATH 288,A00,098057,Agarwal; Pooja,9,0,10,1
1667963920671,MATH 288,B00,098058,Zhang; Danna,9,0,10,1
1667963920671,MATH 288,C00,098059,Williams; Ruth J,10,0,10,0
1667963921094,MATH 290B,A00,098060,Roberts; Justin Deritter,14,0,15,1
1667963921518,MATH 292,A00,098061,Belmont; Eva Kinoshita,10,0,10,0
1667963921941,MATH 295,A00,098062,Suk; Andrew Hoon,48,0,50,2
1667963922378,MATH 296,A00,098063,Novak; Jonathan I,20,0,20,0
1667963922799,MATH 297,001,098064,Gamst; Anthony Collins,9997,0,9999,2
1667964423726,COGS 205,A00,101395,Chiba; Andrea,19,0,20,1
1667964424149,COGS 210B,001,101404,Greene; Deanna Jacquelyn,9998,0,9999,1
1667964424149,COGS 210B,002,101417,Xia; Haijun,9999,0,9999,0
1667964424149,COGS 210B,003,101422,Nitz; Douglas A.,9999,0,9999,0
1667964424149,COGS 210B,004,101423,Hollan; James D.,9998,0,9999,1
1667964424149,COGS 210B,005,101424,Deak; Gedeon O.,9999,0,9999,0
1667964424149,COGS 210B,006,101425,Rossano; Federico,9999,0,9999,0
1667964424580,COGS 211B,A00,101427,Coulson; Seana M,9997,0,9999,2
1667964425010,COGS 220,A00,101428,Hollan; James D.,0,0,25,25
1667964425439,COGS 229,A00,101429,Dow; Steven P,18,0,25,7
1667964425862,COGS 230,A00,101430,Klemmer; Scott R,13,0,17,4
1667964426286,COGS 234,A00,101431,Xia; Haijun,7,0,25,18
1667964426710,COGS 260,A00,101432,Kiyonaga; Anastasia,20,0,25,5
1667964426710,COGS 260,B00,101433,Kirsh; David Joel,16,0,25,9
1667964427135,CSE 202,A00,102371,Impagliazzo; Russell,0,0,0,0
1667964427559,CSE 203B,A01,102373,Cheng; Chung Kuan,0,0,0,0
1667964427984,CSE 208,A00,102374,Micciancio; Daniele,0,0,0,0
1667964428407,CSE 209A,A00,112895,Impagliazzo; Russell,0,0,15,15
1667964428835,CSE 209B,A00,108005,Bellare; Mihir,0,0,0,0
1667964429259,CSE 210,A00,113163,Coblenz; Michael J,0,0,0,0
1667964429682,CSE 219,A00,106111,Dow; Steven P,0,0,20,20
1667964430109,CSE 221,A00,102376,Voelker; Geoffrey M.,0,0,0,0
1667964430532,CSE 224,A01,102378,Porter; George M,0,0,0,0
1667964430955,CSE 229A,A00,102379,Savage; Stefan,0,0,0,0
1667964431381,CSE 229C,A00,102380,Munyaka; Imani N. S.,0,0,0,0
1667964431803,CSE 232B,A00,102382,Deutsch; Alin Bernard,0,0,0,0
1667964432227,CSE 234,A01,112904,Kumar; Arun Kumar,0,0,0,0
1667964432652,CSE 237A,A00,102383,Rosing; Tajana Simunic,0,0,0,0
1667964433082,CSE 239A,A00,102384,Deutsch; Alin Bernard,0,0,0,0
1667964433504,CSE 239B,A00,102385,Polikarpova; Nadezhda,0,0,0,0
1667964433937,CSE 240A,A00,102386,Pannuto; Patrick William,0,0,0,0
1667964434360,CSE 240B,A00,102387,Zhao; Jishen,0,0,0,0
1667964434785,CSE 241A,A00,106406,Kang; Mingu,0,0,0,0
1667964435207,CSE 249B,A00,102388,Kahng; Andrew Byun,0,0,8,8
1667964435628,CSE 251B,A01,102392,Cottrell; Garrison W,0,0,0,0
1667964435628,CSE 251B,A02,102393,Cottrell; Garrison W,0,0,0,0
1667964436060,CSE 252B,A00,102394,Ochoa; Benjamin Lawrence,0,0,0,0
1667964436495,CSE 257,A01,102396,Gao; Sicun,0,0,0,0
1667964436923,CSE 272,A00,102397,Li; Tzumao,0,0,0,0
1667964437348,CSE 274,A00,111323,Chern; Albert Ren-Haur,0,0,0,0
1667964437784,CSE 282,A00,102398,Pevzner; Pavel Arkadjevich,0,0,0,0
1667964438210,CSE 284,A00,114175,Gymrek; Melissa Ann,0,0,0,0
1667964438633,CSE 290,A00,102399,Chandraker; Manmohan Krishna,0,0,0,0
1667964438633,CSE 290,B00,102400,Vaccaro; Kristen Marie,0,0,25,25
1667964438633,CSE 290,C00,102414,Pannuto; Patrick William,0,0,25,25
1667964438633,CSE 290,D00,102427,Pevzner; Pavel Arkadjevich,0,0,0,0
1667964438633,CSE 290,E00,102429,Zhao; Jishen,0,0,0,0
1667964438633,CSE 290,F00,102436,Tullsen; Dean Michael,0,0,0,0
1667964438633,CSE 290,G00,102440,Christensen; Henrik I,0,0,20,20
1667964439058,CSE 291,A00,102443,Su; Hao,0,0,0,0
1667964439058,CSE 291,B00,102448,Polikarpova; Nadezhda,0,0,0,0
1667964439058,CSE 291,C00,102453,Vaccaro; Kristen Marie,0,0,0,0
1667964439058,CSE 291,D00,111343,Savage; Stefan,0,0,0,0
1667964439058,CSE 291,E00,116474,Claffy; Kimberly Claire,0,0,0,0
1667964439058,CSE 291,F00,116479,Pasquale; Joseph,0,0,0,0
1667964439518,CSE 293,001,119111,Bafna; Vineet,9999,0,9999,0
1667964439518,CSE 293,002,119118,Bellare; Mihir,9999,0,9999,0
1667964439518,CSE 293,003,119122,Berg-Kirkpatrick; Taylor D,9999,0,9999,0
1667964439518,CSE 293,004,119135,Christensen; Henrik I,9999,0,9999,0
1667964439518,CSE 293,005,119142,Cottrell; Garrison W,9999,0,9999,0
1667964439518,CSE 293,006,119146,Deutsch; Alin Bernard,9999,0,9999,0
1667964439518,CSE 293,007,119159,Esmaeilzadeh; Hadi,9999,0,9999,0
1667964439518,CSE 293,008,119166,Freund; Yoav,9999,0,9999,0
1667964439518,CSE 293,009,119170,Griswold; William G.,9999,0,9999,0
1667964439518,CSE 293,010,119183,Gymrek; Melissa Ann,9999,0,9999,0
1667964439518,CSE 293,011,119190,Heninger; Nadia A,9999,0,9999,0
1667964439518,CSE 293,012,119230,Impagliazzo; Russell,9999,0,9999,0
1667964439518,CSE 293,013,119232,Jhala; Ranjit,9999,0,9999,0
1667964439518,CSE 293,014,119233,Kahng; Andrew Byun,9999,0,9999,0
1667964439518,CSE 293,015,119298,Kane; Daniel Mertz,9999,0,9999,0
1667964439518,CSE 293,016,119299,Kriegman; David J,9999,0,9999,0
1667964439518,CSE 293,017,119300,Kumar; Arun Kumar,9999,0,9999,0
1667964439518,CSE 293,018,119301,Lerner; Sorin,9999,0,9999,0
1667964439518,CSE 293,019,119302,Lovett; Shachar,9999,0,9999,0
1667964439518,CSE 293,020,119303,McAuley; Julian John,9999,0,9999,0
1667964439518,CSE 293,021,119304,Micciancio; Daniele,9999,0,9999,0
1667964439518,CSE 293,022,119367,Orailoglu; Alex,9999,0,9999,0
1667964439518,CSE 293,023,119382,Paturi; Ramamohan,9999,0,9999,0
1667964439518,CSE 293,024,119404,Polikarpova; Nadezhda,9999,0,9999,0
1667964439518,CSE 293,025,119406,Politz; Joseph Gibbs,9999,0,9999,0
1667964439518,CSE 293,026,119411,Porter; George M,9999,0,9999,0
1667964439518,CSE 293,027,119414,Porter; Leonard Emerson,9999,0,9999,0
1667964439518,CSE 293,028,119416,Ramamoorthi; Ravi,9999,0,9999,0
1667964439518,CSE 293,029,119417,Sahoo; Debashis,9999,0,9999,0
1667964439518,CSE 293,030,119420,Saul; Lawrence,9999,0,9999,0
1667964439518,CSE 293,031,119421,Savage; Stefan,9999,0,9999,0
1667964439518,CSE 293,032,119425,Schulze; Jurgen P.,9999,0,9999,0
1667964439518,CSE 293,033,119426,Snoeren; Alex C.,9999,0,9999,0
1667964439518,CSE 293,034,119428,Shang; Jingbo,9999,0,9999,0
1667964439518,CSE 293,035,119430,Stefan; Deian,9999,0,9999,0
1667964439518,CSE 293,036,119431,Su; Hao,9999,0,9999,0
1667964439518,CSE 293,037,119433,Swanson; Steven James,9999,0,9999,0
1667964439518,CSE 293,038,119435,Tullsen; Dean Michael,9999,0,9999,0
1667964439518,CSE 293,039,119483,Voelker; Geoffrey M.,9999,0,9999,0
1667964439518,CSE 293,040,119537,Zhao; Jishen,9999,0,9999,0
1667964439518,CSE 293,041,119538,Zhou; Yuan-Yuan,9999,0,9999,0
1667964439518,CSE 293,042,119539,Gao; Sicun,9999,0,9999,0
1667964439518,CSE 293,043,119540,Weibel; Nadir,9999,0,9999,0
1667964439518,CSE 293,044,119541,Gupta; Rajesh K.,9999,0,9999,0
1667964439951,CSE 294,A00,102459,Voelker; Geoffrey M.,0,0,0,0
1667964439951,CSE 294,B00,111322,Orailoglu; Alex,0,0,0,0
1667964440381,DSE 201,A00,096914,Deutsch; Alin Bernard,30,0,30,0
1667964440808,DSE 210,A00,096915,Dasgupta; Sanjoy,30,0,30,0
1667964441230,DSE 260A,A00,096916,Altintas De Callaf; Ilkay,30,0,30,0
1667964441658,ECE 200,001,103586,Antipa; Nicholas A,9999,0,9999,0
1667964441658,ECE 200,002,103587,Atanasov; Nikolay A.,9999,0,9999,0
1667964441658,ECE 200,003,103588,Bharadia; Dinesh,9999,0,9999,0
1667964441658,ECE 200,004,103589,Cheng; Chung Kuan,9999,0,9999,0
1667964441658,ECE 200,005,103590,Cosman; Pamela C.,9999,0,9999,0
1667964441658,ECE 200,006,103591,Dayeh; Shadi Ahmad,9999,0,9999,0
1667964441658,ECE 200,007,103592,Fainman; Yeshaiahu,9999,0,9999,0
1667964441658,ECE 200,008,103593,Ford; Joseph Earl,9999,0,9999,0
1667964441658,ECE 200,009,103594,Franceschetti; Massimo,9999,0,9999,0
1667964441658,ECE 200,010,103595,Fullerton; Eric E,9999,0,9999,0
1667964441658,ECE 200,011,103596,Galton; Ian A,9999,0,9999,0
1667964441658,ECE 200,012,103597,Gilja; Vikash,9999,0,9999,0
1667964441658,ECE 200,013,103598,Hall; Drew A.,9999,0,9999,0
1667964441658,ECE 200,014,103599,Hsueh; Tzu-Chien,9999,0,9999,0
1667964441658,ECE 200,015,103600,Javidi; Tara,9999,0,9999,0
1667964441658,ECE 200,016,103601,Kahng; Andrew Byun,9999,0,9999,0
1667964441658,ECE 200,017,103602,Kim; Young-Han,9999,0,9999,0
1667964441658,ECE 200,018,103603,Koushanfar; Farinaz,9999,0,9999,0
1667964441658,ECE 200,019,103604,Kuzum; Duygu,9999,0,9999,0
1667964441658,ECE 200,020,103605,Le; Hanh-Phuc,9999,0,9999,0
1667964441658,ECE 200,021,103606,Lin; Bill,9999,0,9999,0
1667964441658,ECE 200,022,103607,Liu; Zhaowei,9998,0,9999,1
1667964441658,ECE 200,023,103608,Lo; Yu-Hwa,9999,0,9999,0
1667964441658,ECE 200,024,103609,Lomakin; Vitaliy,9999,0,9999,0
1667964441658,ECE 200,025,103610,Mercier; Patrick Philip,9999,0,9999,0
1667964441658,ECE 200,026,103611,Meyer; Florian,9999,0,9999,0
1667964441658,ECE 200,027,103612,Milstein; Laurence B.,9999,0,9999,0
1667964441658,ECE 200,028,103613,Mir Arabbaygi; Siavash,9999,0,9999,0
1667964441658,ECE 200,029,103614,Mookherjea; Shayan,9999,0,9999,0
1667964441658,ECE 200,030,103615,Morris; Karcher William,9999,0,9999,0
1667964441658,ECE 200,031,103616,Ng; Tse Nga,9999,0,9999,0
1667964441658,ECE 200,032,103617,Nguyen; Truong Quang,9999,0,9999,0
1667964441658,ECE 200,033,103618,Nomura; Kenji,9999,0,9999,0
1667964441658,ECE 200,034,103619,Orlitsky; Alon,9999,0,9999,0
1667964441658,ECE 200,035,103620,Pal; Piya,9999,0,9999,0
1667964441658,ECE 200,036,103621,Papen; George C.,9999,0,9999,0
1667964441658,ECE 200,037,103622,Radic; Stojan,9999,0,9999,0
1667964441658,ECE 200,038,103623,Rao; Bhaskar D.,9999,0,9999,0
1667964441658,ECE 200,039,103624,Rao; Ramesh R,9999,0,9999,0
1667964441658,ECE 200,040,103625,Rebeiz; Gabriel,9999,0,9999,0
1667964441658,ECE 200,041,103626,Sanford; John R,9999,0,9999,0
1667964441658,ECE 200,042,103627,Siegel; Paul H.,9999,0,9999,0
1667964441658,ECE 200,043,103628,Sievenpiper; Daniel F.,9999,0,9999,0
1667964441658,ECE 200,044,103629,Sworder; David D.,9999,0,9999,0
1667964441658,ECE 200,045,103630,Taur; Yuan,9999,0,9999,0
1667964441658,ECE 200,046,103631,Touri; Behrouz,9999,0,9999,0
1667964441658,ECE 200,047,103632,Trivedi; Mohan M.,9999,0,9999,0
1667964441658,ECE 200,048,103633,Vasconcelos; Nuno,9999,0,9999,0
1667964441658,ECE 200,049,103634,Wang; Xiaolong,9999,0,9999,0
1667964441658,ECE 200,050,103635,Xie; Pengtao,9999,0,9999,0
1667964441658,ECE 200,051,103636,Yip; Michael,9999,0,9999,0
1667964441658,ECE 200,052,103637,Zeger; Kenneth A.,999,0,999,0
1667964441658,ECE 200,053,103638,Zhang; Xinyu,9999,0,9999,0
1667964441658,ECE 200,054,103639,Turakhia; Yatish Girish,9999,0,9999,0
1667964441658,ECE 200,055,103640,Kang; Mingu,9999,0,9999,0
1667964441658,ECE 200,056,103641,Shi; Yuanyuan,9999,0,9999,0
1667964441658,ECE 200,057,103642,Wang; Edward Jay,9999,0,9999,0
1667964441658,ECE 200,058,103643,Zheng; Yang,9999,0,9999,0
1667964442087,ECE 202,A00,103644,Kuzum; Duygu,0,0,0,0
1667964442512,ECE 212BN,A00,103646,Ng; Tse Nga,0,0,0,0
1667964442941,ECE 221,A00,111493,Staff,0,0,0,0
1667964443362,ECE 222B,A00,103647,Lomakin; Vitaliy,0,0,0,0
1667964443788,ECE 230B,A00,103648,Taur; Yuan,0,0,0,0
1667964444211,ECE 238B,A00,103649,Garay; Javier,0,0,0,0
1667964444641,ECE 240B,A00,112900,Fainman; Yeshaiahu,0,0,0,0
1667964445065,ECE 247A,A00,103650,Jokerst; Jesse Vincent,0,0,0,0
1667964445486,ECE 247B,A00,103651,Wang; Joseph,0,0,0,0
1667964445911,ECE 250,A00,103652,Siegel; Paul H.,0,0,0,0
1667964446334,ECE 251A,A00,103654,Rao; Bhaskar D.,0,0,0,0
1667964446852,ECE 257B,A00,103655,Bharadia; Dinesh,0,0,0,0
1667964447276,ECE 258A,A00,103656,Milstein; Laurence B.,0,0,0,0
1667964447699,ECE 260B,A00,103658,Kang; Mingu,0,0,0,0
1667964448125,ECE 264A,A00,103659,Galton; Ian A,0,0,0,0
1667964448561,ECE 265A,A00,103661,Gudem; Prasad S.S.,0,0,0,0
1667964448986,ECE 265D,A00,103662,Gudem; Prasad S.S.,0,0,0,0
1667964449413,ECE 268,A00,103663,Koushanfar; Farinaz,0,0,0,0
1667964449837,ECE 269,A01,103665,Pal; Piya,0,0,0,0
1667964450266,ECE 271B,A00,103666,Vasconcelos; Manuela,0,0,0,0
1667964450687,ECE 276A,A00,103667,Atanasov; Nikolay A.,0,0,0,0
1667964451109,ECE 277,A00,103668,An; Cheolhong,0,0,0,0
1667964451534,ECE 279,A00,117947,Hall; Drew A.,0,0,0,0
1667964452393,ECE 283,A00,103670,Hsueh; Tzu-Chien,0,0,0,0
1667964452818,ECE 284,A00,103671,Turakhia; Yatish Girish,0,0,0,0
1667964453241,ECE 285,A00,103672,Zheng; Yang,0,0,0,0
1667964453241,ECE 285,B00,103673,Sworder; David D.,0,0,0,0
1667964453666,ECE 287,A00,103676,Javidi; Tara,0,0,0,0
1667964454103,MATH 200B,A00,098023,Salehi Golsefidy; Alireza,14,0,15,1
1667964454526,MATH 202B,A00,098024,Rhoades; Brendon Patrick,12,0,15,3
1667964454951,MATH 203B,A00,098025,Oprea; Dragos N.,12,0,15,3
1667964455377,MATH 204B,A00,098026,Sorensen; Claus M,14,0,15,1
1667964455800,MATH 208,A00,098027,Izadi; Elham,7,0,10,3
1667964456226,MATH 209,A00,098028,Pollack; Aaron,10,0,10,0
1667964456650,MATH 211A,A00,112919,Rogalski; Daniel,9,0,10,1
1667964457076,MATH 211B,A00,112920,Seward; Brandon M.,9,0,10,1
1667964457498,MATH 218,A00,098029,Li; Bo,10,0,10,0
1667964457921,MATH 220B,A00,098030,Novak; Jonathan I,13,0,15,2
1667964458344,MATH 221A,A00,098031,Ebenfelt; Peter F,13,0,15,2
1667964458771,MATH 231B,A00,098032,Zlatos; Andrej,12,0,15,3
1667964459195,MATH 240B,A00,098033,Ni; Lei,10,0,15,5
1667964459625,MATH 243,A00,098034,Jekel; David Andrew,10,0,10,0
1667964460053,MATH 245A,A00,098035,Nie; Jiawang,0,0,15,16
1667964460478,MATH 248,A00,098036,Bejenaru; Ioan,10,0,10,0
1667964460902,MATH 250B,A00,098037,Spolaor; Luca,14,0,15,1
1667964461326,MATH 258,A00,098038,Ni; Lei,10,0,10,0
1667964461755,MATH 264B,A00,098041,Rhoades; Brendon Patrick,12,0,15,3
1667964462183,MATH 268,A00,098042,Buss; Samuel R,10,0,10,0
1667964462615,MATH 269,A00,098043,Rhoades; Brendon Patrick,10,0,10,0
1667964463040,MATH 270B,A00,098044,Li; Bo,11,0,15,4
1667964463467,MATH 272B,A00,098045,Holst; Michael J,13,0,15,2
1667964463901,MATH 273A,A00,098046,Tian; Xiaochuan,12,0,15,3
1667964464325,MATH 275,A01,098048,Tian; Xiaochuan,6,0,10,4
1667964464751,MATH 278A,A00,098049,Holst; Michael J,8,0,10,2
1667964465178,MATH 278B,A00,098050,Cloninger; Alexander,10,0,10,0
1667964465603,MATH 278C,A00,098051,Nie; Jiawang,8,0,10,2
1667964466031,MATH 280B,A00,098052,Zheng; Tianyi,12,0,15,3
1667964466454,MATH 281B,A00,098053,Bradic; Jelena,4,0,15,11
1667964466884,MATH 282B,A00,098054,Arias-Castro; Ery,2,0,15,13
1667964467308,MATH 285,A00,098055,Fitzsimmons; Patrick J,0,0,15,17
1667964467745,MATH 287B,A00,098056,Arias-Castro; Ery,5,0,15,10
1667964468168,MATH 288,A00,098057,Agarwal; Pooja,9,0,10,1
1667964468168,MATH 288,B00,098058,Zhang; Danna,9,0,10,1
1667964468168,MATH 288,C00,098059,Williams; Ruth J,10,0,10,0
1667964468603,MATH 290B,A00,098060,Roberts; Justin Deritter,14,0,15,1
1667964469029,MATH 292,A00,098061,Belmont; Eva Kinoshita,10,0,10,0
1667964469452,MATH 295,A00,098062,Suk; Andrew Hoon,48,0,50,2
1667964469874,MATH 296,A00,098063,Novak; Jonathan I,20,0,20,0
1667964470299,MATH 297,001,098064,Gamst; Anthony Collins,9997,0,9999,2
1667964972721,COGS 205,A00,101395,Chiba; Andrea,19,0,20,1
1667964973155,COGS 210B,001,101404,Greene; Deanna Jacquelyn,9998,0,9999,1
1667964973155,COGS 210B,002,101417,Xia; Haijun,9999,0,9999,0
1667964973155,COGS 210B,003,101422,Nitz; Douglas A.,9999,0,9999,0
1667964973155,COGS 210B,004,101423,Hollan; James D.,9998,0,9999,1
1667964973155,COGS 210B,005,101424,Deak; Gedeon O.,9999,0,9999,0
1667964973155,COGS 210B,006,101425,Rossano; Federico,9999,0,9999,0
1667964973579,COGS 211B,A00,101427,Coulson; Seana M,9997,0,9999,2
1667964974006,COGS 220,A00,101428,Hollan; James D.,0,0,25,25
1667964974440,COGS 229,A00,101429,Dow; Steven P,18,0,25,7
1667964974866,COGS 230,A00,101430,Klemmer; Scott R,13,0,17,4
1667964975291,COGS 234,A00,101431,Xia; Haijun,7,0,25,18
1667964975717,COGS 260,A00,101432,Kiyonaga; Anastasia,20,0,25,5
1667964975717,COGS 260,B00,101433,Kirsh; David Joel,16,0,25,9
1667964976145,CSE 202,A00,102371,Impagliazzo; Russell,0,0,0,0
1667964976573,CSE 203B,A01,102373,Cheng; Chung Kuan,0,0,0,0
1667964976998,CSE 208,A00,102374,Micciancio; Daniele,0,0,0,0
1667964977428,CSE 209A,A00,112895,Impagliazzo; Russell,0,0,15,15
1667964977850,CSE 209B,A00,108005,Bellare; Mihir,0,0,0,0
1667964978275,CSE 210,A00,113163,Coblenz; Michael J,0,0,0,0
1667964978700,CSE 219,A00,106111,Dow; Steven P,0,0,20,20
1667964979123,CSE 221,A00,102376,Voelker; Geoffrey M.,0,0,0,0
1667964979550,CSE 224,A01,102378,Porter; George M,0,0,0,0
1667964979975,CSE 229A,A00,102379,Savage; Stefan,0,0,0,0
1667964980403,CSE 229C,A00,102380,Munyaka; Imani N. S.,0,0,0,0
1667964980826,CSE 232B,A00,102382,Deutsch; Alin Bernard,0,0,0,0
1667964981250,CSE 234,A01,112904,Kumar; Arun Kumar,0,0,0,0
1667964981672,CSE 237A,A00,102383,Rosing; Tajana Simunic,0,0,0,0
1667964982096,CSE 239A,A00,102384,Deutsch; Alin Bernard,0,0,0,0
1667964982523,CSE 239B,A00,102385,Polikarpova; Nadezhda,0,0,0,0
1667964982949,CSE 240A,A00,102386,Pannuto; Patrick William,0,0,0,0
1667964983371,CSE 240B,A00,102387,Zhao; Jishen,0,0,0,0
1667964983798,CSE 241A,A00,106406,Kang; Mingu,0,0,0,0
1667964984225,CSE 249B,A00,102388,Kahng; Andrew Byun,0,0,8,8
1667964984649,CSE 251B,A01,102392,Cottrell; Garrison W,0,0,0,0
1667964984649,CSE 251B,A02,102393,Cottrell; Garrison W,0,0,0,0
1667964985074,CSE 252B,A00,102394,Ochoa; Benjamin Lawrence,0,0,0,0
1667964985496,CSE 257,A01,102396,Gao; Sicun,0,0,0,0
1667964985920,CSE 272,A00,102397,Li; Tzumao,0,0,0,0
1667964986346,CSE 274,A00,111323,Chern; Albert Ren-Haur,0,0,0,0
1667964986769,CSE 282,A00,102398,Pevzner; Pavel Arkadjevich,0,0,0,0
1667964987193,CSE 284,A00,114175,Gymrek; Melissa Ann,0,0,0,0
1667964987621,CSE 290,A00,102399,Chandraker; Manmohan Krishna,0,0,0,0
1667964987621,CSE 290,B00,102400,Vaccaro; Kristen Marie,0,0,25,25
1667964987621,CSE 290,C00,102414,Pannuto; Patrick William,0,0,25,25
1667964987621,CSE 290,D00,102427,Pevzner; Pavel Arkadjevich,0,0,0,0
1667964987621,CSE 290,E00,102429,Zhao; Jishen,0,0,0,0
1667964987621,CSE 290,F00,102436,Tullsen; Dean Michael,0,0,0,0
1667964987621,CSE 290,G00,102440,Christensen; Henrik I,0,0,20,20
1667964988046,CSE 291,A00,102443,Su; Hao,0,0,0,0
1667964988046,CSE 291,B00,102448,Polikarpova; Nadezhda,0,0,0,0
1667964988046,CSE 291,C00,102453,Vaccaro; Kristen Marie,0,0,0,0
1667964988046,CSE 291,D00,111343,Savage; Stefan,0,0,0,0
1667964988046,CSE 291,E00,116474,Claffy; Kimberly Claire,0,0,0,0
1667964988046,CSE 291,F00,116479,Pasquale; Joseph,0,0,0,0
1667964988474,CSE 293,001,119111,Bafna; Vineet,9999,0,9999,0
1667964988474,CSE 293,002,119118,Bellare; Mihir,9999,0,9999,0
1667964988474,CSE 293,003,119122,Berg-Kirkpatrick; Taylor D,9999,0,9999,0
1667964988474,CSE 293,004,119135,Christensen; Henrik I,9999,0,9999,0
1667964988474,CSE 293,005,119142,Cottrell; Garrison W,9999,0,9999,0
1667964988474,CSE 293,006,119146,Deutsch; Alin Bernard,9999,0,9999,0
1667964988474,CSE 293,007,119159,Esmaeilzadeh; Hadi,9999,0,9999,0
1667964988474,CSE 293,008,119166,Freund; Yoav,9999,0,9999,0
1667964988474,CSE 293,009,119170,Griswold; William G.,9999,0,9999,0
1667964988474,CSE 293,010,119183,Gymrek; Melissa Ann,9999,0,9999,0
1667964988474,CSE 293,011,119190,Heninger; Nadia A,9999,0,9999,0
1667964988474,CSE 293,012,119230,Impagliazzo; Russell,9999,0,9999,0
1667964988474,CSE 293,013,119232,Jhala; Ranjit,9999,0,9999,0
1667964988474,CSE 293,014,119233,Kahng; Andrew Byun,9999,0,9999,0
1667964988474,CSE 293,015,119298,Kane; Daniel Mertz,9999,0,9999,0
1667964988474,CSE 293,016,119299,Kriegman; David J,9999,0,9999,0
1667964988474,CSE 293,017,119300,Kumar; Arun Kumar,9999,0,9999,0
1667964988474,CSE 293,018,119301,Lerner; Sorin,9999,0,9999,0
1667964988474,CSE 293,019,119302,Lovett; Shachar,9999,0,9999,0
1667964988474,CSE 293,020,119303,McAuley; Julian John,9999,0,9999,0
1667964988474,CSE 293,021,119304,Micciancio; Daniele,9999,0,9999,0
1667964988474,CSE 293,022,119367,Orailoglu; Alex,9999,0,9999,0
1667964988474,CSE 293,023,119382,Paturi; Ramamohan,9999,0,9999,0
1667964988474,CSE 293,024,119404,Polikarpova; Nadezhda,9999,0,9999,0
1667964988474,CSE 293,025,119406,Politz; Joseph Gibbs,9999,0,9999,0
1667964988474,CSE 293,026,119411,Porter; George M,9999,0,9999,0
1667964988474,CSE 293,027,119414,Porter; Leonard Emerson,9999,0,9999,0
1667964988474,CSE 293,028,119416,Ramamoorthi; Ravi,9999,0,9999,0
1667964988474,CSE 293,029,119417,Sahoo; Debashis,9999,0,9999,0
1667964988474,CSE 293,030,119420,Saul; Lawrence,9999,0,9999,0
1667964988474,CSE 293,031,119421,Savage; Stefan,9999,0,9999,0
1667964988474,CSE 293,032,119425,Schulze; Jurgen P.,9999,0,9999,0
1667964988474,CSE 293,033,119426,Snoeren; Alex C.,9999,0,9999,0
1667964988474,CSE 293,034,119428,Shang; Jingbo,9999,0,9999,0
1667964988474,CSE 293,035,119430,Stefan; Deian,9999,0,9999,0
1667964988474,CSE 293,036,119431,Su; Hao,9999,0,9999,0
1667964988474,CSE 293,037,119433,Swanson; Steven James,9999,0,9999,0
1667964988474,CSE 293,038,119435,Tullsen; Dean Michael,9999,0,9999,0
1667964988474,CSE 293,039,119483,Voelker; Geoffrey M.,9999,0,9999,0
1667964988474,CSE 293,040,119537,Zhao; Jishen,9999,0,9999,0
1667964988474,CSE 293,041,119538,Zhou; Yuan-Yuan,9999,0,9999,0
1667964988474,CSE 293,042,119539,Gao; Sicun,9999,0,9999,0
1667964988474,CSE 293,043,119540,Weibel; Nadir,9999,0,9999,0
1667964988474,CSE 293,044,119541,Gupta; Rajesh K.,9999,0,9999,0
1667964988901,CSE 294,A00,102459,Voelker; Geoffrey M.,0,0,0,0
1667964988901,CSE 294,B00,111322,Orailoglu; Alex,0,0,0,0
1667964989323,DSE 201,A00,096914,Deutsch; Alin Bernard,30,0,30,0
1667964989756,DSE 210,A00,096915,Dasgupta; Sanjoy,30,0,30,0
1667964990178,DSE 260A,A00,096916,Altintas De Callaf; Ilkay,30,0,30,0
1667964990620,ECE 200,001,103586,Antipa; Nicholas A,9999,0,9999,0
1667964990620,ECE 200,002,103587,Atanasov; Nikolay A.,9999,0,9999,0
1667964990620,ECE 200,003,103588,Bharadia; Dinesh,9999,0,9999,0
1667964990620,ECE 200,004,103589,Cheng; Chung Kuan,9999,0,9999,0
1667964990620,ECE 200,005,103590,Cosman; Pamela C.,9999,0,9999,0
1667964990620,ECE 200,006,103591,Dayeh; Shadi Ahmad,9999,0,9999,0
1667964990620,ECE 200,007,103592,Fainman; Yeshaiahu,9999,0,9999,0
1667964990620,ECE 200,008,103593,Ford; Joseph Earl,9999,0,9999,0
1667964990620,ECE 200,009,103594,Franceschetti; Massimo,9999,0,9999,0
1667964990620,ECE 200,010,103595,Fullerton; Eric E,9999,0,9999,0
1667964990620,ECE 200,011,103596,Galton; Ian A,9999,0,9999,0
1667964990620,ECE 200,012,103597,Gilja; Vikash,9999,0,9999,0
1667964990620,ECE 200,013,103598,Hall; Drew A.,9999,0,9999,0
1667964990620,ECE 200,014,103599,Hsueh; Tzu-Chien,9999,0,9999,0
1667964990620,ECE 200,015,103600,Javidi; Tara,9999,0,9999,0
1667964990620,ECE 200,016,103601,Kahng; Andrew Byun,9999,0,9999,0
1667964990620,ECE 200,017,103602,Kim; Young-Han,9999,0,9999,0
1667964990620,ECE 200,018,103603,Koushanfar; Farinaz,9999,0,9999,0
1667964990620,ECE 200,019,103604,Kuzum; Duygu,9999,0,9999,0
1667964990620,ECE 200,020,103605,Le; Hanh-Phuc,9999,0,9999,0
1667964990620,ECE 200,021,103606,Lin; Bill,9999,0,9999,0
1667964990620,ECE 200,022,103607,Liu; Zhaowei,9998,0,9999,1
1667964990620,ECE 200,023,103608,Lo; Yu-Hwa,9999,0,9999,0
1667964990620,ECE 200,024,103609,Lomakin; Vitaliy,9999,0,9999,0
1667964990620,ECE 200,025,103610,Mercier; Patrick Philip,9999,0,9999,0
1667964990620,ECE 200,026,103611,Meyer; Florian,9999,0,9999,0
1667964990620,ECE 200,027,103612,Milstein; Laurence B.,9999,0,9999,0
1667964990620,ECE 200,028,103613,Mir Arabbaygi; Siavash,9999,0,9999,0
1667964990620,ECE 200,029,103614,Mookherjea; Shayan,9999,0,9999,0
1667964990620,ECE 200,030,103615,Morris; Karcher William,9999,0,9999,0
1667964990620,ECE 200,031,103616,Ng; Tse Nga,9999,0,9999,0
1667964990620,ECE 200,032,103617,Nguyen; Truong Quang,9999,0,9999,0
1667964990620,ECE 200,033,103618,Nomura; Kenji,9999,0,9999,0
1667964990620,ECE 200,034,103619,Orlitsky; Alon,9999,0,9999,0
1667964990620,ECE 200,035,103620,Pal; Piya,9999,0,9999,0
1667964990620,ECE 200,036,103621,Papen; George C.,9999,0,9999,0
1667964990620,ECE 200,037,103622,Radic; Stojan,9999,0,9999,0
1667964990620,ECE 200,038,103623,Rao; Bhaskar D.,9999,0,9999,0
1667964990620,ECE 200,039,103624,Rao; Ramesh R,9999,0,9999,0
1667964990620,ECE 200,040,103625,Rebeiz; Gabriel,9999,0,9999,0
1667964990620,ECE 200,041,103626,Sanford; John R,9999,0,9999,0
1667964990620,ECE 200,042,103627,Siegel; Paul H.,9999,0,9999,0
1667964990620,ECE 200,043,103628,Sievenpiper; Daniel F.,9999,0,9999,0
1667964990620,ECE 200,044,103629,Sworder; David D.,9999,0,9999,0
1667964990620,ECE 200,045,103630,Taur; Yuan,9999,0,9999,0
1667964990620,ECE 200,046,103631,Touri; Behrouz,9999,0,9999,0
1667964990620,ECE 200,047,103632,Trivedi; Mohan M.,9999,0,9999,0
1667964990620,ECE 200,048,103633,Vasconcelos; Nuno,9999,0,9999,0
1667964990620,ECE 200,049,103634,Wang; Xiaolong,9999,0,9999,0
1667964990620,ECE 200,050,103635,Xie; Pengtao,9999,0,9999,0
1667964990620,ECE 200,051,103636,Yip; Michael,9999,0,9999,0
1667964990620,ECE 200,052,103637,Zeger; Kenneth A.,999,0,999,0
1667964990620,ECE 200,053,103638,Zhang; Xinyu,9999,0,9999,0
1667964990620,ECE 200,054,103639,Turakhia; Yatish Girish,9999,0,9999,0
1667964990620,ECE 200,055,103640,Kang; Mingu,9999,0,9999,0
1667964990620,ECE 200,056,103641,Shi; Yuanyuan,9999,0,9999,0
1667964990620,ECE 200,057,103642,Wang; Edward Jay,9999,0,9999,0
1667964990620,ECE 200,058,103643,Zheng; Yang,9999,0,9999,0
1667964991044,ECE 202,A00,103644,Kuzum; Duygu,0,0,0,0
1667964991469,ECE 212BN,A00,103646,Ng; Tse Nga,0,0,0,0
1667964991893,ECE 221,A00,111493,Staff,0,0,0,0
1667964992318,ECE 222B,A00,103647,Lomakin; Vitaliy,0,0,0,0
1667964992742,ECE 230B,A00,103648,Taur; Yuan,0,0,0,0
1667964993170,ECE 238B,A00,103649,Garay; Javier,0,0,0,0
1667964993593,ECE 240B,A00,112900,Fainman; Yeshaiahu,0,0,0,0
1667964994016,ECE 247A,A00,103650,Jokerst; Jesse Vincent,0,0,0,0
1667964994442,ECE 247B,A00,103651,Wang; Joseph,0,0,0,0
1667964994870,ECE 250,A00,103652,Siegel; Paul H.,0,0,0,0
1667964995293,ECE 251A,A00,103654,Rao; Bhaskar D.,0,0,0,0
1667964995718,ECE 257B,A00,103655,Bharadia; Dinesh,0,0,0,0
1667964996145,ECE 258A,A00,103656,Milstein; Laurence B.,0,0,0,0
1667964996571,ECE 260B,A00,103658,Kang; Mingu,0,0,0,0
1667964997004,ECE 264A,A00,103659,Galton; Ian A,0,0,0,0
1667964997433,ECE 265A,A00,103661,Gudem; Prasad S.S.,0,0,0,0
1667964997857,ECE 265D,A00,103662,Gudem; Prasad S.S.,0,0,0,0
1667964998284,ECE 268,A00,103663,Koushanfar; Farinaz,0,0,0,0
1667964998707,ECE 269,A01,103665,Pal; Piya,0,0,0,0
1667964999130,ECE 271B,A00,103666,Vasconcelos; Manuela,0,0,0,0
1667964999556,ECE 276A,A00,103667,Atanasov; Nikolay A.,0,0,0,0
1667964999978,ECE 277,A00,103668,An; Cheolhong,0,0,0,0
1667965000404,ECE 279,A00,117947,Hall; Drew A.,0,0,0,0
1667965001253,ECE 283,A00,103670,Hsueh; Tzu-Chien,0,0,0,0
1667965001679,ECE 284,A00,103671,Turakhia; Yatish Girish,0,0,0,0
1667965002106,ECE 285,A00,103672,Zheng; Yang,0,0,0,0
1667965002106,ECE 285,B00,103673,Sworder; David D.,0,0,0,0
1667965002542,ECE 287,A00,103676,Javidi; Tara,0,0,0,0
1667965002975,MATH 200B,A00,098023,Salehi Golsefidy; Alireza,14,0,15,1
1667965003398,MATH 202B,A00,098024,Rhoades; Brendon Patrick,12,0,15,3
1667965003821,MATH 203B,A00,098025,Oprea; Dragos N.,12,0,15,3
1667965004252,MATH 204B,A00,098026,Sorensen; Claus M,14,0,15,1
1667965004684,MATH 208,A00,098027,Izadi; Elham,7,0,10,3
1667965005107,MATH 209,A00,098028,Pollack; Aaron,10,0,10,0
1667965005536,MATH 211A,A00,112919,Rogalski; Daniel,9,0,10,1
1667965005959,MATH 211B,A00,112920,Seward; Brandon M.,9,0,10,1
1667965006384,MATH 218,A00,098029,Li; Bo,10,0,10,0
1667965006810,MATH 220B,A00,098030,Novak; Jonathan I,13,0,15,2
1667965007235,MATH 221A,A00,098031,Ebenfelt; Peter F,13,0,15,2
1667965007658,MATH 231B,A00,098032,Zlatos; Andrej,12,0,15,3
1667965008082,MATH 240B,A00,098033,Ni; Lei,10,0,15,5
1667965008514,MATH 243,A00,098034,Jekel; David Andrew,10,0,10,0
1667965008940,MATH 245A,A00,098035,Nie; Jiawang,0,0,15,16
1667965009370,MATH 248,A00,098036,Bejenaru; Ioan,10,0,10,0
1667965009794,MATH 250B,A00,098037,Spolaor; Luca,14,0,15,1
1667965010221,MATH 258,A00,098038,Ni; Lei,10,0,10,0
1667965010645,MATH 264B,A00,098041,Rhoades; Brendon Patrick,12,0,15,3
1667965011070,MATH 268,A00,098042,Buss; Samuel R,10,0,10,0
1667965011493,MATH 269,A00,098043,Rhoades; Brendon Patrick,10,0,10,0
1667965011917,MATH 270B,A00,098044,Li; Bo,11,0,15,4
1667965012425,MATH 272B,A00,098045,Holst; Michael J,13,0,15,2
1667965012851,MATH 273A,A00,098046,Tian; Xiaochuan,12,0,15,3
1667965013273,MATH 275,A01,098048,Tian; Xiaochuan,6,0,10,4
1667965013695,MATH 278A,A00,098049,Holst; Michael J,8,0,10,2
1667965014117,MATH 278B,A00,098050,Cloninger; Alexander,10,0,10,0
1667965014552,MATH 278C,A00,098051,Nie; Jiawang,8,0,10,2
1667965014980,MATH 280B,A00,098052,Zheng; Tianyi,12,0,15,3
1667965015405,MATH 281B,A00,098053,Bradic; Jelena,4,0,15,11
1667965015829,MATH 282B,A00,098054,Arias-Castro; Ery,2,0,15,13
1667965016252,MATH 285,A00,098055,Fitzsimmons; Patrick J,0,0,15,17
1667965016685,MATH 287B,A00,098056,Arias-Castro; Ery,5,0,15,10
1667965017109,MATH 288,A00,098057,Agarwal; Pooja,9,0,10,1
1667965017109,MATH 288,B00,098058,Zhang; Danna,9,0,10,1
1667965017109,MATH 288,C00,098059,Williams; Ruth J,10,0,10,0
1667965017534,MATH 290B,A00,098060,Roberts; Justin Deritter,14,0,15,1
1667965017958,MATH 292,A00,098061,Belmont; Eva Kinoshita,10,0,10,0
1667965018379,MATH 295,A00,098062,Suk; Andrew Hoon,48,0,50,2
1667965018813,MATH 296,A00,098063,Novak; Jonathan I,20,0,20,0
1667965019244,MATH 297,001,098064,Gamst; Anthony Collins,9997,0,9999,2
1667965530981,COGS 205,A00,101395,Chiba; Andrea,19,0,20,1
1667965531406,COGS 210B,001,101404,Greene; Deanna Jacquelyn,9998,0,9999,1
1667965531406,COGS 210B,002,101417,Xia; Haijun,9999,0,9999,0
1667965531406,COGS 210B,003,101422,Nitz; Douglas A.,9999,0,9999,0
1667965531406,COGS 210B,004,101423,Hollan; James D.,9998,0,9999,1
1667965531406,COGS 210B,005,101424,Deak; Gedeon O.,9999,0,9999,0
1667965531406,COGS 210B,006,101425,Rossano; Federico,9999,0,9999,0
1667965531835,COGS 211B,A00,101427,Coulson; Seana M,9997,0,9999,2
1667965532269,COGS 220,A00,101428,Hollan; James D.,0,0,25,25
1667965532694,COGS 229,A00,101429,Dow; Steven P,18,0,25,7
1667965533118,COGS 230,A00,101430,Klemmer; Scott R,13,0,17,4
1667965533545,COGS 234,A00,101431,Xia; Haijun,7,0,25,18
1667965533973,COGS 260,A00,101432,Kiyonaga; Anastasia,20,0,25,5
1667965533973,COGS 260,B00,101433,Kirsh; David Joel,16,0,25,9
1667965534403,CSE 202,A00,102371,Impagliazzo; Russell,0,0,0,0
1667965534839,CSE 203B,A01,102373,Cheng; Chung Kuan,0,0,0,0
1667965535273,CSE 208,A00,102374,Micciancio; Daniele,0,0,0,0
1667965535697,CSE 209A,A00,112895,Impagliazzo; Russell,0,0,15,15
1667965536129,CSE 209B,A00,108005,Bellare; Mihir,0,0,0,0
1667965536556,CSE 210,A00,113163,Coblenz; Michael J,0,0,0,0
1667965536983,CSE 219,A00,106111,Dow; Steven P,0,0,20,20
1667965537407,CSE 221,A00,102376,Voelker; Geoffrey M.,0,0,0,0
1667965537830,CSE 224,A01,102378,Porter; George M,0,0,0,0
1667965538266,CSE 229A,A00,102379,Savage; Stefan,0,0,0,0
1667965538692,CSE 229C,A00,102380,Munyaka; Imani N. S.,0,0,0,0
1667965539122,CSE 232B,A00,102382,Deutsch; Alin Bernard,0,0,0,0
1667965539547,CSE 234,A01,112904,Kumar; Arun Kumar,0,0,0,0
1667965539973,CSE 237A,A00,102383,Rosing; Tajana Simunic,0,0,0,0
1667965540406,CSE 239A,A00,102384,Deutsch; Alin Bernard,0,0,0,0
1667965540837,CSE 239B,A00,102385,Polikarpova; Nadezhda,0,0,0,0
1667965541260,CSE 240A,A00,102386,Pannuto; Patrick William,0,0,0,0
1667965541691,CSE 240B,A00,102387,Zhao; Jishen,0,0,0,0
1667965542114,CSE 241A,A00,106406,Kang; Mingu,0,0,0,0
1667965542536,CSE 249B,A00,102388,Kahng; Andrew Byun,0,0,8,8
1667965542974,CSE 251B,A01,102392,Cottrell; Garrison W,0,0,0,0
1667965542974,CSE 251B,A02,102393,Cottrell; Garrison W,0,0,0,0
1667965543397,CSE 252B,A00,102394,Ochoa; Benjamin Lawrence,0,0,0,0
1667965543825,CSE 257,A01,102396,Gao; Sicun,0,0,0,0
1667965544335,CSE 272,A00,102397,Li; Tzumao,0,0,0,0
1667965544764,CSE 274,A00,111323,Chern; Albert Ren-Haur,0,0,0,0
1667965545191,CSE 282,A00,102398,Pevzner; Pavel Arkadjevich,0,0,0,0
1667965545612,CSE 284,A00,114175,Gymrek; Melissa Ann,0,0,0,0
1667965546046,CSE 290,A00,102399,Chandraker; Manmohan Krishna,0,0,0,0
1667965546046,CSE 290,B00,102400,Vaccaro; Kristen Marie,0,0,25,25
1667965546046,CSE 290,C00,102414,Pannuto; Patrick William,0,0,25,25
1667965546046,CSE 290,D00,102427,Pevzner; Pavel Arkadjevich,0,0,0,0
1667965546046,CSE 290,E00,102429,Zhao; Jishen,0,0,0,0
1667965546046,CSE 290,F00,102436,Tullsen; Dean Michael,0,0,0,0
1667965546046,CSE 290,G00,102440,Christensen; Henrik I,0,0,20,20
1667965546484,CSE 291,A00,102443,Su; Hao,0,0,0,0
1667965546484,CSE 291,B00,102448,Polikarpova; Nadezhda,0,0,0,0
1667965546484,CSE 291,C00,102453,Vaccaro; Kristen Marie,0,0,0,0
1667965546484,CSE 291,D00,111343,Savage; Stefan,0,0,0,0
1667965546484,CSE 291,E00,116474,Claffy; Kimberly Claire,0,0,0,0
1667965546484,CSE 291,F00,116479,Pasquale; Joseph,0,0,0,0
1667965546932,CSE 293,001,119111,Bafna; Vineet,9999,0,9999,0
1667965546932,CSE 293,002,119118,Bellare; Mihir,9999,0,9999,0
1667965546932,CSE 293,003,119122,Berg-Kirkpatrick; Taylor D,9999,0,9999,0
1667965546932,CSE 293,004,119135,Christensen; Henrik I,9999,0,9999,0
1667965546932,CSE 293,005,119142,Cottrell; Garrison W,9999,0,9999,0
1667965546932,CSE 293,006,119146,Deutsch; Alin Bernard,9999,0,9999,0
1667965546932,CSE 293,007,119159,Esmaeilzadeh; Hadi,9999,0,9999,0
1667965546932,CSE 293,008,119166,Freund; Yoav,9999,0,9999,0
1667965546932,CSE 293,009,119170,Griswold; William G.,9999,0,9999,0
1667965546932,CSE 293,010,119183,Gymrek; Melissa Ann,9999,0,9999,0
1667965546932,CSE 293,011,119190,Heninger; Nadia A,9999,0,9999,0
1667965546932,CSE 293,012,119230,Impagliazzo; Russell,9999,0,9999,0
1667965546932,CSE 293,013,119232,Jhala; Ranjit,9999,0,9999,0
1667965546932,CSE 293,014,119233,Kahng; Andrew Byun,9999,0,9999,0
1667965546932,CSE 293,015,119298,Kane; Daniel Mertz,9999,0,9999,0
1667965546932,CSE 293,016,119299,Kriegman; David J,9999,0,9999,0
1667965546932,CSE 293,017,119300,Kumar; Arun Kumar,9999,0,9999,0
1667965546932,CSE 293,018,119301,Lerner; Sorin,9999,0,9999,0
1667965546932,CSE 293,019,119302,Lovett; Shachar,9999,0,9999,0
1667965546932,CSE 293,020,119303,McAuley; Julian John,9999,0,9999,0
1667965546932,CSE 293,021,119304,Micciancio; Daniele,9999,0,9999,0
1667965546932,CSE 293,022,119367,Orailoglu; Alex,9999,0,9999,0
1667965546932,CSE 293,023,119382,Paturi; Ramamohan,9999,0,9999,0
1667965546932,CSE 293,024,119404,Polikarpova; Nadezhda,9999,0,9999,0
1667965546932,CSE 293,025,119406,Politz; Joseph Gibbs,9999,0,9999,0
1667965546932,CSE 293,026,119411,Porter; George M,9999,0,9999,0
1667965546932,CSE 293,027,119414,Porter; Leonard Emerson,9999,0,9999,0
1667965546932,CSE 293,028,119416,Ramamoorthi; Ravi,9999,0,9999,0
1667965546932,CSE 293,029,119417,Sahoo; Debashis,9999,0,9999,0
1667965546932,CSE 293,030,119420,Saul; Lawrence,9999,0,9999,0
1667965546932,CSE 293,031,119421,Savage; Stefan,9999,0,9999,0
1667965546932,CSE 293,032,119425,Schulze; Jurgen P.,9999,0,9999,0
1667965546932,CSE 293,033,119426,Snoeren; Alex C.,9999,0,9999,0
1667965546932,CSE 293,034,119428,Shang; Jingbo,9999,0,9999,0
1667965546932,CSE 293,035,119430,Stefan; Deian,9999,0,9999,0
1667965546932,CSE 293,036,119431,Su; Hao,9999,0,9999,0
1667965546932,CSE 293,037,119433,Swanson; Steven James,9999,0,9999,0
1667965546932,CSE 293,038,119435,Tullsen; Dean Michael,9999,0,9999,0
1667965546932,CSE 293,039,119483,Voelker; Geoffrey M.,9999,0,9999,0
1667965546932,CSE 293,040,119537,Zhao; Jishen,9999,0,9999,0
1667965546932,CSE 293,041,119538,Zhou; Yuan-Yuan,9999,0,9999,0
1667965546932,CSE 293,042,119539,Gao; Sicun,9999,0,9999,0
1667965546932,CSE 293,043,119540,Weibel; Nadir,9999,0,9999,0
1667965546932,CSE 293,044,119541,Gupta; Rajesh K.,9999,0,9999,0
1667965547357,CSE 294,A00,102459,Voelker; Geoffrey M.,0,0,0,0
1667965547357,CSE 294,B00,111322,Orailoglu; Alex,0,0,0,0
1667965547780,DSE 201,A00,096914,Deutsch; Alin Bernard,30,0,30,0
1667965548220,DSE 210,A00,096915,Dasgupta; Sanjoy,30,0,30,0
1667965548641,DSE 260A,A00,096916,Altintas De Callaf; Ilkay,30,0,30,0
1667965549090,ECE 200,001,103586,Antipa; Nicholas A,9999,0,9999,0
1667965549090,ECE 200,002,103587,Atanasov; Nikolay A.,9999,0,9999,0
1667965549090,ECE 200,003,103588,Bharadia; Dinesh,9999,0,9999,0
1667965549090,ECE 200,004,103589,Cheng; Chung Kuan,9999,0,9999,0
1667965549090,ECE 200,005,103590,Cosman; Pamela C.,9999,0,9999,0
1667965549090,ECE 200,006,103591,Dayeh; Shadi Ahmad,9999,0,9999,0
1667965549090,ECE 200,007,103592,Fainman; Yeshaiahu,9999,0,9999,0
1667965549090,ECE 200,008,103593,Ford; Joseph Earl,9999,0,9999,0
1667965549090,ECE 200,009,103594,Franceschetti; Massimo,9999,0,9999,0
1667965549090,ECE 200,010,103595,Fullerton; Eric E,9999,0,9999,0
1667965549090,ECE 200,011,103596,Galton; Ian A,9999,0,9999,0
1667965549090,ECE 200,012,103597,Gilja; Vikash,9999,0,9999,0
1667965549090,ECE 200,013,103598,Hall; Drew A.,9999,0,9999,0
1667965549090,ECE 200,014,103599,Hsueh; Tzu-Chien,9999,0,9999,0
1667965549090,ECE 200,015,103600,Javidi; Tara,9999,0,9999,0
1667965549090,ECE 200,016,103601,Kahng; Andrew Byun,9999,0,9999,0
1667965549090,ECE 200,017,103602,Kim; Young-Han,9999,0,9999,0
1667965549090,ECE 200,018,103603,Koushanfar; Farinaz,9999,0,9999,0
1667965549090,ECE 200,019,103604,Kuzum; Duygu,9999,0,9999,0
1667965549090,ECE 200,020,103605,Le; Hanh-Phuc,9999,0,9999,0
1667965549090,ECE 200,021,103606,Lin; Bill,9999,0,9999,0
1667965549090,ECE 200,022,103607,Liu; Zhaowei,9998,0,9999,1
1667965549090,ECE 200,023,103608,Lo; Yu-Hwa,9999,0,9999,0
1667965549090,ECE 200,024,103609,Lomakin; Vitaliy,9999,0,9999,0
1667965549090,ECE 200,025,103610,Mercier; Patrick Philip,9999,0,9999,0
1667965549090,ECE 200,026,103611,Meyer; Florian,9999,0,9999,0
1667965549090,ECE 200,027,103612,Milstein; Laurence B.,9999,0,9999,0
1667965549090,ECE 200,028,103613,Mir Arabbaygi; Siavash,9999,0,9999,0
1667965549090,ECE 200,029,103614,Mookherjea; Shayan,9999,0,9999,0
1667965549090,ECE 200,030,103615,Morris; Karcher William,9999,0,9999,0
1667965549090,ECE 200,031,103616,Ng; Tse Nga,9999,0,9999,0
1667965549090,ECE 200,032,103617,Nguyen; Truong Quang,9999,0,9999,0
1667965549090,ECE 200,033,103618,Nomura; Kenji,9999,0,9999,0
1667965549090,ECE 200,034,103619,Orlitsky; Alon,9999,0,9999,0
1667965549090,ECE 200,035,103620,Pal; Piya,9999,0,9999,0
1667965549090,ECE 200,036,103621,Papen; George C.,9999,0,9999,0
1667965549090,ECE 200,037,103622,Radic; Stojan,9999,0,9999,0
1667965549090,ECE 200,038,103623,Rao; Bhaskar D.,9999,0,9999,0
1667965549090,ECE 200,039,103624,Rao; Ramesh R,9999,0,9999,0
1667965549090,ECE 200,040,103625,Rebeiz; Gabriel,9999,0,9999,0
1667965549090,ECE 200,041,103626,Sanford; John R,9999,0,9999,0
1667965549090,ECE 200,042,103627,Siegel; Paul H.,9999,0,9999,0
1667965549090,ECE 200,043,103628,Sievenpiper; Daniel F.,9999,0,9999,0
1667965549090,ECE 200,044,103629,Sworder; David D.,9999,0,9999,0
1667965549090,ECE 200,045,103630,Taur; Yuan,9999,0,9999,0
1667965549090,ECE 200,046,103631,Touri; Behrouz,9999,0,9999,0
1667965549090,ECE 200,047,103632,Trivedi; Mohan M.,9999,0,9999,0
1667965549090,ECE 200,048,103633,Vasconcelos; Nuno,9999,0,9999,0
1667965549090,ECE 200,049,103634,Wang; Xiaolong,9999,0,9999,0
1667965549090,ECE 200,050,103635,Xie; Pengtao,9999,0,9999,0
1667965549090,ECE 200,051,103636,Yip; Michael,9999,0,9999,0
1667965549090,ECE 200,052,103637,Zeger; Kenneth A.,999,0,999,0
1667965549090,ECE 200,053,103638,Zhang; Xinyu,9999,0,9999,0
1667965549090,ECE 200,054,103639,Turakhia; Yatish Girish,9999,0,9999,0
1667965549090,ECE 200,055,103640,Kang; Mingu,9999,0,9999,0
1667965549090,ECE 200,056,103641,Shi; Yuanyuan,9999,0,9999,0
1667965549090,ECE 200,057,103642,Wang; Edward Jay,9999,0,9999,0
1667965549090,ECE 200,058,103643,Zheng; Yang,9999,0,9999,0
1667965549519,ECE 202,A00,103644,Kuzum; Duygu,0,0,0,0
1667965549944,ECE 212BN,A00,103646,Ng; Tse Nga,0,0,0,0
1667965550375,ECE 221,A00,111493,Staff,0,0,0,0
1667965550803,ECE 222B,A00,103647,Lomakin; Vitaliy,0,0,0,0
1667965551224,ECE 230B,A00,103648,Taur; Yuan,0,0,0,0
1667965551649,ECE 238B,A00,103649,Garay; Javier,0,0,0,0
1667965552072,ECE 240B,A00,112900,Fainman; Yeshaiahu,0,0,0,0
1667965552497,ECE 247A,A00,103650,Jokerst; Jesse Vincent,0,0,0,0
1667965552933,ECE 247B,A00,103651,Wang; Joseph,0,0,0,0
1667965553359,ECE 250,A00,103652,Siegel; Paul H.,0,0,0,0
1667965553786,ECE 251A,A00,103654,Rao; Bhaskar D.,0,0,0,0
1667965554209,ECE 257B,A00,103655,Bharadia; Dinesh,0,0,0,0
1667965554631,ECE 258A,A00,103656,Milstein; Laurence B.,0,0,0,0
1667965555056,ECE 260B,A00,103658,Kang; Mingu,0,0,0,0
1667965555482,ECE 264A,A00,103659,Galton; Ian A,0,0,0,0
1667965555903,ECE 265A,A00,103661,Gudem; Prasad S.S.,0,0,0,0
1667965556331,ECE 265D,A00,103662,Gudem; Prasad S.S.,0,0,0,0
1667965556756,ECE 268,A00,103663,Koushanfar; Farinaz,0,0,0,0
1667965557180,ECE 269,A01,103665,Pal; Piya,0,0,0,0
1667965557604,ECE 271B,A00,103666,Vasconcelos; Manuela,0,0,0,0
1667965558025,ECE 276A,A00,103667,Atanasov; Nikolay A.,0,0,0,0
1667965558449,ECE 277,A00,103668,An; Cheolhong,0,0,0,0
1667965558873,ECE 279,A00,117947,Hall; Drew A.,0,0,0,0
1667965559727,ECE 283,A00,103670,Hsueh; Tzu-Chien,0,0,0,0
1667965560153,ECE 284,A00,103671,Turakhia; Yatish Girish,0,0,0,0
1667965560577,ECE 285,A00,103672,Zheng; Yang,0,0,0,0
1667965560577,ECE 285,B00,103673,Sworder; David D.,0,0,0,0
1667965561005,ECE 287,A00,103676,Javidi; Tara,0,0,0,0
1667965561435,MATH 200B,A00,098023,Salehi Golsefidy; Alireza,14,0,15,1
1667965561856,MATH 202B,A00,098024,Rhoades; Brendon Patrick,12,0,15,3
1667965562281,MATH 203B,A00,098025,Oprea; Dragos N.,12,0,15,3
1667965562704,MATH 204B,A00,098026,Sorensen; Claus M,14,0,15,1
1667965563126,MATH 208,A00,098027,Izadi; Elham,7,0,10,3
1667965563548,MATH 209,A00,098028,Pollack; Aaron,10,0,10,0
1667965563973,MATH 211A,A00,112919,Rogalski; Daniel,9,0,10,1
1667965564397,MATH 211B,A00,112920,Seward; Brandon M.,9,0,10,1
1667965564823,MATH 218,A00,098029,Li; Bo,10,0,10,0
1667965565247,MATH 220B,A00,098030,Novak; Jonathan I,13,0,15,2
1667965565674,MATH 221A,A00,098031,Ebenfelt; Peter F,13,0,15,2
1667965566099,MATH 231B,A00,098032,Zlatos; Andrej,12,0,15,3
1667965566524,MATH 240B,A00,098033,Ni; Lei,10,0,15,5
1667965566947,MATH 243,A00,098034,Jekel; David Andrew,10,0,10,0
1667965567371,MATH 245A,A00,098035,Nie; Jiawang,0,0,15,16
1667965567793,MATH 248,A00,098036,Bejenaru; Ioan,10,0,10,0
1667965568218,MATH 250B,A00,098037,Spolaor; Luca,14,0,15,1
1667965568644,MATH 258,A00,098038,Ni; Lei,10,0,10,0
1667965569082,MATH 264B,A00,098041,Rhoades; Brendon Patrick,12,0,15,3
1667965569504,MATH 268,A00,098042,Buss; Samuel R,10,0,10,0
1667965569926,MATH 269,A00,098043,Rhoades; Brendon Patrick,10,0,10,0
1667965570349,MATH 270B,A00,098044,Li; Bo,11,0,15,4
1667965570790,MATH 272B,A00,098045,Holst; Michael J,13,0,15,2
1667965571231,MATH 273A,A00,098046,Tian; Xiaochuan,12,0,15,3
1667965571654,MATH 275,A01,098048,Tian; Xiaochuan,6,0,10,4
1667965572084,MATH 278A,A00,098049,Holst; Michael J,8,0,10,2
1667965572505,MATH 278B,A00,098050,Cloninger; Alexander,10,0,10,0
1667965572929,MATH 278C,A00,098051,Nie; Jiawang,8,0,10,2
1667965573354,MATH 280B,A00,098052,Zheng; Tianyi,12,0,15,3
1667965573780,MATH 281B,A00,098053,Bradic; Jelena,4,0,15,11
1667965574203,MATH 282B,A00,098054,Arias-Castro; Ery,2,0,15,13
1667965574628,MATH 285,A00,098055,Fitzsimmons; Patrick J,0,0,15,17
1667965575049,MATH 287B,A00,098056,Arias-Castro; Ery,5,0,15,10
1667965575481,MATH 288,A00,098057,Agarwal; Pooja,9,0,10,1
1667965575481,MATH 288,B00,098058,Zhang; Danna,9,0,10,1
1667965575481,MATH 288,C00,098059,Williams; Ruth J,10,0,10,0
1667965575916,MATH 290B,A00,098060,Roberts; Justin Deritter,14,0,15,1
1667965576338,MATH 292,A00,098061,Belmont; Eva Kinoshita,10,0,10,0
1667965576761,MATH 295,A00,098062,Suk; Andrew Hoon,48,0,50,2
1667965577185,MATH 296,A00,098063,Novak; Jonathan I,20,0,20,0
1667965577610,MATH 297,001,098064,Gamst; Anthony Collins,9997,0,9999,2
1667966078908,COGS 205,A00,101395,Chiba; Andrea,19,0,20,1
1667966079336,COGS 210B,001,101404,Greene; Deanna Jacquelyn,9998,0,9999,1
1667966079336,COGS 210B,002,101417,Xia; Haijun,9999,0,9999,0
1667966079336,COGS 210B,003,101422,Nitz; Douglas A.,9999,0,9999,0
1667966079336,COGS 210B,004,101423,Hollan; James D.,9998,0,9999,1
1667966079336,COGS 210B,005,101424,Deak; Gedeon O.,9999,0,9999,0
1667966079336,COGS 210B,006,101425,Rossano; Federico,9999,0,9999,0
1667966079762,COGS 211B,A00,101427,Coulson; Seana M,9997,0,9999,2
1667966080187,COGS 220,A00,101428,Hollan; James D.,0,0,25,25
1667966080609,COGS 229,A00,101429,Dow; Steven P,18,0,25,7
1667966081035,COGS 230,A00,101430,Klemmer; Scott R,13,0,17,4
1667966081462,COGS 234,A00,101431,Xia; Haijun,7,0,25,18
1667966081885,COGS 260,A00,101432,Kiyonaga; Anastasia,20,0,25,5
1667966081885,COGS 260,B00,101433,Kirsh; David Joel,16,0,25,9
1667966082318,CSE 202,A00,102371,Impagliazzo; Russell,0,0,0,0
1667966082739,CSE 203B,A01,102373,Cheng; Chung Kuan,0,0,0,0
1667966083166,CSE 208,A00,102374,Micciancio; Daniele,0,0,0,0
1667966083593,CSE 209A,A00,112895,Impagliazzo; Russell,0,0,15,15
1667966084017,CSE 209B,A00,108005,Bellare; Mihir,0,0,0,0
1667966084441,CSE 210,A00,113163,Coblenz; Michael J,0,0,0,0
1667966084877,CSE 219,A00,106111,Dow; Steven P,0,0,20,20
1667966085302,CSE 221,A00,102376,Voelker; Geoffrey M.,0,0,0,0
1667966085759,CSE 224,A01,102378,Porter; George M,0,0,0,0
1667966086183,CSE 229A,A00,102379,Savage; Stefan,0,0,0,0
1667966086611,CSE 229C,A00,102380,Munyaka; Imani N. S.,0,0,0,0
1667966087046,CSE 232B,A00,102382,Deutsch; Alin Bernard,0,0,0,0
1667966087480,CSE 234,A01,112904,Kumar; Arun Kumar,0,0,0,0
1667966087902,CSE 237A,A00,102383,Rosing; Tajana Simunic,0,0,0,0
1667966088327,CSE 239A,A00,102384,Deutsch; Alin Bernard,0,0,0,0
1667966088750,CSE 239B,A00,102385,Polikarpova; Nadezhda,0,0,0,0
1667966089183,CSE 240A,A00,102386,Pannuto; Patrick William,0,0,0,0
1667966089607,CSE 240B,A00,102387,Zhao; Jishen,0,0,0,0
1667966090029,CSE 241A,A00,106406,Kang; Mingu,0,0,0,0
1667966090456,CSE 249B,A00,102388,Kahng; Andrew Byun,0,0,8,8
1667966090883,CSE 251B,A01,102392,Cottrell; Garrison W,0,0,0,0
1667966090883,CSE 251B,A02,102393,Cottrell; Garrison W,0,0,0,0
1667966091310,CSE 252B,A00,102394,Ochoa; Benjamin Lawrence,0,0,0,0
1667966091744,CSE 257,A01,102396,Gao; Sicun,0,0,0,0
1667966092172,CSE 272,A00,102397,Li; Tzumao,0,0,0,0
1667966092598,CSE 274,A00,111323,Chern; Albert Ren-Haur,0,0,0,0
1667966093029,CSE 282,A00,102398,Pevzner; Pavel Arkadjevich,0,0,0,0
1667966093452,CSE 284,A00,114175,Gymrek; Melissa Ann,0,0,0,0
1667966093878,CSE 290,A00,102399,Chandraker; Manmohan Krishna,0,0,0,0
1667966093878,CSE 290,B00,102400,Vaccaro; Kristen Marie,0,0,25,25
1667966093878,CSE 290,C00,102414,Pannuto; Patrick William,0,0,25,25
1667966093878,CSE 290,D00,102427,Pevzner; Pavel Arkadjevich,0,0,0,0
1667966093878,CSE 290,E00,102429,Zhao; Jishen,0,0,0,0
1667966093878,CSE 290,F00,102436,Tullsen; Dean Michael,0,0,0,0
1667966093878,CSE 290,G00,102440,Christensen; Henrik I,0,0,20,20
1667966094317,CSE 291,A00,102443,Su; Hao,0,0,0,0
1667966094317,CSE 291,B00,102448,Polikarpova; Nadezhda,0,0,0,0
1667966094317,CSE 291,C00,102453,Vaccaro; Kristen Marie,0,0,0,0
1667966094317,CSE 291,D00,111343,Savage; Stefan,0,0,0,0
1667966094317,CSE 291,E00,116474,Claffy; Kimberly Claire,0,0,0,0
1667966094317,CSE 291,F00,116479,Pasquale; Joseph,0,0,0,0
1667966094754,CSE 293,001,119111,Bafna; Vineet,9999,0,9999,0
1667966094754,CSE 293,002,119118,Bellare; Mihir,9999,0,9999,0
1667966094754,CSE 293,003,119122,Berg-Kirkpatrick; Taylor D,9999,0,9999,0
1667966094754,CSE 293,004,119135,Christensen; Henrik I,9999,0,9999,0
1667966094754,CSE 293,005,119142,Cottrell; Garrison W,9999,0,9999,0
1667966094754,CSE 293,006,119146,Deutsch; Alin Bernard,9999,0,9999,0
1667966094754,CSE 293,007,119159,Esmaeilzadeh; Hadi,9999,0,9999,0
1667966094754,CSE 293,008,119166,Freund; Yoav,9999,0,9999,0
1667966094754,CSE 293,009,119170,Griswold; William G.,9999,0,9999,0
1667966094754,CSE 293,010,119183,Gymrek; Melissa Ann,9999,0,9999,0
1667966094754,CSE 293,011,119190,Heninger; Nadia A,9999,0,9999,0
1667966094754,CSE 293,012,119230,Impagliazzo; Russell,9999,0,9999,0
1667966094754,CSE 293,013,119232,Jhala; Ranjit,9999,0,9999,0
1667966094754,CSE 293,014,119233,Kahng; Andrew Byun,9999,0,9999,0
1667966094754,CSE 293,015,119298,Kane; Daniel Mertz,9999,0,9999,0
1667966094754,CSE 293,016,119299,Kriegman; David J,9999,0,9999,0
1667966094754,CSE 293,017,119300,Kumar; Arun Kumar,9999,0,9999,0
1667966094754,CSE 293,018,119301,Lerner; Sorin,9999,0,9999,0
1667966094754,CSE 293,019,119302,Lovett; Shachar,9999,0,9999,0
1667966094754,CSE 293,020,119303,McAuley; Julian John,9999,0,9999,0
1667966094754,CSE 293,021,119304,Micciancio; Daniele,9999,0,9999,0
1667966094754,CSE 293,022,119367,Orailoglu; Alex,9999,0,9999,0
1667966094754,CSE 293,023,119382,Paturi; Ramamohan,9999,0,9999,0
1667966094754,CSE 293,024,119404,Polikarpova; Nadezhda,9999,0,9999,0
1667966094754,CSE 293,025,119406,Politz; Joseph Gibbs,9999,0,9999,0
1667966094754,CSE 293,026,119411,Porter; George M,9999,0,9999,0
1667966094754,CSE 293,027,119414,Porter; Leonard Emerson,9999,0,9999,0
1667966094754,CSE 293,028,119416,Ramamoorthi; Ravi,9999,0,9999,0
1667966094754,CSE 293,029,119417,Sahoo; Debashis,9999,0,9999,0
1667966094754,CSE 293,030,119420,Saul; Lawrence,9999,0,9999,0
1667966094754,CSE 293,031,119421,Savage; Stefan,9999,0,9999,0
1667966094754,CSE 293,032,119425,Schulze; Jurgen P.,9999,0,9999,0
1667966094754,CSE 293,033,119426,Snoeren; Alex C.,9999,0,9999,0
1667966094754,CSE 293,034,119428,Shang; Jingbo,9999,0,9999,0
1667966094754,CSE 293,035,119430,Stefan; Deian,9999,0,9999,0
1667966094754,CSE 293,036,119431,Su; Hao,9999,0,9999,0
1667966094754,CSE 293,037,119433,Swanson; Steven James,9999,0,9999,0
1667966094754,CSE 293,038,119435,Tullsen; Dean Michael,9999,0,9999,0
1667966094754,CSE 293,039,119483,Voelker; Geoffrey M.,9999,0,9999,0
1667966094754,CSE 293,040,119537,Zhao; Jishen,9999,0,9999,0
1667966094754,CSE 293,041,119538,Zhou; Yuan-Yuan,9999,0,9999,0
1667966094754,CSE 293,042,119539,Gao; Sicun,9999,0,9999,0
1667966094754,CSE 293,043,119540,Weibel; Nadir,9999,0,9999,0
1667966094754,CSE 293,044,119541,Gupta; Rajesh K.,9999,0,9999,0
1667966095178,CSE 294,A00,102459,Voelker; Geoffrey M.,0,0,0,0
1667966095178,CSE 294,B00,111322,Orailoglu; Alex,0,0,0,0
1667966095604,DSE 201,A00,096914,Deutsch; Alin Bernard,30,0,30,0
1667966096027,DSE 210,A00,096915,Dasgupta; Sanjoy,30,0,30,0
1667966096454,DSE 260A,A00,096916,Altintas De Callaf; Ilkay,30,0,30,0
1667966096897,ECE 200,001,103586,Antipa; Nicholas A,9999,0,9999,0
1667966096897,ECE 200,002,103587,Atanasov; Nikolay A.,9999,0,9999,0
1667966096897,ECE 200,003,103588,Bharadia; Dinesh,9999,0,9999,0
1667966096897,ECE 200,004,103589,Cheng; Chung Kuan,9999,0,9999,0
1667966096897,ECE 200,005,103590,Cosman; Pamela C.,9999,0,9999,0
1667966096897,ECE 200,006,103591,Dayeh; Shadi Ahmad,9999,0,9999,0
1667966096897,ECE 200,007,103592,Fainman; Yeshaiahu,9999,0,9999,0
1667966096897,ECE 200,008,103593,Ford; Joseph Earl,9999,0,9999,0
1667966096897,ECE 200,009,103594,Franceschetti; Massimo,9999,0,9999,0
1667966096897,ECE 200,010,103595,Fullerton; Eric E,9999,0,9999,0
1667966096897,ECE 200,011,103596,Galton; Ian A,9999,0,9999,0
1667966096897,ECE 200,012,103597,Gilja; Vikash,9999,0,9999,0
1667966096897,ECE 200,013,103598,Hall; Drew A.,9999,0,9999,0
1667966096897,ECE 200,014,103599,Hsueh; Tzu-Chien,9999,0,9999,0
1667966096897,ECE 200,015,103600,Javidi; Tara,9999,0,9999,0
1667966096897,ECE 200,016,103601,Kahng; Andrew Byun,9999,0,9999,0
1667966096897,ECE 200,017,103602,Kim; Young-Han,9999,0,9999,0
1667966096897,ECE 200,018,103603,Koushanfar; Farinaz,9999,0,9999,0
1667966096897,ECE 200,019,103604,Kuzum; Duygu,9999,0,9999,0
1667966096897,ECE 200,020,103605,Le; Hanh-Phuc,9999,0,9999,0
1667966096897,ECE 200,021,103606,Lin; Bill,9999,0,9999,0
1667966096897,ECE 200,022,103607,Liu; Zhaowei,9998,0,9999,1
1667966096897,ECE 200,023,103608,Lo; Yu-Hwa,9999,0,9999,0
1667966096897,ECE 200,024,103609,Lomakin; Vitaliy,9999,0,9999,0
1667966096897,ECE 200,025,103610,Mercier; Patrick Philip,9999,0,9999,0
1667966096897,ECE 200,026,103611,Meyer; Florian,9999,0,9999,0
1667966096897,ECE 200,027,103612,Milstein; Laurence B.,9999,0,9999,0
1667966096897,ECE 200,028,103613,Mir Arabbaygi; Siavash,9999,0,9999,0
1667966096897,ECE 200,029,103614,Mookherjea; Shayan,9999,0,9999,0
1667966096897,ECE 200,030,103615,Morris; Karcher William,9999,0,9999,0
1667966096897,ECE 200,031,103616,Ng; Tse Nga,9999,0,9999,0
1667966096897,ECE 200,032,103617,Nguyen; Truong Quang,9999,0,9999,0
1667966096897,ECE 200,033,103618,Nomura; Kenji,9999,0,9999,0
1667966096897,ECE 200,034,103619,Orlitsky; Alon,9999,0,9999,0
1667966096897,ECE 200,035,103620,Pal; Piya,9999,0,9999,0
1667966096897,ECE 200,036,103621,Papen; George C.,9999,0,9999,0
1667966096897,ECE 200,037,103622,Radic; Stojan,9999,0,9999,0
1667966096897,ECE 200,038,103623,Rao; Bhaskar D.,9999,0,9999,0
1667966096897,ECE 200,039,103624,Rao; Ramesh R,9999,0,9999,0
1667966096897,ECE 200,040,103625,Rebeiz; Gabriel,9999,0,9999,0
1667966096897,ECE 200,041,103626,Sanford; John R,9999,0,9999,0
1667966096897,ECE 200,042,103627,Siegel; Paul H.,9999,0,9999,0
1667966096897,ECE 200,043,103628,Sievenpiper; Daniel F.,9999,0,9999,0
1667966096897,ECE 200,044,103629,Sworder; David D.,9999,0,9999,0
1667966096897,ECE 200,045,103630,Taur; Yuan,9999,0,9999,0
1667966096897,ECE 200,046,103631,Touri; Behrouz,9999,0,9999,0
1667966096897,ECE 200,047,103632,Trivedi; Mohan M.,9999,0,9999,0
1667966096897,ECE 200,048,103633,Vasconcelos; Nuno,9999,0,9999,0
1667966096897,ECE 200,049,103634,Wang; Xiaolong,9999,0,9999,0
1667966096897,ECE 200,050,103635,Xie; Pengtao,9999,0,9999,0
1667966096897,ECE 200,051,103636,Yip; Michael,9999,0,9999,0
1667966096897,ECE 200,052,103637,Zeger; Kenneth A.,999,0,999,0
1667966096897,ECE 200,053,103638,Zhang; Xinyu,9999,0,9999,0
1667966096897,ECE 200,054,103639,Turakhia; Yatish Girish,9999,0,9999,0
1667966096897,ECE 200,055,103640,Kang; Mingu,9999,0,9999,0
1667966096897,ECE 200,056,103641,Shi; Yuanyuan,9999,0,9999,0
1667966096897,ECE 200,057,103642,Wang; Edward Jay,9999,0,9999,0
1667966096897,ECE 200,058,103643,Zheng; Yang,9999,0,9999,0
1667966097325,ECE 202,A00,103644,Kuzum; Duygu,0,0,0,0
1667966097746,ECE 212BN,A00,103646,Ng; Tse Nga,0,0,0,0
1667966098172,ECE 221,A00,111493,Staff,0,0,0,0
1667966098611,ECE 222B,A00,103647,Lomakin; Vitaliy,0,0,0,0
1667966099038,ECE 230B,A00,103648,Taur; Yuan,0,0,0,0
1667966099467,ECE 238B,A00,103649,Garay; Javier,0,0,0,0
1667966099891,ECE 240B,A00,112900,Fainman; Yeshaiahu,0,0,0,0
1667966100316,ECE 247A,A00,103650,Jokerst; Jesse Vincent,0,0,0,0
1667966100742,ECE 247B,A00,103651,Wang; Joseph,0,0,0,0
1667966101184,ECE 250,A00,103652,Siegel; Paul H.,0,0,0,0
1667966101610,ECE 251A,A00,103654,Rao; Bhaskar D.,0,0,0,0
1667966102033,ECE 257B,A00,103655,Bharadia; Dinesh,0,0,0,0
1667966102455,ECE 258A,A00,103656,Milstein; Laurence B.,0,0,0,0
1667966102885,ECE 260B,A00,103658,Kang; Mingu,0,0,0,0
1667966103311,ECE 264A,A00,103659,Galton; Ian A,0,0,0,0
1667966103737,ECE 265A,A00,103661,Gudem; Prasad S.S.,0,0,0,0
1667966104164,ECE 265D,A00,103662,Gudem; Prasad S.S.,0,0,0,0
1667966104589,ECE 268,A00,103663,Koushanfar; Farinaz,0,0,0,0
1667966105018,ECE 269,A01,103665,Pal; Piya,0,0,0,0
1667966105445,ECE 271B,A00,103666,Vasconcelos; Manuela,0,0,0,0
1667966105877,ECE 276A,A00,103667,Atanasov; Nikolay A.,0,0,0,0
1667966106311,ECE 277,A00,103668,An; Cheolhong,0,0,0,0
1667966106737,ECE 279,A00,117947,Hall; Drew A.,0,0,0,0
1667966107586,ECE 283,A00,103670,Hsueh; Tzu-Chien,0,0,0,0
1667966108016,ECE 284,A00,103671,Turakhia; Yatish Girish,0,0,0,0
1667966108441,ECE 285,A00,103672,Zheng; Yang,0,0,0,0
1667966108441,ECE 285,B00,103673,Sworder; David D.,0,0,0,0
1667966108944,ECE 287,A00,103676,Javidi; Tara,0,0,0,0
1667966109370,MATH 200B,A00,098023,Salehi Golsefidy; Alireza,14,0,15,1
1667966109794,MATH 202B,A00,098024,Rhoades; Brendon Patrick,12,0,15,3
1667966110218,MATH 203B,A00,098025,Oprea; Dragos N.,12,0,15,3
1667966110644,MATH 204B,A00,098026,Sorensen; Claus M,14,0,15,1
1667966111067,MATH 208,A00,098027,Izadi; Elham,7,0,10,3
1667966111498,MATH 209,A00,098028,Pollack; Aaron,10,0,10,0
1667966111929,MATH 211A,A00,112919,Rogalski; Daniel,9,0,10,1
1667966112361,MATH 211B,A00,112920,Seward; Brandon M.,9,0,10,1
1667966112809,MATH 218,A00,098029,Li; Bo,10,0,10,0
1667966113242,MATH 220B,A00,098030,Novak; Jonathan I,13,0,15,2
1667966113671,MATH 221A,A00,098031,Ebenfelt; Peter F,13,0,15,2
1667966114095,MATH 231B,A00,098032,Zlatos; Andrej,12,0,15,3
1667966114517,MATH 240B,A00,098033,Ni; Lei,10,0,15,5
1667966114949,MATH 243,A00,098034,Jekel; David Andrew,10,0,10,0
1667966115376,MATH 245A,A00,098035,Nie; Jiawang,0,0,15,16
1667966115800,MATH 248,A00,098036,Bejenaru; Ioan,10,0,10,0
1667966116225,MATH 250B,A00,098037,Spolaor; Luca,14,0,15,1
1667966116651,MATH 258,A00,098038,Ni; Lei,10,0,10,0
1667966117089,MATH 264B,A00,098041,Rhoades; Brendon Patrick,12,0,15,3
1667966117512,MATH 268,A00,098042,Buss; Samuel R,10,0,10,0
1667966117935,MATH 269,A00,098043,Rhoades; Brendon Patrick,10,0,10,0
1667966118362,MATH 270B,A00,098044,Li; Bo,11,0,15,4
1667966118788,MATH 272B,A00,098045,Holst; Michael J,13,0,15,2
1667966119210,MATH 273A,A00,098046,Tian; Xiaochuan,12,0,15,3
1667966119634,MATH 275,A01,098048,Tian; Xiaochuan,6,0,10,4
1667966120057,MATH 278A,A00,098049,Holst; Michael J,8,0,10,2
1667966120480,MATH 278B,A00,098050,Cloninger; Alexander,10,0,10,0
1667966120913,MATH 278C,A00,098051,Nie; Jiawang,8,0,10,2
1667966121337,MATH 280B,A00,098052,Zheng; Tianyi,12,0,15,3
1667966121764,MATH 281B,A00,098053,Bradic; Jelena,4,0,15,11
1667966122200,MATH 282B,A00,098054,Arias-Castro; Ery,2,0,15,13
1667966122625,MATH 285,A00,098055,Fitzsimmons; Patrick J,0,0,15,17
1667966123050,MATH 287B,A00,098056,Arias-Castro; Ery,5,0,15,10
1667966123473,MATH 288,A00,098057,Agarwal; Pooja,9,0,10,1
1667966123473,MATH 288,B00,098058,Zhang; Danna,9,0,10,1
1667966123473,MATH 288,C00,098059,Williams; Ruth J,10,0,10,0
1667966123913,MATH 290B,A00,098060,Roberts; Justin Deritter,14,0,15,1
1667966124352,MATH 292,A00,098061,Belmont; Eva Kinoshita,10,0,10,0
1667966124777,MATH 295,A00,098062,Suk; Andrew Hoon,48,0,50,2
1667966125207,MATH 296,A00,098063,Novak; Jonathan I,20,0,20,0
1667966125634,MATH 297,001,098064,Gamst; Anthony Collins,9997,0,9999,2
1667966627467,COGS 205,A00,101395,Chiba; Andrea,19,0,20,1
1667966627896,COGS 210B,001,101404,Greene; Deanna Jacquelyn,9998,0,9999,1
1667966627896,COGS 210B,002,101417,Xia; Haijun,9999,0,9999,0
1667966627896,COGS 210B,003,101422,Nitz; Douglas A.,9999,0,9999,0
1667966627896,COGS 210B,004,101423,Hollan; James D.,9998,0,9999,1
1667966627896,COGS 210B,005,101424,Deak; Gedeon O.,9999,0,9999,0
1667966627896,COGS 210B,006,101425,Rossano; Federico,9999,0,9999,0
1667966628320,COGS 211B,A00,101427,Coulson; Seana M,9997,0,9999,2
1667966628746,COGS 220,A00,101428,Hollan; James D.,0,0,25,25
1667966629170,COGS 229,A00,101429,Dow; Steven P,18,0,25,7
1667966629594,COGS 230,A00,101430,Klemmer; Scott R,13,0,17,4
1667966630025,COGS 234,A00,101431,Xia; Haijun,7,0,25,18
1667966630459,COGS 260,A00,101432,Kiyonaga; Anastasia,20,0,25,5
1667966630459,COGS 260,B00,101433,Kirsh; David Joel,16,0,25,9
1667966630991,CSE 202,A00,102371,Impagliazzo; Russell,0,0,0,0
1667966631417,CSE 203B,A01,102373,Cheng; Chung Kuan,0,0,0,0
1667966631841,CSE 208,A00,102374,Micciancio; Daniele,0,0,0,0
1667966632264,CSE 209A,A00,112895,Impagliazzo; Russell,0,0,15,15
1667966632688,CSE 209B,A00,108005,Bellare; Mihir,0,0,0,0
1667966633119,CSE 210,A00,113163,Coblenz; Michael J,0,0,0,0
1667966633549,CSE 219,A00,106111,Dow; Steven P,0,0,20,20
1667966633974,CSE 221,A00,102376,Voelker; Geoffrey M.,0,0,0,0
1667966634399,CSE 224,A01,102378,Porter; George M,0,0,0,0
1667966634825,CSE 229A,A00,102379,Savage; Stefan,0,0,0,0
1667966635257,CSE 229C,A00,102380,Munyaka; Imani N. S.,0,0,0,0
1667966635683,CSE 232B,A00,102382,Deutsch; Alin Bernard,0,0,0,0
1667966636111,CSE 234,A01,112904,Kumar; Arun Kumar,0,0,0,0
1667966636536,CSE 237A,A00,102383,Rosing; Tajana Simunic,0,0,0,0
1667966636967,CSE 239A,A00,102384,Deutsch; Alin Bernard,0,0,0,0
1667966637400,CSE 239B,A00,102385,Polikarpova; Nadezhda,0,0,0,0
1667966637824,CSE 240A,A00,102386,Pannuto; Patrick William,0,0,0,0
1667966638247,CSE 240B,A00,102387,Zhao; Jishen,0,0,0,0
1667966638675,CSE 241A,A00,106406,Kang; Mingu,0,0,0,0
1667966639100,CSE 249B,A00,102388,Kahng; Andrew Byun,0,0,8,8
1667966639527,CSE 251B,A01,102392,Cottrell; Garrison W,0,0,0,0
1667966639527,CSE 251B,A02,102393,Cottrell; Garrison W,0,0,0,0
1667966639961,CSE 252B,A00,102394,Ochoa; Benjamin Lawrence,0,0,0,0
1667966640393,CSE 257,A01,102396,Gao; Sicun,0,0,0,0
1667966640819,CSE 272,A00,102397,Li; Tzumao,0,0,0,0
1667966641243,CSE 274,A00,111323,Chern; Albert Ren-Haur,0,0,0,0
1667966641667,CSE 282,A00,102398,Pevzner; Pavel Arkadjevich,0,0,0,0
1667966642090,CSE 284,A00,114175,Gymrek; Melissa Ann,0,0,0,0
1667966642519,CSE 290,A00,102399,Chandraker; Manmohan Krishna,0,0,0,0
1667966642519,CSE 290,B00,102400,Vaccaro; Kristen Marie,0,0,25,25
1667966642519,CSE 290,C00,102414,Pannuto; Patrick William,0,0,25,25
1667966642519,CSE 290,D00,102427,Pevzner; Pavel Arkadjevich,0,0,0,0
1667966642519,CSE 290,E00,102429,Zhao; Jishen,0,0,0,0
1667966642519,CSE 290,F00,102436,Tullsen; Dean Michael,0,0,0,0
1667966642519,CSE 290,G00,102440,Christensen; Henrik I,0,0,20,20
1667966642942,CSE 291,A00,102443,Su; Hao,0,0,0,0
1667966642942,CSE 291,B00,102448,Polikarpova; Nadezhda,0,0,0,0
1667966642942,CSE 291,C00,102453,Vaccaro; Kristen Marie,0,0,0,0
1667966642942,CSE 291,D00,111343,Savage; Stefan,0,0,0,0
1667966642942,CSE 291,E00,116474,Claffy; Kimberly Claire,0,0,0,0
1667966642942,CSE 291,F00,116479,Pasquale; Joseph,0,0,0,0
1667966643378,CSE 293,001,119111,Bafna; Vineet,9999,0,9999,0
1667966643378,CSE 293,002,119118,Bellare; Mihir,9999,0,9999,0
1667966643378,CSE 293,003,119122,Berg-Kirkpatrick; Taylor D,9999,0,9999,0
1667966643378,CSE 293,004,119135,Christensen; Henrik I,9999,0,9999,0
1667966643378,CSE 293,005,119142,Cottrell; Garrison W,9999,0,9999,0
1667966643378,CSE 293,006,119146,Deutsch; Alin Bernard,9999,0,9999,0
1667966643378,CSE 293,007,119159,Esmaeilzadeh; Hadi,9999,0,9999,0
1667966643378,CSE 293,008,119166,Freund; Yoav,9999,0,9999,0
1667966643378,CSE 293,009,119170,Griswold; William G.,9999,0,9999,0
1667966643378,CSE 293,010,119183,Gymrek; Melissa Ann,9999,0,9999,0
1667966643378,CSE 293,011,119190,Heninger; Nadia A,9999,0,9999,0
1667966643378,CSE 293,012,119230,Impagliazzo; Russell,9999,0,9999,0
1667966643378,CSE 293,013,119232,Jhala; Ranjit,9999,0,9999,0
1667966643378,CSE 293,014,119233,Kahng; Andrew Byun,9999,0,9999,0
1667966643378,CSE 293,015,119298,Kane; Daniel Mertz,9999,0,9999,0
1667966643378,CSE 293,016,119299,Kriegman; David J,9999,0,9999,0
1667966643378,CSE 293,017,119300,Kumar; Arun Kumar,9999,0,9999,0
1667966643378,CSE 293,018,119301,Lerner; Sorin,9999,0,9999,0
1667966643378,CSE 293,019,119302,Lovett; Shachar,9999,0,9999,0
1667966643378,CSE 293,020,119303,McAuley; Julian John,9999,0,9999,0
1667966643378,CSE 293,021,119304,Micciancio; Daniele,9999,0,9999,0
1667966643378,CSE 293,022,119367,Orailoglu; Alex,9999,0,9999,0
1667966643378,CSE 293,023,119382,Paturi; Ramamohan,9999,0,9999,0
1667966643378,CSE 293,024,119404,Polikarpova; Nadezhda,9999,0,9999,0
1667966643378,CSE 293,025,119406,Politz; Joseph Gibbs,9999,0,9999,0
1667966643378,CSE 293,026,119411,Porter; George M,9999,0,9999,0
1667966643378,CSE 293,027,119414,Porter; Leonard Emerson,9999,0,9999,0
1667966643378,CSE 293,028,119416,Ramamoorthi; Ravi,9999,0,9999,0
1667966643378,CSE 293,029,119417,Sahoo; Debashis,9999,0,9999,0
1667966643378,CSE 293,030,119420,Saul; Lawrence,9999,0,9999,0
1667966643378,CSE 293,031,119421,Savage; Stefan,9999,0,9999,0
1667966643378,CSE 293,032,119425,Schulze; Jurgen P.,9999,0,9999,0
1667966643378,CSE 293,033,119426,Snoeren; Alex C.,9999,0,9999,0
1667966643378,CSE 293,034,119428,Shang; Jingbo,9999,0,9999,0
1667966643378,CSE 293,035,119430,Stefan; Deian,9999,0,9999,0
1667966643378,CSE 293,036,119431,Su; Hao,9999,0,9999,0
1667966643378,CSE 293,037,119433,Swanson; Steven James,9999,0,9999,0
1667966643378,CSE 293,038,119435,Tullsen; Dean Michael,9999,0,9999,0
1667966643378,CSE 293,039,119483,Voelker; Geoffrey M.,9999,0,9999,0
1667966643378,CSE 293,040,119537,Zhao; Jishen,9999,0,9999,0
1667966643378,CSE 293,041,119538,Zhou; Yuan-Yuan,9999,0,9999,0
1667966643378,CSE 293,042,119539,Gao; Sicun,9999,0,9999,0
1667966643378,CSE 293,043,119540,Weibel; Nadir,9999,0,9999,0
1667966643378,CSE 293,044,119541,Gupta; Rajesh K.,9999,0,9999,0
1667966643802,CSE 294,A00,102459,Voelker; Geoffrey M.,0,0,0,0
1667966643802,CSE 294,B00,111322,Orailoglu; Alex,0,0,0,0
1667966644225,DSE 201,A00,096914,Deutsch; Alin Bernard,30,0,30,0
1667966644657,DSE 210,A00,096915,Dasgupta; Sanjoy,30,0,30,0
1667966645084,DSE 260A,A00,096916,Altintas De Callaf; Ilkay,30,0,30,0
1667966645527,ECE 200,001,103586,Antipa; Nicholas A,9999,0,9999,0
1667966645527,ECE 200,002,103587,Atanasov; Nikolay A.,9999,0,9999,0
1667966645527,ECE 200,003,103588,Bharadia; Dinesh,9999,0,9999,0
1667966645527,ECE 200,004,103589,Cheng; Chung Kuan,9999,0,9999,0
1667966645527,ECE 200,005,103590,Cosman; Pamela C.,9999,0,9999,0
1667966645527,ECE 200,006,103591,Dayeh; Shadi Ahmad,9999,0,9999,0
1667966645527,ECE 200,007,103592,Fainman; Yeshaiahu,9999,0,9999,0
1667966645527,ECE 200,008,103593,Ford; Joseph Earl,9999,0,9999,0
1667966645527,ECE 200,009,103594,Franceschetti; Massimo,9999,0,9999,0
1667966645527,ECE 200,010,103595,Fullerton; Eric E,9999,0,9999,0
1667966645527,ECE 200,011,103596,Galton; Ian A,9999,0,9999,0
1667966645527,ECE 200,012,103597,Gilja; Vikash,9999,0,9999,0
1667966645527,ECE 200,013,103598,Hall; Drew A.,9999,0,9999,0
1667966645527,ECE 200,014,103599,Hsueh; Tzu-Chien,9999,0,9999,0
1667966645527,ECE 200,015,103600,Javidi; Tara,9999,0,9999,0
1667966645527,ECE 200,016,103601,Kahng; Andrew Byun,9999,0,9999,0
1667966645527,ECE 200,017,103602,Kim; Young-Han,9999,0,9999,0
1667966645527,ECE 200,018,103603,Koushanfar; Farinaz,9999,0,9999,0
1667966645527,ECE 200,019,103604,Kuzum; Duygu,9999,0,9999,0
1667966645527,ECE 200,020,103605,Le; Hanh-Phuc,9999,0,9999,0
1667966645527,ECE 200,021,103606,Lin; Bill,9999,0,9999,0
1667966645527,ECE 200,022,103607,Liu; Zhaowei,9998,0,9999,1
1667966645527,ECE 200,023,103608,Lo; Yu-Hwa,9999,0,9999,0
1667966645527,ECE 200,024,103609,Lomakin; Vitaliy,9999,0,9999,0
1667966645527,ECE 200,025,103610,Mercier; Patrick Philip,9999,0,9999,0
1667966645527,ECE 200,026,103611,Meyer; Florian,9999,0,9999,0
1667966645527,ECE 200,027,103612,Milstein; Laurence B.,9999,0,9999,0
1667966645527,ECE 200,028,103613,Mir Arabbaygi; Siavash,9999,0,9999,0
1667966645527,ECE 200,029,103614,Mookherjea; Shayan,9999,0,9999,0
1667966645527,ECE 200,030,103615,Morris; Karcher William,9999,0,9999,0
1667966645527,ECE 200,031,103616,Ng; Tse Nga,9999,0,9999,0
1667966645527,ECE 200,032,103617,Nguyen; Truong Quang,9999,0,9999,0
1667966645527,ECE 200,033,103618,Nomura; Kenji,9999,0,9999,0
1667966645527,ECE 200,034,103619,Orlitsky; Alon,9999,0,9999,0
1667966645527,ECE 200,035,103620,Pal; Piya,9999,0,9999,0
1667966645527,ECE 200,036,103621,Papen; George C.,9999,0,9999,0
1667966645527,ECE 200,037,103622,Radic; Stojan,9999,0,9999,0
1667966645527,ECE 200,038,103623,Rao; Bhaskar D.,9999,0,9999,0
1667966645527,ECE 200,039,103624,Rao; Ramesh R,9999,0,9999,0
1667966645527,ECE 200,040,103625,Rebeiz; Gabriel,9999,0,9999,0
1667966645527,ECE 200,041,103626,Sanford; John R,9999,0,9999,0
1667966645527,ECE 200,042,103627,Siegel; Paul H.,9999,0,9999,0
1667966645527,ECE 200,043,103628,Sievenpiper; Daniel F.,9999,0,9999,0
1667966645527,ECE 200,044,103629,Sworder; David D.,9999,0,9999,0
1667966645527,ECE 200,045,103630,Taur; Yuan,9999,0,9999,0
1667966645527,ECE 200,046,103631,Touri; Behrouz,9999,0,9999,0
1667966645527,ECE 200,047,103632,Trivedi; Mohan M.,9999,0,9999,0
1667966645527,ECE 200,048,103633,Vasconcelos; Nuno,9999,0,9999,0
1667966645527,ECE 200,049,103634,Wang; Xiaolong,9999,0,9999,0
1667966645527,ECE 200,050,103635,Xie; Pengtao,9999,0,9999,0
1667966645527,ECE 200,051,103636,Yip; Michael,9999,0,9999,0
1667966645527,ECE 200,052,103637,Zeger; Kenneth A.,999,0,999,0
1667966645527,ECE 200,053,103638,Zhang; Xinyu,9999,0,9999,0
1667966645527,ECE 200,054,103639,Turakhia; Yatish Girish,9999,0,9999,0
1667966645527,ECE 200,055,103640,Kang; Mingu,9999,0,9999,0
1667966645527,ECE 200,056,103641,Shi; Yuanyuan,9999,0,9999,0
1667966645527,ECE 200,057,103642,Wang; Edward Jay,9999,0,9999,0
1667966645527,ECE 200,058,103643,Zheng; Yang,9999,0,9999,0
1667966645952,ECE 202,A00,103644,Kuzum; Duygu,0,0,0,0
1667966646394,ECE 212BN,A00,103646,Ng; Tse Nga,0,0,0,0
1667966646820,ECE 221,A00,111493,Staff,0,0,0,0
1667966647257,ECE 222B,A00,103647,Lomakin; Vitaliy,0,0,0,0
1667966647680,ECE 230B,A00,103648,Taur; Yuan,0,0,0,0
1667966648111,ECE 238B,A00,103649,Garay; Javier,0,0,0,0
1667966648534,ECE 240B,A00,112900,Fainman; Yeshaiahu,0,0,0,0
1667966648957,ECE 247A,A00,103650,Jokerst; Jesse Vincent,0,0,0,0
1667966649396,ECE 247B,A00,103651,Wang; Joseph,0,0,0,0
1667966649823,ECE 250,A00,103652,Siegel; Paul H.,0,0,0,0
1667966650252,ECE 251A,A00,103654,Rao; Bhaskar D.,0,0,0,0
1667966650674,ECE 257B,A00,103655,Bharadia; Dinesh,0,0,0,0
1667966651106,ECE 258A,A00,103656,Milstein; Laurence B.,0,0,0,0
1667966651531,ECE 260B,A00,103658,Kang; Mingu,0,0,0,0
1667966651970,ECE 264A,A00,103659,Galton; Ian A,0,0,0,0
1667966652395,ECE 265A,A00,103661,Gudem; Prasad S.S.,0,0,0,0
1667966652830,ECE 265D,A00,103662,Gudem; Prasad S.S.,0,0,0,0
1667966653263,ECE 268,A00,103663,Koushanfar; Farinaz,0,0,0,0
1667966653685,ECE 269,A01,103665,Pal; Piya,0,0,0,0
1667966654110,ECE 271B,A00,103666,Vasconcelos; Manuela,0,0,0,0
1667966654547,ECE 276A,A00,103667,Atanasov; Nikolay A.,0,0,0,0
1667966654972,ECE 277,A00,103668,An; Cheolhong,0,0,0,0
1667966655400,ECE 279,A00,117947,Hall; Drew A.,0,0,0,0
1667966656255,ECE 283,A00,103670,Hsueh; Tzu-Chien,0,0,0,0
1667966656681,ECE 284,A00,103671,Turakhia; Yatish Girish,0,0,0,0
1667966657117,ECE 285,A00,103672,Zheng; Yang,0,0,0,0
1667966657117,ECE 285,B00,103673,Sworder; David D.,0,0,0,0
1667966657539,ECE 287,A00,103676,Javidi; Tara,0,0,0,0
1667966657963,MATH 200B,A00,098023,Salehi Golsefidy; Alireza,14,0,15,1
1667966658387,MATH 202B,A00,098024,Rhoades; Brendon Patrick,12,0,15,3
1667966658812,MATH 203B,A00,098025,Oprea; Dragos N.,12,0,15,3
1667966659235,MATH 204B,A00,098026,Sorensen; Claus M,14,0,15,1
1667966659661,MATH 208,A00,098027,Izadi; Elham,7,0,10,3
1667966660094,MATH 209,A00,098028,Pollack; Aaron,10,0,10,0
1667966660543,MATH 211A,A00,112919,Rogalski; Daniel,9,0,10,1
1667966660980,MATH 211B,A00,112920,Seward; Brandon M.,9,0,10,1
1667966661406,MATH 218,A00,098029,Li; Bo,10,0,10,0
1667966661850,MATH 220B,A00,098030,Novak; Jonathan I,13,0,15,2
1667966662274,MATH 221A,A00,098031,Ebenfelt; Peter F,13,0,15,2
1667966662698,MATH 231B,A00,098032,Zlatos; Andrej,12,0,15,3
1667966663122,MATH 240B,A00,098033,Ni; Lei,10,0,15,5
1667966663547,MATH 243,A00,098034,Jekel; David Andrew,10,0,10,0
1667966663970,MATH 245A,A00,098035,Nie; Jiawang,0,0,15,16
1667966664393,MATH 248,A00,098036,Bejenaru; Ioan,10,0,10,0
1667966664825,MATH 250B,A00,098037,Spolaor; Luca,14,0,15,1
1667966665249,MATH 258,A00,098038,Ni; Lei,10,0,10,0
1667966665682,MATH 264B,A00,098041,Rhoades; Brendon Patrick,12,0,15,3
1667966666106,MATH 268,A00,098042,Buss; Samuel R,10,0,10,0
1667966666536,MATH 269,A00,098043,Rhoades; Brendon Patrick,10,0,10,0
1667966666961,MATH 270B,A00,098044,Li; Bo,11,0,15,4
1667966667384,MATH 272B,A00,098045,Holst; Michael J,13,0,15,2
1667966667808,MATH 273A,A00,098046,Tian; Xiaochuan,12,0,15,3
1667966668239,MATH 275,A01,098048,Tian; Xiaochuan,6,0,10,4
1667966668661,MATH 278A,A00,098049,Holst; Michael J,8,0,10,2
1667966669083,MATH 278B,A00,098050,Cloninger; Alexander,10,0,10,0
1667966669511,MATH 278C,A00,098051,Nie; Jiawang,8,0,10,2
1667966669933,MATH 280B,A00,098052,Zheng; Tianyi,12,0,15,3
1667966670365,MATH 281B,A00,098053,Bradic; Jelena,4,0,15,11
1667966670789,MATH 282B,A00,098054,Arias-Castro; Ery,2,0,15,13
1667966671217,MATH 285,A00,098055,Fitzsimmons; Patrick J,0,0,15,17
1667966671642,MATH 287B,A00,098056,Arias-Castro; Ery,5,0,15,10
1667966672068,MATH 288,A00,098057,Agarwal; Pooja,9,0,10,1
1667966672068,MATH 288,B00,098058,Zhang; Danna,9,0,10,1
1667966672068,MATH 288,C00,098059,Williams; Ruth J,10,0,10,0
1667966672499,MATH 290B,A00,098060,Roberts; Justin Deritter,14,0,15,1
1667966672926,MATH 292,A00,098061,Belmont; Eva Kinoshita,10,0,10,0
1667966673349,MATH 295,A00,098062,Suk; Andrew Hoon,48,0,50,2
1667966673773,MATH 296,A00,098063,Novak; Jonathan I,20,0,20,0
1667966674271,MATH 297,001,098064,Gamst; Anthony Collins,9997,0,9999,2
1667967177806,COGS 205,A00,101395,Chiba; Andrea,19,0,20,1
1667967178233,COGS 210B,001,101404,Greene; Deanna Jacquelyn,9998,0,9999,1
1667967178233,COGS 210B,002,101417,Xia; Haijun,9999,0,9999,0
1667967178233,COGS 210B,003,101422,Nitz; Douglas A.,9999,0,9999,0
1667967178233,COGS 210B,004,101423,Hollan; James D.,9998,0,9999,1
1667967178233,COGS 210B,005,101424,Deak; Gedeon O.,9999,0,9999,0
1667967178233,COGS 210B,006,101425,Rossano; Federico,9999,0,9999,0
1667967178661,COGS 211B,A00,101427,Coulson; Seana M,9997,0,9999,2
1667967179083,COGS 220,A00,101428,Hollan; James D.,0,0,25,25
1667967179506,COGS 229,A00,101429,Dow; Steven P,18,0,25,7
1667967179929,COGS 230,A00,101430,Klemmer; Scott R,13,0,17,4
1667967180354,COGS 234,A00,101431,Xia; Haijun,7,0,25,18
1667967180781,COGS 260,A00,101432,Kiyonaga; Anastasia,20,0,25,5
1667967180781,COGS 260,B00,101433,Kirsh; David Joel,16,0,25,9
1667967181204,CSE 202,A00,102371,Impagliazzo; Russell,0,0,0,0
1667967181628,CSE 203B,A01,102373,Cheng; Chung Kuan,0,0,0,0
1667967182054,CSE 208,A00,102374,Micciancio; Daniele,0,0,0,0
1667967182478,CSE 209A,A00,112895,Impagliazzo; Russell,0,0,15,15
1667967182902,CSE 209B,A00,108005,Bellare; Mihir,0,0,0,0
1667967183325,CSE 210,A00,113163,Coblenz; Michael J,0,0,0,0
1667967183755,CSE 219,A00,106111,Dow; Steven P,0,0,20,20
1667967184181,CSE 221,A00,102376,Voelker; Geoffrey M.,0,0,0,0
1667967184604,CSE 224,A01,102378,Porter; George M,0,0,0,0
1667967185027,CSE 229A,A00,102379,Savage; Stefan,0,0,0,0
1667967185451,CSE 229C,A00,102380,Munyaka; Imani N. S.,0,0,0,0
1667967185877,CSE 232B,A00,102382,Deutsch; Alin Bernard,0,0,0,0
1667967186303,CSE 234,A01,112904,Kumar; Arun Kumar,0,0,0,0
1667967186728,CSE 237A,A00,102383,Rosing; Tajana Simunic,0,0,0,0
1667967187152,CSE 239A,A00,102384,Deutsch; Alin Bernard,0,0,0,0
1667967187576,CSE 239B,A00,102385,Polikarpova; Nadezhda,0,0,0,0
1667967188009,CSE 240A,A00,102386,Pannuto; Patrick William,0,0,0,0
1667967188433,CSE 240B,A00,102387,Zhao; Jishen,0,0,0,0
1667967188860,CSE 241A,A00,106406,Kang; Mingu,0,0,0,0
1667967189285,CSE 249B,A00,102388,Kahng; Andrew Byun,0,0,8,8
1667967189711,CSE 251B,A01,102392,Cottrell; Garrison W,0,0,0,0
1667967189711,CSE 251B,A02,102393,Cottrell; Garrison W,0,0,0,0
1667967190135,CSE 252B,A00,102394,Ochoa; Benjamin Lawrence,0,0,0,0
1667967190561,CSE 257,A01,102396,Gao; Sicun,0,0,0,0
1667967190994,CSE 272,A00,102397,Li; Tzumao,0,0,0,0
1667967191423,CSE 274,A00,111323,Chern; Albert Ren-Haur,0,0,0,0
1667967191845,CSE 282,A00,102398,Pevzner; Pavel Arkadjevich,0,0,0,0
1667967192279,CSE 284,A00,114175,Gymrek; Melissa Ann,0,0,0,0
1667967192704,CSE 290,A00,102399,Chandraker; Manmohan Krishna,0,0,0,0
1667967192704,CSE 290,B00,102400,Vaccaro; Kristen Marie,0,0,25,25
1667967192704,CSE 290,C00,102414,Pannuto; Patrick William,0,0,25,25
1667967192704,CSE 290,D00,102427,Pevzner; Pavel Arkadjevich,0,0,0,0
1667967192704,CSE 290,E00,102429,Zhao; Jishen,0,0,0,0
1667967192704,CSE 290,F00,102436,Tullsen; Dean Michael,0,0,0,0
1667967192704,CSE 290,G00,102440,Christensen; Henrik I,0,0,20,20
1667967193134,CSE 291,A00,102443,Su; Hao,0,0,0,0
1667967193134,CSE 291,B00,102448,Polikarpova; Nadezhda,0,0,0,0
1667967193134,CSE 291,C00,102453,Vaccaro; Kristen Marie,0,0,0,0
1667967193134,CSE 291,D00,111343,Savage; Stefan,0,0,0,0
1667967193134,CSE 291,E00,116474,Claffy; Kimberly Claire,0,0,0,0
1667967193134,CSE 291,F00,116479,Pasquale; Joseph,0,0,0,0
1667967193570,CSE 293,001,119111,Bafna; Vineet,9999,0,9999,0
1667967193570,CSE 293,002,119118,Bellare; Mihir,9999,0,9999,0
1667967193570,CSE 293,003,119122,Berg-Kirkpatrick; Taylor D,9999,0,9999,0
1667967193570,CSE 293,004,119135,Christensen; Henrik I,9999,0,9999,0
1667967193570,CSE 293,005,119142,Cottrell; Garrison W,9999,0,9999,0
1667967193570,CSE 293,006,119146,Deutsch; Alin Bernard,9999,0,9999,0
1667967193570,CSE 293,007,119159,Esmaeilzadeh; Hadi,9999,0,9999,0
1667967193570,CSE 293,008,119166,Freund; Yoav,9999,0,9999,0
1667967193570,CSE 293,009,119170,Griswold; William G.,9999,0,9999,0
1667967193570,CSE 293,010,119183,Gymrek; Melissa Ann,9999,0,9999,0
1667967193570,CSE 293,011,119190,Heninger; Nadia A,9999,0,9999,0
1667967193570,CSE 293,012,119230,Impagliazzo; Russell,9999,0,9999,0
1667967193570,CSE 293,013,119232,Jhala; Ranjit,9999,0,9999,0
1667967193570,CSE 293,014,119233,Kahng; Andrew Byun,9999,0,9999,0
1667967193570,CSE 293,015,119298,Kane; Daniel Mertz,9999,0,9999,0
1667967193570,CSE 293,016,119299,Kriegman; David J,9999,0,9999,0
1667967193570,CSE 293,017,119300,Kumar; Arun Kumar,9999,0,9999,0
1667967193570,CSE 293,018,119301,Lerner; Sorin,9999,0,9999,0
1667967193570,CSE 293,019,119302,Lovett; Shachar,9999,0,9999,0
1667967193570,CSE 293,020,119303,McAuley; Julian John,9999,0,9999,0
1667967193570,CSE 293,021,119304,Micciancio; Daniele,9999,0,9999,0
1667967193570,CSE 293,022,119367,Orailoglu; Alex,9999,0,9999,0
1667967193570,CSE 293,023,119382,Paturi; Ramamohan,9999,0,9999,0
1667967193570,CSE 293,024,119404,Polikarpova; Nadezhda,9999,0,9999,0
1667967193570,CSE 293,025,119406,Politz; Joseph Gibbs,9999,0,9999,0
1667967193570,CSE 293,026,119411,Porter; George M,9999,0,9999,0
1667967193570,CSE 293,027,119414,Porter; Leonard Emerson,9999,0,9999,0
1667967193570,CSE 293,028,119416,Ramamoorthi; Ravi,9999,0,9999,0
1667967193570,CSE 293,029,119417,Sahoo; Debashis,9999,0,9999,0
1667967193570,CSE 293,030,119420,Saul; Lawrence,9999,0,9999,0
1667967193570,CSE 293,031,119421,Savage; Stefan,9999,0,9999,0
1667967193570,CSE 293,032,119425,Schulze; Jurgen P.,9999,0,9999,0
1667967193570,CSE 293,033,119426,Snoeren; Alex C.,9999,0,9999,0
1667967193570,CSE 293,034,119428,Shang; Jingbo,9999,0,9999,0
1667967193570,CSE 293,035,119430,Stefan; Deian,9999,0,9999,0
1667967193570,CSE 293,036,119431,Su; Hao,9999,0,9999,0
1667967193570,CSE 293,037,119433,Swanson; Steven James,9999,0,9999,0
1667967193570,CSE 293,038,119435,Tullsen; Dean Michael,9999,0,9999,0
1667967193570,CSE 293,039,119483,Voelker; Geoffrey M.,9999,0,9999,0
1667967193570,CSE 293,040,119537,Zhao; Jishen,9999,0,9999,0
1667967193570,CSE 293,041,119538,Zhou; Yuan-Yuan,9999,0,9999,0
1667967193570,CSE 293,042,119539,Gao; Sicun,9999,0,9999,0
1667967193570,CSE 293,043,119540,Weibel; Nadir,9999,0,9999,0
1667967193570,CSE 293,044,119541,Gupta; Rajesh K.,9999,0,9999,0
1667967193994,CSE 294,A00,102459,Voelker; Geoffrey M.,0,0,0,0
1667967193994,CSE 294,B00,111322,Orailoglu; Alex,0,0,0,0
1667967194421,DSE 201,A00,096914,Deutsch; Alin Bernard,30,0,30,0
1667967194865,DSE 210,A00,096915,Dasgupta; Sanjoy,30,0,30,0
1667967195291,DSE 260A,A00,096916,Altintas De Callaf; Ilkay,30,0,30,0
1667967195717,ECE 200,001,103586,Antipa; Nicholas A,9999,0,9999,0
1667967195717,ECE 200,002,103587,Atanasov; Nikolay A.,9999,0,9999,0
1667967195717,ECE 200,003,103588,Bharadia; Dinesh,9999,0,9999,0
1667967195717,ECE 200,004,103589,Cheng; Chung Kuan,9999,0,9999,0
1667967195717,ECE 200,005,103590,Cosman; Pamela C.,9999,0,9999,0
1667967195717,ECE 200,006,103591,Dayeh; Shadi Ahmad,9999,0,9999,0
1667967195717,ECE 200,007,103592,Fainman; Yeshaiahu,9999,0,9999,0
1667967195717,ECE 200,008,103593,Ford; Joseph Earl,9999,0,9999,0
1667967195717,ECE 200,009,103594,Franceschetti; Massimo,9999,0,9999,0
1667967195717,ECE 200,010,103595,Fullerton; Eric E,9999,0,9999,0
1667967195717,ECE 200,011,103596,Galton; Ian A,9999,0,9999,0
1667967195717,ECE 200,012,103597,Gilja; Vikash,9999,0,9999,0
1667967195717,ECE 200,013,103598,Hall; Drew A.,9999,0,9999,0
1667967195717,ECE 200,014,103599,Hsueh; Tzu-Chien,9999,0,9999,0
1667967195717,ECE 200,015,103600,Javidi; Tara,9999,0,9999,0
1667967195717,ECE 200,016,103601,Kahng; Andrew Byun,9999,0,9999,0
1667967195717,ECE 200,017,103602,Kim; Young-Han,9999,0,9999,0
1667967195717,ECE 200,018,103603,Koushanfar; Farinaz,9999,0,9999,0
1667967195717,ECE 200,019,103604,Kuzum; Duygu,9999,0,9999,0
1667967195717,ECE 200,020,103605,Le; Hanh-Phuc,9999,0,9999,0
1667967195717,ECE 200,021,103606,Lin; Bill,9999,0,9999,0
1667967195717,ECE 200,022,103607,Liu; Zhaowei,9998,0,9999,1
1667967195717,ECE 200,023,103608,Lo; Yu-Hwa,9999,0,9999,0
1667967195717,ECE 200,024,103609,Lomakin; Vitaliy,9999,0,9999,0
1667967195717,ECE 200,025,103610,Mercier; Patrick Philip,9999,0,9999,0
1667967195717,ECE 200,026,103611,Meyer; Florian,9999,0,9999,0
1667967195717,ECE 200,027,103612,Milstein; Laurence B.,9999,0,9999,0
1667967195717,ECE 200,028,103613,Mir Arabbaygi; Siavash,9999,0,9999,0
1667967195717,ECE 200,029,103614,Mookherjea; Shayan,9999,0,9999,0
1667967195717,ECE 200,030,103615,Morris; Karcher William,9999,0,9999,0
1667967195717,ECE 200,031,103616,Ng; Tse Nga,9999,0,9999,0
1667967195717,ECE 200,032,103617,Nguyen; Truong Quang,9999,0,9999,0
1667967195717,ECE 200,033,103618,Nomura; Kenji,9999,0,9999,0
1667967195717,ECE 200,034,103619,Orlitsky; Alon,9999,0,9999,0
1667967195717,ECE 200,035,103620,Pal; Piya,9999,0,9999,0
1667967195717,ECE 200,036,103621,Papen; George C.,9999,0,9999,0
1667967195717,ECE 200,037,103622,Radic; Stojan,9999,0,9999,0
1667967195717,ECE 200,038,103623,Rao; Bhaskar D.,9999,0,9999,0
1667967195717,ECE 200,039,103624,Rao; Ramesh R,9999,0,9999,0
1667967195717,ECE 200,040,103625,Rebeiz; Gabriel,9999,0,9999,0
1667967195717,ECE 200,041,103626,Sanford; John R,9999,0,9999,0
1667967195717,ECE 200,042,103627,Siegel; Paul H.,9999,0,9999,0
1667967195717,ECE 200,043,103628,Sievenpiper; Daniel F.,9999,0,9999,0
1667967195717,ECE 200,044,103629,Sworder; David D.,9999,0,9999,0
1667967195717,ECE 200,045,103630,Taur; Yuan,9999,0,9999,0
1667967195717,ECE 200,046,103631,Touri; Behrouz,9999,0,9999,0
1667967195717,ECE 200,047,103632,Trivedi; Mohan M.,9999,0,9999,0
1667967195717,ECE 200,048,103633,Vasconcelos; Nuno,9999,0,9999,0
1667967195717,ECE 200,049,103634,Wang; Xiaolong,9999,0,9999,0
1667967195717,ECE 200,050,103635,Xie; Pengtao,9999,0,9999,0
1667967195717,ECE 200,051,103636,Yip; Michael,9999,0,9999,0
1667967195717,ECE 200,052,103637,Zeger; Kenneth A.,999,0,999,0
1667967195717,ECE 200,053,103638,Zhang; Xinyu,9999,0,9999,0
1667967195717,ECE 200,054,103639,Turakhia; Yatish Girish,9999,0,9999,0
1667967195717,ECE 200,055,103640,Kang; Mingu,9999,0,9999,0
1667967195717,ECE 200,056,103641,Shi; Yuanyuan,9999,0,9999,0
1667967195717,ECE 200,057,103642,Wang; Edward Jay,9999,0,9999,0
1667967195717,ECE 200,058,103643,Zheng; Yang,9999,0,9999,0
1667967196141,ECE 202,A00,103644,Kuzum; Duygu,0,0,0,0
1667967196580,ECE 212BN,A00,103646,Ng; Tse Nga,0,0,0,0
1667967197016,ECE 221,A00,111493,Staff,0,0,0,0
1667967197449,ECE 222B,A00,103647,Lomakin; Vitaliy,0,0,0,0
1667967197953,ECE 230B,A00,103648,Taur; Yuan,0,0,0,0
1667967198378,ECE 238B,A00,103649,Garay; Javier,0,0,0,0
1667967198799,ECE 240B,A00,112900,Fainman; Yeshaiahu,0,0,0,0
1667967199223,ECE 247A,A00,103650,Jokerst; Jesse Vincent,0,0,0,0
1667967199644,ECE 247B,A00,103651,Wang; Joseph,0,0,0,0
1667967200079,ECE 250,A00,103652,Siegel; Paul H.,0,0,0,0
1667967200501,ECE 251A,A00,103654,Rao; Bhaskar D.,0,0,0,0
1667967200927,ECE 257B,A00,103655,Bharadia; Dinesh,0,0,0,0
1667967201355,ECE 258A,A00,103656,Milstein; Laurence B.,0,0,0,0
1667967201777,ECE 260B,A00,103658,Kang; Mingu,0,0,0,0
1667967202207,ECE 264A,A00,103659,Galton; Ian A,0,0,0,0
1667967202631,ECE 265A,A00,103661,Gudem; Prasad S.S.,0,0,0,0
1667967203058,ECE 265D,A00,103662,Gudem; Prasad S.S.,0,0,0,0
1667967203488,ECE 268,A00,103663,Koushanfar; Farinaz,0,0,0,0
1667967203919,ECE 269,A01,103665,Pal; Piya,0,0,0,0
1667967204341,ECE 271B,A00,103666,Vasconcelos; Manuela,0,0,0,0
1667967204767,ECE 276A,A00,103667,Atanasov; Nikolay A.,0,0,0,0
1667967205191,ECE 277,A00,103668,An; Cheolhong,0,0,0,0
1667967205620,ECE 279,A00,117947,Hall; Drew A.,0,0,0,0
1667967206469,ECE 283,A00,103670,Hsueh; Tzu-Chien,0,0,0,0
1667967206897,ECE 284,A00,103671,Turakhia; Yatish Girish,0,0,0,0
1667967207320,ECE 285,A00,103672,Zheng; Yang,0,0,0,0
1667967207320,ECE 285,B00,103673,Sworder; David D.,0,0,0,0
1667967207744,ECE 287,A00,103676,Javidi; Tara,0,0,0,0
1667967208166,MATH 200B,A00,098023,Salehi Golsefidy; Alireza,14,0,15,1
1667967208590,MATH 202B,A00,098024,Rhoades; Brendon Patrick,12,0,15,3
1667967209021,MATH 203B,A00,098025,Oprea; Dragos N.,12,0,15,3
1667967209450,MATH 204B,A00,098026,Sorensen; Claus M,14,0,15,1
1667967209871,MATH 208,A00,098027,Izadi; Elham,7,0,10,3
1667967210294,MATH 209,A00,098028,Pollack; Aaron,10,0,10,0
1667967210732,MATH 211A,A00,112919,Rogalski; Daniel,9,0,10,1
1667967211157,MATH 211B,A00,112920,Seward; Brandon M.,9,0,10,1
1667967211584,MATH 218,A00,098029,Li; Bo,10,0,10,0
1667967212018,MATH 220B,A00,098030,Novak; Jonathan I,13,0,15,2
1667967212446,MATH 221A,A00,098031,Ebenfelt; Peter F,13,0,15,2
1667967212880,MATH 231B,A00,098032,Zlatos; Andrej,12,0,15,3
1667967213305,MATH 240B,A00,098033,Ni; Lei,10,0,15,5
1667967213730,MATH 243,A00,098034,Jekel; David Andrew,10,0,10,0
1667967214158,MATH 245A,A00,098035,Nie; Jiawang,0,0,15,16
1667967214584,MATH 248,A00,098036,Bejenaru; Ioan,10,0,10,0
1667967215011,MATH 250B,A00,098037,Spolaor; Luca,14,0,15,1
1667967215433,MATH 258,A00,098038,Ni; Lei,10,0,10,0
1667967215856,MATH 264B,A00,098041,Rhoades; Brendon Patrick,12,0,15,3
1667967216288,MATH 268,A00,098042,Buss; Samuel R,10,0,10,0
1667967216726,MATH 269,A00,098043,Rhoades; Brendon Patrick,10,0,10,0
1667967217150,MATH 270B,A00,098044,Li; Bo,11,0,15,4
1667967217582,MATH 272B,A00,098045,Holst; Michael J,13,0,15,2
1667967218009,MATH 273A,A00,098046,Tian; Xiaochuan,12,0,15,3
1667967218438,MATH 275,A01,098048,Tian; Xiaochuan,6,0,10,4
1667967218865,MATH 278A,A00,098049,Holst; Michael J,8,0,10,2
1667967219315,MATH 278B,A00,098050,Cloninger; Alexander,10,0,10,0
1667967219740,MATH 278C,A00,098051,Nie; Jiawang,8,0,10,2
1667967220168,MATH 280B,A00,098052,Zheng; Tianyi,12,0,15,3
1667967220589,MATH 281B,A00,098053,Bradic; Jelena,4,0,15,11
1667967221012,MATH 282B,A00,098054,Arias-Castro; Ery,2,0,15,13
1667967221443,MATH 285,A00,098055,Fitzsimmons; Patrick J,0,0,15,17
1667967221870,MATH 287B,A00,098056,Arias-Castro; Ery,5,0,15,10
1667967222292,MATH 288,A00,098057,Agarwal; Pooja,9,0,10,1
1667967222292,MATH 288,B00,098058,Zhang; Danna,9,0,10,1
1667967222292,MATH 288,C00,098059,Williams; Ruth J,10,0,10,0
1667967222715,MATH 290B,A00,098060,Roberts; Justin Deritter,14,0,15,1
1667967223142,MATH 292,A00,098061,Belmont; Eva Kinoshita,10,0,10,0
1667967223569,MATH 295,A00,098062,Suk; Andrew Hoon,48,0,50,2
1667967224028,MATH 296,A00,098063,Novak; Jonathan I,20,0,20,0
1667967224467,MATH 297,001,098064,Gamst; Anthony Collins,9997,0,9999,2
1667967725991,COGS 205,A00,101395,Chiba; Andrea,19,0,20,1
1667967726418,COGS 210B,001,101404,Greene; Deanna Jacquelyn,9998,0,9999,1
1667967726418,COGS 210B,002,101417,Xia; Haijun,9999,0,9999,0
1667967726418,COGS 210B,003,101422,Nitz; Douglas A.,9999,0,9999,0
1667967726418,COGS 210B,004,101423,Hollan; James D.,9998,0,9999,1
1667967726418,COGS 210B,005,101424,Deak; Gedeon O.,9999,0,9999,0
1667967726418,COGS 210B,006,101425,Rossano; Federico,9999,0,9999,0
1667967726856,COGS 211B,A00,101427,Coulson; Seana M,9997,0,9999,2
1667967727280,COGS 220,A00,101428,Hollan; James D.,0,0,25,25
1667967727705,COGS 229,A00,101429,Dow; Steven P,18,0,25,7
1667967728132,COGS 230,A00,101430,Klemmer; Scott R,13,0,17,4
1667967728565,COGS 234,A00,101431,Xia; Haijun,7,0,25,18
1667967728988,COGS 260,A00,101432,Kiyonaga; Anastasia,20,0,25,5
1667967728988,COGS 260,B00,101433,Kirsh; David Joel,16,0,25,9
1667967729413,CSE 202,A00,102371,Impagliazzo; Russell,0,0,0,0
1667967729837,CSE 203B,A01,102373,Cheng; Chung Kuan,0,0,0,0
1667967730261,CSE 208,A00,102374,Micciancio; Daniele,0,0,0,0
1667967730688,CSE 209A,A00,112895,Impagliazzo; Russell,0,0,15,15
1667967731128,CSE 209B,A00,108005,Bellare; Mihir,0,0,0,0
1667967731556,CSE 210,A00,113163,Coblenz; Michael J,0,0,0,0
1667967731986,CSE 219,A00,106111,Dow; Steven P,0,0,20,20
1667967732411,CSE 221,A00,102376,Voelker; Geoffrey M.,0,0,0,0
1667967732834,CSE 224,A01,102378,Porter; George M,0,0,0,0
1667967733257,CSE 229A,A00,102379,Savage; Stefan,0,0,0,0
1667967733684,CSE 229C,A00,102380,Munyaka; Imani N. S.,0,0,0,0
1667967734120,CSE 232B,A00,102382,Deutsch; Alin Bernard,0,0,0,0
1667967734545,CSE 234,A01,112904,Kumar; Arun Kumar,0,0,0,0
1667967734973,CSE 237A,A00,102383,Rosing; Tajana Simunic,0,0,0,0
1667967735396,CSE 239A,A00,102384,Deutsch; Alin Bernard,0,0,0,0
1667967735832,CSE 239B,A00,102385,Polikarpova; Nadezhda,0,0,0,0
1667967736257,CSE 240A,A00,102386,Pannuto; Patrick William,0,0,0,0
1667967736681,CSE 240B,A00,102387,Zhao; Jishen,0,0,0,0
1667967737106,CSE 241A,A00,106406,Kang; Mingu,0,0,0,0
1667967737542,CSE 249B,A00,102388,Kahng; Andrew Byun,0,0,8,8
1667967737965,CSE 251B,A01,102392,Cottrell; Garrison W,0,0,0,0
1667967737965,CSE 251B,A02,102393,Cottrell; Garrison W,0,0,0,0
1667967738393,CSE 252B,A00,102394,Ochoa; Benjamin Lawrence,0,0,0,0
1667967738821,CSE 257,A01,102396,Gao; Sicun,0,0,0,0
1667967739245,CSE 272,A00,102397,Li; Tzumao,0,0,0,0
1667967739692,CSE 274,A00,111323,Chern; Albert Ren-Haur,0,0,0,0
1667967740117,CSE 282,A00,102398,Pevzner; Pavel Arkadjevich,0,0,0,0
1667967740540,CSE 284,A00,114175,Gymrek; Melissa Ann,0,0,0,0
1667967740970,CSE 290,A00,102399,Chandraker; Manmohan Krishna,0,0,0,0
1667967740970,CSE 290,B00,102400,Vaccaro; Kristen Marie,0,0,25,25
1667967740970,CSE 290,C00,102414,Pannuto; Patrick William,0,0,25,25
1667967740970,CSE 290,D00,102427,Pevzner; Pavel Arkadjevich,0,0,0,0
1667967740970,CSE 290,E00,102429,Zhao; Jishen,0,0,0,0
1667967740970,CSE 290,F00,102436,Tullsen; Dean Michael,0,0,0,0
1667967740970,CSE 290,G00,102440,Christensen; Henrik I,0,0,20,20
1667967741421,CSE 291,A00,102443,Su; Hao,0,0,0,0
1667967741421,CSE 291,B00,102448,Polikarpova; Nadezhda,0,0,0,0
1667967741421,CSE 291,C00,102453,Vaccaro; Kristen Marie,0,0,0,0
1667967741421,CSE 291,D00,111343,Savage; Stefan,0,0,0,0
1667967741421,CSE 291,E00,116474,Claffy; Kimberly Claire,0,0,0,0
1667967741421,CSE 291,F00,116479,Pasquale; Joseph,0,0,0,0
1667967741858,CSE 293,001,119111,Bafna; Vineet,9999,0,9999,0
1667967741858,CSE 293,002,119118,Bellare; Mihir,9999,0,9999,0
1667967741858,CSE 293,003,119122,Berg-Kirkpatrick; Taylor D,9999,0,9999,0
1667967741858,CSE 293,004,119135,Christensen; Henrik I,9999,0,9999,0
1667967741858,CSE 293,005,119142,Cottrell; Garrison W,9999,0,9999,0
1667967741858,CSE 293,006,119146,Deutsch; Alin Bernard,9999,0,9999,0
1667967741858,CSE 293,007,119159,Esmaeilzadeh; Hadi,9999,0,9999,0
1667967741858,CSE 293,008,119166,Freund; Yoav,9999,0,9999,0
1667967741858,CSE 293,009,119170,Griswold; William G.,9999,0,9999,0
1667967741858,CSE 293,010,119183,Gymrek; Melissa Ann,9999,0,9999,0
1667967741858,CSE 293,011,119190,Heninger; Nadia A,9999,0,9999,0
1667967741858,CSE 293,012,119230,Impagliazzo; Russell,9999,0,9999,0
1667967741858,CSE 293,013,119232,Jhala; Ranjit,9999,0,9999,0
1667967741858,CSE 293,014,119233,Kahng; Andrew Byun,9999,0,9999,0
1667967741858,CSE 293,015,119298,Kane; Daniel Mertz,9999,0,9999,0
1667967741858,CSE 293,016,119299,Kriegman; David J,9999,0,9999,0
1667967741858,CSE 293,017,119300,Kumar; Arun Kumar,9999,0,9999,0
1667967741858,CSE 293,018,119301,Lerner; Sorin,9999,0,9999,0
1667967741858,CSE 293,019,119302,Lovett; Shachar,9999,0,9999,0
1667967741858,CSE 293,020,119303,McAuley; Julian John,9999,0,9999,0
1667967741858,CSE 293,021,119304,Micciancio; Daniele,9999,0,9999,0
1667967741858,CSE 293,022,119367,Orailoglu; Alex,9999,0,9999,0
1667967741858,CSE 293,023,119382,Paturi; Ramamohan,9999,0,9999,0
1667967741858,CSE 293,024,119404,Polikarpova; Nadezhda,9999,0,9999,0
1667967741858,CSE 293,025,119406,Politz; Joseph Gibbs,9999,0,9999,0
1667967741858,CSE 293,026,119411,Porter; George M,9999,0,9999,0
1667967741858,CSE 293,027,119414,Porter; Leonard Emerson,9999,0,9999,0
1667967741858,CSE 293,028,119416,Ramamoorthi; Ravi,9999,0,9999,0
1667967741858,CSE 293,029,119417,Sahoo; Debashis,9999,0,9999,0
1667967741858,CSE 293,030,119420,Saul; Lawrence,9999,0,9999,0
1667967741858,CSE 293,031,119421,Savage; Stefan,9999,0,9999,0
1667967741858,CSE 293,032,119425,Schulze; Jurgen P.,9999,0,9999,0
1667967741858,CSE 293,033,119426,Snoeren; Alex C.,9999,0,9999,0
1667967741858,CSE 293,034,119428,Shang; Jingbo,9999,0,9999,0
1667967741858,CSE 293,035,119430,Stefan; Deian,9999,0,9999,0
1667967741858,CSE 293,036,119431,Su; Hao,9999,0,9999,0
1667967741858,CSE 293,037,119433,Swanson; Steven James,9999,0,9999,0
1667967741858,CSE 293,038,119435,Tullsen; Dean Michael,9999,0,9999,0
1667967741858,CSE 293,039,119483,Voelker; Geoffrey M.,9999,0,9999,0
1667967741858,CSE 293,040,119537,Zhao; Jishen,9999,0,9999,0
1667967741858,CSE 293,041,119538,Zhou; Yuan-Yuan,9999,0,9999,0
1667967741858,CSE 293,042,119539,Gao; Sicun,9999,0,9999,0
1667967741858,CSE 293,043,119540,Weibel; Nadir,9999,0,9999,0
1667967741858,CSE 293,044,119541,Gupta; Rajesh K.,9999,0,9999,0
1667967742283,CSE 294,A00,102459,Voelker; Geoffrey M.,0,0,0,0
1667967742283,CSE 294,B00,111322,Orailoglu; Alex,0,0,0,0
1667967742707,DSE 201,A00,096914,Deutsch; Alin Bernard,30,0,30,0
1667967743137,DSE 210,A00,096915,Dasgupta; Sanjoy,30,0,30,0
1667967743566,DSE 260A,A00,096916,Altintas De Callaf; Ilkay,30,0,30,0
1667967743993,ECE 200,001,103586,Antipa; Nicholas A,9999,0,9999,0
1667967743993,ECE 200,002,103587,Atanasov; Nikolay A.,9999,0,9999,0
1667967743993,ECE 200,003,103588,Bharadia; Dinesh,9999,0,9999,0
1667967743993,ECE 200,004,103589,Cheng; Chung Kuan,9999,0,9999,0
1667967743993,ECE 200,005,103590,Cosman; Pamela C.,9999,0,9999,0
1667967743993,ECE 200,006,103591,Dayeh; Shadi Ahmad,9999,0,9999,0
1667967743993,ECE 200,007,103592,Fainman; Yeshaiahu,9999,0,9999,0
1667967743993,ECE 200,008,103593,Ford; Joseph Earl,9999,0,9999,0
1667967743993,ECE 200,009,103594,Franceschetti; Massimo,9999,0,9999,0
1667967743993,ECE 200,010,103595,Fullerton; Eric E,9999,0,9999,0
1667967743993,ECE 200,011,103596,Galton; Ian A,9999,0,9999,0
1667967743993,ECE 200,012,103597,Gilja; Vikash,9999,0,9999,0
1667967743993,ECE 200,013,103598,Hall; Drew A.,9999,0,9999,0
1667967743993,ECE 200,014,103599,Hsueh; Tzu-Chien,9999,0,9999,0
1667967743993,ECE 200,015,103600,Javidi; Tara,9999,0,9999,0
1667967743993,ECE 200,016,103601,Kahng; Andrew Byun,9999,0,9999,0
1667967743993,ECE 200,017,103602,Kim; Young-Han,9999,0,9999,0
1667967743993,ECE 200,018,103603,Koushanfar; Farinaz,9999,0,9999,0
1667967743993,ECE 200,019,103604,Kuzum; Duygu,9999,0,9999,0
1667967743993,ECE 200,020,103605,Le; Hanh-Phuc,9999,0,9999,0
1667967743993,ECE 200,021,103606,Lin; Bill,9999,0,9999,0
1667967743993,ECE 200,022,103607,Liu; Zhaowei,9998,0,9999,1
1667967743993,ECE 200,023,103608,Lo; Yu-Hwa,9999,0,9999,0
1667967743993,ECE 200,024,103609,Lomakin; Vitaliy,9999,0,9999,0
1667967743993,ECE 200,025,103610,Mercier; Patrick Philip,9999,0,9999,0
1667967743993,ECE 200,026,103611,Meyer; Florian,9999,0,9999,0
1667967743993,ECE 200,027,103612,Milstein; Laurence B.,9999,0,9999,0
1667967743993,ECE 200,028,103613,Mir Arabbaygi; Siavash,9999,0,9999,0
1667967743993,ECE 200,029,103614,Mookherjea; Shayan,9999,0,9999,0
1667967743993,ECE 200,030,103615,Morris; Karcher William,9999,0,9999,0
1667967743993,ECE 200,031,103616,Ng; Tse Nga,9999,0,9999,0
1667967743993,ECE 200,032,103617,Nguyen; Truong Quang,9999,0,9999,0
1667967743993,ECE 200,033,103618,Nomura; Kenji,9999,0,9999,0
1667967743993,ECE 200,034,103619,Orlitsky; Alon,9999,0,9999,0
1667967743993,ECE 200,035,103620,Pal; Piya,9999,0,9999,0
1667967743993,ECE 200,036,103621,Papen; George C.,9999,0,9999,0
1667967743993,ECE 200,037,103622,Radic; Stojan,9999,0,9999,0
1667967743993,ECE 200,038,103623,Rao; Bhaskar D.,9999,0,9999,0
1667967743993,ECE 200,039,103624,Rao; Ramesh R,9999,0,9999,0
1667967743993,ECE 200,040,103625,Rebeiz; Gabriel,9999,0,9999,0
1667967743993,ECE 200,041,103626,Sanford; John R,9999,0,9999,0
1667967743993,ECE 200,042,103627,Siegel; Paul H.,9999,0,9999,0
1667967743993,ECE 200,043,103628,Sievenpiper; Daniel F.,9999,0,9999,0
1667967743993,ECE 200,044,103629,Sworder; David D.,9999,0,9999,0
1667967743993,ECE 200,045,103630,Taur; Yuan,9999,0,9999,0
1667967743993,ECE 200,046,103631,Touri; Behrouz,9999,0,9999,0
1667967743993,ECE 200,047,103632,Trivedi; Mohan M.,9999,0,9999,0
1667967743993,ECE 200,048,103633,Vasconcelos; Nuno,9999,0,9999,0
1667967743993,ECE 200,049,103634,Wang; Xiaolong,9999,0,9999,0
1667967743993,ECE 200,050,103635,Xie; Pengtao,9999,0,9999,0
1667967743993,ECE 200,051,103636,Yip; Michael,9999,0,9999,0
1667967743993,ECE 200,052,103637,Zeger; Kenneth A.,999,0,999,0
1667967743993,ECE 200,053,103638,Zhang; Xinyu,9999,0,9999,0
1667967743993,ECE 200,054,103639,Turakhia; Yatish Girish,9999,0,9999,0
1667967743993,ECE 200,055,103640,Kang; Mingu,9999,0,9999,0
1667967743993,ECE 200,056,103641,Shi; Yuanyuan,9999,0,9999,0
1667967743993,ECE 200,057,103642,Wang; Edward Jay,9999,0,9999,0
1667967743993,ECE 200,058,103643,Zheng; Yang,9999,0,9999,0
1667967744418,ECE 202,A00,103644,Kuzum; Duygu,0,0,0,0
1667967744841,ECE 212BN,A00,103646,Ng; Tse Nga,0,0,0,0
1667967745267,ECE 221,A00,111493,Staff,0,0,0,0
1667967745691,ECE 222B,A00,103647,Lomakin; Vitaliy,0,0,0,0
1667967746119,ECE 230B,A00,103648,Taur; Yuan,0,0,0,0
1667967746542,ECE 238B,A00,103649,Garay; Javier,0,0,0,0
1667967746968,ECE 240B,A00,112900,Fainman; Yeshaiahu,0,0,0,0
1667967747393,ECE 247A,A00,103650,Jokerst; Jesse Vincent,0,0,0,0
1667967747815,ECE 247B,A00,103651,Wang; Joseph,0,0,0,0
1667967748242,ECE 250,A00,103652,Siegel; Paul H.,0,0,0,0
1667967748677,ECE 251A,A00,103654,Rao; Bhaskar D.,0,0,0,0
1667967749103,ECE 257B,A00,103655,Bharadia; Dinesh,0,0,0,0
1667967749530,ECE 258A,A00,103656,Milstein; Laurence B.,0,0,0,0
1667967749955,ECE 260B,A00,103658,Kang; Mingu,0,0,0,0
1667967750379,ECE 264A,A00,103659,Galton; Ian A,0,0,0,0
1667967750802,ECE 265A,A00,103661,Gudem; Prasad S.S.,0,0,0,0
1667967751226,ECE 265D,A00,103662,Gudem; Prasad S.S.,0,0,0,0
1667967751653,ECE 268,A00,103663,Koushanfar; Farinaz,0,0,0,0
1667967752083,ECE 269,A01,103665,Pal; Piya,0,0,0,0
1667967752507,ECE 271B,A00,103666,Vasconcelos; Manuela,0,0,0,0
1667967752928,ECE 276A,A00,103667,Atanasov; Nikolay A.,0,0,0,0
1667967753351,ECE 277,A00,103668,An; Cheolhong,0,0,0,0
1667967753773,ECE 279,A00,117947,Hall; Drew A.,0,0,0,0
1667967754729,ECE 283,A00,103670,Hsueh; Tzu-Chien,0,0,0,0
1667967755176,ECE 284,A00,103671,Turakhia; Yatish Girish,0,0,0,0
1667967755598,ECE 285,A00,103672,Zheng; Yang,0,0,0,0
1667967755598,ECE 285,B00,103673,Sworder; David D.,0,0,0,0
1667967756023,ECE 287,A00,103676,Javidi; Tara,0,0,0,0
1667967756448,MATH 200B,A00,098023,Salehi Golsefidy; Alireza,14,0,15,1
1667967756872,MATH 202B,A00,098024,Rhoades; Brendon Patrick,12,0,15,3
1667967757300,MATH 203B,A00,098025,Oprea; Dragos N.,12,0,15,3
1667967757722,MATH 204B,A00,098026,Sorensen; Claus M,14,0,15,1
1667967758145,MATH 208,A00,098027,Izadi; Elham,7,0,10,3
1667967758567,MATH 209,A00,098028,Pollack; Aaron,10,0,10,0
1667967758990,MATH 211A,A00,112919,Rogalski; Daniel,9,0,10,1
1667967759412,MATH 211B,A00,112920,Seward; Brandon M.,9,0,10,1
1667967759837,MATH 218,A00,098029,Li; Bo,10,0,10,0
1667967760263,MATH 220B,A00,098030,Novak; Jonathan I,13,0,15,2
1667967760687,MATH 221A,A00,098031,Ebenfelt; Peter F,13,0,15,2
1667967761115,MATH 231B,A00,098032,Zlatos; Andrej,12,0,15,3
1667967761537,MATH 240B,A00,098033,Ni; Lei,10,0,15,5
1667967761977,MATH 243,A00,098034,Jekel; David Andrew,10,0,10,0
1667967762404,MATH 245A,A00,098035,Nie; Jiawang,0,0,15,16
1667967762919,MATH 248,A00,098036,Bejenaru; Ioan,10,0,10,0
1667967763341,MATH 250B,A00,098037,Spolaor; Luca,14,0,15,1
1667967763778,MATH 258,A00,098038,Ni; Lei,10,0,10,0
1667967764200,MATH 264B,A00,098041,Rhoades; Brendon Patrick,12,0,15,3
1667967764623,MATH 268,A00,098042,Buss; Samuel R,10,0,10,0
1667967765052,MATH 269,A00,098043,Rhoades; Brendon Patrick,10,0,10,0
1667967765477,MATH 270B,A00,098044,Li; Bo,11,0,15,4
1667967765900,MATH 272B,A00,098045,Holst; Michael J,13,0,15,2
1667967766328,MATH 273A,A00,098046,Tian; Xiaochuan,12,0,15,3
1667967766751,MATH 275,A01,098048,Tian; Xiaochuan,6,0,10,4
1667967767176,MATH 278A,A00,098049,Holst; Michael J,8,0,10,2
1667967767612,MATH 278B,A00,098050,Cloninger; Alexander,10,0,10,0
1667967768035,MATH 278C,A00,098051,Nie; Jiawang,8,0,10,2
1667967768462,MATH 280B,A00,098052,Zheng; Tianyi,12,0,15,3
1667967768885,MATH 281B,A00,098053,Bradic; Jelena,4,0,15,11
1667967769310,MATH 282B,A00,098054,Arias-Castro; Ery,2,0,15,13
1667967769745,MATH 285,A00,098055,Fitzsimmons; Patrick J,0,0,15,17
1667967770174,MATH 287B,A00,098056,Arias-Castro; Ery,5,0,15,10
1667967770600,MATH 288,A00,098057,Agarwal; Pooja,9,0,10,1
1667967770600,MATH 288,B00,098058,Zhang; Danna,9,0,10,1
1667967770600,MATH 288,C00,098059,Williams; Ruth J,10,0,10,0
1667967771021,MATH 290B,A00,098060,Roberts; Justin Deritter,14,0,15,1
1667967771447,MATH 292,A00,098061,Belmont; Eva Kinoshita,10,0,10,0
1667967771879,MATH 295,A00,098062,Suk; Andrew Hoon,48,0,50,2
1667967772306,MATH 296,A00,098063,Novak; Jonathan I,20,0,20,0
1667967772730,MATH 297,001,098064,Gamst; Anthony Collins,9997,0,9999,2
1667968274825,COGS 205,A00,101395,Chiba; Andrea,19,0,20,1
1667968275253,COGS 210B,001,101404,Greene; Deanna Jacquelyn,9998,0,9999,1
1667968275253,COGS 210B,002,101417,Xia; Haijun,9999,0,9999,0
1667968275253,COGS 210B,003,101422,Nitz; Douglas A.,9999,0,9999,0
1667968275253,COGS 210B,004,101423,Hollan; James D.,9998,0,9999,1
1667968275253,COGS 210B,005,101424,Deak; Gedeon O.,9999,0,9999,0
1667968275253,COGS 210B,006,101425,Rossano; Federico,9999,0,9999,0
1667968275682,COGS 211B,A00,101427,Coulson; Seana M,9997,0,9999,2
1667968276105,COGS 220,A00,101428,Hollan; James D.,0,0,25,25
1667968276527,COGS 229,A00,101429,Dow; Steven P,18,0,25,7
1667968276956,COGS 230,A00,101430,Klemmer; Scott R,13,0,17,4
1667968277391,COGS 234,A00,101431,Xia; Haijun,7,0,25,18
1667968277820,COGS 260,A00,101432,Kiyonaga; Anastasia,20,0,25,5
1667968277820,COGS 260,B00,101433,Kirsh; David Joel,16,0,25,9
1667968278244,CSE 202,A00,102371,Impagliazzo; Russell,0,0,0,0
1667968278667,CSE 203B,A01,102373,Cheng; Chung Kuan,0,0,0,0
1667968279094,CSE 208,A00,102374,Micciancio; Daniele,0,0,0,0
1667968279519,CSE 209A,A00,112895,Impagliazzo; Russell,0,0,15,15
1667968279943,CSE 209B,A00,108005,Bellare; Mihir,0,0,0,0
1667968280372,CSE 210,A00,113163,Coblenz; Michael J,0,0,0,0
1667968280793,CSE 219,A00,106111,Dow; Steven P,0,0,20,20
1667968281238,CSE 221,A00,102376,Voelker; Geoffrey M.,0,0,0,0
1667968281665,CSE 224,A01,102378,Porter; George M,0,0,0,0
1667968282089,CSE 229A,A00,102379,Savage; Stefan,0,0,0,0
1667968282516,CSE 229C,A00,102380,Munyaka; Imani N. S.,0,0,0,0
1667968282945,CSE 232B,A00,102382,Deutsch; Alin Bernard,0,0,0,0
1667968283374,CSE 234,A01,112904,Kumar; Arun Kumar,0,0,0,0
1667968283801,CSE 237A,A00,102383,Rosing; Tajana Simunic,0,0,0,0
1667968284229,CSE 239A,A00,102384,Deutsch; Alin Bernard,0,0,0,0
1667968284651,CSE 239B,A00,102385,Polikarpova; Nadezhda,0,0,0,0
1667968285174,CSE 240A,A00,102386,Pannuto; Patrick William,0,0,0,0
1667968285598,CSE 240B,A00,102387,Zhao; Jishen,0,0,0,0
1667968286027,CSE 241A,A00,106406,Kang; Mingu,0,0,0,0
1667968286451,CSE 249B,A00,102388,Kahng; Andrew Byun,0,0,8,8
1667968286875,CSE 251B,A01,102392,Cottrell; Garrison W,0,0,0,0
1667968286875,CSE 251B,A02,102393,Cottrell; Garrison W,0,0,0,0
1667968287309,CSE 252B,A00,102394,Ochoa; Benjamin Lawrence,0,0,0,0
1667968287747,CSE 257,A01,102396,Gao; Sicun,0,0,0,0
1667968288170,CSE 272,A00,102397,Li; Tzumao,0,0,0,0
1667968288593,CSE 274,A00,111323,Chern; Albert Ren-Haur,0,0,0,0
1667968289020,CSE 282,A00,102398,Pevzner; Pavel Arkadjevich,0,0,0,0
1667968289450,CSE 284,A00,114175,Gymrek; Melissa Ann,0,0,0,0
1667968289888,CSE 290,A00,102399,Chandraker; Manmohan Krishna,0,0,0,0
1667968289888,CSE 290,B00,102400,Vaccaro; Kristen Marie,0,0,25,25
1667968289888,CSE 290,C00,102414,Pannuto; Patrick William,0,0,25,25
1667968289888,CSE 290,D00,102427,Pevzner; Pavel Arkadjevich,0,0,0,0
1667968289888,CSE 290,E00,102429,Zhao; Jishen,0,0,0,0
1667968289888,CSE 290,F00,102436,Tullsen; Dean Michael,0,0,0,0
1667968289888,CSE 290,G00,102440,Christensen; Henrik I,0,0,20,20
1667968290330,CSE 291,A00,102443,Su; Hao,0,0,0,0
1667968290330,CSE 291,B00,102448,Polikarpova; Nadezhda,0,0,0,0
1667968290330,CSE 291,C00,102453,Vaccaro; Kristen Marie,0,0,0,0
1667968290330,CSE 291,D00,111343,Savage; Stefan,0,0,0,0
1667968290330,CSE 291,E00,116474,Claffy; Kimberly Claire,0,0,0,0
1667968290330,CSE 291,F00,116479,Pasquale; Joseph,0,0,0,0
1667968290756,CSE 293,001,119111,Bafna; Vineet,9999,0,9999,0
1667968290756,CSE 293,002,119118,Bellare; Mihir,9999,0,9999,0
1667968290756,CSE 293,003,119122,Berg-Kirkpatrick; Taylor D,9999,0,9999,0
1667968290756,CSE 293,004,119135,Christensen; Henrik I,9999,0,9999,0
1667968290756,CSE 293,005,119142,Cottrell; Garrison W,9999,0,9999,0
1667968290756,CSE 293,006,119146,Deutsch; Alin Bernard,9999,0,9999,0
1667968290756,CSE 293,007,119159,Esmaeilzadeh; Hadi,9999,0,9999,0
1667968290756,CSE 293,008,119166,Freund; Yoav,9999,0,9999,0
1667968290756,CSE 293,009,119170,Griswold; William G.,9999,0,9999,0
1667968290756,CSE 293,010,119183,Gymrek; Melissa Ann,9999,0,9999,0
1667968290756,CSE 293,011,119190,Heninger; Nadia A,9999,0,9999,0
1667968290756,CSE 293,012,119230,Impagliazzo; Russell,9999,0,9999,0
1667968290756,CSE 293,013,119232,Jhala; Ranjit,9999,0,9999,0
1667968290756,CSE 293,014,119233,Kahng; Andrew Byun,9999,0,9999,0
1667968290756,CSE 293,015,119298,Kane; Daniel Mertz,9999,0,9999,0
1667968290756,CSE 293,016,119299,Kriegman; David J,9999,0,9999,0
1667968290756,CSE 293,017,119300,Kumar; Arun Kumar,9999,0,9999,0
1667968290756,CSE 293,018,119301,Lerner; Sorin,9999,0,9999,0
1667968290756,CSE 293,019,119302,Lovett; Shachar,9999,0,9999,0
1667968290756,CSE 293,020,119303,McAuley; Julian John,9999,0,9999,0
1667968290756,CSE 293,021,119304,Micciancio; Daniele,9999,0,9999,0
1667968290756,CSE 293,022,119367,Orailoglu; Alex,9999,0,9999,0
1667968290756,CSE 293,023,119382,Paturi; Ramamohan,9999,0,9999,0
1667968290756,CSE 293,024,119404,Polikarpova; Nadezhda,9999,0,9999,0
1667968290756,CSE 293,025,119406,Politz; Joseph Gibbs,9999,0,9999,0
1667968290756,CSE 293,026,119411,Porter; George M,9999,0,9999,0
1667968290756,CSE 293,027,119414,Porter; Leonard Emerson,9999,0,9999,0
1667968290756,CSE 293,028,119416,Ramamoorthi; Ravi,9999,0,9999,0
1667968290756,CSE 293,029,119417,Sahoo; Debashis,9999,0,9999,0
1667968290756,CSE 293,030,119420,Saul; Lawrence,9999,0,9999,0
1667968290756,CSE 293,031,119421,Savage; Stefan,9999,0,9999,0
1667968290756,CSE 293,032,119425,Schulze; Jurgen P.,9999,0,9999,0
1667968290756,CSE 293,033,119426,Snoeren; Alex C.,9999,0,9999,0
1667968290756,CSE 293,034,119428,Shang; Jingbo,9999,0,9999,0
1667968290756,CSE 293,035,119430,Stefan; Deian,9999,0,9999,0
1667968290756,CSE 293,036,119431,Su; Hao,9999,0,9999,0
1667968290756,CSE 293,037,119433,Swanson; Steven James,9999,0,9999,0
1667968290756,CSE 293,038,119435,Tullsen; Dean Michael,9999,0,9999,0
1667968290756,CSE 293,039,119483,Voelker; Geoffrey M.,9999,0,9999,0
1667968290756,CSE 293,040,119537,Zhao; Jishen,9999,0,9999,0
1667968290756,CSE 293,041,119538,Zhou; Yuan-Yuan,9999,0,9999,0
1667968290756,CSE 293,042,119539,Gao; Sicun,9999,0,9999,0
1667968290756,CSE 293,043,119540,Weibel; Nadir,9999,0,9999,0
1667968290756,CSE 293,044,119541,Gupta; Rajesh K.,9999,0,9999,0
1667968291179,CSE 294,A00,102459,Voelker; Geoffrey M.,0,0,0,0
1667968291179,CSE 294,B00,111322,Orailoglu; Alex,0,0,0,0
1667968291613,DSE 201,A00,096914,Deutsch; Alin Bernard,30,0,30,0
1667968292046,DSE 210,A00,096915,Dasgupta; Sanjoy,30,0,30,0
1667968292469,DSE 260A,A00,096916,Altintas De Callaf; Ilkay,30,0,30,0
1667968292898,ECE 200,001,103586,Antipa; Nicholas A,9999,0,9999,0
1667968292898,ECE 200,002,103587,Atanasov; Nikolay A.,9999,0,9999,0
1667968292898,ECE 200,003,103588,Bharadia; Dinesh,9999,0,9999,0
1667968292898,ECE 200,004,103589,Cheng; Chung Kuan,9999,0,9999,0
1667968292898,ECE 200,005,103590,Cosman; Pamela C.,9999,0,9999,0
1667968292898,ECE 200,006,103591,Dayeh; Shadi Ahmad,9999,0,9999,0
1667968292898,ECE 200,007,103592,Fainman; Yeshaiahu,9999,0,9999,0
1667968292898,ECE 200,008,103593,Ford; Joseph Earl,9999,0,9999,0
1667968292898,ECE 200,009,103594,Franceschetti; Massimo,9999,0,9999,0
1667968292898,ECE 200,010,103595,Fullerton; Eric E,9999,0,9999,0
1667968292898,ECE 200,011,103596,Galton; Ian A,9999,0,9999,0
1667968292898,ECE 200,012,103597,Gilja; Vikash,9999,0,9999,0
1667968292898,ECE 200,013,103598,Hall; Drew A.,9999,0,9999,0
1667968292898,ECE 200,014,103599,Hsueh; Tzu-Chien,9999,0,9999,0
1667968292898,ECE 200,015,103600,Javidi; Tara,9999,0,9999,0
1667968292898,ECE 200,016,103601,Kahng; Andrew Byun,9999,0,9999,0
1667968292898,ECE 200,017,103602,Kim; Young-Han,9999,0,9999,0
1667968292898,ECE 200,018,103603,Koushanfar; Farinaz,9999,0,9999,0
1667968292898,ECE 200,019,103604,Kuzum; Duygu,9999,0,9999,0
1667968292898,ECE 200,020,103605,Le; Hanh-Phuc,9999,0,9999,0
1667968292898,ECE 200,021,103606,Lin; Bill,9999,0,9999,0
1667968292898,ECE 200,022,103607,Liu; Zhaowei,9998,0,9999,1
1667968292898,ECE 200,023,103608,Lo; Yu-Hwa,9999,0,9999,0
1667968292898,ECE 200,024,103609,Lomakin; Vitaliy,9999,0,9999,0
1667968292898,ECE 200,025,103610,Mercier; Patrick Philip,9999,0,9999,0
1667968292898,ECE 200,026,103611,Meyer; Florian,9999,0,9999,0
1667968292898,ECE 200,027,103612,Milstein; Laurence B.,9999,0,9999,0
1667968292898,ECE 200,028,103613,Mir Arabbaygi; Siavash,9999,0,9999,0
1667968292898,ECE 200,029,103614,Mookherjea; Shayan,9999,0,9999,0
1667968292898,ECE 200,030,103615,Morris; Karcher William,9999,0,9999,0
1667968292898,ECE 200,031,103616,Ng; Tse Nga,9999,0,9999,0
1667968292898,ECE 200,032,103617,Nguyen; Truong Quang,9999,0,9999,0
1667968292898,ECE 200,033,103618,Nomura; Kenji,9999,0,9999,0
1667968292898,ECE 200,034,103619,Orlitsky; Alon,9999,0,9999,0
1667968292898,ECE 200,035,103620,Pal; Piya,9999,0,9999,0
1667968292898,ECE 200,036,103621,Papen; George C.,9999,0,9999,0
1667968292898,ECE 200,037,103622,Radic; Stojan,9999,0,9999,0
1667968292898,ECE 200,038,103623,Rao; Bhaskar D.,9999,0,9999,0
1667968292898,ECE 200,039,103624,Rao; Ramesh R,9999,0,9999,0
1667968292898,ECE 200,040,103625,Rebeiz; Gabriel,9999,0,9999,0
1667968292898,ECE 200,041,103626,Sanford; John R,9999,0,9999,0
1667968292898,ECE 200,042,103627,Siegel; Paul H.,9999,0,9999,0
1667968292898,ECE 200,043,103628,Sievenpiper; Daniel F.,9999,0,9999,0
1667968292898,ECE 200,044,103629,Sworder; David D.,9999,0,9999,0
1667968292898,ECE 200,045,103630,Taur; Yuan,9999,0,9999,0
1667968292898,ECE 200,046,103631,Touri; Behrouz,9999,0,9999,0
1667968292898,ECE 200,047,103632,Trivedi; Mohan M.,9999,0,9999,0
1667968292898,ECE 200,048,103633,Vasconcelos; Nuno,9999,0,9999,0
1667968292898,ECE 200,049,103634,Wang; Xiaolong,9999,0,9999,0
1667968292898,ECE 200,050,103635,Xie; Pengtao,9999,0,9999,0
1667968292898,ECE 200,051,103636,Yip; Michael,9999,0,9999,0
1667968292898,ECE 200,052,103637,Zeger; Kenneth A.,999,0,999,0
1667968292898,ECE 200,053,103638,Zhang; Xinyu,9999,0,9999,0
1667968292898,ECE 200,054,103639,Turakhia; Yatish Girish,9999,0,9999,0
1667968292898,ECE 200,055,103640,Kang; Mingu,9999,0,9999,0
1667968292898,ECE 200,056,103641,Shi; Yuanyuan,9999,0,9999,0
1667968292898,ECE 200,057,103642,Wang; Edward Jay,9999,0,9999,0
1667968292898,ECE 200,058,103643,Zheng; Yang,9999,0,9999,0
1667968293323,ECE 202,A00,103644,Kuzum; Duygu,0,0,0,0
1667968293746,ECE 212BN,A00,103646,Ng; Tse Nga,0,0,0,0
1667968294170,ECE 221,A00,111493,Staff,0,0,0,0
1667968294596,ECE 222B,A00,103647,Lomakin; Vitaliy,0,0,0,0
1667968295020,ECE 230B,A00,103648,Taur; Yuan,0,0,0,0
1667968295446,ECE 238B,A00,103649,Garay; Javier,0,0,0,0
1667968295869,ECE 240B,A00,112900,Fainman; Yeshaiahu,0,0,0,0
1667968296307,ECE 247A,A00,103650,Jokerst; Jesse Vincent,0,0,0,0
1667968296743,ECE 247B,A00,103651,Wang; Joseph,0,0,0,0
1667968297168,ECE 250,A00,103652,Siegel; Paul H.,0,0,0,0
1667968297597,ECE 251A,A00,103654,Rao; Bhaskar D.,0,0,0,0
1667968298019,ECE 257B,A00,103655,Bharadia; Dinesh,0,0,0,0
1667968298452,ECE 258A,A00,103656,Milstein; Laurence B.,0,0,0,0
1667968298881,ECE 260B,A00,103658,Kang; Mingu,0,0,0,0
1667968299303,ECE 264A,A00,103659,Galton; Ian A,0,0,0,0
1667968299733,ECE 265A,A00,103661,Gudem; Prasad S.S.,0,0,0,0
1667968300156,ECE 265D,A00,103662,Gudem; Prasad S.S.,0,0,0,0
1667968300582,ECE 268,A00,103663,Koushanfar; Farinaz,0,0,0,0
1667968301017,ECE 269,A01,103665,Pal; Piya,0,0,0,0
1667968301443,ECE 271B,A00,103666,Vasconcelos; Manuela,0,0,0,0
1667968301868,ECE 276A,A00,103667,Atanasov; Nikolay A.,0,0,0,0
1667968302296,ECE 277,A00,103668,An; Cheolhong,0,0,0,0
1667968302718,ECE 279,A00,117947,Hall; Drew A.,0,0,0,0
1667968303582,ECE 283,A00,103670,Hsueh; Tzu-Chien,0,0,0,0
1667968304027,ECE 284,A00,103671,Turakhia; Yatish Girish,0,0,0,0
1667968304452,ECE 285,A00,103672,Zheng; Yang,0,0,0,0
1667968304452,ECE 285,B00,103673,Sworder; David D.,0,0,0,0
1667968304873,ECE 287,A00,103676,Javidi; Tara,0,0,0,0
1667968305304,MATH 200B,A00,098023,Salehi Golsefidy; Alireza,14,0,15,1
1667968305726,MATH 202B,A00,098024,Rhoades; Brendon Patrick,12,0,15,3
1667968306150,MATH 203B,A00,098025,Oprea; Dragos N.,12,0,15,3
1667968306606,MATH 204B,A00,098026,Sorensen; Claus M,14,0,15,1
1667968307032,MATH 208,A00,098027,Izadi; Elham,7,0,10,3
1667968307456,MATH 209,A00,098028,Pollack; Aaron,10,0,10,0
1667968307879,MATH 211A,A00,112919,Rogalski; Daniel,9,0,10,1
1667968308304,MATH 211B,A00,112920,Seward; Brandon M.,9,0,10,1
1667968308726,MATH 218,A00,098029,Li; Bo,10,0,10,0
1667968309148,MATH 220B,A00,098030,Novak; Jonathan I,13,0,15,2
1667968309572,MATH 221A,A00,098031,Ebenfelt; Peter F,13,0,15,2
1667968309996,MATH 231B,A00,098032,Zlatos; Andrej,12,0,15,3
1667968310426,MATH 240B,A00,098033,Ni; Lei,10,0,15,5
1667968310856,MATH 243,A00,098034,Jekel; David Andrew,10,0,10,0
1667968311282,MATH 245A,A00,098035,Nie; Jiawang,0,0,15,16
1667968311706,MATH 248,A00,098036,Bejenaru; Ioan,10,0,10,0
1667968312141,MATH 250B,A00,098037,Spolaor; Luca,14,0,15,1
1667968312573,MATH 258,A00,098038,Ni; Lei,10,0,10,0
1667968313003,MATH 264B,A00,098041,Rhoades; Brendon Patrick,12,0,15,3
1667968313428,MATH 268,A00,098042,Buss; Samuel R,10,0,10,0
1667968313851,MATH 269,A00,098043,Rhoades; Brendon Patrick,10,0,10,0
1667968314278,MATH 270B,A00,098044,Li; Bo,11,0,15,4
1667968314715,MATH 272B,A00,098045,Holst; Michael J,13,0,15,2
1667968315139,MATH 273A,A00,098046,Tian; Xiaochuan,12,0,15,3
1667968315565,MATH 275,A01,098048,Tian; Xiaochuan,6,0,10,4
1667968315991,MATH 278A,A00,098049,Holst; Michael J,8,0,10,2
1667968316414,MATH 278B,A00,098050,Cloninger; Alexander,10,0,10,0
1667968316841,MATH 278C,A00,098051,Nie; Jiawang,8,0,10,2
1667968317264,MATH 280B,A00,098052,Zheng; Tianyi,12,0,15,3
1667968317687,MATH 281B,A00,098053,Bradic; Jelena,4,0,15,11
1667968318111,MATH 282B,A00,098054,Arias-Castro; Ery,2,0,15,13
1667968318543,MATH 285,A00,098055,Fitzsimmons; Patrick J,0,0,15,17
1667968318968,MATH 287B,A00,098056,Arias-Castro; Ery,5,0,15,10
1667968319394,MATH 288,A00,098057,Agarwal; Pooja,9,0,10,1
1667968319394,MATH 288,B00,098058,Zhang; Danna,9,0,10,1
1667968319394,MATH 288,C00,098059,Williams; Ruth J,10,0,10,0
1667968319818,MATH 290B,A00,098060,Roberts; Justin Deritter,14,0,15,1
1667968320242,MATH 292,A00,098061,Belmont; Eva Kinoshita,10,0,10,0
1667968320675,MATH 295,A00,098062,Suk; Andrew Hoon,48,0,50,2
1667968321102,MATH 296,A00,098063,Novak; Jonathan I,20,0,20,0
1667968321525,MATH 297,001,098064,Gamst; Anthony Collins,9997,0,9999,2
1667968832610,COGS 205,A00,101395,Chiba; Andrea,19,0,20,1
1667968833044,COGS 210B,001,101404,Greene; Deanna Jacquelyn,9998,0,9999,1
1667968833044,COGS 210B,002,101417,Xia; Haijun,9999,0,9999,0
1667968833044,COGS 210B,003,101422,Nitz; Douglas A.,9999,0,9999,0
1667968833044,COGS 210B,004,101423,Hollan; James D.,9998,0,9999,1
1667968833044,COGS 210B,005,101424,Deak; Gedeon O.,9999,0,9999,0
1667968833044,COGS 210B,006,101425,Rossano; Federico,9999,0,9999,0
1667968833475,COGS 211B,A00,101427,Coulson; Seana M,9997,0,9999,2
1667968833901,COGS 220,A00,101428,Hollan; James D.,0,0,25,25
1667968834328,COGS 229,A00,101429,Dow; Steven P,18,0,25,7
1667968834760,COGS 230,A00,101430,Klemmer; Scott R,13,0,17,4
1667968835198,COGS 234,A00,101431,Xia; Haijun,7,0,25,18
1667968835627,COGS 260,A00,101432,Kiyonaga; Anastasia,20,0,25,5
1667968835627,COGS 260,B00,101433,Kirsh; David Joel,16,0,25,9
1667968836052,CSE 202,A00,102371,Impagliazzo; Russell,0,0,0,0
1667968836477,CSE 203B,A01,102373,Cheng; Chung Kuan,0,0,0,0
1667968836902,CSE 208,A00,102374,Micciancio; Daniele,0,0,0,0
1667968837328,CSE 209A,A00,112895,Impagliazzo; Russell,0,0,15,15
1667968837766,CSE 209B,A00,108005,Bellare; Mihir,0,0,0,0
1667968838192,CSE 210,A00,113163,Coblenz; Michael J,0,0,0,0
1667968838615,CSE 219,A00,106111,Dow; Steven P,0,0,20,20
1667968839039,CSE 221,A00,102376,Voelker; Geoffrey M.,0,0,0,0
1667968839461,CSE 224,A01,102378,Porter; George M,0,0,0,0
1667968839884,CSE 229A,A00,102379,Savage; Stefan,0,0,0,0
1667968840307,CSE 229C,A00,102380,Munyaka; Imani N. S.,0,0,0,0
1667968840731,CSE 232B,A00,102382,Deutsch; Alin Bernard,0,0,0,0
1667968841156,CSE 234,A01,112904,Kumar; Arun Kumar,0,0,0,0
1667968841582,CSE 237A,A00,102383,Rosing; Tajana Simunic,0,0,0,0
1667968842004,CSE 239A,A00,102384,Deutsch; Alin Bernard,0,0,0,0
1667968842426,CSE 239B,A00,102385,Polikarpova; Nadezhda,0,0,0,0
1667968842862,CSE 240A,A00,102386,Pannuto; Patrick William,0,0,0,0
1667968843285,CSE 240B,A00,102387,Zhao; Jishen,0,0,0,0
1667968843707,CSE 241A,A00,106406,Kang; Mingu,0,0,0,0
1667968844131,CSE 249B,A00,102388,Kahng; Andrew Byun,0,0,8,8
1667968844557,CSE 251B,A01,102392,Cottrell; Garrison W,0,0,0,0
1667968844557,CSE 251B,A02,102393,Cottrell; Garrison W,0,0,0,0
1667968844982,CSE 252B,A00,102394,Ochoa; Benjamin Lawrence,0,0,0,0
1667968845412,CSE 257,A01,102396,Gao; Sicun,0,0,0,0
1667968845836,CSE 272,A00,102397,Li; Tzumao,0,0,0,0
1667968846258,CSE 274,A00,111323,Chern; Albert Ren-Haur,0,0,0,0
1667968846682,CSE 282,A00,102398,Pevzner; Pavel Arkadjevich,0,0,0,0
1667968847104,CSE 284,A00,114175,Gymrek; Melissa Ann,0,0,0,0
1667968847531,CSE 290,A00,102399,Chandraker; Manmohan Krishna,0,0,0,0
1667968847531,CSE 290,B00,102400,Vaccaro; Kristen Marie,0,0,25,25
1667968847531,CSE 290,C00,102414,Pannuto; Patrick William,0,0,25,25
1667968847531,CSE 290,D00,102427,Pevzner; Pavel Arkadjevich,0,0,0,0
1667968847531,CSE 290,E00,102429,Zhao; Jishen,0,0,0,0
1667968847531,CSE 290,F00,102436,Tullsen; Dean Michael,0,0,0,0
1667968847531,CSE 290,G00,102440,Christensen; Henrik I,0,0,20,20
1667968847958,CSE 291,A00,102443,Su; Hao,0,0,0,0
1667968847958,CSE 291,B00,102448,Polikarpova; Nadezhda,0,0,0,0
1667968847958,CSE 291,C00,102453,Vaccaro; Kristen Marie,0,0,0,0
1667968847958,CSE 291,D00,111343,Savage; Stefan,0,0,0,0
1667968847958,CSE 291,E00,116474,Claffy; Kimberly Claire,0,0,0,0
1667968847958,CSE 291,F00,116479,Pasquale; Joseph,0,0,0,0
1667968848386,CSE 293,001,119111,Bafna; Vineet,9999,0,9999,0
1667968848386,CSE 293,002,119118,Bellare; Mihir,9999,0,9999,0
1667968848386,CSE 293,003,119122,Berg-Kirkpatrick; Taylor D,9999,0,9999,0
1667968848386,CSE 293,004,119135,Christensen; Henrik I,9999,0,9999,0
1667968848386,CSE 293,005,119142,Cottrell; Garrison W,9999,0,9999,0
1667968848386,CSE 293,006,119146,Deutsch; Alin Bernard,9999,0,9999,0
1667968848386,CSE 293,007,119159,Esmaeilzadeh; Hadi,9999,0,9999,0
1667968848386,CSE 293,008,119166,Freund; Yoav,9999,0,9999,0
1667968848386,CSE 293,009,119170,Griswold; William G.,9999,0,9999,0
1667968848386,CSE 293,010,119183,Gymrek; Melissa Ann,9999,0,9999,0
1667968848386,CSE 293,011,119190,Heninger; Nadia A,9999,0,9999,0
1667968848386,CSE 293,012,119230,Impagliazzo; Russell,9999,0,9999,0
1667968848386,CSE 293,013,119232,Jhala; Ranjit,9999,0,9999,0
1667968848386,CSE 293,014,119233,Kahng; Andrew Byun,9999,0,9999,0
1667968848386,CSE 293,015,119298,Kane; Daniel Mertz,9999,0,9999,0
1667968848386,CSE 293,016,119299,Kriegman; David J,9999,0,9999,0
1667968848386,CSE 293,017,119300,Kumar; Arun Kumar,9999,0,9999,0
1667968848386,CSE 293,018,119301,Lerner; Sorin,9999,0,9999,0
1667968848386,CSE 293,019,119302,Lovett; Shachar,9999,0,9999,0
1667968848386,CSE 293,020,119303,McAuley; Julian John,9999,0,9999,0
1667968848386,CSE 293,021,119304,Micciancio; Daniele,9999,0,9999,0
1667968848386,CSE 293,022,119367,Orailoglu; Alex,9999,0,9999,0
1667968848386,CSE 293,023,119382,Paturi; Ramamohan,9999,0,9999,0
1667968848386,CSE 293,024,119404,Polikarpova; Nadezhda,9999,0,9999,0
1667968848386,CSE 293,025,119406,Politz; Joseph Gibbs,9999,0,9999,0
1667968848386,CSE 293,026,119411,Porter; George M,9999,0,9999,0
1667968848386,CSE 293,027,119414,Porter; Leonard Emerson,9999,0,9999,0
1667968848386,CSE 293,028,119416,Ramamoorthi; Ravi,9999,0,9999,0
1667968848386,CSE 293,029,119417,Sahoo; Debashis,9999,0,9999,0
1667968848386,CSE 293,030,119420,Saul; Lawrence,9999,0,9999,0
1667968848386,CSE 293,031,119421,Savage; Stefan,9999,0,9999,0
1667968848386,CSE 293,032,119425,Schulze; Jurgen P.,9999,0,9999,0
1667968848386,CSE 293,033,119426,Snoeren; Alex C.,9999,0,9999,0
1667968848386,CSE 293,034,119428,Shang; Jingbo,9999,0,9999,0
1667968848386,CSE 293,035,119430,Stefan; Deian,9999,0,9999,0
1667968848386,CSE 293,036,119431,Su; Hao,9999,0,9999,0
1667968848386,CSE 293,037,119433,Swanson; Steven James,9999,0,9999,0
1667968848386,CSE 293,038,119435,Tullsen; Dean Michael,9999,0,9999,0
1667968848386,CSE 293,039,119483,Voelker; Geoffrey M.,9999,0,9999,0
1667968848386,CSE 293,040,119537,Zhao; Jishen,9999,0,9999,0
1667968848386,CSE 293,041,119538,Zhou; Yuan-Yuan,9999,0,9999,0
1667968848386,CSE 293,042,119539,Gao; Sicun,9999,0,9999,0
1667968848386,CSE 293,043,119540,Weibel; Nadir,9999,0,9999,0
1667968848386,CSE 293,044,119541,Gupta; Rajesh K.,9999,0,9999,0
1667968848807,CSE 294,A00,102459,Voelker; Geoffrey M.,0,0,0,0
1667968848807,CSE 294,B00,111322,Orailoglu; Alex,0,0,0,0
1667968849230,DSE 201,A00,096914,Deutsch; Alin Bernard,30,0,30,0
1667968849654,DSE 210,A00,096915,Dasgupta; Sanjoy,30,0,30,0
1667968850076,DSE 260A,A00,096916,Altintas De Callaf; Ilkay,30,0,30,0
1667968850504,ECE 200,001,103586,Antipa; Nicholas A,9999,0,9999,0
1667968850504,ECE 200,002,103587,Atanasov; Nikolay A.,9999,0,9999,0
1667968850504,ECE 200,003,103588,Bharadia; Dinesh,9999,0,9999,0
1667968850504,ECE 200,004,103589,Cheng; Chung Kuan,9999,0,9999,0
1667968850504,ECE 200,005,103590,Cosman; Pamela C.,9999,0,9999,0
1667968850504,ECE 200,006,103591,Dayeh; Shadi Ahmad,9999,0,9999,0
1667968850504,ECE 200,007,103592,Fainman; Yeshaiahu,9999,0,9999,0
1667968850504,ECE 200,008,103593,Ford; Joseph Earl,9999,0,9999,0
1667968850504,ECE 200,009,103594,Franceschetti; Massimo,9999,0,9999,0
1667968850504,ECE 200,010,103595,Fullerton; Eric E,9999,0,9999,0
1667968850504,ECE 200,011,103596,Galton; Ian A,9999,0,9999,0
1667968850504,ECE 200,012,103597,Gilja; Vikash,9999,0,9999,0
1667968850504,ECE 200,013,103598,Hall; Drew A.,9999,0,9999,0
1667968850504,ECE 200,014,103599,Hsueh; Tzu-Chien,9999,0,9999,0
1667968850504,ECE 200,015,103600,Javidi; Tara,9999,0,9999,0
1667968850504,ECE 200,016,103601,Kahng; Andrew Byun,9999,0,9999,0
1667968850504,ECE 200,017,103602,Kim; Young-Han,9999,0,9999,0
1667968850504,ECE 200,018,103603,Koushanfar; Farinaz,9999,0,9999,0
1667968850504,ECE 200,019,103604,Kuzum; Duygu,9999,0,9999,0
1667968850504,ECE 200,020,103605,Le; Hanh-Phuc,9999,0,9999,0
1667968850504,ECE 200,021,103606,Lin; Bill,9999,0,9999,0
1667968850504,ECE 200,022,103607,Liu; Zhaowei,9998,0,9999,1
1667968850504,ECE 200,023,103608,Lo; Yu-Hwa,9999,0,9999,0
1667968850504,ECE 200,024,103609,Lomakin; Vitaliy,9999,0,9999,0
1667968850504,ECE 200,025,103610,Mercier; Patrick Philip,9999,0,9999,0
1667968850504,ECE 200,026,103611,Meyer; Florian,9999,0,9999,0
1667968850504,ECE 200,027,103612,Milstein; Laurence B.,9999,0,9999,0
1667968850504,ECE 200,028,103613,Mir Arabbaygi; Siavash,9999,0,9999,0
1667968850504,ECE 200,029,103614,Mookherjea; Shayan,9999,0,9999,0
1667968850504,ECE 200,030,103615,Morris; Karcher William,9999,0,9999,0
1667968850504,ECE 200,031,103616,Ng; Tse Nga,9999,0,9999,0
1667968850504,ECE 200,032,103617,Nguyen; Truong Quang,9999,0,9999,0
1667968850504,ECE 200,033,103618,Nomura; Kenji,9999,0,9999,0
1667968850504,ECE 200,034,103619,Orlitsky; Alon,9999,0,9999,0
1667968850504,ECE 200,035,103620,Pal; Piya,9999,0,9999,0
1667968850504,ECE 200,036,103621,Papen; George C.,9999,0,9999,0
1667968850504,ECE 200,037,103622,Radic; Stojan,9999,0,9999,0
1667968850504,ECE 200,038,103623,Rao; Bhaskar D.,9999,0,9999,0
1667968850504,ECE 200,039,103624,Rao; Ramesh R,9999,0,9999,0
1667968850504,ECE 200,040,103625,Rebeiz; Gabriel,9999,0,9999,0
1667968850504,ECE 200,041,103626,Sanford; John R,9999,0,9999,0
1667968850504,ECE 200,042,103627,Siegel; Paul H.,9999,0,9999,0
1667968850504,ECE 200,043,103628,Sievenpiper; Daniel F.,9999,0,9999,0
1667968850504,ECE 200,044,103629,Sworder; David D.,9999,0,9999,0
1667968850504,ECE 200,045,103630,Taur; Yuan,9999,0,9999,0
1667968850504,ECE 200,046,103631,Touri; Behrouz,9999,0,9999,0
1667968850504,ECE 200,047,103632,Trivedi; Mohan M.,9999,0,9999,0
1667968850504,ECE 200,048,103633,Vasconcelos; Nuno,9999,0,9999,0
1667968850504,ECE 200,049,103634,Wang; Xiaolong,9999,0,9999,0
1667968850504,ECE 200,050,103635,Xie; Pengtao,9999,0,9999,0
1667968850504,ECE 200,051,103636,Yip; Michael,9999,0,9999,0
1667968850504,ECE 200,052,103637,Zeger; Kenneth A.,999,0,999,0
1667968850504,ECE 200,053,103638,Zhang; Xinyu,9999,0,9999,0
1667968850504,ECE 200,054,103639,Turakhia; Yatish Girish,9999,0,9999,0
1667968850504,ECE 200,055,103640,Kang; Mingu,9999,0,9999,0
1667968850504,ECE 200,056,103641,Shi; Yuanyuan,9999,0,9999,0
1667968850504,ECE 200,057,103642,Wang; Edward Jay,9999,0,9999,0
1667968850504,ECE 200,058,103643,Zheng; Yang,9999,0,9999,0
1667968850931,ECE 202,A00,103644,Kuzum; Duygu,0,0,0,0
1667968851360,ECE 212BN,A00,103646,Ng; Tse Nga,0,0,0,0
1667968851785,ECE 221,A00,111493,Staff,0,0,0,0
1667968852206,ECE 222B,A00,103647,Lomakin; Vitaliy,0,0,0,0
1667968852631,ECE 230B,A00,103648,Taur; Yuan,0,0,0,0
1667968853062,ECE 238B,A00,103649,Garay; Javier,0,0,0,0
1667968853487,ECE 240B,A00,112900,Fainman; Yeshaiahu,0,0,0,0
1667968853913,ECE 247A,A00,103650,Jokerst; Jesse Vincent,0,0,0,0
1667968854336,ECE 247B,A00,103651,Wang; Joseph,0,0,0,0
1667968854760,ECE 250,A00,103652,Siegel; Paul H.,0,0,0,0
1667968855196,ECE 251A,A00,103654,Rao; Bhaskar D.,0,0,0,0
1667968855621,ECE 257B,A00,103655,Bharadia; Dinesh,0,0,0,0
1667968856047,ECE 258A,A00,103656,Milstein; Laurence B.,0,0,0,0
1667968856473,ECE 260B,A00,103658,Kang; Mingu,0,0,0,0
1667968856915,ECE 264A,A00,103659,Galton; Ian A,0,0,0,0
1667968857340,ECE 265A,A00,103661,Gudem; Prasad S.S.,0,0,0,0
1667968857767,ECE 265D,A00,103662,Gudem; Prasad S.S.,0,0,0,0
1667968858194,ECE 268,A00,103663,Koushanfar; Farinaz,0,0,0,0
1667968858628,ECE 269,A01,103665,Pal; Piya,0,0,0,0
1667968859059,ECE 271B,A00,103666,Vasconcelos; Manuela,0,0,0,0
1667968859588,ECE 276A,A00,103667,Atanasov; Nikolay A.,0,0,0,0
1667968860019,ECE 277,A00,103668,An; Cheolhong,0,0,0,0
1667968860459,ECE 279,A00,117947,Hall; Drew A.,0,0,0,0
1667968861317,ECE 283,A00,103670,Hsueh; Tzu-Chien,0,0,0,0
1667968861744,ECE 284,A00,103671,Turakhia; Yatish Girish,0,0,0,0
1667968862179,ECE 285,A00,103672,Zheng; Yang,0,0,0,0
1667968862179,ECE 285,B00,103673,Sworder; David D.,0,0,0,0
1667968862610,ECE 287,A00,103676,Javidi; Tara,0,0,0,0
1667968863032,MATH 200B,A00,098023,Salehi Golsefidy; Alireza,14,0,15,1
1667968863459,MATH 202B,A00,098024,Rhoades; Brendon Patrick,12,0,15,3
1667968863886,MATH 203B,A00,098025,Oprea; Dragos N.,12,0,15,3
1667968864308,MATH 204B,A00,098026,Sorensen; Claus M,14,0,15,1
1667968864734,MATH 208,A00,098027,Izadi; Elham,7,0,10,3
1667968865159,MATH 209,A00,098028,Pollack; Aaron,10,0,10,0
1667968865583,MATH 211A,A00,112919,Rogalski; Daniel,9,0,10,1
1667968866006,MATH 211B,A00,112920,Seward; Brandon M.,9,0,10,1
1667968866429,MATH 218,A00,098029,Li; Bo,10,0,10,0
1667968866858,MATH 220B,A00,098030,Novak; Jonathan I,13,0,15,2
1667968867291,MATH 221A,A00,098031,Ebenfelt; Peter F,13,0,15,2
1667968867727,MATH 231B,A00,098032,Zlatos; Andrej,12,0,15,3
1667968868150,MATH 240B,A00,098033,Ni; Lei,10,0,15,5
1667968868575,MATH 243,A00,098034,Jekel; David Andrew,10,0,10,0
1667968869006,MATH 245A,A00,098035,Nie; Jiawang,0,0,15,16
1667968869431,MATH 248,A00,098036,Bejenaru; Ioan,10,0,10,0
1667968869859,MATH 250B,A00,098037,Spolaor; Luca,14,0,15,1
1667968870283,MATH 258,A00,098038,Ni; Lei,10,0,10,0
1667968870710,MATH 264B,A00,098041,Rhoades; Brendon Patrick,12,0,15,3
1667968871133,MATH 268,A00,098042,Buss; Samuel R,10,0,10,0
1667968871556,MATH 269,A00,098043,Rhoades; Brendon Patrick,10,0,10,0
1667968871983,MATH 270B,A00,098044,Li; Bo,11,0,15,4
1667968872408,MATH 272B,A00,098045,Holst; Michael J,13,0,15,2
1667968872835,MATH 273A,A00,098046,Tian; Xiaochuan,12,0,15,3
1667968873258,MATH 275,A01,098048,Tian; Xiaochuan,6,0,10,4
1667968873684,MATH 278A,A00,098049,Holst; Michael J,8,0,10,2
1667968874107,MATH 278B,A00,098050,Cloninger; Alexander,10,0,10,0
1667968874530,MATH 278C,A00,098051,Nie; Jiawang,8,0,10,2
1667968874952,MATH 280B,A00,098052,Zheng; Tianyi,12,0,15,3
1667968875378,MATH 281B,A00,098053,Bradic; Jelena,4,0,15,11
1667968875800,MATH 282B,A00,098054,Arias-Castro; Ery,2,0,15,13
1667968876227,MATH 285,A00,098055,Fitzsimmons; Patrick J,0,0,15,17
1667968876649,MATH 287B,A00,098056,Arias-Castro; Ery,5,0,15,10
1667968877077,MATH 288,A00,098057,Agarwal; Pooja,9,0,10,1
1667968877077,MATH 288,B00,098058,Zhang; Danna,9,0,10,1
1667968877077,MATH 288,C00,098059,Williams; Ruth J,10,0,10,0
1667968877510,MATH 290B,A00,098060,Roberts; Justin Deritter,14,0,15,1
1667968877934,MATH 292,A00,098061,Belmont; Eva Kinoshita,10,0,10,0
1667968878360,MATH 295,A00,098062,Suk; Andrew Hoon,48,0,50,2
1667968878782,MATH 296,A00,098063,Novak; Jonathan I,20,0,20,0
1667968879206,MATH 297,001,098064,Gamst; Anthony Collins,9997,0,9999,2
1667969378791,COGS 205,A00,101395,Chiba; Andrea,19,0,20,1
1667969379315,COGS 210B,001,101404,Greene; Deanna Jacquelyn,9998,0,9999,1
1667969379315,COGS 210B,002,101417,Xia; Haijun,9999,0,9999,0
1667969379315,COGS 210B,003,101422,Nitz; Douglas A.,9999,0,9999,0
1667969379315,COGS 210B,004,101423,Hollan; James D.,9998,0,9999,1
1667969379315,COGS 210B,005,101424,Deak; Gedeon O.,9999,0,9999,0
1667969379315,COGS 210B,006,101425,Rossano; Federico,9999,0,9999,0
1667969379742,COGS 211B,A00,101427,Coulson; Seana M,9997,0,9999,2
1667969380167,COGS 220,A00,101428,Hollan; James D.,0,0,25,25
1667969380592,COGS 229,A00,101429,Dow; Steven P,18,0,25,7
1667969381019,COGS 230,A00,101430,Klemmer; Scott R,13,0,17,4
1667969381443,COGS 234,A00,101431,Xia; Haijun,7,0,25,18
1667969381866,COGS 260,A00,101432,Kiyonaga; Anastasia,20,0,25,5
1667969381866,COGS 260,B00,101433,Kirsh; David Joel,16,0,25,9
1667969382288,CSE 202,A00,102371,Impagliazzo; Russell,0,0,0,0
1667969382710,CSE 203B,A01,102373,Cheng; Chung Kuan,0,0,0,0
1667969383135,CSE 208,A00,102374,Micciancio; Daniele,0,0,0,0
1667969383565,CSE 209A,A00,112895,Impagliazzo; Russell,0,0,15,15
1667969383989,CSE 209B,A00,108005,Bellare; Mihir,0,0,0,0
1667969384414,CSE 210,A00,113163,Coblenz; Michael J,0,0,0,0
1667969384837,CSE 219,A00,106111,Dow; Steven P,0,0,20,20
1667969385267,CSE 221,A00,102376,Voelker; Geoffrey M.,0,0,0,0
1667969385698,CSE 224,A01,102378,Porter; George M,0,0,0,0
1667969386123,CSE 229A,A00,102379,Savage; Stefan,0,0,0,0
1667969386547,CSE 229C,A00,102380,Munyaka; Imani N. S.,0,0,0,0
1667969386973,CSE 232B,A00,102382,Deutsch; Alin Bernard,0,0,0,0
1667969387400,CSE 234,A01,112904,Kumar; Arun Kumar,0,0,0,0
1667969387828,CSE 237A,A00,102383,Rosing; Tajana Simunic,0,0,0,0
1667969388253,CSE 239A,A00,102384,Deutsch; Alin Bernard,0,0,0,0
1667969388679,CSE 239B,A00,102385,Polikarpova; Nadezhda,0,0,0,0
1667969389101,CSE 240A,A00,102386,Pannuto; Patrick William,0,0,0,0
1667969389522,CSE 240B,A00,102387,Zhao; Jishen,0,0,0,0
1667969389948,CSE 241A,A00,106406,Kang; Mingu,0,0,0,0
1667969390371,CSE 249B,A00,102388,Kahng; Andrew Byun,0,0,8,8
1667969390797,CSE 251B,A01,102392,Cottrell; Garrison W,0,0,0,0
1667969390797,CSE 251B,A02,102393,Cottrell; Garrison W,0,0,0,0
1667969391229,CSE 252B,A00,102394,Ochoa; Benjamin Lawrence,0,0,0,0
1667969391656,CSE 257,A01,102396,Gao; Sicun,0,0,0,0
1667969392079,CSE 272,A00,102397,Li; Tzumao,0,0,0,0
1667969392501,CSE 274,A00,111323,Chern; Albert Ren-Haur,0,0,0,0
1667969392925,CSE 282,A00,102398,Pevzner; Pavel Arkadjevich,0,0,0,0
1667969393348,CSE 284,A00,114175,Gymrek; Melissa Ann,0,0,0,0
1667969393773,CSE 290,A00,102399,Chandraker; Manmohan Krishna,0,0,0,0
1667969393773,CSE 290,B00,102400,Vaccaro; Kristen Marie,0,0,25,25
1667969393773,CSE 290,C00,102414,Pannuto; Patrick William,0,0,25,25
1667969393773,CSE 290,D00,102427,Pevzner; Pavel Arkadjevich,0,0,0,0
1667969393773,CSE 290,E00,102429,Zhao; Jishen,0,0,0,0
1667969393773,CSE 290,F00,102436,Tullsen; Dean Michael,0,0,0,0
1667969393773,CSE 290,G00,102440,Christensen; Henrik I,0,0,20,20
1667969394203,CSE 291,A00,102443,Su; Hao,0,0,0,0
1667969394203,CSE 291,B00,102448,Polikarpova; Nadezhda,0,0,0,0
1667969394203,CSE 291,C00,102453,Vaccaro; Kristen Marie,0,0,0,0
1667969394203,CSE 291,D00,111343,Savage; Stefan,0,0,0,0
1667969394203,CSE 291,E00,116474,Claffy; Kimberly Claire,0,0,0,0
1667969394203,CSE 291,F00,116479,Pasquale; Joseph,0,0,0,0
1667969394635,CSE 293,001,119111,Bafna; Vineet,9999,0,9999,0
1667969394635,CSE 293,002,119118,Bellare; Mihir,9999,0,9999,0
1667969394635,CSE 293,003,119122,Berg-Kirkpatrick; Taylor D,9999,0,9999,0
1667969394635,CSE 293,004,119135,Christensen; Henrik I,9999,0,9999,0
1667969394635,CSE 293,005,119142,Cottrell; Garrison W,9999,0,9999,0
1667969394635,CSE 293,006,119146,Deutsch; Alin Bernard,9999,0,9999,0
1667969394635,CSE 293,007,119159,Esmaeilzadeh; Hadi,9999,0,9999,0
1667969394635,CSE 293,008,119166,Freund; Yoav,9999,0,9999,0
1667969394635,CSE 293,009,119170,Griswold; William G.,9999,0,9999,0
1667969394635,CSE 293,010,119183,Gymrek; Melissa Ann,9999,0,9999,0
1667969394635,CSE 293,011,119190,Heninger; Nadia A,9999,0,9999,0
1667969394635,CSE 293,012,119230,Impagliazzo; Russell,9999,0,9999,0
1667969394635,CSE 293,013,119232,Jhala; Ranjit,9999,0,9999,0
1667969394635,CSE 293,014,119233,Kahng; Andrew Byun,9999,0,9999,0
1667969394635,CSE 293,015,119298,Kane; Daniel Mertz,9999,0,9999,0
1667969394635,CSE 293,016,119299,Kriegman; David J,9999,0,9999,0
1667969394635,CSE 293,017,119300,Kumar; Arun Kumar,9999,0,9999,0
1667969394635,CSE 293,018,119301,Lerner; Sorin,9999,0,9999,0
1667969394635,CSE 293,019,119302,Lovett; Shachar,9999,0,9999,0
1667969394635,CSE 293,020,119303,McAuley; Julian John,9999,0,9999,0
1667969394635,CSE 293,021,119304,Micciancio; Daniele,9999,0,9999,0
1667969394635,CSE 293,022,119367,Orailoglu; Alex,9999,0,9999,0
1667969394635,CSE 293,023,119382,Paturi; Ramamohan,9999,0,9999,0
1667969394635,CSE 293,024,119404,Polikarpova; Nadezhda,9999,0,9999,0
1667969394635,CSE 293,025,119406,Politz; Joseph Gibbs,9999,0,9999,0
1667969394635,CSE 293,026,119411,Porter; George M,9999,0,9999,0
1667969394635,CSE 293,027,119414,Porter; Leonard Emerson,9999,0,9999,0
1667969394635,CSE 293,028,119416,Ramamoorthi; Ravi,9999,0,9999,0
1667969394635,CSE 293,029,119417,Sahoo; Debashis,9999,0,9999,0
1667969394635,CSE 293,030,119420,Saul; Lawrence,9999,0,9999,0
1667969394635,CSE 293,031,119421,Savage; Stefan,9999,0,9999,0
1667969394635,CSE 293,032,119425,Schulze; Jurgen P.,9999,0,9999,0
1667969394635,CSE 293,033,119426,Snoeren; Alex C.,9999,0,9999,0
1667969394635,CSE 293,034,119428,Shang; Jingbo,9999,0,9999,0
1667969394635,CSE 293,035,119430,Stefan; Deian,9999,0,9999,0
1667969394635,CSE 293,036,119431,Su; Hao,9999,0,9999,0
1667969394635,CSE 293,037,119433,Swanson; Steven James,9999,0,9999,0
1667969394635,CSE 293,038,119435,Tullsen; Dean Michael,9999,0,9999,0
1667969394635,CSE 293,039,119483,Voelker; Geoffrey M.,9999,0,9999,0
1667969394635,CSE 293,040,119537,Zhao; Jishen,9999,0,9999,0
1667969394635,CSE 293,041,119538,Zhou; Yuan-Yuan,9999,0,9999,0
1667969394635,CSE 293,042,119539,Gao; Sicun,9999,0,9999,0
1667969394635,CSE 293,043,119540,Weibel; Nadir,9999,0,9999,0
1667969394635,CSE 293,044,119541,Gupta; Rajesh K.,9999,0,9999,0
1667969395058,CSE 294,A00,102459,Voelker; Geoffrey M.,0,0,0,0
1667969395058,CSE 294,B00,111322,Orailoglu; Alex,0,0,0,0
1667969395489,DSE 201,A00,096914,Deutsch; Alin Bernard,30,0,30,0
1667969395911,DSE 210,A00,096915,Dasgupta; Sanjoy,30,0,30,0
1667969396334,DSE 260A,A00,096916,Altintas De Callaf; Ilkay,30,0,30,0
1667969396762,ECE 200,001,103586,Antipa; Nicholas A,9999,0,9999,0
1667969396762,ECE 200,002,103587,Atanasov; Nikolay A.,9999,0,9999,0
1667969396762,ECE 200,003,103588,Bharadia; Dinesh,9999,0,9999,0
1667969396762,ECE 200,004,103589,Cheng; Chung Kuan,9999,0,9999,0
1667969396762,ECE 200,005,103590,Cosman; Pamela C.,9999,0,9999,0
1667969396762,ECE 200,006,103591,Dayeh; Shadi Ahmad,9999,0,9999,0
1667969396762,ECE 200,007,103592,Fainman; Yeshaiahu,9999,0,9999,0
1667969396762,ECE 200,008,103593,Ford; Joseph Earl,9999,0,9999,0
1667969396762,ECE 200,009,103594,Franceschetti; Massimo,9999,0,9999,0
1667969396762,ECE 200,010,103595,Fullerton; Eric E,9999,0,9999,0
1667969396762,ECE 200,011,103596,Galton; Ian A,9999,0,9999,0
1667969396762,ECE 200,012,103597,Gilja; Vikash,9999,0,9999,0
1667969396762,ECE 200,013,103598,Hall; Drew A.,9999,0,9999,0
1667969396762,ECE 200,014,103599,Hsueh; Tzu-Chien,9999,0,9999,0
1667969396762,ECE 200,015,103600,Javidi; Tara,9999,0,9999,0
1667969396762,ECE 200,016,103601,Kahng; Andrew Byun,9999,0,9999,0
1667969396762,ECE 200,017,103602,Kim; Young-Han,9999,0,9999,0
1667969396762,ECE 200,018,103603,Koushanfar; Farinaz,9999,0,9999,0
1667969396762,ECE 200,019,103604,Kuzum; Duygu,9999,0,9999,0
1667969396762,ECE 200,020,103605,Le; Hanh-Phuc,9999,0,9999,0
1667969396762,ECE 200,021,103606,Lin; Bill,9999,0,9999,0
1667969396762,ECE 200,022,103607,Liu; Zhaowei,9998,0,9999,1
1667969396762,ECE 200,023,103608,Lo; Yu-Hwa,9999,0,9999,0
1667969396762,ECE 200,024,103609,Lomakin; Vitaliy,9999,0,9999,0
1667969396762,ECE 200,025,103610,Mercier; Patrick Philip,9999,0,9999,0
1667969396762,ECE 200,026,103611,Meyer; Florian,9999,0,9999,0
1667969396762,ECE 200,027,103612,Milstein; Laurence B.,9999,0,9999,0
1667969396762,ECE 200,028,103613,Mir Arabbaygi; Siavash,9999,0,9999,0
1667969396762,ECE 200,029,103614,Mookherjea; Shayan,9999,0,9999,0
1667969396762,ECE 200,030,103615,Morris; Karcher William,9999,0,9999,0
1667969396762,ECE 200,031,103616,Ng; Tse Nga,9999,0,9999,0
1667969396762,ECE 200,032,103617,Nguyen; Truong Quang,9999,0,9999,0
1667969396762,ECE 200,033,103618,Nomura; Kenji,9999,0,9999,0
1667969396762,ECE 200,034,103619,Orlitsky; Alon,9999,0,9999,0
1667969396762,ECE 200,035,103620,Pal; Piya,9999,0,9999,0
1667969396762,ECE 200,036,103621,Papen; George C.,9999,0,9999,0
1667969396762,ECE 200,037,103622,Radic; Stojan,9999,0,9999,0
1667969396762,ECE 200,038,103623,Rao; Bhaskar D.,9999,0,9999,0
1667969396762,ECE 200,039,103624,Rao; Ramesh R,9999,0,9999,0
1667969396762,ECE 200,040,103625,Rebeiz; Gabriel,9999,0,9999,0
1667969396762,ECE 200,041,103626,Sanford; John R,9999,0,9999,0
1667969396762,ECE 200,042,103627,Siegel; Paul H.,9999,0,9999,0
1667969396762,ECE 200,043,103628,Sievenpiper; Daniel F.,9999,0,9999,0
1667969396762,ECE 200,044,103629,Sworder; David D.,9999,0,9999,0
1667969396762,ECE 200,045,103630,Taur; Yuan,9999,0,9999,0
1667969396762,ECE 200,046,103631,Touri; Behrouz,9999,0,9999,0
1667969396762,ECE 200,047,103632,Trivedi; Mohan M.,9999,0,9999,0
1667969396762,ECE 200,048,103633,Vasconcelos; Nuno,9999,0,9999,0
1667969396762,ECE 200,049,103634,Wang; Xiaolong,9999,0,9999,0
1667969396762,ECE 200,050,103635,Xie; Pengtao,9999,0,9999,0
1667969396762,ECE 200,051,103636,Yip; Michael,9999,0,9999,0
1667969396762,ECE 200,052,103637,Zeger; Kenneth A.,999,0,999,0
1667969396762,ECE 200,053,103638,Zhang; Xinyu,9999,0,9999,0
1667969396762,ECE 200,054,103639,Turakhia; Yatish Girish,9999,0,9999,0
1667969396762,ECE 200,055,103640,Kang; Mingu,9999,0,9999,0
1667969396762,ECE 200,056,103641,Shi; Yuanyuan,9999,0,9999,0
1667969396762,ECE 200,057,103642,Wang; Edward Jay,9999,0,9999,0
1667969396762,ECE 200,058,103643,Zheng; Yang,9999,0,9999,0
1667969397185,ECE 202,A00,103644,Kuzum; Duygu,0,0,0,0
1667969397607,ECE 212BN,A00,103646,Ng; Tse Nga,0,0,0,0
1667969398034,ECE 221,A00,111493,Staff,0,0,0,0
1667969398460,ECE 222B,A00,103647,Lomakin; Vitaliy,0,0,0,0
1667969398885,ECE 230B,A00,103648,Taur; Yuan,0,0,0,0
1667969399309,ECE 238B,A00,103649,Garay; Javier,0,0,0,0
1667969399732,ECE 240B,A00,112900,Fainman; Yeshaiahu,0,0,0,0
1667969400966,ECE 247A,A00,103650,Jokerst; Jesse Vincent,0,0,0,0
1667969401390,ECE 247B,A00,103651,Wang; Joseph,0,0,0,0
1667969401818,ECE 250,A00,103652,Siegel; Paul H.,0,0,0,0
1667969402247,ECE 251A,A00,103654,Rao; Bhaskar D.,0,0,0,0
1667969402678,ECE 257B,A00,103655,Bharadia; Dinesh,0,0,0,0
1667969403107,ECE 258A,A00,103656,Milstein; Laurence B.,0,0,0,0
1667969403541,ECE 260B,A00,103658,Kang; Mingu,0,0,0,0
1667969403967,ECE 264A,A00,103659,Galton; Ian A,0,0,0,0
1667969404393,ECE 265A,A00,103661,Gudem; Prasad S.S.,0,0,0,0
1667969404824,ECE 265D,A00,103662,Gudem; Prasad S.S.,0,0,0,0
1667969405252,ECE 268,A00,103663,Koushanfar; Farinaz,0,0,0,0
1667969405678,ECE 269,A01,103665,Pal; Piya,0,0,0,0
1667969406104,ECE 271B,A00,103666,Vasconcelos; Manuela,0,0,0,0
1667969406531,ECE 276A,A00,103667,Atanasov; Nikolay A.,0,0,0,0
1667969406958,ECE 277,A00,103668,An; Cheolhong,0,0,0,0
1667969407386,ECE 279,A00,117947,Hall; Drew A.,0,0,0,0
1667969408236,ECE 283,A00,103670,Hsueh; Tzu-Chien,0,0,0,0
1667969408660,ECE 284,A00,103671,Turakhia; Yatish Girish,0,0,0,0
1667969409083,ECE 285,A00,103672,Zheng; Yang,0,0,0,0
1667969409083,ECE 285,B00,103673,Sworder; David D.,0,0,0,0
1667969409506,ECE 287,A00,103676,Javidi; Tara,0,0,0,0
1667969409928,MATH 200B,A00,098023,Salehi Golsefidy; Alireza,14,0,15,1
1667969410351,MATH 202B,A00,098024,Rhoades; Brendon Patrick,12,0,15,3
1667969410774,MATH 203B,A00,098025,Oprea; Dragos N.,12,0,15,3
1667969411198,MATH 204B,A00,098026,Sorensen; Claus M,14,0,15,1
1667969411621,MATH 208,A00,098027,Izadi; Elham,7,0,10,3
1667969412289,MATH 209,A00,098028,Pollack; Aaron,10,0,10,0
1667969412711,MATH 211A,A00,112919,Rogalski; Daniel,9,0,10,1
1667969413135,MATH 211B,A00,112920,Seward; Brandon M.,9,0,10,1
1667969413560,MATH 218,A00,098029,Li; Bo,10,0,10,0
1667969413987,MATH 220B,A00,098030,Novak; Jonathan I,13,0,15,2
1667969414420,MATH 221A,A00,098031,Ebenfelt; Peter F,13,0,15,2
1667969414852,MATH 231B,A00,098032,Zlatos; Andrej,12,0,15,3
1667969415276,MATH 240B,A00,098033,Ni; Lei,10,0,15,5
1667969415702,MATH 243,A00,098034,Jekel; David Andrew,10,0,10,0
1667969416130,MATH 245A,A00,098035,Nie; Jiawang,0,0,15,16
1667969416559,MATH 248,A00,098036,Bejenaru; Ioan,10,0,10,0
1667969416982,MATH 250B,A00,098037,Spolaor; Luca,14,0,15,1
1667969417403,MATH 258,A00,098038,Ni; Lei,10,0,10,0
1667969417829,MATH 264B,A00,098041,Rhoades; Brendon Patrick,12,0,15,3
1667969418255,MATH 268,A00,098042,Buss; Samuel R,10,0,10,0
1667969418684,MATH 269,A00,098043,Rhoades; Brendon Patrick,10,0,10,0
1667969419108,MATH 270B,A00,098044,Li; Bo,11,0,15,4
1667969419533,MATH 272B,A00,098045,Holst; Michael J,13,0,15,2
1667969419958,MATH 273A,A00,098046,Tian; Xiaochuan,12,0,15,3
1667969420385,MATH 275,A01,098048,Tian; Xiaochuan,6,0,10,4
1667969420810,MATH 278A,A00,098049,Holst; Michael J,8,0,10,2
1667969421248,MATH 278B,A00,098050,Cloninger; Alexander,10,0,10,0
1667969421691,MATH 278C,A00,098051,Nie; Jiawang,8,0,10,2
1667969422115,MATH 280B,A00,098052,Zheng; Tianyi,12,0,15,3
1667969422541,MATH 281B,A00,098053,Bradic; Jelena,4,0,15,11
1667969422965,MATH 282B,A00,098054,Arias-Castro; Ery,2,0,15,13
1667969423469,MATH 285,A00,098055,Fitzsimmons; Patrick J,0,0,15,17
1667969423896,MATH 287B,A00,098056,Arias-Castro; Ery,5,0,15,10
1667969424318,MATH 288,A00,098057,Agarwal; Pooja,9,0,10,1
1667969424318,MATH 288,B00,098058,Zhang; Danna,9,0,10,1
1667969424318,MATH 288,C00,098059,Williams; Ruth J,10,0,10,0
1667969424741,MATH 290B,A00,098060,Roberts; Justin Deritter,14,0,15,1
1667969425169,MATH 292,A00,098061,Belmont; Eva Kinoshita,10,0,10,0
1667969425591,MATH 295,A00,098062,Suk; Andrew Hoon,48,0,50,2
1667969426016,MATH 296,A00,098063,Novak; Jonathan I,20,0,20,0
1667969426444,MATH 297,001,098064,Gamst; Anthony Collins,9997,0,9999,2
1667969926583,COGS 205,A00,101395,Chiba; Andrea,19,0,20,1
1667969927006,COGS 210B,001,101404,Greene; Deanna Jacquelyn,9998,0,9999,1
1667969927006,COGS 210B,002,101417,Xia; Haijun,9999,0,9999,0
1667969927006,COGS 210B,003,101422,Nitz; Douglas A.,9999,0,9999,0
1667969927006,COGS 210B,004,101423,Hollan; James D.,9998,0,9999,1
1667969927006,COGS 210B,005,101424,Deak; Gedeon O.,9999,0,9999,0
1667969927006,COGS 210B,006,101425,Rossano; Federico,9999,0,9999,0
1667969927442,COGS 211B,A00,101427,Coulson; Seana M,9997,0,9999,2
1667969927863,COGS 220,A00,101428,Hollan; James D.,0,0,25,25
1667969928285,COGS 229,A00,101429,Dow; Steven P,18,0,25,7
1667969928706,COGS 230,A00,101430,Klemmer; Scott R,13,0,17,4
1667969929130,COGS 234,A00,101431,Xia; Haijun,7,0,25,18
1667969929555,COGS 260,A00,101432,Kiyonaga; Anastasia,20,0,25,5
1667969929555,COGS 260,B00,101433,Kirsh; David Joel,16,0,25,9
1667969929990,CSE 202,A00,102371,Impagliazzo; Russell,0,0,0,0
1667969930414,CSE 203B,A01,102373,Cheng; Chung Kuan,0,0,0,0
1667969930851,CSE 208,A00,102374,Micciancio; Daniele,0,0,0,0
1667969931280,CSE 209A,A00,112895,Impagliazzo; Russell,0,0,15,15
1667969931704,CSE 209B,A00,108005,Bellare; Mihir,0,0,0,0
1667969932134,CSE 210,A00,113163,Coblenz; Michael J,0,0,0,0
1667969932564,CSE 219,A00,106111,Dow; Steven P,0,0,20,20
1667969932985,CSE 221,A00,102376,Voelker; Geoffrey M.,0,0,0,0
1667969933409,CSE 224,A01,102378,Porter; George M,0,0,0,0
1667969933832,CSE 229A,A00,102379,Savage; Stefan,0,0,0,0
1667969934256,CSE 229C,A00,102380,Munyaka; Imani N. S.,0,0,0,0
1667969934684,CSE 232B,A00,102382,Deutsch; Alin Bernard,0,0,0,0
1667969935115,CSE 234,A01,112904,Kumar; Arun Kumar,0,0,0,0
1667969935538,CSE 237A,A00,102383,Rosing; Tajana Simunic,0,0,0,0
1667969935961,CSE 239A,A00,102384,Deutsch; Alin Bernard,0,0,0,0
1667969936387,CSE 239B,A00,102385,Polikarpova; Nadezhda,0,0,0,0
1667969936814,CSE 240A,A00,102386,Pannuto; Patrick William,0,0,0,0
1667969937237,CSE 240B,A00,102387,Zhao; Jishen,0,0,0,0
1667969937663,CSE 241A,A00,106406,Kang; Mingu,0,0,0,0
1667969938092,CSE 249B,A00,102388,Kahng; Andrew Byun,0,0,8,8
1667969938522,CSE 251B,A01,102392,Cottrell; Garrison W,0,0,0,0
1667969938522,CSE 251B,A02,102393,Cottrell; Garrison W,0,0,0,0
1667969938952,CSE 252B,A00,102394,Ochoa; Benjamin Lawrence,0,0,0,0
1667969939375,CSE 257,A01,102396,Gao; Sicun,0,0,0,0
1667969939797,CSE 272,A00,102397,Li; Tzumao,0,0,0,0
1667969940232,CSE 274,A00,111323,Chern; Albert Ren-Haur,0,0,0,0
1667969940656,CSE 282,A00,102398,Pevzner; Pavel Arkadjevich,0,0,0,0
1667969941083,CSE 284,A00,114175,Gymrek; Melissa Ann,0,0,0,0
1667969941510,CSE 290,A00,102399,Chandraker; Manmohan Krishna,0,0,0,0
1667969941510,CSE 290,B00,102400,Vaccaro; Kristen Marie,0,0,25,25
1667969941510,CSE 290,C00,102414,Pannuto; Patrick William,0,0,25,25
1667969941510,CSE 290,D00,102427,Pevzner; Pavel Arkadjevich,0,0,0,0
1667969941510,CSE 290,E00,102429,Zhao; Jishen,0,0,0,0
1667969941510,CSE 290,F00,102436,Tullsen; Dean Michael,0,0,0,0
1667969941510,CSE 290,G00,102440,Christensen; Henrik I,0,0,20,20
1667969941934,CSE 291,A00,102443,Su; Hao,0,0,0,0
1667969941934,CSE 291,B00,102448,Polikarpova; Nadezhda,0,0,0,0
1667969941934,CSE 291,C00,102453,Vaccaro; Kristen Marie,0,0,0,0
1667969941934,CSE 291,D00,111343,Savage; Stefan,0,0,0,0
1667969941934,CSE 291,E00,116474,Claffy; Kimberly Claire,0,0,0,0
1667969941934,CSE 291,F00,116479,Pasquale; Joseph,0,0,0,0
1667969942361,CSE 293,001,119111,Bafna; Vineet,9999,0,9999,0
1667969942361,CSE 293,002,119118,Bellare; Mihir,9999,0,9999,0
1667969942361,CSE 293,003,119122,Berg-Kirkpatrick; Taylor D,9999,0,9999,0
1667969942361,CSE 293,004,119135,Christensen; Henrik I,9999,0,9999,0
1667969942361,CSE 293,005,119142,Cottrell; Garrison W,9999,0,9999,0
1667969942361,CSE 293,006,119146,Deutsch; Alin Bernard,9999,0,9999,0
1667969942361,CSE 293,007,119159,Esmaeilzadeh; Hadi,9999,0,9999,0
1667969942361,CSE 293,008,119166,Freund; Yoav,9999,0,9999,0
1667969942361,CSE 293,009,119170,Griswold; William G.,9999,0,9999,0
1667969942361,CSE 293,010,119183,Gymrek; Melissa Ann,9999,0,9999,0
1667969942361,CSE 293,011,119190,Heninger; Nadia A,9999,0,9999,0
1667969942361,CSE 293,012,119230,Impagliazzo; Russell,9999,0,9999,0
1667969942361,CSE 293,013,119232,Jhala; Ranjit,9999,0,9999,0
1667969942361,CSE 293,014,119233,Kahng; Andrew Byun,9999,0,9999,0
1667969942361,CSE 293,015,119298,Kane; Daniel Mertz,9999,0,9999,0
1667969942361,CSE 293,016,119299,Kriegman; David J,9999,0,9999,0
1667969942361,CSE 293,017,119300,Kumar; Arun Kumar,9999,0,9999,0
1667969942361,CSE 293,018,119301,Lerner; Sorin,9999,0,9999,0
1667969942361,CSE 293,019,119302,Lovett; Shachar,9999,0,9999,0
1667969942361,CSE 293,020,119303,McAuley; Julian John,9999,0,9999,0
1667969942361,CSE 293,021,119304,Micciancio; Daniele,9999,0,9999,0
1667969942361,CSE 293,022,119367,Orailoglu; Alex,9999,0,9999,0
1667969942361,CSE 293,023,119382,Paturi; Ramamohan,9999,0,9999,0
1667969942361,CSE 293,024,119404,Polikarpova; Nadezhda,9999,0,9999,0
1667969942361,CSE 293,025,119406,Politz; Joseph Gibbs,9999,0,9999,0
1667969942361,CSE 293,026,119411,Porter; George M,9999,0,9999,0
1667969942361,CSE 293,027,119414,Porter; Leonard Emerson,9999,0,9999,0
1667969942361,CSE 293,028,119416,Ramamoorthi; Ravi,9999,0,9999,0
1667969942361,CSE 293,029,119417,Sahoo; Debashis,9999,0,9999,0
1667969942361,CSE 293,030,119420,Saul; Lawrence,9999,0,9999,0
1667969942361,CSE 293,031,119421,Savage; Stefan,9999,0,9999,0
1667969942361,CSE 293,032,119425,Schulze; Jurgen P.,9999,0,9999,0
1667969942361,CSE 293,033,119426,Snoeren; Alex C.,9999,0,9999,0
1667969942361,CSE 293,034,119428,Shang; Jingbo,9999,0,9999,0
1667969942361,CSE 293,035,119430,Stefan; Deian,9999,0,9999,0
1667969942361,CSE 293,036,119431,Su; Hao,9999,0,9999,0
1667969942361,CSE 293,037,119433,Swanson; Steven James,9999,0,9999,0
1667969942361,CSE 293,038,119435,Tullsen; Dean Michael,9999,0,9999,0
1667969942361,CSE 293,039,119483,Voelker; Geoffrey M.,9999,0,9999,0
1667969942361,CSE 293,040,119537,Zhao; Jishen,9999,0,9999,0
1667969942361,CSE 293,041,119538,Zhou; Yuan-Yuan,9999,0,9999,0
1667969942361,CSE 293,042,119539,Gao; Sicun,9999,0,9999,0
1667969942361,CSE 293,043,119540,Weibel; Nadir,9999,0,9999,0
1667969942361,CSE 293,044,119541,Gupta; Rajesh K.,9999,0,9999,0
1667969942782,CSE 294,A00,102459,Voelker; Geoffrey M.,0,0,0,0
1667969942782,CSE 294,B00,111322,Orailoglu; Alex,0,0,0,0
1667969943210,DSE 201,A00,096914,Deutsch; Alin Bernard,30,0,30,0
1667969943753,DSE 210,A00,096915,Dasgupta; Sanjoy,30,0,30,0
1667969944180,DSE 260A,A00,096916,Altintas De Callaf; Ilkay,30,0,30,0
1667969944633,ECE 200,001,103586,Antipa; Nicholas A,9999,0,9999,0
1667969944633,ECE 200,002,103587,Atanasov; Nikolay A.,9999,0,9999,0
1667969944633,ECE 200,003,103588,Bharadia; Dinesh,9999,0,9999,0
1667969944633,ECE 200,004,103589,Cheng; Chung Kuan,9999,0,9999,0
1667969944633,ECE 200,005,103590,Cosman; Pamela C.,9999,0,9999,0
1667969944633,ECE 200,006,103591,Dayeh; Shadi Ahmad,9999,0,9999,0
1667969944633,ECE 200,007,103592,Fainman; Yeshaiahu,9999,0,9999,0
1667969944633,ECE 200,008,103593,Ford; Joseph Earl,9999,0,9999,0
1667969944633,ECE 200,009,103594,Franceschetti; Massimo,9999,0,9999,0
1667969944633,ECE 200,010,103595,Fullerton; Eric E,9999,0,9999,0
1667969944633,ECE 200,011,103596,Galton; Ian A,9999,0,9999,0
1667969944633,ECE 200,012,103597,Gilja; Vikash,9999,0,9999,0
1667969944633,ECE 200,013,103598,Hall; Drew A.,9999,0,9999,0
1667969944633,ECE 200,014,103599,Hsueh; Tzu-Chien,9999,0,9999,0
1667969944633,ECE 200,015,103600,Javidi; Tara,9999,0,9999,0
1667969944633,ECE 200,016,103601,Kahng; Andrew Byun,9999,0,9999,0
1667969944633,ECE 200,017,103602,Kim; Young-Han,9999,0,9999,0
1667969944633,ECE 200,018,103603,Koushanfar; Farinaz,9999,0,9999,0
1667969944633,ECE 200,019,103604,Kuzum; Duygu,9999,0,9999,0
1667969944633,ECE 200,020,103605,Le; Hanh-Phuc,9999,0,9999,0
1667969944633,ECE 200,021,103606,Lin; Bill,9999,0,9999,0
1667969944633,ECE 200,022,103607,Liu; Zhaowei,9998,0,9999,1
1667969944633,ECE 200,023,103608,Lo; Yu-Hwa,9999,0,9999,0
1667969944633,ECE 200,024,103609,Lomakin; Vitaliy,9999,0,9999,0
1667969944633,ECE 200,025,103610,Mercier; Patrick Philip,9999,0,9999,0
1667969944633,ECE 200,026,103611,Meyer; Florian,9999,0,9999,0
1667969944633,ECE 200,027,103612,Milstein; Laurence B.,9999,0,9999,0
1667969944633,ECE 200,028,103613,Mir Arabbaygi; Siavash,9999,0,9999,0
1667969944633,ECE 200,029,103614,Mookherjea; Shayan,9999,0,9999,0
1667969944633,ECE 200,030,103615,Morris; Karcher William,9999,0,9999,0
1667969944633,ECE 200,031,103616,Ng; Tse Nga,9999,0,9999,0
1667969944633,ECE 200,032,103617,Nguyen; Truong Quang,9999,0,9999,0
1667969944633,ECE 200,033,103618,Nomura; Kenji,9999,0,9999,0
1667969944633,ECE 200,034,103619,Orlitsky; Alon,9999,0,9999,0
1667969944633,ECE 200,035,103620,Pal; Piya,9999,0,9999,0
1667969944633,ECE 200,036,103621,Papen; George C.,9999,0,9999,0
1667969944633,ECE 200,037,103622,Radic; Stojan,9999,0,9999,0
1667969944633,ECE 200,038,103623,Rao; Bhaskar D.,9999,0,9999,0
1667969944633,ECE 200,039,103624,Rao; Ramesh R,9999,0,9999,0
1667969944633,ECE 200,040,103625,Rebeiz; Gabriel,9999,0,9999,0
1667969944633,ECE 200,041,103626,Sanford; John R,9999,0,9999,0
1667969944633,ECE 200,042,103627,Siegel; Paul H.,9999,0,9999,0
1667969944633,ECE 200,043,103628,Sievenpiper; Daniel F.,9999,0,9999,0
1667969944633,ECE 200,044,103629,Sworder; David D.,9999,0,9999,0
1667969944633,ECE 200,045,103630,Taur; Yuan,9999,0,9999,0
1667969944633,ECE 200,046,103631,Touri; Behrouz,9999,0,9999,0
1667969944633,ECE 200,047,103632,Trivedi; Mohan M.,9999,0,9999,0
1667969944633,ECE 200,048,103633,Vasconcelos; Nuno,9999,0,9999,0
1667969944633,ECE 200,049,103634,Wang; Xiaolong,9999,0,9999,0
1667969944633,ECE 200,050,103635,Xie; Pengtao,9999,0,9999,0
1667969944633,ECE 200,051,103636,Yip; Michael,9999,0,9999,0
1667969944633,ECE 200,052,103637,Zeger; Kenneth A.,999,0,999,0
1667969944633,ECE 200,053,103638,Zhang; Xinyu,9999,0,9999,0
1667969944633,ECE 200,054,103639,Turakhia; Yatish Girish,9999,0,9999,0
1667969944633,ECE 200,055,103640,Kang; Mingu,9999,0,9999,0
1667969944633,ECE 200,056,103641,Shi; Yuanyuan,9999,0,9999,0
1667969944633,ECE 200,057,103642,Wang; Edward Jay,9999,0,9999,0
1667969944633,ECE 200,058,103643,Zheng; Yang,9999,0,9999,0
1667969945060,ECE 202,A00,103644,Kuzum; Duygu,0,0,0,0
1667969945482,ECE 212BN,A00,103646,Ng; Tse Nga,0,0,0,0
1667969945906,ECE 221,A00,111493,Staff,0,0,0,0
1667969946333,ECE 222B,A00,103647,Lomakin; Vitaliy,0,0,0,0
1667969946765,ECE 230B,A00,103648,Taur; Yuan,0,0,0,0
1667969947192,ECE 238B,A00,103649,Garay; Javier,0,0,0,0
1667969947616,ECE 240B,A00,112900,Fainman; Yeshaiahu,0,0,0,0
1667969948040,ECE 247A,A00,103650,Jokerst; Jesse Vincent,0,0,0,0
1667969948463,ECE 247B,A00,103651,Wang; Joseph,0,0,0,0
1667969948891,ECE 250,A00,103652,Siegel; Paul H.,0,0,0,0
1667969949318,ECE 251A,A00,103654,Rao; Bhaskar D.,0,0,0,0
1667969949743,ECE 257B,A00,103655,Bharadia; Dinesh,0,0,0,0
1667969950167,ECE 258A,A00,103656,Milstein; Laurence B.,0,0,0,0
1667969950590,ECE 260B,A00,103658,Kang; Mingu,0,0,0,0
1667969951014,ECE 264A,A00,103659,Galton; Ian A,0,0,0,0
1667969951438,ECE 265A,A00,103661,Gudem; Prasad S.S.,0,0,0,0
1667969951862,ECE 265D,A00,103662,Gudem; Prasad S.S.,0,0,0,0
1667969952287,ECE 268,A00,103663,Koushanfar; Farinaz,0,0,0,0
1667969952723,ECE 269,A01,103665,Pal; Piya,0,0,0,0
1667969953145,ECE 271B,A00,103666,Vasconcelos; Manuela,0,0,0,0
1667969953571,ECE 276A,A00,103667,Atanasov; Nikolay A.,0,0,0,0
1667969953995,ECE 277,A00,103668,An; Cheolhong,0,0,0,0
1667969954421,ECE 279,A00,117947,Hall; Drew A.,0,0,0,0
1667969955277,ECE 283,A00,103670,Hsueh; Tzu-Chien,0,0,0,0
1667969955704,ECE 284,A00,103671,Turakhia; Yatish Girish,0,0,0,0
1667969956130,ECE 285,A00,103672,Zheng; Yang,0,0,0,0
1667969956130,ECE 285,B00,103673,Sworder; David D.,0,0,0,0
1667969956556,ECE 287,A00,103676,Javidi; Tara,0,0,0,0
1667969956982,MATH 200B,A00,098023,Salehi Golsefidy; Alireza,14,0,15,1
1667969957415,MATH 202B,A00,098024,Rhoades; Brendon Patrick,12,0,15,3
1667969957841,MATH 203B,A00,098025,Oprea; Dragos N.,12,0,15,3
1667969958277,MATH 204B,A00,098026,Sorensen; Claus M,14,0,15,1
1667969958699,MATH 208,A00,098027,Izadi; Elham,7,0,10,3
1667969959122,MATH 209,A00,098028,Pollack; Aaron,10,0,10,0
1667969959552,MATH 211A,A00,112919,Rogalski; Daniel,9,0,10,1
1667969959978,MATH 211B,A00,112920,Seward; Brandon M.,9,0,10,1
1667969960401,MATH 218,A00,098029,Li; Bo,10,0,10,0
1667969960827,MATH 220B,A00,098030,Novak; Jonathan I,13,0,15,2
1667969961253,MATH 221A,A00,098031,Ebenfelt; Peter F,13,0,15,2
1667969961694,MATH 231B,A00,098032,Zlatos; Andrej,12,0,15,3
1667969962116,MATH 240B,A00,098033,Ni; Lei,10,0,15,5
1667969962542,MATH 243,A00,098034,Jekel; David Andrew,10,0,10,0
1667969962963,MATH 245A,A00,098035,Nie; Jiawang,0,0,15,16
1667969963405,MATH 248,A00,098036,Bejenaru; Ioan,10,0,10,0
1667969963827,MATH 250B,A00,098037,Spolaor; Luca,14,0,15,1
1667969964260,MATH 258,A00,098038,Ni; Lei,10,0,10,0
1667969964690,MATH 264B,A00,098041,Rhoades; Brendon Patrick,12,0,15,3
1667969965112,MATH 268,A00,098042,Buss; Samuel R,10,0,10,0
1667969965537,MATH 269,A00,098043,Rhoades; Brendon Patrick,10,0,10,0
1667969965960,MATH 270B,A00,098044,Li; Bo,11,0,15,4
1667969966383,MATH 272B,A00,098045,Holst; Michael J,13,0,15,2
1667969966807,MATH 273A,A00,098046,Tian; Xiaochuan,12,0,15,3
1667969967234,MATH 275,A01,098048,Tian; Xiaochuan,6,0,10,4
1667969967655,MATH 278A,A00,098049,Holst; Michael J,8,0,10,2
1667969968089,MATH 278B,A00,098050,Cloninger; Alexander,10,0,10,0
1667969968514,MATH 278C,A00,098051,Nie; Jiawang,8,0,10,2
1667969968937,MATH 280B,A00,098052,Zheng; Tianyi,11,0,15,4
1667969969361,MATH 281B,A00,098053,Bradic; Jelena,4,0,15,11
1667969969786,MATH 282B,A00,098054,Arias-Castro; Ery,2,0,15,13
1667969970211,MATH 285,A00,098055,Fitzsimmons; Patrick J,0,0,15,17
1667969970632,MATH 287B,A00,098056,Arias-Castro; Ery,5,0,15,10
1667969971057,MATH 288,A00,098057,Agarwal; Pooja,9,0,10,1
1667969971057,MATH 288,B00,098058,Zhang; Danna,9,0,10,1
1667969971057,MATH 288,C00,098059,Williams; Ruth J,10,0,10,0
1667969971481,MATH 290B,A00,098060,Roberts; Justin Deritter,14,0,15,1
1667969971906,MATH 292,A00,098061,Belmont; Eva Kinoshita,10,0,10,0
1667969972327,MATH 295,A00,098062,Suk; Andrew Hoon,48,0,50,2
1667969972750,MATH 296,A00,098063,Novak; Jonathan I,20,0,20,0
1667969973174,MATH 297,001,098064,Gamst; Anthony Collins,9997,0,9999,2
1667970474373,COGS 205,A00,101395,Chiba; Andrea,19,0,20,1
1667970474795,COGS 210B,001,101404,Greene; Deanna Jacquelyn,9998,0,9999,1
1667970474795,COGS 210B,002,101417,Xia; Haijun,9999,0,9999,0
1667970474795,COGS 210B,003,101422,Nitz; Douglas A.,9999,0,9999,0
1667970474795,COGS 210B,004,101423,Hollan; James D.,9998,0,9999,1
1667970474795,COGS 210B,005,101424,Deak; Gedeon O.,9999,0,9999,0
1667970474795,COGS 210B,006,101425,Rossano; Federico,9999,0,9999,0
1667970475223,COGS 211B,A00,101427,Coulson; Seana M,9997,0,9999,2
1667970475648,COGS 220,A00,101428,Hollan; James D.,0,0,25,25
1667970476072,COGS 229,A00,101429,Dow; Steven P,18,0,25,7
1667970476499,COGS 230,A00,101430,Klemmer; Scott R,13,0,17,4
1667970476923,COGS 234,A00,101431,Xia; Haijun,7,0,25,18
1667970477353,COGS 260,A00,101432,Kiyonaga; Anastasia,20,0,25,5
1667970477353,COGS 260,B00,101433,Kirsh; David Joel,16,0,25,9
1667970477787,CSE 202,A00,102371,Impagliazzo; Russell,0,0,0,0
1667970478221,CSE 203B,A01,102373,Cheng; Chung Kuan,0,0,0,0
1667970478651,CSE 208,A00,102374,Micciancio; Daniele,0,0,0,0
1667970479074,CSE 209A,A00,112895,Impagliazzo; Russell,0,0,15,15
1667970479498,CSE 209B,A00,108005,Bellare; Mihir,0,0,0,0
1667970479930,CSE 210,A00,113163,Coblenz; Michael J,0,0,0,0
1667970480353,CSE 219,A00,106111,Dow; Steven P,0,0,20,20
1667970480775,CSE 221,A00,102376,Voelker; Geoffrey M.,0,0,0,0
1667970481197,CSE 224,A01,102378,Porter; George M,0,0,0,0
1667970481627,CSE 229A,A00,102379,Savage; Stefan,0,0,0,0
1667970482054,CSE 229C,A00,102380,Munyaka; Imani N. S.,0,0,0,0
1667970482483,CSE 232B,A00,102382,Deutsch; Alin Bernard,0,0,0,0
1667970482909,CSE 234,A01,112904,Kumar; Arun Kumar,0,0,0,0
1667970483334,CSE 237A,A00,102383,Rosing; Tajana Simunic,0,0,0,0
1667970483760,CSE 239A,A00,102384,Deutsch; Alin Bernard,0,0,0,0
1667970484183,CSE 239B,A00,102385,Polikarpova; Nadezhda,0,0,0,0
1667970484607,CSE 240A,A00,102386,Pannuto; Patrick William,0,0,0,0
1667970485031,CSE 240B,A00,102387,Zhao; Jishen,0,0,0,0
1667970485458,CSE 241A,A00,106406,Kang; Mingu,0,0,0,0
1667970485884,CSE 249B,A00,102388,Kahng; Andrew Byun,0,0,8,8
1667970486309,CSE 251B,A01,102392,Cottrell; Garrison W,0,0,0,0
1667970486309,CSE 251B,A02,102393,Cottrell; Garrison W,0,0,0,0
1667970486731,CSE 252B,A00,102394,Ochoa; Benjamin Lawrence,0,0,0,0
1667970487155,CSE 257,A01,102396,Gao; Sicun,0,0,0,0
1667970487581,CSE 272,A00,102397,Li; Tzumao,0,0,0,0
1667970488004,CSE 274,A00,111323,Chern; Albert Ren-Haur,0,0,0,0
1667970488427,CSE 282,A00,102398,Pevzner; Pavel Arkadjevich,0,0,0,0
1667970488854,CSE 284,A00,114175,Gymrek; Melissa Ann,0,0,0,0
1667970489277,CSE 290,A00,102399,Chandraker; Manmohan Krishna,0,0,0,0
1667970489277,CSE 290,B00,102400,Vaccaro; Kristen Marie,0,0,25,25
1667970489277,CSE 290,C00,102414,Pannuto; Patrick William,0,0,25,25
1667970489277,CSE 290,D00,102427,Pevzner; Pavel Arkadjevich,0,0,0,0
1667970489277,CSE 290,E00,102429,Zhao; Jishen,0,0,0,0
1667970489277,CSE 290,F00,102436,Tullsen; Dean Michael,0,0,0,0
1667970489277,CSE 290,G00,102440,Christensen; Henrik I,0,0,20,20
1667970489726,CSE 291,A00,102443,Su; Hao,0,0,0,0
1667970489726,CSE 291,B00,102448,Polikarpova; Nadezhda,0,0,0,0
1667970489726,CSE 291,C00,102453,Vaccaro; Kristen Marie,0,0,0,0
1667970489726,CSE 291,D00,111343,Savage; Stefan,0,0,0,0
1667970489726,CSE 291,E00,116474,Claffy; Kimberly Claire,0,0,0,0
1667970489726,CSE 291,F00,116479,Pasquale; Joseph,0,0,0,0
1667970490197,CSE 293,001,119111,Bafna; Vineet,9999,0,9999,0
1667970490197,CSE 293,002,119118,Bellare; Mihir,9999,0,9999,0
1667970490197,CSE 293,003,119122,Berg-Kirkpatrick; Taylor D,9999,0,9999,0
1667970490197,CSE 293,004,119135,Christensen; Henrik I,9999,0,9999,0
1667970490197,CSE 293,005,119142,Cottrell; Garrison W,9999,0,9999,0
1667970490197,CSE 293,006,119146,Deutsch; Alin Bernard,9999,0,9999,0
1667970490197,CSE 293,007,119159,Esmaeilzadeh; Hadi,9999,0,9999,0
1667970490197,CSE 293,008,119166,Freund; Yoav,9999,0,9999,0
1667970490197,CSE 293,009,119170,Griswold; William G.,9999,0,9999,0
1667970490197,CSE 293,010,119183,Gymrek; Melissa Ann,9999,0,9999,0
1667970490197,CSE 293,011,119190,Heninger; Nadia A,9999,0,9999,0
1667970490197,CSE 293,012,119230,Impagliazzo; Russell,9999,0,9999,0
1667970490197,CSE 293,013,119232,Jhala; Ranjit,9999,0,9999,0
1667970490197,CSE 293,014,119233,Kahng; Andrew Byun,9999,0,9999,0
1667970490197,CSE 293,015,119298,Kane; Daniel Mertz,9999,0,9999,0
1667970490197,CSE 293,016,119299,Kriegman; David J,9999,0,9999,0
1667970490197,CSE 293,017,119300,Kumar; Arun Kumar,9999,0,9999,0
1667970490197,CSE 293,018,119301,Lerner; Sorin,9999,0,9999,0
1667970490197,CSE 293,019,119302,Lovett; Shachar,9999,0,9999,0
1667970490197,CSE 293,020,119303,McAuley; Julian John,9999,0,9999,0
1667970490197,CSE 293,021,119304,Micciancio; Daniele,9999,0,9999,0
1667970490197,CSE 293,022,119367,Orailoglu; Alex,9999,0,9999,0
1667970490197,CSE 293,023,119382,Paturi; Ramamohan,9999,0,9999,0
1667970490197,CSE 293,024,119404,Polikarpova; Nadezhda,9999,0,9999,0
1667970490197,CSE 293,025,119406,Politz; Joseph Gibbs,9999,0,9999,0
1667970490197,CSE 293,026,119411,Porter; George M,9999,0,9999,0
1667970490197,CSE 293,027,119414,Porter; Leonard Emerson,9999,0,9999,0
1667970490197,CSE 293,028,119416,Ramamoorthi; Ravi,9999,0,9999,0
1667970490197,CSE 293,029,119417,Sahoo; Debashis,9999,0,9999,0
1667970490197,CSE 293,030,119420,Saul; Lawrence,9999,0,9999,0
1667970490197,CSE 293,031,119421,Savage; Stefan,9999,0,9999,0
1667970490197,CSE 293,032,119425,Schulze; Jurgen P.,9999,0,9999,0
1667970490197,CSE 293,033,119426,Snoeren; Alex C.,9999,0,9999,0
1667970490197,CSE 293,034,119428,Shang; Jingbo,9999,0,9999,0
1667970490197,CSE 293,035,119430,Stefan; Deian,9999,0,9999,0
1667970490197,CSE 293,036,119431,Su; Hao,9999,0,9999,0
1667970490197,CSE 293,037,119433,Swanson; Steven James,9999,0,9999,0
1667970490197,CSE 293,038,119435,Tullsen; Dean Michael,9999,0,9999,0
1667970490197,CSE 293,039,119483,Voelker; Geoffrey M.,9999,0,9999,0
1667970490197,CSE 293,040,119537,Zhao; Jishen,9999,0,9999,0
1667970490197,CSE 293,041,119538,Zhou; Yuan-Yuan,9999,0,9999,0
1667970490197,CSE 293,042,119539,Gao; Sicun,9999,0,9999,0
1667970490197,CSE 293,043,119540,Weibel; Nadir,9999,0,9999,0
1667970490197,CSE 293,044,119541,Gupta; Rajesh K.,9999,0,9999,0
1667970490624,CSE 294,A00,102459,Voelker; Geoffrey M.,0,0,0,0
1667970490624,CSE 294,B00,111322,Orailoglu; Alex,0,0,0,0
1667970491050,DSE 201,A00,096914,Deutsch; Alin Bernard,30,0,30,0
1667970491480,DSE 210,A00,096915,Dasgupta; Sanjoy,30,0,30,0
1667970491903,DSE 260A,A00,096916,Altintas De Callaf; Ilkay,30,0,30,0
1667970492341,ECE 200,001,103586,Antipa; Nicholas A,9999,0,9999,0
1667970492341,ECE 200,002,103587,Atanasov; Nikolay A.,9999,0,9999,0
1667970492341,ECE 200,003,103588,Bharadia; Dinesh,9999,0,9999,0
1667970492341,ECE 200,004,103589,Cheng; Chung Kuan,9999,0,9999,0
1667970492341,ECE 200,005,103590,Cosman; Pamela C.,9999,0,9999,0
1667970492341,ECE 200,006,103591,Dayeh; Shadi Ahmad,9999,0,9999,0
1667970492341,ECE 200,007,103592,Fainman; Yeshaiahu,9999,0,9999,0
1667970492341,ECE 200,008,103593,Ford; Joseph Earl,9999,0,9999,0
1667970492341,ECE 200,009,103594,Franceschetti; Massimo,9999,0,9999,0
1667970492341,ECE 200,010,103595,Fullerton; Eric E,9999,0,9999,0
1667970492341,ECE 200,011,103596,Galton; Ian A,9999,0,9999,0
1667970492341,ECE 200,012,103597,Gilja; Vikash,9999,0,9999,0
1667970492341,ECE 200,013,103598,Hall; Drew A.,9999,0,9999,0
1667970492341,ECE 200,014,103599,Hsueh; Tzu-Chien,9999,0,9999,0
1667970492341,ECE 200,015,103600,Javidi; Tara,9999,0,9999,0
1667970492341,ECE 200,016,103601,Kahng; Andrew Byun,9999,0,9999,0
1667970492341,ECE 200,017,103602,Kim; Young-Han,9999,0,9999,0
1667970492341,ECE 200,018,103603,Koushanfar; Farinaz,9999,0,9999,0
1667970492341,ECE 200,019,103604,Kuzum; Duygu,9999,0,9999,0
1667970492341,ECE 200,020,103605,Le; Hanh-Phuc,9999,0,9999,0
1667970492341,ECE 200,021,103606,Lin; Bill,9999,0,9999,0
1667970492341,ECE 200,022,103607,Liu; Zhaowei,9998,0,9999,1
1667970492341,ECE 200,023,103608,Lo; Yu-Hwa,9999,0,9999,0
1667970492341,ECE 200,024,103609,Lomakin; Vitaliy,9999,0,9999,0
1667970492341,ECE 200,025,103610,Mercier; Patrick Philip,9999,0,9999,0
1667970492341,ECE 200,026,103611,Meyer; Florian,9999,0,9999,0
1667970492341,ECE 200,027,103612,Milstein; Laurence B.,9999,0,9999,0
1667970492341,ECE 200,028,103613,Mir Arabbaygi; Siavash,9999,0,9999,0
1667970492341,ECE 200,029,103614,Mookherjea; Shayan,9999,0,9999,0
1667970492341,ECE 200,030,103615,Morris; Karcher William,9999,0,9999,0
1667970492341,ECE 200,031,103616,Ng; Tse Nga,9999,0,9999,0
1667970492341,ECE 200,032,103617,Nguyen; Truong Quang,9999,0,9999,0
1667970492341,ECE 200,033,103618,Nomura; Kenji,9999,0,9999,0
1667970492341,ECE 200,034,103619,Orlitsky; Alon,9999,0,9999,0
1667970492341,ECE 200,035,103620,Pal; Piya,9999,0,9999,0
1667970492341,ECE 200,036,103621,Papen; George C.,9999,0,9999,0
1667970492341,ECE 200,037,103622,Radic; Stojan,9999,0,9999,0
1667970492341,ECE 200,038,103623,Rao; Bhaskar D.,9999,0,9999,0
1667970492341,ECE 200,039,103624,Rao; Ramesh R,9999,0,9999,0
1667970492341,ECE 200,040,103625,Rebeiz; Gabriel,9999,0,9999,0
1667970492341,ECE 200,041,103626,Sanford; John R,9999,0,9999,0
1667970492341,ECE 200,042,103627,Siegel; Paul H.,9999,0,9999,0
1667970492341,ECE 200,043,103628,Sievenpiper; Daniel F.,9999,0,9999,0
1667970492341,ECE 200,044,103629,Sworder; David D.,9999,0,9999,0
1667970492341,ECE 200,045,103630,Taur; Yuan,9999,0,9999,0
1667970492341,ECE 200,046,103631,Touri; Behrouz,9999,0,9999,0
1667970492341,ECE 200,047,103632,Trivedi; Mohan M.,9999,0,9999,0
1667970492341,ECE 200,048,103633,Vasconcelos; Nuno,9999,0,9999,0
1667970492341,ECE 200,049,103634,Wang; Xiaolong,9999,0,9999,0
1667970492341,ECE 200,050,103635,Xie; Pengtao,9999,0,9999,0
1667970492341,ECE 200,051,103636,Yip; Michael,9999,0,9999,0
1667970492341,ECE 200,052,103637,Zeger; Kenneth A.,999,0,999,0
1667970492341,ECE 200,053,103638,Zhang; Xinyu,9999,0,9999,0
1667970492341,ECE 200,054,103639,Turakhia; Yatish Girish,9999,0,9999,0
1667970492341,ECE 200,055,103640,Kang; Mingu,9999,0,9999,0
1667970492341,ECE 200,056,103641,Shi; Yuanyuan,9999,0,9999,0
1667970492341,ECE 200,057,103642,Wang; Edward Jay,9999,0,9999,0
1667970492341,ECE 200,058,103643,Zheng; Yang,9999,0,9999,0
1667970492764,ECE 202,A00,103644,Kuzum; Duygu,0,0,0,0
1667970493187,ECE 212BN,A00,103646,Ng; Tse Nga,0,0,0,0
1667970493612,ECE 221,A00,111493,Staff,0,0,0,0
1667970494034,ECE 222B,A00,103647,Lomakin; Vitaliy,0,0,0,0
1667970494460,ECE 230B,A00,103648,Taur; Yuan,0,0,0,0
1667970494893,ECE 238B,A00,103649,Garay; Javier,0,0,0,0
1667970495324,ECE 240B,A00,112900,Fainman; Yeshaiahu,0,0,0,0
1667970495749,ECE 247A,A00,103650,Jokerst; Jesse Vincent,0,0,0,0
1667970496172,ECE 247B,A00,103651,Wang; Joseph,0,0,0,0
1667970496599,ECE 250,A00,103652,Siegel; Paul H.,0,0,0,0
1667970497023,ECE 251A,A00,103654,Rao; Bhaskar D.,0,0,0,0
1667970497445,ECE 257B,A00,103655,Bharadia; Dinesh,0,0,0,0
1667970497881,ECE 258A,A00,103656,Milstein; Laurence B.,0,0,0,0
1667970498304,ECE 260B,A00,103658,Kang; Mingu,0,0,0,0
1667970498727,ECE 264A,A00,103659,Galton; Ian A,0,0,0,0
1667970499153,ECE 265A,A00,103661,Gudem; Prasad S.S.,0,0,0,0
1667970499581,ECE 265D,A00,103662,Gudem; Prasad S.S.,0,0,0,0
1667970500003,ECE 268,A00,103663,Koushanfar; Farinaz,0,0,0,0
1667970500427,ECE 269,A01,103665,Pal; Piya,0,0,0,0
1667970500862,ECE 271B,A00,103666,Vasconcelos; Manuela,0,0,0,0
1667970501287,ECE 276A,A00,103667,Atanasov; Nikolay A.,0,0,0,0
1667970501710,ECE 277,A00,103668,An; Cheolhong,0,0,0,0
1667970502136,ECE 279,A00,117947,Hall; Drew A.,0,0,0,0
1667970502982,ECE 283,A00,103670,Hsueh; Tzu-Chien,0,0,0,0
1667970503405,ECE 284,A00,103671,Turakhia; Yatish Girish,0,0,0,0
1667970503831,ECE 285,A00,103672,Zheng; Yang,0,0,0,0
1667970503831,ECE 285,B00,103673,Sworder; David D.,0,0,0,0
1667970504257,ECE 287,A00,103676,Javidi; Tara,0,0,0,0
1667970504686,MATH 200B,A00,098023,Salehi Golsefidy; Alireza,14,0,15,1
1667970505112,MATH 202B,A00,098024,Rhoades; Brendon Patrick,12,0,15,3
1667970505542,MATH 203B,A00,098025,Oprea; Dragos N.,12,0,15,3
1667970505966,MATH 204B,A00,098026,Sorensen; Claus M,14,0,15,1
1667970506391,MATH 208,A00,098027,Izadi; Elham,7,0,10,3
1667970506818,MATH 209,A00,098028,Pollack; Aaron,10,0,10,0
1667970507239,MATH 211A,A00,112919,Rogalski; Daniel,9,0,10,1
1667970507667,MATH 211B,A00,112920,Seward; Brandon M.,9,0,10,1
1667970508167,MATH 218,A00,098029,Li; Bo,10,0,10,0
1667970508591,MATH 220B,A00,098030,Novak; Jonathan I,13,0,15,2
1667970509014,MATH 221A,A00,098031,Ebenfelt; Peter F,13,0,15,2
1667970509440,MATH 231B,A00,098032,Zlatos; Andrej,12,0,15,3
1667970509864,MATH 240B,A00,098033,Ni; Lei,10,0,15,5
1667970510286,MATH 243,A00,098034,Jekel; David Andrew,10,0,10,0
1667970510711,MATH 245A,A00,098035,Nie; Jiawang,0,0,15,16
1667970511141,MATH 248,A00,098036,Bejenaru; Ioan,10,0,10,0
1667970511564,MATH 250B,A00,098037,Spolaor; Luca,14,0,15,1
1667970511987,MATH 258,A00,098038,Ni; Lei,10,0,10,0
1667970512408,MATH 264B,A00,098041,Rhoades; Brendon Patrick,12,0,15,3
1667970512834,MATH 268,A00,098042,Buss; Samuel R,10,0,10,0
1667970513259,MATH 269,A00,098043,Rhoades; Brendon Patrick,10,0,10,0
1667970513689,MATH 270B,A00,098044,Li; Bo,11,0,15,4
1667970514112,MATH 272B,A00,098045,Holst; Michael J,13,0,15,2
1667970514537,MATH 273A,A00,098046,Tian; Xiaochuan,12,0,15,3
1667970514959,MATH 275,A01,098048,Tian; Xiaochuan,6,0,10,4
1667970515386,MATH 278A,A00,098049,Holst; Michael J,8,0,10,2
1667970515809,MATH 278B,A00,098050,Cloninger; Alexander,10,0,10,0
1667970516232,MATH 278C,A00,098051,Nie; Jiawang,8,0,10,2
1667970516658,MATH 280B,A00,098052,Zheng; Tianyi,11,0,15,4
1667970517085,MATH 281B,A00,098053,Bradic; Jelena,4,0,15,11
1667970517509,MATH 282B,A00,098054,Arias-Castro; Ery,2,0,15,13
1667970517931,MATH 285,A00,098055,Fitzsimmons; Patrick J,0,0,15,17
1667970518370,MATH 287B,A00,098056,Arias-Castro; Ery,5,0,15,10
1667970518796,MATH 288,A00,098057,Agarwal; Pooja,9,0,10,1
1667970518796,MATH 288,B00,098058,Zhang; Danna,9,0,10,1
1667970518796,MATH 288,C00,098059,Williams; Ruth J,10,0,10,0
1667970519221,MATH 290B,A00,098060,Roberts; Justin Deritter,14,0,15,1
1667970519645,MATH 292,A00,098061,Belmont; Eva Kinoshita,10,0,10,0
1667970520071,MATH 295,A00,098062,Suk; Andrew Hoon,48,0,50,2
1667970520493,MATH 296,A00,098063,Novak; Jonathan I,20,0,20,0
1667970520915,MATH 297,001,098064,Gamst; Anthony Collins,9997,0,9999,2
1667971021208,COGS 205,A00,101395,Chiba; Andrea,19,0,20,1
1667971021637,COGS 210B,001,101404,Greene; Deanna Jacquelyn,9998,0,9999,1
1667971021637,COGS 210B,002,101417,Xia; Haijun,9999,0,9999,0
1667971021637,COGS 210B,003,101422,Nitz; Douglas A.,9999,0,9999,0
1667971021637,COGS 210B,004,101423,Hollan; James D.,9998,0,9999,1
1667971021637,COGS 210B,005,101424,Deak; Gedeon O.,9999,0,9999,0
1667971021637,COGS 210B,006,101425,Rossano; Federico,9999,0,9999,0
1667971022064,COGS 211B,A00,101427,Coulson; Seana M,9997,0,9999,2
1667971022501,COGS 220,A00,101428,Hollan; James D.,0,0,25,25
1667971022923,COGS 229,A00,101429,Dow; Steven P,18,0,25,7
1667971023360,COGS 230,A00,101430,Klemmer; Scott R,13,0,17,4
1667971023785,COGS 234,A00,101431,Xia; Haijun,7,0,25,18
1667971024209,COGS 260,A00,101432,Kiyonaga; Anastasia,20,0,25,5
1667971024209,COGS 260,B00,101433,Kirsh; David Joel,16,0,25,9
1667971024631,CSE 202,A00,102371,Impagliazzo; Russell,0,0,0,0
1667971025056,CSE 203B,A01,102373,Cheng; Chung Kuan,0,0,0,0
1667971025486,CSE 208,A00,102374,Micciancio; Daniele,0,0,0,0
1667971025913,CSE 209A,A00,112895,Impagliazzo; Russell,0,0,15,15
1667971026336,CSE 209B,A00,108005,Bellare; Mihir,0,0,0,0
1667971026756,CSE 210,A00,113163,Coblenz; Michael J,0,0,0,0
1667971027190,CSE 219,A00,106111,Dow; Steven P,0,0,20,20
1667971027636,CSE 221,A00,102376,Voelker; Geoffrey M.,0,0,0,0
1667971028061,CSE 224,A01,102378,Porter; George M,0,0,0,0
1667971028566,CSE 229A,A00,102379,Savage; Stefan,0,0,0,0
1667971028989,CSE 229C,A00,102380,Munyaka; Imani N. S.,0,0,0,0
1667971029411,CSE 232B,A00,102382,Deutsch; Alin Bernard,0,0,0,0
1667971029840,CSE 234,A01,112904,Kumar; Arun Kumar,0,0,0,0
1667971030265,CSE 237A,A00,102383,Rosing; Tajana Simunic,0,0,0,0
1667971030689,CSE 239A,A00,102384,Deutsch; Alin Bernard,0,0,0,0
1667971031118,CSE 239B,A00,102385,Polikarpova; Nadezhda,0,0,0,0
1667971031545,CSE 240A,A00,102386,Pannuto; Patrick William,0,0,0,0
1667971031976,CSE 240B,A00,102387,Zhao; Jishen,0,0,0,0
1667971032398,CSE 241A,A00,106406,Kang; Mingu,0,0,0,0
1667971032822,CSE 249B,A00,102388,Kahng; Andrew Byun,0,0,8,8
1667971033245,CSE 251B,A01,102392,Cottrell; Garrison W,0,0,0,0
1667971033245,CSE 251B,A02,102393,Cottrell; Garrison W,0,0,0,0
1667971033668,CSE 252B,A00,102394,Ochoa; Benjamin Lawrence,0,0,0,0
1667971034099,CSE 257,A01,102396,Gao; Sicun,0,0,0,0
1667971034523,CSE 272,A00,102397,Li; Tzumao,0,0,0,0
1667971034946,CSE 274,A00,111323,Chern; Albert Ren-Haur,0,0,0,0
1667971035367,CSE 282,A00,102398,Pevzner; Pavel Arkadjevich,0,0,0,0
1667971035793,CSE 284,A00,114175,Gymrek; Melissa Ann,0,0,0,0
1667971036218,CSE 290,A00,102399,Chandraker; Manmohan Krishna,0,0,0,0
1667971036218,CSE 290,B00,102400,Vaccaro; Kristen Marie,0,0,25,25
1667971036218,CSE 290,C00,102414,Pannuto; Patrick William,0,0,25,25
1667971036218,CSE 290,D00,102427,Pevzner; Pavel Arkadjevich,0,0,0,0
1667971036218,CSE 290,E00,102429,Zhao; Jishen,0,0,0,0
1667971036218,CSE 290,F00,102436,Tullsen; Dean Michael,0,0,0,0
1667971036218,CSE 290,G00,102440,Christensen; Henrik I,0,0,20,20
1667971036642,CSE 291,A00,102443,Su; Hao,0,0,0,0
1667971036642,CSE 291,B00,102448,Polikarpova; Nadezhda,0,0,0,0
1667971036642,CSE 291,C00,102453,Vaccaro; Kristen Marie,0,0,0,0
1667971036642,CSE 291,D00,111343,Savage; Stefan,0,0,0,0
1667971036642,CSE 291,E00,116474,Claffy; Kimberly Claire,0,0,0,0
1667971036642,CSE 291,F00,116479,Pasquale; Joseph,0,0,0,0
1667971037079,CSE 293,001,119111,Bafna; Vineet,9999,0,9999,0
1667971037079,CSE 293,002,119118,Bellare; Mihir,9999,0,9999,0
1667971037079,CSE 293,003,119122,Berg-Kirkpatrick; Taylor D,9999,0,9999,0
1667971037079,CSE 293,004,119135,Christensen; Henrik I,9999,0,9999,0
1667971037079,CSE 293,005,119142,Cottrell; Garrison W,9999,0,9999,0
1667971037079,CSE 293,006,119146,Deutsch; Alin Bernard,9999,0,9999,0
1667971037079,CSE 293,007,119159,Esmaeilzadeh; Hadi,9999,0,9999,0
1667971037079,CSE 293,008,119166,Freund; Yoav,9999,0,9999,0
1667971037079,CSE 293,009,119170,Griswold; William G.,9999,0,9999,0
1667971037079,CSE 293,010,119183,Gymrek; Melissa Ann,9999,0,9999,0
1667971037079,CSE 293,011,119190,Heninger; Nadia A,9999,0,9999,0
1667971037079,CSE 293,012,119230,Impagliazzo; Russell,9999,0,9999,0
1667971037079,CSE 293,013,119232,Jhala; Ranjit,9999,0,9999,0
1667971037079,CSE 293,014,119233,Kahng; Andrew Byun,9999,0,9999,0
1667971037079,CSE 293,015,119298,Kane; Daniel Mertz,9999,0,9999,0
1667971037079,CSE 293,016,119299,Kriegman; David J,9999,0,9999,0
1667971037079,CSE 293,017,119300,Kumar; Arun Kumar,9999,0,9999,0
1667971037079,CSE 293,018,119301,Lerner; Sorin,9999,0,9999,0
1667971037079,CSE 293,019,119302,Lovett; Shachar,9999,0,9999,0
1667971037079,CSE 293,020,119303,McAuley; Julian John,9999,0,9999,0
1667971037079,CSE 293,021,119304,Micciancio; Daniele,9999,0,9999,0
1667971037079,CSE 293,022,119367,Orailoglu; Alex,9999,0,9999,0
1667971037079,CSE 293,023,119382,Paturi; Ramamohan,9999,0,9999,0
1667971037079,CSE 293,024,119404,Polikarpova; Nadezhda,9999,0,9999,0
1667971037079,CSE 293,025,119406,Politz; Joseph Gibbs,9999,0,9999,0
1667971037079,CSE 293,026,119411,Porter; George M,9999,0,9999,0
1667971037079,CSE 293,027,119414,Porter; Leonard Emerson,9999,0,9999,0
1667971037079,CSE 293,028,119416,Ramamoorthi; Ravi,9999,0,9999,0
1667971037079,CSE 293,029,119417,Sahoo; Debashis,9999,0,9999,0
1667971037079,CSE 293,030,119420,Saul; Lawrence,9999,0,9999,0
1667971037079,CSE 293,031,119421,Savage; Stefan,9999,0,9999,0
1667971037079,CSE 293,032,119425,Schulze; Jurgen P.,9999,0,9999,0
1667971037079,CSE 293,033,119426,Snoeren; Alex C.,9999,0,9999,0
1667971037079,CSE 293,034,119428,Shang; Jingbo,9999,0,9999,0
1667971037079,CSE 293,035,119430,Stefan; Deian,9999,0,9999,0
1667971037079,CSE 293,036,119431,Su; Hao,9999,0,9999,0
1667971037079,CSE 293,037,119433,Swanson; Steven James,9999,0,9999,0
1667971037079,CSE 293,038,119435,Tullsen; Dean Michael,9999,0,9999,0
1667971037079,CSE 293,039,119483,Voelker; Geoffrey M.,9999,0,9999,0
1667971037079,CSE 293,040,119537,Zhao; Jishen,9999,0,9999,0
1667971037079,CSE 293,041,119538,Zhou; Yuan-Yuan,9999,0,9999,0
1667971037079,CSE 293,042,119539,Gao; Sicun,9999,0,9999,0
1667971037079,CSE 293,043,119540,Weibel; Nadir,9999,0,9999,0
1667971037079,CSE 293,044,119541,Gupta; Rajesh K.,9999,0,9999,0
1667971037505,CSE 294,A00,102459,Voelker; Geoffrey M.,0,0,0,0
1667971037505,CSE 294,B00,111322,Orailoglu; Alex,0,0,0,0
1667971037928,DSE 201,A00,096914,Deutsch; Alin Bernard,30,0,30,0
1667971038354,DSE 210,A00,096915,Dasgupta; Sanjoy,30,0,30,0
1667971038791,DSE 260A,A00,096916,Altintas De Callaf; Ilkay,30,0,30,0
1667971039360,ECE 200,001,103586,Antipa; Nicholas A,9999,0,9999,0
1667971039360,ECE 200,002,103587,Atanasov; Nikolay A.,9999,0,9999,0
1667971039360,ECE 200,003,103588,Bharadia; Dinesh,9999,0,9999,0
1667971039360,ECE 200,004,103589,Cheng; Chung Kuan,9999,0,9999,0
1667971039360,ECE 200,005,103590,Cosman; Pamela C.,9999,0,9999,0
1667971039360,ECE 200,006,103591,Dayeh; Shadi Ahmad,9999,0,9999,0
1667971039360,ECE 200,007,103592,Fainman; Yeshaiahu,9999,0,9999,0
1667971039360,ECE 200,008,103593,Ford; Joseph Earl,9999,0,9999,0
1667971039360,ECE 200,009,103594,Franceschetti; Massimo,9999,0,9999,0
1667971039360,ECE 200,010,103595,Fullerton; Eric E,9999,0,9999,0
1667971039360,ECE 200,011,103596,Galton; Ian A,9999,0,9999,0
1667971039360,ECE 200,012,103597,Gilja; Vikash,9999,0,9999,0
1667971039360,ECE 200,013,103598,Hall; Drew A.,9999,0,9999,0
1667971039360,ECE 200,014,103599,Hsueh; Tzu-Chien,9999,0,9999,0
1667971039360,ECE 200,015,103600,Javidi; Tara,9999,0,9999,0
1667971039360,ECE 200,016,103601,Kahng; Andrew Byun,9999,0,9999,0
1667971039360,ECE 200,017,103602,Kim; Young-Han,9999,0,9999,0
1667971039360,ECE 200,018,103603,Koushanfar; Farinaz,9999,0,9999,0
1667971039360,ECE 200,019,103604,Kuzum; Duygu,9999,0,9999,0
1667971039360,ECE 200,020,103605,Le; Hanh-Phuc,9999,0,9999,0
1667971039360,ECE 200,021,103606,Lin; Bill,9999,0,9999,0
1667971039360,ECE 200,022,103607,Liu; Zhaowei,9998,0,9999,1
1667971039360,ECE 200,023,103608,Lo; Yu-Hwa,9999,0,9999,0
1667971039360,ECE 200,024,103609,Lomakin; Vitaliy,9999,0,9999,0
1667971039360,ECE 200,025,103610,Mercier; Patrick Philip,9999,0,9999,0
1667971039360,ECE 200,026,103611,Meyer; Florian,9999,0,9999,0
1667971039360,ECE 200,027,103612,Milstein; Laurence B.,9999,0,9999,0
1667971039360,ECE 200,028,103613,Mir Arabbaygi; Siavash,9999,0,9999,0
1667971039360,ECE 200,029,103614,Mookherjea; Shayan,9999,0,9999,0
1667971039360,ECE 200,030,103615,Morris; Karcher William,9999,0,9999,0
1667971039360,ECE 200,031,103616,Ng; Tse Nga,9999,0,9999,0
1667971039360,ECE 200,032,103617,Nguyen; Truong Quang,9999,0,9999,0
1667971039360,ECE 200,033,103618,Nomura; Kenji,9999,0,9999,0
1667971039360,ECE 200,034,103619,Orlitsky; Alon,9999,0,9999,0
1667971039360,ECE 200,035,103620,Pal; Piya,9999,0,9999,0
1667971039360,ECE 200,036,103621,Papen; George C.,9999,0,9999,0
1667971039360,ECE 200,037,103622,Radic; Stojan,9999,0,9999,0
1667971039360,ECE 200,038,103623,Rao; Bhaskar D.,9999,0,9999,0
1667971039360,ECE 200,039,103624,Rao; Ramesh R,9999,0,9999,0
1667971039360,ECE 200,040,103625,Rebeiz; Gabriel,9999,0,9999,0
1667971039360,ECE 200,041,103626,Sanford; John R,9999,0,9999,0
1667971039360,ECE 200,042,103627,Siegel; Paul H.,9999,0,9999,0
1667971039360,ECE 200,043,103628,Sievenpiper; Daniel F.,9999,0,9999,0
1667971039360,ECE 200,044,103629,Sworder; David D.,9999,0,9999,0
1667971039360,ECE 200,045,103630,Taur; Yuan,9999,0,9999,0
1667971039360,ECE 200,046,103631,Touri; Behrouz,9999,0,9999,0
1667971039360,ECE 200,047,103632,Trivedi; Mohan M.,9999,0,9999,0
1667971039360,ECE 200,048,103633,Vasconcelos; Nuno,9999,0,9999,0
1667971039360,ECE 200,049,103634,Wang; Xiaolong,9999,0,9999,0
1667971039360,ECE 200,050,103635,Xie; Pengtao,9999,0,9999,0
1667971039360,ECE 200,051,103636,Yip; Michael,9999,0,9999,0
1667971039360,ECE 200,052,103637,Zeger; Kenneth A.,999,0,999,0
1667971039360,ECE 200,053,103638,Zhang; Xinyu,9999,0,9999,0
1667971039360,ECE 200,054,103639,Turakhia; Yatish Girish,9999,0,9999,0
1667971039360,ECE 200,055,103640,Kang; Mingu,9999,0,9999,0
1667971039360,ECE 200,056,103641,Shi; Yuanyuan,9999,0,9999,0
1667971039360,ECE 200,057,103642,Wang; Edward Jay,9999,0,9999,0
1667971039360,ECE 200,058,103643,Zheng; Yang,9999,0,9999,0
1667971039793,ECE 202,A00,103644,Kuzum; Duygu,0,0,0,0
1667971040218,ECE 212BN,A00,103646,Ng; Tse Nga,0,0,0,0
1667971040642,ECE 221,A00,111493,Staff,0,0,0,0
1667971041070,ECE 222B,A00,103647,Lomakin; Vitaliy,0,0,0,0
1667971041501,ECE 230B,A00,103648,Taur; Yuan,0,0,0,0
1667971041925,ECE 238B,A00,103649,Garay; Javier,0,0,0,0
1667971042362,ECE 240B,A00,112900,Fainman; Yeshaiahu,0,0,0,0
1667971042785,ECE 247A,A00,103650,Jokerst; Jesse Vincent,0,0,0,0
1667971043212,ECE 247B,A00,103651,Wang; Joseph,0,0,0,0
1667971043638,ECE 250,A00,103652,Siegel; Paul H.,0,0,0,0
1667971044062,ECE 251A,A00,103654,Rao; Bhaskar D.,0,0,0,0
1667971044492,ECE 257B,A00,103655,Bharadia; Dinesh,0,0,0,0
1667971044919,ECE 258A,A00,103656,Milstein; Laurence B.,0,0,0,0
1667971045343,ECE 260B,A00,103658,Kang; Mingu,0,0,0,0
1667971045767,ECE 264A,A00,103659,Galton; Ian A,0,0,0,0
1667971046193,ECE 265A,A00,103661,Gudem; Prasad S.S.,0,0,0,0
1667971046620,ECE 265D,A00,103662,Gudem; Prasad S.S.,0,0,0,0
1667971047047,ECE 268,A00,103663,Koushanfar; Farinaz,0,0,0,0
1667971047480,ECE 269,A01,103665,Pal; Piya,0,0,0,0
1667971047901,ECE 271B,A00,103666,Vasconcelos; Manuela,0,0,0,0
1667971048325,ECE 276A,A00,103667,Atanasov; Nikolay A.,0,0,0,0
1667971048750,ECE 277,A00,103668,An; Cheolhong,0,0,0,0
1667971049173,ECE 279,A00,117947,Hall; Drew A.,0,0,0,0
1667971050020,ECE 283,A00,103670,Hsueh; Tzu-Chien,0,0,0,0
1667971050447,ECE 284,A00,103671,Turakhia; Yatish Girish,0,0,0,0
1667971050871,ECE 285,A00,103672,Zheng; Yang,0,0,0,0
1667971050871,ECE 285,B00,103673,Sworder; David D.,0,0,0,0
1667971051296,ECE 287,A00,103676,Javidi; Tara,0,0,0,0
1667971051721,MATH 200B,A00,098023,Salehi Golsefidy; Alireza,14,0,15,1
1667971052145,MATH 202B,A00,098024,Rhoades; Brendon Patrick,12,0,15,3
1667971052574,MATH 203B,A00,098025,Oprea; Dragos N.,12,0,15,3
1667971053001,MATH 204B,A00,098026,Sorensen; Claus M,14,0,15,1
1667971053424,MATH 208,A00,098027,Izadi; Elham,7,0,10,3
1667971053855,MATH 209,A00,098028,Pollack; Aaron,10,0,10,0
1667971054278,MATH 211A,A00,112919,Rogalski; Daniel,9,0,10,1
1667971054703,MATH 211B,A00,112920,Seward; Brandon M.,9,0,10,1
1667971055127,MATH 218,A00,098029,Li; Bo,10,0,10,0
1667971055554,MATH 220B,A00,098030,Novak; Jonathan I,13,0,15,2
1667971055982,MATH 221A,A00,098031,Ebenfelt; Peter F,13,0,15,2
1667971056404,MATH 231B,A00,098032,Zlatos; Andrej,12,0,15,3
1667971056825,MATH 240B,A00,098033,Ni; Lei,10,0,15,5
1667971057261,MATH 243,A00,098034,Jekel; David Andrew,10,0,10,0
1667971057693,MATH 245A,A00,098035,Nie; Jiawang,0,0,15,16
1667971058116,MATH 248,A00,098036,Bejenaru; Ioan,10,0,10,0
1667971058542,MATH 250B,A00,098037,Spolaor; Luca,14,0,15,1
1667971058965,MATH 258,A00,098038,Ni; Lei,10,0,10,0
1667971059391,MATH 264B,A00,098041,Rhoades; Brendon Patrick,12,0,15,3
1667971059813,MATH 268,A00,098042,Buss; Samuel R,10,0,10,0
1667971060250,MATH 269,A00,098043,Rhoades; Brendon Patrick,10,0,10,0
1667971060688,MATH 270B,A00,098044,Li; Bo,11,0,15,4
1667971061111,MATH 272B,A00,098045,Holst; Michael J,13,0,15,2
1667971061534,MATH 273A,A00,098046,Tian; Xiaochuan,12,0,15,3
1667971061958,MATH 275,A01,098048,Tian; Xiaochuan,6,0,10,4
1667971062381,MATH 278A,A00,098049,Holst; Michael J,8,0,10,2
1667971062802,MATH 278B,A00,098050,Cloninger; Alexander,10,0,10,0
1667971063230,MATH 278C,A00,098051,Nie; Jiawang,8,0,10,2
1667971063655,MATH 280B,A00,098052,Zheng; Tianyi,11,0,15,4
1667971064081,MATH 281B,A00,098053,Bradic; Jelena,4,0,15,11
1667971064504,MATH 282B,A00,098054,Arias-Castro; Ery,2,0,15,13
1667971064927,MATH 285,A00,098055,Fitzsimmons; Patrick J,0,0,15,17
1667971065350,MATH 287B,A00,098056,Arias-Castro; Ery,5,0,15,10
1667971065777,MATH 288,A00,098057,Agarwal; Pooja,9,0,10,1
1667971065777,MATH 288,B00,098058,Zhang; Danna,9,0,10,1
1667971065777,MATH 288,C00,098059,Williams; Ruth J,10,0,10,0
1667971066203,MATH 290B,A00,098060,Roberts; Justin Deritter,14,0,15,1
1667971066627,MATH 292,A00,098061,Belmont; Eva Kinoshita,10,0,10,0
1667971067050,MATH 295,A00,098062,Suk; Andrew Hoon,48,0,50,2
1667971067481,MATH 296,A00,098063,Novak; Jonathan I,20,0,20,0
1667971067904,MATH 297,001,098064,Gamst; Anthony Collins,9997,0,9999,2
1667971568054,COGS 205,A00,101395,Chiba; Andrea,19,0,20,1
1667971568480,COGS 210B,001,101404,Greene; Deanna Jacquelyn,9998,0,9999,1
1667971568480,COGS 210B,002,101417,Xia; Haijun,9999,0,9999,0
1667971568480,COGS 210B,003,101422,Nitz; Douglas A.,9999,0,9999,0
1667971568480,COGS 210B,004,101423,Hollan; James D.,9998,0,9999,1
1667971568480,COGS 210B,005,101424,Deak; Gedeon O.,9999,0,9999,0
1667971568480,COGS 210B,006,101425,Rossano; Federico,9999,0,9999,0
1667971568906,COGS 211B,A00,101427,Coulson; Seana M,9997,0,9999,2
1667971569330,COGS 220,A00,101428,Hollan; James D.,0,0,25,25
1667971569772,COGS 229,A00,101429,Dow; Steven P,18,0,25,7
1667971570199,COGS 230,A00,101430,Klemmer; Scott R,13,0,17,4
1667971570633,COGS 234,A00,101431,Xia; Haijun,7,0,25,18
1667971571056,COGS 260,A00,101432,Kiyonaga; Anastasia,20,0,25,5
1667971571056,COGS 260,B00,101433,Kirsh; David Joel,16,0,25,9
1667971571485,CSE 202,A00,102371,Impagliazzo; Russell,0,0,0,0
1667971571911,CSE 203B,A01,102373,Cheng; Chung Kuan,0,0,0,0
1667971572336,CSE 208,A00,102374,Micciancio; Daniele,0,0,0,0
1667971572759,CSE 209A,A00,112895,Impagliazzo; Russell,0,0,15,15
1667971573184,CSE 209B,A00,108005,Bellare; Mihir,0,0,0,0
1667971573609,CSE 210,A00,113163,Coblenz; Michael J,0,0,0,0
1667971574034,CSE 219,A00,106111,Dow; Steven P,0,0,20,20
1667971574456,CSE 221,A00,102376,Voelker; Geoffrey M.,0,0,0,0
1667971574878,CSE 224,A01,102378,Porter; George M,0,0,0,0
1667971575304,CSE 229A,A00,102379,Savage; Stefan,0,0,0,0
1667971575739,CSE 229C,A00,102380,Munyaka; Imani N. S.,0,0,0,0
1667971576164,CSE 232B,A00,102382,Deutsch; Alin Bernard,0,0,0,0
1667971576592,CSE 234,A01,112904,Kumar; Arun Kumar,0,0,0,0
1667971577020,CSE 237A,A00,102383,Rosing; Tajana Simunic,0,0,0,0
1667971577445,CSE 239A,A00,102384,Deutsch; Alin Bernard,0,0,0,0
1667971577869,CSE 239B,A00,102385,Polikarpova; Nadezhda,0,0,0,0
1667971578292,CSE 240A,A00,102386,Pannuto; Patrick William,0,0,0,0
1667971578716,CSE 240B,A00,102387,Zhao; Jishen,0,0,0,0
1667971579142,CSE 241A,A00,106406,Kang; Mingu,0,0,0,0
1667971579568,CSE 249B,A00,102388,Kahng; Andrew Byun,0,0,8,8
1667971579995,CSE 251B,A01,102392,Cottrell; Garrison W,0,0,0,0
1667971579995,CSE 251B,A02,102393,Cottrell; Garrison W,0,0,0,0
1667971580424,CSE 252B,A00,102394,Ochoa; Benjamin Lawrence,0,0,0,0
1667971580853,CSE 257,A01,102396,Gao; Sicun,0,0,0,0
1667971581276,CSE 272,A00,102397,Li; Tzumao,0,0,0,0
1667971581699,CSE 274,A00,111323,Chern; Albert Ren-Haur,0,0,0,0
1667971582123,CSE 282,A00,102398,Pevzner; Pavel Arkadjevich,0,0,0,0
1667971582548,CSE 284,A00,114175,Gymrek; Melissa Ann,0,0,0,0
1667971582971,CSE 290,A00,102399,Chandraker; Manmohan Krishna,0,0,0,0
1667971582971,CSE 290,B00,102400,Vaccaro; Kristen Marie,0,0,25,25
1667971582971,CSE 290,C00,102414,Pannuto; Patrick William,0,0,25,25
1667971582971,CSE 290,D00,102427,Pevzner; Pavel Arkadjevich,0,0,0,0
1667971582971,CSE 290,E00,102429,Zhao; Jishen,0,0,0,0
1667971582971,CSE 290,F00,102436,Tullsen; Dean Michael,0,0,0,0
1667971582971,CSE 290,G00,102440,Christensen; Henrik I,0,0,20,20
1667971583396,CSE 291,A00,102443,Su; Hao,0,0,0,0
1667971583396,CSE 291,B00,102448,Polikarpova; Nadezhda,0,0,0,0
1667971583396,CSE 291,C00,102453,Vaccaro; Kristen Marie,0,0,0,0
1667971583396,CSE 291,D00,111343,Savage; Stefan,0,0,0,0
1667971583396,CSE 291,E00,116474,Claffy; Kimberly Claire,0,0,0,0
1667971583396,CSE 291,F00,116479,Pasquale; Joseph,0,0,0,0
1667971583827,CSE 293,001,119111,Bafna; Vineet,9999,0,9999,0
1667971583827,CSE 293,002,119118,Bellare; Mihir,9999,0,9999,0
1667971583827,CSE 293,003,119122,Berg-Kirkpatrick; Taylor D,9999,0,9999,0
1667971583827,CSE 293,004,119135,Christensen; Henrik I,9999,0,9999,0
1667971583827,CSE 293,005,119142,Cottrell; Garrison W,9999,0,9999,0
1667971583827,CSE 293,006,119146,Deutsch; Alin Bernard,9999,0,9999,0
1667971583827,CSE 293,007,119159,Esmaeilzadeh; Hadi,9999,0,9999,0
1667971583827,CSE 293,008,119166,Freund; Yoav,9999,0,9999,0
1667971583827,CSE 293,009,119170,Griswold; William G.,9999,0,9999,0
1667971583827,CSE 293,010,119183,Gymrek; Melissa Ann,9999,0,9999,0
1667971583827,CSE 293,011,119190,Heninger; Nadia A,9999,0,9999,0
1667971583827,CSE 293,012,119230,Impagliazzo; Russell,9999,0,9999,0
1667971583827,CSE 293,013,119232,Jhala; Ranjit,9999,0,9999,0
1667971583827,CSE 293,014,119233,Kahng; Andrew Byun,9999,0,9999,0
1667971583827,CSE 293,015,119298,Kane; Daniel Mertz,9999,0,9999,0
1667971583827,CSE 293,016,119299,Kriegman; David J,9999,0,9999,0
1667971583827,CSE 293,017,119300,Kumar; Arun Kumar,9999,0,9999,0
1667971583827,CSE 293,018,119301,Lerner; Sorin,9999,0,9999,0
1667971583827,CSE 293,019,119302,Lovett; Shachar,9999,0,9999,0
1667971583827,CSE 293,020,119303,McAuley; Julian John,9999,0,9999,0
1667971583827,CSE 293,021,119304,Micciancio; Daniele,9999,0,9999,0
1667971583827,CSE 293,022,119367,Orailoglu; Alex,9999,0,9999,0
1667971583827,CSE 293,023,119382,Paturi; Ramamohan,9999,0,9999,0
1667971583827,CSE 293,024,119404,Polikarpova; Nadezhda,9999,0,9999,0
1667971583827,CSE 293,025,119406,Politz; Joseph Gibbs,9999,0,9999,0
1667971583827,CSE 293,026,119411,Porter; George M,9999,0,9999,0
1667971583827,CSE 293,027,119414,Porter; Leonard Emerson,9999,0,9999,0
1667971583827,CSE 293,028,119416,Ramamoorthi; Ravi,9999,0,9999,0
1667971583827,CSE 293,029,119417,Sahoo; Debashis,9999,0,9999,0
1667971583827,CSE 293,030,119420,Saul; Lawrence,9999,0,9999,0
1667971583827,CSE 293,031,119421,Savage; Stefan,9999,0,9999,0
1667971583827,CSE 293,032,119425,Schulze; Jurgen P.,9999,0,9999,0
1667971583827,CSE 293,033,119426,Snoeren; Alex C.,9999,0,9999,0
1667971583827,CSE 293,034,119428,Shang; Jingbo,9999,0,9999,0
1667971583827,CSE 293,035,119430,Stefan; Deian,9999,0,9999,0
1667971583827,CSE 293,036,119431,Su; Hao,9999,0,9999,0
1667971583827,CSE 293,037,119433,Swanson; Steven James,9999,0,9999,0
1667971583827,CSE 293,038,119435,Tullsen; Dean Michael,9999,0,9999,0
1667971583827,CSE 293,039,119483,Voelker; Geoffrey M.,9999,0,9999,0
1667971583827,CSE 293,040,119537,Zhao; Jishen,9999,0,9999,0
1667971583827,CSE 293,041,119538,Zhou; Yuan-Yuan,9999,0,9999,0
1667971583827,CSE 293,042,119539,Gao; Sicun,9999,0,9999,0
1667971583827,CSE 293,043,119540,Weibel; Nadir,9999,0,9999,0
1667971583827,CSE 293,044,119541,Gupta; Rajesh K.,9999,0,9999,0
1667971584253,CSE 294,A00,102459,Voelker; Geoffrey M.,0,0,0,0
1667971584253,CSE 294,B00,111322,Orailoglu; Alex,0,0,0,0
1667971584681,DSE 201,A00,096914,Deutsch; Alin Bernard,30,0,30,0
1667971585103,DSE 210,A00,096915,Dasgupta; Sanjoy,30,0,30,0
1667971585529,DSE 260A,A00,096916,Altintas De Callaf; Ilkay,30,0,30,0
1667971585969,ECE 200,001,103586,Antipa; Nicholas A,9999,0,9999,0
1667971585969,ECE 200,002,103587,Atanasov; Nikolay A.,9999,0,9999,0
1667971585969,ECE 200,003,103588,Bharadia; Dinesh,9999,0,9999,0
1667971585969,ECE 200,004,103589,Cheng; Chung Kuan,9999,0,9999,0
1667971585969,ECE 200,005,103590,Cosman; Pamela C.,9999,0,9999,0
1667971585969,ECE 200,006,103591,Dayeh; Shadi Ahmad,9999,0,9999,0
1667971585969,ECE 200,007,103592,Fainman; Yeshaiahu,9999,0,9999,0
1667971585969,ECE 200,008,103593,Ford; Joseph Earl,9999,0,9999,0
1667971585969,ECE 200,009,103594,Franceschetti; Massimo,9999,0,9999,0
1667971585969,ECE 200,010,103595,Fullerton; Eric E,9999,0,9999,0
1667971585969,ECE 200,011,103596,Galton; Ian A,9999,0,9999,0
1667971585969,ECE 200,012,103597,Gilja; Vikash,9999,0,9999,0
1667971585969,ECE 200,013,103598,Hall; Drew A.,9999,0,9999,0
1667971585969,ECE 200,014,103599,Hsueh; Tzu-Chien,9999,0,9999,0
1667971585969,ECE 200,015,103600,Javidi; Tara,9999,0,9999,0
1667971585969,ECE 200,016,103601,Kahng; Andrew Byun,9999,0,9999,0
1667971585969,ECE 200,017,103602,Kim; Young-Han,9999,0,9999,0
1667971585969,ECE 200,018,103603,Koushanfar; Farinaz,9999,0,9999,0
1667971585969,ECE 200,019,103604,Kuzum; Duygu,9999,0,9999,0
1667971585969,ECE 200,020,103605,Le; Hanh-Phuc,9999,0,9999,0
1667971585969,ECE 200,021,103606,Lin; Bill,9999,0,9999,0
1667971585969,ECE 200,022,103607,Liu; Zhaowei,9998,0,9999,1
1667971585969,ECE 200,023,103608,Lo; Yu-Hwa,9999,0,9999,0
1667971585969,ECE 200,024,103609,Lomakin; Vitaliy,9999,0,9999,0
1667971585969,ECE 200,025,103610,Mercier; Patrick Philip,9999,0,9999,0
1667971585969,ECE 200,026,103611,Meyer; Florian,9999,0,9999,0
1667971585969,ECE 200,027,103612,Milstein; Laurence B.,9999,0,9999,0
1667971585969,ECE 200,028,103613,Mir Arabbaygi; Siavash,9999,0,9999,0
1667971585969,ECE 200,029,103614,Mookherjea; Shayan,9999,0,9999,0
1667971585969,ECE 200,030,103615,Morris; Karcher William,9999,0,9999,0
1667971585969,ECE 200,031,103616,Ng; Tse Nga,9999,0,9999,0
1667971585969,ECE 200,032,103617,Nguyen; Truong Quang,9999,0,9999,0
1667971585969,ECE 200,033,103618,Nomura; Kenji,9999,0,9999,0
1667971585969,ECE 200,034,103619,Orlitsky; Alon,9999,0,9999,0
1667971585969,ECE 200,035,103620,Pal; Piya,9999,0,9999,0
1667971585969,ECE 200,036,103621,Papen; George C.,9999,0,9999,0
1667971585969,ECE 200,037,103622,Radic; Stojan,9999,0,9999,0
1667971585969,ECE 200,038,103623,Rao; Bhaskar D.,9999,0,9999,0
1667971585969,ECE 200,039,103624,Rao; Ramesh R,9999,0,9999,0
1667971585969,ECE 200,040,103625,Rebeiz; Gabriel,9999,0,9999,0
1667971585969,ECE 200,041,103626,Sanford; John R,9999,0,9999,0
1667971585969,ECE 200,042,103627,Siegel; Paul H.,9999,0,9999,0
1667971585969,ECE 200,043,103628,Sievenpiper; Daniel F.,9999,0,9999,0
1667971585969,ECE 200,044,103629,Sworder; David D.,9999,0,9999,0
1667971585969,ECE 200,045,103630,Taur; Yuan,9999,0,9999,0
1667971585969,ECE 200,046,103631,Touri; Behrouz,9999,0,9999,0
1667971585969,ECE 200,047,103632,Trivedi; Mohan M.,9999,0,9999,0
1667971585969,ECE 200,048,103633,Vasconcelos; Nuno,9999,0,9999,0
1667971585969,ECE 200,049,103634,Wang; Xiaolong,9999,0,9999,0
1667971585969,ECE 200,050,103635,Xie; Pengtao,9999,0,9999,0
1667971585969,ECE 200,051,103636,Yip; Michael,9999,0,9999,0
1667971585969,ECE 200,052,103637,Zeger; Kenneth A.,999,0,999,0
1667971585969,ECE 200,053,103638,Zhang; Xinyu,9999,0,9999,0
1667971585969,ECE 200,054,103639,Turakhia; Yatish Girish,9999,0,9999,0
1667971585969,ECE 200,055,103640,Kang; Mingu,9999,0,9999,0
1667971585969,ECE 200,056,103641,Shi; Yuanyuan,9999,0,9999,0
1667971585969,ECE 200,057,103642,Wang; Edward Jay,9999,0,9999,0
1667971585969,ECE 200,058,103643,Zheng; Yang,9999,0,9999,0
1667971586396,ECE 202,A00,103644,Kuzum; Duygu,0,0,0,0
1667971586823,ECE 212BN,A00,103646,Ng; Tse Nga,0,0,0,0
1667971587247,ECE 221,A00,111493,Staff,0,0,0,0
1667971587673,ECE 222B,A00,103647,Lomakin; Vitaliy,0,0,0,0
1667971588102,ECE 230B,A00,103648,Taur; Yuan,0,0,0,0
1667971588533,ECE 238B,A00,103649,Garay; Javier,0,0,0,0
1667971588956,ECE 240B,A00,112900,Fainman; Yeshaiahu,0,0,0,0
1667971589389,ECE 247A,A00,103650,Jokerst; Jesse Vincent,0,0,0,0
1667971589813,ECE 247B,A00,103651,Wang; Joseph,0,0,0,0
1667971590238,ECE 250,A00,103652,Siegel; Paul H.,0,0,0,0
1667971590661,ECE 251A,A00,103654,Rao; Bhaskar D.,0,0,0,0
1667971591090,ECE 257B,A00,103655,Bharadia; Dinesh,0,0,0,0
1667971591517,ECE 258A,A00,103656,Milstein; Laurence B.,0,0,0,0
1667971592035,ECE 260B,A00,103658,Kang; Mingu,0,0,0,0
1667971592457,ECE 264A,A00,103659,Galton; Ian A,0,0,0,0
1667971592882,ECE 265A,A00,103661,Gudem; Prasad S.S.,0,0,0,0
1667971593308,ECE 265D,A00,103662,Gudem; Prasad S.S.,0,0,0,0
1667971593734,ECE 268,A00,103663,Koushanfar; Farinaz,0,0,0,0
1667971594158,ECE 269,A01,103665,Pal; Piya,0,0,0,0
1667971594583,ECE 271B,A00,103666,Vasconcelos; Manuela,0,0,0,0
1667971595006,ECE 276A,A00,103667,Atanasov; Nikolay A.,0,0,0,0
1667971595427,ECE 277,A00,103668,An; Cheolhong,0,0,0,0
1667971595853,ECE 279,A00,117947,Hall; Drew A.,0,0,0,0
1667971596705,ECE 283,A00,103670,Hsueh; Tzu-Chien,0,0,0,0
1667971597128,ECE 284,A00,103671,Turakhia; Yatish Girish,0,0,0,0
1667971597555,ECE 285,A00,103672,Zheng; Yang,0,0,0,0
1667971597555,ECE 285,B00,103673,Sworder; David D.,0,0,0,0
1667971597994,ECE 287,A00,103676,Javidi; Tara,0,0,0,0
1667971598423,MATH 200B,A00,098023,Salehi Golsefidy; Alireza,14,0,15,1
1667971598854,MATH 202B,A00,098024,Rhoades; Brendon Patrick,12,0,15,3
1667971599280,MATH 203B,A00,098025,Oprea; Dragos N.,12,0,15,3
1667971599708,MATH 204B,A00,098026,Sorensen; Claus M,14,0,15,1
1667971600134,MATH 208,A00,098027,Izadi; Elham,7,0,10,3
1667971600558,MATH 209,A00,098028,Pollack; Aaron,10,0,10,0
1667971600985,MATH 211A,A00,112919,Rogalski; Daniel,9,0,10,1
1667971601416,MATH 211B,A00,112920,Seward; Brandon M.,9,0,10,1
1667971602018,MATH 218,A00,098029,Li; Bo,10,0,10,0
1667971602443,MATH 220B,A00,098030,Novak; Jonathan I,13,0,15,2
1667971602876,MATH 221A,A00,098031,Ebenfelt; Peter F,13,0,15,2
1667971603300,MATH 231B,A00,098032,Zlatos; Andrej,12,0,15,3
1667971603726,MATH 240B,A00,098033,Ni; Lei,10,0,15,5
1667971604148,MATH 243,A00,098034,Jekel; David Andrew,10,0,10,0
1667971604571,MATH 245A,A00,098035,Nie; Jiawang,0,0,15,16
1667971605001,MATH 248,A00,098036,Bejenaru; Ioan,10,0,10,0
1667971605424,MATH 250B,A00,098037,Spolaor; Luca,14,0,15,1
1667971605848,MATH 258,A00,098038,Ni; Lei,10,0,10,0
1667971606272,MATH 264B,A00,098041,Rhoades; Brendon Patrick,12,0,15,3
1667971606695,MATH 268,A00,098042,Buss; Samuel R,10,0,10,0
1667971607124,MATH 269,A00,098043,Rhoades; Brendon Patrick,10,0,10,0
1667971607549,MATH 270B,A00,098044,Li; Bo,11,0,15,4
1667971607978,MATH 272B,A00,098045,Holst; Michael J,13,0,15,2
1667971608403,MATH 273A,A00,098046,Tian; Xiaochuan,12,0,15,3
1667971608826,MATH 275,A01,098048,Tian; Xiaochuan,6,0,10,4
1667971609248,MATH 278A,A00,098049,Holst; Michael J,8,0,10,2
1667971609671,MATH 278B,A00,098050,Cloninger; Alexander,10,0,10,0
1667971610095,MATH 278C,A00,098051,Nie; Jiawang,8,0,10,2
1667971610517,MATH 280B,A00,098052,Zheng; Tianyi,11,0,15,4
1667971610941,MATH 281B,A00,098053,Bradic; Jelena,4,0,15,11
1667971611365,MATH 282B,A00,098054,Arias-Castro; Ery,2,0,15,13
1667971611806,MATH 285,A00,098055,Fitzsimmons; Patrick J,0,0,15,17
1667971612230,MATH 287B,A00,098056,Arias-Castro; Ery,5,0,15,10
1667971612663,MATH 288,A00,098057,Agarwal; Pooja,9,0,10,1
1667971612663,MATH 288,B00,098058,Zhang; Danna,9,0,10,1
1667971612663,MATH 288,C00,098059,Williams; Ruth J,10,0,10,0
1667971613090,MATH 290B,A00,098060,Roberts; Justin Deritter,14,0,15,1
1667971613515,MATH 292,A00,098061,Belmont; Eva Kinoshita,10,0,10,0
1667971613939,MATH 295,A00,098062,Suk; Andrew Hoon,48,0,50,2
1667971614363,MATH 296,A00,098063,Novak; Jonathan I,20,0,20,0
1667971614784,MATH 297,001,098064,Gamst; Anthony Collins,9997,0,9999,2
1667972125377,COGS 205,A00,101395,Chiba; Andrea,19,0,20,1
1667972125814,COGS 210B,001,101404,Greene; Deanna Jacquelyn,9998,0,9999,1
1667972125814,COGS 210B,002,101417,Xia; Haijun,9999,0,9999,0
1667972125814,COGS 210B,003,101422,Nitz; Douglas A.,9999,0,9999,0
1667972125814,COGS 210B,004,101423,Hollan; James D.,9998,0,9999,1
1667972125814,COGS 210B,005,101424,Deak; Gedeon O.,9999,0,9999,0
1667972125814,COGS 210B,006,101425,Rossano; Federico,9999,0,9999,0
1667972126237,COGS 211B,A00,101427,Coulson; Seana M,9997,0,9999,2
1667972126667,COGS 220,A00,101428,Hollan; James D.,0,0,25,25
1667972127094,COGS 229,A00,101429,Dow; Steven P,18,0,25,7
1667972127516,COGS 230,A00,101430,Klemmer; Scott R,13,0,17,4
1667972127939,COGS 234,A00,101431,Xia; Haijun,7,0,25,18
1667972128380,COGS 260,A00,101432,Kiyonaga; Anastasia,20,0,25,5
1667972128380,COGS 260,B00,101433,Kirsh; David Joel,16,0,25,9
1667972128805,CSE 202,A00,102371,Impagliazzo; Russell,0,0,0,0
1667972129233,CSE 203B,A01,102373,Cheng; Chung Kuan,0,0,0,0
1667972129661,CSE 208,A00,102374,Micciancio; Daniele,0,0,0,0
1667972130086,CSE 209A,A00,112895,Impagliazzo; Russell,0,0,15,15
1667972130511,CSE 209B,A00,108005,Bellare; Mihir,0,0,0,0
1667972130935,CSE 210,A00,113163,Coblenz; Michael J,0,0,0,0
1667972131360,CSE 219,A00,106111,Dow; Steven P,0,0,20,20
1667972131789,CSE 221,A00,102376,Voelker; Geoffrey M.,0,0,0,0
1667972132219,CSE 224,A01,102378,Porter; George M,0,0,0,0
1667972132648,CSE 229A,A00,102379,Savage; Stefan,0,0,0,0
1667972133072,CSE 229C,A00,102380,Munyaka; Imani N. S.,0,0,0,0
1667972133496,CSE 232B,A00,102382,Deutsch; Alin Bernard,0,0,0,0
1667972133923,CSE 234,A01,112904,Kumar; Arun Kumar,0,0,0,0
1667972134346,CSE 237A,A00,102383,Rosing; Tajana Simunic,0,0,0,0
1667972134773,CSE 239A,A00,102384,Deutsch; Alin Bernard,0,0,0,0
1667972135197,CSE 239B,A00,102385,Polikarpova; Nadezhda,0,0,0,0
1667972135621,CSE 240A,A00,102386,Pannuto; Patrick William,0,0,0,0
1667972136045,CSE 240B,A00,102387,Zhao; Jishen,0,0,0,0
1667972136480,CSE 241A,A00,106406,Kang; Mingu,0,0,0,0
1667972136906,CSE 249B,A00,102388,Kahng; Andrew Byun,0,0,8,8
1667972137336,CSE 251B,A01,102392,Cottrell; Garrison W,0,0,0,0
1667972137336,CSE 251B,A02,102393,Cottrell; Garrison W,0,0,0,0
1667972137762,CSE 252B,A00,102394,Ochoa; Benjamin Lawrence,0,0,0,0
1667972138189,CSE 257,A01,102396,Gao; Sicun,0,0,0,0
1667972138612,CSE 272,A00,102397,Li; Tzumao,0,0,0,0
1667972139036,CSE 274,A00,111323,Chern; Albert Ren-Haur,0,0,0,0
1667972139463,CSE 282,A00,102398,Pevzner; Pavel Arkadjevich,0,0,0,0
1667972139886,CSE 284,A00,114175,Gymrek; Melissa Ann,0,0,0,0
1667972140322,CSE 290,A00,102399,Chandraker; Manmohan Krishna,0,0,0,0
1667972140322,CSE 290,B00,102400,Vaccaro; Kristen Marie,0,0,25,25
1667972140322,CSE 290,C00,102414,Pannuto; Patrick William,0,0,25,25
1667972140322,CSE 290,D00,102427,Pevzner; Pavel Arkadjevich,0,0,0,0
1667972140322,CSE 290,E00,102429,Zhao; Jishen,0,0,0,0
1667972140322,CSE 290,F00,102436,Tullsen; Dean Michael,0,0,0,0
1667972140322,CSE 290,G00,102440,Christensen; Henrik I,0,0,20,20
1667972140751,CSE 291,A00,102443,Su; Hao,0,0,0,0
1667972140751,CSE 291,B00,102448,Polikarpova; Nadezhda,0,0,0,0
1667972140751,CSE 291,C00,102453,Vaccaro; Kristen Marie,0,0,0,0
1667972140751,CSE 291,D00,111343,Savage; Stefan,0,0,0,0
1667972140751,CSE 291,E00,116474,Claffy; Kimberly Claire,0,0,0,0
1667972140751,CSE 291,F00,116479,Pasquale; Joseph,0,0,0,0
1667972141183,CSE 293,001,119111,Bafna; Vineet,9999,0,9999,0
1667972141183,CSE 293,002,119118,Bellare; Mihir,9999,0,9999,0
1667972141183,CSE 293,003,119122,Berg-Kirkpatrick; Taylor D,9999,0,9999,0
1667972141183,CSE 293,004,119135,Christensen; Henrik I,9999,0,9999,0
1667972141183,CSE 293,005,119142,Cottrell; Garrison W,9999,0,9999,0
1667972141183,CSE 293,006,119146,Deutsch; Alin Bernard,9999,0,9999,0
1667972141183,CSE 293,007,119159,Esmaeilzadeh; Hadi,9999,0,9999,0
1667972141183,CSE 293,008,119166,Freund; Yoav,9999,0,9999,0
1667972141183,CSE 293,009,119170,Griswold; William G.,9999,0,9999,0
1667972141183,CSE 293,010,119183,Gymrek; Melissa Ann,9999,0,9999,0
1667972141183,CSE 293,011,119190,Heninger; Nadia A,9999,0,9999,0
1667972141183,CSE 293,012,119230,Impagliazzo; Russell,9999,0,9999,0
1667972141183,CSE 293,013,119232,Jhala; Ranjit,9999,0,9999,0
1667972141183,CSE 293,014,119233,Kahng; Andrew Byun,9999,0,9999,0
1667972141183,CSE 293,015,119298,Kane; Daniel Mertz,9999,0,9999,0
1667972141183,CSE 293,016,119299,Kriegman; David J,9999,0,9999,0
1667972141183,CSE 293,017,119300,Kumar; Arun Kumar,9999,0,9999,0
1667972141183,CSE 293,018,119301,Lerner; Sorin,9999,0,9999,0
1667972141183,CSE 293,019,119302,Lovett; Shachar,9999,0,9999,0
1667972141183,CSE 293,020,119303,McAuley; Julian John,9999,0,9999,0
1667972141183,CSE 293,021,119304,Micciancio; Daniele,9999,0,9999,0
1667972141183,CSE 293,022,119367,Orailoglu; Alex,9999,0,9999,0
1667972141183,CSE 293,023,119382,Paturi; Ramamohan,9999,0,9999,0
1667972141183,CSE 293,024,119404,Polikarpova; Nadezhda,9999,0,9999,0
1667972141183,CSE 293,025,119406,Politz; Joseph Gibbs,9999,0,9999,0
1667972141183,CSE 293,026,119411,Porter; George M,9999,0,9999,0
1667972141183,CSE 293,027,119414,Porter; Leonard Emerson,9999,0,9999,0
1667972141183,CSE 293,028,119416,Ramamoorthi; Ravi,9999,0,9999,0
1667972141183,CSE 293,029,119417,Sahoo; Debashis,9999,0,9999,0
1667972141183,CSE 293,030,119420,Saul; Lawrence,9999,0,9999,0
1667972141183,CSE 293,031,119421,Savage; Stefan,9999,0,9999,0
1667972141183,CSE 293,032,119425,Schulze; Jurgen P.,9999,0,9999,0
1667972141183,CSE 293,033,119426,Snoeren; Alex C.,9999,0,9999,0
1667972141183,CSE 293,034,119428,Shang; Jingbo,9999,0,9999,0
1667972141183,CSE 293,035,119430,Stefan; Deian,9999,0,9999,0
1667972141183,CSE 293,036,119431,Su; Hao,9999,0,9999,0
1667972141183,CSE 293,037,119433,Swanson; Steven James,9999,0,9999,0
1667972141183,CSE 293,038,119435,Tullsen; Dean Michael,9999,0,9999,0
1667972141183,CSE 293,039,119483,Voelker; Geoffrey M.,9999,0,9999,0
1667972141183,CSE 293,040,119537,Zhao; Jishen,9999,0,9999,0
1667972141183,CSE 293,041,119538,Zhou; Yuan-Yuan,9999,0,9999,0
1667972141183,CSE 293,042,119539,Gao; Sicun,9999,0,9999,0
1667972141183,CSE 293,043,119540,Weibel; Nadir,9999,0,9999,0
1667972141183,CSE 293,044,119541,Gupta; Rajesh K.,9999,0,9999,0
1667972141608,CSE 294,A00,102459,Voelker; Geoffrey M.,0,0,0,0
1667972141608,CSE 294,B00,111322,Orailoglu; Alex,0,0,0,0
1667972142032,DSE 201,A00,096914,Deutsch; Alin Bernard,30,0,30,0
1667972142455,DSE 210,A00,096915,Dasgupta; Sanjoy,30,0,30,0
1667972142889,DSE 260A,A00,096916,Altintas De Callaf; Ilkay,30,0,30,0
1667972143320,ECE 200,001,103586,Antipa; Nicholas A,9999,0,9999,0
1667972143320,ECE 200,002,103587,Atanasov; Nikolay A.,9999,0,9999,0
1667972143320,ECE 200,003,103588,Bharadia; Dinesh,9999,0,9999,0
1667972143320,ECE 200,004,103589,Cheng; Chung Kuan,9999,0,9999,0
1667972143320,ECE 200,005,103590,Cosman; Pamela C.,9999,0,9999,0
1667972143320,ECE 200,006,103591,Dayeh; Shadi Ahmad,9999,0,9999,0
1667972143320,ECE 200,007,103592,Fainman; Yeshaiahu,9999,0,9999,0
1667972143320,ECE 200,008,103593,Ford; Joseph Earl,9999,0,9999,0
1667972143320,ECE 200,009,103594,Franceschetti; Massimo,9999,0,9999,0
1667972143320,ECE 200,010,103595,Fullerton; Eric E,9999,0,9999,0
1667972143320,ECE 200,011,103596,Galton; Ian A,9999,0,9999,0
1667972143320,ECE 200,012,103597,Gilja; Vikash,9999,0,9999,0
1667972143320,ECE 200,013,103598,Hall; Drew A.,9999,0,9999,0
1667972143320,ECE 200,014,103599,Hsueh; Tzu-Chien,9999,0,9999,0
1667972143320,ECE 200,015,103600,Javidi; Tara,9999,0,9999,0
1667972143320,ECE 200,016,103601,Kahng; Andrew Byun,9999,0,9999,0
1667972143320,ECE 200,017,103602,Kim; Young-Han,9999,0,9999,0
1667972143320,ECE 200,018,103603,Koushanfar; Farinaz,9999,0,9999,0
1667972143320,ECE 200,019,103604,Kuzum; Duygu,9999,0,9999,0
1667972143320,ECE 200,020,103605,Le; Hanh-Phuc,9999,0,9999,0
1667972143320,ECE 200,021,103606,Lin; Bill,9999,0,9999,0
1667972143320,ECE 200,022,103607,Liu; Zhaowei,9998,0,9999,1
1667972143320,ECE 200,023,103608,Lo; Yu-Hwa,9999,0,9999,0
1667972143320,ECE 200,024,103609,Lomakin; Vitaliy,9999,0,9999,0
1667972143320,ECE 200,025,103610,Mercier; Patrick Philip,9999,0,9999,0
1667972143320,ECE 200,026,103611,Meyer; Florian,9999,0,9999,0
1667972143320,ECE 200,027,103612,Milstein; Laurence B.,9999,0,9999,0
1667972143320,ECE 200,028,103613,Mir Arabbaygi; Siavash,9999,0,9999,0
1667972143320,ECE 200,029,103614,Mookherjea; Shayan,9999,0,9999,0
1667972143320,ECE 200,030,103615,Morris; Karcher William,9999,0,9999,0
1667972143320,ECE 200,031,103616,Ng; Tse Nga,9999,0,9999,0
1667972143320,ECE 200,032,103617,Nguyen; Truong Quang,9999,0,9999,0
1667972143320,ECE 200,033,103618,Nomura; Kenji,9999,0,9999,0
1667972143320,ECE 200,034,103619,Orlitsky; Alon,9999,0,9999,0
1667972143320,ECE 200,035,103620,Pal; Piya,9999,0,9999,0
1667972143320,ECE 200,036,103621,Papen; George C.,9999,0,9999,0
1667972143320,ECE 200,037,103622,Radic; Stojan,9999,0,9999,0
1667972143320,ECE 200,038,103623,Rao; Bhaskar D.,9999,0,9999,0
1667972143320,ECE 200,039,103624,Rao; Ramesh R,9999,0,9999,0
1667972143320,ECE 200,040,103625,Rebeiz; Gabriel,9999,0,9999,0
1667972143320,ECE 200,041,103626,Sanford; John R,9999,0,9999,0
1667972143320,ECE 200,042,103627,Siegel; Paul H.,9999,0,9999,0
1667972143320,ECE 200,043,103628,Sievenpiper; Daniel F.,9999,0,9999,0
1667972143320,ECE 200,044,103629,Sworder; David D.,9999,0,9999,0
1667972143320,ECE 200,045,103630,Taur; Yuan,9999,0,9999,0
1667972143320,ECE 200,046,103631,Touri; Behrouz,9999,0,9999,0
1667972143320,ECE 200,047,103632,Trivedi; Mohan M.,9999,0,9999,0
1667972143320,ECE 200,048,103633,Vasconcelos; Nuno,9999,0,9999,0
1667972143320,ECE 200,049,103634,Wang; Xiaolong,9999,0,9999,0
1667972143320,ECE 200,050,103635,Xie; Pengtao,9999,0,9999,0
1667972143320,ECE 200,051,103636,Yip; Michael,9999,0,9999,0
1667972143320,ECE 200,052,103637,Zeger; Kenneth A.,999,0,999,0
1667972143320,ECE 200,053,103638,Zhang; Xinyu,9999,0,9999,0
1667972143320,ECE 200,054,103639,Turakhia; Yatish Girish,9999,0,9999,0
1667972143320,ECE 200,055,103640,Kang; Mingu,9999,0,9999,0
1667972143320,ECE 200,056,103641,Shi; Yuanyuan,9999,0,9999,0
1667972143320,ECE 200,057,103642,Wang; Edward Jay,9999,0,9999,0
1667972143320,ECE 200,058,103643,Zheng; Yang,9999,0,9999,0
1667972143746,ECE 202,A00,103644,Kuzum; Duygu,0,0,0,0
1667972144170,ECE 212BN,A00,103646,Ng; Tse Nga,0,0,0,0
1667972144594,ECE 221,A00,111493,Staff,0,0,0,0
1667972145015,ECE 222B,A00,103647,Lomakin; Vitaliy,0,0,0,0
1667972145449,ECE 230B,A00,103648,Taur; Yuan,0,0,0,0
1667972145871,ECE 238B,A00,103649,Garay; Javier,0,0,0,0
1667972146299,ECE 240B,A00,112900,Fainman; Yeshaiahu,0,0,0,0
1667972146730,ECE 247A,A00,103650,Jokerst; Jesse Vincent,0,0,0,0
1667972147156,ECE 247B,A00,103651,Wang; Joseph,0,0,0,0
1667972147582,ECE 250,A00,103652,Siegel; Paul H.,0,0,0,0
1667972148008,ECE 251A,A00,103654,Rao; Bhaskar D.,0,0,0,0
1667972148442,ECE 257B,A00,103655,Bharadia; Dinesh,0,0,0,0
1667972148868,ECE 258A,A00,103656,Milstein; Laurence B.,0,0,0,0
1667972149293,ECE 260B,A00,103658,Kang; Mingu,0,0,0,0
1667972149728,ECE 264A,A00,103659,Galton; Ian A,0,0,0,0
1667972150153,ECE 265A,A00,103661,Gudem; Prasad S.S.,0,0,0,0
1667972150576,ECE 265D,A00,103662,Gudem; Prasad S.S.,0,0,0,0
1667972150999,ECE 268,A00,103663,Koushanfar; Farinaz,0,0,0,0
1667972151427,ECE 269,A01,103665,Pal; Piya,0,0,0,0
1667972151852,ECE 271B,A00,103666,Vasconcelos; Manuela,0,0,0,0
1667972152273,ECE 276A,A00,103667,Atanasov; Nikolay A.,0,0,0,0
1667972152700,ECE 277,A00,103668,An; Cheolhong,0,0,0,0
1667972153123,ECE 279,A00,117947,Hall; Drew A.,0,0,0,0
1667972153971,ECE 283,A00,103670,Hsueh; Tzu-Chien,0,0,0,0
1667972154394,ECE 284,A00,103671,Turakhia; Yatish Girish,0,0,0,0
1667972154818,ECE 285,A00,103672,Zheng; Yang,0,0,0,0
1667972154818,ECE 285,B00,103673,Sworder; David D.,0,0,0,0
1667972155250,ECE 287,A00,103676,Javidi; Tara,0,0,0,0
1667972155673,MATH 200B,A00,098023,Salehi Golsefidy; Alireza,14,0,15,1
1667972156098,MATH 202B,A00,098024,Rhoades; Brendon Patrick,12,0,15,3
1667972156526,MATH 203B,A00,098025,Oprea; Dragos N.,12,0,15,3
1667972156949,MATH 204B,A00,098026,Sorensen; Claus M,14,0,15,1
1667972157373,MATH 208,A00,098027,Izadi; Elham,7,0,10,3
1667972157795,MATH 209,A00,098028,Pollack; Aaron,10,0,10,0
1667972158217,MATH 211A,A00,112919,Rogalski; Daniel,9,0,10,1
1667972158643,MATH 211B,A00,112920,Seward; Brandon M.,9,0,10,1
1667972159070,MATH 218,A00,098029,Li; Bo,10,0,10,0
1667972159493,MATH 220B,A00,098030,Novak; Jonathan I,13,0,15,2
1667972159933,MATH 221A,A00,098031,Ebenfelt; Peter F,13,0,15,2
1667972160357,MATH 231B,A00,098032,Zlatos; Andrej,12,0,15,3
1667972160785,MATH 240B,A00,098033,Ni; Lei,10,0,15,5
1667972161210,MATH 243,A00,098034,Jekel; David Andrew,10,0,10,0
1667972161633,MATH 245A,A00,098035,Nie; Jiawang,0,0,15,16
1667972162059,MATH 248,A00,098036,Bejenaru; Ioan,10,0,10,0
1667972162485,MATH 250B,A00,098037,Spolaor; Luca,14,0,15,1
1667972162909,MATH 258,A00,098038,Ni; Lei,10,0,10,0
1667972163350,MATH 264B,A00,098041,Rhoades; Brendon Patrick,12,0,15,3
1667972163774,MATH 268,A00,098042,Buss; Samuel R,10,0,10,0
1667972164201,MATH 269,A00,098043,Rhoades; Brendon Patrick,10,0,10,0
1667972164624,MATH 270B,A00,098044,Li; Bo,11,0,15,4
1667972165051,MATH 272B,A00,098045,Holst; Michael J,13,0,15,2
1667972165475,MATH 273A,A00,098046,Tian; Xiaochuan,12,0,15,3
1667972165975,MATH 275,A01,098048,Tian; Xiaochuan,6,0,10,4
1667972166400,MATH 278A,A00,098049,Holst; Michael J,8,0,10,2
1667972166824,MATH 278B,A00,098050,Cloninger; Alexander,10,0,10,0
1667972167249,MATH 278C,A00,098051,Nie; Jiawang,8,0,10,2
1667972167674,MATH 280B,A00,098052,Zheng; Tianyi,11,0,15,4
1667972168096,MATH 281B,A00,098053,Bradic; Jelena,4,0,15,11
1667972168531,MATH 282B,A00,098054,Arias-Castro; Ery,2,0,15,13
1667972168957,MATH 285,A00,098055,Fitzsimmons; Patrick J,0,0,15,17
1667972169384,MATH 287B,A00,098056,Arias-Castro; Ery,5,0,15,10
1667972169808,MATH 288,A00,098057,Agarwal; Pooja,9,0,10,1
1667972169808,MATH 288,B00,098058,Zhang; Danna,9,0,10,1
1667972169808,MATH 288,C00,098059,Williams; Ruth J,10,0,10,0
1667972170231,MATH 290B,A00,098060,Roberts; Justin Deritter,14,0,15,1
1667972170653,MATH 292,A00,098061,Belmont; Eva Kinoshita,10,0,10,0
1667972171088,MATH 295,A00,098062,Suk; Andrew Hoon,48,0,50,2
1667972171514,MATH 296,A00,098063,Novak; Jonathan I,20,0,20,0
1667972171940,MATH 297,001,098064,Gamst; Anthony Collins,9997,0,9999,2
1667972671299,COGS 205,A00,101395,Chiba; Andrea,19,0,20,1
1667972671726,COGS 210B,001,101404,Greene; Deanna Jacquelyn,9998,0,9999,1
1667972671726,COGS 210B,002,101417,Xia; Haijun,9999,0,9999,0
1667972671726,COGS 210B,003,101422,Nitz; Douglas A.,9999,0,9999,0
1667972671726,COGS 210B,004,101423,Hollan; James D.,9998,0,9999,1
1667972671726,COGS 210B,005,101424,Deak; Gedeon O.,9999,0,9999,0
1667972671726,COGS 210B,006,101425,Rossano; Federico,9999,0,9999,0
1667972672149,COGS 211B,A00,101427,Coulson; Seana M,9997,0,9999,2
1667972672575,COGS 220,A00,101428,Hollan; James D.,0,0,25,25
1667972672997,COGS 229,A00,101429,Dow; Steven P,18,0,25,7
1667972673423,COGS 230,A00,101430,Klemmer; Scott R,13,0,17,4
1667972673848,COGS 234,A00,101431,Xia; Haijun,7,0,25,18
1667972674272,COGS 260,A00,101432,Kiyonaga; Anastasia,20,0,25,5
1667972674272,COGS 260,B00,101433,Kirsh; David Joel,16,0,25,9
1667972674698,CSE 202,A00,102371,Impagliazzo; Russell,0,0,0,0
1667972675125,CSE 203B,A01,102373,Cheng; Chung Kuan,0,0,0,0
1667972675549,CSE 208,A00,102374,Micciancio; Daniele,0,0,0,0
1667972675974,CSE 209A,A00,112895,Impagliazzo; Russell,0,0,15,15
1667972676407,CSE 209B,A00,108005,Bellare; Mihir,0,0,0,0
1667972676833,CSE 210,A00,113163,Coblenz; Michael J,0,0,0,0
1667972677258,CSE 219,A00,106111,Dow; Steven P,0,0,20,20
1667972677681,CSE 221,A00,102376,Voelker; Geoffrey M.,0,0,0,0
1667972678106,CSE 224,A01,102378,Porter; George M,0,0,0,0
1667972678528,CSE 229A,A00,102379,Savage; Stefan,0,0,0,0
1667972678953,CSE 229C,A00,102380,Munyaka; Imani N. S.,0,0,0,0
1667972679376,CSE 232B,A00,102382,Deutsch; Alin Bernard,0,0,0,0
1667972679798,CSE 234,A01,112904,Kumar; Arun Kumar,0,0,0,0
1667972680222,CSE 237A,A00,102383,Rosing; Tajana Simunic,0,0,0,0
1667972680646,CSE 239A,A00,102384,Deutsch; Alin Bernard,0,0,0,0
1667972681068,CSE 239B,A00,102385,Polikarpova; Nadezhda,0,0,0,0
1667972681497,CSE 240A,A00,102386,Pannuto; Patrick William,0,0,0,0
1667972681925,CSE 240B,A00,102387,Zhao; Jishen,0,0,0,0
1667972682349,CSE 241A,A00,106406,Kang; Mingu,0,0,0,0
1667972682775,CSE 249B,A00,102388,Kahng; Andrew Byun,0,0,8,8
1667972683201,CSE 251B,A01,102392,Cottrell; Garrison W,0,0,0,0
1667972683201,CSE 251B,A02,102393,Cottrell; Garrison W,0,0,0,0
1667972683626,CSE 252B,A00,102394,Ochoa; Benjamin Lawrence,0,0,0,0
1667972684049,CSE 257,A01,102396,Gao; Sicun,0,0,0,0
1667972684472,CSE 272,A00,102397,Li; Tzumao,0,0,0,0
1667972684895,CSE 274,A00,111323,Chern; Albert Ren-Haur,0,0,0,0
1667972685398,CSE 282,A00,102398,Pevzner; Pavel Arkadjevich,0,0,0,0
1667972685827,CSE 284,A00,114175,Gymrek; Melissa Ann,0,0,0,0
1667972686255,CSE 290,A00,102399,Chandraker; Manmohan Krishna,0,0,0,0
1667972686255,CSE 290,B00,102400,Vaccaro; Kristen Marie,0,0,25,25
1667972686255,CSE 290,C00,102414,Pannuto; Patrick William,0,0,25,25
1667972686255,CSE 290,D00,102427,Pevzner; Pavel Arkadjevich,0,0,0,0
1667972686255,CSE 290,E00,102429,Zhao; Jishen,0,0,0,0
1667972686255,CSE 290,F00,102436,Tullsen; Dean Michael,0,0,0,0
1667972686255,CSE 290,G00,102440,Christensen; Henrik I,0,0,20,20
1667972686692,CSE 291,A00,102443,Su; Hao,0,0,0,0
1667972686692,CSE 291,B00,102448,Polikarpova; Nadezhda,0,0,0,0
1667972686692,CSE 291,C00,102453,Vaccaro; Kristen Marie,0,0,0,0
1667972686692,CSE 291,D00,111343,Savage; Stefan,0,0,0,0
1667972686692,CSE 291,E00,116474,Claffy; Kimberly Claire,0,0,0,0
1667972686692,CSE 291,F00,116479,Pasquale; Joseph,0,0,0,0
1667972687118,CSE 293,001,119111,Bafna; Vineet,9999,0,9999,0
1667972687118,CSE 293,002,119118,Bellare; Mihir,9999,0,9999,0
1667972687118,CSE 293,003,119122,Berg-Kirkpatrick; Taylor D,9999,0,9999,0
1667972687118,CSE 293,004,119135,Christensen; Henrik I,9999,0,9999,0
1667972687118,CSE 293,005,119142,Cottrell; Garrison W,9999,0,9999,0
1667972687118,CSE 293,006,119146,Deutsch; Alin Bernard,9999,0,9999,0
1667972687118,CSE 293,007,119159,Esmaeilzadeh; Hadi,9999,0,9999,0
1667972687118,CSE 293,008,119166,Freund; Yoav,9999,0,9999,0
1667972687118,CSE 293,009,119170,Griswold; William G.,9999,0,9999,0
1667972687118,CSE 293,010,119183,Gymrek; Melissa Ann,9999,0,9999,0
1667972687118,CSE 293,011,119190,Heninger; Nadia A,9999,0,9999,0
1667972687118,CSE 293,012,119230,Impagliazzo; Russell,9999,0,9999,0
1667972687118,CSE 293,013,119232,Jhala; Ranjit,9999,0,9999,0
1667972687118,CSE 293,014,119233,Kahng; Andrew Byun,9999,0,9999,0
1667972687118,CSE 293,015,119298,Kane; Daniel Mertz,9999,0,9999,0
1667972687118,CSE 293,016,119299,Kriegman; David J,9999,0,9999,0
1667972687118,CSE 293,017,119300,Kumar; Arun Kumar,9999,0,9999,0
1667972687118,CSE 293,018,119301,Lerner; Sorin,9999,0,9999,0
1667972687118,CSE 293,019,119302,Lovett; Shachar,9999,0,9999,0
1667972687118,CSE 293,020,119303,McAuley; Julian John,9999,0,9999,0
1667972687118,CSE 293,021,119304,Micciancio; Daniele,9999,0,9999,0
1667972687118,CSE 293,022,119367,Orailoglu; Alex,9999,0,9999,0
1667972687118,CSE 293,023,119382,Paturi; Ramamohan,9999,0,9999,0
1667972687118,CSE 293,024,119404,Polikarpova; Nadezhda,9999,0,9999,0
1667972687118,CSE 293,025,119406,Politz; Joseph Gibbs,9999,0,9999,0
1667972687118,CSE 293,026,119411,Porter; George M,9999,0,9999,0
1667972687118,CSE 293,027,119414,Porter; Leonard Emerson,9999,0,9999,0
1667972687118,CSE 293,028,119416,Ramamoorthi; Ravi,9999,0,9999,0
1667972687118,CSE 293,029,119417,Sahoo; Debashis,9999,0,9999,0
1667972687118,CSE 293,030,119420,Saul; Lawrence,9999,0,9999,0
1667972687118,CSE 293,031,119421,Savage; Stefan,9999,0,9999,0
1667972687118,CSE 293,032,119425,Schulze; Jurgen P.,9999,0,9999,0
1667972687118,CSE 293,033,119426,Snoeren; Alex C.,9999,0,9999,0
1667972687118,CSE 293,034,119428,Shang; Jingbo,9999,0,9999,0
1667972687118,CSE 293,035,119430,Stefan; Deian,9999,0,9999,0
1667972687118,CSE 293,036,119431,Su; Hao,9999,0,9999,0
1667972687118,CSE 293,037,119433,Swanson; Steven James,9999,0,9999,0
1667972687118,CSE 293,038,119435,Tullsen; Dean Michael,9999,0,9999,0
1667972687118,CSE 293,039,119483,Voelker; Geoffrey M.,9999,0,9999,0
1667972687118,CSE 293,040,119537,Zhao; Jishen,9999,0,9999,0
1667972687118,CSE 293,041,119538,Zhou; Yuan-Yuan,9999,0,9999,0
1667972687118,CSE 293,042,119539,Gao; Sicun,9999,0,9999,0
1667972687118,CSE 293,043,119540,Weibel; Nadir,9999,0,9999,0
1667972687118,CSE 293,044,119541,Gupta; Rajesh K.,9999,0,9999,0
1667972687540,CSE 294,A00,102459,Voelker; Geoffrey M.,0,0,0,0
1667972687540,CSE 294,B00,111322,Orailoglu; Alex,0,0,0,0
1667972687964,DSE 201,A00,096914,Deutsch; Alin Bernard,30,0,30,0
1667972688386,DSE 210,A00,096915,Dasgupta; Sanjoy,30,0,30,0
1667972688819,DSE 260A,A00,096916,Altintas De Callaf; Ilkay,30,0,30,0
1667972689251,ECE 200,001,103586,Antipa; Nicholas A,9999,0,9999,0
1667972689251,ECE 200,002,103587,Atanasov; Nikolay A.,9999,0,9999,0
1667972689251,ECE 200,003,103588,Bharadia; Dinesh,9999,0,9999,0
1667972689251,ECE 200,004,103589,Cheng; Chung Kuan,9999,0,9999,0
1667972689251,ECE 200,005,103590,Cosman; Pamela C.,9999,0,9999,0
1667972689251,ECE 200,006,103591,Dayeh; Shadi Ahmad,9999,0,9999,0
1667972689251,ECE 200,007,103592,Fainman; Yeshaiahu,9999,0,9999,0
1667972689251,ECE 200,008,103593,Ford; Joseph Earl,9999,0,9999,0
1667972689251,ECE 200,009,103594,Franceschetti; Massimo,9999,0,9999,0
1667972689251,ECE 200,010,103595,Fullerton; Eric E,9999,0,9999,0
1667972689251,ECE 200,011,103596,Galton; Ian A,9999,0,9999,0
1667972689251,ECE 200,012,103597,Gilja; Vikash,9999,0,9999,0
1667972689251,ECE 200,013,103598,Hall; Drew A.,9999,0,9999,0
1667972689251,ECE 200,014,103599,Hsueh; Tzu-Chien,9999,0,9999,0
1667972689251,ECE 200,015,103600,Javidi; Tara,9999,0,9999,0
1667972689251,ECE 200,016,103601,Kahng; Andrew Byun,9999,0,9999,0
1667972689251,ECE 200,017,103602,Kim; Young-Han,9999,0,9999,0
1667972689251,ECE 200,018,103603,Koushanfar; Farinaz,9999,0,9999,0
1667972689251,ECE 200,019,103604,Kuzum; Duygu,9999,0,9999,0
1667972689251,ECE 200,020,103605,Le; Hanh-Phuc,9999,0,9999,0
1667972689251,ECE 200,021,103606,Lin; Bill,9999,0,9999,0
1667972689251,ECE 200,022,103607,Liu; Zhaowei,9998,0,9999,1
1667972689251,ECE 200,023,103608,Lo; Yu-Hwa,9999,0,9999,0
1667972689251,ECE 200,024,103609,Lomakin; Vitaliy,9999,0,9999,0
1667972689251,ECE 200,025,103610,Mercier; Patrick Philip,9999,0,9999,0
1667972689251,ECE 200,026,103611,Meyer; Florian,9999,0,9999,0
1667972689251,ECE 200,027,103612,Milstein; Laurence B.,9999,0,9999,0
1667972689251,ECE 200,028,103613,Mir Arabbaygi; Siavash,9999,0,9999,0
1667972689251,ECE 200,029,103614,Mookherjea; Shayan,9999,0,9999,0
1667972689251,ECE 200,030,103615,Morris; Karcher William,9999,0,9999,0
1667972689251,ECE 200,031,103616,Ng; Tse Nga,9999,0,9999,0
1667972689251,ECE 200,032,103617,Nguyen; Truong Quang,9999,0,9999,0
1667972689251,ECE 200,033,103618,Nomura; Kenji,9999,0,9999,0
1667972689251,ECE 200,034,103619,Orlitsky; Alon,9999,0,9999,0
1667972689251,ECE 200,035,103620,Pal; Piya,9999,0,9999,0
1667972689251,ECE 200,036,103621,Papen; George C.,9999,0,9999,0
1667972689251,ECE 200,037,103622,Radic; Stojan,9999,0,9999,0
1667972689251,ECE 200,038,103623,Rao; Bhaskar D.,9999,0,9999,0
1667972689251,ECE 200,039,103624,Rao; Ramesh R,9999,0,9999,0
1667972689251,ECE 200,040,103625,Rebeiz; Gabriel,9999,0,9999,0
1667972689251,ECE 200,041,103626,Sanford; John R,9999,0,9999,0
1667972689251,ECE 200,042,103627,Siegel; Paul H.,9999,0,9999,0
1667972689251,ECE 200,043,103628,Sievenpiper; Daniel F.,9999,0,9999,0
1667972689251,ECE 200,044,103629,Sworder; David D.,9999,0,9999,0
1667972689251,ECE 200,045,103630,Taur; Yuan,9999,0,9999,0
1667972689251,ECE 200,046,103631,Touri; Behrouz,9999,0,9999,0
1667972689251,ECE 200,047,103632,Trivedi; Mohan M.,9999,0,9999,0
1667972689251,ECE 200,048,103633,Vasconcelos; Nuno,9999,0,9999,0
1667972689251,ECE 200,049,103634,Wang; Xiaolong,9999,0,9999,0
1667972689251,ECE 200,050,103635,Xie; Pengtao,9999,0,9999,0
1667972689251,ECE 200,051,103636,Yip; Michael,9999,0,9999,0
1667972689251,ECE 200,052,103637,Zeger; Kenneth A.,999,0,999,0
1667972689251,ECE 200,053,103638,Zhang; Xinyu,9999,0,9999,0
1667972689251,ECE 200,054,103639,Turakhia; Yatish Girish,9999,0,9999,0
1667972689251,ECE 200,055,103640,Kang; Mingu,9999,0,9999,0
1667972689251,ECE 200,056,103641,Shi; Yuanyuan,9999,0,9999,0
1667972689251,ECE 200,057,103642,Wang; Edward Jay,9999,0,9999,0
1667972689251,ECE 200,058,103643,Zheng; Yang,9999,0,9999,0
1667972689674,ECE 202,A00,103644,Kuzum; Duygu,0,0,0,0
1667972690100,ECE 212BN,A00,103646,Ng; Tse Nga,0,0,0,0
1667972690527,ECE 221,A00,111493,Staff,0,0,0,0
1667972690954,ECE 222B,A00,103647,Lomakin; Vitaliy,0,0,0,0
1667972691380,ECE 230B,A00,103648,Taur; Yuan,0,0,0,0
1667972691805,ECE 238B,A00,103649,Garay; Javier,0,0,0,0
1667972692227,ECE 240B,A00,112900,Fainman; Yeshaiahu,0,0,0,0
1667972692654,ECE 247A,A00,103650,Jokerst; Jesse Vincent,0,0,0,0
1667972693078,ECE 247B,A00,103651,Wang; Joseph,0,0,0,0
1667972693499,ECE 250,A00,103652,Siegel; Paul H.,0,0,0,0
1667972693926,ECE 251A,A00,103654,Rao; Bhaskar D.,0,0,0,0
1667972694348,ECE 257B,A00,103655,Bharadia; Dinesh,0,0,0,0
1667972694774,ECE 258A,A00,103656,Milstein; Laurence B.,0,0,0,0
1667972695205,ECE 260B,A00,103658,Kang; Mingu,0,0,0,0
1667972695630,ECE 264A,A00,103659,Galton; Ian A,0,0,0,0
1667972696055,ECE 265A,A00,103661,Gudem; Prasad S.S.,0,0,0,0
1667972696476,ECE 265D,A00,103662,Gudem; Prasad S.S.,0,0,0,0
1667972696898,ECE 268,A00,103663,Koushanfar; Farinaz,0,0,0,0
1667972697321,ECE 269,A01,103665,Pal; Piya,0,0,0,0
1667972697747,ECE 271B,A00,103666,Vasconcelos; Manuela,0,0,0,0
1667972698176,ECE 276A,A00,103667,Atanasov; Nikolay A.,0,0,0,0
1667972698599,ECE 277,A00,103668,An; Cheolhong,0,0,0,0
1667972699026,ECE 279,A00,117947,Hall; Drew A.,0,0,0,0
1667972699880,ECE 283,A00,103670,Hsueh; Tzu-Chien,0,0,0,0
1667972700323,ECE 284,A00,103671,Turakhia; Yatish Girish,0,0,0,0
1667972700751,ECE 285,A00,103672,Zheng; Yang,0,0,0,0
1667972700751,ECE 285,B00,103673,Sworder; David D.,0,0,0,0
1667972701174,ECE 287,A00,103676,Javidi; Tara,0,0,0,0
1667972701604,MATH 200B,A00,098023,Salehi Golsefidy; Alireza,14,0,15,1
1667972702027,MATH 202B,A00,098024,Rhoades; Brendon Patrick,12,0,15,3
1667972702455,MATH 203B,A00,098025,Oprea; Dragos N.,12,0,15,3
1667972702877,MATH 204B,A00,098026,Sorensen; Claus M,14,0,15,1
1667972703304,MATH 208,A00,098027,Izadi; Elham,7,0,10,3
1667972703724,MATH 209,A00,098028,Pollack; Aaron,10,0,10,0
1667972704150,MATH 211A,A00,112919,Rogalski; Daniel,9,0,10,1
1667972704579,MATH 211B,A00,112920,Seward; Brandon M.,9,0,10,1
1667972705008,MATH 218,A00,098029,Li; Bo,10,0,10,0
1667972705430,MATH 220B,A00,098030,Novak; Jonathan I,13,0,15,2
1667972705857,MATH 221A,A00,098031,Ebenfelt; Peter F,13,0,15,2
1667972706299,MATH 231B,A00,098032,Zlatos; Andrej,12,0,15,3
1667972706722,MATH 240B,A00,098033,Ni; Lei,10,0,15,5
1667972707149,MATH 243,A00,098034,Jekel; David Andrew,10,0,10,0
1667972707571,MATH 245A,A00,098035,Nie; Jiawang,0,0,15,16
1667972707994,MATH 248,A00,098036,Bejenaru; Ioan,10,0,10,0
1667972708420,MATH 250B,A00,098037,Spolaor; Luca,14,0,15,1
1667972708854,MATH 258,A00,098038,Ni; Lei,10,0,10,0
1667972709289,MATH 264B,A00,098041,Rhoades; Brendon Patrick,12,0,15,3
1667972709714,MATH 268,A00,098042,Buss; Samuel R,10,0,10,0
1667972710148,MATH 269,A00,098043,Rhoades; Brendon Patrick,10,0,10,0
1667972710573,MATH 270B,A00,098044,Li; Bo,11,0,15,4
1667972711000,MATH 272B,A00,098045,Holst; Michael J,13,0,15,2
1667972711425,MATH 273A,A00,098046,Tian; Xiaochuan,12,0,15,3
1667972711849,MATH 275,A01,098048,Tian; Xiaochuan,6,0,10,4
1667972712273,MATH 278A,A00,098049,Holst; Michael J,8,0,10,2
1667972712696,MATH 278B,A00,098050,Cloninger; Alexander,10,0,10,0
1667972713126,MATH 278C,A00,098051,Nie; Jiawang,8,0,10,2
1667972713551,MATH 280B,A00,098052,Zheng; Tianyi,11,0,15,4
1667972713975,MATH 281B,A00,098053,Bradic; Jelena,4,0,15,11
1667972714401,MATH 282B,A00,098054,Arias-Castro; Ery,2,0,15,13
1667972714842,MATH 285,A00,098055,Fitzsimmons; Patrick J,0,0,15,17
1667972715266,MATH 287B,A00,098056,Arias-Castro; Ery,5,0,15,10
1667972715697,MATH 288,A00,098057,Agarwal; Pooja,9,0,10,1
1667972715697,MATH 288,B00,098058,Zhang; Danna,9,0,10,1
1667972715697,MATH 288,C00,098059,Williams; Ruth J,10,0,10,0
1667972716121,MATH 290B,A00,098060,Roberts; Justin Deritter,14,0,15,1
1667972716548,MATH 292,A00,098061,Belmont; Eva Kinoshita,10,0,10,0
1667972716975,MATH 295,A00,098062,Suk; Andrew Hoon,48,0,50,2
1667972717410,MATH 296,A00,098063,Novak; Jonathan I,20,0,20,0
1667972717835,MATH 297,001,098064,Gamst; Anthony Collins,9997,0,9999,2
1667973216743,COGS 205,A00,101395,Chiba; Andrea,19,0,20,1
1667973217175,COGS 210B,001,101404,Greene; Deanna Jacquelyn,9998,0,9999,1
1667973217175,COGS 210B,002,101417,Xia; Haijun,9999,0,9999,0
1667973217175,COGS 210B,003,101422,Nitz; Douglas A.,9999,0,9999,0
1667973217175,COGS 210B,004,101423,Hollan; James D.,9998,0,9999,1
1667973217175,COGS 210B,005,101424,Deak; Gedeon O.,9999,0,9999,0
1667973217175,COGS 210B,006,101425,Rossano; Federico,9999,0,9999,0
1667973217600,COGS 211B,A00,101427,Coulson; Seana M,9997,0,9999,2
1667973218025,COGS 220,A00,101428,Hollan; James D.,0,0,25,25
1667973218448,COGS 229,A00,101429,Dow; Steven P,18,0,25,7
1667973218879,COGS 230,A00,101430,Klemmer; Scott R,13,0,17,4
1667973219300,COGS 234,A00,101431,Xia; Haijun,7,0,25,18
1667973219721,COGS 260,A00,101432,Kiyonaga; Anastasia,20,0,25,5
1667973219721,COGS 260,B00,101433,Kirsh; David Joel,16,0,25,9
1667973220247,CSE 202,A00,102371,Impagliazzo; Russell,0,0,0,0
1667973220669,CSE 203B,A01,102373,Cheng; Chung Kuan,0,0,0,0
1667973221094,CSE 208,A00,102374,Micciancio; Daniele,0,0,0,0
1667973221518,CSE 209A,A00,112895,Impagliazzo; Russell,0,0,15,15
1667973221942,CSE 209B,A00,108005,Bellare; Mihir,0,0,0,0
1667973222368,CSE 210,A00,113163,Coblenz; Michael J,0,0,0,0
1667973222790,CSE 219,A00,106111,Dow; Steven P,0,0,20,20
1667973223212,CSE 221,A00,102376,Voelker; Geoffrey M.,0,0,0,0
1667973223635,CSE 224,A01,102378,Porter; George M,0,0,0,0
1667973224058,CSE 229A,A00,102379,Savage; Stefan,0,0,0,0
1667973224484,CSE 229C,A00,102380,Munyaka; Imani N. S.,0,0,0,0
1667973224908,CSE 232B,A00,102382,Deutsch; Alin Bernard,0,0,0,0
1667973225334,CSE 234,A01,112904,Kumar; Arun Kumar,0,0,0,0
1667973225756,CSE 237A,A00,102383,Rosing; Tajana Simunic,0,0,0,0
1667973226178,CSE 239A,A00,102384,Deutsch; Alin Bernard,0,0,0,0
1667973226608,CSE 239B,A00,102385,Polikarpova; Nadezhda,0,0,0,0
1667973227035,CSE 240A,A00,102386,Pannuto; Patrick William,0,0,0,0
1667973227465,CSE 240B,A00,102387,Zhao; Jishen,0,0,0,0
1667973227890,CSE 241A,A00,106406,Kang; Mingu,0,0,0,0
1667973228313,CSE 249B,A00,102388,Kahng; Andrew Byun,0,0,8,8
1667973228737,CSE 251B,A01,102392,Cottrell; Garrison W,0,0,0,0
1667973228737,CSE 251B,A02,102393,Cottrell; Garrison W,0,0,0,0
1667973229163,CSE 252B,A00,102394,Ochoa; Benjamin Lawrence,0,0,0,0
1667973229587,CSE 257,A01,102396,Gao; Sicun,0,0,0,0
1667973230015,CSE 272,A00,102397,Li; Tzumao,0,0,0,0
1667973230437,CSE 274,A00,111323,Chern; Albert Ren-Haur,0,0,0,0
1667973230860,CSE 282,A00,102398,Pevzner; Pavel Arkadjevich,0,0,0,0
1667973231291,CSE 284,A00,114175,Gymrek; Melissa Ann,0,0,0,0
1667973231713,CSE 290,A00,102399,Chandraker; Manmohan Krishna,0,0,0,0
1667973231713,CSE 290,B00,102400,Vaccaro; Kristen Marie,0,0,25,25
1667973231713,CSE 290,C00,102414,Pannuto; Patrick William,0,0,25,25
1667973231713,CSE 290,D00,102427,Pevzner; Pavel Arkadjevich,0,0,0,0
1667973231713,CSE 290,E00,102429,Zhao; Jishen,0,0,0,0
1667973231713,CSE 290,F00,102436,Tullsen; Dean Michael,0,0,0,0
1667973231713,CSE 290,G00,102440,Christensen; Henrik I,0,0,20,20
1667973232135,CSE 291,A00,102443,Su; Hao,0,0,0,0
1667973232135,CSE 291,B00,102448,Polikarpova; Nadezhda,0,0,0,0
1667973232135,CSE 291,C00,102453,Vaccaro; Kristen Marie,0,0,0,0
1667973232135,CSE 291,D00,111343,Savage; Stefan,0,0,0,0
1667973232135,CSE 291,E00,116474,Claffy; Kimberly Claire,0,0,0,0
1667973232135,CSE 291,F00,116479,Pasquale; Joseph,0,0,0,0
1667973232569,CSE 293,001,119111,Bafna; Vineet,9999,0,9999,0
1667973232569,CSE 293,002,119118,Bellare; Mihir,9999,0,9999,0
1667973232569,CSE 293,003,119122,Berg-Kirkpatrick; Taylor D,9999,0,9999,0
1667973232569,CSE 293,004,119135,Christensen; Henrik I,9999,0,9999,0
1667973232569,CSE 293,005,119142,Cottrell; Garrison W,9999,0,9999,0
1667973232569,CSE 293,006,119146,Deutsch; Alin Bernard,9999,0,9999,0
1667973232569,CSE 293,007,119159,Esmaeilzadeh; Hadi,9999,0,9999,0
1667973232569,CSE 293,008,119166,Freund; Yoav,9999,0,9999,0
1667973232569,CSE 293,009,119170,Griswold; William G.,9999,0,9999,0
1667973232569,CSE 293,010,119183,Gymrek; Melissa Ann,9999,0,9999,0
1667973232569,CSE 293,011,119190,Heninger; Nadia A,9999,0,9999,0
1667973232569,CSE 293,012,119230,Impagliazzo; Russell,9999,0,9999,0
1667973232569,CSE 293,013,119232,Jhala; Ranjit,9999,0,9999,0
1667973232569,CSE 293,014,119233,Kahng; Andrew Byun,9999,0,9999,0
1667973232569,CSE 293,015,119298,Kane; Daniel Mertz,9999,0,9999,0
1667973232569,CSE 293,016,119299,Kriegman; David J,9999,0,9999,0
1667973232569,CSE 293,017,119300,Kumar; Arun Kumar,9999,0,9999,0
1667973232569,CSE 293,018,119301,Lerner; Sorin,9999,0,9999,0
1667973232569,CSE 293,019,119302,Lovett; Shachar,9999,0,9999,0
1667973232569,CSE 293,020,119303,McAuley; Julian John,9999,0,9999,0
1667973232569,CSE 293,021,119304,Micciancio; Daniele,9999,0,9999,0
1667973232569,CSE 293,022,119367,Orailoglu; Alex,9999,0,9999,0
1667973232569,CSE 293,023,119382,Paturi; Ramamohan,9999,0,9999,0
1667973232569,CSE 293,024,119404,Polikarpova; Nadezhda,9999,0,9999,0
1667973232569,CSE 293,025,119406,Politz; Joseph Gibbs,9999,0,9999,0
1667973232569,CSE 293,026,119411,Porter; George M,9999,0,9999,0
1667973232569,CSE 293,027,119414,Porter; Leonard Emerson,9999,0,9999,0
1667973232569,CSE 293,028,119416,Ramamoorthi; Ravi,9999,0,9999,0
1667973232569,CSE 293,029,119417,Sahoo; Debashis,9999,0,9999,0
1667973232569,CSE 293,030,119420,Saul; Lawrence,9999,0,9999,0
1667973232569,CSE 293,031,119421,Savage; Stefan,9999,0,9999,0
1667973232569,CSE 293,032,119425,Schulze; Jurgen P.,9999,0,9999,0
1667973232569,CSE 293,033,119426,Snoeren; Alex C.,9999,0,9999,0
1667973232569,CSE 293,034,119428,Shang; Jingbo,9999,0,9999,0
1667973232569,CSE 293,035,119430,Stefan; Deian,9999,0,9999,0
1667973232569,CSE 293,036,119431,Su; Hao,9999,0,9999,0
1667973232569,CSE 293,037,119433,Swanson; Steven James,9999,0,9999,0
1667973232569,CSE 293,038,119435,Tullsen; Dean Michael,9999,0,9999,0
1667973232569,CSE 293,039,119483,Voelker; Geoffrey M.,9999,0,9999,0
1667973232569,CSE 293,040,119537,Zhao; Jishen,9999,0,9999,0
1667973232569,CSE 293,041,119538,Zhou; Yuan-Yuan,9999,0,9999,0
1667973232569,CSE 293,042,119539,Gao; Sicun,9999,0,9999,0
1667973232569,CSE 293,043,119540,Weibel; Nadir,9999,0,9999,0
1667973232569,CSE 293,044,119541,Gupta; Rajesh K.,9999,0,9999,0
1667973232995,CSE 294,A00,102459,Voelker; Geoffrey M.,0,0,0,0
1667973232995,CSE 294,B00,111322,Orailoglu; Alex,0,0,0,0
1667973233419,DSE 201,A00,096914,Deutsch; Alin Bernard,30,0,30,0
1667973233847,DSE 210,A00,096915,Dasgupta; Sanjoy,30,0,30,0
1667973234269,DSE 260A,A00,096916,Altintas De Callaf; Ilkay,30,0,30,0
1667973234696,ECE 200,001,103586,Antipa; Nicholas A,9999,0,9999,0
1667973234696,ECE 200,002,103587,Atanasov; Nikolay A.,9999,0,9999,0
1667973234696,ECE 200,003,103588,Bharadia; Dinesh,9999,0,9999,0
1667973234696,ECE 200,004,103589,Cheng; Chung Kuan,9999,0,9999,0
1667973234696,ECE 200,005,103590,Cosman; Pamela C.,9999,0,9999,0
1667973234696,ECE 200,006,103591,Dayeh; Shadi Ahmad,9999,0,9999,0
1667973234696,ECE 200,007,103592,Fainman; Yeshaiahu,9999,0,9999,0
1667973234696,ECE 200,008,103593,Ford; Joseph Earl,9999,0,9999,0
1667973234696,ECE 200,009,103594,Franceschetti; Massimo,9999,0,9999,0
1667973234696,ECE 200,010,103595,Fullerton; Eric E,9999,0,9999,0
1667973234696,ECE 200,011,103596,Galton; Ian A,9999,0,9999,0
1667973234696,ECE 200,012,103597,Gilja; Vikash,9999,0,9999,0
1667973234696,ECE 200,013,103598,Hall; Drew A.,9999,0,9999,0
1667973234696,ECE 200,014,103599,Hsueh; Tzu-Chien,9999,0,9999,0
1667973234696,ECE 200,015,103600,Javidi; Tara,9999,0,9999,0
1667973234696,ECE 200,016,103601,Kahng; Andrew Byun,9999,0,9999,0
1667973234696,ECE 200,017,103602,Kim; Young-Han,9999,0,9999,0
1667973234696,ECE 200,018,103603,Koushanfar; Farinaz,9999,0,9999,0
1667973234696,ECE 200,019,103604,Kuzum; Duygu,9999,0,9999,0
1667973234696,ECE 200,020,103605,Le; Hanh-Phuc,9999,0,9999,0
1667973234696,ECE 200,021,103606,Lin; Bill,9999,0,9999,0
1667973234696,ECE 200,022,103607,Liu; Zhaowei,9998,0,9999,1
1667973234696,ECE 200,023,103608,Lo; Yu-Hwa,9999,0,9999,0
1667973234696,ECE 200,024,103609,Lomakin; Vitaliy,9999,0,9999,0
1667973234696,ECE 200,025,103610,Mercier; Patrick Philip,9999,0,9999,0
1667973234696,ECE 200,026,103611,Meyer; Florian,9999,0,9999,0
1667973234696,ECE 200,027,103612,Milstein; Laurence B.,9999,0,9999,0
1667973234696,ECE 200,028,103613,Mir Arabbaygi; Siavash,9999,0,9999,0
1667973234696,ECE 200,029,103614,Mookherjea; Shayan,9999,0,9999,0
1667973234696,ECE 200,030,103615,Morris; Karcher William,9999,0,9999,0
1667973234696,ECE 200,031,103616,Ng; Tse Nga,9999,0,9999,0
1667973234696,ECE 200,032,103617,Nguyen; Truong Quang,9999,0,9999,0
1667973234696,ECE 200,033,103618,Nomura; Kenji,9999,0,9999,0
1667973234696,ECE 200,034,103619,Orlitsky; Alon,9999,0,9999,0
1667973234696,ECE 200,035,103620,Pal; Piya,9999,0,9999,0
1667973234696,ECE 200,036,103621,Papen; George C.,9999,0,9999,0
1667973234696,ECE 200,037,103622,Radic; Stojan,9999,0,9999,0
1667973234696,ECE 200,038,103623,Rao; Bhaskar D.,9999,0,9999,0
1667973234696,ECE 200,039,103624,Rao; Ramesh R,9999,0,9999,0
1667973234696,ECE 200,040,103625,Rebeiz; Gabriel,9999,0,9999,0
1667973234696,ECE 200,041,103626,Sanford; John R,9999,0,9999,0
1667973234696,ECE 200,042,103627,Siegel; Paul H.,9999,0,9999,0
1667973234696,ECE 200,043,103628,Sievenpiper; Daniel F.,9999,0,9999,0
1667973234696,ECE 200,044,103629,Sworder; David D.,9999,0,9999,0
1667973234696,ECE 200,045,103630,Taur; Yuan,9999,0,9999,0
1667973234696,ECE 200,046,103631,Touri; Behrouz,9999,0,9999,0
1667973234696,ECE 200,047,103632,Trivedi; Mohan M.,9999,0,9999,0
1667973234696,ECE 200,048,103633,Vasconcelos; Nuno,9999,0,9999,0
1667973234696,ECE 200,049,103634,Wang; Xiaolong,9999,0,9999,0
1667973234696,ECE 200,050,103635,Xie; Pengtao,9999,0,9999,0
1667973234696,ECE 200,051,103636,Yip; Michael,9999,0,9999,0
1667973234696,ECE 200,052,103637,Zeger; Kenneth A.,999,0,999,0
1667973234696,ECE 200,053,103638,Zhang; Xinyu,9999,0,9999,0
1667973234696,ECE 200,054,103639,Turakhia; Yatish Girish,9999,0,9999,0
1667973234696,ECE 200,055,103640,Kang; Mingu,9999,0,9999,0
1667973234696,ECE 200,056,103641,Shi; Yuanyuan,9999,0,9999,0
1667973234696,ECE 200,057,103642,Wang; Edward Jay,9999,0,9999,0
1667973234696,ECE 200,058,103643,Zheng; Yang,9999,0,9999,0
1667973235118,ECE 202,A00,103644,Kuzum; Duygu,0,0,0,0
1667973235544,ECE 212BN,A00,103646,Ng; Tse Nga,0,0,0,0
1667973235975,ECE 221,A00,111493,Staff,0,0,0,0
1667973236398,ECE 222B,A00,103647,Lomakin; Vitaliy,0,0,0,0
1667973236834,ECE 230B,A00,103648,Taur; Yuan,0,0,0,0
1667973237257,ECE 238B,A00,103649,Garay; Javier,0,0,0,0
1667973237679,ECE 240B,A00,112900,Fainman; Yeshaiahu,0,0,0,0
1667973238104,ECE 247A,A00,103650,Jokerst; Jesse Vincent,0,0,0,0
1667973238528,ECE 247B,A00,103651,Wang; Joseph,0,0,0,0
1667973238955,ECE 250,A00,103652,Siegel; Paul H.,0,0,0,0
1667973239380,ECE 251A,A00,103654,Rao; Bhaskar D.,0,0,0,0
1667973239803,ECE 257B,A00,103655,Bharadia; Dinesh,0,0,0,0
1667973240227,ECE 258A,A00,103656,Milstein; Laurence B.,0,0,0,0
1667973240654,ECE 260B,A00,103658,Kang; Mingu,0,0,0,0
1667973241084,ECE 264A,A00,103659,Galton; Ian A,0,0,0,0
1667973241512,ECE 265A,A00,103661,Gudem; Prasad S.S.,0,0,0,0
1667973241936,ECE 265D,A00,103662,Gudem; Prasad S.S.,0,0,0,0
1667973242367,ECE 268,A00,103663,Koushanfar; Farinaz,0,0,0,0
1667973242791,ECE 269,A01,103665,Pal; Piya,0,0,0,0
1667973243217,ECE 271B,A00,103666,Vasconcelos; Manuela,0,0,0,0
1667973243639,ECE 276A,A00,103667,Atanasov; Nikolay A.,0,0,0,0
1667973244065,ECE 277,A00,103668,An; Cheolhong,0,0,0,0
1667973244489,ECE 279,A00,117947,Hall; Drew A.,0,0,0,0
1667973245339,ECE 283,A00,103670,Hsueh; Tzu-Chien,0,0,0,0
1667973245765,ECE 284,A00,103671,Turakhia; Yatish Girish,0,0,0,0
1667973246196,ECE 285,A00,103672,Zheng; Yang,0,0,0,0
1667973246196,ECE 285,B00,103673,Sworder; David D.,0,0,0,0
1667973246619,ECE 287,A00,103676,Javidi; Tara,0,0,0,0
1667973247042,MATH 200B,A00,098023,Salehi Golsefidy; Alireza,14,0,15,1
1667973247568,MATH 202B,A00,098024,Rhoades; Brendon Patrick,12,0,15,3
1667973247992,MATH 203B,A00,098025,Oprea; Dragos N.,12,0,15,3
1667973248425,MATH 204B,A00,098026,Sorensen; Claus M,14,0,15,1
1667973248848,MATH 208,A00,098027,Izadi; Elham,7,0,10,3
1667973249271,MATH 209,A00,098028,Pollack; Aaron,10,0,10,0
1667973249691,MATH 211A,A00,112919,Rogalski; Daniel,9,0,10,1
1667973250117,MATH 211B,A00,112920,Seward; Brandon M.,9,0,10,1
1667973250539,MATH 218,A00,098029,Li; Bo,10,0,10,0
1667973250964,MATH 220B,A00,098030,Novak; Jonathan I,13,0,15,2
1667973251394,MATH 221A,A00,098031,Ebenfelt; Peter F,13,0,15,2
1667973251820,MATH 231B,A00,098032,Zlatos; Andrej,12,0,15,3
1667973252242,MATH 240B,A00,098033,Ni; Lei,10,0,15,5
1667973252668,MATH 243,A00,098034,Jekel; David Andrew,10,0,10,0
1667973253092,MATH 245A,A00,098035,Nie; Jiawang,0,0,15,16
1667973253516,MATH 248,A00,098036,Bejenaru; Ioan,10,0,10,0
1667973253938,MATH 250B,A00,098037,Spolaor; Luca,14,0,15,1
1667973254362,MATH 258,A00,098038,Ni; Lei,10,0,10,0
1667973254787,MATH 264B,A00,098041,Rhoades; Brendon Patrick,12,0,15,3
1667973255216,MATH 268,A00,098042,Buss; Samuel R,10,0,10,0
1667973255636,MATH 269,A00,098043,Rhoades; Brendon Patrick,10,0,10,0
1667973256060,MATH 270B,A00,098044,Li; Bo,11,0,15,4
1667973256483,MATH 272B,A00,098045,Holst; Michael J,13,0,15,2
1667973256907,MATH 273A,A00,098046,Tian; Xiaochuan,12,0,15,3
1667973257334,MATH 275,A01,098048,Tian; Xiaochuan,6,0,10,4
1667973257758,MATH 278A,A00,098049,Holst; Michael J,8,0,10,2
1667973258183,MATH 278B,A00,098050,Cloninger; Alexander,10,0,10,0
1667973258606,MATH 278C,A00,098051,Nie; Jiawang,8,0,10,2
1667973259030,MATH 280B,A00,098052,Zheng; Tianyi,11,0,15,4
1667973259459,MATH 281B,A00,098053,Bradic; Jelena,4,0,15,11
1667973259891,MATH 282B,A00,098054,Arias-Castro; Ery,2,0,15,13
1667973260313,MATH 285,A00,098055,Fitzsimmons; Patrick J,0,0,15,17
1667973260740,MATH 287B,A00,098056,Arias-Castro; Ery,5,0,15,10
1667973261163,MATH 288,A00,098057,Agarwal; Pooja,9,0,10,1
1667973261163,MATH 288,B00,098058,Zhang; Danna,9,0,10,1
1667973261163,MATH 288,C00,098059,Williams; Ruth J,10,0,10,0
1667973261586,MATH 290B,A00,098060,Roberts; Justin Deritter,14,0,15,1
1667973262009,MATH 292,A00,098061,Belmont; Eva Kinoshita,10,0,10,0
1667973262430,MATH 295,A00,098062,Suk; Andrew Hoon,48,0,50,2
1667973262858,MATH 296,A00,098063,Novak; Jonathan I,20,0,20,0
1667973263281,MATH 297,001,098064,Gamst; Anthony Collins,9997,0,9999,2
1667973762916,COGS 205,A00,101395,Chiba; Andrea,19,0,20,1
1667973763345,COGS 210B,001,101404,Greene; Deanna Jacquelyn,9998,0,9999,1
1667973763345,COGS 210B,002,101417,Xia; Haijun,9999,0,9999,0
1667973763345,COGS 210B,003,101422,Nitz; Douglas A.,9999,0,9999,0
1667973763345,COGS 210B,004,101423,Hollan; James D.,9998,0,9999,1
1667973763345,COGS 210B,005,101424,Deak; Gedeon O.,9999,0,9999,0
1667973763345,COGS 210B,006,101425,Rossano; Federico,9999,0,9999,0
1667973763769,COGS 211B,A00,101427,Coulson; Seana M,9997,0,9999,2
1667973764193,COGS 220,A00,101428,Hollan; James D.,0,0,25,25
1667973764619,COGS 229,A00,101429,Dow; Steven P,18,0,25,7
1667973765045,COGS 230,A00,101430,Klemmer; Scott R,13,0,17,4
1667973765466,COGS 234,A00,101431,Xia; Haijun,7,0,25,18
1667973765889,COGS 260,A00,101432,Kiyonaga; Anastasia,20,0,25,5
1667973765889,COGS 260,B00,101433,Kirsh; David Joel,16,0,25,9
1667973766321,CSE 202,A00,102371,Impagliazzo; Russell,0,0,0,0
1667973766745,CSE 203B,A01,102373,Cheng; Chung Kuan,0,0,0,0
1667973767267,CSE 208,A00,102374,Micciancio; Daniele,0,0,0,0
1667973767697,CSE 209A,A00,112895,Impagliazzo; Russell,0,0,15,15
1667973768120,CSE 209B,A00,108005,Bellare; Mihir,0,0,0,0
1667973768545,CSE 210,A00,113163,Coblenz; Michael J,0,0,0,0
1667973768974,CSE 219,A00,106111,Dow; Steven P,0,0,20,20
1667973769397,CSE 221,A00,102376,Voelker; Geoffrey M.,0,0,0,0
1667973769829,CSE 224,A01,102378,Porter; George M,0,0,0,0
1667973770254,CSE 229A,A00,102379,Savage; Stefan,0,0,0,0
1667973770676,CSE 229C,A00,102380,Munyaka; Imani N. S.,0,0,0,0
1667973771106,CSE 232B,A00,102382,Deutsch; Alin Bernard,0,0,0,0
1667973771533,CSE 234,A01,112904,Kumar; Arun Kumar,0,0,0,0
1667973771954,CSE 237A,A00,102383,Rosing; Tajana Simunic,0,0,0,0
1667973772380,CSE 239A,A00,102384,Deutsch; Alin Bernard,0,0,0,0
1667973772806,CSE 239B,A00,102385,Polikarpova; Nadezhda,0,0,0,0
1667973773231,CSE 240A,A00,102386,Pannuto; Patrick William,0,0,0,0
1667973773656,CSE 240B,A00,102387,Zhao; Jishen,0,0,0,0
1667973774098,CSE 241A,A00,106406,Kang; Mingu,0,0,0,0
1667973774522,CSE 249B,A00,102388,Kahng; Andrew Byun,0,0,8,8
1667973774951,CSE 251B,A01,102392,Cottrell; Garrison W,0,0,0,0
1667973774951,CSE 251B,A02,102393,Cottrell; Garrison W,0,0,0,0
1667973775377,CSE 252B,A00,102394,Ochoa; Benjamin Lawrence,0,0,0,0
1667973775803,CSE 257,A01,102396,Gao; Sicun,0,0,0,0
1667973776225,CSE 272,A00,102397,Li; Tzumao,0,0,0,0
1667973776651,CSE 274,A00,111323,Chern; Albert Ren-Haur,0,0,0,0
1667973777079,CSE 282,A00,102398,Pevzner; Pavel Arkadjevich,0,0,0,0
1667973777502,CSE 284,A00,114175,Gymrek; Melissa Ann,0,0,0,0
1667973777930,CSE 290,A00,102399,Chandraker; Manmohan Krishna,0,0,0,0
1667973777930,CSE 290,B00,102400,Vaccaro; Kristen Marie,0,0,25,25
1667973777930,CSE 290,C00,102414,Pannuto; Patrick William,0,0,25,25
1667973777930,CSE 290,D00,102427,Pevzner; Pavel Arkadjevich,0,0,0,0
1667973777930,CSE 290,E00,102429,Zhao; Jishen,0,0,0,0
1667973777930,CSE 290,F00,102436,Tullsen; Dean Michael,0,0,0,0
1667973777930,CSE 290,G00,102440,Christensen; Henrik I,0,0,20,20
1667973778357,CSE 291,A00,102443,Su; Hao,0,0,0,0
1667973778357,CSE 291,B00,102448,Polikarpova; Nadezhda,0,0,0,0
1667973778357,CSE 291,C00,102453,Vaccaro; Kristen Marie,0,0,0,0
1667973778357,CSE 291,D00,111343,Savage; Stefan,0,0,0,0
1667973778357,CSE 291,E00,116474,Claffy; Kimberly Claire,0,0,0,0
1667973778357,CSE 291,F00,116479,Pasquale; Joseph,0,0,0,0
1667973778818,CSE 293,001,119111,Bafna; Vineet,9999,0,9999,0
1667973778818,CSE 293,002,119118,Bellare; Mihir,9999,0,9999,0
1667973778818,CSE 293,003,119122,Berg-Kirkpatrick; Taylor D,9999,0,9999,0
1667973778818,CSE 293,004,119135,Christensen; Henrik I,9999,0,9999,0
1667973778818,CSE 293,005,119142,Cottrell; Garrison W,9999,0,9999,0
1667973778818,CSE 293,006,119146,Deutsch; Alin Bernard,9999,0,9999,0
1667973778818,CSE 293,007,119159,Esmaeilzadeh; Hadi,9999,0,9999,0
1667973778818,CSE 293,008,119166,Freund; Yoav,9999,0,9999,0
1667973778818,CSE 293,009,119170,Griswold; William G.,9999,0,9999,0
1667973778818,CSE 293,010,119183,Gymrek; Melissa Ann,9999,0,9999,0
1667973778818,CSE 293,011,119190,Heninger; Nadia A,9999,0,9999,0
1667973778818,CSE 293,012,119230,Impagliazzo; Russell,9999,0,9999,0
1667973778818,CSE 293,013,119232,Jhala; Ranjit,9999,0,9999,0
1667973778818,CSE 293,014,119233,Kahng; Andrew Byun,9999,0,9999,0
1667973778818,CSE 293,015,119298,Kane; Daniel Mertz,9999,0,9999,0
1667973778818,CSE 293,016,119299,Kriegman; David J,9999,0,9999,0
1667973778818,CSE 293,017,119300,Kumar; Arun Kumar,9999,0,9999,0
1667973778818,CSE 293,018,119301,Lerner; Sorin,9999,0,9999,0
1667973778818,CSE 293,019,119302,Lovett; Shachar,9999,0,9999,0
1667973778818,CSE 293,020,119303,McAuley; Julian John,9999,0,9999,0
1667973778818,CSE 293,021,119304,Micciancio; Daniele,9999,0,9999,0
1667973778818,CSE 293,022,119367,Orailoglu; Alex,9999,0,9999,0
1667973778818,CSE 293,023,119382,Paturi; Ramamohan,9999,0,9999,0
1667973778818,CSE 293,024,119404,Polikarpova; Nadezhda,9999,0,9999,0
1667973778818,CSE 293,025,119406,Politz; Joseph Gibbs,9999,0,9999,0
1667973778818,CSE 293,026,119411,Porter; George M,9999,0,9999,0
1667973778818,CSE 293,027,119414,Porter; Leonard Emerson,9999,0,9999,0
1667973778818,CSE 293,028,119416,Ramamoorthi; Ravi,9999,0,9999,0
1667973778818,CSE 293,029,119417,Sahoo; Debashis,9999,0,9999,0
1667973778818,CSE 293,030,119420,Saul; Lawrence,9999,0,9999,0
1667973778818,CSE 293,031,119421,Savage; Stefan,9999,0,9999,0
1667973778818,CSE 293,032,119425,Schulze; Jurgen P.,9999,0,9999,0
1667973778818,CSE 293,033,119426,Snoeren; Alex C.,9999,0,9999,0
1667973778818,CSE 293,034,119428,Shang; Jingbo,9999,0,9999,0
1667973778818,CSE 293,035,119430,Stefan; Deian,9999,0,9999,0
1667973778818,CSE 293,036,119431,Su; Hao,9999,0,9999,0
1667973778818,CSE 293,037,119433,Swanson; Steven James,9999,0,9999,0
1667973778818,CSE 293,038,119435,Tullsen; Dean Michael,9999,0,9999,0
1667973778818,CSE 293,039,119483,Voelker; Geoffrey M.,9999,0,9999,0
1667973778818,CSE 293,040,119537,Zhao; Jishen,9999,0,9999,0
1667973778818,CSE 293,041,119538,Zhou; Yuan-Yuan,9999,0,9999,0
1667973778818,CSE 293,042,119539,Gao; Sicun,9999,0,9999,0
1667973778818,CSE 293,043,119540,Weibel; Nadir,9999,0,9999,0
1667973778818,CSE 293,044,119541,Gupta; Rajesh K.,9999,0,9999,0
1667973779243,CSE 294,A00,102459,Voelker; Geoffrey M.,0,0,0,0
1667973779243,CSE 294,B00,111322,Orailoglu; Alex,0,0,0,0
1667973779667,DSE 201,A00,096914,Deutsch; Alin Bernard,30,0,30,0
1667973780100,DSE 210,A00,096915,Dasgupta; Sanjoy,30,0,30,0
1667973780527,DSE 260A,A00,096916,Altintas De Callaf; Ilkay,30,0,30,0
1667973780970,ECE 200,001,103586,Antipa; Nicholas A,9999,0,9999,0
1667973780970,ECE 200,002,103587,Atanasov; Nikolay A.,9999,0,9999,0
1667973780970,ECE 200,003,103588,Bharadia; Dinesh,9999,0,9999,0
1667973780970,ECE 200,004,103589,Cheng; Chung Kuan,9999,0,9999,0
1667973780970,ECE 200,005,103590,Cosman; Pamela C.,9999,0,9999,0
1667973780970,ECE 200,006,103591,Dayeh; Shadi Ahmad,9999,0,9999,0
1667973780970,ECE 200,007,103592,Fainman; Yeshaiahu,9999,0,9999,0
1667973780970,ECE 200,008,103593,Ford; Joseph Earl,9999,0,9999,0
1667973780970,ECE 200,009,103594,Franceschetti; Massimo,9999,0,9999,0
1667973780970,ECE 200,010,103595,Fullerton; Eric E,9999,0,9999,0
1667973780970,ECE 200,011,103596,Galton; Ian A,9999,0,9999,0
1667973780970,ECE 200,012,103597,Gilja; Vikash,9999,0,9999,0
1667973780970,ECE 200,013,103598,Hall; Drew A.,9999,0,9999,0
1667973780970,ECE 200,014,103599,Hsueh; Tzu-Chien,9999,0,9999,0
1667973780970,ECE 200,015,103600,Javidi; Tara,9999,0,9999,0
1667973780970,ECE 200,016,103601,Kahng; Andrew Byun,9999,0,9999,0
1667973780970,ECE 200,017,103602,Kim; Young-Han,9999,0,9999,0
1667973780970,ECE 200,018,103603,Koushanfar; Farinaz,9999,0,9999,0
1667973780970,ECE 200,019,103604,Kuzum; Duygu,9999,0,9999,0
1667973780970,ECE 200,020,103605,Le; Hanh-Phuc,9999,0,9999,0
1667973780970,ECE 200,021,103606,Lin; Bill,9999,0,9999,0
1667973780970,ECE 200,022,103607,Liu; Zhaowei,9998,0,9999,1
1667973780970,ECE 200,023,103608,Lo; Yu-Hwa,9999,0,9999,0
1667973780970,ECE 200,024,103609,Lomakin; Vitaliy,9999,0,9999,0
1667973780970,ECE 200,025,103610,Mercier; Patrick Philip,9999,0,9999,0
1667973780970,ECE 200,026,103611,Meyer; Florian,9999,0,9999,0
1667973780970,ECE 200,027,103612,Milstein; Laurence B.,9999,0,9999,0
1667973780970,ECE 200,028,103613,Mir Arabbaygi; Siavash,9999,0,9999,0
1667973780970,ECE 200,029,103614,Mookherjea; Shayan,9999,0,9999,0
1667973780970,ECE 200,030,103615,Morris; Karcher William,9999,0,9999,0
1667973780970,ECE 200,031,103616,Ng; Tse Nga,9999,0,9999,0
1667973780970,ECE 200,032,103617,Nguyen; Truong Quang,9999,0,9999,0
1667973780970,ECE 200,033,103618,Nomura; Kenji,9999,0,9999,0
1667973780970,ECE 200,034,103619,Orlitsky; Alon,9999,0,9999,0
1667973780970,ECE 200,035,103620,Pal; Piya,9999,0,9999,0
1667973780970,ECE 200,036,103621,Papen; George C.,9999,0,9999,0
1667973780970,ECE 200,037,103622,Radic; Stojan,9999,0,9999,0
1667973780970,ECE 200,038,103623,Rao; Bhaskar D.,9999,0,9999,0
1667973780970,ECE 200,039,103624,Rao; Ramesh R,9999,0,9999,0
1667973780970,ECE 200,040,103625,Rebeiz; Gabriel,9999,0,9999,0
1667973780970,ECE 200,041,103626,Sanford; John R,9999,0,9999,0
1667973780970,ECE 200,042,103627,Siegel; Paul H.,9999,0,9999,0
1667973780970,ECE 200,043,103628,Sievenpiper; Daniel F.,9999,0,9999,0
1667973780970,ECE 200,044,103629,Sworder; David D.,9999,0,9999,0
1667973780970,ECE 200,045,103630,Taur; Yuan,9999,0,9999,0
1667973780970,ECE 200,046,103631,Touri; Behrouz,9999,0,9999,0
1667973780970,ECE 200,047,103632,Trivedi; Mohan M.,9999,0,9999,0
1667973780970,ECE 200,048,103633,Vasconcelos; Nuno,9999,0,9999,0
1667973780970,ECE 200,049,103634,Wang; Xiaolong,9999,0,9999,0
1667973780970,ECE 200,050,103635,Xie; Pengtao,9999,0,9999,0
1667973780970,ECE 200,051,103636,Yip; Michael,9999,0,9999,0
1667973780970,ECE 200,052,103637,Zeger; Kenneth A.,999,0,999,0
1667973780970,ECE 200,053,103638,Zhang; Xinyu,9999,0,9999,0
1667973780970,ECE 200,054,103639,Turakhia; Yatish Girish,9999,0,9999,0
1667973780970,ECE 200,055,103640,Kang; Mingu,9999,0,9999,0
1667973780970,ECE 200,056,103641,Shi; Yuanyuan,9999,0,9999,0
1667973780970,ECE 200,057,103642,Wang; Edward Jay,9999,0,9999,0
1667973780970,ECE 200,058,103643,Zheng; Yang,9999,0,9999,0
1667973781395,ECE 202,A00,103644,Kuzum; Duygu,0,0,0,0
1667973781823,ECE 212BN,A00,103646,Ng; Tse Nga,0,0,0,0
1667973782249,ECE 221,A00,111493,Staff,0,0,0,0
1667973782672,ECE 222B,A00,103647,Lomakin; Vitaliy,0,0,0,0
1667973783100,ECE 230B,A00,103648,Taur; Yuan,0,0,0,0
1667973783525,ECE 238B,A00,103649,Garay; Javier,0,0,0,0
1667973783948,ECE 240B,A00,112900,Fainman; Yeshaiahu,0,0,0,0
1667973784385,ECE 247A,A00,103650,Jokerst; Jesse Vincent,0,0,0,0
1667973784815,ECE 247B,A00,103651,Wang; Joseph,0,0,0,0
1667973785239,ECE 250,A00,103652,Siegel; Paul H.,0,0,0,0
1667973785667,ECE 251A,A00,103654,Rao; Bhaskar D.,0,0,0,0
1667973786093,ECE 257B,A00,103655,Bharadia; Dinesh,0,0,0,0
1667973786522,ECE 258A,A00,103656,Milstein; Laurence B.,0,0,0,0
1667973786973,ECE 260B,A00,103658,Kang; Mingu,0,0,0,0
1667973787395,ECE 264A,A00,103659,Galton; Ian A,0,0,0,0
1667973787819,ECE 265A,A00,103661,Gudem; Prasad S.S.,0,0,0,0
1667973788255,ECE 265D,A00,103662,Gudem; Prasad S.S.,0,0,0,0
1667973788682,ECE 268,A00,103663,Koushanfar; Farinaz,0,0,0,0
1667973789106,ECE 269,A01,103665,Pal; Piya,0,0,0,0
1667973789529,ECE 271B,A00,103666,Vasconcelos; Manuela,0,0,0,0
1667973789955,ECE 276A,A00,103667,Atanasov; Nikolay A.,0,0,0,0
1667973790385,ECE 277,A00,103668,An; Cheolhong,0,0,0,0
1667973790824,ECE 279,A00,117947,Hall; Drew A.,0,0,0,0
1667973791675,ECE 283,A00,103670,Hsueh; Tzu-Chien,0,0,0,0
1667973792097,ECE 284,A00,103671,Turakhia; Yatish Girish,0,0,0,0
1667973792532,ECE 285,A00,103672,Zheng; Yang,0,0,0,0
1667973792532,ECE 285,B00,103673,Sworder; David D.,0,0,0,0
1667973792958,ECE 287,A00,103676,Javidi; Tara,0,0,0,0
1667973793382,MATH 200B,A00,098023,Salehi Golsefidy; Alireza,14,0,15,1
1667973793809,MATH 202B,A00,098024,Rhoades; Brendon Patrick,12,0,15,3
1667973794244,MATH 203B,A00,098025,Oprea; Dragos N.,12,0,15,3
1667973794668,MATH 204B,A00,098026,Sorensen; Claus M,14,0,15,1
1667973795093,MATH 208,A00,098027,Izadi; Elham,7,0,10,3
1667973795516,MATH 209,A00,098028,Pollack; Aaron,10,0,10,0
1667973795945,MATH 211A,A00,112919,Rogalski; Daniel,9,0,10,1
1667973796376,MATH 211B,A00,112920,Seward; Brandon M.,9,0,10,1
1667973796798,MATH 218,A00,098029,Li; Bo,10,0,10,0
1667973797234,MATH 220B,A00,098030,Novak; Jonathan I,13,0,15,2
1667973797666,MATH 221A,A00,098031,Ebenfelt; Peter F,13,0,15,2
1667973798094,MATH 231B,A00,098032,Zlatos; Andrej,12,0,15,3
1667973798516,MATH 240B,A00,098033,Ni; Lei,10,0,15,5
1667973798948,MATH 243,A00,098034,Jekel; David Andrew,10,0,10,0
1667973799373,MATH 245A,A00,098035,Nie; Jiawang,0,0,15,16
1667973799798,MATH 248,A00,098036,Bejenaru; Ioan,10,0,10,0
1667973800223,MATH 250B,A00,098037,Spolaor; Luca,14,0,15,1
1667973800654,MATH 258,A00,098038,Ni; Lei,10,0,10,0
1667973801081,MATH 264B,A00,098041,Rhoades; Brendon Patrick,12,0,15,3
1667973801502,MATH 268,A00,098042,Buss; Samuel R,10,0,10,0
1667973801927,MATH 269,A00,098043,Rhoades; Brendon Patrick,10,0,10,0
1667973802351,MATH 270B,A00,098044,Li; Bo,11,0,15,4
1667973802789,MATH 272B,A00,098045,Holst; Michael J,13,0,15,2
1667973803214,MATH 273A,A00,098046,Tian; Xiaochuan,12,0,15,3
1667973803643,MATH 275,A01,098048,Tian; Xiaochuan,6,0,10,4
1667973804064,MATH 278A,A00,098049,Holst; Michael J,8,0,10,2
1667973804486,MATH 278B,A00,098050,Cloninger; Alexander,10,0,10,0
1667973804913,MATH 278C,A00,098051,Nie; Jiawang,8,0,10,2
1667973805345,MATH 280B,A00,098052,Zheng; Tianyi,11,0,15,4
1667973805786,MATH 281B,A00,098053,Bradic; Jelena,4,0,15,11
1667973806210,MATH 282B,A00,098054,Arias-Castro; Ery,2,0,15,13
1667973806635,MATH 285,A00,098055,Fitzsimmons; Patrick J,0,0,15,17
1667973807061,MATH 287B,A00,098056,Arias-Castro; Ery,5,0,15,10
1667973807490,MATH 288,A00,098057,Agarwal; Pooja,9,0,10,1
1667973807490,MATH 288,B00,098058,Zhang; Danna,9,0,10,1
1667973807490,MATH 288,C00,098059,Williams; Ruth J,10,0,10,0
1667973807919,MATH 290B,A00,098060,Roberts; Justin Deritter,14,0,15,1
1667973808350,MATH 292,A00,098061,Belmont; Eva Kinoshita,10,0,10,0
1667973808772,MATH 295,A00,098062,Suk; Andrew Hoon,48,0,50,2
1667973809194,MATH 296,A00,098063,Novak; Jonathan I,20,0,20,0
1667973809618,MATH 297,001,098064,Gamst; Anthony Collins,9997,0,9999,2
1667974309336,COGS 205,A00,101395,Chiba; Andrea,19,0,20,1
1667974309762,COGS 210B,001,101404,Greene; Deanna Jacquelyn,9998,0,9999,1
1667974309762,COGS 210B,002,101417,Xia; Haijun,9999,0,9999,0
1667974309762,COGS 210B,003,101422,Nitz; Douglas A.,9999,0,9999,0
1667974309762,COGS 210B,004,101423,Hollan; James D.,9998,0,9999,1
1667974309762,COGS 210B,005,101424,Deak; Gedeon O.,9999,0,9999,0
1667974309762,COGS 210B,006,101425,Rossano; Federico,9999,0,9999,0
1667974310191,COGS 211B,A00,101427,Coulson; Seana M,9997,0,9999,2
1667974310616,COGS 220,A00,101428,Hollan; James D.,0,0,25,25
1667974311044,COGS 229,A00,101429,Dow; Steven P,18,0,25,7
1667974311474,COGS 230,A00,101430,Klemmer; Scott R,13,0,17,4
1667974311901,COGS 234,A00,101431,Xia; Haijun,7,0,25,18
1667974312323,COGS 260,A00,101432,Kiyonaga; Anastasia,20,0,25,5
1667974312323,COGS 260,B00,101433,Kirsh; David Joel,16,0,25,9
1667974312747,CSE 202,A00,102371,Impagliazzo; Russell,0,0,0,0
1667974313177,CSE 203B,A01,102373,Cheng; Chung Kuan,0,0,0,0
1667974313607,CSE 208,A00,102374,Micciancio; Daniele,0,0,0,0
1667974314037,CSE 209A,A00,112895,Impagliazzo; Russell,0,0,15,15
1667974314461,CSE 209B,A00,108005,Bellare; Mihir,0,0,0,0
1667974314891,CSE 210,A00,113163,Coblenz; Michael J,0,0,0,0
1667974315324,CSE 219,A00,106111,Dow; Steven P,0,0,20,20
1667974315745,CSE 221,A00,102376,Voelker; Geoffrey M.,0,0,0,0
1667974316169,CSE 224,A01,102378,Porter; George M,0,0,0,0
1667974316595,CSE 229A,A00,102379,Savage; Stefan,0,0,0,0
1667974317021,CSE 229C,A00,102380,Munyaka; Imani N. S.,0,0,0,0
1667974317455,CSE 232B,A00,102382,Deutsch; Alin Bernard,0,0,0,0
1667974317883,CSE 234,A01,112904,Kumar; Arun Kumar,0,0,0,0
1667974318306,CSE 237A,A00,102383,Rosing; Tajana Simunic,0,0,0,0
1667974318736,CSE 239A,A00,102384,Deutsch; Alin Bernard,0,0,0,0
1667974319160,CSE 239B,A00,102385,Polikarpova; Nadezhda,0,0,0,0
1667974319584,CSE 240A,A00,102386,Pannuto; Patrick William,0,0,0,0
1667974320010,CSE 240B,A00,102387,Zhao; Jishen,0,0,0,0
1667974320436,CSE 241A,A00,106406,Kang; Mingu,0,0,0,0
1667974320858,CSE 249B,A00,102388,Kahng; Andrew Byun,0,0,8,8
1667974321284,CSE 251B,A01,102392,Cottrell; Garrison W,0,0,0,0
1667974321284,CSE 251B,A02,102393,Cottrell; Garrison W,0,0,0,0
1667974321709,CSE 252B,A00,102394,Ochoa; Benjamin Lawrence,0,0,0,0
1667974322134,CSE 257,A01,102396,Gao; Sicun,0,0,0,0
1667974322557,CSE 272,A00,102397,Li; Tzumao,0,0,0,0
1667974322979,CSE 274,A00,111323,Chern; Albert Ren-Haur,0,0,0,0
1667974323404,CSE 282,A00,102398,Pevzner; Pavel Arkadjevich,0,0,0,0
1667974323826,CSE 284,A00,114175,Gymrek; Melissa Ann,0,0,0,0
1667974324250,CSE 290,A00,102399,Chandraker; Manmohan Krishna,0,0,0,0
1667974324250,CSE 290,B00,102400,Vaccaro; Kristen Marie,0,0,25,25
1667974324250,CSE 290,C00,102414,Pannuto; Patrick William,0,0,25,25
1667974324250,CSE 290,D00,102427,Pevzner; Pavel Arkadjevich,0,0,0,0
1667974324250,CSE 290,E00,102429,Zhao; Jishen,0,0,0,0
1667974324250,CSE 290,F00,102436,Tullsen; Dean Michael,0,0,0,0
1667974324250,CSE 290,G00,102440,Christensen; Henrik I,0,0,20,20
1667974324679,CSE 291,A00,102443,Su; Hao,0,0,0,0
1667974324679,CSE 291,B00,102448,Polikarpova; Nadezhda,0,0,0,0
1667974324679,CSE 291,C00,102453,Vaccaro; Kristen Marie,0,0,0,0
1667974324679,CSE 291,D00,111343,Savage; Stefan,0,0,0,0
1667974324679,CSE 291,E00,116474,Claffy; Kimberly Claire,0,0,0,0
1667974324679,CSE 291,F00,116479,Pasquale; Joseph,0,0,0,0
1667974325130,CSE 293,001,119111,Bafna; Vineet,9999,0,9999,0
1667974325130,CSE 293,002,119118,Bellare; Mihir,9999,0,9999,0
1667974325130,CSE 293,003,119122,Berg-Kirkpatrick; Taylor D,9999,0,9999,0
1667974325130,CSE 293,004,119135,Christensen; Henrik I,9999,0,9999,0
1667974325130,CSE 293,005,119142,Cottrell; Garrison W,9999,0,9999,0
1667974325130,CSE 293,006,119146,Deutsch; Alin Bernard,9999,0,9999,0
1667974325130,CSE 293,007,119159,Esmaeilzadeh; Hadi,9999,0,9999,0
1667974325130,CSE 293,008,119166,Freund; Yoav,9999,0,9999,0
1667974325130,CSE 293,009,119170,Griswold; William G.,9999,0,9999,0
1667974325130,CSE 293,010,119183,Gymrek; Melissa Ann,9999,0,9999,0
1667974325130,CSE 293,011,119190,Heninger; Nadia A,9999,0,9999,0
1667974325130,CSE 293,012,119230,Impagliazzo; Russell,9999,0,9999,0
1667974325130,CSE 293,013,119232,Jhala; Ranjit,9999,0,9999,0
1667974325130,CSE 293,014,119233,Kahng; Andrew Byun,9999,0,9999,0
1667974325130,CSE 293,015,119298,Kane; Daniel Mertz,9999,0,9999,0
1667974325130,CSE 293,016,119299,Kriegman; David J,9999,0,9999,0
1667974325130,CSE 293,017,119300,Kumar; Arun Kumar,9999,0,9999,0
1667974325130,CSE 293,018,119301,Lerner; Sorin,9999,0,9999,0
1667974325130,CSE 293,019,119302,Lovett; Shachar,9999,0,9999,0
1667974325130,CSE 293,020,119303,McAuley; Julian John,9999,0,9999,0
1667974325130,CSE 293,021,119304,Micciancio; Daniele,9999,0,9999,0
1667974325130,CSE 293,022,119367,Orailoglu; Alex,9999,0,9999,0
1667974325130,CSE 293,023,119382,Paturi; Ramamohan,9999,0,9999,0
1667974325130,CSE 293,024,119404,Polikarpova; Nadezhda,9999,0,9999,0
1667974325130,CSE 293,025,119406,Politz; Joseph Gibbs,9999,0,9999,0
1667974325130,CSE 293,026,119411,Porter; George M,9999,0,9999,0
1667974325130,CSE 293,027,119414,Porter; Leonard Emerson,9999,0,9999,0
1667974325130,CSE 293,028,119416,Ramamoorthi; Ravi,9999,0,9999,0
1667974325130,CSE 293,029,119417,Sahoo; Debashis,9999,0,9999,0
1667974325130,CSE 293,030,119420,Saul; Lawrence,9999,0,9999,0
1667974325130,CSE 293,031,119421,Savage; Stefan,9999,0,9999,0
1667974325130,CSE 293,032,119425,Schulze; Jurgen P.,9999,0,9999,0
1667974325130,CSE 293,033,119426,Snoeren; Alex C.,9999,0,9999,0
1667974325130,CSE 293,034,119428,Shang; Jingbo,9999,0,9999,0
1667974325130,CSE 293,035,119430,Stefan; Deian,9999,0,9999,0
1667974325130,CSE 293,036,119431,Su; Hao,9999,0,9999,0
1667974325130,CSE 293,037,119433,Swanson; Steven James,9999,0,9999,0
1667974325130,CSE 293,038,119435,Tullsen; Dean Michael,9999,0,9999,0
1667974325130,CSE 293,039,119483,Voelker; Geoffrey M.,9999,0,9999,0
1667974325130,CSE 293,040,119537,Zhao; Jishen,9999,0,9999,0
1667974325130,CSE 293,041,119538,Zhou; Yuan-Yuan,9999,0,9999,0
1667974325130,CSE 293,042,119539,Gao; Sicun,9999,0,9999,0
1667974325130,CSE 293,043,119540,Weibel; Nadir,9999,0,9999,0
1667974325130,CSE 293,044,119541,Gupta; Rajesh K.,9999,0,9999,0
1667974325559,CSE 294,A00,102459,Voelker; Geoffrey M.,0,0,0,0
1667974325559,CSE 294,B00,111322,Orailoglu; Alex,0,0,0,0
1667974325983,DSE 201,A00,096914,Deutsch; Alin Bernard,30,0,30,0
1667974326407,DSE 210,A00,096915,Dasgupta; Sanjoy,30,0,30,0
1667974326833,DSE 260A,A00,096916,Altintas De Callaf; Ilkay,30,0,30,0
1667974327279,ECE 200,001,103586,Antipa; Nicholas A,9999,0,9999,0
1667974327279,ECE 200,002,103587,Atanasov; Nikolay A.,9999,0,9999,0
1667974327279,ECE 200,003,103588,Bharadia; Dinesh,9999,0,9999,0
1667974327279,ECE 200,004,103589,Cheng; Chung Kuan,9999,0,9999,0
1667974327279,ECE 200,005,103590,Cosman; Pamela C.,9999,0,9999,0
1667974327279,ECE 200,006,103591,Dayeh; Shadi Ahmad,9999,0,9999,0
1667974327279,ECE 200,007,103592,Fainman; Yeshaiahu,9999,0,9999,0
1667974327279,ECE 200,008,103593,Ford; Joseph Earl,9999,0,9999,0
1667974327279,ECE 200,009,103594,Franceschetti; Massimo,9999,0,9999,0
1667974327279,ECE 200,010,103595,Fullerton; Eric E,9999,0,9999,0
1667974327279,ECE 200,011,103596,Galton; Ian A,9999,0,9999,0
1667974327279,ECE 200,012,103597,Gilja; Vikash,9999,0,9999,0
1667974327279,ECE 200,013,103598,Hall; Drew A.,9999,0,9999,0
1667974327279,ECE 200,014,103599,Hsueh; Tzu-Chien,9999,0,9999,0
1667974327279,ECE 200,015,103600,Javidi; Tara,9999,0,9999,0
1667974327279,ECE 200,016,103601,Kahng; Andrew Byun,9999,0,9999,0
1667974327279,ECE 200,017,103602,Kim; Young-Han,9999,0,9999,0
1667974327279,ECE 200,018,103603,Koushanfar; Farinaz,9999,0,9999,0
1667974327279,ECE 200,019,103604,Kuzum; Duygu,9999,0,9999,0
1667974327279,ECE 200,020,103605,Le; Hanh-Phuc,9999,0,9999,0
1667974327279,ECE 200,021,103606,Lin; Bill,9999,0,9999,0
1667974327279,ECE 200,022,103607,Liu; Zhaowei,9998,0,9999,1
1667974327279,ECE 200,023,103608,Lo; Yu-Hwa,9999,0,9999,0
1667974327279,ECE 200,024,103609,Lomakin; Vitaliy,9999,0,9999,0
1667974327279,ECE 200,025,103610,Mercier; Patrick Philip,9999,0,9999,0
1667974327279,ECE 200,026,103611,Meyer; Florian,9999,0,9999,0
1667974327279,ECE 200,027,103612,Milstein; Laurence B.,9999,0,9999,0
1667974327279,ECE 200,028,103613,Mir Arabbaygi; Siavash,9999,0,9999,0
1667974327279,ECE 200,029,103614,Mookherjea; Shayan,9999,0,9999,0
1667974327279,ECE 200,030,103615,Morris; Karcher William,9999,0,9999,0
1667974327279,ECE 200,031,103616,Ng; Tse Nga,9999,0,9999,0
1667974327279,ECE 200,032,103617,Nguyen; Truong Quang,9999,0,9999,0
1667974327279,ECE 200,033,103618,Nomura; Kenji,9999,0,9999,0
1667974327279,ECE 200,034,103619,Orlitsky; Alon,9999,0,9999,0
1667974327279,ECE 200,035,103620,Pal; Piya,9999,0,9999,0
1667974327279,ECE 200,036,103621,Papen; George C.,9999,0,9999,0
1667974327279,ECE 200,037,103622,Radic; Stojan,9999,0,9999,0
1667974327279,ECE 200,038,103623,Rao; Bhaskar D.,9999,0,9999,0
1667974327279,ECE 200,039,103624,Rao; Ramesh R,9999,0,9999,0
1667974327279,ECE 200,040,103625,Rebeiz; Gabriel,9999,0,9999,0
1667974327279,ECE 200,041,103626,Sanford; John R,9999,0,9999,0
1667974327279,ECE 200,042,103627,Siegel; Paul H.,9999,0,9999,0
1667974327279,ECE 200,043,103628,Sievenpiper; Daniel F.,9999,0,9999,0
1667974327279,ECE 200,044,103629,Sworder; David D.,9999,0,9999,0
1667974327279,ECE 200,045,103630,Taur; Yuan,9999,0,9999,0
1667974327279,ECE 200,046,103631,Touri; Behrouz,9999,0,9999,0
1667974327279,ECE 200,047,103632,Trivedi; Mohan M.,9999,0,9999,0
1667974327279,ECE 200,048,103633,Vasconcelos; Nuno,9999,0,9999,0
1667974327279,ECE 200,049,103634,Wang; Xiaolong,9999,0,9999,0
1667974327279,ECE 200,050,103635,Xie; Pengtao,9999,0,9999,0
1667974327279,ECE 200,051,103636,Yip; Michael,9999,0,9999,0
1667974327279,ECE 200,052,103637,Zeger; Kenneth A.,999,0,999,0
1667974327279,ECE 200,053,103638,Zhang; Xinyu,9999,0,9999,0
1667974327279,ECE 200,054,103639,Turakhia; Yatish Girish,9999,0,9999,0
1667974327279,ECE 200,055,103640,Kang; Mingu,9999,0,9999,0
1667974327279,ECE 200,056,103641,Shi; Yuanyuan,9999,0,9999,0
1667974327279,ECE 200,057,103642,Wang; Edward Jay,9999,0,9999,0
1667974327279,ECE 200,058,103643,Zheng; Yang,9999,0,9999,0
1667974327709,ECE 202,A00,103644,Kuzum; Duygu,0,0,0,0
1667974328134,ECE 212BN,A00,103646,Ng; Tse Nga,0,0,0,0
1667974328559,ECE 221,A00,111493,Staff,0,0,0,0
1667974328982,ECE 222B,A00,103647,Lomakin; Vitaliy,0,0,0,0
1667974329407,ECE 230B,A00,103648,Taur; Yuan,0,0,0,0
1667974329833,ECE 238B,A00,103649,Garay; Javier,0,0,0,0
1667974330332,ECE 240B,A00,112900,Fainman; Yeshaiahu,0,0,0,0
1667974330758,ECE 247A,A00,103650,Jokerst; Jesse Vincent,0,0,0,0
1667974331184,ECE 247B,A00,103651,Wang; Joseph,0,0,0,0
1667974331605,ECE 250,A00,103652,Siegel; Paul H.,0,0,0,0
1667974332030,ECE 251A,A00,103654,Rao; Bhaskar D.,0,0,0,0
1667974332456,ECE 257B,A00,103655,Bharadia; Dinesh,0,0,0,0
1667974332886,ECE 258A,A00,103656,Milstein; Laurence B.,0,0,0,0
1667974333311,ECE 260B,A00,103658,Kang; Mingu,0,0,0,0
1667974333734,ECE 264A,A00,103659,Galton; Ian A,0,0,0,0
1667974334158,ECE 265A,A00,103661,Gudem; Prasad S.S.,0,0,0,0
1667974334581,ECE 265D,A00,103662,Gudem; Prasad S.S.,0,0,0,0
1667974335005,ECE 268,A00,103663,Koushanfar; Farinaz,0,0,0,0
1667974335428,ECE 269,A01,103665,Pal; Piya,0,0,0,0
1667974335849,ECE 271B,A00,103666,Vasconcelos; Manuela,0,0,0,0
1667974336273,ECE 276A,A00,103667,Atanasov; Nikolay A.,0,0,0,0
1667974336709,ECE 277,A00,103668,An; Cheolhong,0,0,0,0
1667974337132,ECE 279,A00,117947,Hall; Drew A.,0,0,0,0
1667974337986,ECE 283,A00,103670,Hsueh; Tzu-Chien,0,0,0,0
1667974338418,ECE 284,A00,103671,Turakhia; Yatish Girish,0,0,0,0
1667974338844,ECE 285,A00,103672,Zheng; Yang,0,0,0,0
1667974338844,ECE 285,B00,103673,Sworder; David D.,0,0,0,0
1667974339269,ECE 287,A00,103676,Javidi; Tara,0,0,0,0
1667974339694,MATH 200B,A00,098023,Salehi Golsefidy; Alireza,14,0,15,1
1667974340117,MATH 202B,A00,098024,Rhoades; Brendon Patrick,12,0,15,3
1667974340542,MATH 203B,A00,098025,Oprea; Dragos N.,12,0,15,3
1667974340969,MATH 204B,A00,098026,Sorensen; Claus M,14,0,15,1
1667974341391,MATH 208,A00,098027,Izadi; Elham,7,0,10,3
1667974341814,MATH 209,A00,098028,Pollack; Aaron,10,0,10,0
1667974342236,MATH 211A,A00,112919,Rogalski; Daniel,9,0,10,1
1667974342660,MATH 211B,A00,112920,Seward; Brandon M.,9,0,10,1
1667974343084,MATH 218,A00,098029,Li; Bo,10,0,10,0
1667974343507,MATH 220B,A00,098030,Novak; Jonathan I,13,0,15,2
1667974343933,MATH 221A,A00,098031,Ebenfelt; Peter F,13,0,15,2
1667974344358,MATH 231B,A00,098032,Zlatos; Andrej,12,0,15,3
1667974344781,MATH 240B,A00,098033,Ni; Lei,10,0,15,5
1667974345204,MATH 243,A00,098034,Jekel; David Andrew,10,0,10,0
1667974345629,MATH 245A,A00,098035,Nie; Jiawang,0,0,15,16
1667974346053,MATH 248,A00,098036,Bejenaru; Ioan,10,0,10,0
1667974346476,MATH 250B,A00,098037,Spolaor; Luca,14,0,15,1
1667974346900,MATH 258,A00,098038,Ni; Lei,10,0,10,0
1667974347331,MATH 264B,A00,098041,Rhoades; Brendon Patrick,12,0,15,3
1667974347755,MATH 268,A00,098042,Buss; Samuel R,10,0,10,0
1667974348186,MATH 269,A00,098043,Rhoades; Brendon Patrick,10,0,10,0
1667974348615,MATH 270B,A00,098044,Li; Bo,11,0,15,4
1667974349041,MATH 272B,A00,098045,Holst; Michael J,13,0,15,2
1667974349467,MATH 273A,A00,098046,Tian; Xiaochuan,12,0,15,3
1667974349890,MATH 275,A01,098048,Tian; Xiaochuan,6,0,10,4
1667974350314,MATH 278A,A00,098049,Holst; Michael J,8,0,10,2
1667974350753,MATH 278B,A00,098050,Cloninger; Alexander,10,0,10,0
1667974351178,MATH 278C,A00,098051,Nie; Jiawang,8,0,10,2
1667974351601,MATH 280B,A00,098052,Zheng; Tianyi,11,0,15,4
1667974352023,MATH 281B,A00,098053,Bradic; Jelena,4,0,15,11
1667974352451,MATH 282B,A00,098054,Arias-Castro; Ery,2,0,15,13
1667974352873,MATH 285,A00,098055,Fitzsimmons; Patrick J,0,0,15,17
1667974353294,MATH 287B,A00,098056,Arias-Castro; Ery,5,0,15,10
1667974353721,MATH 288,A00,098057,Agarwal; Pooja,9,0,10,1
1667974353721,MATH 288,B00,098058,Zhang; Danna,9,0,10,1
1667974353721,MATH 288,C00,098059,Williams; Ruth J,10,0,10,0
1667974354147,MATH 290B,A00,098060,Roberts; Justin Deritter,14,0,15,1
1667974354572,MATH 292,A00,098061,Belmont; Eva Kinoshita,10,0,10,0
1667974354998,MATH 295,A00,098062,Suk; Andrew Hoon,48,0,50,2
1667974355436,MATH 296,A00,098063,Novak; Jonathan I,20,0,20,0
1667974355861,MATH 297,001,098064,Gamst; Anthony Collins,9997,0,9999,2
1667974855653,COGS 205,A00,101395,Chiba; Andrea,19,0,20,1
1667974856091,COGS 210B,001,101404,Greene; Deanna Jacquelyn,9998,0,9999,1
1667974856091,COGS 210B,002,101417,Xia; Haijun,9999,0,9999,0
1667974856091,COGS 210B,003,101422,Nitz; Douglas A.,9999,0,9999,0
1667974856091,COGS 210B,004,101423,Hollan; James D.,9998,0,9999,1
1667974856091,COGS 210B,005,101424,Deak; Gedeon O.,9999,0,9999,0
1667974856091,COGS 210B,006,101425,Rossano; Federico,9999,0,9999,0
1667974856518,COGS 211B,A00,101427,Coulson; Seana M,9997,0,9999,2
1667974856942,COGS 220,A00,101428,Hollan; James D.,0,0,25,25
1667974857367,COGS 229,A00,101429,Dow; Steven P,18,0,25,7
1667974857794,COGS 230,A00,101430,Klemmer; Scott R,13,0,17,4
1667974858222,COGS 234,A00,101431,Xia; Haijun,7,0,25,18
1667974858647,COGS 260,A00,101432,Kiyonaga; Anastasia,20,0,25,5
1667974858647,COGS 260,B00,101433,Kirsh; David Joel,16,0,25,9
1667974859072,CSE 202,A00,102371,Impagliazzo; Russell,0,0,0,0
1667974859494,CSE 203B,A01,102373,Cheng; Chung Kuan,0,0,0,0
1667974859920,CSE 208,A00,102374,Micciancio; Daniele,0,0,0,0
1667974860344,CSE 209A,A00,112895,Impagliazzo; Russell,0,0,15,15
1667974860769,CSE 209B,A00,108005,Bellare; Mihir,0,0,0,0
1667974861194,CSE 210,A00,113163,Coblenz; Michael J,0,0,0,0
1667974861618,CSE 219,A00,106111,Dow; Steven P,0,0,20,20
1667974862044,CSE 221,A00,102376,Voelker; Geoffrey M.,0,0,0,0
1667974862473,CSE 224,A01,102378,Porter; George M,0,0,0,0
1667974862901,CSE 229A,A00,102379,Savage; Stefan,0,0,0,0
1667974863334,CSE 229C,A00,102380,Munyaka; Imani N. S.,0,0,0,0
1667974863761,CSE 232B,A00,102382,Deutsch; Alin Bernard,0,0,0,0
1667974864185,CSE 234,A01,112904,Kumar; Arun Kumar,0,0,0,0
1667974864610,CSE 237A,A00,102383,Rosing; Tajana Simunic,0,0,0,0
1667974865031,CSE 239A,A00,102384,Deutsch; Alin Bernard,0,0,0,0
1667974865455,CSE 239B,A00,102385,Polikarpova; Nadezhda,0,0,0,0
1667974865886,CSE 240A,A00,102386,Pannuto; Patrick William,0,0,0,0
1667974866315,CSE 240B,A00,102387,Zhao; Jishen,0,0,0,0
1667974866741,CSE 241A,A00,106406,Kang; Mingu,0,0,0,0
1667974867176,CSE 249B,A00,102388,Kahng; Andrew Byun,0,0,8,8
1667974867604,CSE 251B,A01,102392,Cottrell; Garrison W,0,0,0,0
1667974867604,CSE 251B,A02,102393,Cottrell; Garrison W,0,0,0,0
1667974868027,CSE 252B,A00,102394,Ochoa; Benjamin Lawrence,0,0,0,0
1667974868451,CSE 257,A01,102396,Gao; Sicun,0,0,0,0
1667974868878,CSE 272,A00,102397,Li; Tzumao,0,0,0,0
1667974869301,CSE 274,A00,111323,Chern; Albert Ren-Haur,0,0,0,0
1667974869725,CSE 282,A00,102398,Pevzner; Pavel Arkadjevich,0,0,0,0
1667974870153,CSE 284,A00,114175,Gymrek; Melissa Ann,0,0,0,0
1667974870576,CSE 290,A00,102399,Chandraker; Manmohan Krishna,0,0,0,0
1667974870576,CSE 290,B00,102400,Vaccaro; Kristen Marie,0,0,25,25
1667974870576,CSE 290,C00,102414,Pannuto; Patrick William,0,0,25,25
1667974870576,CSE 290,D00,102427,Pevzner; Pavel Arkadjevich,0,0,0,0
1667974870576,CSE 290,E00,102429,Zhao; Jishen,0,0,0,0
1667974870576,CSE 290,F00,102436,Tullsen; Dean Michael,0,0,0,0
1667974870576,CSE 290,G00,102440,Christensen; Henrik I,0,0,20,20
1667974871013,CSE 291,A00,102443,Su; Hao,0,0,0,0
1667974871013,CSE 291,B00,102448,Polikarpova; Nadezhda,0,0,0,0
1667974871013,CSE 291,C00,102453,Vaccaro; Kristen Marie,0,0,0,0
1667974871013,CSE 291,D00,111343,Savage; Stefan,0,0,0,0
1667974871013,CSE 291,E00,116474,Claffy; Kimberly Claire,0,0,0,0
1667974871013,CSE 291,F00,116479,Pasquale; Joseph,0,0,0,0
1667974871447,CSE 293,001,119111,Bafna; Vineet,9999,0,9999,0
1667974871447,CSE 293,002,119118,Bellare; Mihir,9999,0,9999,0
1667974871447,CSE 293,003,119122,Berg-Kirkpatrick; Taylor D,9999,0,9999,0
1667974871447,CSE 293,004,119135,Christensen; Henrik I,9999,0,9999,0
1667974871447,CSE 293,005,119142,Cottrell; Garrison W,9999,0,9999,0
1667974871447,CSE 293,006,119146,Deutsch; Alin Bernard,9999,0,9999,0
1667974871447,CSE 293,007,119159,Esmaeilzadeh; Hadi,9999,0,9999,0
1667974871447,CSE 293,008,119166,Freund; Yoav,9999,0,9999,0
1667974871447,CSE 293,009,119170,Griswold; William G.,9999,0,9999,0
1667974871447,CSE 293,010,119183,Gymrek; Melissa Ann,9999,0,9999,0
1667974871447,CSE 293,011,119190,Heninger; Nadia A,9999,0,9999,0
1667974871447,CSE 293,012,119230,Impagliazzo; Russell,9999,0,9999,0
1667974871447,CSE 293,013,119232,Jhala; Ranjit,9999,0,9999,0
1667974871447,CSE 293,014,119233,Kahng; Andrew Byun,9999,0,9999,0
1667974871447,CSE 293,015,119298,Kane; Daniel Mertz,9999,0,9999,0
1667974871447,CSE 293,016,119299,Kriegman; David J,9999,0,9999,0
1667974871447,CSE 293,017,119300,Kumar; Arun Kumar,9999,0,9999,0
1667974871447,CSE 293,018,119301,Lerner; Sorin,9999,0,9999,0
1667974871447,CSE 293,019,119302,Lovett; Shachar,9999,0,9999,0
1667974871447,CSE 293,020,119303,McAuley; Julian John,9999,0,9999,0
1667974871447,CSE 293,021,119304,Micciancio; Daniele,9999,0,9999,0
1667974871447,CSE 293,022,119367,Orailoglu; Alex,9999,0,9999,0
1667974871447,CSE 293,023,119382,Paturi; Ramamohan,9999,0,9999,0
1667974871447,CSE 293,024,119404,Polikarpova; Nadezhda,9999,0,9999,0
1667974871447,CSE 293,025,119406,Politz; Joseph Gibbs,9999,0,9999,0
1667974871447,CSE 293,026,119411,Porter; George M,9999,0,9999,0
1667974871447,CSE 293,027,119414,Porter; Leonard Emerson,9999,0,9999,0
1667974871447,CSE 293,028,119416,Ramamoorthi; Ravi,9999,0,9999,0
1667974871447,CSE 293,029,119417,Sahoo; Debashis,9999,0,9999,0
1667974871447,CSE 293,030,119420,Saul; Lawrence,9999,0,9999,0
1667974871447,CSE 293,031,119421,Savage; Stefan,9999,0,9999,0
1667974871447,CSE 293,032,119425,Schulze; Jurgen P.,9999,0,9999,0
1667974871447,CSE 293,033,119426,Snoeren; Alex C.,9999,0,9999,0
1667974871447,CSE 293,034,119428,Shang; Jingbo,9999,0,9999,0
1667974871447,CSE 293,035,119430,Stefan; Deian,9999,0,9999,0
1667974871447,CSE 293,036,119431,Su; Hao,9999,0,9999,0
1667974871447,CSE 293,037,119433,Swanson; Steven James,9999,0,9999,0
1667974871447,CSE 293,038,119435,Tullsen; Dean Michael,9999,0,9999,0
1667974871447,CSE 293,039,119483,Voelker; Geoffrey M.,9999,0,9999,0
1667974871447,CSE 293,040,119537,Zhao; Jishen,9999,0,9999,0
1667974871447,CSE 293,041,119538,Zhou; Yuan-Yuan,9999,0,9999,0
1667974871447,CSE 293,042,119539,Gao; Sicun,9999,0,9999,0
1667974871447,CSE 293,043,119540,Weibel; Nadir,9999,0,9999,0
1667974871447,CSE 293,044,119541,Gupta; Rajesh K.,9999,0,9999,0
1667974871874,CSE 294,A00,102459,Voelker; Geoffrey M.,0,0,0,0
1667974871874,CSE 294,B00,111322,Orailoglu; Alex,0,0,0,0
1667974872297,DSE 201,A00,096914,Deutsch; Alin Bernard,30,0,30,0
1667974872724,DSE 210,A00,096915,Dasgupta; Sanjoy,30,0,30,0
1667974873147,DSE 260A,A00,096916,Altintas De Callaf; Ilkay,30,0,30,0
1667974873575,ECE 200,001,103586,Antipa; Nicholas A,9999,0,9999,0
1667974873575,ECE 200,002,103587,Atanasov; Nikolay A.,9999,0,9999,0
1667974873575,ECE 200,003,103588,Bharadia; Dinesh,9999,0,9999,0
1667974873575,ECE 200,004,103589,Cheng; Chung Kuan,9999,0,9999,0
1667974873575,ECE 200,005,103590,Cosman; Pamela C.,9999,0,9999,0
1667974873575,ECE 200,006,103591,Dayeh; Shadi Ahmad,9999,0,9999,0
1667974873575,ECE 200,007,103592,Fainman; Yeshaiahu,9999,0,9999,0
1667974873575,ECE 200,008,103593,Ford; Joseph Earl,9999,0,9999,0
1667974873575,ECE 200,009,103594,Franceschetti; Massimo,9999,0,9999,0
1667974873575,ECE 200,010,103595,Fullerton; Eric E,9999,0,9999,0
1667974873575,ECE 200,011,103596,Galton; Ian A,9999,0,9999,0
1667974873575,ECE 200,012,103597,Gilja; Vikash,9999,0,9999,0
1667974873575,ECE 200,013,103598,Hall; Drew A.,9999,0,9999,0
1667974873575,ECE 200,014,103599,Hsueh; Tzu-Chien,9999,0,9999,0
1667974873575,ECE 200,015,103600,Javidi; Tara,9999,0,9999,0
1667974873575,ECE 200,016,103601,Kahng; Andrew Byun,9999,0,9999,0
1667974873575,ECE 200,017,103602,Kim; Young-Han,9999,0,9999,0
1667974873575,ECE 200,018,103603,Koushanfar; Farinaz,9999,0,9999,0
1667974873575,ECE 200,019,103604,Kuzum; Duygu,9999,0,9999,0
1667974873575,ECE 200,020,103605,Le; Hanh-Phuc,9999,0,9999,0
1667974873575,ECE 200,021,103606,Lin; Bill,9999,0,9999,0
1667974873575,ECE 200,022,103607,Liu; Zhaowei,9998,0,9999,1
1667974873575,ECE 200,023,103608,Lo; Yu-Hwa,9999,0,9999,0
1667974873575,ECE 200,024,103609,Lomakin; Vitaliy,9999,0,9999,0
1667974873575,ECE 200,025,103610,Mercier; Patrick Philip,9999,0,9999,0
1667974873575,ECE 200,026,103611,Meyer; Florian,9999,0,9999,0
1667974873575,ECE 200,027,103612,Milstein; Laurence B.,9999,0,9999,0
1667974873575,ECE 200,028,103613,Mir Arabbaygi; Siavash,9999,0,9999,0
1667974873575,ECE 200,029,103614,Mookherjea; Shayan,9999,0,9999,0
1667974873575,ECE 200,030,103615,Morris; Karcher William,9999,0,9999,0
1667974873575,ECE 200,031,103616,Ng; Tse Nga,9999,0,9999,0
1667974873575,ECE 200,032,103617,Nguyen; Truong Quang,9999,0,9999,0
1667974873575,ECE 200,033,103618,Nomura; Kenji,9999,0,9999,0
1667974873575,ECE 200,034,103619,Orlitsky; Alon,9999,0,9999,0
1667974873575,ECE 200,035,103620,Pal; Piya,9999,0,9999,0
1667974873575,ECE 200,036,103621,Papen; George C.,9999,0,9999,0
1667974873575,ECE 200,037,103622,Radic; Stojan,9999,0,9999,0
1667974873575,ECE 200,038,103623,Rao; Bhaskar D.,9999,0,9999,0
1667974873575,ECE 200,039,103624,Rao; Ramesh R,9999,0,9999,0
1667974873575,ECE 200,040,103625,Rebeiz; Gabriel,9999,0,9999,0
1667974873575,ECE 200,041,103626,Sanford; John R,9999,0,9999,0
1667974873575,ECE 200,042,103627,Siegel; Paul H.,9999,0,9999,0
1667974873575,ECE 200,043,103628,Sievenpiper; Daniel F.,9999,0,9999,0
1667974873575,ECE 200,044,103629,Sworder; David D.,9999,0,9999,0
1667974873575,ECE 200,045,103630,Taur; Yuan,9999,0,9999,0
1667974873575,ECE 200,046,103631,Touri; Behrouz,9999,0,9999,0
1667974873575,ECE 200,047,103632,Trivedi; Mohan M.,9999,0,9999,0
1667974873575,ECE 200,048,103633,Vasconcelos; Nuno,9999,0,9999,0
1667974873575,ECE 200,049,103634,Wang; Xiaolong,9999,0,9999,0
1667974873575,ECE 200,050,103635,Xie; Pengtao,9999,0,9999,0
1667974873575,ECE 200,051,103636,Yip; Michael,9999,0,9999,0
1667974873575,ECE 200,052,103637,Zeger; Kenneth A.,999,0,999,0
1667974873575,ECE 200,053,103638,Zhang; Xinyu,9999,0,9999,0
1667974873575,ECE 200,054,103639,Turakhia; Yatish Girish,9999,0,9999,0
1667974873575,ECE 200,055,103640,Kang; Mingu,9999,0,9999,0
1667974873575,ECE 200,056,103641,Shi; Yuanyuan,9999,0,9999,0
1667974873575,ECE 200,057,103642,Wang; Edward Jay,9999,0,9999,0
1667974873575,ECE 200,058,103643,Zheng; Yang,9999,0,9999,0
1667974873998,ECE 202,A00,103644,Kuzum; Duygu,0,0,0,0
1667974874425,ECE 212BN,A00,103646,Ng; Tse Nga,0,0,0,0
1667974874852,ECE 221,A00,111493,Staff,0,0,0,0
1667974875284,ECE 222B,A00,103647,Lomakin; Vitaliy,0,0,0,0
1667974875707,ECE 230B,A00,103648,Taur; Yuan,0,0,0,0
1667974876132,ECE 238B,A00,103649,Garay; Javier,0,0,0,0
1667974876557,ECE 240B,A00,112900,Fainman; Yeshaiahu,0,0,0,0
1667974876983,ECE 247A,A00,103650,Jokerst; Jesse Vincent,0,0,0,0
1667974877410,ECE 247B,A00,103651,Wang; Joseph,0,0,0,0
1667974877837,ECE 250,A00,103652,Siegel; Paul H.,0,0,0,0
1667974878270,ECE 251A,A00,103654,Rao; Bhaskar D.,0,0,0,0
1667974878694,ECE 257B,A00,103655,Bharadia; Dinesh,0,0,0,0
1667974879125,ECE 258A,A00,103656,Milstein; Laurence B.,0,0,0,0
1667974879550,ECE 260B,A00,103658,Kang; Mingu,0,0,0,0
1667974879974,ECE 264A,A00,103659,Galton; Ian A,0,0,0,0
1667974880396,ECE 265A,A00,103661,Gudem; Prasad S.S.,0,0,0,0
1667974880820,ECE 265D,A00,103662,Gudem; Prasad S.S.,0,0,0,0
1667974881245,ECE 268,A00,103663,Koushanfar; Farinaz,0,0,0,0
1667974881671,ECE 269,A01,103665,Pal; Piya,0,0,0,0
1667974882093,ECE 271B,A00,103666,Vasconcelos; Manuela,0,0,0,0
1667974882517,ECE 276A,A00,103667,Atanasov; Nikolay A.,0,0,0,0
1667974882949,ECE 277,A00,103668,An; Cheolhong,0,0,0,0
1667974883372,ECE 279,A00,117947,Hall; Drew A.,0,0,0,0
1667974884252,ECE 283,A00,103670,Hsueh; Tzu-Chien,0,0,0,0
1667974884676,ECE 284,A00,103671,Turakhia; Yatish Girish,0,0,0,0
1667974885101,ECE 285,A00,103672,Zheng; Yang,0,0,0,0
1667974885101,ECE 285,B00,103673,Sworder; David D.,0,0,0,0
1667974885530,ECE 287,A00,103676,Javidi; Tara,0,0,0,0
1667974885956,MATH 200B,A00,098023,Salehi Golsefidy; Alireza,14,0,15,1
1667974886381,MATH 202B,A00,098024,Rhoades; Brendon Patrick,12,0,15,3
1667974886805,MATH 203B,A00,098025,Oprea; Dragos N.,12,0,15,3
1667974887229,MATH 204B,A00,098026,Sorensen; Claus M,14,0,15,1
1667974887652,MATH 208,A00,098027,Izadi; Elham,7,0,10,3
1667974888077,MATH 209,A00,098028,Pollack; Aaron,10,0,10,0
1667974888499,MATH 211A,A00,112919,Rogalski; Daniel,9,0,10,1
1667974888923,MATH 211B,A00,112920,Seward; Brandon M.,9,0,10,1
1667974889346,MATH 218,A00,098029,Li; Bo,10,0,10,0
1667974889770,MATH 220B,A00,098030,Novak; Jonathan I,13,0,15,2
1667974890196,MATH 221A,A00,098031,Ebenfelt; Peter F,13,0,15,2
1667974890629,MATH 231B,A00,098032,Zlatos; Andrej,12,0,15,3
1667974891054,MATH 240B,A00,098033,Ni; Lei,10,0,15,5
1667974891479,MATH 243,A00,098034,Jekel; David Andrew,10,0,10,0
1667974891904,MATH 245A,A00,098035,Nie; Jiawang,0,0,15,16
1667974892337,MATH 248,A00,098036,Bejenaru; Ioan,10,0,10,0
1667974892759,MATH 250B,A00,098037,Spolaor; Luca,14,0,15,1
1667974893275,MATH 258,A00,098038,Ni; Lei,10,0,10,0
1667974893699,MATH 264B,A00,098041,Rhoades; Brendon Patrick,12,0,15,3
1667974894124,MATH 268,A00,098042,Buss; Samuel R,10,0,10,0
1667974894554,MATH 269,A00,098043,Rhoades; Brendon Patrick,10,0,10,0
1667974894987,MATH 270B,A00,098044,Li; Bo,11,0,15,4
1667974895417,MATH 272B,A00,098045,Holst; Michael J,13,0,15,2
1667974895850,MATH 273A,A00,098046,Tian; Xiaochuan,12,0,15,3
1667974896284,MATH 275,A01,098048,Tian; Xiaochuan,6,0,10,4
1667974896706,MATH 278A,A00,098049,Holst; Michael J,8,0,10,2
1667974897130,MATH 278B,A00,098050,Cloninger; Alexander,10,0,10,0
1667974897561,MATH 278C,A00,098051,Nie; Jiawang,8,0,10,2
1667974897984,MATH 280B,A00,098052,Zheng; Tianyi,11,0,15,4
1667974898410,MATH 281B,A00,098053,Bradic; Jelena,4,0,15,11
1667974898840,MATH 282B,A00,098054,Arias-Castro; Ery,2,0,15,13
1667974899262,MATH 285,A00,098055,Fitzsimmons; Patrick J,0,0,15,17
1667974899686,MATH 287B,A00,098056,Arias-Castro; Ery,5,0,15,10
1667974900122,MATH 288,A00,098057,Agarwal; Pooja,9,0,10,1
1667974900122,MATH 288,B00,098058,Zhang; Danna,9,0,10,1
1667974900122,MATH 288,C00,098059,Williams; Ruth J,10,0,10,0
1667974900550,MATH 290B,A00,098060,Roberts; Justin Deritter,14,0,15,1
1667974900979,MATH 292,A00,098061,Belmont; Eva Kinoshita,10,0,10,0
1667974901407,MATH 295,A00,098062,Suk; Andrew Hoon,48,0,50,2
1667974901829,MATH 296,A00,098063,Novak; Jonathan I,20,0,20,0
1667974902253,MATH 297,001,098064,Gamst; Anthony Collins,9997,0,9999,2
1667975412421,COGS 205,A00,101395,Chiba; Andrea,19,0,20,1
1667975412845,COGS 210B,001,101404,Greene; Deanna Jacquelyn,9998,0,9999,1
1667975412845,COGS 210B,002,101417,Xia; Haijun,9999,0,9999,0
1667975412845,COGS 210B,003,101422,Nitz; Douglas A.,9999,0,9999,0
1667975412845,COGS 210B,004,101423,Hollan; James D.,9998,0,9999,1
1667975412845,COGS 210B,005,101424,Deak; Gedeon O.,9999,0,9999,0
1667975412845,COGS 210B,006,101425,Rossano; Federico,9999,0,9999,0
1667975413270,COGS 211B,A00,101427,Coulson; Seana M,9997,0,9999,2
1667975413694,COGS 220,A00,101428,Hollan; James D.,0,0,25,25
1667975414119,COGS 229,A00,101429,Dow; Steven P,18,0,25,7
1667975414544,COGS 230,A00,101430,Klemmer; Scott R,13,0,17,4
1667975414966,COGS 234,A00,101431,Xia; Haijun,7,0,25,18
1667975415391,COGS 260,A00,101432,Kiyonaga; Anastasia,20,0,25,5
1667975415391,COGS 260,B00,101433,Kirsh; David Joel,16,0,25,9
1667975415813,CSE 202,A00,102371,Impagliazzo; Russell,0,0,0,0
1667975416236,CSE 203B,A01,102373,Cheng; Chung Kuan,0,0,0,0
1667975416659,CSE 208,A00,102374,Micciancio; Daniele,0,0,0,0
1667975417093,CSE 209A,A00,112895,Impagliazzo; Russell,0,0,15,15
1667975417520,CSE 209B,A00,108005,Bellare; Mihir,0,0,0,0
1667975417950,CSE 210,A00,113163,Coblenz; Michael J,0,0,0,0
1667975418375,CSE 219,A00,106111,Dow; Steven P,0,0,20,20
1667975418798,CSE 221,A00,102376,Voelker; Geoffrey M.,0,0,0,0
1667975419220,CSE 224,A01,102378,Porter; George M,0,0,0,0
1667975419644,CSE 229A,A00,102379,Savage; Stefan,0,0,0,0
1667975420070,CSE 229C,A00,102380,Munyaka; Imani N. S.,0,0,0,0
1667975420495,CSE 232B,A00,102382,Deutsch; Alin Bernard,0,0,0,0
1667975420919,CSE 234,A01,112904,Kumar; Arun Kumar,0,0,0,0
1667975421346,CSE 237A,A00,102383,Rosing; Tajana Simunic,0,0,0,0
1667975421769,CSE 239A,A00,102384,Deutsch; Alin Bernard,0,0,0,0
1667975422192,CSE 239B,A00,102385,Polikarpova; Nadezhda,0,0,0,0
1667975422614,CSE 240A,A00,102386,Pannuto; Patrick William,0,0,0,0
1667975423037,CSE 240B,A00,102387,Zhao; Jishen,0,0,0,0
1667975423561,CSE 241A,A00,106406,Kang; Mingu,0,0,0,0
1667975423987,CSE 249B,A00,102388,Kahng; Andrew Byun,0,0,8,8
1667975424415,CSE 251B,A01,102392,Cottrell; Garrison W,0,0,0,0
1667975424415,CSE 251B,A02,102393,Cottrell; Garrison W,0,0,0,0
1667975424844,CSE 252B,A00,102394,Ochoa; Benjamin Lawrence,0,0,0,0
1667975425267,CSE 257,A01,102396,Gao; Sicun,0,0,0,0
1667975425694,CSE 272,A00,102397,Li; Tzumao,0,0,0,0
1667975426118,CSE 274,A00,111323,Chern; Albert Ren-Haur,0,0,0,0
1667975426543,CSE 282,A00,102398,Pevzner; Pavel Arkadjevich,0,0,0,0
1667975426968,CSE 284,A00,114175,Gymrek; Melissa Ann,0,0,0,0
1667975427391,CSE 290,A00,102399,Chandraker; Manmohan Krishna,0,0,0,0
1667975427391,CSE 290,B00,102400,Vaccaro; Kristen Marie,0,0,25,25
1667975427391,CSE 290,C00,102414,Pannuto; Patrick William,0,0,25,25
1667975427391,CSE 290,D00,102427,Pevzner; Pavel Arkadjevich,0,0,0,0
1667975427391,CSE 290,E00,102429,Zhao; Jishen,0,0,0,0
1667975427391,CSE 290,F00,102436,Tullsen; Dean Michael,0,0,0,0
1667975427391,CSE 290,G00,102440,Christensen; Henrik I,0,0,20,20
1667975427816,CSE 291,A00,102443,Su; Hao,0,0,0,0
1667975427816,CSE 291,B00,102448,Polikarpova; Nadezhda,0,0,0,0
1667975427816,CSE 291,C00,102453,Vaccaro; Kristen Marie,0,0,0,0
1667975427816,CSE 291,D00,111343,Savage; Stefan,0,0,0,0
1667975427816,CSE 291,E00,116474,Claffy; Kimberly Claire,0,0,0,0
1667975427816,CSE 291,F00,116479,Pasquale; Joseph,0,0,0,0
1667975428251,CSE 293,001,119111,Bafna; Vineet,9999,0,9999,0
1667975428251,CSE 293,002,119118,Bellare; Mihir,9999,0,9999,0
1667975428251,CSE 293,003,119122,Berg-Kirkpatrick; Taylor D,9999,0,9999,0
1667975428251,CSE 293,004,119135,Christensen; Henrik I,9999,0,9999,0
1667975428251,CSE 293,005,119142,Cottrell; Garrison W,9999,0,9999,0
1667975428251,CSE 293,006,119146,Deutsch; Alin Bernard,9999,0,9999,0
1667975428251,CSE 293,007,119159,Esmaeilzadeh; Hadi,9999,0,9999,0
1667975428251,CSE 293,008,119166,Freund; Yoav,9999,0,9999,0
1667975428251,CSE 293,009,119170,Griswold; William G.,9999,0,9999,0
1667975428251,CSE 293,010,119183,Gymrek; Melissa Ann,9999,0,9999,0
1667975428251,CSE 293,011,119190,Heninger; Nadia A,9999,0,9999,0
1667975428251,CSE 293,012,119230,Impagliazzo; Russell,9999,0,9999,0
1667975428251,CSE 293,013,119232,Jhala; Ranjit,9999,0,9999,0
1667975428251,CSE 293,014,119233,Kahng; Andrew Byun,9999,0,9999,0
1667975428251,CSE 293,015,119298,Kane; Daniel Mertz,9999,0,9999,0
1667975428251,CSE 293,016,119299,Kriegman; David J,9999,0,9999,0
1667975428251,CSE 293,017,119300,Kumar; Arun Kumar,9999,0,9999,0
1667975428251,CSE 293,018,119301,Lerner; Sorin,9999,0,9999,0
1667975428251,CSE 293,019,119302,Lovett; Shachar,9999,0,9999,0
1667975428251,CSE 293,020,119303,McAuley; Julian John,9999,0,9999,0
1667975428251,CSE 293,021,119304,Micciancio; Daniele,9999,0,9999,0
1667975428251,CSE 293,022,119367,Orailoglu; Alex,9999,0,9999,0
1667975428251,CSE 293,023,119382,Paturi; Ramamohan,9999,0,9999,0
1667975428251,CSE 293,024,119404,Polikarpova; Nadezhda,9999,0,9999,0
1667975428251,CSE 293,025,119406,Politz; Joseph Gibbs,9999,0,9999,0
1667975428251,CSE 293,026,119411,Porter; George M,9999,0,9999,0
1667975428251,CSE 293,027,119414,Porter; Leonard Emerson,9999,0,9999,0
1667975428251,CSE 293,028,119416,Ramamoorthi; Ravi,9999,0,9999,0
1667975428251,CSE 293,029,119417,Sahoo; Debashis,9999,0,9999,0
1667975428251,CSE 293,030,119420,Saul; Lawrence,9999,0,9999,0
1667975428251,CSE 293,031,119421,Savage; Stefan,9999,0,9999,0
1667975428251,CSE 293,032,119425,Schulze; Jurgen P.,9999,0,9999,0
1667975428251,CSE 293,033,119426,Snoeren; Alex C.,9999,0,9999,0
1667975428251,CSE 293,034,119428,Shang; Jingbo,9999,0,9999,0
1667975428251,CSE 293,035,119430,Stefan; Deian,9999,0,9999,0
1667975428251,CSE 293,036,119431,Su; Hao,9999,0,9999,0
1667975428251,CSE 293,037,119433,Swanson; Steven James,9999,0,9999,0
1667975428251,CSE 293,038,119435,Tullsen; Dean Michael,9999,0,9999,0
1667975428251,CSE 293,039,119483,Voelker; Geoffrey M.,9999,0,9999,0
1667975428251,CSE 293,040,119537,Zhao; Jishen,9999,0,9999,0
1667975428251,CSE 293,041,119538,Zhou; Yuan-Yuan,9999,0,9999,0
1667975428251,CSE 293,042,119539,Gao; Sicun,9999,0,9999,0
1667975428251,CSE 293,043,119540,Weibel; Nadir,9999,0,9999,0
1667975428251,CSE 293,044,119541,Gupta; Rajesh K.,9999,0,9999,0
1667975428675,CSE 294,A00,102459,Voelker; Geoffrey M.,0,0,0,0
1667975428675,CSE 294,B00,111322,Orailoglu; Alex,0,0,0,0
1667975429098,DSE 201,A00,096914,Deutsch; Alin Bernard,30,0,30,0
1667975429523,DSE 210,A00,096915,Dasgupta; Sanjoy,30,0,30,0
1667975429949,DSE 260A,A00,096916,Altintas De Callaf; Ilkay,30,0,30,0
1667975430389,ECE 200,001,103586,Antipa; Nicholas A,9999,0,9999,0
1667975430389,ECE 200,002,103587,Atanasov; Nikolay A.,9999,0,9999,0
1667975430389,ECE 200,003,103588,Bharadia; Dinesh,9999,0,9999,0
1667975430389,ECE 200,004,103589,Cheng; Chung Kuan,9999,0,9999,0
1667975430389,ECE 200,005,103590,Cosman; Pamela C.,9999,0,9999,0
1667975430389,ECE 200,006,103591,Dayeh; Shadi Ahmad,9999,0,9999,0
1667975430389,ECE 200,007,103592,Fainman; Yeshaiahu,9999,0,9999,0
1667975430389,ECE 200,008,103593,Ford; Joseph Earl,9999,0,9999,0
1667975430389,ECE 200,009,103594,Franceschetti; Massimo,9999,0,9999,0
1667975430389,ECE 200,010,103595,Fullerton; Eric E,9999,0,9999,0
1667975430389,ECE 200,011,103596,Galton; Ian A,9999,0,9999,0
1667975430389,ECE 200,012,103597,Gilja; Vikash,9999,0,9999,0
1667975430389,ECE 200,013,103598,Hall; Drew A.,9999,0,9999,0
1667975430389,ECE 200,014,103599,Hsueh; Tzu-Chien,9999,0,9999,0
1667975430389,ECE 200,015,103600,Javidi; Tara,9999,0,9999,0
1667975430389,ECE 200,016,103601,Kahng; Andrew Byun,9999,0,9999,0
1667975430389,ECE 200,017,103602,Kim; Young-Han,9999,0,9999,0
1667975430389,ECE 200,018,103603,Koushanfar; Farinaz,9999,0,9999,0
1667975430389,ECE 200,019,103604,Kuzum; Duygu,9999,0,9999,0
1667975430389,ECE 200,020,103605,Le; Hanh-Phuc,9999,0,9999,0
1667975430389,ECE 200,021,103606,Lin; Bill,9999,0,9999,0
1667975430389,ECE 200,022,103607,Liu; Zhaowei,9998,0,9999,1
1667975430389,ECE 200,023,103608,Lo; Yu-Hwa,9999,0,9999,0
1667975430389,ECE 200,024,103609,Lomakin; Vitaliy,9999,0,9999,0
1667975430389,ECE 200,025,103610,Mercier; Patrick Philip,9999,0,9999,0
1667975430389,ECE 200,026,103611,Meyer; Florian,9999,0,9999,0
1667975430389,ECE 200,027,103612,Milstein; Laurence B.,9999,0,9999,0
1667975430389,ECE 200,028,103613,Mir Arabbaygi; Siavash,9999,0,9999,0
1667975430389,ECE 200,029,103614,Mookherjea; Shayan,9999,0,9999,0
1667975430389,ECE 200,030,103615,Morris; Karcher William,9999,0,9999,0
1667975430389,ECE 200,031,103616,Ng; Tse Nga,9999,0,9999,0
1667975430389,ECE 200,032,103617,Nguyen; Truong Quang,9999,0,9999,0
1667975430389,ECE 200,033,103618,Nomura; Kenji,9999,0,9999,0
1667975430389,ECE 200,034,103619,Orlitsky; Alon,9999,0,9999,0
1667975430389,ECE 200,035,103620,Pal; Piya,9999,0,9999,0
1667975430389,ECE 200,036,103621,Papen; George C.,9999,0,9999,0
1667975430389,ECE 200,037,103622,Radic; Stojan,9999,0,9999,0
1667975430389,ECE 200,038,103623,Rao; Bhaskar D.,9999,0,9999,0
1667975430389,ECE 200,039,103624,Rao; Ramesh R,9999,0,9999,0
1667975430389,ECE 200,040,103625,Rebeiz; Gabriel,9999,0,9999,0
1667975430389,ECE 200,041,103626,Sanford; John R,9999,0,9999,0
1667975430389,ECE 200,042,103627,Siegel; Paul H.,9999,0,9999,0
1667975430389,ECE 200,043,103628,Sievenpiper; Daniel F.,9999,0,9999,0
1667975430389,ECE 200,044,103629,Sworder; David D.,9999,0,9999,0
1667975430389,ECE 200,045,103630,Taur; Yuan,9999,0,9999,0
1667975430389,ECE 200,046,103631,Touri; Behrouz,9999,0,9999,0
1667975430389,ECE 200,047,103632,Trivedi; Mohan M.,9999,0,9999,0
1667975430389,ECE 200,048,103633,Vasconcelos; Nuno,9999,0,9999,0
1667975430389,ECE 200,049,103634,Wang; Xiaolong,9999,0,9999,0
1667975430389,ECE 200,050,103635,Xie; Pengtao,9999,0,9999,0
1667975430389,ECE 200,051,103636,Yip; Michael,9999,0,9999,0
1667975430389,ECE 200,052,103637,Zeger; Kenneth A.,999,0,999,0
1667975430389,ECE 200,053,103638,Zhang; Xinyu,9999,0,9999,0
1667975430389,ECE 200,054,103639,Turakhia; Yatish Girish,9999,0,9999,0
1667975430389,ECE 200,055,103640,Kang; Mingu,9999,0,9999,0
1667975430389,ECE 200,056,103641,Shi; Yuanyuan,9999,0,9999,0
1667975430389,ECE 200,057,103642,Wang; Edward Jay,9999,0,9999,0
1667975430389,ECE 200,058,103643,Zheng; Yang,9999,0,9999,0
1667975430814,ECE 202,A00,103644,Kuzum; Duygu,0,0,0,0
1667975431247,ECE 212BN,A00,103646,Ng; Tse Nga,0,0,0,0
1667975431671,ECE 221,A00,111493,Staff,0,0,0,0
1667975432098,ECE 222B,A00,103647,Lomakin; Vitaliy,0,0,0,0
1667975432523,ECE 230B,A00,103648,Taur; Yuan,0,0,0,0
1667975432955,ECE 238B,A00,103649,Garay; Javier,0,0,0,0
1667975433377,ECE 240B,A00,112900,Fainman; Yeshaiahu,0,0,0,0
1667975433800,ECE 247A,A00,103650,Jokerst; Jesse Vincent,0,0,0,0
1667975434232,ECE 247B,A00,103651,Wang; Joseph,0,0,0,0
1667975434661,ECE 250,A00,103652,Siegel; Paul H.,0,0,0,0
1667975435083,ECE 251A,A00,103654,Rao; Bhaskar D.,0,0,0,0
1667975435506,ECE 257B,A00,103655,Bharadia; Dinesh,0,0,0,0
1667975435933,ECE 258A,A00,103656,Milstein; Laurence B.,0,0,0,0
1667975436362,ECE 260B,A00,103658,Kang; Mingu,0,0,0,0
1667975436789,ECE 264A,A00,103659,Galton; Ian A,0,0,0,0
1667975437214,ECE 265A,A00,103661,Gudem; Prasad S.S.,0,0,0,0
1667975437641,ECE 265D,A00,103662,Gudem; Prasad S.S.,0,0,0,0
1667975438075,ECE 268,A00,103663,Koushanfar; Farinaz,0,0,0,0
1667975438502,ECE 269,A01,103665,Pal; Piya,0,0,0,0
1667975438931,ECE 271B,A00,103666,Vasconcelos; Manuela,0,0,0,0
1667975439355,ECE 276A,A00,103667,Atanasov; Nikolay A.,0,0,0,0
1667975439779,ECE 277,A00,103668,An; Cheolhong,0,0,0,0
1667975440206,ECE 279,A00,117947,Hall; Drew A.,0,0,0,0
1667975441052,ECE 283,A00,103670,Hsueh; Tzu-Chien,0,0,0,0
1667975441477,ECE 284,A00,103671,Turakhia; Yatish Girish,0,0,0,0
1667975441899,ECE 285,A00,103672,Zheng; Yang,0,0,0,0
1667975441899,ECE 285,B00,103673,Sworder; David D.,0,0,0,0
1667975442322,ECE 287,A00,103676,Javidi; Tara,0,0,0,0
1667975442745,MATH 200B,A00,098023,Salehi Golsefidy; Alireza,14,0,15,1
1667975443171,MATH 202B,A00,098024,Rhoades; Brendon Patrick,12,0,15,3
1667975443604,MATH 203B,A00,098025,Oprea; Dragos N.,12,0,15,3
1667975444030,MATH 204B,A00,098026,Sorensen; Claus M,14,0,15,1
1667975444454,MATH 208,A00,098027,Izadi; Elham,7,0,10,3
1667975444881,MATH 209,A00,098028,Pollack; Aaron,10,0,10,0
1667975445307,MATH 211A,A00,112919,Rogalski; Daniel,9,0,10,1
1667975445731,MATH 211B,A00,112920,Seward; Brandon M.,9,0,10,1
1667975446155,MATH 218,A00,098029,Li; Bo,10,0,10,0
1667975446577,MATH 220B,A00,098030,Novak; Jonathan I,13,0,15,2
1667975447004,MATH 221A,A00,098031,Ebenfelt; Peter F,13,0,15,2
1667975447429,MATH 231B,A00,098032,Zlatos; Andrej,12,0,15,3
1667975447854,MATH 240B,A00,098033,Ni; Lei,10,0,15,5
1667975448279,MATH 243,A00,098034,Jekel; David Andrew,10,0,10,0
1667975448709,MATH 245A,A00,098035,Nie; Jiawang,0,0,15,16
1667975449138,MATH 248,A00,098036,Bejenaru; Ioan,10,0,10,0
1667975449562,MATH 250B,A00,098037,Spolaor; Luca,14,0,15,1
1667975449991,MATH 258,A00,098038,Ni; Lei,10,0,10,0
1667975450421,MATH 264B,A00,098041,Rhoades; Brendon Patrick,12,0,15,3
1667975450846,MATH 268,A00,098042,Buss; Samuel R,10,0,10,0
1667975451277,MATH 269,A00,098043,Rhoades; Brendon Patrick,10,0,10,0
1667975451700,MATH 270B,A00,098044,Li; Bo,11,0,15,4
1667975452123,MATH 272B,A00,098045,Holst; Michael J,13,0,15,2
1667975452549,MATH 273A,A00,098046,Tian; Xiaochuan,12,0,15,3
1667975452978,MATH 275,A01,098048,Tian; Xiaochuan,6,0,10,4
1667975453402,MATH 278A,A00,098049,Holst; Michael J,8,0,10,2
1667975453830,MATH 278B,A00,098050,Cloninger; Alexander,10,0,10,0
1667975454254,MATH 278C,A00,098051,Nie; Jiawang,8,0,10,2
1667975454679,MATH 280B,A00,098052,Zheng; Tianyi,11,0,15,4
1667975455106,MATH 281B,A00,098053,Bradic; Jelena,4,0,15,11
1667975455530,MATH 282B,A00,098054,Arias-Castro; Ery,2,0,15,13
1667975455953,MATH 285,A00,098055,Fitzsimmons; Patrick J,0,0,15,17
1667975456378,MATH 287B,A00,098056,Arias-Castro; Ery,5,0,15,10
1667975456801,MATH 288,A00,098057,Agarwal; Pooja,9,0,10,1
1667975456801,MATH 288,B00,098058,Zhang; Danna,9,0,10,1
1667975456801,MATH 288,C00,098059,Williams; Ruth J,10,0,10,0
1667975457225,MATH 290B,A00,098060,Roberts; Justin Deritter,14,0,15,1
1667975457646,MATH 292,A00,098061,Belmont; Eva Kinoshita,10,0,10,0
1667975458069,MATH 295,A00,098062,Suk; Andrew Hoon,48,0,50,2
1667975458493,MATH 296,A00,098063,Novak; Jonathan I,20,0,20,0
1667975458915,MATH 297,001,098064,Gamst; Anthony Collins,9997,0,9999,2
1667975958064,COGS 205,A00,101395,Chiba; Andrea,19,0,20,1
1667975958492,COGS 210B,001,101404,Greene; Deanna Jacquelyn,9998,0,9999,1
1667975958492,COGS 210B,002,101417,Xia; Haijun,9999,0,9999,0
1667975958492,COGS 210B,003,101422,Nitz; Douglas A.,9999,0,9999,0
1667975958492,COGS 210B,004,101423,Hollan; James D.,9998,0,9999,1
1667975958492,COGS 210B,005,101424,Deak; Gedeon O.,9999,0,9999,0
1667975958492,COGS 210B,006,101425,Rossano; Federico,9999,0,9999,0
1667975958920,COGS 211B,A00,101427,Coulson; Seana M,9997,0,9999,2
1667975959342,COGS 220,A00,101428,Hollan; James D.,0,0,25,25
1667975959766,COGS 229,A00,101429,Dow; Steven P,18,0,25,7
1667975960188,COGS 230,A00,101430,Klemmer; Scott R,13,0,17,4
1667975960615,COGS 234,A00,101431,Xia; Haijun,7,0,25,18
1667975961039,COGS 260,A00,101432,Kiyonaga; Anastasia,20,0,25,5
1667975961039,COGS 260,B00,101433,Kirsh; David Joel,16,0,25,9
1667975961460,CSE 202,A00,102371,Impagliazzo; Russell,0,0,0,0
1667975961904,CSE 203B,A01,102373,Cheng; Chung Kuan,0,0,0,0
1667975962327,CSE 208,A00,102374,Micciancio; Daniele,0,0,0,0
1667975962752,CSE 209A,A00,112895,Impagliazzo; Russell,0,0,15,15
1667975963174,CSE 209B,A00,108005,Bellare; Mihir,0,0,0,0
1667975963597,CSE 210,A00,113163,Coblenz; Michael J,0,0,0,0
1667975964027,CSE 219,A00,106111,Dow; Steven P,0,0,20,20
1667975964456,CSE 221,A00,102376,Voelker; Geoffrey M.,0,0,0,0
1667975964879,CSE 224,A01,102378,Porter; George M,0,0,0,0
1667975965310,CSE 229A,A00,102379,Savage; Stefan,0,0,0,0
1667975965735,CSE 229C,A00,102380,Munyaka; Imani N. S.,0,0,0,0
1667975966163,CSE 232B,A00,102382,Deutsch; Alin Bernard,0,0,0,0
1667975966587,CSE 234,A01,112904,Kumar; Arun Kumar,0,0,0,0
1667975967013,CSE 237A,A00,102383,Rosing; Tajana Simunic,0,0,0,0
1667975967439,CSE 239A,A00,102384,Deutsch; Alin Bernard,0,0,0,0
1667975967865,CSE 239B,A00,102385,Polikarpova; Nadezhda,0,0,0,0
1667975968290,CSE 240A,A00,102386,Pannuto; Patrick William,0,0,0,0
1667975968718,CSE 240B,A00,102387,Zhao; Jishen,0,0,0,0
1667975969144,CSE 241A,A00,106406,Kang; Mingu,0,0,0,0
1667975969568,CSE 249B,A00,102388,Kahng; Andrew Byun,0,0,8,8
1667975969990,CSE 251B,A01,102392,Cottrell; Garrison W,0,0,0,0
1667975969990,CSE 251B,A02,102393,Cottrell; Garrison W,0,0,0,0
1667975970421,CSE 252B,A00,102394,Ochoa; Benjamin Lawrence,0,0,0,0
1667975970846,CSE 257,A01,102396,Gao; Sicun,0,0,0,0
1667975971270,CSE 272,A00,102397,Li; Tzumao,0,0,0,0
1667975971694,CSE 274,A00,111323,Chern; Albert Ren-Haur,0,0,0,0
1667975972121,CSE 282,A00,102398,Pevzner; Pavel Arkadjevich,0,0,0,0
1667975972551,CSE 284,A00,114175,Gymrek; Melissa Ann,0,0,0,0
1667975972975,CSE 290,A00,102399,Chandraker; Manmohan Krishna,0,0,0,0
1667975972975,CSE 290,B00,102400,Vaccaro; Kristen Marie,0,0,25,25
1667975972975,CSE 290,C00,102414,Pannuto; Patrick William,0,0,25,25
1667975972975,CSE 290,D00,102427,Pevzner; Pavel Arkadjevich,0,0,0,0
1667975972975,CSE 290,E00,102429,Zhao; Jishen,0,0,0,0
1667975972975,CSE 290,F00,102436,Tullsen; Dean Michael,0,0,0,0
1667975972975,CSE 290,G00,102440,Christensen; Henrik I,0,0,20,20
1667975973402,CSE 291,A00,102443,Su; Hao,0,0,0,0
1667975973402,CSE 291,B00,102448,Polikarpova; Nadezhda,0,0,0,0
1667975973402,CSE 291,C00,102453,Vaccaro; Kristen Marie,0,0,0,0
1667975973402,CSE 291,D00,111343,Savage; Stefan,0,0,0,0
1667975973402,CSE 291,E00,116474,Claffy; Kimberly Claire,0,0,0,0
1667975973402,CSE 291,F00,116479,Pasquale; Joseph,0,0,0,0
1667975973871,CSE 293,001,119111,Bafna; Vineet,9999,0,9999,0
1667975973871,CSE 293,002,119118,Bellare; Mihir,9999,0,9999,0
1667975973871,CSE 293,003,119122,Berg-Kirkpatrick; Taylor D,9999,0,9999,0
1667975973871,CSE 293,004,119135,Christensen; Henrik I,9999,0,9999,0
1667975973871,CSE 293,005,119142,Cottrell; Garrison W,9999,0,9999,0
1667975973871,CSE 293,006,119146,Deutsch; Alin Bernard,9999,0,9999,0
1667975973871,CSE 293,007,119159,Esmaeilzadeh; Hadi,9999,0,9999,0
1667975973871,CSE 293,008,119166,Freund; Yoav,9999,0,9999,0
1667975973871,CSE 293,009,119170,Griswold; William G.,9999,0,9999,0
1667975973871,CSE 293,010,119183,Gymrek; Melissa Ann,9999,0,9999,0
1667975973871,CSE 293,011,119190,Heninger; Nadia A,9999,0,9999,0
1667975973871,CSE 293,012,119230,Impagliazzo; Russell,9999,0,9999,0
1667975973871,CSE 293,013,119232,Jhala; Ranjit,9999,0,9999,0
1667975973871,CSE 293,014,119233,Kahng; Andrew Byun,9999,0,9999,0
1667975973871,CSE 293,015,119298,Kane; Daniel Mertz,9999,0,9999,0
1667975973871,CSE 293,016,119299,Kriegman; David J,9999,0,9999,0
1667975973871,CSE 293,017,119300,Kumar; Arun Kumar,9999,0,9999,0
1667975973871,CSE 293,018,119301,Lerner; Sorin,9999,0,9999,0
1667975973871,CSE 293,019,119302,Lovett; Shachar,9999,0,9999,0
1667975973871,CSE 293,020,119303,McAuley; Julian John,9999,0,9999,0
1667975973871,CSE 293,021,119304,Micciancio; Daniele,9999,0,9999,0
1667975973871,CSE 293,022,119367,Orailoglu; Alex,9999,0,9999,0
1667975973871,CSE 293,023,119382,Paturi; Ramamohan,9999,0,9999,0
1667975973871,CSE 293,024,119404,Polikarpova; Nadezhda,9999,0,9999,0
1667975973871,CSE 293,025,119406,Politz; Joseph Gibbs,9999,0,9999,0
1667975973871,CSE 293,026,119411,Porter; George M,9999,0,9999,0
1667975973871,CSE 293,027,119414,Porter; Leonard Emerson,9999,0,9999,0
1667975973871,CSE 293,028,119416,Ramamoorthi; Ravi,9999,0,9999,0
1667975973871,CSE 293,029,119417,Sahoo; Debashis,9999,0,9999,0
1667975973871,CSE 293,030,119420,Saul; Lawrence,9999,0,9999,0
1667975973871,CSE 293,031,119421,Savage; Stefan,9999,0,9999,0
1667975973871,CSE 293,032,119425,Schulze; Jurgen P.,9999,0,9999,0
1667975973871,CSE 293,033,119426,Snoeren; Alex C.,9999,0,9999,0
1667975973871,CSE 293,034,119428,Shang; Jingbo,9999,0,9999,0
1667975973871,CSE 293,035,119430,Stefan; Deian,9999,0,9999,0
1667975973871,CSE 293,036,119431,Su; Hao,9999,0,9999,0
1667975973871,CSE 293,037,119433,Swanson; Steven James,9999,0,9999,0
1667975973871,CSE 293,038,119435,Tullsen; Dean Michael,9999,0,9999,0
1667975973871,CSE 293,039,119483,Voelker; Geoffrey M.,9999,0,9999,0
1667975973871,CSE 293,040,119537,Zhao; Jishen,9999,0,9999,0
1667975973871,CSE 293,041,119538,Zhou; Yuan-Yuan,9999,0,9999,0
1667975973871,CSE 293,042,119539,Gao; Sicun,9999,0,9999,0
1667975973871,CSE 293,043,119540,Weibel; Nadir,9999,0,9999,0
1667975973871,CSE 293,044,119541,Gupta; Rajesh K.,9999,0,9999,0
1667975974294,CSE 294,A00,102459,Voelker; Geoffrey M.,0,0,0,0
1667975974294,CSE 294,B00,111322,Orailoglu; Alex,0,0,0,0
1667975974721,DSE 201,A00,096914,Deutsch; Alin Bernard,30,0,30,0
1667975975144,DSE 210,A00,096915,Dasgupta; Sanjoy,30,0,30,0
1667975975576,DSE 260A,A00,096916,Altintas De Callaf; Ilkay,30,0,30,0
1667975976005,ECE 200,001,103586,Antipa; Nicholas A,9999,0,9999,0
1667975976005,ECE 200,002,103587,Atanasov; Nikolay A.,9999,0,9999,0
1667975976005,ECE 200,003,103588,Bharadia; Dinesh,9999,0,9999,0
1667975976005,ECE 200,004,103589,Cheng; Chung Kuan,9999,0,9999,0
1667975976005,ECE 200,005,103590,Cosman; Pamela C.,9999,0,9999,0
1667975976005,ECE 200,006,103591,Dayeh; Shadi Ahmad,9999,0,9999,0
1667975976005,ECE 200,007,103592,Fainman; Yeshaiahu,9999,0,9999,0
1667975976005,ECE 200,008,103593,Ford; Joseph Earl,9999,0,9999,0
1667975976005,ECE 200,009,103594,Franceschetti; Massimo,9999,0,9999,0
1667975976005,ECE 200,010,103595,Fullerton; Eric E,9999,0,9999,0
1667975976005,ECE 200,011,103596,Galton; Ian A,9999,0,9999,0
1667975976005,ECE 200,012,103597,Gilja; Vikash,9999,0,9999,0
1667975976005,ECE 200,013,103598,Hall; Drew A.,9999,0,9999,0
1667975976005,ECE 200,014,103599,Hsueh; Tzu-Chien,9999,0,9999,0
1667975976005,ECE 200,015,103600,Javidi; Tara,9999,0,9999,0
1667975976005,ECE 200,016,103601,Kahng; Andrew Byun,9999,0,9999,0
1667975976005,ECE 200,017,103602,Kim; Young-Han,9999,0,9999,0
1667975976005,ECE 200,018,103603,Koushanfar; Farinaz,9999,0,9999,0
1667975976005,ECE 200,019,103604,Kuzum; Duygu,9999,0,9999,0
1667975976005,ECE 200,020,103605,Le; Hanh-Phuc,9999,0,9999,0
1667975976005,ECE 200,021,103606,Lin; Bill,9999,0,9999,0
1667975976005,ECE 200,022,103607,Liu; Zhaowei,9998,0,9999,1
1667975976005,ECE 200,023,103608,Lo; Yu-Hwa,9999,0,9999,0
1667975976005,ECE 200,024,103609,Lomakin; Vitaliy,9999,0,9999,0
1667975976005,ECE 200,025,103610,Mercier; Patrick Philip,9999,0,9999,0
1667975976005,ECE 200,026,103611,Meyer; Florian,9999,0,9999,0
1667975976005,ECE 200,027,103612,Milstein; Laurence B.,9999,0,9999,0
1667975976005,ECE 200,028,103613,Mir Arabbaygi; Siavash,9999,0,9999,0
1667975976005,ECE 200,029,103614,Mookherjea; Shayan,9999,0,9999,0
1667975976005,ECE 200,030,103615,Morris; Karcher William,9999,0,9999,0
1667975976005,ECE 200,031,103616,Ng; Tse Nga,9999,0,9999,0
1667975976005,ECE 200,032,103617,Nguyen; Truong Quang,9999,0,9999,0
1667975976005,ECE 200,033,103618,Nomura; Kenji,9999,0,9999,0
1667975976005,ECE 200,034,103619,Orlitsky; Alon,9999,0,9999,0
1667975976005,ECE 200,035,103620,Pal; Piya,9999,0,9999,0
1667975976005,ECE 200,036,103621,Papen; George C.,9999,0,9999,0
1667975976005,ECE 200,037,103622,Radic; Stojan,9999,0,9999,0
1667975976005,ECE 200,038,103623,Rao; Bhaskar D.,9999,0,9999,0
1667975976005,ECE 200,039,103624,Rao; Ramesh R,9999,0,9999,0
1667975976005,ECE 200,040,103625,Rebeiz; Gabriel,9999,0,9999,0
1667975976005,ECE 200,041,103626,Sanford; John R,9999,0,9999,0
1667975976005,ECE 200,042,103627,Siegel; Paul H.,9999,0,9999,0
1667975976005,ECE 200,043,103628,Sievenpiper; Daniel F.,9999,0,9999,0
1667975976005,ECE 200,044,103629,Sworder; David D.,9999,0,9999,0
1667975976005,ECE 200,045,103630,Taur; Yuan,9999,0,9999,0
1667975976005,ECE 200,046,103631,Touri; Behrouz,9999,0,9999,0
1667975976005,ECE 200,047,103632,Trivedi; Mohan M.,9999,0,9999,0
1667975976005,ECE 200,048,103633,Vasconcelos; Nuno,9999,0,9999,0
1667975976005,ECE 200,049,103634,Wang; Xiaolong,9999,0,9999,0
1667975976005,ECE 200,050,103635,Xie; Pengtao,9999,0,9999,0
1667975976005,ECE 200,051,103636,Yip; Michael,9999,0,9999,0
1667975976005,ECE 200,052,103637,Zeger; Kenneth A.,999,0,999,0
1667975976005,ECE 200,053,103638,Zhang; Xinyu,9999,0,9999,0
1667975976005,ECE 200,054,103639,Turakhia; Yatish Girish,9999,0,9999,0
1667975976005,ECE 200,055,103640,Kang; Mingu,9999,0,9999,0
1667975976005,ECE 200,056,103641,Shi; Yuanyuan,9999,0,9999,0
1667975976005,ECE 200,057,103642,Wang; Edward Jay,9999,0,9999,0
1667975976005,ECE 200,058,103643,Zheng; Yang,9999,0,9999,0
1667975976429,ECE 202,A00,103644,Kuzum; Duygu,0,0,0,0
1667975976851,ECE 212BN,A00,103646,Ng; Tse Nga,0,0,0,0
1667975977278,ECE 221,A00,111493,Staff,0,0,0,0
1667975977705,ECE 222B,A00,103647,Lomakin; Vitaliy,0,0,0,0
1667975978127,ECE 230B,A00,103648,Taur; Yuan,0,0,0,0
1667975978554,ECE 238B,A00,103649,Garay; Javier,0,0,0,0
1667975978978,ECE 240B,A00,112900,Fainman; Yeshaiahu,0,0,0,0
1667975979400,ECE 247A,A00,103650,Jokerst; Jesse Vincent,0,0,0,0
1667975979827,ECE 247B,A00,103651,Wang; Joseph,0,0,0,0
1667975980252,ECE 250,A00,103652,Siegel; Paul H.,0,0,0,0
1667975980677,ECE 251A,A00,103654,Rao; Bhaskar D.,0,0,0,0
1667975981102,ECE 257B,A00,103655,Bharadia; Dinesh,0,0,0,0
1667975981525,ECE 258A,A00,103656,Milstein; Laurence B.,0,0,0,0
1667975981947,ECE 260B,A00,103658,Kang; Mingu,0,0,0,0
1667975982379,ECE 264A,A00,103659,Galton; Ian A,0,0,0,0
1667975982814,ECE 265A,A00,103661,Gudem; Prasad S.S.,0,0,0,0
1667975983238,ECE 265D,A00,103662,Gudem; Prasad S.S.,0,0,0,0
1667975983665,ECE 268,A00,103663,Koushanfar; Farinaz,0,0,0,0
1667975984091,ECE 269,A01,103665,Pal; Piya,0,0,0,0
1667975984517,ECE 271B,A00,103666,Vasconcelos; Manuela,0,0,0,0
1667975984940,ECE 276A,A00,103667,Atanasov; Nikolay A.,0,0,0,0
1667975985362,ECE 277,A00,103668,An; Cheolhong,0,0,0,0
1667975985881,ECE 279,A00,117947,Hall; Drew A.,0,0,0,0
1667975986747,ECE 283,A00,103670,Hsueh; Tzu-Chien,0,0,0,0
1667975987171,ECE 284,A00,103671,Turakhia; Yatish Girish,0,0,0,0
1667975987597,ECE 285,A00,103672,Zheng; Yang,0,0,0,0
1667975987597,ECE 285,B00,103673,Sworder; David D.,0,0,0,0
1667975988024,ECE 287,A00,103676,Javidi; Tara,0,0,0,0
1667975988454,MATH 200B,A00,098023,Salehi Golsefidy; Alireza,14,0,15,1
1667975988879,MATH 202B,A00,098024,Rhoades; Brendon Patrick,12,0,15,3
1667975989304,MATH 203B,A00,098025,Oprea; Dragos N.,12,0,15,3
1667975989728,MATH 204B,A00,098026,Sorensen; Claus M,14,0,15,1
1667975990149,MATH 208,A00,098027,Izadi; Elham,7,0,10,3
1667975990572,MATH 209,A00,098028,Pollack; Aaron,10,0,10,0
1667975990994,MATH 211A,A00,112919,Rogalski; Daniel,9,0,10,1
1667975991417,MATH 211B,A00,112920,Seward; Brandon M.,9,0,10,1
1667975991842,MATH 218,A00,098029,Li; Bo,10,0,10,0
1667975992265,MATH 220B,A00,098030,Novak; Jonathan I,13,0,15,2
1667975992692,MATH 221A,A00,098031,Ebenfelt; Peter F,13,0,15,2
1667975993115,MATH 231B,A00,098032,Zlatos; Andrej,12,0,15,3
1667975993537,MATH 240B,A00,098033,Ni; Lei,10,0,15,5
1667975993963,MATH 243,A00,098034,Jekel; David Andrew,10,0,10,0
1667975994387,MATH 245A,A00,098035,Nie; Jiawang,0,0,15,16
1667975994809,MATH 248,A00,098036,Bejenaru; Ioan,10,0,10,0
1667975995239,MATH 250B,A00,098037,Spolaor; Luca,14,0,15,1
1667975995665,MATH 258,A00,098038,Ni; Lei,10,0,10,0
1667975996092,MATH 264B,A00,098041,Rhoades; Brendon Patrick,12,0,15,3
1667975996515,MATH 268,A00,098042,Buss; Samuel R,10,0,10,0
1667975996942,MATH 269,A00,098043,Rhoades; Brendon Patrick,10,0,10,0
1667975997369,MATH 270B,A00,098044,Li; Bo,11,0,15,4
1667975997796,MATH 272B,A00,098045,Holst; Michael J,13,0,15,2
1667975998223,MATH 273A,A00,098046,Tian; Xiaochuan,12,0,15,3
1667975998646,MATH 275,A01,098048,Tian; Xiaochuan,6,0,10,4
1667975999069,MATH 278A,A00,098049,Holst; Michael J,8,0,10,2
1667975999491,MATH 278B,A00,098050,Cloninger; Alexander,10,0,10,0
1667975999914,MATH 278C,A00,098051,Nie; Jiawang,8,0,10,2
1667976000343,MATH 280B,A00,098052,Zheng; Tianyi,11,0,15,4
1667976000765,MATH 281B,A00,098053,Bradic; Jelena,4,0,15,11
1667976001189,MATH 282B,A00,098054,Arias-Castro; Ery,2,0,15,13
1667976001611,MATH 285,A00,098055,Fitzsimmons; Patrick J,0,0,15,17
1667976002037,MATH 287B,A00,098056,Arias-Castro; Ery,5,0,15,10
1667976002462,MATH 288,A00,098057,Agarwal; Pooja,9,0,10,1
1667976002462,MATH 288,B00,098058,Zhang; Danna,9,0,10,1
1667976002462,MATH 288,C00,098059,Williams; Ruth J,10,0,10,0
1667976002892,MATH 290B,A00,098060,Roberts; Justin Deritter,14,0,15,1
1667976003331,MATH 292,A00,098061,Belmont; Eva Kinoshita,10,0,10,0
1667976003761,MATH 295,A00,098062,Suk; Andrew Hoon,48,0,50,2
1667976004195,MATH 296,A00,098063,Novak; Jonathan I,20,0,20,0
1667976004627,MATH 297,001,098064,Gamst; Anthony Collins,9997,0,9999,2
1667976503618,COGS 205,A00,101395,Chiba; Andrea,19,0,20,1
1667976504044,COGS 210B,001,101404,Greene; Deanna Jacquelyn,9998,0,9999,1
1667976504044,COGS 210B,002,101417,Xia; Haijun,9999,0,9999,0
1667976504044,COGS 210B,003,101422,Nitz; Douglas A.,9999,0,9999,0
1667976504044,COGS 210B,004,101423,Hollan; James D.,9998,0,9999,1
1667976504044,COGS 210B,005,101424,Deak; Gedeon O.,9999,0,9999,0
1667976504044,COGS 210B,006,101425,Rossano; Federico,9999,0,9999,0
1667976504467,COGS 211B,A00,101427,Coulson; Seana M,9997,0,9999,2
1667976504981,COGS 220,A00,101428,Hollan; James D.,0,0,25,25
1667976505405,COGS 229,A00,101429,Dow; Steven P,18,0,25,7
1667976505828,COGS 230,A00,101430,Klemmer; Scott R,13,0,17,4
1667976506251,COGS 234,A00,101431,Xia; Haijun,7,0,25,18
1667976506677,COGS 260,A00,101432,Kiyonaga; Anastasia,20,0,25,5
1667976506677,COGS 260,B00,101433,Kirsh; David Joel,16,0,25,9
1667976507101,CSE 202,A00,102371,Impagliazzo; Russell,0,0,0,0
1667976507528,CSE 203B,A01,102373,Cheng; Chung Kuan,0,0,0,0
1667976507950,CSE 208,A00,102374,Micciancio; Daniele,0,0,0,0
1667976508375,CSE 209A,A00,112895,Impagliazzo; Russell,0,0,15,15
1667976508806,CSE 209B,A00,108005,Bellare; Mihir,0,0,0,0
1667976509238,CSE 210,A00,113163,Coblenz; Michael J,0,0,0,0
1667976509667,CSE 219,A00,106111,Dow; Steven P,0,0,20,20
1667976510094,CSE 221,A00,102376,Voelker; Geoffrey M.,0,0,0,0
1667976510518,CSE 224,A01,102378,Porter; George M,0,0,0,0
1667976510946,CSE 229A,A00,102379,Savage; Stefan,0,0,0,0
1667976511371,CSE 229C,A00,102380,Munyaka; Imani N. S.,0,0,0,0
1667976511798,CSE 232B,A00,102382,Deutsch; Alin Bernard,0,0,0,0
1667976512221,CSE 234,A01,112904,Kumar; Arun Kumar,0,0,0,0
1667976512644,CSE 237A,A00,102383,Rosing; Tajana Simunic,0,0,0,0
1667976513067,CSE 239A,A00,102384,Deutsch; Alin Bernard,0,0,0,0
1667976513495,CSE 239B,A00,102385,Polikarpova; Nadezhda,0,0,0,0
1667976513920,CSE 240A,A00,102386,Pannuto; Patrick William,0,0,0,0
1667976514347,CSE 240B,A00,102387,Zhao; Jishen,0,0,0,0
1667976514772,CSE 241A,A00,106406,Kang; Mingu,0,0,0,0
1667976515196,CSE 249B,A00,102388,Kahng; Andrew Byun,0,0,8,8
1667976515621,CSE 251B,A01,102392,Cottrell; Garrison W,0,0,0,0
1667976515621,CSE 251B,A02,102393,Cottrell; Garrison W,0,0,0,0
1667976516051,CSE 252B,A00,102394,Ochoa; Benjamin Lawrence,0,0,0,0
1667976516474,CSE 257,A01,102396,Gao; Sicun,0,0,0,0
1667976516908,CSE 272,A00,102397,Li; Tzumao,0,0,0,0
1667976517336,CSE 274,A00,111323,Chern; Albert Ren-Haur,0,0,0,0
1667976517759,CSE 282,A00,102398,Pevzner; Pavel Arkadjevich,0,0,0,0
1667976518182,CSE 284,A00,114175,Gymrek; Melissa Ann,0,0,0,0
1667976518608,CSE 290,A00,102399,Chandraker; Manmohan Krishna,0,0,0,0
1667976518608,CSE 290,B00,102400,Vaccaro; Kristen Marie,0,0,25,25
1667976518608,CSE 290,C00,102414,Pannuto; Patrick William,0,0,25,25
1667976518608,CSE 290,D00,102427,Pevzner; Pavel Arkadjevich,0,0,0,0
1667976518608,CSE 290,E00,102429,Zhao; Jishen,0,0,0,0
1667976518608,CSE 290,F00,102436,Tullsen; Dean Michael,0,0,0,0
1667976518608,CSE 290,G00,102440,Christensen; Henrik I,0,0,20,20
1667976519032,CSE 291,A00,102443,Su; Hao,0,0,0,0
1667976519032,CSE 291,B00,102448,Polikarpova; Nadezhda,0,0,0,0
1667976519032,CSE 291,C00,102453,Vaccaro; Kristen Marie,0,0,0,0
1667976519032,CSE 291,D00,111343,Savage; Stefan,0,0,0,0
1667976519032,CSE 291,E00,116474,Claffy; Kimberly Claire,0,0,0,0
1667976519032,CSE 291,F00,116479,Pasquale; Joseph,0,0,0,0
1667976519465,CSE 293,001,119111,Bafna; Vineet,9999,0,9999,0
1667976519465,CSE 293,002,119118,Bellare; Mihir,9999,0,9999,0
1667976519465,CSE 293,003,119122,Berg-Kirkpatrick; Taylor D,9999,0,9999,0
1667976519465,CSE 293,004,119135,Christensen; Henrik I,9999,0,9999,0
1667976519465,CSE 293,005,119142,Cottrell; Garrison W,9999,0,9999,0
1667976519465,CSE 293,006,119146,Deutsch; Alin Bernard,9999,0,9999,0
1667976519465,CSE 293,007,119159,Esmaeilzadeh; Hadi,9999,0,9999,0
1667976519465,CSE 293,008,119166,Freund; Yoav,9999,0,9999,0
1667976519465,CSE 293,009,119170,Griswold; William G.,9999,0,9999,0
1667976519465,CSE 293,010,119183,Gymrek; Melissa Ann,9999,0,9999,0
1667976519465,CSE 293,011,119190,Heninger; Nadia A,9999,0,9999,0
1667976519465,CSE 293,012,119230,Impagliazzo; Russell,9999,0,9999,0
1667976519465,CSE 293,013,119232,Jhala; Ranjit,9999,0,9999,0
1667976519465,CSE 293,014,119233,Kahng; Andrew Byun,9999,0,9999,0
1667976519465,CSE 293,015,119298,Kane; Daniel Mertz,9999,0,9999,0
1667976519465,CSE 293,016,119299,Kriegman; David J,9999,0,9999,0
1667976519465,CSE 293,017,119300,Kumar; Arun Kumar,9999,0,9999,0
1667976519465,CSE 293,018,119301,Lerner; Sorin,9999,0,9999,0
1667976519465,CSE 293,019,119302,Lovett; Shachar,9999,0,9999,0
1667976519465,CSE 293,020,119303,McAuley; Julian John,9999,0,9999,0
1667976519465,CSE 293,021,119304,Micciancio; Daniele,9999,0,9999,0
1667976519465,CSE 293,022,119367,Orailoglu; Alex,9999,0,9999,0
1667976519465,CSE 293,023,119382,Paturi; Ramamohan,9999,0,9999,0
1667976519465,CSE 293,024,119404,Polikarpova; Nadezhda,9999,0,9999,0
1667976519465,CSE 293,025,119406,Politz; Joseph Gibbs,9999,0,9999,0
1667976519465,CSE 293,026,119411,Porter; George M,9999,0,9999,0
1667976519465,CSE 293,027,119414,Porter; Leonard Emerson,9999,0,9999,0
1667976519465,CSE 293,028,119416,Ramamoorthi; Ravi,9999,0,9999,0
1667976519465,CSE 293,029,119417,Sahoo; Debashis,9999,0,9999,0
1667976519465,CSE 293,030,119420,Saul; Lawrence,9999,0,9999,0
1667976519465,CSE 293,031,119421,Savage; Stefan,9999,0,9999,0
1667976519465,CSE 293,032,119425,Schulze; Jurgen P.,9999,0,9999,0
1667976519465,CSE 293,033,119426,Snoeren; Alex C.,9999,0,9999,0
1667976519465,CSE 293,034,119428,Shang; Jingbo,9999,0,9999,0
1667976519465,CSE 293,035,119430,Stefan; Deian,9999,0,9999,0
1667976519465,CSE 293,036,119431,Su; Hao,9999,0,9999,0
1667976519465,CSE 293,037,119433,Swanson; Steven James,9999,0,9999,0
1667976519465,CSE 293,038,119435,Tullsen; Dean Michael,9999,0,9999,0
1667976519465,CSE 293,039,119483,Voelker; Geoffrey M.,9999,0,9999,0
1667976519465,CSE 293,040,119537,Zhao; Jishen,9999,0,9999,0
1667976519465,CSE 293,041,119538,Zhou; Yuan-Yuan,9999,0,9999,0
1667976519465,CSE 293,042,119539,Gao; Sicun,9999,0,9999,0
1667976519465,CSE 293,043,119540,Weibel; Nadir,9999,0,9999,0
1667976519465,CSE 293,044,119541,Gupta; Rajesh K.,9999,0,9999,0
1667976519887,CSE 294,A00,102459,Voelker; Geoffrey M.,0,0,0,0
1667976519887,CSE 294,B00,111322,Orailoglu; Alex,0,0,0,0
1667976520309,DSE 201,A00,096914,Deutsch; Alin Bernard,30,0,30,0
1667976520734,DSE 210,A00,096915,Dasgupta; Sanjoy,30,0,30,0
1667976521155,DSE 260A,A00,096916,Altintas De Callaf; Ilkay,30,0,30,0
1667976521605,ECE 200,001,103586,Antipa; Nicholas A,9999,0,9999,0
1667976521605,ECE 200,002,103587,Atanasov; Nikolay A.,9999,0,9999,0
1667976521605,ECE 200,003,103588,Bharadia; Dinesh,9999,0,9999,0
1667976521605,ECE 200,004,103589,Cheng; Chung Kuan,9999,0,9999,0
1667976521605,ECE 200,005,103590,Cosman; Pamela C.,9999,0,9999,0
1667976521605,ECE 200,006,103591,Dayeh; Shadi Ahmad,9999,0,9999,0
1667976521605,ECE 200,007,103592,Fainman; Yeshaiahu,9999,0,9999,0
1667976521605,ECE 200,008,103593,Ford; Joseph Earl,9999,0,9999,0
1667976521605,ECE 200,009,103594,Franceschetti; Massimo,9999,0,9999,0
1667976521605,ECE 200,010,103595,Fullerton; Eric E,9999,0,9999,0
1667976521605,ECE 200,011,103596,Galton; Ian A,9999,0,9999,0
1667976521605,ECE 200,012,103597,Gilja; Vikash,9999,0,9999,0
1667976521605,ECE 200,013,103598,Hall; Drew A.,9999,0,9999,0
1667976521605,ECE 200,014,103599,Hsueh; Tzu-Chien,9999,0,9999,0
1667976521605,ECE 200,015,103600,Javidi; Tara,9999,0,9999,0
1667976521605,ECE 200,016,103601,Kahng; Andrew Byun,9999,0,9999,0
1667976521605,ECE 200,017,103602,Kim; Young-Han,9999,0,9999,0
1667976521605,ECE 200,018,103603,Koushanfar; Farinaz,9999,0,9999,0
1667976521605,ECE 200,019,103604,Kuzum; Duygu,9999,0,9999,0
1667976521605,ECE 200,020,103605,Le; Hanh-Phuc,9999,0,9999,0
1667976521605,ECE 200,021,103606,Lin; Bill,9999,0,9999,0
1667976521605,ECE 200,022,103607,Liu; Zhaowei,9998,0,9999,1
1667976521605,ECE 200,023,103608,Lo; Yu-Hwa,9999,0,9999,0
1667976521605,ECE 200,024,103609,Lomakin; Vitaliy,9999,0,9999,0
1667976521605,ECE 200,025,103610,Mercier; Patrick Philip,9999,0,9999,0
1667976521605,ECE 200,026,103611,Meyer; Florian,9999,0,9999,0
1667976521605,ECE 200,027,103612,Milstein; Laurence B.,9999,0,9999,0
1667976521605,ECE 200,028,103613,Mir Arabbaygi; Siavash,9999,0,9999,0
1667976521605,ECE 200,029,103614,Mookherjea; Shayan,9999,0,9999,0
1667976521605,ECE 200,030,103615,Morris; Karcher William,9999,0,9999,0
1667976521605,ECE 200,031,103616,Ng; Tse Nga,9999,0,9999,0
1667976521605,ECE 200,032,103617,Nguyen; Truong Quang,9999,0,9999,0
1667976521605,ECE 200,033,103618,Nomura; Kenji,9999,0,9999,0
1667976521605,ECE 200,034,103619,Orlitsky; Alon,9999,0,9999,0
1667976521605,ECE 200,035,103620,Pal; Piya,9999,0,9999,0
1667976521605,ECE 200,036,103621,Papen; George C.,9999,0,9999,0
1667976521605,ECE 200,037,103622,Radic; Stojan,9999,0,9999,0
1667976521605,ECE 200,038,103623,Rao; Bhaskar D.,9999,0,9999,0
1667976521605,ECE 200,039,103624,Rao; Ramesh R,9999,0,9999,0
1667976521605,ECE 200,040,103625,Rebeiz; Gabriel,9999,0,9999,0
1667976521605,ECE 200,041,103626,Sanford; John R,9999,0,9999,0
1667976521605,ECE 200,042,103627,Siegel; Paul H.,9999,0,9999,0
1667976521605,ECE 200,043,103628,Sievenpiper; Daniel F.,9999,0,9999,0
1667976521605,ECE 200,044,103629,Sworder; David D.,9999,0,9999,0
1667976521605,ECE 200,045,103630,Taur; Yuan,9999,0,9999,0
1667976521605,ECE 200,046,103631,Touri; Behrouz,9999,0,9999,0
1667976521605,ECE 200,047,103632,Trivedi; Mohan M.,9999,0,9999,0
1667976521605,ECE 200,048,103633,Vasconcelos; Nuno,9999,0,9999,0
1667976521605,ECE 200,049,103634,Wang; Xiaolong,9999,0,9999,0
1667976521605,ECE 200,050,103635,Xie; Pengtao,9999,0,9999,0
1667976521605,ECE 200,051,103636,Yip; Michael,9999,0,9999,0
1667976521605,ECE 200,052,103637,Zeger; Kenneth A.,999,0,999,0
1667976521605,ECE 200,053,103638,Zhang; Xinyu,9999,0,9999,0
1667976521605,ECE 200,054,103639,Turakhia; Yatish Girish,9999,0,9999,0
1667976521605,ECE 200,055,103640,Kang; Mingu,9999,0,9999,0
1667976521605,ECE 200,056,103641,Shi; Yuanyuan,9999,0,9999,0
1667976521605,ECE 200,057,103642,Wang; Edward Jay,9999,0,9999,0
1667976521605,ECE 200,058,103643,Zheng; Yang,9999,0,9999,0
1667976522034,ECE 202,A00,103644,Kuzum; Duygu,0,0,0,0
1667976522458,ECE 212BN,A00,103646,Ng; Tse Nga,0,0,0,0
1667976522881,ECE 221,A00,111493,Staff,0,0,0,0
1667976523308,ECE 222B,A00,103647,Lomakin; Vitaliy,0,0,0,0
1667976523731,ECE 230B,A00,103648,Taur; Yuan,0,0,0,0
1667976524154,ECE 238B,A00,103649,Garay; Javier,0,0,0,0
1667976524577,ECE 240B,A00,112900,Fainman; Yeshaiahu,0,0,0,0
1667976525000,ECE 247A,A00,103650,Jokerst; Jesse Vincent,0,0,0,0
1667976525424,ECE 247B,A00,103651,Wang; Joseph,0,0,0,0
1667976525846,ECE 250,A00,103652,Siegel; Paul H.,0,0,0,0
1667976526273,ECE 251A,A00,103654,Rao; Bhaskar D.,0,0,0,0
1667976526699,ECE 257B,A00,103655,Bharadia; Dinesh,0,0,0,0
1667976527121,ECE 258A,A00,103656,Milstein; Laurence B.,0,0,0,0
1667976527545,ECE 260B,A00,103658,Kang; Mingu,0,0,0,0
1667976527971,ECE 264A,A00,103659,Galton; Ian A,0,0,0,0
1667976528395,ECE 265A,A00,103661,Gudem; Prasad S.S.,0,0,0,0
1667976528817,ECE 265D,A00,103662,Gudem; Prasad S.S.,0,0,0,0
1667976529241,ECE 268,A00,103663,Koushanfar; Farinaz,0,0,0,0
1667976529665,ECE 269,A01,103665,Pal; Piya,0,0,0,0
1667976530091,ECE 271B,A00,103666,Vasconcelos; Manuela,0,0,0,0
1667976530515,ECE 276A,A00,103667,Atanasov; Nikolay A.,0,0,0,0
1667976530947,ECE 277,A00,103668,An; Cheolhong,0,0,0,0
1667976531380,ECE 279,A00,117947,Hall; Drew A.,0,0,0,0
1667976532224,ECE 283,A00,103670,Hsueh; Tzu-Chien,0,0,0,0
1667976532647,ECE 284,A00,103671,Turakhia; Yatish Girish,0,0,0,0
1667976533074,ECE 285,A00,103672,Zheng; Yang,0,0,0,0
1667976533074,ECE 285,B00,103673,Sworder; David D.,0,0,0,0
1667976533499,ECE 287,A00,103676,Javidi; Tara,0,0,0,0
1667976533924,MATH 200B,A00,098023,Salehi Golsefidy; Alireza,14,0,15,1
1667976534350,MATH 202B,A00,098024,Rhoades; Brendon Patrick,12,0,15,3
1667976534773,MATH 203B,A00,098025,Oprea; Dragos N.,12,0,15,3
1667976535199,MATH 204B,A00,098026,Sorensen; Claus M,14,0,15,1
1667976535633,MATH 208,A00,098027,Izadi; Elham,7,0,10,3
1667976536055,MATH 209,A00,098028,Pollack; Aaron,10,0,10,0
1667976536479,MATH 211A,A00,112919,Rogalski; Daniel,9,0,10,1
1667976536901,MATH 211B,A00,112920,Seward; Brandon M.,9,0,10,1
1667976537328,MATH 218,A00,098029,Li; Bo,10,0,10,0
1667976537751,MATH 220B,A00,098030,Novak; Jonathan I,13,0,15,2
1667976538175,MATH 221A,A00,098031,Ebenfelt; Peter F,13,0,15,2
1667976538602,MATH 231B,A00,098032,Zlatos; Andrej,12,0,15,3
1667976539025,MATH 240B,A00,098033,Ni; Lei,10,0,15,5
1667976539447,MATH 243,A00,098034,Jekel; David Andrew,10,0,10,0
1667976539881,MATH 245A,A00,098035,Nie; Jiawang,0,0,15,16
1667976540304,MATH 248,A00,098036,Bejenaru; Ioan,10,0,10,0
1667976540729,MATH 250B,A00,098037,Spolaor; Luca,14,0,15,1
1667976541169,MATH 258,A00,098038,Ni; Lei,10,0,10,0
1667976541598,MATH 264B,A00,098041,Rhoades; Brendon Patrick,12,0,15,3
1667976542024,MATH 268,A00,098042,Buss; Samuel R,10,0,10,0
1667976542449,MATH 269,A00,098043,Rhoades; Brendon Patrick,10,0,10,0
1667976542878,MATH 270B,A00,098044,Li; Bo,11,0,15,4
1667976543300,MATH 272B,A00,098045,Holst; Michael J,13,0,15,2
1667976543724,MATH 273A,A00,098046,Tian; Xiaochuan,12,0,15,3
1667976544148,MATH 275,A01,098048,Tian; Xiaochuan,6,0,10,4
1667976544576,MATH 278A,A00,098049,Holst; Michael J,8,0,10,2
1667976545013,MATH 278B,A00,098050,Cloninger; Alexander,10,0,10,0
1667976545446,MATH 278C,A00,098051,Nie; Jiawang,8,0,10,2
1667976545868,MATH 280B,A00,098052,Zheng; Tianyi,11,0,15,4
1667976546291,MATH 281B,A00,098053,Bradic; Jelena,4,0,15,11
1667976546718,MATH 282B,A00,098054,Arias-Castro; Ery,2,0,15,13
1667976547141,MATH 285,A00,098055,Fitzsimmons; Patrick J,0,0,15,17
1667976547564,MATH 287B,A00,098056,Arias-Castro; Ery,5,0,15,10
1667976548066,MATH 288,A00,098057,Agarwal; Pooja,9,0,10,1
1667976548066,MATH 288,B00,098058,Zhang; Danna,9,0,10,1
1667976548066,MATH 288,C00,098059,Williams; Ruth J,10,0,10,0
1667976548491,MATH 290B,A00,098060,Roberts; Justin Deritter,14,0,15,1
1667976548917,MATH 292,A00,098061,Belmont; Eva Kinoshita,10,0,10,0
1667976549343,MATH 295,A00,098062,Suk; Andrew Hoon,48,0,50,2
1667976549768,MATH 296,A00,098063,Novak; Jonathan I,20,0,20,0
1667976550197,MATH 297,001,098064,Gamst; Anthony Collins,9997,0,9999,2
1667977049366,COGS 205,A00,101395,Chiba; Andrea,19,0,20,1
1667977049790,COGS 210B,001,101404,Greene; Deanna Jacquelyn,9998,0,9999,1
1667977049790,COGS 210B,002,101417,Xia; Haijun,9999,0,9999,0
1667977049790,COGS 210B,003,101422,Nitz; Douglas A.,9999,0,9999,0
1667977049790,COGS 210B,004,101423,Hollan; James D.,9998,0,9999,1
1667977049790,COGS 210B,005,101424,Deak; Gedeon O.,9999,0,9999,0
1667977049790,COGS 210B,006,101425,Rossano; Federico,9999,0,9999,0
1667977050223,COGS 211B,A00,101427,Coulson; Seana M,9997,0,9999,2
1667977050646,COGS 220,A00,101428,Hollan; James D.,0,0,25,25
1667977051071,COGS 229,A00,101429,Dow; Steven P,18,0,25,7
1667977051495,COGS 230,A00,101430,Klemmer; Scott R,13,0,17,4
1667977051918,COGS 234,A00,101431,Xia; Haijun,7,0,25,18
1667977052342,COGS 260,A00,101432,Kiyonaga; Anastasia,20,0,25,5
1667977052342,COGS 260,B00,101433,Kirsh; David Joel,16,0,25,9
1667977052763,CSE 202,A00,102371,Impagliazzo; Russell,0,0,0,0
1667977053189,CSE 203B,A01,102373,Cheng; Chung Kuan,0,0,0,0
1667977053614,CSE 208,A00,102374,Micciancio; Daniele,0,0,0,0
1667977054036,CSE 209A,A00,112895,Impagliazzo; Russell,0,0,15,15
1667977054458,CSE 209B,A00,108005,Bellare; Mihir,0,0,0,0
1667977054883,CSE 210,A00,113163,Coblenz; Michael J,0,0,0,0
1667977055309,CSE 219,A00,106111,Dow; Steven P,0,0,20,20
1667977055734,CSE 221,A00,102376,Voelker; Geoffrey M.,0,0,0,0
1667977056159,CSE 224,A01,102378,Porter; George M,0,0,0,0
1667977056582,CSE 229A,A00,102379,Savage; Stefan,0,0,0,0
1667977057009,CSE 229C,A00,102380,Munyaka; Imani N. S.,0,0,0,0
1667977057443,CSE 232B,A00,102382,Deutsch; Alin Bernard,0,0,0,0
1667977057874,CSE 234,A01,112904,Kumar; Arun Kumar,0,0,0,0
1667977058297,CSE 237A,A00,102383,Rosing; Tajana Simunic,0,0,0,0
1667977058723,CSE 239A,A00,102384,Deutsch; Alin Bernard,0,0,0,0
1667977059148,CSE 239B,A00,102385,Polikarpova; Nadezhda,0,0,0,0
1667977059574,CSE 240A,A00,102386,Pannuto; Patrick William,0,0,0,0
1667977059996,CSE 240B,A00,102387,Zhao; Jishen,0,0,0,0
1667977060421,CSE 241A,A00,106406,Kang; Mingu,0,0,0,0
1667977060844,CSE 249B,A00,102388,Kahng; Andrew Byun,0,0,8,8
1667977061271,CSE 251B,A01,102392,Cottrell; Garrison W,0,0,0,0
1667977061271,CSE 251B,A02,102393,Cottrell; Garrison W,0,0,0,0
1667977061695,CSE 252B,A00,102394,Ochoa; Benjamin Lawrence,0,0,0,0
1667977062119,CSE 257,A01,102396,Gao; Sicun,0,0,0,0
1667977062544,CSE 272,A00,102397,Li; Tzumao,0,0,0,0
1667977062971,CSE 274,A00,111323,Chern; Albert Ren-Haur,0,0,0,0
1667977063395,CSE 282,A00,102398,Pevzner; Pavel Arkadjevich,0,0,0,0
1667977063817,CSE 284,A00,114175,Gymrek; Melissa Ann,0,0,0,0
1667977064239,CSE 290,A00,102399,Chandraker; Manmohan Krishna,0,0,0,0
1667977064239,CSE 290,B00,102400,Vaccaro; Kristen Marie,0,0,25,25
1667977064239,CSE 290,C00,102414,Pannuto; Patrick William,0,0,25,25
1667977064239,CSE 290,D00,102427,Pevzner; Pavel Arkadjevich,0,0,0,0
1667977064239,CSE 290,E00,102429,Zhao; Jishen,0,0,0,0
1667977064239,CSE 290,F00,102436,Tullsen; Dean Michael,0,0,0,0
1667977064239,CSE 290,G00,102440,Christensen; Henrik I,0,0,20,20
1667977064669,CSE 291,A00,102443,Su; Hao,0,0,0,0
1667977064669,CSE 291,B00,102448,Polikarpova; Nadezhda,0,0,0,0
1667977064669,CSE 291,C00,102453,Vaccaro; Kristen Marie,0,0,0,0
1667977064669,CSE 291,D00,111343,Savage; Stefan,0,0,0,0
1667977064669,CSE 291,E00,116474,Claffy; Kimberly Claire,0,0,0,0
1667977064669,CSE 291,F00,116479,Pasquale; Joseph,0,0,0,0
1667977065096,CSE 293,001,119111,Bafna; Vineet,9999,0,9999,0
1667977065096,CSE 293,002,119118,Bellare; Mihir,9999,0,9999,0
1667977065096,CSE 293,003,119122,Berg-Kirkpatrick; Taylor D,9999,0,9999,0
1667977065096,CSE 293,004,119135,Christensen; Henrik I,9999,0,9999,0
1667977065096,CSE 293,005,119142,Cottrell; Garrison W,9999,0,9999,0
1667977065096,CSE 293,006,119146,Deutsch; Alin Bernard,9999,0,9999,0
1667977065096,CSE 293,007,119159,Esmaeilzadeh; Hadi,9999,0,9999,0
1667977065096,CSE 293,008,119166,Freund; Yoav,9999,0,9999,0
1667977065096,CSE 293,009,119170,Griswold; William G.,9999,0,9999,0
1667977065096,CSE 293,010,119183,Gymrek; Melissa Ann,9999,0,9999,0
1667977065096,CSE 293,011,119190,Heninger; Nadia A,9999,0,9999,0
1667977065096,CSE 293,012,119230,Impagliazzo; Russell,9999,0,9999,0
1667977065096,CSE 293,013,119232,Jhala; Ranjit,9999,0,9999,0
1667977065096,CSE 293,014,119233,Kahng; Andrew Byun,9999,0,9999,0
1667977065096,CSE 293,015,119298,Kane; Daniel Mertz,9999,0,9999,0
1667977065096,CSE 293,016,119299,Kriegman; David J,9999,0,9999,0
1667977065096,CSE 293,017,119300,Kumar; Arun Kumar,9999,0,9999,0
1667977065096,CSE 293,018,119301,Lerner; Sorin,9999,0,9999,0
1667977065096,CSE 293,019,119302,Lovett; Shachar,9999,0,9999,0
1667977065096,CSE 293,020,119303,McAuley; Julian John,9999,0,9999,0
1667977065096,CSE 293,021,119304,Micciancio; Daniele,9999,0,9999,0
1667977065096,CSE 293,022,119367,Orailoglu; Alex,9999,0,9999,0
1667977065096,CSE 293,023,119382,Paturi; Ramamohan,9999,0,9999,0
1667977065096,CSE 293,024,119404,Polikarpova; Nadezhda,9999,0,9999,0
1667977065096,CSE 293,025,119406,Politz; Joseph Gibbs,9999,0,9999,0
1667977065096,CSE 293,026,119411,Porter; George M,9999,0,9999,0
1667977065096,CSE 293,027,119414,Porter; Leonard Emerson,9999,0,9999,0
1667977065096,CSE 293,028,119416,Ramamoorthi; Ravi,9999,0,9999,0
1667977065096,CSE 293,029,119417,Sahoo; Debashis,9999,0,9999,0
1667977065096,CSE 293,030,119420,Saul; Lawrence,9999,0,9999,0
1667977065096,CSE 293,031,119421,Savage; Stefan,9999,0,9999,0
1667977065096,CSE 293,032,119425,Schulze; Jurgen P.,9999,0,9999,0
1667977065096,CSE 293,033,119426,Snoeren; Alex C.,9999,0,9999,0
1667977065096,CSE 293,034,119428,Shang; Jingbo,9999,0,9999,0
1667977065096,CSE 293,035,119430,Stefan; Deian,9999,0,9999,0
1667977065096,CSE 293,036,119431,Su; Hao,9999,0,9999,0
1667977065096,CSE 293,037,119433,Swanson; Steven James,9999,0,9999,0
1667977065096,CSE 293,038,119435,Tullsen; Dean Michael,9999,0,9999,0
1667977065096,CSE 293,039,119483,Voelker; Geoffrey M.,9999,0,9999,0
1667977065096,CSE 293,040,119537,Zhao; Jishen,9999,0,9999,0
1667977065096,CSE 293,041,119538,Zhou; Yuan-Yuan,9999,0,9999,0
1667977065096,CSE 293,042,119539,Gao; Sicun,9999,0,9999,0
1667977065096,CSE 293,043,119540,Weibel; Nadir,9999,0,9999,0
1667977065096,CSE 293,044,119541,Gupta; Rajesh K.,9999,0,9999,0
1667977065520,CSE 294,A00,102459,Voelker; Geoffrey M.,0,0,0,0
1667977065520,CSE 294,B00,111322,Orailoglu; Alex,0,0,0,0
1667977065944,DSE 201,A00,096914,Deutsch; Alin Bernard,30,0,30,0
1667977066382,DSE 210,A00,096915,Dasgupta; Sanjoy,30,0,30,0
1667977066808,DSE 260A,A00,096916,Altintas De Callaf; Ilkay,30,0,30,0
1667977067335,ECE 200,001,103586,Antipa; Nicholas A,9999,0,9999,0
1667977067335,ECE 200,002,103587,Atanasov; Nikolay A.,9999,0,9999,0
1667977067335,ECE 200,003,103588,Bharadia; Dinesh,9999,0,9999,0
1667977067335,ECE 200,004,103589,Cheng; Chung Kuan,9999,0,9999,0
1667977067335,ECE 200,005,103590,Cosman; Pamela C.,9999,0,9999,0
1667977067335,ECE 200,006,103591,Dayeh; Shadi Ahmad,9999,0,9999,0
1667977067335,ECE 200,007,103592,Fainman; Yeshaiahu,9999,0,9999,0
1667977067335,ECE 200,008,103593,Ford; Joseph Earl,9999,0,9999,0
1667977067335,ECE 200,009,103594,Franceschetti; Massimo,9999,0,9999,0
1667977067335,ECE 200,010,103595,Fullerton; Eric E,9999,0,9999,0
1667977067335,ECE 200,011,103596,Galton; Ian A,9999,0,9999,0
1667977067335,ECE 200,012,103597,Gilja; Vikash,9999,0,9999,0
1667977067335,ECE 200,013,103598,Hall; Drew A.,9999,0,9999,0
1667977067335,ECE 200,014,103599,Hsueh; Tzu-Chien,9999,0,9999,0
1667977067335,ECE 200,015,103600,Javidi; Tara,9999,0,9999,0
1667977067335,ECE 200,016,103601,Kahng; Andrew Byun,9999,0,9999,0
1667977067335,ECE 200,017,103602,Kim; Young-Han,9999,0,9999,0
1667977067335,ECE 200,018,103603,Koushanfar; Farinaz,9999,0,9999,0
1667977067335,ECE 200,019,103604,Kuzum; Duygu,9999,0,9999,0
1667977067335,ECE 200,020,103605,Le; Hanh-Phuc,9999,0,9999,0
1667977067335,ECE 200,021,103606,Lin; Bill,9999,0,9999,0
1667977067335,ECE 200,022,103607,Liu; Zhaowei,9998,0,9999,1
1667977067335,ECE 200,023,103608,Lo; Yu-Hwa,9999,0,9999,0
1667977067335,ECE 200,024,103609,Lomakin; Vitaliy,9999,0,9999,0
1667977067335,ECE 200,025,103610,Mercier; Patrick Philip,9999,0,9999,0
1667977067335,ECE 200,026,103611,Meyer; Florian,9999,0,9999,0
1667977067335,ECE 200,027,103612,Milstein; Laurence B.,9999,0,9999,0
1667977067335,ECE 200,028,103613,Mir Arabbaygi; Siavash,9999,0,9999,0
1667977067335,ECE 200,029,103614,Mookherjea; Shayan,9999,0,9999,0
1667977067335,ECE 200,030,103615,Morris; Karcher William,9999,0,9999,0
1667977067335,ECE 200,031,103616,Ng; Tse Nga,9999,0,9999,0
1667977067335,ECE 200,032,103617,Nguyen; Truong Quang,9999,0,9999,0
1667977067335,ECE 200,033,103618,Nomura; Kenji,9999,0,9999,0
1667977067335,ECE 200,034,103619,Orlitsky; Alon,9999,0,9999,0
1667977067335,ECE 200,035,103620,Pal; Piya,9999,0,9999,0
1667977067335,ECE 200,036,103621,Papen; George C.,9999,0,9999,0
1667977067335,ECE 200,037,103622,Radic; Stojan,9999,0,9999,0
1667977067335,ECE 200,038,103623,Rao; Bhaskar D.,9999,0,9999,0
1667977067335,ECE 200,039,103624,Rao; Ramesh R,9999,0,9999,0
1667977067335,ECE 200,040,103625,Rebeiz; Gabriel,9999,0,9999,0
1667977067335,ECE 200,041,103626,Sanford; John R,9999,0,9999,0
1667977067335,ECE 200,042,103627,Siegel; Paul H.,9999,0,9999,0
1667977067335,ECE 200,043,103628,Sievenpiper; Daniel F.,9999,0,9999,0
1667977067335,ECE 200,044,103629,Sworder; David D.,9999,0,9999,0
1667977067335,ECE 200,045,103630,Taur; Yuan,9999,0,9999,0
1667977067335,ECE 200,046,103631,Touri; Behrouz,9999,0,9999,0
1667977067335,ECE 200,047,103632,Trivedi; Mohan M.,9999,0,9999,0
1667977067335,ECE 200,048,103633,Vasconcelos; Nuno,9999,0,9999,0
1667977067335,ECE 200,049,103634,Wang; Xiaolong,9999,0,9999,0
1667977067335,ECE 200,050,103635,Xie; Pengtao,9999,0,9999,0
1667977067335,ECE 200,051,103636,Yip; Michael,9999,0,9999,0
1667977067335,ECE 200,052,103637,Zeger; Kenneth A.,999,0,999,0
1667977067335,ECE 200,053,103638,Zhang; Xinyu,9999,0,9999,0
1667977067335,ECE 200,054,103639,Turakhia; Yatish Girish,9999,0,9999,0
1667977067335,ECE 200,055,103640,Kang; Mingu,9999,0,9999,0
1667977067335,ECE 200,056,103641,Shi; Yuanyuan,9999,0,9999,0
1667977067335,ECE 200,057,103642,Wang; Edward Jay,9999,0,9999,0
1667977067335,ECE 200,058,103643,Zheng; Yang,9999,0,9999,0
1667977067763,ECE 202,A00,103644,Kuzum; Duygu,0,0,0,0
1667977068186,ECE 212BN,A00,103646,Ng; Tse Nga,0,0,0,0
1667977068610,ECE 221,A00,111493,Staff,0,0,0,0
1667977069051,ECE 222B,A00,103647,Lomakin; Vitaliy,0,0,0,0
1667977069476,ECE 230B,A00,103648,Taur; Yuan,0,0,0,0
1667977069900,ECE 238B,A00,103649,Garay; Javier,0,0,0,0
1667977070332,ECE 240B,A00,112900,Fainman; Yeshaiahu,0,0,0,0
1667977070757,ECE 247A,A00,103650,Jokerst; Jesse Vincent,0,0,0,0
1667977071179,ECE 247B,A00,103651,Wang; Joseph,0,0,0,0
1667977071602,ECE 250,A00,103652,Siegel; Paul H.,0,0,0,0
1667977072024,ECE 251A,A00,103654,Rao; Bhaskar D.,0,0,0,0
1667977072453,ECE 257B,A00,103655,Bharadia; Dinesh,0,0,0,0
1667977072876,ECE 258A,A00,103656,Milstein; Laurence B.,0,0,0,0
1667977073298,ECE 260B,A00,103658,Kang; Mingu,0,0,0,0
1667977073725,ECE 264A,A00,103659,Galton; Ian A,0,0,0,0
1667977074151,ECE 265A,A00,103661,Gudem; Prasad S.S.,0,0,0,0
1667977074574,ECE 265D,A00,103662,Gudem; Prasad S.S.,0,0,0,0
1667977074997,ECE 268,A00,103663,Koushanfar; Farinaz,0,0,0,0
1667977075419,ECE 269,A01,103665,Pal; Piya,0,0,0,0
1667977075846,ECE 271B,A00,103666,Vasconcelos; Manuela,0,0,0,0
1667977076268,ECE 276A,A00,103667,Atanasov; Nikolay A.,0,0,0,0
1667977076689,ECE 277,A00,103668,An; Cheolhong,0,0,0,0
1667977077112,ECE 279,A00,117947,Hall; Drew A.,0,0,0,0
1667977077970,ECE 283,A00,103670,Hsueh; Tzu-Chien,0,0,0,0
1667977078395,ECE 284,A00,103671,Turakhia; Yatish Girish,0,0,0,0
1667977078818,ECE 285,A00,103672,Zheng; Yang,0,0,0,0
1667977078818,ECE 285,B00,103673,Sworder; David D.,0,0,0,0
1667977079247,ECE 287,A00,103676,Javidi; Tara,0,0,0,0
1667977079670,MATH 200B,A00,098023,Salehi Golsefidy; Alireza,14,0,15,1
1667977080095,MATH 202B,A00,098024,Rhoades; Brendon Patrick,12,0,15,3
1667977080519,MATH 203B,A00,098025,Oprea; Dragos N.,12,0,15,3
1667977080946,MATH 204B,A00,098026,Sorensen; Claus M,14,0,15,1
1667977081370,MATH 208,A00,098027,Izadi; Elham,7,0,10,3
1667977081793,MATH 209,A00,098028,Pollack; Aaron,10,0,10,0
1667977082217,MATH 211A,A00,112919,Rogalski; Daniel,9,0,10,1
1667977082639,MATH 211B,A00,112920,Seward; Brandon M.,9,0,10,1
1667977083065,MATH 218,A00,098029,Li; Bo,10,0,10,0
1667977083486,MATH 220B,A00,098030,Novak; Jonathan I,13,0,15,2
1667977083910,MATH 221A,A00,098031,Ebenfelt; Peter F,13,0,15,2
1667977084336,MATH 231B,A00,098032,Zlatos; Andrej,12,0,15,3
1667977084760,MATH 240B,A00,098033,Ni; Lei,10,0,15,5
1667977085186,MATH 243,A00,098034,Jekel; David Andrew,10,0,10,0
1667977085616,MATH 245A,A00,098035,Nie; Jiawang,0,0,15,16
1667977086043,MATH 248,A00,098036,Bejenaru; Ioan,10,0,10,0
1667977086466,MATH 250B,A00,098037,Spolaor; Luca,14,0,15,1
1667977086887,MATH 258,A00,098038,Ni; Lei,10,0,10,0
1667977087315,MATH 264B,A00,098041,Rhoades; Brendon Patrick,12,0,15,3
1667977087744,MATH 268,A00,098042,Buss; Samuel R,10,0,10,0
1667977088169,MATH 269,A00,098043,Rhoades; Brendon Patrick,10,0,10,0
1667977088598,MATH 270B,A00,098044,Li; Bo,11,0,15,4
1667977089033,MATH 272B,A00,098045,Holst; Michael J,13,0,15,2
1667977089457,MATH 273A,A00,098046,Tian; Xiaochuan,12,0,15,3
1667977089879,MATH 275,A01,098048,Tian; Xiaochuan,6,0,10,4
1667977090312,MATH 278A,A00,098049,Holst; Michael J,8,0,10,2
1667977090736,MATH 278B,A00,098050,Cloninger; Alexander,10,0,10,0
1667977091167,MATH 278C,A00,098051,Nie; Jiawang,8,0,10,2
1667977091594,MATH 280B,A00,098052,Zheng; Tianyi,11,0,15,4
1667977092017,MATH 281B,A00,098053,Bradic; Jelena,4,0,15,11
1667977092444,MATH 282B,A00,098054,Arias-Castro; Ery,2,0,15,13
1667977092872,MATH 285,A00,098055,Fitzsimmons; Patrick J,0,0,15,17
1667977093297,MATH 287B,A00,098056,Arias-Castro; Ery,5,0,15,10
1667977093718,MATH 288,A00,098057,Agarwal; Pooja,9,0,10,1
1667977093718,MATH 288,B00,098058,Zhang; Danna,9,0,10,1
1667977093718,MATH 288,C00,098059,Williams; Ruth J,10,0,10,0
1667977094142,MATH 290B,A00,098060,Roberts; Justin Deritter,14,0,15,1
1667977094567,MATH 292,A00,098061,Belmont; Eva Kinoshita,10,0,10,0
1667977094990,MATH 295,A00,098062,Suk; Andrew Hoon,48,0,50,2
1667977095412,MATH 296,A00,098063,Novak; Jonathan I,20,0,20,0
1667977095842,MATH 297,001,098064,Gamst; Anthony Collins,9997,0,9999,2
1667977596104,COGS 205,A00,101395,Chiba; Andrea,19,0,20,1
1667977596526,COGS 210B,001,101404,Greene; Deanna Jacquelyn,9998,0,9999,1
1667977596526,COGS 210B,002,101417,Xia; Haijun,9999,0,9999,0
1667977596526,COGS 210B,003,101422,Nitz; Douglas A.,9999,0,9999,0
1667977596526,COGS 210B,004,101423,Hollan; James D.,9998,0,9999,1
1667977596526,COGS 210B,005,101424,Deak; Gedeon O.,9999,0,9999,0
1667977596526,COGS 210B,006,101425,Rossano; Federico,9999,0,9999,0
1667977596954,COGS 211B,A00,101427,Coulson; Seana M,9997,0,9999,2
1667977597379,COGS 220,A00,101428,Hollan; James D.,0,0,25,25
1667977597802,COGS 229,A00,101429,Dow; Steven P,18,0,25,7
1667977598229,COGS 230,A00,101430,Klemmer; Scott R,13,0,17,4
1667977598655,COGS 234,A00,101431,Xia; Haijun,7,0,25,18
1667977599078,COGS 260,A00,101432,Kiyonaga; Anastasia,20,0,25,5
1667977599078,COGS 260,B00,101433,Kirsh; David Joel,16,0,25,9
1667977599501,CSE 202,A00,102371,Impagliazzo; Russell,0,0,0,0
1667977599923,CSE 203B,A01,102373,Cheng; Chung Kuan,0,0,0,0
1667977600356,CSE 208,A00,102374,Micciancio; Daniele,0,0,0,0
1667977600778,CSE 209A,A00,112895,Impagliazzo; Russell,0,0,15,15
1667977601212,CSE 209B,A00,108005,Bellare; Mihir,0,0,0,0
1667977601635,CSE 210,A00,113163,Coblenz; Michael J,0,0,0,0
1667977602057,CSE 219,A00,106111,Dow; Steven P,0,0,20,20
1667977602482,CSE 221,A00,102376,Voelker; Geoffrey M.,0,0,0,0
1667977602906,CSE 224,A01,102378,Porter; George M,0,0,0,0
1667977603329,CSE 229A,A00,102379,Savage; Stefan,0,0,0,0
1667977603753,CSE 229C,A00,102380,Munyaka; Imani N. S.,0,0,0,0
1667977604183,CSE 232B,A00,102382,Deutsch; Alin Bernard,0,0,0,0
1667977604609,CSE 234,A01,112904,Kumar; Arun Kumar,0,0,0,0
1667977605035,CSE 237A,A00,102383,Rosing; Tajana Simunic,0,0,0,0
1667977605461,CSE 239A,A00,102384,Deutsch; Alin Bernard,0,0,0,0
1667977605883,CSE 239B,A00,102385,Polikarpova; Nadezhda,0,0,0,0
1667977606309,CSE 240A,A00,102386,Pannuto; Patrick William,0,0,0,0
1667977606742,CSE 240B,A00,102387,Zhao; Jishen,0,0,0,0
1667977607167,CSE 241A,A00,106406,Kang; Mingu,0,0,0,0
1667977607594,CSE 249B,A00,102388,Kahng; Andrew Byun,0,0,8,8
1667977608018,CSE 251B,A01,102392,Cottrell; Garrison W,0,0,0,0
1667977608018,CSE 251B,A02,102393,Cottrell; Garrison W,0,0,0,0
1667977608444,CSE 252B,A00,102394,Ochoa; Benjamin Lawrence,0,0,0,0
1667977608874,CSE 257,A01,102396,Gao; Sicun,0,0,0,0
1667977609300,CSE 272,A00,102397,Li; Tzumao,0,0,0,0
1667977609743,CSE 274,A00,111323,Chern; Albert Ren-Haur,0,0,0,0
1667977610166,CSE 282,A00,102398,Pevzner; Pavel Arkadjevich,0,0,0,0
1667977610592,CSE 284,A00,114175,Gymrek; Melissa Ann,0,0,0,0
1667977611017,CSE 290,A00,102399,Chandraker; Manmohan Krishna,0,0,0,0
1667977611017,CSE 290,B00,102400,Vaccaro; Kristen Marie,0,0,25,25
1667977611017,CSE 290,C00,102414,Pannuto; Patrick William,0,0,25,25
1667977611017,CSE 290,D00,102427,Pevzner; Pavel Arkadjevich,0,0,0,0
1667977611017,CSE 290,E00,102429,Zhao; Jishen,0,0,0,0
1667977611017,CSE 290,F00,102436,Tullsen; Dean Michael,0,0,0,0
1667977611017,CSE 290,G00,102440,Christensen; Henrik I,0,0,20,20
1667977611442,CSE 291,A00,102443,Su; Hao,0,0,0,0
1667977611442,CSE 291,B00,102448,Polikarpova; Nadezhda,0,0,0,0
1667977611442,CSE 291,C00,102453,Vaccaro; Kristen Marie,0,0,0,0
1667977611442,CSE 291,D00,111343,Savage; Stefan,0,0,0,0
1667977611442,CSE 291,E00,116474,Claffy; Kimberly Claire,0,0,0,0
1667977611442,CSE 291,F00,116479,Pasquale; Joseph,0,0,0,0
1667977611873,CSE 293,001,119111,Bafna; Vineet,9999,0,9999,0
1667977611873,CSE 293,002,119118,Bellare; Mihir,9999,0,9999,0
1667977611873,CSE 293,003,119122,Berg-Kirkpatrick; Taylor D,9999,0,9999,0
1667977611873,CSE 293,004,119135,Christensen; Henrik I,9999,0,9999,0
1667977611873,CSE 293,005,119142,Cottrell; Garrison W,9999,0,9999,0
1667977611873,CSE 293,006,119146,Deutsch; Alin Bernard,9999,0,9999,0
1667977611873,CSE 293,007,119159,Esmaeilzadeh; Hadi,9999,0,9999,0
1667977611873,CSE 293,008,119166,Freund; Yoav,9999,0,9999,0
1667977611873,CSE 293,009,119170,Griswold; William G.,9999,0,9999,0
1667977611873,CSE 293,010,119183,Gymrek; Melissa Ann,9999,0,9999,0
1667977611873,CSE 293,011,119190,Heninger; Nadia A,9999,0,9999,0
1667977611873,CSE 293,012,119230,Impagliazzo; Russell,9999,0,9999,0
1667977611873,CSE 293,013,119232,Jhala; Ranjit,9999,0,9999,0
1667977611873,CSE 293,014,119233,Kahng; Andrew Byun,9999,0,9999,0
1667977611873,CSE 293,015,119298,Kane; Daniel Mertz,9999,0,9999,0
1667977611873,CSE 293,016,119299,Kriegman; David J,9999,0,9999,0
1667977611873,CSE 293,017,119300,Kumar; Arun Kumar,9999,0,9999,0
1667977611873,CSE 293,018,119301,Lerner; Sorin,9999,0,9999,0
1667977611873,CSE 293,019,119302,Lovett; Shachar,9999,0,9999,0
1667977611873,CSE 293,020,119303,McAuley; Julian John,9999,0,9999,0
1667977611873,CSE 293,021,119304,Micciancio; Daniele,9999,0,9999,0
1667977611873,CSE 293,022,119367,Orailoglu; Alex,9999,0,9999,0
1667977611873,CSE 293,023,119382,Paturi; Ramamohan,9999,0,9999,0
1667977611873,CSE 293,024,119404,Polikarpova; Nadezhda,9999,0,9999,0
1667977611873,CSE 293,025,119406,Politz; Joseph Gibbs,9999,0,9999,0
1667977611873,CSE 293,026,119411,Porter; George M,9999,0,9999,0
1667977611873,CSE 293,027,119414,Porter; Leonard Emerson,9999,0,9999,0
1667977611873,CSE 293,028,119416,Ramamoorthi; Ravi,9999,0,9999,0
1667977611873,CSE 293,029,119417,Sahoo; Debashis,9999,0,9999,0
1667977611873,CSE 293,030,119420,Saul; Lawrence,9999,0,9999,0
1667977611873,CSE 293,031,119421,Savage; Stefan,9999,0,9999,0
1667977611873,CSE 293,032,119425,Schulze; Jurgen P.,9999,0,9999,0
1667977611873,CSE 293,033,119426,Snoeren; Alex C.,9999,0,9999,0
1667977611873,CSE 293,034,119428,Shang; Jingbo,9999,0,9999,0
1667977611873,CSE 293,035,119430,Stefan; Deian,9999,0,9999,0
1667977611873,CSE 293,036,119431,Su; Hao,9999,0,9999,0
1667977611873,CSE 293,037,119433,Swanson; Steven James,9999,0,9999,0
1667977611873,CSE 293,038,119435,Tullsen; Dean Michael,9999,0,9999,0
1667977611873,CSE 293,039,119483,Voelker; Geoffrey M.,9999,0,9999,0
1667977611873,CSE 293,040,119537,Zhao; Jishen,9999,0,9999,0
1667977611873,CSE 293,041,119538,Zhou; Yuan-Yuan,9999,0,9999,0
1667977611873,CSE 293,042,119539,Gao; Sicun,9999,0,9999,0
1667977611873,CSE 293,043,119540,Weibel; Nadir,9999,0,9999,0
1667977611873,CSE 293,044,119541,Gupta; Rajesh K.,9999,0,9999,0
1667977612295,CSE 294,A00,102459,Voelker; Geoffrey M.,0,0,0,0
1667977612295,CSE 294,B00,111322,Orailoglu; Alex,0,0,0,0
1667977612719,DSE 201,A00,096914,Deutsch; Alin Bernard,30,0,30,0
1667977613149,DSE 210,A00,096915,Dasgupta; Sanjoy,30,0,30,0
1667977613571,DSE 260A,A00,096916,Altintas De Callaf; Ilkay,30,0,30,0
1667977614005,ECE 200,001,103586,Antipa; Nicholas A,9999,0,9999,0
1667977614005,ECE 200,002,103587,Atanasov; Nikolay A.,9999,0,9999,0
1667977614005,ECE 200,003,103588,Bharadia; Dinesh,9999,0,9999,0
1667977614005,ECE 200,004,103589,Cheng; Chung Kuan,9999,0,9999,0
1667977614005,ECE 200,005,103590,Cosman; Pamela C.,9999,0,9999,0
1667977614005,ECE 200,006,103591,Dayeh; Shadi Ahmad,9999,0,9999,0
1667977614005,ECE 200,007,103592,Fainman; Yeshaiahu,9999,0,9999,0
1667977614005,ECE 200,008,103593,Ford; Joseph Earl,9999,0,9999,0
1667977614005,ECE 200,009,103594,Franceschetti; Massimo,9999,0,9999,0
1667977614005,ECE 200,010,103595,Fullerton; Eric E,9999,0,9999,0
1667977614005,ECE 200,011,103596,Galton; Ian A,9999,0,9999,0
1667977614005,ECE 200,012,103597,Gilja; Vikash,9999,0,9999,0
1667977614005,ECE 200,013,103598,Hall; Drew A.,9999,0,9999,0
1667977614005,ECE 200,014,103599,Hsueh; Tzu-Chien,9999,0,9999,0
1667977614005,ECE 200,015,103600,Javidi; Tara,9999,0,9999,0
1667977614005,ECE 200,016,103601,Kahng; Andrew Byun,9999,0,9999,0
1667977614005,ECE 200,017,103602,Kim; Young-Han,9999,0,9999,0
1667977614005,ECE 200,018,103603,Koushanfar; Farinaz,9999,0,9999,0
1667977614005,ECE 200,019,103604,Kuzum; Duygu,9999,0,9999,0
1667977614005,ECE 200,020,103605,Le; Hanh-Phuc,9999,0,9999,0
1667977614005,ECE 200,021,103606,Lin; Bill,9999,0,9999,0
1667977614005,ECE 200,022,103607,Liu; Zhaowei,9998,0,9999,1
1667977614005,ECE 200,023,103608,Lo; Yu-Hwa,9999,0,9999,0
1667977614005,ECE 200,024,103609,Lomakin; Vitaliy,9999,0,9999,0
1667977614005,ECE 200,025,103610,Mercier; Patrick Philip,9999,0,9999,0
1667977614005,ECE 200,026,103611,Meyer; Florian,9999,0,9999,0
1667977614005,ECE 200,027,103612,Milstein; Laurence B.,9999,0,9999,0
1667977614005,ECE 200,028,103613,Mir Arabbaygi; Siavash,9999,0,9999,0
1667977614005,ECE 200,029,103614,Mookherjea; Shayan,9999,0,9999,0
1667977614005,ECE 200,030,103615,Morris; Karcher William,9999,0,9999,0
1667977614005,ECE 200,031,103616,Ng; Tse Nga,9999,0,9999,0
1667977614005,ECE 200,032,103617,Nguyen; Truong Quang,9999,0,9999,0
1667977614005,ECE 200,033,103618,Nomura; Kenji,9999,0,9999,0
1667977614005,ECE 200,034,103619,Orlitsky; Alon,9999,0,9999,0
1667977614005,ECE 200,035,103620,Pal; Piya,9999,0,9999,0
1667977614005,ECE 200,036,103621,Papen; George C.,9999,0,9999,0
1667977614005,ECE 200,037,103622,Radic; Stojan,9999,0,9999,0
1667977614005,ECE 200,038,103623,Rao; Bhaskar D.,9999,0,9999,0
1667977614005,ECE 200,039,103624,Rao; Ramesh R,9999,0,9999,0
1667977614005,ECE 200,040,103625,Rebeiz; Gabriel,9999,0,9999,0
1667977614005,ECE 200,041,103626,Sanford; John R,9999,0,9999,0
1667977614005,ECE 200,042,103627,Siegel; Paul H.,9999,0,9999,0
1667977614005,ECE 200,043,103628,Sievenpiper; Daniel F.,9999,0,9999,0
1667977614005,ECE 200,044,103629,Sworder; David D.,9999,0,9999,0
1667977614005,ECE 200,045,103630,Taur; Yuan,9999,0,9999,0
1667977614005,ECE 200,046,103631,Touri; Behrouz,9999,0,9999,0
1667977614005,ECE 200,047,103632,Trivedi; Mohan M.,9999,0,9999,0
1667977614005,ECE 200,048,103633,Vasconcelos; Nuno,9999,0,9999,0
1667977614005,ECE 200,049,103634,Wang; Xiaolong,9999,0,9999,0
1667977614005,ECE 200,050,103635,Xie; Pengtao,9999,0,9999,0
1667977614005,ECE 200,051,103636,Yip; Michael,9999,0,9999,0
1667977614005,ECE 200,052,103637,Zeger; Kenneth A.,999,0,999,0
1667977614005,ECE 200,053,103638,Zhang; Xinyu,9999,0,9999,0
1667977614005,ECE 200,054,103639,Turakhia; Yatish Girish,9999,0,9999,0
1667977614005,ECE 200,055,103640,Kang; Mingu,9999,0,9999,0
1667977614005,ECE 200,056,103641,Shi; Yuanyuan,9999,0,9999,0
1667977614005,ECE 200,057,103642,Wang; Edward Jay,9999,0,9999,0
1667977614005,ECE 200,058,103643,Zheng; Yang,9999,0,9999,0
1667977614438,ECE 202,A00,103644,Kuzum; Duygu,0,0,0,0
1667977614862,ECE 212BN,A00,103646,Ng; Tse Nga,0,0,0,0
1667977615284,ECE 221,A00,111493,Staff,0,0,0,0
1667977615707,ECE 222B,A00,103647,Lomakin; Vitaliy,0,0,0,0
1667977616152,ECE 230B,A00,103648,Taur; Yuan,0,0,0,0
1667977616579,ECE 238B,A00,103649,Garay; Javier,0,0,0,0
1667977617003,ECE 240B,A00,112900,Fainman; Yeshaiahu,0,0,0,0
1667977617431,ECE 247A,A00,103650,Jokerst; Jesse Vincent,0,0,0,0
1667977617856,ECE 247B,A00,103651,Wang; Joseph,0,0,0,0
1667977618279,ECE 250,A00,103652,Siegel; Paul H.,0,0,0,0
1667977618702,ECE 251A,A00,103654,Rao; Bhaskar D.,0,0,0,0
1667977619127,ECE 257B,A00,103655,Bharadia; Dinesh,0,0,0,0
1667977619551,ECE 258A,A00,103656,Milstein; Laurence B.,0,0,0,0
1667977619979,ECE 260B,A00,103658,Kang; Mingu,0,0,0,0
1667977620403,ECE 264A,A00,103659,Galton; Ian A,0,0,0,0
1667977620833,ECE 265A,A00,103661,Gudem; Prasad S.S.,0,0,0,0
1667977621260,ECE 265D,A00,103662,Gudem; Prasad S.S.,0,0,0,0
1667977621683,ECE 268,A00,103663,Koushanfar; Farinaz,0,0,0,0
1667977622106,ECE 269,A01,103665,Pal; Piya,0,0,0,0
1667977622533,ECE 271B,A00,103666,Vasconcelos; Manuela,0,0,0,0
1667977622956,ECE 276A,A00,103667,Atanasov; Nikolay A.,0,0,0,0
1667977623380,ECE 277,A00,103668,An; Cheolhong,0,0,0,0
1667977623810,ECE 279,A00,117947,Hall; Drew A.,0,0,0,0
1667977624657,ECE 283,A00,103670,Hsueh; Tzu-Chien,0,0,0,0
1667977625079,ECE 284,A00,103671,Turakhia; Yatish Girish,0,0,0,0
1667977625514,ECE 285,A00,103672,Zheng; Yang,0,0,0,0
1667977625514,ECE 285,B00,103673,Sworder; David D.,0,0,0,0
1667977625941,ECE 287,A00,103676,Javidi; Tara,0,0,0,0
1667977626376,MATH 200B,A00,098023,Salehi Golsefidy; Alireza,14,0,15,1
1667977626807,MATH 202B,A00,098024,Rhoades; Brendon Patrick,12,0,15,3
1667977627238,MATH 203B,A00,098025,Oprea; Dragos N.,12,0,15,3
1667977627663,MATH 204B,A00,098026,Sorensen; Claus M,14,0,15,1
1667977628086,MATH 208,A00,098027,Izadi; Elham,7,0,10,3
1667977628508,MATH 209,A00,098028,Pollack; Aaron,10,0,10,0
1667977628931,MATH 211A,A00,112919,Rogalski; Daniel,9,0,10,1
1667977629355,MATH 211B,A00,112920,Seward; Brandon M.,9,0,10,1
1667977629780,MATH 218,A00,098029,Li; Bo,10,0,10,0
1667977630206,MATH 220B,A00,098030,Novak; Jonathan I,13,0,15,2
1667977630724,MATH 221A,A00,098031,Ebenfelt; Peter F,13,0,15,2
1667977631147,MATH 231B,A00,098032,Zlatos; Andrej,12,0,15,3
1667977631586,MATH 240B,A00,098033,Ni; Lei,10,0,15,5
1667977632008,MATH 243,A00,098034,Jekel; David Andrew,10,0,10,0
1667977632435,MATH 245A,A00,098035,Nie; Jiawang,0,0,15,16
1667977632864,MATH 248,A00,098036,Bejenaru; Ioan,10,0,10,0
1667977633290,MATH 250B,A00,098037,Spolaor; Luca,14,0,15,1
1667977633724,MATH 258,A00,098038,Ni; Lei,10,0,10,0
1667977634155,MATH 264B,A00,098041,Rhoades; Brendon Patrick,12,0,15,3
1667977634585,MATH 268,A00,098042,Buss; Samuel R,10,0,10,0
1667977635018,MATH 269,A00,098043,Rhoades; Brendon Patrick,10,0,10,0
1667977635440,MATH 270B,A00,098044,Li; Bo,11,0,15,4
1667977635863,MATH 272B,A00,098045,Holst; Michael J,13,0,15,2
1667977636287,MATH 273A,A00,098046,Tian; Xiaochuan,12,0,15,3
1667977636713,MATH 275,A01,098048,Tian; Xiaochuan,6,0,10,4
1667977637137,MATH 278A,A00,098049,Holst; Michael J,8,0,10,2
1667977637559,MATH 278B,A00,098050,Cloninger; Alexander,10,0,10,0
1667977637996,MATH 278C,A00,098051,Nie; Jiawang,8,0,10,2
1667977638427,MATH 280B,A00,098052,Zheng; Tianyi,11,0,15,4
1667977638849,MATH 281B,A00,098053,Bradic; Jelena,4,0,15,11
1667977639274,MATH 282B,A00,098054,Arias-Castro; Ery,2,0,15,13
1667977639700,MATH 285,A00,098055,Fitzsimmons; Patrick J,0,0,15,17
1667977640131,MATH 287B,A00,098056,Arias-Castro; Ery,5,0,15,10
1667977640555,MATH 288,A00,098057,Agarwal; Pooja,9,0,10,1
1667977640555,MATH 288,B00,098058,Zhang; Danna,9,0,10,1
1667977640555,MATH 288,C00,098059,Williams; Ruth J,10,0,10,0
1667977640978,MATH 290B,A00,098060,Roberts; Justin Deritter,14,0,15,1
1667977641402,MATH 292,A00,098061,Belmont; Eva Kinoshita,10,0,10,0
1667977641827,MATH 295,A00,098062,Suk; Andrew Hoon,48,0,50,2
1667977642254,MATH 296,A00,098063,Novak; Jonathan I,20,0,20,0
1667977642676,MATH 297,001,098064,Gamst; Anthony Collins,9997,0,9999,2
1667978141847,COGS 205,A00,101395,Chiba; Andrea,19,0,20,1
1667978142276,COGS 210B,001,101404,Greene; Deanna Jacquelyn,9998,0,9999,1
1667978142276,COGS 210B,002,101417,Xia; Haijun,9999,0,9999,0
1667978142276,COGS 210B,003,101422,Nitz; Douglas A.,9999,0,9999,0
1667978142276,COGS 210B,004,101423,Hollan; James D.,9998,0,9999,1
1667978142276,COGS 210B,005,101424,Deak; Gedeon O.,9999,0,9999,0
1667978142276,COGS 210B,006,101425,Rossano; Federico,9999,0,9999,0
1667978142700,COGS 211B,A00,101427,Coulson; Seana M,9997,0,9999,2
1667978143123,COGS 220,A00,101428,Hollan; James D.,0,0,25,25
1667978143547,COGS 229,A00,101429,Dow; Steven P,18,0,25,7
1667978143970,COGS 230,A00,101430,Klemmer; Scott R,13,0,17,4
1667978144394,COGS 234,A00,101431,Xia; Haijun,7,0,25,18
1667978144826,COGS 260,A00,101432,Kiyonaga; Anastasia,20,0,25,5
1667978144826,COGS 260,B00,101433,Kirsh; David Joel,16,0,25,9
1667978145250,CSE 202,A00,102371,Impagliazzo; Russell,0,0,0,0
1667978145671,CSE 203B,A01,102373,Cheng; Chung Kuan,0,0,0,0
1667978146097,CSE 208,A00,102374,Micciancio; Daniele,0,0,0,0
1667978146522,CSE 209A,A00,112895,Impagliazzo; Russell,0,0,15,15
1667978146946,CSE 209B,A00,108005,Bellare; Mihir,0,0,0,0
1667978147373,CSE 210,A00,113163,Coblenz; Michael J,0,0,0,0
1667978147796,CSE 219,A00,106111,Dow; Steven P,0,0,20,20
1667978148222,CSE 221,A00,102376,Voelker; Geoffrey M.,0,0,0,0
1667978148647,CSE 224,A01,102378,Porter; George M,0,0,0,0
1667978149078,CSE 229A,A00,102379,Savage; Stefan,0,0,0,0
1667978149504,CSE 229C,A00,102380,Munyaka; Imani N. S.,0,0,0,0
1667978150008,CSE 232B,A00,102382,Deutsch; Alin Bernard,0,0,0,0
1667978150435,CSE 234,A01,112904,Kumar; Arun Kumar,0,0,0,0
1667978150861,CSE 237A,A00,102383,Rosing; Tajana Simunic,0,0,0,0
1667978151293,CSE 239A,A00,102384,Deutsch; Alin Bernard,0,0,0,0
1667978151716,CSE 239B,A00,102385,Polikarpova; Nadezhda,0,0,0,0
1667978152141,CSE 240A,A00,102386,Pannuto; Patrick William,0,0,0,0
1667978152565,CSE 240B,A00,102387,Zhao; Jishen,0,0,0,0
1667978152994,CSE 241A,A00,106406,Kang; Mingu,0,0,0,0
1667978153424,CSE 249B,A00,102388,Kahng; Andrew Byun,0,0,8,8
1667978153848,CSE 251B,A01,102392,Cottrell; Garrison W,0,0,0,0
1667978153848,CSE 251B,A02,102393,Cottrell; Garrison W,0,0,0,0
1667978154276,CSE 252B,A00,102394,Ochoa; Benjamin Lawrence,0,0,0,0
1667978154704,CSE 257,A01,102396,Gao; Sicun,0,0,0,0
1667978155128,CSE 272,A00,102397,Li; Tzumao,0,0,0,0
1667978155554,CSE 274,A00,111323,Chern; Albert Ren-Haur,0,0,0,0
1667978155977,CSE 282,A00,102398,Pevzner; Pavel Arkadjevich,0,0,0,0
1667978156401,CSE 284,A00,114175,Gymrek; Melissa Ann,0,0,0,0
1667978156831,CSE 290,A00,102399,Chandraker; Manmohan Krishna,0,0,0,0
1667978156831,CSE 290,B00,102400,Vaccaro; Kristen Marie,0,0,25,25
1667978156831,CSE 290,C00,102414,Pannuto; Patrick William,0,0,25,25
1667978156831,CSE 290,D00,102427,Pevzner; Pavel Arkadjevich,0,0,0,0
1667978156831,CSE 290,E00,102429,Zhao; Jishen,0,0,0,0
1667978156831,CSE 290,F00,102436,Tullsen; Dean Michael,0,0,0,0
1667978156831,CSE 290,G00,102440,Christensen; Henrik I,0,0,20,20
1667978157254,CSE 291,A00,102443,Su; Hao,0,0,0,0
1667978157254,CSE 291,B00,102448,Polikarpova; Nadezhda,0,0,0,0
1667978157254,CSE 291,C00,102453,Vaccaro; Kristen Marie,0,0,0,0
1667978157254,CSE 291,D00,111343,Savage; Stefan,0,0,0,0
1667978157254,CSE 291,E00,116474,Claffy; Kimberly Claire,0,0,0,0
1667978157254,CSE 291,F00,116479,Pasquale; Joseph,0,0,0,0
1667978157686,CSE 293,001,119111,Bafna; Vineet,9999,0,9999,0
1667978157686,CSE 293,002,119118,Bellare; Mihir,9999,0,9999,0
1667978157686,CSE 293,003,119122,Berg-Kirkpatrick; Taylor D,9999,0,9999,0
1667978157686,CSE 293,004,119135,Christensen; Henrik I,9999,0,9999,0
1667978157686,CSE 293,005,119142,Cottrell; Garrison W,9999,0,9999,0
1667978157686,CSE 293,006,119146,Deutsch; Alin Bernard,9999,0,9999,0
1667978157686,CSE 293,007,119159,Esmaeilzadeh; Hadi,9999,0,9999,0
1667978157686,CSE 293,008,119166,Freund; Yoav,9999,0,9999,0
1667978157686,CSE 293,009,119170,Griswold; William G.,9999,0,9999,0
1667978157686,CSE 293,010,119183,Gymrek; Melissa Ann,9999,0,9999,0
1667978157686,CSE 293,011,119190,Heninger; Nadia A,9999,0,9999,0
1667978157686,CSE 293,012,119230,Impagliazzo; Russell,9999,0,9999,0
1667978157686,CSE 293,013,119232,Jhala; Ranjit,9999,0,9999,0
1667978157686,CSE 293,014,119233,Kahng; Andrew Byun,9999,0,9999,0
1667978157686,CSE 293,015,119298,Kane; Daniel Mertz,9999,0,9999,0
1667978157686,CSE 293,016,119299,Kriegman; David J,9999,0,9999,0
1667978157686,CSE 293,017,119300,Kumar; Arun Kumar,9999,0,9999,0
1667978157686,CSE 293,018,119301,Lerner; Sorin,9999,0,9999,0
1667978157686,CSE 293,019,119302,Lovett; Shachar,9999,0,9999,0
1667978157686,CSE 293,020,119303,McAuley; Julian John,9999,0,9999,0
1667978157686,CSE 293,021,119304,Micciancio; Daniele,9999,0,9999,0
1667978157686,CSE 293,022,119367,Orailoglu; Alex,9999,0,9999,0
1667978157686,CSE 293,023,119382,Paturi; Ramamohan,9999,0,9999,0
1667978157686,CSE 293,024,119404,Polikarpova; Nadezhda,9999,0,9999,0
1667978157686,CSE 293,025,119406,Politz; Joseph Gibbs,9999,0,9999,0
1667978157686,CSE 293,026,119411,Porter; George M,9999,0,9999,0
1667978157686,CSE 293,027,119414,Porter; Leonard Emerson,9999,0,9999,0
1667978157686,CSE 293,028,119416,Ramamoorthi; Ravi,9999,0,9999,0
1667978157686,CSE 293,029,119417,Sahoo; Debashis,9999,0,9999,0
1667978157686,CSE 293,030,119420,Saul; Lawrence,9999,0,9999,0
1667978157686,CSE 293,031,119421,Savage; Stefan,9999,0,9999,0
1667978157686,CSE 293,032,119425,Schulze; Jurgen P.,9999,0,9999,0
1667978157686,CSE 293,033,119426,Snoeren; Alex C.,9999,0,9999,0
1667978157686,CSE 293,034,119428,Shang; Jingbo,9999,0,9999,0
1667978157686,CSE 293,035,119430,Stefan; Deian,9999,0,9999,0
1667978157686,CSE 293,036,119431,Su; Hao,9999,0,9999,0
1667978157686,CSE 293,037,119433,Swanson; Steven James,9999,0,9999,0
1667978157686,CSE 293,038,119435,Tullsen; Dean Michael,9999,0,9999,0
1667978157686,CSE 293,039,119483,Voelker; Geoffrey M.,9999,0,9999,0
1667978157686,CSE 293,040,119537,Zhao; Jishen,9999,0,9999,0
1667978157686,CSE 293,041,119538,Zhou; Yuan-Yuan,9999,0,9999,0
1667978157686,CSE 293,042,119539,Gao; Sicun,9999,0,9999,0
1667978157686,CSE 293,043,119540,Weibel; Nadir,9999,0,9999,0
1667978157686,CSE 293,044,119541,Gupta; Rajesh K.,9999,0,9999,0
1667978157686,CSE 293,045,126410,Vaccaro; Kristen Marie,9999,0,9999,0
1667978157686,CSE 293,046,126411,Klemke; Richard,9999,0,9999,0
1667978158113,CSE 294,A00,102459,Voelker; Geoffrey M.,0,0,0,0
1667978158113,CSE 294,B00,111322,Orailoglu; Alex,0,0,0,0
1667978158537,DSE 201,A00,096914,Deutsch; Alin Bernard,30,0,30,0
1667978158962,DSE 210,A00,096915,Dasgupta; Sanjoy,30,0,30,0
1667978159387,DSE 260A,A00,096916,Altintas De Callaf; Ilkay,30,0,30,0
1667978159840,ECE 200,001,103586,Antipa; Nicholas A,9999,0,9999,0
1667978159840,ECE 200,002,103587,Atanasov; Nikolay A.,9999,0,9999,0
1667978159840,ECE 200,003,103588,Bharadia; Dinesh,9999,0,9999,0
1667978159840,ECE 200,004,103589,Cheng; Chung Kuan,9999,0,9999,0
1667978159840,ECE 200,005,103590,Cosman; Pamela C.,9999,0,9999,0
1667978159840,ECE 200,006,103591,Dayeh; Shadi Ahmad,9999,0,9999,0
1667978159840,ECE 200,007,103592,Fainman; Yeshaiahu,9999,0,9999,0
1667978159840,ECE 200,008,103593,Ford; Joseph Earl,9999,0,9999,0
1667978159840,ECE 200,009,103594,Franceschetti; Massimo,9999,0,9999,0
1667978159840,ECE 200,010,103595,Fullerton; Eric E,9999,0,9999,0
1667978159840,ECE 200,011,103596,Galton; Ian A,9999,0,9999,0
1667978159840,ECE 200,012,103597,Gilja; Vikash,9999,0,9999,0
1667978159840,ECE 200,013,103598,Hall; Drew A.,9999,0,9999,0
1667978159840,ECE 200,014,103599,Hsueh; Tzu-Chien,9999,0,9999,0
1667978159840,ECE 200,015,103600,Javidi; Tara,9999,0,9999,0
1667978159840,ECE 200,016,103601,Kahng; Andrew Byun,9999,0,9999,0
1667978159840,ECE 200,017,103602,Kim; Young-Han,9999,0,9999,0
1667978159840,ECE 200,018,103603,Koushanfar; Farinaz,9999,0,9999,0
1667978159840,ECE 200,019,103604,Kuzum; Duygu,9999,0,9999,0
1667978159840,ECE 200,020,103605,Le; Hanh-Phuc,9999,0,9999,0
1667978159840,ECE 200,021,103606,Lin; Bill,9999,0,9999,0
1667978159840,ECE 200,022,103607,Liu; Zhaowei,9998,0,9999,1
1667978159840,ECE 200,023,103608,Lo; Yu-Hwa,9999,0,9999,0
1667978159840,ECE 200,024,103609,Lomakin; Vitaliy,9999,0,9999,0
1667978159840,ECE 200,025,103610,Mercier; Patrick Philip,9999,0,9999,0
1667978159840,ECE 200,026,103611,Meyer; Florian,9999,0,9999,0
1667978159840,ECE 200,027,103612,Milstein; Laurence B.,9999,0,9999,0
1667978159840,ECE 200,028,103613,Mir Arabbaygi; Siavash,9999,0,9999,0
1667978159840,ECE 200,029,103614,Mookherjea; Shayan,9999,0,9999,0
1667978159840,ECE 200,030,103615,Morris; Karcher William,9999,0,9999,0
1667978159840,ECE 200,031,103616,Ng; Tse Nga,9999,0,9999,0
1667978159840,ECE 200,032,103617,Nguyen; Truong Quang,9999,0,9999,0
1667978159840,ECE 200,033,103618,Nomura; Kenji,9999,0,9999,0
1667978159840,ECE 200,034,103619,Orlitsky; Alon,9999,0,9999,0
1667978159840,ECE 200,035,103620,Pal; Piya,9999,0,9999,0
1667978159840,ECE 200,036,103621,Papen; George C.,9999,0,9999,0
1667978159840,ECE 200,037,103622,Radic; Stojan,9999,0,9999,0
1667978159840,ECE 200,038,103623,Rao; Bhaskar D.,9999,0,9999,0
1667978159840,ECE 200,039,103624,Rao; Ramesh R,9999,0,9999,0
1667978159840,ECE 200,040,103625,Rebeiz; Gabriel,9999,0,9999,0
1667978159840,ECE 200,041,103626,Sanford; John R,9999,0,9999,0
1667978159840,ECE 200,042,103627,Siegel; Paul H.,9999,0,9999,0
1667978159840,ECE 200,043,103628,Sievenpiper; Daniel F.,9999,0,9999,0
1667978159840,ECE 200,044,103629,Sworder; David D.,9999,0,9999,0
1667978159840,ECE 200,045,103630,Taur; Yuan,9999,0,9999,0
1667978159840,ECE 200,046,103631,Touri; Behrouz,9999,0,9999,0
1667978159840,ECE 200,047,103632,Trivedi; Mohan M.,9999,0,9999,0
1667978159840,ECE 200,048,103633,Vasconcelos; Nuno,9999,0,9999,0
1667978159840,ECE 200,049,103634,Wang; Xiaolong,9999,0,9999,0
1667978159840,ECE 200,050,103635,Xie; Pengtao,9999,0,9999,0
1667978159840,ECE 200,051,103636,Yip; Michael,9999,0,9999,0
1667978159840,ECE 200,052,103637,Zeger; Kenneth A.,999,0,999,0
1667978159840,ECE 200,053,103638,Zhang; Xinyu,9999,0,9999,0
1667978159840,ECE 200,054,103639,Turakhia; Yatish Girish,9999,0,9999,0
1667978159840,ECE 200,055,103640,Kang; Mingu,9999,0,9999,0
1667978159840,ECE 200,056,103641,Shi; Yuanyuan,9999,0,9999,0
1667978159840,ECE 200,057,103642,Wang; Edward Jay,9999,0,9999,0
1667978159840,ECE 200,058,103643,Zheng; Yang,9999,0,9999,0
1667978160266,ECE 202,A00,103644,Kuzum; Duygu,0,0,0,0
1667978160687,ECE 212BN,A00,103646,Ng; Tse Nga,0,0,0,0
1667978161121,ECE 221,A00,111493,Staff,0,0,0,0
1667978161547,ECE 222B,A00,103647,Lomakin; Vitaliy,0,0,0,0
1667978161973,ECE 230B,A00,103648,Taur; Yuan,0,0,0,0
1667978162407,ECE 238B,A00,103649,Garay; Javier,0,0,0,0
1667978162834,ECE 240B,A00,112900,Fainman; Yeshaiahu,0,0,0,0
1667978163259,ECE 247A,A00,103650,Jokerst; Jesse Vincent,0,0,0,0
1667978163683,ECE 247B,A00,103651,Wang; Joseph,0,0,0,0
1667978164110,ECE 250,A00,103652,Siegel; Paul H.,0,0,0,0
1667978164537,ECE 251A,A00,103654,Rao; Bhaskar D.,0,0,0,0
1667978164958,ECE 257B,A00,103655,Bharadia; Dinesh,0,0,0,0
1667978165392,ECE 258A,A00,103656,Milstein; Laurence B.,0,0,0,0
1667978165816,ECE 260B,A00,103658,Kang; Mingu,0,0,0,0
1667978166238,ECE 264A,A00,103659,Galton; Ian A,0,0,0,0
1667978166661,ECE 265A,A00,103661,Gudem; Prasad S.S.,0,0,0,0
1667978167088,ECE 265D,A00,103662,Gudem; Prasad S.S.,0,0,0,0
1667978167511,ECE 268,A00,103663,Koushanfar; Farinaz,0,0,0,0
1667978167935,ECE 269,A01,103665,Pal; Piya,0,0,0,0
1667978168358,ECE 271B,A00,103666,Vasconcelos; Manuela,0,0,0,0
1667978168785,ECE 276A,A00,103667,Atanasov; Nikolay A.,0,0,0,0
1667978169213,ECE 277,A00,103668,An; Cheolhong,0,0,0,0
1667978169634,ECE 279,A00,117947,Hall; Drew A.,0,0,0,0
1667978170484,ECE 283,A00,103670,Hsueh; Tzu-Chien,0,0,0,0
1667978170906,ECE 284,A00,103671,Turakhia; Yatish Girish,0,0,0,0
1667978171335,ECE 285,A00,103672,Zheng; Yang,0,0,0,0
1667978171335,ECE 285,B00,103673,Sworder; David D.,0,0,0,0
1667978171761,ECE 287,A00,103676,Javidi; Tara,0,0,0,0
1667978172187,MATH 200B,A00,098023,Salehi Golsefidy; Alireza,14,0,15,1
1667978172611,MATH 202B,A00,098024,Rhoades; Brendon Patrick,12,0,15,3
1667978173034,MATH 203B,A00,098025,Oprea; Dragos N.,12,0,15,3
1667978173458,MATH 204B,A00,098026,Sorensen; Claus M,14,0,15,1
1667978173883,MATH 208,A00,098027,Izadi; Elham,7,0,10,3
1667978174308,MATH 209,A00,098028,Pollack; Aaron,10,0,10,0
1667978174730,MATH 211A,A00,112919,Rogalski; Daniel,9,0,10,1
1667978175155,MATH 211B,A00,112920,Seward; Brandon M.,9,0,10,1
1667978175594,MATH 218,A00,098029,Li; Bo,10,0,10,0
1667978176017,MATH 220B,A00,098030,Novak; Jonathan I,13,0,15,2
1667978176445,MATH 221A,A00,098031,Ebenfelt; Peter F,13,0,15,2
1667978176871,MATH 231B,A00,098032,Zlatos; Andrej,12,0,15,3
1667978177300,MATH 240B,A00,098033,Ni; Lei,10,0,15,5
1667978177734,MATH 243,A00,098034,Jekel; David Andrew,10,0,10,0
1667978178162,MATH 245A,A00,098035,Nie; Jiawang,0,0,15,16
1667978178586,MATH 248,A00,098036,Bejenaru; Ioan,10,0,10,0
1667978179009,MATH 250B,A00,098037,Spolaor; Luca,14,0,15,1
1667978179431,MATH 258,A00,098038,Ni; Lei,10,0,10,0
1667978179855,MATH 264B,A00,098041,Rhoades; Brendon Patrick,12,0,15,3
1667978180279,MATH 268,A00,098042,Buss; Samuel R,10,0,10,0
1667978180707,MATH 269,A00,098043,Rhoades; Brendon Patrick,10,0,10,0
1667978181132,MATH 270B,A00,098044,Li; Bo,11,0,15,4
1667978181553,MATH 272B,A00,098045,Holst; Michael J,13,0,15,2
1667978181980,MATH 273A,A00,098046,Tian; Xiaochuan,12,0,15,3
1667978182403,MATH 275,A01,098048,Tian; Xiaochuan,6,0,10,4
1667978182834,MATH 278A,A00,098049,Holst; Michael J,8,0,10,2
1667978183275,MATH 278B,A00,098050,Cloninger; Alexander,10,0,10,0
1667978183697,MATH 278C,A00,098051,Nie; Jiawang,8,0,10,2
1667978184124,MATH 280B,A00,098052,Zheng; Tianyi,11,0,15,4
1667978184545,MATH 281B,A00,098053,Bradic; Jelena,4,0,15,11
1667978184971,MATH 282B,A00,098054,Arias-Castro; Ery,2,0,15,13
1667978185394,MATH 285,A00,098055,Fitzsimmons; Patrick J,0,0,15,17
1667978185818,MATH 287B,A00,098056,Arias-Castro; Ery,5,0,15,10
1667978186248,MATH 288,A00,098057,Agarwal; Pooja,9,0,10,1
1667978186248,MATH 288,B00,098058,Zhang; Danna,9,0,10,1
1667978186248,MATH 288,C00,098059,Williams; Ruth J,10,0,10,0
1667978186680,MATH 290B,A00,098060,Roberts; Justin Deritter,14,0,15,1
1667978187110,MATH 292,A00,098061,Belmont; Eva Kinoshita,10,0,10,0
1667978187544,MATH 295,A00,098062,Suk; Andrew Hoon,48,0,50,2
1667978187966,MATH 296,A00,098063,Novak; Jonathan I,20,0,20,0
1667978188398,MATH 297,001,098064,Gamst; Anthony Collins,9997,0,9999,2
1667978687980,COGS 205,A00,101395,Chiba; Andrea,19,0,20,1
1667978688410,COGS 210B,001,101404,Greene; Deanna Jacquelyn,9998,0,9999,1
1667978688410,COGS 210B,002,101417,Xia; Haijun,9999,0,9999,0
1667978688410,COGS 210B,003,101422,Nitz; Douglas A.,9999,0,9999,0
1667978688410,COGS 210B,004,101423,Hollan; James D.,9998,0,9999,1
1667978688410,COGS 210B,005,101424,Deak; Gedeon O.,9999,0,9999,0
1667978688410,COGS 210B,006,101425,Rossano; Federico,9999,0,9999,0
1667978688850,COGS 211B,A00,101427,Coulson; Seana M,9997,0,9999,2
1667978689275,COGS 220,A00,101428,Hollan; James D.,0,0,25,25
1667978689699,COGS 229,A00,101429,Dow; Steven P,18,0,25,7
1667978690122,COGS 230,A00,101430,Klemmer; Scott R,13,0,17,4
1667978690545,COGS 234,A00,101431,Xia; Haijun,7,0,25,18
1667978690968,COGS 260,A00,101432,Kiyonaga; Anastasia,20,0,25,5
1667978690968,COGS 260,B00,101433,Kirsh; David Joel,16,0,25,9
1667978691391,CSE 202,A00,102371,Impagliazzo; Russell,0,0,0,0
1667978691815,CSE 203B,A01,102373,Cheng; Chung Kuan,0,0,0,0
1667978692241,CSE 208,A00,102374,Micciancio; Daniele,0,0,0,0
1667978692670,CSE 209A,A00,112895,Impagliazzo; Russell,0,0,15,15
1667978693094,CSE 209B,A00,108005,Bellare; Mihir,0,0,0,0
1667978693517,CSE 210,A00,113163,Coblenz; Michael J,0,0,0,0
1667978693957,CSE 219,A00,106111,Dow; Steven P,0,0,20,20
1667978694379,CSE 221,A00,102376,Voelker; Geoffrey M.,0,0,0,0
1667978694808,CSE 224,A01,102378,Porter; George M,0,0,0,0
1667978695232,CSE 229A,A00,102379,Savage; Stefan,0,0,0,0
1667978695656,CSE 229C,A00,102380,Munyaka; Imani N. S.,0,0,0,0
1667978696084,CSE 232B,A00,102382,Deutsch; Alin Bernard,0,0,0,0
1667978696508,CSE 234,A01,112904,Kumar; Arun Kumar,0,0,0,0
1667978696935,CSE 237A,A00,102383,Rosing; Tajana Simunic,0,0,0,0
1667978697358,CSE 239A,A00,102384,Deutsch; Alin Bernard,0,0,0,0
1667978697781,CSE 239B,A00,102385,Polikarpova; Nadezhda,0,0,0,0
1667978698208,CSE 240A,A00,102386,Pannuto; Patrick William,0,0,0,0
1667978698631,CSE 240B,A00,102387,Zhao; Jishen,0,0,0,0
1667978699057,CSE 241A,A00,106406,Kang; Mingu,0,0,0,0
1667978699482,CSE 249B,A00,102388,Kahng; Andrew Byun,0,0,8,8
1667978699905,CSE 251B,A01,102392,Cottrell; Garrison W,0,0,0,0
1667978699905,CSE 251B,A02,102393,Cottrell; Garrison W,0,0,0,0
1667978700333,CSE 252B,A00,102394,Ochoa; Benjamin Lawrence,0,0,0,0
1667978700755,CSE 257,A01,102396,Gao; Sicun,0,0,0,0
1667978701177,CSE 272,A00,102397,Li; Tzumao,0,0,0,0
1667978701599,CSE 274,A00,111323,Chern; Albert Ren-Haur,0,0,0,0
1667978702024,CSE 282,A00,102398,Pevzner; Pavel Arkadjevich,0,0,0,0
1667978702464,CSE 284,A00,114175,Gymrek; Melissa Ann,0,0,0,0
1667978702887,CSE 290,A00,102399,Chandraker; Manmohan Krishna,0,0,0,0
1667978702887,CSE 290,B00,102400,Vaccaro; Kristen Marie,0,0,25,25
1667978702887,CSE 290,C00,102414,Pannuto; Patrick William,0,0,25,25
1667978702887,CSE 290,D00,102427,Pevzner; Pavel Arkadjevich,0,0,0,0
1667978702887,CSE 290,E00,102429,Zhao; Jishen,0,0,0,0
1667978702887,CSE 290,F00,102436,Tullsen; Dean Michael,0,0,0,0
1667978702887,CSE 290,G00,102440,Christensen; Henrik I,0,0,20,20
1667978703320,CSE 291,A00,102443,Su; Hao,0,0,0,0
1667978703320,CSE 291,B00,102448,Polikarpova; Nadezhda,0,0,0,0
1667978703320,CSE 291,C00,102453,Vaccaro; Kristen Marie,0,0,0,0
1667978703320,CSE 291,D00,111343,Savage; Stefan,0,0,0,0
1667978703320,CSE 291,E00,116474,Claffy; Kimberly Claire,0,0,0,0
1667978703320,CSE 291,F00,116479,Pasquale; Joseph,0,0,0,0
1667978703754,CSE 293,001,119111,Bafna; Vineet,9999,0,9999,0
1667978703754,CSE 293,002,119118,Bellare; Mihir,9999,0,9999,0
1667978703754,CSE 293,003,119122,Berg-Kirkpatrick; Taylor D,9999,0,9999,0
1667978703754,CSE 293,004,119135,Christensen; Henrik I,9999,0,9999,0
1667978703754,CSE 293,005,119142,Cottrell; Garrison W,9999,0,9999,0
1667978703754,CSE 293,006,119146,Deutsch; Alin Bernard,9999,0,9999,0
1667978703754,CSE 293,007,119159,Esmaeilzadeh; Hadi,9999,0,9999,0
1667978703754,CSE 293,008,119166,Freund; Yoav,9999,0,9999,0
1667978703754,CSE 293,009,119170,Griswold; William G.,9999,0,9999,0
1667978703754,CSE 293,010,119183,Gymrek; Melissa Ann,9999,0,9999,0
1667978703754,CSE 293,011,119190,Heninger; Nadia A,9999,0,9999,0
1667978703754,CSE 293,012,119230,Impagliazzo; Russell,9999,0,9999,0
1667978703754,CSE 293,013,119232,Jhala; Ranjit,9999,0,9999,0
1667978703754,CSE 293,014,119233,Kahng; Andrew Byun,9999,0,9999,0
1667978703754,CSE 293,015,119298,Kane; Daniel Mertz,9999,0,9999,0
1667978703754,CSE 293,016,119299,Kriegman; David J,9999,0,9999,0
1667978703754,CSE 293,017,119300,Kumar; Arun Kumar,9999,0,9999,0
1667978703754,CSE 293,018,119301,Lerner; Sorin,9999,0,9999,0
1667978703754,CSE 293,019,119302,Lovett; Shachar,9999,0,9999,0
1667978703754,CSE 293,020,119303,McAuley; Julian John,9999,0,9999,0
1667978703754,CSE 293,021,119304,Micciancio; Daniele,9999,0,9999,0
1667978703754,CSE 293,022,119367,Orailoglu; Alex,9999,0,9999,0
1667978703754,CSE 293,023,119382,Paturi; Ramamohan,9999,0,9999,0
1667978703754,CSE 293,024,119404,Polikarpova; Nadezhda,9999,0,9999,0
1667978703754,CSE 293,025,119406,Politz; Joseph Gibbs,9999,0,9999,0
1667978703754,CSE 293,026,119411,Porter; George M,9999,0,9999,0
1667978703754,CSE 293,027,119414,Porter; Leonard Emerson,9999,0,9999,0
1667978703754,CSE 293,028,119416,Ramamoorthi; Ravi,9999,0,9999,0
1667978703754,CSE 293,029,119417,Sahoo; Debashis,9999,0,9999,0
1667978703754,CSE 293,030,119420,Saul; Lawrence,9999,0,9999,0
1667978703754,CSE 293,031,119421,Savage; Stefan,9999,0,9999,0
1667978703754,CSE 293,032,119425,Schulze; Jurgen P.,9999,0,9999,0
1667978703754,CSE 293,033,119426,Snoeren; Alex C.,9999,0,9999,0
1667978703754,CSE 293,034,119428,Shang; Jingbo,9999,0,9999,0
1667978703754,CSE 293,035,119430,Stefan; Deian,9999,0,9999,0
1667978703754,CSE 293,036,119431,Su; Hao,9999,0,9999,0
1667978703754,CSE 293,037,119433,Swanson; Steven James,9999,0,9999,0
1667978703754,CSE 293,038,119435,Tullsen; Dean Michael,9999,0,9999,0
1667978703754,CSE 293,039,119483,Voelker; Geoffrey M.,9999,0,9999,0
1667978703754,CSE 293,040,119537,Zhao; Jishen,9999,0,9999,0
1667978703754,CSE 293,041,119538,Zhou; Yuan-Yuan,9999,0,9999,0
1667978703754,CSE 293,042,119539,Gao; Sicun,9999,0,9999,0
1667978703754,CSE 293,043,119540,Weibel; Nadir,9999,0,9999,0
1667978703754,CSE 293,044,119541,Gupta; Rajesh K.,9999,0,9999,0
1667978703754,CSE 293,045,126410,Vaccaro; Kristen Marie,9999,0,9999,0
1667978703754,CSE 293,046,126411,Klemke; Richard,9999,0,9999,0
1667978704180,CSE 294,A00,102459,Voelker; Geoffrey M.,0,0,0,0
1667978704180,CSE 294,B00,111322,Orailoglu; Alex,0,0,0,0
1667978704608,DSE 201,A00,096914,Deutsch; Alin Bernard,30,0,30,0
1667978705033,DSE 210,A00,096915,Dasgupta; Sanjoy,30,0,30,0
1667978705460,DSE 260A,A00,096916,Altintas De Callaf; Ilkay,30,0,30,0
1667978705888,ECE 200,001,103586,Antipa; Nicholas A,9999,0,9999,0
1667978705888,ECE 200,002,103587,Atanasov; Nikolay A.,9999,0,9999,0
1667978705888,ECE 200,003,103588,Bharadia; Dinesh,9999,0,9999,0
1667978705888,ECE 200,004,103589,Cheng; Chung Kuan,9999,0,9999,0
1667978705888,ECE 200,005,103590,Cosman; Pamela C.,9999,0,9999,0
1667978705888,ECE 200,006,103591,Dayeh; Shadi Ahmad,9999,0,9999,0
1667978705888,ECE 200,007,103592,Fainman; Yeshaiahu,9999,0,9999,0
1667978705888,ECE 200,008,103593,Ford; Joseph Earl,9999,0,9999,0
1667978705888,ECE 200,009,103594,Franceschetti; Massimo,9999,0,9999,0
1667978705888,ECE 200,010,103595,Fullerton; Eric E,9999,0,9999,0
1667978705888,ECE 200,011,103596,Galton; Ian A,9999,0,9999,0
1667978705888,ECE 200,012,103597,Gilja; Vikash,9999,0,9999,0
1667978705888,ECE 200,013,103598,Hall; Drew A.,9999,0,9999,0
1667978705888,ECE 200,014,103599,Hsueh; Tzu-Chien,9999,0,9999,0
1667978705888,ECE 200,015,103600,Javidi; Tara,9999,0,9999,0
1667978705888,ECE 200,016,103601,Kahng; Andrew Byun,9999,0,9999,0
1667978705888,ECE 200,017,103602,Kim; Young-Han,9999,0,9999,0
1667978705888,ECE 200,018,103603,Koushanfar; Farinaz,9999,0,9999,0
1667978705888,ECE 200,019,103604,Kuzum; Duygu,9999,0,9999,0
1667978705888,ECE 200,020,103605,Le; Hanh-Phuc,9999,0,9999,0
1667978705888,ECE 200,021,103606,Lin; Bill,9999,0,9999,0
1667978705888,ECE 200,022,103607,Liu; Zhaowei,9998,0,9999,1
1667978705888,ECE 200,023,103608,Lo; Yu-Hwa,9999,0,9999,0
1667978705888,ECE 200,024,103609,Lomakin; Vitaliy,9999,0,9999,0
1667978705888,ECE 200,025,103610,Mercier; Patrick Philip,9999,0,9999,0
1667978705888,ECE 200,026,103611,Meyer; Florian,9999,0,9999,0
1667978705888,ECE 200,027,103612,Milstein; Laurence B.,9999,0,9999,0
1667978705888,ECE 200,028,103613,Mir Arabbaygi; Siavash,9999,0,9999,0
1667978705888,ECE 200,029,103614,Mookherjea; Shayan,9999,0,9999,0
1667978705888,ECE 200,030,103615,Morris; Karcher William,9999,0,9999,0
1667978705888,ECE 200,031,103616,Ng; Tse Nga,9999,0,9999,0
1667978705888,ECE 200,032,103617,Nguyen; Truong Quang,9999,0,9999,0
1667978705888,ECE 200,033,103618,Nomura; Kenji,9999,0,9999,0
1667978705888,ECE 200,034,103619,Orlitsky; Alon,9999,0,9999,0
1667978705888,ECE 200,035,103620,Pal; Piya,9999,0,9999,0
1667978705888,ECE 200,036,103621,Papen; George C.,9999,0,9999,0
1667978705888,ECE 200,037,103622,Radic; Stojan,9999,0,9999,0
1667978705888,ECE 200,038,103623,Rao; Bhaskar D.,9999,0,9999,0
1667978705888,ECE 200,039,103624,Rao; Ramesh R,9999,0,9999,0
1667978705888,ECE 200,040,103625,Rebeiz; Gabriel,9999,0,9999,0
1667978705888,ECE 200,041,103626,Sanford; John R,9999,0,9999,0
1667978705888,ECE 200,042,103627,Siegel; Paul H.,9999,0,9999,0
1667978705888,ECE 200,043,103628,Sievenpiper; Daniel F.,9999,0,9999,0
1667978705888,ECE 200,044,103629,Sworder; David D.,9999,0,9999,0
1667978705888,ECE 200,045,103630,Taur; Yuan,9999,0,9999,0
1667978705888,ECE 200,046,103631,Touri; Behrouz,9999,0,9999,0
1667978705888,ECE 200,047,103632,Trivedi; Mohan M.,9999,0,9999,0
1667978705888,ECE 200,048,103633,Vasconcelos; Nuno,9999,0,9999,0
1667978705888,ECE 200,049,103634,Wang; Xiaolong,9999,0,9999,0
1667978705888,ECE 200,050,103635,Xie; Pengtao,9999,0,9999,0
1667978705888,ECE 200,051,103636,Yip; Michael,9999,0,9999,0
1667978705888,ECE 200,052,103637,Zeger; Kenneth A.,999,0,999,0
1667978705888,ECE 200,053,103638,Zhang; Xinyu,9999,0,9999,0
1667978705888,ECE 200,054,103639,Turakhia; Yatish Girish,9999,0,9999,0
1667978705888,ECE 200,055,103640,Kang; Mingu,9999,0,9999,0
1667978705888,ECE 200,056,103641,Shi; Yuanyuan,9999,0,9999,0
1667978705888,ECE 200,057,103642,Wang; Edward Jay,9999,0,9999,0
1667978705888,ECE 200,058,103643,Zheng; Yang,9999,0,9999,0
1667978706311,ECE 202,A00,103644,Kuzum; Duygu,0,0,0,0
1667978706736,ECE 212BN,A00,103646,Ng; Tse Nga,0,0,0,0
1667978707158,ECE 221,A00,111493,Staff,0,0,0,0
1667978707584,ECE 222B,A00,103647,Lomakin; Vitaliy,0,0,0,0
1667978708010,ECE 230B,A00,103648,Taur; Yuan,0,0,0,0
1667978708434,ECE 238B,A00,103649,Garay; Javier,0,0,0,0
1667978708860,ECE 240B,A00,112900,Fainman; Yeshaiahu,0,0,0,0
1667978709285,ECE 247A,A00,103650,Jokerst; Jesse Vincent,0,0,0,0
1667978709711,ECE 247B,A00,103651,Wang; Joseph,0,0,0,0
1667978710135,ECE 250,A00,103652,Siegel; Paul H.,0,0,0,0
1667978710570,ECE 251A,A00,103654,Rao; Bhaskar D.,0,0,0,0
1667978710996,ECE 257B,A00,103655,Bharadia; Dinesh,0,0,0,0
1667978711423,ECE 258A,A00,103656,Milstein; Laurence B.,0,0,0,0
1667978711849,ECE 260B,A00,103658,Kang; Mingu,0,0,0,0
1667978712276,ECE 264A,A00,103659,Galton; Ian A,0,0,0,0
1667978712789,ECE 265A,A00,103661,Gudem; Prasad S.S.,0,0,0,0
1667978713212,ECE 265D,A00,103662,Gudem; Prasad S.S.,0,0,0,0
1667978713642,ECE 268,A00,103663,Koushanfar; Farinaz,0,0,0,0
1667978714070,ECE 269,A01,103665,Pal; Piya,0,0,0,0
1667978714495,ECE 271B,A00,103666,Vasconcelos; Manuela,0,0,0,0
1667978714919,ECE 276A,A00,103667,Atanasov; Nikolay A.,0,0,0,0
1667978715344,ECE 277,A00,103668,An; Cheolhong,0,0,0,0
1667978715766,ECE 279,A00,117947,Hall; Drew A.,0,0,0,0
1667978716615,ECE 283,A00,103670,Hsueh; Tzu-Chien,0,0,0,0
1667978717040,ECE 284,A00,103671,Turakhia; Yatish Girish,0,0,0,0
1667978717465,ECE 285,A00,103672,Zheng; Yang,0,0,0,0
1667978717465,ECE 285,B00,103673,Sworder; David D.,0,0,0,0
1667978717889,ECE 287,A00,103676,Javidi; Tara,0,0,0,0
1667978718332,MATH 200B,A00,098023,Salehi Golsefidy; Alireza,14,0,15,1
1667978718756,MATH 202B,A00,098024,Rhoades; Brendon Patrick,12,0,15,3
1667978719180,MATH 203B,A00,098025,Oprea; Dragos N.,12,0,15,3
1667978719610,MATH 204B,A00,098026,Sorensen; Claus M,14,0,15,1
1667978720036,MATH 208,A00,098027,Izadi; Elham,7,0,10,3
1667978720470,MATH 209,A00,098028,Pollack; Aaron,10,0,10,0
1667978720895,MATH 211A,A00,112919,Rogalski; Daniel,9,0,10,1
1667978721323,MATH 211B,A00,112920,Seward; Brandon M.,9,0,10,1
1667978721746,MATH 218,A00,098029,Li; Bo,10,0,10,0
1667978722173,MATH 220B,A00,098030,Novak; Jonathan I,13,0,15,2
1667978722597,MATH 221A,A00,098031,Ebenfelt; Peter F,13,0,15,2
1667978723031,MATH 231B,A00,098032,Zlatos; Andrej,12,0,15,3
1667978723456,MATH 240B,A00,098033,Ni; Lei,10,0,15,5
1667978723881,MATH 243,A00,098034,Jekel; David Andrew,10,0,10,0
1667978724306,MATH 245A,A00,098035,Nie; Jiawang,0,0,15,16
1667978724730,MATH 248,A00,098036,Bejenaru; Ioan,10,0,10,0
1667978725163,MATH 250B,A00,098037,Spolaor; Luca,14,0,15,1
1667978725587,MATH 258,A00,098038,Ni; Lei,10,0,10,0
1667978726011,MATH 264B,A00,098041,Rhoades; Brendon Patrick,12,0,15,3
1667978726435,MATH 268,A00,098042,Buss; Samuel R,10,0,10,0
1667978726862,MATH 269,A00,098043,Rhoades; Brendon Patrick,10,0,10,0
1667978727294,MATH 270B,A00,098044,Li; Bo,11,0,15,4
1667978727718,MATH 272B,A00,098045,Holst; Michael J,13,0,15,2
1667978728154,MATH 273A,A00,098046,Tian; Xiaochuan,12,0,15,3
1667978728577,MATH 275,A01,098048,Tian; Xiaochuan,6,0,10,4
1667978729004,MATH 278A,A00,098049,Holst; Michael J,8,0,10,2
1667978729438,MATH 278B,A00,098050,Cloninger; Alexander,10,0,10,0
1667978729866,MATH 278C,A00,098051,Nie; Jiawang,8,0,10,2
1667978730293,MATH 280B,A00,098052,Zheng; Tianyi,11,0,15,4
1667978730714,MATH 281B,A00,098053,Bradic; Jelena,4,0,15,11
1667978731139,MATH 282B,A00,098054,Arias-Castro; Ery,2,0,15,13
1667978731566,MATH 285,A00,098055,Fitzsimmons; Patrick J,0,0,15,17
1667978731995,MATH 287B,A00,098056,Arias-Castro; Ery,5,0,15,10
1667978732418,MATH 288,A00,098057,Agarwal; Pooja,9,0,10,1
1667978732418,MATH 288,B00,098058,Zhang; Danna,9,0,10,1
1667978732418,MATH 288,C00,098059,Williams; Ruth J,10,0,10,0
1667978732845,MATH 290B,A00,098060,Roberts; Justin Deritter,14,0,15,1
1667978733268,MATH 292,A00,098061,Belmont; Eva Kinoshita,10,0,10,0
1667978733699,MATH 295,A00,098062,Suk; Andrew Hoon,48,0,50,2
1667978734123,MATH 296,A00,098063,Novak; Jonathan I,20,0,20,0
1667978734546,MATH 297,001,098064,Gamst; Anthony Collins,9997,0,9999,2
1667979246492,COGS 205,A00,101395,Chiba; Andrea,19,0,20,1
1667979246917,COGS 210B,001,101404,Greene; Deanna Jacquelyn,9998,0,9999,1
1667979246917,COGS 210B,002,101417,Xia; Haijun,9999,0,9999,0
1667979246917,COGS 210B,003,101422,Nitz; Douglas A.,9999,0,9999,0
1667979246917,COGS 210B,004,101423,Hollan; James D.,9998,0,9999,1
1667979246917,COGS 210B,005,101424,Deak; Gedeon O.,9999,0,9999,0
1667979246917,COGS 210B,006,101425,Rossano; Federico,9999,0,9999,0
1667979247347,COGS 211B,A00,101427,Coulson; Seana M,9997,0,9999,2
1667979247772,COGS 220,A00,101428,Hollan; James D.,0,0,25,25
1667979248195,COGS 229,A00,101429,Dow; Steven P,18,0,25,7
1667979248627,COGS 230,A00,101430,Klemmer; Scott R,13,0,17,4
1667979249049,COGS 234,A00,101431,Xia; Haijun,7,0,25,18
1667979249493,COGS 260,A00,101432,Kiyonaga; Anastasia,20,0,25,5
1667979249493,COGS 260,B00,101433,Kirsh; David Joel,16,0,25,9
1667979249920,CSE 202,A00,102371,Impagliazzo; Russell,0,0,0,0
1667979250348,CSE 203B,A01,102373,Cheng; Chung Kuan,0,0,0,0
1667979250772,CSE 208,A00,102374,Micciancio; Daniele,0,0,0,0
1667979251200,CSE 209A,A00,112895,Impagliazzo; Russell,0,0,15,15
1667979251634,CSE 209B,A00,108005,Bellare; Mihir,0,0,0,0
1667979252070,CSE 210,A00,113163,Coblenz; Michael J,0,0,0,0
1667979252498,CSE 219,A00,106111,Dow; Steven P,0,0,20,20
1667979252921,CSE 221,A00,102376,Voelker; Geoffrey M.,0,0,0,0
1667979253347,CSE 224,A01,102378,Porter; George M,0,0,0,0
1667979253774,CSE 229A,A00,102379,Savage; Stefan,0,0,0,0
1667979254198,CSE 229C,A00,102380,Munyaka; Imani N. S.,0,0,0,0
1667979254622,CSE 232B,A00,102382,Deutsch; Alin Bernard,0,0,0,0
1667979255054,CSE 234,A01,112904,Kumar; Arun Kumar,0,0,0,0
1667979255487,CSE 237A,A00,102383,Rosing; Tajana Simunic,0,0,0,0
1667979255915,CSE 239A,A00,102384,Deutsch; Alin Bernard,0,0,0,0
1667979256351,CSE 239B,A00,102385,Polikarpova; Nadezhda,0,0,0,0
1667979256775,CSE 240A,A00,102386,Pannuto; Patrick William,0,0,0,0
1667979257208,CSE 240B,A00,102387,Zhao; Jishen,0,0,0,0
1667979257637,CSE 241A,A00,106406,Kang; Mingu,0,0,0,0
1667979258060,CSE 249B,A00,102388,Kahng; Andrew Byun,0,0,8,8
1667979258489,CSE 251B,A01,102392,Cottrell; Garrison W,0,0,0,0
1667979258489,CSE 251B,A02,102393,Cottrell; Garrison W,0,0,0,0
1667979258916,CSE 252B,A00,102394,Ochoa; Benjamin Lawrence,0,0,0,0
1667979259352,CSE 257,A01,102396,Gao; Sicun,0,0,0,0
1667979259778,CSE 272,A00,102397,Li; Tzumao,0,0,0,0
1667979260201,CSE 274,A00,111323,Chern; Albert Ren-Haur,0,0,0,0
1667979260625,CSE 282,A00,102398,Pevzner; Pavel Arkadjevich,0,0,0,0
1667979261048,CSE 284,A00,114175,Gymrek; Melissa Ann,0,0,0,0
1667979261475,CSE 290,A00,102399,Chandraker; Manmohan Krishna,0,0,0,0
1667979261475,CSE 290,B00,102400,Vaccaro; Kristen Marie,0,0,25,25
1667979261475,CSE 290,C00,102414,Pannuto; Patrick William,0,0,25,25
1667979261475,CSE 290,D00,102427,Pevzner; Pavel Arkadjevich,0,0,0,0
1667979261475,CSE 290,E00,102429,Zhao; Jishen,0,0,0,0
1667979261475,CSE 290,F00,102436,Tullsen; Dean Michael,0,0,0,0
1667979261475,CSE 290,G00,102440,Christensen; Henrik I,0,0,20,20
1667979261907,CSE 291,A00,102443,Su; Hao,0,0,0,0
1667979261907,CSE 291,B00,102448,Polikarpova; Nadezhda,0,0,0,0
1667979261907,CSE 291,C00,102453,Vaccaro; Kristen Marie,0,0,0,0
1667979261907,CSE 291,D00,111343,Savage; Stefan,0,0,0,0
1667979261907,CSE 291,E00,116474,Claffy; Kimberly Claire,0,0,0,0
1667979261907,CSE 291,F00,116479,Pasquale; Joseph,0,0,0,0
1667979262334,CSE 293,001,119111,Bafna; Vineet,9999,0,9999,0
1667979262334,CSE 293,002,119118,Bellare; Mihir,9999,0,9999,0
1667979262334,CSE 293,003,119122,Berg-Kirkpatrick; Taylor D,9999,0,9999,0
1667979262334,CSE 293,004,119135,Christensen; Henrik I,9999,0,9999,0
1667979262334,CSE 293,005,119142,Cottrell; Garrison W,9999,0,9999,0
1667979262334,CSE 293,006,119146,Deutsch; Alin Bernard,9999,0,9999,0
1667979262334,CSE 293,007,119159,Esmaeilzadeh; Hadi,9999,0,9999,0
1667979262334,CSE 293,008,119166,Freund; Yoav,9999,0,9999,0
1667979262334,CSE 293,009,119170,Griswold; William G.,9999,0,9999,0
1667979262334,CSE 293,010,119183,Gymrek; Melissa Ann,9999,0,9999,0
1667979262334,CSE 293,011,119190,Heninger; Nadia A,9999,0,9999,0
1667979262334,CSE 293,012,119230,Impagliazzo; Russell,9999,0,9999,0
1667979262334,CSE 293,013,119232,Jhala; Ranjit,9999,0,9999,0
1667979262334,CSE 293,014,119233,Kahng; Andrew Byun,9999,0,9999,0
1667979262334,CSE 293,015,119298,Kane; Daniel Mertz,9999,0,9999,0
1667979262334,CSE 293,016,119299,Kriegman; David J,9999,0,9999,0
1667979262334,CSE 293,017,119300,Kumar; Arun Kumar,9999,0,9999,0
1667979262334,CSE 293,018,119301,Lerner; Sorin,9999,0,9999,0
1667979262334,CSE 293,019,119302,Lovett; Shachar,9999,0,9999,0
1667979262334,CSE 293,020,119303,McAuley; Julian John,9999,0,9999,0
1667979262334,CSE 293,021,119304,Micciancio; Daniele,9999,0,9999,0
1667979262334,CSE 293,022,119367,Orailoglu; Alex,9999,0,9999,0
1667979262334,CSE 293,023,119382,Paturi; Ramamohan,9999,0,9999,0
1667979262334,CSE 293,024,119404,Polikarpova; Nadezhda,9999,0,9999,0
1667979262334,CSE 293,025,119406,Politz; Joseph Gibbs,9999,0,9999,0
1667979262334,CSE 293,026,119411,Porter; George M,9999,0,9999,0
1667979262334,CSE 293,027,119414,Porter; Leonard Emerson,9999,0,9999,0
1667979262334,CSE 293,028,119416,Ramamoorthi; Ravi,9999,0,9999,0
1667979262334,CSE 293,029,119417,Sahoo; Debashis,9999,0,9999,0
1667979262334,CSE 293,030,119420,Saul; Lawrence,9999,0,9999,0
1667979262334,CSE 293,031,119421,Savage; Stefan,9999,0,9999,0
1667979262334,CSE 293,032,119425,Schulze; Jurgen P.,9999,0,9999,0
1667979262334,CSE 293,033,119426,Snoeren; Alex C.,9999,0,9999,0
1667979262334,CSE 293,034,119428,Shang; Jingbo,9999,0,9999,0
1667979262334,CSE 293,035,119430,Stefan; Deian,9999,0,9999,0
1667979262334,CSE 293,036,119431,Su; Hao,9999,0,9999,0
1667979262334,CSE 293,037,119433,Swanson; Steven James,9999,0,9999,0
1667979262334,CSE 293,038,119435,Tullsen; Dean Michael,9999,0,9999,0
1667979262334,CSE 293,039,119483,Voelker; Geoffrey M.,9999,0,9999,0
1667979262334,CSE 293,040,119537,Zhao; Jishen,9999,0,9999,0
1667979262334,CSE 293,041,119538,Zhou; Yuan-Yuan,9999,0,9999,0
1667979262334,CSE 293,042,119539,Gao; Sicun,9999,0,9999,0
1667979262334,CSE 293,043,119540,Weibel; Nadir,9999,0,9999,0
1667979262334,CSE 293,044,119541,Gupta; Rajesh K.,9999,0,9999,0
1667979262334,CSE 293,045,126410,Vaccaro; Kristen Marie,9999,0,9999,0
1667979262334,CSE 293,046,126411,Klemke; Richard,9999,0,9999,0
1667979262766,CSE 294,A00,102459,Voelker; Geoffrey M.,0,0,0,0
1667979262766,CSE 294,B00,111322,Orailoglu; Alex,0,0,0,0
1667979263190,DSE 201,A00,096914,Deutsch; Alin Bernard,30,0,30,0
1667979263614,DSE 210,A00,096915,Dasgupta; Sanjoy,30,0,30,0
1667979264036,DSE 260A,A00,096916,Altintas De Callaf; Ilkay,30,0,30,0
1667979264475,ECE 200,001,103586,Antipa; Nicholas A,9999,0,9999,0
1667979264475,ECE 200,002,103587,Atanasov; Nikolay A.,9999,0,9999,0
1667979264475,ECE 200,003,103588,Bharadia; Dinesh,9999,0,9999,0
1667979264475,ECE 200,004,103589,Cheng; Chung Kuan,9999,0,9999,0
1667979264475,ECE 200,005,103590,Cosman; Pamela C.,9999,0,9999,0
1667979264475,ECE 200,006,103591,Dayeh; Shadi Ahmad,9999,0,9999,0
1667979264475,ECE 200,007,103592,Fainman; Yeshaiahu,9999,0,9999,0
1667979264475,ECE 200,008,103593,Ford; Joseph Earl,9999,0,9999,0
1667979264475,ECE 200,009,103594,Franceschetti; Massimo,9999,0,9999,0
1667979264475,ECE 200,010,103595,Fullerton; Eric E,9999,0,9999,0
1667979264475,ECE 200,011,103596,Galton; Ian A,9999,0,9999,0
1667979264475,ECE 200,012,103597,Gilja; Vikash,9999,0,9999,0
1667979264475,ECE 200,013,103598,Hall; Drew A.,9999,0,9999,0
1667979264475,ECE 200,014,103599,Hsueh; Tzu-Chien,9999,0,9999,0
1667979264475,ECE 200,015,103600,Javidi; Tara,9999,0,9999,0
1667979264475,ECE 200,016,103601,Kahng; Andrew Byun,9999,0,9999,0
1667979264475,ECE 200,017,103602,Kim; Young-Han,9999,0,9999,0
1667979264475,ECE 200,018,103603,Koushanfar; Farinaz,9999,0,9999,0
1667979264475,ECE 200,019,103604,Kuzum; Duygu,9999,0,9999,0
1667979264475,ECE 200,020,103605,Le; Hanh-Phuc,9999,0,9999,0
1667979264475,ECE 200,021,103606,Lin; Bill,9999,0,9999,0
1667979264475,ECE 200,022,103607,Liu; Zhaowei,9998,0,9999,1
1667979264475,ECE 200,023,103608,Lo; Yu-Hwa,9999,0,9999,0
1667979264475,ECE 200,024,103609,Lomakin; Vitaliy,9999,0,9999,0
1667979264475,ECE 200,025,103610,Mercier; Patrick Philip,9999,0,9999,0
1667979264475,ECE 200,026,103611,Meyer; Florian,9999,0,9999,0
1667979264475,ECE 200,027,103612,Milstein; Laurence B.,9999,0,9999,0
1667979264475,ECE 200,028,103613,Mir Arabbaygi; Siavash,9999,0,9999,0
1667979264475,ECE 200,029,103614,Mookherjea; Shayan,9999,0,9999,0
1667979264475,ECE 200,030,103615,Morris; Karcher William,9999,0,9999,0
1667979264475,ECE 200,031,103616,Ng; Tse Nga,9999,0,9999,0
1667979264475,ECE 200,032,103617,Nguyen; Truong Quang,9999,0,9999,0
1667979264475,ECE 200,033,103618,Nomura; Kenji,9999,0,9999,0
1667979264475,ECE 200,034,103619,Orlitsky; Alon,9999,0,9999,0
1667979264475,ECE 200,035,103620,Pal; Piya,9999,0,9999,0
1667979264475,ECE 200,036,103621,Papen; George C.,9999,0,9999,0
1667979264475,ECE 200,037,103622,Radic; Stojan,9999,0,9999,0
1667979264475,ECE 200,038,103623,Rao; Bhaskar D.,9999,0,9999,0
1667979264475,ECE 200,039,103624,Rao; Ramesh R,9999,0,9999,0
1667979264475,ECE 200,040,103625,Rebeiz; Gabriel,9999,0,9999,0
1667979264475,ECE 200,041,103626,Sanford; John R,9999,0,9999,0
1667979264475,ECE 200,042,103627,Siegel; Paul H.,9999,0,9999,0
1667979264475,ECE 200,043,103628,Sievenpiper; Daniel F.,9999,0,9999,0
1667979264475,ECE 200,044,103629,Sworder; David D.,9999,0,9999,0
1667979264475,ECE 200,045,103630,Taur; Yuan,9999,0,9999,0
1667979264475,ECE 200,046,103631,Touri; Behrouz,9999,0,9999,0
1667979264475,ECE 200,047,103632,Trivedi; Mohan M.,9999,0,9999,0
1667979264475,ECE 200,048,103633,Vasconcelos; Nuno,9999,0,9999,0
1667979264475,ECE 200,049,103634,Wang; Xiaolong,9999,0,9999,0
1667979264475,ECE 200,050,103635,Xie; Pengtao,9999,0,9999,0
1667979264475,ECE 200,051,103636,Yip; Michael,9999,0,9999,0
1667979264475,ECE 200,052,103637,Zeger; Kenneth A.,999,0,999,0
1667979264475,ECE 200,053,103638,Zhang; Xinyu,9999,0,9999,0
1667979264475,ECE 200,054,103639,Turakhia; Yatish Girish,9999,0,9999,0
1667979264475,ECE 200,055,103640,Kang; Mingu,9999,0,9999,0
1667979264475,ECE 200,056,103641,Shi; Yuanyuan,9999,0,9999,0
1667979264475,ECE 200,057,103642,Wang; Edward Jay,9999,0,9999,0
1667979264475,ECE 200,058,103643,Zheng; Yang,9999,0,9999,0
1667979264901,ECE 202,A00,103644,Kuzum; Duygu,0,0,0,0
1667979265334,ECE 212BN,A00,103646,Ng; Tse Nga,0,0,0,0
1667979265758,ECE 221,A00,111493,Staff,0,0,0,0
1667979266181,ECE 222B,A00,103647,Lomakin; Vitaliy,0,0,0,0
1667979266604,ECE 230B,A00,103648,Taur; Yuan,0,0,0,0
1667979267031,ECE 238B,A00,103649,Garay; Javier,0,0,0,0
1667979267453,ECE 240B,A00,112900,Fainman; Yeshaiahu,0,0,0,0
1667979267877,ECE 247A,A00,103650,Jokerst; Jesse Vincent,0,0,0,0
1667979268300,ECE 247B,A00,103651,Wang; Joseph,0,0,0,0
1667979268726,ECE 250,A00,103652,Siegel; Paul H.,0,0,0,0
1667979269150,ECE 251A,A00,103654,Rao; Bhaskar D.,0,0,0,0
1667979269575,ECE 257B,A00,103655,Bharadia; Dinesh,0,0,0,0
1667979269997,ECE 258A,A00,103656,Milstein; Laurence B.,0,0,0,0
1667979270421,ECE 260B,A00,103658,Kang; Mingu,0,0,0,0
1667979270844,ECE 264A,A00,103659,Galton; Ian A,0,0,0,0
1667979271270,ECE 265A,A00,103661,Gudem; Prasad S.S.,0,0,0,0
1667979271695,ECE 265D,A00,103662,Gudem; Prasad S.S.,0,0,0,0
1667979272123,ECE 268,A00,103663,Koushanfar; Farinaz,0,0,0,0
1667979272548,ECE 269,A01,103665,Pal; Piya,0,0,0,0
1667979272973,ECE 271B,A00,103666,Vasconcelos; Manuela,0,0,0,0
1667979273408,ECE 276A,A00,103667,Atanasov; Nikolay A.,0,0,0,0
1667979273839,ECE 277,A00,103668,An; Cheolhong,0,0,0,0
1667979274264,ECE 279,A00,117947,Hall; Drew A.,0,0,0,0
1667979275111,ECE 283,A00,103670,Hsueh; Tzu-Chien,0,0,0,0
1667979275538,ECE 284,A00,103671,Turakhia; Yatish Girish,0,0,0,0
1667979275970,ECE 285,A00,103672,Zheng; Yang,0,0,0,0
1667979275970,ECE 285,B00,103673,Sworder; David D.,0,0,0,0
1667979276398,ECE 287,A00,103676,Javidi; Tara,0,0,0,0
1667979276822,MATH 200B,A00,098023,Salehi Golsefidy; Alireza,14,0,15,1
1667979277246,MATH 202B,A00,098024,Rhoades; Brendon Patrick,12,0,15,3
1667979277668,MATH 203B,A00,098025,Oprea; Dragos N.,12,0,15,3
1667979278093,MATH 204B,A00,098026,Sorensen; Claus M,14,0,15,1
1667979278517,MATH 208,A00,098027,Izadi; Elham,7,0,10,3
1667979278948,MATH 209,A00,098028,Pollack; Aaron,10,0,10,0
1667979279373,MATH 211A,A00,112919,Rogalski; Daniel,9,0,10,1
1667979279806,MATH 211B,A00,112920,Seward; Brandon M.,9,0,10,1
1667979280229,MATH 218,A00,098029,Li; Bo,10,0,10,0
1667979280658,MATH 220B,A00,098030,Novak; Jonathan I,13,0,15,2
1667979281082,MATH 221A,A00,098031,Ebenfelt; Peter F,13,0,15,2
1667979281505,MATH 231B,A00,098032,Zlatos; Andrej,12,0,15,3
1667979281928,MATH 240B,A00,098033,Ni; Lei,10,0,15,5
1667979282350,MATH 243,A00,098034,Jekel; David Andrew,10,0,10,0
1667979282774,MATH 245A,A00,098035,Nie; Jiawang,0,0,15,16
1667979283213,MATH 248,A00,098036,Bejenaru; Ioan,10,0,10,0
1667979283647,MATH 250B,A00,098037,Spolaor; Luca,14,0,15,1
1667979284071,MATH 258,A00,098038,Ni; Lei,10,0,10,0
1667979284496,MATH 264B,A00,098041,Rhoades; Brendon Patrick,12,0,15,3
1667979284918,MATH 268,A00,098042,Buss; Samuel R,10,0,10,0
1667979285344,MATH 269,A00,098043,Rhoades; Brendon Patrick,10,0,10,0
1667979285770,MATH 270B,A00,098044,Li; Bo,11,0,15,4
1667979286196,MATH 272B,A00,098045,Holst; Michael J,13,0,15,2
1667979286620,MATH 273A,A00,098046,Tian; Xiaochuan,12,0,15,3
1667979287043,MATH 275,A01,098048,Tian; Xiaochuan,6,0,10,4
1667979287473,MATH 278A,A00,098049,Holst; Michael J,8,0,10,2
1667979287969,MATH 278B,A00,098050,Cloninger; Alexander,10,0,10,0
1667979288392,MATH 278C,A00,098051,Nie; Jiawang,8,0,10,2
1667979288815,MATH 280B,A00,098052,Zheng; Tianyi,11,0,15,4
1667979289241,MATH 281B,A00,098053,Bradic; Jelena,4,0,15,11
1667979289670,MATH 282B,A00,098054,Arias-Castro; Ery,2,0,15,13
1667979290094,MATH 285,A00,098055,Fitzsimmons; Patrick J,0,0,15,17
1667979290521,MATH 287B,A00,098056,Arias-Castro; Ery,5,0,15,10
1667979290946,MATH 288,A00,098057,Agarwal; Pooja,9,0,10,1
1667979290946,MATH 288,B00,098058,Zhang; Danna,9,0,10,1
1667979290946,MATH 288,C00,098059,Williams; Ruth J,10,0,10,0
1667979291370,MATH 290B,A00,098060,Roberts; Justin Deritter,14,0,15,1
1667979291798,MATH 292,A00,098061,Belmont; Eva Kinoshita,10,0,10,0
1667979292221,MATH 295,A00,098062,Suk; Andrew Hoon,48,0,50,2
1667979292643,MATH 296,A00,098063,Novak; Jonathan I,20,0,20,0
1667979293067,MATH 297,001,098064,Gamst; Anthony Collins,9997,0,9999,2
1667979792249,COGS 205,A00,101395,Chiba; Andrea,19,0,20,1
1667979792673,COGS 210B,001,101404,Greene; Deanna Jacquelyn,9998,0,9999,1
1667979792673,COGS 210B,002,101417,Xia; Haijun,9999,0,9999,0
1667979792673,COGS 210B,003,101422,Nitz; Douglas A.,9999,0,9999,0
1667979792673,COGS 210B,004,101423,Hollan; James D.,9998,0,9999,1
1667979792673,COGS 210B,005,101424,Deak; Gedeon O.,9999,0,9999,0
1667979792673,COGS 210B,006,101425,Rossano; Federico,9999,0,9999,0
1667979793095,COGS 211B,A00,101427,Coulson; Seana M,9997,0,9999,2
1667979793521,COGS 220,A00,101428,Hollan; James D.,0,0,25,25
1667979793948,COGS 229,A00,101429,Dow; Steven P,18,0,25,7
1667979794373,COGS 230,A00,101430,Klemmer; Scott R,13,0,17,4
1667979794795,COGS 234,A00,101431,Xia; Haijun,7,0,25,18
1667979795219,COGS 260,A00,101432,Kiyonaga; Anastasia,20,0,25,5
1667979795219,COGS 260,B00,101433,Kirsh; David Joel,16,0,25,9
1667979795641,CSE 202,A00,102371,Impagliazzo; Russell,0,0,0,0
1667979796066,CSE 203B,A01,102373,Cheng; Chung Kuan,0,0,0,0
1667979796498,CSE 208,A00,102374,Micciancio; Daniele,0,0,0,0
1667979796923,CSE 209A,A00,112895,Impagliazzo; Russell,0,0,15,15
1667979797344,CSE 209B,A00,108005,Bellare; Mihir,0,0,0,0
1667979797770,CSE 210,A00,113163,Coblenz; Michael J,0,0,0,0
1667979798195,CSE 219,A00,106111,Dow; Steven P,0,0,20,20
1667979798618,CSE 221,A00,102376,Voelker; Geoffrey M.,0,0,0,0
1667979799041,CSE 224,A01,102378,Porter; George M,0,0,0,0
1667979799463,CSE 229A,A00,102379,Savage; Stefan,0,0,0,0
1667979799888,CSE 229C,A00,102380,Munyaka; Imani N. S.,0,0,0,0
1667979800311,CSE 232B,A00,102382,Deutsch; Alin Bernard,0,0,0,0
1667979800735,CSE 234,A01,112904,Kumar; Arun Kumar,0,0,0,0
1667979801156,CSE 237A,A00,102383,Rosing; Tajana Simunic,0,0,0,0
1667979801583,CSE 239A,A00,102384,Deutsch; Alin Bernard,0,0,0,0
1667979802011,CSE 239B,A00,102385,Polikarpova; Nadezhda,0,0,0,0
1667979802438,CSE 240A,A00,102386,Pannuto; Patrick William,0,0,0,0
1667979802863,CSE 240B,A00,102387,Zhao; Jishen,0,0,0,0
1667979803291,CSE 241A,A00,106406,Kang; Mingu,0,0,0,0
1667979803715,CSE 249B,A00,102388,Kahng; Andrew Byun,0,0,8,8
1667979804138,CSE 251B,A01,102392,Cottrell; Garrison W,0,0,0,0
1667979804138,CSE 251B,A02,102393,Cottrell; Garrison W,0,0,0,0
1667979804564,CSE 252B,A00,102394,Ochoa; Benjamin Lawrence,0,0,0,0
1667979804993,CSE 257,A01,102396,Gao; Sicun,0,0,0,0
1667979805416,CSE 272,A00,102397,Li; Tzumao,0,0,0,0
1667979805839,CSE 274,A00,111323,Chern; Albert Ren-Haur,0,0,0,0
1667979806262,CSE 282,A00,102398,Pevzner; Pavel Arkadjevich,0,0,0,0
1667979806684,CSE 284,A00,114175,Gymrek; Melissa Ann,0,0,0,0
1667979807207,CSE 290,A00,102399,Chandraker; Manmohan Krishna,0,0,0,0
1667979807207,CSE 290,B00,102400,Vaccaro; Kristen Marie,0,0,25,25
1667979807207,CSE 290,C00,102414,Pannuto; Patrick William,0,0,25,25
1667979807207,CSE 290,D00,102427,Pevzner; Pavel Arkadjevich,0,0,0,0
1667979807207,CSE 290,E00,102429,Zhao; Jishen,0,0,0,0
1667979807207,CSE 290,F00,102436,Tullsen; Dean Michael,0,0,0,0
1667979807207,CSE 290,G00,102440,Christensen; Henrik I,0,0,20,20
1667979807634,CSE 291,A00,102443,Su; Hao,0,0,0,0
1667979807634,CSE 291,B00,102448,Polikarpova; Nadezhda,0,0,0,0
1667979807634,CSE 291,C00,102453,Vaccaro; Kristen Marie,0,0,0,0
1667979807634,CSE 291,D00,111343,Savage; Stefan,0,0,0,0
1667979807634,CSE 291,E00,116474,Claffy; Kimberly Claire,0,0,0,0
1667979807634,CSE 291,F00,116479,Pasquale; Joseph,0,0,0,0
1667979808070,CSE 293,001,119111,Bafna; Vineet,9999,0,9999,0
1667979808070,CSE 293,002,119118,Bellare; Mihir,9999,0,9999,0
1667979808070,CSE 293,003,119122,Berg-Kirkpatrick; Taylor D,9999,0,9999,0
1667979808070,CSE 293,004,119135,Christensen; Henrik I,9999,0,9999,0
1667979808070,CSE 293,005,119142,Cottrell; Garrison W,9999,0,9999,0
1667979808070,CSE 293,006,119146,Deutsch; Alin Bernard,9999,0,9999,0
1667979808070,CSE 293,007,119159,Esmaeilzadeh; Hadi,9999,0,9999,0
1667979808070,CSE 293,008,119166,Freund; Yoav,9999,0,9999,0
1667979808070,CSE 293,009,119170,Griswold; William G.,9999,0,9999,0
1667979808070,CSE 293,010,119183,Gymrek; Melissa Ann,9999,0,9999,0
1667979808070,CSE 293,011,119190,Heninger; Nadia A,9999,0,9999,0
1667979808070,CSE 293,012,119230,Impagliazzo; Russell,9999,0,9999,0
1667979808070,CSE 293,013,119232,Jhala; Ranjit,9999,0,9999,0
1667979808070,CSE 293,014,119233,Kahng; Andrew Byun,9999,0,9999,0
1667979808070,CSE 293,015,119298,Kane; Daniel Mertz,9999,0,9999,0
1667979808070,CSE 293,016,119299,Kriegman; David J,9999,0,9999,0
1667979808070,CSE 293,017,119300,Kumar; Arun Kumar,9999,0,9999,0
1667979808070,CSE 293,018,119301,Lerner; Sorin,9999,0,9999,0
1667979808070,CSE 293,019,119302,Lovett; Shachar,9999,0,9999,0
1667979808070,CSE 293,020,119303,McAuley; Julian John,9999,0,9999,0
1667979808070,CSE 293,021,119304,Micciancio; Daniele,9999,0,9999,0
1667979808070,CSE 293,022,119367,Orailoglu; Alex,9999,0,9999,0
1667979808070,CSE 293,023,119382,Paturi; Ramamohan,9999,0,9999,0
1667979808070,CSE 293,024,119404,Polikarpova; Nadezhda,9999,0,9999,0
1667979808070,CSE 293,025,119406,Politz; Joseph Gibbs,9999,0,9999,0
1667979808070,CSE 293,026,119411,Porter; George M,9999,0,9999,0
1667979808070,CSE 293,027,119414,Porter; Leonard Emerson,9999,0,9999,0
1667979808070,CSE 293,028,119416,Ramamoorthi; Ravi,9999,0,9999,0
1667979808070,CSE 293,029,119417,Sahoo; Debashis,9999,0,9999,0
1667979808070,CSE 293,030,119420,Saul; Lawrence,9999,0,9999,0
1667979808070,CSE 293,031,119421,Savage; Stefan,9999,0,9999,0
1667979808070,CSE 293,032,119425,Schulze; Jurgen P.,9999,0,9999,0
1667979808070,CSE 293,033,119426,Snoeren; Alex C.,9999,0,9999,0
1667979808070,CSE 293,034,119428,Shang; Jingbo,9999,0,9999,0
1667979808070,CSE 293,035,119430,Stefan; Deian,9999,0,9999,0
1667979808070,CSE 293,036,119431,Su; Hao,9999,0,9999,0
1667979808070,CSE 293,037,119433,Swanson; Steven James,9999,0,9999,0
1667979808070,CSE 293,038,119435,Tullsen; Dean Michael,9999,0,9999,0
1667979808070,CSE 293,039,119483,Voelker; Geoffrey M.,9999,0,9999,0
1667979808070,CSE 293,040,119537,Zhao; Jishen,9999,0,9999,0
1667979808070,CSE 293,041,119538,Zhou; Yuan-Yuan,9999,0,9999,0
1667979808070,CSE 293,042,119539,Gao; Sicun,9999,0,9999,0
1667979808070,CSE 293,043,119540,Weibel; Nadir,9999,0,9999,0
1667979808070,CSE 293,044,119541,Gupta; Rajesh K.,9999,0,9999,0
1667979808070,CSE 293,045,126410,Vaccaro; Kristen Marie,9999,0,9999,0
1667979808070,CSE 293,046,126411,Klemke; Richard,9999,0,9999,0
1667979808493,CSE 294,A00,102459,Voelker; Geoffrey M.,0,0,0,0
1667979808493,CSE 294,B00,111322,Orailoglu; Alex,0,0,0,0
1667979808916,DSE 201,A00,096914,Deutsch; Alin Bernard,30,0,30,0
1667979809341,DSE 210,A00,096915,Dasgupta; Sanjoy,30,0,30,0
1667979809766,DSE 260A,A00,096916,Altintas De Callaf; Ilkay,30,0,30,0
1667979810219,ECE 200,001,103586,Antipa; Nicholas A,9999,0,9999,0
1667979810219,ECE 200,002,103587,Atanasov; Nikolay A.,9999,0,9999,0
1667979810219,ECE 200,003,103588,Bharadia; Dinesh,9999,0,9999,0
1667979810219,ECE 200,004,103589,Cheng; Chung Kuan,9999,0,9999,0
1667979810219,ECE 200,005,103590,Cosman; Pamela C.,9999,0,9999,0
1667979810219,ECE 200,006,103591,Dayeh; Shadi Ahmad,9999,0,9999,0
1667979810219,ECE 200,007,103592,Fainman; Yeshaiahu,9999,0,9999,0
1667979810219,ECE 200,008,103593,Ford; Joseph Earl,9999,0,9999,0
1667979810219,ECE 200,009,103594,Franceschetti; Massimo,9999,0,9999,0
1667979810219,ECE 200,010,103595,Fullerton; Eric E,9999,0,9999,0
1667979810219,ECE 200,011,103596,Galton; Ian A,9999,0,9999,0
1667979810219,ECE 200,012,103597,Gilja; Vikash,9999,0,9999,0
1667979810219,ECE 200,013,103598,Hall; Drew A.,9999,0,9999,0
1667979810219,ECE 200,014,103599,Hsueh; Tzu-Chien,9999,0,9999,0
1667979810219,ECE 200,015,103600,Javidi; Tara,9999,0,9999,0
1667979810219,ECE 200,016,103601,Kahng; Andrew Byun,9999,0,9999,0
1667979810219,ECE 200,017,103602,Kim; Young-Han,9999,0,9999,0
1667979810219,ECE 200,018,103603,Koushanfar; Farinaz,9999,0,9999,0
1667979810219,ECE 200,019,103604,Kuzum; Duygu,9999,0,9999,0
1667979810219,ECE 200,020,103605,Le; Hanh-Phuc,9999,0,9999,0
1667979810219,ECE 200,021,103606,Lin; Bill,9999,0,9999,0
1667979810219,ECE 200,022,103607,Liu; Zhaowei,9998,0,9999,1
1667979810219,ECE 200,023,103608,Lo; Yu-Hwa,9999,0,9999,0
1667979810219,ECE 200,024,103609,Lomakin; Vitaliy,9999,0,9999,0
1667979810219,ECE 200,025,103610,Mercier; Patrick Philip,9999,0,9999,0
1667979810219,ECE 200,026,103611,Meyer; Florian,9999,0,9999,0
1667979810219,ECE 200,027,103612,Milstein; Laurence B.,9999,0,9999,0
1667979810219,ECE 200,028,103613,Mir Arabbaygi; Siavash,9999,0,9999,0
1667979810219,ECE 200,029,103614,Mookherjea; Shayan,9999,0,9999,0
1667979810219,ECE 200,030,103615,Morris; Karcher William,9999,0,9999,0
1667979810219,ECE 200,031,103616,Ng; Tse Nga,9999,0,9999,0
1667979810219,ECE 200,032,103617,Nguyen; Truong Quang,9999,0,9999,0
1667979810219,ECE 200,033,103618,Nomura; Kenji,9999,0,9999,0
1667979810219,ECE 200,034,103619,Orlitsky; Alon,9999,0,9999,0
1667979810219,ECE 200,035,103620,Pal; Piya,9999,0,9999,0
1667979810219,ECE 200,036,103621,Papen; George C.,9999,0,9999,0
1667979810219,ECE 200,037,103622,Radic; Stojan,9999,0,9999,0
1667979810219,ECE 200,038,103623,Rao; Bhaskar D.,9999,0,9999,0
1667979810219,ECE 200,039,103624,Rao; Ramesh R,9999,0,9999,0
1667979810219,ECE 200,040,103625,Rebeiz; Gabriel,9999,0,9999,0
1667979810219,ECE 200,041,103626,Sanford; John R,9999,0,9999,0
1667979810219,ECE 200,042,103627,Siegel; Paul H.,9999,0,9999,0
1667979810219,ECE 200,043,103628,Sievenpiper; Daniel F.,9999,0,9999,0
1667979810219,ECE 200,044,103629,Sworder; David D.,9999,0,9999,0
1667979810219,ECE 200,045,103630,Taur; Yuan,9999,0,9999,0
1667979810219,ECE 200,046,103631,Touri; Behrouz,9999,0,9999,0
1667979810219,ECE 200,047,103632,Trivedi; Mohan M.,9999,0,9999,0
1667979810219,ECE 200,048,103633,Vasconcelos; Nuno,9999,0,9999,0
1667979810219,ECE 200,049,103634,Wang; Xiaolong,9999,0,9999,0
1667979810219,ECE 200,050,103635,Xie; Pengtao,9999,0,9999,0
1667979810219,ECE 200,051,103636,Yip; Michael,9999,0,9999,0
1667979810219,ECE 200,052,103637,Zeger; Kenneth A.,999,0,999,0
1667979810219,ECE 200,053,103638,Zhang; Xinyu,9999,0,9999,0
1667979810219,ECE 200,054,103639,Turakhia; Yatish Girish,9999,0,9999,0
1667979810219,ECE 200,055,103640,Kang; Mingu,9999,0,9999,0
1667979810219,ECE 200,056,103641,Shi; Yuanyuan,9999,0,9999,0
1667979810219,ECE 200,057,103642,Wang; Edward Jay,9999,0,9999,0
1667979810219,ECE 200,058,103643,Zheng; Yang,9999,0,9999,0
1667979810646,ECE 202,A00,103644,Kuzum; Duygu,0,0,0,0
1667979811070,ECE 212BN,A00,103646,Ng; Tse Nga,0,0,0,0
1667979811500,ECE 221,A00,111493,Staff,0,0,0,0
1667979811924,ECE 222B,A00,103647,Lomakin; Vitaliy,0,0,0,0
1667979812350,ECE 230B,A00,103648,Taur; Yuan,0,0,0,0
1667979812775,ECE 238B,A00,103649,Garay; Javier,0,0,0,0
1667979813199,ECE 240B,A00,112900,Fainman; Yeshaiahu,0,0,0,0
1667979813625,ECE 247A,A00,103650,Jokerst; Jesse Vincent,0,0,0,0
1667979814051,ECE 247B,A00,103651,Wang; Joseph,0,0,0,0
1667979814475,ECE 250,A00,103652,Siegel; Paul H.,0,0,0,0
1667979814900,ECE 251A,A00,103654,Rao; Bhaskar D.,0,0,0,0
1667979815324,ECE 257B,A00,103655,Bharadia; Dinesh,0,0,0,0
1667979815751,ECE 258A,A00,103656,Milstein; Laurence B.,0,0,0,0
1667979816175,ECE 260B,A00,103658,Kang; Mingu,0,0,0,0
1667979816598,ECE 264A,A00,103659,Galton; Ian A,0,0,0,0
1667979817021,ECE 265A,A00,103661,Gudem; Prasad S.S.,0,0,0,0
1667979817442,ECE 265D,A00,103662,Gudem; Prasad S.S.,0,0,0,0
1667979817863,ECE 268,A00,103663,Koushanfar; Farinaz,0,0,0,0
1667979818287,ECE 269,A01,103665,Pal; Piya,0,0,0,0
1667979818711,ECE 271B,A00,103666,Vasconcelos; Manuela,0,0,0,0
1667979819139,ECE 276A,A00,103667,Atanasov; Nikolay A.,0,0,0,0
1667979819562,ECE 277,A00,103668,An; Cheolhong,0,0,0,0
1667979819988,ECE 279,A00,117947,Hall; Drew A.,0,0,0,0
1667979820844,ECE 283,A00,103670,Hsueh; Tzu-Chien,0,0,0,0
1667979821271,ECE 284,A00,103671,Turakhia; Yatish Girish,0,0,0,0
1667979821700,ECE 285,A00,103672,Zheng; Yang,0,0,0,0
1667979821700,ECE 285,B00,103673,Sworder; David D.,0,0,0,0
1667979822125,ECE 287,A00,103676,Javidi; Tara,0,0,0,0
1667979822550,MATH 200B,A00,098023,Salehi Golsefidy; Alireza,14,0,15,1
1667979822976,MATH 202B,A00,098024,Rhoades; Brendon Patrick,12,0,15,3
1667979823404,MATH 203B,A00,098025,Oprea; Dragos N.,12,0,15,3
1667979823832,MATH 204B,A00,098026,Sorensen; Claus M,14,0,15,1
1667979824255,MATH 208,A00,098027,Izadi; Elham,7,0,10,3
1667979824678,MATH 209,A00,098028,Pollack; Aaron,10,0,10,0
1667979825104,MATH 211A,A00,112919,Rogalski; Daniel,9,0,10,1
1667979825528,MATH 211B,A00,112920,Seward; Brandon M.,9,0,10,1
1667979825951,MATH 218,A00,098029,Li; Bo,10,0,10,0
1667979826386,MATH 220B,A00,098030,Novak; Jonathan I,13,0,15,2
1667979826845,MATH 221A,A00,098031,Ebenfelt; Peter F,13,0,15,2
1667979827269,MATH 231B,A00,098032,Zlatos; Andrej,12,0,15,3
1667979827696,MATH 240B,A00,098033,Ni; Lei,10,0,15,5
1667979828123,MATH 243,A00,098034,Jekel; David Andrew,10,0,10,0
1667979828548,MATH 245A,A00,098035,Nie; Jiawang,0,0,15,16
1667979828996,MATH 248,A00,098036,Bejenaru; Ioan,10,0,10,0
1667979829420,MATH 250B,A00,098037,Spolaor; Luca,14,0,15,1
1667979829846,MATH 258,A00,098038,Ni; Lei,10,0,10,0
1667979830271,MATH 264B,A00,098041,Rhoades; Brendon Patrick,12,0,15,3
1667979830696,MATH 268,A00,098042,Buss; Samuel R,10,0,10,0
1667979831126,MATH 269,A00,098043,Rhoades; Brendon Patrick,10,0,10,0
1667979831552,MATH 270B,A00,098044,Li; Bo,11,0,15,4
1667979831978,MATH 272B,A00,098045,Holst; Michael J,13,0,15,2
1667979832404,MATH 273A,A00,098046,Tian; Xiaochuan,12,0,15,3
1667979832831,MATH 275,A01,098048,Tian; Xiaochuan,6,0,10,4
1667979833265,MATH 278A,A00,098049,Holst; Michael J,8,0,10,2
1667979833688,MATH 278B,A00,098050,Cloninger; Alexander,10,0,10,0
1667979834112,MATH 278C,A00,098051,Nie; Jiawang,8,0,10,2
1667979834539,MATH 280B,A00,098052,Zheng; Tianyi,11,0,15,4
1667979834962,MATH 281B,A00,098053,Bradic; Jelena,4,0,15,11
1667979835395,MATH 282B,A00,098054,Arias-Castro; Ery,2,0,15,13
1667979835819,MATH 285,A00,098055,Fitzsimmons; Patrick J,0,0,15,17
1667979836249,MATH 287B,A00,098056,Arias-Castro; Ery,5,0,15,10
1667979836671,MATH 288,A00,098057,Agarwal; Pooja,9,0,10,1
1667979836671,MATH 288,B00,098058,Zhang; Danna,9,0,10,1
1667979836671,MATH 288,C00,098059,Williams; Ruth J,10,0,10,0
1667979837096,MATH 290B,A00,098060,Roberts; Justin Deritter,14,0,15,1
1667979837518,MATH 292,A00,098061,Belmont; Eva Kinoshita,10,0,10,0
1667979837944,MATH 295,A00,098062,Suk; Andrew Hoon,48,0,50,2
1667979838371,MATH 296,A00,098063,Novak; Jonathan I,20,0,20,0
1667979838795,MATH 297,001,098064,Gamst; Anthony Collins,9997,0,9999,2
1667980337729,COGS 205,A00,101395,Chiba; Andrea,19,0,20,1
1667980338154,COGS 210B,001,101404,Greene; Deanna Jacquelyn,9998,0,9999,1
1667980338154,COGS 210B,002,101417,Xia; Haijun,9999,0,9999,0
1667980338154,COGS 210B,003,101422,Nitz; Douglas A.,9999,0,9999,0
1667980338154,COGS 210B,004,101423,Hollan; James D.,9998,0,9999,1
1667980338154,COGS 210B,005,101424,Deak; Gedeon O.,9999,0,9999,0
1667980338154,COGS 210B,006,101425,Rossano; Federico,9999,0,9999,0
1667980338577,COGS 211B,A00,101427,Coulson; Seana M,9997,0,9999,2
1667980339003,COGS 220,A00,101428,Hollan; James D.,0,0,25,25
1667980339426,COGS 229,A00,101429,Dow; Steven P,18,0,25,7
1667980339851,COGS 230,A00,101430,Klemmer; Scott R,13,0,17,4
1667980340276,COGS 234,A00,101431,Xia; Haijun,7,0,25,18
1667980340705,COGS 260,A00,101432,Kiyonaga; Anastasia,20,0,25,5
1667980340705,COGS 260,B00,101433,Kirsh; David Joel,16,0,25,9
1667980341128,CSE 202,A00,102371,Impagliazzo; Russell,0,0,0,0
1667980341554,CSE 203B,A01,102373,Cheng; Chung Kuan,0,0,0,0
1667980341977,CSE 208,A00,102374,Micciancio; Daniele,0,0,0,0
1667980342401,CSE 209A,A00,112895,Impagliazzo; Russell,0,0,15,15
1667980342825,CSE 209B,A00,108005,Bellare; Mihir,0,0,0,0
1667980343250,CSE 210,A00,113163,Coblenz; Michael J,0,0,0,0
1667980343675,CSE 219,A00,106111,Dow; Steven P,0,0,20,20
1667980344097,CSE 221,A00,102376,Voelker; Geoffrey M.,0,0,0,0
1667980344519,CSE 224,A01,102378,Porter; George M,0,0,0,0
1667980344954,CSE 229A,A00,102379,Savage; Stefan,0,0,0,0
1667980345387,CSE 229C,A00,102380,Munyaka; Imani N. S.,0,0,0,0
1667980345812,CSE 232B,A00,102382,Deutsch; Alin Bernard,0,0,0,0
1667980346238,CSE 234,A01,112904,Kumar; Arun Kumar,0,0,0,0
1667980346662,CSE 237A,A00,102383,Rosing; Tajana Simunic,0,0,0,0
1667980347088,CSE 239A,A00,102384,Deutsch; Alin Bernard,0,0,0,0
1667980347514,CSE 239B,A00,102385,Polikarpova; Nadezhda,0,0,0,0
1667980347939,CSE 240A,A00,102386,Pannuto; Patrick William,0,0,0,0
1667980348372,CSE 240B,A00,102387,Zhao; Jishen,0,0,0,0
1667980348795,CSE 241A,A00,106406,Kang; Mingu,0,0,0,0
1667980349218,CSE 249B,A00,102388,Kahng; Andrew Byun,0,0,8,8
1667980349642,CSE 251B,A01,102392,Cottrell; Garrison W,0,0,0,0
1667980349642,CSE 251B,A02,102393,Cottrell; Garrison W,0,0,0,0
1667980350067,CSE 252B,A00,102394,Ochoa; Benjamin Lawrence,0,0,0,0
1667980350490,CSE 257,A01,102396,Gao; Sicun,0,0,0,0
1667980350932,CSE 272,A00,102397,Li; Tzumao,0,0,0,0
1667980351359,CSE 274,A00,111323,Chern; Albert Ren-Haur,0,0,0,0
1667980351783,CSE 282,A00,102398,Pevzner; Pavel Arkadjevich,0,0,0,0
1667980352206,CSE 284,A00,114175,Gymrek; Melissa Ann,0,0,0,0
1667980352630,CSE 290,A00,102399,Chandraker; Manmohan Krishna,0,0,0,0
1667980352630,CSE 290,B00,102400,Vaccaro; Kristen Marie,0,0,25,25
1667980352630,CSE 290,C00,102414,Pannuto; Patrick William,0,0,25,25
1667980352630,CSE 290,D00,102427,Pevzner; Pavel Arkadjevich,0,0,0,0
1667980352630,CSE 290,E00,102429,Zhao; Jishen,0,0,0,0
1667980352630,CSE 290,F00,102436,Tullsen; Dean Michael,0,0,0,0
1667980352630,CSE 290,G00,102440,Christensen; Henrik I,0,0,20,20
1667980353058,CSE 291,A00,102443,Su; Hao,0,0,0,0
1667980353058,CSE 291,B00,102448,Polikarpova; Nadezhda,0,0,0,0
1667980353058,CSE 291,C00,102453,Vaccaro; Kristen Marie,0,0,0,0
1667980353058,CSE 291,D00,111343,Savage; Stefan,0,0,0,0
1667980353058,CSE 291,E00,116474,Claffy; Kimberly Claire,0,0,0,0
1667980353058,CSE 291,F00,116479,Pasquale; Joseph,0,0,0,0
1667980353485,CSE 293,001,119111,Bafna; Vineet,9999,0,9999,0
1667980353485,CSE 293,002,119118,Bellare; Mihir,9999,0,9999,0
1667980353485,CSE 293,003,119122,Berg-Kirkpatrick; Taylor D,9999,0,9999,0
1667980353485,CSE 293,004,119135,Christensen; Henrik I,9999,0,9999,0
1667980353485,CSE 293,005,119142,Cottrell; Garrison W,9999,0,9999,0
1667980353485,CSE 293,006,119146,Deutsch; Alin Bernard,9999,0,9999,0
1667980353485,CSE 293,007,119159,Esmaeilzadeh; Hadi,9999,0,9999,0
1667980353485,CSE 293,008,119166,Freund; Yoav,9999,0,9999,0
1667980353485,CSE 293,009,119170,Griswold; William G.,9999,0,9999,0
1667980353485,CSE 293,010,119183,Gymrek; Melissa Ann,9999,0,9999,0
1667980353485,CSE 293,011,119190,Heninger; Nadia A,9999,0,9999,0
1667980353485,CSE 293,012,119230,Impagliazzo; Russell,9999,0,9999,0
1667980353485,CSE 293,013,119232,Jhala; Ranjit,9999,0,9999,0
1667980353485,CSE 293,014,119233,Kahng; Andrew Byun,9999,0,9999,0
1667980353485,CSE 293,015,119298,Kane; Daniel Mertz,9999,0,9999,0
1667980353485,CSE 293,016,119299,Kriegman; David J,9999,0,9999,0
1667980353485,CSE 293,017,119300,Kumar; Arun Kumar,9999,0,9999,0
1667980353485,CSE 293,018,119301,Lerner; Sorin,9999,0,9999,0
1667980353485,CSE 293,019,119302,Lovett; Shachar,9999,0,9999,0
1667980353485,CSE 293,020,119303,McAuley; Julian John,9999,0,9999,0
1667980353485,CSE 293,021,119304,Micciancio; Daniele,9999,0,9999,0
1667980353485,CSE 293,022,119367,Orailoglu; Alex,9999,0,9999,0
1667980353485,CSE 293,023,119382,Paturi; Ramamohan,9999,0,9999,0
1667980353485,CSE 293,024,119404,Polikarpova; Nadezhda,9999,0,9999,0
1667980353485,CSE 293,025,119406,Politz; Joseph Gibbs,9999,0,9999,0
1667980353485,CSE 293,026,119411,Porter; George M,9999,0,9999,0
1667980353485,CSE 293,027,119414,Porter; Leonard Emerson,9999,0,9999,0
1667980353485,CSE 293,028,119416,Ramamoorthi; Ravi,9999,0,9999,0
1667980353485,CSE 293,029,119417,Sahoo; Debashis,9999,0,9999,0
1667980353485,CSE 293,030,119420,Saul; Lawrence,9999,0,9999,0
1667980353485,CSE 293,031,119421,Savage; Stefan,9999,0,9999,0
1667980353485,CSE 293,032,119425,Schulze; Jurgen P.,9999,0,9999,0
1667980353485,CSE 293,033,119426,Snoeren; Alex C.,9999,0,9999,0
1667980353485,CSE 293,034,119428,Shang; Jingbo,9999,0,9999,0
1667980353485,CSE 293,035,119430,Stefan; Deian,9999,0,9999,0
1667980353485,CSE 293,036,119431,Su; Hao,9999,0,9999,0
1667980353485,CSE 293,037,119433,Swanson; Steven James,9999,0,9999,0
1667980353485,CSE 293,038,119435,Tullsen; Dean Michael,9999,0,9999,0
1667980353485,CSE 293,039,119483,Voelker; Geoffrey M.,9999,0,9999,0
1667980353485,CSE 293,040,119537,Zhao; Jishen,9999,0,9999,0
1667980353485,CSE 293,041,119538,Zhou; Yuan-Yuan,9999,0,9999,0
1667980353485,CSE 293,042,119539,Gao; Sicun,9999,0,9999,0
1667980353485,CSE 293,043,119540,Weibel; Nadir,9999,0,9999,0
1667980353485,CSE 293,044,119541,Gupta; Rajesh K.,9999,0,9999,0
1667980353485,CSE 293,045,126410,Vaccaro; Kristen Marie,9999,0,9999,0
1667980353485,CSE 293,046,126411,Klemke; Richard,9999,0,9999,0
1667980353909,CSE 294,A00,102459,Voelker; Geoffrey M.,0,0,0,0
1667980353909,CSE 294,B00,111322,Orailoglu; Alex,0,0,0,0
1667980354337,DSE 201,A00,096914,Deutsch; Alin Bernard,30,0,30,0
1667980354762,DSE 210,A00,096915,Dasgupta; Sanjoy,30,0,30,0
1667980355191,DSE 260A,A00,096916,Altintas De Callaf; Ilkay,30,0,30,0
1667980355628,ECE 200,001,103586,Antipa; Nicholas A,9999,0,9999,0
1667980355628,ECE 200,002,103587,Atanasov; Nikolay A.,9999,0,9999,0
1667980355628,ECE 200,003,103588,Bharadia; Dinesh,9999,0,9999,0
1667980355628,ECE 200,004,103589,Cheng; Chung Kuan,9999,0,9999,0
1667980355628,ECE 200,005,103590,Cosman; Pamela C.,9999,0,9999,0
1667980355628,ECE 200,006,103591,Dayeh; Shadi Ahmad,9999,0,9999,0
1667980355628,ECE 200,007,103592,Fainman; Yeshaiahu,9999,0,9999,0
1667980355628,ECE 200,008,103593,Ford; Joseph Earl,9999,0,9999,0
1667980355628,ECE 200,009,103594,Franceschetti; Massimo,9999,0,9999,0
1667980355628,ECE 200,010,103595,Fullerton; Eric E,9999,0,9999,0
1667980355628,ECE 200,011,103596,Galton; Ian A,9999,0,9999,0
1667980355628,ECE 200,012,103597,Gilja; Vikash,9999,0,9999,0
1667980355628,ECE 200,013,103598,Hall; Drew A.,9999,0,9999,0
1667980355628,ECE 200,014,103599,Hsueh; Tzu-Chien,9999,0,9999,0
1667980355628,ECE 200,015,103600,Javidi; Tara,9999,0,9999,0
1667980355628,ECE 200,016,103601,Kahng; Andrew Byun,9999,0,9999,0
1667980355628,ECE 200,017,103602,Kim; Young-Han,9999,0,9999,0
1667980355628,ECE 200,018,103603,Koushanfar; Farinaz,9999,0,9999,0
1667980355628,ECE 200,019,103604,Kuzum; Duygu,9999,0,9999,0
1667980355628,ECE 200,020,103605,Le; Hanh-Phuc,9999,0,9999,0
1667980355628,ECE 200,021,103606,Lin; Bill,9999,0,9999,0
1667980355628,ECE 200,022,103607,Liu; Zhaowei,9998,0,9999,1
1667980355628,ECE 200,023,103608,Lo; Yu-Hwa,9999,0,9999,0
1667980355628,ECE 200,024,103609,Lomakin; Vitaliy,9999,0,9999,0
1667980355628,ECE 200,025,103610,Mercier; Patrick Philip,9999,0,9999,0
1667980355628,ECE 200,026,103611,Meyer; Florian,9999,0,9999,0
1667980355628,ECE 200,027,103612,Milstein; Laurence B.,9999,0,9999,0
1667980355628,ECE 200,028,103613,Mir Arabbaygi; Siavash,9999,0,9999,0
1667980355628,ECE 200,029,103614,Mookherjea; Shayan,9999,0,9999,0
1667980355628,ECE 200,030,103615,Morris; Karcher William,9999,0,9999,0
1667980355628,ECE 200,031,103616,Ng; Tse Nga,9999,0,9999,0
1667980355628,ECE 200,032,103617,Nguyen; Truong Quang,9999,0,9999,0
1667980355628,ECE 200,033,103618,Nomura; Kenji,9999,0,9999,0
1667980355628,ECE 200,034,103619,Orlitsky; Alon,9999,0,9999,0
1667980355628,ECE 200,035,103620,Pal; Piya,9999,0,9999,0
1667980355628,ECE 200,036,103621,Papen; George C.,9999,0,9999,0
1667980355628,ECE 200,037,103622,Radic; Stojan,9999,0,9999,0
1667980355628,ECE 200,038,103623,Rao; Bhaskar D.,9999,0,9999,0
1667980355628,ECE 200,039,103624,Rao; Ramesh R,9999,0,9999,0
1667980355628,ECE 200,040,103625,Rebeiz; Gabriel,9999,0,9999,0
1667980355628,ECE 200,041,103626,Sanford; John R,9999,0,9999,0
1667980355628,ECE 200,042,103627,Siegel; Paul H.,9999,0,9999,0
1667980355628,ECE 200,043,103628,Sievenpiper; Daniel F.,9999,0,9999,0
1667980355628,ECE 200,044,103629,Sworder; David D.,9999,0,9999,0
1667980355628,ECE 200,045,103630,Taur; Yuan,9999,0,9999,0
1667980355628,ECE 200,046,103631,Touri; Behrouz,9999,0,9999,0
1667980355628,ECE 200,047,103632,Trivedi; Mohan M.,9999,0,9999,0
1667980355628,ECE 200,048,103633,Vasconcelos; Nuno,9999,0,9999,0
1667980355628,ECE 200,049,103634,Wang; Xiaolong,9999,0,9999,0
1667980355628,ECE 200,050,103635,Xie; Pengtao,9999,0,9999,0
1667980355628,ECE 200,051,103636,Yip; Michael,9999,0,9999,0
1667980355628,ECE 200,052,103637,Zeger; Kenneth A.,999,0,999,0
1667980355628,ECE 200,053,103638,Zhang; Xinyu,9999,0,9999,0
1667980355628,ECE 200,054,103639,Turakhia; Yatish Girish,9999,0,9999,0
1667980355628,ECE 200,055,103640,Kang; Mingu,9999,0,9999,0
1667980355628,ECE 200,056,103641,Shi; Yuanyuan,9999,0,9999,0
1667980355628,ECE 200,057,103642,Wang; Edward Jay,9999,0,9999,0
1667980355628,ECE 200,058,103643,Zheng; Yang,9999,0,9999,0
1667980356065,ECE 202,A00,103644,Kuzum; Duygu,0,0,0,0
1667980356489,ECE 212BN,A00,103646,Ng; Tse Nga,0,0,0,0
1667980356913,ECE 221,A00,111493,Staff,0,0,0,0
1667980357342,ECE 222B,A00,103647,Lomakin; Vitaliy,0,0,0,0
1667980357766,ECE 230B,A00,103648,Taur; Yuan,0,0,0,0
1667980358192,ECE 238B,A00,103649,Garay; Javier,0,0,0,0
1667980358613,ECE 240B,A00,112900,Fainman; Yeshaiahu,0,0,0,0
1667980359040,ECE 247A,A00,103650,Jokerst; Jesse Vincent,0,0,0,0
1667980359463,ECE 247B,A00,103651,Wang; Joseph,0,0,0,0
1667980359887,ECE 250,A00,103652,Siegel; Paul H.,0,0,0,0
1667980360312,ECE 251A,A00,103654,Rao; Bhaskar D.,0,0,0,0
1667980360734,ECE 257B,A00,103655,Bharadia; Dinesh,0,0,0,0
1667980361160,ECE 258A,A00,103656,Milstein; Laurence B.,0,0,0,0
1667980361582,ECE 260B,A00,103658,Kang; Mingu,0,0,0,0
1667980362010,ECE 264A,A00,103659,Galton; Ian A,0,0,0,0
1667980362434,ECE 265A,A00,103661,Gudem; Prasad S.S.,0,0,0,0
1667980362865,ECE 265D,A00,103662,Gudem; Prasad S.S.,0,0,0,0
1667980363291,ECE 268,A00,103663,Koushanfar; Farinaz,0,0,0,0
1667980363716,ECE 269,A01,103665,Pal; Piya,0,0,0,0
1667980364138,ECE 271B,A00,103666,Vasconcelos; Manuela,0,0,0,0
1667980364561,ECE 276A,A00,103667,Atanasov; Nikolay A.,0,0,0,0
1667980364984,ECE 277,A00,103668,An; Cheolhong,0,0,0,0
1667980365410,ECE 279,A00,117947,Hall; Drew A.,0,0,0,0
1667980366257,ECE 283,A00,103670,Hsueh; Tzu-Chien,0,0,0,0
1667980366680,ECE 284,A00,103671,Turakhia; Yatish Girish,0,0,0,0
1667980367102,ECE 285,A00,103672,Zheng; Yang,0,0,0,0
1667980367102,ECE 285,B00,103673,Sworder; David D.,0,0,0,0
1667980367529,ECE 287,A00,103676,Javidi; Tara,0,0,0,0
1667980367962,MATH 200B,A00,098023,Salehi Golsefidy; Alireza,14,0,15,1
1667980368390,MATH 202B,A00,098024,Rhoades; Brendon Patrick,12,0,15,3
1667980368813,MATH 203B,A00,098025,Oprea; Dragos N.,12,0,15,3
1667980369326,MATH 204B,A00,098026,Sorensen; Claus M,14,0,15,1
1667980369750,MATH 208,A00,098027,Izadi; Elham,7,0,10,3
1667980370175,MATH 209,A00,098028,Pollack; Aaron,10,0,10,0
1667980370601,MATH 211A,A00,112919,Rogalski; Daniel,9,0,10,1
1667980371024,MATH 211B,A00,112920,Seward; Brandon M.,9,0,10,1
1667980371454,MATH 218,A00,098029,Li; Bo,10,0,10,0
1667980371877,MATH 220B,A00,098030,Novak; Jonathan I,13,0,15,2
1667980372300,MATH 221A,A00,098031,Ebenfelt; Peter F,13,0,15,2
1667980372723,MATH 231B,A00,098032,Zlatos; Andrej,12,0,15,3
1667980373146,MATH 240B,A00,098033,Ni; Lei,10,0,15,5
1667980373573,MATH 243,A00,098034,Jekel; David Andrew,10,0,10,0
1667980373998,MATH 245A,A00,098035,Nie; Jiawang,0,0,15,16
1667980374423,MATH 248,A00,098036,Bejenaru; Ioan,10,0,10,0
1667980374848,MATH 250B,A00,098037,Spolaor; Luca,14,0,15,1
1667980375271,MATH 258,A00,098038,Ni; Lei,10,0,10,0
1667980375694,MATH 264B,A00,098041,Rhoades; Brendon Patrick,12,0,15,3
1667980376120,MATH 268,A00,098042,Buss; Samuel R,10,0,10,0
1667980376542,MATH 269,A00,098043,Rhoades; Brendon Patrick,10,0,10,0
1667980376968,MATH 270B,A00,098044,Li; Bo,11,0,15,4
1667980377400,MATH 272B,A00,098045,Holst; Michael J,13,0,15,2
1667980377825,MATH 273A,A00,098046,Tian; Xiaochuan,12,0,15,3
1667980378260,MATH 275,A01,098048,Tian; Xiaochuan,6,0,10,4
1667980378682,MATH 278A,A00,098049,Holst; Michael J,8,0,10,2
1667980379112,MATH 278B,A00,098050,Cloninger; Alexander,10,0,10,0
1667980379534,MATH 278C,A00,098051,Nie; Jiawang,8,0,10,2
1667980379958,MATH 280B,A00,098052,Zheng; Tianyi,11,0,15,4
1667980380383,MATH 281B,A00,098053,Bradic; Jelena,4,0,15,11
1667980380806,MATH 282B,A00,098054,Arias-Castro; Ery,2,0,15,13
1667980381235,MATH 285,A00,098055,Fitzsimmons; Patrick J,0,0,15,17
1667980381658,MATH 287B,A00,098056,Arias-Castro; Ery,5,0,15,10
1667980382085,MATH 288,A00,098057,Agarwal; Pooja,9,0,10,1
1667980382085,MATH 288,B00,098058,Zhang; Danna,9,0,10,1
1667980382085,MATH 288,C00,098059,Williams; Ruth J,10,0,10,0
1667980382511,MATH 290B,A00,098060,Roberts; Justin Deritter,14,0,15,1
1667980382936,MATH 292,A00,098061,Belmont; Eva Kinoshita,10,0,10,0
1667980383358,MATH 295,A00,098062,Suk; Andrew Hoon,48,0,50,2
1667980383782,MATH 296,A00,098063,Novak; Jonathan I,20,0,20,0
1667980384207,MATH 297,001,098064,Gamst; Anthony Collins,9997,0,9999,2
1667980883835,COGS 205,A00,101395,Chiba; Andrea,19,0,20,1
1667980884264,COGS 210B,001,101404,Greene; Deanna Jacquelyn,9998,0,9999,1
1667980884264,COGS 210B,002,101417,Xia; Haijun,9999,0,9999,0
1667980884264,COGS 210B,003,101422,Nitz; Douglas A.,9999,0,9999,0
1667980884264,COGS 210B,004,101423,Hollan; James D.,9998,0,9999,1
1667980884264,COGS 210B,005,101424,Deak; Gedeon O.,9999,0,9999,0
1667980884264,COGS 210B,006,101425,Rossano; Federico,9999,0,9999,0
1667980884691,COGS 211B,A00,101427,Coulson; Seana M,9997,0,9999,2
1667980885118,COGS 220,A00,101428,Hollan; James D.,0,0,25,25
1667980885544,COGS 229,A00,101429,Dow; Steven P,18,0,25,7
1667980885972,COGS 230,A00,101430,Klemmer; Scott R,13,0,17,4
1667980886396,COGS 234,A00,101431,Xia; Haijun,7,0,25,18
1667980886823,COGS 260,A00,101432,Kiyonaga; Anastasia,20,0,25,5
1667980886823,COGS 260,B00,101433,Kirsh; David Joel,16,0,25,9
1667980887248,CSE 202,A00,102371,Impagliazzo; Russell,0,0,0,0
1667980887678,CSE 203B,A01,102373,Cheng; Chung Kuan,0,0,0,0
1667980888101,CSE 208,A00,102374,Micciancio; Daniele,0,0,0,0
1667980888535,CSE 209A,A00,112895,Impagliazzo; Russell,0,0,15,15
1667980889045,CSE 209B,A00,108005,Bellare; Mihir,0,0,0,0
1667980889470,CSE 210,A00,113163,Coblenz; Michael J,0,0,0,0
1667980889894,CSE 219,A00,106111,Dow; Steven P,0,0,20,20
1667980890323,CSE 221,A00,102376,Voelker; Geoffrey M.,0,0,0,0
1667980890744,CSE 224,A01,102378,Porter; George M,0,0,0,0
1667980891166,CSE 229A,A00,102379,Savage; Stefan,0,0,0,0
1667980891595,CSE 229C,A00,102380,Munyaka; Imani N. S.,0,0,0,0
1667980892021,CSE 232B,A00,102382,Deutsch; Alin Bernard,0,0,0,0
1667980892446,CSE 234,A01,112904,Kumar; Arun Kumar,0,0,0,0
1667980892881,CSE 237A,A00,102383,Rosing; Tajana Simunic,0,0,0,0
1667980893307,CSE 239A,A00,102384,Deutsch; Alin Bernard,0,0,0,0
1667980893731,CSE 239B,A00,102385,Polikarpova; Nadezhda,0,0,0,0
1667980894155,CSE 240A,A00,102386,Pannuto; Patrick William,0,0,0,0
1667980894578,CSE 240B,A00,102387,Zhao; Jishen,0,0,0,0
1667980895014,CSE 241A,A00,106406,Kang; Mingu,0,0,0,0
1667980895439,CSE 249B,A00,102388,Kahng; Andrew Byun,0,0,8,8
1667980895865,CSE 251B,A01,102392,Cottrell; Garrison W,0,0,0,0
1667980895865,CSE 251B,A02,102393,Cottrell; Garrison W,0,0,0,0
1667980896294,CSE 252B,A00,102394,Ochoa; Benjamin Lawrence,0,0,0,0
1667980896718,CSE 257,A01,102396,Gao; Sicun,0,0,0,0
1667980897143,CSE 272,A00,102397,Li; Tzumao,0,0,0,0
1667980897573,CSE 274,A00,111323,Chern; Albert Ren-Haur,0,0,0,0
1667980898002,CSE 282,A00,102398,Pevzner; Pavel Arkadjevich,0,0,0,0
1667980898432,CSE 284,A00,114175,Gymrek; Melissa Ann,0,0,0,0
1667980898859,CSE 290,A00,102399,Chandraker; Manmohan Krishna,0,0,0,0
1667980898859,CSE 290,B00,102400,Vaccaro; Kristen Marie,0,0,25,25
1667980898859,CSE 290,C00,102414,Pannuto; Patrick William,0,0,25,25
1667980898859,CSE 290,D00,102427,Pevzner; Pavel Arkadjevich,0,0,0,0
1667980898859,CSE 290,E00,102429,Zhao; Jishen,0,0,0,0
1667980898859,CSE 290,F00,102436,Tullsen; Dean Michael,0,0,0,0
1667980898859,CSE 290,G00,102440,Christensen; Henrik I,0,0,20,20
1667980899290,CSE 291,A00,102443,Su; Hao,0,0,0,0
1667980899290,CSE 291,B00,102448,Polikarpova; Nadezhda,0,0,0,0
1667980899290,CSE 291,C00,102453,Vaccaro; Kristen Marie,0,0,0,0
1667980899290,CSE 291,D00,111343,Savage; Stefan,0,0,0,0
1667980899290,CSE 291,E00,116474,Claffy; Kimberly Claire,0,0,0,0
1667980899290,CSE 291,F00,116479,Pasquale; Joseph,0,0,0,0
1667980899726,CSE 293,001,119111,Bafna; Vineet,9999,0,9999,0
1667980899726,CSE 293,002,119118,Bellare; Mihir,9999,0,9999,0
1667980899726,CSE 293,003,119122,Berg-Kirkpatrick; Taylor D,9999,0,9999,0
1667980899726,CSE 293,004,119135,Christensen; Henrik I,9999,0,9999,0
1667980899726,CSE 293,005,119142,Cottrell; Garrison W,9999,0,9999,0
1667980899726,CSE 293,006,119146,Deutsch; Alin Bernard,9999,0,9999,0
1667980899726,CSE 293,007,119159,Esmaeilzadeh; Hadi,9999,0,9999,0
1667980899726,CSE 293,008,119166,Freund; Yoav,9999,0,9999,0
1667980899726,CSE 293,009,119170,Griswold; William G.,9999,0,9999,0
1667980899726,CSE 293,010,119183,Gymrek; Melissa Ann,9999,0,9999,0
1667980899726,CSE 293,011,119190,Heninger; Nadia A,9999,0,9999,0
1667980899726,CSE 293,012,119230,Impagliazzo; Russell,9999,0,9999,0
1667980899726,CSE 293,013,119232,Jhala; Ranjit,9999,0,9999,0
1667980899726,CSE 293,014,119233,Kahng; Andrew Byun,9999,0,9999,0
1667980899726,CSE 293,015,119298,Kane; Daniel Mertz,9999,0,9999,0
1667980899726,CSE 293,016,119299,Kriegman; David J,9999,0,9999,0
1667980899726,CSE 293,017,119300,Kumar; Arun Kumar,9999,0,9999,0
1667980899726,CSE 293,018,119301,Lerner; Sorin,9999,0,9999,0
1667980899726,CSE 293,019,119302,Lovett; Shachar,9999,0,9999,0
1667980899726,CSE 293,020,119303,McAuley; Julian John,9999,0,9999,0
1667980899726,CSE 293,021,119304,Micciancio; Daniele,9999,0,9999,0
1667980899726,CSE 293,022,119367,Orailoglu; Alex,9999,0,9999,0
1667980899726,CSE 293,023,119382,Paturi; Ramamohan,9999,0,9999,0
1667980899726,CSE 293,024,119404,Polikarpova; Nadezhda,9999,0,9999,0
1667980899726,CSE 293,025,119406,Politz; Joseph Gibbs,9999,0,9999,0
1667980899726,CSE 293,026,119411,Porter; George M,9999,0,9999,0
1667980899726,CSE 293,027,119414,Porter; Leonard Emerson,9999,0,9999,0
1667980899726,CSE 293,028,119416,Ramamoorthi; Ravi,9999,0,9999,0
1667980899726,CSE 293,029,119417,Sahoo; Debashis,9999,0,9999,0
1667980899726,CSE 293,030,119420,Saul; Lawrence,9999,0,9999,0
1667980899726,CSE 293,031,119421,Savage; Stefan,9999,0,9999,0
1667980899726,CSE 293,032,119425,Schulze; Jurgen P.,9999,0,9999,0
1667980899726,CSE 293,033,119426,Snoeren; Alex C.,9999,0,9999,0
1667980899726,CSE 293,034,119428,Shang; Jingbo,9999,0,9999,0
1667980899726,CSE 293,035,119430,Stefan; Deian,9999,0,9999,0
1667980899726,CSE 293,036,119431,Su; Hao,9999,0,9999,0
1667980899726,CSE 293,037,119433,Swanson; Steven James,9999,0,9999,0
1667980899726,CSE 293,038,119435,Tullsen; Dean Michael,9999,0,9999,0
1667980899726,CSE 293,039,119483,Voelker; Geoffrey M.,9999,0,9999,0
1667980899726,CSE 293,040,119537,Zhao; Jishen,9999,0,9999,0
1667980899726,CSE 293,041,119538,Zhou; Yuan-Yuan,9999,0,9999,0
1667980899726,CSE 293,042,119539,Gao; Sicun,9999,0,9999,0
1667980899726,CSE 293,043,119540,Weibel; Nadir,9999,0,9999,0
1667980899726,CSE 293,044,119541,Gupta; Rajesh K.,9999,0,9999,0
1667980899726,CSE 293,045,126410,Vaccaro; Kristen Marie,9999,0,9999,0
1667980899726,CSE 293,046,126411,Klemke; Richard,9999,0,9999,0
1667980900152,CSE 294,A00,102459,Voelker; Geoffrey M.,0,0,0,0
1667980900152,CSE 294,B00,111322,Orailoglu; Alex,0,0,0,0
1667980900585,DSE 201,A00,096914,Deutsch; Alin Bernard,30,0,30,0
1667980901013,DSE 210,A00,096915,Dasgupta; Sanjoy,30,0,30,0
1667980901444,DSE 260A,A00,096916,Altintas De Callaf; Ilkay,30,0,30,0
1667980901893,ECE 200,001,103586,Antipa; Nicholas A,9999,0,9999,0
1667980901893,ECE 200,002,103587,Atanasov; Nikolay A.,9999,0,9999,0
1667980901893,ECE 200,003,103588,Bharadia; Dinesh,9999,0,9999,0
1667980901893,ECE 200,004,103589,Cheng; Chung Kuan,9999,0,9999,0
1667980901893,ECE 200,005,103590,Cosman; Pamela C.,9999,0,9999,0
1667980901893,ECE 200,006,103591,Dayeh; Shadi Ahmad,9999,0,9999,0
1667980901893,ECE 200,007,103592,Fainman; Yeshaiahu,9999,0,9999,0
1667980901893,ECE 200,008,103593,Ford; Joseph Earl,9999,0,9999,0
1667980901893,ECE 200,009,103594,Franceschetti; Massimo,9999,0,9999,0
1667980901893,ECE 200,010,103595,Fullerton; Eric E,9999,0,9999,0
1667980901893,ECE 200,011,103596,Galton; Ian A,9999,0,9999,0
1667980901893,ECE 200,012,103597,Gilja; Vikash,9999,0,9999,0
1667980901893,ECE 200,013,103598,Hall; Drew A.,9999,0,9999,0
1667980901893,ECE 200,014,103599,Hsueh; Tzu-Chien,9999,0,9999,0
1667980901893,ECE 200,015,103600,Javidi; Tara,9999,0,9999,0
1667980901893,ECE 200,016,103601,Kahng; Andrew Byun,9999,0,9999,0
1667980901893,ECE 200,017,103602,Kim; Young-Han,9999,0,9999,0
1667980901893,ECE 200,018,103603,Koushanfar; Farinaz,9999,0,9999,0
1667980901893,ECE 200,019,103604,Kuzum; Duygu,9999,0,9999,0
1667980901893,ECE 200,020,103605,Le; Hanh-Phuc,9999,0,9999,0
1667980901893,ECE 200,021,103606,Lin; Bill,9999,0,9999,0
1667980901893,ECE 200,022,103607,Liu; Zhaowei,9998,0,9999,1
1667980901893,ECE 200,023,103608,Lo; Yu-Hwa,9999,0,9999,0
1667980901893,ECE 200,024,103609,Lomakin; Vitaliy,9999,0,9999,0
1667980901893,ECE 200,025,103610,Mercier; Patrick Philip,9999,0,9999,0
1667980901893,ECE 200,026,103611,Meyer; Florian,9999,0,9999,0
1667980901893,ECE 200,027,103612,Milstein; Laurence B.,9999,0,9999,0
1667980901893,ECE 200,028,103613,Mir Arabbaygi; Siavash,9999,0,9999,0
1667980901893,ECE 200,029,103614,Mookherjea; Shayan,9999,0,9999,0
1667980901893,ECE 200,030,103615,Morris; Karcher William,9999,0,9999,0
1667980901893,ECE 200,031,103616,Ng; Tse Nga,9999,0,9999,0
1667980901893,ECE 200,032,103617,Nguyen; Truong Quang,9999,0,9999,0
1667980901893,ECE 200,033,103618,Nomura; Kenji,9999,0,9999,0
1667980901893,ECE 200,034,103619,Orlitsky; Alon,9999,0,9999,0
1667980901893,ECE 200,035,103620,Pal; Piya,9999,0,9999,0
1667980901893,ECE 200,036,103621,Papen; George C.,9999,0,9999,0
1667980901893,ECE 200,037,103622,Radic; Stojan,9999,0,9999,0
1667980901893,ECE 200,038,103623,Rao; Bhaskar D.,9999,0,9999,0
1667980901893,ECE 200,039,103624,Rao; Ramesh R,9999,0,9999,0
1667980901893,ECE 200,040,103625,Rebeiz; Gabriel,9999,0,9999,0
1667980901893,ECE 200,041,103626,Sanford; John R,9999,0,9999,0
1667980901893,ECE 200,042,103627,Siegel; Paul H.,9999,0,9999,0
1667980901893,ECE 200,043,103628,Sievenpiper; Daniel F.,9999,0,9999,0
1667980901893,ECE 200,044,103629,Sworder; David D.,9999,0,9999,0
1667980901893,ECE 200,045,103630,Taur; Yuan,9999,0,9999,0
1667980901893,ECE 200,046,103631,Touri; Behrouz,9999,0,9999,0
1667980901893,ECE 200,047,103632,Trivedi; Mohan M.,9999,0,9999,0
1667980901893,ECE 200,048,103633,Vasconcelos; Nuno,9999,0,9999,0
1667980901893,ECE 200,049,103634,Wang; Xiaolong,9999,0,9999,0
1667980901893,ECE 200,050,103635,Xie; Pengtao,9999,0,9999,0
1667980901893,ECE 200,051,103636,Yip; Michael,9999,0,9999,0
1667980901893,ECE 200,052,103637,Zeger; Kenneth A.,999,0,999,0
1667980901893,ECE 200,053,103638,Zhang; Xinyu,9999,0,9999,0
1667980901893,ECE 200,054,103639,Turakhia; Yatish Girish,9999,0,9999,0
1667980901893,ECE 200,055,103640,Kang; Mingu,9999,0,9999,0
1667980901893,ECE 200,056,103641,Shi; Yuanyuan,9999,0,9999,0
1667980901893,ECE 200,057,103642,Wang; Edward Jay,9999,0,9999,0
1667980901893,ECE 200,058,103643,Zheng; Yang,9999,0,9999,0
1667980902332,ECE 202,A00,103644,Kuzum; Duygu,0,0,0,0
1667980902758,ECE 212BN,A00,103646,Ng; Tse Nga,0,0,0,0
1667980903188,ECE 221,A00,111493,Staff,0,0,0,0
1667980903618,ECE 222B,A00,103647,Lomakin; Vitaliy,0,0,0,0
1667980904052,ECE 230B,A00,103648,Taur; Yuan,0,0,0,0
1667980904476,ECE 238B,A00,103649,Garay; Javier,0,0,0,0
1667980904903,ECE 240B,A00,112900,Fainman; Yeshaiahu,0,0,0,0
1667980905334,ECE 247A,A00,103650,Jokerst; Jesse Vincent,0,0,0,0
1667980905758,ECE 247B,A00,103651,Wang; Joseph,0,0,0,0
1667980906182,ECE 250,A00,103652,Siegel; Paul H.,0,0,0,0
1667980906606,ECE 251A,A00,103654,Rao; Bhaskar D.,0,0,0,0
1667980907030,ECE 257B,A00,103655,Bharadia; Dinesh,0,0,0,0
1667980907458,ECE 258A,A00,103656,Milstein; Laurence B.,0,0,0,0
1667980907883,ECE 260B,A00,103658,Kang; Mingu,0,0,0,0
1667980908309,ECE 264A,A00,103659,Galton; Ian A,0,0,0,0
1667980908737,ECE 265A,A00,103661,Gudem; Prasad S.S.,0,0,0,0
1667980909161,ECE 265D,A00,103662,Gudem; Prasad S.S.,0,0,0,0
1667980909594,ECE 268,A00,103663,Koushanfar; Farinaz,0,0,0,0
1667980910021,ECE 269,A01,103665,Pal; Piya,0,0,0,0
1667980910444,ECE 271B,A00,103666,Vasconcelos; Manuela,0,0,0,0
1667980910869,ECE 276A,A00,103667,Atanasov; Nikolay A.,0,0,0,0
1667980911294,ECE 277,A00,103668,An; Cheolhong,0,0,0,0
1667980911720,ECE 279,A00,117947,Hall; Drew A.,0,0,0,0
1667980912578,ECE 283,A00,103670,Hsueh; Tzu-Chien,0,0,0,0
1667980913007,ECE 284,A00,103671,Turakhia; Yatish Girish,0,0,0,0
1667980913430,ECE 285,A00,103672,Zheng; Yang,0,0,0,0
1667980913430,ECE 285,B00,103673,Sworder; David D.,0,0,0,0
1667980913855,ECE 287,A00,103676,Javidi; Tara,0,0,0,0
1667980914279,MATH 200B,A00,098023,Salehi Golsefidy; Alireza,14,0,15,1
1667980914711,MATH 202B,A00,098024,Rhoades; Brendon Patrick,12,0,15,3
1667980915138,MATH 203B,A00,098025,Oprea; Dragos N.,12,0,15,3
1667980915567,MATH 204B,A00,098026,Sorensen; Claus M,14,0,15,1
1667980915990,MATH 208,A00,098027,Izadi; Elham,7,0,10,3
1667980916419,MATH 209,A00,098028,Pollack; Aaron,10,0,10,0
1667980916845,MATH 211A,A00,112919,Rogalski; Daniel,9,0,10,1
1667980917268,MATH 211B,A00,112920,Seward; Brandon M.,9,0,10,1
1667980917697,MATH 218,A00,098029,Li; Bo,10,0,10,0
1667980918120,MATH 220B,A00,098030,Novak; Jonathan I,13,0,15,2
1667980918547,MATH 221A,A00,098031,Ebenfelt; Peter F,13,0,15,2
1667980918978,MATH 231B,A00,098032,Zlatos; Andrej,12,0,15,3
1667980919408,MATH 240B,A00,098033,Ni; Lei,10,0,15,5
1667980919831,MATH 243,A00,098034,Jekel; David Andrew,10,0,10,0
1667980920258,MATH 245A,A00,098035,Nie; Jiawang,0,0,15,16
1667980920682,MATH 248,A00,098036,Bejenaru; Ioan,10,0,10,0
1667980921105,MATH 250B,A00,098037,Spolaor; Luca,14,0,15,1
1667980921535,MATH 258,A00,098038,Ni; Lei,10,0,10,0
1667980921963,MATH 264B,A00,098041,Rhoades; Brendon Patrick,12,0,15,3
1667980922386,MATH 268,A00,098042,Buss; Samuel R,10,0,10,0
1667980922809,MATH 269,A00,098043,Rhoades; Brendon Patrick,10,0,10,0
1667980923233,MATH 270B,A00,098044,Li; Bo,11,0,15,4
1667980923657,MATH 272B,A00,098045,Holst; Michael J,13,0,15,2
1667980924082,MATH 273A,A00,098046,Tian; Xiaochuan,12,0,15,3
1667980924521,MATH 275,A01,098048,Tian; Xiaochuan,6,0,10,4
1667980924954,MATH 278A,A00,098049,Holst; Michael J,8,0,10,2
1667980925378,MATH 278B,A00,098050,Cloninger; Alexander,10,0,10,0
1667980925805,MATH 278C,A00,098051,Nie; Jiawang,8,0,10,2
1667980926229,MATH 280B,A00,098052,Zheng; Tianyi,11,0,15,4
1667980926660,MATH 281B,A00,098053,Bradic; Jelena,4,0,15,11
1667980927084,MATH 282B,A00,098054,Arias-Castro; Ery,2,0,15,13
1667980927506,MATH 285,A00,098055,Fitzsimmons; Patrick J,0,0,15,17
1667980927933,MATH 287B,A00,098056,Arias-Castro; Ery,5,0,15,10
1667980928357,MATH 288,A00,098057,Agarwal; Pooja,9,0,10,1
1667980928357,MATH 288,B00,098058,Zhang; Danna,9,0,10,1
1667980928357,MATH 288,C00,098059,Williams; Ruth J,10,0,10,0
1667980928785,MATH 290B,A00,098060,Roberts; Justin Deritter,14,0,15,1
1667980929209,MATH 292,A00,098061,Belmont; Eva Kinoshita,10,0,10,0
1667980929636,MATH 295,A00,098062,Suk; Andrew Hoon,48,0,50,2
1667980930059,MATH 296,A00,098063,Novak; Jonathan I,20,0,20,0
1667980930487,MATH 297,001,098064,Gamst; Anthony Collins,9997,0,9999,2
1667981431520,COGS 205,A00,101395,Chiba; Andrea,19,0,20,1
1667981431944,COGS 210B,001,101404,Greene; Deanna Jacquelyn,9998,0,9999,1
1667981431944,COGS 210B,002,101417,Xia; Haijun,9999,0,9999,0
1667981431944,COGS 210B,003,101422,Nitz; Douglas A.,9999,0,9999,0
1667981431944,COGS 210B,004,101423,Hollan; James D.,9998,0,9999,1
1667981431944,COGS 210B,005,101424,Deak; Gedeon O.,9999,0,9999,0
1667981431944,COGS 210B,006,101425,Rossano; Federico,9999,0,9999,0
1667981432366,COGS 211B,A00,101427,Coulson; Seana M,9997,0,9999,2
1667981432810,COGS 220,A00,101428,Hollan; James D.,0,0,25,25
1667981433235,COGS 229,A00,101429,Dow; Steven P,18,0,25,7
1667981433665,COGS 230,A00,101430,Klemmer; Scott R,13,0,17,4
1667981434088,COGS 234,A00,101431,Xia; Haijun,7,0,25,18
1667981434512,COGS 260,A00,101432,Kiyonaga; Anastasia,20,0,25,5
1667981434512,COGS 260,B00,101433,Kirsh; David Joel,16,0,25,9
1667981434940,CSE 202,A00,102371,Impagliazzo; Russell,0,0,0,0
1667981435382,CSE 203B,A01,102373,Cheng; Chung Kuan,0,0,0,0
1667981435807,CSE 208,A00,102374,Micciancio; Daniele,0,0,0,0
1667981436233,CSE 209A,A00,112895,Impagliazzo; Russell,0,0,15,15
1667981436665,CSE 209B,A00,108005,Bellare; Mihir,0,0,0,0
1667981437093,CSE 210,A00,113163,Coblenz; Michael J,0,0,0,0
1667981437515,CSE 219,A00,106111,Dow; Steven P,0,0,20,20
1667981437938,CSE 221,A00,102376,Voelker; Geoffrey M.,0,0,0,0
1667981438361,CSE 224,A01,102378,Porter; George M,0,0,0,0
1667981438786,CSE 229A,A00,102379,Savage; Stefan,0,0,0,0
1667981439210,CSE 229C,A00,102380,Munyaka; Imani N. S.,0,0,0,0
1667981439640,CSE 232B,A00,102382,Deutsch; Alin Bernard,0,0,0,0
1667981440071,CSE 234,A01,112904,Kumar; Arun Kumar,0,0,0,0
1667981440497,CSE 237A,A00,102383,Rosing; Tajana Simunic,0,0,0,0
1667981440925,CSE 239A,A00,102384,Deutsch; Alin Bernard,0,0,0,0
1667981441353,CSE 239B,A00,102385,Polikarpova; Nadezhda,0,0,0,0
1667981441778,CSE 240A,A00,102386,Pannuto; Patrick William,0,0,0,0
1667981442202,CSE 240B,A00,102387,Zhao; Jishen,0,0,0,0
1667981442630,CSE 241A,A00,106406,Kang; Mingu,0,0,0,0
1667981443054,CSE 249B,A00,102388,Kahng; Andrew Byun,0,0,8,8
1667981443483,CSE 251B,A01,102392,Cottrell; Garrison W,0,0,0,0
1667981443483,CSE 251B,A02,102393,Cottrell; Garrison W,0,0,0,0
1667981443906,CSE 252B,A00,102394,Ochoa; Benjamin Lawrence,0,0,0,0
1667981444330,CSE 257,A01,102396,Gao; Sicun,0,0,0,0
1667981444761,CSE 272,A00,102397,Li; Tzumao,0,0,0,0
1667981445197,CSE 274,A00,111323,Chern; Albert Ren-Haur,0,0,0,0
1667981445619,CSE 282,A00,102398,Pevzner; Pavel Arkadjevich,0,0,0,0
1667981446051,CSE 284,A00,114175,Gymrek; Melissa Ann,0,0,0,0
1667981446482,CSE 290,A00,102399,Chandraker; Manmohan Krishna,0,0,0,0
1667981446482,CSE 290,B00,102400,Vaccaro; Kristen Marie,0,0,25,25
1667981446482,CSE 290,C00,102414,Pannuto; Patrick William,0,0,25,25
1667981446482,CSE 290,D00,102427,Pevzner; Pavel Arkadjevich,0,0,0,0
1667981446482,CSE 290,E00,102429,Zhao; Jishen,0,0,0,0
1667981446482,CSE 290,F00,102436,Tullsen; Dean Michael,0,0,0,0
1667981446482,CSE 290,G00,102440,Christensen; Henrik I,0,0,20,20
1667981446919,CSE 291,A00,102443,Su; Hao,0,0,0,0
1667981446919,CSE 291,B00,102448,Polikarpova; Nadezhda,0,0,0,0
1667981446919,CSE 291,C00,102453,Vaccaro; Kristen Marie,0,0,0,0
1667981446919,CSE 291,D00,111343,Savage; Stefan,0,0,0,0
1667981446919,CSE 291,E00,116474,Claffy; Kimberly Claire,0,0,0,0
1667981446919,CSE 291,F00,116479,Pasquale; Joseph,0,0,0,0
1667981447359,CSE 293,001,119111,Bafna; Vineet,9999,0,9999,0
1667981447359,CSE 293,002,119118,Bellare; Mihir,9999,0,9999,0
1667981447359,CSE 293,003,119122,Berg-Kirkpatrick; Taylor D,9999,0,9999,0
1667981447359,CSE 293,004,119135,Christensen; Henrik I,9999,0,9999,0
1667981447359,CSE 293,005,119142,Cottrell; Garrison W,9999,0,9999,0
1667981447359,CSE 293,006,119146,Deutsch; Alin Bernard,9999,0,9999,0
1667981447359,CSE 293,007,119159,Esmaeilzadeh; Hadi,9999,0,9999,0
1667981447359,CSE 293,008,119166,Freund; Yoav,9999,0,9999,0
1667981447359,CSE 293,009,119170,Griswold; William G.,9999,0,9999,0
1667981447359,CSE 293,010,119183,Gymrek; Melissa Ann,9999,0,9999,0
1667981447359,CSE 293,011,119190,Heninger; Nadia A,9999,0,9999,0
1667981447359,CSE 293,012,119230,Impagliazzo; Russell,9999,0,9999,0
1667981447359,CSE 293,013,119232,Jhala; Ranjit,9999,0,9999,0
1667981447359,CSE 293,014,119233,Kahng; Andrew Byun,9999,0,9999,0
1667981447359,CSE 293,015,119298,Kane; Daniel Mertz,9999,0,9999,0
1667981447359,CSE 293,016,119299,Kriegman; David J,9999,0,9999,0
1667981447359,CSE 293,017,119300,Kumar; Arun Kumar,9999,0,9999,0
1667981447359,CSE 293,018,119301,Lerner; Sorin,9999,0,9999,0
1667981447359,CSE 293,019,119302,Lovett; Shachar,9999,0,9999,0
1667981447359,CSE 293,020,119303,McAuley; Julian John,9999,0,9999,0
1667981447359,CSE 293,021,119304,Micciancio; Daniele,9999,0,9999,0
1667981447359,CSE 293,022,119367,Orailoglu; Alex,9999,0,9999,0
1667981447359,CSE 293,023,119382,Paturi; Ramamohan,9999,0,9999,0
1667981447359,CSE 293,024,119404,Polikarpova; Nadezhda,9999,0,9999,0
1667981447359,CSE 293,025,119406,Politz; Joseph Gibbs,9999,0,9999,0
1667981447359,CSE 293,026,119411,Porter; George M,9999,0,9999,0
1667981447359,CSE 293,027,119414,Porter; Leonard Emerson,9999,0,9999,0
1667981447359,CSE 293,028,119416,Ramamoorthi; Ravi,9999,0,9999,0
1667981447359,CSE 293,029,119417,Sahoo; Debashis,9999,0,9999,0
1667981447359,CSE 293,030,119420,Saul; Lawrence,9999,0,9999,0
1667981447359,CSE 293,031,119421,Savage; Stefan,9999,0,9999,0
1667981447359,CSE 293,032,119425,Schulze; Jurgen P.,9999,0,9999,0
1667981447359,CSE 293,033,119426,Snoeren; Alex C.,9999,0,9999,0
1667981447359,CSE 293,034,119428,Shang; Jingbo,9999,0,9999,0
1667981447359,CSE 293,035,119430,Stefan; Deian,9999,0,9999,0
1667981447359,CSE 293,036,119431,Su; Hao,9999,0,9999,0
1667981447359,CSE 293,037,119433,Swanson; Steven James,9999,0,9999,0
1667981447359,CSE 293,038,119435,Tullsen; Dean Michael,9999,0,9999,0
1667981447359,CSE 293,039,119483,Voelker; Geoffrey M.,9999,0,9999,0
1667981447359,CSE 293,040,119537,Zhao; Jishen,9999,0,9999,0
1667981447359,CSE 293,041,119538,Zhou; Yuan-Yuan,9999,0,9999,0
1667981447359,CSE 293,042,119539,Gao; Sicun,9999,0,9999,0
1667981447359,CSE 293,043,119540,Weibel; Nadir,9999,0,9999,0
1667981447359,CSE 293,044,119541,Gupta; Rajesh K.,9999,0,9999,0
1667981447359,CSE 293,045,126410,Vaccaro; Kristen Marie,9999,0,9999,0
1667981447359,CSE 293,046,126411,Klemke; Richard,9999,0,9999,0
1667981447783,CSE 294,A00,102459,Voelker; Geoffrey M.,0,0,0,0
1667981447783,CSE 294,B00,111322,Orailoglu; Alex,0,0,0,0
1667981448229,DSE 201,A00,096914,Deutsch; Alin Bernard,30,0,30,0
1667981448657,DSE 210,A00,096915,Dasgupta; Sanjoy,30,0,30,0
1667981449080,DSE 260A,A00,096916,Altintas De Callaf; Ilkay,30,0,30,0
1667981449506,ECE 200,001,103586,Antipa; Nicholas A,9999,0,9999,0
1667981449506,ECE 200,002,103587,Atanasov; Nikolay A.,9999,0,9999,0
1667981449506,ECE 200,003,103588,Bharadia; Dinesh,9999,0,9999,0
1667981449506,ECE 200,004,103589,Cheng; Chung Kuan,9999,0,9999,0
1667981449506,ECE 200,005,103590,Cosman; Pamela C.,9999,0,9999,0
1667981449506,ECE 200,006,103591,Dayeh; Shadi Ahmad,9999,0,9999,0
1667981449506,ECE 200,007,103592,Fainman; Yeshaiahu,9999,0,9999,0
1667981449506,ECE 200,008,103593,Ford; Joseph Earl,9999,0,9999,0
1667981449506,ECE 200,009,103594,Franceschetti; Massimo,9999,0,9999,0
1667981449506,ECE 200,010,103595,Fullerton; Eric E,9999,0,9999,0
1667981449506,ECE 200,011,103596,Galton; Ian A,9999,0,9999,0
1667981449506,ECE 200,012,103597,Gilja; Vikash,9999,0,9999,0
1667981449506,ECE 200,013,103598,Hall; Drew A.,9999,0,9999,0
1667981449506,ECE 200,014,103599,Hsueh; Tzu-Chien,9999,0,9999,0
1667981449506,ECE 200,015,103600,Javidi; Tara,9999,0,9999,0
1667981449506,ECE 200,016,103601,Kahng; Andrew Byun,9999,0,9999,0
1667981449506,ECE 200,017,103602,Kim; Young-Han,9999,0,9999,0
1667981449506,ECE 200,018,103603,Koushanfar; Farinaz,9999,0,9999,0
1667981449506,ECE 200,019,103604,Kuzum; Duygu,9999,0,9999,0
1667981449506,ECE 200,020,103605,Le; Hanh-Phuc,9999,0,9999,0
1667981449506,ECE 200,021,103606,Lin; Bill,9999,0,9999,0
1667981449506,ECE 200,022,103607,Liu; Zhaowei,9998,0,9999,1
1667981449506,ECE 200,023,103608,Lo; Yu-Hwa,9999,0,9999,0
1667981449506,ECE 200,024,103609,Lomakin; Vitaliy,9999,0,9999,0
1667981449506,ECE 200,025,103610,Mercier; Patrick Philip,9999,0,9999,0
1667981449506,ECE 200,026,103611,Meyer; Florian,9999,0,9999,0
1667981449506,ECE 200,027,103612,Milstein; Laurence B.,9999,0,9999,0
1667981449506,ECE 200,028,103613,Mir Arabbaygi; Siavash,9999,0,9999,0
1667981449506,ECE 200,029,103614,Mookherjea; Shayan,9999,0,9999,0
1667981449506,ECE 200,030,103615,Morris; Karcher William,9999,0,9999,0
1667981449506,ECE 200,031,103616,Ng; Tse Nga,9999,0,9999,0
1667981449506,ECE 200,032,103617,Nguyen; Truong Quang,9999,0,9999,0
1667981449506,ECE 200,033,103618,Nomura; Kenji,9999,0,9999,0
1667981449506,ECE 200,034,103619,Orlitsky; Alon,9999,0,9999,0
1667981449506,ECE 200,035,103620,Pal; Piya,9999,0,9999,0
1667981449506,ECE 200,036,103621,Papen; George C.,9999,0,9999,0
1667981449506,ECE 200,037,103622,Radic; Stojan,9999,0,9999,0
1667981449506,ECE 200,038,103623,Rao; Bhaskar D.,9999,0,9999,0
1667981449506,ECE 200,039,103624,Rao; Ramesh R,9999,0,9999,0
1667981449506,ECE 200,040,103625,Rebeiz; Gabriel,9999,0,9999,0
1667981449506,ECE 200,041,103626,Sanford; John R,9999,0,9999,0
1667981449506,ECE 200,042,103627,Siegel; Paul H.,9999,0,9999,0
1667981449506,ECE 200,043,103628,Sievenpiper; Daniel F.,9999,0,9999,0
1667981449506,ECE 200,044,103629,Sworder; David D.,9999,0,9999,0
1667981449506,ECE 200,045,103630,Taur; Yuan,9999,0,9999,0
1667981449506,ECE 200,046,103631,Touri; Behrouz,9999,0,9999,0
1667981449506,ECE 200,047,103632,Trivedi; Mohan M.,9999,0,9999,0
1667981449506,ECE 200,048,103633,Vasconcelos; Nuno,9999,0,9999,0
1667981449506,ECE 200,049,103634,Wang; Xiaolong,9999,0,9999,0
1667981449506,ECE 200,050,103635,Xie; Pengtao,9999,0,9999,0
1667981449506,ECE 200,051,103636,Yip; Michael,9999,0,9999,0
1667981449506,ECE 200,052,103637,Zeger; Kenneth A.,999,0,999,0
1667981449506,ECE 200,053,103638,Zhang; Xinyu,9999,0,9999,0
1667981449506,ECE 200,054,103639,Turakhia; Yatish Girish,9999,0,9999,0
1667981449506,ECE 200,055,103640,Kang; Mingu,9999,0,9999,0
1667981449506,ECE 200,056,103641,Shi; Yuanyuan,9999,0,9999,0
1667981449506,ECE 200,057,103642,Wang; Edward Jay,9999,0,9999,0
1667981449506,ECE 200,058,103643,Zheng; Yang,9999,0,9999,0
1667981449929,ECE 202,A00,103644,Kuzum; Duygu,0,0,0,0
1667981450354,ECE 212BN,A00,103646,Ng; Tse Nga,0,0,0,0
1667981450779,ECE 221,A00,111493,Staff,0,0,0,0
1667981451204,ECE 222B,A00,103647,Lomakin; Vitaliy,0,0,0,0
1667981451627,ECE 230B,A00,103648,Taur; Yuan,0,0,0,0
1667981452056,ECE 238B,A00,103649,Garay; Javier,0,0,0,0
1667981452486,ECE 240B,A00,112900,Fainman; Yeshaiahu,0,0,0,0
1667981452914,ECE 247A,A00,103650,Jokerst; Jesse Vincent,0,0,0,0
1667981453444,ECE 247B,A00,103651,Wang; Joseph,0,0,0,0
1667981453868,ECE 250,A00,103652,Siegel; Paul H.,0,0,0,0
1667981454297,ECE 251A,A00,103654,Rao; Bhaskar D.,0,0,0,0
1667981454725,ECE 257B,A00,103655,Bharadia; Dinesh,0,0,0,0
1667981455150,ECE 258A,A00,103656,Milstein; Laurence B.,0,0,0,0
1667981455574,ECE 260B,A00,103658,Kang; Mingu,0,0,0,0
1667981456004,ECE 264A,A00,103659,Galton; Ian A,0,0,0,0
1667981456441,ECE 265A,A00,103661,Gudem; Prasad S.S.,0,0,0,0
1667981456872,ECE 265D,A00,103662,Gudem; Prasad S.S.,0,0,0,0
1667981457303,ECE 268,A00,103663,Koushanfar; Farinaz,0,0,0,0
1667981457728,ECE 269,A01,103665,Pal; Piya,0,0,0,0
1667981458153,ECE 271B,A00,103666,Vasconcelos; Manuela,0,0,0,0
1667981458575,ECE 276A,A00,103667,Atanasov; Nikolay A.,0,0,0,0
1667981458999,ECE 277,A00,103668,An; Cheolhong,0,0,0,0
1667981459423,ECE 279,A00,117947,Hall; Drew A.,0,0,0,0
1667981460281,ECE 283,A00,103670,Hsueh; Tzu-Chien,0,0,0,0
1667981460704,ECE 284,A00,103671,Turakhia; Yatish Girish,0,0,0,0
1667981461128,ECE 285,A00,103672,Zheng; Yang,0,0,0,0
1667981461128,ECE 285,B00,103673,Sworder; David D.,0,0,0,0
1667981461551,ECE 287,A00,103676,Javidi; Tara,0,0,0,0
1667981461973,MATH 200B,A00,098023,Salehi Golsefidy; Alireza,14,0,15,1
1667981462405,MATH 202B,A00,098024,Rhoades; Brendon Patrick,12,0,15,3
1667981462828,MATH 203B,A00,098025,Oprea; Dragos N.,12,0,15,3
1667981463253,MATH 204B,A00,098026,Sorensen; Claus M,14,0,15,1
1667981463676,MATH 208,A00,098027,Izadi; Elham,7,0,10,3
1667981464108,MATH 209,A00,098028,Pollack; Aaron,10,0,10,0
1667981464544,MATH 211A,A00,112919,Rogalski; Daniel,9,0,10,1
1667981464974,MATH 211B,A00,112920,Seward; Brandon M.,9,0,10,1
1667981465401,MATH 218,A00,098029,Li; Bo,10,0,10,0
1667981465825,MATH 220B,A00,098030,Novak; Jonathan I,13,0,15,2
1667981466249,MATH 221A,A00,098031,Ebenfelt; Peter F,13,0,15,2
1667981466685,MATH 231B,A00,098032,Zlatos; Andrej,12,0,15,3
1667981467122,MATH 240B,A00,098033,Ni; Lei,10,0,15,5
1667981467545,MATH 243,A00,098034,Jekel; David Andrew,10,0,10,0
1667981467970,MATH 245A,A00,098035,Nie; Jiawang,0,0,15,16
1667981468412,MATH 248,A00,098036,Bejenaru; Ioan,10,0,10,0
1667981468838,MATH 250B,A00,098037,Spolaor; Luca,14,0,15,1
1667981469271,MATH 258,A00,098038,Ni; Lei,10,0,10,0
1667981469711,MATH 264B,A00,098041,Rhoades; Brendon Patrick,12,0,15,3
1667981470135,MATH 268,A00,098042,Buss; Samuel R,10,0,10,0
1667981470564,MATH 269,A00,098043,Rhoades; Brendon Patrick,10,0,10,0
1667981470994,MATH 270B,A00,098044,Li; Bo,11,0,15,4
1667981471418,MATH 272B,A00,098045,Holst; Michael J,13,0,15,2
1667981471845,MATH 273A,A00,098046,Tian; Xiaochuan,12,0,15,3
1667981472270,MATH 275,A01,098048,Tian; Xiaochuan,6,0,10,4
1667981472695,MATH 278A,A00,098049,Holst; Michael J,8,0,10,2
1667981473119,MATH 278B,A00,098050,Cloninger; Alexander,10,0,10,0
1667981473543,MATH 278C,A00,098051,Nie; Jiawang,8,0,10,2
1667981473967,MATH 280B,A00,098052,Zheng; Tianyi,11,0,15,4
1667981474391,MATH 281B,A00,098053,Bradic; Jelena,4,0,15,11
1667981474815,MATH 282B,A00,098054,Arias-Castro; Ery,2,0,15,13
1667981475238,MATH 285,A00,098055,Fitzsimmons; Patrick J,0,0,15,17
1667981475660,MATH 287B,A00,098056,Arias-Castro; Ery,5,0,15,10
1667981476092,MATH 288,A00,098057,Agarwal; Pooja,9,0,10,1
1667981476092,MATH 288,B00,098058,Zhang; Danna,9,0,10,1
1667981476092,MATH 288,C00,098059,Williams; Ruth J,10,0,10,0
1667981476516,MATH 290B,A00,098060,Roberts; Justin Deritter,14,0,15,1
1667981476942,MATH 292,A00,098061,Belmont; Eva Kinoshita,10,0,10,0
1667981477365,MATH 295,A00,098062,Suk; Andrew Hoon,48,0,50,2
1667981477789,MATH 296,A00,098063,Novak; Jonathan I,20,0,20,0
1667981478212,MATH 297,001,098064,Gamst; Anthony Collins,9997,0,9999,2
1667981979158,COGS 205,A00,101395,Chiba; Andrea,19,0,20,1
1667981979585,COGS 210B,001,101404,Greene; Deanna Jacquelyn,9998,0,9999,1
1667981979585,COGS 210B,002,101417,Xia; Haijun,9999,0,9999,0
1667981979585,COGS 210B,003,101422,Nitz; Douglas A.,9999,0,9999,0
1667981979585,COGS 210B,004,101423,Hollan; James D.,9998,0,9999,1
1667981979585,COGS 210B,005,101424,Deak; Gedeon O.,9999,0,9999,0
1667981979585,COGS 210B,006,101425,Rossano; Federico,9999,0,9999,0
1667981980010,COGS 211B,A00,101427,Coulson; Seana M,9997,0,9999,2
1667981980431,COGS 220,A00,101428,Hollan; James D.,0,0,25,25
1667981980855,COGS 229,A00,101429,Dow; Steven P,18,0,25,7
1667981981285,COGS 230,A00,101430,Klemmer; Scott R,13,0,17,4
1667981981711,COGS 234,A00,101431,Xia; Haijun,7,0,25,18
1667981982136,COGS 260,A00,101432,Kiyonaga; Anastasia,20,0,25,5
1667981982136,COGS 260,B00,101433,Kirsh; David Joel,16,0,25,9
1667981982562,CSE 202,A00,102371,Impagliazzo; Russell,0,0,0,0
1667981982990,CSE 203B,A01,102373,Cheng; Chung Kuan,0,0,0,0
1667981983412,CSE 208,A00,102374,Micciancio; Daniele,0,0,0,0
1667981983836,CSE 209A,A00,112895,Impagliazzo; Russell,0,0,15,15
1667981984261,CSE 209B,A00,108005,Bellare; Mihir,0,0,0,0
1667981984686,CSE 210,A00,113163,Coblenz; Michael J,0,0,0,0
1667981985112,CSE 219,A00,106111,Dow; Steven P,0,0,20,20
1667981985534,CSE 221,A00,102376,Voelker; Geoffrey M.,0,0,0,0
1667981985957,CSE 224,A01,102378,Porter; George M,0,0,0,0
1667981986379,CSE 229A,A00,102379,Savage; Stefan,0,0,0,0
1667981986813,CSE 229C,A00,102380,Munyaka; Imani N. S.,0,0,0,0
1667981987237,CSE 232B,A00,102382,Deutsch; Alin Bernard,0,0,0,0
1667981987665,CSE 234,A01,112904,Kumar; Arun Kumar,0,0,0,0
1667981988094,CSE 237A,A00,102383,Rosing; Tajana Simunic,0,0,0,0
1667981988517,CSE 239A,A00,102384,Deutsch; Alin Bernard,0,0,0,0
1667981988943,CSE 239B,A00,102385,Polikarpova; Nadezhda,0,0,0,0
1667981989368,CSE 240A,A00,102386,Pannuto; Patrick William,0,0,0,0
1667981989795,CSE 240B,A00,102387,Zhao; Jishen,0,0,0,0
1667981990219,CSE 241A,A00,106406,Kang; Mingu,0,0,0,0
1667981990644,CSE 249B,A00,102388,Kahng; Andrew Byun,0,0,8,8
1667981991072,CSE 251B,A01,102392,Cottrell; Garrison W,0,0,0,0
1667981991072,CSE 251B,A02,102393,Cottrell; Garrison W,0,0,0,0
1667981991495,CSE 252B,A00,102394,Ochoa; Benjamin Lawrence,0,0,0,0
1667981991921,CSE 257,A01,102396,Gao; Sicun,0,0,0,0
1667981992347,CSE 272,A00,102397,Li; Tzumao,0,0,0,0
1667981992771,CSE 274,A00,111323,Chern; Albert Ren-Haur,0,0,0,0
1667981993201,CSE 282,A00,102398,Pevzner; Pavel Arkadjevich,0,0,0,0
1667981993628,CSE 284,A00,114175,Gymrek; Melissa Ann,0,0,0,0
1667981994058,CSE 290,A00,102399,Chandraker; Manmohan Krishna,0,0,0,0
1667981994058,CSE 290,B00,102400,Vaccaro; Kristen Marie,0,0,25,25
1667981994058,CSE 290,C00,102414,Pannuto; Patrick William,0,0,25,25
1667981994058,CSE 290,D00,102427,Pevzner; Pavel Arkadjevich,0,0,0,0
1667981994058,CSE 290,E00,102429,Zhao; Jishen,0,0,0,0
1667981994058,CSE 290,F00,102436,Tullsen; Dean Michael,0,0,0,0
1667981994058,CSE 290,G00,102440,Christensen; Henrik I,0,0,20,20
1667981994482,CSE 291,A00,102443,Su; Hao,0,0,0,0
1667981994482,CSE 291,B00,102448,Polikarpova; Nadezhda,0,0,0,0
1667981994482,CSE 291,C00,102453,Vaccaro; Kristen Marie,0,0,0,0
1667981994482,CSE 291,D00,111343,Savage; Stefan,0,0,0,0
1667981994482,CSE 291,E00,116474,Claffy; Kimberly Claire,0,0,0,0
1667981994482,CSE 291,F00,116479,Pasquale; Joseph,0,0,0,0
1667981994910,CSE 293,001,119111,Bafna; Vineet,9999,0,9999,0
1667981994910,CSE 293,002,119118,Bellare; Mihir,9999,0,9999,0
1667981994910,CSE 293,003,119122,Berg-Kirkpatrick; Taylor D,9999,0,9999,0
1667981994910,CSE 293,004,119135,Christensen; Henrik I,9999,0,9999,0
1667981994910,CSE 293,005,119142,Cottrell; Garrison W,9999,0,9999,0
1667981994910,CSE 293,006,119146,Deutsch; Alin Bernard,9999,0,9999,0
1667981994910,CSE 293,007,119159,Esmaeilzadeh; Hadi,9999,0,9999,0
1667981994910,CSE 293,008,119166,Freund; Yoav,9999,0,9999,0
1667981994910,CSE 293,009,119170,Griswold; William G.,9999,0,9999,0
1667981994910,CSE 293,010,119183,Gymrek; Melissa Ann,9999,0,9999,0
1667981994910,CSE 293,011,119190,Heninger; Nadia A,9999,0,9999,0
1667981994910,CSE 293,012,119230,Impagliazzo; Russell,9999,0,9999,0
1667981994910,CSE 293,013,119232,Jhala; Ranjit,9999,0,9999,0
1667981994910,CSE 293,014,119233,Kahng; Andrew Byun,9999,0,9999,0
1667981994910,CSE 293,015,119298,Kane; Daniel Mertz,9999,0,9999,0
1667981994910,CSE 293,016,119299,Kriegman; David J,9999,0,9999,0
1667981994910,CSE 293,017,119300,Kumar; Arun Kumar,9999,0,9999,0
1667981994910,CSE 293,018,119301,Lerner; Sorin,9999,0,9999,0
1667981994910,CSE 293,019,119302,Lovett; Shachar,9999,0,9999,0
1667981994910,CSE 293,020,119303,McAuley; Julian John,9999,0,9999,0
1667981994910,CSE 293,021,119304,Micciancio; Daniele,9999,0,9999,0
1667981994910,CSE 293,022,119367,Orailoglu; Alex,9999,0,9999,0
1667981994910,CSE 293,023,119382,Paturi; Ramamohan,9999,0,9999,0
1667981994910,CSE 293,024,119404,Polikarpova; Nadezhda,9999,0,9999,0
1667981994910,CSE 293,025,119406,Politz; Joseph Gibbs,9999,0,9999,0
1667981994910,CSE 293,026,119411,Porter; George M,9999,0,9999,0
1667981994910,CSE 293,027,119414,Porter; Leonard Emerson,9999,0,9999,0
1667981994910,CSE 293,028,119416,Ramamoorthi; Ravi,9999,0,9999,0
1667981994910,CSE 293,029,119417,Sahoo; Debashis,9999,0,9999,0
1667981994910,CSE 293,030,119420,Saul; Lawrence,9999,0,9999,0
1667981994910,CSE 293,031,119421,Savage; Stefan,9999,0,9999,0
1667981994910,CSE 293,032,119425,Schulze; Jurgen P.,9999,0,9999,0
1667981994910,CSE 293,033,119426,Snoeren; Alex C.,9999,0,9999,0
1667981994910,CSE 293,034,119428,Shang; Jingbo,9999,0,9999,0
1667981994910,CSE 293,035,119430,Stefan; Deian,9999,0,9999,0
1667981994910,CSE 293,036,119431,Su; Hao,9999,0,9999,0
1667981994910,CSE 293,037,119433,Swanson; Steven James,9999,0,9999,0
1667981994910,CSE 293,038,119435,Tullsen; Dean Michael,9999,0,9999,0
1667981994910,CSE 293,039,119483,Voelker; Geoffrey M.,9999,0,9999,0
1667981994910,CSE 293,040,119537,Zhao; Jishen,9999,0,9999,0
1667981994910,CSE 293,041,119538,Zhou; Yuan-Yuan,9999,0,9999,0
1667981994910,CSE 293,042,119539,Gao; Sicun,9999,0,9999,0
1667981994910,CSE 293,043,119540,Weibel; Nadir,9999,0,9999,0
1667981994910,CSE 293,044,119541,Gupta; Rajesh K.,9999,0,9999,0
1667981994910,CSE 293,045,126410,Vaccaro; Kristen Marie,9999,0,9999,0
1667981994910,CSE 293,046,126411,Klemke; Richard,9999,0,9999,0
1667981995335,CSE 294,A00,102459,Voelker; Geoffrey M.,0,0,0,0
1667981995335,CSE 294,B00,111322,Orailoglu; Alex,0,0,0,0
1667981995762,DSE 201,A00,096914,Deutsch; Alin Bernard,30,0,30,0
1667981996187,DSE 210,A00,096915,Dasgupta; Sanjoy,30,0,30,0
1667981996612,DSE 260A,A00,096916,Altintas De Callaf; Ilkay,30,0,30,0
1667981997047,ECE 200,001,103586,Antipa; Nicholas A,9999,0,9999,0
1667981997047,ECE 200,002,103587,Atanasov; Nikolay A.,9999,0,9999,0
1667981997047,ECE 200,003,103588,Bharadia; Dinesh,9999,0,9999,0
1667981997047,ECE 200,004,103589,Cheng; Chung Kuan,9999,0,9999,0
1667981997047,ECE 200,005,103590,Cosman; Pamela C.,9999,0,9999,0
1667981997047,ECE 200,006,103591,Dayeh; Shadi Ahmad,9999,0,9999,0
1667981997047,ECE 200,007,103592,Fainman; Yeshaiahu,9999,0,9999,0
1667981997047,ECE 200,008,103593,Ford; Joseph Earl,9999,0,9999,0
1667981997047,ECE 200,009,103594,Franceschetti; Massimo,9999,0,9999,0
1667981997047,ECE 200,010,103595,Fullerton; Eric E,9999,0,9999,0
1667981997047,ECE 200,011,103596,Galton; Ian A,9999,0,9999,0
1667981997047,ECE 200,012,103597,Gilja; Vikash,9999,0,9999,0
1667981997047,ECE 200,013,103598,Hall; Drew A.,9999,0,9999,0
1667981997047,ECE 200,014,103599,Hsueh; Tzu-Chien,9999,0,9999,0
1667981997047,ECE 200,015,103600,Javidi; Tara,9999,0,9999,0
1667981997047,ECE 200,016,103601,Kahng; Andrew Byun,9999,0,9999,0
1667981997047,ECE 200,017,103602,Kim; Young-Han,9999,0,9999,0
1667981997047,ECE 200,018,103603,Koushanfar; Farinaz,9999,0,9999,0
1667981997047,ECE 200,019,103604,Kuzum; Duygu,9999,0,9999,0
1667981997047,ECE 200,020,103605,Le; Hanh-Phuc,9999,0,9999,0
1667981997047,ECE 200,021,103606,Lin; Bill,9999,0,9999,0
1667981997047,ECE 200,022,103607,Liu; Zhaowei,9998,0,9999,1
1667981997047,ECE 200,023,103608,Lo; Yu-Hwa,9999,0,9999,0
1667981997047,ECE 200,024,103609,Lomakin; Vitaliy,9999,0,9999,0
1667981997047,ECE 200,025,103610,Mercier; Patrick Philip,9999,0,9999,0
1667981997047,ECE 200,026,103611,Meyer; Florian,9999,0,9999,0
1667981997047,ECE 200,027,103612,Milstein; Laurence B.,9999,0,9999,0
1667981997047,ECE 200,028,103613,Mir Arabbaygi; Siavash,9999,0,9999,0
1667981997047,ECE 200,029,103614,Mookherjea; Shayan,9999,0,9999,0
1667981997047,ECE 200,030,103615,Morris; Karcher William,9999,0,9999,0
1667981997047,ECE 200,031,103616,Ng; Tse Nga,9999,0,9999,0
1667981997047,ECE 200,032,103617,Nguyen; Truong Quang,9999,0,9999,0
1667981997047,ECE 200,033,103618,Nomura; Kenji,9999,0,9999,0
1667981997047,ECE 200,034,103619,Orlitsky; Alon,9999,0,9999,0
1667981997047,ECE 200,035,103620,Pal; Piya,9999,0,9999,0
1667981997047,ECE 200,036,103621,Papen; George C.,9999,0,9999,0
1667981997047,ECE 200,037,103622,Radic; Stojan,9999,0,9999,0
1667981997047,ECE 200,038,103623,Rao; Bhaskar D.,9999,0,9999,0
1667981997047,ECE 200,039,103624,Rao; Ramesh R,9999,0,9999,0
1667981997047,ECE 200,040,103625,Rebeiz; Gabriel,9999,0,9999,0
1667981997047,ECE 200,041,103626,Sanford; John R,9999,0,9999,0
1667981997047,ECE 200,042,103627,Siegel; Paul H.,9999,0,9999,0
1667981997047,ECE 200,043,103628,Sievenpiper; Daniel F.,9999,0,9999,0
1667981997047,ECE 200,044,103629,Sworder; David D.,9999,0,9999,0
1667981997047,ECE 200,045,103630,Taur; Yuan,9999,0,9999,0
1667981997047,ECE 200,046,103631,Touri; Behrouz,9999,0,9999,0
1667981997047,ECE 200,047,103632,Trivedi; Mohan M.,9999,0,9999,0
1667981997047,ECE 200,048,103633,Vasconcelos; Nuno,9999,0,9999,0
1667981997047,ECE 200,049,103634,Wang; Xiaolong,9999,0,9999,0
1667981997047,ECE 200,050,103635,Xie; Pengtao,9999,0,9999,0
1667981997047,ECE 200,051,103636,Yip; Michael,9999,0,9999,0
1667981997047,ECE 200,052,103637,Zeger; Kenneth A.,999,0,999,0
1667981997047,ECE 200,053,103638,Zhang; Xinyu,9999,0,9999,0
1667981997047,ECE 200,054,103639,Turakhia; Yatish Girish,9999,0,9999,0
1667981997047,ECE 200,055,103640,Kang; Mingu,9999,0,9999,0
1667981997047,ECE 200,056,103641,Shi; Yuanyuan,9999,0,9999,0
1667981997047,ECE 200,057,103642,Wang; Edward Jay,9999,0,9999,0
1667981997047,ECE 200,058,103643,Zheng; Yang,9999,0,9999,0
1667981997475,ECE 202,A00,103644,Kuzum; Duygu,0,0,0,0
1667981997903,ECE 212BN,A00,103646,Ng; Tse Nga,0,0,0,0
1667981998329,ECE 221,A00,111493,Staff,0,0,0,0
1667981998754,ECE 222B,A00,103647,Lomakin; Vitaliy,0,0,0,0
1667981999180,ECE 230B,A00,103648,Taur; Yuan,0,0,0,0
1667981999609,ECE 238B,A00,103649,Garay; Javier,0,0,0,0
1667982000048,ECE 240B,A00,112900,Fainman; Yeshaiahu,0,0,0,0
1667982000473,ECE 247A,A00,103650,Jokerst; Jesse Vincent,0,0,0,0
1667982000909,ECE 247B,A00,103651,Wang; Joseph,0,0,0,0
1667982001334,ECE 250,A00,103652,Siegel; Paul H.,0,0,0,0
1667982001765,ECE 251A,A00,103654,Rao; Bhaskar D.,0,0,0,0
1667982002189,ECE 257B,A00,103655,Bharadia; Dinesh,0,0,0,0
1667982002613,ECE 258A,A00,103656,Milstein; Laurence B.,0,0,0,0
1667982003036,ECE 260B,A00,103658,Kang; Mingu,0,0,0,0
1667982003461,ECE 264A,A00,103659,Galton; Ian A,0,0,0,0
1667982003884,ECE 265A,A00,103661,Gudem; Prasad S.S.,0,0,0,0
1667982004311,ECE 265D,A00,103662,Gudem; Prasad S.S.,0,0,0,0
1667982004738,ECE 268,A00,103663,Koushanfar; Farinaz,0,0,0,0
1667982005166,ECE 269,A01,103665,Pal; Piya,0,0,0,0
1667982005605,ECE 271B,A00,103666,Vasconcelos; Manuela,0,0,0,0
1667982006033,ECE 276A,A00,103667,Atanasov; Nikolay A.,0,0,0,0
1667982006461,ECE 277,A00,103668,An; Cheolhong,0,0,0,0
1667982006898,ECE 279,A00,117947,Hall; Drew A.,0,0,0,0
1667982007749,ECE 283,A00,103670,Hsueh; Tzu-Chien,0,0,0,0
1667982008173,ECE 284,A00,103671,Turakhia; Yatish Girish,0,0,0,0
1667982008599,ECE 285,A00,103672,Zheng; Yang,0,0,0,0
1667982008599,ECE 285,B00,103673,Sworder; David D.,0,0,0,0
1667982009021,ECE 287,A00,103676,Javidi; Tara,0,0,0,0
1667982009452,MATH 200B,A00,098023,Salehi Golsefidy; Alireza,14,0,15,1
1667982009876,MATH 202B,A00,098024,Rhoades; Brendon Patrick,12,0,15,3
1667982010310,MATH 203B,A00,098025,Oprea; Dragos N.,12,0,15,3
1667982010735,MATH 204B,A00,098026,Sorensen; Claus M,14,0,15,1
1667982011162,MATH 208,A00,098027,Izadi; Elham,7,0,10,3
1667982011587,MATH 209,A00,098028,Pollack; Aaron,10,0,10,0
1667982012010,MATH 211A,A00,112919,Rogalski; Daniel,9,0,10,1
1667982012439,MATH 211B,A00,112920,Seward; Brandon M.,9,0,10,1
1667982012866,MATH 218,A00,098029,Li; Bo,10,0,10,0
1667982013291,MATH 220B,A00,098030,Novak; Jonathan I,13,0,15,2
1667982013715,MATH 221A,A00,098031,Ebenfelt; Peter F,13,0,15,2
1667982014140,MATH 231B,A00,098032,Zlatos; Andrej,12,0,15,3
1667982014582,MATH 240B,A00,098033,Ni; Lei,10,0,15,5
1667982015007,MATH 243,A00,098034,Jekel; David Andrew,10,0,10,0
1667982015434,MATH 245A,A00,098035,Nie; Jiawang,0,0,15,16
1667982015860,MATH 248,A00,098036,Bejenaru; Ioan,10,0,10,0
1667982016283,MATH 250B,A00,098037,Spolaor; Luca,14,0,15,1
1667982016712,MATH 258,A00,098038,Ni; Lei,10,0,10,0
1667982017140,MATH 264B,A00,098041,Rhoades; Brendon Patrick,11,0,15,4
1667982017638,MATH 268,A00,098042,Buss; Samuel R,10,0,10,0
1667982018061,MATH 269,A00,098043,Rhoades; Brendon Patrick,10,0,10,0
1667982018490,MATH 270B,A00,098044,Li; Bo,11,0,15,4
1667982018917,MATH 272B,A00,098045,Holst; Michael J,13,0,15,2
1667982019342,MATH 273A,A00,098046,Tian; Xiaochuan,12,0,15,3
1667982019769,MATH 275,A01,098048,Tian; Xiaochuan,6,0,10,4
1667982020197,MATH 278A,A00,098049,Holst; Michael J,8,0,10,2
1667982020623,MATH 278B,A00,098050,Cloninger; Alexander,10,0,10,0
1667982021048,MATH 278C,A00,098051,Nie; Jiawang,8,0,10,2
1667982021472,MATH 280B,A00,098052,Zheng; Tianyi,11,0,15,4
1667982021901,MATH 281B,A00,098053,Bradic; Jelena,4,0,15,11
1667982022336,MATH 282B,A00,098054,Arias-Castro; Ery,2,0,15,13
1667982022790,MATH 285,A00,098055,Fitzsimmons; Patrick J,0,0,15,17
1667982023219,MATH 287B,A00,098056,Arias-Castro; Ery,5,0,15,10
1667982023647,MATH 288,A00,098057,Agarwal; Pooja,9,0,10,1
1667982023647,MATH 288,B00,098058,Zhang; Danna,9,0,10,1
1667982023647,MATH 288,C00,098059,Williams; Ruth J,10,0,10,0
1667982024070,MATH 290B,A00,098060,Roberts; Justin Deritter,14,0,15,1
1667982024493,MATH 292,A00,098061,Belmont; Eva Kinoshita,10,0,10,0
1667982024921,MATH 295,A00,098062,Suk; Andrew Hoon,48,0,50,2
1667982025344,MATH 296,A00,098063,Novak; Jonathan I,20,0,20,0
1667982025768,MATH 297,001,098064,Gamst; Anthony Collins,9997,0,9999,2
1667982525454,COGS 205,A00,101395,Chiba; Andrea,19,0,20,1
1667982525880,COGS 210B,001,101404,Greene; Deanna Jacquelyn,9998,0,9999,1
1667982525880,COGS 210B,002,101417,Xia; Haijun,9999,0,9999,0
1667982525880,COGS 210B,003,101422,Nitz; Douglas A.,9999,0,9999,0
1667982525880,COGS 210B,004,101423,Hollan; James D.,9998,0,9999,1
1667982525880,COGS 210B,005,101424,Deak; Gedeon O.,9999,0,9999,0
1667982525880,COGS 210B,006,101425,Rossano; Federico,9999,0,9999,0
1667982526304,COGS 211B,A00,101427,Coulson; Seana M,9997,0,9999,2
1667982526727,COGS 220,A00,101428,Hollan; James D.,0,0,25,25
1667982527157,COGS 229,A00,101429,Dow; Steven P,18,0,25,7
1667982527579,COGS 230,A00,101430,Klemmer; Scott R,13,0,17,4
1667982528003,COGS 234,A00,101431,Xia; Haijun,7,0,25,18
1667982528430,COGS 260,A00,101432,Kiyonaga; Anastasia,20,0,25,5
1667982528430,COGS 260,B00,101433,Kirsh; David Joel,16,0,25,9
1667982528852,CSE 202,A00,102371,Impagliazzo; Russell,0,0,0,0
1667982529275,CSE 203B,A01,102373,Cheng; Chung Kuan,0,0,0,0
1667982529699,CSE 208,A00,102374,Micciancio; Daniele,0,0,0,0
1667982530124,CSE 209A,A00,112895,Impagliazzo; Russell,0,0,15,15
1667982530548,CSE 209B,A00,108005,Bellare; Mihir,0,0,0,0
1667982530972,CSE 210,A00,113163,Coblenz; Michael J,0,0,0,0
1667982531398,CSE 219,A00,106111,Dow; Steven P,0,0,20,20
1667982531820,CSE 221,A00,102376,Voelker; Geoffrey M.,0,0,0,0
1667982532257,CSE 224,A01,102378,Porter; George M,0,0,0,0
1667982532683,CSE 229A,A00,102379,Savage; Stefan,0,0,0,0
1667982533108,CSE 229C,A00,102380,Munyaka; Imani N. S.,0,0,0,0
1667982533535,CSE 232B,A00,102382,Deutsch; Alin Bernard,0,0,0,0
1667982533960,CSE 234,A01,112904,Kumar; Arun Kumar,0,0,0,0
1667982534383,CSE 237A,A00,102383,Rosing; Tajana Simunic,0,0,0,0
1667982534804,CSE 239A,A00,102384,Deutsch; Alin Bernard,0,0,0,0
1667982535232,CSE 239B,A00,102385,Polikarpova; Nadezhda,0,0,0,0
1667982535659,CSE 240A,A00,102386,Pannuto; Patrick William,0,0,0,0
1667982536084,CSE 240B,A00,102387,Zhao; Jishen,0,0,0,0
1667982536515,CSE 241A,A00,106406,Kang; Mingu,0,0,0,0
1667982536939,CSE 249B,A00,102388,Kahng; Andrew Byun,0,0,8,8
1667982537437,CSE 251B,A01,102392,Cottrell; Garrison W,0,0,0,0
1667982537437,CSE 251B,A02,102393,Cottrell; Garrison W,0,0,0,0
1667982537865,CSE 252B,A00,102394,Ochoa; Benjamin Lawrence,0,0,0,0
1667982538293,CSE 257,A01,102396,Gao; Sicun,0,0,0,0
1667982538719,CSE 272,A00,102397,Li; Tzumao,0,0,0,0
1667982539141,CSE 274,A00,111323,Chern; Albert Ren-Haur,0,0,0,0
1667982539563,CSE 282,A00,102398,Pevzner; Pavel Arkadjevich,0,0,0,0
1667982539987,CSE 284,A00,114175,Gymrek; Melissa Ann,0,0,0,0
1667982540414,CSE 290,A00,102399,Chandraker; Manmohan Krishna,0,0,0,0
1667982540414,CSE 290,B00,102400,Vaccaro; Kristen Marie,0,0,25,25
1667982540414,CSE 290,C00,102414,Pannuto; Patrick William,0,0,25,25
1667982540414,CSE 290,D00,102427,Pevzner; Pavel Arkadjevich,0,0,0,0
1667982540414,CSE 290,E00,102429,Zhao; Jishen,0,0,0,0
1667982540414,CSE 290,F00,102436,Tullsen; Dean Michael,0,0,0,0
1667982540414,CSE 290,G00,102440,Christensen; Henrik I,0,0,20,20
1667982540844,CSE 291,A00,102443,Su; Hao,0,0,0,0
1667982540844,CSE 291,B00,102448,Polikarpova; Nadezhda,0,0,0,0
1667982540844,CSE 291,C00,102453,Vaccaro; Kristen Marie,0,0,0,0
1667982540844,CSE 291,D00,111343,Savage; Stefan,0,0,0,0
1667982540844,CSE 291,E00,116474,Claffy; Kimberly Claire,0,0,0,0
1667982540844,CSE 291,F00,116479,Pasquale; Joseph,0,0,0,0
1667982541301,CSE 293,001,119111,Bafna; Vineet,9999,0,9999,0
1667982541301,CSE 293,002,119118,Bellare; Mihir,9999,0,9999,0
1667982541301,CSE 293,003,119122,Berg-Kirkpatrick; Taylor D,9999,0,9999,0
1667982541301,CSE 293,004,119135,Christensen; Henrik I,9999,0,9999,0
1667982541301,CSE 293,005,119142,Cottrell; Garrison W,9999,0,9999,0
1667982541301,CSE 293,006,119146,Deutsch; Alin Bernard,9999,0,9999,0
1667982541301,CSE 293,007,119159,Esmaeilzadeh; Hadi,9999,0,9999,0
1667982541301,CSE 293,008,119166,Freund; Yoav,9999,0,9999,0
1667982541301,CSE 293,009,119170,Griswold; William G.,9999,0,9999,0
1667982541301,CSE 293,010,119183,Gymrek; Melissa Ann,9999,0,9999,0
1667982541301,CSE 293,011,119190,Heninger; Nadia A,9999,0,9999,0
1667982541301,CSE 293,012,119230,Impagliazzo; Russell,9999,0,9999,0
1667982541301,CSE 293,013,119232,Jhala; Ranjit,9999,0,9999,0
1667982541301,CSE 293,014,119233,Kahng; Andrew Byun,9999,0,9999,0
1667982541301,CSE 293,015,119298,Kane; Daniel Mertz,9999,0,9999,0
1667982541301,CSE 293,016,119299,Kriegman; David J,9999,0,9999,0
1667982541301,CSE 293,017,119300,Kumar; Arun Kumar,9999,0,9999,0
1667982541301,CSE 293,018,119301,Lerner; Sorin,9999,0,9999,0
1667982541301,CSE 293,019,119302,Lovett; Shachar,9999,0,9999,0
1667982541301,CSE 293,020,119303,McAuley; Julian John,9999,0,9999,0
1667982541301,CSE 293,021,119304,Micciancio; Daniele,9999,0,9999,0
1667982541301,CSE 293,022,119367,Orailoglu; Alex,9999,0,9999,0
1667982541301,CSE 293,023,119382,Paturi; Ramamohan,9999,0,9999,0
1667982541301,CSE 293,024,119404,Polikarpova; Nadezhda,9999,0,9999,0
1667982541301,CSE 293,025,119406,Politz; Joseph Gibbs,9999,0,9999,0
1667982541301,CSE 293,026,119411,Porter; George M,9999,0,9999,0
1667982541301,CSE 293,027,119414,Porter; Leonard Emerson,9999,0,9999,0
1667982541301,CSE 293,028,119416,Ramamoorthi; Ravi,9999,0,9999,0
1667982541301,CSE 293,029,119417,Sahoo; Debashis,9999,0,9999,0
1667982541301,CSE 293,030,119420,Saul; Lawrence,9999,0,9999,0
1667982541301,CSE 293,031,119421,Savage; Stefan,9999,0,9999,0
1667982541301,CSE 293,032,119425,Schulze; Jurgen P.,9999,0,9999,0
1667982541301,CSE 293,033,119426,Snoeren; Alex C.,9999,0,9999,0
1667982541301,CSE 293,034,119428,Shang; Jingbo,9999,0,9999,0
1667982541301,CSE 293,035,119430,Stefan; Deian,9999,0,9999,0
1667982541301,CSE 293,036,119431,Su; Hao,9999,0,9999,0
1667982541301,CSE 293,037,119433,Swanson; Steven James,9999,0,9999,0
1667982541301,CSE 293,038,119435,Tullsen; Dean Michael,9999,0,9999,0
1667982541301,CSE 293,039,119483,Voelker; Geoffrey M.,9999,0,9999,0
1667982541301,CSE 293,040,119537,Zhao; Jishen,9999,0,9999,0
1667982541301,CSE 293,041,119538,Zhou; Yuan-Yuan,9999,0,9999,0
1667982541301,CSE 293,042,119539,Gao; Sicun,9999,0,9999,0
1667982541301,CSE 293,043,119540,Weibel; Nadir,9999,0,9999,0
1667982541301,CSE 293,044,119541,Gupta; Rajesh K.,9999,0,9999,0
1667982541301,CSE 293,045,126410,Vaccaro; Kristen Marie,9999,0,9999,0
1667982541301,CSE 293,046,126411,Klemke; Richard,9999,0,9999,0
1667982541723,CSE 294,A00,102459,Voelker; Geoffrey M.,0,0,0,0
1667982541723,CSE 294,B00,111322,Orailoglu; Alex,0,0,0,0
1667982542246,DSE 201,A00,096914,Deutsch; Alin Bernard,30,0,30,0
1667982542672,DSE 210,A00,096915,Dasgupta; Sanjoy,30,0,30,0
1667982543096,DSE 260A,A00,096916,Altintas De Callaf; Ilkay,30,0,30,0
1667982543534,ECE 200,001,103586,Antipa; Nicholas A,9999,0,9999,0
1667982543534,ECE 200,002,103587,Atanasov; Nikolay A.,9999,0,9999,0
1667982543534,ECE 200,003,103588,Bharadia; Dinesh,9999,0,9999,0
1667982543534,ECE 200,004,103589,Cheng; Chung Kuan,9999,0,9999,0
1667982543534,ECE 200,005,103590,Cosman; Pamela C.,9999,0,9999,0
1667982543534,ECE 200,006,103591,Dayeh; Shadi Ahmad,9999,0,9999,0
1667982543534,ECE 200,007,103592,Fainman; Yeshaiahu,9999,0,9999,0
1667982543534,ECE 200,008,103593,Ford; Joseph Earl,9999,0,9999,0
1667982543534,ECE 200,009,103594,Franceschetti; Massimo,9999,0,9999,0
1667982543534,ECE 200,010,103595,Fullerton; Eric E,9999,0,9999,0
1667982543534,ECE 200,011,103596,Galton; Ian A,9999,0,9999,0
1667982543534,ECE 200,012,103597,Gilja; Vikash,9999,0,9999,0
1667982543534,ECE 200,013,103598,Hall; Drew A.,9999,0,9999,0
1667982543534,ECE 200,014,103599,Hsueh; Tzu-Chien,9999,0,9999,0
1667982543534,ECE 200,015,103600,Javidi; Tara,9999,0,9999,0
1667982543534,ECE 200,016,103601,Kahng; Andrew Byun,9999,0,9999,0
1667982543534,ECE 200,017,103602,Kim; Young-Han,9999,0,9999,0
1667982543534,ECE 200,018,103603,Koushanfar; Farinaz,9999,0,9999,0
1667982543534,ECE 200,019,103604,Kuzum; Duygu,9999,0,9999,0
1667982543534,ECE 200,020,103605,Le; Hanh-Phuc,9999,0,9999,0
1667982543534,ECE 200,021,103606,Lin; Bill,9999,0,9999,0
1667982543534,ECE 200,022,103607,Liu; Zhaowei,9998,0,9999,1
1667982543534,ECE 200,023,103608,Lo; Yu-Hwa,9999,0,9999,0
1667982543534,ECE 200,024,103609,Lomakin; Vitaliy,9999,0,9999,0
1667982543534,ECE 200,025,103610,Mercier; Patrick Philip,9999,0,9999,0
1667982543534,ECE 200,026,103611,Meyer; Florian,9999,0,9999,0
1667982543534,ECE 200,027,103612,Milstein; Laurence B.,9999,0,9999,0
1667982543534,ECE 200,028,103613,Mir Arabbaygi; Siavash,9999,0,9999,0
1667982543534,ECE 200,029,103614,Mookherjea; Shayan,9999,0,9999,0
1667982543534,ECE 200,030,103615,Morris; Karcher William,9999,0,9999,0
1667982543534,ECE 200,031,103616,Ng; Tse Nga,9999,0,9999,0
1667982543534,ECE 200,032,103617,Nguyen; Truong Quang,9999,0,9999,0
1667982543534,ECE 200,033,103618,Nomura; Kenji,9999,0,9999,0
1667982543534,ECE 200,034,103619,Orlitsky; Alon,9999,0,9999,0
1667982543534,ECE 200,035,103620,Pal; Piya,9999,0,9999,0
1667982543534,ECE 200,036,103621,Papen; George C.,9999,0,9999,0
1667982543534,ECE 200,037,103622,Radic; Stojan,9999,0,9999,0
1667982543534,ECE 200,038,103623,Rao; Bhaskar D.,9999,0,9999,0
1667982543534,ECE 200,039,103624,Rao; Ramesh R,9999,0,9999,0
1667982543534,ECE 200,040,103625,Rebeiz; Gabriel,9999,0,9999,0
1667982543534,ECE 200,041,103626,Sanford; John R,9999,0,9999,0
1667982543534,ECE 200,042,103627,Siegel; Paul H.,9999,0,9999,0
1667982543534,ECE 200,043,103628,Sievenpiper; Daniel F.,9999,0,9999,0
1667982543534,ECE 200,044,103629,Sworder; David D.,9999,0,9999,0
1667982543534,ECE 200,045,103630,Taur; Yuan,9999,0,9999,0
1667982543534,ECE 200,046,103631,Touri; Behrouz,9999,0,9999,0
1667982543534,ECE 200,047,103632,Trivedi; Mohan M.,9999,0,9999,0
1667982543534,ECE 200,048,103633,Vasconcelos; Nuno,9999,0,9999,0
1667982543534,ECE 200,049,103634,Wang; Xiaolong,9999,0,9999,0
1667982543534,ECE 200,050,103635,Xie; Pengtao,9999,0,9999,0
1667982543534,ECE 200,051,103636,Yip; Michael,9999,0,9999,0
1667982543534,ECE 200,052,103637,Zeger; Kenneth A.,999,0,999,0
1667982543534,ECE 200,053,103638,Zhang; Xinyu,9999,0,9999,0
1667982543534,ECE 200,054,103639,Turakhia; Yatish Girish,9999,0,9999,0
1667982543534,ECE 200,055,103640,Kang; Mingu,9999,0,9999,0
1667982543534,ECE 200,056,103641,Shi; Yuanyuan,9999,0,9999,0
1667982543534,ECE 200,057,103642,Wang; Edward Jay,9999,0,9999,0
1667982543534,ECE 200,058,103643,Zheng; Yang,9999,0,9999,0
1667982543959,ECE 202,A00,103644,Kuzum; Duygu,0,0,0,0
1667982544383,ECE 212BN,A00,103646,Ng; Tse Nga,0,0,0,0
1667982544809,ECE 221,A00,111493,Staff,0,0,0,0
1667982545235,ECE 222B,A00,103647,Lomakin; Vitaliy,0,0,0,0
1667982545665,ECE 230B,A00,103648,Taur; Yuan,0,0,0,0
1667982546090,ECE 238B,A00,103649,Garay; Javier,0,0,0,0
1667982546520,ECE 240B,A00,112900,Fainman; Yeshaiahu,0,0,0,0
1667982546952,ECE 247A,A00,103650,Jokerst; Jesse Vincent,0,0,0,0
1667982547377,ECE 247B,A00,103651,Wang; Joseph,0,0,0,0
1667982547804,ECE 250,A00,103652,Siegel; Paul H.,0,0,0,0
1667982548230,ECE 251A,A00,103654,Rao; Bhaskar D.,0,0,0,0
1667982548654,ECE 257B,A00,103655,Bharadia; Dinesh,0,0,0,0
1667982549078,ECE 258A,A00,103656,Milstein; Laurence B.,0,0,0,0
1667982549501,ECE 260B,A00,103658,Kang; Mingu,0,0,0,0
1667982549926,ECE 264A,A00,103659,Galton; Ian A,0,0,0,0
1667982550357,ECE 265A,A00,103661,Gudem; Prasad S.S.,0,0,0,0
1667982550784,ECE 265D,A00,103662,Gudem; Prasad S.S.,0,0,0,0
1667982551211,ECE 268,A00,103663,Koushanfar; Farinaz,0,0,0,0
1667982551634,ECE 269,A01,103665,Pal; Piya,0,0,0,0
1667982552058,ECE 271B,A00,103666,Vasconcelos; Manuela,0,0,0,0
1667982552480,ECE 276A,A00,103667,Atanasov; Nikolay A.,0,0,0,0
1667982552908,ECE 277,A00,103668,An; Cheolhong,0,0,0,0
1667982553330,ECE 279,A00,117947,Hall; Drew A.,0,0,0,0
1667982554182,ECE 283,A00,103670,Hsueh; Tzu-Chien,0,0,0,0
1667982554606,ECE 284,A00,103671,Turakhia; Yatish Girish,0,0,0,0
1667982555030,ECE 285,A00,103672,Zheng; Yang,0,0,0,0
1667982555030,ECE 285,B00,103673,Sworder; David D.,0,0,0,0
1667982555458,ECE 287,A00,103676,Javidi; Tara,0,0,0,0
1667982555887,MATH 200B,A00,098023,Salehi Golsefidy; Alireza,14,0,15,1
1667982556310,MATH 202B,A00,098024,Rhoades; Brendon Patrick,12,0,15,3
1667982556735,MATH 203B,A00,098025,Oprea; Dragos N.,12,0,15,3
1667982557162,MATH 204B,A00,098026,Sorensen; Claus M,14,0,15,1
1667982557590,MATH 208,A00,098027,Izadi; Elham,7,0,10,3
1667982558013,MATH 209,A00,098028,Pollack; Aaron,10,0,10,0
1667982558446,MATH 211A,A00,112919,Rogalski; Daniel,9,0,10,1
1667982558871,MATH 211B,A00,112920,Seward; Brandon M.,9,0,10,1
1667982559293,MATH 218,A00,098029,Li; Bo,10,0,10,0
1667982559718,MATH 220B,A00,098030,Novak; Jonathan I,13,0,15,2
1667982560144,MATH 221A,A00,098031,Ebenfelt; Peter F,13,0,15,2
1667982560571,MATH 231B,A00,098032,Zlatos; Andrej,12,0,15,3
1667982560997,MATH 240B,A00,098033,Ni; Lei,10,0,15,5
1667982561420,MATH 243,A00,098034,Jekel; David Andrew,10,0,10,0
1667982561848,MATH 245A,A00,098035,Nie; Jiawang,0,0,15,16
1667982562273,MATH 248,A00,098036,Bejenaru; Ioan,10,0,10,0
1667982562698,MATH 250B,A00,098037,Spolaor; Luca,14,0,15,1
1667982563122,MATH 258,A00,098038,Ni; Lei,10,0,10,0
1667982563545,MATH 264B,A00,098041,Rhoades; Brendon Patrick,11,0,15,4
1667982563972,MATH 268,A00,098042,Buss; Samuel R,10,0,10,0
1667982564395,MATH 269,A00,098043,Rhoades; Brendon Patrick,10,0,10,0
1667982564821,MATH 270B,A00,098044,Li; Bo,11,0,15,4
1667982565245,MATH 272B,A00,098045,Holst; Michael J,13,0,15,2
1667982565669,MATH 273A,A00,098046,Tian; Xiaochuan,12,0,15,3
1667982566101,MATH 275,A01,098048,Tian; Xiaochuan,6,0,10,4
1667982566528,MATH 278A,A00,098049,Holst; Michael J,8,0,10,2
1667982566953,MATH 278B,A00,098050,Cloninger; Alexander,10,0,10,0
1667982567383,MATH 278C,A00,098051,Nie; Jiawang,8,0,10,2
1667982567806,MATH 280B,A00,098052,Zheng; Tianyi,11,0,15,4
1667982568235,MATH 281B,A00,098053,Bradic; Jelena,4,0,15,11
1667982568670,MATH 282B,A00,098054,Arias-Castro; Ery,2,0,15,13
1667982569097,MATH 285,A00,098055,Fitzsimmons; Patrick J,0,0,15,17
1667982569520,MATH 287B,A00,098056,Arias-Castro; Ery,5,0,15,10
1667982569943,MATH 288,A00,098057,Agarwal; Pooja,9,0,10,1
1667982569943,MATH 288,B00,098058,Zhang; Danna,9,0,10,1
1667982569943,MATH 288,C00,098059,Williams; Ruth J,10,0,10,0
1667982570374,MATH 290B,A00,098060,Roberts; Justin Deritter,14,0,15,1
1667982570799,MATH 292,A00,098061,Belmont; Eva Kinoshita,10,0,10,0
1667982571228,MATH 295,A00,098062,Suk; Andrew Hoon,48,0,50,2
1667982571662,MATH 296,A00,098063,Novak; Jonathan I,20,0,20,0
1667982572084,MATH 297,001,098064,Gamst; Anthony Collins,9997,0,9999,2
1667983084995,COGS 205,A00,101395,Chiba; Andrea,19,0,20,1
1667983085419,COGS 210B,001,101404,Greene; Deanna Jacquelyn,9998,0,9999,1
1667983085419,COGS 210B,002,101417,Xia; Haijun,9999,0,9999,0
1667983085419,COGS 210B,003,101422,Nitz; Douglas A.,9999,0,9999,0
1667983085419,COGS 210B,004,101423,Hollan; James D.,9998,0,9999,1
1667983085419,COGS 210B,005,101424,Deak; Gedeon O.,9999,0,9999,0
1667983085419,COGS 210B,006,101425,Rossano; Federico,9999,0,9999,0
1667983085843,COGS 211B,A00,101427,Coulson; Seana M,9997,0,9999,2
1667983086266,COGS 220,A00,101428,Hollan; James D.,0,0,25,25
1667983086690,COGS 229,A00,101429,Dow; Steven P,18,0,25,7
1667983087118,COGS 230,A00,101430,Klemmer; Scott R,13,0,17,4
1667983087543,COGS 234,A00,101431,Xia; Haijun,7,0,25,18
1667983087968,COGS 260,A00,101432,Kiyonaga; Anastasia,20,0,25,5
1667983087968,COGS 260,B00,101433,Kirsh; David Joel,16,0,25,9
1667983088392,CSE 202,A00,102371,Impagliazzo; Russell,0,0,0,0
1667983088827,CSE 203B,A01,102373,Cheng; Chung Kuan,0,0,0,0
1667983089255,CSE 208,A00,102374,Micciancio; Daniele,0,0,0,0
1667983089682,CSE 209A,A00,112895,Impagliazzo; Russell,0,0,15,15
1667983090106,CSE 209B,A00,108005,Bellare; Mihir,0,0,0,0
1667983090533,CSE 210,A00,113163,Coblenz; Michael J,0,0,0,0
1667983090960,CSE 219,A00,106111,Dow; Steven P,0,0,20,20
1667983091386,CSE 221,A00,102376,Voelker; Geoffrey M.,0,0,0,0
1667983091810,CSE 224,A01,102378,Porter; George M,0,0,0,0
1667983092236,CSE 229A,A00,102379,Savage; Stefan,0,0,0,0
1667983092666,CSE 229C,A00,102380,Munyaka; Imani N. S.,0,0,0,0
1667983093100,CSE 232B,A00,102382,Deutsch; Alin Bernard,0,0,0,0
1667983093530,CSE 234,A01,112904,Kumar; Arun Kumar,0,0,0,0
1667983093959,CSE 237A,A00,102383,Rosing; Tajana Simunic,0,0,0,0
1667983094382,CSE 239A,A00,102384,Deutsch; Alin Bernard,0,0,0,0
1667983094819,CSE 239B,A00,102385,Polikarpova; Nadezhda,0,0,0,0
1667983095244,CSE 240A,A00,102386,Pannuto; Patrick William,0,0,0,0
1667983095670,CSE 240B,A00,102387,Zhao; Jishen,0,0,0,0
1667983096099,CSE 241A,A00,106406,Kang; Mingu,0,0,0,0
1667983096535,CSE 249B,A00,102388,Kahng; Andrew Byun,0,0,8,8
1667983096959,CSE 251B,A01,102392,Cottrell; Garrison W,0,0,0,0
1667983096959,CSE 251B,A02,102393,Cottrell; Garrison W,0,0,0,0
1667983097396,CSE 252B,A00,102394,Ochoa; Benjamin Lawrence,0,0,0,0
1667983097821,CSE 257,A01,102396,Gao; Sicun,0,0,0,0
1667983098247,CSE 272,A00,102397,Li; Tzumao,0,0,0,0
1667983098671,CSE 274,A00,111323,Chern; Albert Ren-Haur,0,0,0,0
1667983099103,CSE 282,A00,102398,Pevzner; Pavel Arkadjevich,0,0,0,0
1667983099526,CSE 284,A00,114175,Gymrek; Melissa Ann,0,0,0,0
1667983099951,CSE 290,A00,102399,Chandraker; Manmohan Krishna,0,0,0,0
1667983099951,CSE 290,B00,102400,Vaccaro; Kristen Marie,0,0,25,25
1667983099951,CSE 290,C00,102414,Pannuto; Patrick William,0,0,25,25
1667983099951,CSE 290,D00,102427,Pevzner; Pavel Arkadjevich,0,0,0,0
1667983099951,CSE 290,E00,102429,Zhao; Jishen,0,0,0,0
1667983099951,CSE 290,F00,102436,Tullsen; Dean Michael,0,0,0,0
1667983099951,CSE 290,G00,102440,Christensen; Henrik I,0,0,20,20
1667983100375,CSE 291,A00,102443,Su; Hao,0,0,0,0
1667983100375,CSE 291,B00,102448,Polikarpova; Nadezhda,0,0,0,0
1667983100375,CSE 291,C00,102453,Vaccaro; Kristen Marie,0,0,0,0
1667983100375,CSE 291,D00,111343,Savage; Stefan,0,0,0,0
1667983100375,CSE 291,E00,116474,Claffy; Kimberly Claire,0,0,0,0
1667983100375,CSE 291,F00,116479,Pasquale; Joseph,0,0,0,0
1667983100817,CSE 293,001,119111,Bafna; Vineet,9999,0,9999,0
1667983100817,CSE 293,002,119118,Bellare; Mihir,9999,0,9999,0
1667983100817,CSE 293,003,119122,Berg-Kirkpatrick; Taylor D,9999,0,9999,0
1667983100817,CSE 293,004,119135,Christensen; Henrik I,9999,0,9999,0
1667983100817,CSE 293,005,119142,Cottrell; Garrison W,9999,0,9999,0
1667983100817,CSE 293,006,119146,Deutsch; Alin Bernard,9999,0,9999,0
1667983100817,CSE 293,007,119159,Esmaeilzadeh; Hadi,9999,0,9999,0
1667983100817,CSE 293,008,119166,Freund; Yoav,9999,0,9999,0
1667983100817,CSE 293,009,119170,Griswold; William G.,9999,0,9999,0
1667983100817,CSE 293,010,119183,Gymrek; Melissa Ann,9999,0,9999,0
1667983100817,CSE 293,011,119190,Heninger; Nadia A,9999,0,9999,0
1667983100817,CSE 293,012,119230,Impagliazzo; Russell,9999,0,9999,0
1667983100817,CSE 293,013,119232,Jhala; Ranjit,9999,0,9999,0
1667983100817,CSE 293,014,119233,Kahng; Andrew Byun,9999,0,9999,0
1667983100817,CSE 293,015,119298,Kane; Daniel Mertz,9999,0,9999,0
1667983100817,CSE 293,016,119299,Kriegman; David J,9999,0,9999,0
1667983100817,CSE 293,017,119300,Kumar; Arun Kumar,9999,0,9999,0
1667983100817,CSE 293,018,119301,Lerner; Sorin,9999,0,9999,0
1667983100817,CSE 293,019,119302,Lovett; Shachar,9999,0,9999,0
1667983100817,CSE 293,020,119303,McAuley; Julian John,9999,0,9999,0
1667983100817,CSE 293,021,119304,Micciancio; Daniele,9999,0,9999,0
1667983100817,CSE 293,022,119367,Orailoglu; Alex,9999,0,9999,0
1667983100817,CSE 293,023,119382,Paturi; Ramamohan,9999,0,9999,0
1667983100817,CSE 293,024,119404,Polikarpova; Nadezhda,9999,0,9999,0
1667983100817,CSE 293,025,119406,Politz; Joseph Gibbs,9999,0,9999,0
1667983100817,CSE 293,026,119411,Porter; George M,9999,0,9999,0
1667983100817,CSE 293,027,119414,Porter; Leonard Emerson,9999,0,9999,0
1667983100817,CSE 293,028,119416,Ramamoorthi; Ravi,9999,0,9999,0
1667983100817,CSE 293,029,119417,Sahoo; Debashis,9999,0,9999,0
1667983100817,CSE 293,030,119420,Saul; Lawrence,9999,0,9999,0
1667983100817,CSE 293,031,119421,Savage; Stefan,9999,0,9999,0
1667983100817,CSE 293,032,119425,Schulze; Jurgen P.,9999,0,9999,0
1667983100817,CSE 293,033,119426,Snoeren; Alex C.,9999,0,9999,0
1667983100817,CSE 293,034,119428,Shang; Jingbo,9999,0,9999,0
1667983100817,CSE 293,035,119430,Stefan; Deian,9999,0,9999,0
1667983100817,CSE 293,036,119431,Su; Hao,9999,0,9999,0
1667983100817,CSE 293,037,119433,Swanson; Steven James,9999,0,9999,0
1667983100817,CSE 293,038,119435,Tullsen; Dean Michael,9999,0,9999,0
1667983100817,CSE 293,039,119483,Voelker; Geoffrey M.,9999,0,9999,0
1667983100817,CSE 293,040,119537,Zhao; Jishen,9999,0,9999,0
1667983100817,CSE 293,041,119538,Zhou; Yuan-Yuan,9999,0,9999,0
1667983100817,CSE 293,042,119539,Gao; Sicun,9999,0,9999,0
1667983100817,CSE 293,043,119540,Weibel; Nadir,9999,0,9999,0
1667983100817,CSE 293,044,119541,Gupta; Rajesh K.,9999,0,9999,0
1667983100817,CSE 293,045,126410,Vaccaro; Kristen Marie,9999,0,9999,0
1667983100817,CSE 293,046,126411,Klemke; Richard,9999,0,9999,0
1667983101246,CSE 294,A00,102459,Voelker; Geoffrey M.,0,0,0,0
1667983101246,CSE 294,B00,111322,Orailoglu; Alex,0,0,0,0
1667983101673,DSE 201,A00,096914,Deutsch; Alin Bernard,30,0,30,0
1667983102096,DSE 210,A00,096915,Dasgupta; Sanjoy,30,0,30,0
1667983102521,DSE 260A,A00,096916,Altintas De Callaf; Ilkay,30,0,30,0
1667983102989,ECE 200,001,103586,Antipa; Nicholas A,9999,0,9999,0
1667983102989,ECE 200,002,103587,Atanasov; Nikolay A.,9999,0,9999,0
1667983102989,ECE 200,003,103588,Bharadia; Dinesh,9999,0,9999,0
1667983102989,ECE 200,004,103589,Cheng; Chung Kuan,9999,0,9999,0
1667983102989,ECE 200,005,103590,Cosman; Pamela C.,9999,0,9999,0
1667983102989,ECE 200,006,103591,Dayeh; Shadi Ahmad,9999,0,9999,0
1667983102989,ECE 200,007,103592,Fainman; Yeshaiahu,9999,0,9999,0
1667983102989,ECE 200,008,103593,Ford; Joseph Earl,9999,0,9999,0
1667983102989,ECE 200,009,103594,Franceschetti; Massimo,9999,0,9999,0
1667983102989,ECE 200,010,103595,Fullerton; Eric E,9999,0,9999,0
1667983102989,ECE 200,011,103596,Galton; Ian A,9999,0,9999,0
1667983102989,ECE 200,012,103597,Gilja; Vikash,9999,0,9999,0
1667983102989,ECE 200,013,103598,Hall; Drew A.,9999,0,9999,0
1667983102989,ECE 200,014,103599,Hsueh; Tzu-Chien,9999,0,9999,0
1667983102989,ECE 200,015,103600,Javidi; Tara,9999,0,9999,0
1667983102989,ECE 200,016,103601,Kahng; Andrew Byun,9999,0,9999,0
1667983102989,ECE 200,017,103602,Kim; Young-Han,9999,0,9999,0
1667983102989,ECE 200,018,103603,Koushanfar; Farinaz,9999,0,9999,0
1667983102989,ECE 200,019,103604,Kuzum; Duygu,9999,0,9999,0
1667983102989,ECE 200,020,103605,Le; Hanh-Phuc,9999,0,9999,0
1667983102989,ECE 200,021,103606,Lin; Bill,9999,0,9999,0
1667983102989,ECE 200,022,103607,Liu; Zhaowei,9998,0,9999,1
1667983102989,ECE 200,023,103608,Lo; Yu-Hwa,9999,0,9999,0
1667983102989,ECE 200,024,103609,Lomakin; Vitaliy,9999,0,9999,0
1667983102989,ECE 200,025,103610,Mercier; Patrick Philip,9999,0,9999,0
1667983102989,ECE 200,026,103611,Meyer; Florian,9999,0,9999,0
1667983102989,ECE 200,027,103612,Milstein; Laurence B.,9999,0,9999,0
1667983102989,ECE 200,028,103613,Mir Arabbaygi; Siavash,9999,0,9999,0
1667983102989,ECE 200,029,103614,Mookherjea; Shayan,9999,0,9999,0
1667983102989,ECE 200,030,103615,Morris; Karcher William,9999,0,9999,0
1667983102989,ECE 200,031,103616,Ng; Tse Nga,9999,0,9999,0
1667983102989,ECE 200,032,103617,Nguyen; Truong Quang,9999,0,9999,0
1667983102989,ECE 200,033,103618,Nomura; Kenji,9999,0,9999,0
1667983102989,ECE 200,034,103619,Orlitsky; Alon,9999,0,9999,0
1667983102989,ECE 200,035,103620,Pal; Piya,9999,0,9999,0
1667983102989,ECE 200,036,103621,Papen; George C.,9999,0,9999,0
1667983102989,ECE 200,037,103622,Radic; Stojan,9999,0,9999,0
1667983102989,ECE 200,038,103623,Rao; Bhaskar D.,9999,0,9999,0
1667983102989,ECE 200,039,103624,Rao; Ramesh R,9999,0,9999,0
1667983102989,ECE 200,040,103625,Rebeiz; Gabriel,9999,0,9999,0
1667983102989,ECE 200,041,103626,Sanford; John R,9999,0,9999,0
1667983102989,ECE 200,042,103627,Siegel; Paul H.,9999,0,9999,0
1667983102989,ECE 200,043,103628,Sievenpiper; Daniel F.,9999,0,9999,0
1667983102989,ECE 200,044,103629,Sworder; David D.,9999,0,9999,0
1667983102989,ECE 200,045,103630,Taur; Yuan,9999,0,9999,0
1667983102989,ECE 200,046,103631,Touri; Behrouz,9999,0,9999,0
1667983102989,ECE 200,047,103632,Trivedi; Mohan M.,9999,0,9999,0
1667983102989,ECE 200,048,103633,Vasconcelos; Nuno,9999,0,9999,0
1667983102989,ECE 200,049,103634,Wang; Xiaolong,9999,0,9999,0
1667983102989,ECE 200,050,103635,Xie; Pengtao,9999,0,9999,0
1667983102989,ECE 200,051,103636,Yip; Michael,9999,0,9999,0
1667983102989,ECE 200,052,103637,Zeger; Kenneth A.,999,0,999,0
1667983102989,ECE 200,053,103638,Zhang; Xinyu,9999,0,9999,0
1667983102989,ECE 200,054,103639,Turakhia; Yatish Girish,9999,0,9999,0
1667983102989,ECE 200,055,103640,Kang; Mingu,9999,0,9999,0
1667983102989,ECE 200,056,103641,Shi; Yuanyuan,9999,0,9999,0
1667983102989,ECE 200,057,103642,Wang; Edward Jay,9999,0,9999,0
1667983102989,ECE 200,058,103643,Zheng; Yang,9999,0,9999,0
1667983103413,ECE 202,A00,103644,Kuzum; Duygu,0,0,0,0
1667983103839,ECE 212BN,A00,103646,Ng; Tse Nga,0,0,0,0
1667983104264,ECE 221,A00,111493,Staff,0,0,0,0
1667983104689,ECE 222B,A00,103647,Lomakin; Vitaliy,0,0,0,0
1667983105112,ECE 230B,A00,103648,Taur; Yuan,0,0,0,0
1667983105541,ECE 238B,A00,103649,Garay; Javier,0,0,0,0
1667983105966,ECE 240B,A00,112900,Fainman; Yeshaiahu,0,0,0,0
1667983106390,ECE 247A,A00,103650,Jokerst; Jesse Vincent,0,0,0,0
1667983106818,ECE 247B,A00,103651,Wang; Joseph,0,0,0,0
1667983107246,ECE 250,A00,103652,Siegel; Paul H.,0,0,0,0
1667983107670,ECE 251A,A00,103654,Rao; Bhaskar D.,0,0,0,0
1667983108107,ECE 257B,A00,103655,Bharadia; Dinesh,0,0,0,0
1667983108556,ECE 258A,A00,103656,Milstein; Laurence B.,0,0,0,0
1667983108981,ECE 260B,A00,103658,Kang; Mingu,0,0,0,0
1667983109405,ECE 264A,A00,103659,Galton; Ian A,0,0,0,0
1667983109836,ECE 265A,A00,103661,Gudem; Prasad S.S.,0,0,0,0
1667983110262,ECE 265D,A00,103662,Gudem; Prasad S.S.,0,0,0,0
1667983110686,ECE 268,A00,103663,Koushanfar; Farinaz,0,0,0,0
1667983111114,ECE 269,A01,103665,Pal; Piya,0,0,0,0
1667983111542,ECE 271B,A00,103666,Vasconcelos; Manuela,0,0,0,0
1667983111968,ECE 276A,A00,103667,Atanasov; Nikolay A.,0,0,0,0
1667983112397,ECE 277,A00,103668,An; Cheolhong,0,0,0,0
1667983112821,ECE 279,A00,117947,Hall; Drew A.,0,0,0,0
1667983113758,ECE 283,A00,103670,Hsueh; Tzu-Chien,0,0,0,0
1667983114186,ECE 284,A00,103671,Turakhia; Yatish Girish,0,0,0,0
1667983114612,ECE 285,A00,103672,Zheng; Yang,0,0,0,0
1667983114612,ECE 285,B00,103673,Sworder; David D.,0,0,0,0
1667983115035,ECE 287,A00,103676,Javidi; Tara,0,0,0,0
1667983115460,MATH 200B,A00,098023,Salehi Golsefidy; Alireza,14,0,15,1
1667983115886,MATH 202B,A00,098024,Rhoades; Brendon Patrick,12,0,15,3
1667983116310,MATH 203B,A00,098025,Oprea; Dragos N.,12,0,15,3
1667983116735,MATH 204B,A00,098026,Sorensen; Claus M,14,0,15,1
1667983117158,MATH 208,A00,098027,Izadi; Elham,7,0,10,3
1667983117582,MATH 209,A00,098028,Pollack; Aaron,10,0,10,0
1667983118005,MATH 211A,A00,112919,Rogalski; Daniel,9,0,10,1
1667983118429,MATH 211B,A00,112920,Seward; Brandon M.,9,0,10,1
1667983118854,MATH 218,A00,098029,Li; Bo,10,0,10,0
1667983119278,MATH 220B,A00,098030,Novak; Jonathan I,13,0,15,2
1667983119705,MATH 221A,A00,098031,Ebenfelt; Peter F,13,0,15,2
1667983120132,MATH 231B,A00,098032,Zlatos; Andrej,12,0,15,3
1667983120559,MATH 240B,A00,098033,Ni; Lei,10,0,15,5
1667983120985,MATH 243,A00,098034,Jekel; David Andrew,10,0,10,0
1667983121412,MATH 245A,A00,098035,Nie; Jiawang,0,0,15,16
1667983121838,MATH 248,A00,098036,Bejenaru; Ioan,10,0,10,0
1667983122261,MATH 250B,A00,098037,Spolaor; Luca,14,0,15,1
1667983122683,MATH 258,A00,098038,Ni; Lei,10,0,10,0
1667983123110,MATH 264B,A00,098041,Rhoades; Brendon Patrick,11,0,15,4
1667983123536,MATH 268,A00,098042,Buss; Samuel R,10,0,10,0
1667983123960,MATH 269,A00,098043,Rhoades; Brendon Patrick,10,0,10,0
1667983124383,MATH 270B,A00,098044,Li; Bo,11,0,15,4
1667983124813,MATH 272B,A00,098045,Holst; Michael J,13,0,15,2
1667983125239,MATH 273A,A00,098046,Tian; Xiaochuan,12,0,15,3
1667983125662,MATH 275,A01,098048,Tian; Xiaochuan,6,0,10,4
1667983126087,MATH 278A,A00,098049,Holst; Michael J,8,0,10,2
1667983126514,MATH 278B,A00,098050,Cloninger; Alexander,10,0,10,0
1667983126940,MATH 278C,A00,098051,Nie; Jiawang,8,0,10,2
1667983127363,MATH 280B,A00,098052,Zheng; Tianyi,11,0,15,4
1667983127787,MATH 281B,A00,098053,Bradic; Jelena,4,0,15,11
1667983128212,MATH 282B,A00,098054,Arias-Castro; Ery,2,0,15,13
1667983128638,MATH 285,A00,098055,Fitzsimmons; Patrick J,0,0,15,17
1667983129074,MATH 287B,A00,098056,Arias-Castro; Ery,5,0,15,10
1667983129499,MATH 288,A00,098057,Agarwal; Pooja,9,0,10,1
1667983129499,MATH 288,B00,098058,Zhang; Danna,9,0,10,1
1667983129499,MATH 288,C00,098059,Williams; Ruth J,10,0,10,0
1667983129922,MATH 290B,A00,098060,Roberts; Justin Deritter,14,0,15,1
1667983130345,MATH 292,A00,098061,Belmont; Eva Kinoshita,10,0,10,0
1667983130769,MATH 295,A00,098062,Suk; Andrew Hoon,48,0,50,2
1667983131195,MATH 296,A00,098063,Novak; Jonathan I,20,0,20,0
1667983131617,MATH 297,001,098064,Gamst; Anthony Collins,9997,0,9999,2
1667983633082,COGS 205,A00,101395,Chiba; Andrea,19,0,20,1
1667983633513,COGS 210B,001,101404,Greene; Deanna Jacquelyn,9998,0,9999,1
1667983633513,COGS 210B,002,101417,Xia; Haijun,9999,0,9999,0
1667983633513,COGS 210B,003,101422,Nitz; Douglas A.,9999,0,9999,0
1667983633513,COGS 210B,004,101423,Hollan; James D.,9998,0,9999,1
1667983633513,COGS 210B,005,101424,Deak; Gedeon O.,9999,0,9999,0
1667983633513,COGS 210B,006,101425,Rossano; Federico,9999,0,9999,0
1667983633941,COGS 211B,A00,101427,Coulson; Seana M,9997,0,9999,2
1667983634366,COGS 220,A00,101428,Hollan; James D.,0,0,25,25
1667983634794,COGS 229,A00,101429,Dow; Steven P,18,0,25,7
1667983635314,COGS 230,A00,101430,Klemmer; Scott R,13,0,17,4
1667983635740,COGS 234,A00,101431,Xia; Haijun,7,0,25,18
1667983636169,COGS 260,A00,101432,Kiyonaga; Anastasia,20,0,25,5
1667983636169,COGS 260,B00,101433,Kirsh; David Joel,16,0,25,9
1667983636597,CSE 202,A00,102371,Impagliazzo; Russell,0,0,0,0
1667983637027,CSE 203B,A01,102373,Cheng; Chung Kuan,0,0,0,0
1667983637456,CSE 208,A00,102374,Micciancio; Daniele,0,0,0,0
1667983637886,CSE 209A,A00,112895,Impagliazzo; Russell,0,0,15,15
1667983638311,CSE 209B,A00,108005,Bellare; Mihir,0,0,0,0
1667983638736,CSE 210,A00,113163,Coblenz; Michael J,0,0,0,0
1667983639160,CSE 219,A00,106111,Dow; Steven P,1,0,20,19
1667983639588,CSE 221,A00,102376,Voelker; Geoffrey M.,0,0,0,0
1667983640013,CSE 224,A01,102378,Porter; George M,0,0,0,0
1667983640437,CSE 229A,A00,102379,Savage; Stefan,0,0,0,0
1667983640865,CSE 229C,A00,102380,Munyaka; Imani N. S.,0,0,0,0
1667983641298,CSE 232B,A00,102382,Deutsch; Alin Bernard,0,0,0,0
1667983641729,CSE 234,A01,112904,Kumar; Arun Kumar,0,0,0,0
1667983642154,CSE 237A,A00,102383,Rosing; Tajana Simunic,0,0,0,0
1667983642577,CSE 239A,A00,102384,Deutsch; Alin Bernard,0,0,0,0
1667983642999,CSE 239B,A00,102385,Polikarpova; Nadezhda,0,0,0,0
1667983643423,CSE 240A,A00,102386,Pannuto; Patrick William,0,0,0,0
1667983643851,CSE 240B,A00,102387,Zhao; Jishen,0,0,0,0
1667983644274,CSE 241A,A00,106406,Kang; Mingu,0,0,0,0
1667983644699,CSE 249B,A00,102388,Kahng; Andrew Byun,0,0,8,8
1667983645127,CSE 251B,A01,102392,Cottrell; Garrison W,0,0,0,0
1667983645127,CSE 251B,A02,102393,Cottrell; Garrison W,0,0,0,0
1667983645559,CSE 252B,A00,102394,Ochoa; Benjamin Lawrence,0,0,0,0
1667983645989,CSE 257,A01,102396,Gao; Sicun,0,0,0,0
1667983646417,CSE 272,A00,102397,Li; Tzumao,0,0,0,0
1667983646840,CSE 274,A00,111323,Chern; Albert Ren-Haur,0,0,0,0
1667983647263,CSE 282,A00,102398,Pevzner; Pavel Arkadjevich,0,0,0,0
1667983647699,CSE 284,A00,114175,Gymrek; Melissa Ann,0,0,0,0
1667983648128,CSE 290,A00,102399,Chandraker; Manmohan Krishna,0,0,0,0
1667983648128,CSE 290,B00,102400,Vaccaro; Kristen Marie,0,0,25,25
1667983648128,CSE 290,C00,102414,Pannuto; Patrick William,0,0,25,25
1667983648128,CSE 290,D00,102427,Pevzner; Pavel Arkadjevich,0,0,0,0
1667983648128,CSE 290,E00,102429,Zhao; Jishen,0,0,0,0
1667983648128,CSE 290,F00,102436,Tullsen; Dean Michael,0,0,0,0
1667983648128,CSE 290,G00,102440,Christensen; Henrik I,0,0,20,20
1667983648554,CSE 291,A00,102443,Su; Hao,0,0,0,0
1667983648554,CSE 291,B00,102448,Polikarpova; Nadezhda,0,0,0,0
1667983648554,CSE 291,C00,102453,Vaccaro; Kristen Marie,0,0,0,0
1667983648554,CSE 291,D00,111343,Savage; Stefan,0,0,0,0
1667983648554,CSE 291,E00,116474,Claffy; Kimberly Claire,0,0,0,0
1667983648554,CSE 291,F00,116479,Pasquale; Joseph,0,0,0,0
1667983649030,CSE 293,001,119111,Bafna; Vineet,9999,0,9999,0
1667983649030,CSE 293,002,119118,Bellare; Mihir,9999,0,9999,0
1667983649030,CSE 293,003,119122,Berg-Kirkpatrick; Taylor D,9999,0,9999,0
1667983649030,CSE 293,004,119135,Christensen; Henrik I,9999,0,9999,0
1667983649030,CSE 293,005,119142,Cottrell; Garrison W,9999,0,9999,0
1667983649030,CSE 293,006,119146,Deutsch; Alin Bernard,9999,0,9999,0
1667983649030,CSE 293,007,119159,Esmaeilzadeh; Hadi,9999,0,9999,0
1667983649030,CSE 293,008,119166,Freund; Yoav,9999,0,9999,0
1667983649030,CSE 293,009,119170,Griswold; William G.,9999,0,9999,0
1667983649030,CSE 293,010,119183,Gymrek; Melissa Ann,9999,0,9999,0
1667983649030,CSE 293,011,119190,Heninger; Nadia A,9999,0,9999,0
1667983649030,CSE 293,012,119230,Impagliazzo; Russell,9999,0,9999,0
1667983649030,CSE 293,013,119232,Jhala; Ranjit,9999,0,9999,0
1667983649030,CSE 293,014,119233,Kahng; Andrew Byun,9999,0,9999,0
1667983649030,CSE 293,015,119298,Kane; Daniel Mertz,9999,0,9999,0
1667983649030,CSE 293,016,119299,Kriegman; David J,9999,0,9999,0
1667983649030,CSE 293,017,119300,Kumar; Arun Kumar,9999,0,9999,0
1667983649030,CSE 293,018,119301,Lerner; Sorin,9999,0,9999,0
1667983649030,CSE 293,019,119302,Lovett; Shachar,9999,0,9999,0
1667983649030,CSE 293,020,119303,McAuley; Julian John,9999,0,9999,0
1667983649030,CSE 293,021,119304,Micciancio; Daniele,9999,0,9999,0
1667983649030,CSE 293,022,119367,Orailoglu; Alex,9999,0,9999,0
1667983649030,CSE 293,023,119382,Paturi; Ramamohan,9999,0,9999,0
1667983649030,CSE 293,024,119404,Polikarpova; Nadezhda,9999,0,9999,0
1667983649030,CSE 293,025,119406,Politz; Joseph Gibbs,9999,0,9999,0
1667983649030,CSE 293,026,119411,Porter; George M,9999,0,9999,0
1667983649030,CSE 293,027,119414,Porter; Leonard Emerson,9999,0,9999,0
1667983649030,CSE 293,028,119416,Ramamoorthi; Ravi,9999,0,9999,0
1667983649030,CSE 293,029,119417,Sahoo; Debashis,9999,0,9999,0
1667983649030,CSE 293,030,119420,Saul; Lawrence,9999,0,9999,0
1667983649030,CSE 293,031,119421,Savage; Stefan,9999,0,9999,0
1667983649030,CSE 293,032,119425,Schulze; Jurgen P.,9999,0,9999,0
1667983649030,CSE 293,033,119426,Snoeren; Alex C.,9999,0,9999,0
1667983649030,CSE 293,034,119428,Shang; Jingbo,9999,0,9999,0
1667983649030,CSE 293,035,119430,Stefan; Deian,9999,0,9999,0
1667983649030,CSE 293,036,119431,Su; Hao,9999,0,9999,0
1667983649030,CSE 293,037,119433,Swanson; Steven James,9999,0,9999,0
1667983649030,CSE 293,038,119435,Tullsen; Dean Michael,9999,0,9999,0
1667983649030,CSE 293,039,119483,Voelker; Geoffrey M.,9999,0,9999,0
1667983649030,CSE 293,040,119537,Zhao; Jishen,9999,0,9999,0
1667983649030,CSE 293,041,119538,Zhou; Yuan-Yuan,9999,0,9999,0
1667983649030,CSE 293,042,119539,Gao; Sicun,9999,0,9999,0
1667983649030,CSE 293,043,119540,Weibel; Nadir,9999,0,9999,0
1667983649030,CSE 293,044,119541,Gupta; Rajesh K.,9999,0,9999,0
1667983649030,CSE 293,045,126410,Vaccaro; Kristen Marie,9999,0,9999,0
1667983649030,CSE 293,046,126411,Klemke; Richard,9999,0,9999,0
1667983649456,CSE 294,A00,102459,Voelker; Geoffrey M.,0,0,0,0
1667983649456,CSE 294,B00,111322,Orailoglu; Alex,0,0,0,0
1667983649880,DSE 201,A00,096914,Deutsch; Alin Bernard,30,0,30,0
1667983650317,DSE 210,A00,096915,Dasgupta; Sanjoy,30,0,30,0
1667983650742,DSE 260A,A00,096916,Altintas De Callaf; Ilkay,30,0,30,0
1667983651230,ECE 200,001,103586,Antipa; Nicholas A,9999,0,9999,0
1667983651230,ECE 200,002,103587,Atanasov; Nikolay A.,9999,0,9999,0
1667983651230,ECE 200,003,103588,Bharadia; Dinesh,9999,0,9999,0
1667983651230,ECE 200,004,103589,Cheng; Chung Kuan,9999,0,9999,0
1667983651230,ECE 200,005,103590,Cosman; Pamela C.,9999,0,9999,0
1667983651230,ECE 200,006,103591,Dayeh; Shadi Ahmad,9999,0,9999,0
1667983651230,ECE 200,007,103592,Fainman; Yeshaiahu,9999,0,9999,0
1667983651230,ECE 200,008,103593,Ford; Joseph Earl,9999,0,9999,0
1667983651230,ECE 200,009,103594,Franceschetti; Massimo,9999,0,9999,0
1667983651230,ECE 200,010,103595,Fullerton; Eric E,9999,0,9999,0
1667983651230,ECE 200,011,103596,Galton; Ian A,9999,0,9999,0
1667983651230,ECE 200,012,103597,Gilja; Vikash,9999,0,9999,0
1667983651230,ECE 200,013,103598,Hall; Drew A.,9999,0,9999,0
1667983651230,ECE 200,014,103599,Hsueh; Tzu-Chien,9999,0,9999,0
1667983651230,ECE 200,015,103600,Javidi; Tara,9999,0,9999,0
1667983651230,ECE 200,016,103601,Kahng; Andrew Byun,9999,0,9999,0
1667983651230,ECE 200,017,103602,Kim; Young-Han,9999,0,9999,0
1667983651230,ECE 200,018,103603,Koushanfar; Farinaz,9999,0,9999,0
1667983651230,ECE 200,019,103604,Kuzum; Duygu,9999,0,9999,0
1667983651230,ECE 200,020,103605,Le; Hanh-Phuc,9999,0,9999,0
1667983651230,ECE 200,021,103606,Lin; Bill,9999,0,9999,0
1667983651230,ECE 200,022,103607,Liu; Zhaowei,9998,0,9999,1
1667983651230,ECE 200,023,103608,Lo; Yu-Hwa,9999,0,9999,0
1667983651230,ECE 200,024,103609,Lomakin; Vitaliy,9999,0,9999,0
1667983651230,ECE 200,025,103610,Mercier; Patrick Philip,9999,0,9999,0
1667983651230,ECE 200,026,103611,Meyer; Florian,9999,0,9999,0
1667983651230,ECE 200,027,103612,Milstein; Laurence B.,9999,0,9999,0
1667983651230,ECE 200,028,103613,Mir Arabbaygi; Siavash,9999,0,9999,0
1667983651230,ECE 200,029,103614,Mookherjea; Shayan,9999,0,9999,0
1667983651230,ECE 200,030,103615,Morris; Karcher William,9999,0,9999,0
1667983651230,ECE 200,031,103616,Ng; Tse Nga,9999,0,9999,0
1667983651230,ECE 200,032,103617,Nguyen; Truong Quang,9999,0,9999,0
1667983651230,ECE 200,033,103618,Nomura; Kenji,9999,0,9999,0
1667983651230,ECE 200,034,103619,Orlitsky; Alon,9999,0,9999,0
1667983651230,ECE 200,035,103620,Pal; Piya,9999,0,9999,0
1667983651230,ECE 200,036,103621,Papen; George C.,9999,0,9999,0
1667983651230,ECE 200,037,103622,Radic; Stojan,9999,0,9999,0
1667983651230,ECE 200,038,103623,Rao; Bhaskar D.,9999,0,9999,0
1667983651230,ECE 200,039,103624,Rao; Ramesh R,9999,0,9999,0
1667983651230,ECE 200,040,103625,Rebeiz; Gabriel,9999,0,9999,0
1667983651230,ECE 200,041,103626,Sanford; John R,9999,0,9999,0
1667983651230,ECE 200,042,103627,Siegel; Paul H.,9999,0,9999,0
1667983651230,ECE 200,043,103628,Sievenpiper; Daniel F.,9999,0,9999,0
1667983651230,ECE 200,044,103629,Sworder; David D.,9999,0,9999,0
1667983651230,ECE 200,045,103630,Taur; Yuan,9999,0,9999,0
1667983651230,ECE 200,046,103631,Touri; Behrouz,9999,0,9999,0
1667983651230,ECE 200,047,103632,Trivedi; Mohan M.,9999,0,9999,0
1667983651230,ECE 200,048,103633,Vasconcelos; Nuno,9999,0,9999,0
1667983651230,ECE 200,049,103634,Wang; Xiaolong,9999,0,9999,0
1667983651230,ECE 200,050,103635,Xie; Pengtao,9999,0,9999,0
1667983651230,ECE 200,051,103636,Yip; Michael,9999,0,9999,0
1667983651230,ECE 200,052,103637,Zeger; Kenneth A.,999,0,999,0
1667983651230,ECE 200,053,103638,Zhang; Xinyu,9999,0,9999,0
1667983651230,ECE 200,054,103639,Turakhia; Yatish Girish,9999,0,9999,0
1667983651230,ECE 200,055,103640,Kang; Mingu,9999,0,9999,0
1667983651230,ECE 200,056,103641,Shi; Yuanyuan,9999,0,9999,0
1667983651230,ECE 200,057,103642,Wang; Edward Jay,9999,0,9999,0
1667983651230,ECE 200,058,103643,Zheng; Yang,9999,0,9999,0
1667983651656,ECE 202,A00,103644,Kuzum; Duygu,0,0,0,0
1667983652082,ECE 212BN,A00,103646,Ng; Tse Nga,0,0,0,0
1667983652518,ECE 221,A00,111493,Staff,0,0,0,0
1667983652945,ECE 222B,A00,103647,Lomakin; Vitaliy,0,0,0,0
1667983653373,ECE 230B,A00,103648,Taur; Yuan,0,0,0,0
1667983653797,ECE 238B,A00,103649,Garay; Javier,0,0,0,0
1667983654221,ECE 240B,A00,112900,Fainman; Yeshaiahu,0,0,0,0
1667983654649,ECE 247A,A00,103650,Jokerst; Jesse Vincent,0,0,0,0
1667983655075,ECE 247B,A00,103651,Wang; Joseph,0,0,0,0
1667983655499,ECE 250,A00,103652,Siegel; Paul H.,0,0,0,0
1667983655929,ECE 251A,A00,103654,Rao; Bhaskar D.,0,0,0,0
1667983656352,ECE 257B,A00,103655,Bharadia; Dinesh,0,0,0,0
1667983656780,ECE 258A,A00,103656,Milstein; Laurence B.,0,0,0,0
1667983657204,ECE 260B,A00,103658,Kang; Mingu,0,0,0,0
1667983657627,ECE 264A,A00,103659,Galton; Ian A,0,0,0,0
1667983658055,ECE 265A,A00,103661,Gudem; Prasad S.S.,0,0,0,0
1667983658477,ECE 265D,A00,103662,Gudem; Prasad S.S.,0,0,0,0
1667983658901,ECE 268,A00,103663,Koushanfar; Farinaz,0,0,0,0
1667983659324,ECE 269,A01,103665,Pal; Piya,0,0,0,0
1667983659747,ECE 271B,A00,103666,Vasconcelos; Manuela,0,0,0,0
1667983660174,ECE 276A,A00,103667,Atanasov; Nikolay A.,0,0,0,0
1667983660601,ECE 277,A00,103668,An; Cheolhong,0,0,0,0
1667983661028,ECE 279,A00,117947,Hall; Drew A.,0,0,0,0
1667983661878,ECE 283,A00,103670,Hsueh; Tzu-Chien,0,0,0,0
1667983662314,ECE 284,A00,103671,Turakhia; Yatish Girish,0,0,0,0
1667983662755,ECE 285,A00,103672,Zheng; Yang,0,0,0,0
1667983662755,ECE 285,B00,103673,Sworder; David D.,0,0,0,0
1667983663179,ECE 287,A00,103676,Javidi; Tara,0,0,0,0
1667983663609,MATH 200B,A00,098023,Salehi Golsefidy; Alireza,14,0,15,1
1667983664032,MATH 202B,A00,098024,Rhoades; Brendon Patrick,12,0,15,3
1667983664460,MATH 203B,A00,098025,Oprea; Dragos N.,12,0,15,3
1667983664883,MATH 204B,A00,098026,Sorensen; Claus M,14,0,15,1
1667983665310,MATH 208,A00,098027,Izadi; Elham,7,0,10,3
1667983665738,MATH 209,A00,098028,Pollack; Aaron,10,0,10,0
1667983666162,MATH 211A,A00,112919,Rogalski; Daniel,9,0,10,1
1667983666590,MATH 211B,A00,112920,Seward; Brandon M.,9,0,10,1
1667983667014,MATH 218,A00,098029,Li; Bo,10,0,10,0
1667983667438,MATH 220B,A00,098030,Novak; Jonathan I,13,0,15,2
1667983667864,MATH 221A,A00,098031,Ebenfelt; Peter F,13,0,15,2
1667983668291,MATH 231B,A00,098032,Zlatos; Andrej,12,0,15,3
1667983668720,MATH 240B,A00,098033,Ni; Lei,10,0,15,5
1667983669143,MATH 243,A00,098034,Jekel; David Andrew,10,0,10,0
1667983669567,MATH 245A,A00,098035,Nie; Jiawang,0,0,15,16
1667983669990,MATH 248,A00,098036,Bejenaru; Ioan,10,0,10,0
1667983670426,MATH 250B,A00,098037,Spolaor; Luca,14,0,15,1
1667983670852,MATH 258,A00,098038,Ni; Lei,10,0,10,0
1667983671277,MATH 264B,A00,098041,Rhoades; Brendon Patrick,11,0,15,4
1667983671708,MATH 268,A00,098042,Buss; Samuel R,10,0,10,0
1667983672138,MATH 269,A00,098043,Rhoades; Brendon Patrick,10,0,10,0
1667983672566,MATH 270B,A00,098044,Li; Bo,11,0,15,4
1667983672991,MATH 272B,A00,098045,Holst; Michael J,13,0,15,2
1667983673415,MATH 273A,A00,098046,Tian; Xiaochuan,12,0,15,3
1667983673842,MATH 275,A01,098048,Tian; Xiaochuan,6,0,10,4
1667983674267,MATH 278A,A00,098049,Holst; Michael J,8,0,10,2
1667983674700,MATH 278B,A00,098050,Cloninger; Alexander,10,0,10,0
1667983675135,MATH 278C,A00,098051,Nie; Jiawang,8,0,10,2
1667983675572,MATH 280B,A00,098052,Zheng; Tianyi,11,0,15,4
1667983675998,MATH 281B,A00,098053,Bradic; Jelena,4,0,15,11
1667983676424,MATH 282B,A00,098054,Arias-Castro; Ery,2,0,15,13
1667983676852,MATH 285,A00,098055,Fitzsimmons; Patrick J,0,0,15,17
1667983677276,MATH 287B,A00,098056,Arias-Castro; Ery,5,0,15,10
1667983677705,MATH 288,A00,098057,Agarwal; Pooja,9,0,10,1
1667983677705,MATH 288,B00,098058,Zhang; Danna,9,0,10,1
1667983677705,MATH 288,C00,098059,Williams; Ruth J,10,0,10,0
1667983678134,MATH 290B,A00,098060,Roberts; Justin Deritter,14,0,15,1
1667983678640,MATH 292,A00,098061,Belmont; Eva Kinoshita,10,0,10,0
1667983679066,MATH 295,A00,098062,Suk; Andrew Hoon,48,0,50,2
1667983679499,MATH 296,A00,098063,Novak; Jonathan I,20,0,20,0
1667983679934,MATH 297,001,098064,Gamst; Anthony Collins,9997,0,9999,2
1667984180710,COGS 205,A00,101395,Chiba; Andrea,19,0,20,1
1667984181136,COGS 210B,001,101404,Greene; Deanna Jacquelyn,9998,0,9999,1
1667984181136,COGS 210B,002,101417,Xia; Haijun,9999,0,9999,0
1667984181136,COGS 210B,003,101422,Nitz; Douglas A.,9999,0,9999,0
1667984181136,COGS 210B,004,101423,Hollan; James D.,9998,0,9999,1
1667984181136,COGS 210B,005,101424,Deak; Gedeon O.,9999,0,9999,0
1667984181136,COGS 210B,006,101425,Rossano; Federico,9999,0,9999,0
1667984181561,COGS 211B,A00,101427,Coulson; Seana M,9997,0,9999,2
1667984181992,COGS 220,A00,101428,Hollan; James D.,0,0,25,25
1667984182420,COGS 229,A00,101429,Dow; Steven P,18,0,25,7
1667984182844,COGS 230,A00,101430,Klemmer; Scott R,13,0,17,4
1667984183269,COGS 234,A00,101431,Xia; Haijun,7,0,25,18
1667984183697,COGS 260,A00,101432,Kiyonaga; Anastasia,20,0,25,5
1667984183697,COGS 260,B00,101433,Kirsh; David Joel,16,0,25,9
1667984184122,CSE 202,A00,102371,Impagliazzo; Russell,0,0,0,0
1667984184546,CSE 203B,A01,102373,Cheng; Chung Kuan,0,0,0,0
1667984184973,CSE 208,A00,102374,Micciancio; Daniele,0,0,0,0
1667984185398,CSE 209A,A00,112895,Impagliazzo; Russell,0,0,15,15
1667984185827,CSE 209B,A00,108005,Bellare; Mihir,0,0,0,0
1667984186250,CSE 210,A00,113163,Coblenz; Michael J,0,0,0,0
1667984186674,CSE 219,A00,106111,Dow; Steven P,1,0,20,19
1667984187098,CSE 221,A00,102376,Voelker; Geoffrey M.,0,0,0,0
1667984187522,CSE 224,A01,102378,Porter; George M,0,0,0,0
1667984187949,CSE 229A,A00,102379,Savage; Stefan,0,0,0,0
1667984188373,CSE 229C,A00,102380,Munyaka; Imani N. S.,0,0,0,0
1667984188798,CSE 232B,A00,102382,Deutsch; Alin Bernard,0,0,0,0
1667984189225,CSE 234,A01,112904,Kumar; Arun Kumar,0,0,0,0
1667984189654,CSE 237A,A00,102383,Rosing; Tajana Simunic,0,0,0,0
1667984190079,CSE 239A,A00,102384,Deutsch; Alin Bernard,0,0,0,0
1667984190505,CSE 239B,A00,102385,Polikarpova; Nadezhda,0,0,0,0
1667984190933,CSE 240A,A00,102386,Pannuto; Patrick William,0,0,0,0
1667984191357,CSE 240B,A00,102387,Zhao; Jishen,0,0,0,0
1667984191779,CSE 241A,A00,106406,Kang; Mingu,0,0,0,0
1667984192204,CSE 249B,A00,102388,Kahng; Andrew Byun,0,0,8,8
1667984192629,CSE 251B,A01,102392,Cottrell; Garrison W,0,0,0,0
1667984192629,CSE 251B,A02,102393,Cottrell; Garrison W,0,0,0,0
1667984193056,CSE 252B,A00,102394,Ochoa; Benjamin Lawrence,0,0,0,0
1667984193485,CSE 257,A01,102396,Gao; Sicun,0,0,0,0
1667984193914,CSE 272,A00,102397,Li; Tzumao,0,0,0,0
1667984194342,CSE 274,A00,111323,Chern; Albert Ren-Haur,0,0,0,0
1667984194768,CSE 282,A00,102398,Pevzner; Pavel Arkadjevich,0,0,0,0
1667984195192,CSE 284,A00,114175,Gymrek; Melissa Ann,0,0,0,0
1667984195616,CSE 290,A00,102399,Chandraker; Manmohan Krishna,0,0,0,0
1667984195616,CSE 290,B00,102400,Vaccaro; Kristen Marie,0,0,25,25
1667984195616,CSE 290,C00,102414,Pannuto; Patrick William,0,0,25,25
1667984195616,CSE 290,D00,102427,Pevzner; Pavel Arkadjevich,0,0,0,0
1667984195616,CSE 290,E00,102429,Zhao; Jishen,0,0,0,0
1667984195616,CSE 290,F00,102436,Tullsen; Dean Michael,0,0,0,0
1667984195616,CSE 290,G00,102440,Christensen; Henrik I,0,0,20,20
1667984196048,CSE 291,A00,102443,Su; Hao,0,0,0,0
1667984196048,CSE 291,B00,102448,Polikarpova; Nadezhda,0,0,0,0
1667984196048,CSE 291,C00,102453,Vaccaro; Kristen Marie,0,0,0,0
1667984196048,CSE 291,D00,111343,Savage; Stefan,0,0,0,0
1667984196048,CSE 291,E00,116474,Claffy; Kimberly Claire,0,0,0,0
1667984196048,CSE 291,F00,116479,Pasquale; Joseph,0,0,0,0
1667984196509,CSE 293,001,119111,Bafna; Vineet,9999,0,9999,0
1667984196509,CSE 293,002,119118,Bellare; Mihir,9999,0,9999,0
1667984196509,CSE 293,003,119122,Berg-Kirkpatrick; Taylor D,9999,0,9999,0
1667984196509,CSE 293,004,119135,Christensen; Henrik I,9999,0,9999,0
1667984196509,CSE 293,005,119142,Cottrell; Garrison W,9999,0,9999,0
1667984196509,CSE 293,006,119146,Deutsch; Alin Bernard,9999,0,9999,0
1667984196509,CSE 293,007,119159,Esmaeilzadeh; Hadi,9999,0,9999,0
1667984196509,CSE 293,008,119166,Freund; Yoav,9999,0,9999,0
1667984196509,CSE 293,009,119170,Griswold; William G.,9999,0,9999,0
1667984196509,CSE 293,010,119183,Gymrek; Melissa Ann,9999,0,9999,0
1667984196509,CSE 293,011,119190,Heninger; Nadia A,9999,0,9999,0
1667984196509,CSE 293,012,119230,Impagliazzo; Russell,9999,0,9999,0
1667984196509,CSE 293,013,119232,Jhala; Ranjit,9999,0,9999,0
1667984196509,CSE 293,014,119233,Kahng; Andrew Byun,9999,0,9999,0
1667984196509,CSE 293,015,119298,Kane; Daniel Mertz,9999,0,9999,0
1667984196509,CSE 293,016,119299,Kriegman; David J,9999,0,9999,0
1667984196509,CSE 293,017,119300,Kumar; Arun Kumar,9999,0,9999,0
1667984196509,CSE 293,018,119301,Lerner; Sorin,9999,0,9999,0
1667984196509,CSE 293,019,119302,Lovett; Shachar,9999,0,9999,0
1667984196509,CSE 293,020,119303,McAuley; Julian John,9999,0,9999,0
1667984196509,CSE 293,021,119304,Micciancio; Daniele,9999,0,9999,0
1667984196509,CSE 293,022,119367,Orailoglu; Alex,9999,0,9999,0
1667984196509,CSE 293,023,119382,Paturi; Ramamohan,9999,0,9999,0
1667984196509,CSE 293,024,119404,Polikarpova; Nadezhda,9999,0,9999,0
1667984196509,CSE 293,025,119406,Politz; Joseph Gibbs,9999,0,9999,0
1667984196509,CSE 293,026,119411,Porter; George M,9999,0,9999,0
1667984196509,CSE 293,027,119414,Porter; Leonard Emerson,9999,0,9999,0
1667984196509,CSE 293,028,119416,Ramamoorthi; Ravi,9999,0,9999,0
1667984196509,CSE 293,029,119417,Sahoo; Debashis,9999,0,9999,0
1667984196509,CSE 293,030,119420,Saul; Lawrence,9999,0,9999,0
1667984196509,CSE 293,031,119421,Savage; Stefan,9999,0,9999,0
1667984196509,CSE 293,032,119425,Schulze; Jurgen P.,9999,0,9999,0
1667984196509,CSE 293,033,119426,Snoeren; Alex C.,9999,0,9999,0
1667984196509,CSE 293,034,119428,Shang; Jingbo,9999,0,9999,0
1667984196509,CSE 293,035,119430,Stefan; Deian,9999,0,9999,0
1667984196509,CSE 293,036,119431,Su; Hao,9999,0,9999,0
1667984196509,CSE 293,037,119433,Swanson; Steven James,9999,0,9999,0
1667984196509,CSE 293,038,119435,Tullsen; Dean Michael,9999,0,9999,0
1667984196509,CSE 293,039,119483,Voelker; Geoffrey M.,9999,0,9999,0
1667984196509,CSE 293,040,119537,Zhao; Jishen,9999,0,9999,0
1667984196509,CSE 293,041,119538,Zhou; Yuan-Yuan,9999,0,9999,0
1667984196509,CSE 293,042,119539,Gao; Sicun,9999,0,9999,0
1667984196509,CSE 293,043,119540,Weibel; Nadir,9999,0,9999,0
1667984196509,CSE 293,044,119541,Gupta; Rajesh K.,9999,0,9999,0
1667984196509,CSE 293,045,126410,Vaccaro; Kristen Marie,9999,0,9999,0
1667984196509,CSE 293,046,126411,Klemke; Richard,9999,0,9999,0
1667984196935,CSE 294,A00,102459,Voelker; Geoffrey M.,0,0,0,0
1667984196935,CSE 294,B00,111322,Orailoglu; Alex,0,0,0,0
1667984197359,DSE 201,A00,096914,Deutsch; Alin Bernard,30,0,30,0
1667984197782,DSE 210,A00,096915,Dasgupta; Sanjoy,30,0,30,0
1667984198209,DSE 260A,A00,096916,Altintas De Callaf; Ilkay,30,0,30,0
1667984198654,ECE 200,001,103586,Antipa; Nicholas A,9999,0,9999,0
1667984198654,ECE 200,002,103587,Atanasov; Nikolay A.,9999,0,9999,0
1667984198654,ECE 200,003,103588,Bharadia; Dinesh,9999,0,9999,0
1667984198654,ECE 200,004,103589,Cheng; Chung Kuan,9999,0,9999,0
1667984198654,ECE 200,005,103590,Cosman; Pamela C.,9999,0,9999,0
1667984198654,ECE 200,006,103591,Dayeh; Shadi Ahmad,9999,0,9999,0
1667984198654,ECE 200,007,103592,Fainman; Yeshaiahu,9999,0,9999,0
1667984198654,ECE 200,008,103593,Ford; Joseph Earl,9999,0,9999,0
1667984198654,ECE 200,009,103594,Franceschetti; Massimo,9999,0,9999,0
1667984198654,ECE 200,010,103595,Fullerton; Eric E,9999,0,9999,0
1667984198654,ECE 200,011,103596,Galton; Ian A,9999,0,9999,0
1667984198654,ECE 200,012,103597,Gilja; Vikash,9999,0,9999,0
1667984198654,ECE 200,013,103598,Hall; Drew A.,9999,0,9999,0
1667984198654,ECE 200,014,103599,Hsueh; Tzu-Chien,9999,0,9999,0
1667984198654,ECE 200,015,103600,Javidi; Tara,9999,0,9999,0
1667984198654,ECE 200,016,103601,Kahng; Andrew Byun,9999,0,9999,0
1667984198654,ECE 200,017,103602,Kim; Young-Han,9999,0,9999,0
1667984198654,ECE 200,018,103603,Koushanfar; Farinaz,9999,0,9999,0
1667984198654,ECE 200,019,103604,Kuzum; Duygu,9999,0,9999,0
1667984198654,ECE 200,020,103605,Le; Hanh-Phuc,9999,0,9999,0
1667984198654,ECE 200,021,103606,Lin; Bill,9999,0,9999,0
1667984198654,ECE 200,022,103607,Liu; Zhaowei,9998,0,9999,1
1667984198654,ECE 200,023,103608,Lo; Yu-Hwa,9999,0,9999,0
1667984198654,ECE 200,024,103609,Lomakin; Vitaliy,9999,0,9999,0
1667984198654,ECE 200,025,103610,Mercier; Patrick Philip,9999,0,9999,0
1667984198654,ECE 200,026,103611,Meyer; Florian,9999,0,9999,0
1667984198654,ECE 200,027,103612,Milstein; Laurence B.,9999,0,9999,0
1667984198654,ECE 200,028,103613,Mir Arabbaygi; Siavash,9999,0,9999,0
1667984198654,ECE 200,029,103614,Mookherjea; Shayan,9999,0,9999,0
1667984198654,ECE 200,030,103615,Morris; Karcher William,9999,0,9999,0
1667984198654,ECE 200,031,103616,Ng; Tse Nga,9999,0,9999,0
1667984198654,ECE 200,032,103617,Nguyen; Truong Quang,9999,0,9999,0
1667984198654,ECE 200,033,103618,Nomura; Kenji,9999,0,9999,0
1667984198654,ECE 200,034,103619,Orlitsky; Alon,9999,0,9999,0
1667984198654,ECE 200,035,103620,Pal; Piya,9999,0,9999,0
1667984198654,ECE 200,036,103621,Papen; George C.,9999,0,9999,0
1667984198654,ECE 200,037,103622,Radic; Stojan,9999,0,9999,0
1667984198654,ECE 200,038,103623,Rao; Bhaskar D.,9999,0,9999,0
1667984198654,ECE 200,039,103624,Rao; Ramesh R,9999,0,9999,0
1667984198654,ECE 200,040,103625,Rebeiz; Gabriel,9999,0,9999,0
1667984198654,ECE 200,041,103626,Sanford; John R,9999,0,9999,0
1667984198654,ECE 200,042,103627,Siegel; Paul H.,9999,0,9999,0
1667984198654,ECE 200,043,103628,Sievenpiper; Daniel F.,9999,0,9999,0
1667984198654,ECE 200,044,103629,Sworder; David D.,9999,0,9999,0
1667984198654,ECE 200,045,103630,Taur; Yuan,9999,0,9999,0
1667984198654,ECE 200,046,103631,Touri; Behrouz,9999,0,9999,0
1667984198654,ECE 200,047,103632,Trivedi; Mohan M.,9999,0,9999,0
1667984198654,ECE 200,048,103633,Vasconcelos; Nuno,9999,0,9999,0
1667984198654,ECE 200,049,103634,Wang; Xiaolong,9999,0,9999,0
1667984198654,ECE 200,050,103635,Xie; Pengtao,9999,0,9999,0
1667984198654,ECE 200,051,103636,Yip; Michael,9999,0,9999,0
1667984198654,ECE 200,052,103637,Zeger; Kenneth A.,999,0,999,0
1667984198654,ECE 200,053,103638,Zhang; Xinyu,9999,0,9999,0
1667984198654,ECE 200,054,103639,Turakhia; Yatish Girish,9999,0,9999,0
1667984198654,ECE 200,055,103640,Kang; Mingu,9999,0,9999,0
1667984198654,ECE 200,056,103641,Shi; Yuanyuan,9999,0,9999,0
1667984198654,ECE 200,057,103642,Wang; Edward Jay,9999,0,9999,0
1667984198654,ECE 200,058,103643,Zheng; Yang,9999,0,9999,0
1667984199081,ECE 202,A00,103644,Kuzum; Duygu,0,0,0,0
1667984199583,ECE 212BN,A00,103646,Ng; Tse Nga,0,0,0,0
1667984200008,ECE 221,A00,111493,Staff,0,0,0,0
1667984200435,ECE 222B,A00,103647,Lomakin; Vitaliy,0,0,0,0
1667984200862,ECE 230B,A00,103648,Taur; Yuan,0,0,0,0
1667984201285,ECE 238B,A00,103649,Garay; Javier,0,0,0,0
1667984201707,ECE 240B,A00,112900,Fainman; Yeshaiahu,0,0,0,0
1667984202131,ECE 247A,A00,103650,Jokerst; Jesse Vincent,0,0,0,0
1667984202559,ECE 247B,A00,103651,Wang; Joseph,0,0,0,0
1667984202989,ECE 250,A00,103652,Siegel; Paul H.,0,0,0,0
1667984203411,ECE 251A,A00,103654,Rao; Bhaskar D.,0,0,0,0
1667984203838,ECE 257B,A00,103655,Bharadia; Dinesh,0,0,0,0
1667984204262,ECE 258A,A00,103656,Milstein; Laurence B.,0,0,0,0
1667984204720,ECE 260B,A00,103658,Kang; Mingu,0,0,0,0
1667984205143,ECE 264A,A00,103659,Galton; Ian A,0,0,0,0
1667984205567,ECE 265A,A00,103661,Gudem; Prasad S.S.,0,0,0,0
1667984205992,ECE 265D,A00,103662,Gudem; Prasad S.S.,0,0,0,0
1667984206418,ECE 268,A00,103663,Koushanfar; Farinaz,0,0,0,0
1667984206845,ECE 269,A01,103665,Pal; Piya,0,0,0,0
1667984207274,ECE 271B,A00,103666,Vasconcelos; Manuela,0,0,0,0
1667984207698,ECE 276A,A00,103667,Atanasov; Nikolay A.,0,0,0,0
1667984208126,ECE 277,A00,103668,An; Cheolhong,0,0,0,0
1667984208550,ECE 279,A00,117947,Hall; Drew A.,0,0,0,0
1667984209398,ECE 283,A00,103670,Hsueh; Tzu-Chien,0,0,0,0
1667984209826,ECE 284,A00,103671,Turakhia; Yatish Girish,0,0,0,0
1667984210254,ECE 285,A00,103672,Zheng; Yang,0,0,0,0
1667984210254,ECE 285,B00,103673,Sworder; David D.,0,0,0,0
1667984210679,ECE 287,A00,103676,Javidi; Tara,0,0,0,0
1667984211108,MATH 200B,A00,098023,Salehi Golsefidy; Alireza,14,0,15,1
1667984211532,MATH 202B,A00,098024,Rhoades; Brendon Patrick,12,0,15,3
1667984211962,MATH 203B,A00,098025,Oprea; Dragos N.,12,0,15,3
1667984212389,MATH 204B,A00,098026,Sorensen; Claus M,14,0,15,1
1667984212814,MATH 208,A00,098027,Izadi; Elham,7,0,10,3
1667984213237,MATH 209,A00,098028,Pollack; Aaron,10,0,10,0
1667984213665,MATH 211A,A00,112919,Rogalski; Daniel,9,0,10,1
1667984214091,MATH 211B,A00,112920,Seward; Brandon M.,9,0,10,1
1667984214517,MATH 218,A00,098029,Li; Bo,10,0,10,0
1667984214943,MATH 220B,A00,098030,Novak; Jonathan I,13,0,15,2
1667984215370,MATH 221A,A00,098031,Ebenfelt; Peter F,13,0,15,2
1667984215796,MATH 231B,A00,098032,Zlatos; Andrej,12,0,15,3
1667984216219,MATH 240B,A00,098033,Ni; Lei,10,0,15,5
1667984216646,MATH 243,A00,098034,Jekel; David Andrew,10,0,10,0
1667984217071,MATH 245A,A00,098035,Nie; Jiawang,0,0,15,16
1667984217494,MATH 248,A00,098036,Bejenaru; Ioan,10,0,10,0
1667984217918,MATH 250B,A00,098037,Spolaor; Luca,14,0,15,1
1667984218343,MATH 258,A00,098038,Ni; Lei,10,0,10,0
1667984218770,MATH 264B,A00,098041,Rhoades; Brendon Patrick,11,0,15,4
1667984219194,MATH 268,A00,098042,Buss; Samuel R,10,0,10,0
1667984219622,MATH 269,A00,098043,Rhoades; Brendon Patrick,10,0,10,0
1667984220049,MATH 270B,A00,098044,Li; Bo,11,0,15,4
1667984220472,MATH 272B,A00,098045,Holst; Michael J,13,0,15,2
1667984220898,MATH 273A,A00,098046,Tian; Xiaochuan,12,0,15,3
1667984221326,MATH 275,A01,098048,Tian; Xiaochuan,6,0,10,4
1667984221750,MATH 278A,A00,098049,Holst; Michael J,8,0,10,2
1667984222174,MATH 278B,A00,098050,Cloninger; Alexander,10,0,10,0
1667984222596,MATH 278C,A00,098051,Nie; Jiawang,8,0,10,2
1667984223019,MATH 280B,A00,098052,Zheng; Tianyi,11,0,15,4
1667984223443,MATH 281B,A00,098053,Bradic; Jelena,4,0,15,11
1667984223871,MATH 282B,A00,098054,Arias-Castro; Ery,2,0,15,13
1667984224294,MATH 285,A00,098055,Fitzsimmons; Patrick J,0,0,15,17
1667984224719,MATH 287B,A00,098056,Arias-Castro; Ery,5,0,15,10
1667984225145,MATH 288,A00,098057,Agarwal; Pooja,9,0,10,1
1667984225145,MATH 288,B00,098058,Zhang; Danna,9,0,10,1
1667984225145,MATH 288,C00,098059,Williams; Ruth J,10,0,10,0
1667984225570,MATH 290B,A00,098060,Roberts; Justin Deritter,14,0,15,1
1667984225993,MATH 292,A00,098061,Belmont; Eva Kinoshita,10,0,10,0
1667984226417,MATH 295,A00,098062,Suk; Andrew Hoon,48,0,50,2
1667984226840,MATH 296,A00,098063,Novak; Jonathan I,20,0,20,0
1667984227268,MATH 297,001,098064,Gamst; Anthony Collins,9997,0,9999,2
1667984728241,COGS 205,A00,101395,Chiba; Andrea,19,0,20,1
1667984728667,COGS 210B,001,101404,Greene; Deanna Jacquelyn,9998,0,9999,1
1667984728667,COGS 210B,002,101417,Xia; Haijun,9999,0,9999,0
1667984728667,COGS 210B,003,101422,Nitz; Douglas A.,9999,0,9999,0
1667984728667,COGS 210B,004,101423,Hollan; James D.,9998,0,9999,1
1667984728667,COGS 210B,005,101424,Deak; Gedeon O.,9999,0,9999,0
1667984728667,COGS 210B,006,101425,Rossano; Federico,9999,0,9999,0
1667984729091,COGS 211B,A00,101427,Coulson; Seana M,9997,0,9999,2
1667984729518,COGS 220,A00,101428,Hollan; James D.,0,0,25,25
1667984729945,COGS 229,A00,101429,Dow; Steven P,18,0,25,7
1667984730371,COGS 230,A00,101430,Klemmer; Scott R,13,0,17,4
1667984730795,COGS 234,A00,101431,Xia; Haijun,7,0,25,18
1667984731222,COGS 260,A00,101432,Kiyonaga; Anastasia,20,0,25,5
1667984731222,COGS 260,B00,101433,Kirsh; David Joel,16,0,25,9
1667984731651,CSE 202,A00,102371,Impagliazzo; Russell,0,0,0,0
1667984732076,CSE 203B,A01,102373,Cheng; Chung Kuan,0,0,0,0
1667984732505,CSE 208,A00,102374,Micciancio; Daniele,0,0,0,0
1667984732936,CSE 209A,A00,112895,Impagliazzo; Russell,0,0,15,15
1667984733370,CSE 209B,A00,108005,Bellare; Mihir,0,0,0,0
1667984733794,CSE 210,A00,113163,Coblenz; Michael J,0,0,0,0
1667984734218,CSE 219,A00,106111,Dow; Steven P,1,0,20,19
1667984734643,CSE 221,A00,102376,Voelker; Geoffrey M.,0,0,0,0
1667984735067,CSE 224,A01,102378,Porter; George M,0,0,0,0
1667984735491,CSE 229A,A00,102379,Savage; Stefan,0,0,0,0
1667984735920,CSE 229C,A00,102380,Munyaka; Imani N. S.,0,0,0,0
1667984736346,CSE 232B,A00,102382,Deutsch; Alin Bernard,0,0,0,0
1667984736770,CSE 234,A01,112904,Kumar; Arun Kumar,0,0,0,0
1667984737195,CSE 237A,A00,102383,Rosing; Tajana Simunic,0,0,0,0
1667984737617,CSE 239A,A00,102384,Deutsch; Alin Bernard,0,0,0,0
1667984738044,CSE 239B,A00,102385,Polikarpova; Nadezhda,0,0,0,0
1667984738468,CSE 240A,A00,102386,Pannuto; Patrick William,0,0,0,0
1667984738896,CSE 240B,A00,102387,Zhao; Jishen,0,0,0,0
1667984739320,CSE 241A,A00,106406,Kang; Mingu,0,0,0,0
1667984739747,CSE 249B,A00,102388,Kahng; Andrew Byun,0,0,8,8
1667984740177,CSE 251B,A01,102392,Cottrell; Garrison W,0,0,0,0
1667984740177,CSE 251B,A02,102393,Cottrell; Garrison W,0,0,0,0
1667984740606,CSE 252B,A00,102394,Ochoa; Benjamin Lawrence,0,0,0,0
1667984741031,CSE 257,A01,102396,Gao; Sicun,0,0,0,0
1667984741455,CSE 272,A00,102397,Li; Tzumao,0,0,0,0
1667984741878,CSE 274,A00,111323,Chern; Albert Ren-Haur,0,0,0,0
1667984742302,CSE 282,A00,102398,Pevzner; Pavel Arkadjevich,0,0,0,0
1667984742727,CSE 284,A00,114175,Gymrek; Melissa Ann,0,0,0,0
1667984743151,CSE 290,A00,102399,Chandraker; Manmohan Krishna,0,0,0,0
1667984743151,CSE 290,B00,102400,Vaccaro; Kristen Marie,0,0,25,25
1667984743151,CSE 290,C00,102414,Pannuto; Patrick William,0,0,25,25
1667984743151,CSE 290,D00,102427,Pevzner; Pavel Arkadjevich,0,0,0,0
1667984743151,CSE 290,E00,102429,Zhao; Jishen,0,0,0,0
1667984743151,CSE 290,F00,102436,Tullsen; Dean Michael,0,0,0,0
1667984743151,CSE 290,G00,102440,Christensen; Henrik I,0,0,20,20
1667984743578,CSE 291,A00,102443,Su; Hao,0,0,0,0
1667984743578,CSE 291,B00,102448,Polikarpova; Nadezhda,0,0,0,0
1667984743578,CSE 291,C00,102453,Vaccaro; Kristen Marie,0,0,0,0
1667984743578,CSE 291,D00,111343,Savage; Stefan,0,0,0,0
1667984743578,CSE 291,E00,116474,Claffy; Kimberly Claire,0,0,0,0
1667984743578,CSE 291,F00,116479,Pasquale; Joseph,0,0,0,0
1667984744018,CSE 293,001,119111,Bafna; Vineet,9999,0,9999,0
1667984744018,CSE 293,002,119118,Bellare; Mihir,9999,0,9999,0
1667984744018,CSE 293,003,119122,Berg-Kirkpatrick; Taylor D,9999,0,9999,0
1667984744018,CSE 293,004,119135,Christensen; Henrik I,9999,0,9999,0
1667984744018,CSE 293,005,119142,Cottrell; Garrison W,9999,0,9999,0
1667984744018,CSE 293,006,119146,Deutsch; Alin Bernard,9999,0,9999,0
1667984744018,CSE 293,007,119159,Esmaeilzadeh; Hadi,9999,0,9999,0
1667984744018,CSE 293,008,119166,Freund; Yoav,9999,0,9999,0
1667984744018,CSE 293,009,119170,Griswold; William G.,9999,0,9999,0
1667984744018,CSE 293,010,119183,Gymrek; Melissa Ann,9999,0,9999,0
1667984744018,CSE 293,011,119190,Heninger; Nadia A,9999,0,9999,0
1667984744018,CSE 293,012,119230,Impagliazzo; Russell,9999,0,9999,0
1667984744018,CSE 293,013,119232,Jhala; Ranjit,9999,0,9999,0
1667984744018,CSE 293,014,119233,Kahng; Andrew Byun,9999,0,9999,0
1667984744018,CSE 293,015,119298,Kane; Daniel Mertz,9999,0,9999,0
1667984744018,CSE 293,016,119299,Kriegman; David J,9999,0,9999,0
1667984744018,CSE 293,017,119300,Kumar; Arun Kumar,9999,0,9999,0
1667984744018,CSE 293,018,119301,Lerner; Sorin,9999,0,9999,0
1667984744018,CSE 293,019,119302,Lovett; Shachar,9999,0,9999,0
1667984744018,CSE 293,020,119303,McAuley; Julian John,9999,0,9999,0
1667984744018,CSE 293,021,119304,Micciancio; Daniele,9999,0,9999,0
1667984744018,CSE 293,022,119367,Orailoglu; Alex,9999,0,9999,0
1667984744018,CSE 293,023,119382,Paturi; Ramamohan,9999,0,9999,0
1667984744018,CSE 293,024,119404,Polikarpova; Nadezhda,9999,0,9999,0
1667984744018,CSE 293,025,119406,Politz; Joseph Gibbs,9999,0,9999,0
1667984744018,CSE 293,026,119411,Porter; George M,9999,0,9999,0
1667984744018,CSE 293,027,119414,Porter; Leonard Emerson,9999,0,9999,0
1667984744018,CSE 293,028,119416,Ramamoorthi; Ravi,9999,0,9999,0
1667984744018,CSE 293,029,119417,Sahoo; Debashis,9999,0,9999,0
1667984744018,CSE 293,030,119420,Saul; Lawrence,9999,0,9999,0
1667984744018,CSE 293,031,119421,Savage; Stefan,9999,0,9999,0
1667984744018,CSE 293,032,119425,Schulze; Jurgen P.,9999,0,9999,0
1667984744018,CSE 293,033,119426,Snoeren; Alex C.,9999,0,9999,0
1667984744018,CSE 293,034,119428,Shang; Jingbo,9999,0,9999,0
1667984744018,CSE 293,035,119430,Stefan; Deian,9999,0,9999,0
1667984744018,CSE 293,036,119431,Su; Hao,9999,0,9999,0
1667984744018,CSE 293,037,119433,Swanson; Steven James,9999,0,9999,0
1667984744018,CSE 293,038,119435,Tullsen; Dean Michael,9999,0,9999,0
1667984744018,CSE 293,039,119483,Voelker; Geoffrey M.,9999,0,9999,0
1667984744018,CSE 293,040,119537,Zhao; Jishen,9999,0,9999,0
1667984744018,CSE 293,041,119538,Zhou; Yuan-Yuan,9999,0,9999,0
1667984744018,CSE 293,042,119539,Gao; Sicun,9999,0,9999,0
1667984744018,CSE 293,043,119540,Weibel; Nadir,9999,0,9999,0
1667984744018,CSE 293,044,119541,Gupta; Rajesh K.,9999,0,9999,0
1667984744018,CSE 293,045,126410,Vaccaro; Kristen Marie,9999,0,9999,0
1667984744018,CSE 293,046,126411,Klemke; Richard,9999,0,9999,0
1667984744445,CSE 294,A00,102459,Voelker; Geoffrey M.,0,0,0,0
1667984744445,CSE 294,B00,111322,Orailoglu; Alex,0,0,0,0
1667984744876,DSE 201,A00,096914,Deutsch; Alin Bernard,30,0,30,0
1667984745300,DSE 210,A00,096915,Dasgupta; Sanjoy,30,0,30,0
1667984745726,DSE 260A,A00,096916,Altintas De Callaf; Ilkay,30,0,30,0
1667984746176,ECE 200,001,103586,Antipa; Nicholas A,9999,0,9999,0
1667984746176,ECE 200,002,103587,Atanasov; Nikolay A.,9999,0,9999,0
1667984746176,ECE 200,003,103588,Bharadia; Dinesh,9999,0,9999,0
1667984746176,ECE 200,004,103589,Cheng; Chung Kuan,9999,0,9999,0
1667984746176,ECE 200,005,103590,Cosman; Pamela C.,9999,0,9999,0
1667984746176,ECE 200,006,103591,Dayeh; Shadi Ahmad,9999,0,9999,0
1667984746176,ECE 200,007,103592,Fainman; Yeshaiahu,9999,0,9999,0
1667984746176,ECE 200,008,103593,Ford; Joseph Earl,9999,0,9999,0
1667984746176,ECE 200,009,103594,Franceschetti; Massimo,9999,0,9999,0
1667984746176,ECE 200,010,103595,Fullerton; Eric E,9999,0,9999,0
1667984746176,ECE 200,011,103596,Galton; Ian A,9999,0,9999,0
1667984746176,ECE 200,012,103597,Gilja; Vikash,9999,0,9999,0
1667984746176,ECE 200,013,103598,Hall; Drew A.,9999,0,9999,0
1667984746176,ECE 200,014,103599,Hsueh; Tzu-Chien,9999,0,9999,0
1667984746176,ECE 200,015,103600,Javidi; Tara,9999,0,9999,0
1667984746176,ECE 200,016,103601,Kahng; Andrew Byun,9999,0,9999,0
1667984746176,ECE 200,017,103602,Kim; Young-Han,9999,0,9999,0
1667984746176,ECE 200,018,103603,Koushanfar; Farinaz,9999,0,9999,0
1667984746176,ECE 200,019,103604,Kuzum; Duygu,9999,0,9999,0
1667984746176,ECE 200,020,103605,Le; Hanh-Phuc,9999,0,9999,0
1667984746176,ECE 200,021,103606,Lin; Bill,9999,0,9999,0
1667984746176,ECE 200,022,103607,Liu; Zhaowei,9998,0,9999,1
1667984746176,ECE 200,023,103608,Lo; Yu-Hwa,9999,0,9999,0
1667984746176,ECE 200,024,103609,Lomakin; Vitaliy,9999,0,9999,0
1667984746176,ECE 200,025,103610,Mercier; Patrick Philip,9999,0,9999,0
1667984746176,ECE 200,026,103611,Meyer; Florian,9999,0,9999,0
1667984746176,ECE 200,027,103612,Milstein; Laurence B.,9999,0,9999,0
1667984746176,ECE 200,028,103613,Mir Arabbaygi; Siavash,9999,0,9999,0
1667984746176,ECE 200,029,103614,Mookherjea; Shayan,9999,0,9999,0
1667984746176,ECE 200,030,103615,Morris; Karcher William,9999,0,9999,0
1667984746176,ECE 200,031,103616,Ng; Tse Nga,9999,0,9999,0
1667984746176,ECE 200,032,103617,Nguyen; Truong Quang,9999,0,9999,0
1667984746176,ECE 200,033,103618,Nomura; Kenji,9999,0,9999,0
1667984746176,ECE 200,034,103619,Orlitsky; Alon,9999,0,9999,0
1667984746176,ECE 200,035,103620,Pal; Piya,9999,0,9999,0
1667984746176,ECE 200,036,103621,Papen; George C.,9999,0,9999,0
1667984746176,ECE 200,037,103622,Radic; Stojan,9999,0,9999,0
1667984746176,ECE 200,038,103623,Rao; Bhaskar D.,9999,0,9999,0
1667984746176,ECE 200,039,103624,Rao; Ramesh R,9999,0,9999,0
1667984746176,ECE 200,040,103625,Rebeiz; Gabriel,9999,0,9999,0
1667984746176,ECE 200,041,103626,Sanford; John R,9999,0,9999,0
1667984746176,ECE 200,042,103627,Siegel; Paul H.,9999,0,9999,0
1667984746176,ECE 200,043,103628,Sievenpiper; Daniel F.,9999,0,9999,0
1667984746176,ECE 200,044,103629,Sworder; David D.,9999,0,9999,0
1667984746176,ECE 200,045,103630,Taur; Yuan,9999,0,9999,0
1667984746176,ECE 200,046,103631,Touri; Behrouz,9999,0,9999,0
1667984746176,ECE 200,047,103632,Trivedi; Mohan M.,9999,0,9999,0
1667984746176,ECE 200,048,103633,Vasconcelos; Nuno,9999,0,9999,0
1667984746176,ECE 200,049,103634,Wang; Xiaolong,9999,0,9999,0
1667984746176,ECE 200,050,103635,Xie; Pengtao,9999,0,9999,0
1667984746176,ECE 200,051,103636,Yip; Michael,9999,0,9999,0
1667984746176,ECE 200,052,103637,Zeger; Kenneth A.,999,0,999,0
1667984746176,ECE 200,053,103638,Zhang; Xinyu,9999,0,9999,0
1667984746176,ECE 200,054,103639,Turakhia; Yatish Girish,9999,0,9999,0
1667984746176,ECE 200,055,103640,Kang; Mingu,9999,0,9999,0
1667984746176,ECE 200,056,103641,Shi; Yuanyuan,9999,0,9999,0
1667984746176,ECE 200,057,103642,Wang; Edward Jay,9999,0,9999,0
1667984746176,ECE 200,058,103643,Zheng; Yang,9999,0,9999,0
1667984746602,ECE 202,A00,103644,Kuzum; Duygu,0,0,0,0
1667984747026,ECE 212BN,A00,103646,Ng; Tse Nga,0,0,0,0
1667984747451,ECE 221,A00,111493,Staff,0,0,0,0
1667984747879,ECE 222B,A00,103647,Lomakin; Vitaliy,0,0,0,0
1667984748308,ECE 230B,A00,103648,Taur; Yuan,0,0,0,0
1667984748736,ECE 238B,A00,103649,Garay; Javier,0,0,0,0
1667984749161,ECE 240B,A00,112900,Fainman; Yeshaiahu,0,0,0,0
1667984749589,ECE 247A,A00,103650,Jokerst; Jesse Vincent,0,0,0,0
1667984750013,ECE 247B,A00,103651,Wang; Joseph,0,0,0,0
1667984750440,ECE 250,A00,103652,Siegel; Paul H.,0,0,0,0
1667984750864,ECE 251A,A00,103654,Rao; Bhaskar D.,0,0,0,0
1667984751290,ECE 257B,A00,103655,Bharadia; Dinesh,0,0,0,0
1667984751718,ECE 258A,A00,103656,Milstein; Laurence B.,0,0,0,0
1667984752142,ECE 260B,A00,103658,Kang; Mingu,0,0,0,0
1667984752573,ECE 264A,A00,103659,Galton; Ian A,0,0,0,0
1667984753004,ECE 265A,A00,103661,Gudem; Prasad S.S.,0,0,0,0
1667984753427,ECE 265D,A00,103662,Gudem; Prasad S.S.,0,0,0,0
1667984753850,ECE 268,A00,103663,Koushanfar; Farinaz,0,0,0,0
1667984754288,ECE 269,A01,103665,Pal; Piya,0,0,0,0
1667984754713,ECE 271B,A00,103666,Vasconcelos; Manuela,0,0,0,0
1667984755136,ECE 276A,A00,103667,Atanasov; Nikolay A.,0,0,0,0
1667984755566,ECE 277,A00,103668,An; Cheolhong,0,0,0,0
1667984755994,ECE 279,A00,117947,Hall; Drew A.,0,0,0,0
1667984756870,ECE 283,A00,103670,Hsueh; Tzu-Chien,0,0,0,0
1667984757298,ECE 284,A00,103671,Turakhia; Yatish Girish,0,0,0,0
1667984757732,ECE 285,A00,103672,Zheng; Yang,0,0,0,0
1667984757732,ECE 285,B00,103673,Sworder; David D.,0,0,0,0
1667984758155,ECE 287,A00,103676,Javidi; Tara,0,0,0,0
1667984758583,MATH 200B,A00,098023,Salehi Golsefidy; Alireza,14,0,15,1
1667984759010,MATH 202B,A00,098024,Rhoades; Brendon Patrick,12,0,15,3
1667984759440,MATH 203B,A00,098025,Oprea; Dragos N.,12,0,15,3
1667984759865,MATH 204B,A00,098026,Sorensen; Claus M,14,0,15,1
1667984760291,MATH 208,A00,098027,Izadi; Elham,7,0,10,3
1667984760713,MATH 209,A00,098028,Pollack; Aaron,10,0,10,0
1667984761157,MATH 211A,A00,112919,Rogalski; Daniel,9,0,10,1
1667984761594,MATH 211B,A00,112920,Seward; Brandon M.,9,0,10,1
1667984762021,MATH 218,A00,098029,Li; Bo,10,0,10,0
1667984762447,MATH 220B,A00,098030,Novak; Jonathan I,13,0,15,2
1667984762878,MATH 221A,A00,098031,Ebenfelt; Peter F,13,0,15,2
1667984763309,MATH 231B,A00,098032,Zlatos; Andrej,12,0,15,3
1667984763831,MATH 240B,A00,098033,Ni; Lei,10,0,15,5
1667984764255,MATH 243,A00,098034,Jekel; David Andrew,10,0,10,0
1667984764684,MATH 245A,A00,098035,Nie; Jiawang,0,0,15,16
1667984765107,MATH 248,A00,098036,Bejenaru; Ioan,10,0,10,0
1667984765532,MATH 250B,A00,098037,Spolaor; Luca,14,0,15,1
1667984765956,MATH 258,A00,098038,Ni; Lei,10,0,10,0
1667984766379,MATH 264B,A00,098041,Rhoades; Brendon Patrick,11,0,15,4
1667984766804,MATH 268,A00,098042,Buss; Samuel R,10,0,10,0
1667984767231,MATH 269,A00,098043,Rhoades; Brendon Patrick,10,0,10,0
1667984767655,MATH 270B,A00,098044,Li; Bo,11,0,15,4
1667984768084,MATH 272B,A00,098045,Holst; Michael J,13,0,15,2
1667984768511,MATH 273A,A00,098046,Tian; Xiaochuan,12,0,15,3
1667984768937,MATH 275,A01,098048,Tian; Xiaochuan,6,0,10,4
1667984769362,MATH 278A,A00,098049,Holst; Michael J,8,0,10,2
1667984769788,MATH 278B,A00,098050,Cloninger; Alexander,10,0,10,0
1667984770212,MATH 278C,A00,098051,Nie; Jiawang,8,0,10,2
1667984770639,MATH 280B,A00,098052,Zheng; Tianyi,11,0,15,4
1667984771063,MATH 281B,A00,098053,Bradic; Jelena,4,0,15,11
1667984771492,MATH 282B,A00,098054,Arias-Castro; Ery,2,0,15,13
1667984771922,MATH 285,A00,098055,Fitzsimmons; Patrick J,0,0,15,17
1667984772346,MATH 287B,A00,098056,Arias-Castro; Ery,5,0,15,10
1667984772775,MATH 288,A00,098057,Agarwal; Pooja,9,0,10,1
1667984772775,MATH 288,B00,098058,Zhang; Danna,9,0,10,1
1667984772775,MATH 288,C00,098059,Williams; Ruth J,10,0,10,0
1667984773199,MATH 290B,A00,098060,Roberts; Justin Deritter,14,0,15,1
1667984773624,MATH 292,A00,098061,Belmont; Eva Kinoshita,10,0,10,0
1667984774049,MATH 295,A00,098062,Suk; Andrew Hoon,48,0,50,2
1667984774476,MATH 296,A00,098063,Novak; Jonathan I,20,0,20,0
1667984774904,MATH 297,001,098064,Gamst; Anthony Collins,9997,0,9999,2
1667985275585,COGS 205,A00,101395,Chiba; Andrea,19,0,20,1
1667985276011,COGS 210B,001,101404,Greene; Deanna Jacquelyn,9998,0,9999,1
1667985276011,COGS 210B,002,101417,Xia; Haijun,9999,0,9999,0
1667985276011,COGS 210B,003,101422,Nitz; Douglas A.,9999,0,9999,0
1667985276011,COGS 210B,004,101423,Hollan; James D.,9998,0,9999,1
1667985276011,COGS 210B,005,101424,Deak; Gedeon O.,9999,0,9999,0
1667985276011,COGS 210B,006,101425,Rossano; Federico,9999,0,9999,0
1667985276435,COGS 211B,A00,101427,Coulson; Seana M,9997,0,9999,2
1667985276858,COGS 220,A00,101428,Hollan; James D.,0,0,25,25
1667985277281,COGS 229,A00,101429,Dow; Steven P,18,0,25,7
1667985277703,COGS 230,A00,101430,Klemmer; Scott R,13,0,17,4
1667985278128,COGS 234,A00,101431,Xia; Haijun,7,0,25,18
1667985278552,COGS 260,A00,101432,Kiyonaga; Anastasia,20,0,25,5
1667985278552,COGS 260,B00,101433,Kirsh; David Joel,16,0,25,9
1667985278981,CSE 202,A00,102371,Impagliazzo; Russell,0,0,0,0
1667985279404,CSE 203B,A01,102373,Cheng; Chung Kuan,0,0,0,0
1667985279833,CSE 208,A00,102374,Micciancio; Daniele,0,0,0,0
1667985280257,CSE 209A,A00,112895,Impagliazzo; Russell,0,0,15,15
1667985280681,CSE 209B,A00,108005,Bellare; Mihir,0,0,0,0
1667985281105,CSE 210,A00,113163,Coblenz; Michael J,0,0,0,0
1667985281530,CSE 219,A00,106111,Dow; Steven P,1,0,20,19
1667985281956,CSE 221,A00,102376,Voelker; Geoffrey M.,0,0,0,0
1667985282382,CSE 224,A01,102378,Porter; George M,0,0,0,0
1667985282810,CSE 229A,A00,102379,Savage; Stefan,0,0,0,0
1667985283233,CSE 229C,A00,102380,Munyaka; Imani N. S.,0,0,0,0
1667985283668,CSE 232B,A00,102382,Deutsch; Alin Bernard,0,0,0,0
1667985284098,CSE 234,A01,112904,Kumar; Arun Kumar,0,0,0,0
1667985284619,CSE 237A,A00,102383,Rosing; Tajana Simunic,0,0,0,0
1667985285044,CSE 239A,A00,102384,Deutsch; Alin Bernard,0,0,0,0
1667985285474,CSE 239B,A00,102385,Polikarpova; Nadezhda,0,0,0,0
1667985285901,CSE 240A,A00,102386,Pannuto; Patrick William,0,0,0,0
1667985286323,CSE 240B,A00,102387,Zhao; Jishen,0,0,0,0
1667985286746,CSE 241A,A00,106406,Kang; Mingu,0,0,0,0
1667985287177,CSE 249B,A00,102388,Kahng; Andrew Byun,0,0,8,8
1667985287601,CSE 251B,A01,102392,Cottrell; Garrison W,0,0,0,0
1667985287601,CSE 251B,A02,102393,Cottrell; Garrison W,0,0,0,0
1667985288026,CSE 252B,A00,102394,Ochoa; Benjamin Lawrence,0,0,0,0
1667985288449,CSE 257,A01,102396,Gao; Sicun,0,0,0,0
1667985288877,CSE 272,A00,102397,Li; Tzumao,0,0,0,0
1667985289300,CSE 274,A00,111323,Chern; Albert Ren-Haur,0,0,0,0
1667985289729,CSE 282,A00,102398,Pevzner; Pavel Arkadjevich,0,0,0,0
1667985290157,CSE 284,A00,114175,Gymrek; Melissa Ann,0,0,0,0
1667985290589,CSE 290,A00,102399,Chandraker; Manmohan Krishna,0,0,0,0
1667985290589,CSE 290,B00,102400,Vaccaro; Kristen Marie,0,0,25,25
1667985290589,CSE 290,C00,102414,Pannuto; Patrick William,0,0,25,25
1667985290589,CSE 290,D00,102427,Pevzner; Pavel Arkadjevich,0,0,0,0
1667985290589,CSE 290,E00,102429,Zhao; Jishen,0,0,0,0
1667985290589,CSE 290,F00,102436,Tullsen; Dean Michael,0,0,0,0
1667985290589,CSE 290,G00,102440,Christensen; Henrik I,0,0,20,20
1667985291014,CSE 291,A00,102443,Su; Hao,0,0,0,0
1667985291014,CSE 291,B00,102448,Polikarpova; Nadezhda,0,0,0,0
1667985291014,CSE 291,C00,102453,Vaccaro; Kristen Marie,0,0,0,0
1667985291014,CSE 291,D00,111343,Savage; Stefan,0,0,0,0
1667985291014,CSE 291,E00,116474,Claffy; Kimberly Claire,0,0,0,0
1667985291014,CSE 291,F00,116479,Pasquale; Joseph,0,0,0,0
1667985291459,CSE 293,001,119111,Bafna; Vineet,9999,0,9999,0
1667985291459,CSE 293,002,119118,Bellare; Mihir,9999,0,9999,0
1667985291459,CSE 293,003,119122,Berg-Kirkpatrick; Taylor D,9999,0,9999,0
1667985291459,CSE 293,004,119135,Christensen; Henrik I,9999,0,9999,0
1667985291459,CSE 293,005,119142,Cottrell; Garrison W,9999,0,9999,0
1667985291459,CSE 293,006,119146,Deutsch; Alin Bernard,9999,0,9999,0
1667985291459,CSE 293,007,119159,Esmaeilzadeh; Hadi,9999,0,9999,0
1667985291459,CSE 293,008,119166,Freund; Yoav,9999,0,9999,0
1667985291459,CSE 293,009,119170,Griswold; William G.,9999,0,9999,0
1667985291459,CSE 293,010,119183,Gymrek; Melissa Ann,9999,0,9999,0
1667985291459,CSE 293,011,119190,Heninger; Nadia A,9999,0,9999,0
1667985291459,CSE 293,012,119230,Impagliazzo; Russell,9999,0,9999,0
1667985291459,CSE 293,013,119232,Jhala; Ranjit,9999,0,9999,0
1667985291459,CSE 293,014,119233,Kahng; Andrew Byun,9999,0,9999,0
1667985291459,CSE 293,015,119298,Kane; Daniel Mertz,9999,0,9999,0
1667985291459,CSE 293,016,119299,Kriegman; David J,9999,0,9999,0
1667985291459,CSE 293,017,119300,Kumar; Arun Kumar,9999,0,9999,0
1667985291459,CSE 293,018,119301,Lerner; Sorin,9999,0,9999,0
1667985291459,CSE 293,019,119302,Lovett; Shachar,9999,0,9999,0
1667985291459,CSE 293,020,119303,McAuley; Julian John,9999,0,9999,0
1667985291459,CSE 293,021,119304,Micciancio; Daniele,9999,0,9999,0
1667985291459,CSE 293,022,119367,Orailoglu; Alex,9999,0,9999,0
1667985291459,CSE 293,023,119382,Paturi; Ramamohan,9999,0,9999,0
1667985291459,CSE 293,024,119404,Polikarpova; Nadezhda,9999,0,9999,0
1667985291459,CSE 293,025,119406,Politz; Joseph Gibbs,9999,0,9999,0
1667985291459,CSE 293,026,119411,Porter; George M,9999,0,9999,0
1667985291459,CSE 293,027,119414,Porter; Leonard Emerson,9999,0,9999,0
1667985291459,CSE 293,028,119416,Ramamoorthi; Ravi,9999,0,9999,0
1667985291459,CSE 293,029,119417,Sahoo; Debashis,9999,0,9999,0
1667985291459,CSE 293,030,119420,Saul; Lawrence,9999,0,9999,0
1667985291459,CSE 293,031,119421,Savage; Stefan,9999,0,9999,0
1667985291459,CSE 293,032,119425,Schulze; Jurgen P.,9999,0,9999,0
1667985291459,CSE 293,033,119426,Snoeren; Alex C.,9999,0,9999,0
1667985291459,CSE 293,034,119428,Shang; Jingbo,9999,0,9999,0
1667985291459,CSE 293,035,119430,Stefan; Deian,9999,0,9999,0
1667985291459,CSE 293,036,119431,Su; Hao,9999,0,9999,0
1667985291459,CSE 293,037,119433,Swanson; Steven James,9999,0,9999,0
1667985291459,CSE 293,038,119435,Tullsen; Dean Michael,9999,0,9999,0
1667985291459,CSE 293,039,119483,Voelker; Geoffrey M.,9999,0,9999,0
1667985291459,CSE 293,040,119537,Zhao; Jishen,9999,0,9999,0
1667985291459,CSE 293,041,119538,Zhou; Yuan-Yuan,9999,0,9999,0
1667985291459,CSE 293,042,119539,Gao; Sicun,9999,0,9999,0
1667985291459,CSE 293,043,119540,Weibel; Nadir,9999,0,9999,0
1667985291459,CSE 293,044,119541,Gupta; Rajesh K.,9999,0,9999,0
1667985291459,CSE 293,045,126410,Vaccaro; Kristen Marie,9999,0,9999,0
1667985291459,CSE 293,046,126411,Klemke; Richard,9999,0,9999,0
1667985291884,CSE 294,A00,102459,Voelker; Geoffrey M.,0,0,0,0
1667985291884,CSE 294,B00,111322,Orailoglu; Alex,0,0,0,0
1667985292307,DSE 201,A00,096914,Deutsch; Alin Bernard,30,0,30,0
1667985292729,DSE 210,A00,096915,Dasgupta; Sanjoy,30,0,30,0
1667985293153,DSE 260A,A00,096916,Altintas De Callaf; Ilkay,30,0,30,0
1667985293630,ECE 200,001,103586,Antipa; Nicholas A,9999,0,9999,0
1667985293630,ECE 200,002,103587,Atanasov; Nikolay A.,9999,0,9999,0
1667985293630,ECE 200,003,103588,Bharadia; Dinesh,9999,0,9999,0
1667985293630,ECE 200,004,103589,Cheng; Chung Kuan,9999,0,9999,0
1667985293630,ECE 200,005,103590,Cosman; Pamela C.,9999,0,9999,0
1667985293630,ECE 200,006,103591,Dayeh; Shadi Ahmad,9999,0,9999,0
1667985293630,ECE 200,007,103592,Fainman; Yeshaiahu,9999,0,9999,0
1667985293630,ECE 200,008,103593,Ford; Joseph Earl,9999,0,9999,0
1667985293630,ECE 200,009,103594,Franceschetti; Massimo,9999,0,9999,0
1667985293630,ECE 200,010,103595,Fullerton; Eric E,9999,0,9999,0
1667985293630,ECE 200,011,103596,Galton; Ian A,9999,0,9999,0
1667985293630,ECE 200,012,103597,Gilja; Vikash,9999,0,9999,0
1667985293630,ECE 200,013,103598,Hall; Drew A.,9999,0,9999,0
1667985293630,ECE 200,014,103599,Hsueh; Tzu-Chien,9999,0,9999,0
1667985293630,ECE 200,015,103600,Javidi; Tara,9999,0,9999,0
1667985293630,ECE 200,016,103601,Kahng; Andrew Byun,9999,0,9999,0
1667985293630,ECE 200,017,103602,Kim; Young-Han,9999,0,9999,0
1667985293630,ECE 200,018,103603,Koushanfar; Farinaz,9999,0,9999,0
1667985293630,ECE 200,019,103604,Kuzum; Duygu,9999,0,9999,0
1667985293630,ECE 200,020,103605,Le; Hanh-Phuc,9999,0,9999,0
1667985293630,ECE 200,021,103606,Lin; Bill,9999,0,9999,0
1667985293630,ECE 200,022,103607,Liu; Zhaowei,9998,0,9999,1
1667985293630,ECE 200,023,103608,Lo; Yu-Hwa,9999,0,9999,0
1667985293630,ECE 200,024,103609,Lomakin; Vitaliy,9999,0,9999,0
1667985293630,ECE 200,025,103610,Mercier; Patrick Philip,9999,0,9999,0
1667985293630,ECE 200,026,103611,Meyer; Florian,9999,0,9999,0
1667985293630,ECE 200,027,103612,Milstein; Laurence B.,9999,0,9999,0
1667985293630,ECE 200,028,103613,Mir Arabbaygi; Siavash,9999,0,9999,0
1667985293630,ECE 200,029,103614,Mookherjea; Shayan,9999,0,9999,0
1667985293630,ECE 200,030,103615,Morris; Karcher William,9999,0,9999,0
1667985293630,ECE 200,031,103616,Ng; Tse Nga,9999,0,9999,0
1667985293630,ECE 200,032,103617,Nguyen; Truong Quang,9999,0,9999,0
1667985293630,ECE 200,033,103618,Nomura; Kenji,9999,0,9999,0
1667985293630,ECE 200,034,103619,Orlitsky; Alon,9999,0,9999,0
1667985293630,ECE 200,035,103620,Pal; Piya,9999,0,9999,0
1667985293630,ECE 200,036,103621,Papen; George C.,9999,0,9999,0
1667985293630,ECE 200,037,103622,Radic; Stojan,9999,0,9999,0
1667985293630,ECE 200,038,103623,Rao; Bhaskar D.,9999,0,9999,0
1667985293630,ECE 200,039,103624,Rao; Ramesh R,9999,0,9999,0
1667985293630,ECE 200,040,103625,Rebeiz; Gabriel,9999,0,9999,0
1667985293630,ECE 200,041,103626,Sanford; John R,9999,0,9999,0
1667985293630,ECE 200,042,103627,Siegel; Paul H.,9999,0,9999,0
1667985293630,ECE 200,043,103628,Sievenpiper; Daniel F.,9999,0,9999,0
1667985293630,ECE 200,044,103629,Sworder; David D.,9999,0,9999,0
1667985293630,ECE 200,045,103630,Taur; Yuan,9999,0,9999,0
1667985293630,ECE 200,046,103631,Touri; Behrouz,9999,0,9999,0
1667985293630,ECE 200,047,103632,Trivedi; Mohan M.,9999,0,9999,0
1667985293630,ECE 200,048,103633,Vasconcelos; Nuno,9999,0,9999,0
1667985293630,ECE 200,049,103634,Wang; Xiaolong,9999,0,9999,0
1667985293630,ECE 200,050,103635,Xie; Pengtao,9999,0,9999,0
1667985293630,ECE 200,051,103636,Yip; Michael,9999,0,9999,0
1667985293630,ECE 200,052,103637,Zeger; Kenneth A.,999,0,999,0
1667985293630,ECE 200,053,103638,Zhang; Xinyu,9999,0,9999,0
1667985293630,ECE 200,054,103639,Turakhia; Yatish Girish,9999,0,9999,0
1667985293630,ECE 200,055,103640,Kang; Mingu,9999,0,9999,0
1667985293630,ECE 200,056,103641,Shi; Yuanyuan,9999,0,9999,0
1667985293630,ECE 200,057,103642,Wang; Edward Jay,9999,0,9999,0
1667985293630,ECE 200,058,103643,Zheng; Yang,9999,0,9999,0
1667985294053,ECE 202,A00,103644,Kuzum; Duygu,0,0,0,0
1667985294476,ECE 212BN,A00,103646,Ng; Tse Nga,0,0,0,0
1667985294900,ECE 221,A00,111493,Staff,0,0,0,0
1667985295325,ECE 222B,A00,103647,Lomakin; Vitaliy,0,0,0,0
1667985295750,ECE 230B,A00,103648,Taur; Yuan,0,0,0,0
1667985296175,ECE 238B,A00,103649,Garay; Javier,0,0,0,0
1667985296599,ECE 240B,A00,112900,Fainman; Yeshaiahu,0,0,0,0
1667985297024,ECE 247A,A00,103650,Jokerst; Jesse Vincent,0,0,0,0
1667985297454,ECE 247B,A00,103651,Wang; Joseph,0,0,0,0
1667985297882,ECE 250,A00,103652,Siegel; Paul H.,0,0,0,0
1667985298304,ECE 251A,A00,103654,Rao; Bhaskar D.,0,0,0,0
1667985298726,ECE 257B,A00,103655,Bharadia; Dinesh,0,0,0,0
1667985299150,ECE 258A,A00,103656,Milstein; Laurence B.,0,0,0,0
1667985299573,ECE 260B,A00,103658,Kang; Mingu,0,0,0,0
1667985300000,ECE 264A,A00,103659,Galton; Ian A,0,0,0,0
1667985300424,ECE 265A,A00,103661,Gudem; Prasad S.S.,0,0,0,0
1667985300850,ECE 265D,A00,103662,Gudem; Prasad S.S.,0,0,0,0
1667985301277,ECE 268,A00,103663,Koushanfar; Farinaz,0,0,0,0
1667985301705,ECE 269,A01,103665,Pal; Piya,0,0,0,0
1667985302134,ECE 271B,A00,103666,Vasconcelos; Manuela,0,0,0,0
1667985302557,ECE 276A,A00,103667,Atanasov; Nikolay A.,0,0,0,0
1667985302984,ECE 277,A00,103668,An; Cheolhong,0,0,0,0
1667985303411,ECE 279,A00,117947,Hall; Drew A.,0,0,0,0
1667985304266,ECE 283,A00,103670,Hsueh; Tzu-Chien,0,0,0,0
1667985304695,ECE 284,A00,103671,Turakhia; Yatish Girish,0,0,0,0
1667985305118,ECE 285,A00,103672,Zheng; Yang,0,0,0,0
1667985305118,ECE 285,B00,103673,Sworder; David D.,0,0,0,0
1667985305543,ECE 287,A00,103676,Javidi; Tara,0,0,0,0
1667985305969,MATH 200B,A00,098023,Salehi Golsefidy; Alireza,14,0,15,1
1667985306397,MATH 202B,A00,098024,Rhoades; Brendon Patrick,12,0,15,3
1667985306824,MATH 203B,A00,098025,Oprea; Dragos N.,12,0,15,3
1667985307248,MATH 204B,A00,098026,Sorensen; Claus M,14,0,15,1
1667985307676,MATH 208,A00,098027,Izadi; Elham,7,0,10,3
1667985308106,MATH 209,A00,098028,Pollack; Aaron,10,0,10,0
1667985308540,MATH 211A,A00,112919,Rogalski; Daniel,9,0,10,1
1667985308968,MATH 211B,A00,112920,Seward; Brandon M.,9,0,10,1
1667985309396,MATH 218,A00,098029,Li; Bo,10,0,10,0
1667985309823,MATH 220B,A00,098030,Novak; Jonathan I,13,0,15,2
1667985310248,MATH 221A,A00,098031,Ebenfelt; Peter F,13,0,15,2
1667985310676,MATH 231B,A00,098032,Zlatos; Andrej,12,0,15,3
1667985311099,MATH 240B,A00,098033,Ni; Lei,10,0,15,5
1667985311523,MATH 243,A00,098034,Jekel; David Andrew,10,0,10,0
1667985311956,MATH 245A,A00,098035,Nie; Jiawang,0,0,15,16
1667985312381,MATH 248,A00,098036,Bejenaru; Ioan,10,0,10,0
1667985312816,MATH 250B,A00,098037,Spolaor; Luca,14,0,15,1
1667985313245,MATH 258,A00,098038,Ni; Lei,10,0,10,0
1667985313670,MATH 264B,A00,098041,Rhoades; Brendon Patrick,11,0,15,4
1667985314099,MATH 268,A00,098042,Buss; Samuel R,10,0,10,0
1667985314523,MATH 269,A00,098043,Rhoades; Brendon Patrick,10,0,10,0
1667985314952,MATH 270B,A00,098044,Li; Bo,11,0,15,4
1667985315385,MATH 272B,A00,098045,Holst; Michael J,13,0,15,2
1667985315814,MATH 273A,A00,098046,Tian; Xiaochuan,12,0,15,3
1667985316239,MATH 275,A01,098048,Tian; Xiaochuan,6,0,10,4
1667985316669,MATH 278A,A00,098049,Holst; Michael J,8,0,10,2
1667985317094,MATH 278B,A00,098050,Cloninger; Alexander,10,0,10,0
1667985317522,MATH 278C,A00,098051,Nie; Jiawang,8,0,10,2
1667985317957,MATH 280B,A00,098052,Zheng; Tianyi,11,0,15,4
1667985318390,MATH 281B,A00,098053,Bradic; Jelena,4,0,15,11
1667985318814,MATH 282B,A00,098054,Arias-Castro; Ery,2,0,15,13
1667985319241,MATH 285,A00,098055,Fitzsimmons; Patrick J,0,0,15,17
1667985319667,MATH 287B,A00,098056,Arias-Castro; Ery,5,0,15,10
1667985320097,MATH 288,A00,098057,Agarwal; Pooja,9,0,10,1
1667985320097,MATH 288,B00,098058,Zhang; Danna,9,0,10,1
1667985320097,MATH 288,C00,098059,Williams; Ruth J,10,0,10,0
1667985320521,MATH 290B,A00,098060,Roberts; Justin Deritter,14,0,15,1
1667985320944,MATH 292,A00,098061,Belmont; Eva Kinoshita,10,0,10,0
1667985321369,MATH 295,A00,098062,Suk; Andrew Hoon,48,0,50,2
1667985321800,MATH 296,A00,098063,Novak; Jonathan I,20,0,20,0
1667985322225,MATH 297,001,098064,Gamst; Anthony Collins,9997,0,9999,2
1667985823232,COGS 205,A00,101395,Chiba; Andrea,19,0,20,1
1667985823665,COGS 210B,001,101404,Greene; Deanna Jacquelyn,9998,0,9999,1
1667985823665,COGS 210B,002,101417,Xia; Haijun,9999,0,9999,0
1667985823665,COGS 210B,003,101422,Nitz; Douglas A.,9999,0,9999,0
1667985823665,COGS 210B,004,101423,Hollan; James D.,9998,0,9999,1
1667985823665,COGS 210B,005,101424,Deak; Gedeon O.,9999,0,9999,0
1667985823665,COGS 210B,006,101425,Rossano; Federico,9999,0,9999,0
1667985824095,COGS 211B,A00,101427,Coulson; Seana M,9997,0,9999,2
1667985824523,COGS 220,A00,101428,Hollan; James D.,0,0,25,25
1667985824951,COGS 229,A00,101429,Dow; Steven P,18,0,25,7
1667985825377,COGS 230,A00,101430,Klemmer; Scott R,13,0,17,4
1667985825807,COGS 234,A00,101431,Xia; Haijun,7,0,25,18
1667985826236,COGS 260,A00,101432,Kiyonaga; Anastasia,20,0,25,5
1667985826236,COGS 260,B00,101433,Kirsh; David Joel,16,0,25,9
1667985826660,CSE 202,A00,102371,Impagliazzo; Russell,0,0,0,0
1667985827091,CSE 203B,A01,102373,Cheng; Chung Kuan,0,0,0,0
1667985827530,CSE 208,A00,102374,Micciancio; Daniele,0,0,0,0
1667985827959,CSE 209A,A00,112895,Impagliazzo; Russell,0,0,15,15
1667985828383,CSE 209B,A00,108005,Bellare; Mihir,0,0,0,0
1667985828815,CSE 210,A00,113163,Coblenz; Michael J,0,0,0,0
1667985829238,CSE 219,A00,106111,Dow; Steven P,1,0,20,19
1667985829663,CSE 221,A00,102376,Voelker; Geoffrey M.,0,0,0,0
1667985830094,CSE 224,A01,102378,Porter; George M,0,0,0,0
1667985830519,CSE 229A,A00,102379,Savage; Stefan,0,0,0,0
1667985830940,CSE 229C,A00,102380,Munyaka; Imani N. S.,0,0,0,0
1667985831371,CSE 232B,A00,102382,Deutsch; Alin Bernard,0,0,0,0
1667985831798,CSE 234,A01,112904,Kumar; Arun Kumar,0,0,0,0
1667985832223,CSE 237A,A00,102383,Rosing; Tajana Simunic,0,0,0,0
1667985832651,CSE 239A,A00,102384,Deutsch; Alin Bernard,0,0,0,0
1667985833082,CSE 239B,A00,102385,Polikarpova; Nadezhda,0,0,0,0
1667985833505,CSE 240A,A00,102386,Pannuto; Patrick William,0,0,0,0
1667985833936,CSE 240B,A00,102387,Zhao; Jishen,0,0,0,0
1667985834361,CSE 241A,A00,106406,Kang; Mingu,0,0,0,0
1667985834784,CSE 249B,A00,102388,Kahng; Andrew Byun,0,0,8,8
1667985835206,CSE 251B,A01,102392,Cottrell; Garrison W,0,0,0,0
1667985835206,CSE 251B,A02,102393,Cottrell; Garrison W,0,0,0,0
1667985835631,CSE 252B,A00,102394,Ochoa; Benjamin Lawrence,0,0,0,0
1667985836061,CSE 257,A01,102396,Gao; Sicun,0,0,0,0
1667985836485,CSE 272,A00,102397,Li; Tzumao,0,0,0,0
1667985836915,CSE 274,A00,111323,Chern; Albert Ren-Haur,0,0,0,0
1667985837344,CSE 282,A00,102398,Pevzner; Pavel Arkadjevich,0,0,0,0
1667985837769,CSE 284,A00,114175,Gymrek; Melissa Ann,0,0,0,0
1667985838201,CSE 290,A00,102399,Chandraker; Manmohan Krishna,0,0,0,0
1667985838201,CSE 290,B00,102400,Vaccaro; Kristen Marie,0,0,25,25
1667985838201,CSE 290,C00,102414,Pannuto; Patrick William,0,0,25,25
1667985838201,CSE 290,D00,102427,Pevzner; Pavel Arkadjevich,0,0,0,0
1667985838201,CSE 290,E00,102429,Zhao; Jishen,0,0,0,0
1667985838201,CSE 290,F00,102436,Tullsen; Dean Michael,0,0,0,0
1667985838201,CSE 290,G00,102440,Christensen; Henrik I,0,0,20,20
1667985838637,CSE 291,A00,102443,Su; Hao,0,0,0,0
1667985838637,CSE 291,B00,102448,Polikarpova; Nadezhda,0,0,0,0
1667985838637,CSE 291,C00,102453,Vaccaro; Kristen Marie,0,0,0,0
1667985838637,CSE 291,D00,111343,Savage; Stefan,0,0,0,0
1667985838637,CSE 291,E00,116474,Claffy; Kimberly Claire,0,0,0,0
1667985838637,CSE 291,F00,116479,Pasquale; Joseph,0,0,0,0
1667985839082,CSE 293,001,119111,Bafna; Vineet,9999,0,9999,0
1667985839082,CSE 293,002,119118,Bellare; Mihir,9999,0,9999,0
1667985839082,CSE 293,003,119122,Berg-Kirkpatrick; Taylor D,9999,0,9999,0
1667985839082,CSE 293,004,119135,Christensen; Henrik I,9999,0,9999,0
1667985839082,CSE 293,005,119142,Cottrell; Garrison W,9999,0,9999,0
1667985839082,CSE 293,006,119146,Deutsch; Alin Bernard,9999,0,9999,0
1667985839082,CSE 293,007,119159,Esmaeilzadeh; Hadi,9999,0,9999,0
1667985839082,CSE 293,008,119166,Freund; Yoav,9999,0,9999,0
1667985839082,CSE 293,009,119170,Griswold; William G.,9999,0,9999,0
1667985839082,CSE 293,010,119183,Gymrek; Melissa Ann,9999,0,9999,0
1667985839082,CSE 293,011,119190,Heninger; Nadia A,9999,0,9999,0
1667985839082,CSE 293,012,119230,Impagliazzo; Russell,9999,0,9999,0
1667985839082,CSE 293,013,119232,Jhala; Ranjit,9999,0,9999,0
1667985839082,CSE 293,014,119233,Kahng; Andrew Byun,9999,0,9999,0
1667985839082,CSE 293,015,119298,Kane; Daniel Mertz,9999,0,9999,0
1667985839082,CSE 293,016,119299,Kriegman; David J,9999,0,9999,0
1667985839082,CSE 293,017,119300,Kumar; Arun Kumar,9999,0,9999,0
1667985839082,CSE 293,018,119301,Lerner; Sorin,9999,0,9999,0
1667985839082,CSE 293,019,119302,Lovett; Shachar,9999,0,9999,0
1667985839082,CSE 293,020,119303,McAuley; Julian John,9999,0,9999,0
1667985839082,CSE 293,021,119304,Micciancio; Daniele,9999,0,9999,0
1667985839082,CSE 293,022,119367,Orailoglu; Alex,9999,0,9999,0
1667985839082,CSE 293,023,119382,Paturi; Ramamohan,9999,0,9999,0
1667985839082,CSE 293,024,119404,Polikarpova; Nadezhda,9999,0,9999,0
1667985839082,CSE 293,025,119406,Politz; Joseph Gibbs,9999,0,9999,0
1667985839082,CSE 293,026,119411,Porter; George M,9999,0,9999,0
1667985839082,CSE 293,027,119414,Porter; Leonard Emerson,9999,0,9999,0
1667985839082,CSE 293,028,119416,Ramamoorthi; Ravi,9999,0,9999,0
1667985839082,CSE 293,029,119417,Sahoo; Debashis,9999,0,9999,0
1667985839082,CSE 293,030,119420,Saul; Lawrence,9999,0,9999,0
1667985839082,CSE 293,031,119421,Savage; Stefan,9999,0,9999,0
1667985839082,CSE 293,032,119425,Schulze; Jurgen P.,9999,0,9999,0
1667985839082,CSE 293,033,119426,Snoeren; Alex C.,9999,0,9999,0
1667985839082,CSE 293,034,119428,Shang; Jingbo,9999,0,9999,0
1667985839082,CSE 293,035,119430,Stefan; Deian,9999,0,9999,0
1667985839082,CSE 293,036,119431,Su; Hao,9999,0,9999,0
1667985839082,CSE 293,037,119433,Swanson; Steven James,9999,0,9999,0
1667985839082,CSE 293,038,119435,Tullsen; Dean Michael,9999,0,9999,0
1667985839082,CSE 293,039,119483,Voelker; Geoffrey M.,9999,0,9999,0
1667985839082,CSE 293,040,119537,Zhao; Jishen,9999,0,9999,0
1667985839082,CSE 293,041,119538,Zhou; Yuan-Yuan,9999,0,9999,0
1667985839082,CSE 293,042,119539,Gao; Sicun,9999,0,9999,0
1667985839082,CSE 293,043,119540,Weibel; Nadir,9999,0,9999,0
1667985839082,CSE 293,044,119541,Gupta; Rajesh K.,9999,0,9999,0
1667985839082,CSE 293,045,126410,Vaccaro; Kristen Marie,9999,0,9999,0
1667985839082,CSE 293,046,126411,Klemke; Richard,9999,0,9999,0
1667985839507,CSE 294,A00,102459,Voelker; Geoffrey M.,0,0,0,0
1667985839507,CSE 294,B00,111322,Orailoglu; Alex,0,0,0,0
1667985839931,DSE 201,A00,096914,Deutsch; Alin Bernard,30,0,30,0
1667985840355,DSE 210,A00,096915,Dasgupta; Sanjoy,30,0,30,0
1667985840779,DSE 260A,A00,096916,Altintas De Callaf; Ilkay,30,0,30,0
1667985841278,ECE 200,001,103586,Antipa; Nicholas A,9999,0,9999,0
1667985841278,ECE 200,002,103587,Atanasov; Nikolay A.,9999,0,9999,0
1667985841278,ECE 200,003,103588,Bharadia; Dinesh,9999,0,9999,0
1667985841278,ECE 200,004,103589,Cheng; Chung Kuan,9999,0,9999,0
1667985841278,ECE 200,005,103590,Cosman; Pamela C.,9999,0,9999,0
1667985841278,ECE 200,006,103591,Dayeh; Shadi Ahmad,9999,0,9999,0
1667985841278,ECE 200,007,103592,Fainman; Yeshaiahu,9999,0,9999,0
1667985841278,ECE 200,008,103593,Ford; Joseph Earl,9999,0,9999,0
1667985841278,ECE 200,009,103594,Franceschetti; Massimo,9999,0,9999,0
1667985841278,ECE 200,010,103595,Fullerton; Eric E,9999,0,9999,0
1667985841278,ECE 200,011,103596,Galton; Ian A,9999,0,9999,0
1667985841278,ECE 200,012,103597,Gilja; Vikash,9999,0,9999,0
1667985841278,ECE 200,013,103598,Hall; Drew A.,9999,0,9999,0
1667985841278,ECE 200,014,103599,Hsueh; Tzu-Chien,9999,0,9999,0
1667985841278,ECE 200,015,103600,Javidi; Tara,9999,0,9999,0
1667985841278,ECE 200,016,103601,Kahng; Andrew Byun,9999,0,9999,0
1667985841278,ECE 200,017,103602,Kim; Young-Han,9999,0,9999,0
1667985841278,ECE 200,018,103603,Koushanfar; Farinaz,9999,0,9999,0
1667985841278,ECE 200,019,103604,Kuzum; Duygu,9999,0,9999,0
1667985841278,ECE 200,020,103605,Le; Hanh-Phuc,9999,0,9999,0
1667985841278,ECE 200,021,103606,Lin; Bill,9999,0,9999,0
1667985841278,ECE 200,022,103607,Liu; Zhaowei,9998,0,9999,1
1667985841278,ECE 200,023,103608,Lo; Yu-Hwa,9999,0,9999,0
1667985841278,ECE 200,024,103609,Lomakin; Vitaliy,9999,0,9999,0
1667985841278,ECE 200,025,103610,Mercier; Patrick Philip,9999,0,9999,0
1667985841278,ECE 200,026,103611,Meyer; Florian,9999,0,9999,0
1667985841278,ECE 200,027,103612,Milstein; Laurence B.,9999,0,9999,0
1667985841278,ECE 200,028,103613,Mir Arabbaygi; Siavash,9999,0,9999,0
1667985841278,ECE 200,029,103614,Mookherjea; Shayan,9999,0,9999,0
1667985841278,ECE 200,030,103615,Morris; Karcher William,9999,0,9999,0
1667985841278,ECE 200,031,103616,Ng; Tse Nga,9999,0,9999,0
1667985841278,ECE 200,032,103617,Nguyen; Truong Quang,9999,0,9999,0
1667985841278,ECE 200,033,103618,Nomura; Kenji,9999,0,9999,0
1667985841278,ECE 200,034,103619,Orlitsky; Alon,9999,0,9999,0
1667985841278,ECE 200,035,103620,Pal; Piya,9999,0,9999,0
1667985841278,ECE 200,036,103621,Papen; George C.,9999,0,9999,0
1667985841278,ECE 200,037,103622,Radic; Stojan,9999,0,9999,0
1667985841278,ECE 200,038,103623,Rao; Bhaskar D.,9999,0,9999,0
1667985841278,ECE 200,039,103624,Rao; Ramesh R,9999,0,9999,0
1667985841278,ECE 200,040,103625,Rebeiz; Gabriel,9999,0,9999,0
1667985841278,ECE 200,041,103626,Sanford; John R,9999,0,9999,0
1667985841278,ECE 200,042,103627,Siegel; Paul H.,9999,0,9999,0
1667985841278,ECE 200,043,103628,Sievenpiper; Daniel F.,9999,0,9999,0
1667985841278,ECE 200,044,103629,Sworder; David D.,9999,0,9999,0
1667985841278,ECE 200,045,103630,Taur; Yuan,9999,0,9999,0
1667985841278,ECE 200,046,103631,Touri; Behrouz,9999,0,9999,0
1667985841278,ECE 200,047,103632,Trivedi; Mohan M.,9999,0,9999,0
1667985841278,ECE 200,048,103633,Vasconcelos; Nuno,9999,0,9999,0
1667985841278,ECE 200,049,103634,Wang; Xiaolong,9999,0,9999,0
1667985841278,ECE 200,050,103635,Xie; Pengtao,9999,0,9999,0
1667985841278,ECE 200,051,103636,Yip; Michael,9999,0,9999,0
1667985841278,ECE 200,052,103637,Zeger; Kenneth A.,999,0,999,0
1667985841278,ECE 200,053,103638,Zhang; Xinyu,9999,0,9999,0
1667985841278,ECE 200,054,103639,Turakhia; Yatish Girish,9999,0,9999,0
1667985841278,ECE 200,055,103640,Kang; Mingu,9999,0,9999,0
1667985841278,ECE 200,056,103641,Shi; Yuanyuan,9999,0,9999,0
1667985841278,ECE 200,057,103642,Wang; Edward Jay,9999,0,9999,0
1667985841278,ECE 200,058,103643,Zheng; Yang,9999,0,9999,0
1667985841702,ECE 202,A00,103644,Kuzum; Duygu,0,0,0,0
1667985842134,ECE 212BN,A00,103646,Ng; Tse Nga,0,0,0,0
1667985842565,ECE 221,A00,111493,Staff,0,0,0,0
1667985842989,ECE 222B,A00,103647,Lomakin; Vitaliy,0,0,0,0
1667985843442,ECE 230B,A00,103648,Taur; Yuan,0,0,0,0
1667985843868,ECE 238B,A00,103649,Garay; Javier,0,0,0,0
1667985844291,ECE 240B,A00,112900,Fainman; Yeshaiahu,0,0,0,0
1667985844719,ECE 247A,A00,103650,Jokerst; Jesse Vincent,0,0,0,0
1667985845149,ECE 247B,A00,103651,Wang; Joseph,0,0,0,0
1667985845580,ECE 250,A00,103652,Siegel; Paul H.,0,0,0,0
1667985846004,ECE 251A,A00,103654,Rao; Bhaskar D.,0,0,0,0
1667985846426,ECE 257B,A00,103655,Bharadia; Dinesh,0,0,0,0
1667985846851,ECE 258A,A00,103656,Milstein; Laurence B.,0,0,0,0
1667985847275,ECE 260B,A00,103658,Kang; Mingu,0,0,0,0
1667985847708,ECE 264A,A00,103659,Galton; Ian A,0,0,0,0
1667985848142,ECE 265A,A00,103661,Gudem; Prasad S.S.,0,0,0,0
1667985848565,ECE 265D,A00,103662,Gudem; Prasad S.S.,0,0,0,0
1667985849064,ECE 268,A00,103663,Koushanfar; Farinaz,0,0,0,0
1667985849487,ECE 269,A01,103665,Pal; Piya,0,0,0,0
1667985849913,ECE 271B,A00,103666,Vasconcelos; Manuela,0,0,0,0
1667985850338,ECE 276A,A00,103667,Atanasov; Nikolay A.,0,0,0,0
1667985850774,ECE 277,A00,103668,An; Cheolhong,0,0,0,0
1667985851198,ECE 279,A00,117947,Hall; Drew A.,0,0,0,0
1667985852045,ECE 283,A00,103670,Hsueh; Tzu-Chien,0,0,0,0
1667985852470,ECE 284,A00,103671,Turakhia; Yatish Girish,0,0,0,0
1667985852894,ECE 285,A00,103672,Zheng; Yang,0,0,0,0
1667985852894,ECE 285,B00,103673,Sworder; David D.,0,0,0,0
1667985853319,ECE 287,A00,103676,Javidi; Tara,0,0,0,0
1667985853744,MATH 200B,A00,098023,Salehi Golsefidy; Alireza,14,0,15,1
1667985854169,MATH 202B,A00,098024,Rhoades; Brendon Patrick,12,0,15,3
1667985854600,MATH 203B,A00,098025,Oprea; Dragos N.,12,0,15,3
1667985855024,MATH 204B,A00,098026,Sorensen; Claus M,14,0,15,1
1667985855447,MATH 208,A00,098027,Izadi; Elham,7,0,10,3
1667985855872,MATH 209,A00,098028,Pollack; Aaron,10,0,10,0
1667985856302,MATH 211A,A00,112919,Rogalski; Daniel,9,0,10,1
1667985856732,MATH 211B,A00,112920,Seward; Brandon M.,9,0,10,1
1667985857161,MATH 218,A00,098029,Li; Bo,10,0,10,0
1667985857586,MATH 220B,A00,098030,Novak; Jonathan I,13,0,15,2
1667985858011,MATH 221A,A00,098031,Ebenfelt; Peter F,13,0,15,2
1667985858437,MATH 231B,A00,098032,Zlatos; Andrej,12,0,15,3
1667985858866,MATH 240B,A00,098033,Ni; Lei,10,0,15,5
1667985859292,MATH 243,A00,098034,Jekel; David Andrew,10,0,10,0
1667985859716,MATH 245A,A00,098035,Nie; Jiawang,0,0,15,16
1667985860146,MATH 248,A00,098036,Bejenaru; Ioan,10,0,10,0
1667985860577,MATH 250B,A00,098037,Spolaor; Luca,14,0,15,1
1667985861002,MATH 258,A00,098038,Ni; Lei,10,0,10,0
1667985861426,MATH 264B,A00,098041,Rhoades; Brendon Patrick,11,0,15,4
1667985861850,MATH 268,A00,098042,Buss; Samuel R,10,0,10,0
1667985862277,MATH 269,A00,098043,Rhoades; Brendon Patrick,10,0,10,0
1667985862702,MATH 270B,A00,098044,Li; Bo,11,0,15,4
1667985863134,MATH 272B,A00,098045,Holst; Michael J,13,0,15,2
1667985863560,MATH 273A,A00,098046,Tian; Xiaochuan,12,0,15,3
1667985863985,MATH 275,A01,098048,Tian; Xiaochuan,6,0,10,4
1667985864409,MATH 278A,A00,098049,Holst; Michael J,8,0,10,2
1667985864836,MATH 278B,A00,098050,Cloninger; Alexander,10,0,10,0
1667985865260,MATH 278C,A00,098051,Nie; Jiawang,8,0,10,2
1667985865698,MATH 280B,A00,098052,Zheng; Tianyi,11,0,15,4
1667985866126,MATH 281B,A00,098053,Bradic; Jelena,4,0,15,11
1667985866550,MATH 282B,A00,098054,Arias-Castro; Ery,2,0,15,13
1667985866981,MATH 285,A00,098055,Fitzsimmons; Patrick J,0,0,15,17
1667985867405,MATH 287B,A00,098056,Arias-Castro; Ery,5,0,15,10
1667985867829,MATH 288,A00,098057,Agarwal; Pooja,9,0,10,1
1667985867829,MATH 288,B00,098058,Zhang; Danna,9,0,10,1
1667985867829,MATH 288,C00,098059,Williams; Ruth J,10,0,10,0
1667985868260,MATH 290B,A00,098060,Roberts; Justin Deritter,14,0,15,1
1667985868696,MATH 292,A00,098061,Belmont; Eva Kinoshita,10,0,10,0
1667985869122,MATH 295,A00,098062,Suk; Andrew Hoon,48,0,50,2
1667985869544,MATH 296,A00,098063,Novak; Jonathan I,20,0,20,0
1667985869978,MATH 297,001,098064,Gamst; Anthony Collins,9997,0,9999,2
1667986371293,COGS 205,A00,101395,Chiba; Andrea,19,0,20,1
1667986371718,COGS 210B,001,101404,Greene; Deanna Jacquelyn,9998,0,9999,1
1667986371718,COGS 210B,002,101417,Xia; Haijun,9999,0,9999,0
1667986371718,COGS 210B,003,101422,Nitz; Douglas A.,9999,0,9999,0
1667986371718,COGS 210B,004,101423,Hollan; James D.,9998,0,9999,1
1667986371718,COGS 210B,005,101424,Deak; Gedeon O.,9999,0,9999,0
1667986371718,COGS 210B,006,101425,Rossano; Federico,9999,0,9999,0
1667986372145,COGS 211B,A00,101427,Coulson; Seana M,9997,0,9999,2
1667986372570,COGS 220,A00,101428,Hollan; James D.,0,0,25,25
1667986372997,COGS 229,A00,101429,Dow; Steven P,18,0,25,7
1667986373428,COGS 230,A00,101430,Klemmer; Scott R,13,0,17,4
1667986373852,COGS 234,A00,101431,Xia; Haijun,7,0,25,18
1667986374278,COGS 260,A00,101432,Kiyonaga; Anastasia,20,0,25,5
1667986374278,COGS 260,B00,101433,Kirsh; David Joel,16,0,25,9
1667986374706,CSE 202,A00,102371,Impagliazzo; Russell,0,0,0,0
1667986375132,CSE 203B,A01,102373,Cheng; Chung Kuan,0,0,0,0
1667986375559,CSE 208,A00,102374,Micciancio; Daniele,0,0,0,0
1667986375992,CSE 209A,A00,112895,Impagliazzo; Russell,0,0,15,15
1667986376415,CSE 209B,A00,108005,Bellare; Mihir,0,0,0,0
1667986376846,CSE 210,A00,113163,Coblenz; Michael J,0,0,0,0
1667986377271,CSE 219,A00,106111,Dow; Steven P,1,0,20,19
1667986377706,CSE 221,A00,102376,Voelker; Geoffrey M.,0,0,0,0
1667986378132,CSE 224,A01,102378,Porter; George M,0,0,0,0
1667986378566,CSE 229A,A00,102379,Savage; Stefan,0,0,0,0
1667986378988,CSE 229C,A00,102380,Munyaka; Imani N. S.,0,0,0,0
1667986379413,CSE 232B,A00,102382,Deutsch; Alin Bernard,0,0,0,0
1667986379837,CSE 234,A01,112904,Kumar; Arun Kumar,0,0,0,0
1667986380266,CSE 237A,A00,102383,Rosing; Tajana Simunic,0,0,0,0
1667986380690,CSE 239A,A00,102384,Deutsch; Alin Bernard,0,0,0,0
1667986381117,CSE 239B,A00,102385,Polikarpova; Nadezhda,0,0,0,0
1667986381541,CSE 240A,A00,102386,Pannuto; Patrick William,0,0,0,0
1667986381966,CSE 240B,A00,102387,Zhao; Jishen,0,0,0,0
1667986382391,CSE 241A,A00,106406,Kang; Mingu,0,0,0,0
1667986382818,CSE 249B,A00,102388,Kahng; Andrew Byun,0,0,8,8
1667986383250,CSE 251B,A01,102392,Cottrell; Garrison W,0,0,0,0
1667986383250,CSE 251B,A02,102393,Cottrell; Garrison W,0,0,0,0
1667986383677,CSE 252B,A00,102394,Ochoa; Benjamin Lawrence,0,0,0,0
1667986384110,CSE 257,A01,102396,Gao; Sicun,0,0,0,0
1667986384539,CSE 272,A00,102397,Li; Tzumao,0,0,0,0
1667986384963,CSE 274,A00,111323,Chern; Albert Ren-Haur,0,0,0,0
1667986385392,CSE 282,A00,102398,Pevzner; Pavel Arkadjevich,0,0,0,0
1667986385816,CSE 284,A00,114175,Gymrek; Melissa Ann,0,0,0,0
1667986386241,CSE 290,A00,102399,Chandraker; Manmohan Krishna,0,0,0,0
1667986386241,CSE 290,B00,102400,Vaccaro; Kristen Marie,0,0,25,25
1667986386241,CSE 290,C00,102414,Pannuto; Patrick William,0,0,25,25
1667986386241,CSE 290,D00,102427,Pevzner; Pavel Arkadjevich,0,0,0,0
1667986386241,CSE 290,E00,102429,Zhao; Jishen,0,0,0,0
1667986386241,CSE 290,F00,102436,Tullsen; Dean Michael,0,0,0,0
1667986386241,CSE 290,G00,102440,Christensen; Henrik I,0,0,20,20
1667986386678,CSE 291,A00,102443,Su; Hao,0,0,0,0
1667986386678,CSE 291,B00,102448,Polikarpova; Nadezhda,0,0,0,0
1667986386678,CSE 291,C00,102453,Vaccaro; Kristen Marie,0,0,0,0
1667986386678,CSE 291,D00,111343,Savage; Stefan,0,0,0,0
1667986386678,CSE 291,E00,116474,Claffy; Kimberly Claire,0,0,0,0
1667986386678,CSE 291,F00,116479,Pasquale; Joseph,0,0,0,0
1667986387118,CSE 293,001,119111,Bafna; Vineet,9999,0,9999,0
1667986387118,CSE 293,002,119118,Bellare; Mihir,9999,0,9999,0
1667986387118,CSE 293,003,119122,Berg-Kirkpatrick; Taylor D,9999,0,9999,0
1667986387118,CSE 293,004,119135,Christensen; Henrik I,9999,0,9999,0
1667986387118,CSE 293,005,119142,Cottrell; Garrison W,9999,0,9999,0
1667986387118,CSE 293,006,119146,Deutsch; Alin Bernard,9999,0,9999,0
1667986387118,CSE 293,007,119159,Esmaeilzadeh; Hadi,9999,0,9999,0
1667986387118,CSE 293,008,119166,Freund; Yoav,9999,0,9999,0
1667986387118,CSE 293,009,119170,Griswold; William G.,9999,0,9999,0
1667986387118,CSE 293,010,119183,Gymrek; Melissa Ann,9999,0,9999,0
1667986387118,CSE 293,011,119190,Heninger; Nadia A,9999,0,9999,0
1667986387118,CSE 293,012,119230,Impagliazzo; Russell,9999,0,9999,0
1667986387118,CSE 293,013,119232,Jhala; Ranjit,9999,0,9999,0
1667986387118,CSE 293,014,119233,Kahng; Andrew Byun,9999,0,9999,0
1667986387118,CSE 293,015,119298,Kane; Daniel Mertz,9999,0,9999,0
1667986387118,CSE 293,016,119299,Kriegman; David J,9999,0,9999,0
1667986387118,CSE 293,017,119300,Kumar; Arun Kumar,9999,0,9999,0
1667986387118,CSE 293,018,119301,Lerner; Sorin,9999,0,9999,0
1667986387118,CSE 293,019,119302,Lovett; Shachar,9999,0,9999,0
1667986387118,CSE 293,020,119303,McAuley; Julian John,9999,0,9999,0
1667986387118,CSE 293,021,119304,Micciancio; Daniele,9999,0,9999,0
1667986387118,CSE 293,022,119367,Orailoglu; Alex,9999,0,9999,0
1667986387118,CSE 293,023,119382,Paturi; Ramamohan,9999,0,9999,0
1667986387118,CSE 293,024,119404,Polikarpova; Nadezhda,9999,0,9999,0
1667986387118,CSE 293,025,119406,Politz; Joseph Gibbs,9999,0,9999,0
1667986387118,CSE 293,026,119411,Porter; George M,9999,0,9999,0
1667986387118,CSE 293,027,119414,Porter; Leonard Emerson,9999,0,9999,0
1667986387118,CSE 293,028,119416,Ramamoorthi; Ravi,9999,0,9999,0
1667986387118,CSE 293,029,119417,Sahoo; Debashis,9999,0,9999,0
1667986387118,CSE 293,030,119420,Saul; Lawrence,9999,0,9999,0
1667986387118,CSE 293,031,119421,Savage; Stefan,9999,0,9999,0
1667986387118,CSE 293,032,119425,Schulze; Jurgen P.,9999,0,9999,0
1667986387118,CSE 293,033,119426,Snoeren; Alex C.,9999,0,9999,0
1667986387118,CSE 293,034,119428,Shang; Jingbo,9999,0,9999,0
1667986387118,CSE 293,035,119430,Stefan; Deian,9999,0,9999,0
1667986387118,CSE 293,036,119431,Su; Hao,9999,0,9999,0
1667986387118,CSE 293,037,119433,Swanson; Steven James,9999,0,9999,0
1667986387118,CSE 293,038,119435,Tullsen; Dean Michael,9999,0,9999,0
1667986387118,CSE 293,039,119483,Voelker; Geoffrey M.,9999,0,9999,0
1667986387118,CSE 293,040,119537,Zhao; Jishen,9999,0,9999,0
1667986387118,CSE 293,041,119538,Zhou; Yuan-Yuan,9999,0,9999,0
1667986387118,CSE 293,042,119539,Gao; Sicun,9999,0,9999,0
1667986387118,CSE 293,043,119540,Weibel; Nadir,9999,0,9999,0
1667986387118,CSE 293,044,119541,Gupta; Rajesh K.,9999,0,9999,0
1667986387118,CSE 293,045,126410,Vaccaro; Kristen Marie,9999,0,9999,0
1667986387118,CSE 293,046,126411,Klemke; Richard,9999,0,9999,0
1667986387543,CSE 294,A00,102459,Voelker; Geoffrey M.,0,0,0,0
1667986387543,CSE 294,B00,111322,Orailoglu; Alex,0,0,0,0
1667986387967,DSE 201,A00,096914,Deutsch; Alin Bernard,30,0,30,0
1667986388392,DSE 210,A00,096915,Dasgupta; Sanjoy,30,0,30,0
1667986388817,DSE 260A,A00,096916,Altintas De Callaf; Ilkay,30,0,30,0
1667986389300,ECE 200,001,103586,Antipa; Nicholas A,9999,0,9999,0
1667986389300,ECE 200,002,103587,Atanasov; Nikolay A.,9999,0,9999,0
1667986389300,ECE 200,003,103588,Bharadia; Dinesh,9999,0,9999,0
1667986389300,ECE 200,004,103589,Cheng; Chung Kuan,9999,0,9999,0
1667986389300,ECE 200,005,103590,Cosman; Pamela C.,9999,0,9999,0
1667986389300,ECE 200,006,103591,Dayeh; Shadi Ahmad,9999,0,9999,0
1667986389300,ECE 200,007,103592,Fainman; Yeshaiahu,9999,0,9999,0
1667986389300,ECE 200,008,103593,Ford; Joseph Earl,9999,0,9999,0
1667986389300,ECE 200,009,103594,Franceschetti; Massimo,9999,0,9999,0
1667986389300,ECE 200,010,103595,Fullerton; Eric E,9999,0,9999,0
1667986389300,ECE 200,011,103596,Galton; Ian A,9999,0,9999,0
1667986389300,ECE 200,012,103597,Gilja; Vikash,9999,0,9999,0
1667986389300,ECE 200,013,103598,Hall; Drew A.,9999,0,9999,0
1667986389300,ECE 200,014,103599,Hsueh; Tzu-Chien,9999,0,9999,0
1667986389300,ECE 200,015,103600,Javidi; Tara,9999,0,9999,0
1667986389300,ECE 200,016,103601,Kahng; Andrew Byun,9999,0,9999,0
1667986389300,ECE 200,017,103602,Kim; Young-Han,9999,0,9999,0
1667986389300,ECE 200,018,103603,Koushanfar; Farinaz,9999,0,9999,0
1667986389300,ECE 200,019,103604,Kuzum; Duygu,9999,0,9999,0
1667986389300,ECE 200,020,103605,Le; Hanh-Phuc,9999,0,9999,0
1667986389300,ECE 200,021,103606,Lin; Bill,9999,0,9999,0
1667986389300,ECE 200,022,103607,Liu; Zhaowei,9998,0,9999,1
1667986389300,ECE 200,023,103608,Lo; Yu-Hwa,9999,0,9999,0
1667986389300,ECE 200,024,103609,Lomakin; Vitaliy,9999,0,9999,0
1667986389300,ECE 200,025,103610,Mercier; Patrick Philip,9999,0,9999,0
1667986389300,ECE 200,026,103611,Meyer; Florian,9999,0,9999,0
1667986389300,ECE 200,027,103612,Milstein; Laurence B.,9999,0,9999,0
1667986389300,ECE 200,028,103613,Mir Arabbaygi; Siavash,9999,0,9999,0
1667986389300,ECE 200,029,103614,Mookherjea; Shayan,9999,0,9999,0
1667986389300,ECE 200,030,103615,Morris; Karcher William,9999,0,9999,0
1667986389300,ECE 200,031,103616,Ng; Tse Nga,9999,0,9999,0
1667986389300,ECE 200,032,103617,Nguyen; Truong Quang,9999,0,9999,0
1667986389300,ECE 200,033,103618,Nomura; Kenji,9999,0,9999,0
1667986389300,ECE 200,034,103619,Orlitsky; Alon,9999,0,9999,0
1667986389300,ECE 200,035,103620,Pal; Piya,9999,0,9999,0
1667986389300,ECE 200,036,103621,Papen; George C.,9999,0,9999,0
1667986389300,ECE 200,037,103622,Radic; Stojan,9999,0,9999,0
1667986389300,ECE 200,038,103623,Rao; Bhaskar D.,9999,0,9999,0
1667986389300,ECE 200,039,103624,Rao; Ramesh R,9999,0,9999,0
1667986389300,ECE 200,040,103625,Rebeiz; Gabriel,9999,0,9999,0
1667986389300,ECE 200,041,103626,Sanford; John R,9999,0,9999,0
1667986389300,ECE 200,042,103627,Siegel; Paul H.,9999,0,9999,0
1667986389300,ECE 200,043,103628,Sievenpiper; Daniel F.,9999,0,9999,0
1667986389300,ECE 200,044,103629,Sworder; David D.,9999,0,9999,0
1667986389300,ECE 200,045,103630,Taur; Yuan,9999,0,9999,0
1667986389300,ECE 200,046,103631,Touri; Behrouz,9999,0,9999,0
1667986389300,ECE 200,047,103632,Trivedi; Mohan M.,9999,0,9999,0
1667986389300,ECE 200,048,103633,Vasconcelos; Nuno,9999,0,9999,0
1667986389300,ECE 200,049,103634,Wang; Xiaolong,9999,0,9999,0
1667986389300,ECE 200,050,103635,Xie; Pengtao,9999,0,9999,0
1667986389300,ECE 200,051,103636,Yip; Michael,9999,0,9999,0
1667986389300,ECE 200,052,103637,Zeger; Kenneth A.,999,0,999,0
1667986389300,ECE 200,053,103638,Zhang; Xinyu,9999,0,9999,0
1667986389300,ECE 200,054,103639,Turakhia; Yatish Girish,9999,0,9999,0
1667986389300,ECE 200,055,103640,Kang; Mingu,9999,0,9999,0
1667986389300,ECE 200,056,103641,Shi; Yuanyuan,9999,0,9999,0
1667986389300,ECE 200,057,103642,Wang; Edward Jay,9999,0,9999,0
1667986389300,ECE 200,058,103643,Zheng; Yang,9999,0,9999,0
1667986389728,ECE 202,A00,103644,Kuzum; Duygu,0,0,0,0
1667986390152,ECE 212BN,A00,103646,Ng; Tse Nga,0,0,0,0
1667986390575,ECE 221,A00,111493,Staff,0,0,0,0
1667986390999,ECE 222B,A00,103647,Lomakin; Vitaliy,0,0,0,0
1667986391425,ECE 230B,A00,103648,Taur; Yuan,0,0,0,0
1667986391853,ECE 238B,A00,103649,Garay; Javier,0,0,0,0
1667986392277,ECE 240B,A00,112900,Fainman; Yeshaiahu,0,0,0,0
1667986392701,ECE 247A,A00,103650,Jokerst; Jesse Vincent,0,0,0,0
1667986393127,ECE 247B,A00,103651,Wang; Joseph,0,0,0,0
1667986393557,ECE 250,A00,103652,Siegel; Paul H.,0,0,0,0
1667986393982,ECE 251A,A00,103654,Rao; Bhaskar D.,0,0,0,0
1667986394404,ECE 257B,A00,103655,Bharadia; Dinesh,0,0,0,0
1667986394833,ECE 258A,A00,103656,Milstein; Laurence B.,0,0,0,0
1667986395258,ECE 260B,A00,103658,Kang; Mingu,0,0,0,0
1667986395682,ECE 264A,A00,103659,Galton; Ian A,0,0,0,0
1667986396107,ECE 265A,A00,103661,Gudem; Prasad S.S.,0,0,0,0
1667986396531,ECE 265D,A00,103662,Gudem; Prasad S.S.,0,0,0,0
1667986396956,ECE 268,A00,103663,Koushanfar; Farinaz,0,0,0,0
1667986397381,ECE 269,A01,103665,Pal; Piya,0,0,0,0
1667986397810,ECE 271B,A00,103666,Vasconcelos; Manuela,0,0,0,0
1667986398241,ECE 276A,A00,103667,Atanasov; Nikolay A.,0,0,0,0
1667986398833,ECE 277,A00,103668,An; Cheolhong,0,0,0,0
1667986399273,ECE 279,A00,117947,Hall; Drew A.,0,0,0,0
1667986400132,ECE 283,A00,103670,Hsueh; Tzu-Chien,0,0,0,0
1667986400558,ECE 284,A00,103671,Turakhia; Yatish Girish,0,0,0,0
1667986400984,ECE 285,A00,103672,Zheng; Yang,0,0,0,0
1667986400984,ECE 285,B00,103673,Sworder; David D.,0,0,0,0
1667986401412,ECE 287,A00,103676,Javidi; Tara,0,0,0,0
1667986401843,MATH 200B,A00,098023,Salehi Golsefidy; Alireza,14,0,15,1
1667986402271,MATH 202B,A00,098024,Rhoades; Brendon Patrick,12,0,15,3
1667986402701,MATH 203B,A00,098025,Oprea; Dragos N.,12,0,15,3
1667986403138,MATH 204B,A00,098026,Sorensen; Claus M,14,0,15,1
1667986403568,MATH 208,A00,098027,Izadi; Elham,7,0,10,3
1667986403995,MATH 209,A00,098028,Pollack; Aaron,10,0,10,0
1667986404436,MATH 211A,A00,112919,Rogalski; Daniel,9,0,10,1
1667986404861,MATH 211B,A00,112920,Seward; Brandon M.,9,0,10,1
1667986405286,MATH 218,A00,098029,Li; Bo,10,0,10,0
1667986405709,MATH 220B,A00,098030,Novak; Jonathan I,13,0,15,2
1667986406139,MATH 221A,A00,098031,Ebenfelt; Peter F,13,0,15,2
1667986406576,MATH 231B,A00,098032,Zlatos; Andrej,12,0,15,3
1667986407004,MATH 240B,A00,098033,Ni; Lei,10,0,15,5
1667986407433,MATH 243,A00,098034,Jekel; David Andrew,10,0,10,0
1667986407863,MATH 245A,A00,098035,Nie; Jiawang,0,0,15,16
1667986408298,MATH 248,A00,098036,Bejenaru; Ioan,10,0,10,0
1667986408729,MATH 250B,A00,098037,Spolaor; Luca,14,0,15,1
1667986409155,MATH 258,A00,098038,Ni; Lei,10,0,10,0
1667986409582,MATH 264B,A00,098041,Rhoades; Brendon Patrick,11,0,15,4
1667986410009,MATH 268,A00,098042,Buss; Samuel R,10,0,10,0
1667986410437,MATH 269,A00,098043,Rhoades; Brendon Patrick,10,0,10,0
1667986410862,MATH 270B,A00,098044,Li; Bo,11,0,15,4
1667986411290,MATH 272B,A00,098045,Holst; Michael J,13,0,15,2
1667986411728,MATH 273A,A00,098046,Tian; Xiaochuan,12,0,15,3
1667986412158,MATH 275,A01,098048,Tian; Xiaochuan,6,0,10,4
1667986412581,MATH 278A,A00,098049,Holst; Michael J,8,0,10,2
1667986413003,MATH 278B,A00,098050,Cloninger; Alexander,10,0,10,0
1667986413427,MATH 278C,A00,098051,Nie; Jiawang,8,0,10,2
1667986413946,MATH 280B,A00,098052,Zheng; Tianyi,11,0,15,4
1667986414376,MATH 281B,A00,098053,Bradic; Jelena,4,0,15,11
1667986414800,MATH 282B,A00,098054,Arias-Castro; Ery,2,0,15,13
1667986415226,MATH 285,A00,098055,Fitzsimmons; Patrick J,0,0,15,17
1667986415651,MATH 287B,A00,098056,Arias-Castro; Ery,5,0,15,10
1667986416078,MATH 288,A00,098057,Agarwal; Pooja,9,0,10,1
1667986416078,MATH 288,B00,098058,Zhang; Danna,9,0,10,1
1667986416078,MATH 288,C00,098059,Williams; Ruth J,10,0,10,0
1667986416506,MATH 290B,A00,098060,Roberts; Justin Deritter,14,0,15,1
1667986416941,MATH 292,A00,098061,Belmont; Eva Kinoshita,10,0,10,0
1667986417370,MATH 295,A00,098062,Suk; Andrew Hoon,48,0,50,2
1667986417797,MATH 296,A00,098063,Novak; Jonathan I,20,0,20,0
1667986418230,MATH 297,001,098064,Gamst; Anthony Collins,9997,0,9999,2
1667986918979,COGS 205,A00,101395,Chiba; Andrea,19,0,20,1
1667986919422,COGS 210B,001,101404,Greene; Deanna Jacquelyn,9998,0,9999,1
1667986919422,COGS 210B,002,101417,Xia; Haijun,9999,0,9999,0
1667986919422,COGS 210B,003,101422,Nitz; Douglas A.,9999,0,9999,0
1667986919422,COGS 210B,004,101423,Hollan; James D.,9998,0,9999,1
1667986919422,COGS 210B,005,101424,Deak; Gedeon O.,9999,0,9999,0
1667986919422,COGS 210B,006,101425,Rossano; Federico,9999,0,9999,0
1667986919847,COGS 211B,A00,101427,Coulson; Seana M,9997,0,9999,2
1667986920280,COGS 220,A00,101428,Hollan; James D.,0,0,25,25
1667986920703,COGS 229,A00,101429,Dow; Steven P,18,0,25,7
1667986921129,COGS 230,A00,101430,Klemmer; Scott R,13,0,17,4
1667986921557,COGS 234,A00,101431,Xia; Haijun,7,0,25,18
1667986921983,COGS 260,A00,101432,Kiyonaga; Anastasia,20,0,25,5
1667986921983,COGS 260,B00,101433,Kirsh; David Joel,16,0,25,9
1667986922422,CSE 202,A00,102371,Impagliazzo; Russell,0,0,0,0
1667986922850,CSE 203B,A01,102373,Cheng; Chung Kuan,0,0,0,0
1667986923273,CSE 208,A00,102374,Micciancio; Daniele,0,0,0,0
1667986923697,CSE 209A,A00,112895,Impagliazzo; Russell,0,0,15,15
1667986924122,CSE 209B,A00,108005,Bellare; Mihir,0,0,0,0
1667986924548,CSE 210,A00,113163,Coblenz; Michael J,0,0,0,0
1667986924974,CSE 219,A00,106111,Dow; Steven P,1,0,20,19
1667986925402,CSE 221,A00,102376,Voelker; Geoffrey M.,0,0,0,0
1667986925832,CSE 224,A01,102378,Porter; George M,0,0,0,0
1667986926261,CSE 229A,A00,102379,Savage; Stefan,0,0,0,0
1667986926683,CSE 229C,A00,102380,Munyaka; Imani N. S.,0,0,0,0
1667986927110,CSE 232B,A00,102382,Deutsch; Alin Bernard,0,0,0,0
1667986927538,CSE 234,A01,112904,Kumar; Arun Kumar,0,0,0,0
1667986927965,CSE 237A,A00,102383,Rosing; Tajana Simunic,0,0,0,0
1667986928389,CSE 239A,A00,102384,Deutsch; Alin Bernard,0,0,0,0
1667986928817,CSE 239B,A00,102385,Polikarpova; Nadezhda,0,0,0,0
1667986929242,CSE 240A,A00,102386,Pannuto; Patrick William,0,0,0,0
1667986929667,CSE 240B,A00,102387,Zhao; Jishen,0,0,0,0
1667986930092,CSE 241A,A00,106406,Kang; Mingu,0,0,0,0
1667986930515,CSE 249B,A00,102388,Kahng; Andrew Byun,0,0,8,8
1667986930943,CSE 251B,A01,102392,Cottrell; Garrison W,0,0,0,0
1667986930943,CSE 251B,A02,102393,Cottrell; Garrison W,0,0,0,0
1667986931368,CSE 252B,A00,102394,Ochoa; Benjamin Lawrence,0,0,0,0
1667986931791,CSE 257,A01,102396,Gao; Sicun,0,0,0,0
1667986932217,CSE 272,A00,102397,Li; Tzumao,0,0,0,0
1667986932645,CSE 274,A00,111323,Chern; Albert Ren-Haur,0,0,0,0
1667986933074,CSE 282,A00,102398,Pevzner; Pavel Arkadjevich,0,0,0,0
1667986933497,CSE 284,A00,114175,Gymrek; Melissa Ann,0,0,0,0
1667986933925,CSE 290,A00,102399,Chandraker; Manmohan Krishna,0,0,0,0
1667986933925,CSE 290,B00,102400,Vaccaro; Kristen Marie,0,0,25,25
1667986933925,CSE 290,C00,102414,Pannuto; Patrick William,0,0,25,25
1667986933925,CSE 290,D00,102427,Pevzner; Pavel Arkadjevich,0,0,0,0
1667986933925,CSE 290,E00,102429,Zhao; Jishen,0,0,0,0
1667986933925,CSE 290,F00,102436,Tullsen; Dean Michael,0,0,0,0
1667986933925,CSE 290,G00,102440,Christensen; Henrik I,0,0,20,20
1667986934362,CSE 291,A00,102443,Su; Hao,0,0,0,0
1667986934362,CSE 291,B00,102448,Polikarpova; Nadezhda,0,0,0,0
1667986934362,CSE 291,C00,102453,Vaccaro; Kristen Marie,0,0,0,0
1667986934362,CSE 291,D00,111343,Savage; Stefan,0,0,0,0
1667986934362,CSE 291,E00,116474,Claffy; Kimberly Claire,0,0,0,0
1667986934362,CSE 291,F00,116479,Pasquale; Joseph,0,0,0,0
1667986934925,CSE 293,001,119111,Bafna; Vineet,9999,0,9999,0
1667986934925,CSE 293,002,119118,Bellare; Mihir,9999,0,9999,0
1667986934925,CSE 293,003,119122,Berg-Kirkpatrick; Taylor D,9999,0,9999,0
1667986934925,CSE 293,004,119135,Christensen; Henrik I,9999,0,9999,0
1667986934925,CSE 293,005,119142,Cottrell; Garrison W,9999,0,9999,0
1667986934925,CSE 293,006,119146,Deutsch; Alin Bernard,9999,0,9999,0
1667986934925,CSE 293,007,119159,Esmaeilzadeh; Hadi,9999,0,9999,0
1667986934925,CSE 293,008,119166,Freund; Yoav,9999,0,9999,0
1667986934925,CSE 293,009,119170,Griswold; William G.,9999,0,9999,0
1667986934925,CSE 293,010,119183,Gymrek; Melissa Ann,9999,0,9999,0
1667986934925,CSE 293,011,119190,Heninger; Nadia A,9999,0,9999,0
1667986934925,CSE 293,012,119230,Impagliazzo; Russell,9999,0,9999,0
1667986934925,CSE 293,013,119232,Jhala; Ranjit,9999,0,9999,0
1667986934925,CSE 293,014,119233,Kahng; Andrew Byun,9999,0,9999,0
1667986934925,CSE 293,015,119298,Kane; Daniel Mertz,9999,0,9999,0
1667986934925,CSE 293,016,119299,Kriegman; David J,9999,0,9999,0
1667986934925,CSE 293,017,119300,Kumar; Arun Kumar,9999,0,9999,0
1667986934925,CSE 293,018,119301,Lerner; Sorin,9999,0,9999,0
1667986934925,CSE 293,019,119302,Lovett; Shachar,9999,0,9999,0
1667986934925,CSE 293,020,119303,McAuley; Julian John,9999,0,9999,0
1667986934925,CSE 293,021,119304,Micciancio; Daniele,9999,0,9999,0
1667986934925,CSE 293,022,119367,Orailoglu; Alex,9999,0,9999,0
1667986934925,CSE 293,023,119382,Paturi; Ramamohan,9999,0,9999,0
1667986934925,CSE 293,024,119404,Polikarpova; Nadezhda,9999,0,9999,0
1667986934925,CSE 293,025,119406,Politz; Joseph Gibbs,9999,0,9999,0
1667986934925,CSE 293,026,119411,Porter; George M,9999,0,9999,0
1667986934925,CSE 293,027,119414,Porter; Leonard Emerson,9999,0,9999,0
1667986934925,CSE 293,028,119416,Ramamoorthi; Ravi,9999,0,9999,0
1667986934925,CSE 293,029,119417,Sahoo; Debashis,9999,0,9999,0
1667986934925,CSE 293,030,119420,Saul; Lawrence,9999,0,9999,0
1667986934925,CSE 293,031,119421,Savage; Stefan,9999,0,9999,0
1667986934925,CSE 293,032,119425,Schulze; Jurgen P.,9999,0,9999,0
1667986934925,CSE 293,033,119426,Snoeren; Alex C.,9999,0,9999,0
1667986934925,CSE 293,034,119428,Shang; Jingbo,9999,0,9999,0
1667986934925,CSE 293,035,119430,Stefan; Deian,9999,0,9999,0
1667986934925,CSE 293,036,119431,Su; Hao,9999,0,9999,0
1667986934925,CSE 293,037,119433,Swanson; Steven James,9999,0,9999,0
1667986934925,CSE 293,038,119435,Tullsen; Dean Michael,9999,0,9999,0
1667986934925,CSE 293,039,119483,Voelker; Geoffrey M.,9999,0,9999,0
1667986934925,CSE 293,040,119537,Zhao; Jishen,9999,0,9999,0
1667986934925,CSE 293,041,119538,Zhou; Yuan-Yuan,9999,0,9999,0
1667986934925,CSE 293,042,119539,Gao; Sicun,9999,0,9999,0
1667986934925,CSE 293,043,119540,Weibel; Nadir,9999,0,9999,0
1667986934925,CSE 293,044,119541,Gupta; Rajesh K.,9999,0,9999,0
1667986934925,CSE 293,045,126410,Vaccaro; Kristen Marie,9999,0,9999,0
1667986934925,CSE 293,046,126411,Klemke; Richard,9999,0,9999,0
1667986935350,CSE 294,A00,102459,Voelker; Geoffrey M.,0,0,0,0
1667986935350,CSE 294,B00,111322,Orailoglu; Alex,0,0,0,0
1667986935773,DSE 201,A00,096914,Deutsch; Alin Bernard,30,0,30,0
1667986936201,DSE 210,A00,096915,Dasgupta; Sanjoy,30,0,30,0
1667986936629,DSE 260A,A00,096916,Altintas De Callaf; Ilkay,30,0,30,0
1667986937116,ECE 200,001,103586,Antipa; Nicholas A,9999,0,9999,0
1667986937116,ECE 200,002,103587,Atanasov; Nikolay A.,9999,0,9999,0
1667986937116,ECE 200,003,103588,Bharadia; Dinesh,9999,0,9999,0
1667986937116,ECE 200,004,103589,Cheng; Chung Kuan,9999,0,9999,0
1667986937116,ECE 200,005,103590,Cosman; Pamela C.,9999,0,9999,0
1667986937116,ECE 200,006,103591,Dayeh; Shadi Ahmad,9999,0,9999,0
1667986937116,ECE 200,007,103592,Fainman; Yeshaiahu,9999,0,9999,0
1667986937116,ECE 200,008,103593,Ford; Joseph Earl,9999,0,9999,0
1667986937116,ECE 200,009,103594,Franceschetti; Massimo,9999,0,9999,0
1667986937116,ECE 200,010,103595,Fullerton; Eric E,9999,0,9999,0
1667986937116,ECE 200,011,103596,Galton; Ian A,9999,0,9999,0
1667986937116,ECE 200,012,103597,Gilja; Vikash,9999,0,9999,0
1667986937116,ECE 200,013,103598,Hall; Drew A.,9999,0,9999,0
1667986937116,ECE 200,014,103599,Hsueh; Tzu-Chien,9999,0,9999,0
1667986937116,ECE 200,015,103600,Javidi; Tara,9999,0,9999,0
1667986937116,ECE 200,016,103601,Kahng; Andrew Byun,9999,0,9999,0
1667986937116,ECE 200,017,103602,Kim; Young-Han,9999,0,9999,0
1667986937116,ECE 200,018,103603,Koushanfar; Farinaz,9999,0,9999,0
1667986937116,ECE 200,019,103604,Kuzum; Duygu,9999,0,9999,0
1667986937116,ECE 200,020,103605,Le; Hanh-Phuc,9999,0,9999,0
1667986937116,ECE 200,021,103606,Lin; Bill,9999,0,9999,0
1667986937116,ECE 200,022,103607,Liu; Zhaowei,9998,0,9999,1
1667986937116,ECE 200,023,103608,Lo; Yu-Hwa,9999,0,9999,0
1667986937116,ECE 200,024,103609,Lomakin; Vitaliy,9999,0,9999,0
1667986937116,ECE 200,025,103610,Mercier; Patrick Philip,9999,0,9999,0
1667986937116,ECE 200,026,103611,Meyer; Florian,9999,0,9999,0
1667986937116,ECE 200,027,103612,Milstein; Laurence B.,9999,0,9999,0
1667986937116,ECE 200,028,103613,Mir Arabbaygi; Siavash,9999,0,9999,0
1667986937116,ECE 200,029,103614,Mookherjea; Shayan,9999,0,9999,0
1667986937116,ECE 200,030,103615,Morris; Karcher William,9999,0,9999,0
1667986937116,ECE 200,031,103616,Ng; Tse Nga,9999,0,9999,0
1667986937116,ECE 200,032,103617,Nguyen; Truong Quang,9999,0,9999,0
1667986937116,ECE 200,033,103618,Nomura; Kenji,9999,0,9999,0
1667986937116,ECE 200,034,103619,Orlitsky; Alon,9999,0,9999,0
1667986937116,ECE 200,035,103620,Pal; Piya,9999,0,9999,0
1667986937116,ECE 200,036,103621,Papen; George C.,9999,0,9999,0
1667986937116,ECE 200,037,103622,Radic; Stojan,9999,0,9999,0
1667986937116,ECE 200,038,103623,Rao; Bhaskar D.,9999,0,9999,0
1667986937116,ECE 200,039,103624,Rao; Ramesh R,9999,0,9999,0
1667986937116,ECE 200,040,103625,Rebeiz; Gabriel,9999,0,9999,0
1667986937116,ECE 200,041,103626,Sanford; John R,9999,0,9999,0
1667986937116,ECE 200,042,103627,Siegel; Paul H.,9999,0,9999,0
1667986937116,ECE 200,043,103628,Sievenpiper; Daniel F.,9999,0,9999,0
1667986937116,ECE 200,044,103629,Sworder; David D.,9999,0,9999,0
1667986937116,ECE 200,045,103630,Taur; Yuan,9999,0,9999,0
1667986937116,ECE 200,046,103631,Touri; Behrouz,9999,0,9999,0
1667986937116,ECE 200,047,103632,Trivedi; Mohan M.,9999,0,9999,0
1667986937116,ECE 200,048,103633,Vasconcelos; Nuno,9999,0,9999,0
1667986937116,ECE 200,049,103634,Wang; Xiaolong,9999,0,9999,0
1667986937116,ECE 200,050,103635,Xie; Pengtao,9999,0,9999,0
1667986937116,ECE 200,051,103636,Yip; Michael,9999,0,9999,0
1667986937116,ECE 200,052,103637,Zeger; Kenneth A.,999,0,999,0
1667986937116,ECE 200,053,103638,Zhang; Xinyu,9999,0,9999,0
1667986937116,ECE 200,054,103639,Turakhia; Yatish Girish,9999,0,9999,0
1667986937116,ECE 200,055,103640,Kang; Mingu,9999,0,9999,0
1667986937116,ECE 200,056,103641,Shi; Yuanyuan,9999,0,9999,0
1667986937116,ECE 200,057,103642,Wang; Edward Jay,9999,0,9999,0
1667986937116,ECE 200,058,103643,Zheng; Yang,9999,0,9999,0
1667986937545,ECE 202,A00,103644,Kuzum; Duygu,0,0,0,0
1667986937972,ECE 212BN,A00,103646,Ng; Tse Nga,0,0,0,0
1667986938403,ECE 221,A00,111493,Staff,0,0,0,0
1667986938827,ECE 222B,A00,103647,Lomakin; Vitaliy,0,0,0,0
1667986939252,ECE 230B,A00,103648,Taur; Yuan,0,0,0,0
1667986939685,ECE 238B,A00,103649,Garay; Javier,0,0,0,0
1667986940114,ECE 240B,A00,112900,Fainman; Yeshaiahu,0,0,0,0
1667986940541,ECE 247A,A00,103650,Jokerst; Jesse Vincent,0,0,0,0
1667986940968,ECE 247B,A00,103651,Wang; Joseph,0,0,0,0
1667986941393,ECE 250,A00,103652,Siegel; Paul H.,0,0,0,0
1667986941820,ECE 251A,A00,103654,Rao; Bhaskar D.,0,0,0,0
1667986942244,ECE 257B,A00,103655,Bharadia; Dinesh,0,0,0,0
1667986942669,ECE 258A,A00,103656,Milstein; Laurence B.,0,0,0,0
1667986943097,ECE 260B,A00,103658,Kang; Mingu,0,0,0,0
1667986943522,ECE 264A,A00,103659,Galton; Ian A,0,0,0,0
1667986943946,ECE 265A,A00,103661,Gudem; Prasad S.S.,0,0,0,0
1667986944370,ECE 265D,A00,103662,Gudem; Prasad S.S.,0,0,0,0
1667986944799,ECE 268,A00,103663,Koushanfar; Farinaz,0,0,0,0
1667986945224,ECE 269,A01,103665,Pal; Piya,0,0,0,0
1667986945660,ECE 271B,A00,103666,Vasconcelos; Manuela,0,0,0,0
1667986946084,ECE 276A,A00,103667,Atanasov; Nikolay A.,0,0,0,0
1667986946515,ECE 277,A00,103668,An; Cheolhong,0,0,0,0
1667986946943,ECE 279,A00,117947,Hall; Drew A.,0,0,0,0
1667986947793,ECE 283,A00,103670,Hsueh; Tzu-Chien,0,0,0,0
1667986948221,ECE 284,A00,103671,Turakhia; Yatish Girish,0,0,0,0
1667986948647,ECE 285,A00,103672,Zheng; Yang,0,0,0,0
1667986948647,ECE 285,B00,103673,Sworder; David D.,0,0,0,0
1667986949072,ECE 287,A00,103676,Javidi; Tara,0,0,0,0
1667986949495,MATH 200B,A00,098023,Salehi Golsefidy; Alireza,14,0,15,1
1667986949924,MATH 202B,A00,098024,Rhoades; Brendon Patrick,12,0,15,3
1667986950350,MATH 203B,A00,098025,Oprea; Dragos N.,12,0,15,3
1667986950772,MATH 204B,A00,098026,Sorensen; Claus M,14,0,15,1
1667986951198,MATH 208,A00,098027,Izadi; Elham,7,0,10,3
1667986951621,MATH 209,A00,098028,Pollack; Aaron,10,0,10,0
1667986952059,MATH 211A,A00,112919,Rogalski; Daniel,9,0,10,1
1667986952483,MATH 211B,A00,112920,Seward; Brandon M.,9,0,10,1
1667986952906,MATH 218,A00,098029,Li; Bo,10,0,10,0
1667986953339,MATH 220B,A00,098030,Novak; Jonathan I,13,0,15,2
1667986953765,MATH 221A,A00,098031,Ebenfelt; Peter F,13,0,15,2
1667986954195,MATH 231B,A00,098032,Zlatos; Andrej,12,0,15,3
1667986954625,MATH 240B,A00,098033,Ni; Lei,10,0,15,5
1667986955048,MATH 243,A00,098034,Jekel; David Andrew,10,0,10,0
1667986955471,MATH 245A,A00,098035,Nie; Jiawang,0,0,15,16
1667986955896,MATH 248,A00,098036,Bejenaru; Ioan,10,0,10,0
1667986956321,MATH 250B,A00,098037,Spolaor; Luca,14,0,15,1
1667986956756,MATH 258,A00,098038,Ni; Lei,10,0,10,0
1667986957181,MATH 264B,A00,098041,Rhoades; Brendon Patrick,11,0,15,4
1667986957616,MATH 268,A00,098042,Buss; Samuel R,10,0,10,0
1667986958040,MATH 269,A00,098043,Rhoades; Brendon Patrick,10,0,10,0
1667986958463,MATH 270B,A00,098044,Li; Bo,11,0,15,4
1667986958891,MATH 272B,A00,098045,Holst; Michael J,13,0,15,2
1667986959316,MATH 273A,A00,098046,Tian; Xiaochuan,12,0,15,3
1667986959741,MATH 275,A01,098048,Tian; Xiaochuan,6,0,10,4
1667986960164,MATH 278A,A00,098049,Holst; Michael J,8,0,10,2
1667986960592,MATH 278B,A00,098050,Cloninger; Alexander,10,0,10,0
1667986961019,MATH 278C,A00,098051,Nie; Jiawang,8,0,10,2
1667986961443,MATH 280B,A00,098052,Zheng; Tianyi,11,0,15,4
1667986961867,MATH 281B,A00,098053,Bradic; Jelena,4,0,15,11
1667986962297,MATH 282B,A00,098054,Arias-Castro; Ery,2,0,15,13
1667986962721,MATH 285,A00,098055,Fitzsimmons; Patrick J,0,0,15,17
1667986963145,MATH 287B,A00,098056,Arias-Castro; Ery,5,0,15,10
1667986963572,MATH 288,A00,098057,Agarwal; Pooja,9,0,10,1
1667986963572,MATH 288,B00,098058,Zhang; Danna,9,0,10,1
1667986963572,MATH 288,C00,098059,Williams; Ruth J,10,0,10,0
1667986964001,MATH 290B,A00,098060,Roberts; Justin Deritter,14,0,15,1
1667986964430,MATH 292,A00,098061,Belmont; Eva Kinoshita,10,0,10,0
1667986964854,MATH 295,A00,098062,Suk; Andrew Hoon,48,0,50,2
1667986965280,MATH 296,A00,098063,Novak; Jonathan I,20,0,20,0
1667986965704,MATH 297,001,098064,Gamst; Anthony Collins,9997,0,9999,2
1667987466292,COGS 205,A00,101395,Chiba; Andrea,19,0,20,1
1667987466720,COGS 210B,001,101404,Greene; Deanna Jacquelyn,9998,0,9999,1
1667987466720,COGS 210B,002,101417,Xia; Haijun,9999,0,9999,0
1667987466720,COGS 210B,003,101422,Nitz; Douglas A.,9999,0,9999,0
1667987466720,COGS 210B,004,101423,Hollan; James D.,9998,0,9999,1
1667987466720,COGS 210B,005,101424,Deak; Gedeon O.,9999,0,9999,0
1667987466720,COGS 210B,006,101425,Rossano; Federico,9999,0,9999,0
1667987467155,COGS 211B,A00,101427,Coulson; Seana M,9997,0,9999,2
1667987467580,COGS 220,A00,101428,Hollan; James D.,0,0,25,25
1667987468007,COGS 229,A00,101429,Dow; Steven P,18,0,25,7
1667987468432,COGS 230,A00,101430,Klemmer; Scott R,13,0,17,4
1667987468855,COGS 234,A00,101431,Xia; Haijun,7,0,25,18
1667987469278,COGS 260,A00,101432,Kiyonaga; Anastasia,20,0,25,5
1667987469278,COGS 260,B00,101433,Kirsh; David Joel,16,0,25,9
1667987469700,CSE 202,A00,102371,Impagliazzo; Russell,0,0,0,0
1667987470124,CSE 203B,A01,102373,Cheng; Chung Kuan,0,0,0,0
1667987470555,CSE 208,A00,102374,Micciancio; Daniele,0,0,0,0
1667987470980,CSE 209A,A00,112895,Impagliazzo; Russell,0,0,15,15
1667987471404,CSE 209B,A00,108005,Bellare; Mihir,0,0,0,0
1667987471827,CSE 210,A00,113163,Coblenz; Michael J,0,0,0,0
1667987472256,CSE 219,A00,106111,Dow; Steven P,1,0,20,19
1667987472684,CSE 221,A00,102376,Voelker; Geoffrey M.,0,0,0,0
1667987473106,CSE 224,A01,102378,Porter; George M,0,0,0,0
1667987473534,CSE 229A,A00,102379,Savage; Stefan,0,0,0,0
1667987473957,CSE 229C,A00,102380,Munyaka; Imani N. S.,0,0,0,0
1667987474383,CSE 232B,A00,102382,Deutsch; Alin Bernard,0,0,0,0
1667987474812,CSE 234,A01,112904,Kumar; Arun Kumar,0,0,0,0
1667987475239,CSE 237A,A00,102383,Rosing; Tajana Simunic,0,0,0,0
1667987475664,CSE 239A,A00,102384,Deutsch; Alin Bernard,0,0,0,0
1667987476089,CSE 239B,A00,102385,Polikarpova; Nadezhda,0,0,0,0
1667987476513,CSE 240A,A00,102386,Pannuto; Patrick William,0,0,0,0
1667987476937,CSE 240B,A00,102387,Zhao; Jishen,0,0,0,0
1667987477365,CSE 241A,A00,106406,Kang; Mingu,0,0,0,0
1667987477790,CSE 249B,A00,102388,Kahng; Andrew Byun,0,0,8,8
1667987478214,CSE 251B,A01,102392,Cottrell; Garrison W,0,0,0,0
1667987478214,CSE 251B,A02,102393,Cottrell; Garrison W,0,0,0,0
1667987478642,CSE 252B,A00,102394,Ochoa; Benjamin Lawrence,0,0,0,0
1667987479065,CSE 257,A01,102396,Gao; Sicun,0,0,0,0
1667987479492,CSE 272,A00,102397,Li; Tzumao,0,0,0,0
1667987479919,CSE 274,A00,111323,Chern; Albert Ren-Haur,0,0,0,0
1667987480344,CSE 282,A00,102398,Pevzner; Pavel Arkadjevich,0,0,0,0
1667987480771,CSE 284,A00,114175,Gymrek; Melissa Ann,0,0,0,0
1667987481202,CSE 290,A00,102399,Chandraker; Manmohan Krishna,0,0,0,0
1667987481202,CSE 290,B00,102400,Vaccaro; Kristen Marie,0,0,25,25
1667987481202,CSE 290,C00,102414,Pannuto; Patrick William,0,0,25,25
1667987481202,CSE 290,D00,102427,Pevzner; Pavel Arkadjevich,0,0,0,0
1667987481202,CSE 290,E00,102429,Zhao; Jishen,0,0,0,0
1667987481202,CSE 290,F00,102436,Tullsen; Dean Michael,0,0,0,0
1667987481202,CSE 290,G00,102440,Christensen; Henrik I,0,0,20,20
1667987481657,CSE 291,A00,102443,Su; Hao,0,0,0,0
1667987481657,CSE 291,B00,102448,Polikarpova; Nadezhda,0,0,0,0
1667987481657,CSE 291,C00,102453,Vaccaro; Kristen Marie,0,0,0,0
1667987481657,CSE 291,D00,111343,Savage; Stefan,0,0,0,0
1667987481657,CSE 291,E00,116474,Claffy; Kimberly Claire,0,0,0,0
1667987481657,CSE 291,F00,116479,Pasquale; Joseph,0,0,0,0
1667987482102,CSE 293,001,119111,Bafna; Vineet,9999,0,9999,0
1667987482102,CSE 293,002,119118,Bellare; Mihir,9999,0,9999,0
1667987482102,CSE 293,003,119122,Berg-Kirkpatrick; Taylor D,9999,0,9999,0
1667987482102,CSE 293,004,119135,Christensen; Henrik I,9999,0,9999,0
1667987482102,CSE 293,005,119142,Cottrell; Garrison W,9999,0,9999,0
1667987482102,CSE 293,006,119146,Deutsch; Alin Bernard,9999,0,9999,0
1667987482102,CSE 293,007,119159,Esmaeilzadeh; Hadi,9999,0,9999,0
1667987482102,CSE 293,008,119166,Freund; Yoav,9999,0,9999,0
1667987482102,CSE 293,009,119170,Griswold; William G.,9999,0,9999,0
1667987482102,CSE 293,010,119183,Gymrek; Melissa Ann,9999,0,9999,0
1667987482102,CSE 293,011,119190,Heninger; Nadia A,9999,0,9999,0
1667987482102,CSE 293,012,119230,Impagliazzo; Russell,9999,0,9999,0
1667987482102,CSE 293,013,119232,Jhala; Ranjit,9999,0,9999,0
1667987482102,CSE 293,014,119233,Kahng; Andrew Byun,9999,0,9999,0
1667987482102,CSE 293,015,119298,Kane; Daniel Mertz,9999,0,9999,0
1667987482102,CSE 293,016,119299,Kriegman; David J,9999,0,9999,0
1667987482102,CSE 293,017,119300,Kumar; Arun Kumar,9999,0,9999,0
1667987482102,CSE 293,018,119301,Lerner; Sorin,9999,0,9999,0
1667987482102,CSE 293,019,119302,Lovett; Shachar,9999,0,9999,0
1667987482102,CSE 293,020,119303,McAuley; Julian John,9999,0,9999,0
1667987482102,CSE 293,021,119304,Micciancio; Daniele,9999,0,9999,0
1667987482102,CSE 293,022,119367,Orailoglu; Alex,9999,0,9999,0
1667987482102,CSE 293,023,119382,Paturi; Ramamohan,9999,0,9999,0
1667987482102,CSE 293,024,119404,Polikarpova; Nadezhda,9999,0,9999,0
1667987482102,CSE 293,025,119406,Politz; Joseph Gibbs,9999,0,9999,0
1667987482102,CSE 293,026,119411,Porter; George M,9999,0,9999,0
1667987482102,CSE 293,027,119414,Porter; Leonard Emerson,9999,0,9999,0
1667987482102,CSE 293,028,119416,Ramamoorthi; Ravi,9999,0,9999,0
1667987482102,CSE 293,029,119417,Sahoo; Debashis,9999,0,9999,0
1667987482102,CSE 293,030,119420,Saul; Lawrence,9999,0,9999,0
1667987482102,CSE 293,031,119421,Savage; Stefan,9999,0,9999,0
1667987482102,CSE 293,032,119425,Schulze; Jurgen P.,9999,0,9999,0
1667987482102,CSE 293,033,119426,Snoeren; Alex C.,9999,0,9999,0
1667987482102,CSE 293,034,119428,Shang; Jingbo,9999,0,9999,0
1667987482102,CSE 293,035,119430,Stefan; Deian,9999,0,9999,0
1667987482102,CSE 293,036,119431,Su; Hao,9999,0,9999,0
1667987482102,CSE 293,037,119433,Swanson; Steven James,9999,0,9999,0
1667987482102,CSE 293,038,119435,Tullsen; Dean Michael,9999,0,9999,0
1667987482102,CSE 293,039,119483,Voelker; Geoffrey M.,9999,0,9999,0
1667987482102,CSE 293,040,119537,Zhao; Jishen,9999,0,9999,0
1667987482102,CSE 293,041,119538,Zhou; Yuan-Yuan,9999,0,9999,0
1667987482102,CSE 293,042,119539,Gao; Sicun,9999,0,9999,0
1667987482102,CSE 293,043,119540,Weibel; Nadir,9999,0,9999,0
1667987482102,CSE 293,044,119541,Gupta; Rajesh K.,9999,0,9999,0
1667987482102,CSE 293,045,126410,Vaccaro; Kristen Marie,9999,0,9999,0
1667987482102,CSE 293,046,126411,Klemke; Richard,9999,0,9999,0
1667987482529,CSE 294,A00,102459,Voelker; Geoffrey M.,0,0,0,0
1667987482529,CSE 294,B00,111322,Orailoglu; Alex,0,0,0,0
1667987482955,DSE 201,A00,096914,Deutsch; Alin Bernard,30,0,30,0
1667987483380,DSE 210,A00,096915,Dasgupta; Sanjoy,30,0,30,0
1667987483809,DSE 260A,A00,096916,Altintas De Callaf; Ilkay,30,0,30,0
1667987484278,ECE 200,001,103586,Antipa; Nicholas A,9999,0,9999,0
1667987484278,ECE 200,002,103587,Atanasov; Nikolay A.,9999,0,9999,0
1667987484278,ECE 200,003,103588,Bharadia; Dinesh,9999,0,9999,0
1667987484278,ECE 200,004,103589,Cheng; Chung Kuan,9999,0,9999,0
1667987484278,ECE 200,005,103590,Cosman; Pamela C.,9999,0,9999,0
1667987484278,ECE 200,006,103591,Dayeh; Shadi Ahmad,9999,0,9999,0
1667987484278,ECE 200,007,103592,Fainman; Yeshaiahu,9999,0,9999,0
1667987484278,ECE 200,008,103593,Ford; Joseph Earl,9999,0,9999,0
1667987484278,ECE 200,009,103594,Franceschetti; Massimo,9999,0,9999,0
1667987484278,ECE 200,010,103595,Fullerton; Eric E,9999,0,9999,0
1667987484278,ECE 200,011,103596,Galton; Ian A,9999,0,9999,0
1667987484278,ECE 200,012,103597,Gilja; Vikash,9999,0,9999,0
1667987484278,ECE 200,013,103598,Hall; Drew A.,9999,0,9999,0
1667987484278,ECE 200,014,103599,Hsueh; Tzu-Chien,9999,0,9999,0
1667987484278,ECE 200,015,103600,Javidi; Tara,9999,0,9999,0
1667987484278,ECE 200,016,103601,Kahng; Andrew Byun,9999,0,9999,0
1667987484278,ECE 200,017,103602,Kim; Young-Han,9999,0,9999,0
1667987484278,ECE 200,018,103603,Koushanfar; Farinaz,9999,0,9999,0
1667987484278,ECE 200,019,103604,Kuzum; Duygu,9999,0,9999,0
1667987484278,ECE 200,020,103605,Le; Hanh-Phuc,9999,0,9999,0
1667987484278,ECE 200,021,103606,Lin; Bill,9999,0,9999,0
1667987484278,ECE 200,022,103607,Liu; Zhaowei,9998,0,9999,1
1667987484278,ECE 200,023,103608,Lo; Yu-Hwa,9999,0,9999,0
1667987484278,ECE 200,024,103609,Lomakin; Vitaliy,9999,0,9999,0
1667987484278,ECE 200,025,103610,Mercier; Patrick Philip,9999,0,9999,0
1667987484278,ECE 200,026,103611,Meyer; Florian,9999,0,9999,0
1667987484278,ECE 200,027,103612,Milstein; Laurence B.,9999,0,9999,0
1667987484278,ECE 200,028,103613,Mir Arabbaygi; Siavash,9999,0,9999,0
1667987484278,ECE 200,029,103614,Mookherjea; Shayan,9999,0,9999,0
1667987484278,ECE 200,030,103615,Morris; Karcher William,9999,0,9999,0
1667987484278,ECE 200,031,103616,Ng; Tse Nga,9999,0,9999,0
1667987484278,ECE 200,032,103617,Nguyen; Truong Quang,9999,0,9999,0
1667987484278,ECE 200,033,103618,Nomura; Kenji,9999,0,9999,0
1667987484278,ECE 200,034,103619,Orlitsky; Alon,9999,0,9999,0
1667987484278,ECE 200,035,103620,Pal; Piya,9999,0,9999,0
1667987484278,ECE 200,036,103621,Papen; George C.,9999,0,9999,0
1667987484278,ECE 200,037,103622,Radic; Stojan,9999,0,9999,0
1667987484278,ECE 200,038,103623,Rao; Bhaskar D.,9999,0,9999,0
1667987484278,ECE 200,039,103624,Rao; Ramesh R,9999,0,9999,0
1667987484278,ECE 200,040,103625,Rebeiz; Gabriel,9999,0,9999,0
1667987484278,ECE 200,041,103626,Sanford; John R,9999,0,9999,0
1667987484278,ECE 200,042,103627,Siegel; Paul H.,9999,0,9999,0
1667987484278,ECE 200,043,103628,Sievenpiper; Daniel F.,9999,0,9999,0
1667987484278,ECE 200,044,103629,Sworder; David D.,9999,0,9999,0
1667987484278,ECE 200,045,103630,Taur; Yuan,9999,0,9999,0
1667987484278,ECE 200,046,103631,Touri; Behrouz,9999,0,9999,0
1667987484278,ECE 200,047,103632,Trivedi; Mohan M.,9999,0,9999,0
1667987484278,ECE 200,048,103633,Vasconcelos; Nuno,9999,0,9999,0
1667987484278,ECE 200,049,103634,Wang; Xiaolong,9999,0,9999,0
1667987484278,ECE 200,050,103635,Xie; Pengtao,9999,0,9999,0
1667987484278,ECE 200,051,103636,Yip; Michael,9999,0,9999,0
1667987484278,ECE 200,052,103637,Zeger; Kenneth A.,999,0,999,0
1667987484278,ECE 200,053,103638,Zhang; Xinyu,9999,0,9999,0
1667987484278,ECE 200,054,103639,Turakhia; Yatish Girish,9999,0,9999,0
1667987484278,ECE 200,055,103640,Kang; Mingu,9999,0,9999,0
1667987484278,ECE 200,056,103641,Shi; Yuanyuan,9999,0,9999,0
1667987484278,ECE 200,057,103642,Wang; Edward Jay,9999,0,9999,0
1667987484278,ECE 200,058,103643,Zheng; Yang,9999,0,9999,0
1667987484708,ECE 202,A00,103644,Kuzum; Duygu,0,0,0,0
1667987485132,ECE 212BN,A00,103646,Ng; Tse Nga,0,0,0,0
1667987485557,ECE 221,A00,111493,Staff,0,0,0,0
1667987485981,ECE 222B,A00,103647,Lomakin; Vitaliy,0,0,0,0
1667987486406,ECE 230B,A00,103648,Taur; Yuan,0,0,0,0
1667987486833,ECE 238B,A00,103649,Garay; Javier,0,0,0,0
1667987487270,ECE 240B,A00,112900,Fainman; Yeshaiahu,0,0,0,0
1667987487698,ECE 247A,A00,103650,Jokerst; Jesse Vincent,0,0,0,0
1667987488124,ECE 247B,A00,103651,Wang; Joseph,0,0,0,0
1667987488547,ECE 250,A00,103652,Siegel; Paul H.,0,0,0,0
1667987488971,ECE 251A,A00,103654,Rao; Bhaskar D.,0,0,0,0
1667987489398,ECE 257B,A00,103655,Bharadia; Dinesh,0,0,0,0
1667987489820,ECE 258A,A00,103656,Milstein; Laurence B.,0,0,0,0
1667987490243,ECE 260B,A00,103658,Kang; Mingu,0,0,0,0
1667987490668,ECE 264A,A00,103659,Galton; Ian A,0,0,0,0
1667987491091,ECE 265A,A00,103661,Gudem; Prasad S.S.,0,0,0,0
1667987491515,ECE 265D,A00,103662,Gudem; Prasad S.S.,0,0,0,0
1667987491938,ECE 268,A00,103663,Koushanfar; Farinaz,0,0,0,0
1667987492368,ECE 269,A01,103665,Pal; Piya,0,0,0,0
1667987492791,ECE 271B,A00,103666,Vasconcelos; Manuela,0,0,0,0
1667987493216,ECE 276A,A00,103667,Atanasov; Nikolay A.,0,0,0,0
1667987493644,ECE 277,A00,103668,An; Cheolhong,0,0,0,0
1667987494070,ECE 279,A00,117947,Hall; Drew A.,0,0,0,0
1667987494925,ECE 283,A00,103670,Hsueh; Tzu-Chien,0,0,0,0
1667987495349,ECE 284,A00,103671,Turakhia; Yatish Girish,0,0,0,0
1667987495775,ECE 285,A00,103672,Zheng; Yang,0,0,0,0
1667987495775,ECE 285,B00,103673,Sworder; David D.,0,0,0,0
1667987496198,ECE 287,A00,103676,Javidi; Tara,0,0,0,0
1667987496624,MATH 200B,A00,098023,Salehi Golsefidy; Alireza,14,0,15,1
1667987497048,MATH 202B,A00,098024,Rhoades; Brendon Patrick,12,0,15,3
1667987497472,MATH 203B,A00,098025,Oprea; Dragos N.,12,0,15,3
1667987497901,MATH 204B,A00,098026,Sorensen; Claus M,14,0,15,1
1667987498325,MATH 208,A00,098027,Izadi; Elham,7,0,10,3
1667987498841,MATH 209,A00,098028,Pollack; Aaron,10,0,10,0
1667987499274,MATH 211A,A00,112919,Rogalski; Daniel,9,0,10,1
1667987499697,MATH 211B,A00,112920,Seward; Brandon M.,9,0,10,1
1667987500125,MATH 218,A00,098029,Li; Bo,10,0,10,0
1667987500551,MATH 220B,A00,098030,Novak; Jonathan I,13,0,15,2
1667987500977,MATH 221A,A00,098031,Ebenfelt; Peter F,13,0,15,2
1667987501408,MATH 231B,A00,098032,Zlatos; Andrej,12,0,15,3
1667987501837,MATH 240B,A00,098033,Ni; Lei,10,0,15,5
1667987502264,MATH 243,A00,098034,Jekel; David Andrew,10,0,10,0
1667987502691,MATH 245A,A00,098035,Nie; Jiawang,0,0,15,16
1667987503116,MATH 248,A00,098036,Bejenaru; Ioan,10,0,10,0
1667987503539,MATH 250B,A00,098037,Spolaor; Luca,14,0,15,1
1667987503963,MATH 258,A00,098038,Ni; Lei,10,0,10,0
1667987504389,MATH 264B,A00,098041,Rhoades; Brendon Patrick,11,0,15,4
1667987504814,MATH 268,A00,098042,Buss; Samuel R,10,0,10,0
1667987505239,MATH 269,A00,098043,Rhoades; Brendon Patrick,10,0,10,0
1667987505669,MATH 270B,A00,098044,Li; Bo,11,0,15,4
1667987506095,MATH 272B,A00,098045,Holst; Michael J,13,0,15,2
1667987506522,MATH 273A,A00,098046,Tian; Xiaochuan,12,0,15,3
1667987506949,MATH 275,A01,098048,Tian; Xiaochuan,6,0,10,4
1667987507374,MATH 278A,A00,098049,Holst; Michael J,8,0,10,2
1667987507801,MATH 278B,A00,098050,Cloninger; Alexander,10,0,10,0
1667987508234,MATH 278C,A00,098051,Nie; Jiawang,8,0,10,2
1667987508660,MATH 280B,A00,098052,Zheng; Tianyi,11,0,15,4
1667987509088,MATH 281B,A00,098053,Bradic; Jelena,4,0,15,11
1667987509516,MATH 282B,A00,098054,Arias-Castro; Ery,2,0,15,13
1667987509945,MATH 285,A00,098055,Fitzsimmons; Patrick J,0,0,15,17
1667987510369,MATH 287B,A00,098056,Arias-Castro; Ery,5,0,15,10
1667987510794,MATH 288,A00,098057,Agarwal; Pooja,9,0,10,1
1667987510794,MATH 288,B00,098058,Zhang; Danna,9,0,10,1
1667987510794,MATH 288,C00,098059,Williams; Ruth J,10,0,10,0
1667987511228,MATH 290B,A00,098060,Roberts; Justin Deritter,14,0,15,1
1667987511686,MATH 292,A00,098061,Belmont; Eva Kinoshita,10,0,10,0
1667987512115,MATH 295,A00,098062,Suk; Andrew Hoon,48,0,50,2
1667987512559,MATH 296,A00,098063,Novak; Jonathan I,20,0,20,0
1667987512987,MATH 297,001,098064,Gamst; Anthony Collins,9997,0,9999,2
1667988012491,COGS 205,A00,101395,Chiba; Andrea,19,0,20,1
1667988012917,COGS 210B,001,101404,Greene; Deanna Jacquelyn,9998,0,9999,1
1667988012917,COGS 210B,002,101417,Xia; Haijun,9999,0,9999,0
1667988012917,COGS 210B,003,101422,Nitz; Douglas A.,9999,0,9999,0
1667988012917,COGS 210B,004,101423,Hollan; James D.,9998,0,9999,1
1667988012917,COGS 210B,005,101424,Deak; Gedeon O.,9999,0,9999,0
1667988012917,COGS 210B,006,101425,Rossano; Federico,9999,0,9999,0
1667988013342,COGS 211B,A00,101427,Coulson; Seana M,9997,0,9999,2
1667988013769,COGS 220,A00,101428,Hollan; James D.,0,0,25,25
1667988014200,COGS 229,A00,101429,Dow; Steven P,18,0,25,7
1667988014627,COGS 230,A00,101430,Klemmer; Scott R,13,0,17,4
1667988015050,COGS 234,A00,101431,Xia; Haijun,7,0,25,18
1667988015473,COGS 260,A00,101432,Kiyonaga; Anastasia,20,0,25,5
1667988015473,COGS 260,B00,101433,Kirsh; David Joel,16,0,25,9
1667988015902,CSE 202,A00,102371,Impagliazzo; Russell,0,0,0,0
1667988016327,CSE 203B,A01,102373,Cheng; Chung Kuan,0,0,0,0
1667988016756,CSE 208,A00,102374,Micciancio; Daniele,0,0,0,0
1667988017179,CSE 209A,A00,112895,Impagliazzo; Russell,0,0,15,15
1667988017605,CSE 209B,A00,108005,Bellare; Mihir,0,0,0,0
1667988018031,CSE 210,A00,113163,Coblenz; Michael J,0,0,0,0
1667988018548,CSE 219,A00,106111,Dow; Steven P,1,0,20,19
1667988018977,CSE 221,A00,102376,Voelker; Geoffrey M.,0,0,0,0
1667988019401,CSE 224,A01,102378,Porter; George M,0,0,0,0
1667988019827,CSE 229A,A00,102379,Savage; Stefan,0,0,0,0
1667988020257,CSE 229C,A00,102380,Munyaka; Imani N. S.,0,0,0,0
1667988020684,CSE 232B,A00,102382,Deutsch; Alin Bernard,0,0,0,0
1667988021112,CSE 234,A01,112904,Kumar; Arun Kumar,0,0,0,0
1667988021535,CSE 237A,A00,102383,Rosing; Tajana Simunic,0,0,0,0
1667988021960,CSE 239A,A00,102384,Deutsch; Alin Bernard,0,0,0,0
1667988022390,CSE 239B,A00,102385,Polikarpova; Nadezhda,0,0,0,0
1667988022814,CSE 240A,A00,102386,Pannuto; Patrick William,0,0,0,0
1667988023242,CSE 240B,A00,102387,Zhao; Jishen,0,0,0,0
1667988023669,CSE 241A,A00,106406,Kang; Mingu,0,0,0,0
1667988024097,CSE 249B,A00,102388,Kahng; Andrew Byun,0,0,8,8
1667988024522,CSE 251B,A01,102392,Cottrell; Garrison W,0,0,0,0
1667988024522,CSE 251B,A02,102393,Cottrell; Garrison W,0,0,0,0
1667988024951,CSE 252B,A00,102394,Ochoa; Benjamin Lawrence,0,0,0,0
1667988025377,CSE 257,A01,102396,Gao; Sicun,0,0,0,0
1667988025803,CSE 272,A00,102397,Li; Tzumao,0,0,0,0
1667988026231,CSE 274,A00,111323,Chern; Albert Ren-Haur,0,0,0,0
1667988026657,CSE 282,A00,102398,Pevzner; Pavel Arkadjevich,0,0,0,0
1667988027085,CSE 284,A00,114175,Gymrek; Melissa Ann,0,0,0,0
1667988027517,CSE 290,A00,102399,Chandraker; Manmohan Krishna,0,0,0,0
1667988027517,CSE 290,B00,102400,Vaccaro; Kristen Marie,0,0,25,25
1667988027517,CSE 290,C00,102414,Pannuto; Patrick William,0,0,25,25
1667988027517,CSE 290,D00,102427,Pevzner; Pavel Arkadjevich,0,0,0,0
1667988027517,CSE 290,E00,102429,Zhao; Jishen,0,0,0,0
1667988027517,CSE 290,F00,102436,Tullsen; Dean Michael,0,0,0,0
1667988027517,CSE 290,G00,102440,Christensen; Henrik I,0,0,20,20
1667988027955,CSE 291,A00,102443,Su; Hao,0,0,0,0
1667988027955,CSE 291,B00,102448,Polikarpova; Nadezhda,0,0,0,0
1667988027955,CSE 291,C00,102453,Vaccaro; Kristen Marie,0,0,0,0
1667988027955,CSE 291,D00,111343,Savage; Stefan,0,0,0,0
1667988027955,CSE 291,E00,116474,Claffy; Kimberly Claire,0,0,0,0
1667988027955,CSE 291,F00,116479,Pasquale; Joseph,0,0,0,0
1667988028397,CSE 293,001,119111,Bafna; Vineet,9999,0,9999,0
1667988028397,CSE 293,002,119118,Bellare; Mihir,9999,0,9999,0
1667988028397,CSE 293,003,119122,Berg-Kirkpatrick; Taylor D,9999,0,9999,0
1667988028397,CSE 293,004,119135,Christensen; Henrik I,9999,0,9999,0
1667988028397,CSE 293,005,119142,Cottrell; Garrison W,9999,0,9999,0
1667988028397,CSE 293,006,119146,Deutsch; Alin Bernard,9999,0,9999,0
1667988028397,CSE 293,007,119159,Esmaeilzadeh; Hadi,9999,0,9999,0
1667988028397,CSE 293,008,119166,Freund; Yoav,9999,0,9999,0
1667988028397,CSE 293,009,119170,Griswold; William G.,9999,0,9999,0
1667988028397,CSE 293,010,119183,Gymrek; Melissa Ann,9999,0,9999,0
1667988028397,CSE 293,011,119190,Heninger; Nadia A,9999,0,9999,0
1667988028397,CSE 293,012,119230,Impagliazzo; Russell,9999,0,9999,0
1667988028397,CSE 293,013,119232,Jhala; Ranjit,9999,0,9999,0
1667988028397,CSE 293,014,119233,Kahng; Andrew Byun,9999,0,9999,0
1667988028397,CSE 293,015,119298,Kane; Daniel Mertz,9999,0,9999,0
1667988028397,CSE 293,016,119299,Kriegman; David J,9999,0,9999,0
1667988028397,CSE 293,017,119300,Kumar; Arun Kumar,9999,0,9999,0
1667988028397,CSE 293,018,119301,Lerner; Sorin,9999,0,9999,0
1667988028397,CSE 293,019,119302,Lovett; Shachar,9999,0,9999,0
1667988028397,CSE 293,020,119303,McAuley; Julian John,9999,0,9999,0
1667988028397,CSE 293,021,119304,Micciancio; Daniele,9999,0,9999,0
1667988028397,CSE 293,022,119367,Orailoglu; Alex,9999,0,9999,0
1667988028397,CSE 293,023,119382,Paturi; Ramamohan,9999,0,9999,0
1667988028397,CSE 293,024,119404,Polikarpova; Nadezhda,9999,0,9999,0
1667988028397,CSE 293,025,119406,Politz; Joseph Gibbs,9999,0,9999,0
1667988028397,CSE 293,026,119411,Porter; George M,9999,0,9999,0
1667988028397,CSE 293,027,119414,Porter; Leonard Emerson,9999,0,9999,0
1667988028397,CSE 293,028,119416,Ramamoorthi; Ravi,9999,0,9999,0
1667988028397,CSE 293,029,119417,Sahoo; Debashis,9999,0,9999,0
1667988028397,CSE 293,030,119420,Saul; Lawrence,9999,0,9999,0
1667988028397,CSE 293,031,119421,Savage; Stefan,9999,0,9999,0
1667988028397,CSE 293,032,119425,Schulze; Jurgen P.,9999,0,9999,0
1667988028397,CSE 293,033,119426,Snoeren; Alex C.,9999,0,9999,0
1667988028397,CSE 293,034,119428,Shang; Jingbo,9999,0,9999,0
1667988028397,CSE 293,035,119430,Stefan; Deian,9999,0,9999,0
1667988028397,CSE 293,036,119431,Su; Hao,9999,0,9999,0
1667988028397,CSE 293,037,119433,Swanson; Steven James,9999,0,9999,0
1667988028397,CSE 293,038,119435,Tullsen; Dean Michael,9999,0,9999,0
1667988028397,CSE 293,039,119483,Voelker; Geoffrey M.,9999,0,9999,0
1667988028397,CSE 293,040,119537,Zhao; Jishen,9999,0,9999,0
1667988028397,CSE 293,041,119538,Zhou; Yuan-Yuan,9999,0,9999,0
1667988028397,CSE 293,042,119539,Gao; Sicun,9999,0,9999,0
1667988028397,CSE 293,043,119540,Weibel; Nadir,9999,0,9999,0
1667988028397,CSE 293,044,119541,Gupta; Rajesh K.,9999,0,9999,0
1667988028397,CSE 293,045,126410,Vaccaro; Kristen Marie,9999,0,9999,0
1667988028397,CSE 293,046,126411,Klemke; Richard,9999,0,9999,0
1667988028833,CSE 294,A00,102459,Voelker; Geoffrey M.,0,0,0,0
1667988028833,CSE 294,B00,111322,Orailoglu; Alex,0,0,0,0
1667988029260,DSE 201,A00,096914,Deutsch; Alin Bernard,30,0,30,0
1667988029683,DSE 210,A00,096915,Dasgupta; Sanjoy,30,0,30,0
1667988030107,DSE 260A,A00,096916,Altintas De Callaf; Ilkay,30,0,30,0
1667988030595,ECE 200,001,103586,Antipa; Nicholas A,9999,0,9999,0
1667988030595,ECE 200,002,103587,Atanasov; Nikolay A.,9999,0,9999,0
1667988030595,ECE 200,003,103588,Bharadia; Dinesh,9999,0,9999,0
1667988030595,ECE 200,004,103589,Cheng; Chung Kuan,9999,0,9999,0
1667988030595,ECE 200,005,103590,Cosman; Pamela C.,9999,0,9999,0
1667988030595,ECE 200,006,103591,Dayeh; Shadi Ahmad,9999,0,9999,0
1667988030595,ECE 200,007,103592,Fainman; Yeshaiahu,9999,0,9999,0
1667988030595,ECE 200,008,103593,Ford; Joseph Earl,9999,0,9999,0
1667988030595,ECE 200,009,103594,Franceschetti; Massimo,9999,0,9999,0
1667988030595,ECE 200,010,103595,Fullerton; Eric E,9999,0,9999,0
1667988030595,ECE 200,011,103596,Galton; Ian A,9999,0,9999,0
1667988030595,ECE 200,012,103597,Gilja; Vikash,9999,0,9999,0
1667988030595,ECE 200,013,103598,Hall; Drew A.,9999,0,9999,0
1667988030595,ECE 200,014,103599,Hsueh; Tzu-Chien,9999,0,9999,0
1667988030595,ECE 200,015,103600,Javidi; Tara,9999,0,9999,0
1667988030595,ECE 200,016,103601,Kahng; Andrew Byun,9999,0,9999,0
1667988030595,ECE 200,017,103602,Kim; Young-Han,9999,0,9999,0
1667988030595,ECE 200,018,103603,Koushanfar; Farinaz,9999,0,9999,0
1667988030595,ECE 200,019,103604,Kuzum; Duygu,9999,0,9999,0
1667988030595,ECE 200,020,103605,Le; Hanh-Phuc,9999,0,9999,0
1667988030595,ECE 200,021,103606,Lin; Bill,9999,0,9999,0
1667988030595,ECE 200,022,103607,Liu; Zhaowei,9998,0,9999,1
1667988030595,ECE 200,023,103608,Lo; Yu-Hwa,9999,0,9999,0
1667988030595,ECE 200,024,103609,Lomakin; Vitaliy,9999,0,9999,0
1667988030595,ECE 200,025,103610,Mercier; Patrick Philip,9999,0,9999,0
1667988030595,ECE 200,026,103611,Meyer; Florian,9999,0,9999,0
1667988030595,ECE 200,027,103612,Milstein; Laurence B.,9999,0,9999,0
1667988030595,ECE 200,028,103613,Mir Arabbaygi; Siavash,9999,0,9999,0
1667988030595,ECE 200,029,103614,Mookherjea; Shayan,9999,0,9999,0
1667988030595,ECE 200,030,103615,Morris; Karcher William,9999,0,9999,0
1667988030595,ECE 200,031,103616,Ng; Tse Nga,9999,0,9999,0
1667988030595,ECE 200,032,103617,Nguyen; Truong Quang,9999,0,9999,0
1667988030595,ECE 200,033,103618,Nomura; Kenji,9999,0,9999,0
1667988030595,ECE 200,034,103619,Orlitsky; Alon,9999,0,9999,0
1667988030595,ECE 200,035,103620,Pal; Piya,9999,0,9999,0
1667988030595,ECE 200,036,103621,Papen; George C.,9999,0,9999,0
1667988030595,ECE 200,037,103622,Radic; Stojan,9999,0,9999,0
1667988030595,ECE 200,038,103623,Rao; Bhaskar D.,9999,0,9999,0
1667988030595,ECE 200,039,103624,Rao; Ramesh R,9999,0,9999,0
1667988030595,ECE 200,040,103625,Rebeiz; Gabriel,9999,0,9999,0
1667988030595,ECE 200,041,103626,Sanford; John R,9999,0,9999,0
1667988030595,ECE 200,042,103627,Siegel; Paul H.,9999,0,9999,0
1667988030595,ECE 200,043,103628,Sievenpiper; Daniel F.,9999,0,9999,0
1667988030595,ECE 200,044,103629,Sworder; David D.,9999,0,9999,0
1667988030595,ECE 200,045,103630,Taur; Yuan,9999,0,9999,0
1667988030595,ECE 200,046,103631,Touri; Behrouz,9999,0,9999,0
1667988030595,ECE 200,047,103632,Trivedi; Mohan M.,9999,0,9999,0
1667988030595,ECE 200,048,103633,Vasconcelos; Nuno,9999,0,9999,0
1667988030595,ECE 200,049,103634,Wang; Xiaolong,9999,0,9999,0
1667988030595,ECE 200,050,103635,Xie; Pengtao,9999,0,9999,0
1667988030595,ECE 200,051,103636,Yip; Michael,9999,0,9999,0
1667988030595,ECE 200,052,103637,Zeger; Kenneth A.,999,0,999,0
1667988030595,ECE 200,053,103638,Zhang; Xinyu,9999,0,9999,0
1667988030595,ECE 200,054,103639,Turakhia; Yatish Girish,9999,0,9999,0
1667988030595,ECE 200,055,103640,Kang; Mingu,9999,0,9999,0
1667988030595,ECE 200,056,103641,Shi; Yuanyuan,9999,0,9999,0
1667988030595,ECE 200,057,103642,Wang; Edward Jay,9999,0,9999,0
1667988030595,ECE 200,058,103643,Zheng; Yang,9999,0,9999,0
1667988031023,ECE 202,A00,103644,Kuzum; Duygu,0,0,0,0
1667988031449,ECE 212BN,A00,103646,Ng; Tse Nga,0,0,0,0
1667988031877,ECE 221,A00,111493,Staff,0,0,0,0
1667988032305,ECE 222B,A00,103647,Lomakin; Vitaliy,0,0,0,0
1667988032737,ECE 230B,A00,103648,Taur; Yuan,0,0,0,0
1667988033161,ECE 238B,A00,103649,Garay; Javier,0,0,0,0
1667988033591,ECE 240B,A00,112900,Fainman; Yeshaiahu,0,0,0,0
1667988034014,ECE 247A,A00,103650,Jokerst; Jesse Vincent,0,0,0,0
1667988034438,ECE 247B,A00,103651,Wang; Joseph,0,0,0,0
1667988034864,ECE 250,A00,103652,Siegel; Paul H.,0,0,0,0
1667988035288,ECE 251A,A00,103654,Rao; Bhaskar D.,0,0,0,0
1667988035717,ECE 257B,A00,103655,Bharadia; Dinesh,0,0,0,0
1667988036145,ECE 258A,A00,103656,Milstein; Laurence B.,0,0,0,0
1667988036568,ECE 260B,A00,103658,Kang; Mingu,0,0,0,0
1667988036995,ECE 264A,A00,103659,Galton; Ian A,0,0,0,0
1667988037420,ECE 265A,A00,103661,Gudem; Prasad S.S.,0,0,0,0
1667988037848,ECE 265D,A00,103662,Gudem; Prasad S.S.,0,0,0,0
1667988038272,ECE 268,A00,103663,Koushanfar; Farinaz,0,0,0,0
1667988038702,ECE 269,A01,103665,Pal; Piya,0,0,0,0
1667988039133,ECE 271B,A00,103666,Vasconcelos; Manuela,0,0,0,0
1667988039566,ECE 276A,A00,103667,Atanasov; Nikolay A.,0,0,0,0
1667988039989,ECE 277,A00,103668,An; Cheolhong,0,0,0,0
1667988040440,ECE 279,A00,117947,Hall; Drew A.,0,0,0,0
1667988041294,ECE 283,A00,103670,Hsueh; Tzu-Chien,0,0,0,0
1667988041719,ECE 284,A00,103671,Turakhia; Yatish Girish,0,0,0,0
1667988042152,ECE 285,A00,103672,Zheng; Yang,0,0,0,0
1667988042152,ECE 285,B00,103673,Sworder; David D.,0,0,0,0
1667988042582,ECE 287,A00,103676,Javidi; Tara,0,0,0,0
1667988043009,MATH 200B,A00,098023,Salehi Golsefidy; Alireza,14,0,15,1
1667988043440,MATH 202B,A00,098024,Rhoades; Brendon Patrick,12,0,15,3
1667988043863,MATH 203B,A00,098025,Oprea; Dragos N.,12,0,15,3
1667988044286,MATH 204B,A00,098026,Sorensen; Claus M,14,0,15,1
1667988044713,MATH 208,A00,098027,Izadi; Elham,7,0,10,3
1667988045140,MATH 209,A00,098028,Pollack; Aaron,10,0,10,0
1667988045568,MATH 211A,A00,112919,Rogalski; Daniel,9,0,10,1
1667988045990,MATH 211B,A00,112920,Seward; Brandon M.,9,0,10,1
1667988046419,MATH 218,A00,098029,Li; Bo,10,0,10,0
1667988046844,MATH 220B,A00,098030,Novak; Jonathan I,13,0,15,2
1667988047270,MATH 221A,A00,098031,Ebenfelt; Peter F,13,0,15,2
1667988047698,MATH 231B,A00,098032,Zlatos; Andrej,12,0,15,3
1667988048125,MATH 240B,A00,098033,Ni; Lei,10,0,15,5
1667988048554,MATH 243,A00,098034,Jekel; David Andrew,10,0,10,0
1667988048981,MATH 245A,A00,098035,Nie; Jiawang,0,0,15,16
1667988049408,MATH 248,A00,098036,Bejenaru; Ioan,10,0,10,0
1667988049831,MATH 250B,A00,098037,Spolaor; Luca,14,0,15,1
1667988050256,MATH 258,A00,098038,Ni; Lei,10,0,10,0
1667988050684,MATH 264B,A00,098041,Rhoades; Brendon Patrick,11,0,15,4
1667988051113,MATH 268,A00,098042,Buss; Samuel R,10,0,10,0
1667988051540,MATH 269,A00,098043,Rhoades; Brendon Patrick,10,0,10,0
1667988051970,MATH 270B,A00,098044,Li; Bo,11,0,15,4
1667988052394,MATH 272B,A00,098045,Holst; Michael J,13,0,15,2
1667988052819,MATH 273A,A00,098046,Tian; Xiaochuan,12,0,15,3
1667988053244,MATH 275,A01,098048,Tian; Xiaochuan,6,0,10,4
1667988053672,MATH 278A,A00,098049,Holst; Michael J,8,0,10,2
1667988054099,MATH 278B,A00,098050,Cloninger; Alexander,10,0,10,0
1667988054522,MATH 278C,A00,098051,Nie; Jiawang,8,0,10,2
1667988054952,MATH 280B,A00,098052,Zheng; Tianyi,11,0,15,4
1667988055375,MATH 281B,A00,098053,Bradic; Jelena,4,0,15,11
1667988055799,MATH 282B,A00,098054,Arias-Castro; Ery,2,0,15,13
1667988056228,MATH 285,A00,098055,Fitzsimmons; Patrick J,0,0,15,17
1667988056651,MATH 287B,A00,098056,Arias-Castro; Ery,5,0,15,10
1667988057080,MATH 288,A00,098057,Agarwal; Pooja,9,0,10,1
1667988057080,MATH 288,B00,098058,Zhang; Danna,9,0,10,1
1667988057080,MATH 288,C00,098059,Williams; Ruth J,10,0,10,0
1667988057507,MATH 290B,A00,098060,Roberts; Justin Deritter,14,0,15,1
1667988057934,MATH 292,A00,098061,Belmont; Eva Kinoshita,10,0,10,0
1667988058362,MATH 295,A00,098062,Suk; Andrew Hoon,48,0,50,2
1667988058787,MATH 296,A00,098063,Novak; Jonathan I,20,0,20,0
1667988059214,MATH 297,001,098064,Gamst; Anthony Collins,9997,0,9999,2
1667988560583,COGS 205,A00,101395,Chiba; Andrea,19,0,20,1
1667988561019,COGS 210B,001,101404,Greene; Deanna Jacquelyn,9998,0,9999,1
1667988561019,COGS 210B,002,101417,Xia; Haijun,9999,0,9999,0
1667988561019,COGS 210B,003,101422,Nitz; Douglas A.,9999,0,9999,0
1667988561019,COGS 210B,004,101423,Hollan; James D.,9998,0,9999,1
1667988561019,COGS 210B,005,101424,Deak; Gedeon O.,9999,0,9999,0
1667988561019,COGS 210B,006,101425,Rossano; Federico,9999,0,9999,0
1667988561445,COGS 211B,A00,101427,Coulson; Seana M,9997,0,9999,2
1667988561870,COGS 220,A00,101428,Hollan; James D.,0,0,25,25
1667988562297,COGS 229,A00,101429,Dow; Steven P,18,0,25,7
1667988562720,COGS 230,A00,101430,Klemmer; Scott R,13,0,17,4
1667988563149,COGS 234,A00,101431,Xia; Haijun,7,0,25,18
1667988563577,COGS 260,A00,101432,Kiyonaga; Anastasia,20,0,25,5
1667988563577,COGS 260,B00,101433,Kirsh; David Joel,16,0,25,9
1667988564010,CSE 202,A00,102371,Impagliazzo; Russell,0,0,0,0
1667988564449,CSE 203B,A01,102373,Cheng; Chung Kuan,0,0,0,0
1667988564878,CSE 208,A00,102374,Micciancio; Daniele,0,0,0,0
1667988565307,CSE 209A,A00,112895,Impagliazzo; Russell,0,0,15,15
1667988565733,CSE 209B,A00,108005,Bellare; Mihir,0,0,0,0
1667988566164,CSE 210,A00,113163,Coblenz; Michael J,0,0,0,0
1667988566595,CSE 219,A00,106111,Dow; Steven P,1,0,20,19
1667988567019,CSE 221,A00,102376,Voelker; Geoffrey M.,0,0,0,0
1667988567444,CSE 224,A01,102378,Porter; George M,0,0,0,0
1667988567870,CSE 229A,A00,102379,Savage; Stefan,0,0,0,0
1667988568299,CSE 229C,A00,102380,Munyaka; Imani N. S.,0,0,0,0
1667988568724,CSE 232B,A00,102382,Deutsch; Alin Bernard,0,0,0,0
1667988569153,CSE 234,A01,112904,Kumar; Arun Kumar,0,0,0,0
1667988569579,CSE 237A,A00,102383,Rosing; Tajana Simunic,0,0,0,0
1667988570006,CSE 239A,A00,102384,Deutsch; Alin Bernard,0,0,0,0
1667988570435,CSE 239B,A00,102385,Polikarpova; Nadezhda,0,0,0,0
1667988570860,CSE 240A,A00,102386,Pannuto; Patrick William,0,0,0,0
1667988571283,CSE 240B,A00,102387,Zhao; Jishen,0,0,0,0
1667988571707,CSE 241A,A00,106406,Kang; Mingu,0,0,0,0
1667988572129,CSE 249B,A00,102388,Kahng; Andrew Byun,0,0,8,8
1667988572575,CSE 251B,A01,102392,Cottrell; Garrison W,0,0,0,0
1667988572575,CSE 251B,A02,102393,Cottrell; Garrison W,0,0,0,0
1667988572998,CSE 252B,A00,102394,Ochoa; Benjamin Lawrence,0,0,0,0
1667988573426,CSE 257,A01,102396,Gao; Sicun,0,0,0,0
1667988573855,CSE 272,A00,102397,Li; Tzumao,0,0,0,0
1667988574284,CSE 274,A00,111323,Chern; Albert Ren-Haur,0,0,0,0
1667988574710,CSE 282,A00,102398,Pevzner; Pavel Arkadjevich,0,0,0,0
1667988575139,CSE 284,A00,114175,Gymrek; Melissa Ann,0,0,0,0
1667988575565,CSE 290,A00,102399,Chandraker; Manmohan Krishna,0,0,0,0
1667988575565,CSE 290,B00,102400,Vaccaro; Kristen Marie,0,0,25,25
1667988575565,CSE 290,C00,102414,Pannuto; Patrick William,0,0,25,25
1667988575565,CSE 290,D00,102427,Pevzner; Pavel Arkadjevich,0,0,0,0
1667988575565,CSE 290,E00,102429,Zhao; Jishen,0,0,0,0
1667988575565,CSE 290,F00,102436,Tullsen; Dean Michael,0,0,0,0
1667988575565,CSE 290,G00,102440,Christensen; Henrik I,0,0,20,20
1667988575993,CSE 291,A00,102443,Su; Hao,0,0,0,0
1667988575993,CSE 291,B00,102448,Polikarpova; Nadezhda,0,0,0,0
1667988575993,CSE 291,C00,102453,Vaccaro; Kristen Marie,0,0,0,0
1667988575993,CSE 291,D00,111343,Savage; Stefan,0,0,0,0
1667988575993,CSE 291,E00,116474,Claffy; Kimberly Claire,0,0,0,0
1667988575993,CSE 291,F00,116479,Pasquale; Joseph,0,0,0,0
1667988576439,CSE 293,001,119111,Bafna; Vineet,9999,0,9999,0
1667988576439,CSE 293,002,119118,Bellare; Mihir,9999,0,9999,0
1667988576439,CSE 293,003,119122,Berg-Kirkpatrick; Taylor D,9999,0,9999,0
1667988576439,CSE 293,004,119135,Christensen; Henrik I,9999,0,9999,0
1667988576439,CSE 293,005,119142,Cottrell; Garrison W,9999,0,9999,0
1667988576439,CSE 293,006,119146,Deutsch; Alin Bernard,9999,0,9999,0
1667988576439,CSE 293,007,119159,Esmaeilzadeh; Hadi,9999,0,9999,0
1667988576439,CSE 293,008,119166,Freund; Yoav,9999,0,9999,0
1667988576439,CSE 293,009,119170,Griswold; William G.,9999,0,9999,0
1667988576439,CSE 293,010,119183,Gymrek; Melissa Ann,9999,0,9999,0
1667988576439,CSE 293,011,119190,Heninger; Nadia A,9999,0,9999,0
1667988576439,CSE 293,012,119230,Impagliazzo; Russell,9999,0,9999,0
1667988576439,CSE 293,013,119232,Jhala; Ranjit,9999,0,9999,0
1667988576439,CSE 293,014,119233,Kahng; Andrew Byun,9999,0,9999,0
1667988576439,CSE 293,015,119298,Kane; Daniel Mertz,9999,0,9999,0
1667988576439,CSE 293,016,119299,Kriegman; David J,9999,0,9999,0
1667988576439,CSE 293,017,119300,Kumar; Arun Kumar,9999,0,9999,0
1667988576439,CSE 293,018,119301,Lerner; Sorin,9999,0,9999,0
1667988576439,CSE 293,019,119302,Lovett; Shachar,9999,0,9999,0
1667988576439,CSE 293,020,119303,McAuley; Julian John,9999,0,9999,0
1667988576439,CSE 293,021,119304,Micciancio; Daniele,9999,0,9999,0
1667988576439,CSE 293,022,119367,Orailoglu; Alex,9999,0,9999,0
1667988576439,CSE 293,023,119382,Paturi; Ramamohan,9999,0,9999,0
1667988576439,CSE 293,024,119404,Polikarpova; Nadezhda,9999,0,9999,0
1667988576439,CSE 293,025,119406,Politz; Joseph Gibbs,9999,0,9999,0
1667988576439,CSE 293,026,119411,Porter; George M,9999,0,9999,0
1667988576439,CSE 293,027,119414,Porter; Leonard Emerson,9999,0,9999,0
1667988576439,CSE 293,028,119416,Ramamoorthi; Ravi,9999,0,9999,0
1667988576439,CSE 293,029,119417,Sahoo; Debashis,9999,0,9999,0
1667988576439,CSE 293,030,119420,Saul; Lawrence,9999,0,9999,0
1667988576439,CSE 293,031,119421,Savage; Stefan,9999,0,9999,0
1667988576439,CSE 293,032,119425,Schulze; Jurgen P.,9999,0,9999,0
1667988576439,CSE 293,033,119426,Snoeren; Alex C.,9999,0,9999,0
1667988576439,CSE 293,034,119428,Shang; Jingbo,9999,0,9999,0
1667988576439,CSE 293,035,119430,Stefan; Deian,9999,0,9999,0
1667988576439,CSE 293,036,119431,Su; Hao,9999,0,9999,0
1667988576439,CSE 293,037,119433,Swanson; Steven James,9999,0,9999,0
1667988576439,CSE 293,038,119435,Tullsen; Dean Michael,9999,0,9999,0
1667988576439,CSE 293,039,119483,Voelker; Geoffrey M.,9999,0,9999,0
1667988576439,CSE 293,040,119537,Zhao; Jishen,9999,0,9999,0
1667988576439,CSE 293,041,119538,Zhou; Yuan-Yuan,9999,0,9999,0
1667988576439,CSE 293,042,119539,Gao; Sicun,9999,0,9999,0
1667988576439,CSE 293,043,119540,Weibel; Nadir,9999,0,9999,0
1667988576439,CSE 293,044,119541,Gupta; Rajesh K.,9999,0,9999,0
1667988576439,CSE 293,045,126410,Vaccaro; Kristen Marie,9999,0,9999,0
1667988576439,CSE 293,046,126411,Klemke; Richard,9999,0,9999,0
1667988576864,CSE 294,A00,102459,Voelker; Geoffrey M.,0,0,0,0
1667988576864,CSE 294,B00,111322,Orailoglu; Alex,0,0,0,0
1667988577289,DSE 201,A00,096914,Deutsch; Alin Bernard,30,0,30,0
1667988577715,DSE 210,A00,096915,Dasgupta; Sanjoy,30,0,30,0
1667988578140,DSE 260A,A00,096916,Altintas De Callaf; Ilkay,30,0,30,0
1667988578651,ECE 200,001,103586,Antipa; Nicholas A,9999,0,9999,0
1667988578651,ECE 200,002,103587,Atanasov; Nikolay A.,9999,0,9999,0
1667988578651,ECE 200,003,103588,Bharadia; Dinesh,9999,0,9999,0
1667988578651,ECE 200,004,103589,Cheng; Chung Kuan,9999,0,9999,0
1667988578651,ECE 200,005,103590,Cosman; Pamela C.,9999,0,9999,0
1667988578651,ECE 200,006,103591,Dayeh; Shadi Ahmad,9999,0,9999,0
1667988578651,ECE 200,007,103592,Fainman; Yeshaiahu,9999,0,9999,0
1667988578651,ECE 200,008,103593,Ford; Joseph Earl,9999,0,9999,0
1667988578651,ECE 200,009,103594,Franceschetti; Massimo,9999,0,9999,0
1667988578651,ECE 200,010,103595,Fullerton; Eric E,9999,0,9999,0
1667988578651,ECE 200,011,103596,Galton; Ian A,9999,0,9999,0
1667988578651,ECE 200,012,103597,Gilja; Vikash,9999,0,9999,0
1667988578651,ECE 200,013,103598,Hall; Drew A.,9999,0,9999,0
1667988578651,ECE 200,014,103599,Hsueh; Tzu-Chien,9999,0,9999,0
1667988578651,ECE 200,015,103600,Javidi; Tara,9999,0,9999,0
1667988578651,ECE 200,016,103601,Kahng; Andrew Byun,9999,0,9999,0
1667988578651,ECE 200,017,103602,Kim; Young-Han,9999,0,9999,0
1667988578651,ECE 200,018,103603,Koushanfar; Farinaz,9999,0,9999,0
1667988578651,ECE 200,019,103604,Kuzum; Duygu,9999,0,9999,0
1667988578651,ECE 200,020,103605,Le; Hanh-Phuc,9999,0,9999,0
1667988578651,ECE 200,021,103606,Lin; Bill,9999,0,9999,0
1667988578651,ECE 200,022,103607,Liu; Zhaowei,9998,0,9999,1
1667988578651,ECE 200,023,103608,Lo; Yu-Hwa,9999,0,9999,0
1667988578651,ECE 200,024,103609,Lomakin; Vitaliy,9999,0,9999,0
1667988578651,ECE 200,025,103610,Mercier; Patrick Philip,9999,0,9999,0
1667988578651,ECE 200,026,103611,Meyer; Florian,9999,0,9999,0
1667988578651,ECE 200,027,103612,Milstein; Laurence B.,9999,0,9999,0
1667988578651,ECE 200,028,103613,Mir Arabbaygi; Siavash,9999,0,9999,0
1667988578651,ECE 200,029,103614,Mookherjea; Shayan,9999,0,9999,0
1667988578651,ECE 200,030,103615,Morris; Karcher William,9999,0,9999,0
1667988578651,ECE 200,031,103616,Ng; Tse Nga,9999,0,9999,0
1667988578651,ECE 200,032,103617,Nguyen; Truong Quang,9999,0,9999,0
1667988578651,ECE 200,033,103618,Nomura; Kenji,9999,0,9999,0
1667988578651,ECE 200,034,103619,Orlitsky; Alon,9999,0,9999,0
1667988578651,ECE 200,035,103620,Pal; Piya,9999,0,9999,0
1667988578651,ECE 200,036,103621,Papen; George C.,9999,0,9999,0
1667988578651,ECE 200,037,103622,Radic; Stojan,9999,0,9999,0
1667988578651,ECE 200,038,103623,Rao; Bhaskar D.,9999,0,9999,0
1667988578651,ECE 200,039,103624,Rao; Ramesh R,9999,0,9999,0
1667988578651,ECE 200,040,103625,Rebeiz; Gabriel,9999,0,9999,0
1667988578651,ECE 200,041,103626,Sanford; John R,9999,0,9999,0
1667988578651,ECE 200,042,103627,Siegel; Paul H.,9999,0,9999,0
1667988578651,ECE 200,043,103628,Sievenpiper; Daniel F.,9999,0,9999,0
1667988578651,ECE 200,044,103629,Sworder; David D.,9999,0,9999,0
1667988578651,ECE 200,045,103630,Taur; Yuan,9999,0,9999,0
1667988578651,ECE 200,046,103631,Touri; Behrouz,9999,0,9999,0
1667988578651,ECE 200,047,103632,Trivedi; Mohan M.,9999,0,9999,0
1667988578651,ECE 200,048,103633,Vasconcelos; Nuno,9999,0,9999,0
1667988578651,ECE 200,049,103634,Wang; Xiaolong,9999,0,9999,0
1667988578651,ECE 200,050,103635,Xie; Pengtao,9999,0,9999,0
1667988578651,ECE 200,051,103636,Yip; Michael,9999,0,9999,0
1667988578651,ECE 200,052,103637,Zeger; Kenneth A.,999,0,999,0
1667988578651,ECE 200,053,103638,Zhang; Xinyu,9999,0,9999,0
1667988578651,ECE 200,054,103639,Turakhia; Yatish Girish,9999,0,9999,0
1667988578651,ECE 200,055,103640,Kang; Mingu,9999,0,9999,0
1667988578651,ECE 200,056,103641,Shi; Yuanyuan,9999,0,9999,0
1667988578651,ECE 200,057,103642,Wang; Edward Jay,9999,0,9999,0
1667988578651,ECE 200,058,103643,Zheng; Yang,9999,0,9999,0
1667988579078,ECE 202,A00,103644,Kuzum; Duygu,0,0,0,0
1667988579500,ECE 212BN,A00,103646,Ng; Tse Nga,0,0,0,0
1667988579925,ECE 221,A00,111493,Staff,0,0,0,0
1667988580349,ECE 222B,A00,103647,Lomakin; Vitaliy,0,0,0,0
1667988580776,ECE 230B,A00,103648,Taur; Yuan,0,0,0,0
1667988581205,ECE 238B,A00,103649,Garay; Javier,0,0,0,0
1667988581634,ECE 240B,A00,112900,Fainman; Yeshaiahu,0,0,0,0
1667988582061,ECE 247A,A00,103650,Jokerst; Jesse Vincent,0,0,0,0
1667988582488,ECE 247B,A00,103651,Wang; Joseph,0,0,0,0
1667988582915,ECE 250,A00,103652,Siegel; Paul H.,0,0,0,0
1667988583414,ECE 251A,A00,103654,Rao; Bhaskar D.,0,0,0,0
1667988583836,ECE 257B,A00,103655,Bharadia; Dinesh,0,0,0,0
1667988584268,ECE 258A,A00,103656,Milstein; Laurence B.,0,0,0,0
1667988584693,ECE 260B,A00,103658,Kang; Mingu,0,0,0,0
1667988585122,ECE 264A,A00,103659,Galton; Ian A,0,0,0,0
1667988585547,ECE 265A,A00,103661,Gudem; Prasad S.S.,0,0,0,0
1667988585976,ECE 265D,A00,103662,Gudem; Prasad S.S.,0,0,0,0
1667988586404,ECE 268,A00,103663,Koushanfar; Farinaz,0,0,0,0
1667988586830,ECE 269,A01,103665,Pal; Piya,0,0,0,0
1667988587262,ECE 271B,A00,103666,Vasconcelos; Manuela,0,0,0,0
1667988587687,ECE 276A,A00,103667,Atanasov; Nikolay A.,0,0,0,0
1667988588120,ECE 277,A00,103668,An; Cheolhong,0,0,0,0
1667988588544,ECE 279,A00,117947,Hall; Drew A.,0,0,0,0
1667988589407,ECE 283,A00,103670,Hsueh; Tzu-Chien,0,0,0,0
1667988589830,ECE 284,A00,103671,Turakhia; Yatish Girish,0,0,0,0
1667988590259,ECE 285,A00,103672,Zheng; Yang,0,0,0,0
1667988590259,ECE 285,B00,103673,Sworder; David D.,0,0,0,0
1667988590683,ECE 287,A00,103676,Javidi; Tara,0,0,0,0
1667988591113,MATH 200B,A00,098023,Salehi Golsefidy; Alireza,14,0,15,1
1667988591539,MATH 202B,A00,098024,Rhoades; Brendon Patrick,12,0,15,3
1667988591967,MATH 203B,A00,098025,Oprea; Dragos N.,12,0,15,3
1667988592392,MATH 204B,A00,098026,Sorensen; Claus M,14,0,15,1
1667988592818,MATH 208,A00,098027,Izadi; Elham,7,0,10,3
1667988593242,MATH 209,A00,098028,Pollack; Aaron,10,0,10,0
1667988593667,MATH 211A,A00,112919,Rogalski; Daniel,9,0,10,1
1667988594091,MATH 211B,A00,112920,Seward; Brandon M.,9,0,10,1
1667988594518,MATH 218,A00,098029,Li; Bo,10,0,10,0
1667988594950,MATH 220B,A00,098030,Novak; Jonathan I,13,0,15,2
1667988595377,MATH 221A,A00,098031,Ebenfelt; Peter F,13,0,15,2
1667988595801,MATH 231B,A00,098032,Zlatos; Andrej,12,0,15,3
1667988596236,MATH 240B,A00,098033,Ni; Lei,10,0,15,5
1667988596662,MATH 243,A00,098034,Jekel; David Andrew,10,0,10,0
1667988597087,MATH 245A,A00,098035,Nie; Jiawang,0,0,15,16
1667988597512,MATH 248,A00,098036,Bejenaru; Ioan,10,0,10,0
1667988597940,MATH 250B,A00,098037,Spolaor; Luca,14,0,15,1
1667988598364,MATH 258,A00,098038,Ni; Lei,10,0,10,0
1667988598788,MATH 264B,A00,098041,Rhoades; Brendon Patrick,11,0,15,4
1667988599211,MATH 268,A00,098042,Buss; Samuel R,10,0,10,0
1667988599638,MATH 269,A00,098043,Rhoades; Brendon Patrick,10,0,10,0
1667988600065,MATH 270B,A00,098044,Li; Bo,11,0,15,4
1667988600489,MATH 272B,A00,098045,Holst; Michael J,13,0,15,2
1667988600918,MATH 273A,A00,098046,Tian; Xiaochuan,12,0,15,3
1667988601358,MATH 275,A01,098048,Tian; Xiaochuan,6,0,10,4
1667988601786,MATH 278A,A00,098049,Holst; Michael J,8,0,10,2
1667988602212,MATH 278B,A00,098050,Cloninger; Alexander,10,0,10,0
1667988602637,MATH 278C,A00,098051,Nie; Jiawang,8,0,10,2
1667988603067,MATH 280B,A00,098052,Zheng; Tianyi,11,0,15,4
1667988603490,MATH 281B,A00,098053,Bradic; Jelena,4,0,15,11
1667988603917,MATH 282B,A00,098054,Arias-Castro; Ery,2,0,15,13
1667988604341,MATH 285,A00,098055,Fitzsimmons; Patrick J,0,0,15,17
1667988604773,MATH 287B,A00,098056,Arias-Castro; Ery,5,0,15,10
1667988605202,MATH 288,A00,098057,Agarwal; Pooja,9,0,10,1
1667988605202,MATH 288,B00,098058,Zhang; Danna,9,0,10,1
1667988605202,MATH 288,C00,098059,Williams; Ruth J,10,0,10,0
1667988605629,MATH 290B,A00,098060,Roberts; Justin Deritter,14,0,15,1
1667988606058,MATH 292,A00,098061,Belmont; Eva Kinoshita,10,0,10,0
1667988606483,MATH 295,A00,098062,Suk; Andrew Hoon,48,0,50,2
1667988606910,MATH 296,A00,098063,Novak; Jonathan I,20,0,20,0
1667988607337,MATH 297,001,098064,Gamst; Anthony Collins,9997,0,9999,2
1667989112230,COGS 205,A00,101395,Chiba; Andrea,19,0,20,1
1667989112655,COGS 210B,001,101404,Greene; Deanna Jacquelyn,9998,0,9999,1
1667989112655,COGS 210B,002,101417,Xia; Haijun,9999,0,9999,0
1667989112655,COGS 210B,003,101422,Nitz; Douglas A.,9999,0,9999,0
1667989112655,COGS 210B,004,101423,Hollan; James D.,9998,0,9999,1
1667989112655,COGS 210B,005,101424,Deak; Gedeon O.,9999,0,9999,0
1667989112655,COGS 210B,006,101425,Rossano; Federico,9999,0,9999,0
1667989113082,COGS 211B,A00,101427,Coulson; Seana M,9997,0,9999,2
1667989113504,COGS 220,A00,101428,Hollan; James D.,0,0,25,25
1667989113933,COGS 229,A00,101429,Dow; Steven P,18,0,25,7
1667989114358,COGS 230,A00,101430,Klemmer; Scott R,13,0,17,4
1667989114784,COGS 234,A00,101431,Xia; Haijun,7,0,25,18
1667989115211,COGS 260,A00,101432,Kiyonaga; Anastasia,20,0,25,5
1667989115211,COGS 260,B00,101433,Kirsh; David Joel,16,0,25,9
1667989115643,CSE 202,A00,102371,Impagliazzo; Russell,0,0,0,0
1667989116069,CSE 203B,A01,102373,Cheng; Chung Kuan,0,0,0,0
1667989116496,CSE 208,A00,102374,Micciancio; Daniele,0,0,0,0
1667989116922,CSE 209A,A00,112895,Impagliazzo; Russell,0,0,15,15
1667989117363,CSE 209B,A00,108005,Bellare; Mihir,0,0,0,0
1667989117788,CSE 210,A00,113163,Coblenz; Michael J,0,0,0,0
1667989118212,CSE 219,A00,106111,Dow; Steven P,1,0,20,19
1667989118637,CSE 221,A00,102376,Voelker; Geoffrey M.,0,0,0,0
1667989119063,CSE 224,A01,102378,Porter; George M,0,0,0,0
1667989119493,CSE 229A,A00,102379,Savage; Stefan,0,0,0,0
1667989119919,CSE 229C,A00,102380,Munyaka; Imani N. S.,0,0,0,0
1667989120344,CSE 232B,A00,102382,Deutsch; Alin Bernard,0,0,0,0
1667989120775,CSE 234,A01,112904,Kumar; Arun Kumar,0,0,0,0
1667989121200,CSE 237A,A00,102383,Rosing; Tajana Simunic,0,0,0,0
1667989121623,CSE 239A,A00,102384,Deutsch; Alin Bernard,0,0,0,0
1667989122055,CSE 239B,A00,102385,Polikarpova; Nadezhda,0,0,0,0
1667989122479,CSE 240A,A00,102386,Pannuto; Patrick William,0,0,0,0
1667989122912,CSE 240B,A00,102387,Zhao; Jishen,0,0,0,0
1667989123337,CSE 241A,A00,106406,Kang; Mingu,0,0,0,0
1667989123762,CSE 249B,A00,102388,Kahng; Andrew Byun,0,0,8,8
1667989124186,CSE 251B,A01,102392,Cottrell; Garrison W,0,0,0,0
1667989124186,CSE 251B,A02,102393,Cottrell; Garrison W,0,0,0,0
1667989124611,CSE 252B,A00,102394,Ochoa; Benjamin Lawrence,0,0,0,0
1667989125034,CSE 257,A01,102396,Gao; Sicun,0,0,0,0
1667989125463,CSE 272,A00,102397,Li; Tzumao,0,0,0,0
1667989125889,CSE 274,A00,111323,Chern; Albert Ren-Haur,0,0,0,0
1667989126311,CSE 282,A00,102398,Pevzner; Pavel Arkadjevich,0,0,0,0
1667989126743,CSE 284,A00,114175,Gymrek; Melissa Ann,0,0,0,0
1667989127176,CSE 290,A00,102399,Chandraker; Manmohan Krishna,0,0,0,0
1667989127176,CSE 290,B00,102400,Vaccaro; Kristen Marie,0,0,25,25
1667989127176,CSE 290,C00,102414,Pannuto; Patrick William,0,0,25,25
1667989127176,CSE 290,D00,102427,Pevzner; Pavel Arkadjevich,0,0,0,0
1667989127176,CSE 290,E00,102429,Zhao; Jishen,0,0,0,0
1667989127176,CSE 290,F00,102436,Tullsen; Dean Michael,0,0,0,0
1667989127176,CSE 290,G00,102440,Christensen; Henrik I,0,0,20,20
1667989127604,CSE 291,A00,102443,Su; Hao,0,0,0,0
1667989127604,CSE 291,B00,102448,Polikarpova; Nadezhda,0,0,0,0
1667989127604,CSE 291,C00,102453,Vaccaro; Kristen Marie,0,0,0,0
1667989127604,CSE 291,D00,111343,Savage; Stefan,0,0,0,0
1667989127604,CSE 291,E00,116474,Claffy; Kimberly Claire,0,0,0,0
1667989127604,CSE 291,F00,116479,Pasquale; Joseph,0,0,0,0
1667989128109,CSE 293,001,119111,Bafna; Vineet,9999,0,9999,0
1667989128109,CSE 293,002,119118,Bellare; Mihir,9999,0,9999,0
1667989128109,CSE 293,003,119122,Berg-Kirkpatrick; Taylor D,9999,0,9999,0
1667989128109,CSE 293,004,119135,Christensen; Henrik I,9999,0,9999,0
1667989128109,CSE 293,005,119142,Cottrell; Garrison W,9999,0,9999,0
1667989128109,CSE 293,006,119146,Deutsch; Alin Bernard,9999,0,9999,0
1667989128109,CSE 293,007,119159,Esmaeilzadeh; Hadi,9999,0,9999,0
1667989128109,CSE 293,008,119166,Freund; Yoav,9999,0,9999,0
1667989128109,CSE 293,009,119170,Griswold; William G.,9999,0,9999,0
1667989128109,CSE 293,010,119183,Gymrek; Melissa Ann,9999,0,9999,0
1667989128109,CSE 293,011,119190,Heninger; Nadia A,9999,0,9999,0
1667989128109,CSE 293,012,119230,Impagliazzo; Russell,9999,0,9999,0
1667989128109,CSE 293,013,119232,Jhala; Ranjit,9999,0,9999,0
1667989128109,CSE 293,014,119233,Kahng; Andrew Byun,9999,0,9999,0
1667989128109,CSE 293,015,119298,Kane; Daniel Mertz,9999,0,9999,0
1667989128109,CSE 293,016,119299,Kriegman; David J,9999,0,9999,0
1667989128109,CSE 293,017,119300,Kumar; Arun Kumar,9999,0,9999,0
1667989128109,CSE 293,018,119301,Lerner; Sorin,9999,0,9999,0
1667989128109,CSE 293,019,119302,Lovett; Shachar,9999,0,9999,0
1667989128109,CSE 293,020,119303,McAuley; Julian John,9999,0,9999,0
1667989128109,CSE 293,021,119304,Micciancio; Daniele,9999,0,9999,0
1667989128109,CSE 293,022,119367,Orailoglu; Alex,9999,0,9999,0
1667989128109,CSE 293,023,119382,Paturi; Ramamohan,9999,0,9999,0
1667989128109,CSE 293,024,119404,Polikarpova; Nadezhda,9999,0,9999,0
1667989128109,CSE 293,025,119406,Politz; Joseph Gibbs,9999,0,9999,0
1667989128109,CSE 293,026,119411,Porter; George M,9999,0,9999,0
1667989128109,CSE 293,027,119414,Porter; Leonard Emerson,9999,0,9999,0
1667989128109,CSE 293,028,119416,Ramamoorthi; Ravi,9999,0,9999,0
1667989128109,CSE 293,029,119417,Sahoo; Debashis,9999,0,9999,0
1667989128109,CSE 293,030,119420,Saul; Lawrence,9999,0,9999,0
1667989128109,CSE 293,031,119421,Savage; Stefan,9999,0,9999,0
1667989128109,CSE 293,032,119425,Schulze; Jurgen P.,9999,0,9999,0
1667989128109,CSE 293,033,119426,Snoeren; Alex C.,9999,0,9999,0
1667989128109,CSE 293,034,119428,Shang; Jingbo,9999,0,9999,0
1667989128109,CSE 293,035,119430,Stefan; Deian,9999,0,9999,0
1667989128109,CSE 293,036,119431,Su; Hao,9999,0,9999,0
1667989128109,CSE 293,037,119433,Swanson; Steven James,9999,0,9999,0
1667989128109,CSE 293,038,119435,Tullsen; Dean Michael,9999,0,9999,0
1667989128109,CSE 293,039,119483,Voelker; Geoffrey M.,9999,0,9999,0
1667989128109,CSE 293,040,119537,Zhao; Jishen,9999,0,9999,0
1667989128109,CSE 293,041,119538,Zhou; Yuan-Yuan,9999,0,9999,0
1667989128109,CSE 293,042,119539,Gao; Sicun,9999,0,9999,0
1667989128109,CSE 293,043,119540,Weibel; Nadir,9999,0,9999,0
1667989128109,CSE 293,044,119541,Gupta; Rajesh K.,9999,0,9999,0
1667989128109,CSE 293,045,126410,Vaccaro; Kristen Marie,9999,0,9999,0
1667989128109,CSE 293,046,126411,Klemke; Richard,9999,0,9999,0
1667989128533,CSE 294,A00,102459,Voelker; Geoffrey M.,0,0,0,0
1667989128533,CSE 294,B00,111322,Orailoglu; Alex,0,0,0,0
1667989128958,DSE 201,A00,096914,Deutsch; Alin Bernard,30,0,30,0
1667989129385,DSE 210,A00,096915,Dasgupta; Sanjoy,30,0,30,0
1667989129815,DSE 260A,A00,096916,Altintas De Callaf; Ilkay,30,0,30,0
1667989130276,ECE 200,001,103586,Antipa; Nicholas A,9999,0,9999,0
1667989130276,ECE 200,002,103587,Atanasov; Nikolay A.,9999,0,9999,0
1667989130276,ECE 200,003,103588,Bharadia; Dinesh,9999,0,9999,0
1667989130276,ECE 200,004,103589,Cheng; Chung Kuan,9999,0,9999,0
1667989130276,ECE 200,005,103590,Cosman; Pamela C.,9999,0,9999,0
1667989130276,ECE 200,006,103591,Dayeh; Shadi Ahmad,9999,0,9999,0
1667989130276,ECE 200,007,103592,Fainman; Yeshaiahu,9999,0,9999,0
1667989130276,ECE 200,008,103593,Ford; Joseph Earl,9999,0,9999,0
1667989130276,ECE 200,009,103594,Franceschetti; Massimo,9999,0,9999,0
1667989130276,ECE 200,010,103595,Fullerton; Eric E,9999,0,9999,0
1667989130276,ECE 200,011,103596,Galton; Ian A,9999,0,9999,0
1667989130276,ECE 200,012,103597,Gilja; Vikash,9999,0,9999,0
1667989130276,ECE 200,013,103598,Hall; Drew A.,9999,0,9999,0
1667989130276,ECE 200,014,103599,Hsueh; Tzu-Chien,9999,0,9999,0
1667989130276,ECE 200,015,103600,Javidi; Tara,9999,0,9999,0
1667989130276,ECE 200,016,103601,Kahng; Andrew Byun,9999,0,9999,0
1667989130276,ECE 200,017,103602,Kim; Young-Han,9999,0,9999,0
1667989130276,ECE 200,018,103603,Koushanfar; Farinaz,9999,0,9999,0
1667989130276,ECE 200,019,103604,Kuzum; Duygu,9999,0,9999,0
1667989130276,ECE 200,020,103605,Le; Hanh-Phuc,9999,0,9999,0
1667989130276,ECE 200,021,103606,Lin; Bill,9999,0,9999,0
1667989130276,ECE 200,022,103607,Liu; Zhaowei,9998,0,9999,1
1667989130276,ECE 200,023,103608,Lo; Yu-Hwa,9999,0,9999,0
1667989130276,ECE 200,024,103609,Lomakin; Vitaliy,9999,0,9999,0
1667989130276,ECE 200,025,103610,Mercier; Patrick Philip,9999,0,9999,0
1667989130276,ECE 200,026,103611,Meyer; Florian,9999,0,9999,0
1667989130276,ECE 200,027,103612,Milstein; Laurence B.,9999,0,9999,0
1667989130276,ECE 200,028,103613,Mir Arabbaygi; Siavash,9999,0,9999,0
1667989130276,ECE 200,029,103614,Mookherjea; Shayan,9999,0,9999,0
1667989130276,ECE 200,030,103615,Morris; Karcher William,9999,0,9999,0
1667989130276,ECE 200,031,103616,Ng; Tse Nga,9999,0,9999,0
1667989130276,ECE 200,032,103617,Nguyen; Truong Quang,9999,0,9999,0
1667989130276,ECE 200,033,103618,Nomura; Kenji,9999,0,9999,0
1667989130276,ECE 200,034,103619,Orlitsky; Alon,9999,0,9999,0
1667989130276,ECE 200,035,103620,Pal; Piya,9999,0,9999,0
1667989130276,ECE 200,036,103621,Papen; George C.,9999,0,9999,0
1667989130276,ECE 200,037,103622,Radic; Stojan,9999,0,9999,0
1667989130276,ECE 200,038,103623,Rao; Bhaskar D.,9999,0,9999,0
1667989130276,ECE 200,039,103624,Rao; Ramesh R,9999,0,9999,0
1667989130276,ECE 200,040,103625,Rebeiz; Gabriel,9999,0,9999,0
1667989130276,ECE 200,041,103626,Sanford; John R,9999,0,9999,0
1667989130276,ECE 200,042,103627,Siegel; Paul H.,9999,0,9999,0
1667989130276,ECE 200,043,103628,Sievenpiper; Daniel F.,9999,0,9999,0
1667989130276,ECE 200,044,103629,Sworder; David D.,9999,0,9999,0
1667989130276,ECE 200,045,103630,Taur; Yuan,9999,0,9999,0
1667989130276,ECE 200,046,103631,Touri; Behrouz,9999,0,9999,0
1667989130276,ECE 200,047,103632,Trivedi; Mohan M.,9999,0,9999,0
1667989130276,ECE 200,048,103633,Vasconcelos; Nuno,9999,0,9999,0
1667989130276,ECE 200,049,103634,Wang; Xiaolong,9999,0,9999,0
1667989130276,ECE 200,050,103635,Xie; Pengtao,9999,0,9999,0
1667989130276,ECE 200,051,103636,Yip; Michael,9999,0,9999,0
1667989130276,ECE 200,052,103637,Zeger; Kenneth A.,999,0,999,0
1667989130276,ECE 200,053,103638,Zhang; Xinyu,9999,0,9999,0
1667989130276,ECE 200,054,103639,Turakhia; Yatish Girish,9999,0,9999,0
1667989130276,ECE 200,055,103640,Kang; Mingu,9999,0,9999,0
1667989130276,ECE 200,056,103641,Shi; Yuanyuan,9999,0,9999,0
1667989130276,ECE 200,057,103642,Wang; Edward Jay,9999,0,9999,0
1667989130276,ECE 200,058,103643,Zheng; Yang,9999,0,9999,0
1667989130706,ECE 202,A00,103644,Kuzum; Duygu,0,0,0,0
1667989131131,ECE 212BN,A00,103646,Ng; Tse Nga,0,0,0,0
1667989131556,ECE 221,A00,111493,Staff,0,0,0,0
1667989131986,ECE 222B,A00,103647,Lomakin; Vitaliy,0,0,0,0
1667989132409,ECE 230B,A00,103648,Taur; Yuan,0,0,0,0
1667989132835,ECE 238B,A00,103649,Garay; Javier,0,0,0,0
1667989133259,ECE 240B,A00,112900,Fainman; Yeshaiahu,0,0,0,0
1667989133691,ECE 247A,A00,103650,Jokerst; Jesse Vincent,0,0,0,0
1667989134116,ECE 247B,A00,103651,Wang; Joseph,0,0,0,0
1667989134547,ECE 250,A00,103652,Siegel; Paul H.,0,0,0,0
1667989134972,ECE 251A,A00,103654,Rao; Bhaskar D.,0,0,0,0
1667989135395,ECE 257B,A00,103655,Bharadia; Dinesh,0,0,0,0
1667989135823,ECE 258A,A00,103656,Milstein; Laurence B.,0,0,0,0
1667989136250,ECE 260B,A00,103658,Kang; Mingu,0,0,0,0
1667989136680,ECE 264A,A00,103659,Galton; Ian A,0,0,0,0
1667989137106,ECE 265A,A00,103661,Gudem; Prasad S.S.,0,0,0,0
1667989137531,ECE 265D,A00,103662,Gudem; Prasad S.S.,0,0,0,0
1667989137957,ECE 268,A00,103663,Koushanfar; Farinaz,0,0,0,0
1667989138388,ECE 269,A01,103665,Pal; Piya,0,0,0,0
1667989138813,ECE 271B,A00,103666,Vasconcelos; Manuela,0,0,0,0
1667989139242,ECE 276A,A00,103667,Atanasov; Nikolay A.,0,0,0,0
1667989139669,ECE 277,A00,103668,An; Cheolhong,0,0,0,0
1667989140097,ECE 279,A00,117947,Hall; Drew A.,0,0,0,0
1667989140951,ECE 283,A00,103670,Hsueh; Tzu-Chien,0,0,0,0
1667989141374,ECE 284,A00,103671,Turakhia; Yatish Girish,0,0,0,0
1667989141797,ECE 285,A00,103672,Zheng; Yang,0,0,0,0
1667989141797,ECE 285,B00,103673,Sworder; David D.,0,0,0,0
1667989142222,ECE 287,A00,103676,Javidi; Tara,0,0,0,0
1667989142658,MATH 200B,A00,098023,Salehi Golsefidy; Alireza,14,0,15,1
1667989143084,MATH 202B,A00,098024,Rhoades; Brendon Patrick,12,0,15,3
1667989143511,MATH 203B,A00,098025,Oprea; Dragos N.,12,0,15,3
1667989143937,MATH 204B,A00,098026,Sorensen; Claus M,14,0,15,1
1667989144361,MATH 208,A00,098027,Izadi; Elham,7,0,10,3
1667989144788,MATH 209,A00,098028,Pollack; Aaron,10,0,10,0
1667989145218,MATH 211A,A00,112919,Rogalski; Daniel,9,0,10,1
1667989145646,MATH 211B,A00,112920,Seward; Brandon M.,9,0,10,1
1667989146073,MATH 218,A00,098029,Li; Bo,10,0,10,0
1667989146497,MATH 220B,A00,098030,Novak; Jonathan I,13,0,15,2
1667989146921,MATH 221A,A00,098031,Ebenfelt; Peter F,13,0,15,2
1667989147348,MATH 231B,A00,098032,Zlatos; Andrej,12,0,15,3
1667989147773,MATH 240B,A00,098033,Ni; Lei,10,0,15,5
1667989148200,MATH 243,A00,098034,Jekel; David Andrew,10,0,10,0
1667989148626,MATH 245A,A00,098035,Nie; Jiawang,0,0,15,16
1667989149055,MATH 248,A00,098036,Bejenaru; Ioan,10,0,10,0
1667989149479,MATH 250B,A00,098037,Spolaor; Luca,14,0,15,1
1667989149903,MATH 258,A00,098038,Ni; Lei,10,0,10,0
1667989150330,MATH 264B,A00,098041,Rhoades; Brendon Patrick,11,0,15,4
1667989150755,MATH 268,A00,098042,Buss; Samuel R,10,0,10,0
1667989151180,MATH 269,A00,098043,Rhoades; Brendon Patrick,10,0,10,0
1667989151701,MATH 270B,A00,098044,Li; Bo,11,0,15,4
1667989152129,MATH 272B,A00,098045,Holst; Michael J,13,0,15,2
1667989152554,MATH 273A,A00,098046,Tian; Xiaochuan,12,0,15,3
1667989152980,MATH 275,A01,098048,Tian; Xiaochuan,6,0,10,4
1667989153403,MATH 278A,A00,098049,Holst; Michael J,8,0,10,2
1667989153828,MATH 278B,A00,098050,Cloninger; Alexander,10,0,10,0
1667989154253,MATH 278C,A00,098051,Nie; Jiawang,8,0,10,2
1667989154678,MATH 280B,A00,098052,Zheng; Tianyi,11,0,15,4
1667989155101,MATH 281B,A00,098053,Bradic; Jelena,4,0,15,11
1667989155529,MATH 282B,A00,098054,Arias-Castro; Ery,2,0,15,13
1667989155955,MATH 285,A00,098055,Fitzsimmons; Patrick J,0,0,15,17
1667989156380,MATH 287B,A00,098056,Arias-Castro; Ery,5,0,15,10
1667989156807,MATH 288,A00,098057,Agarwal; Pooja,9,0,10,1
1667989156807,MATH 288,B00,098058,Zhang; Danna,9,0,10,1
1667989156807,MATH 288,C00,098059,Williams; Ruth J,10,0,10,0
1667989157235,MATH 290B,A00,098060,Roberts; Justin Deritter,14,0,15,1
1667989157669,MATH 292,A00,098061,Belmont; Eva Kinoshita,10,0,10,0
1667989158093,MATH 295,A00,098062,Suk; Andrew Hoon,48,0,50,2
1667989158519,MATH 296,A00,098063,Novak; Jonathan I,20,0,20,0
1667989158942,MATH 297,001,098064,Gamst; Anthony Collins,9997,0,9999,2
1667989659545,COGS 205,A00,101395,Chiba; Andrea,19,0,20,1
1667989659971,COGS 210B,001,101404,Greene; Deanna Jacquelyn,9998,0,9999,1
1667989659971,COGS 210B,002,101417,Xia; Haijun,9999,0,9999,0
1667989659971,COGS 210B,003,101422,Nitz; Douglas A.,9999,0,9999,0
1667989659971,COGS 210B,004,101423,Hollan; James D.,9998,0,9999,1
1667989659971,COGS 210B,005,101424,Deak; Gedeon O.,9999,0,9999,0
1667989659971,COGS 210B,006,101425,Rossano; Federico,9999,0,9999,0
1667989660400,COGS 211B,A00,101427,Coulson; Seana M,9997,0,9999,2
1667989660822,COGS 220,A00,101428,Hollan; James D.,0,0,25,25
1667989661250,COGS 229,A00,101429,Dow; Steven P,18,0,25,7
1667989661674,COGS 230,A00,101430,Klemmer; Scott R,13,0,17,4
1667989662097,COGS 234,A00,101431,Xia; Haijun,7,0,25,18
1667989662522,COGS 260,A00,101432,Kiyonaga; Anastasia,20,0,25,5
1667989662522,COGS 260,B00,101433,Kirsh; David Joel,16,0,25,9
1667989662951,CSE 202,A00,102371,Impagliazzo; Russell,0,0,0,0
1667989663380,CSE 203B,A01,102373,Cheng; Chung Kuan,0,0,0,0
1667989663802,CSE 208,A00,102374,Micciancio; Daniele,0,0,0,0
1667989664226,CSE 209A,A00,112895,Impagliazzo; Russell,0,0,15,15
1667989664649,CSE 209B,A00,108005,Bellare; Mihir,0,0,0,0
1667989665074,CSE 210,A00,113163,Coblenz; Michael J,0,0,0,0
1667989665498,CSE 219,A00,106111,Dow; Steven P,0,0,20,20
1667989665926,CSE 221,A00,102376,Voelker; Geoffrey M.,0,0,0,0
1667989666351,CSE 224,A01,102378,Porter; George M,0,0,0,0
1667989666774,CSE 229A,A00,102379,Savage; Stefan,0,0,0,0
1667989667198,CSE 229C,A00,102380,Munyaka; Imani N. S.,0,0,0,0
1667989667624,CSE 232B,A00,102382,Deutsch; Alin Bernard,0,0,0,0
1667989668048,CSE 234,A01,112904,Kumar; Arun Kumar,0,0,0,0
1667989668479,CSE 237A,A00,102383,Rosing; Tajana Simunic,0,0,0,0
1667989668906,CSE 239A,A00,102384,Deutsch; Alin Bernard,0,0,0,0
1667989669331,CSE 239B,A00,102385,Polikarpova; Nadezhda,0,0,0,0
1667989669761,CSE 240A,A00,102386,Pannuto; Patrick William,0,0,0,0
1667989670188,CSE 240B,A00,102387,Zhao; Jishen,0,0,0,0
1667989670612,CSE 241A,A00,106406,Kang; Mingu,0,0,0,0
1667989671037,CSE 249B,A00,102388,Kahng; Andrew Byun,0,0,8,8
1667989671462,CSE 251B,A01,102392,Cottrell; Garrison W,0,0,0,0
1667989671462,CSE 251B,A02,102393,Cottrell; Garrison W,0,0,0,0
1667989671886,CSE 252B,A00,102394,Ochoa; Benjamin Lawrence,0,0,0,0
1667989672422,CSE 257,A01,102396,Gao; Sicun,0,0,0,0
1667989672847,CSE 272,A00,102397,Li; Tzumao,0,0,0,0
1667989673271,CSE 274,A00,111323,Chern; Albert Ren-Haur,0,0,0,0
1667989673699,CSE 282,A00,102398,Pevzner; Pavel Arkadjevich,0,0,0,0
1667989674128,CSE 284,A00,114175,Gymrek; Melissa Ann,0,0,0,0
1667989674557,CSE 290,A00,102399,Chandraker; Manmohan Krishna,0,0,0,0
1667989674557,CSE 290,B00,102400,Vaccaro; Kristen Marie,0,0,25,25
1667989674557,CSE 290,C00,102414,Pannuto; Patrick William,0,0,25,25
1667989674557,CSE 290,D00,102427,Pevzner; Pavel Arkadjevich,0,0,0,0
1667989674557,CSE 290,E00,102429,Zhao; Jishen,0,0,0,0
1667989674557,CSE 290,F00,102436,Tullsen; Dean Michael,0,0,0,0
1667989674557,CSE 290,G00,102440,Christensen; Henrik I,0,0,20,20
1667989674982,CSE 291,A00,102443,Su; Hao,0,0,0,0
1667989674982,CSE 291,B00,102448,Polikarpova; Nadezhda,0,0,0,0
1667989674982,CSE 291,C00,102453,Vaccaro; Kristen Marie,0,0,0,0
1667989674982,CSE 291,D00,111343,Savage; Stefan,0,0,0,0
1667989674982,CSE 291,E00,116474,Claffy; Kimberly Claire,0,0,0,0
1667989674982,CSE 291,F00,116479,Pasquale; Joseph,0,0,0,0
1667989675451,CSE 293,001,119111,Bafna; Vineet,9999,0,9999,0
1667989675451,CSE 293,002,119118,Bellare; Mihir,9999,0,9999,0
1667989675451,CSE 293,003,119122,Berg-Kirkpatrick; Taylor D,9999,0,9999,0
1667989675451,CSE 293,004,119135,Christensen; Henrik I,9999,0,9999,0
1667989675451,CSE 293,005,119142,Cottrell; Garrison W,9999,0,9999,0
1667989675451,CSE 293,006,119146,Deutsch; Alin Bernard,9999,0,9999,0
1667989675451,CSE 293,007,119159,Esmaeilzadeh; Hadi,9999,0,9999,0
1667989675451,CSE 293,008,119166,Freund; Yoav,9999,0,9999,0
1667989675451,CSE 293,009,119170,Griswold; William G.,9999,0,9999,0
1667989675451,CSE 293,010,119183,Gymrek; Melissa Ann,9999,0,9999,0
1667989675451,CSE 293,011,119190,Heninger; Nadia A,9999,0,9999,0
1667989675451,CSE 293,012,119230,Impagliazzo; Russell,9999,0,9999,0
1667989675451,CSE 293,013,119232,Jhala; Ranjit,9999,0,9999,0
1667989675451,CSE 293,014,119233,Kahng; Andrew Byun,9999,0,9999,0
1667989675451,CSE 293,015,119298,Kane; Daniel Mertz,9999,0,9999,0
1667989675451,CSE 293,016,119299,Kriegman; David J,9999,0,9999,0
1667989675451,CSE 293,017,119300,Kumar; Arun Kumar,9999,0,9999,0
1667989675451,CSE 293,018,119301,Lerner; Sorin,9999,0,9999,0
1667989675451,CSE 293,019,119302,Lovett; Shachar,9999,0,9999,0
1667989675451,CSE 293,020,119303,McAuley; Julian John,9999,0,9999,0
1667989675451,CSE 293,021,119304,Micciancio; Daniele,9999,0,9999,0
1667989675451,CSE 293,022,119367,Orailoglu; Alex,9999,0,9999,0
1667989675451,CSE 293,023,119382,Paturi; Ramamohan,9999,0,9999,0
1667989675451,CSE 293,024,119404,Polikarpova; Nadezhda,9999,0,9999,0
1667989675451,CSE 293,025,119406,Politz; Joseph Gibbs,9999,0,9999,0
1667989675451,CSE 293,026,119411,Porter; George M,9999,0,9999,0
1667989675451,CSE 293,027,119414,Porter; Leonard Emerson,9999,0,9999,0
1667989675451,CSE 293,028,119416,Ramamoorthi; Ravi,9999,0,9999,0
1667989675451,CSE 293,029,119417,Sahoo; Debashis,9999,0,9999,0
1667989675451,CSE 293,030,119420,Saul; Lawrence,9999,0,9999,0
1667989675451,CSE 293,031,119421,Savage; Stefan,9999,0,9999,0
1667989675451,CSE 293,032,119425,Schulze; Jurgen P.,9999,0,9999,0
1667989675451,CSE 293,033,119426,Snoeren; Alex C.,9999,0,9999,0
1667989675451,CSE 293,034,119428,Shang; Jingbo,9999,0,9999,0
1667989675451,CSE 293,035,119430,Stefan; Deian,9999,0,9999,0
1667989675451,CSE 293,036,119431,Su; Hao,9999,0,9999,0
1667989675451,CSE 293,037,119433,Swanson; Steven James,9999,0,9999,0
1667989675451,CSE 293,038,119435,Tullsen; Dean Michael,9999,0,9999,0
1667989675451,CSE 293,039,119483,Voelker; Geoffrey M.,9999,0,9999,0
1667989675451,CSE 293,040,119537,Zhao; Jishen,9999,0,9999,0
1667989675451,CSE 293,041,119538,Zhou; Yuan-Yuan,9999,0,9999,0
1667989675451,CSE 293,042,119539,Gao; Sicun,9999,0,9999,0
1667989675451,CSE 293,043,119540,Weibel; Nadir,9999,0,9999,0
1667989675451,CSE 293,044,119541,Gupta; Rajesh K.,9999,0,9999,0
1667989675451,CSE 293,045,126410,Vaccaro; Kristen Marie,9999,0,9999,0
1667989675451,CSE 293,046,126411,Klemke; Richard,9999,0,9999,0
1667989675879,CSE 294,A00,102459,Voelker; Geoffrey M.,0,0,0,0
1667989675879,CSE 294,B00,111322,Orailoglu; Alex,0,0,0,0
1667989676302,DSE 201,A00,096914,Deutsch; Alin Bernard,30,0,30,0
1667989676727,DSE 210,A00,096915,Dasgupta; Sanjoy,30,0,30,0
1667989677153,DSE 260A,A00,096916,Altintas De Callaf; Ilkay,30,0,30,0
1667989677650,ECE 200,001,103586,Antipa; Nicholas A,9999,0,9999,0
1667989677650,ECE 200,002,103587,Atanasov; Nikolay A.,9999,0,9999,0
1667989677650,ECE 200,003,103588,Bharadia; Dinesh,9999,0,9999,0
1667989677650,ECE 200,004,103589,Cheng; Chung Kuan,9999,0,9999,0
1667989677650,ECE 200,005,103590,Cosman; Pamela C.,9999,0,9999,0
1667989677650,ECE 200,006,103591,Dayeh; Shadi Ahmad,9999,0,9999,0
1667989677650,ECE 200,007,103592,Fainman; Yeshaiahu,9999,0,9999,0
1667989677650,ECE 200,008,103593,Ford; Joseph Earl,9999,0,9999,0
1667989677650,ECE 200,009,103594,Franceschetti; Massimo,9999,0,9999,0
1667989677650,ECE 200,010,103595,Fullerton; Eric E,9999,0,9999,0
1667989677650,ECE 200,011,103596,Galton; Ian A,9999,0,9999,0
1667989677650,ECE 200,012,103597,Gilja; Vikash,9999,0,9999,0
1667989677650,ECE 200,013,103598,Hall; Drew A.,9999,0,9999,0
1667989677650,ECE 200,014,103599,Hsueh; Tzu-Chien,9999,0,9999,0
1667989677650,ECE 200,015,103600,Javidi; Tara,9999,0,9999,0
1667989677650,ECE 200,016,103601,Kahng; Andrew Byun,9999,0,9999,0
1667989677650,ECE 200,017,103602,Kim; Young-Han,9999,0,9999,0
1667989677650,ECE 200,018,103603,Koushanfar; Farinaz,9999,0,9999,0
1667989677650,ECE 200,019,103604,Kuzum; Duygu,9999,0,9999,0
1667989677650,ECE 200,020,103605,Le; Hanh-Phuc,9999,0,9999,0
1667989677650,ECE 200,021,103606,Lin; Bill,9999,0,9999,0
1667989677650,ECE 200,022,103607,Liu; Zhaowei,9998,0,9999,1
1667989677650,ECE 200,023,103608,Lo; Yu-Hwa,9999,0,9999,0
1667989677650,ECE 200,024,103609,Lomakin; Vitaliy,9999,0,9999,0
1667989677650,ECE 200,025,103610,Mercier; Patrick Philip,9999,0,9999,0
1667989677650,ECE 200,026,103611,Meyer; Florian,9999,0,9999,0
1667989677650,ECE 200,027,103612,Milstein; Laurence B.,9999,0,9999,0
1667989677650,ECE 200,028,103613,Mir Arabbaygi; Siavash,9999,0,9999,0
1667989677650,ECE 200,029,103614,Mookherjea; Shayan,9999,0,9999,0
1667989677650,ECE 200,030,103615,Morris; Karcher William,9999,0,9999,0
1667989677650,ECE 200,031,103616,Ng; Tse Nga,9999,0,9999,0
1667989677650,ECE 200,032,103617,Nguyen; Truong Quang,9999,0,9999,0
1667989677650,ECE 200,033,103618,Nomura; Kenji,9999,0,9999,0
1667989677650,ECE 200,034,103619,Orlitsky; Alon,9999,0,9999,0
1667989677650,ECE 200,035,103620,Pal; Piya,9999,0,9999,0
1667989677650,ECE 200,036,103621,Papen; George C.,9999,0,9999,0
1667989677650,ECE 200,037,103622,Radic; Stojan,9999,0,9999,0
1667989677650,ECE 200,038,103623,Rao; Bhaskar D.,9999,0,9999,0
1667989677650,ECE 200,039,103624,Rao; Ramesh R,9999,0,9999,0
1667989677650,ECE 200,040,103625,Rebeiz; Gabriel,9999,0,9999,0
1667989677650,ECE 200,041,103626,Sanford; John R,9999,0,9999,0
1667989677650,ECE 200,042,103627,Siegel; Paul H.,9999,0,9999,0
1667989677650,ECE 200,043,103628,Sievenpiper; Daniel F.,9999,0,9999,0
1667989677650,ECE 200,044,103629,Sworder; David D.,9999,0,9999,0
1667989677650,ECE 200,045,103630,Taur; Yuan,9999,0,9999,0
1667989677650,ECE 200,046,103631,Touri; Behrouz,9999,0,9999,0
1667989677650,ECE 200,047,103632,Trivedi; Mohan M.,9999,0,9999,0
1667989677650,ECE 200,048,103633,Vasconcelos; Nuno,9999,0,9999,0
1667989677650,ECE 200,049,103634,Wang; Xiaolong,9999,0,9999,0
1667989677650,ECE 200,050,103635,Xie; Pengtao,9999,0,9999,0
1667989677650,ECE 200,051,103636,Yip; Michael,9999,0,9999,0
1667989677650,ECE 200,052,103637,Zeger; Kenneth A.,999,0,999,0
1667989677650,ECE 200,053,103638,Zhang; Xinyu,9999,0,9999,0
1667989677650,ECE 200,054,103639,Turakhia; Yatish Girish,9999,0,9999,0
1667989677650,ECE 200,055,103640,Kang; Mingu,9999,0,9999,0
1667989677650,ECE 200,056,103641,Shi; Yuanyuan,9999,0,9999,0
1667989677650,ECE 200,057,103642,Wang; Edward Jay,9999,0,9999,0
1667989677650,ECE 200,058,103643,Zheng; Yang,9999,0,9999,0
1667989678078,ECE 202,A00,103644,Kuzum; Duygu,0,0,0,0
1667989678506,ECE 212BN,A00,103646,Ng; Tse Nga,0,0,0,0
1667989678935,ECE 221,A00,111493,Staff,0,0,0,0
1667989679358,ECE 222B,A00,103647,Lomakin; Vitaliy,0,0,0,0
1667989679781,ECE 230B,A00,103648,Taur; Yuan,0,0,0,0
1667989680204,ECE 238B,A00,103649,Garay; Javier,0,0,0,0
1667989680629,ECE 240B,A00,112900,Fainman; Yeshaiahu,0,0,0,0
1667989681052,ECE 247A,A00,103650,Jokerst; Jesse Vincent,0,0,0,0
1667989681475,ECE 247B,A00,103651,Wang; Joseph,0,0,0,0
1667989681904,ECE 250,A00,103652,Siegel; Paul H.,0,0,0,0
1667989682335,ECE 251A,A00,103654,Rao; Bhaskar D.,0,0,0,0
1667989682759,ECE 257B,A00,103655,Bharadia; Dinesh,0,0,0,0
1667989683183,ECE 258A,A00,103656,Milstein; Laurence B.,0,0,0,0
1667989683611,ECE 260B,A00,103658,Kang; Mingu,0,0,0,0
1667989684040,ECE 264A,A00,103659,Galton; Ian A,0,0,0,0
1667989684469,ECE 265A,A00,103661,Gudem; Prasad S.S.,0,0,0,0
1667989684896,ECE 265D,A00,103662,Gudem; Prasad S.S.,0,0,0,0
1667989685319,ECE 268,A00,103663,Koushanfar; Farinaz,0,0,0,0
1667989685747,ECE 269,A01,103665,Pal; Piya,0,0,0,0
1667989686171,ECE 271B,A00,103666,Vasconcelos; Manuela,0,0,0,0
1667989686596,ECE 276A,A00,103667,Atanasov; Nikolay A.,0,0,0,0
1667989687022,ECE 277,A00,103668,An; Cheolhong,0,0,0,0
1667989687450,ECE 279,A00,117947,Hall; Drew A.,0,0,0,0
1667989688300,ECE 283,A00,103670,Hsueh; Tzu-Chien,0,0,0,0
1667989688727,ECE 284,A00,103671,Turakhia; Yatish Girish,0,0,0,0
1667989689152,ECE 285,A00,103672,Zheng; Yang,0,0,0,0
1667989689152,ECE 285,B00,103673,Sworder; David D.,0,0,0,0
1667989689574,ECE 287,A00,103676,Javidi; Tara,0,0,0,0
1667989690006,MATH 200B,A00,098023,Salehi Golsefidy; Alireza,14,0,15,1
1667989690430,MATH 202B,A00,098024,Rhoades; Brendon Patrick,12,0,15,3
1667989690859,MATH 203B,A00,098025,Oprea; Dragos N.,12,0,15,3
1667989691284,MATH 204B,A00,098026,Sorensen; Claus M,14,0,15,1
1667989691708,MATH 208,A00,098027,Izadi; Elham,7,0,10,3
1667989692136,MATH 209,A00,098028,Pollack; Aaron,10,0,10,0
1667989692559,MATH 211A,A00,112919,Rogalski; Daniel,9,0,10,1
1667989692985,MATH 211B,A00,112920,Seward; Brandon M.,9,0,10,1
1667989693410,MATH 218,A00,098029,Li; Bo,10,0,10,0
1667989693835,MATH 220B,A00,098030,Novak; Jonathan I,13,0,15,2
1667989694266,MATH 221A,A00,098031,Ebenfelt; Peter F,13,0,15,2
1667989694692,MATH 231B,A00,098032,Zlatos; Andrej,12,0,15,3
1667989695133,MATH 240B,A00,098033,Ni; Lei,10,0,15,5
1667989695565,MATH 243,A00,098034,Jekel; David Andrew,10,0,10,0
1667989695990,MATH 245A,A00,098035,Nie; Jiawang,0,0,15,16
1667989696416,MATH 248,A00,098036,Bejenaru; Ioan,10,0,10,0
1667989696853,MATH 250B,A00,098037,Spolaor; Luca,14,0,15,1
1667989697280,MATH 258,A00,098038,Ni; Lei,10,0,10,0
1667989697706,MATH 264B,A00,098041,Rhoades; Brendon Patrick,11,0,15,4
1667989698147,MATH 268,A00,098042,Buss; Samuel R,10,0,10,0
1667989698569,MATH 269,A00,098043,Rhoades; Brendon Patrick,10,0,10,0
1667989698993,MATH 270B,A00,098044,Li; Bo,11,0,15,4
1667989699417,MATH 272B,A00,098045,Holst; Michael J,13,0,15,2
1667989699848,MATH 273A,A00,098046,Tian; Xiaochuan,12,0,15,3
1667989700279,MATH 275,A01,098048,Tian; Xiaochuan,6,0,10,4
1667989700705,MATH 278A,A00,098049,Holst; Michael J,8,0,10,2
1667989701134,MATH 278B,A00,098050,Cloninger; Alexander,10,0,10,0
1667989701560,MATH 278C,A00,098051,Nie; Jiawang,8,0,10,2
1667989701983,MATH 280B,A00,098052,Zheng; Tianyi,11,0,15,4
1667989702408,MATH 281B,A00,098053,Bradic; Jelena,4,0,15,11
1667989702848,MATH 282B,A00,098054,Arias-Castro; Ery,2,0,15,13
1667989703273,MATH 285,A00,098055,Fitzsimmons; Patrick J,0,0,15,17
1667989703697,MATH 287B,A00,098056,Arias-Castro; Ery,5,0,15,10
1667989704122,MATH 288,A00,098057,Agarwal; Pooja,9,0,10,1
1667989704122,MATH 288,B00,098058,Zhang; Danna,9,0,10,1
1667989704122,MATH 288,C00,098059,Williams; Ruth J,10,0,10,0
1667989704550,MATH 290B,A00,098060,Roberts; Justin Deritter,14,0,15,1
1667989704980,MATH 292,A00,098061,Belmont; Eva Kinoshita,10,0,10,0
1667989705408,MATH 295,A00,098062,Suk; Andrew Hoon,48,0,50,2
1667989705837,MATH 296,A00,098063,Novak; Jonathan I,20,0,20,0
1667989706263,MATH 297,001,098064,Gamst; Anthony Collins,9997,0,9999,2
1667990218325,COGS 205,A00,101395,Chiba; Andrea,19,0,20,1
1667990218756,COGS 210B,001,101404,Greene; Deanna Jacquelyn,9998,0,9999,1
1667990218756,COGS 210B,002,101417,Xia; Haijun,9999,0,9999,0
1667990218756,COGS 210B,003,101422,Nitz; Douglas A.,9999,0,9999,0
1667990218756,COGS 210B,004,101423,Hollan; James D.,9998,0,9999,1
1667990218756,COGS 210B,005,101424,Deak; Gedeon O.,9999,0,9999,0
1667990218756,COGS 210B,006,101425,Rossano; Federico,9999,0,9999,0
1667990219185,COGS 211B,A00,101427,Coulson; Seana M,9997,0,9999,2
1667990219610,COGS 220,A00,101428,Hollan; James D.,0,0,25,25
1667990220035,COGS 229,A00,101429,Dow; Steven P,18,0,25,7
1667990220460,COGS 230,A00,101430,Klemmer; Scott R,13,0,17,4
1667990220884,COGS 234,A00,101431,Xia; Haijun,7,0,25,18
1667990221310,COGS 260,A00,101432,Kiyonaga; Anastasia,20,0,25,5
1667990221310,COGS 260,B00,101433,Kirsh; David Joel,16,0,25,9
1667990221734,CSE 202,A00,102371,Impagliazzo; Russell,0,0,0,0
1667990222160,CSE 203B,A01,102373,Cheng; Chung Kuan,0,0,0,0
1667990222589,CSE 208,A00,102374,Micciancio; Daniele,0,0,0,0
1667990223012,CSE 209A,A00,112895,Impagliazzo; Russell,0,0,15,15
1667990223439,CSE 209B,A00,108005,Bellare; Mihir,0,0,0,0
1667990223864,CSE 210,A00,113163,Coblenz; Michael J,0,0,0,0
1667990224286,CSE 219,A00,106111,Dow; Steven P,0,0,20,20
1667990224718,CSE 221,A00,102376,Voelker; Geoffrey M.,0,0,0,0
1667990225145,CSE 224,A01,102378,Porter; George M,0,0,0,0
1667990225570,CSE 229A,A00,102379,Savage; Stefan,0,0,0,0
1667990225996,CSE 229C,A00,102380,Munyaka; Imani N. S.,0,0,0,0
1667990226424,CSE 232B,A00,102382,Deutsch; Alin Bernard,0,0,0,0
1667990226851,CSE 234,A01,112904,Kumar; Arun Kumar,0,0,0,0
1667990227278,CSE 237A,A00,102383,Rosing; Tajana Simunic,0,0,0,0
1667990227702,CSE 239A,A00,102384,Deutsch; Alin Bernard,0,0,0,0
1667990228127,CSE 239B,A00,102385,Polikarpova; Nadezhda,0,0,0,0
1667990228556,CSE 240A,A00,102386,Pannuto; Patrick William,0,0,0,0
1667990228990,CSE 240B,A00,102387,Zhao; Jishen,0,0,0,0
1667990229415,CSE 241A,A00,106406,Kang; Mingu,0,0,0,0
1667990229845,CSE 249B,A00,102388,Kahng; Andrew Byun,0,0,8,8
1667990230268,CSE 251B,A01,102392,Cottrell; Garrison W,0,0,0,0
1667990230268,CSE 251B,A02,102393,Cottrell; Garrison W,0,0,0,0
1667990230696,CSE 252B,A00,102394,Ochoa; Benjamin Lawrence,0,0,0,0
1667990231123,CSE 257,A01,102396,Gao; Sicun,0,0,0,0
1667990231552,CSE 272,A00,102397,Li; Tzumao,0,0,0,0
1667990231976,CSE 274,A00,111323,Chern; Albert Ren-Haur,0,0,0,0
1667990232399,CSE 282,A00,102398,Pevzner; Pavel Arkadjevich,0,0,0,0
1667990232824,CSE 284,A00,114175,Gymrek; Melissa Ann,0,0,0,0
1667990233248,CSE 290,A00,102399,Chandraker; Manmohan Krishna,0,0,0,0
1667990233248,CSE 290,B00,102400,Vaccaro; Kristen Marie,0,0,25,25
1667990233248,CSE 290,C00,102414,Pannuto; Patrick William,0,0,25,25
1667990233248,CSE 290,D00,102427,Pevzner; Pavel Arkadjevich,0,0,0,0
1667990233248,CSE 290,E00,102429,Zhao; Jishen,0,0,0,0
1667990233248,CSE 290,F00,102436,Tullsen; Dean Michael,0,0,0,0
1667990233248,CSE 290,G00,102440,Christensen; Henrik I,0,0,20,20
1667990233680,CSE 291,A00,102443,Su; Hao,0,0,0,0
1667990233680,CSE 291,B00,102448,Polikarpova; Nadezhda,0,0,0,0
1667990233680,CSE 291,C00,102453,Vaccaro; Kristen Marie,0,0,0,0
1667990233680,CSE 291,D00,111343,Savage; Stefan,0,0,0,0
1667990233680,CSE 291,E00,116474,Claffy; Kimberly Claire,0,0,0,0
1667990233680,CSE 291,F00,116479,Pasquale; Joseph,0,0,0,0
1667990234127,CSE 293,001,119111,Bafna; Vineet,9999,0,9999,0
1667990234127,CSE 293,002,119118,Bellare; Mihir,9999,0,9999,0
1667990234127,CSE 293,003,119122,Berg-Kirkpatrick; Taylor D,9999,0,9999,0
1667990234127,CSE 293,004,119135,Christensen; Henrik I,9999,0,9999,0
1667990234127,CSE 293,005,119142,Cottrell; Garrison W,9999,0,9999,0
1667990234127,CSE 293,006,119146,Deutsch; Alin Bernard,9999,0,9999,0
1667990234127,CSE 293,007,119159,Esmaeilzadeh; Hadi,9999,0,9999,0
1667990234127,CSE 293,008,119166,Freund; Yoav,9999,0,9999,0
1667990234127,CSE 293,009,119170,Griswold; William G.,9999,0,9999,0
1667990234127,CSE 293,010,119183,Gymrek; Melissa Ann,9999,0,9999,0
1667990234127,CSE 293,011,119190,Heninger; Nadia A,9999,0,9999,0
1667990234127,CSE 293,012,119230,Impagliazzo; Russell,9999,0,9999,0
1667990234127,CSE 293,013,119232,Jhala; Ranjit,9999,0,9999,0
1667990234127,CSE 293,014,119233,Kahng; Andrew Byun,9999,0,9999,0
1667990234127,CSE 293,015,119298,Kane; Daniel Mertz,9999,0,9999,0
1667990234127,CSE 293,016,119299,Kriegman; David J,9999,0,9999,0
1667990234127,CSE 293,017,119300,Kumar; Arun Kumar,9999,0,9999,0
1667990234127,CSE 293,018,119301,Lerner; Sorin,9999,0,9999,0
1667990234127,CSE 293,019,119302,Lovett; Shachar,9999,0,9999,0
1667990234127,CSE 293,020,119303,McAuley; Julian John,9999,0,9999,0
1667990234127,CSE 293,021,119304,Micciancio; Daniele,9999,0,9999,0
1667990234127,CSE 293,022,119367,Orailoglu; Alex,9999,0,9999,0
1667990234127,CSE 293,023,119382,Paturi; Ramamohan,9999,0,9999,0
1667990234127,CSE 293,024,119404,Polikarpova; Nadezhda,9999,0,9999,0
1667990234127,CSE 293,025,119406,Politz; Joseph Gibbs,9999,0,9999,0
1667990234127,CSE 293,026,119411,Porter; George M,9999,0,9999,0
1667990234127,CSE 293,027,119414,Porter; Leonard Emerson,9999,0,9999,0
1667990234127,CSE 293,028,119416,Ramamoorthi; Ravi,9999,0,9999,0
1667990234127,CSE 293,029,119417,Sahoo; Debashis,9999,0,9999,0
1667990234127,CSE 293,030,119420,Saul; Lawrence,9999,0,9999,0
1667990234127,CSE 293,031,119421,Savage; Stefan,9999,0,9999,0
1667990234127,CSE 293,032,119425,Schulze; Jurgen P.,9999,0,9999,0
1667990234127,CSE 293,033,119426,Snoeren; Alex C.,9999,0,9999,0
1667990234127,CSE 293,034,119428,Shang; Jingbo,9999,0,9999,0
1667990234127,CSE 293,035,119430,Stefan; Deian,9999,0,9999,0
1667990234127,CSE 293,036,119431,Su; Hao,9999,0,9999,0
1667990234127,CSE 293,037,119433,Swanson; Steven James,9999,0,9999,0
1667990234127,CSE 293,038,119435,Tullsen; Dean Michael,9999,0,9999,0
1667990234127,CSE 293,039,119483,Voelker; Geoffrey M.,9999,0,9999,0
1667990234127,CSE 293,040,119537,Zhao; Jishen,9999,0,9999,0
1667990234127,CSE 293,041,119538,Zhou; Yuan-Yuan,9999,0,9999,0
1667990234127,CSE 293,042,119539,Gao; Sicun,9999,0,9999,0
1667990234127,CSE 293,043,119540,Weibel; Nadir,9999,0,9999,0
1667990234127,CSE 293,044,119541,Gupta; Rajesh K.,9999,0,9999,0
1667990234127,CSE 293,045,126410,Vaccaro; Kristen Marie,9999,0,9999,0
1667990234127,CSE 293,046,126411,Klemke; Richard,9999,0,9999,0
1667990234551,CSE 294,A00,102459,Voelker; Geoffrey M.,0,0,0,0
1667990234551,CSE 294,B00,111322,Orailoglu; Alex,0,0,0,0
1667990234980,DSE 201,A00,096914,Deutsch; Alin Bernard,30,0,30,0
1667990235407,DSE 210,A00,096915,Dasgupta; Sanjoy,30,0,30,0
1667990235831,DSE 260A,A00,096916,Altintas De Callaf; Ilkay,30,0,30,0
1667990236276,ECE 200,001,103586,Antipa; Nicholas A,9999,0,9999,0
1667990236276,ECE 200,002,103587,Atanasov; Nikolay A.,9999,0,9999,0
1667990236276,ECE 200,003,103588,Bharadia; Dinesh,9999,0,9999,0
1667990236276,ECE 200,004,103589,Cheng; Chung Kuan,9999,0,9999,0
1667990236276,ECE 200,005,103590,Cosman; Pamela C.,9999,0,9999,0
1667990236276,ECE 200,006,103591,Dayeh; Shadi Ahmad,9999,0,9999,0
1667990236276,ECE 200,007,103592,Fainman; Yeshaiahu,9999,0,9999,0
1667990236276,ECE 200,008,103593,Ford; Joseph Earl,9999,0,9999,0
1667990236276,ECE 200,009,103594,Franceschetti; Massimo,9999,0,9999,0
1667990236276,ECE 200,010,103595,Fullerton; Eric E,9999,0,9999,0
1667990236276,ECE 200,011,103596,Galton; Ian A,9999,0,9999,0
1667990236276,ECE 200,012,103597,Gilja; Vikash,9999,0,9999,0
1667990236276,ECE 200,013,103598,Hall; Drew A.,9999,0,9999,0
1667990236276,ECE 200,014,103599,Hsueh; Tzu-Chien,9999,0,9999,0
1667990236276,ECE 200,015,103600,Javidi; Tara,9999,0,9999,0
1667990236276,ECE 200,016,103601,Kahng; Andrew Byun,9999,0,9999,0
1667990236276,ECE 200,017,103602,Kim; Young-Han,9999,0,9999,0
1667990236276,ECE 200,018,103603,Koushanfar; Farinaz,9999,0,9999,0
1667990236276,ECE 200,019,103604,Kuzum; Duygu,9999,0,9999,0
1667990236276,ECE 200,020,103605,Le; Hanh-Phuc,9999,0,9999,0
1667990236276,ECE 200,021,103606,Lin; Bill,9999,0,9999,0
1667990236276,ECE 200,022,103607,Liu; Zhaowei,9998,0,9999,1
1667990236276,ECE 200,023,103608,Lo; Yu-Hwa,9999,0,9999,0
1667990236276,ECE 200,024,103609,Lomakin; Vitaliy,9999,0,9999,0
1667990236276,ECE 200,025,103610,Mercier; Patrick Philip,9999,0,9999,0
1667990236276,ECE 200,026,103611,Meyer; Florian,9999,0,9999,0
1667990236276,ECE 200,027,103612,Milstein; Laurence B.,9999,0,9999,0
1667990236276,ECE 200,028,103613,Mir Arabbaygi; Siavash,9999,0,9999,0
1667990236276,ECE 200,029,103614,Mookherjea; Shayan,9999,0,9999,0
1667990236276,ECE 200,030,103615,Morris; Karcher William,9999,0,9999,0
1667990236276,ECE 200,031,103616,Ng; Tse Nga,9999,0,9999,0
1667990236276,ECE 200,032,103617,Nguyen; Truong Quang,9999,0,9999,0
1667990236276,ECE 200,033,103618,Nomura; Kenji,9999,0,9999,0
1667990236276,ECE 200,034,103619,Orlitsky; Alon,9999,0,9999,0
1667990236276,ECE 200,035,103620,Pal; Piya,9999,0,9999,0
1667990236276,ECE 200,036,103621,Papen; George C.,9999,0,9999,0
1667990236276,ECE 200,037,103622,Radic; Stojan,9999,0,9999,0
1667990236276,ECE 200,038,103623,Rao; Bhaskar D.,9999,0,9999,0
1667990236276,ECE 200,039,103624,Rao; Ramesh R,9999,0,9999,0
1667990236276,ECE 200,040,103625,Rebeiz; Gabriel,9999,0,9999,0
1667990236276,ECE 200,041,103626,Sanford; John R,9999,0,9999,0
1667990236276,ECE 200,042,103627,Siegel; Paul H.,9999,0,9999,0
1667990236276,ECE 200,043,103628,Sievenpiper; Daniel F.,9999,0,9999,0
1667990236276,ECE 200,044,103629,Sworder; David D.,9999,0,9999,0
1667990236276,ECE 200,045,103630,Taur; Yuan,9999,0,9999,0
1667990236276,ECE 200,046,103631,Touri; Behrouz,9999,0,9999,0
1667990236276,ECE 200,047,103632,Trivedi; Mohan M.,9999,0,9999,0
1667990236276,ECE 200,048,103633,Vasconcelos; Nuno,9999,0,9999,0
1667990236276,ECE 200,049,103634,Wang; Xiaolong,9999,0,9999,0
1667990236276,ECE 200,050,103635,Xie; Pengtao,9999,0,9999,0
1667990236276,ECE 200,051,103636,Yip; Michael,9999,0,9999,0
1667990236276,ECE 200,052,103637,Zeger; Kenneth A.,999,0,999,0
1667990236276,ECE 200,053,103638,Zhang; Xinyu,9999,0,9999,0
1667990236276,ECE 200,054,103639,Turakhia; Yatish Girish,9999,0,9999,0
1667990236276,ECE 200,055,103640,Kang; Mingu,9999,0,9999,0
1667990236276,ECE 200,056,103641,Shi; Yuanyuan,9999,0,9999,0
1667990236276,ECE 200,057,103642,Wang; Edward Jay,9999,0,9999,0
1667990236276,ECE 200,058,103643,Zheng; Yang,9999,0,9999,0
1667990236701,ECE 202,A00,103644,Kuzum; Duygu,0,0,0,0
1667990237127,ECE 212BN,A00,103646,Ng; Tse Nga,0,0,0,0
1667990237556,ECE 221,A00,111493,Staff,0,0,0,0
1667990237981,ECE 222B,A00,103647,Lomakin; Vitaliy,0,0,0,0
1667990238409,ECE 230B,A00,103648,Taur; Yuan,0,0,0,0
1667990238833,ECE 238B,A00,103649,Garay; Javier,0,0,0,0
1667990239256,ECE 240B,A00,112900,Fainman; Yeshaiahu,0,0,0,0
1667990239683,ECE 247A,A00,103650,Jokerst; Jesse Vincent,0,0,0,0
1667990240107,ECE 247B,A00,103651,Wang; Joseph,0,0,0,0
1667990240535,ECE 250,A00,103652,Siegel; Paul H.,0,0,0,0
1667990240962,ECE 251A,A00,103654,Rao; Bhaskar D.,0,0,0,0
1667990241388,ECE 257B,A00,103655,Bharadia; Dinesh,0,0,0,0
1667990241815,ECE 258A,A00,103656,Milstein; Laurence B.,0,0,0,0
1667990242240,ECE 260B,A00,103658,Kang; Mingu,0,0,0,0
1667990242665,ECE 264A,A00,103659,Galton; Ian A,0,0,0,0
1667990243092,ECE 265A,A00,103661,Gudem; Prasad S.S.,0,0,0,0
1667990243525,ECE 265D,A00,103662,Gudem; Prasad S.S.,0,0,0,0
1667990243953,ECE 268,A00,103663,Koushanfar; Farinaz,0,0,0,0
1667990244376,ECE 269,A01,103665,Pal; Piya,0,0,0,0
1667990244805,ECE 271B,A00,103666,Vasconcelos; Manuela,0,0,0,0
1667990245229,ECE 276A,A00,103667,Atanasov; Nikolay A.,0,0,0,0
1667990245658,ECE 277,A00,103668,An; Cheolhong,0,0,0,0
1667990246083,ECE 279,A00,117947,Hall; Drew A.,0,0,0,0
1667990246929,ECE 283,A00,103670,Hsueh; Tzu-Chien,0,0,0,0
1667990247353,ECE 284,A00,103671,Turakhia; Yatish Girish,0,0,0,0
1667990247858,ECE 285,A00,103672,Zheng; Yang,0,0,0,0
1667990247858,ECE 285,B00,103673,Sworder; David D.,0,0,0,0
1667990248282,ECE 287,A00,103676,Javidi; Tara,0,0,0,0
1667990248711,MATH 200B,A00,098023,Salehi Golsefidy; Alireza,14,0,15,1
1667990249143,MATH 202B,A00,098024,Rhoades; Brendon Patrick,12,0,15,3
1667990249568,MATH 203B,A00,098025,Oprea; Dragos N.,12,0,15,3
1667990249990,MATH 204B,A00,098026,Sorensen; Claus M,14,0,15,1
1667990250411,MATH 208,A00,098027,Izadi; Elham,7,0,10,3
1667990250837,MATH 209,A00,098028,Pollack; Aaron,10,0,10,0
1667990251262,MATH 211A,A00,112919,Rogalski; Daniel,9,0,10,1
1667990251686,MATH 211B,A00,112920,Seward; Brandon M.,9,0,10,1
1667990252110,MATH 218,A00,098029,Li; Bo,10,0,10,0
1667990252533,MATH 220B,A00,098030,Novak; Jonathan I,13,0,15,2
1667990252962,MATH 221A,A00,098031,Ebenfelt; Peter F,13,0,15,2
1667990253419,MATH 231B,A00,098032,Zlatos; Andrej,12,0,15,3
1667990253847,MATH 240B,A00,098033,Ni; Lei,10,0,15,5
1667990254274,MATH 243,A00,098034,Jekel; David Andrew,10,0,10,0
1667990254700,MATH 245A,A00,098035,Nie; Jiawang,0,0,15,16
1667990255126,MATH 248,A00,098036,Bejenaru; Ioan,10,0,10,0
1667990255551,MATH 250B,A00,098037,Spolaor; Luca,14,0,15,1
1667990255979,MATH 258,A00,098038,Ni; Lei,10,0,10,0
1667990256406,MATH 264B,A00,098041,Rhoades; Brendon Patrick,11,0,15,4
1667990256830,MATH 268,A00,098042,Buss; Samuel R,10,0,10,0
1667990257255,MATH 269,A00,098043,Rhoades; Brendon Patrick,10,0,10,0
1667990257682,MATH 270B,A00,098044,Li; Bo,11,0,15,4
1667990258104,MATH 272B,A00,098045,Holst; Michael J,13,0,15,2
1667990258528,MATH 273A,A00,098046,Tian; Xiaochuan,12,0,15,3
1667990258954,MATH 275,A01,098048,Tian; Xiaochuan,6,0,10,4
1667990259379,MATH 278A,A00,098049,Holst; Michael J,8,0,10,2
1667990259802,MATH 278B,A00,098050,Cloninger; Alexander,10,0,10,0
1667990260229,MATH 278C,A00,098051,Nie; Jiawang,8,0,10,2
1667990260653,MATH 280B,A00,098052,Zheng; Tianyi,11,0,15,4
1667990261077,MATH 281B,A00,098053,Bradic; Jelena,4,0,15,11
1667990261502,MATH 282B,A00,098054,Arias-Castro; Ery,2,0,15,13
1667990261928,MATH 285,A00,098055,Fitzsimmons; Patrick J,0,0,15,17
1667990262350,MATH 287B,A00,098056,Arias-Castro; Ery,5,0,15,10
1667990262781,MATH 288,A00,098057,Agarwal; Pooja,9,0,10,1
1667990262781,MATH 288,B00,098058,Zhang; Danna,9,0,10,1
1667990262781,MATH 288,C00,098059,Williams; Ruth J,10,0,10,0
1667990263207,MATH 290B,A00,098060,Roberts; Justin Deritter,14,0,15,1
1667990263634,MATH 292,A00,098061,Belmont; Eva Kinoshita,10,0,10,0
1667990264059,MATH 295,A00,098062,Suk; Andrew Hoon,48,0,50,2
1667990264485,MATH 296,A00,098063,Novak; Jonathan I,20,0,20,0
1667990264914,MATH 297,001,098064,Gamst; Anthony Collins,9997,0,9999,2
1667990765149,COGS 205,A00,101395,Chiba; Andrea,19,0,20,1
1667990765576,COGS 210B,001,101404,Greene; Deanna Jacquelyn,9998,0,9999,1
1667990765576,COGS 210B,002,101417,Xia; Haijun,9999,0,9999,0
1667990765576,COGS 210B,003,101422,Nitz; Douglas A.,9999,0,9999,0
1667990765576,COGS 210B,004,101423,Hollan; James D.,9998,0,9999,1
1667990765576,COGS 210B,005,101424,Deak; Gedeon O.,9999,0,9999,0
1667990765576,COGS 210B,006,101425,Rossano; Federico,9999,0,9999,0
1667990766004,COGS 211B,A00,101427,Coulson; Seana M,9997,0,9999,2
1667990766430,COGS 220,A00,101428,Hollan; James D.,0,0,25,25
1667990766859,COGS 229,A00,101429,Dow; Steven P,18,0,25,7
1667990767299,COGS 230,A00,101430,Klemmer; Scott R,13,0,17,4
1667990767728,COGS 234,A00,101431,Xia; Haijun,7,0,25,18
1667990768234,COGS 260,A00,101432,Kiyonaga; Anastasia,20,0,25,5
1667990768234,COGS 260,B00,101433,Kirsh; David Joel,16,0,25,9
1667990768660,CSE 202,A00,102371,Impagliazzo; Russell,0,0,0,0
1667990769088,CSE 203B,A01,102373,Cheng; Chung Kuan,0,0,0,0
1667990769513,CSE 208,A00,102374,Micciancio; Daniele,0,0,0,0
1667990769941,CSE 209A,A00,112895,Impagliazzo; Russell,0,0,15,15
1667990770366,CSE 209B,A00,108005,Bellare; Mihir,0,0,0,0
1667990770789,CSE 210,A00,113163,Coblenz; Michael J,0,0,0,0
1667990771214,CSE 219,A00,106111,Dow; Steven P,0,0,20,20
1667990771643,CSE 221,A00,102376,Voelker; Geoffrey M.,0,0,0,0
1667990772071,CSE 224,A01,102378,Porter; George M,0,0,0,0
1667990772497,CSE 229A,A00,102379,Savage; Stefan,0,0,0,0
1667990772920,CSE 229C,A00,102380,Munyaka; Imani N. S.,0,0,0,0
1667990773343,CSE 232B,A00,102382,Deutsch; Alin Bernard,0,0,0,0
1667990773774,CSE 234,A01,112904,Kumar; Arun Kumar,0,0,0,0
1667990774198,CSE 237A,A00,102383,Rosing; Tajana Simunic,0,0,0,0
1667990774623,CSE 239A,A00,102384,Deutsch; Alin Bernard,0,0,0,0
1667990775046,CSE 239B,A00,102385,Polikarpova; Nadezhda,0,0,0,0
1667990775468,CSE 240A,A00,102386,Pannuto; Patrick William,0,0,0,0
1667990775898,CSE 240B,A00,102387,Zhao; Jishen,0,0,0,0
1667990776335,CSE 241A,A00,106406,Kang; Mingu,0,0,0,0
1667990776769,CSE 249B,A00,102388,Kahng; Andrew Byun,0,0,8,8
1667990777192,CSE 251B,A01,102392,Cottrell; Garrison W,0,0,0,0
1667990777192,CSE 251B,A02,102393,Cottrell; Garrison W,0,0,0,0
1667990777630,CSE 252B,A00,102394,Ochoa; Benjamin Lawrence,0,0,0,0
1667990778054,CSE 257,A01,102396,Gao; Sicun,0,0,0,0
1667990778492,CSE 272,A00,102397,Li; Tzumao,0,0,0,0
1667990778927,CSE 274,A00,111323,Chern; Albert Ren-Haur,0,0,0,0
1667990779360,CSE 282,A00,102398,Pevzner; Pavel Arkadjevich,0,0,0,0
1667990779785,CSE 284,A00,114175,Gymrek; Melissa Ann,0,0,0,0
1667990780226,CSE 290,A00,102399,Chandraker; Manmohan Krishna,0,0,0,0
1667990780226,CSE 290,B00,102400,Vaccaro; Kristen Marie,0,0,25,25
1667990780226,CSE 290,C00,102414,Pannuto; Patrick William,0,0,25,25
1667990780226,CSE 290,D00,102427,Pevzner; Pavel Arkadjevich,0,0,0,0
1667990780226,CSE 290,E00,102429,Zhao; Jishen,0,0,0,0
1667990780226,CSE 290,F00,102436,Tullsen; Dean Michael,0,0,0,0
1667990780226,CSE 290,G00,102440,Christensen; Henrik I,0,0,20,20
1667990780659,CSE 291,A00,102443,Su; Hao,0,0,0,0
1667990780659,CSE 291,B00,102448,Polikarpova; Nadezhda,0,0,0,0
1667990780659,CSE 291,C00,102453,Vaccaro; Kristen Marie,0,0,0,0
1667990780659,CSE 291,D00,111343,Savage; Stefan,0,0,0,0
1667990780659,CSE 291,E00,116474,Claffy; Kimberly Claire,0,0,0,0
1667990780659,CSE 291,F00,116479,Pasquale; Joseph,0,0,0,0
1667990781153,CSE 293,001,119111,Bafna; Vineet,9999,0,9999,0
1667990781153,CSE 293,002,119118,Bellare; Mihir,9999,0,9999,0
1667990781153,CSE 293,003,119122,Berg-Kirkpatrick; Taylor D,9999,0,9999,0
1667990781153,CSE 293,004,119135,Christensen; Henrik I,9999,0,9999,0
1667990781153,CSE 293,005,119142,Cottrell; Garrison W,9999,0,9999,0
1667990781153,CSE 293,006,119146,Deutsch; Alin Bernard,9999,0,9999,0
1667990781153,CSE 293,007,119159,Esmaeilzadeh; Hadi,9999,0,9999,0
1667990781153,CSE 293,008,119166,Freund; Yoav,9999,0,9999,0
1667990781153,CSE 293,009,119170,Griswold; William G.,9999,0,9999,0
1667990781153,CSE 293,010,119183,Gymrek; Melissa Ann,9999,0,9999,0
1667990781153,CSE 293,011,119190,Heninger; Nadia A,9999,0,9999,0
1667990781153,CSE 293,012,119230,Impagliazzo; Russell,9999,0,9999,0
1667990781153,CSE 293,013,119232,Jhala; Ranjit,9999,0,9999,0
1667990781153,CSE 293,014,119233,Kahng; Andrew Byun,9999,0,9999,0
1667990781153,CSE 293,015,119298,Kane; Daniel Mertz,9999,0,9999,0
1667990781153,CSE 293,016,119299,Kriegman; David J,9999,0,9999,0
1667990781153,CSE 293,017,119300,Kumar; Arun Kumar,9999,0,9999,0
1667990781153,CSE 293,018,119301,Lerner; Sorin,9999,0,9999,0
1667990781153,CSE 293,019,119302,Lovett; Shachar,9999,0,9999,0
1667990781153,CSE 293,020,119303,McAuley; Julian John,9999,0,9999,0
1667990781153,CSE 293,021,119304,Micciancio; Daniele,9999,0,9999,0
1667990781153,CSE 293,022,119367,Orailoglu; Alex,9999,0,9999,0
1667990781153,CSE 293,023,119382,Paturi; Ramamohan,9999,0,9999,0
1667990781153,CSE 293,024,119404,Polikarpova; Nadezhda,9999,0,9999,0
1667990781153,CSE 293,025,119406,Politz; Joseph Gibbs,9999,0,9999,0
1667990781153,CSE 293,026,119411,Porter; George M,9999,0,9999,0
1667990781153,CSE 293,027,119414,Porter; Leonard Emerson,9999,0,9999,0
1667990781153,CSE 293,028,119416,Ramamoorthi; Ravi,9999,0,9999,0
1667990781153,CSE 293,029,119417,Sahoo; Debashis,9999,0,9999,0
1667990781153,CSE 293,030,119420,Saul; Lawrence,9999,0,9999,0
1667990781153,CSE 293,031,119421,Savage; Stefan,9999,0,9999,0
1667990781153,CSE 293,032,119425,Schulze; Jurgen P.,9999,0,9999,0
1667990781153,CSE 293,033,119426,Snoeren; Alex C.,9999,0,9999,0
1667990781153,CSE 293,034,119428,Shang; Jingbo,9999,0,9999,0
1667990781153,CSE 293,035,119430,Stefan; Deian,9999,0,9999,0
1667990781153,CSE 293,036,119431,Su; Hao,9999,0,9999,0
1667990781153,CSE 293,037,119433,Swanson; Steven James,9999,0,9999,0
1667990781153,CSE 293,038,119435,Tullsen; Dean Michael,9999,0,9999,0
1667990781153,CSE 293,039,119483,Voelker; Geoffrey M.,9999,0,9999,0
1667990781153,CSE 293,040,119537,Zhao; Jishen,9999,0,9999,0
1667990781153,CSE 293,041,119538,Zhou; Yuan-Yuan,9999,0,9999,0
1667990781153,CSE 293,042,119539,Gao; Sicun,9999,0,9999,0
1667990781153,CSE 293,043,119540,Weibel; Nadir,9999,0,9999,0
1667990781153,CSE 293,044,119541,Gupta; Rajesh K.,9999,0,9999,0
1667990781153,CSE 293,045,126410,Vaccaro; Kristen Marie,9999,0,9999,0
1667990781153,CSE 293,046,126411,Klemke; Richard,9999,0,9999,0
1667990781577,CSE 294,A00,102459,Voelker; Geoffrey M.,0,0,0,0
1667990781577,CSE 294,B00,111322,Orailoglu; Alex,0,0,0,0
1667990782002,DSE 201,A00,096914,Deutsch; Alin Bernard,30,0,30,0
1667990782432,DSE 210,A00,096915,Dasgupta; Sanjoy,30,0,30,0
1667990782856,DSE 260A,A00,096916,Altintas De Callaf; Ilkay,30,0,30,0
1667990783310,ECE 200,001,103586,Antipa; Nicholas A,9999,0,9999,0
1667990783310,ECE 200,002,103587,Atanasov; Nikolay A.,9999,0,9999,0
1667990783310,ECE 200,003,103588,Bharadia; Dinesh,9999,0,9999,0
1667990783310,ECE 200,004,103589,Cheng; Chung Kuan,9999,0,9999,0
1667990783310,ECE 200,005,103590,Cosman; Pamela C.,9999,0,9999,0
1667990783310,ECE 200,006,103591,Dayeh; Shadi Ahmad,9999,0,9999,0
1667990783310,ECE 200,007,103592,Fainman; Yeshaiahu,9999,0,9999,0
1667990783310,ECE 200,008,103593,Ford; Joseph Earl,9999,0,9999,0
1667990783310,ECE 200,009,103594,Franceschetti; Massimo,9999,0,9999,0
1667990783310,ECE 200,010,103595,Fullerton; Eric E,9999,0,9999,0
1667990783310,ECE 200,011,103596,Galton; Ian A,9999,0,9999,0
1667990783310,ECE 200,012,103597,Gilja; Vikash,9999,0,9999,0
1667990783310,ECE 200,013,103598,Hall; Drew A.,9999,0,9999,0
1667990783310,ECE 200,014,103599,Hsueh; Tzu-Chien,9999,0,9999,0
1667990783310,ECE 200,015,103600,Javidi; Tara,9999,0,9999,0
1667990783310,ECE 200,016,103601,Kahng; Andrew Byun,9999,0,9999,0
1667990783310,ECE 200,017,103602,Kim; Young-Han,9999,0,9999,0
1667990783310,ECE 200,018,103603,Koushanfar; Farinaz,9999,0,9999,0
1667990783310,ECE 200,019,103604,Kuzum; Duygu,9999,0,9999,0
1667990783310,ECE 200,020,103605,Le; Hanh-Phuc,9999,0,9999,0
1667990783310,ECE 200,021,103606,Lin; Bill,9999,0,9999,0
1667990783310,ECE 200,022,103607,Liu; Zhaowei,9998,0,9999,1
1667990783310,ECE 200,023,103608,Lo; Yu-Hwa,9999,0,9999,0
1667990783310,ECE 200,024,103609,Lomakin; Vitaliy,9999,0,9999,0
1667990783310,ECE 200,025,103610,Mercier; Patrick Philip,9999,0,9999,0
1667990783310,ECE 200,026,103611,Meyer; Florian,9999,0,9999,0
1667990783310,ECE 200,027,103612,Milstein; Laurence B.,9999,0,9999,0
1667990783310,ECE 200,028,103613,Mir Arabbaygi; Siavash,9999,0,9999,0
1667990783310,ECE 200,029,103614,Mookherjea; Shayan,9999,0,9999,0
1667990783310,ECE 200,030,103615,Morris; Karcher William,9999,0,9999,0
1667990783310,ECE 200,031,103616,Ng; Tse Nga,9999,0,9999,0
1667990783310,ECE 200,032,103617,Nguyen; Truong Quang,9999,0,9999,0
1667990783310,ECE 200,033,103618,Nomura; Kenji,9999,0,9999,0
1667990783310,ECE 200,034,103619,Orlitsky; Alon,9999,0,9999,0
1667990783310,ECE 200,035,103620,Pal; Piya,9999,0,9999,0
1667990783310,ECE 200,036,103621,Papen; George C.,9999,0,9999,0
1667990783310,ECE 200,037,103622,Radic; Stojan,9999,0,9999,0
1667990783310,ECE 200,038,103623,Rao; Bhaskar D.,9999,0,9999,0
1667990783310,ECE 200,039,103624,Rao; Ramesh R,9999,0,9999,0
1667990783310,ECE 200,040,103625,Rebeiz; Gabriel,9999,0,9999,0
1667990783310,ECE 200,041,103626,Sanford; John R,9999,0,9999,0
1667990783310,ECE 200,042,103627,Siegel; Paul H.,9999,0,9999,0
1667990783310,ECE 200,043,103628,Sievenpiper; Daniel F.,9999,0,9999,0
1667990783310,ECE 200,044,103629,Sworder; David D.,9999,0,9999,0
1667990783310,ECE 200,045,103630,Taur; Yuan,9999,0,9999,0
1667990783310,ECE 200,046,103631,Touri; Behrouz,9999,0,9999,0
1667990783310,ECE 200,047,103632,Trivedi; Mohan M.,9999,0,9999,0
1667990783310,ECE 200,048,103633,Vasconcelos; Nuno,9999,0,9999,0
1667990783310,ECE 200,049,103634,Wang; Xiaolong,9999,0,9999,0
1667990783310,ECE 200,050,103635,Xie; Pengtao,9999,0,9999,0
1667990783310,ECE 200,051,103636,Yip; Michael,9999,0,9999,0
1667990783310,ECE 200,052,103637,Zeger; Kenneth A.,999,0,999,0
1667990783310,ECE 200,053,103638,Zhang; Xinyu,9999,0,9999,0
1667990783310,ECE 200,054,103639,Turakhia; Yatish Girish,9999,0,9999,0
1667990783310,ECE 200,055,103640,Kang; Mingu,9999,0,9999,0
1667990783310,ECE 200,056,103641,Shi; Yuanyuan,9999,0,9999,0
1667990783310,ECE 200,057,103642,Wang; Edward Jay,9999,0,9999,0
1667990783310,ECE 200,058,103643,Zheng; Yang,9999,0,9999,0
1667990783744,ECE 202,A00,103644,Kuzum; Duygu,0,0,0,0
1667990784168,ECE 212BN,A00,103646,Ng; Tse Nga,0,0,0,0
1667990784592,ECE 221,A00,111493,Staff,0,0,0,0
1667990785016,ECE 222B,A00,103647,Lomakin; Vitaliy,0,0,0,0
1667990785445,ECE 230B,A00,103648,Taur; Yuan,0,0,0,0
1667990785873,ECE 238B,A00,103649,Garay; Javier,0,0,0,0
1667990786302,ECE 240B,A00,112900,Fainman; Yeshaiahu,0,0,0,0
1667990786732,ECE 247A,A00,103650,Jokerst; Jesse Vincent,0,0,0,0
1667990787156,ECE 247B,A00,103651,Wang; Joseph,0,0,0,0
1667990787579,ECE 250,A00,103652,Siegel; Paul H.,0,0,0,0
1667990788004,ECE 251A,A00,103654,Rao; Bhaskar D.,0,0,0,0
1667990788430,ECE 257B,A00,103655,Bharadia; Dinesh,0,0,0,0
1667990788855,ECE 258A,A00,103656,Milstein; Laurence B.,0,0,0,0
1667990789279,ECE 260B,A00,103658,Kang; Mingu,0,0,0,0
1667990789707,ECE 264A,A00,103659,Galton; Ian A,0,0,0,0
1667990790137,ECE 265A,A00,103661,Gudem; Prasad S.S.,0,0,0,0
1667990790567,ECE 265D,A00,103662,Gudem; Prasad S.S.,0,0,0,0
1667990790991,ECE 268,A00,103663,Koushanfar; Farinaz,0,0,0,0
1667990791418,ECE 269,A01,103665,Pal; Piya,0,0,0,0
1667990791844,ECE 271B,A00,103666,Vasconcelos; Manuela,0,0,0,0
1667990792268,ECE 276A,A00,103667,Atanasov; Nikolay A.,0,0,0,0
1667990792694,ECE 277,A00,103668,An; Cheolhong,0,0,0,0
1667990793119,ECE 279,A00,117947,Hall; Drew A.,0,0,0,0
1667990793972,ECE 283,A00,103670,Hsueh; Tzu-Chien,0,0,0,0
1667990794395,ECE 284,A00,103671,Turakhia; Yatish Girish,0,0,0,0
1667990794819,ECE 285,A00,103672,Zheng; Yang,0,0,0,0
1667990794819,ECE 285,B00,103673,Sworder; David D.,0,0,0,0
1667990795243,ECE 287,A00,103676,Javidi; Tara,0,0,0,0
1667990795667,MATH 200B,A00,098023,Salehi Golsefidy; Alireza,14,0,15,1
1667990796092,MATH 202B,A00,098024,Rhoades; Brendon Patrick,12,0,15,3
1667990796516,MATH 203B,A00,098025,Oprea; Dragos N.,12,0,15,3
1667990796942,MATH 204B,A00,098026,Sorensen; Claus M,14,0,15,1
1667990797365,MATH 208,A00,098027,Izadi; Elham,7,0,10,3
1667990797788,MATH 209,A00,098028,Pollack; Aaron,10,0,10,0
1667990798218,MATH 211A,A00,112919,Rogalski; Daniel,9,0,10,1
1667990798643,MATH 211B,A00,112920,Seward; Brandon M.,9,0,10,1
1667990799066,MATH 218,A00,098029,Li; Bo,10,0,10,0
1667990799496,MATH 220B,A00,098030,Novak; Jonathan I,13,0,15,2
1667990799923,MATH 221A,A00,098031,Ebenfelt; Peter F,13,0,15,2
1667990800351,MATH 231B,A00,098032,Zlatos; Andrej,12,0,15,3
1667990800781,MATH 240B,A00,098033,Ni; Lei,10,0,15,5
1667990801205,MATH 243,A00,098034,Jekel; David Andrew,10,0,10,0
1667990801630,MATH 245A,A00,098035,Nie; Jiawang,0,0,15,16
1667990802055,MATH 248,A00,098036,Bejenaru; Ioan,10,0,10,0
1667990802481,MATH 250B,A00,098037,Spolaor; Luca,14,0,15,1
1667990802906,MATH 258,A00,098038,Ni; Lei,10,0,10,0
1667990803330,MATH 264B,A00,098041,Rhoades; Brendon Patrick,11,0,15,4
1667990803756,MATH 268,A00,098042,Buss; Samuel R,10,0,10,0
1667990804180,MATH 269,A00,098043,Rhoades; Brendon Patrick,10,0,10,0
1667990804604,MATH 270B,A00,098044,Li; Bo,11,0,15,4
1667990805026,MATH 272B,A00,098045,Holst; Michael J,13,0,15,2
1667990805451,MATH 273A,A00,098046,Tian; Xiaochuan,12,0,15,3
1667990805874,MATH 275,A01,098048,Tian; Xiaochuan,6,0,10,4
1667990806297,MATH 278A,A00,098049,Holst; Michael J,8,0,10,2
1667990806722,MATH 278B,A00,098050,Cloninger; Alexander,10,0,10,0
1667990807149,MATH 278C,A00,098051,Nie; Jiawang,8,0,10,2
1667990807574,MATH 280B,A00,098052,Zheng; Tianyi,11,0,15,4
1667990807998,MATH 281B,A00,098053,Bradic; Jelena,4,0,15,11
1667990808421,MATH 282B,A00,098054,Arias-Castro; Ery,2,0,15,13
1667990808846,MATH 285,A00,098055,Fitzsimmons; Patrick J,0,0,15,17
1667990809267,MATH 287B,A00,098056,Arias-Castro; Ery,5,0,15,10
1667990809693,MATH 288,A00,098057,Agarwal; Pooja,9,0,10,1
1667990809693,MATH 288,B00,098058,Zhang; Danna,9,0,10,1
1667990809693,MATH 288,C00,098059,Williams; Ruth J,10,0,10,0
1667990810115,MATH 290B,A00,098060,Roberts; Justin Deritter,14,0,15,1
1667990810539,MATH 292,A00,098061,Belmont; Eva Kinoshita,10,0,10,0
1667990810962,MATH 295,A00,098062,Suk; Andrew Hoon,48,0,50,2
1667990811476,MATH 296,A00,098063,Novak; Jonathan I,20,0,20,0
1667990811899,MATH 297,001,098064,Gamst; Anthony Collins,9997,0,9999,2
1667991311410,COGS 205,A00,101395,Chiba; Andrea,19,0,20,1
1667991311847,COGS 210B,001,101404,Greene; Deanna Jacquelyn,9998,0,9999,1
1667991311847,COGS 210B,002,101417,Xia; Haijun,9999,0,9999,0
1667991311847,COGS 210B,003,101422,Nitz; Douglas A.,9999,0,9999,0
1667991311847,COGS 210B,004,101423,Hollan; James D.,9998,0,9999,1
1667991311847,COGS 210B,005,101424,Deak; Gedeon O.,9999,0,9999,0
1667991311847,COGS 210B,006,101425,Rossano; Federico,9999,0,9999,0
1667991312270,COGS 211B,A00,101427,Coulson; Seana M,9997,0,9999,2
1667991312693,COGS 220,A00,101428,Hollan; James D.,0,0,25,25
1667991313124,COGS 229,A00,101429,Dow; Steven P,18,0,25,7
1667991313547,COGS 230,A00,101430,Klemmer; Scott R,13,0,17,4
1667991313972,COGS 234,A00,101431,Xia; Haijun,7,0,25,18
1667991314396,COGS 260,A00,101432,Kiyonaga; Anastasia,20,0,25,5
1667991314396,COGS 260,B00,101433,Kirsh; David Joel,16,0,25,9
1667991314818,CSE 202,A00,102371,Impagliazzo; Russell,0,0,0,0
1667991315241,CSE 203B,A01,102373,Cheng; Chung Kuan,0,0,0,0
1667991315669,CSE 208,A00,102374,Micciancio; Daniele,0,0,0,0
1667991316094,CSE 209A,A00,112895,Impagliazzo; Russell,0,0,15,15
1667991316519,CSE 209B,A00,108005,Bellare; Mihir,0,0,0,0
1667991316943,CSE 210,A00,113163,Coblenz; Michael J,0,0,0,0
1667991317368,CSE 219,A00,106111,Dow; Steven P,0,0,20,20
1667991317799,CSE 221,A00,102376,Voelker; Geoffrey M.,0,0,0,0
1667991318223,CSE 224,A01,102378,Porter; George M,0,0,0,0
1667991318647,CSE 229A,A00,102379,Savage; Stefan,0,0,0,0
1667991319072,CSE 229C,A00,102380,Munyaka; Imani N. S.,0,0,0,0
1667991319497,CSE 232B,A00,102382,Deutsch; Alin Bernard,0,0,0,0
1667991319926,CSE 234,A01,112904,Kumar; Arun Kumar,0,0,0,0
1667991320350,CSE 237A,A00,102383,Rosing; Tajana Simunic,0,0,0,0
1667991320778,CSE 239A,A00,102384,Deutsch; Alin Bernard,0,0,0,0
1667991321202,CSE 239B,A00,102385,Polikarpova; Nadezhda,0,0,0,0
1667991321628,CSE 240A,A00,102386,Pannuto; Patrick William,0,0,0,0
1667991322055,CSE 240B,A00,102387,Zhao; Jishen,0,0,0,0
1667991322479,CSE 241A,A00,106406,Kang; Mingu,0,0,0,0
1667991322903,CSE 249B,A00,102388,Kahng; Andrew Byun,0,0,8,8
1667991323329,CSE 251B,A01,102392,Cottrell; Garrison W,0,0,0,0
1667991323329,CSE 251B,A02,102393,Cottrell; Garrison W,0,0,0,0
1667991323762,CSE 252B,A00,102394,Ochoa; Benjamin Lawrence,0,0,0,0
1667991324186,CSE 257,A01,102396,Gao; Sicun,0,0,0,0
1667991324611,CSE 272,A00,102397,Li; Tzumao,0,0,0,0
1667991325033,CSE 274,A00,111323,Chern; Albert Ren-Haur,0,0,0,0
1667991325462,CSE 282,A00,102398,Pevzner; Pavel Arkadjevich,0,0,0,0
1667991325890,CSE 284,A00,114175,Gymrek; Melissa Ann,0,0,0,0
1667991326319,CSE 290,A00,102399,Chandraker; Manmohan Krishna,0,0,0,0
1667991326319,CSE 290,B00,102400,Vaccaro; Kristen Marie,0,0,25,25
1667991326319,CSE 290,C00,102414,Pannuto; Patrick William,0,0,25,25
1667991326319,CSE 290,D00,102427,Pevzner; Pavel Arkadjevich,0,0,0,0
1667991326319,CSE 290,E00,102429,Zhao; Jishen,0,0,0,0
1667991326319,CSE 290,F00,102436,Tullsen; Dean Michael,0,0,0,0
1667991326319,CSE 290,G00,102440,Christensen; Henrik I,0,0,20,20
1667991326745,CSE 291,A00,102443,Su; Hao,0,0,0,0
1667991326745,CSE 291,B00,102448,Polikarpova; Nadezhda,0,0,0,0
1667991326745,CSE 291,C00,102453,Vaccaro; Kristen Marie,0,0,0,0
1667991326745,CSE 291,D00,111343,Savage; Stefan,0,0,0,0
1667991326745,CSE 291,E00,116474,Claffy; Kimberly Claire,0,0,0,0
1667991326745,CSE 291,F00,116479,Pasquale; Joseph,0,0,0,0
1667991327177,CSE 293,001,119111,Bafna; Vineet,9999,0,9999,0
1667991327177,CSE 293,002,119118,Bellare; Mihir,9999,0,9999,0
1667991327177,CSE 293,003,119122,Berg-Kirkpatrick; Taylor D,9999,0,9999,0
1667991327177,CSE 293,004,119135,Christensen; Henrik I,9999,0,9999,0
1667991327177,CSE 293,005,119142,Cottrell; Garrison W,9999,0,9999,0
1667991327177,CSE 293,006,119146,Deutsch; Alin Bernard,9999,0,9999,0
1667991327177,CSE 293,007,119159,Esmaeilzadeh; Hadi,9999,0,9999,0
1667991327177,CSE 293,008,119166,Freund; Yoav,9999,0,9999,0
1667991327177,CSE 293,009,119170,Griswold; William G.,9999,0,9999,0
1667991327177,CSE 293,010,119183,Gymrek; Melissa Ann,9999,0,9999,0
1667991327177,CSE 293,011,119190,Heninger; Nadia A,9999,0,9999,0
1667991327177,CSE 293,012,119230,Impagliazzo; Russell,9999,0,9999,0
1667991327177,CSE 293,013,119232,Jhala; Ranjit,9999,0,9999,0
1667991327177,CSE 293,014,119233,Kahng; Andrew Byun,9999,0,9999,0
1667991327177,CSE 293,015,119298,Kane; Daniel Mertz,9999,0,9999,0
1667991327177,CSE 293,016,119299,Kriegman; David J,9999,0,9999,0
1667991327177,CSE 293,017,119300,Kumar; Arun Kumar,9999,0,9999,0
1667991327177,CSE 293,018,119301,Lerner; Sorin,9999,0,9999,0
1667991327177,CSE 293,019,119302,Lovett; Shachar,9999,0,9999,0
1667991327177,CSE 293,020,119303,McAuley; Julian John,9999,0,9999,0
1667991327177,CSE 293,021,119304,Micciancio; Daniele,9999,0,9999,0
1667991327177,CSE 293,022,119367,Orailoglu; Alex,9999,0,9999,0
1667991327177,CSE 293,023,119382,Paturi; Ramamohan,9999,0,9999,0
1667991327177,CSE 293,024,119404,Polikarpova; Nadezhda,9999,0,9999,0
1667991327177,CSE 293,025,119406,Politz; Joseph Gibbs,9999,0,9999,0
1667991327177,CSE 293,026,119411,Porter; George M,9999,0,9999,0
1667991327177,CSE 293,027,119414,Porter; Leonard Emerson,9999,0,9999,0
1667991327177,CSE 293,028,119416,Ramamoorthi; Ravi,9999,0,9999,0
1667991327177,CSE 293,029,119417,Sahoo; Debashis,9999,0,9999,0
1667991327177,CSE 293,030,119420,Saul; Lawrence,9999,0,9999,0
1667991327177,CSE 293,031,119421,Savage; Stefan,9999,0,9999,0
1667991327177,CSE 293,032,119425,Schulze; Jurgen P.,9999,0,9999,0
1667991327177,CSE 293,033,119426,Snoeren; Alex C.,9999,0,9999,0
1667991327177,CSE 293,034,119428,Shang; Jingbo,9999,0,9999,0
1667991327177,CSE 293,035,119430,Stefan; Deian,9999,0,9999,0
1667991327177,CSE 293,036,119431,Su; Hao,9999,0,9999,0
1667991327177,CSE 293,037,119433,Swanson; Steven James,9999,0,9999,0
1667991327177,CSE 293,038,119435,Tullsen; Dean Michael,9999,0,9999,0
1667991327177,CSE 293,039,119483,Voelker; Geoffrey M.,9999,0,9999,0
1667991327177,CSE 293,040,119537,Zhao; Jishen,9999,0,9999,0
1667991327177,CSE 293,041,119538,Zhou; Yuan-Yuan,9999,0,9999,0
1667991327177,CSE 293,042,119539,Gao; Sicun,9999,0,9999,0
1667991327177,CSE 293,043,119540,Weibel; Nadir,9999,0,9999,0
1667991327177,CSE 293,044,119541,Gupta; Rajesh K.,9999,0,9999,0
1667991327177,CSE 293,045,126410,Vaccaro; Kristen Marie,9999,0,9999,0
1667991327177,CSE 293,046,126411,Klemke; Richard,9999,0,9999,0
1667991327600,CSE 294,A00,102459,Voelker; Geoffrey M.,0,0,0,0
1667991327600,CSE 294,B00,111322,Orailoglu; Alex,0,0,0,0
1667991328028,DSE 201,A00,096914,Deutsch; Alin Bernard,30,0,30,0
1667991328452,DSE 210,A00,096915,Dasgupta; Sanjoy,30,0,30,0
1667991328879,DSE 260A,A00,096916,Altintas De Callaf; Ilkay,30,0,30,0
1667991329311,ECE 200,001,103586,Antipa; Nicholas A,9999,0,9999,0
1667991329311,ECE 200,002,103587,Atanasov; Nikolay A.,9999,0,9999,0
1667991329311,ECE 200,003,103588,Bharadia; Dinesh,9999,0,9999,0
1667991329311,ECE 200,004,103589,Cheng; Chung Kuan,9999,0,9999,0
1667991329311,ECE 200,005,103590,Cosman; Pamela C.,9999,0,9999,0
1667991329311,ECE 200,006,103591,Dayeh; Shadi Ahmad,9999,0,9999,0
1667991329311,ECE 200,007,103592,Fainman; Yeshaiahu,9999,0,9999,0
1667991329311,ECE 200,008,103593,Ford; Joseph Earl,9999,0,9999,0
1667991329311,ECE 200,009,103594,Franceschetti; Massimo,9999,0,9999,0
1667991329311,ECE 200,010,103595,Fullerton; Eric E,9999,0,9999,0
1667991329311,ECE 200,011,103596,Galton; Ian A,9999,0,9999,0
1667991329311,ECE 200,012,103597,Gilja; Vikash,9999,0,9999,0
1667991329311,ECE 200,013,103598,Hall; Drew A.,9999,0,9999,0
1667991329311,ECE 200,014,103599,Hsueh; Tzu-Chien,9999,0,9999,0
1667991329311,ECE 200,015,103600,Javidi; Tara,9999,0,9999,0
1667991329311,ECE 200,016,103601,Kahng; Andrew Byun,9999,0,9999,0
1667991329311,ECE 200,017,103602,Kim; Young-Han,9999,0,9999,0
1667991329311,ECE 200,018,103603,Koushanfar; Farinaz,9999,0,9999,0
1667991329311,ECE 200,019,103604,Kuzum; Duygu,9999,0,9999,0
1667991329311,ECE 200,020,103605,Le; Hanh-Phuc,9999,0,9999,0
1667991329311,ECE 200,021,103606,Lin; Bill,9999,0,9999,0
1667991329311,ECE 200,022,103607,Liu; Zhaowei,9998,0,9999,1
1667991329311,ECE 200,023,103608,Lo; Yu-Hwa,9999,0,9999,0
1667991329311,ECE 200,024,103609,Lomakin; Vitaliy,9999,0,9999,0
1667991329311,ECE 200,025,103610,Mercier; Patrick Philip,9999,0,9999,0
1667991329311,ECE 200,026,103611,Meyer; Florian,9999,0,9999,0
1667991329311,ECE 200,027,103612,Milstein; Laurence B.,9999,0,9999,0
1667991329311,ECE 200,028,103613,Mir Arabbaygi; Siavash,9999,0,9999,0
1667991329311,ECE 200,029,103614,Mookherjea; Shayan,9999,0,9999,0
1667991329311,ECE 200,030,103615,Morris; Karcher William,9999,0,9999,0
1667991329311,ECE 200,031,103616,Ng; Tse Nga,9999,0,9999,0
1667991329311,ECE 200,032,103617,Nguyen; Truong Quang,9999,0,9999,0
1667991329311,ECE 200,033,103618,Nomura; Kenji,9999,0,9999,0
1667991329311,ECE 200,034,103619,Orlitsky; Alon,9999,0,9999,0
1667991329311,ECE 200,035,103620,Pal; Piya,9999,0,9999,0
1667991329311,ECE 200,036,103621,Papen; George C.,9999,0,9999,0
1667991329311,ECE 200,037,103622,Radic; Stojan,9999,0,9999,0
1667991329311,ECE 200,038,103623,Rao; Bhaskar D.,9999,0,9999,0
1667991329311,ECE 200,039,103624,Rao; Ramesh R,9999,0,9999,0
1667991329311,ECE 200,040,103625,Rebeiz; Gabriel,9999,0,9999,0
1667991329311,ECE 200,041,103626,Sanford; John R,9999,0,9999,0
1667991329311,ECE 200,042,103627,Siegel; Paul H.,9999,0,9999,0
1667991329311,ECE 200,043,103628,Sievenpiper; Daniel F.,9999,0,9999,0
1667991329311,ECE 200,044,103629,Sworder; David D.,9999,0,9999,0
1667991329311,ECE 200,045,103630,Taur; Yuan,9999,0,9999,0
1667991329311,ECE 200,046,103631,Touri; Behrouz,9999,0,9999,0
1667991329311,ECE 200,047,103632,Trivedi; Mohan M.,9999,0,9999,0
1667991329311,ECE 200,048,103633,Vasconcelos; Nuno,9999,0,9999,0
1667991329311,ECE 200,049,103634,Wang; Xiaolong,9999,0,9999,0
1667991329311,ECE 200,050,103635,Xie; Pengtao,9999,0,9999,0
1667991329311,ECE 200,051,103636,Yip; Michael,9999,0,9999,0
1667991329311,ECE 200,052,103637,Zeger; Kenneth A.,999,0,999,0
1667991329311,ECE 200,053,103638,Zhang; Xinyu,9999,0,9999,0
1667991329311,ECE 200,054,103639,Turakhia; Yatish Girish,9999,0,9999,0
1667991329311,ECE 200,055,103640,Kang; Mingu,9999,0,9999,0
1667991329311,ECE 200,056,103641,Shi; Yuanyuan,9999,0,9999,0
1667991329311,ECE 200,057,103642,Wang; Edward Jay,9999,0,9999,0
1667991329311,ECE 200,058,103643,Zheng; Yang,9999,0,9999,0
1667991329738,ECE 202,A00,103644,Kuzum; Duygu,0,0,0,0
1667991330165,ECE 212BN,A00,103646,Ng; Tse Nga,0,0,0,0
1667991330590,ECE 221,A00,111493,Staff,0,0,0,0
1667991331106,ECE 222B,A00,103647,Lomakin; Vitaliy,0,0,0,0
1667991331530,ECE 230B,A00,103648,Taur; Yuan,0,0,0,0
1667991331958,ECE 238B,A00,103649,Garay; Javier,0,0,0,0
1667991332381,ECE 240B,A00,112900,Fainman; Yeshaiahu,0,0,0,0
1667991332807,ECE 247A,A00,103650,Jokerst; Jesse Vincent,0,0,0,0
1667991333232,ECE 247B,A00,103651,Wang; Joseph,0,0,0,0
1667991333655,ECE 250,A00,103652,Siegel; Paul H.,0,0,0,0
1667991334081,ECE 251A,A00,103654,Rao; Bhaskar D.,0,0,0,0
1667991334504,ECE 257B,A00,103655,Bharadia; Dinesh,0,0,0,0
1667991334929,ECE 258A,A00,103656,Milstein; Laurence B.,0,0,0,0
1667991335351,ECE 260B,A00,103658,Kang; Mingu,0,0,0,0
1667991335781,ECE 264A,A00,103659,Galton; Ian A,0,0,0,0
1667991336205,ECE 265A,A00,103661,Gudem; Prasad S.S.,0,0,0,0
1667991336634,ECE 265D,A00,103662,Gudem; Prasad S.S.,0,0,0,0
1667991337061,ECE 268,A00,103663,Koushanfar; Farinaz,0,0,0,0
1667991337484,ECE 269,A01,103665,Pal; Piya,0,0,0,0
1667991337916,ECE 271B,A00,103666,Vasconcelos; Manuela,0,0,0,0
1667991338342,ECE 276A,A00,103667,Atanasov; Nikolay A.,0,0,0,0
1667991338764,ECE 277,A00,103668,An; Cheolhong,0,0,0,0
1667991339193,ECE 279,A00,117947,Hall; Drew A.,0,0,0,0
1667991340038,ECE 283,A00,103670,Hsueh; Tzu-Chien,0,0,0,0
1667991340465,ECE 284,A00,103671,Turakhia; Yatish Girish,0,0,0,0
1667991340890,ECE 285,A00,103672,Zheng; Yang,0,0,0,0
1667991340890,ECE 285,B00,103673,Sworder; David D.,0,0,0,0
1667991341321,ECE 287,A00,103676,Javidi; Tara,0,0,0,0
1667991341750,MATH 200B,A00,098023,Salehi Golsefidy; Alireza,14,0,15,1
1667991342175,MATH 202B,A00,098024,Rhoades; Brendon Patrick,12,0,15,3
1667991342601,MATH 203B,A00,098025,Oprea; Dragos N.,12,0,15,3
1667991343029,MATH 204B,A00,098026,Sorensen; Claus M,14,0,15,1
1667991343453,MATH 208,A00,098027,Izadi; Elham,7,0,10,3
1667991343876,MATH 209,A00,098028,Pollack; Aaron,10,0,10,0
1667991344300,MATH 211A,A00,112919,Rogalski; Daniel,9,0,10,1
1667991344723,MATH 211B,A00,112920,Seward; Brandon M.,9,0,10,1
1667991345151,MATH 218,A00,098029,Li; Bo,10,0,10,0
1667991345575,MATH 220B,A00,098030,Novak; Jonathan I,13,0,15,2
1667991346003,MATH 221A,A00,098031,Ebenfelt; Peter F,13,0,15,2
1667991346430,MATH 231B,A00,098032,Zlatos; Andrej,12,0,15,3
1667991346853,MATH 240B,A00,098033,Ni; Lei,10,0,15,5
1667991347280,MATH 243,A00,098034,Jekel; David Andrew,10,0,10,0
1667991347703,MATH 245A,A00,098035,Nie; Jiawang,0,0,15,16
1667991348126,MATH 248,A00,098036,Bejenaru; Ioan,10,0,10,0
1667991348550,MATH 250B,A00,098037,Spolaor; Luca,14,0,15,1
1667991348984,MATH 258,A00,098038,Ni; Lei,10,0,10,0
1667991349412,MATH 264B,A00,098041,Rhoades; Brendon Patrick,11,0,15,4
1667991349834,MATH 268,A00,098042,Buss; Samuel R,10,0,10,0
1667991350260,MATH 269,A00,098043,Rhoades; Brendon Patrick,10,0,10,0
1667991350687,MATH 270B,A00,098044,Li; Bo,11,0,15,4
1667991351111,MATH 272B,A00,098045,Holst; Michael J,13,0,15,2
1667991351536,MATH 273A,A00,098046,Tian; Xiaochuan,12,0,15,3
1667991351959,MATH 275,A01,098048,Tian; Xiaochuan,6,0,10,4
1667991352387,MATH 278A,A00,098049,Holst; Michael J,8,0,10,2
1667991352810,MATH 278B,A00,098050,Cloninger; Alexander,10,0,10,0
1667991353238,MATH 278C,A00,098051,Nie; Jiawang,8,0,10,2
1667991353661,MATH 280B,A00,098052,Zheng; Tianyi,11,0,15,4
1667991354086,MATH 281B,A00,098053,Bradic; Jelena,4,0,15,11
1667991354510,MATH 282B,A00,098054,Arias-Castro; Ery,2,0,15,13
1667991354938,MATH 285,A00,098055,Fitzsimmons; Patrick J,0,0,15,17
1667991355366,MATH 287B,A00,098056,Arias-Castro; Ery,5,0,15,10
1667991355789,MATH 288,A00,098057,Agarwal; Pooja,9,0,10,1
1667991355789,MATH 288,B00,098058,Zhang; Danna,9,0,10,1
1667991355789,MATH 288,C00,098059,Williams; Ruth J,10,0,10,0
1667991356224,MATH 290B,A00,098060,Roberts; Justin Deritter,14,0,15,1
1667991356648,MATH 292,A00,098061,Belmont; Eva Kinoshita,10,0,10,0
1667991357078,MATH 295,A00,098062,Suk; Andrew Hoon,48,0,50,2
1667991357500,MATH 296,A00,098063,Novak; Jonathan I,20,0,20,0
1667991357924,MATH 297,001,098064,Gamst; Anthony Collins,9997,0,9999,2
1667991857945,COGS 205,A00,101395,Chiba; Andrea,19,0,20,1
1667991858371,COGS 210B,001,101404,Greene; Deanna Jacquelyn,9998,0,9999,1
1667991858371,COGS 210B,002,101417,Xia; Haijun,9999,0,9999,0
1667991858371,COGS 210B,003,101422,Nitz; Douglas A.,9999,0,9999,0
1667991858371,COGS 210B,004,101423,Hollan; James D.,9998,0,9999,1
1667991858371,COGS 210B,005,101424,Deak; Gedeon O.,9999,0,9999,0
1667991858371,COGS 210B,006,101425,Rossano; Federico,9999,0,9999,0
1667991858795,COGS 211B,A00,101427,Coulson; Seana M,9997,0,9999,2
1667991859219,COGS 220,A00,101428,Hollan; James D.,0,0,25,25
1667991859641,COGS 229,A00,101429,Dow; Steven P,18,0,25,7
1667991860067,COGS 230,A00,101430,Klemmer; Scott R,13,0,17,4
1667991860492,COGS 234,A00,101431,Xia; Haijun,7,0,25,18
1667991860918,COGS 260,A00,101432,Kiyonaga; Anastasia,20,0,25,5
1667991860918,COGS 260,B00,101433,Kirsh; David Joel,16,0,25,9
1667991861343,CSE 202,A00,102371,Impagliazzo; Russell,0,0,0,0
1667991861771,CSE 203B,A01,102373,Cheng; Chung Kuan,0,0,0,0
1667991862193,CSE 208,A00,102374,Micciancio; Daniele,0,0,0,0
1667991862619,CSE 209A,A00,112895,Impagliazzo; Russell,0,0,15,15
1667991863048,CSE 209B,A00,108005,Bellare; Mihir,0,0,0,0
1667991863472,CSE 210,A00,113163,Coblenz; Michael J,0,0,0,0
1667991863898,CSE 219,A00,106111,Dow; Steven P,0,0,20,20
1667991864321,CSE 221,A00,102376,Voelker; Geoffrey M.,0,0,0,0
1667991864747,CSE 224,A01,102378,Porter; George M,0,0,0,0
1667991865172,CSE 229A,A00,102379,Savage; Stefan,0,0,0,0
1667991865601,CSE 229C,A00,102380,Munyaka; Imani N. S.,0,0,0,0
1667991866026,CSE 232B,A00,102382,Deutsch; Alin Bernard,0,0,0,0
1667991866454,CSE 234,A01,112904,Kumar; Arun Kumar,0,0,0,0
1667991866885,CSE 237A,A00,102383,Rosing; Tajana Simunic,0,0,0,0
1667991867309,CSE 239A,A00,102384,Deutsch; Alin Bernard,0,0,0,0
1667991867731,CSE 239B,A00,102385,Polikarpova; Nadezhda,0,0,0,0
1667991868154,CSE 240A,A00,102386,Pannuto; Patrick William,0,0,0,0
1667991868577,CSE 240B,A00,102387,Zhao; Jishen,0,0,0,0
1667991869005,CSE 241A,A00,106406,Kang; Mingu,0,0,0,0
1667991869433,CSE 249B,A00,102388,Kahng; Andrew Byun,0,0,8,8
1667991869865,CSE 251B,A01,102392,Cottrell; Garrison W,0,0,0,0
1667991869865,CSE 251B,A02,102393,Cottrell; Garrison W,0,0,0,0
1667991870290,CSE 252B,A00,102394,Ochoa; Benjamin Lawrence,0,0,0,0
1667991870716,CSE 257,A01,102396,Gao; Sicun,0,0,0,0
1667991871140,CSE 272,A00,102397,Li; Tzumao,0,0,0,0
1667991871564,CSE 274,A00,111323,Chern; Albert Ren-Haur,0,0,0,0
1667991871986,CSE 282,A00,102398,Pevzner; Pavel Arkadjevich,0,0,0,0
1667991872410,CSE 284,A00,114175,Gymrek; Melissa Ann,0,0,0,0
1667991872834,CSE 290,A00,102399,Chandraker; Manmohan Krishna,0,0,0,0
1667991872834,CSE 290,B00,102400,Vaccaro; Kristen Marie,0,0,25,25
1667991872834,CSE 290,C00,102414,Pannuto; Patrick William,0,0,25,25
1667991872834,CSE 290,D00,102427,Pevzner; Pavel Arkadjevich,0,0,0,0
1667991872834,CSE 290,E00,102429,Zhao; Jishen,0,0,0,0
1667991872834,CSE 290,F00,102436,Tullsen; Dean Michael,0,0,0,0
1667991872834,CSE 290,G00,102440,Christensen; Henrik I,0,0,20,20
1667991873259,CSE 291,A00,102443,Su; Hao,0,0,0,0
1667991873259,CSE 291,B00,102448,Polikarpova; Nadezhda,0,0,0,0
1667991873259,CSE 291,C00,102453,Vaccaro; Kristen Marie,0,0,0,0
1667991873259,CSE 291,D00,111343,Savage; Stefan,0,0,0,0
1667991873259,CSE 291,E00,116474,Claffy; Kimberly Claire,0,0,0,0
1667991873259,CSE 291,F00,116479,Pasquale; Joseph,0,0,0,0
1667991873699,CSE 293,001,119111,Bafna; Vineet,9999,0,9999,0
1667991873699,CSE 293,002,119118,Bellare; Mihir,9999,0,9999,0
1667991873699,CSE 293,003,119122,Berg-Kirkpatrick; Taylor D,9999,0,9999,0
1667991873699,CSE 293,004,119135,Christensen; Henrik I,9999,0,9999,0
1667991873699,CSE 293,005,119142,Cottrell; Garrison W,9999,0,9999,0
1667991873699,CSE 293,006,119146,Deutsch; Alin Bernard,9999,0,9999,0
1667991873699,CSE 293,007,119159,Esmaeilzadeh; Hadi,9999,0,9999,0
1667991873699,CSE 293,008,119166,Freund; Yoav,9999,0,9999,0
1667991873699,CSE 293,009,119170,Griswold; William G.,9999,0,9999,0
1667991873699,CSE 293,010,119183,Gymrek; Melissa Ann,9999,0,9999,0
1667991873699,CSE 293,011,119190,Heninger; Nadia A,9999,0,9999,0
1667991873699,CSE 293,012,119230,Impagliazzo; Russell,9999,0,9999,0
1667991873699,CSE 293,013,119232,Jhala; Ranjit,9999,0,9999,0
1667991873699,CSE 293,014,119233,Kahng; Andrew Byun,9999,0,9999,0
1667991873699,CSE 293,015,119298,Kane; Daniel Mertz,9999,0,9999,0
1667991873699,CSE 293,016,119299,Kriegman; David J,9999,0,9999,0
1667991873699,CSE 293,017,119300,Kumar; Arun Kumar,9999,0,9999,0
1667991873699,CSE 293,018,119301,Lerner; Sorin,9999,0,9999,0
1667991873699,CSE 293,019,119302,Lovett; Shachar,9999,0,9999,0
1667991873699,CSE 293,020,119303,McAuley; Julian John,9999,0,9999,0
1667991873699,CSE 293,021,119304,Micciancio; Daniele,9999,0,9999,0
1667991873699,CSE 293,022,119367,Orailoglu; Alex,9999,0,9999,0
1667991873699,CSE 293,023,119382,Paturi; Ramamohan,9999,0,9999,0
1667991873699,CSE 293,024,119404,Polikarpova; Nadezhda,9999,0,9999,0
1667991873699,CSE 293,025,119406,Politz; Joseph Gibbs,9999,0,9999,0
1667991873699,CSE 293,026,119411,Porter; George M,9999,0,9999,0
1667991873699,CSE 293,027,119414,Porter; Leonard Emerson,9999,0,9999,0
1667991873699,CSE 293,028,119416,Ramamoorthi; Ravi,9999,0,9999,0
1667991873699,CSE 293,029,119417,Sahoo; Debashis,9999,0,9999,0
1667991873699,CSE 293,030,119420,Saul; Lawrence,9999,0,9999,0
1667991873699,CSE 293,031,119421,Savage; Stefan,9999,0,9999,0
1667991873699,CSE 293,032,119425,Schulze; Jurgen P.,9999,0,9999,0
1667991873699,CSE 293,033,119426,Snoeren; Alex C.,9999,0,9999,0
1667991873699,CSE 293,034,119428,Shang; Jingbo,9999,0,9999,0
1667991873699,CSE 293,035,119430,Stefan; Deian,9999,0,9999,0
1667991873699,CSE 293,036,119431,Su; Hao,9999,0,9999,0
1667991873699,CSE 293,037,119433,Swanson; Steven James,9999,0,9999,0
1667991873699,CSE 293,038,119435,Tullsen; Dean Michael,9999,0,9999,0
1667991873699,CSE 293,039,119483,Voelker; Geoffrey M.,9999,0,9999,0
1667991873699,CSE 293,040,119537,Zhao; Jishen,9999,0,9999,0
1667991873699,CSE 293,041,119538,Zhou; Yuan-Yuan,9999,0,9999,0
1667991873699,CSE 293,042,119539,Gao; Sicun,9999,0,9999,0
1667991873699,CSE 293,043,119540,Weibel; Nadir,9999,0,9999,0
1667991873699,CSE 293,044,119541,Gupta; Rajesh K.,9999,0,9999,0
1667991873699,CSE 293,045,126410,Vaccaro; Kristen Marie,9999,0,9999,0
1667991873699,CSE 293,046,126411,Klemke; Richard,9999,0,9999,0
1667991874130,CSE 294,A00,102459,Voelker; Geoffrey M.,0,0,0,0
1667991874130,CSE 294,B00,111322,Orailoglu; Alex,0,0,0,0
1667991874553,DSE 201,A00,096914,Deutsch; Alin Bernard,30,0,30,0
1667991874976,DSE 210,A00,096915,Dasgupta; Sanjoy,30,0,30,0
1667991875403,DSE 260A,A00,096916,Altintas De Callaf; Ilkay,30,0,30,0
1667991875858,ECE 200,001,103586,Antipa; Nicholas A,9999,0,9999,0
1667991875858,ECE 200,002,103587,Atanasov; Nikolay A.,9999,0,9999,0
1667991875858,ECE 200,003,103588,Bharadia; Dinesh,9999,0,9999,0
1667991875858,ECE 200,004,103589,Cheng; Chung Kuan,9999,0,9999,0
1667991875858,ECE 200,005,103590,Cosman; Pamela C.,9999,0,9999,0
1667991875858,ECE 200,006,103591,Dayeh; Shadi Ahmad,9999,0,9999,0
1667991875858,ECE 200,007,103592,Fainman; Yeshaiahu,9999,0,9999,0
1667991875858,ECE 200,008,103593,Ford; Joseph Earl,9999,0,9999,0
1667991875858,ECE 200,009,103594,Franceschetti; Massimo,9999,0,9999,0
1667991875858,ECE 200,010,103595,Fullerton; Eric E,9999,0,9999,0
1667991875858,ECE 200,011,103596,Galton; Ian A,9999,0,9999,0
1667991875858,ECE 200,012,103597,Gilja; Vikash,9999,0,9999,0
1667991875858,ECE 200,013,103598,Hall; Drew A.,9999,0,9999,0
1667991875858,ECE 200,014,103599,Hsueh; Tzu-Chien,9999,0,9999,0
1667991875858,ECE 200,015,103600,Javidi; Tara,9999,0,9999,0
1667991875858,ECE 200,016,103601,Kahng; Andrew Byun,9999,0,9999,0
1667991875858,ECE 200,017,103602,Kim; Young-Han,9999,0,9999,0
1667991875858,ECE 200,018,103603,Koushanfar; Farinaz,9999,0,9999,0
1667991875858,ECE 200,019,103604,Kuzum; Duygu,9999,0,9999,0
1667991875858,ECE 200,020,103605,Le; Hanh-Phuc,9999,0,9999,0
1667991875858,ECE 200,021,103606,Lin; Bill,9999,0,9999,0
1667991875858,ECE 200,022,103607,Liu; Zhaowei,9998,0,9999,1
1667991875858,ECE 200,023,103608,Lo; Yu-Hwa,9999,0,9999,0
1667991875858,ECE 200,024,103609,Lomakin; Vitaliy,9999,0,9999,0
1667991875858,ECE 200,025,103610,Mercier; Patrick Philip,9999,0,9999,0
1667991875858,ECE 200,026,103611,Meyer; Florian,9999,0,9999,0
1667991875858,ECE 200,027,103612,Milstein; Laurence B.,9999,0,9999,0
1667991875858,ECE 200,028,103613,Mir Arabbaygi; Siavash,9999,0,9999,0
1667991875858,ECE 200,029,103614,Mookherjea; Shayan,9999,0,9999,0
1667991875858,ECE 200,030,103615,Morris; Karcher William,9999,0,9999,0
1667991875858,ECE 200,031,103616,Ng; Tse Nga,9999,0,9999,0
1667991875858,ECE 200,032,103617,Nguyen; Truong Quang,9999,0,9999,0
1667991875858,ECE 200,033,103618,Nomura; Kenji,9999,0,9999,0
1667991875858,ECE 200,034,103619,Orlitsky; Alon,9999,0,9999,0
1667991875858,ECE 200,035,103620,Pal; Piya,9999,0,9999,0
1667991875858,ECE 200,036,103621,Papen; George C.,9999,0,9999,0
1667991875858,ECE 200,037,103622,Radic; Stojan,9999,0,9999,0
1667991875858,ECE 200,038,103623,Rao; Bhaskar D.,9999,0,9999,0
1667991875858,ECE 200,039,103624,Rao; Ramesh R,9999,0,9999,0
1667991875858,ECE 200,040,103625,Rebeiz; Gabriel,9999,0,9999,0
1667991875858,ECE 200,041,103626,Sanford; John R,9999,0,9999,0
1667991875858,ECE 200,042,103627,Siegel; Paul H.,9999,0,9999,0
1667991875858,ECE 200,043,103628,Sievenpiper; Daniel F.,9999,0,9999,0
1667991875858,ECE 200,044,103629,Sworder; David D.,9999,0,9999,0
1667991875858,ECE 200,045,103630,Taur; Yuan,9999,0,9999,0
1667991875858,ECE 200,046,103631,Touri; Behrouz,9999,0,9999,0
1667991875858,ECE 200,047,103632,Trivedi; Mohan M.,9999,0,9999,0
1667991875858,ECE 200,048,103633,Vasconcelos; Nuno,9999,0,9999,0
1667991875858,ECE 200,049,103634,Wang; Xiaolong,9999,0,9999,0
1667991875858,ECE 200,050,103635,Xie; Pengtao,9999,0,9999,0
1667991875858,ECE 200,051,103636,Yip; Michael,9999,0,9999,0
1667991875858,ECE 200,052,103637,Zeger; Kenneth A.,999,0,999,0
1667991875858,ECE 200,053,103638,Zhang; Xinyu,9999,0,9999,0
1667991875858,ECE 200,054,103639,Turakhia; Yatish Girish,9999,0,9999,0
1667991875858,ECE 200,055,103640,Kang; Mingu,9999,0,9999,0
1667991875858,ECE 200,056,103641,Shi; Yuanyuan,9999,0,9999,0
1667991875858,ECE 200,057,103642,Wang; Edward Jay,9999,0,9999,0
1667991875858,ECE 200,058,103643,Zheng; Yang,9999,0,9999,0
1667991876290,ECE 202,A00,103644,Kuzum; Duygu,0,0,0,0
1667991876724,ECE 212BN,A00,103646,Ng; Tse Nga,0,0,0,0
1667991877157,ECE 221,A00,111493,Staff,0,0,0,0
1667991877582,ECE 222B,A00,103647,Lomakin; Vitaliy,0,0,0,0
1667991878013,ECE 230B,A00,103648,Taur; Yuan,0,0,0,0
1667991878445,ECE 238B,A00,103649,Garay; Javier,0,0,0,0
1667991878871,ECE 240B,A00,112900,Fainman; Yeshaiahu,0,0,0,0
1667991879300,ECE 247A,A00,103650,Jokerst; Jesse Vincent,0,0,0,0
1667991879725,ECE 247B,A00,103651,Wang; Joseph,0,0,0,0
1667991880150,ECE 250,A00,103652,Siegel; Paul H.,0,0,0,0
1667991880578,ECE 251A,A00,103654,Rao; Bhaskar D.,0,0,0,0
1667991881001,ECE 257B,A00,103655,Bharadia; Dinesh,0,0,0,0
1667991881427,ECE 258A,A00,103656,Milstein; Laurence B.,0,0,0,0
1667991881852,ECE 260B,A00,103658,Kang; Mingu,0,0,0,0
1667991882275,ECE 264A,A00,103659,Galton; Ian A,0,0,0,0
1667991882697,ECE 265A,A00,103661,Gudem; Prasad S.S.,0,0,0,0
1667991883124,ECE 265D,A00,103662,Gudem; Prasad S.S.,0,0,0,0
1667991883548,ECE 268,A00,103663,Koushanfar; Farinaz,0,0,0,0
1667991883974,ECE 269,A01,103665,Pal; Piya,0,0,0,0
1667991884400,ECE 271B,A00,103666,Vasconcelos; Manuela,0,0,0,0
1667991884824,ECE 276A,A00,103667,Atanasov; Nikolay A.,0,0,0,0
1667991885250,ECE 277,A00,103668,An; Cheolhong,0,0,0,0
1667991885673,ECE 279,A00,117947,Hall; Drew A.,0,0,0,0
1667991886527,ECE 283,A00,103670,Hsueh; Tzu-Chien,0,0,0,0
1667991886950,ECE 284,A00,103671,Turakhia; Yatish Girish,0,0,0,0
1667991887374,ECE 285,A00,103672,Zheng; Yang,0,0,0,0
1667991887374,ECE 285,B00,103673,Sworder; David D.,0,0,0,0
1667991887799,ECE 287,A00,103676,Javidi; Tara,0,0,0,0
1667991888226,MATH 200B,A00,098023,Salehi Golsefidy; Alireza,14,0,15,1
1667991888649,MATH 202B,A00,098024,Rhoades; Brendon Patrick,12,0,15,3
1667991889075,MATH 203B,A00,098025,Oprea; Dragos N.,12,0,15,3
1667991889500,MATH 204B,A00,098026,Sorensen; Claus M,14,0,15,1
1667991889929,MATH 208,A00,098027,Izadi; Elham,7,0,10,3
1667991890353,MATH 209,A00,098028,Pollack; Aaron,10,0,10,0
1667991890781,MATH 211A,A00,112919,Rogalski; Daniel,9,0,10,1
1667991891207,MATH 211B,A00,112920,Seward; Brandon M.,9,0,10,1
1667991891630,MATH 218,A00,098029,Li; Bo,10,0,10,0
1667991892053,MATH 220B,A00,098030,Novak; Jonathan I,13,0,15,2
1667991892481,MATH 221A,A00,098031,Ebenfelt; Peter F,13,0,15,2
1667991892912,MATH 231B,A00,098032,Zlatos; Andrej,12,0,15,3
1667991893335,MATH 240B,A00,098033,Ni; Lei,10,0,15,5
1667991893759,MATH 243,A00,098034,Jekel; David Andrew,10,0,10,0
1667991894262,MATH 245A,A00,098035,Nie; Jiawang,0,0,15,16
1667991894685,MATH 248,A00,098036,Bejenaru; Ioan,10,0,10,0
1667991895110,MATH 250B,A00,098037,Spolaor; Luca,14,0,15,1
1667991895538,MATH 258,A00,098038,Ni; Lei,10,0,10,0
1667991895969,MATH 264B,A00,098041,Rhoades; Brendon Patrick,11,0,15,4
1667991896396,MATH 268,A00,098042,Buss; Samuel R,10,0,10,0
1667991896820,MATH 269,A00,098043,Rhoades; Brendon Patrick,10,0,10,0
1667991897248,MATH 270B,A00,098044,Li; Bo,11,0,15,4
1667991897679,MATH 272B,A00,098045,Holst; Michael J,13,0,15,2
1667991898104,MATH 273A,A00,098046,Tian; Xiaochuan,12,0,15,3
1667991898527,MATH 275,A01,098048,Tian; Xiaochuan,6,0,10,4
1667991898955,MATH 278A,A00,098049,Holst; Michael J,8,0,10,2
1667991899378,MATH 278B,A00,098050,Cloninger; Alexander,10,0,10,0
1667991899807,MATH 278C,A00,098051,Nie; Jiawang,8,0,10,2
1667991900236,MATH 280B,A00,098052,Zheng; Tianyi,11,0,15,4
1667991900658,MATH 281B,A00,098053,Bradic; Jelena,4,0,15,11
1667991901083,MATH 282B,A00,098054,Arias-Castro; Ery,2,0,15,13
1667991901509,MATH 285,A00,098055,Fitzsimmons; Patrick J,0,0,15,17
1667991901935,MATH 287B,A00,098056,Arias-Castro; Ery,5,0,15,10
1667991902374,MATH 288,A00,098057,Agarwal; Pooja,9,0,10,1
1667991902374,MATH 288,B00,098058,Zhang; Danna,9,0,10,1
1667991902374,MATH 288,C00,098059,Williams; Ruth J,10,0,10,0
1667991902806,MATH 290B,A00,098060,Roberts; Justin Deritter,14,0,15,1
1667991903230,MATH 292,A00,098061,Belmont; Eva Kinoshita,10,0,10,0
1667991903657,MATH 295,A00,098062,Suk; Andrew Hoon,48,0,50,2
1667991904083,MATH 296,A00,098063,Novak; Jonathan I,20,0,20,0
1667991904511,MATH 297,001,098064,Gamst; Anthony Collins,9997,0,9999,2
1667992404607,COGS 205,A00,101395,Chiba; Andrea,19,0,20,1
1667992405033,COGS 210B,001,101404,Greene; Deanna Jacquelyn,9998,0,9999,1
1667992405033,COGS 210B,002,101417,Xia; Haijun,9999,0,9999,0
1667992405033,COGS 210B,003,101422,Nitz; Douglas A.,9999,0,9999,0
1667992405033,COGS 210B,004,101423,Hollan; James D.,9998,0,9999,1
1667992405033,COGS 210B,005,101424,Deak; Gedeon O.,9999,0,9999,0
1667992405033,COGS 210B,006,101425,Rossano; Federico,9999,0,9999,0
1667992405458,COGS 211B,A00,101427,Coulson; Seana M,9997,0,9999,2
1667992405886,COGS 220,A00,101428,Hollan; James D.,0,0,25,25
1667992406311,COGS 229,A00,101429,Dow; Steven P,18,0,25,7
1667992406741,COGS 230,A00,101430,Klemmer; Scott R,13,0,17,4
1667992407165,COGS 234,A00,101431,Xia; Haijun,7,0,25,18
1667992407591,COGS 260,A00,101432,Kiyonaga; Anastasia,20,0,25,5
1667992407591,COGS 260,B00,101433,Kirsh; David Joel,16,0,25,9
1667992408016,CSE 202,A00,102371,Impagliazzo; Russell,0,0,0,0
1667992408441,CSE 203B,A01,102373,Cheng; Chung Kuan,0,0,0,0
1667992408869,CSE 208,A00,102374,Micciancio; Daniele,0,0,0,0
1667992409292,CSE 209A,A00,112895,Impagliazzo; Russell,0,0,15,15
1667992409730,CSE 209B,A00,108005,Bellare; Mihir,0,0,0,0
1667992410158,CSE 210,A00,113163,Coblenz; Michael J,0,0,0,0
1667992410586,CSE 219,A00,106111,Dow; Steven P,0,0,20,20
1667992411010,CSE 221,A00,102376,Voelker; Geoffrey M.,0,0,0,0
1667992411435,CSE 224,A01,102378,Porter; George M,0,0,0,0
1667992411867,CSE 229A,A00,102379,Savage; Stefan,0,0,0,0
1667992412290,CSE 229C,A00,102380,Munyaka; Imani N. S.,0,0,0,0
1667992412716,CSE 232B,A00,102382,Deutsch; Alin Bernard,0,0,0,0
1667992413140,CSE 234,A01,112904,Kumar; Arun Kumar,0,0,0,0
1667992413567,CSE 237A,A00,102383,Rosing; Tajana Simunic,0,0,0,0
1667992413991,CSE 239A,A00,102384,Deutsch; Alin Bernard,0,0,0,0
1667992414510,CSE 239B,A00,102385,Polikarpova; Nadezhda,0,0,0,0
1667992414934,CSE 240A,A00,102386,Pannuto; Patrick William,0,0,0,0
1667992415365,CSE 240B,A00,102387,Zhao; Jishen,0,0,0,0
1667992415792,CSE 241A,A00,106406,Kang; Mingu,0,0,0,0
1667992416217,CSE 249B,A00,102388,Kahng; Andrew Byun,0,0,8,8
1667992416646,CSE 251B,A01,102392,Cottrell; Garrison W,0,0,0,0
1667992416646,CSE 251B,A02,102393,Cottrell; Garrison W,0,0,0,0
1667992417073,CSE 252B,A00,102394,Ochoa; Benjamin Lawrence,0,0,0,0
1667992417500,CSE 257,A01,102396,Gao; Sicun,0,0,0,0
1667992417924,CSE 272,A00,102397,Li; Tzumao,0,0,0,0
1667992418351,CSE 274,A00,111323,Chern; Albert Ren-Haur,0,0,0,0
1667992418781,CSE 282,A00,102398,Pevzner; Pavel Arkadjevich,0,0,0,0
1667992419206,CSE 284,A00,114175,Gymrek; Melissa Ann,0,0,0,0
1667992419636,CSE 290,A00,102399,Chandraker; Manmohan Krishna,0,0,0,0
1667992419636,CSE 290,B00,102400,Vaccaro; Kristen Marie,0,0,25,25
1667992419636,CSE 290,C00,102414,Pannuto; Patrick William,0,0,25,25
1667992419636,CSE 290,D00,102427,Pevzner; Pavel Arkadjevich,0,0,0,0
1667992419636,CSE 290,E00,102429,Zhao; Jishen,0,0,0,0
1667992419636,CSE 290,F00,102436,Tullsen; Dean Michael,0,0,0,0
1667992419636,CSE 290,G00,102440,Christensen; Henrik I,0,0,20,20
1667992420071,CSE 291,A00,102443,Su; Hao,0,0,0,0
1667992420071,CSE 291,B00,102448,Polikarpova; Nadezhda,0,0,0,0
1667992420071,CSE 291,C00,102453,Vaccaro; Kristen Marie,0,0,0,0
1667992420071,CSE 291,D00,111343,Savage; Stefan,0,0,0,0
1667992420071,CSE 291,E00,116474,Claffy; Kimberly Claire,0,0,0,0
1667992420071,CSE 291,F00,116479,Pasquale; Joseph,0,0,0,0
1667992420510,CSE 293,001,119111,Bafna; Vineet,9999,0,9999,0
1667992420510,CSE 293,002,119118,Bellare; Mihir,9999,0,9999,0
1667992420510,CSE 293,003,119122,Berg-Kirkpatrick; Taylor D,9999,0,9999,0
1667992420510,CSE 293,004,119135,Christensen; Henrik I,9999,0,9999,0
1667992420510,CSE 293,005,119142,Cottrell; Garrison W,9999,0,9999,0
1667992420510,CSE 293,006,119146,Deutsch; Alin Bernard,9999,0,9999,0
1667992420510,CSE 293,007,119159,Esmaeilzadeh; Hadi,9999,0,9999,0
1667992420510,CSE 293,008,119166,Freund; Yoav,9999,0,9999,0
1667992420510,CSE 293,009,119170,Griswold; William G.,9999,0,9999,0
1667992420510,CSE 293,010,119183,Gymrek; Melissa Ann,9999,0,9999,0
1667992420510,CSE 293,011,119190,Heninger; Nadia A,9999,0,9999,0
1667992420510,CSE 293,012,119230,Impagliazzo; Russell,9999,0,9999,0
1667992420510,CSE 293,013,119232,Jhala; Ranjit,9999,0,9999,0
1667992420510,CSE 293,014,119233,Kahng; Andrew Byun,9999,0,9999,0
1667992420510,CSE 293,015,119298,Kane; Daniel Mertz,9999,0,9999,0
1667992420510,CSE 293,016,119299,Kriegman; David J,9999,0,9999,0
1667992420510,CSE 293,017,119300,Kumar; Arun Kumar,9999,0,9999,0
1667992420510,CSE 293,018,119301,Lerner; Sorin,9999,0,9999,0
1667992420510,CSE 293,019,119302,Lovett; Shachar,9999,0,9999,0
1667992420510,CSE 293,020,119303,McAuley; Julian John,9999,0,9999,0
1667992420510,CSE 293,021,119304,Micciancio; Daniele,9999,0,9999,0
1667992420510,CSE 293,022,119367,Orailoglu; Alex,9999,0,9999,0
1667992420510,CSE 293,023,119382,Paturi; Ramamohan,9999,0,9999,0
1667992420510,CSE 293,024,119404,Polikarpova; Nadezhda,9999,0,9999,0
1667992420510,CSE 293,025,119406,Politz; Joseph Gibbs,9999,0,9999,0
1667992420510,CSE 293,026,119411,Porter; George M,9999,0,9999,0
1667992420510,CSE 293,027,119414,Porter; Leonard Emerson,9999,0,9999,0
1667992420510,CSE 293,028,119416,Ramamoorthi; Ravi,9999,0,9999,0
1667992420510,CSE 293,029,119417,Sahoo; Debashis,9999,0,9999,0
1667992420510,CSE 293,030,119420,Saul; Lawrence,9999,0,9999,0
1667992420510,CSE 293,031,119421,Savage; Stefan,9999,0,9999,0
1667992420510,CSE 293,032,119425,Schulze; Jurgen P.,9999,0,9999,0
1667992420510,CSE 293,033,119426,Snoeren; Alex C.,9999,0,9999,0
1667992420510,CSE 293,034,119428,Shang; Jingbo,9999,0,9999,0
1667992420510,CSE 293,035,119430,Stefan; Deian,9999,0,9999,0
1667992420510,CSE 293,036,119431,Su; Hao,9999,0,9999,0
1667992420510,CSE 293,037,119433,Swanson; Steven James,9999,0,9999,0
1667992420510,CSE 293,038,119435,Tullsen; Dean Michael,9999,0,9999,0
1667992420510,CSE 293,039,119483,Voelker; Geoffrey M.,9999,0,9999,0
1667992420510,CSE 293,040,119537,Zhao; Jishen,9999,0,9999,0
1667992420510,CSE 293,041,119538,Zhou; Yuan-Yuan,9999,0,9999,0
1667992420510,CSE 293,042,119539,Gao; Sicun,9999,0,9999,0
1667992420510,CSE 293,043,119540,Weibel; Nadir,9999,0,9999,0
1667992420510,CSE 293,044,119541,Gupta; Rajesh K.,9999,0,9999,0
1667992420510,CSE 293,045,126410,Vaccaro; Kristen Marie,9999,0,9999,0
1667992420510,CSE 293,046,126411,Klemke; Richard,9999,0,9999,0
1667992420936,CSE 294,A00,102459,Voelker; Geoffrey M.,0,0,0,0
1667992420936,CSE 294,B00,111322,Orailoglu; Alex,0,0,0,0
1667992421360,DSE 201,A00,096914,Deutsch; Alin Bernard,30,0,30,0
1667992421789,DSE 210,A00,096915,Dasgupta; Sanjoy,30,0,30,0
1667992422214,DSE 260A,A00,096916,Altintas De Callaf; Ilkay,30,0,30,0
1667992422658,ECE 200,001,103586,Antipa; Nicholas A,9999,0,9999,0
1667992422658,ECE 200,002,103587,Atanasov; Nikolay A.,9999,0,9999,0
1667992422658,ECE 200,003,103588,Bharadia; Dinesh,9999,0,9999,0
1667992422658,ECE 200,004,103589,Cheng; Chung Kuan,9999,0,9999,0
1667992422658,ECE 200,005,103590,Cosman; Pamela C.,9999,0,9999,0
1667992422658,ECE 200,006,103591,Dayeh; Shadi Ahmad,9999,0,9999,0
1667992422658,ECE 200,007,103592,Fainman; Yeshaiahu,9999,0,9999,0
1667992422658,ECE 200,008,103593,Ford; Joseph Earl,9999,0,9999,0
1667992422658,ECE 200,009,103594,Franceschetti; Massimo,9999,0,9999,0
1667992422658,ECE 200,010,103595,Fullerton; Eric E,9999,0,9999,0
1667992422658,ECE 200,011,103596,Galton; Ian A,9999,0,9999,0
1667992422658,ECE 200,012,103597,Gilja; Vikash,9999,0,9999,0
1667992422658,ECE 200,013,103598,Hall; Drew A.,9999,0,9999,0
1667992422658,ECE 200,014,103599,Hsueh; Tzu-Chien,9999,0,9999,0
1667992422658,ECE 200,015,103600,Javidi; Tara,9999,0,9999,0
1667992422658,ECE 200,016,103601,Kahng; Andrew Byun,9999,0,9999,0
1667992422658,ECE 200,017,103602,Kim; Young-Han,9999,0,9999,0
1667992422658,ECE 200,018,103603,Koushanfar; Farinaz,9999,0,9999,0
1667992422658,ECE 200,019,103604,Kuzum; Duygu,9999,0,9999,0
1667992422658,ECE 200,020,103605,Le; Hanh-Phuc,9999,0,9999,0
1667992422658,ECE 200,021,103606,Lin; Bill,9999,0,9999,0
1667992422658,ECE 200,022,103607,Liu; Zhaowei,9998,0,9999,1
1667992422658,ECE 200,023,103608,Lo; Yu-Hwa,9999,0,9999,0
1667992422658,ECE 200,024,103609,Lomakin; Vitaliy,9999,0,9999,0
1667992422658,ECE 200,025,103610,Mercier; Patrick Philip,9999,0,9999,0
1667992422658,ECE 200,026,103611,Meyer; Florian,9999,0,9999,0
1667992422658,ECE 200,027,103612,Milstein; Laurence B.,9999,0,9999,0
1667992422658,ECE 200,028,103613,Mir Arabbaygi; Siavash,9999,0,9999,0
1667992422658,ECE 200,029,103614,Mookherjea; Shayan,9999,0,9999,0
1667992422658,ECE 200,030,103615,Morris; Karcher William,9999,0,9999,0
1667992422658,ECE 200,031,103616,Ng; Tse Nga,9999,0,9999,0
1667992422658,ECE 200,032,103617,Nguyen; Truong Quang,9999,0,9999,0
1667992422658,ECE 200,033,103618,Nomura; Kenji,9999,0,9999,0
1667992422658,ECE 200,034,103619,Orlitsky; Alon,9999,0,9999,0
1667992422658,ECE 200,035,103620,Pal; Piya,9999,0,9999,0
1667992422658,ECE 200,036,103621,Papen; George C.,9999,0,9999,0
1667992422658,ECE 200,037,103622,Radic; Stojan,9999,0,9999,0
1667992422658,ECE 200,038,103623,Rao; Bhaskar D.,9999,0,9999,0
1667992422658,ECE 200,039,103624,Rao; Ramesh R,9999,0,9999,0
1667992422658,ECE 200,040,103625,Rebeiz; Gabriel,9999,0,9999,0
1667992422658,ECE 200,041,103626,Sanford; John R,9999,0,9999,0
1667992422658,ECE 200,042,103627,Siegel; Paul H.,9999,0,9999,0
1667992422658,ECE 200,043,103628,Sievenpiper; Daniel F.,9999,0,9999,0
1667992422658,ECE 200,044,103629,Sworder; David D.,9999,0,9999,0
1667992422658,ECE 200,045,103630,Taur; Yuan,9999,0,9999,0
1667992422658,ECE 200,046,103631,Touri; Behrouz,9999,0,9999,0
1667992422658,ECE 200,047,103632,Trivedi; Mohan M.,9999,0,9999,0
1667992422658,ECE 200,048,103633,Vasconcelos; Nuno,9999,0,9999,0
1667992422658,ECE 200,049,103634,Wang; Xiaolong,9999,0,9999,0
1667992422658,ECE 200,050,103635,Xie; Pengtao,9999,0,9999,0
1667992422658,ECE 200,051,103636,Yip; Michael,9999,0,9999,0
1667992422658,ECE 200,052,103637,Zeger; Kenneth A.,999,0,999,0
1667992422658,ECE 200,053,103638,Zhang; Xinyu,9999,0,9999,0
1667992422658,ECE 200,054,103639,Turakhia; Yatish Girish,9999,0,9999,0
1667992422658,ECE 200,055,103640,Kang; Mingu,9999,0,9999,0
1667992422658,ECE 200,056,103641,Shi; Yuanyuan,9999,0,9999,0
1667992422658,ECE 200,057,103642,Wang; Edward Jay,9999,0,9999,0
1667992422658,ECE 200,058,103643,Zheng; Yang,9999,0,9999,0
1667992423081,ECE 202,A00,103644,Kuzum; Duygu,0,0,0,0
1667992423504,ECE 212BN,A00,103646,Ng; Tse Nga,0,0,0,0
1667992423932,ECE 221,A00,111493,Staff,0,0,0,0
1667992424355,ECE 222B,A00,103647,Lomakin; Vitaliy,0,0,0,0
1667992424783,ECE 230B,A00,103648,Taur; Yuan,0,0,0,0
1667992425207,ECE 238B,A00,103649,Garay; Javier,0,0,0,0
1667992425628,ECE 240B,A00,112900,Fainman; Yeshaiahu,0,0,0,0
1667992426058,ECE 247A,A00,103650,Jokerst; Jesse Vincent,0,0,0,0
1667992426485,ECE 247B,A00,103651,Wang; Joseph,0,0,0,0
1667992426910,ECE 250,A00,103652,Siegel; Paul H.,0,0,0,0
1667992427336,ECE 251A,A00,103654,Rao; Bhaskar D.,0,0,0,0
1667992427761,ECE 257B,A00,103655,Bharadia; Dinesh,0,0,0,0
1667992428186,ECE 258A,A00,103656,Milstein; Laurence B.,0,0,0,0
1667992428613,ECE 260B,A00,103658,Kang; Mingu,0,0,0,0
1667992429038,ECE 264A,A00,103659,Galton; Ian A,0,0,0,0
1667992429461,ECE 265A,A00,103661,Gudem; Prasad S.S.,0,0,0,0
1667992429891,ECE 265D,A00,103662,Gudem; Prasad S.S.,0,0,0,0
1667992430317,ECE 268,A00,103663,Koushanfar; Farinaz,0,0,0,0
1667992430744,ECE 269,A01,103665,Pal; Piya,0,0,0,0
1667992431171,ECE 271B,A00,103666,Vasconcelos; Manuela,0,0,0,0
1667992431600,ECE 276A,A00,103667,Atanasov; Nikolay A.,0,0,0,0
1667992432024,ECE 277,A00,103668,An; Cheolhong,0,0,0,0
1667992432451,ECE 279,A00,117947,Hall; Drew A.,0,0,0,0
1667992433298,ECE 283,A00,103670,Hsueh; Tzu-Chien,0,0,0,0
1667992433727,ECE 284,A00,103671,Turakhia; Yatish Girish,0,0,0,0
1667992434152,ECE 285,A00,103672,Zheng; Yang,0,0,0,0
1667992434152,ECE 285,B00,103673,Sworder; David D.,0,0,0,0
1667992434579,ECE 287,A00,103676,Javidi; Tara,0,0,0,0
1667992435007,MATH 200B,A00,098023,Salehi Golsefidy; Alireza,14,0,15,1
1667992435431,MATH 202B,A00,098024,Rhoades; Brendon Patrick,12,0,15,3
1667992435861,MATH 203B,A00,098025,Oprea; Dragos N.,12,0,15,3
1667992436293,MATH 204B,A00,098026,Sorensen; Claus M,14,0,15,1
1667992436717,MATH 208,A00,098027,Izadi; Elham,7,0,10,3
1667992437142,MATH 209,A00,098028,Pollack; Aaron,10,0,10,0
1667992437564,MATH 211A,A00,112919,Rogalski; Daniel,9,0,10,1
1667992437988,MATH 211B,A00,112920,Seward; Brandon M.,9,0,10,1
1667992438415,MATH 218,A00,098029,Li; Bo,10,0,10,0
1667992438840,MATH 220B,A00,098030,Novak; Jonathan I,13,0,15,2
1667992439263,MATH 221A,A00,098031,Ebenfelt; Peter F,13,0,15,2
1667992439689,MATH 231B,A00,098032,Zlatos; Andrej,12,0,15,3
1667992440118,MATH 240B,A00,098033,Ni; Lei,10,0,15,5
1667992440553,MATH 243,A00,098034,Jekel; David Andrew,10,0,10,0
1667992440978,MATH 245A,A00,098035,Nie; Jiawang,0,0,15,16
1667992441406,MATH 248,A00,098036,Bejenaru; Ioan,10,0,10,0
1667992441833,MATH 250B,A00,098037,Spolaor; Luca,14,0,15,1
1667992442260,MATH 258,A00,098038,Ni; Lei,10,0,10,0
1667992442687,MATH 264B,A00,098041,Rhoades; Brendon Patrick,11,0,15,4
1667992443110,MATH 268,A00,098042,Buss; Samuel R,10,0,10,0
1667992443538,MATH 269,A00,098043,Rhoades; Brendon Patrick,10,0,10,0
1667992443961,MATH 270B,A00,098044,Li; Bo,11,0,15,4
1667992444385,MATH 272B,A00,098045,Holst; Michael J,13,0,15,2
1667992444822,MATH 273A,A00,098046,Tian; Xiaochuan,12,0,15,3
1667992445246,MATH 275,A01,098048,Tian; Xiaochuan,6,0,10,4
1667992445674,MATH 278A,A00,098049,Holst; Michael J,8,0,10,2
1667992446099,MATH 278B,A00,098050,Cloninger; Alexander,10,0,10,0
1667992446526,MATH 278C,A00,098051,Nie; Jiawang,8,0,10,2
1667992446955,MATH 280B,A00,098052,Zheng; Tianyi,11,0,15,4
1667992447382,MATH 281B,A00,098053,Bradic; Jelena,4,0,15,11
1667992447810,MATH 282B,A00,098054,Arias-Castro; Ery,2,0,15,13
1667992448233,MATH 285,A00,098055,Fitzsimmons; Patrick J,0,0,15,17
1667992448655,MATH 287B,A00,098056,Arias-Castro; Ery,5,0,15,10
1667992449080,MATH 288,A00,098057,Agarwal; Pooja,9,0,10,1
1667992449080,MATH 288,B00,098058,Zhang; Danna,9,0,10,1
1667992449080,MATH 288,C00,098059,Williams; Ruth J,10,0,10,0
1667992449504,MATH 290B,A00,098060,Roberts; Justin Deritter,14,0,15,1
1667992449930,MATH 292,A00,098061,Belmont; Eva Kinoshita,10,0,10,0
1667992450353,MATH 295,A00,098062,Suk; Andrew Hoon,48,0,50,2
1667992450778,MATH 296,A00,098063,Novak; Jonathan I,20,0,20,0
1667992451203,MATH 297,001,098064,Gamst; Anthony Collins,9997,0,9999,2
1667992950717,COGS 205,A00,101395,Chiba; Andrea,19,0,20,1
1667992951140,COGS 210B,001,101404,Greene; Deanna Jacquelyn,9998,0,9999,1
1667992951140,COGS 210B,002,101417,Xia; Haijun,9999,0,9999,0
1667992951140,COGS 210B,003,101422,Nitz; Douglas A.,9999,0,9999,0
1667992951140,COGS 210B,004,101423,Hollan; James D.,9998,0,9999,1
1667992951140,COGS 210B,005,101424,Deak; Gedeon O.,9999,0,9999,0
1667992951140,COGS 210B,006,101425,Rossano; Federico,9999,0,9999,0
1667992951564,COGS 211B,A00,101427,Coulson; Seana M,9997,0,9999,2
1667992951993,COGS 220,A00,101428,Hollan; James D.,0,0,25,25
1667992952421,COGS 229,A00,101429,Dow; Steven P,18,0,25,7
1667992952846,COGS 230,A00,101430,Klemmer; Scott R,13,0,17,4
1667992953273,COGS 234,A00,101431,Xia; Haijun,7,0,25,18
1667992953698,COGS 260,A00,101432,Kiyonaga; Anastasia,20,0,25,5
1667992953698,COGS 260,B00,101433,Kirsh; David Joel,16,0,25,9
1667992954122,CSE 202,A00,102371,Impagliazzo; Russell,0,0,0,0
1667992954546,CSE 203B,A01,102373,Cheng; Chung Kuan,0,0,0,0
1667992954973,CSE 208,A00,102374,Micciancio; Daniele,0,0,0,0
1667992955399,CSE 209A,A00,112895,Impagliazzo; Russell,0,0,15,15
1667992955823,CSE 209B,A00,108005,Bellare; Mihir,0,0,0,0
1667992956246,CSE 210,A00,113163,Coblenz; Michael J,0,0,0,0
1667992956671,CSE 219,A00,106111,Dow; Steven P,0,0,20,20
1667992957098,CSE 221,A00,102376,Voelker; Geoffrey M.,0,0,0,0
1667992957521,CSE 224,A01,102378,Porter; George M,0,0,0,0
1667992957944,CSE 229A,A00,102379,Savage; Stefan,0,0,0,0
1667992958367,CSE 229C,A00,102380,Munyaka; Imani N. S.,0,0,0,0
1667992958794,CSE 232B,A00,102382,Deutsch; Alin Bernard,0,0,0,0
1667992959219,CSE 234,A01,112904,Kumar; Arun Kumar,0,0,0,0
1667992959643,CSE 237A,A00,102383,Rosing; Tajana Simunic,0,0,0,0
1667992960068,CSE 239A,A00,102384,Deutsch; Alin Bernard,0,0,0,0
1667992960493,CSE 239B,A00,102385,Polikarpova; Nadezhda,0,0,0,0
1667992960920,CSE 240A,A00,102386,Pannuto; Patrick William,0,0,0,0
1667992961343,CSE 240B,A00,102387,Zhao; Jishen,0,0,0,0
1667992961767,CSE 241A,A00,106406,Kang; Mingu,0,0,0,0
1667992962191,CSE 249B,A00,102388,Kahng; Andrew Byun,0,0,8,8
1667992962620,CSE 251B,A01,102392,Cottrell; Garrison W,0,0,0,0
1667992962620,CSE 251B,A02,102393,Cottrell; Garrison W,0,0,0,0
1667992963046,CSE 252B,A00,102394,Ochoa; Benjamin Lawrence,0,0,0,0
1667992963469,CSE 257,A01,102396,Gao; Sicun,0,0,0,0
1667992963892,CSE 272,A00,102397,Li; Tzumao,0,0,0,0
1667992964315,CSE 274,A00,111323,Chern; Albert Ren-Haur,0,0,0,0
1667992964739,CSE 282,A00,102398,Pevzner; Pavel Arkadjevich,0,0,0,0
1667992965164,CSE 284,A00,114175,Gymrek; Melissa Ann,0,0,0,0
1667992965592,CSE 290,A00,102399,Chandraker; Manmohan Krishna,0,0,0,0
1667992965592,CSE 290,B00,102400,Vaccaro; Kristen Marie,0,0,25,25
1667992965592,CSE 290,C00,102414,Pannuto; Patrick William,0,0,25,25
1667992965592,CSE 290,D00,102427,Pevzner; Pavel Arkadjevich,0,0,0,0
1667992965592,CSE 290,E00,102429,Zhao; Jishen,0,0,0,0
1667992965592,CSE 290,F00,102436,Tullsen; Dean Michael,0,0,0,0
1667992965592,CSE 290,G00,102440,Christensen; Henrik I,0,0,20,20
1667992966016,CSE 291,A00,102443,Su; Hao,0,0,0,0
1667992966016,CSE 291,B00,102448,Polikarpova; Nadezhda,0,0,0,0
1667992966016,CSE 291,C00,102453,Vaccaro; Kristen Marie,0,0,0,0
1667992966016,CSE 291,D00,111343,Savage; Stefan,0,0,0,0
1667992966016,CSE 291,E00,116474,Claffy; Kimberly Claire,0,0,0,0
1667992966016,CSE 291,F00,116479,Pasquale; Joseph,0,0,0,0
1667992966444,CSE 293,001,119111,Bafna; Vineet,9999,0,9999,0
1667992966444,CSE 293,002,119118,Bellare; Mihir,9999,0,9999,0
1667992966444,CSE 293,003,119122,Berg-Kirkpatrick; Taylor D,9999,0,9999,0
1667992966444,CSE 293,004,119135,Christensen; Henrik I,9999,0,9999,0
1667992966444,CSE 293,005,119142,Cottrell; Garrison W,9999,0,9999,0
1667992966444,CSE 293,006,119146,Deutsch; Alin Bernard,9999,0,9999,0
1667992966444,CSE 293,007,119159,Esmaeilzadeh; Hadi,9999,0,9999,0
1667992966444,CSE 293,008,119166,Freund; Yoav,9999,0,9999,0
1667992966444,CSE 293,009,119170,Griswold; William G.,9999,0,9999,0
1667992966444,CSE 293,010,119183,Gymrek; Melissa Ann,9999,0,9999,0
1667992966444,CSE 293,011,119190,Heninger; Nadia A,9999,0,9999,0
1667992966444,CSE 293,012,119230,Impagliazzo; Russell,9999,0,9999,0
1667992966444,CSE 293,013,119232,Jhala; Ranjit,9999,0,9999,0
1667992966444,CSE 293,014,119233,Kahng; Andrew Byun,9999,0,9999,0
1667992966444,CSE 293,015,119298,Kane; Daniel Mertz,9999,0,9999,0
1667992966444,CSE 293,016,119299,Kriegman; David J,9999,0,9999,0
1667992966444,CSE 293,017,119300,Kumar; Arun Kumar,9999,0,9999,0
1667992966444,CSE 293,018,119301,Lerner; Sorin,9999,0,9999,0
1667992966444,CSE 293,019,119302,Lovett; Shachar,9999,0,9999,0
1667992966444,CSE 293,020,119303,McAuley; Julian John,9999,0,9999,0
1667992966444,CSE 293,021,119304,Micciancio; Daniele,9999,0,9999,0
1667992966444,CSE 293,022,119367,Orailoglu; Alex,9999,0,9999,0
1667992966444,CSE 293,023,119382,Paturi; Ramamohan,9999,0,9999,0
1667992966444,CSE 293,024,119404,Polikarpova; Nadezhda,9999,0,9999,0
1667992966444,CSE 293,025,119406,Politz; Joseph Gibbs,9999,0,9999,0
1667992966444,CSE 293,026,119411,Porter; George M,9999,0,9999,0
1667992966444,CSE 293,027,119414,Porter; Leonard Emerson,9999,0,9999,0
1667992966444,CSE 293,028,119416,Ramamoorthi; Ravi,9999,0,9999,0
1667992966444,CSE 293,029,119417,Sahoo; Debashis,9999,0,9999,0
1667992966444,CSE 293,030,119420,Saul; Lawrence,9999,0,9999,0
1667992966444,CSE 293,031,119421,Savage; Stefan,9999,0,9999,0
1667992966444,CSE 293,032,119425,Schulze; Jurgen P.,9999,0,9999,0
1667992966444,CSE 293,033,119426,Snoeren; Alex C.,9999,0,9999,0
1667992966444,CSE 293,034,119428,Shang; Jingbo,9999,0,9999,0
1667992966444,CSE 293,035,119430,Stefan; Deian,9999,0,9999,0
1667992966444,CSE 293,036,119431,Su; Hao,9999,0,9999,0
1667992966444,CSE 293,037,119433,Swanson; Steven James,9999,0,9999,0
1667992966444,CSE 293,038,119435,Tullsen; Dean Michael,9999,0,9999,0
1667992966444,CSE 293,039,119483,Voelker; Geoffrey M.,9999,0,9999,0
1667992966444,CSE 293,040,119537,Zhao; Jishen,9999,0,9999,0
1667992966444,CSE 293,041,119538,Zhou; Yuan-Yuan,9999,0,9999,0
1667992966444,CSE 293,042,119539,Gao; Sicun,9999,0,9999,0
1667992966444,CSE 293,043,119540,Weibel; Nadir,9999,0,9999,0
1667992966444,CSE 293,044,119541,Gupta; Rajesh K.,9999,0,9999,0
1667992966444,CSE 293,045,126410,Vaccaro; Kristen Marie,9999,0,9999,0
1667992966444,CSE 293,046,126411,Klemke; Richard,9999,0,9999,0
1667992966869,CSE 294,A00,102459,Voelker; Geoffrey M.,0,0,0,0
1667992966869,CSE 294,B00,111322,Orailoglu; Alex,0,0,0,0
1667992967291,DSE 201,A00,096914,Deutsch; Alin Bernard,30,0,30,0
1667992967718,DSE 210,A00,096915,Dasgupta; Sanjoy,30,0,30,0
1667992968142,DSE 260A,A00,096916,Altintas De Callaf; Ilkay,30,0,30,0
1667992968583,ECE 200,001,103586,Antipa; Nicholas A,9999,0,9999,0
1667992968583,ECE 200,002,103587,Atanasov; Nikolay A.,9999,0,9999,0
1667992968583,ECE 200,003,103588,Bharadia; Dinesh,9999,0,9999,0
1667992968583,ECE 200,004,103589,Cheng; Chung Kuan,9999,0,9999,0
1667992968583,ECE 200,005,103590,Cosman; Pamela C.,9999,0,9999,0
1667992968583,ECE 200,006,103591,Dayeh; Shadi Ahmad,9999,0,9999,0
1667992968583,ECE 200,007,103592,Fainman; Yeshaiahu,9999,0,9999,0
1667992968583,ECE 200,008,103593,Ford; Joseph Earl,9999,0,9999,0
1667992968583,ECE 200,009,103594,Franceschetti; Massimo,9999,0,9999,0
1667992968583,ECE 200,010,103595,Fullerton; Eric E,9999,0,9999,0
1667992968583,ECE 200,011,103596,Galton; Ian A,9999,0,9999,0
1667992968583,ECE 200,012,103597,Gilja; Vikash,9999,0,9999,0
1667992968583,ECE 200,013,103598,Hall; Drew A.,9999,0,9999,0
1667992968583,ECE 200,014,103599,Hsueh; Tzu-Chien,9999,0,9999,0
1667992968583,ECE 200,015,103600,Javidi; Tara,9999,0,9999,0
1667992968583,ECE 200,016,103601,Kahng; Andrew Byun,9999,0,9999,0
1667992968583,ECE 200,017,103602,Kim; Young-Han,9999,0,9999,0
1667992968583,ECE 200,018,103603,Koushanfar; Farinaz,9999,0,9999,0
1667992968583,ECE 200,019,103604,Kuzum; Duygu,9999,0,9999,0
1667992968583,ECE 200,020,103605,Le; Hanh-Phuc,9999,0,9999,0
1667992968583,ECE 200,021,103606,Lin; Bill,9999,0,9999,0
1667992968583,ECE 200,022,103607,Liu; Zhaowei,9998,0,9999,1
1667992968583,ECE 200,023,103608,Lo; Yu-Hwa,9999,0,9999,0
1667992968583,ECE 200,024,103609,Lomakin; Vitaliy,9999,0,9999,0
1667992968583,ECE 200,025,103610,Mercier; Patrick Philip,9999,0,9999,0
1667992968583,ECE 200,026,103611,Meyer; Florian,9999,0,9999,0
1667992968583,ECE 200,027,103612,Milstein; Laurence B.,9999,0,9999,0
1667992968583,ECE 200,028,103613,Mir Arabbaygi; Siavash,9999,0,9999,0
1667992968583,ECE 200,029,103614,Mookherjea; Shayan,9999,0,9999,0
1667992968583,ECE 200,030,103615,Morris; Karcher William,9999,0,9999,0
1667992968583,ECE 200,031,103616,Ng; Tse Nga,9999,0,9999,0
1667992968583,ECE 200,032,103617,Nguyen; Truong Quang,9999,0,9999,0
1667992968583,ECE 200,033,103618,Nomura; Kenji,9999,0,9999,0
1667992968583,ECE 200,034,103619,Orlitsky; Alon,9999,0,9999,0
1667992968583,ECE 200,035,103620,Pal; Piya,9999,0,9999,0
1667992968583,ECE 200,036,103621,Papen; George C.,9999,0,9999,0
1667992968583,ECE 200,037,103622,Radic; Stojan,9999,0,9999,0
1667992968583,ECE 200,038,103623,Rao; Bhaskar D.,9999,0,9999,0
1667992968583,ECE 200,039,103624,Rao; Ramesh R,9999,0,9999,0
1667992968583,ECE 200,040,103625,Rebeiz; Gabriel,9999,0,9999,0
1667992968583,ECE 200,041,103626,Sanford; John R,9999,0,9999,0
1667992968583,ECE 200,042,103627,Siegel; Paul H.,9999,0,9999,0
1667992968583,ECE 200,043,103628,Sievenpiper; Daniel F.,9999,0,9999,0
1667992968583,ECE 200,044,103629,Sworder; David D.,9999,0,9999,0
1667992968583,ECE 200,045,103630,Taur; Yuan,9999,0,9999,0
1667992968583,ECE 200,046,103631,Touri; Behrouz,9999,0,9999,0
1667992968583,ECE 200,047,103632,Trivedi; Mohan M.,9999,0,9999,0
1667992968583,ECE 200,048,103633,Vasconcelos; Nuno,9999,0,9999,0
1667992968583,ECE 200,049,103634,Wang; Xiaolong,9999,0,9999,0
1667992968583,ECE 200,050,103635,Xie; Pengtao,9999,0,9999,0
1667992968583,ECE 200,051,103636,Yip; Michael,9999,0,9999,0
1667992968583,ECE 200,052,103637,Zeger; Kenneth A.,999,0,999,0
1667992968583,ECE 200,053,103638,Zhang; Xinyu,9999,0,9999,0
1667992968583,ECE 200,054,103639,Turakhia; Yatish Girish,9999,0,9999,0
1667992968583,ECE 200,055,103640,Kang; Mingu,9999,0,9999,0
1667992968583,ECE 200,056,103641,Shi; Yuanyuan,9999,0,9999,0
1667992968583,ECE 200,057,103642,Wang; Edward Jay,9999,0,9999,0
1667992968583,ECE 200,058,103643,Zheng; Yang,9999,0,9999,0
1667992969010,ECE 202,A00,103644,Kuzum; Duygu,0,0,0,0
1667992969434,ECE 212BN,A00,103646,Ng; Tse Nga,0,0,0,0
1667992969857,ECE 221,A00,111493,Staff,0,0,0,0
1667992970282,ECE 222B,A00,103647,Lomakin; Vitaliy,0,0,0,0
1667992970705,ECE 230B,A00,103648,Taur; Yuan,0,0,0,0
1667992971138,ECE 238B,A00,103649,Garay; Javier,0,0,0,0
1667992971561,ECE 240B,A00,112900,Fainman; Yeshaiahu,0,0,0,0
1667992971986,ECE 247A,A00,103650,Jokerst; Jesse Vincent,0,0,0,0
1667992972414,ECE 247B,A00,103651,Wang; Joseph,0,0,0,0
1667992972838,ECE 250,A00,103652,Siegel; Paul H.,0,0,0,0
1667992973262,ECE 251A,A00,103654,Rao; Bhaskar D.,0,0,0,0
1667992973692,ECE 257B,A00,103655,Bharadia; Dinesh,0,0,0,0
1667992974119,ECE 258A,A00,103656,Milstein; Laurence B.,0,0,0,0
1667992974547,ECE 260B,A00,103658,Kang; Mingu,0,0,0,0
1667992974973,ECE 264A,A00,103659,Galton; Ian A,0,0,0,0
1667992975400,ECE 265A,A00,103661,Gudem; Prasad S.S.,0,0,0,0
1667992975827,ECE 265D,A00,103662,Gudem; Prasad S.S.,0,0,0,0
1667992976251,ECE 268,A00,103663,Koushanfar; Farinaz,0,0,0,0
1667992976679,ECE 269,A01,103665,Pal; Piya,0,0,0,0
1667992977179,ECE 271B,A00,103666,Vasconcelos; Manuela,0,0,0,0
1667992977606,ECE 276A,A00,103667,Atanasov; Nikolay A.,0,0,0,0
1667992978032,ECE 277,A00,103668,An; Cheolhong,0,0,0,0
1667992978457,ECE 279,A00,117947,Hall; Drew A.,0,0,0,0
1667992979310,ECE 283,A00,103670,Hsueh; Tzu-Chien,0,0,0,0
1667992979734,ECE 284,A00,103671,Turakhia; Yatish Girish,0,0,0,0
1667992980158,ECE 285,A00,103672,Zheng; Yang,0,0,0,0
1667992980158,ECE 285,B00,103673,Sworder; David D.,0,0,0,0
1667992980580,ECE 287,A00,103676,Javidi; Tara,0,0,0,0
1667992981010,MATH 200B,A00,098023,Salehi Golsefidy; Alireza,14,0,15,1
1667992981435,MATH 202B,A00,098024,Rhoades; Brendon Patrick,12,0,15,3
1667992981861,MATH 203B,A00,098025,Oprea; Dragos N.,12,0,15,3
1667992982288,MATH 204B,A00,098026,Sorensen; Claus M,14,0,15,1
1667992982717,MATH 208,A00,098027,Izadi; Elham,7,0,10,3
1667992983141,MATH 209,A00,098028,Pollack; Aaron,10,0,10,0
1667992983569,MATH 211A,A00,112919,Rogalski; Daniel,9,0,10,1
1667992983998,MATH 211B,A00,112920,Seward; Brandon M.,9,0,10,1
1667992984425,MATH 218,A00,098029,Li; Bo,10,0,10,0
1667992984851,MATH 220B,A00,098030,Novak; Jonathan I,13,0,15,2
1667992985274,MATH 221A,A00,098031,Ebenfelt; Peter F,13,0,15,2
1667992985701,MATH 231B,A00,098032,Zlatos; Andrej,12,0,15,3
1667992986129,MATH 240B,A00,098033,Ni; Lei,10,0,15,5
1667992986559,MATH 243,A00,098034,Jekel; David Andrew,10,0,10,0
1667992986984,MATH 245A,A00,098035,Nie; Jiawang,0,0,15,16
1667992987406,MATH 248,A00,098036,Bejenaru; Ioan,10,0,10,0
1667992987833,MATH 250B,A00,098037,Spolaor; Luca,14,0,15,1
1667992988257,MATH 258,A00,098038,Ni; Lei,10,0,10,0
1667992988684,MATH 264B,A00,098041,Rhoades; Brendon Patrick,11,0,15,4
1667992989109,MATH 268,A00,098042,Buss; Samuel R,10,0,10,0
1667992989537,MATH 269,A00,098043,Rhoades; Brendon Patrick,10,0,10,0
1667992989960,MATH 270B,A00,098044,Li; Bo,11,0,15,4
1667992990387,MATH 272B,A00,098045,Holst; Michael J,13,0,15,2
1667992990810,MATH 273A,A00,098046,Tian; Xiaochuan,12,0,15,3
1667992991238,MATH 275,A01,098048,Tian; Xiaochuan,6,0,10,4
1667992991665,MATH 278A,A00,098049,Holst; Michael J,8,0,10,2
1667992992093,MATH 278B,A00,098050,Cloninger; Alexander,10,0,10,0
1667992992515,MATH 278C,A00,098051,Nie; Jiawang,8,0,10,2
1667992992938,MATH 280B,A00,098052,Zheng; Tianyi,11,0,15,4
1667992993362,MATH 281B,A00,098053,Bradic; Jelena,4,0,15,11
1667992993786,MATH 282B,A00,098054,Arias-Castro; Ery,2,0,15,13
1667992994214,MATH 285,A00,098055,Fitzsimmons; Patrick J,0,0,15,17
1667992994641,MATH 287B,A00,098056,Arias-Castro; Ery,5,0,15,10
1667992995064,MATH 288,A00,098057,Agarwal; Pooja,9,0,10,1
1667992995064,MATH 288,B00,098058,Zhang; Danna,9,0,10,1
1667992995064,MATH 288,C00,098059,Williams; Ruth J,10,0,10,0
1667992995487,MATH 290B,A00,098060,Roberts; Justin Deritter,14,0,15,1
1667992995913,MATH 292,A00,098061,Belmont; Eva Kinoshita,10,0,10,0
1667992996335,MATH 295,A00,098062,Suk; Andrew Hoon,48,0,50,2
1667992996760,MATH 296,A00,098063,Novak; Jonathan I,20,0,20,0
1667992997188,MATH 297,001,098064,Gamst; Anthony Collins,9997,0,9999,2
1667993497689,COGS 205,A00,101395,Chiba; Andrea,19,0,20,1
1667993498122,COGS 210B,001,101404,Greene; Deanna Jacquelyn,9998,0,9999,1
1667993498122,COGS 210B,002,101417,Xia; Haijun,9999,0,9999,0
1667993498122,COGS 210B,003,101422,Nitz; Douglas A.,9999,0,9999,0
1667993498122,COGS 210B,004,101423,Hollan; James D.,9998,0,9999,1
1667993498122,COGS 210B,005,101424,Deak; Gedeon O.,9999,0,9999,0
1667993498122,COGS 210B,006,101425,Rossano; Federico,9999,0,9999,0
1667993498553,COGS 211B,A00,101427,Coulson; Seana M,9997,0,9999,2
1667993498983,COGS 220,A00,101428,Hollan; James D.,0,0,25,25
1667993499413,COGS 229,A00,101429,Dow; Steven P,18,0,25,7
1667993499842,COGS 230,A00,101430,Klemmer; Scott R,13,0,17,4
1667993500265,COGS 234,A00,101431,Xia; Haijun,7,0,25,18
1667993500690,COGS 260,A00,101432,Kiyonaga; Anastasia,20,0,25,5
1667993500690,COGS 260,B00,101433,Kirsh; David Joel,16,0,25,9
1667993501116,CSE 202,A00,102371,Impagliazzo; Russell,0,0,0,0
1667993501542,CSE 203B,A01,102373,Cheng; Chung Kuan,0,0,0,0
1667993501971,CSE 208,A00,102374,Micciancio; Daniele,0,0,0,0
1667993502408,CSE 209A,A00,112895,Impagliazzo; Russell,0,0,15,15
1667993502836,CSE 209B,A00,108005,Bellare; Mihir,0,0,0,0
1667993503264,CSE 210,A00,113163,Coblenz; Michael J,0,0,0,0
1667993503690,CSE 219,A00,106111,Dow; Steven P,0,0,20,20
1667993504118,CSE 221,A00,102376,Voelker; Geoffrey M.,0,0,0,0
1667993504545,CSE 224,A01,102378,Porter; George M,0,0,0,0
1667993504971,CSE 229A,A00,102379,Savage; Stefan,0,0,0,0
1667993505396,CSE 229C,A00,102380,Munyaka; Imani N. S.,0,0,0,0
1667993505818,CSE 232B,A00,102382,Deutsch; Alin Bernard,0,0,0,0
1667993506246,CSE 234,A01,112904,Kumar; Arun Kumar,0,0,0,0
1667993506672,CSE 237A,A00,102383,Rosing; Tajana Simunic,0,0,0,0
1667993507097,CSE 239A,A00,102384,Deutsch; Alin Bernard,0,0,0,0
1667993507521,CSE 239B,A00,102385,Polikarpova; Nadezhda,0,0,0,0
1667993507950,CSE 240A,A00,102386,Pannuto; Patrick William,0,0,0,0
1667993508376,CSE 240B,A00,102387,Zhao; Jishen,0,0,0,0
1667993508799,CSE 241A,A00,106406,Kang; Mingu,0,0,0,0
1667993509226,CSE 249B,A00,102388,Kahng; Andrew Byun,0,0,8,8
1667993509657,CSE 251B,A01,102392,Cottrell; Garrison W,0,0,0,0
1667993509657,CSE 251B,A02,102393,Cottrell; Garrison W,0,0,0,0
1667993510081,CSE 252B,A00,102394,Ochoa; Benjamin Lawrence,0,0,0,0
1667993510505,CSE 257,A01,102396,Gao; Sicun,0,0,0,0
1667993510930,CSE 272,A00,102397,Li; Tzumao,0,0,0,0
1667993511355,CSE 274,A00,111323,Chern; Albert Ren-Haur,0,0,0,0
1667993511785,CSE 282,A00,102398,Pevzner; Pavel Arkadjevich,0,0,0,0
1667993512217,CSE 284,A00,114175,Gymrek; Melissa Ann,0,0,0,0
1667993512646,CSE 290,A00,102399,Chandraker; Manmohan Krishna,0,0,0,0
1667993512646,CSE 290,B00,102400,Vaccaro; Kristen Marie,0,0,25,25
1667993512646,CSE 290,C00,102414,Pannuto; Patrick William,0,0,25,25
1667993512646,CSE 290,D00,102427,Pevzner; Pavel Arkadjevich,0,0,0,0
1667993512646,CSE 290,E00,102429,Zhao; Jishen,0,0,0,0
1667993512646,CSE 290,F00,102436,Tullsen; Dean Michael,0,0,0,0
1667993512646,CSE 290,G00,102440,Christensen; Henrik I,0,0,20,20
1667993513088,CSE 291,A00,102443,Su; Hao,0,0,0,0
1667993513088,CSE 291,B00,102448,Polikarpova; Nadezhda,0,0,0,0
1667993513088,CSE 291,C00,102453,Vaccaro; Kristen Marie,0,0,0,0
1667993513088,CSE 291,D00,111343,Savage; Stefan,0,0,0,0
1667993513088,CSE 291,E00,116474,Claffy; Kimberly Claire,0,0,0,0
1667993513088,CSE 291,F00,116479,Pasquale; Joseph,0,0,0,0
1667993513558,CSE 293,001,119111,Bafna; Vineet,9999,0,9999,0
1667993513558,CSE 293,002,119118,Bellare; Mihir,9999,0,9999,0
1667993513558,CSE 293,003,119122,Berg-Kirkpatrick; Taylor D,9999,0,9999,0
1667993513558,CSE 293,004,119135,Christensen; Henrik I,9999,0,9999,0
1667993513558,CSE 293,005,119142,Cottrell; Garrison W,9999,0,9999,0
1667993513558,CSE 293,006,119146,Deutsch; Alin Bernard,9999,0,9999,0
1667993513558,CSE 293,007,119159,Esmaeilzadeh; Hadi,9999,0,9999,0
1667993513558,CSE 293,008,119166,Freund; Yoav,9999,0,9999,0
1667993513558,CSE 293,009,119170,Griswold; William G.,9999,0,9999,0
1667993513558,CSE 293,010,119183,Gymrek; Melissa Ann,9999,0,9999,0
1667993513558,CSE 293,011,119190,Heninger; Nadia A,9999,0,9999,0
1667993513558,CSE 293,012,119230,Impagliazzo; Russell,9999,0,9999,0
1667993513558,CSE 293,013,119232,Jhala; Ranjit,9999,0,9999,0
1667993513558,CSE 293,014,119233,Kahng; Andrew Byun,9999,0,9999,0
1667993513558,CSE 293,015,119298,Kane; Daniel Mertz,9999,0,9999,0
1667993513558,CSE 293,016,119299,Kriegman; David J,9999,0,9999,0
1667993513558,CSE 293,017,119300,Kumar; Arun Kumar,9999,0,9999,0
1667993513558,CSE 293,018,119301,Lerner; Sorin,9999,0,9999,0
1667993513558,CSE 293,019,119302,Lovett; Shachar,9999,0,9999,0
1667993513558,CSE 293,020,119303,McAuley; Julian John,9999,0,9999,0
1667993513558,CSE 293,021,119304,Micciancio; Daniele,9999,0,9999,0
1667993513558,CSE 293,022,119367,Orailoglu; Alex,9999,0,9999,0
1667993513558,CSE 293,023,119382,Paturi; Ramamohan,9999,0,9999,0
1667993513558,CSE 293,024,119404,Polikarpova; Nadezhda,9999,0,9999,0
1667993513558,CSE 293,025,119406,Politz; Joseph Gibbs,9999,0,9999,0
1667993513558,CSE 293,026,119411,Porter; George M,9999,0,9999,0
1667993513558,CSE 293,027,119414,Porter; Leonard Emerson,9999,0,9999,0
1667993513558,CSE 293,028,119416,Ramamoorthi; Ravi,9999,0,9999,0
1667993513558,CSE 293,029,119417,Sahoo; Debashis,9999,0,9999,0
1667993513558,CSE 293,030,119420,Saul; Lawrence,9999,0,9999,0
1667993513558,CSE 293,031,119421,Savage; Stefan,9999,0,9999,0
1667993513558,CSE 293,032,119425,Schulze; Jurgen P.,9999,0,9999,0
1667993513558,CSE 293,033,119426,Snoeren; Alex C.,9999,0,9999,0
1667993513558,CSE 293,034,119428,Shang; Jingbo,9999,0,9999,0
1667993513558,CSE 293,035,119430,Stefan; Deian,9999,0,9999,0
1667993513558,CSE 293,036,119431,Su; Hao,9999,0,9999,0
1667993513558,CSE 293,037,119433,Swanson; Steven James,9999,0,9999,0
1667993513558,CSE 293,038,119435,Tullsen; Dean Michael,9999,0,9999,0
1667993513558,CSE 293,039,119483,Voelker; Geoffrey M.,9999,0,9999,0
1667993513558,CSE 293,040,119537,Zhao; Jishen,9999,0,9999,0
1667993513558,CSE 293,041,119538,Zhou; Yuan-Yuan,9999,0,9999,0
1667993513558,CSE 293,042,119539,Gao; Sicun,9999,0,9999,0
1667993513558,CSE 293,043,119540,Weibel; Nadir,9999,0,9999,0
1667993513558,CSE 293,044,119541,Gupta; Rajesh K.,9999,0,9999,0
1667993513558,CSE 293,045,126410,Vaccaro; Kristen Marie,9999,0,9999,0
1667993513558,CSE 293,046,126411,Klemke; Richard,9999,0,9999,0
1667993513987,CSE 294,A00,102459,Voelker; Geoffrey M.,0,0,0,0
1667993513987,CSE 294,B00,111322,Orailoglu; Alex,0,0,0,0
1667993514417,DSE 201,A00,096914,Deutsch; Alin Bernard,30,0,30,0
1667993514845,DSE 210,A00,096915,Dasgupta; Sanjoy,30,0,30,0
1667993515274,DSE 260A,A00,096916,Altintas De Callaf; Ilkay,30,0,30,0
1667993515771,ECE 200,001,103586,Antipa; Nicholas A,9999,0,9999,0
1667993515771,ECE 200,002,103587,Atanasov; Nikolay A.,9999,0,9999,0
1667993515771,ECE 200,003,103588,Bharadia; Dinesh,9999,0,9999,0
1667993515771,ECE 200,004,103589,Cheng; Chung Kuan,9999,0,9999,0
1667993515771,ECE 200,005,103590,Cosman; Pamela C.,9999,0,9999,0
1667993515771,ECE 200,006,103591,Dayeh; Shadi Ahmad,9999,0,9999,0
1667993515771,ECE 200,007,103592,Fainman; Yeshaiahu,9999,0,9999,0
1667993515771,ECE 200,008,103593,Ford; Joseph Earl,9999,0,9999,0
1667993515771,ECE 200,009,103594,Franceschetti; Massimo,9999,0,9999,0
1667993515771,ECE 200,010,103595,Fullerton; Eric E,9999,0,9999,0
1667993515771,ECE 200,011,103596,Galton; Ian A,9999,0,9999,0
1667993515771,ECE 200,012,103597,Gilja; Vikash,9999,0,9999,0
1667993515771,ECE 200,013,103598,Hall; Drew A.,9999,0,9999,0
1667993515771,ECE 200,014,103599,Hsueh; Tzu-Chien,9999,0,9999,0
1667993515771,ECE 200,015,103600,Javidi; Tara,9999,0,9999,0
1667993515771,ECE 200,016,103601,Kahng; Andrew Byun,9999,0,9999,0
1667993515771,ECE 200,017,103602,Kim; Young-Han,9999,0,9999,0
1667993515771,ECE 200,018,103603,Koushanfar; Farinaz,9999,0,9999,0
1667993515771,ECE 200,019,103604,Kuzum; Duygu,9999,0,9999,0
1667993515771,ECE 200,020,103605,Le; Hanh-Phuc,9999,0,9999,0
1667993515771,ECE 200,021,103606,Lin; Bill,9999,0,9999,0
1667993515771,ECE 200,022,103607,Liu; Zhaowei,9998,0,9999,1
1667993515771,ECE 200,023,103608,Lo; Yu-Hwa,9999,0,9999,0
1667993515771,ECE 200,024,103609,Lomakin; Vitaliy,9999,0,9999,0
1667993515771,ECE 200,025,103610,Mercier; Patrick Philip,9999,0,9999,0
1667993515771,ECE 200,026,103611,Meyer; Florian,9999,0,9999,0
1667993515771,ECE 200,027,103612,Milstein; Laurence B.,9999,0,9999,0
1667993515771,ECE 200,028,103613,Mir Arabbaygi; Siavash,9999,0,9999,0
1667993515771,ECE 200,029,103614,Mookherjea; Shayan,9999,0,9999,0
1667993515771,ECE 200,030,103615,Morris; Karcher William,9999,0,9999,0
1667993515771,ECE 200,031,103616,Ng; Tse Nga,9999,0,9999,0
1667993515771,ECE 200,032,103617,Nguyen; Truong Quang,9999,0,9999,0
1667993515771,ECE 200,033,103618,Nomura; Kenji,9999,0,9999,0
1667993515771,ECE 200,034,103619,Orlitsky; Alon,9999,0,9999,0
1667993515771,ECE 200,035,103620,Pal; Piya,9999,0,9999,0
1667993515771,ECE 200,036,103621,Papen; George C.,9999,0,9999,0
1667993515771,ECE 200,037,103622,Radic; Stojan,9999,0,9999,0
1667993515771,ECE 200,038,103623,Rao; Bhaskar D.,9999,0,9999,0
1667993515771,ECE 200,039,103624,Rao; Ramesh R,9999,0,9999,0
1667993515771,ECE 200,040,103625,Rebeiz; Gabriel,9999,0,9999,0
1667993515771,ECE 200,041,103626,Sanford; John R,9999,0,9999,0
1667993515771,ECE 200,042,103627,Siegel; Paul H.,9999,0,9999,0
1667993515771,ECE 200,043,103628,Sievenpiper; Daniel F.,9999,0,9999,0
1667993515771,ECE 200,044,103629,Sworder; David D.,9999,0,9999,0
1667993515771,ECE 200,045,103630,Taur; Yuan,9999,0,9999,0
1667993515771,ECE 200,046,103631,Touri; Behrouz,9999,0,9999,0
1667993515771,ECE 200,047,103632,Trivedi; Mohan M.,9999,0,9999,0
1667993515771,ECE 200,048,103633,Vasconcelos; Nuno,9999,0,9999,0
1667993515771,ECE 200,049,103634,Wang; Xiaolong,9999,0,9999,0
1667993515771,ECE 200,050,103635,Xie; Pengtao,9999,0,9999,0
1667993515771,ECE 200,051,103636,Yip; Michael,9999,0,9999,0
1667993515771,ECE 200,052,103637,Zeger; Kenneth A.,999,0,999,0
1667993515771,ECE 200,053,103638,Zhang; Xinyu,9999,0,9999,0
1667993515771,ECE 200,054,103639,Turakhia; Yatish Girish,9999,0,9999,0
1667993515771,ECE 200,055,103640,Kang; Mingu,9999,0,9999,0
1667993515771,ECE 200,056,103641,Shi; Yuanyuan,9999,0,9999,0
1667993515771,ECE 200,057,103642,Wang; Edward Jay,9999,0,9999,0
1667993515771,ECE 200,058,103643,Zheng; Yang,9999,0,9999,0
1667993516201,ECE 202,A00,103644,Kuzum; Duygu,0,0,0,0
1667993516630,ECE 212BN,A00,103646,Ng; Tse Nga,0,0,0,0
1667993517054,ECE 221,A00,111493,Staff,0,0,0,0
1667993517486,ECE 222B,A00,103647,Lomakin; Vitaliy,0,0,0,0
1667993517911,ECE 230B,A00,103648,Taur; Yuan,0,0,0,0
1667993518342,ECE 238B,A00,103649,Garay; Javier,0,0,0,0
1667993518765,ECE 240B,A00,112900,Fainman; Yeshaiahu,0,0,0,0
1667993519192,ECE 247A,A00,103650,Jokerst; Jesse Vincent,0,0,0,0
1667993519614,ECE 247B,A00,103651,Wang; Joseph,0,0,0,0
1667993520048,ECE 250,A00,103652,Siegel; Paul H.,0,0,0,0
1667993520485,ECE 251A,A00,103654,Rao; Bhaskar D.,0,0,0,0
1667993520914,ECE 257B,A00,103655,Bharadia; Dinesh,0,0,0,0
1667993521340,ECE 258A,A00,103656,Milstein; Laurence B.,0,0,0,0
1667993521765,ECE 260B,A00,103658,Kang; Mingu,0,0,0,0
1667993522191,ECE 264A,A00,103659,Galton; Ian A,0,0,0,0
1667993522618,ECE 265A,A00,103661,Gudem; Prasad S.S.,0,0,0,0
1667993523043,ECE 265D,A00,103662,Gudem; Prasad S.S.,0,0,0,0
1667993523469,ECE 268,A00,103663,Koushanfar; Farinaz,0,0,0,0
1667993523898,ECE 269,A01,103665,Pal; Piya,0,0,0,0
1667993524322,ECE 271B,A00,103666,Vasconcelos; Manuela,0,0,0,0
1667993524747,ECE 276A,A00,103667,Atanasov; Nikolay A.,0,0,0,0
1667993525174,ECE 277,A00,103668,An; Cheolhong,0,0,0,0
1667993525604,ECE 279,A00,117947,Hall; Drew A.,0,0,0,0
1667993526468,ECE 283,A00,103670,Hsueh; Tzu-Chien,0,0,0,0
1667993526898,ECE 284,A00,103671,Turakhia; Yatish Girish,0,0,0,0
1667993527327,ECE 285,A00,103672,Zheng; Yang,0,0,0,0
1667993527327,ECE 285,B00,103673,Sworder; David D.,0,0,0,0
1667993527751,ECE 287,A00,103676,Javidi; Tara,0,0,0,0
1667993528175,MATH 200B,A00,098023,Salehi Golsefidy; Alireza,14,0,15,1
1667993528604,MATH 202B,A00,098024,Rhoades; Brendon Patrick,12,0,15,3
1667993529051,MATH 203B,A00,098025,Oprea; Dragos N.,12,0,15,3
1667993529476,MATH 204B,A00,098026,Sorensen; Claus M,14,0,15,1
1667993529900,MATH 208,A00,098027,Izadi; Elham,7,0,10,3
1667993530325,MATH 209,A00,098028,Pollack; Aaron,10,0,10,0
1667993530752,MATH 211A,A00,112919,Rogalski; Daniel,9,0,10,1
1667993531179,MATH 211B,A00,112920,Seward; Brandon M.,9,0,10,1
1667993531604,MATH 218,A00,098029,Li; Bo,10,0,10,0
1667993532031,MATH 220B,A00,098030,Novak; Jonathan I,13,0,15,2
1667993532456,MATH 221A,A00,098031,Ebenfelt; Peter F,13,0,15,2
1667993532880,MATH 231B,A00,098032,Zlatos; Andrej,12,0,15,3
1667993533312,MATH 240B,A00,098033,Ni; Lei,10,0,15,5
1667993533736,MATH 243,A00,098034,Jekel; David Andrew,10,0,10,0
1667993534166,MATH 245A,A00,098035,Nie; Jiawang,0,0,15,16
1667993534596,MATH 248,A00,098036,Bejenaru; Ioan,10,0,10,0
1667993535025,MATH 250B,A00,098037,Spolaor; Luca,14,0,15,1
1667993535454,MATH 258,A00,098038,Ni; Lei,10,0,10,0
1667993535878,MATH 264B,A00,098041,Rhoades; Brendon Patrick,11,0,15,4
1667993536306,MATH 268,A00,098042,Buss; Samuel R,10,0,10,0
1667993536729,MATH 269,A00,098043,Rhoades; Brendon Patrick,10,0,10,0
1667993537155,MATH 270B,A00,098044,Li; Bo,11,0,15,4
1667993537580,MATH 272B,A00,098045,Holst; Michael J,13,0,15,2
1667993538009,MATH 273A,A00,098046,Tian; Xiaochuan,12,0,15,3
1667993538433,MATH 275,A01,098048,Tian; Xiaochuan,6,0,10,4
1667993538870,MATH 278A,A00,098049,Holst; Michael J,8,0,10,2
1667993539294,MATH 278B,A00,098050,Cloninger; Alexander,10,0,10,0
1667993539722,MATH 278C,A00,098051,Nie; Jiawang,8,0,10,2
1667993540148,MATH 280B,A00,098052,Zheng; Tianyi,11,0,15,4
1667993540572,MATH 281B,A00,098053,Bradic; Jelena,4,0,15,11
1667993541072,MATH 282B,A00,098054,Arias-Castro; Ery,2,0,15,13
1667993541504,MATH 285,A00,098055,Fitzsimmons; Patrick J,0,0,15,17
1667993541932,MATH 287B,A00,098056,Arias-Castro; Ery,5,0,15,10
1667993542363,MATH 288,A00,098057,Agarwal; Pooja,9,0,10,1
1667993542363,MATH 288,B00,098058,Zhang; Danna,9,0,10,1
1667993542363,MATH 288,C00,098059,Williams; Ruth J,10,0,10,0
1667993542794,MATH 290B,A00,098060,Roberts; Justin Deritter,14,0,15,1
1667993543220,MATH 292,A00,098061,Belmont; Eva Kinoshita,10,0,10,0
1667993543649,MATH 295,A00,098062,Suk; Andrew Hoon,48,0,50,2
1667993544075,MATH 296,A00,098063,Novak; Jonathan I,20,0,20,0
1667993544504,MATH 297,001,098064,Gamst; Anthony Collins,9997,0,9999,2
1667994045285,COGS 205,A00,101395,Chiba; Andrea,19,0,20,1
1667994045721,COGS 210B,001,101404,Greene; Deanna Jacquelyn,9998,0,9999,1
1667994045721,COGS 210B,002,101417,Xia; Haijun,9999,0,9999,0
1667994045721,COGS 210B,003,101422,Nitz; Douglas A.,9999,0,9999,0
1667994045721,COGS 210B,004,101423,Hollan; James D.,9998,0,9999,1
1667994045721,COGS 210B,005,101424,Deak; Gedeon O.,9999,0,9999,0
1667994045721,COGS 210B,006,101425,Rossano; Federico,9999,0,9999,0
1667994046146,COGS 211B,A00,101427,Coulson; Seana M,9997,0,9999,2
1667994046574,COGS 220,A00,101428,Hollan; James D.,0,0,25,25
1667994047001,COGS 229,A00,101429,Dow; Steven P,18,0,25,7
1667994047426,COGS 230,A00,101430,Klemmer; Scott R,13,0,17,4
1667994047871,COGS 234,A00,101431,Xia; Haijun,7,0,25,18
1667994048296,COGS 260,A00,101432,Kiyonaga; Anastasia,20,0,25,5
1667994048296,COGS 260,B00,101433,Kirsh; David Joel,16,0,25,9
1667994048722,CSE 202,A00,102371,Impagliazzo; Russell,0,0,0,0
1667994049161,CSE 203B,A01,102373,Cheng; Chung Kuan,0,0,0,0
1667994049590,CSE 208,A00,102374,Micciancio; Daniele,0,0,0,0
1667994050015,CSE 209A,A00,112895,Impagliazzo; Russell,0,0,15,15
1667994050445,CSE 209B,A00,108005,Bellare; Mihir,0,0,0,0
1667994050897,CSE 210,A00,113163,Coblenz; Michael J,0,0,0,0
1667994051321,CSE 219,A00,106111,Dow; Steven P,0,0,20,20
1667994051754,CSE 221,A00,102376,Voelker; Geoffrey M.,0,0,0,0
1667994052186,CSE 224,A01,102378,Porter; George M,0,0,0,0
1667994052614,CSE 229A,A00,102379,Savage; Stefan,0,0,0,0
1667994053039,CSE 229C,A00,102380,Munyaka; Imani N. S.,0,0,0,0
1667994053469,CSE 232B,A00,102382,Deutsch; Alin Bernard,0,0,0,0
1667994053906,CSE 234,A01,112904,Kumar; Arun Kumar,0,0,0,0
1667994054330,CSE 237A,A00,102383,Rosing; Tajana Simunic,0,0,0,0
1667994054755,CSE 239A,A00,102384,Deutsch; Alin Bernard,0,0,0,0
1667994055188,CSE 239B,A00,102385,Polikarpova; Nadezhda,0,0,0,0
1667994055615,CSE 240A,A00,102386,Pannuto; Patrick William,0,0,0,0
1667994056043,CSE 240B,A00,102387,Zhao; Jishen,0,0,0,0
1667994056470,CSE 241A,A00,106406,Kang; Mingu,0,0,0,0
1667994056900,CSE 249B,A00,102388,Kahng; Andrew Byun,0,0,8,8
1667994057326,CSE 251B,A01,102392,Cottrell; Garrison W,0,0,0,0
1667994057326,CSE 251B,A02,102393,Cottrell; Garrison W,0,0,0,0
1667994057775,CSE 252B,A00,102394,Ochoa; Benjamin Lawrence,0,0,0,0
1667994058200,CSE 257,A01,102396,Gao; Sicun,0,0,0,0
1667994058626,CSE 272,A00,102397,Li; Tzumao,0,0,0,0
1667994059064,CSE 274,A00,111323,Chern; Albert Ren-Haur,0,0,0,0
1667994059492,CSE 282,A00,102398,Pevzner; Pavel Arkadjevich,0,0,0,0
1667994059926,CSE 284,A00,114175,Gymrek; Melissa Ann,0,0,0,0
1667994060356,CSE 290,A00,102399,Chandraker; Manmohan Krishna,0,0,0,0
1667994060356,CSE 290,B00,102400,Vaccaro; Kristen Marie,0,0,25,25
1667994060356,CSE 290,C00,102414,Pannuto; Patrick William,0,0,25,25
1667994060356,CSE 290,D00,102427,Pevzner; Pavel Arkadjevich,0,0,0,0
1667994060356,CSE 290,E00,102429,Zhao; Jishen,0,0,0,0
1667994060356,CSE 290,F00,102436,Tullsen; Dean Michael,0,0,0,0
1667994060356,CSE 290,G00,102440,Christensen; Henrik I,0,0,20,20
1667994060793,CSE 291,A00,102443,Su; Hao,0,0,0,0
1667994060793,CSE 291,B00,102448,Polikarpova; Nadezhda,0,0,0,0
1667994060793,CSE 291,C00,102453,Vaccaro; Kristen Marie,0,0,0,0
1667994060793,CSE 291,D00,111343,Savage; Stefan,0,0,0,0
1667994060793,CSE 291,E00,116474,Claffy; Kimberly Claire,0,0,0,0
1667994060793,CSE 291,F00,116479,Pasquale; Joseph,0,0,0,0
1667994061238,CSE 293,001,119111,Bafna; Vineet,9999,0,9999,0
1667994061238,CSE 293,002,119118,Bellare; Mihir,9999,0,9999,0
1667994061238,CSE 293,003,119122,Berg-Kirkpatrick; Taylor D,9999,0,9999,0
1667994061238,CSE 293,004,119135,Christensen; Henrik I,9999,0,9999,0
1667994061238,CSE 293,005,119142,Cottrell; Garrison W,9999,0,9999,0
1667994061238,CSE 293,006,119146,Deutsch; Alin Bernard,9999,0,9999,0
1667994061238,CSE 293,007,119159,Esmaeilzadeh; Hadi,9999,0,9999,0
1667994061238,CSE 293,008,119166,Freund; Yoav,9999,0,9999,0
1667994061238,CSE 293,009,119170,Griswold; William G.,9999,0,9999,0
1667994061238,CSE 293,010,119183,Gymrek; Melissa Ann,9999,0,9999,0
1667994061238,CSE 293,011,119190,Heninger; Nadia A,9999,0,9999,0
1667994061238,CSE 293,012,119230,Impagliazzo; Russell,9999,0,9999,0
1667994061238,CSE 293,013,119232,Jhala; Ranjit,9999,0,9999,0
1667994061238,CSE 293,014,119233,Kahng; Andrew Byun,9999,0,9999,0
1667994061238,CSE 293,015,119298,Kane; Daniel Mertz,9999,0,9999,0
1667994061238,CSE 293,016,119299,Kriegman; David J,9999,0,9999,0
1667994061238,CSE 293,017,119300,Kumar; Arun Kumar,9999,0,9999,0
1667994061238,CSE 293,018,119301,Lerner; Sorin,9999,0,9999,0
1667994061238,CSE 293,019,119302,Lovett; Shachar,9999,0,9999,0
1667994061238,CSE 293,020,119303,McAuley; Julian John,9999,0,9999,0
1667994061238,CSE 293,021,119304,Micciancio; Daniele,9999,0,9999,0
1667994061238,CSE 293,022,119367,Orailoglu; Alex,9999,0,9999,0
1667994061238,CSE 293,023,119382,Paturi; Ramamohan,9999,0,9999,0
1667994061238,CSE 293,024,119404,Polikarpova; Nadezhda,9999,0,9999,0
1667994061238,CSE 293,025,119406,Politz; Joseph Gibbs,9999,0,9999,0
1667994061238,CSE 293,026,119411,Porter; George M,9999,0,9999,0
1667994061238,CSE 293,027,119414,Porter; Leonard Emerson,9999,0,9999,0
1667994061238,CSE 293,028,119416,Ramamoorthi; Ravi,9999,0,9999,0
1667994061238,CSE 293,029,119417,Sahoo; Debashis,9999,0,9999,0
1667994061238,CSE 293,030,119420,Saul; Lawrence,9999,0,9999,0
1667994061238,CSE 293,031,119421,Savage; Stefan,9999,0,9999,0
1667994061238,CSE 293,032,119425,Schulze; Jurgen P.,9999,0,9999,0
1667994061238,CSE 293,033,119426,Snoeren; Alex C.,9999,0,9999,0
1667994061238,CSE 293,034,119428,Shang; Jingbo,9999,0,9999,0
1667994061238,CSE 293,035,119430,Stefan; Deian,9999,0,9999,0
1667994061238,CSE 293,036,119431,Su; Hao,9999,0,9999,0
1667994061238,CSE 293,037,119433,Swanson; Steven James,9999,0,9999,0
1667994061238,CSE 293,038,119435,Tullsen; Dean Michael,9999,0,9999,0
1667994061238,CSE 293,039,119483,Voelker; Geoffrey M.,9999,0,9999,0
1667994061238,CSE 293,040,119537,Zhao; Jishen,9999,0,9999,0
1667994061238,CSE 293,041,119538,Zhou; Yuan-Yuan,9999,0,9999,0
1667994061238,CSE 293,042,119539,Gao; Sicun,9999,0,9999,0
1667994061238,CSE 293,043,119540,Weibel; Nadir,9999,0,9999,0
1667994061238,CSE 293,044,119541,Gupta; Rajesh K.,9999,0,9999,0
1667994061238,CSE 293,045,126410,Vaccaro; Kristen Marie,9999,0,9999,0
1667994061238,CSE 293,046,126411,Klemke; Richard,9999,0,9999,0
1667994061668,CSE 294,A00,102459,Voelker; Geoffrey M.,0,0,0,0
1667994061668,CSE 294,B00,111322,Orailoglu; Alex,0,0,0,0
1667994062197,DSE 201,A00,096914,Deutsch; Alin Bernard,30,0,30,0
1667994062622,DSE 210,A00,096915,Dasgupta; Sanjoy,30,0,30,0
1667994063050,DSE 260A,A00,096916,Altintas De Callaf; Ilkay,30,0,30,0
1667994063570,ECE 200,001,103586,Antipa; Nicholas A,9999,0,9999,0
1667994063570,ECE 200,002,103587,Atanasov; Nikolay A.,9999,0,9999,0
1667994063570,ECE 200,003,103588,Bharadia; Dinesh,9999,0,9999,0
1667994063570,ECE 200,004,103589,Cheng; Chung Kuan,9999,0,9999,0
1667994063570,ECE 200,005,103590,Cosman; Pamela C.,9999,0,9999,0
1667994063570,ECE 200,006,103591,Dayeh; Shadi Ahmad,9999,0,9999,0
1667994063570,ECE 200,007,103592,Fainman; Yeshaiahu,9999,0,9999,0
1667994063570,ECE 200,008,103593,Ford; Joseph Earl,9999,0,9999,0
1667994063570,ECE 200,009,103594,Franceschetti; Massimo,9999,0,9999,0
1667994063570,ECE 200,010,103595,Fullerton; Eric E,9999,0,9999,0
1667994063570,ECE 200,011,103596,Galton; Ian A,9999,0,9999,0
1667994063570,ECE 200,012,103597,Gilja; Vikash,9999,0,9999,0
1667994063570,ECE 200,013,103598,Hall; Drew A.,9999,0,9999,0
1667994063570,ECE 200,014,103599,Hsueh; Tzu-Chien,9999,0,9999,0
1667994063570,ECE 200,015,103600,Javidi; Tara,9999,0,9999,0
1667994063570,ECE 200,016,103601,Kahng; Andrew Byun,9999,0,9999,0
1667994063570,ECE 200,017,103602,Kim; Young-Han,9999,0,9999,0
1667994063570,ECE 200,018,103603,Koushanfar; Farinaz,9999,0,9999,0
1667994063570,ECE 200,019,103604,Kuzum; Duygu,9999,0,9999,0
1667994063570,ECE 200,020,103605,Le; Hanh-Phuc,9999,0,9999,0
1667994063570,ECE 200,021,103606,Lin; Bill,9999,0,9999,0
1667994063570,ECE 200,022,103607,Liu; Zhaowei,9998,0,9999,1
1667994063570,ECE 200,023,103608,Lo; Yu-Hwa,9999,0,9999,0
1667994063570,ECE 200,024,103609,Lomakin; Vitaliy,9999,0,9999,0
1667994063570,ECE 200,025,103610,Mercier; Patrick Philip,9999,0,9999,0
1667994063570,ECE 200,026,103611,Meyer; Florian,9999,0,9999,0
1667994063570,ECE 200,027,103612,Milstein; Laurence B.,9999,0,9999,0
1667994063570,ECE 200,028,103613,Mir Arabbaygi; Siavash,9999,0,9999,0
1667994063570,ECE 200,029,103614,Mookherjea; Shayan,9999,0,9999,0
1667994063570,ECE 200,030,103615,Morris; Karcher William,9999,0,9999,0
1667994063570,ECE 200,031,103616,Ng; Tse Nga,9999,0,9999,0
1667994063570,ECE 200,032,103617,Nguyen; Truong Quang,9999,0,9999,0
1667994063570,ECE 200,033,103618,Nomura; Kenji,9999,0,9999,0
1667994063570,ECE 200,034,103619,Orlitsky; Alon,9999,0,9999,0
1667994063570,ECE 200,035,103620,Pal; Piya,9999,0,9999,0
1667994063570,ECE 200,036,103621,Papen; George C.,9999,0,9999,0
1667994063570,ECE 200,037,103622,Radic; Stojan,9999,0,9999,0
1667994063570,ECE 200,038,103623,Rao; Bhaskar D.,9999,0,9999,0
1667994063570,ECE 200,039,103624,Rao; Ramesh R,9999,0,9999,0
1667994063570,ECE 200,040,103625,Rebeiz; Gabriel,9999,0,9999,0
1667994063570,ECE 200,041,103626,Sanford; John R,9999,0,9999,0
1667994063570,ECE 200,042,103627,Siegel; Paul H.,9999,0,9999,0
1667994063570,ECE 200,043,103628,Sievenpiper; Daniel F.,9999,0,9999,0
1667994063570,ECE 200,044,103629,Sworder; David D.,9999,0,9999,0
1667994063570,ECE 200,045,103630,Taur; Yuan,9999,0,9999,0
1667994063570,ECE 200,046,103631,Touri; Behrouz,9999,0,9999,0
1667994063570,ECE 200,047,103632,Trivedi; Mohan M.,9999,0,9999,0
1667994063570,ECE 200,048,103633,Vasconcelos; Nuno,9999,0,9999,0
1667994063570,ECE 200,049,103634,Wang; Xiaolong,9999,0,9999,0
1667994063570,ECE 200,050,103635,Xie; Pengtao,9999,0,9999,0
1667994063570,ECE 200,051,103636,Yip; Michael,9999,0,9999,0
1667994063570,ECE 200,052,103637,Zeger; Kenneth A.,999,0,999,0
1667994063570,ECE 200,053,103638,Zhang; Xinyu,9999,0,9999,0
1667994063570,ECE 200,054,103639,Turakhia; Yatish Girish,9999,0,9999,0
1667994063570,ECE 200,055,103640,Kang; Mingu,9999,0,9999,0
1667994063570,ECE 200,056,103641,Shi; Yuanyuan,9999,0,9999,0
1667994063570,ECE 200,057,103642,Wang; Edward Jay,9999,0,9999,0
1667994063570,ECE 200,058,103643,Zheng; Yang,9999,0,9999,0
1667994063994,ECE 202,A00,103644,Kuzum; Duygu,0,0,0,0
1667994064420,ECE 212BN,A00,103646,Ng; Tse Nga,0,0,0,0
1667994064863,ECE 221,A00,111493,Staff,0,0,0,0
1667994065288,ECE 222B,A00,103647,Lomakin; Vitaliy,0,0,0,0
1667994065723,ECE 230B,A00,103648,Taur; Yuan,0,0,0,0
1667994066153,ECE 238B,A00,103649,Garay; Javier,0,0,0,0
1667994066596,ECE 240B,A00,112900,Fainman; Yeshaiahu,0,0,0,0
1667994067025,ECE 247A,A00,103650,Jokerst; Jesse Vincent,0,0,0,0
1667994067453,ECE 247B,A00,103651,Wang; Joseph,0,0,0,0
1667994067895,ECE 250,A00,103652,Siegel; Paul H.,0,0,0,0
1667994068328,ECE 251A,A00,103654,Rao; Bhaskar D.,0,0,0,0
1667994068757,ECE 257B,A00,103655,Bharadia; Dinesh,0,0,0,0
1667994069186,ECE 258A,A00,103656,Milstein; Laurence B.,0,0,0,0
1667994069614,ECE 260B,A00,103658,Kang; Mingu,0,0,0,0
1667994070060,ECE 264A,A00,103659,Galton; Ian A,0,0,0,0
1667994070490,ECE 265A,A00,103661,Gudem; Prasad S.S.,0,0,0,0
1667994070914,ECE 265D,A00,103662,Gudem; Prasad S.S.,0,0,0,0
1667994071340,ECE 268,A00,103663,Koushanfar; Farinaz,0,0,0,0
1667994071769,ECE 269,A01,103665,Pal; Piya,0,0,0,0
1667994072193,ECE 271B,A00,103666,Vasconcelos; Manuela,0,0,0,0
1667994072619,ECE 276A,A00,103667,Atanasov; Nikolay A.,0,0,0,0
1667994073049,ECE 277,A00,103668,An; Cheolhong,0,0,0,0
1667994073472,ECE 279,A00,117947,Hall; Drew A.,0,0,0,0
1667994074336,ECE 283,A00,103670,Hsueh; Tzu-Chien,0,0,0,0
1667994074759,ECE 284,A00,103671,Turakhia; Yatish Girish,0,0,0,0
1667994075183,ECE 285,A00,103672,Zheng; Yang,0,0,0,0
1667994075183,ECE 285,B00,103673,Sworder; David D.,0,0,0,0
1667994075606,ECE 287,A00,103676,Javidi; Tara,0,0,0,0
1667994076032,MATH 200B,A00,098023,Salehi Golsefidy; Alireza,14,0,15,1
1667994076457,MATH 202B,A00,098024,Rhoades; Brendon Patrick,12,0,15,3
1667994076885,MATH 203B,A00,098025,Oprea; Dragos N.,12,0,15,3
1667994077309,MATH 204B,A00,098026,Sorensen; Claus M,14,0,15,1
1667994077734,MATH 208,A00,098027,Izadi; Elham,7,0,10,3
1667994078160,MATH 209,A00,098028,Pollack; Aaron,10,0,10,0
1667994078588,MATH 211A,A00,112919,Rogalski; Daniel,9,0,10,1
1667994079012,MATH 211B,A00,112920,Seward; Brandon M.,9,0,10,1
1667994079437,MATH 218,A00,098029,Li; Bo,10,0,10,0
1667994079875,MATH 220B,A00,098030,Novak; Jonathan I,13,0,15,2
1667994080307,MATH 221A,A00,098031,Ebenfelt; Peter F,13,0,15,2
1667994080741,MATH 231B,A00,098032,Zlatos; Andrej,12,0,15,3
1667994081172,MATH 240B,A00,098033,Ni; Lei,10,0,15,5
1667994081596,MATH 243,A00,098034,Jekel; David Andrew,10,0,10,0
1667994082027,MATH 245A,A00,098035,Nie; Jiawang,0,0,15,16
1667994082452,MATH 248,A00,098036,Bejenaru; Ioan,10,0,10,0
1667994082877,MATH 250B,A00,098037,Spolaor; Luca,14,0,15,1
1667994083325,MATH 258,A00,098038,Ni; Lei,10,0,10,0
1667994083749,MATH 264B,A00,098041,Rhoades; Brendon Patrick,11,0,15,4
1667994084172,MATH 268,A00,098042,Buss; Samuel R,10,0,10,0
1667994084600,MATH 269,A00,098043,Rhoades; Brendon Patrick,10,0,10,0
1667994085026,MATH 270B,A00,098044,Li; Bo,11,0,15,4
1667994085457,MATH 272B,A00,098045,Holst; Michael J,13,0,15,2
1667994085890,MATH 273A,A00,098046,Tian; Xiaochuan,12,0,15,3
1667994086324,MATH 275,A01,098048,Tian; Xiaochuan,6,0,10,4
1667994086757,MATH 278A,A00,098049,Holst; Michael J,8,0,10,2
1667994087185,MATH 278B,A00,098050,Cloninger; Alexander,10,0,10,0
1667994087608,MATH 278C,A00,098051,Nie; Jiawang,8,0,10,2
1667994088031,MATH 280B,A00,098052,Zheng; Tianyi,11,0,15,4
1667994088458,MATH 281B,A00,098053,Bradic; Jelena,4,0,15,11
1667994088896,MATH 282B,A00,098054,Arias-Castro; Ery,2,0,15,13
1667994089337,MATH 285,A00,098055,Fitzsimmons; Patrick J,0,0,15,17
1667994089761,MATH 287B,A00,098056,Arias-Castro; Ery,5,0,15,10
1667994090195,MATH 288,A00,098057,Agarwal; Pooja,9,0,10,1
1667994090195,MATH 288,B00,098058,Zhang; Danna,9,0,10,1
1667994090195,MATH 288,C00,098059,Williams; Ruth J,10,0,10,0
1667994090619,MATH 290B,A00,098060,Roberts; Justin Deritter,14,0,15,1
1667994091046,MATH 292,A00,098061,Belmont; Eva Kinoshita,10,0,10,0
1667994091472,MATH 295,A00,098062,Suk; Andrew Hoon,48,0,50,2
1667994091894,MATH 296,A00,098063,Novak; Jonathan I,20,0,20,0
1667994092336,MATH 297,001,098064,Gamst; Anthony Collins,9997,0,9999,2
1667994595228,COGS 205,A00,101395,Chiba; Andrea,19,0,20,1
1667994595666,COGS 210B,001,101404,Greene; Deanna Jacquelyn,9998,0,9999,1
1667994595666,COGS 210B,002,101417,Xia; Haijun,9999,0,9999,0
1667994595666,COGS 210B,003,101422,Nitz; Douglas A.,9999,0,9999,0
1667994595666,COGS 210B,004,101423,Hollan; James D.,9998,0,9999,1
1667994595666,COGS 210B,005,101424,Deak; Gedeon O.,9999,0,9999,0
1667994595666,COGS 210B,006,101425,Rossano; Federico,9999,0,9999,0
1667994596090,COGS 211B,A00,101427,Coulson; Seana M,9997,0,9999,2
1667994596532,COGS 220,A00,101428,Hollan; James D.,0,0,25,25
1667994596961,COGS 229,A00,101429,Dow; Steven P,18,0,25,7
1667994597385,COGS 230,A00,101430,Klemmer; Scott R,13,0,17,4
1667994597812,COGS 234,A00,101431,Xia; Haijun,7,0,25,18
1667994598238,COGS 260,A00,101432,Kiyonaga; Anastasia,20,0,25,5
1667994598238,COGS 260,B00,101433,Kirsh; David Joel,16,0,25,9
1667994598669,CSE 202,A00,102371,Impagliazzo; Russell,0,0,0,0
1667994599095,CSE 203B,A01,102373,Cheng; Chung Kuan,0,0,0,0
1667994599531,CSE 208,A00,102374,Micciancio; Daniele,0,0,0,0
1667994599956,CSE 209A,A00,112895,Impagliazzo; Russell,0,0,15,15
1667994600391,CSE 209B,A00,108005,Bellare; Mihir,0,0,0,0
1667994600822,CSE 210,A00,113163,Coblenz; Michael J,0,0,0,0
1667994601246,CSE 219,A00,106111,Dow; Steven P,0,0,20,20
1667994601672,CSE 221,A00,102376,Voelker; Geoffrey M.,0,0,0,0
1667994602103,CSE 224,A01,102378,Porter; George M,0,0,0,0
1667994602529,CSE 229A,A00,102379,Savage; Stefan,0,0,0,0
1667994602958,CSE 229C,A00,102380,Munyaka; Imani N. S.,0,0,0,0
1667994603386,CSE 232B,A00,102382,Deutsch; Alin Bernard,0,0,0,0
1667994603817,CSE 234,A01,112904,Kumar; Arun Kumar,0,0,0,0
1667994604242,CSE 237A,A00,102383,Rosing; Tajana Simunic,0,0,0,0
1667994604670,CSE 239A,A00,102384,Deutsch; Alin Bernard,0,0,0,0
1667994605097,CSE 239B,A00,102385,Polikarpova; Nadezhda,0,0,0,0
1667994605525,CSE 240A,A00,102386,Pannuto; Patrick William,0,0,0,0
1667994605957,CSE 240B,A00,102387,Zhao; Jishen,0,0,0,0
1667994606385,CSE 241A,A00,106406,Kang; Mingu,0,0,0,0
1667994606810,CSE 249B,A00,102388,Kahng; Andrew Byun,0,0,8,8
1667994607235,CSE 251B,A01,102392,Cottrell; Garrison W,0,0,0,0
1667994607235,CSE 251B,A02,102393,Cottrell; Garrison W,0,0,0,0
1667994607660,CSE 252B,A00,102394,Ochoa; Benjamin Lawrence,0,0,0,0
1667994608084,CSE 257,A01,102396,Gao; Sicun,0,0,0,0
1667994608514,CSE 272,A00,102397,Li; Tzumao,0,0,0,0
1667994608945,CSE 274,A00,111323,Chern; Albert Ren-Haur,0,0,0,0
1667994609370,CSE 282,A00,102398,Pevzner; Pavel Arkadjevich,0,0,0,0
1667994609794,CSE 284,A00,114175,Gymrek; Melissa Ann,0,0,0,0
1667994610221,CSE 290,A00,102399,Chandraker; Manmohan Krishna,0,0,0,0
1667994610221,CSE 290,B00,102400,Vaccaro; Kristen Marie,0,0,25,25
1667994610221,CSE 290,C00,102414,Pannuto; Patrick William,0,0,25,25
1667994610221,CSE 290,D00,102427,Pevzner; Pavel Arkadjevich,0,0,0,0
1667994610221,CSE 290,E00,102429,Zhao; Jishen,0,0,0,0
1667994610221,CSE 290,F00,102436,Tullsen; Dean Michael,0,0,0,0
1667994610221,CSE 290,G00,102440,Christensen; Henrik I,0,0,20,20
1667994610657,CSE 291,A00,102443,Su; Hao,0,0,0,0
1667994610657,CSE 291,B00,102448,Polikarpova; Nadezhda,0,0,0,0
1667994610657,CSE 291,C00,102453,Vaccaro; Kristen Marie,0,0,0,0
1667994610657,CSE 291,D00,111343,Savage; Stefan,0,0,0,0
1667994610657,CSE 291,E00,116474,Claffy; Kimberly Claire,0,0,0,0
1667994610657,CSE 291,F00,116479,Pasquale; Joseph,0,0,0,0
1667994611122,CSE 293,001,119111,Bafna; Vineet,9999,0,9999,0
1667994611122,CSE 293,002,119118,Bellare; Mihir,9999,0,9999,0
1667994611122,CSE 293,003,119122,Berg-Kirkpatrick; Taylor D,9999,0,9999,0
1667994611122,CSE 293,004,119135,Christensen; Henrik I,9999,0,9999,0
1667994611122,CSE 293,005,119142,Cottrell; Garrison W,9999,0,9999,0
1667994611122,CSE 293,006,119146,Deutsch; Alin Bernard,9999,0,9999,0
1667994611122,CSE 293,007,119159,Esmaeilzadeh; Hadi,9999,0,9999,0
1667994611122,CSE 293,008,119166,Freund; Yoav,9999,0,9999,0
1667994611122,CSE 293,009,119170,Griswold; William G.,9999,0,9999,0
1667994611122,CSE 293,010,119183,Gymrek; Melissa Ann,9999,0,9999,0
1667994611122,CSE 293,011,119190,Heninger; Nadia A,9999,0,9999,0
1667994611122,CSE 293,012,119230,Impagliazzo; Russell,9999,0,9999,0
1667994611122,CSE 293,013,119232,Jhala; Ranjit,9999,0,9999,0
1667994611122,CSE 293,014,119233,Kahng; Andrew Byun,9999,0,9999,0
1667994611122,CSE 293,015,119298,Kane; Daniel Mertz,9999,0,9999,0
1667994611122,CSE 293,016,119299,Kriegman; David J,9999,0,9999,0
1667994611122,CSE 293,017,119300,Kumar; Arun Kumar,9999,0,9999,0
1667994611122,CSE 293,018,119301,Lerner; Sorin,9999,0,9999,0
1667994611122,CSE 293,019,119302,Lovett; Shachar,9999,0,9999,0
1667994611122,CSE 293,020,119303,McAuley; Julian John,9999,0,9999,0
1667994611122,CSE 293,021,119304,Micciancio; Daniele,9999,0,9999,0
1667994611122,CSE 293,022,119367,Orailoglu; Alex,9999,0,9999,0
1667994611122,CSE 293,023,119382,Paturi; Ramamohan,9999,0,9999,0
1667994611122,CSE 293,024,119404,Polikarpova; Nadezhda,9999,0,9999,0
1667994611122,CSE 293,025,119406,Politz; Joseph Gibbs,9999,0,9999,0
1667994611122,CSE 293,026,119411,Porter; George M,9999,0,9999,0
1667994611122,CSE 293,027,119414,Porter; Leonard Emerson,9999,0,9999,0
1667994611122,CSE 293,028,119416,Ramamoorthi; Ravi,9999,0,9999,0
1667994611122,CSE 293,029,119417,Sahoo; Debashis,9999,0,9999,0
1667994611122,CSE 293,030,119420,Saul; Lawrence,9999,0,9999,0
1667994611122,CSE 293,031,119421,Savage; Stefan,9999,0,9999,0
1667994611122,CSE 293,032,119425,Schulze; Jurgen P.,9999,0,9999,0
1667994611122,CSE 293,033,119426,Snoeren; Alex C.,9999,0,9999,0
1667994611122,CSE 293,034,119428,Shang; Jingbo,9999,0,9999,0
1667994611122,CSE 293,035,119430,Stefan; Deian,9999,0,9999,0
1667994611122,CSE 293,036,119431,Su; Hao,9999,0,9999,0
1667994611122,CSE 293,037,119433,Swanson; Steven James,9999,0,9999,0
1667994611122,CSE 293,038,119435,Tullsen; Dean Michael,9999,0,9999,0
1667994611122,CSE 293,039,119483,Voelker; Geoffrey M.,9999,0,9999,0
1667994611122,CSE 293,040,119537,Zhao; Jishen,9999,0,9999,0
1667994611122,CSE 293,041,119538,Zhou; Yuan-Yuan,9999,0,9999,0
1667994611122,CSE 293,042,119539,Gao; Sicun,9999,0,9999,0
1667994611122,CSE 293,043,119540,Weibel; Nadir,9999,0,9999,0
1667994611122,CSE 293,044,119541,Gupta; Rajesh K.,9999,0,9999,0
1667994611122,CSE 293,045,126410,Vaccaro; Kristen Marie,9999,0,9999,0
1667994611122,CSE 293,046,126411,Klemke; Richard,9999,0,9999,0
1667994611552,CSE 294,A00,102459,Voelker; Geoffrey M.,0,0,0,0
1667994611552,CSE 294,B00,111322,Orailoglu; Alex,0,0,0,0
1667994611982,DSE 201,A00,096914,Deutsch; Alin Bernard,30,0,30,0
1667994612406,DSE 210,A00,096915,Dasgupta; Sanjoy,30,0,30,0
1667994612835,DSE 260A,A00,096916,Altintas De Callaf; Ilkay,30,0,30,0
1667994613324,ECE 200,001,103586,Antipa; Nicholas A,9999,0,9999,0
1667994613324,ECE 200,002,103587,Atanasov; Nikolay A.,9999,0,9999,0
1667994613324,ECE 200,003,103588,Bharadia; Dinesh,9999,0,9999,0
1667994613324,ECE 200,004,103589,Cheng; Chung Kuan,9999,0,9999,0
1667994613324,ECE 200,005,103590,Cosman; Pamela C.,9999,0,9999,0
1667994613324,ECE 200,006,103591,Dayeh; Shadi Ahmad,9999,0,9999,0
1667994613324,ECE 200,007,103592,Fainman; Yeshaiahu,9999,0,9999,0
1667994613324,ECE 200,008,103593,Ford; Joseph Earl,9999,0,9999,0
1667994613324,ECE 200,009,103594,Franceschetti; Massimo,9999,0,9999,0
1667994613324,ECE 200,010,103595,Fullerton; Eric E,9999,0,9999,0
1667994613324,ECE 200,011,103596,Galton; Ian A,9999,0,9999,0
1667994613324,ECE 200,012,103597,Gilja; Vikash,9999,0,9999,0
1667994613324,ECE 200,013,103598,Hall; Drew A.,9999,0,9999,0
1667994613324,ECE 200,014,103599,Hsueh; Tzu-Chien,9999,0,9999,0
1667994613324,ECE 200,015,103600,Javidi; Tara,9999,0,9999,0
1667994613324,ECE 200,016,103601,Kahng; Andrew Byun,9999,0,9999,0
1667994613324,ECE 200,017,103602,Kim; Young-Han,9999,0,9999,0
1667994613324,ECE 200,018,103603,Koushanfar; Farinaz,9999,0,9999,0
1667994613324,ECE 200,019,103604,Kuzum; Duygu,9999,0,9999,0
1667994613324,ECE 200,020,103605,Le; Hanh-Phuc,9999,0,9999,0
1667994613324,ECE 200,021,103606,Lin; Bill,9999,0,9999,0
1667994613324,ECE 200,022,103607,Liu; Zhaowei,9998,0,9999,1
1667994613324,ECE 200,023,103608,Lo; Yu-Hwa,9999,0,9999,0
1667994613324,ECE 200,024,103609,Lomakin; Vitaliy,9999,0,9999,0
1667994613324,ECE 200,025,103610,Mercier; Patrick Philip,9999,0,9999,0
1667994613324,ECE 200,026,103611,Meyer; Florian,9999,0,9999,0
1667994613324,ECE 200,027,103612,Milstein; Laurence B.,9999,0,9999,0
1667994613324,ECE 200,028,103613,Mir Arabbaygi; Siavash,9999,0,9999,0
1667994613324,ECE 200,029,103614,Mookherjea; Shayan,9999,0,9999,0
1667994613324,ECE 200,030,103615,Morris; Karcher William,9999,0,9999,0
1667994613324,ECE 200,031,103616,Ng; Tse Nga,9999,0,9999,0
1667994613324,ECE 200,032,103617,Nguyen; Truong Quang,9999,0,9999,0
1667994613324,ECE 200,033,103618,Nomura; Kenji,9999,0,9999,0
1667994613324,ECE 200,034,103619,Orlitsky; Alon,9999,0,9999,0
1667994613324,ECE 200,035,103620,Pal; Piya,9999,0,9999,0
1667994613324,ECE 200,036,103621,Papen; George C.,9999,0,9999,0
1667994613324,ECE 200,037,103622,Radic; Stojan,9999,0,9999,0
1667994613324,ECE 200,038,103623,Rao; Bhaskar D.,9999,0,9999,0
1667994613324,ECE 200,039,103624,Rao; Ramesh R,9999,0,9999,0
1667994613324,ECE 200,040,103625,Rebeiz; Gabriel,9999,0,9999,0
1667994613324,ECE 200,041,103626,Sanford; John R,9999,0,9999,0
1667994613324,ECE 200,042,103627,Siegel; Paul H.,9999,0,9999,0
1667994613324,ECE 200,043,103628,Sievenpiper; Daniel F.,9999,0,9999,0
1667994613324,ECE 200,044,103629,Sworder; David D.,9999,0,9999,0
1667994613324,ECE 200,045,103630,Taur; Yuan,9999,0,9999,0
1667994613324,ECE 200,046,103631,Touri; Behrouz,9999,0,9999,0
1667994613324,ECE 200,047,103632,Trivedi; Mohan M.,9999,0,9999,0
1667994613324,ECE 200,048,103633,Vasconcelos; Nuno,9999,0,9999,0
1667994613324,ECE 200,049,103634,Wang; Xiaolong,9999,0,9999,0
1667994613324,ECE 200,050,103635,Xie; Pengtao,9999,0,9999,0
1667994613324,ECE 200,051,103636,Yip; Michael,9999,0,9999,0
1667994613324,ECE 200,052,103637,Zeger; Kenneth A.,999,0,999,0
1667994613324,ECE 200,053,103638,Zhang; Xinyu,9999,0,9999,0
1667994613324,ECE 200,054,103639,Turakhia; Yatish Girish,9999,0,9999,0
1667994613324,ECE 200,055,103640,Kang; Mingu,9999,0,9999,0
1667994613324,ECE 200,056,103641,Shi; Yuanyuan,9999,0,9999,0
1667994613324,ECE 200,057,103642,Wang; Edward Jay,9999,0,9999,0
1667994613324,ECE 200,058,103643,Zheng; Yang,9999,0,9999,0
1667994613753,ECE 202,A00,103644,Kuzum; Duygu,0,0,0,0
1667994614180,ECE 212BN,A00,103646,Ng; Tse Nga,0,0,0,0
1667994614604,ECE 221,A00,111493,Staff,0,0,0,0
1667994615032,ECE 222B,A00,103647,Lomakin; Vitaliy,0,0,0,0
1667994615461,ECE 230B,A00,103648,Taur; Yuan,0,0,0,0
1667994615886,ECE 238B,A00,103649,Garay; Javier,0,0,0,0
1667994616310,ECE 240B,A00,112900,Fainman; Yeshaiahu,0,0,0,0
1667994616735,ECE 247A,A00,103650,Jokerst; Jesse Vincent,0,0,0,0
1667994617164,ECE 247B,A00,103651,Wang; Joseph,0,0,0,0
1667994617589,ECE 250,A00,103652,Siegel; Paul H.,0,0,0,0
1667994618013,ECE 251A,A00,103654,Rao; Bhaskar D.,0,0,0,0
1667994618441,ECE 257B,A00,103655,Bharadia; Dinesh,0,0,0,0
1667994618866,ECE 258A,A00,103656,Milstein; Laurence B.,0,0,0,0
1667994619292,ECE 260B,A00,103658,Kang; Mingu,0,0,0,0
1667994619729,ECE 264A,A00,103659,Galton; Ian A,0,0,0,0
1667994620153,ECE 265A,A00,103661,Gudem; Prasad S.S.,0,0,0,0
1667994620578,ECE 265D,A00,103662,Gudem; Prasad S.S.,0,0,0,0
1667994621002,ECE 268,A00,103663,Koushanfar; Farinaz,0,0,0,0
1667994621430,ECE 269,A01,103665,Pal; Piya,0,0,0,0
1667994621866,ECE 271B,A00,103666,Vasconcelos; Manuela,0,0,0,0
1667994622293,ECE 276A,A00,103667,Atanasov; Nikolay A.,0,0,0,0
1667994622721,ECE 277,A00,103668,An; Cheolhong,0,0,0,0
1667994623147,ECE 279,A00,117947,Hall; Drew A.,0,0,0,0
1667994624020,ECE 283,A00,103670,Hsueh; Tzu-Chien,0,0,0,0
1667994624444,ECE 284,A00,103671,Turakhia; Yatish Girish,0,0,0,0
1667994624870,ECE 285,A00,103672,Zheng; Yang,0,0,0,0
1667994624870,ECE 285,B00,103673,Sworder; David D.,0,0,0,0
1667994625306,ECE 287,A00,103676,Javidi; Tara,0,0,0,0
1667994625747,MATH 200B,A00,098023,Salehi Golsefidy; Alireza,14,0,15,1
1667994626172,MATH 202B,A00,098024,Rhoades; Brendon Patrick,12,0,15,3
1667994626598,MATH 203B,A00,098025,Oprea; Dragos N.,12,0,15,3
1667994627024,MATH 204B,A00,098026,Sorensen; Claus M,14,0,15,1
1667994627449,MATH 208,A00,098027,Izadi; Elham,7,0,10,3
1667994627877,MATH 209,A00,098028,Pollack; Aaron,10,0,10,0
1667994628307,MATH 211A,A00,112919,Rogalski; Daniel,9,0,10,1
1667994628810,MATH 211B,A00,112920,Seward; Brandon M.,9,0,10,1
1667994629239,MATH 218,A00,098029,Li; Bo,10,0,10,0
1667994629663,MATH 220B,A00,098030,Novak; Jonathan I,13,0,15,2
1667994630088,MATH 221A,A00,098031,Ebenfelt; Peter F,13,0,15,2
1667994630512,MATH 231B,A00,098032,Zlatos; Andrej,12,0,15,3
1667994630936,MATH 240B,A00,098033,Ni; Lei,10,0,15,5
1667994631363,MATH 243,A00,098034,Jekel; David Andrew,10,0,10,0
1667994631789,MATH 245A,A00,098035,Nie; Jiawang,0,0,15,16
1667994632215,MATH 248,A00,098036,Bejenaru; Ioan,10,0,10,0
1667994632647,MATH 250B,A00,098037,Spolaor; Luca,14,0,15,1
1667994633073,MATH 258,A00,098038,Ni; Lei,10,0,10,0
1667994633501,MATH 264B,A00,098041,Rhoades; Brendon Patrick,11,0,15,4
1667994633927,MATH 268,A00,098042,Buss; Samuel R,10,0,10,0
1667994634356,MATH 269,A00,098043,Rhoades; Brendon Patrick,10,0,10,0
1667994634783,MATH 270B,A00,098044,Li; Bo,11,0,15,4
1667994635216,MATH 272B,A00,098045,Holst; Michael J,13,0,15,2
1667994635644,MATH 273A,A00,098046,Tian; Xiaochuan,12,0,15,3
1667994636070,MATH 275,A01,098048,Tian; Xiaochuan,6,0,10,4
1667994636496,MATH 278A,A00,098049,Holst; Michael J,8,0,10,2
1667994636921,MATH 278B,A00,098050,Cloninger; Alexander,10,0,10,0
1667994637357,MATH 278C,A00,098051,Nie; Jiawang,8,0,10,2
1667994637787,MATH 280B,A00,098052,Zheng; Tianyi,11,0,15,4
1667994638226,MATH 281B,A00,098053,Bradic; Jelena,4,0,15,11
1667994638650,MATH 282B,A00,098054,Arias-Castro; Ery,2,0,15,13
1667994639081,MATH 285,A00,098055,Fitzsimmons; Patrick J,0,0,15,17
1667994639506,MATH 287B,A00,098056,Arias-Castro; Ery,5,0,15,10
1667994639936,MATH 288,A00,098057,Agarwal; Pooja,9,0,10,1
1667994639936,MATH 288,B00,098058,Zhang; Danna,9,0,10,1
1667994639936,MATH 288,C00,098059,Williams; Ruth J,10,0,10,0
1667994640367,MATH 290B,A00,098060,Roberts; Justin Deritter,14,0,15,1
1667994640791,MATH 292,A00,098061,Belmont; Eva Kinoshita,10,0,10,0
1667994641216,MATH 295,A00,098062,Suk; Andrew Hoon,48,0,50,2
1667994641642,MATH 296,A00,098063,Novak; Jonathan I,20,0,20,0
1667994642073,MATH 297,001,098064,Gamst; Anthony Collins,9997,0,9999,2
1667995143590,COGS 205,A00,101395,Chiba; Andrea,19,0,20,1
1667995144021,COGS 210B,001,101404,Greene; Deanna Jacquelyn,9998,0,9999,1
1667995144021,COGS 210B,002,101417,Xia; Haijun,9999,0,9999,0
1667995144021,COGS 210B,003,101422,Nitz; Douglas A.,9999,0,9999,0
1667995144021,COGS 210B,004,101423,Hollan; James D.,9998,0,9999,1
1667995144021,COGS 210B,005,101424,Deak; Gedeon O.,9999,0,9999,0
1667995144021,COGS 210B,006,101425,Rossano; Federico,9999,0,9999,0
1667995144451,COGS 211B,A00,101427,Coulson; Seana M,9997,0,9999,2
1667995144879,COGS 220,A00,101428,Hollan; James D.,0,0,25,25
1667995145302,COGS 229,A00,101429,Dow; Steven P,18,0,25,7
1667995145728,COGS 230,A00,101430,Klemmer; Scott R,13,0,17,4
1667995146154,COGS 234,A00,101431,Xia; Haijun,7,0,25,18
1667995146578,COGS 260,A00,101432,Kiyonaga; Anastasia,20,0,25,5
1667995146578,COGS 260,B00,101433,Kirsh; David Joel,16,0,25,9
1667995147011,CSE 202,A00,102371,Impagliazzo; Russell,0,0,0,0
1667995147435,CSE 203B,A01,102373,Cheng; Chung Kuan,0,0,0,0
1667995147862,CSE 208,A00,102374,Micciancio; Daniele,0,0,0,0
1667995148287,CSE 209A,A00,112895,Impagliazzo; Russell,0,0,15,15
1667995148720,CSE 209B,A00,108005,Bellare; Mihir,0,0,0,0
1667995149145,CSE 210,A00,113163,Coblenz; Michael J,0,0,0,0
1667995149570,CSE 219,A00,106111,Dow; Steven P,0,0,20,20
1667995149995,CSE 221,A00,102376,Voelker; Geoffrey M.,0,0,0,0
1667995150511,CSE 224,A01,102378,Porter; George M,0,0,0,0
1667995150938,CSE 229A,A00,102379,Savage; Stefan,0,0,0,0
1667995151364,CSE 229C,A00,102380,Munyaka; Imani N. S.,0,0,0,0
1667995151787,CSE 232B,A00,102382,Deutsch; Alin Bernard,0,0,0,0
1667995152211,CSE 234,A01,112904,Kumar; Arun Kumar,0,0,0,0
1667995152639,CSE 237A,A00,102383,Rosing; Tajana Simunic,0,0,0,0
1667995153066,CSE 239A,A00,102384,Deutsch; Alin Bernard,0,0,0,0
1667995153490,CSE 239B,A00,102385,Polikarpova; Nadezhda,0,0,0,0
1667995153919,CSE 240A,A00,102386,Pannuto; Patrick William,0,0,0,0
1667995154343,CSE 240B,A00,102387,Zhao; Jishen,0,0,0,0
1667995154767,CSE 241A,A00,106406,Kang; Mingu,0,0,0,0
1667995155191,CSE 249B,A00,102388,Kahng; Andrew Byun,0,0,8,8
1667995155614,CSE 251B,A01,102392,Cottrell; Garrison W,0,0,0,0
1667995155614,CSE 251B,A02,102393,Cottrell; Garrison W,0,0,0,0
1667995156041,CSE 252B,A00,102394,Ochoa; Benjamin Lawrence,0,0,0,0
1667995156468,CSE 257,A01,102396,Gao; Sicun,0,0,0,0
1667995156893,CSE 272,A00,102397,Li; Tzumao,0,0,0,0
1667995157327,CSE 274,A00,111323,Chern; Albert Ren-Haur,0,0,0,0
1667995157753,CSE 282,A00,102398,Pevzner; Pavel Arkadjevich,0,0,0,0
1667995158178,CSE 284,A00,114175,Gymrek; Melissa Ann,0,0,0,0
1667995158603,CSE 290,A00,102399,Chandraker; Manmohan Krishna,0,0,0,0
1667995158603,CSE 290,B00,102400,Vaccaro; Kristen Marie,0,0,25,25
1667995158603,CSE 290,C00,102414,Pannuto; Patrick William,0,0,25,25
1667995158603,CSE 290,D00,102427,Pevzner; Pavel Arkadjevich,0,0,0,0
1667995158603,CSE 290,E00,102429,Zhao; Jishen,0,0,0,0
1667995158603,CSE 290,F00,102436,Tullsen; Dean Michael,0,0,0,0
1667995158603,CSE 290,G00,102440,Christensen; Henrik I,0,0,20,20
1667995159041,CSE 291,A00,102443,Su; Hao,0,0,0,0
1667995159041,CSE 291,B00,102448,Polikarpova; Nadezhda,0,0,0,0
1667995159041,CSE 291,C00,102453,Vaccaro; Kristen Marie,0,0,0,0
1667995159041,CSE 291,D00,111343,Savage; Stefan,0,0,0,0
1667995159041,CSE 291,E00,116474,Claffy; Kimberly Claire,0,0,0,0
1667995159041,CSE 291,F00,116479,Pasquale; Joseph,0,0,0,0
1667995159516,CSE 293,001,119111,Bafna; Vineet,9999,0,9999,0
1667995159516,CSE 293,002,119118,Bellare; Mihir,9999,0,9999,0
1667995159516,CSE 293,003,119122,Berg-Kirkpatrick; Taylor D,9999,0,9999,0
1667995159516,CSE 293,004,119135,Christensen; Henrik I,9999,0,9999,0
1667995159516,CSE 293,005,119142,Cottrell; Garrison W,9999,0,9999,0
1667995159516,CSE 293,006,119146,Deutsch; Alin Bernard,9999,0,9999,0
1667995159516,CSE 293,007,119159,Esmaeilzadeh; Hadi,9999,0,9999,0
1667995159516,CSE 293,008,119166,Freund; Yoav,9999,0,9999,0
1667995159516,CSE 293,009,119170,Griswold; William G.,9999,0,9999,0
1667995159516,CSE 293,010,119183,Gymrek; Melissa Ann,9999,0,9999,0
1667995159516,CSE 293,011,119190,Heninger; Nadia A,9999,0,9999,0
1667995159516,CSE 293,012,119230,Impagliazzo; Russell,9999,0,9999,0
1667995159516,CSE 293,013,119232,Jhala; Ranjit,9999,0,9999,0
1667995159516,CSE 293,014,119233,Kahng; Andrew Byun,9999,0,9999,0
1667995159516,CSE 293,015,119298,Kane; Daniel Mertz,9999,0,9999,0
1667995159516,CSE 293,016,119299,Kriegman; David J,9999,0,9999,0
1667995159516,CSE 293,017,119300,Kumar; Arun Kumar,9999,0,9999,0
1667995159516,CSE 293,018,119301,Lerner; Sorin,9999,0,9999,0
1667995159516,CSE 293,019,119302,Lovett; Shachar,9999,0,9999,0
1667995159516,CSE 293,020,119303,McAuley; Julian John,9999,0,9999,0
1667995159516,CSE 293,021,119304,Micciancio; Daniele,9999,0,9999,0
1667995159516,CSE 293,022,119367,Orailoglu; Alex,9999,0,9999,0
1667995159516,CSE 293,023,119382,Paturi; Ramamohan,9999,0,9999,0
1667995159516,CSE 293,024,119404,Polikarpova; Nadezhda,9999,0,9999,0
1667995159516,CSE 293,025,119406,Politz; Joseph Gibbs,9999,0,9999,0
1667995159516,CSE 293,026,119411,Porter; George M,9999,0,9999,0
1667995159516,CSE 293,027,119414,Porter; Leonard Emerson,9999,0,9999,0
1667995159516,CSE 293,028,119416,Ramamoorthi; Ravi,9999,0,9999,0
1667995159516,CSE 293,029,119417,Sahoo; Debashis,9999,0,9999,0
1667995159516,CSE 293,030,119420,Saul; Lawrence,9999,0,9999,0
1667995159516,CSE 293,031,119421,Savage; Stefan,9999,0,9999,0
1667995159516,CSE 293,032,119425,Schulze; Jurgen P.,9999,0,9999,0
1667995159516,CSE 293,033,119426,Snoeren; Alex C.,9999,0,9999,0
1667995159516,CSE 293,034,119428,Shang; Jingbo,9999,0,9999,0
1667995159516,CSE 293,035,119430,Stefan; Deian,9999,0,9999,0
1667995159516,CSE 293,036,119431,Su; Hao,9999,0,9999,0
1667995159516,CSE 293,037,119433,Swanson; Steven James,9999,0,9999,0
1667995159516,CSE 293,038,119435,Tullsen; Dean Michael,9999,0,9999,0
1667995159516,CSE 293,039,119483,Voelker; Geoffrey M.,9999,0,9999,0
1667995159516,CSE 293,040,119537,Zhao; Jishen,9999,0,9999,0
1667995159516,CSE 293,041,119538,Zhou; Yuan-Yuan,9999,0,9999,0
1667995159516,CSE 293,042,119539,Gao; Sicun,9999,0,9999,0
1667995159516,CSE 293,043,119540,Weibel; Nadir,9999,0,9999,0
1667995159516,CSE 293,044,119541,Gupta; Rajesh K.,9999,0,9999,0
1667995159516,CSE 293,045,126410,Vaccaro; Kristen Marie,9999,0,9999,0
1667995159516,CSE 293,046,126411,Klemke; Richard,9999,0,9999,0
1667995159942,CSE 294,A00,102459,Voelker; Geoffrey M.,0,0,0,0
1667995159942,CSE 294,B00,111322,Orailoglu; Alex,0,0,0,0
1667995160380,DSE 201,A00,096914,Deutsch; Alin Bernard,30,0,30,0
1667995160804,DSE 210,A00,096915,Dasgupta; Sanjoy,30,0,30,0
1667995161228,DSE 260A,A00,096916,Altintas De Callaf; Ilkay,30,0,30,0
1667995161667,ECE 200,001,103586,Antipa; Nicholas A,9999,0,9999,0
1667995161667,ECE 200,002,103587,Atanasov; Nikolay A.,9999,0,9999,0
1667995161667,ECE 200,003,103588,Bharadia; Dinesh,9999,0,9999,0
1667995161667,ECE 200,004,103589,Cheng; Chung Kuan,9999,0,9999,0
1667995161667,ECE 200,005,103590,Cosman; Pamela C.,9999,0,9999,0
1667995161667,ECE 200,006,103591,Dayeh; Shadi Ahmad,9999,0,9999,0
1667995161667,ECE 200,007,103592,Fainman; Yeshaiahu,9999,0,9999,0
1667995161667,ECE 200,008,103593,Ford; Joseph Earl,9999,0,9999,0
1667995161667,ECE 200,009,103594,Franceschetti; Massimo,9999,0,9999,0
1667995161667,ECE 200,010,103595,Fullerton; Eric E,9999,0,9999,0
1667995161667,ECE 200,011,103596,Galton; Ian A,9999,0,9999,0
1667995161667,ECE 200,012,103597,Gilja; Vikash,9999,0,9999,0
1667995161667,ECE 200,013,103598,Hall; Drew A.,9999,0,9999,0
1667995161667,ECE 200,014,103599,Hsueh; Tzu-Chien,9999,0,9999,0
1667995161667,ECE 200,015,103600,Javidi; Tara,9999,0,9999,0
1667995161667,ECE 200,016,103601,Kahng; Andrew Byun,9999,0,9999,0
1667995161667,ECE 200,017,103602,Kim; Young-Han,9999,0,9999,0
1667995161667,ECE 200,018,103603,Koushanfar; Farinaz,9999,0,9999,0
1667995161667,ECE 200,019,103604,Kuzum; Duygu,9999,0,9999,0
1667995161667,ECE 200,020,103605,Le; Hanh-Phuc,9999,0,9999,0
1667995161667,ECE 200,021,103606,Lin; Bill,9999,0,9999,0
1667995161667,ECE 200,022,103607,Liu; Zhaowei,9998,0,9999,1
1667995161667,ECE 200,023,103608,Lo; Yu-Hwa,9999,0,9999,0
1667995161667,ECE 200,024,103609,Lomakin; Vitaliy,9999,0,9999,0
1667995161667,ECE 200,025,103610,Mercier; Patrick Philip,9999,0,9999,0
1667995161667,ECE 200,026,103611,Meyer; Florian,9999,0,9999,0
1667995161667,ECE 200,027,103612,Milstein; Laurence B.,9999,0,9999,0
1667995161667,ECE 200,028,103613,Mir Arabbaygi; Siavash,9999,0,9999,0
1667995161667,ECE 200,029,103614,Mookherjea; Shayan,9999,0,9999,0
1667995161667,ECE 200,030,103615,Morris; Karcher William,9999,0,9999,0
1667995161667,ECE 200,031,103616,Ng; Tse Nga,9999,0,9999,0
1667995161667,ECE 200,032,103617,Nguyen; Truong Quang,9999,0,9999,0
1667995161667,ECE 200,033,103618,Nomura; Kenji,9999,0,9999,0
1667995161667,ECE 200,034,103619,Orlitsky; Alon,9999,0,9999,0
1667995161667,ECE 200,035,103620,Pal; Piya,9999,0,9999,0
1667995161667,ECE 200,036,103621,Papen; George C.,9999,0,9999,0
1667995161667,ECE 200,037,103622,Radic; Stojan,9999,0,9999,0
1667995161667,ECE 200,038,103623,Rao; Bhaskar D.,9999,0,9999,0
1667995161667,ECE 200,039,103624,Rao; Ramesh R,9999,0,9999,0
1667995161667,ECE 200,040,103625,Rebeiz; Gabriel,9999,0,9999,0
1667995161667,ECE 200,041,103626,Sanford; John R,9999,0,9999,0
1667995161667,ECE 200,042,103627,Siegel; Paul H.,9999,0,9999,0
1667995161667,ECE 200,043,103628,Sievenpiper; Daniel F.,9999,0,9999,0
1667995161667,ECE 200,044,103629,Sworder; David D.,9999,0,9999,0
1667995161667,ECE 200,045,103630,Taur; Yuan,9999,0,9999,0
1667995161667,ECE 200,046,103631,Touri; Behrouz,9999,0,9999,0
1667995161667,ECE 200,047,103632,Trivedi; Mohan M.,9999,0,9999,0
1667995161667,ECE 200,048,103633,Vasconcelos; Nuno,9999,0,9999,0
1667995161667,ECE 200,049,103634,Wang; Xiaolong,9999,0,9999,0
1667995161667,ECE 200,050,103635,Xie; Pengtao,9999,0,9999,0
1667995161667,ECE 200,051,103636,Yip; Michael,9999,0,9999,0
1667995161667,ECE 200,052,103637,Zeger; Kenneth A.,999,0,999,0
1667995161667,ECE 200,053,103638,Zhang; Xinyu,9999,0,9999,0
1667995161667,ECE 200,054,103639,Turakhia; Yatish Girish,9999,0,9999,0
1667995161667,ECE 200,055,103640,Kang; Mingu,9999,0,9999,0
1667995161667,ECE 200,056,103641,Shi; Yuanyuan,9999,0,9999,0
1667995161667,ECE 200,057,103642,Wang; Edward Jay,9999,0,9999,0
1667995161667,ECE 200,058,103643,Zheng; Yang,9999,0,9999,0
1667995162096,ECE 202,A00,103644,Kuzum; Duygu,0,0,0,0
1667995162523,ECE 212BN,A00,103646,Ng; Tse Nga,0,0,0,0
1667995162949,ECE 221,A00,111493,Staff,0,0,0,0
1667995163372,ECE 222B,A00,103647,Lomakin; Vitaliy,0,0,0,0
1667995163796,ECE 230B,A00,103648,Taur; Yuan,0,0,0,0
1667995164227,ECE 238B,A00,103649,Garay; Javier,0,0,0,0
1667995164652,ECE 240B,A00,112900,Fainman; Yeshaiahu,0,0,0,0
1667995165075,ECE 247A,A00,103650,Jokerst; Jesse Vincent,0,0,0,0
1667995165501,ECE 247B,A00,103651,Wang; Joseph,0,0,0,0
1667995165927,ECE 250,A00,103652,Siegel; Paul H.,0,0,0,0
1667995166355,ECE 251A,A00,103654,Rao; Bhaskar D.,0,0,0,0
1667995166779,ECE 257B,A00,103655,Bharadia; Dinesh,0,0,0,0
1667995167205,ECE 258A,A00,103656,Milstein; Laurence B.,0,0,0,0
1667995167633,ECE 260B,A00,103658,Kang; Mingu,0,0,0,0
1667995168061,ECE 264A,A00,103659,Galton; Ian A,0,0,0,0
1667995168492,ECE 265A,A00,103661,Gudem; Prasad S.S.,0,0,0,0
1667995168920,ECE 265D,A00,103662,Gudem; Prasad S.S.,0,0,0,0
1667995169345,ECE 268,A00,103663,Koushanfar; Farinaz,0,0,0,0
1667995169774,ECE 269,A01,103665,Pal; Piya,0,0,0,0
1667995170204,ECE 271B,A00,103666,Vasconcelos; Manuela,0,0,0,0
1667995170630,ECE 276A,A00,103667,Atanasov; Nikolay A.,0,0,0,0
1667995171054,ECE 277,A00,103668,An; Cheolhong,0,0,0,0
1667995171479,ECE 279,A00,117947,Hall; Drew A.,0,0,0,0
1667995172327,ECE 283,A00,103670,Hsueh; Tzu-Chien,0,0,0,0
1667995172756,ECE 284,A00,103671,Turakhia; Yatish Girish,0,0,0,0
1667995173183,ECE 285,A00,103672,Zheng; Yang,0,0,0,0
1667995173183,ECE 285,B00,103673,Sworder; David D.,0,0,0,0
1667995173604,ECE 287,A00,103676,Javidi; Tara,0,0,0,0
1667995174030,MATH 200B,A00,098023,Salehi Golsefidy; Alireza,14,0,15,1
1667995174454,MATH 202B,A00,098024,Rhoades; Brendon Patrick,12,0,15,3
1667995174879,MATH 203B,A00,098025,Oprea; Dragos N.,12,0,15,3
1667995175304,MATH 204B,A00,098026,Sorensen; Claus M,14,0,15,1
1667995175732,MATH 208,A00,098027,Izadi; Elham,7,0,10,3
1667995176156,MATH 209,A00,098028,Pollack; Aaron,10,0,10,0
1667995176587,MATH 211A,A00,112919,Rogalski; Daniel,9,0,10,1
1667995177010,MATH 211B,A00,112920,Seward; Brandon M.,9,0,10,1
1667995177438,MATH 218,A00,098029,Li; Bo,10,0,10,0
1667995177874,MATH 220B,A00,098030,Novak; Jonathan I,13,0,15,2
1667995178300,MATH 221A,A00,098031,Ebenfelt; Peter F,13,0,15,2
1667995178728,MATH 231B,A00,098032,Zlatos; Andrej,12,0,15,3
1667995179159,MATH 240B,A00,098033,Ni; Lei,10,0,15,5
1667995179584,MATH 243,A00,098034,Jekel; David Andrew,10,0,10,0
1667995180010,MATH 245A,A00,098035,Nie; Jiawang,0,0,15,16
1667995180435,MATH 248,A00,098036,Bejenaru; Ioan,10,0,10,0
1667995180858,MATH 250B,A00,098037,Spolaor; Luca,14,0,15,1
1667995181283,MATH 258,A00,098038,Ni; Lei,10,0,10,0
1667995181708,MATH 264B,A00,098041,Rhoades; Brendon Patrick,11,0,15,4
1667995182131,MATH 268,A00,098042,Buss; Samuel R,10,0,10,0
1667995182556,MATH 269,A00,098043,Rhoades; Brendon Patrick,10,0,10,0
1667995182982,MATH 270B,A00,098044,Li; Bo,11,0,15,4
1667995183407,MATH 272B,A00,098045,Holst; Michael J,13,0,15,2
1667995183832,MATH 273A,A00,098046,Tian; Xiaochuan,12,0,15,3
1667995184258,MATH 275,A01,098048,Tian; Xiaochuan,6,0,10,4
1667995184695,MATH 278A,A00,098049,Holst; Michael J,8,0,10,2
1667995185117,MATH 278B,A00,098050,Cloninger; Alexander,10,0,10,0
1667995185545,MATH 278C,A00,098051,Nie; Jiawang,8,0,10,2
1667995185980,MATH 280B,A00,098052,Zheng; Tianyi,11,0,15,4
1667995186409,MATH 281B,A00,098053,Bradic; Jelena,4,0,15,11
1667995186833,MATH 282B,A00,098054,Arias-Castro; Ery,2,0,15,13
1667995187259,MATH 285,A00,098055,Fitzsimmons; Patrick J,0,0,15,17
1667995187688,MATH 287B,A00,098056,Arias-Castro; Ery,5,0,15,10
1667995188117,MATH 288,A00,098057,Agarwal; Pooja,9,0,10,1
1667995188117,MATH 288,B00,098058,Zhang; Danna,9,0,10,1
1667995188117,MATH 288,C00,098059,Williams; Ruth J,10,0,10,0
1667995188546,MATH 290B,A00,098060,Roberts; Justin Deritter,14,0,15,1
1667995188972,MATH 292,A00,098061,Belmont; Eva Kinoshita,10,0,10,0
1667995189396,MATH 295,A00,098062,Suk; Andrew Hoon,48,0,50,2
1667995189831,MATH 296,A00,098063,Novak; Jonathan I,20,0,20,0
1667995190257,MATH 297,001,098064,Gamst; Anthony Collins,9997,0,9999,2
1667995693294,COGS 205,A00,101395,Chiba; Andrea,19,0,20,1
1667995693730,COGS 210B,001,101404,Greene; Deanna Jacquelyn,9998,0,9999,1
1667995693730,COGS 210B,002,101417,Xia; Haijun,9999,0,9999,0
1667995693730,COGS 210B,003,101422,Nitz; Douglas A.,9999,0,9999,0
1667995693730,COGS 210B,004,101423,Hollan; James D.,9998,0,9999,1
1667995693730,COGS 210B,005,101424,Deak; Gedeon O.,9999,0,9999,0
1667995693730,COGS 210B,006,101425,Rossano; Federico,9999,0,9999,0
1667995694158,COGS 211B,A00,101427,Coulson; Seana M,9997,0,9999,2
1667995694582,COGS 220,A00,101428,Hollan; James D.,0,0,25,25
1667995695004,COGS 229,A00,101429,Dow; Steven P,18,0,25,7
1667995695429,COGS 230,A00,101430,Klemmer; Scott R,13,0,17,4
1667995695857,COGS 234,A00,101431,Xia; Haijun,7,0,25,18
1667995696290,COGS 260,A00,101432,Kiyonaga; Anastasia,20,0,25,5
1667995696290,COGS 260,B00,101433,Kirsh; David Joel,16,0,25,9
1667995696730,CSE 202,A00,102371,Impagliazzo; Russell,0,0,0,0
1667995697160,CSE 203B,A01,102373,Cheng; Chung Kuan,0,0,0,0
1667995697585,CSE 208,A00,102374,Micciancio; Daniele,0,0,0,0
1667995698009,CSE 209A,A00,112895,Impagliazzo; Russell,0,0,15,15
1667995698435,CSE 209B,A00,108005,Bellare; Mihir,0,0,0,0
1667995698866,CSE 210,A00,113163,Coblenz; Michael J,0,0,0,0
1667995699293,CSE 219,A00,106111,Dow; Steven P,0,0,20,20
1667995699724,CSE 221,A00,102376,Voelker; Geoffrey M.,0,0,0,0
1667995700149,CSE 224,A01,102378,Porter; George M,0,0,0,0
1667995700578,CSE 229A,A00,102379,Savage; Stefan,0,0,0,0
1667995701005,CSE 229C,A00,102380,Munyaka; Imani N. S.,0,0,0,0
1667995701434,CSE 232B,A00,102382,Deutsch; Alin Bernard,0,0,0,0
1667995701859,CSE 234,A01,112904,Kumar; Arun Kumar,0,0,0,0
1667995702285,CSE 237A,A00,102383,Rosing; Tajana Simunic,0,0,0,0
1667995702712,CSE 239A,A00,102384,Deutsch; Alin Bernard,0,0,0,0
1667995703141,CSE 239B,A00,102385,Polikarpova; Nadezhda,0,0,0,0
1667995703566,CSE 240A,A00,102386,Pannuto; Patrick William,0,0,0,0
1667995703988,CSE 240B,A00,102387,Zhao; Jishen,0,0,0,0
1667995704414,CSE 241A,A00,106406,Kang; Mingu,0,0,0,0
1667995704842,CSE 249B,A00,102388,Kahng; Andrew Byun,0,0,8,8
1667995705272,CSE 251B,A01,102392,Cottrell; Garrison W,0,0,0,0
1667995705272,CSE 251B,A02,102393,Cottrell; Garrison W,0,0,0,0
1667995705700,CSE 252B,A00,102394,Ochoa; Benjamin Lawrence,0,0,0,0
1667995706128,CSE 257,A01,102396,Gao; Sicun,0,0,0,0
1667995706569,CSE 272,A00,102397,Li; Tzumao,0,0,0,0
1667995706995,CSE 274,A00,111323,Chern; Albert Ren-Haur,0,0,0,0
1667995707419,CSE 282,A00,102398,Pevzner; Pavel Arkadjevich,0,0,0,0
1667995707845,CSE 284,A00,114175,Gymrek; Melissa Ann,0,0,0,0
1667995708271,CSE 290,A00,102399,Chandraker; Manmohan Krishna,0,0,0,0
1667995708271,CSE 290,B00,102400,Vaccaro; Kristen Marie,0,0,25,25
1667995708271,CSE 290,C00,102414,Pannuto; Patrick William,0,0,25,25
1667995708271,CSE 290,D00,102427,Pevzner; Pavel Arkadjevich,0,0,0,0
1667995708271,CSE 290,E00,102429,Zhao; Jishen,0,0,0,0
1667995708271,CSE 290,F00,102436,Tullsen; Dean Michael,0,0,0,0
1667995708271,CSE 290,G00,102440,Christensen; Henrik I,0,0,20,20
1667995708699,CSE 291,A00,102443,Su; Hao,0,0,0,0
1667995708699,CSE 291,B00,102448,Polikarpova; Nadezhda,0,0,0,0
1667995708699,CSE 291,C00,102453,Vaccaro; Kristen Marie,0,0,0,0
1667995708699,CSE 291,D00,111343,Savage; Stefan,0,0,0,0
1667995708699,CSE 291,E00,116474,Claffy; Kimberly Claire,0,0,0,0
1667995708699,CSE 291,F00,116479,Pasquale; Joseph,0,0,0,0
1667995709147,CSE 293,001,119111,Bafna; Vineet,9999,0,9999,0
1667995709147,CSE 293,002,119118,Bellare; Mihir,9999,0,9999,0
1667995709147,CSE 293,003,119122,Berg-Kirkpatrick; Taylor D,9999,0,9999,0
1667995709147,CSE 293,004,119135,Christensen; Henrik I,9999,0,9999,0
1667995709147,CSE 293,005,119142,Cottrell; Garrison W,9999,0,9999,0
1667995709147,CSE 293,006,119146,Deutsch; Alin Bernard,9999,0,9999,0
1667995709147,CSE 293,007,119159,Esmaeilzadeh; Hadi,9999,0,9999,0
1667995709147,CSE 293,008,119166,Freund; Yoav,9999,0,9999,0
1667995709147,CSE 293,009,119170,Griswold; William G.,9999,0,9999,0
1667995709147,CSE 293,010,119183,Gymrek; Melissa Ann,9999,0,9999,0
1667995709147,CSE 293,011,119190,Heninger; Nadia A,9999,0,9999,0
1667995709147,CSE 293,012,119230,Impagliazzo; Russell,9999,0,9999,0
1667995709147,CSE 293,013,119232,Jhala; Ranjit,9999,0,9999,0
1667995709147,CSE 293,014,119233,Kahng; Andrew Byun,9999,0,9999,0
1667995709147,CSE 293,015,119298,Kane; Daniel Mertz,9999,0,9999,0
1667995709147,CSE 293,016,119299,Kriegman; David J,9999,0,9999,0
1667995709147,CSE 293,017,119300,Kumar; Arun Kumar,9999,0,9999,0
1667995709147,CSE 293,018,119301,Lerner; Sorin,9999,0,9999,0
1667995709147,CSE 293,019,119302,Lovett; Shachar,9999,0,9999,0
1667995709147,CSE 293,020,119303,McAuley; Julian John,9999,0,9999,0
1667995709147,CSE 293,021,119304,Micciancio; Daniele,9999,0,9999,0
1667995709147,CSE 293,022,119367,Orailoglu; Alex,9999,0,9999,0
1667995709147,CSE 293,023,119382,Paturi; Ramamohan,9999,0,9999,0
1667995709147,CSE 293,024,119404,Polikarpova; Nadezhda,9999,0,9999,0
1667995709147,CSE 293,025,119406,Politz; Joseph Gibbs,9999,0,9999,0
1667995709147,CSE 293,026,119411,Porter; George M,9999,0,9999,0
1667995709147,CSE 293,027,119414,Porter; Leonard Emerson,9999,0,9999,0
1667995709147,CSE 293,028,119416,Ramamoorthi; Ravi,9999,0,9999,0
1667995709147,CSE 293,029,119417,Sahoo; Debashis,9999,0,9999,0
1667995709147,CSE 293,030,119420,Saul; Lawrence,9999,0,9999,0
1667995709147,CSE 293,031,119421,Savage; Stefan,9999,0,9999,0
1667995709147,CSE 293,032,119425,Schulze; Jurgen P.,9999,0,9999,0
1667995709147,CSE 293,033,119426,Snoeren; Alex C.,9999,0,9999,0
1667995709147,CSE 293,034,119428,Shang; Jingbo,9999,0,9999,0
1667995709147,CSE 293,035,119430,Stefan; Deian,9999,0,9999,0
1667995709147,CSE 293,036,119431,Su; Hao,9999,0,9999,0
1667995709147,CSE 293,037,119433,Swanson; Steven James,9999,0,9999,0
1667995709147,CSE 293,038,119435,Tullsen; Dean Michael,9999,0,9999,0
1667995709147,CSE 293,039,119483,Voelker; Geoffrey M.,9999,0,9999,0
1667995709147,CSE 293,040,119537,Zhao; Jishen,9999,0,9999,0
1667995709147,CSE 293,041,119538,Zhou; Yuan-Yuan,9999,0,9999,0
1667995709147,CSE 293,042,119539,Gao; Sicun,9999,0,9999,0
1667995709147,CSE 293,043,119540,Weibel; Nadir,9999,0,9999,0
1667995709147,CSE 293,044,119541,Gupta; Rajesh K.,9999,0,9999,0
1667995709147,CSE 293,045,126410,Vaccaro; Kristen Marie,9999,0,9999,0
1667995709147,CSE 293,046,126411,Klemke; Richard,9999,0,9999,0
1667995709572,CSE 294,A00,102459,Voelker; Geoffrey M.,0,0,0,0
1667995709572,CSE 294,B00,111322,Orailoglu; Alex,0,0,0,0
1667995709996,DSE 201,A00,096914,Deutsch; Alin Bernard,30,0,30,0
1667995710425,DSE 210,A00,096915,Dasgupta; Sanjoy,30,0,30,0
1667995710855,DSE 260A,A00,096916,Altintas De Callaf; Ilkay,30,0,30,0
1667995711353,ECE 200,001,103586,Antipa; Nicholas A,9999,0,9999,0
1667995711353,ECE 200,002,103587,Atanasov; Nikolay A.,9999,0,9999,0
1667995711353,ECE 200,003,103588,Bharadia; Dinesh,9999,0,9999,0
1667995711353,ECE 200,004,103589,Cheng; Chung Kuan,9999,0,9999,0
1667995711353,ECE 200,005,103590,Cosman; Pamela C.,9999,0,9999,0
1667995711353,ECE 200,006,103591,Dayeh; Shadi Ahmad,9999,0,9999,0
1667995711353,ECE 200,007,103592,Fainman; Yeshaiahu,9999,0,9999,0
1667995711353,ECE 200,008,103593,Ford; Joseph Earl,9999,0,9999,0
1667995711353,ECE 200,009,103594,Franceschetti; Massimo,9999,0,9999,0
1667995711353,ECE 200,010,103595,Fullerton; Eric E,9999,0,9999,0
1667995711353,ECE 200,011,103596,Galton; Ian A,9999,0,9999,0
1667995711353,ECE 200,012,103597,Gilja; Vikash,9999,0,9999,0
1667995711353,ECE 200,013,103598,Hall; Drew A.,9999,0,9999,0
1667995711353,ECE 200,014,103599,Hsueh; Tzu-Chien,9999,0,9999,0
1667995711353,ECE 200,015,103600,Javidi; Tara,9999,0,9999,0
1667995711353,ECE 200,016,103601,Kahng; Andrew Byun,9999,0,9999,0
1667995711353,ECE 200,017,103602,Kim; Young-Han,9999,0,9999,0
1667995711353,ECE 200,018,103603,Koushanfar; Farinaz,9999,0,9999,0
1667995711353,ECE 200,019,103604,Kuzum; Duygu,9999,0,9999,0
1667995711353,ECE 200,020,103605,Le; Hanh-Phuc,9999,0,9999,0
1667995711353,ECE 200,021,103606,Lin; Bill,9999,0,9999,0
1667995711353,ECE 200,022,103607,Liu; Zhaowei,9998,0,9999,1
1667995711353,ECE 200,023,103608,Lo; Yu-Hwa,9999,0,9999,0
1667995711353,ECE 200,024,103609,Lomakin; Vitaliy,9999,0,9999,0
1667995711353,ECE 200,025,103610,Mercier; Patrick Philip,9999,0,9999,0
1667995711353,ECE 200,026,103611,Meyer; Florian,9999,0,9999,0
1667995711353,ECE 200,027,103612,Milstein; Laurence B.,9999,0,9999,0
1667995711353,ECE 200,028,103613,Mir Arabbaygi; Siavash,9999,0,9999,0
1667995711353,ECE 200,029,103614,Mookherjea; Shayan,9999,0,9999,0
1667995711353,ECE 200,030,103615,Morris; Karcher William,9999,0,9999,0
1667995711353,ECE 200,031,103616,Ng; Tse Nga,9999,0,9999,0
1667995711353,ECE 200,032,103617,Nguyen; Truong Quang,9999,0,9999,0
1667995711353,ECE 200,033,103618,Nomura; Kenji,9999,0,9999,0
1667995711353,ECE 200,034,103619,Orlitsky; Alon,9999,0,9999,0
1667995711353,ECE 200,035,103620,Pal; Piya,9999,0,9999,0
1667995711353,ECE 200,036,103621,Papen; George C.,9999,0,9999,0
1667995711353,ECE 200,037,103622,Radic; Stojan,9999,0,9999,0
1667995711353,ECE 200,038,103623,Rao; Bhaskar D.,9999,0,9999,0
1667995711353,ECE 200,039,103624,Rao; Ramesh R,9999,0,9999,0
1667995711353,ECE 200,040,103625,Rebeiz; Gabriel,9999,0,9999,0
1667995711353,ECE 200,041,103626,Sanford; John R,9999,0,9999,0
1667995711353,ECE 200,042,103627,Siegel; Paul H.,9999,0,9999,0
1667995711353,ECE 200,043,103628,Sievenpiper; Daniel F.,9999,0,9999,0
1667995711353,ECE 200,044,103629,Sworder; David D.,9999,0,9999,0
1667995711353,ECE 200,045,103630,Taur; Yuan,9999,0,9999,0
1667995711353,ECE 200,046,103631,Touri; Behrouz,9999,0,9999,0
1667995711353,ECE 200,047,103632,Trivedi; Mohan M.,9999,0,9999,0
1667995711353,ECE 200,048,103633,Vasconcelos; Nuno,9999,0,9999,0
1667995711353,ECE 200,049,103634,Wang; Xiaolong,9999,0,9999,0
1667995711353,ECE 200,050,103635,Xie; Pengtao,9999,0,9999,0
1667995711353,ECE 200,051,103636,Yip; Michael,9999,0,9999,0
1667995711353,ECE 200,052,103637,Zeger; Kenneth A.,999,0,999,0
1667995711353,ECE 200,053,103638,Zhang; Xinyu,9999,0,9999,0
1667995711353,ECE 200,054,103639,Turakhia; Yatish Girish,9999,0,9999,0
1667995711353,ECE 200,055,103640,Kang; Mingu,9999,0,9999,0
1667995711353,ECE 200,056,103641,Shi; Yuanyuan,9999,0,9999,0
1667995711353,ECE 200,057,103642,Wang; Edward Jay,9999,0,9999,0
1667995711353,ECE 200,058,103643,Zheng; Yang,9999,0,9999,0
1667995711780,ECE 202,A00,103644,Kuzum; Duygu,0,0,0,0
1667995712203,ECE 212BN,A00,103646,Ng; Tse Nga,0,0,0,0
1667995712632,ECE 221,A00,111493,Staff,0,0,0,0
1667995713061,ECE 222B,A00,103647,Lomakin; Vitaliy,0,0,0,0
1667995713484,ECE 230B,A00,103648,Taur; Yuan,0,0,0,0
1667995713916,ECE 238B,A00,103649,Garay; Javier,0,0,0,0
1667995714339,ECE 240B,A00,112900,Fainman; Yeshaiahu,0,0,0,0
1667995714764,ECE 247A,A00,103650,Jokerst; Jesse Vincent,0,0,0,0
1667995715190,ECE 247B,A00,103651,Wang; Joseph,0,0,0,0
1667995715616,ECE 250,A00,103652,Siegel; Paul H.,0,0,0,0
1667995716042,ECE 251A,A00,103654,Rao; Bhaskar D.,0,0,0,0
1667995716467,ECE 257B,A00,103655,Bharadia; Dinesh,0,0,0,0
1667995716892,ECE 258A,A00,103656,Milstein; Laurence B.,0,0,0,0
1667995717317,ECE 260B,A00,103658,Kang; Mingu,0,0,0,0
1667995717749,ECE 264A,A00,103659,Galton; Ian A,0,0,0,0
1667995718175,ECE 265A,A00,103661,Gudem; Prasad S.S.,0,0,0,0
1667995718603,ECE 265D,A00,103662,Gudem; Prasad S.S.,0,0,0,0
1667995719030,ECE 268,A00,103663,Koushanfar; Farinaz,0,0,0,0
1667995719454,ECE 269,A01,103665,Pal; Piya,0,0,0,0
1667995719886,ECE 271B,A00,103666,Vasconcelos; Manuela,0,0,0,0
1667995720316,ECE 276A,A00,103667,Atanasov; Nikolay A.,0,0,0,0
1667995720740,ECE 277,A00,103668,An; Cheolhong,0,0,0,0
1667995721163,ECE 279,A00,117947,Hall; Drew A.,0,0,0,0
1667995722020,ECE 283,A00,103670,Hsueh; Tzu-Chien,0,0,0,0
1667995722449,ECE 284,A00,103671,Turakhia; Yatish Girish,0,0,0,0
1667995722879,ECE 285,A00,103672,Zheng; Yang,0,0,0,0
1667995722879,ECE 285,B00,103673,Sworder; David D.,0,0,0,0
1667995723304,ECE 287,A00,103676,Javidi; Tara,0,0,0,0
1667995723731,MATH 200B,A00,098023,Salehi Golsefidy; Alireza,14,0,15,1
1667995724157,MATH 202B,A00,098024,Rhoades; Brendon Patrick,12,0,15,3
1667995724583,MATH 203B,A00,098025,Oprea; Dragos N.,12,0,15,3
1667995725009,MATH 204B,A00,098026,Sorensen; Claus M,14,0,15,1
1667995725432,MATH 208,A00,098027,Izadi; Elham,7,0,10,3
1667995725864,MATH 209,A00,098028,Pollack; Aaron,10,0,10,0
1667995726292,MATH 211A,A00,112919,Rogalski; Daniel,9,0,10,1
1667995726716,MATH 211B,A00,112920,Seward; Brandon M.,9,0,10,1
1667995727146,MATH 218,A00,098029,Li; Bo,10,0,10,0
1667995727570,MATH 220B,A00,098030,Novak; Jonathan I,13,0,15,2
1667995727994,MATH 221A,A00,098031,Ebenfelt; Peter F,13,0,15,2
1667995728418,MATH 231B,A00,098032,Zlatos; Andrej,12,0,15,3
1667995728849,MATH 240B,A00,098033,Ni; Lei,10,0,15,5
1667995729277,MATH 243,A00,098034,Jekel; David Andrew,10,0,10,0
1667995729704,MATH 245A,A00,098035,Nie; Jiawang,0,0,15,16
1667995730127,MATH 248,A00,098036,Bejenaru; Ioan,10,0,10,0
1667995730553,MATH 250B,A00,098037,Spolaor; Luca,14,0,15,1
1667995730978,MATH 258,A00,098038,Ni; Lei,10,0,10,0
1667995731408,MATH 264B,A00,098041,Rhoades; Brendon Patrick,11,0,15,4
1667995731833,MATH 268,A00,098042,Buss; Samuel R,10,0,10,0
1667995732256,MATH 269,A00,098043,Rhoades; Brendon Patrick,10,0,10,0
1667995732686,MATH 270B,A00,098044,Li; Bo,11,0,15,4
1667995733193,MATH 272B,A00,098045,Holst; Michael J,13,0,15,2
1667995733625,MATH 273A,A00,098046,Tian; Xiaochuan,12,0,15,3
1667995734050,MATH 275,A01,098048,Tian; Xiaochuan,6,0,10,4
1667995734479,MATH 278A,A00,098049,Holst; Michael J,8,0,10,2
1667995734926,MATH 278B,A00,098050,Cloninger; Alexander,10,0,10,0
1667995735369,MATH 278C,A00,098051,Nie; Jiawang,8,0,10,2
1667995735800,MATH 280B,A00,098052,Zheng; Tianyi,11,0,15,4
1667995736228,MATH 281B,A00,098053,Bradic; Jelena,4,0,15,11
1667995736653,MATH 282B,A00,098054,Arias-Castro; Ery,2,0,15,13
1667995737077,MATH 285,A00,098055,Fitzsimmons; Patrick J,0,0,15,17
1667995737502,MATH 287B,A00,098056,Arias-Castro; Ery,5,0,15,10
1667995737936,MATH 288,A00,098057,Agarwal; Pooja,9,0,10,1
1667995737936,MATH 288,B00,098058,Zhang; Danna,9,0,10,1
1667995737936,MATH 288,C00,098059,Williams; Ruth J,10,0,10,0
1667995738366,MATH 290B,A00,098060,Roberts; Justin Deritter,14,0,15,1
1667995738794,MATH 292,A00,098061,Belmont; Eva Kinoshita,10,0,10,0
1667995739218,MATH 295,A00,098062,Suk; Andrew Hoon,48,0,50,2
1667995739645,MATH 296,A00,098063,Novak; Jonathan I,20,0,20,0
1667995740080,MATH 297,001,098064,Gamst; Anthony Collins,9997,0,9999,2
